source,gentime, athop, hopcount,priority, reachedTime
2,3,2,2,1, 5
1,6,1,1,0, 7
4,6,4,4,1, 10
3,7,3,3,1, 10
5,7,3,3,1, 10
6,10,2,2,1, 12
7,12,1,1,1, 13
8,16,1,1,1, 17
11,14,4,4,0, 18
9,17,2,2,0, 19
16,19,2,2,0, 21
14,19,3,3,0, 22
17,19,3,3,1, 22
13,19,4,4,0, 23
15,21,2,2,0, 23
12,20,5,5,1, 25
20,23,6,6,0, 29
22,26,4,4,0, 30
2,28,2,2,1, 30
24,29,1,1,0, 30
19,26,5,5,0, 31
23,28,3,3,0, 31
21,27,5,5,1, 32
1,31,1,1,0, 32
4,31,4,4,1, 35
3,32,3,3,1, 35
5,32,3,3,0, 35
27,32,4,4,1, 36
30,33,3,3,0, 36
6,35,2,2,1, 37
25,35,2,2,0, 37
31,36,2,2,0, 38
7,37,1,1,1, 38
28,34,5,5,1, 39
26,37,3,3,0, 40
29,38,4,4,1, 42
8,41,1,1,0, 42
11,39,4,4,1, 43
9,42,2,2,0, 44
16,44,2,2,1, 46
14,44,3,3,0, 47
17,44,3,3,0, 47
13,44,4,4,0, 48
15,46,2,2,1, 48
12,45,5,5,1, 50
20,48,6,6,1, 54
22,51,4,4,0, 55
2,53,2,2,1, 55
24,54,1,1,0, 55
19,51,5,5,1, 56
23,53,3,3,1, 56
21,52,5,5,0, 57
1,56,1,1,0, 57
4,56,4,4,1, 60
3,57,3,3,0, 60
5,57,3,3,0, 60
27,57,4,4,0, 61
30,58,3,3,1, 61
6,60,2,2,1, 62
25,60,2,2,0, 62
31,61,2,2,0, 63
7,62,1,1,0, 63
28,59,5,5,0, 64
26,62,3,3,0, 65
29,63,4,4,1, 67
8,66,1,1,1, 67
11,64,4,4,1, 68
9,67,2,2,0, 69
16,69,2,2,0, 71
14,69,3,3,0, 72
17,69,3,3,0, 72
13,69,4,4,1, 73
15,71,2,2,0, 73
12,70,5,5,0, 75
18,73,4,4,0, 77
20,73,6,6,1, 79
22,76,4,4,0, 80
2,78,2,2,1, 80
24,79,1,1,1, 80
19,76,5,5,0, 81
23,78,3,3,1, 81
21,77,5,5,0, 82
1,81,1,1,1, 82
4,81,4,4,0, 85
3,82,3,3,0, 85
5,82,3,3,1, 85
27,82,4,4,1, 86
30,83,3,3,0, 86
6,85,2,2,0, 87
25,85,2,2,0, 87
31,86,2,2,0, 88
7,87,1,1,0, 88
28,84,5,5,1, 89
26,87,3,3,1, 90
29,88,4,4,0, 92
8,91,1,1,0, 92
11,89,4,4,1, 93
9,92,2,2,1, 94
16,94,2,2,1, 96
14,94,3,3,0, 97
17,94,3,3,0, 97
13,94,4,4,0, 98
15,96,2,2,1, 98
12,95,5,5,1, 100
18,98,4,4,1, 102
20,98,6,6,1, 104
22,101,4,4,1, 105
2,103,2,2,0, 105
24,104,1,1,0, 105
19,101,5,5,1, 106
23,103,3,3,0, 106
21,102,5,5,1, 107
1,106,1,1,0, 107
4,106,4,4,1, 110
3,107,3,3,1, 110
5,107,3,3,1, 110
27,107,4,4,0, 111
30,108,3,3,1, 111
6,110,2,2,1, 112
25,110,2,2,0, 112
31,111,2,2,1, 113
7,112,1,1,1, 113
28,109,5,5,0, 114
26,112,3,3,0, 115
29,113,4,4,0, 117
8,116,1,1,0, 117
11,114,4,4,1, 118
9,117,2,2,1, 119
16,119,2,2,1, 121
14,119,3,3,0, 122
17,119,3,3,0, 122
13,119,4,4,1, 123
15,121,2,2,0, 123
12,120,5,5,0, 125
18,123,4,4,1, 127
20,123,6,6,1, 129
22,126,4,4,1, 130
2,128,2,2,1, 130
24,129,1,1,1, 130
19,126,5,5,0, 131
23,128,3,3,0, 131
21,127,5,5,0, 132
1,131,1,1,0, 132
4,131,4,4,1, 135
3,132,3,3,0, 135
5,132,3,3,1, 135
27,132,4,4,0, 136
30,133,3,3,1, 136
6,135,2,2,1, 137
25,135,2,2,0, 137
31,136,2,2,1, 138
7,137,1,1,0, 138
28,134,5,5,1, 139
26,137,3,3,1, 140
29,138,4,4,0, 142
8,141,1,1,1, 142
16,144,2,2,1, 146
14,144,3,3,0, 147
17,144,3,3,1, 147
13,144,4,4,1, 148
15,146,2,2,0, 148
18,148,4,4,1, 152
20,148,6,6,1, 154
22,151,4,4,1, 155
24,154,1,1,0, 155
19,151,5,5,1, 156
23,153,3,3,1, 156
21,152,5,5,1, 157
1,156,1,1,0, 157
4,156,4,4,1, 160
3,157,3,3,1, 160
5,157,3,3,1, 160
30,158,3,3,0, 161
6,160,2,2,0, 162
25,160,2,2,1, 162
31,161,2,2,0, 163
7,162,1,1,0, 163
26,162,3,3,1, 165
29,163,4,4,0, 167
8,166,1,1,0, 167
16,169,2,2,1, 171
14,169,3,3,1, 172
13,169,4,4,1, 173
15,171,2,2,1, 173
12,170,5,5,1, 175
20,173,6,6,1, 179
22,176,4,4,0, 180
2,178,2,2,1, 180
24,179,1,1,0, 180
19,176,5,5,1, 181
23,178,3,3,1, 181
21,177,5,5,0, 182
1,181,1,1,0, 182
5,182,3,3,0, 185
27,182,4,4,1, 186
30,183,3,3,0, 186
6,185,2,2,0, 187
25,185,2,2,1, 187
31,186,2,2,0, 188
7,187,1,1,1, 188
28,184,5,5,1, 189
29,188,4,4,0, 192
8,191,1,1,0, 192
9,192,2,2,1, 194
16,194,2,2,0, 196
14,194,3,3,0, 197
13,194,4,4,1, 198
15,196,2,2,0, 198
12,195,5,5,1, 200
18,198,4,4,1, 202
20,198,6,6,1, 204
22,201,4,4,0, 205
2,203,2,2,1, 205
24,204,1,1,0, 205
23,203,3,3,0, 206
21,202,5,5,1, 207
1,206,1,1,0, 207
4,206,4,4,1, 210
3,207,3,3,1, 210
5,207,3,3,0, 210
27,207,4,4,1, 211
30,208,3,3,0, 211
6,210,2,2,0, 212
25,210,2,2,1, 212
31,211,2,2,1, 213
7,212,1,1,0, 213
28,209,5,5,1, 214
26,212,3,3,1, 215
29,213,4,4,0, 217
8,216,1,1,1, 217
16,219,2,2,1, 221
14,219,3,3,1, 222
17,219,3,3,1, 222
13,219,4,4,1, 223
15,221,2,2,0, 223
12,220,5,5,1, 225
20,223,6,6,1, 229
22,226,4,4,0, 230
2,228,2,2,1, 230
24,229,1,1,1, 230
23,228,3,3,0, 231
21,227,5,5,0, 232
1,231,1,1,1, 232
3,232,3,3,1, 235
5,232,3,3,1, 235
30,233,3,3,0, 236
6,235,2,2,0, 237
31,236,2,2,0, 238
7,237,1,1,1, 238
26,237,3,3,1, 240
29,238,4,4,0, 242
8,241,1,1,0, 242
11,239,4,4,1, 243
9,242,2,2,1, 244
16,244,2,2,1, 246
14,244,3,3,1, 247
17,244,3,3,1, 247
13,244,4,4,0, 248
15,246,2,2,0, 248
22,251,4,4,1, 255
24,254,1,1,1, 255
19,251,5,5,1, 256
23,253,3,3,1, 256
21,252,5,5,1, 257
1,256,1,1,0, 257
4,256,4,4,1, 260
5,257,3,3,0, 260
30,258,3,3,1, 261
6,260,2,2,1, 262
31,261,2,2,1, 263
7,262,1,1,1, 263
29,263,4,4,0, 267
8,266,1,1,0, 267
16,269,2,2,1, 271
14,269,3,3,0, 272
13,269,4,4,0, 273
15,271,2,2,0, 273
22,276,4,4,0, 280
24,279,1,1,1, 280
23,278,3,3,1, 281
21,277,5,5,1, 282
5,282,3,3,1, 285
30,283,3,3,1, 286
6,285,2,2,0, 287
31,286,2,2,1, 288
7,287,1,1,0, 288
29,288,4,4,1, 292
8,291,1,1,0, 292
16,294,2,2,0, 296
14,294,3,3,1, 297
13,294,4,4,1, 298
15,296,2,2,0, 298
22,301,4,4,0, 305
24,304,1,1,0, 305
23,303,3,3,1, 306
21,302,5,5,1, 307
5,307,3,3,0, 310
30,308,3,3,1, 311
6,310,2,2,1, 312
31,311,2,2,0, 313
7,312,1,1,0, 313
29,313,4,4,1, 317
8,316,1,1,0, 317
16,319,2,2,1, 321
14,319,3,3,1, 322
13,319,4,4,1, 323
22,326,4,4,1, 330
24,329,1,1,0, 330
23,328,3,3,1, 331
21,327,5,5,1, 332
5,332,3,3,1, 335
30,333,3,3,0, 336
6,335,2,2,0, 337
31,336,2,2,0, 338
7,337,1,1,0, 338
29,338,4,4,1, 342
8,341,1,1,0, 342
13,344,4,4,1, 348
24,354,1,1,1, 355
23,353,3,3,1, 356
5,357,3,3,1, 360
30,358,3,3,0, 361
6,360,2,2,0, 362
31,361,2,2,0, 363
7,362,1,1,0, 363
29,363,4,4,0, 367
8,366,1,1,0, 367
9,367,2,2,1, 369
16,369,2,2,1, 371
17,369,3,3,1, 372
13,369,4,4,1, 373
15,371,2,2,1, 373
12,370,5,5,1, 375
18,373,4,4,1, 377
20,373,6,6,1, 379
24,379,1,1,0, 380
23,378,3,3,1, 381
1,381,1,1,0, 382
4,381,4,4,1, 385
5,382,3,3,0, 385
30,383,3,3,0, 386
6,385,2,2,0, 387
31,386,2,2,0, 388
7,387,1,1,1, 388
28,384,5,5,1, 389
29,388,4,4,0, 392
8,391,1,1,0, 392
11,389,4,4,1, 393
16,394,2,2,1, 396
15,396,2,2,1, 398
24,404,1,1,0, 405
23,403,3,3,1, 406
21,402,5,5,1, 407
1,406,1,1,0, 407
4,406,4,4,1, 410
5,407,3,3,0, 410
30,408,3,3,0, 411
6,410,2,2,1, 412
25,410,2,2,1, 412
31,411,2,2,0, 413
7,412,1,1,1, 413
26,412,3,3,1, 415
29,413,4,4,1, 417
8,416,1,1,1, 417
9,417,2,2,1, 419
14,419,3,3,1, 422
13,419,4,4,1, 423
12,420,5,5,1, 425
24,429,1,1,0, 430
1,431,1,1,1, 432
5,432,3,3,0, 435
30,433,3,3,0, 436
6,435,2,2,0, 437
31,436,2,2,1, 438
7,437,1,1,1, 438
29,438,4,4,1, 442
8,441,1,1,1, 442
13,444,4,4,1, 448
15,446,2,2,1, 448
24,454,1,1,0, 455
1,456,1,1,1, 457
5,457,3,3,0, 460
30,458,3,3,1, 461
6,460,2,2,0, 462
31,461,2,2,1, 463
7,462,1,1,0, 463
29,463,4,4,1, 467
8,466,1,1,0, 467
17,469,3,3,1, 472
22,476,4,4,1, 480
24,479,1,1,1, 480
23,478,3,3,1, 481
21,477,5,5,1, 482
1,481,1,1,0, 482
5,482,3,3,0, 485
30,483,3,3,1, 486
6,485,2,2,1, 487
25,485,2,2,1, 487
31,486,2,2,0, 488
7,487,1,1,1, 488
29,488,4,4,1, 492
8,491,1,1,1, 492
16,494,2,2,1, 496
14,494,3,3,1, 497
24,504,1,1,0, 505
1,506,1,1,1, 507
5,507,3,3,0, 510
30,508,3,3,0, 511
6,510,2,2,1, 512
31,511,2,2,1, 513
7,512,1,1,1, 513
8,516,1,1,1, 517
14,519,3,3,1, 522
17,519,3,3,1, 522
13,519,4,4,1, 523
15,521,2,2,1, 523
2,528,2,2,1, 530
24,529,1,1,0, 530
23,528,3,3,1, 531
1,531,1,1,1, 532
5,532,3,3,1, 535
27,532,4,4,1, 536
25,535,2,2,1, 537
31,536,2,2,1, 538
7,537,1,1,1, 538
28,534,5,5,1, 539
26,537,3,3,1, 540
29,538,4,4,1, 542
8,541,1,1,1, 542
11,539,4,4,1, 543
9,542,2,2,1, 544
13,544,4,4,1, 548
15,546,2,2,1, 548
20,548,6,6,1, 554
22,551,4,4,1, 555
2,553,2,2,1, 555
24,554,1,1,1, 555
19,551,5,5,1, 556
23,553,3,3,1, 556
1,556,1,1,1, 557
3,557,3,3,1, 560
27,557,4,4,1, 561
25,560,2,2,1, 562
7,562,1,1,1, 563
28,559,5,5,1, 564
26,562,3,3,1, 565
29,563,4,4,1, 567
8,566,1,1,1, 567
16,569,2,2,1, 571
13,569,4,4,1, 573
24,579,1,1,0, 580
30,583,3,3,1, 586
6,585,2,2,1, 587
7,587,1,1,1, 588
8,591,1,1,1, 592
13,594,4,4,1, 598
15,596,2,2,1, 598
22,601,4,4,1, 605
24,604,1,1,0, 605
21,602,5,5,1, 607
5,607,3,3,1, 610
6,610,2,2,1, 612
7,612,1,1,0, 613
29,613,4,4,1, 617
8,616,1,1,1, 617
24,629,1,1,1, 630
23,628,3,3,1, 631
21,627,5,5,1, 632
5,632,3,3,1, 635
7,637,1,1,1, 638
8,641,1,1,1, 642
22,651,4,4,1, 655
24,654,1,1,0, 655
7,662,1,1,0, 663
8,666,1,1,0, 667
16,669,2,2,1, 671
14,669,3,3,1, 672
13,669,4,4,1, 673
24,679,1,1,0, 680
23,678,3,3,1, 681
1,681,1,1,0, 682
30,683,3,3,1, 686
31,686,2,2,1, 688
7,687,1,1,1, 688
29,688,4,4,1, 692
8,691,1,1,1, 692
16,694,2,2,1, 696
14,694,3,3,1, 697
12,695,5,5,1, 700
20,698,6,6,1, 704
22,701,4,4,1, 705
2,703,2,2,1, 705
24,704,1,1,1, 705
23,703,3,3,1, 706
21,702,5,5,1, 707
1,706,1,1,0, 707
6,710,2,2,1, 712
25,710,2,2,1, 712
31,711,2,2,1, 713
7,712,1,1,0, 713
26,712,3,3,1, 715
8,716,1,1,1, 717
9,717,2,2,1, 719
16,719,2,2,1, 721
13,719,4,4,1, 723
12,720,5,5,1, 725
18,723,4,4,1, 727
24,729,1,1,0, 730
23,728,3,3,1, 731
1,731,1,1,1, 732
5,732,3,3,1, 735
6,735,2,2,1, 737
25,735,2,2,1, 737
7,737,1,1,0, 738
29,738,4,4,1, 742
8,741,1,1,0, 742
9,742,2,2,1, 744
14,744,3,3,1, 747
13,744,4,4,1, 748
18,748,4,4,1, 752
22,751,4,4,1, 755
2,753,2,2,1, 755
24,754,1,1,1, 755
1,756,1,1,1, 757
30,758,3,3,1, 761
6,760,2,2,1, 762
7,762,1,1,1, 763
26,762,3,3,1, 765
29,763,4,4,1, 767
8,766,1,1,0, 767
9,767,2,2,1, 769
16,769,2,2,1, 771
17,769,3,3,1, 772
15,771,2,2,1, 773
22,776,4,4,1, 780
2,778,2,2,1, 780
24,779,1,1,1, 780
1,781,1,1,1, 782
30,783,3,3,1, 786
6,785,2,2,1, 787
31,786,2,2,1, 788
7,787,1,1,0, 788
29,788,4,4,1, 792
8,791,1,1,0, 792
22,801,4,4,1, 805
24,804,1,1,1, 805
21,802,5,5,1, 807
1,806,1,1,0, 807
30,808,3,3,1, 811
25,810,2,2,1, 812
7,812,1,1,1, 813
29,813,4,4,1, 817
8,816,1,1,1, 817
9,817,2,2,1, 819
16,819,2,2,1, 821
13,819,4,4,1, 823
22,826,4,4,1, 830
24,829,1,1,1, 830
19,826,5,5,1, 831
21,827,5,5,1, 832
1,831,1,1,0, 832
5,832,3,3,1, 835
30,833,3,3,1, 836
25,835,2,2,1, 837
7,837,1,1,1, 838
29,838,4,4,1, 842
8,841,1,1,0, 842
11,839,4,4,1, 843
16,844,2,2,1, 846
14,844,3,3,1, 847
17,844,3,3,1, 847
18,848,4,4,1, 852
24,854,1,1,1, 855
19,851,5,5,1, 856
1,856,1,1,0, 857
4,856,4,4,1, 860
30,858,3,3,1, 861
25,860,2,2,1, 862
31,861,2,2,1, 863
7,862,1,1,1, 863
26,862,3,3,1, 865
29,863,4,4,1, 867
11,864,4,4,1, 868
9,867,2,2,1, 869
17,869,3,3,1, 872
24,879,1,1,1, 880
7,887,1,1,0, 888
24,904,1,1,1, 905
30,908,3,3,1, 911
6,910,2,2,1, 912
31,911,2,2,1, 913
7,912,1,1,1, 913
29,913,4,4,1, 917
24,929,1,1,1, 930
30,933,3,3,1, 936
31,936,2,2,1, 938
7,937,1,1,0, 938
22,951,4,4,1, 955
24,954,1,1,1, 955
6,960,2,2,1, 962
7,962,1,1,0, 963
8,966,1,1,0, 967
15,971,2,2,1, 973
22,976,4,4,1, 980
24,979,1,1,0, 980
21,977,5,5,1, 982
1,981,1,1,1, 982
25,985,2,2,1, 987
31,986,2,2,1, 988
7,987,1,1,0, 988
8,991,1,1,0, 992
16,994,2,2,1, 996
13,994,4,4,1, 998
15,996,2,2,1, 998
22,1001,4,4,1, 1005
24,1004,1,1,0, 1005
23,1003,3,3,1, 1006
21,1002,5,5,1, 1007
1,1006,1,1,0, 1007
5,1007,3,3,1, 1010
31,1011,2,2,1, 1013
7,1012,1,1,0, 1013
29,1013,4,4,1, 1017
8,1016,1,1,1, 1017
9,1017,2,2,1, 1019
15,1021,2,2,1, 1023
22,1026,4,4,1, 1030
24,1029,1,1,0, 1030
23,1028,3,3,1, 1031
21,1027,5,5,1, 1032
1,1031,1,1,1, 1032
6,1035,2,2,1, 1037
31,1036,2,2,1, 1038
7,1037,1,1,0, 1038
29,1038,4,4,1, 1042
8,1041,1,1,1, 1042
16,1044,2,2,1, 1046
13,1044,4,4,1, 1048
24,1054,1,1,0, 1055
23,1053,3,3,1, 1056
1,1056,1,1,0, 1057
6,1060,2,2,1, 1062
25,1060,2,2,1, 1062
7,1062,1,1,1, 1063
29,1063,4,4,1, 1067
8,1066,1,1,0, 1067
17,1069,3,3,1, 1072
13,1069,4,4,1, 1073
22,1076,4,4,1, 1080
24,1079,1,1,0, 1080
1,1081,1,1,0, 1082
6,1085,2,2,1, 1087
7,1087,1,1,1, 1088
29,1088,4,4,1, 1092
8,1091,1,1,0, 1092
14,1094,3,3,1, 1097
13,1094,4,4,1, 1098
22,1101,4,4,1, 1105
2,1103,2,2,1, 1105
24,1104,1,1,1, 1105
23,1103,3,3,1, 1106
21,1102,5,5,1, 1107
1,1106,1,1,1, 1107
5,1107,3,3,1, 1110
25,1110,2,2,1, 1112
7,1112,1,1,0, 1113
26,1112,3,3,1, 1115
29,1113,4,4,1, 1117
8,1116,1,1,0, 1117
14,1119,3,3,1, 1122
17,1119,3,3,1, 1122
13,1119,4,4,1, 1123
18,1123,4,4,1, 1127
24,1129,1,1,1, 1130
1,1131,1,1,1, 1132
5,1132,3,3,1, 1135
30,1133,3,3,1, 1136
25,1135,2,2,1, 1137
7,1137,1,1,0, 1138
26,1137,3,3,1, 1140
8,1141,1,1,1, 1142
9,1142,2,2,1, 1144
16,1144,2,2,1, 1146
18,1148,4,4,1, 1152
20,1148,6,6,1, 1154
22,1151,4,4,1, 1155
2,1153,2,2,1, 1155
24,1154,1,1,0, 1155
21,1152,5,5,1, 1157
1,1156,1,1,1, 1157
27,1157,4,4,1, 1161
6,1160,2,2,1, 1162
25,1160,2,2,1, 1162
7,1162,1,1,1, 1163
28,1159,5,5,1, 1164
8,1166,1,1,1, 1167
11,1164,4,4,1, 1168
16,1169,2,2,1, 1171
12,1170,5,5,1, 1175
18,1173,4,4,1, 1177
24,1179,1,1,1, 1180
19,1176,5,5,1, 1181
21,1177,5,5,1, 1182
1,1181,1,1,0, 1182
5,1182,3,3,1, 1185
27,1182,4,4,1, 1186
6,1185,2,2,1, 1187
31,1186,2,2,1, 1188
7,1187,1,1,1, 1188
28,1184,5,5,1, 1189
8,1191,1,1,1, 1192
11,1189,4,4,1, 1193
9,1192,2,2,1, 1194
22,1201,4,4,1, 1205
24,1204,1,1,1, 1205
1,1206,1,1,0, 1207
4,1206,4,4,1, 1210
3,1207,3,3,1, 1210
27,1207,4,4,1, 1211
30,1208,3,3,1, 1211
6,1210,2,2,1, 1212
25,1210,2,2,1, 1212
7,1212,1,1,1, 1213
26,1212,3,3,1, 1215
29,1213,4,4,1, 1217
8,1216,1,1,0, 1217
11,1214,4,4,1, 1218
16,1219,2,2,1, 1221
13,1219,4,4,1, 1223
12,1220,5,5,1, 1225
18,1223,4,4,1, 1227
20,1223,6,6,1, 1229
24,1229,1,1,1, 1230
7,1237,1,1,1, 1238
29,1238,4,4,1, 1242
24,1254,1,1,1, 1255
30,1258,3,3,1, 1261
31,1261,2,2,1, 1263
7,1262,1,1,0, 1263
24,1279,1,1,0, 1280
6,1285,2,2,1, 1287
7,1287,1,1,1, 1288
24,1304,1,1,0, 1305
6,1310,2,2,1, 1312
31,1311,2,2,1, 1313
7,1312,1,1,1, 1313
24,1329,1,1,1, 1330
5,1332,3,3,1, 1335
30,1333,3,3,1, 1336
6,1335,2,2,1, 1337
7,1337,1,1,1, 1338
8,1341,1,1,0, 1342
9,1342,2,2,1, 1344
16,1344,2,2,1, 1346
14,1344,3,3,1, 1347
17,1344,3,3,1, 1347
13,1344,4,4,1, 1348
15,1346,2,2,1, 1348
24,1354,1,1,0, 1355
21,1352,5,5,1, 1357
1,1356,1,1,1, 1357
5,1357,3,3,1, 1360
30,1358,3,3,1, 1361
31,1361,2,2,1, 1363
7,1362,1,1,1, 1363
29,1363,4,4,1, 1367
8,1366,1,1,1, 1367
16,1369,2,2,1, 1371
22,1376,4,4,1, 1380
24,1379,1,1,1, 1380
23,1378,3,3,1, 1381
1,1381,1,1,1, 1382
6,1385,2,2,1, 1387
25,1385,2,2,1, 1387
31,1386,2,2,1, 1388
7,1387,1,1,0, 1388
26,1387,3,3,1, 1390
8,1391,1,1,1, 1392
16,1394,2,2,1, 1396
13,1394,4,4,1, 1398
18,1398,4,4,1, 1402
2,1403,2,2,1, 1405
24,1404,1,1,0, 1405
21,1402,5,5,1, 1407
1,1406,1,1,0, 1407
5,1407,3,3,1, 1410
31,1411,2,2,1, 1413
7,1412,1,1,1, 1413
8,1416,1,1,0, 1417
9,1417,2,2,1, 1419
14,1419,3,3,1, 1422
17,1419,3,3,1, 1422
24,1429,1,1,1, 1430
23,1428,3,3,1, 1431
1,1431,1,1,1, 1432
6,1435,2,2,1, 1437
7,1437,1,1,0, 1438
8,1441,1,1,1, 1442
2,1453,2,2,1, 1455
24,1454,1,1,1, 1455
23,1453,3,3,1, 1456
1,1456,1,1,1, 1457
30,1458,3,3,1, 1461
31,1461,2,2,1, 1463
7,1462,1,1,1, 1463
26,1462,3,3,1, 1465
8,1466,1,1,1, 1467
11,1464,4,4,1, 1468
9,1467,2,2,1, 1469
15,1471,2,2,1, 1473
18,1473,4,4,1, 1477
20,1473,6,6,1, 1479
2,1478,2,2,1, 1480
24,1479,1,1,1, 1480
19,1476,5,5,1, 1481
23,1478,3,3,1, 1481
21,1477,5,5,1, 1482
1,1481,1,1,1, 1482
3,1482,3,3,1, 1485
30,1483,3,3,1, 1486
25,1485,2,2,1, 1487
7,1487,1,1,1, 1488
28,1484,5,5,1, 1489
29,1488,4,4,1, 1492
8,1491,1,1,0, 1492
17,1494,3,3,1, 1497
18,1498,4,4,1, 1502
20,1498,6,6,1, 1504
22,1501,4,4,1, 1505
24,1504,1,1,1, 1505
19,1501,5,5,1, 1506
21,1502,5,5,1, 1507
1,1506,1,1,1, 1507
4,1506,4,4,1, 1510
5,1507,3,3,1, 1510
27,1507,4,4,1, 1511
25,1510,2,2,1, 1512
31,1511,2,2,1, 1513
7,1512,1,1,0, 1513
26,1512,3,3,1, 1515
29,1513,4,4,1, 1517
8,1516,1,1,1, 1517
9,1517,2,2,1, 1519
16,1519,2,2,1, 1521
13,1519,4,4,1, 1523
24,1529,1,1,0, 1530
23,1528,3,3,1, 1531
21,1527,5,5,1, 1532
1,1531,1,1,0, 1532
4,1531,4,4,1, 1535
3,1532,3,3,1, 1535
27,1532,4,4,1, 1536
31,1536,2,2,1, 1538
7,1537,1,1,0, 1538
8,1541,1,1,1, 1542
16,1544,2,2,1, 1546
14,1544,3,3,1, 1547
13,1544,4,4,1, 1548
15,1546,2,2,1, 1548
24,1554,1,1,1, 1555
23,1553,3,3,1, 1556
5,1557,3,3,1, 1560
30,1558,3,3,1, 1561
6,1560,2,2,1, 1562
31,1561,2,2,1, 1563
7,1562,1,1,1, 1563
8,1566,1,1,1, 1567
13,1569,4,4,1, 1573
15,1571,2,2,1, 1573
22,1576,4,4,1, 1580
24,1579,1,1,0, 1580
21,1577,5,5,1, 1582
5,1582,3,3,1, 1585
6,1585,2,2,1, 1587
7,1587,1,1,1, 1588
29,1588,4,4,1, 1592
8,1591,1,1,1, 1592
14,1594,3,3,1, 1597
13,1594,4,4,1, 1598
22,1601,4,4,1, 1605
24,1604,1,1,0, 1605
23,1603,3,3,1, 1606
21,1602,5,5,1, 1607
6,1610,2,2,1, 1612
7,1612,1,1,0, 1613
8,1616,1,1,1, 1617
24,1629,1,1,0, 1630
30,1633,3,3,1, 1636
7,1637,1,1,0, 1638
29,1638,4,4,1, 1642
9,1642,2,2,1, 1644
24,1654,1,1,1, 1655
1,1656,1,1,0, 1657
5,1657,3,3,1, 1660
6,1660,2,2,1, 1662
7,1662,1,1,1, 1663
29,1663,4,4,1, 1667
24,1679,1,1,0, 1680
1,1681,1,1,0, 1682
25,1685,2,2,1, 1687
31,1686,2,2,1, 1688
7,1687,1,1,1, 1688
29,1688,4,4,1, 1692
9,1692,2,2,1, 1694
17,1694,3,3,1, 1697
24,1704,1,1,0, 1705
1,1706,1,1,1, 1707
30,1708,3,3,1, 1711
7,1712,1,1,1, 1713
9,1717,2,2,1, 1719
24,1729,1,1,0, 1730
21,1727,5,5,1, 1732
1,1731,1,1,0, 1732
30,1733,3,3,1, 1736
31,1736,2,2,1, 1738
7,1737,1,1,1, 1738
29,1738,4,4,1, 1742
8,1741,1,1,1, 1742
15,1746,2,2,1, 1748
22,1751,4,4,1, 1755
24,1754,1,1,1, 1755
1,1756,1,1,1, 1757
6,1760,2,2,1, 1762
25,1760,2,2,1, 1762
31,1761,2,2,1, 1763
7,1762,1,1,0, 1763
26,1762,3,3,1, 1765
29,1763,4,4,1, 1767
8,1766,1,1,0, 1767
22,1776,4,4,1, 1780
2,1778,2,2,1, 1780
24,1779,1,1,1, 1780
23,1778,3,3,1, 1781
1,1781,1,1,1, 1782
30,1783,3,3,1, 1786
6,1785,2,2,1, 1787
31,1786,2,2,1, 1788
7,1787,1,1,1, 1788
26,1787,3,3,1, 1790
8,1791,1,1,0, 1792
16,1794,2,2,1, 1796
14,1794,3,3,1, 1797
13,1794,4,4,1, 1798
15,1796,2,2,1, 1798
18,1798,4,4,1, 1802
24,1804,1,1,0, 1805
19,1801,5,5,1, 1806
23,1803,3,3,1, 1806
1,1806,1,1,0, 1807
4,1806,4,4,1, 1810
3,1807,3,3,1, 1810
5,1807,3,3,1, 1810
27,1807,4,4,1, 1811
7,1812,1,1,0, 1813
29,1813,4,4,1, 1817
8,1816,1,1,1, 1817
11,1814,4,4,1, 1818
9,1817,2,2,1, 1819
16,1819,2,2,1, 1821
14,1819,3,3,1, 1822
17,1819,3,3,1, 1822
15,1821,2,2,1, 1823
12,1820,5,5,1, 1825
18,1823,4,4,1, 1827
20,1823,6,6,1, 1829
22,1826,4,4,1, 1830
2,1828,2,2,1, 1830
24,1829,1,1,0, 1830
19,1826,5,5,1, 1831
1,1831,1,1,0, 1832
5,1832,3,3,1, 1835
6,1835,2,2,1, 1837
31,1836,2,2,1, 1838
7,1837,1,1,0, 1838
28,1834,5,5,1, 1839
29,1838,4,4,1, 1842
8,1841,1,1,0, 1842
9,1842,2,2,1, 1844
16,1844,2,2,1, 1846
14,1844,3,3,1, 1847
15,1846,2,2,1, 1848
20,1848,6,6,1, 1854
24,1854,1,1,0, 1855
19,1851,5,5,1, 1856
23,1853,3,3,1, 1856
1,1856,1,1,0, 1857
4,1856,4,4,1, 1860
5,1857,3,3,1, 1860
27,1857,4,4,1, 1861
30,1858,3,3,1, 1861
25,1860,2,2,1, 1862
7,1862,1,1,0, 1863
28,1859,5,5,1, 1864
29,1863,4,4,1, 1867
8,1866,1,1,0, 1867
9,1867,2,2,1, 1869
16,1869,2,2,1, 1871
13,1869,4,4,1, 1873
18,1873,4,4,1, 1877
24,1879,1,1,0, 1880
23,1878,3,3,1, 1881
21,1877,5,5,1, 1882
1,1881,1,1,0, 1882
4,1881,4,4,1, 1885
30,1883,3,3,1, 1886
6,1885,2,2,1, 1887
7,1887,1,1,1, 1888
26,1887,3,3,1, 1890
8,1891,1,1,0, 1892
11,1889,4,4,1, 1893
16,1894,2,2,1, 1896
14,1894,3,3,1, 1897
13,1894,4,4,1, 1898
15,1896,2,2,1, 1898
24,1904,1,1,0, 1905
21,1902,5,5,1, 1907
5,1907,3,3,1, 1910
31,1911,2,2,1, 1913
7,1912,1,1,1, 1913
29,1913,4,4,1, 1917
8,1916,1,1,0, 1917
16,1919,2,2,1, 1921
14,1919,3,3,1, 1922
24,1929,1,1,1, 1930
5,1932,3,3,1, 1935
7,1937,1,1,1, 1938
29,1938,4,4,1, 1942
24,1954,1,1,1, 1955
6,1960,2,2,1, 1962
31,1961,2,2,1, 1963
7,1962,1,1,1, 1963
24,1979,1,1,0, 1980
6,1985,2,2,1, 1987
31,1986,2,2,1, 1988
7,1987,1,1,0, 1988
17,1994,3,3,1, 1997
24,2004,1,1,0, 2005
1,2006,1,1,0, 2007
30,2008,3,3,1, 2011
6,2010,2,2,1, 2012
7,2012,1,1,1, 2013
17,2019,3,3,1, 2022
18,2023,4,4,1, 2027
2,2028,2,2,1, 2030
24,2029,1,1,0, 2030
21,2027,5,5,1, 2032
1,2031,1,1,1, 2032
5,2032,3,3,1, 2035
6,2035,2,2,1, 2037
25,2035,2,2,1, 2037
7,2037,1,1,1, 2038
26,2037,3,3,1, 2040
29,2038,4,4,1, 2042
8,2041,1,1,0, 2042
22,2051,4,4,1, 2055
2,2053,2,2,1, 2055
24,2054,1,1,0, 2055
1,2056,1,1,1, 2057
6,2060,2,2,1, 2062
31,2061,2,2,1, 2063
7,2062,1,1,0, 2063
29,2063,4,4,1, 2067
8,2066,1,1,1, 2067
16,2069,2,2,1, 2071
14,2069,3,3,1, 2072
18,2073,4,4,1, 2077
22,2076,4,4,1, 2080
2,2078,2,2,1, 2080
24,2079,1,1,1, 2080
21,2077,5,5,1, 2082
1,2081,1,1,1, 2082
6,2085,2,2,1, 2087
25,2085,2,2,1, 2087
7,2087,1,1,1, 2088
29,2088,4,4,1, 2092
8,2091,1,1,1, 2092
9,2092,2,2,1, 2094
16,2094,2,2,1, 2096
14,2094,3,3,1, 2097
2,2103,2,2,1, 2105
24,2104,1,1,0, 2105
23,2103,3,3,1, 2106
1,2106,1,1,0, 2107
6,2110,2,2,1, 2112
31,2111,2,2,1, 2113
7,2112,1,1,1, 2113
8,2116,1,1,1, 2117
11,2114,4,4,1, 2118
9,2117,2,2,1, 2119
16,2119,2,2,1, 2121
14,2119,3,3,1, 2122
17,2119,3,3,1, 2122
13,2119,4,4,1, 2123
18,2123,4,4,1, 2127
22,2126,4,4,1, 2130
2,2128,2,2,1, 2130
24,2129,1,1,1, 2130
21,2127,5,5,1, 2132
1,2131,1,1,0, 2132
4,2131,4,4,1, 2135
3,2132,3,3,1, 2135
5,2132,3,3,1, 2135
30,2133,3,3,1, 2136
7,2137,1,1,1, 2138
29,2138,4,4,1, 2142
8,2141,1,1,1, 2142
11,2139,4,4,1, 2143
16,2144,2,2,1, 2146
14,2144,3,3,1, 2147
17,2144,3,3,1, 2147
13,2144,4,4,1, 2148
15,2146,2,2,1, 2148
20,2148,6,6,1, 2154
24,2154,1,1,0, 2155
1,2156,1,1,0, 2157
5,2157,3,3,1, 2160
27,2157,4,4,1, 2161
6,2160,2,2,1, 2162
25,2160,2,2,1, 2162
7,2162,1,1,0, 2163
26,2162,3,3,1, 2165
29,2163,4,4,1, 2167
8,2166,1,1,0, 2167
11,2164,4,4,1, 2168
9,2167,2,2,1, 2169
15,2171,2,2,1, 2173
18,2173,4,4,1, 2177
20,2173,6,6,1, 2179
24,2179,1,1,1, 2180
5,2182,3,3,1, 2185
6,2185,2,2,1, 2187
7,2187,1,1,0, 2188
29,2188,4,4,1, 2192
8,2191,1,1,0, 2192
16,2194,2,2,1, 2196
22,2201,4,4,1, 2205
24,2204,1,1,0, 2205
23,2203,3,3,1, 2206
21,2202,5,5,1, 2207
6,2210,2,2,1, 2212
31,2211,2,2,1, 2213
7,2212,1,1,1, 2213
29,2213,4,4,1, 2217
8,2216,1,1,1, 2217
13,2219,4,4,1, 2223
15,2221,2,2,1, 2223
24,2229,1,1,0, 2230
23,2228,3,3,1, 2231
5,2232,3,3,1, 2235
30,2233,3,3,1, 2236
6,2235,2,2,1, 2237
7,2237,1,1,1, 2238
8,2241,1,1,0, 2242
16,2244,2,2,1, 2246
14,2244,3,3,1, 2247
22,2251,4,4,1, 2255
24,2254,1,1,1, 2255
5,2257,3,3,1, 2260
30,2258,3,3,1, 2261
6,2260,2,2,1, 2262
31,2261,2,2,1, 2263
7,2262,1,1,1, 2263
29,2263,4,4,1, 2267
8,2266,1,1,1, 2267
22,2276,4,4,1, 2280
24,2279,1,1,0, 2280
23,2278,3,3,1, 2281
1,2281,1,1,1, 2282
30,2283,3,3,1, 2286
31,2286,2,2,1, 2288
7,2287,1,1,1, 2288
29,2288,4,4,1, 2292
8,2291,1,1,0, 2292
9,2292,2,2,1, 2294
14,2294,3,3,1, 2297
17,2294,3,3,1, 2297
13,2294,4,4,1, 2298
15,2296,2,2,1, 2298
22,2301,4,4,1, 2305
24,2304,1,1,1, 2305
21,2302,5,5,1, 2307
1,2306,1,1,1, 2307
5,2307,3,3,1, 2310
30,2308,3,3,1, 2311
31,2311,2,2,1, 2313
7,2312,1,1,0, 2313
29,2313,4,4,1, 2317
9,2317,2,2,1, 2319
24,2329,1,1,1, 2330
1,2331,1,1,1, 2332
9,2342,2,2,1, 2344
17,2344,3,3,1, 2347
24,2354,1,1,1, 2355
1,2356,1,1,0, 2357
17,2369,3,3,1, 2372
12,2370,5,5,1, 2375
24,2379,1,1,0, 2380
19,2376,5,5,1, 2381
1,2381,1,1,0, 2382
27,2382,4,4,1, 2386
28,2384,5,5,1, 2389
26,2387,3,3,1, 2390
9,2392,2,2,1, 2394
17,2394,3,3,1, 2397
12,2395,5,5,1, 2400
18,2398,4,4,1, 2402
2,2403,2,2,1, 2405
24,2404,1,1,1, 2405
19,2401,5,5,1, 2406
1,2406,1,1,0, 2407
4,2406,4,4,1, 2410
3,2407,3,3,1, 2410
27,2407,4,4,1, 2411
25,2410,2,2,1, 2412
8,2416,1,1,1, 2417
9,2417,2,2,1, 2419
16,2419,2,2,1, 2421
14,2419,3,3,1, 2422
17,2419,3,3,1, 2422
13,2419,4,4,1, 2423
15,2421,2,2,1, 2423
24,2429,1,1,1, 2430
23,2428,3,3,1, 2431
21,2427,5,5,1, 2432
1,2431,1,1,1, 2432
30,2433,3,3,1, 2436
6,2435,2,2,1, 2437
25,2435,2,2,1, 2437
31,2436,2,2,1, 2438
7,2437,1,1,0, 2438
8,2441,1,1,0, 2442
9,2442,2,2,1, 2444
16,2444,2,2,1, 2446
17,2444,3,3,1, 2447
24,2454,1,1,1, 2455
1,2456,1,1,0, 2457
7,2462,1,1,1, 2463
26,2462,3,3,1, 2465
8,2466,1,1,1, 2467
14,2469,3,3,1, 2472
13,2469,4,4,1, 2473
15,2471,2,2,1, 2473
24,2479,1,1,1, 2480
23,2478,3,3,1, 2481
21,2477,5,5,1, 2482
30,2483,3,3,1, 2486
6,2485,2,2,1, 2487
31,2486,2,2,1, 2488
7,2487,1,1,0, 2488
8,2491,1,1,1, 2492
15,2496,2,2,1, 2498
22,2501,4,4,1, 2505
24,2504,1,1,1, 2505
23,2503,3,3,1, 2506
21,2502,5,5,1, 2507
31,2511,2,2,1, 2513
7,2512,1,1,0, 2513
8,2516,1,1,1, 2517
16,2519,2,2,1, 2521
14,2519,3,3,1, 2522
13,2519,4,4,1, 2523
15,2521,2,2,1, 2523
24,2529,1,1,0, 2530
21,2527,5,5,1, 2532
30,2533,3,3,1, 2536
6,2535,2,2,1, 2537
7,2537,1,1,0, 2538
29,2538,4,4,1, 2542
8,2541,1,1,0, 2542
14,2544,3,3,1, 2547
13,2544,4,4,1, 2548
22,2551,4,4,1, 2555
24,2554,1,1,0, 2555
30,2558,3,3,1, 2561
6,2560,2,2,1, 2562
7,2562,1,1,1, 2563
8,2566,1,1,0, 2567
15,2571,2,2,1, 2573
18,2573,4,4,1, 2577
20,2573,6,6,1, 2579
22,2576,4,4,1, 2580
2,2578,2,2,1, 2580
24,2579,1,1,0, 2580
23,2578,3,3,1, 2581
1,2581,1,1,1, 2582
4,2581,4,4,1, 2585
5,2582,3,3,1, 2585
25,2585,2,2,1, 2587
31,2586,2,2,1, 2588
7,2587,1,1,0, 2588
28,2584,5,5,1, 2589
8,2591,1,1,0, 2592
13,2594,4,4,1, 2598
15,2596,2,2,1, 2598
12,2595,5,5,1, 2600
18,2598,4,4,1, 2602
20,2598,6,6,1, 2604
2,2603,2,2,1, 2605
24,2604,1,1,1, 2605
21,2602,5,5,1, 2607
1,2606,1,1,0, 2607
4,2606,4,4,1, 2610
3,2607,3,3,1, 2610
27,2607,4,4,1, 2611
6,2610,2,2,1, 2612
31,2611,2,2,1, 2613
7,2612,1,1,1, 2613
28,2609,5,5,1, 2614
26,2612,3,3,1, 2615
29,2613,4,4,1, 2617
8,2616,1,1,0, 2617
16,2619,2,2,1, 2621
14,2619,3,3,1, 2622
17,2619,3,3,1, 2622
20,2623,6,6,1, 2629
2,2628,2,2,1, 2630
24,2629,1,1,0, 2630
19,2626,5,5,1, 2631
1,2631,1,1,1, 2632
5,2632,3,3,1, 2635
30,2633,3,3,1, 2636
6,2635,2,2,1, 2637
31,2636,2,2,1, 2638
7,2637,1,1,0, 2638
24,2654,1,1,1, 2655
6,2660,2,2,1, 2662
7,2662,1,1,0, 2663
29,2663,4,4,1, 2667
24,2679,1,1,1, 2680
30,2683,3,3,1, 2686
6,2685,2,2,1, 2687
31,2686,2,2,1, 2688
7,2687,1,1,1, 2688
29,2688,4,4,1, 2692
24,2704,1,1,0, 2705
31,2711,2,2,1, 2713
7,2712,1,1,0, 2713
29,2713,4,4,1, 2717
22,2726,4,4,1, 2730
24,2729,1,1,1, 2730
23,2728,3,3,1, 2731
5,2732,3,3,1, 2735
30,2733,3,3,1, 2736
6,2735,2,2,1, 2737
31,2736,2,2,1, 2738
7,2737,1,1,1, 2738
8,2741,1,1,0, 2742
16,2744,2,2,1, 2746
14,2744,3,3,1, 2747
17,2744,3,3,1, 2747
15,2746,2,2,1, 2748
22,2751,4,4,1, 2755
24,2754,1,1,0, 2755
23,2753,3,3,1, 2756
1,2756,1,1,1, 2757
30,2758,3,3,1, 2761
6,2760,2,2,1, 2762
31,2761,2,2,1, 2763
7,2762,1,1,1, 2763
29,2763,4,4,1, 2767
8,2766,1,1,1, 2767
17,2769,3,3,1, 2772
13,2769,4,4,1, 2773
15,2771,2,2,1, 2773
12,2770,5,5,1, 2775
18,2773,4,4,1, 2777
24,2779,1,1,1, 2780
19,2776,5,5,1, 2781
21,2777,5,5,1, 2782
1,2781,1,1,0, 2782
3,2782,3,3,1, 2785
6,2785,2,2,1, 2787
25,2785,2,2,1, 2787
7,2787,1,1,0, 2788
26,2787,3,3,1, 2790
8,2791,1,1,0, 2792
11,2789,4,4,1, 2793
14,2794,3,3,1, 2797
13,2794,4,4,1, 2798
12,2795,5,5,1, 2800
18,2798,4,4,1, 2802
2,2803,2,2,1, 2805
24,2804,1,1,0, 2805
1,2806,1,1,0, 2807
4,2806,4,4,1, 2810
30,2808,3,3,1, 2811
6,2810,2,2,1, 2812
25,2810,2,2,1, 2812
7,2812,1,1,0, 2813
28,2809,5,5,1, 2814
29,2813,4,4,1, 2817
8,2816,1,1,1, 2817
11,2814,4,4,1, 2818
9,2817,2,2,1, 2819
17,2819,3,3,1, 2822
12,2820,5,5,1, 2825
24,2829,1,1,1, 2830
21,2827,5,5,1, 2832
5,2832,3,3,1, 2835
30,2833,3,3,1, 2836
7,2837,1,1,0, 2838
29,2838,4,4,1, 2842
8,2841,1,1,0, 2842
14,2844,3,3,1, 2847
13,2844,4,4,1, 2848
15,2846,2,2,1, 2848
24,2854,1,1,0, 2855
23,2853,3,3,1, 2856
21,2852,5,5,1, 2857
6,2860,2,2,1, 2862
31,2861,2,2,1, 2863
7,2862,1,1,0, 2863
29,2863,4,4,1, 2867
8,2866,1,1,1, 2867
15,2871,2,2,1, 2873
24,2879,1,1,0, 2880
5,2882,3,3,1, 2885
30,2883,3,3,1, 2886
6,2885,2,2,1, 2887
7,2887,1,1,0, 2888
8,2891,1,1,0, 2892
13,2894,4,4,1, 2898
24,2904,1,1,0, 2905
21,2902,5,5,1, 2907
30,2908,3,3,1, 2911
31,2911,2,2,1, 2913
7,2912,1,1,0, 2913
8,2916,1,1,0, 2917
14,2919,3,3,1, 2922
20,2923,6,6,1, 2929
24,2929,1,1,0, 2930
21,2927,5,5,1, 2932
1,2931,1,1,1, 2932
4,2931,4,4,1, 2935
25,2935,2,2,1, 2937
7,2937,1,1,0, 2938
29,2938,4,4,1, 2942
8,2941,1,1,1, 2942
9,2942,2,2,1, 2944
14,2944,3,3,1, 2947
17,2944,3,3,1, 2947
15,2946,2,2,1, 2948
22,2951,4,4,1, 2955
24,2954,1,1,1, 2955
21,2952,5,5,1, 2957
1,2956,1,1,1, 2957
30,2958,3,3,1, 2961
31,2961,2,2,1, 2963
7,2962,1,1,0, 2963
8,2966,1,1,0, 2967
9,2967,2,2,1, 2969
16,2969,2,2,1, 2971
14,2969,3,3,1, 2972
13,2969,4,4,1, 2973
15,2971,2,2,1, 2973
22,2976,4,4,1, 2980
24,2979,1,1,1, 2980
1,2981,1,1,0, 2982
5,2982,3,3,1, 2985
6,2985,2,2,1, 2987
7,2987,1,1,0, 2988
29,2988,4,4,1, 2992
8,2991,1,1,1, 2992
16,2994,2,2,1, 2996
17,2994,3,3,1, 2997
15,2996,2,2,1, 2998
22,3001,4,4,1, 3005
24,3004,1,1,0, 3005
23,3003,3,3,1, 3006
1,3006,1,1,1, 3007
5,3007,3,3,1, 3010
6,3010,2,2,1, 3012
31,3011,2,2,1, 3013
7,3012,1,1,1, 3013
9,3017,2,2,1, 3019
24,3029,1,1,0, 3030
1,3031,1,1,1, 3032
30,3033,3,3,1, 3036
6,3035,2,2,1, 3037
25,3035,2,2,1, 3037
7,3037,1,1,1, 3038
17,3044,3,3,1, 3047
18,3048,4,4,1, 3052
24,3054,1,1,1, 3055
1,3056,1,1,0, 3057
5,3057,3,3,1, 3060
30,3058,3,3,1, 3061
7,3062,1,1,0, 3063
26,3062,3,3,1, 3065
29,3063,4,4,1, 3067
17,3069,3,3,1, 3072
18,3073,4,4,1, 3077
2,3078,2,2,1, 3080
24,3079,1,1,1, 3080
1,3081,1,1,1, 3082
30,3083,3,3,1, 3086
6,3085,2,2,1, 3087
25,3085,2,2,1, 3087
7,3087,1,1,0, 3088
17,3094,3,3,1, 3097
2,3103,2,2,1, 3105
24,3104,1,1,0, 3105
1,3106,1,1,1, 3107
5,3107,3,3,1, 3110
6,3110,2,2,1, 3112
25,3110,2,2,1, 3112
31,3111,2,2,1, 3113
7,3112,1,1,1, 3113
26,3112,3,3,1, 3115
8,3116,1,1,0, 3117
9,3117,2,2,1, 3119
16,3119,2,2,1, 3121
14,3119,3,3,1, 3122
13,3119,4,4,1, 3123
12,3120,5,5,1, 3125
18,3123,4,4,1, 3127
20,3123,6,6,1, 3129
22,3126,4,4,1, 3130
24,3129,1,1,0, 3130
23,3128,3,3,1, 3131
21,3127,5,5,1, 3132
1,3131,1,1,0, 3132
3,3132,3,3,1, 3135
27,3132,4,4,1, 3136
28,3134,5,5,1, 3139
26,3137,3,3,1, 3140
8,3141,1,1,1, 3142
11,3139,4,4,1, 3143
14,3144,3,3,1, 3147
17,3144,3,3,1, 3147
15,3146,2,2,1, 3148
18,3148,4,4,1, 3152
20,3148,6,6,1, 3154
24,3154,1,1,0, 3155
1,3156,1,1,1, 3157
25,3160,2,2,1, 3162
8,3166,1,1,0, 3167
14,3169,3,3,1, 3172
13,3169,4,4,1, 3173
24,3179,1,1,0, 3180
8,3191,1,1,1, 3192
14,3194,3,3,1, 3197
13,3194,4,4,1, 3198
15,3196,2,2,1, 3198
22,3201,4,4,1, 3205
24,3204,1,1,1, 3205
8,3216,1,1,1, 3217
14,3219,3,3,1, 3222
15,3221,2,2,1, 3223
22,3226,4,4,1, 3230
24,3229,1,1,0, 3230
5,3232,3,3,1, 3235
6,3235,2,2,1, 3237
31,3236,2,2,1, 3238
7,3237,1,1,1, 3238
29,3238,4,4,1, 3242
8,3241,1,1,1, 3242
24,3254,1,1,0, 3255
23,3253,3,3,1, 3256
5,3257,3,3,1, 3260
6,3260,2,2,1, 3262
31,3261,2,2,1, 3263
7,3262,1,1,0, 3263
29,3263,4,4,1, 3267
8,3266,1,1,1, 3267
9,3267,2,2,1, 3269
16,3269,2,2,1, 3271
15,3271,2,2,1, 3273
22,3276,4,4,1, 3280
24,3279,1,1,0, 3280
21,3277,5,5,1, 3282
1,3281,1,1,0, 3282
5,3282,3,3,1, 3285
25,3285,2,2,1, 3287
7,3287,1,1,0, 3288
29,3288,4,4,1, 3292
8,3291,1,1,1, 3292
9,3292,2,2,1, 3294
16,3294,2,2,1, 3296
13,3294,4,4,1, 3298
15,3296,2,2,1, 3298
22,3301,4,4,1, 3305
24,3304,1,1,0, 3305
1,3306,1,1,0, 3307
6,3310,2,2,1, 3312
25,3310,2,2,1, 3312
7,3312,1,1,1, 3313
8,3316,1,1,0, 3317
16,3319,2,2,1, 3321
17,3319,3,3,1, 3322
15,3321,2,2,1, 3323
22,3326,4,4,1, 3330
24,3329,1,1,0, 3330
21,3327,5,5,1, 3332
1,3331,1,1,1, 3332
30,3333,3,3,1, 3336
31,3336,2,2,1, 3338
7,3337,1,1,1, 3338
26,3337,3,3,1, 3340
29,3338,4,4,1, 3342
8,3341,1,1,1, 3342
14,3344,3,3,1, 3347
17,3344,3,3,1, 3347
18,3348,4,4,1, 3352
24,3354,1,1,1, 3355
21,3352,5,5,1, 3357
1,3356,1,1,0, 3357
5,3357,3,3,1, 3360
30,3358,3,3,1, 3361
7,3362,1,1,1, 3363
26,3362,3,3,1, 3365
8,3366,1,1,0, 3367
16,3369,2,2,1, 3371
14,3369,3,3,1, 3372
18,3373,4,4,1, 3377
20,3373,6,6,1, 3379
24,3379,1,1,0, 3380
1,3381,1,1,0, 3382
4,3381,4,4,1, 3385
3,3382,3,3,1, 3385
5,3382,3,3,1, 3385
30,3383,3,3,1, 3386
6,3385,2,2,1, 3387
25,3385,2,2,1, 3387
7,3387,1,1,1, 3388
26,3387,3,3,1, 3390
29,3388,4,4,1, 3392
9,3392,2,2,1, 3394
12,3395,5,5,1, 3400
18,3398,4,4,1, 3402
2,3403,2,2,1, 3405
24,3404,1,1,0, 3405
19,3401,5,5,1, 3406
1,3406,1,1,0, 3407
3,3407,3,3,1, 3410
5,3407,3,3,1, 3410
7,3412,1,1,0, 3413
28,3409,5,5,1, 3414
26,3412,3,3,1, 3415
29,3413,4,4,1, 3417
9,3417,2,2,1, 3419
17,3419,3,3,1, 3422
18,3423,4,4,1, 3427
24,3429,1,1,1, 3430
19,3426,5,5,1, 3431
1,3431,1,1,1, 3432
3,3432,3,3,1, 3435
30,3433,3,3,1, 3436
31,3436,2,2,1, 3438
7,3437,1,1,0, 3438
24,3454,1,1,1, 3455
5,3457,3,3,1, 3460
6,3460,2,2,1, 3462
31,3461,2,2,1, 3463
7,3462,1,1,0, 3463
22,3476,4,4,1, 3480
24,3479,1,1,1, 3480
23,3478,3,3,1, 3481
21,3477,5,5,1, 3482
31,3486,2,2,1, 3488
7,3487,1,1,0, 3488
8,3491,1,1,0, 3492
16,3494,2,2,1, 3496
14,3494,3,3,1, 3497
13,3494,4,4,1, 3498
15,3496,2,2,1, 3498
22,3501,4,4,1, 3505
24,3504,1,1,0, 3505
21,3502,5,5,1, 3507
30,3508,3,3,1, 3511
6,3510,2,2,1, 3512
31,3511,2,2,1, 3513
7,3512,1,1,0, 3513
8,3516,1,1,0, 3517
16,3519,2,2,1, 3521
22,3526,4,4,1, 3530
24,3529,1,1,0, 3530
30,3533,3,3,1, 3536
7,3537,1,1,1, 3538
29,3538,4,4,1, 3542
8,3541,1,1,0, 3542
14,3544,3,3,1, 3547
24,3554,1,1,0, 3555
21,3552,5,5,1, 3557
1,3556,1,1,1, 3557
30,3558,3,3,1, 3561
6,3560,2,2,1, 3562
25,3560,2,2,1, 3562
31,3561,2,2,1, 3563
7,3562,1,1,1, 3563
8,3566,1,1,1, 3567
11,3564,4,4,1, 3568
14,3569,3,3,1, 3572
13,3569,4,4,1, 3573
15,3571,2,2,1, 3573
12,3570,5,5,1, 3575
2,3578,2,2,1, 3580
24,3579,1,1,0, 3580
1,3581,1,1,0, 3582
5,3582,3,3,1, 3585
31,3586,2,2,1, 3588
7,3587,1,1,0, 3588
28,3584,5,5,1, 3589
26,3587,3,3,1, 3590
8,3591,1,1,1, 3592
11,3589,4,4,1, 3593
14,3594,3,3,1, 3597
17,3594,3,3,1, 3597
15,3596,2,2,1, 3598
18,3598,4,4,1, 3602
2,3603,2,2,1, 3605
24,3604,1,1,0, 3605
23,3603,3,3,1, 3606
21,3602,5,5,1, 3607
1,3606,1,1,1, 3607
30,3608,3,3,1, 3611
6,3610,2,2,1, 3612
25,3610,2,2,1, 3612
7,3612,1,1,0, 3613
8,3616,1,1,1, 3617
9,3617,2,2,1, 3619
16,3619,2,2,1, 3621
13,3619,4,4,1, 3623
22,3626,4,4,1, 3630
2,3628,2,2,1, 3630
24,3629,1,1,1, 3630
21,3627,5,5,1, 3632
1,3631,1,1,1, 3632
5,3632,3,3,1, 3635
6,3635,2,2,1, 3637
25,3635,2,2,1, 3637
7,3637,1,1,0, 3638
8,3641,1,1,0, 3642
9,3642,2,2,1, 3644
16,3644,2,2,1, 3646
14,3644,3,3,1, 3647
17,3644,3,3,1, 3647
13,3644,4,4,1, 3648
24,3654,1,1,1, 3655
1,3656,1,1,1, 3657
5,3657,3,3,1, 3660
30,3658,3,3,1, 3661
31,3661,2,2,1, 3663
7,3662,1,1,1, 3663
29,3663,4,4,1, 3667
9,3667,2,2,1, 3669
24,3679,1,1,1, 3680
1,3681,1,1,1, 3682
30,3683,3,3,1, 3686
6,3685,2,2,1, 3687
7,3687,1,1,1, 3688
9,3692,2,2,1, 3694
12,3695,5,5,1, 3700
18,3698,4,4,1, 3702
24,3704,1,1,0, 3705
1,3706,1,1,1, 3707
3,3707,3,3,1, 3710
30,3708,3,3,1, 3711
31,3711,2,2,1, 3713
7,3712,1,1,0, 3713
28,3709,5,5,1, 3714
11,3714,4,4,1, 3718
18,3723,4,4,1, 3727
24,3729,1,1,0, 3730
1,3731,1,1,0, 3732
5,3732,3,3,1, 3735
27,3732,4,4,1, 3736
30,3733,3,3,1, 3736
25,3735,2,2,1, 3737
7,3737,1,1,0, 3738
28,3734,5,5,1, 3739
11,3739,4,4,1, 3743
17,3744,3,3,1, 3747
12,3745,5,5,1, 3750
22,3751,4,4,1, 3755
2,3753,2,2,1, 3755
24,3754,1,1,1, 3755
19,3751,5,5,1, 3756
23,3753,3,3,1, 3756
21,3752,5,5,1, 3757
5,3757,3,3,1, 3760
30,3758,3,3,1, 3761
31,3761,2,2,1, 3763
7,3762,1,1,1, 3763
8,3766,1,1,1, 3767
14,3769,3,3,1, 3772
24,3779,1,1,0, 3780
23,3778,3,3,1, 3781
21,3777,5,5,1, 3782
6,3785,2,2,1, 3787
31,3786,2,2,1, 3788
7,3787,1,1,0, 3788
29,3788,4,4,1, 3792
8,3791,1,1,0, 3792
16,3794,2,2,1, 3796
13,3794,4,4,1, 3798
15,3796,2,2,1, 3798
24,3804,1,1,0, 3805
5,3807,3,3,1, 3810
30,3808,3,3,1, 3811
31,3811,2,2,1, 3813
7,3812,1,1,0, 3813
29,3813,4,4,1, 3817
8,3816,1,1,1, 3817
16,3819,2,2,1, 3821
14,3819,3,3,1, 3822
13,3819,4,4,1, 3823
15,3821,2,2,1, 3823
24,3829,1,1,0, 3830
8,3841,1,1,0, 3842
22,3851,4,4,1, 3855
24,3854,1,1,0, 3855
23,3853,3,3,1, 3856
25,3860,2,2,1, 3862
8,3866,1,1,0, 3867
9,3867,2,2,1, 3869
17,3869,3,3,1, 3872
15,3871,2,2,1, 3873
24,3879,1,1,0, 3880
1,3881,1,1,1, 3882
25,3885,2,2,1, 3887
8,3891,1,1,1, 3892
24,3904,1,1,1, 3905
23,3903,3,3,1, 3906
21,3902,5,5,1, 3907
1,3906,1,1,0, 3907
25,3910,2,2,1, 3912
8,3916,1,1,0, 3917
9,3917,2,2,1, 3919
16,3919,2,2,1, 3921
14,3919,3,3,1, 3922
17,3919,3,3,1, 3922
24,3929,1,1,1, 3930
21,3927,5,5,1, 3932
1,3931,1,1,1, 3932
30,3933,3,3,1, 3936
31,3936,2,2,1, 3938
7,3937,1,1,0, 3938
8,3941,1,1,0, 3942
13,3944,4,4,1, 3948
15,3946,2,2,1, 3948
18,3948,4,4,1, 3952
2,3953,2,2,1, 3955
24,3954,1,1,0, 3955
23,3953,3,3,1, 3956
21,3952,5,5,1, 3957
1,3956,1,1,0, 3957
6,3960,2,2,1, 3962
31,3961,2,2,1, 3963
7,3962,1,1,1, 3963
8,3966,1,1,1, 3967
9,3967,2,2,1, 3969
14,3969,3,3,1, 3972
13,3969,4,4,1, 3973
18,3973,4,4,1, 3977
22,3976,4,4,1, 3980
24,3979,1,1,0, 3980
23,3978,3,3,1, 3981
1,3981,1,1,1, 3982
6,3985,2,2,1, 3987
25,3985,2,2,1, 3987
31,3986,2,2,1, 3988
7,3987,1,1,0, 3988
26,3987,3,3,1, 3990
29,3988,4,4,1, 3992
8,3991,1,1,1, 3992
9,3992,2,2,1, 3994
16,3994,2,2,1, 3996
17,3994,3,3,1, 3997
24,4004,1,1,0, 4005
21,4002,5,5,1, 4007
1,4006,1,1,1, 4007
31,4011,2,2,1, 4013
7,4012,1,1,1, 4013
28,4009,5,5,1, 4014
26,4012,3,3,1, 4015
8,4016,1,1,0, 4017
11,4014,4,4,1, 4018
9,4017,2,2,1, 4019
16,4019,2,2,1, 4021
12,4020,5,5,1, 4025
22,4026,4,4,1, 4030
24,4029,1,1,1, 4030
19,4026,5,5,1, 4031
21,4027,5,5,1, 4032
1,4031,1,1,0, 4032
4,4031,4,4,1, 4035
5,4032,3,3,1, 4035
30,4033,3,3,1, 4036
25,4035,2,2,1, 4037
31,4036,2,2,1, 4038
7,4037,1,1,1, 4038
28,4034,5,5,1, 4039
29,4038,4,4,1, 4042
8,4041,1,1,1, 4042
11,4039,4,4,1, 4043
16,4044,2,2,1, 4046
13,4044,4,4,1, 4048
15,4046,2,2,1, 4048
12,4045,5,5,1, 4050
18,4048,4,4,1, 4052
20,4048,6,6,1, 4054
22,4051,4,4,1, 4055
24,4054,1,1,1, 4055
1,4056,1,1,1, 4057
3,4057,3,3,1, 4060
5,4057,3,3,1, 4060
27,4057,4,4,1, 4061
6,4060,2,2,1, 4062
7,4062,1,1,0, 4063
29,4063,4,4,1, 4067
24,4079,1,1,0, 4080
30,4083,3,3,1, 4086
6,4085,2,2,1, 4087
7,4087,1,1,1, 4088
24,4104,1,1,1, 4105
30,4108,3,3,1, 4111
7,4112,1,1,1, 4113
24,4129,1,1,0, 4130
30,4133,3,3,1, 4136
6,4135,2,2,1, 4137
31,4136,2,2,1, 4138
7,4137,1,1,0, 4138
29,4138,4,4,1, 4142
24,4154,1,1,1, 4155
21,4152,5,5,1, 4157
30,4158,3,3,1, 4161
6,4160,2,2,1, 4162
31,4161,2,2,1, 4163
7,4162,1,1,1, 4163
8,4166,1,1,0, 4167
14,4169,3,3,1, 4172
17,4169,3,3,1, 4172
15,4171,2,2,1, 4173
24,4179,1,1,1, 4180
23,4178,3,3,1, 4181
1,4181,1,1,1, 4182
5,4182,3,3,1, 4185
30,4183,3,3,1, 4186
6,4185,2,2,1, 4187
7,4187,1,1,1, 4188
8,4191,1,1,0, 4192
14,4194,3,3,1, 4197
13,4194,4,4,1, 4198
15,4196,2,2,1, 4198
22,4201,4,4,1, 4205
24,4204,1,1,0, 4205
23,4203,3,3,1, 4206
21,4202,5,5,1, 4207
1,4206,1,1,0, 4207
5,4207,3,3,1, 4210
6,4210,2,2,1, 4212
25,4210,2,2,1, 4212
31,4211,2,2,1, 4213
7,4212,1,1,0, 4213
8,4216,1,1,0, 4217
9,4217,2,2,1, 4219
16,4219,2,2,1, 4221
18,4223,4,4,1, 4227
22,4226,4,4,1, 4230
24,4229,1,1,1, 4230
1,4231,1,1,1, 4232
5,4232,3,3,1, 4235
25,4235,2,2,1, 4237
7,4237,1,1,0, 4238
26,4237,3,3,1, 4240
29,4238,4,4,1, 4242
8,4241,1,1,0, 4242
16,4244,2,2,1, 4246
17,4244,3,3,1, 4247
13,4244,4,4,1, 4248
15,4246,2,2,1, 4248
12,4245,5,5,1, 4250
22,4251,4,4,1, 4255
2,4253,2,2,1, 4255
24,4254,1,1,1, 4255
23,4253,3,3,1, 4256
1,4256,1,1,0, 4257
4,4256,4,4,1, 4260
3,4257,3,3,1, 4260
5,4257,3,3,1, 4260
6,4260,2,2,1, 4262
25,4260,2,2,1, 4262
7,4262,1,1,0, 4263
28,4259,5,5,1, 4264
26,4262,3,3,1, 4265
29,4263,4,4,1, 4267
8,4266,1,1,0, 4267
11,4264,4,4,1, 4268
18,4273,4,4,1, 4277
20,4273,6,6,1, 4279
22,4276,4,4,1, 4280
24,4279,1,1,1, 4280
19,4276,5,5,1, 4281
23,4278,3,3,1, 4281
1,4281,1,1,1, 4282
5,4282,3,3,1, 4285
27,4282,4,4,1, 4286
7,4287,1,1,1, 4288
28,4284,5,5,1, 4289
29,4288,4,4,1, 4292
8,4291,1,1,1, 4292
9,4292,2,2,1, 4294
14,4294,3,3,1, 4297
15,4296,2,2,1, 4298
12,4295,5,5,1, 4300
2,4303,2,2,1, 4305
24,4304,1,1,1, 4305
19,4301,5,5,1, 4306
23,4303,3,3,1, 4306
21,4302,5,5,1, 4307
1,4306,1,1,1, 4307
5,4307,3,3,1, 4310
27,4307,4,4,1, 4311
30,4308,3,3,1, 4311
6,4310,2,2,1, 4312
25,4310,2,2,1, 4312
7,4312,1,1,1, 4313
8,4316,1,1,1, 4317
11,4314,4,4,1, 4318
14,4319,3,3,1, 4322
17,4319,3,3,1, 4322
24,4329,1,1,0, 4330
21,4327,5,5,1, 4332
6,4335,2,2,1, 4337
7,4337,1,1,0, 4338
8,4341,1,1,1, 4342
15,4346,2,2,1, 4348
24,4354,1,1,1, 4355
30,4358,3,3,1, 4361
31,4361,2,2,1, 4363
7,4362,1,1,0, 4363
8,4366,1,1,1, 4367
13,4369,4,4,1, 4373
22,4376,4,4,1, 4380
24,4379,1,1,1, 4380
23,4378,3,3,1, 4381
21,4377,5,5,1, 4382
5,4382,3,3,1, 4385
6,4385,2,2,1, 4387
7,4387,1,1,0, 4388
8,4391,1,1,0, 4392
16,4394,2,2,1, 4396
13,4394,4,4,1, 4398
15,4396,2,2,1, 4398
24,4404,1,1,0, 4405
23,4403,3,3,1, 4406
21,4402,5,5,1, 4407
6,4410,2,2,1, 4412
7,4412,1,1,0, 4413
24,4429,1,1,0, 4430
1,4431,1,1,0, 4432
5,4432,3,3,1, 4435
6,4435,2,2,1, 4437
31,4436,2,2,1, 4438
7,4437,1,1,1, 4438
17,4444,3,3,1, 4447
24,4454,1,1,0, 4455
1,4456,1,1,0, 4457
25,4460,2,2,1, 4462
7,4462,1,1,1, 4463
17,4469,3,3,1, 4472
24,4479,1,1,0, 4480
1,4481,1,1,1, 4482
7,4487,1,1,0, 4488
26,4487,3,3,1, 4490
29,4488,4,4,1, 4492
11,4489,4,4,1, 4493
17,4494,3,3,1, 4497
18,4498,4,4,1, 4502
24,4504,1,1,1, 4505
19,4501,5,5,1, 4506
1,4506,1,1,1, 4507
4,4506,4,4,1, 4510
3,4507,3,3,1, 4510
27,4507,4,4,1, 4511
30,4508,3,3,1, 4511
6,4510,2,2,1, 4512
7,4512,1,1,0, 4513
8,4516,1,1,1, 4517
15,4521,2,2,1, 4523
18,4523,4,4,1, 4527
20,4523,6,6,1, 4529
22,4526,4,4,1, 4530
24,4529,1,1,0, 4530
23,4528,3,3,1, 4531
1,4531,1,1,0, 4532
4,4531,4,4,1, 4535
30,4533,3,3,1, 4536
6,4535,2,2,1, 4537
31,4536,2,2,1, 4538
7,4537,1,1,1, 4538
26,4537,3,3,1, 4540
29,4538,4,4,1, 4542
8,4541,1,1,0, 4542
9,4542,2,2,1, 4544
16,4544,2,2,1, 4546
14,4544,3,3,1, 4547
17,4544,3,3,1, 4547
15,4546,2,2,1, 4548
12,4545,5,5,1, 4550
20,4548,6,6,1, 4554
22,4551,4,4,1, 4555
2,4553,2,2,1, 4555
24,4554,1,1,0, 4555
1,4556,1,1,0, 4557
3,4557,3,3,1, 4560
31,4561,2,2,1, 4563
7,4562,1,1,0, 4563
26,4562,3,3,1, 4565
8,4566,1,1,0, 4567
11,4564,4,4,1, 4568
17,4569,3,3,1, 4572
13,4569,4,4,1, 4573
12,4570,5,5,1, 4575
24,4579,1,1,0, 4580
23,4578,3,3,1, 4581
21,4577,5,5,1, 4582
5,4582,3,3,1, 4585
7,4587,1,1,1, 4588
8,4591,1,1,0, 4592
16,4594,2,2,1, 4596
14,4594,3,3,1, 4597
13,4594,4,4,1, 4598
22,4601,4,4,1, 4605
24,4604,1,1,0, 4605
7,4612,1,1,1, 4613
29,4613,4,4,1, 4617
8,4616,1,1,0, 4617
16,4619,2,2,1, 4621
13,4619,4,4,1, 4623
22,4626,4,4,1, 4630
24,4629,1,1,1, 4630
23,4628,3,3,1, 4631
7,4637,1,1,1, 4638
8,4641,1,1,0, 4642
16,4644,2,2,1, 4646
14,4644,3,3,1, 4647
24,4654,1,1,1, 4655
6,4660,2,2,1, 4662
7,4662,1,1,1, 4663
8,4666,1,1,0, 4667
16,4669,2,2,1, 4671
14,4669,3,3,1, 4672
15,4671,2,2,1, 4673
24,4679,1,1,0, 4680
21,4677,5,5,1, 4682
1,4681,1,1,1, 4682
6,4685,2,2,1, 4687
25,4685,2,2,1, 4687
31,4686,2,2,1, 4688
7,4687,1,1,1, 4688
8,4691,1,1,1, 4692
9,4692,2,2,1, 4694
16,4694,2,2,1, 4696
17,4694,3,3,1, 4697
15,4696,2,2,1, 4698
2,4703,2,2,1, 4705
24,4704,1,1,1, 4705
21,4702,5,5,1, 4707
1,4706,1,1,1, 4707
5,4707,3,3,1, 4710
31,4711,2,2,1, 4713
7,4712,1,1,0, 4713
29,4713,4,4,1, 4717
8,4716,1,1,1, 4717
16,4719,2,2,1, 4721
14,4719,3,3,1, 4722
15,4721,2,2,1, 4723
22,4726,4,4,1, 4730
2,4728,2,2,1, 4730
24,4729,1,1,1, 4730
1,4731,1,1,0, 4732
30,4733,3,3,1, 4736
7,4737,1,1,1, 4738
26,4737,3,3,1, 4740
29,4738,4,4,1, 4742
9,4742,2,2,1, 4744
17,4744,3,3,1, 4747
2,4753,2,2,1, 4755
24,4754,1,1,1, 4755
1,4756,1,1,0, 4757
5,4757,3,3,1, 4760
30,4758,3,3,1, 4761
7,4762,1,1,1, 4763
26,4762,3,3,1, 4765
12,4770,5,5,1, 4775
18,4773,4,4,1, 4777
20,4773,6,6,1, 4779
2,4778,2,2,1, 4780
24,4779,1,1,0, 4780
19,4776,5,5,1, 4781
1,4781,1,1,0, 4782
6,4785,2,2,1, 4787
25,4785,2,2,1, 4787
31,4786,2,2,1, 4788
7,4787,1,1,0, 4788
26,4787,3,3,1, 4790
9,4792,2,2,1, 4794
12,4795,5,5,1, 4800
24,4804,1,1,1, 4805
19,4801,5,5,1, 4806
1,4806,1,1,1, 4807
3,4807,3,3,1, 4810
30,4808,3,3,1, 4811
25,4810,2,2,1, 4812
31,4811,2,2,1, 4813
7,4812,1,1,0, 4813
29,4813,4,4,1, 4817
11,4814,4,4,1, 4818
24,4829,1,1,0, 4830
5,4832,3,3,1, 4835
30,4833,3,3,1, 4836
6,4835,2,2,1, 4837
7,4837,1,1,1, 4838
8,4841,1,1,1, 4842
16,4844,2,2,1, 4846
14,4844,3,3,1, 4847
13,4844,4,4,1, 4848
24,4854,1,1,1, 4855
21,4852,5,5,1, 4857
30,4858,3,3,1, 4861
7,4862,1,1,1, 4863
8,4866,1,1,0, 4867
15,4871,2,2,1, 4873
22,4876,4,4,1, 4880
24,4879,1,1,0, 4880
21,4877,5,5,1, 4882
5,4882,3,3,1, 4885
7,4887,1,1,1, 4888
29,4888,4,4,1, 4892
8,4891,1,1,0, 4892
16,4894,2,2,1, 4896
14,4894,3,3,1, 4897
13,4894,4,4,1, 4898
24,4904,1,1,1, 4905
23,4903,3,3,1, 4906
30,4908,3,3,1, 4911
7,4912,1,1,1, 4913
8,4916,1,1,0, 4917
12,4920,5,5,1, 4925
24,4929,1,1,1, 4930
1,4931,1,1,1, 4932
30,4933,3,3,1, 4936
25,4935,2,2,1, 4937
31,4936,2,2,1, 4938
7,4937,1,1,1, 4938
29,4938,4,4,1, 4942
8,4941,1,1,0, 4942
9,4942,2,2,1, 4944
14,4944,3,3,1, 4947
13,4944,4,4,1, 4948
15,4946,2,2,1, 4948
24,4954,1,1,1, 4955
23,4953,3,3,1, 4956
21,4952,5,5,1, 4957
1,4956,1,1,1, 4957
5,4957,3,3,1, 4960
30,4958,3,3,1, 4961
6,4960,2,2,1, 4962
25,4960,2,2,1, 4962
31,4961,2,2,1, 4963
7,4962,1,1,1, 4963
29,4963,4,4,1, 4967
8,4966,1,1,1, 4967
17,4969,3,3,1, 4972
13,4969,4,4,1, 4973
22,4976,4,4,1, 4980
24,4979,1,1,0, 4980
23,4978,3,3,1, 4981
1,4981,1,1,0, 4982
30,4983,3,3,1, 4986
31,4986,2,2,1, 4988
7,4987,1,1,1, 4988
29,4988,4,4,1, 4992
8,4991,1,1,1, 4992
17,4994,3,3,1, 4997
22,5001,4,4,1, 5005
24,5004,1,1,0, 5005
23,5003,3,3,1, 5006
21,5002,5,5,1, 5007
1,5006,1,1,1, 5007
5,5007,3,3,1, 5010
30,5008,3,3,1, 5011
25,5010,2,2,1, 5012
7,5012,1,1,0, 5013
29,5013,4,4,1, 5017
8,5016,1,1,0, 5017
17,5019,3,3,1, 5022
13,5019,4,4,1, 5023
15,5021,2,2,1, 5023
22,5026,4,4,1, 5030
2,5028,2,2,1, 5030
24,5029,1,1,0, 5030
23,5028,3,3,1, 5031
1,5031,1,1,0, 5032
5,5032,3,3,1, 5035
7,5037,1,1,0, 5038
29,5038,4,4,1, 5042
8,5041,1,1,1, 5042
16,5044,2,2,1, 5046
17,5044,3,3,1, 5047
13,5044,4,4,1, 5048
24,5054,1,1,0, 5055
23,5053,3,3,1, 5056
1,5056,1,1,0, 5057
30,5058,3,3,1, 5061
6,5060,2,2,1, 5062
25,5060,2,2,1, 5062
31,5061,2,2,1, 5063
7,5062,1,1,1, 5063
8,5066,1,1,1, 5067
9,5067,2,2,1, 5069
14,5069,3,3,1, 5072
17,5069,3,3,1, 5072
15,5071,2,2,1, 5073
18,5073,4,4,1, 5077
24,5079,1,1,0, 5080
1,5081,1,1,0, 5082
5,5082,3,3,1, 5085
30,5083,3,3,1, 5086
31,5086,2,2,1, 5088
7,5087,1,1,0, 5088
28,5084,5,5,1, 5089
26,5087,3,3,1, 5090
29,5088,4,4,1, 5092
8,5091,1,1,0, 5092
9,5092,2,2,1, 5094
16,5094,2,2,1, 5096
17,5094,3,3,1, 5097
13,5094,4,4,1, 5098
15,5096,2,2,1, 5098
12,5095,5,5,1, 5100
18,5098,4,4,1, 5102
24,5104,1,1,1, 5105
19,5101,5,5,1, 5106
23,5103,3,3,1, 5106
21,5102,5,5,1, 5107
1,5106,1,1,1, 5107
3,5107,3,3,1, 5110
27,5107,4,4,1, 5111
30,5108,3,3,1, 5111
6,5110,2,2,1, 5112
25,5110,2,2,1, 5112
31,5111,2,2,1, 5113
7,5112,1,1,1, 5113
12,5120,5,5,1, 5125
18,5123,4,4,1, 5127
24,5129,1,1,1, 5130
1,5131,1,1,1, 5132
3,5132,3,3,1, 5135
5,5132,3,3,1, 5135
27,5132,4,4,1, 5136
30,5133,3,3,1, 5136
6,5135,2,2,1, 5137
25,5135,2,2,1, 5137
31,5136,2,2,1, 5138
7,5137,1,1,1, 5138
28,5134,5,5,1, 5139
29,5138,4,4,1, 5142
11,5139,4,4,1, 5143
18,5148,4,4,1, 5152
24,5154,1,1,0, 5155
19,5151,5,5,1, 5156
1,5156,1,1,0, 5157
4,5156,4,4,1, 5160
5,5157,3,3,1, 5160
6,5160,2,2,1, 5162
24,5179,1,1,1, 5180
24,5204,1,1,0, 5205
8,5216,1,1,0, 5217
13,5219,4,4,1, 5223
22,5226,4,4,1, 5230
24,5229,1,1,0, 5230
23,5228,3,3,1, 5231
8,5241,1,1,1, 5242
16,5244,2,2,1, 5246
14,5244,3,3,1, 5247
15,5246,2,2,1, 5248
24,5254,1,1,1, 5255
23,5253,3,3,1, 5256
21,5252,5,5,1, 5257
29,5263,4,4,1, 5267
8,5266,1,1,1, 5267
16,5269,2,2,1, 5271
17,5269,3,3,1, 5272
13,5269,4,4,1, 5273
24,5279,1,1,0, 5280
1,5281,1,1,1, 5282
5,5282,3,3,1, 5285
30,5283,3,3,1, 5286
25,5285,2,2,1, 5287
7,5287,1,1,0, 5288
8,5291,1,1,0, 5292
9,5292,2,2,1, 5294
16,5294,2,2,1, 5296
14,5294,3,3,1, 5297
13,5294,4,4,1, 5298
22,5301,4,4,1, 5305
24,5304,1,1,1, 5305
1,5306,1,1,0, 5307
30,5308,3,3,1, 5311
6,5310,2,2,1, 5312
25,5310,2,2,1, 5312
7,5312,1,1,1, 5313
29,5313,4,4,1, 5317
8,5316,1,1,1, 5317
17,5319,3,3,1, 5322
2,5328,2,2,1, 5330
24,5329,1,1,0, 5330
23,5328,3,3,1, 5331
21,5327,5,5,1, 5332
1,5331,1,1,0, 5332
4,5331,4,4,1, 5335
27,5332,4,4,1, 5336
25,5335,2,2,1, 5337
7,5337,1,1,0, 5338
26,5337,3,3,1, 5340
8,5341,1,1,0, 5342
11,5339,4,4,1, 5343
9,5342,2,2,1, 5344
16,5344,2,2,1, 5346
14,5344,3,3,1, 5347
15,5346,2,2,1, 5348
18,5348,4,4,1, 5352
24,5354,1,1,0, 5355
1,5356,1,1,0, 5357
30,5358,3,3,1, 5361
25,5360,2,2,1, 5362
7,5362,1,1,1, 5363
26,5362,3,3,1, 5365
29,5363,4,4,1, 5367
8,5366,1,1,0, 5367
14,5369,3,3,1, 5372
18,5373,4,4,1, 5377
24,5379,1,1,0, 5380
23,5378,3,3,1, 5381
1,5381,1,1,0, 5382
5,5382,3,3,1, 5385
30,5383,3,3,1, 5386
31,5386,2,2,1, 5388
7,5387,1,1,0, 5388
8,5391,1,1,1, 5392
14,5394,3,3,1, 5397
13,5394,4,4,1, 5398
15,5396,2,2,1, 5398
18,5398,4,4,1, 5402
22,5401,4,4,1, 5405
2,5403,2,2,1, 5405
24,5404,1,1,1, 5405
23,5403,3,3,1, 5406
21,5402,5,5,1, 5407
1,5406,1,1,1, 5407
5,5407,3,3,1, 5410
30,5408,3,3,1, 5411
6,5410,2,2,1, 5412
25,5410,2,2,1, 5412
7,5412,1,1,0, 5413
29,5413,4,4,1, 5417
8,5416,1,1,0, 5417
16,5419,2,2,1, 5421
15,5421,2,2,1, 5423
22,5426,4,4,1, 5430
24,5429,1,1,0, 5430
1,5431,1,1,0, 5432
31,5436,2,2,1, 5438
7,5437,1,1,1, 5438
26,5437,3,3,1, 5440
9,5442,2,2,1, 5444
17,5444,3,3,1, 5447
12,5445,5,5,1, 5450
20,5448,6,6,1, 5454
24,5454,1,1,1, 5455
1,5456,1,1,1, 5457
3,5457,3,3,1, 5460
5,5457,3,3,1, 5460
27,5457,4,4,1, 5461
6,5460,2,2,1, 5462
7,5462,1,1,1, 5463
26,5462,3,3,1, 5465
12,5470,5,5,1, 5475
20,5473,6,6,1, 5479
2,5478,2,2,1, 5480
24,5479,1,1,1, 5480
1,5481,1,1,1, 5482
3,5482,3,3,1, 5485
5,5482,3,3,1, 5485
30,5483,3,3,1, 5486
31,5486,2,2,1, 5488
7,5487,1,1,1, 5488
29,5488,4,4,1, 5492
24,5504,1,1,0, 5505
5,5507,3,3,1, 5510
6,5510,2,2,1, 5512
7,5512,1,1,1, 5513
29,5513,4,4,1, 5517
24,5529,1,1,0, 5530
5,5532,3,3,1, 5535
30,5533,3,3,1, 5536
7,5537,1,1,0, 5538
8,5541,1,1,1, 5542
16,5544,2,2,1, 5546
13,5544,4,4,1, 5548
15,5546,2,2,1, 5548
22,5551,4,4,1, 5555
24,5554,1,1,1, 5555
31,5561,2,2,1, 5563
7,5562,1,1,1, 5563
8,5566,1,1,1, 5567
14,5569,3,3,1, 5572
24,5579,1,1,0, 5580
5,5582,3,3,1, 5585
30,5583,3,3,1, 5586
7,5587,1,1,0, 5588
8,5591,1,1,1, 5592
17,5594,3,3,1, 5597
15,5596,2,2,1, 5598
22,5601,4,4,1, 5605
24,5604,1,1,0, 5605
1,5606,1,1,0, 5607
5,5607,3,3,1, 5610
31,5611,2,2,1, 5613
7,5612,1,1,0, 5613
29,5613,4,4,1, 5617
8,5616,1,1,0, 5617
9,5617,2,2,1, 5619
13,5619,4,4,1, 5623
22,5626,4,4,1, 5630
24,5629,1,1,0, 5630
19,5626,5,5,1, 5631
23,5628,3,3,1, 5631
1,5631,1,1,0, 5632
4,5631,4,4,1, 5635
3,5632,3,3,1, 5635
6,5635,2,2,1, 5637
25,5635,2,2,1, 5637
7,5637,1,1,1, 5638
28,5634,5,5,1, 5639
26,5637,3,3,1, 5640
8,5641,1,1,1, 5642
9,5642,2,2,1, 5644
14,5644,3,3,1, 5647
18,5648,4,4,1, 5652
22,5651,4,4,1, 5655
24,5654,1,1,0, 5655
23,5653,3,3,1, 5656
21,5652,5,5,1, 5657
1,5656,1,1,1, 5657
7,5662,1,1,0, 5663
26,5662,3,3,1, 5665
8,5666,1,1,0, 5667
9,5667,2,2,1, 5669
16,5669,2,2,1, 5671
14,5669,3,3,1, 5672
17,5669,3,3,1, 5672
22,5676,4,4,1, 5680
24,5679,1,1,0, 5680
23,5678,3,3,1, 5681
21,5677,5,5,1, 5682
1,5681,1,1,0, 5682
30,5683,3,3,1, 5686
31,5686,2,2,1, 5688
7,5687,1,1,1, 5688
8,5691,1,1,0, 5692
16,5694,2,2,1, 5696
13,5694,4,4,1, 5698
15,5696,2,2,1, 5698
18,5698,4,4,1, 5702
2,5703,2,2,1, 5705
24,5704,1,1,1, 5705
1,5706,1,1,0, 5707
5,5707,3,3,1, 5710
7,5712,1,1,1, 5713
26,5712,3,3,1, 5715
8,5716,1,1,1, 5717
9,5717,2,2,1, 5719
24,5729,1,1,1, 5730
23,5728,3,3,1, 5731
21,5727,5,5,1, 5732
1,5731,1,1,0, 5732
30,5733,3,3,1, 5736
6,5735,2,2,1, 5737
25,5735,2,2,1, 5737
31,5736,2,2,1, 5738
7,5737,1,1,0, 5738
8,5741,1,1,0, 5742
9,5742,2,2,1, 5744
16,5744,2,2,1, 5746
14,5744,3,3,1, 5747
17,5744,3,3,1, 5747
20,5748,6,6,1, 5754
22,5751,4,4,1, 5755
2,5753,2,2,1, 5755
24,5754,1,1,0, 5755
19,5751,5,5,1, 5756
1,5756,1,1,1, 5757
3,5757,3,3,1, 5760
27,5757,4,4,1, 5761
25,5760,2,2,1, 5762
31,5761,2,2,1, 5763
7,5762,1,1,0, 5763
28,5759,5,5,1, 5764
29,5763,4,4,1, 5767
8,5766,1,1,1, 5767
14,5769,3,3,1, 5772
15,5771,2,2,1, 5773
22,5776,4,4,1, 5780
24,5779,1,1,0, 5780
21,5777,5,5,1, 5782
5,5782,3,3,1, 5785
6,5785,2,2,1, 5787
31,5786,2,2,1, 5788
7,5787,1,1,1, 5788
8,5791,1,1,0, 5792
14,5794,3,3,1, 5797
15,5796,2,2,1, 5798
22,5801,4,4,1, 5805
24,5804,1,1,0, 5805
23,5803,3,3,1, 5806
21,5802,5,5,1, 5807
5,5807,3,3,1, 5810
30,5808,3,3,1, 5811
6,5810,2,2,1, 5812
31,5811,2,2,1, 5813
7,5812,1,1,1, 5813
29,5813,4,4,1, 5817
8,5816,1,1,0, 5817
24,5829,1,1,1, 5830
30,5833,3,3,1, 5836
7,5837,1,1,1, 5838
29,5838,4,4,1, 5842
24,5854,1,1,0, 5855
30,5858,3,3,1, 5861
6,5860,2,2,1, 5862
7,5862,1,1,0, 5863
24,5879,1,1,1, 5880
1,5881,1,1,1, 5882
30,5883,3,3,1, 5886
6,5885,2,2,1, 5887
31,5886,2,2,1, 5888
7,5887,1,1,1, 5888
29,5888,4,4,1, 5892
17,5894,3,3,1, 5897
24,5904,1,1,1, 5905
1,5906,1,1,0, 5907
30,5908,3,3,1, 5911
6,5910,2,2,1, 5912
25,5910,2,2,1, 5912
31,5911,2,2,1, 5913
7,5912,1,1,1, 5913
9,5917,2,2,1, 5919
17,5919,3,3,1, 5922
22,5926,4,4,1, 5930
24,5929,1,1,1, 5930
1,5931,1,1,1, 5932
5,5932,3,3,1, 5935
30,5933,3,3,1, 5936
6,5935,2,2,1, 5937
25,5935,2,2,1, 5937
31,5936,2,2,1, 5938
7,5937,1,1,1, 5938
29,5938,4,4,1, 5942
8,5941,1,1,1, 5942
16,5944,2,2,1, 5946
14,5944,3,3,1, 5947
17,5944,3,3,1, 5947
13,5944,4,4,1, 5948
15,5946,2,2,1, 5948
22,5951,4,4,1, 5955
24,5954,1,1,1, 5955
21,5952,5,5,1, 5957
1,5956,1,1,1, 5957
5,5957,3,3,1, 5960
30,5958,3,3,1, 5961
6,5960,2,2,1, 5962
25,5960,2,2,1, 5962
31,5961,2,2,1, 5963
7,5962,1,1,1, 5963
29,5963,4,4,1, 5967
8,5966,1,1,0, 5967
11,5964,4,4,1, 5968
9,5967,2,2,1, 5969
14,5969,3,3,1, 5972
17,5969,3,3,1, 5972
15,5971,2,2,1, 5973
2,5978,2,2,1, 5980
24,5979,1,1,1, 5980
19,5976,5,5,1, 5981
1,5981,1,1,0, 5982
4,5981,4,4,1, 5985
3,5982,3,3,1, 5985
26,5987,3,3,1, 5990
8,5991,1,1,1, 5992
11,5989,4,4,1, 5993
9,5992,2,2,1, 5994
16,5994,2,2,1, 5996
14,5994,3,3,1, 5997
17,5994,3,3,1, 5997
15,5996,2,2,1, 5998
22,6001,4,4,1, 6005
2,6003,2,2,1, 6005
24,6004,1,1,1, 6005
23,6003,3,3,1, 6006
21,6002,5,5,1, 6007
1,6006,1,1,1, 6007
26,6012,3,3,1, 6015
8,6016,1,1,0, 6017
16,6019,2,2,1, 6021
14,6019,3,3,1, 6022
13,6019,4,4,1, 6023
18,6023,4,4,1, 6027
24,6029,1,1,0, 6030
23,6028,3,3,1, 6031
1,6031,1,1,0, 6032
25,6035,2,2,1, 6037
26,6037,3,3,1, 6040
8,6041,1,1,1, 6042
9,6042,2,2,1, 6044
16,6044,2,2,1, 6046
14,6044,3,3,1, 6047
15,6046,2,2,1, 6048
22,6051,4,4,1, 6055
24,6054,1,1,0, 6055
23,6053,3,3,1, 6056
1,6056,1,1,0, 6057
8,6066,1,1,0, 6067
14,6069,3,3,1, 6072
17,6069,3,3,1, 6072
24,6079,1,1,0, 6080
1,6081,1,1,1, 6082
30,6083,3,3,1, 6086
7,6087,1,1,1, 6088
12,6095,5,5,1, 6100
24,6104,1,1,0, 6105
1,6106,1,1,0, 6107
4,6106,4,4,1, 6110
5,6107,3,3,1, 6110
27,6107,4,4,1, 6111
30,6108,3,3,1, 6111
6,6110,2,2,1, 6112
25,6110,2,2,1, 6112
7,6112,1,1,0, 6113
28,6109,5,5,1, 6114
26,6112,3,3,1, 6115
29,6113,4,4,1, 6117
17,6119,3,3,1, 6122
18,6123,4,4,1, 6127
20,6123,6,6,1, 6129
24,6129,1,1,0, 6130
5,6132,3,3,1, 6135
30,6133,3,3,1, 6136
6,6135,2,2,1, 6137
7,6137,1,1,1, 6138
24,6154,1,1,1, 6155
7,6162,1,1,0, 6163
29,6163,4,4,1, 6167
24,6179,1,1,1, 6180
23,6178,3,3,1, 6181
5,6182,3,3,1, 6185
6,6185,2,2,1, 6187
7,6187,1,1,0, 6188
8,6191,1,1,0, 6192
13,6194,4,4,1, 6198
15,6196,2,2,1, 6198
24,6204,1,1,0, 6205
23,6203,3,3,1, 6206
21,6202,5,5,1, 6207
5,6207,3,3,1, 6210
30,6208,3,3,1, 6211
6,6210,2,2,1, 6212
31,6211,2,2,1, 6213
7,6212,1,1,0, 6213
29,6213,4,4,1, 6217
8,6216,1,1,1, 6217
16,6219,2,2,1, 6221
14,6219,3,3,1, 6222
13,6219,4,4,1, 6223
24,6229,1,1,1, 6230
21,6227,5,5,1, 6232
1,6231,1,1,0, 6232
5,6232,3,3,1, 6235
6,6235,2,2,1, 6237
7,6237,1,1,1, 6238
29,6238,4,4,1, 6242
8,6241,1,1,1, 6242
9,6242,2,2,1, 6244
14,6244,3,3,1, 6247
22,6251,4,4,1, 6255
24,6254,1,1,1, 6255
1,6256,1,1,1, 6257
25,6260,2,2,1, 6262
7,6262,1,1,0, 6263
8,6266,1,1,1, 6267
9,6267,2,2,1, 6269
16,6269,2,2,1, 6271
13,6269,4,4,1, 6273
22,6276,4,4,1, 6280
24,6279,1,1,1, 6280
1,6281,1,1,0, 6282
5,6282,3,3,1, 6285
7,6287,1,1,0, 6288
8,6291,1,1,1, 6292
9,6292,2,2,1, 6294
13,6294,4,4,1, 6298
24,6304,1,1,1, 6305
1,6306,1,1,1, 6307
30,6308,3,3,1, 6311
6,6310,2,2,1, 6312
25,6310,2,2,1, 6312
7,6312,1,1,0, 6313
26,6312,3,3,1, 6315
29,6313,4,4,1, 6317
8,6316,1,1,0, 6317
9,6317,2,2,1, 6319
16,6319,2,2,1, 6321
14,6319,3,3,1, 6322
17,6319,3,3,1, 6322
13,6319,4,4,1, 6323
15,6321,2,2,1, 6323
18,6323,4,4,1, 6327
24,6329,1,1,0, 6330
21,6327,5,5,1, 6332
1,6331,1,1,1, 6332
30,6333,3,3,1, 6336
25,6335,2,2,1, 6337
31,6336,2,2,1, 6338
7,6337,1,1,1, 6338
26,6337,3,3,1, 6340
29,6338,4,4,1, 6342
8,6341,1,1,1, 6342
11,6339,4,4,1, 6343
14,6344,3,3,1, 6347
13,6344,4,4,1, 6348
15,6346,2,2,1, 6348
12,6345,5,5,1, 6350
18,6348,4,4,1, 6352
2,6353,2,2,1, 6355
24,6354,1,1,0, 6355
19,6351,5,5,1, 6356
1,6356,1,1,0, 6357
27,6357,4,4,1, 6361
7,6362,1,1,1, 6363
28,6359,5,5,1, 6364
8,6366,1,1,1, 6367
9,6367,2,2,1, 6369
14,6369,3,3,1, 6372
13,6369,4,4,1, 6373
15,6371,2,2,1, 6373
18,6373,4,4,1, 6377
20,6373,6,6,1, 6379
22,6376,4,4,1, 6380
2,6378,2,2,1, 6380
24,6379,1,1,0, 6380
23,6378,3,3,1, 6381
1,6381,1,1,1, 6382
27,6382,4,4,1, 6386
30,6383,3,3,1, 6386
6,6385,2,2,1, 6387
31,6386,2,2,1, 6388
7,6387,1,1,1, 6388
28,6384,5,5,1, 6389
26,6387,3,3,1, 6390
8,6391,1,1,0, 6392
11,6389,4,4,1, 6393
22,6401,4,4,1, 6405
24,6404,1,1,0, 6405
5,6407,3,3,1, 6410
6,6410,2,2,1, 6412
31,6411,2,2,1, 6413
7,6412,1,1,1, 6413
29,6413,4,4,1, 6417
8,6416,1,1,0, 6417
16,6419,2,2,1, 6421
15,6421,2,2,1, 6423
24,6429,1,1,0, 6430
21,6427,5,5,1, 6432
7,6437,1,1,1, 6438
29,6438,4,4,1, 6442
8,6441,1,1,0, 6442
16,6444,2,2,1, 6446
14,6444,3,3,1, 6447
13,6444,4,4,1, 6448
24,6454,1,1,0, 6455
23,6453,3,3,1, 6456
21,6452,5,5,1, 6457
30,6458,3,3,1, 6461
7,6462,1,1,0, 6463
24,6479,1,1,0, 6480
5,6482,3,3,1, 6485
31,6486,2,2,1, 6488
7,6487,1,1,0, 6488
29,6488,4,4,1, 6492
17,6494,3,3,1, 6497
24,6504,1,1,0, 6505
1,6506,1,1,0, 6507
5,6507,3,3,1, 6510
30,6508,3,3,1, 6511
6,6510,2,2,1, 6512
7,6512,1,1,0, 6513
9,6517,2,2,1, 6519
17,6519,3,3,1, 6522
24,6529,1,1,0, 6530
1,6531,1,1,0, 6532
31,6536,2,2,1, 6538
7,6537,1,1,1, 6538
9,6542,2,2,1, 6544
17,6544,3,3,1, 6547
2,6553,2,2,1, 6555
24,6554,1,1,1, 6555
1,6556,1,1,0, 6557
30,6558,3,3,1, 6561
31,6561,2,2,1, 6563
7,6562,1,1,1, 6563
29,6563,4,4,1, 6567
8,6566,1,1,0, 6567
9,6567,2,2,1, 6569
16,6569,2,2,1, 6571
17,6569,3,3,1, 6572
13,6569,4,4,1, 6573
22,6576,4,4,1, 6580
24,6579,1,1,1, 6580
21,6577,5,5,1, 6582
1,6581,1,1,1, 6582
5,6582,3,3,1, 6585
30,6583,3,3,1, 6586
6,6585,2,2,1, 6587
25,6585,2,2,1, 6587
31,6586,2,2,1, 6588
7,6587,1,1,0, 6588
29,6588,4,4,1, 6592
8,6591,1,1,0, 6592
9,6592,2,2,1, 6594
16,6594,2,2,1, 6596
14,6594,3,3,1, 6597
17,6594,3,3,1, 6597
15,6596,2,2,1, 6598
12,6595,5,5,1, 6600
22,6601,4,4,1, 6605
2,6603,2,2,1, 6605
24,6604,1,1,0, 6605
19,6601,5,5,1, 6606
21,6602,5,5,1, 6607
1,6606,1,1,0, 6607
3,6607,3,3,1, 6610
5,6607,3,3,1, 6610
31,6611,2,2,1, 6613
7,6612,1,1,0, 6613
26,6612,3,3,1, 6615
8,6616,1,1,0, 6617
11,6614,4,4,1, 6618
14,6619,3,3,1, 6622
17,6619,3,3,1, 6622
13,6619,4,4,1, 6623
18,6623,4,4,1, 6627
20,6623,6,6,1, 6629
2,6628,2,2,1, 6630
24,6629,1,1,1, 6630
19,6626,5,5,1, 6631
23,6628,3,3,1, 6631
21,6627,5,5,1, 6632
1,6631,1,1,0, 6632
4,6631,4,4,1, 6635
3,6632,3,3,1, 6635
25,6635,2,2,1, 6637
7,6637,1,1,1, 6638
29,6638,4,4,1, 6642
8,6641,1,1,0, 6642
11,6639,4,4,1, 6643
17,6644,3,3,1, 6647
15,6646,2,2,1, 6648
22,6651,4,4,1, 6655
24,6654,1,1,0, 6655
7,6662,1,1,0, 6663
8,6666,1,1,1, 6667
24,6679,1,1,1, 6680
5,6682,3,3,1, 6685
30,6683,3,3,1, 6686
31,6686,2,2,1, 6688
7,6687,1,1,0, 6688
29,6688,4,4,1, 6692
8,6691,1,1,1, 6692
15,6696,2,2,1, 6698
22,6701,4,4,1, 6705
24,6704,1,1,0, 6705
23,6703,3,3,1, 6706
21,6702,5,5,1, 6707
5,6707,3,3,1, 6710
30,6708,3,3,1, 6711
31,6711,2,2,1, 6713
7,6712,1,1,0, 6713
29,6713,4,4,1, 6717
8,6716,1,1,0, 6717
15,6721,2,2,1, 6723
24,6729,1,1,0, 6730
23,6728,3,3,1, 6731
30,6733,3,3,1, 6736
6,6735,2,2,1, 6737
31,6736,2,2,1, 6738
7,6737,1,1,0, 6738
8,6741,1,1,0, 6742
22,6751,4,4,1, 6755
24,6754,1,1,0, 6755
1,6756,1,1,0, 6757
5,6757,3,3,1, 6760
30,6758,3,3,1, 6761
25,6760,2,2,1, 6762
7,6762,1,1,0, 6763
29,6763,4,4,1, 6767
8,6766,1,1,1, 6767
16,6769,2,2,1, 6771
14,6769,3,3,1, 6772
17,6769,3,3,1, 6772
15,6771,2,2,1, 6773
24,6779,1,1,1, 6780
21,6777,5,5,1, 6782
1,6781,1,1,0, 6782
31,6786,2,2,1, 6788
7,6787,1,1,1, 6788
29,6788,4,4,1, 6792
8,6791,1,1,0, 6792
16,6794,2,2,1, 6796
17,6794,3,3,1, 6797
15,6796,2,2,1, 6798
24,6804,1,1,0, 6805
21,6802,5,5,1, 6807
1,6806,1,1,0, 6807
5,6807,3,3,1, 6810
30,6808,3,3,1, 6811
6,6810,2,2,1, 6812
25,6810,2,2,1, 6812
7,6812,1,1,0, 6813
8,6816,1,1,1, 6817
16,6819,2,2,1, 6821
13,6819,4,4,1, 6823
18,6823,4,4,1, 6827
22,6826,4,4,1, 6830
24,6829,1,1,0, 6830
23,6828,3,3,1, 6831
21,6827,5,5,1, 6832
1,6831,1,1,0, 6832
5,6832,3,3,1, 6835
7,6837,1,1,0, 6838
8,6841,1,1,1, 6842
14,6844,3,3,1, 6847
18,6848,4,4,1, 6852
2,6853,2,2,1, 6855
24,6854,1,1,1, 6855
1,6856,1,1,1, 6857
25,6860,2,2,1, 6862
31,6861,2,2,1, 6863
7,6862,1,1,1, 6863
29,6863,4,4,1, 6867
12,6870,5,5,1, 6875
18,6873,4,4,1, 6877
20,6873,6,6,1, 6879
24,6879,1,1,0, 6880
1,6881,1,1,1, 6882
3,6882,3,3,1, 6885
27,6882,4,4,1, 6886
6,6885,2,2,1, 6887
31,6886,2,2,1, 6888
7,6887,1,1,0, 6888
28,6884,5,5,1, 6889
11,6889,4,4,1, 6893
9,6892,2,2,1, 6894
12,6895,5,5,1, 6900
24,6904,1,1,0, 6905
1,6906,1,1,0, 6907
4,6906,4,4,1, 6910
3,6907,3,3,1, 6910
5,6907,3,3,1, 6910
27,6907,4,4,1, 6911
30,6908,3,3,1, 6911
6,6910,2,2,1, 6912
7,6912,1,1,1, 6913
28,6909,5,5,1, 6914
26,6912,3,3,1, 6915
29,6913,4,4,1, 6917
9,6917,2,2,1, 6919
24,6929,1,1,1, 6930
19,6926,5,5,1, 6931
1,6931,1,1,0, 6932
4,6931,4,4,1, 6935
27,6932,4,4,1, 6936
30,6933,3,3,1, 6936
6,6935,2,2,1, 6937
31,6936,2,2,1, 6938
7,6937,1,1,1, 6938
26,6937,3,3,1, 6940
29,6938,4,4,1, 6942
9,6942,2,2,1, 6944
17,6944,3,3,1, 6947
12,6945,5,5,1, 6950
18,6948,4,4,1, 6952
24,6954,1,1,1, 6955
23,6953,3,3,1, 6956
21,6952,5,5,1, 6957
5,6957,3,3,1, 6960
7,6962,1,1,1, 6963
29,6963,4,4,1, 6967
8,6966,1,1,1, 6967
16,6969,2,2,1, 6971
14,6969,3,3,1, 6972
13,6969,4,4,1, 6973
15,6971,2,2,1, 6973
24,6979,1,1,0, 6980
23,6978,3,3,1, 6981
8,6991,1,1,1, 6992
16,6994,2,2,1, 6996
14,6994,3,3,1, 6997
13,6994,4,4,1, 6998
24,7004,1,1,0, 7005
23,7003,3,3,1, 7006
21,7002,5,5,1, 7007
8,7016,1,1,1, 7017
16,7019,2,2,1, 7021
13,7019,4,4,1, 7023
22,7026,4,4,1, 7030
24,7029,1,1,0, 7030
8,7041,1,1,0, 7042
14,7044,3,3,1, 7047
15,7046,2,2,1, 7048
24,7054,1,1,0, 7055
23,7053,3,3,1, 7056
21,7052,5,5,1, 7057
1,7056,1,1,0, 7057
8,7066,1,1,0, 7067
9,7067,2,2,1, 7069
16,7069,2,2,1, 7071
14,7069,3,3,1, 7072
13,7069,4,4,1, 7073
2,7078,2,2,1, 7080
24,7079,1,1,0, 7080
21,7077,5,5,1, 7082
1,7081,1,1,0, 7082
5,7082,3,3,1, 7085
30,7083,3,3,1, 7086
6,7085,2,2,1, 7087
25,7085,2,2,1, 7087
31,7086,2,2,1, 7088
7,7087,1,1,1, 7088
26,7087,3,3,1, 7090
29,7088,4,4,1, 7092
24,7104,1,1,1, 7105
1,7106,1,1,0, 7107
25,7110,2,2,1, 7112
31,7111,2,2,1, 7113
7,7112,1,1,0, 7113
26,7112,3,3,1, 7115
29,7113,4,4,1, 7117
17,7119,3,3,1, 7122
24,7129,1,1,0, 7130
19,7126,5,5,1, 7131
1,7131,1,1,1, 7132
3,7132,3,3,1, 7135
27,7132,4,4,1, 7136
7,7137,1,1,0, 7138
11,7139,4,4,1, 7143
17,7144,3,3,1, 7147
12,7145,5,5,1, 7150
18,7148,4,4,1, 7152
2,7153,2,2,1, 7155
24,7154,1,1,0, 7155
1,7156,1,1,0, 7157
5,7157,3,3,1, 7160
31,7161,2,2,1, 7163
7,7162,1,1,1, 7163
11,7164,4,4,1, 7168
12,7170,5,5,1, 7175
20,7173,6,6,1, 7179
2,7178,2,2,1, 7180
24,7179,1,1,0, 7180
19,7176,5,5,1, 7181
1,7181,1,1,0, 7182
27,7182,4,4,1, 7186
31,7186,2,2,1, 7188
7,7187,1,1,1, 7188
28,7184,5,5,1, 7189
26,7187,3,3,1, 7190
8,7191,1,1,1, 7192
9,7192,2,2,1, 7194
14,7194,3,3,1, 7197
15,7196,2,2,1, 7198
18,7198,4,4,1, 7202
22,7201,4,4,1, 7205
24,7204,1,1,1, 7205
23,7203,3,3,1, 7206
21,7202,5,5,1, 7207
5,7207,3,3,1, 7210
30,7208,3,3,1, 7211
6,7210,2,2,1, 7212
31,7211,2,2,1, 7213
7,7212,1,1,0, 7213
8,7216,1,1,0, 7217
22,7226,4,4,1, 7230
24,7229,1,1,1, 7230
30,7233,3,3,1, 7236
7,7237,1,1,1, 7238
29,7238,4,4,1, 7242
8,7241,1,1,0, 7242
16,7244,2,2,1, 7246
13,7244,4,4,1, 7248
24,7254,1,1,1, 7255
23,7253,3,3,1, 7256
5,7257,3,3,1, 7260
7,7262,1,1,0, 7263
8,7266,1,1,1, 7267
16,7269,2,2,1, 7271
14,7269,3,3,1, 7272
24,7279,1,1,0, 7280
21,7277,5,5,1, 7282
5,7282,3,3,1, 7285
30,7283,3,3,1, 7286
7,7287,1,1,1, 7288
8,7291,1,1,1, 7292
14,7294,3,3,1, 7297
15,7296,2,2,1, 7298
22,7301,4,4,1, 7305
24,7304,1,1,1, 7305
21,7302,5,5,1, 7307
1,7306,1,1,0, 7307
5,7307,3,3,1, 7310
6,7310,2,2,1, 7312
25,7310,2,2,1, 7312
7,7312,1,1,1, 7313
29,7313,4,4,1, 7317
8,7316,1,1,1, 7317
9,7317,2,2,1, 7319
17,7319,3,3,1, 7322
22,7326,4,4,1, 7330
24,7329,1,1,0, 7330
1,7331,1,1,1, 7332
5,7332,3,3,1, 7335
30,7333,3,3,1, 7336
6,7335,2,2,1, 7337
25,7335,2,2,1, 7337
31,7336,2,2,1, 7338
7,7337,1,1,1, 7338
8,7341,1,1,0, 7342
16,7344,2,2,1, 7346
17,7344,3,3,1, 7347
15,7346,2,2,1, 7348
22,7351,4,4,1, 7355
24,7354,1,1,1, 7355
21,7352,5,5,1, 7357
1,7356,1,1,0, 7357
5,7357,3,3,1, 7360
25,7360,2,2,1, 7362
7,7362,1,1,1, 7363
29,7363,4,4,1, 7367
8,7366,1,1,1, 7367
14,7369,3,3,1, 7372
17,7369,3,3,1, 7372
15,7371,2,2,1, 7373
24,7379,1,1,0, 7380
1,7381,1,1,1, 7382
6,7385,2,2,1, 7387
7,7387,1,1,0, 7388
29,7388,4,4,1, 7392
8,7391,1,1,1, 7392
16,7394,2,2,1, 7396
17,7394,3,3,1, 7397
15,7396,2,2,1, 7398
24,7404,1,1,0, 7405
21,7402,5,5,1, 7407
1,7406,1,1,0, 7407
5,7407,3,3,1, 7410
25,7410,2,2,1, 7412
31,7411,2,2,1, 7413
7,7412,1,1,1, 7413
8,7416,1,1,0, 7417
16,7419,2,2,1, 7421
14,7419,3,3,1, 7422
12,7420,5,5,1, 7425
18,7423,4,4,1, 7427
20,7423,6,6,1, 7429
24,7429,1,1,0, 7430
19,7426,5,5,1, 7431
23,7428,3,3,1, 7431
1,7431,1,1,0, 7432
5,7432,3,3,1, 7435
27,7432,4,4,1, 7436
30,7433,3,3,1, 7436
6,7435,2,2,1, 7437
25,7435,2,2,1, 7437
7,7437,1,1,1, 7438
26,7437,3,3,1, 7440
8,7441,1,1,0, 7442
11,7439,4,4,1, 7443
16,7444,2,2,1, 7446
17,7444,3,3,1, 7447
15,7446,2,2,1, 7448
18,7448,4,4,1, 7452
20,7448,6,6,1, 7454
24,7454,1,1,0, 7455
19,7451,5,5,1, 7456
23,7453,3,3,1, 7456
21,7452,5,5,1, 7457
1,7456,1,1,0, 7457
4,7456,4,4,1, 7460
5,7457,3,3,1, 7460
27,7457,4,4,1, 7461
30,7458,3,3,1, 7461
6,7460,2,2,1, 7462
31,7461,2,2,1, 7463
7,7462,1,1,0, 7463
28,7459,5,5,1, 7464
26,7462,3,3,1, 7465
8,7466,1,1,0, 7467
11,7464,4,4,1, 7468
16,7469,2,2,1, 7471
14,7469,3,3,1, 7472
24,7479,1,1,1, 7480
30,7483,3,3,1, 7486
7,7487,1,1,0, 7488
29,7488,4,4,1, 7492
24,7504,1,1,1, 7505
30,7508,3,3,1, 7511
6,7510,2,2,1, 7512
7,7512,1,1,0, 7513
24,7529,1,1,1, 7530
30,7533,3,3,1, 7536
6,7535,2,2,1, 7537
31,7536,2,2,1, 7538
7,7537,1,1,0, 7538
24,7554,1,1,0, 7555
7,7562,1,1,0, 7563
24,7579,1,1,0, 7580
23,7578,3,3,1, 7581
21,7577,5,5,1, 7582
1,7581,1,1,0, 7582
5,7582,3,3,1, 7585
6,7585,2,2,1, 7587
25,7585,2,2,1, 7587
31,7586,2,2,1, 7588
7,7587,1,1,1, 7588
8,7591,1,1,0, 7592
16,7594,2,2,1, 7596
14,7594,3,3,1, 7597
15,7596,2,2,1, 7598
24,7604,1,1,0, 7605
21,7602,5,5,1, 7607
1,7606,1,1,0, 7607
5,7607,3,3,1, 7610
30,7608,3,3,1, 7611
6,7610,2,2,1, 7612
31,7611,2,2,1, 7613
7,7612,1,1,0, 7613
8,7616,1,1,1, 7617
9,7617,2,2,1, 7619
16,7619,2,2,1, 7621
14,7619,3,3,1, 7622
17,7619,3,3,1, 7622
13,7619,4,4,1, 7623
15,7621,2,2,1, 7623
2,7628,2,2,1, 7630
24,7629,1,1,1, 7630
23,7628,3,3,1, 7631
1,7631,1,1,1, 7632
30,7633,3,3,1, 7636
25,7635,2,2,1, 7637
31,7636,2,2,1, 7638
7,7637,1,1,1, 7638
26,7637,3,3,1, 7640
29,7638,4,4,1, 7642
8,7641,1,1,1, 7642
9,7642,2,2,1, 7644
13,7644,4,4,1, 7648
15,7646,2,2,1, 7648
22,7651,4,4,1, 7655
2,7653,2,2,1, 7655
24,7654,1,1,0, 7655
23,7653,3,3,1, 7656
21,7652,5,5,1, 7657
1,7656,1,1,0, 7657
30,7658,3,3,1, 7661
6,7660,2,2,1, 7662
25,7660,2,2,1, 7662
31,7661,2,2,1, 7663
7,7662,1,1,1, 7663
29,7663,4,4,1, 7667
8,7666,1,1,1, 7667
9,7667,2,2,1, 7669
14,7669,3,3,1, 7672
17,7669,3,3,1, 7672
18,7673,4,4,1, 7677
2,7678,2,2,1, 7680
24,7679,1,1,0, 7680
21,7677,5,5,1, 7682
1,7681,1,1,1, 7682
30,7683,3,3,1, 7686
6,7685,2,2,1, 7687
31,7686,2,2,1, 7688
7,7687,1,1,1, 7688
26,7687,3,3,1, 7690
29,7688,4,4,1, 7692
8,7691,1,1,1, 7692
9,7692,2,2,1, 7694
14,7694,3,3,1, 7697
17,7694,3,3,1, 7697
13,7694,4,4,1, 7698
18,7698,4,4,1, 7702
24,7704,1,1,1, 7705
21,7702,5,5,1, 7707
1,7706,1,1,1, 7707
5,7707,3,3,1, 7710
31,7711,2,2,1, 7713
7,7712,1,1,0, 7713
26,7712,3,3,1, 7715
8,7716,1,1,1, 7717
9,7717,2,2,1, 7719
14,7719,3,3,1, 7722
17,7719,3,3,1, 7722
15,7721,2,2,1, 7723
12,7720,5,5,1, 7725
22,7726,4,4,1, 7730
2,7728,2,2,1, 7730
24,7729,1,1,1, 7730
1,7731,1,1,0, 7732
5,7732,3,3,1, 7735
27,7732,4,4,1, 7736
25,7735,2,2,1, 7737
31,7736,2,2,1, 7738
7,7737,1,1,1, 7738
26,7737,3,3,1, 7740
29,7738,4,4,1, 7742
8,7741,1,1,1, 7742
11,7739,4,4,1, 7743
16,7744,2,2,1, 7746
14,7744,3,3,1, 7747
17,7744,3,3,1, 7747
13,7744,4,4,1, 7748
15,7746,2,2,1, 7748
2,7753,2,2,1, 7755
24,7754,1,1,0, 7755
19,7751,5,5,1, 7756
24,7779,1,1,0, 7780
24,7804,1,1,0, 7805
24,7829,1,1,0, 7830
22,7851,4,4,1, 7855
24,7854,1,1,0, 7855
5,7857,3,3,1, 7860
30,7858,3,3,1, 7861
6,7860,2,2,1, 7862
7,7862,1,1,0, 7863
8,7866,1,1,1, 7867
9,7867,2,2,1, 7869
16,7869,2,2,1, 7871
14,7869,3,3,1, 7872
17,7869,3,3,1, 7872
13,7869,4,4,1, 7873
15,7871,2,2,1, 7873
24,7879,1,1,0, 7880
21,7877,5,5,1, 7882
1,7881,1,1,1, 7882
5,7882,3,3,1, 7885
25,7885,2,2,1, 7887
7,7887,1,1,1, 7888
8,7891,1,1,0, 7892
16,7894,2,2,1, 7896
14,7894,3,3,1, 7897
13,7894,4,4,1, 7898
22,7901,4,4,1, 7905
24,7904,1,1,0, 7905
21,7902,5,5,1, 7907
1,7906,1,1,1, 7907
31,7911,2,2,1, 7913
7,7912,1,1,1, 7913
8,7916,1,1,1, 7917
15,7921,2,2,1, 7923
24,7929,1,1,1, 7930
1,7931,1,1,1, 7932
25,7935,2,2,1, 7937
31,7936,2,2,1, 7938
7,7937,1,1,1, 7938
26,7937,3,3,1, 7940
29,7938,4,4,1, 7942
8,7941,1,1,0, 7942
16,7944,2,2,1, 7946
14,7944,3,3,1, 7947
17,7944,3,3,1, 7947
24,7954,1,1,1, 7955
21,7952,5,5,1, 7957
1,7956,1,1,1, 7957
30,7958,3,3,1, 7961
6,7960,2,2,1, 7962
7,7962,1,1,0, 7963
26,7962,3,3,1, 7965
29,7963,4,4,1, 7967
8,7966,1,1,0, 7967
16,7969,2,2,1, 7971
17,7969,3,3,1, 7972
13,7969,4,4,1, 7973
18,7973,4,4,1, 7977
22,7976,4,4,1, 7980
2,7978,2,2,1, 7980
24,7979,1,1,0, 7980
23,7978,3,3,1, 7981
1,7981,1,1,1, 7982
5,7982,3,3,1, 7985
31,7986,2,2,1, 7988
7,7987,1,1,1, 7988
29,7988,4,4,1, 7992
8,7991,1,1,1, 7992
9,7992,2,2,1, 7994
17,7994,3,3,1, 7997
13,7994,4,4,1, 7998
18,7998,4,4,1, 8002
20,7998,6,6,1, 8004
22,8001,4,4,1, 8005
2,8003,2,2,1, 8005
24,8004,1,1,0, 8005
23,8003,3,3,1, 8006
1,8006,1,1,1, 8007
4,8006,4,4,1, 8010
27,8007,4,4,1, 8011
30,8008,3,3,1, 8011
7,8012,1,1,1, 8013
26,8012,3,3,1, 8015
8,8016,1,1,1, 8017
11,8014,4,4,1, 8018
16,8019,2,2,1, 8021
14,8019,3,3,1, 8022
12,8020,5,5,1, 8025
18,8023,4,4,1, 8027
20,8023,6,6,1, 8029
24,8029,1,1,1, 8030
21,8027,5,5,1, 8032
1,8031,1,1,0, 8032
5,8032,3,3,1, 8035
27,8032,4,4,1, 8036
6,8035,2,2,1, 8037
25,8035,2,2,1, 8037
7,8037,1,1,0, 8038
29,8038,4,4,1, 8042
8,8041,1,1,0, 8042
9,8042,2,2,1, 8044
14,8044,3,3,1, 8047
13,8044,4,4,1, 8048
15,8046,2,2,1, 8048
22,8051,4,4,1, 8055
24,8054,1,1,1, 8055
1,8056,1,1,0, 8057
5,8057,3,3,1, 8060
30,8058,3,3,1, 8061
25,8060,2,2,1, 8062
7,8062,1,1,0, 8063
26,8062,3,3,1, 8065
20,8073,6,6,1, 8079
24,8079,1,1,1, 8080
1,8081,1,1,1, 8082
5,8082,3,3,1, 8085
6,8085,2,2,1, 8087
25,8085,2,2,1, 8087
31,8086,2,2,1, 8088
7,8087,1,1,0, 8088
28,8084,5,5,1, 8089
29,8088,4,4,1, 8092
11,8089,4,4,1, 8093
12,8095,5,5,1, 8100
18,8098,4,4,1, 8102
24,8104,1,1,0, 8105
1,8106,1,1,0, 8107
3,8107,3,3,1, 8110
31,8111,2,2,1, 8113
7,8112,1,1,1, 8113
29,8113,4,4,1, 8117
24,8129,1,1,0, 8130
31,8136,2,2,1, 8138
7,8137,1,1,1, 8138
29,8138,4,4,1, 8142
24,8154,1,1,1, 8155
5,8157,3,3,1, 8160
6,8160,2,2,1, 8162
31,8161,2,2,1, 8163
7,8162,1,1,0, 8163
29,8163,4,4,1, 8167
8,8166,1,1,0, 8167
16,8169,2,2,1, 8171
14,8169,3,3,1, 8172
13,8169,4,4,1, 8173
15,8171,2,2,1, 8173
24,8179,1,1,1, 8180
23,8178,3,3,1, 8181
21,8177,5,5,1, 8182
5,8182,3,3,1, 8185
30,8183,3,3,1, 8186
7,8187,1,1,0, 8188
8,8191,1,1,1, 8192
14,8194,3,3,1, 8197
24,8204,1,1,1, 8205
5,8207,3,3,1, 8210
6,8210,2,2,1, 8212
31,8211,2,2,1, 8213
7,8212,1,1,0, 8213
29,8213,4,4,1, 8217
8,8216,1,1,0, 8217
16,8219,2,2,1, 8221
15,8221,2,2,1, 8223
22,8226,4,4,1, 8230
24,8229,1,1,0, 8230
21,8227,5,5,1, 8232
1,8231,1,1,1, 8232
30,8233,3,3,1, 8236
7,8237,1,1,1, 8238
8,8241,1,1,0, 8242
9,8242,2,2,1, 8244
14,8244,3,3,1, 8247
17,8244,3,3,1, 8247
13,8244,4,4,1, 8248
18,8248,4,4,1, 8252
24,8254,1,1,0, 8255
19,8251,5,5,1, 8256
23,8253,3,3,1, 8256
21,8252,5,5,1, 8257
1,8256,1,1,1, 8257
5,8257,3,3,1, 8260
30,8258,3,3,1, 8261
31,8261,2,2,1, 8263
7,8262,1,1,0, 8263
26,8262,3,3,1, 8265
29,8263,4,4,1, 8267
8,8266,1,1,1, 8267
9,8267,2,2,1, 8269
16,8269,2,2,1, 8271
17,8269,3,3,1, 8272
13,8269,4,4,1, 8273
15,8271,2,2,1, 8273
12,8270,5,5,1, 8275
18,8273,4,4,1, 8277
24,8279,1,1,1, 8280
19,8276,5,5,1, 8281
23,8278,3,3,1, 8281
1,8281,1,1,0, 8282
27,8282,4,4,1, 8286
7,8287,1,1,0, 8288
26,8287,3,3,1, 8290
29,8288,4,4,1, 8292
8,8291,1,1,0, 8292
9,8292,2,2,1, 8294
13,8294,4,4,1, 8298
2,8303,2,2,1, 8305
24,8304,1,1,1, 8305
1,8306,1,1,0, 8307
5,8307,3,3,1, 8310
31,8311,2,2,1, 8313
7,8312,1,1,0, 8313
29,8313,4,4,1, 8317
8,8316,1,1,1, 8317
16,8319,2,2,1, 8321
22,8326,4,4,1, 8330
2,8328,2,2,1, 8330
24,8329,1,1,1, 8330
23,8328,3,3,1, 8331
21,8327,5,5,1, 8332
1,8331,1,1,0, 8332
5,8332,3,3,1, 8335
30,8333,3,3,1, 8336
31,8336,2,2,1, 8338
7,8337,1,1,0, 8338
26,8337,3,3,1, 8340
29,8338,4,4,1, 8342
8,8341,1,1,0, 8342
9,8342,2,2,1, 8344
15,8346,2,2,1, 8348
18,8348,4,4,1, 8352
22,8351,4,4,1, 8355
24,8354,1,1,1, 8355
23,8353,3,3,1, 8356
21,8352,5,5,1, 8357
1,8356,1,1,0, 8357
30,8358,3,3,1, 8361
25,8360,2,2,1, 8362
7,8362,1,1,0, 8363
26,8362,3,3,1, 8365
29,8363,4,4,1, 8367
8,8366,1,1,1, 8367
17,8369,3,3,1, 8372
15,8371,2,2,1, 8373
22,8376,4,4,1, 8380
2,8378,2,2,1, 8380
24,8379,1,1,1, 8380
23,8378,3,3,1, 8381
1,8381,1,1,1, 8382
5,8382,3,3,1, 8385
30,8383,3,3,1, 8386
6,8385,2,2,1, 8387
25,8385,2,2,1, 8387
7,8387,1,1,1, 8388
26,8387,3,3,1, 8390
29,8388,4,4,1, 8392
9,8392,2,2,1, 8394
17,8394,3,3,1, 8397
2,8403,2,2,1, 8405
24,8404,1,1,0, 8405
19,8401,5,5,1, 8406
30,8408,3,3,1, 8411
6,8410,2,2,1, 8412
7,8412,1,1,0, 8413
29,8413,4,4,1, 8417
24,8429,1,1,0, 8430
24,8454,1,1,1, 8455
24,8479,1,1,1, 8480
8,8491,1,1,0, 8492
16,8494,2,2,1, 8496
14,8494,3,3,1, 8497
15,8496,2,2,1, 8498
24,8504,1,1,1, 8505
23,8503,3,3,1, 8506
21,8502,5,5,1, 8507
28,8509,5,5,1, 8514
26,8512,3,3,1, 8515
8,8516,1,1,1, 8517
9,8517,2,2,1, 8519
14,8519,3,3,1, 8522
13,8519,4,4,1, 8523
15,8521,2,2,1, 8523
24,8529,1,1,1, 8530
21,8527,5,5,1, 8532
1,8531,1,1,0, 8532
25,8535,2,2,1, 8537
31,8536,2,2,1, 8538
7,8537,1,1,1, 8538
8,8541,1,1,0, 8542
16,8544,2,2,1, 8546
24,8554,1,1,0, 8555
23,8553,3,3,1, 8556
1,8556,1,1,0, 8557
30,8558,3,3,1, 8561
6,8560,2,2,1, 8562
31,8561,2,2,1, 8563
7,8562,1,1,0, 8563
29,8563,4,4,1, 8567
8,8566,1,1,1, 8567
9,8567,2,2,1, 8569
16,8569,2,2,1, 8571
13,8569,4,4,1, 8573
15,8571,2,2,1, 8573
24,8579,1,1,1, 8580
23,8578,3,3,1, 8581
21,8577,5,5,1, 8582
1,8581,1,1,1, 8582
5,8582,3,3,1, 8585
30,8583,3,3,1, 8586
31,8586,2,2,1, 8588
7,8587,1,1,1, 8588
8,8591,1,1,1, 8592
14,8594,3,3,1, 8597
24,8604,1,1,0, 8605
23,8603,3,3,1, 8606
1,8606,1,1,1, 8607
30,8608,3,3,1, 8611
6,8610,2,2,1, 8612
25,8610,2,2,1, 8612
7,8612,1,1,1, 8613
29,8613,4,4,1, 8617
8,8616,1,1,0, 8617
9,8617,2,2,1, 8619
17,8619,3,3,1, 8622
13,8619,4,4,1, 8623
2,8628,2,2,1, 8630
24,8629,1,1,1, 8630
23,8628,3,3,1, 8631
21,8627,5,5,1, 8632
1,8631,1,1,0, 8632
6,8635,2,2,1, 8637
31,8636,2,2,1, 8638
7,8637,1,1,0, 8638
26,8637,3,3,1, 8640
29,8638,4,4,1, 8642
8,8641,1,1,1, 8642
14,8644,3,3,1, 8647
13,8644,4,4,1, 8648
24,8654,1,1,0, 8655
21,8652,5,5,1, 8657
1,8656,1,1,1, 8657
5,8657,3,3,1, 8660
30,8658,3,3,1, 8661
6,8660,2,2,1, 8662
25,8660,2,2,1, 8662
31,8661,2,2,1, 8663
7,8662,1,1,0, 8663
8,8666,1,1,1, 8667
14,8669,3,3,1, 8672
17,8669,3,3,1, 8672
18,8673,4,4,1, 8677
24,8679,1,1,1, 8680
23,8678,3,3,1, 8681
1,8681,1,1,0, 8682
5,8682,3,3,1, 8685
30,8683,3,3,1, 8686
6,8685,2,2,1, 8687
25,8685,2,2,1, 8687
31,8686,2,2,1, 8688
7,8687,1,1,0, 8688
8,8691,1,1,1, 8692
11,8689,4,4,1, 8693
16,8694,2,2,1, 8696
12,8695,5,5,1, 8700
18,8698,4,4,1, 8702
22,8701,4,4,1, 8705
24,8704,1,1,1, 8705
23,8703,3,3,1, 8706
1,8706,1,1,1, 8707
4,8706,4,4,1, 8710
3,8707,3,3,1, 8710
5,8707,3,3,1, 8710
30,8708,3,3,1, 8711
31,8711,2,2,1, 8713
7,8712,1,1,0, 8713
28,8709,5,5,1, 8714
26,8712,3,3,1, 8715
29,8713,4,4,1, 8717
8,8716,1,1,0, 8717
11,8714,4,4,1, 8718
16,8719,2,2,1, 8721
14,8719,3,3,1, 8722
17,8719,3,3,1, 8722
13,8719,4,4,1, 8723
15,8721,2,2,1, 8723
20,8723,6,6,1, 8729
24,8729,1,1,1, 8730
19,8726,5,5,1, 8731
1,8731,1,1,1, 8732
4,8731,4,4,1, 8735
27,8732,4,4,1, 8736
6,8735,2,2,1, 8737
7,8737,1,1,1, 8738
28,8734,5,5,1, 8739
11,8739,4,4,1, 8743
9,8742,2,2,1, 8744
12,8745,5,5,1, 8750
18,8748,4,4,1, 8752
24,8754,1,1,0, 8755
19,8751,5,5,1, 8756
1,8756,1,1,0, 8757
6,8760,2,2,1, 8762
7,8762,1,1,0, 8763
29,8763,4,4,1, 8767
9,8767,2,2,1, 8769
17,8769,3,3,1, 8772
24,8779,1,1,1, 8780
30,8783,3,3,1, 8786
6,8785,2,2,1, 8787
7,8787,1,1,1, 8788
24,8804,1,1,0, 8805
31,8811,2,2,1, 8813
7,8812,1,1,0, 8813
22,8826,4,4,1, 8830
24,8829,1,1,0, 8830
23,8828,3,3,1, 8831
21,8827,5,5,1, 8832
5,8832,3,3,1, 8835
31,8836,2,2,1, 8838
7,8837,1,1,1, 8838
29,8838,4,4,1, 8842
8,8841,1,1,0, 8842
16,8844,2,2,1, 8846
13,8844,4,4,1, 8848
15,8846,2,2,1, 8848
24,8854,1,1,1, 8855
23,8853,3,3,1, 8856
5,8857,3,3,1, 8860
6,8860,2,2,1, 8862
7,8862,1,1,0, 8863
29,8863,4,4,1, 8867
8,8866,1,1,0, 8867
15,8871,2,2,1, 8873
24,8879,1,1,1, 8880
23,8878,3,3,1, 8881
21,8877,5,5,1, 8882
1,8881,1,1,1, 8882
5,8882,3,3,1, 8885
30,8883,3,3,1, 8886
6,8885,2,2,1, 8887
25,8885,2,2,1, 8887
7,8887,1,1,0, 8888
29,8888,4,4,1, 8892
8,8891,1,1,1, 8892
14,8894,3,3,1, 8897
13,8894,4,4,1, 8898
22,8901,4,4,1, 8905
24,8904,1,1,1, 8905
21,8902,5,5,1, 8907
1,8906,1,1,1, 8907
7,8912,1,1,0, 8913
29,8913,4,4,1, 8917
8,8916,1,1,1, 8917
9,8917,2,2,1, 8919
17,8919,3,3,1, 8922
18,8923,4,4,1, 8927
2,8928,2,2,1, 8930
24,8929,1,1,0, 8930
19,8926,5,5,1, 8931
21,8927,5,5,1, 8932
1,8931,1,1,1, 8932
4,8931,4,4,1, 8935
27,8932,4,4,1, 8936
25,8935,2,2,1, 8937
31,8936,2,2,1, 8938
7,8937,1,1,1, 8938
8,8941,1,1,0, 8942
11,8939,4,4,1, 8943
9,8942,2,2,1, 8944
16,8944,2,2,1, 8946
13,8944,4,4,1, 8948
15,8946,2,2,1, 8948
18,8948,4,4,1, 8952
24,8954,1,1,1, 8955
19,8951,5,5,1, 8956
1,8956,1,1,1, 8957
5,8957,3,3,1, 8960
27,8957,4,4,1, 8961
30,8958,3,3,1, 8961
6,8960,2,2,1, 8962
7,8962,1,1,0, 8963
28,8959,5,5,1, 8964
26,8962,3,3,1, 8965
8,8966,1,1,0, 8967
9,8967,2,2,1, 8969
14,8969,3,3,1, 8972
17,8969,3,3,1, 8972
15,8971,2,2,1, 8973
18,8973,4,4,1, 8977
22,8976,4,4,1, 8980
24,8979,1,1,0, 8980
23,8978,3,3,1, 8981
21,8977,5,5,1, 8982
1,8981,1,1,0, 8982
3,8982,3,3,1, 8985
5,8982,3,3,1, 8985
27,8982,4,4,1, 8986
30,8983,3,3,1, 8986
7,8987,1,1,1, 8988
28,8984,5,5,1, 8989
26,8987,3,3,1, 8990
8,8991,1,1,0, 8992
14,8994,3,3,1, 8997
13,8994,4,4,1, 8998
15,8996,2,2,1, 8998
22,9001,4,4,1, 9005
24,9004,1,1,0, 9005
21,9002,5,5,1, 9007
5,9007,3,3,1, 9010
30,9008,3,3,1, 9011
6,9010,2,2,1, 9012
7,9012,1,1,0, 9013
8,9016,1,1,1, 9017
16,9019,2,2,1, 9021
22,9026,4,4,1, 9030
24,9029,1,1,0, 9030
5,9032,3,3,1, 9035
31,9036,2,2,1, 9038
7,9037,1,1,1, 9038
8,9041,1,1,0, 9042
16,9044,2,2,1, 9046
15,9046,2,2,1, 9048
24,9054,1,1,0, 9055
23,9053,3,3,1, 9056
5,9057,3,3,1, 9060
6,9060,2,2,1, 9062
31,9061,2,2,1, 9063
7,9062,1,1,0, 9063
24,9079,1,1,1, 9080
5,9082,3,3,1, 9085
30,9083,3,3,1, 9086
31,9086,2,2,1, 9088
7,9087,1,1,1, 9088
24,9104,1,1,1, 9105
1,9106,1,1,0, 9107
5,9107,3,3,1, 9110
30,9108,3,3,1, 9111
25,9110,2,2,1, 9112
7,9112,1,1,0, 9113
29,9113,4,4,1, 9117
24,9129,1,1,1, 9130
1,9131,1,1,1, 9132
25,9135,2,2,1, 9137
24,9154,1,1,0, 9155
1,9156,1,1,1, 9157
8,9166,1,1,0, 9167
17,9169,3,3,1, 9172
15,9171,2,2,1, 9173
2,9178,2,2,1, 9180
24,9179,1,1,1, 9180
23,9178,3,3,1, 9181
1,9181,1,1,1, 9182
25,9185,2,2,1, 9187
8,9191,1,1,0, 9192
9,9192,2,2,1, 9194
16,9194,2,2,1, 9196
18,9198,4,4,1, 9202
24,9204,1,1,1, 9205
23,9203,3,3,1, 9206
1,9206,1,1,0, 9207
25,9210,2,2,1, 9212
26,9212,3,3,1, 9215
8,9216,1,1,1, 9217
16,9219,2,2,1, 9221
22,9226,4,4,1, 9230
24,9229,1,1,0, 9230
1,9231,1,1,0, 9232
5,9232,3,3,1, 9235
6,9235,2,2,1, 9237
25,9235,2,2,1, 9237
31,9236,2,2,1, 9238
7,9237,1,1,1, 9238
29,9238,4,4,1, 9242
8,9241,1,1,1, 9242
13,9244,4,4,1, 9248
20,9248,6,6,1, 9254
24,9254,1,1,1, 9255
19,9251,5,5,1, 9256
23,9253,3,3,1, 9256
21,9252,5,5,1, 9257
1,9256,1,1,1, 9257
3,9257,3,3,1, 9260
5,9257,3,3,1, 9260
27,9257,4,4,1, 9261
6,9260,2,2,1, 9262
31,9261,2,2,1, 9263
7,9262,1,1,0, 9263
26,9262,3,3,1, 9265
29,9263,4,4,1, 9267
8,9266,1,1,1, 9267
16,9269,2,2,1, 9271
13,9269,4,4,1, 9273
15,9271,2,2,1, 9273
18,9273,4,4,1, 9277
20,9273,6,6,1, 9279
22,9276,4,4,1, 9280
24,9279,1,1,0, 9280
23,9278,3,3,1, 9281
21,9277,5,5,1, 9282
1,9281,1,1,0, 9282
5,9282,3,3,1, 9285
30,9283,3,3,1, 9286
6,9285,2,2,1, 9287
31,9286,2,2,1, 9288
7,9287,1,1,0, 9288
29,9288,4,4,1, 9292
8,9291,1,1,0, 9292
11,9289,4,4,1, 9293
16,9294,2,2,1, 9296
18,9298,4,4,1, 9302
22,9301,4,4,1, 9305
24,9304,1,1,1, 9305
21,9302,5,5,1, 9307
1,9306,1,1,0, 9307
4,9306,4,4,1, 9310
31,9311,2,2,1, 9313
7,9312,1,1,1, 9313
29,9313,4,4,1, 9317
8,9316,1,1,0, 9317
15,9321,2,2,1, 9323
2,9328,2,2,1, 9330
24,9329,1,1,0, 9330
19,9326,5,5,1, 9331
23,9328,3,3,1, 9331
21,9327,5,5,1, 9332
1,9331,1,1,0, 9332
3,9332,3,3,1, 9335
27,9332,4,4,1, 9336
30,9333,3,3,1, 9336
25,9335,2,2,1, 9337
7,9337,1,1,0, 9338
8,9341,1,1,0, 9342
9,9342,2,2,1, 9344
17,9344,3,3,1, 9347
12,9345,5,5,1, 9350
2,9353,2,2,1, 9355
24,9354,1,1,0, 9355
21,9352,5,5,1, 9357
1,9356,1,1,1, 9357
27,9357,4,4,1, 9361
30,9358,3,3,1, 9361
6,9360,2,2,1, 9362
7,9362,1,1,1, 9363
29,9363,4,4,1, 9367
8,9366,1,1,1, 9367
11,9364,4,4,1, 9368
16,9369,2,2,1, 9371
15,9371,2,2,1, 9373
12,9370,5,5,1, 9375
20,9373,6,6,1, 9379
2,9378,2,2,1, 9380
24,9379,1,1,0, 9380
19,9376,5,5,1, 9381
21,9377,5,5,1, 9382
1,9381,1,1,0, 9382
4,9381,4,4,1, 9385
3,9382,3,3,1, 9385
31,9386,2,2,1, 9388
7,9387,1,1,0, 9388
8,9391,1,1,1, 9392
14,9394,3,3,1, 9397
24,9404,1,1,0, 9405
23,9403,3,3,1, 9406
5,9407,3,3,1, 9410
30,9408,3,3,1, 9411
7,9412,1,1,0, 9413
8,9416,1,1,1, 9417
16,9419,2,2,1, 9421
13,9419,4,4,1, 9423
24,9429,1,1,1, 9430
23,9428,3,3,1, 9431
5,9432,3,3,1, 9435
31,9436,2,2,1, 9438
7,9437,1,1,0, 9438
8,9441,1,1,0, 9442
14,9444,3,3,1, 9447
22,9451,4,4,1, 9455
24,9454,1,1,1, 9455
21,9452,5,5,1, 9457
31,9461,2,2,1, 9463
7,9462,1,1,0, 9463
8,9466,1,1,1, 9467
16,9469,2,2,1, 9471
13,9469,4,4,1, 9473
15,9471,2,2,1, 9473
22,9476,4,4,1, 9480
24,9479,1,1,0, 9480
21,9477,5,5,1, 9482
5,9482,3,3,1, 9485
30,9483,3,3,1, 9486
6,9485,2,2,1, 9487
31,9486,2,2,1, 9488
7,9487,1,1,0, 9488
29,9488,4,4,1, 9492
9,9492,2,2,1, 9494
24,9504,1,1,1, 9505
1,9506,1,1,0, 9507
30,9508,3,3,1, 9511
25,9510,2,2,1, 9512
7,9512,1,1,1, 9513
24,9529,1,1,0, 9530
1,9531,1,1,0, 9532
30,9533,3,3,1, 9536
6,9535,2,2,1, 9537
31,9536,2,2,1, 9538
7,9537,1,1,0, 9538
29,9538,4,4,1, 9542
18,9548,4,4,1, 9552
2,9553,2,2,1, 9555
24,9554,1,1,0, 9555
1,9556,1,1,0, 9557
30,9558,3,3,1, 9561
7,9562,1,1,1, 9563
26,9562,3,3,1, 9565
11,9564,4,4,1, 9568
9,9567,2,2,1, 9569
17,9569,3,3,1, 9572
18,9573,4,4,1, 9577
20,9573,6,6,1, 9579
2,9578,2,2,1, 9580
24,9579,1,1,1, 9580
19,9576,5,5,1, 9581
1,9581,1,1,1, 9582
3,9582,3,3,1, 9585
25,9585,2,2,1, 9587
31,9586,2,2,1, 9588
7,9587,1,1,1, 9588
26,9587,3,3,1, 9590
29,9588,4,4,1, 9592
8,9591,1,1,1, 9592
17,9594,3,3,1, 9597
13,9594,4,4,1, 9598
12,9595,5,5,1, 9600
18,9598,4,4,1, 9602
20,9598,6,6,1, 9604
22,9601,4,4,1, 9605
24,9604,1,1,0, 9605
19,9601,5,5,1, 9606
23,9603,3,3,1, 9606
1,9606,1,1,1, 9607
4,9606,4,4,1, 9610
3,9607,3,3,1, 9610
5,9607,3,3,1, 9610
27,9607,4,4,1, 9611
25,9610,2,2,1, 9612
7,9612,1,1,0, 9613
26,9612,3,3,1, 9615
8,9616,1,1,1, 9617
14,9619,3,3,1, 9622
13,9619,4,4,1, 9623
22,9626,4,4,1, 9630
24,9629,1,1,1, 9630
6,9635,2,2,1, 9637
7,9637,1,1,0, 9638
8,9641,1,1,1, 9642
16,9644,2,2,1, 9646
14,9644,3,3,1, 9647
22,9651,4,4,1, 9655
24,9654,1,1,0, 9655
23,9653,3,3,1, 9656
5,9657,3,3,1, 9660
7,9662,1,1,0, 9663
8,9666,1,1,0, 9667
16,9669,2,2,1, 9671
13,9669,4,4,1, 9673
22,9676,4,4,1, 9680
24,9679,1,1,1, 9680
23,9678,3,3,1, 9681
6,9685,2,2,1, 9687
7,9687,1,1,1, 9688
29,9688,4,4,1, 9692
8,9691,1,1,0, 9692
16,9694,2,2,1, 9696
22,9701,4,4,1, 9705
24,9704,1,1,0, 9705
23,9703,3,3,1, 9706
30,9708,3,3,1, 9711
7,9712,1,1,0, 9713
29,9713,4,4,1, 9717
8,9716,1,1,1, 9717
13,9719,4,4,1, 9723
15,9721,2,2,1, 9723
24,9729,1,1,1, 9730
1,9731,1,1,0, 9732
5,9732,3,3,1, 9735
30,9733,3,3,1, 9736
6,9735,2,2,1, 9737
25,9735,2,2,1, 9737
7,9737,1,1,1, 9738
29,9738,4,4,1, 9742
8,9741,1,1,0, 9742
17,9744,3,3,1, 9747
13,9744,4,4,1, 9748
18,9748,4,4,1, 9752
2,9753,2,2,1, 9755
24,9754,1,1,0, 9755
23,9753,3,3,1, 9756
21,9752,5,5,1, 9757
1,9756,1,1,0, 9757
5,9757,3,3,1, 9760
30,9758,3,3,1, 9761
6,9760,2,2,1, 9762
25,9760,2,2,1, 9762
31,9761,2,2,1, 9763
7,9762,1,1,1, 9763
26,9762,3,3,1, 9765
8,9766,1,1,0, 9767
17,9769,3,3,1, 9772
13,9769,4,4,1, 9773
15,9771,2,2,1, 9773
22,9776,4,4,1, 9780
24,9779,1,1,0, 9780
1,9781,1,1,0, 9782
5,9782,3,3,1, 9785
30,9783,3,3,1, 9786
6,9785,2,2,1, 9787
25,9785,2,2,1, 9787
31,9786,2,2,1, 9788
7,9787,1,1,0, 9788
26,9787,3,3,1, 9790
8,9791,1,1,0, 9792
9,9792,2,2,1, 9794
14,9794,3,3,1, 9797
17,9794,3,3,1, 9797
13,9794,4,4,1, 9798
18,9798,4,4,1, 9802
2,9803,2,2,1, 9805
24,9804,1,1,0, 9805
23,9803,3,3,1, 9806
1,9806,1,1,0, 9807
5,9807,3,3,1, 9810
30,9808,3,3,1, 9811
6,9810,2,2,1, 9812
31,9811,2,2,1, 9813
7,9812,1,1,1, 9813
8,9816,1,1,0, 9817
9,9817,2,2,1, 9819
16,9819,2,2,1, 9821
14,9819,3,3,1, 9822
17,9819,3,3,1, 9822
15,9821,2,2,1, 9823
12,9820,5,5,1, 9825
20,9823,6,6,1, 9829
24,9829,1,1,0, 9830
19,9826,5,5,1, 9831
23,9828,3,3,1, 9831
1,9831,1,1,1, 9832
4,9831,4,4,1, 9835
30,9833,3,3,1, 9836
7,9837,1,1,1, 9838
28,9834,5,5,1, 9839
26,9837,3,3,1, 9840
8,9841,1,1,0, 9842
16,9844,2,2,1, 9846
18,9848,4,4,1, 9852
2,9853,2,2,1, 9855
24,9854,1,1,0, 9855
19,9851,5,5,1, 9856
1,9856,1,1,0, 9857
30,9858,3,3,1, 9861
6,9860,2,2,1, 9862
25,9860,2,2,1, 9862
7,9862,1,1,1, 9863
24,9879,1,1,1, 9880
5,9882,3,3,1, 9885
7,9887,1,1,0, 9888
29,9888,4,4,1, 9892
24,9904,1,1,0, 9905
5,9907,3,3,1, 9910
30,9908,3,3,1, 9911
31,9911,2,2,1, 9913
7,9912,1,1,0, 9913
24,9929,1,1,0, 9930
5,9932,3,3,1, 9935
7,9937,1,1,0, 9938
22,9951,4,4,1, 9955
24,9954,1,1,0, 9955
5,9957,3,3,1, 9960
30,9958,3,3,1, 9961
31,9961,2,2,1, 9963
7,9962,1,1,1, 9963
29,9963,4,4,1, 9967
8,9966,1,1,0, 9967
16,9969,2,2,1, 9971
17,9969,3,3,1, 9972
24,9979,1,1,0, 9980
23,9978,3,3,1, 9981
1,9981,1,1,0, 9982
3,9982,3,3,1, 9985
27,9982,4,4,1, 9986
8,9991,1,1,0, 9992
24,10004,1,1,1, 10005
23,10003,3,3,1, 10006
1,10006,1,1,1, 10007
4,10006,4,4,1, 10010
25,10010,2,2,1, 10012
26,10012,3,3,1, 10015
8,10016,1,1,0, 10017
11,10014,4,4,1, 10018
9,10017,2,2,1, 10019
15,10021,2,2,1, 10023
12,10020,5,5,1, 10025
24,10029,1,1,0, 10030
1,10031,1,1,0, 10032
8,10041,1,1,0, 10042
9,10042,2,2,1, 10044
16,10044,2,2,1, 10046
17,10044,3,3,1, 10047
22,10051,4,4,1, 10055
24,10054,1,1,1, 10055
23,10053,3,3,1, 10056
21,10052,5,5,1, 10057
1,10056,1,1,0, 10057
8,10066,1,1,0, 10067
9,10067,2,2,1, 10069
15,10071,2,2,1, 10073
22,10076,4,4,1, 10080
24,10079,1,1,1, 10080
23,10078,3,3,1, 10081
21,10077,5,5,1, 10082
1,10081,1,1,0, 10082
5,10082,3,3,1, 10085
30,10083,3,3,1, 10086
25,10085,2,2,1, 10087
31,10086,2,2,1, 10088
7,10087,1,1,0, 10088
29,10088,4,4,1, 10092
8,10091,1,1,0, 10092
9,10092,2,2,1, 10094
16,10094,2,2,1, 10096
13,10094,4,4,1, 10098
24,10104,1,1,0, 10105
1,10106,1,1,0, 10107
5,10107,3,3,1, 10110
30,10108,3,3,1, 10111
31,10111,2,2,1, 10113
7,10112,1,1,1, 10113
29,10113,4,4,1, 10117
8,10116,1,1,0, 10117
16,10119,2,2,1, 10121
14,10119,3,3,1, 10122
17,10119,3,3,1, 10122
22,10126,4,4,1, 10130
2,10128,2,2,1, 10130
24,10129,1,1,0, 10130
19,10126,5,5,1, 10131
23,10128,3,3,1, 10131
1,10131,1,1,0, 10132
3,10132,3,3,1, 10135
25,10135,2,2,1, 10137
7,10137,1,1,0, 10138
26,10137,3,3,1, 10140
29,10138,4,4,1, 10142
8,10141,1,1,0, 10142
11,10139,4,4,1, 10143
16,10144,2,2,1, 10146
12,10145,5,5,1, 10150
20,10148,6,6,1, 10154
22,10151,4,4,1, 10155
24,10154,1,1,0, 10155
19,10151,5,5,1, 10156
23,10153,3,3,1, 10156
1,10156,1,1,1, 10157
4,10156,4,4,1, 10160
3,10157,3,3,1, 10160
27,10157,4,4,1, 10161
25,10160,2,2,1, 10162
7,10162,1,1,0, 10163
28,10159,5,5,1, 10164
8,10166,1,1,1, 10167
17,10169,3,3,1, 10172
13,10169,4,4,1, 10173
15,10171,2,2,1, 10173
18,10173,4,4,1, 10177
2,10178,2,2,1, 10180
24,10179,1,1,0, 10180
23,10178,3,3,1, 10181
21,10177,5,5,1, 10182
1,10181,1,1,1, 10182
5,10182,3,3,1, 10185
30,10183,3,3,1, 10186
25,10185,2,2,1, 10187
31,10186,2,2,1, 10188
7,10187,1,1,0, 10188
29,10188,4,4,1, 10192
8,10191,1,1,0, 10192
16,10194,2,2,1, 10196
14,10194,3,3,1, 10197
13,10194,4,4,1, 10198
15,10196,2,2,1, 10198
24,10204,1,1,0, 10205
23,10203,3,3,1, 10206
21,10202,5,5,1, 10207
5,10207,3,3,1, 10210
6,10210,2,2,1, 10212
31,10211,2,2,1, 10213
7,10212,1,1,0, 10213
8,10216,1,1,1, 10217
15,10221,2,2,1, 10223
24,10229,1,1,1, 10230
21,10227,5,5,1, 10232
6,10235,2,2,1, 10237
7,10237,1,1,0, 10238
29,10238,4,4,1, 10242
8,10241,1,1,0, 10242
14,10244,3,3,1, 10247
15,10246,2,2,1, 10248
24,10254,1,1,0, 10255
5,10257,3,3,1, 10260
30,10258,3,3,1, 10261
6,10260,2,2,1, 10262
7,10262,1,1,0, 10263
8,10266,1,1,0, 10267
16,10269,2,2,1, 10271
15,10271,2,2,1, 10273
24,10279,1,1,0, 10280
23,10278,3,3,1, 10281
21,10277,5,5,1, 10282
7,10287,1,1,0, 10288
18,10298,4,4,1, 10302
20,10298,6,6,1, 10304
2,10303,2,2,1, 10305
24,10304,1,1,0, 10305
1,10306,1,1,1, 10307
4,10306,4,4,1, 10310
5,10307,3,3,1, 10310
25,10310,2,2,1, 10312
7,10312,1,1,0, 10313
28,10309,5,5,1, 10314
11,10314,4,4,1, 10318
9,10317,2,2,1, 10319
12,10320,5,5,1, 10325
18,10323,4,4,1, 10327
24,10329,1,1,0, 10330
19,10326,5,5,1, 10331
1,10331,1,1,1, 10332
30,10333,3,3,1, 10336
6,10335,2,2,1, 10337
31,10336,2,2,1, 10338
7,10337,1,1,0, 10338
17,10344,3,3,1, 10347
24,10354,1,1,1, 10355
1,10356,1,1,0, 10357
5,10357,3,3,1, 10360
6,10360,2,2,1, 10362
7,10362,1,1,0, 10363
29,10363,4,4,1, 10367
9,10367,2,2,1, 10369
17,10369,3,3,1, 10372
24,10379,1,1,0, 10380
1,10381,1,1,0, 10382
5,10382,3,3,1, 10385
30,10383,3,3,1, 10386
25,10385,2,2,1, 10387
31,10386,2,2,1, 10388
7,10387,1,1,1, 10388
8,10391,1,1,1, 10392
9,10392,2,2,1, 10394
16,10394,2,2,1, 10396
13,10394,4,4,1, 10398
15,10396,2,2,1, 10398
24,10404,1,1,0, 10405
21,10402,5,5,1, 10407
1,10406,1,1,1, 10407
30,10408,3,3,1, 10411
6,10410,2,2,1, 10412
25,10410,2,2,1, 10412
7,10412,1,1,0, 10413
29,10413,4,4,1, 10417
8,10416,1,1,0, 10417
9,10417,2,2,1, 10419
17,10419,3,3,1, 10422
13,10419,4,4,1, 10423
15,10421,2,2,1, 10423
24,10429,1,1,1, 10430
21,10427,5,5,1, 10432
1,10431,1,1,0, 10432
6,10435,2,2,1, 10437
7,10437,1,1,1, 10438
26,10437,3,3,1, 10440
29,10438,4,4,1, 10442
8,10441,1,1,0, 10442
11,10439,4,4,1, 10443
14,10444,3,3,1, 10447
15,10446,2,2,1, 10448
12,10445,5,5,1, 10450
18,10448,4,4,1, 10452
2,10453,2,2,1, 10455
24,10454,1,1,0, 10455
19,10451,5,5,1, 10456
1,10456,1,1,1, 10457
4,10456,4,4,1, 10460
3,10457,3,3,1, 10460
5,10457,3,3,1, 10460
30,10458,3,3,1, 10461
7,10462,1,1,1, 10463
26,10462,3,3,1, 10465
29,10463,4,4,1, 10467
8,10466,1,1,0, 10467
14,10469,3,3,1, 10472
13,10469,4,4,1, 10473
15,10471,2,2,1, 10473
22,10476,4,4,1, 10480
24,10479,1,1,1, 10480
23,10478,3,3,1, 10481
21,10477,5,5,1, 10482
30,10483,3,3,1, 10486
6,10485,2,2,1, 10487
7,10487,1,1,0, 10488
29,10488,4,4,1, 10492
8,10491,1,1,0, 10492
13,10494,4,4,1, 10498
15,10496,2,2,1, 10498
24,10504,1,1,1, 10505
6,10510,2,2,1, 10512
7,10512,1,1,1, 10513
29,10513,4,4,1, 10517
8,10516,1,1,0, 10517
16,10519,2,2,1, 10521
13,10519,4,4,1, 10523
15,10521,2,2,1, 10523
24,10529,1,1,0, 10530
23,10528,3,3,1, 10531
21,10527,5,5,1, 10532
30,10533,3,3,1, 10536
6,10535,2,2,1, 10537
7,10537,1,1,1, 10538
29,10538,4,4,1, 10542
8,10541,1,1,1, 10542
13,10544,4,4,1, 10548
24,10554,1,1,0, 10555
21,10552,5,5,1, 10557
30,10558,3,3,1, 10561
6,10560,2,2,1, 10562
7,10562,1,1,1, 10563
8,10566,1,1,0, 10567
17,10569,3,3,1, 10572
22,10576,4,4,1, 10580
2,10578,2,2,1, 10580
24,10579,1,1,0, 10580
21,10577,5,5,1, 10582
1,10581,1,1,0, 10582
4,10581,4,4,1, 10585
3,10582,3,3,1, 10585
25,10585,2,2,1, 10587
31,10586,2,2,1, 10588
7,10587,1,1,1, 10588
29,10588,4,4,1, 10592
8,10591,1,1,1, 10592
9,10592,2,2,1, 10594
16,10594,2,2,1, 10596
14,10594,3,3,1, 10597
17,10594,3,3,1, 10597
15,10596,2,2,1, 10598
18,10598,4,4,1, 10602
24,10604,1,1,0, 10605
19,10601,5,5,1, 10606
23,10603,3,3,1, 10606
1,10606,1,1,0, 10607
4,10606,4,4,1, 10610
6,10610,2,2,1, 10612
25,10610,2,2,1, 10612
7,10612,1,1,0, 10613
29,10613,4,4,1, 10617
8,10616,1,1,1, 10617
16,10619,2,2,1, 10621
15,10621,2,2,1, 10623
12,10620,5,5,1, 10625
2,10628,2,2,1, 10630
24,10629,1,1,0, 10630
19,10626,5,5,1, 10631
1,10631,1,1,0, 10632
3,10632,3,3,1, 10635
5,10632,3,3,1, 10635
27,10632,4,4,1, 10636
30,10633,3,3,1, 10636
25,10635,2,2,1, 10637
31,10636,2,2,1, 10638
7,10637,1,1,0, 10638
26,10637,3,3,1, 10640
29,10638,4,4,1, 10642
11,10639,4,4,1, 10643
9,10642,2,2,1, 10644
17,10644,3,3,1, 10647
18,10648,4,4,1, 10652
20,10648,6,6,1, 10654
24,10654,1,1,1, 10655
30,10658,3,3,1, 10661
6,10660,2,2,1, 10662
31,10661,2,2,1, 10663
7,10662,1,1,0, 10663
29,10663,4,4,1, 10667
24,10679,1,1,1, 10680
24,10704,1,1,1, 10705
24,10729,1,1,0, 10730
21,10727,5,5,1, 10732
8,10741,1,1,1, 10742
15,10746,2,2,1, 10748
22,10751,4,4,1, 10755
24,10754,1,1,1, 10755
21,10752,5,5,1, 10757
8,10766,1,1,1, 10767
9,10767,2,2,1, 10769
16,10769,2,2,1, 10771
14,10769,3,3,1, 10772
13,10769,4,4,1, 10773
15,10771,2,2,1, 10773
24,10779,1,1,0, 10780
23,10778,3,3,1, 10781
21,10777,5,5,1, 10782
1,10781,1,1,0, 10782
5,10782,3,3,1, 10785
6,10785,2,2,1, 10787
31,10786,2,2,1, 10788
7,10787,1,1,1, 10788
28,10784,5,5,1, 10789
8,10791,1,1,1, 10792
11,10789,4,4,1, 10793
9,10792,2,2,1, 10794
16,10794,2,2,1, 10796
17,10794,3,3,1, 10797
20,10798,6,6,1, 10804
24,10804,1,1,1, 10805
19,10801,5,5,1, 10806
1,10806,1,1,0, 10807
5,10807,3,3,1, 10810
27,10807,4,4,1, 10811
30,10808,3,3,1, 10811
6,10810,2,2,1, 10812
25,10810,2,2,1, 10812
31,10811,2,2,1, 10813
7,10812,1,1,1, 10813
29,10813,4,4,1, 10817
8,10816,1,1,0, 10817
11,10814,4,4,1, 10818
17,10819,3,3,1, 10822
13,10819,4,4,1, 10823
18,10823,4,4,1, 10827
22,10826,4,4,1, 10830
2,10828,2,2,1, 10830
24,10829,1,1,1, 10830
23,10828,3,3,1, 10831
1,10831,1,1,0, 10832
5,10832,3,3,1, 10835
7,10837,1,1,1, 10838
29,10838,4,4,1, 10842
8,10841,1,1,0, 10842
9,10842,2,2,1, 10844
14,10844,3,3,1, 10847
17,10844,3,3,1, 10847
13,10844,4,4,1, 10848
15,10846,2,2,1, 10848
24,10854,1,1,1, 10855
1,10856,1,1,1, 10857
25,10860,2,2,1, 10862
31,10861,2,2,1, 10863
7,10862,1,1,0, 10863
26,10862,3,3,1, 10865
29,10863,4,4,1, 10867
8,10866,1,1,1, 10867
9,10867,2,2,1, 10869
16,10869,2,2,1, 10871
15,10871,2,2,1, 10873
18,10873,4,4,1, 10877
24,10879,1,1,0, 10880
23,10878,3,3,1, 10881
1,10881,1,1,0, 10882
25,10885,2,2,1, 10887
31,10886,2,2,1, 10888
7,10887,1,1,0, 10888
29,10888,4,4,1, 10892
8,10891,1,1,0, 10892
9,10892,2,2,1, 10894
14,10894,3,3,1, 10897
13,10894,4,4,1, 10898
15,10896,2,2,1, 10898
18,10898,4,4,1, 10902
22,10901,4,4,1, 10905
24,10904,1,1,0, 10905
21,10902,5,5,1, 10907
1,10906,1,1,0, 10907
5,10907,3,3,1, 10910
30,10908,3,3,1, 10911
25,10910,2,2,1, 10912
31,10911,2,2,1, 10913
7,10912,1,1,0, 10913
29,10913,4,4,1, 10917
8,10916,1,1,0, 10917
9,10917,2,2,1, 10919
16,10919,2,2,1, 10921
14,10919,3,3,1, 10922
17,10919,3,3,1, 10922
15,10921,2,2,1, 10923
12,10920,5,5,1, 10925
18,10923,4,4,1, 10927
20,10923,6,6,1, 10929
22,10926,4,4,1, 10930
24,10929,1,1,0, 10930
21,10927,5,5,1, 10932
6,10935,2,2,1, 10937
7,10937,1,1,0, 10938
29,10938,4,4,1, 10942
24,10954,1,1,1, 10955
30,10958,3,3,1, 10961
6,10960,2,2,1, 10962
7,10962,1,1,1, 10963
29,10963,4,4,1, 10967
24,10979,1,1,1, 10980
5,10982,3,3,1, 10985
6,10985,2,2,1, 10987
7,10987,1,1,0, 10988
29,10988,4,4,1, 10992
24,11004,1,1,0, 11005
30,11008,3,3,1, 11011
7,11012,1,1,1, 11013
29,11013,4,4,1, 11017
24,11029,1,1,0, 11030
5,11032,3,3,1, 11035
27,11032,4,4,1, 11036
25,11035,2,2,1, 11037
31,11036,2,2,1, 11038
7,11037,1,1,0, 11038
28,11034,5,5,1, 11039
8,11041,1,1,0, 11042
11,11039,4,4,1, 11043
16,11044,2,2,1, 11046
17,11044,3,3,1, 11047
13,11044,4,4,1, 11048
22,11051,4,4,1, 11055
24,11054,1,1,1, 11055
1,11056,1,1,1, 11057
6,11060,2,2,1, 11062
7,11062,1,1,1, 11063
8,11066,1,1,1, 11067
14,11069,3,3,1, 11072
22,11076,4,4,1, 11080
24,11079,1,1,0, 11080
21,11077,5,5,1, 11082
1,11081,1,1,0, 11082
30,11083,3,3,1, 11086
6,11085,2,2,1, 11087
25,11085,2,2,1, 11087
7,11087,1,1,1, 11088
8,11091,1,1,0, 11092
9,11092,2,2,1, 11094
16,11094,2,2,1, 11096
17,11094,3,3,1, 11097
13,11094,4,4,1, 11098
24,11104,1,1,0, 11105
1,11106,1,1,0, 11107
30,11108,3,3,1, 11111
25,11110,2,2,1, 11112
7,11112,1,1,0, 11113
8,11116,1,1,0, 11117
16,11119,2,2,1, 11121
17,11119,3,3,1, 11122
13,11119,4,4,1, 11123
15,11121,2,2,1, 11123
24,11129,1,1,1, 11130
23,11128,3,3,1, 11131
21,11127,5,5,1, 11132
1,11131,1,1,0, 11132
5,11132,3,3,1, 11135
6,11135,2,2,1, 11137
31,11136,2,2,1, 11138
7,11137,1,1,1, 11138
29,11138,4,4,1, 11142
8,11141,1,1,1, 11142
9,11142,2,2,1, 11144
15,11146,2,2,1, 11148
18,11148,4,4,1, 11152
22,11151,4,4,1, 11155
24,11154,1,1,1, 11155
23,11153,3,3,1, 11156
1,11156,1,1,1, 11157
6,11160,2,2,1, 11162
7,11162,1,1,0, 11163
29,11163,4,4,1, 11167
8,11166,1,1,1, 11167
14,11169,3,3,1, 11172
17,11169,3,3,1, 11172
13,11169,4,4,1, 11173
18,11173,4,4,1, 11177
24,11179,1,1,0, 11180
21,11177,5,5,1, 11182
1,11181,1,1,0, 11182
30,11183,3,3,1, 11186
7,11187,1,1,0, 11188
26,11187,3,3,1, 11190
29,11188,4,4,1, 11192
8,11191,1,1,0, 11192
9,11192,2,2,1, 11194
16,11194,2,2,1, 11196
18,11198,4,4,1, 11202
24,11204,1,1,1, 11205
23,11203,3,3,1, 11206
21,11202,5,5,1, 11207
1,11206,1,1,0, 11207
25,11210,2,2,1, 11212
31,11211,2,2,1, 11213
7,11212,1,1,0, 11213
8,11216,1,1,0, 11217
16,11219,2,2,1, 11221
13,11219,4,4,1, 11223
15,11221,2,2,1, 11223
22,11226,4,4,1, 11230
2,11228,2,2,1, 11230
24,11229,1,1,0, 11230
23,11228,3,3,1, 11231
21,11227,5,5,1, 11232
1,11231,1,1,1, 11232
7,11237,1,1,0, 11238
12,11245,5,5,1, 11250
24,11254,1,1,1, 11255
19,11251,5,5,1, 11256
1,11256,1,1,1, 11257
3,11257,3,3,1, 11260
5,11257,3,3,1, 11260
25,11260,2,2,1, 11262
31,11261,2,2,1, 11263
7,11262,1,1,0, 11263
28,11259,5,5,1, 11264
11,11264,4,4,1, 11268
17,11269,3,3,1, 11272
12,11270,5,5,1, 11275
24,11279,1,1,1, 11280
1,11281,1,1,1, 11282
4,11281,4,4,1, 11285
30,11283,3,3,1, 11286
25,11285,2,2,1, 11287
31,11286,2,2,1, 11288
7,11287,1,1,1, 11288
26,11287,3,3,1, 11290
29,11288,4,4,1, 11292
9,11292,2,2,1, 11294
12,11295,5,5,1, 11300
2,11303,2,2,1, 11305
24,11304,1,1,1, 11305
19,11301,5,5,1, 11306
1,11306,1,1,0, 11307
27,11307,4,4,1, 11311
6,11310,2,2,1, 11312
7,11312,1,1,1, 11313
29,11313,4,4,1, 11317
24,11329,1,1,0, 11330
6,11335,2,2,1, 11337
31,11336,2,2,1, 11338
7,11337,1,1,0, 11338
29,11338,4,4,1, 11342
8,11341,1,1,1, 11342
14,11344,3,3,1, 11347
15,11346,2,2,1, 11348
22,11351,4,4,1, 11355
24,11354,1,1,1, 11355
23,11353,3,3,1, 11356
21,11352,5,5,1, 11357
5,11357,3,3,1, 11360
31,11361,2,2,1, 11363
7,11362,1,1,0, 11363
29,11363,4,4,1, 11367
8,11366,1,1,0, 11367
16,11369,2,2,1, 11371
13,11369,4,4,1, 11373
15,11371,2,2,1, 11373
22,11376,4,4,1, 11380
24,11379,1,1,0, 11380
21,11377,5,5,1, 11382
5,11382,3,3,1, 11385
30,11383,3,3,1, 11386
7,11387,1,1,0, 11388
8,11391,1,1,0, 11392
14,11394,3,3,1, 11397
13,11394,4,4,1, 11398
22,11401,4,4,1, 11405
24,11404,1,1,1, 11405
23,11403,3,3,1, 11406
30,11408,3,3,1, 11411
6,11410,2,2,1, 11412
31,11411,2,2,1, 11413
7,11412,1,1,1, 11413
8,11416,1,1,1, 11417
9,11417,2,2,1, 11419
13,11419,4,4,1, 11423
24,11429,1,1,1, 11430
23,11428,3,3,1, 11431
1,11431,1,1,0, 11432
5,11432,3,3,1, 11435
30,11433,3,3,1, 11436
31,11436,2,2,1, 11438
7,11437,1,1,0, 11438
8,11441,1,1,1, 11442
9,11442,2,2,1, 11444
17,11444,3,3,1, 11447
22,11451,4,4,1, 11455
24,11454,1,1,0, 11455
1,11456,1,1,0, 11457
5,11457,3,3,1, 11460
7,11462,1,1,1, 11463
29,11463,4,4,1, 11467
8,11466,1,1,1, 11467
15,11471,2,2,1, 11473
24,11479,1,1,1, 11480
23,11478,3,3,1, 11481
21,11477,5,5,1, 11482
1,11481,1,1,1, 11482
6,11485,2,2,1, 11487
7,11487,1,1,0, 11488
29,11488,4,4,1, 11492
8,11491,1,1,1, 11492
16,11494,2,2,1, 11496
14,11494,3,3,1, 11497
17,11494,3,3,1, 11497
13,11494,4,4,1, 11498
15,11496,2,2,1, 11498
24,11504,1,1,0, 11505
19,11501,5,5,1, 11506
23,11503,3,3,1, 11506
1,11506,1,1,0, 11507
4,11506,4,4,1, 11510
3,11507,3,3,1, 11510
5,11507,3,3,1, 11510
30,11508,3,3,1, 11511
6,11510,2,2,1, 11512
25,11510,2,2,1, 11512
31,11511,2,2,1, 11513
7,11512,1,1,1, 11513
28,11509,5,5,1, 11514
26,11512,3,3,1, 11515
29,11513,4,4,1, 11517
8,11516,1,1,0, 11517
11,11514,4,4,1, 11518
14,11519,3,3,1, 11522
17,11519,3,3,1, 11522
13,11519,4,4,1, 11523
18,11523,4,4,1, 11527
2,11528,2,2,1, 11530
24,11529,1,1,1, 11530
19,11526,5,5,1, 11531
1,11531,1,1,0, 11532
4,11531,4,4,1, 11535
5,11532,3,3,1, 11535
27,11532,4,4,1, 11536
25,11535,2,2,1, 11537
7,11537,1,1,1, 11538
11,11539,4,4,1, 11543
12,11545,5,5,1, 11550
2,11553,2,2,1, 11555
24,11554,1,1,0, 11555
1,11556,1,1,1, 11557
3,11557,3,3,1, 11560
5,11557,3,3,1, 11560
27,11557,4,4,1, 11561
6,11560,2,2,1, 11562
25,11560,2,2,1, 11562
7,11562,1,1,1, 11563
28,11559,5,5,1, 11564
26,11562,3,3,1, 11565
29,11563,4,4,1, 11567
24,11579,1,1,1, 11580
1,11581,1,1,1, 11582
31,11586,2,2,1, 11588
7,11587,1,1,1, 11588
24,11604,1,1,1, 11605
1,11606,1,1,1, 11607
5,11607,3,3,1, 11610
30,11608,3,3,1, 11611
25,11610,2,2,1, 11612
7,11612,1,1,0, 11613
9,11617,2,2,1, 11619
18,11623,4,4,1, 11627
2,11628,2,2,1, 11630
24,11629,1,1,0, 11630
1,11631,1,1,0, 11632
7,11637,1,1,0, 11638
26,11637,3,3,1, 11640
8,11641,1,1,0, 11642
16,11644,2,2,1, 11646
14,11644,3,3,1, 11647
13,11644,4,4,1, 11648
18,11648,4,4,1, 11652
22,11651,4,4,1, 11655
24,11654,1,1,1, 11655
21,11652,5,5,1, 11657
1,11656,1,1,0, 11657
5,11657,3,3,1, 11660
30,11658,3,3,1, 11661
6,11660,2,2,1, 11662
7,11662,1,1,0, 11663
26,11662,3,3,1, 11665
29,11663,4,4,1, 11667
8,11666,1,1,1, 11667
11,11664,4,4,1, 11668
17,11669,3,3,1, 11672
13,11669,4,4,1, 11673
15,11671,2,2,1, 11673
24,11679,1,1,1, 11680
23,11678,3,3,1, 11681
7,11687,1,1,1, 11688
8,11691,1,1,0, 11692
16,11694,2,2,1, 11696
14,11694,3,3,1, 11697
15,11696,2,2,1, 11698
22,11701,4,4,1, 11705
24,11704,1,1,0, 11705
23,11703,3,3,1, 11706
5,11707,3,3,1, 11710
31,11711,2,2,1, 11713
7,11712,1,1,0, 11713
8,11716,1,1,1, 11717
14,11719,3,3,1, 11722
15,11721,2,2,1, 11723
24,11729,1,1,1, 11730
5,11732,3,3,1, 11735
30,11733,3,3,1, 11736
31,11736,2,2,1, 11738
7,11737,1,1,1, 11738
29,11738,4,4,1, 11742
8,11741,1,1,1, 11742
16,11744,2,2,1, 11746
14,11744,3,3,1, 11747
15,11746,2,2,1, 11748
24,11754,1,1,0, 11755
23,11753,3,3,1, 11756
21,11752,5,5,1, 11757
30,11758,3,3,1, 11761
31,11761,2,2,1, 11763
7,11762,1,1,1, 11763
29,11763,4,4,1, 11767
8,11766,1,1,1, 11767
16,11769,2,2,1, 11771
14,11769,3,3,1, 11772
15,11771,2,2,1, 11773
22,11776,4,4,1, 11780
24,11779,1,1,0, 11780
23,11778,3,3,1, 11781
21,11777,5,5,1, 11782
1,11781,1,1,0, 11782
25,11785,2,2,1, 11787
9,11792,2,2,1, 11794
17,11794,3,3,1, 11797
24,11804,1,1,0, 11805
1,11806,1,1,0, 11807
28,11809,5,5,1, 11814
26,11812,3,3,1, 11815
11,11814,4,4,1, 11818
9,11817,2,2,1, 11819
17,11819,3,3,1, 11822
18,11823,4,4,1, 11827
2,11828,2,2,1, 11830
24,11829,1,1,0, 11830
1,11831,1,1,1, 11832
11,11839,4,4,1, 11843
9,11842,2,2,1, 11844
18,11848,4,4,1, 11852
24,11854,1,1,1, 11855
1,11856,1,1,0, 11857
4,11856,4,4,1, 11860
28,11859,5,5,1, 11864
11,11864,4,4,1, 11868
9,11867,2,2,1, 11869
12,11870,5,5,1, 11875
20,11873,6,6,1, 11879
24,11879,1,1,0, 11880
1,11881,1,1,0, 11882
3,11882,3,3,1, 11885
5,11882,3,3,1, 11885
27,11882,4,4,1, 11886
6,11885,2,2,1, 11887
31,11886,2,2,1, 11888
7,11887,1,1,1, 11888
26,11887,3,3,1, 11890
29,11888,4,4,1, 11892
8,11891,1,1,1, 11892
9,11892,2,2,1, 11894
13,11894,4,4,1, 11898
12,11895,5,5,1, 11900
24,11904,1,1,1, 11905
5,11907,3,3,1, 11910
30,11908,3,3,1, 11911
6,11910,2,2,1, 11912
7,11912,1,1,1, 11913
29,11913,4,4,1, 11917
8,11916,1,1,0, 11917
13,11919,4,4,1, 11923
15,11921,2,2,1, 11923
24,11929,1,1,1, 11930
23,11928,3,3,1, 11931
21,11927,5,5,1, 11932
5,11932,3,3,1, 11935
7,11937,1,1,0, 11938
29,11938,4,4,1, 11942
8,11941,1,1,1, 11942
13,11944,4,4,1, 11948
15,11946,2,2,1, 11948
24,11954,1,1,0, 11955
21,11952,5,5,1, 11957
5,11957,3,3,1, 11960
31,11961,2,2,1, 11963
7,11962,1,1,1, 11963
29,11963,4,4,1, 11967
8,11966,1,1,0, 11967
24,11979,1,1,0, 11980
5,11982,3,3,1, 11985
30,11983,3,3,1, 11986
6,11985,2,2,1, 11987
31,11986,2,2,1, 11988
7,11987,1,1,1, 11988
29,11988,4,4,1, 11992
8,11991,1,1,1, 11992
14,11994,3,3,1, 11997
15,11996,2,2,1, 11998
24,12004,1,1,1, 12005
1,12006,1,1,0, 12007
6,12010,2,2,1, 12012
7,12012,1,1,0, 12013
29,12013,4,4,1, 12017
8,12016,1,1,1, 12017
9,12017,2,2,1, 12019
14,12019,3,3,1, 12022
17,12019,3,3,1, 12022
22,12026,4,4,1, 12030
24,12029,1,1,0, 12030
23,12028,3,3,1, 12031
21,12027,5,5,1, 12032
1,12031,1,1,1, 12032
30,12033,3,3,1, 12036
25,12035,2,2,1, 12037
7,12037,1,1,0, 12038
8,12041,1,1,1, 12042
15,12046,2,2,1, 12048
20,12048,6,6,1, 12054
22,12051,4,4,1, 12055
2,12053,2,2,1, 12055
24,12054,1,1,1, 12055
19,12051,5,5,1, 12056
1,12056,1,1,0, 12057
3,12057,3,3,1, 12060
5,12057,3,3,1, 12060
30,12058,3,3,1, 12061
31,12061,2,2,1, 12063
7,12062,1,1,1, 12063
28,12059,5,5,1, 12064
26,12062,3,3,1, 12065
8,12066,1,1,1, 12067
9,12067,2,2,1, 12069
17,12069,3,3,1, 12072
15,12071,2,2,1, 12073
12,12070,5,5,1, 12075
20,12073,6,6,1, 12079
2,12078,2,2,1, 12080
24,12079,1,1,1, 12080
1,12081,1,1,1, 12082
27,12082,4,4,1, 12086
30,12083,3,3,1, 12086
6,12085,2,2,1, 12087
31,12086,2,2,1, 12088
7,12087,1,1,0, 12088
28,12084,5,5,1, 12089
26,12087,3,3,1, 12090
29,12088,4,4,1, 12092
8,12091,1,1,0, 12092
11,12089,4,4,1, 12093
9,12092,2,2,1, 12094
14,12094,3,3,1, 12097
13,12094,4,4,1, 12098
18,12098,4,4,1, 12102
24,12104,1,1,0, 12105
23,12103,3,3,1, 12106
1,12106,1,1,0, 12107
4,12106,4,4,1, 12110
7,12112,1,1,1, 12113
28,12109,5,5,1, 12114
26,12112,3,3,1, 12115
29,12113,4,4,1, 12117
8,12116,1,1,1, 12117
14,12119,3,3,1, 12122
17,12119,3,3,1, 12122
15,12121,2,2,1, 12123
24,12129,1,1,0, 12130
21,12127,5,5,1, 12132
7,12137,1,1,1, 12138
8,12141,1,1,1, 12142
16,12144,2,2,1, 12146
14,12144,3,3,1, 12147
13,12144,4,4,1, 12148
15,12146,2,2,1, 12148
24,12154,1,1,0, 12155
23,12153,3,3,1, 12156
5,12157,3,3,1, 12160
30,12158,3,3,1, 12161
31,12161,2,2,1, 12163
7,12162,1,1,1, 12163
29,12163,4,4,1, 12167
8,12166,1,1,0, 12167
16,12169,2,2,1, 12171
24,12179,1,1,1, 12180
30,12183,3,3,1, 12186
6,12185,2,2,1, 12187
31,12186,2,2,1, 12188
7,12187,1,1,0, 12188
29,12188,4,4,1, 12192
8,12191,1,1,1, 12192
16,12194,2,2,1, 12196
14,12194,3,3,1, 12197
13,12194,4,4,1, 12198
15,12196,2,2,1, 12198
24,12204,1,1,0, 12205
21,12202,5,5,1, 12207
5,12207,3,3,1, 12210
6,12210,2,2,1, 12212
7,12212,1,1,1, 12213
8,12216,1,1,1, 12217
16,12219,2,2,1, 12221
14,12219,3,3,1, 12222
13,12219,4,4,1, 12223
15,12221,2,2,1, 12223
22,12226,4,4,1, 12230
24,12229,1,1,1, 12230
23,12228,3,3,1, 12231
1,12231,1,1,0, 12232
5,12232,3,3,1, 12235
30,12233,3,3,1, 12236
6,12235,2,2,1, 12237
7,12237,1,1,1, 12238
29,12238,4,4,1, 12242
8,12241,1,1,1, 12242
17,12244,3,3,1, 12247
13,12244,4,4,1, 12248
22,12251,4,4,1, 12255
24,12254,1,1,1, 12255
21,12252,5,5,1, 12257
1,12256,1,1,0, 12257
26,12262,3,3,1, 12265
8,12266,1,1,0, 12267
15,12271,2,2,1, 12273
22,12276,4,4,1, 12280
2,12278,2,2,1, 12280
24,12279,1,1,1, 12280
23,12278,3,3,1, 12281
1,12281,1,1,0, 12282
26,12287,3,3,1, 12290
8,12291,1,1,0, 12292
17,12294,3,3,1, 12297
22,12301,4,4,1, 12305
24,12304,1,1,0, 12305
21,12302,5,5,1, 12307
1,12306,1,1,1, 12307
25,12310,2,2,1, 12312
26,12312,3,3,1, 12315
18,12323,4,4,1, 12327
24,12329,1,1,1, 12330
1,12331,1,1,0, 12332
25,12335,2,2,1, 12337
9,12342,2,2,1, 12344
17,12344,3,3,1, 12347
2,12353,2,2,1, 12355
24,12354,1,1,1, 12355
19,12351,5,5,1, 12356
1,12356,1,1,1, 12357
4,12356,4,4,1, 12360
5,12357,3,3,1, 12360
27,12357,4,4,1, 12361
30,12358,3,3,1, 12361
31,12361,2,2,1, 12363
7,12362,1,1,1, 12363
29,12363,4,4,1, 12367
11,12364,4,4,1, 12368
9,12367,2,2,1, 12369
17,12369,3,3,1, 12372
18,12373,4,4,1, 12377
2,12378,2,2,1, 12380
24,12379,1,1,0, 12380
1,12381,1,1,0, 12382
4,12381,4,4,1, 12385
5,12382,3,3,1, 12385
27,12382,4,4,1, 12386
30,12383,3,3,1, 12386
6,12385,2,2,1, 12387
31,12386,2,2,1, 12388
7,12387,1,1,1, 12388
26,12387,3,3,1, 12390
9,12392,2,2,1, 12394
17,12394,3,3,1, 12397
12,12395,5,5,1, 12400
18,12398,4,4,1, 12402
20,12398,6,6,1, 12404
24,12404,1,1,1, 12405
19,12401,5,5,1, 12406
5,12407,3,3,1, 12410
7,12412,1,1,1, 12413
8,12416,1,1,1, 12417
16,12419,2,2,1, 12421
14,12419,3,3,1, 12422
13,12419,4,4,1, 12423
22,12426,4,4,1, 12430
24,12429,1,1,0, 12430
23,12428,3,3,1, 12431
5,12432,3,3,1, 12435
6,12435,2,2,1, 12437
7,12437,1,1,0, 12438
8,12441,1,1,0, 12442
14,12444,3,3,1, 12447
15,12446,2,2,1, 12448
24,12454,1,1,1, 12455
30,12458,3,3,1, 12461
6,12460,2,2,1, 12462
31,12461,2,2,1, 12463
7,12462,1,1,1, 12463
8,12466,1,1,1, 12467
16,12469,2,2,1, 12471
13,12469,4,4,1, 12473
22,12476,4,4,1, 12480
24,12479,1,1,0, 12480
6,12485,2,2,1, 12487
31,12486,2,2,1, 12488
7,12487,1,1,0, 12488
29,12488,4,4,1, 12492
8,12491,1,1,1, 12492
16,12494,2,2,1, 12496
13,12494,4,4,1, 12498
15,12496,2,2,1, 12498
22,12501,4,4,1, 12505
24,12504,1,1,1, 12505
21,12502,5,5,1, 12507
30,12508,3,3,1, 12511
7,12512,1,1,1, 12513
29,12513,4,4,1, 12517
8,12516,1,1,0, 12517
9,12517,2,2,1, 12519
16,12519,2,2,1, 12521
14,12519,3,3,1, 12522
24,12529,1,1,1, 12530
21,12527,5,5,1, 12532
1,12531,1,1,1, 12532
5,12532,3,3,1, 12535
31,12536,2,2,1, 12538
7,12537,1,1,1, 12538
8,12541,1,1,0, 12542
9,12542,2,2,1, 12544
16,12544,2,2,1, 12546
17,12544,3,3,1, 12547
13,12544,4,4,1, 12548
24,12554,1,1,1, 12555
23,12553,3,3,1, 12556
1,12556,1,1,0, 12557
5,12557,3,3,1, 12560
30,12558,3,3,1, 12561
7,12562,1,1,1, 12563
8,12566,1,1,0, 12567
16,12569,2,2,1, 12571
17,12569,3,3,1, 12572
13,12569,4,4,1, 12573
24,12579,1,1,1, 12580
21,12577,5,5,1, 12582
1,12581,1,1,0, 12582
6,12585,2,2,1, 12587
25,12585,2,2,1, 12587
7,12587,1,1,0, 12588
29,12588,4,4,1, 12592
8,12591,1,1,0, 12592
9,12592,2,2,1, 12594
16,12594,2,2,1, 12596
14,12594,3,3,1, 12597
17,12594,3,3,1, 12597
15,12596,2,2,1, 12598
24,12604,1,1,0, 12605
1,12606,1,1,0, 12607
5,12607,3,3,1, 12610
30,12608,3,3,1, 12611
6,12610,2,2,1, 12612
25,12610,2,2,1, 12612
31,12611,2,2,1, 12613
7,12612,1,1,1, 12613
29,12613,4,4,1, 12617
9,12617,2,2,1, 12619
17,12619,3,3,1, 12622
24,12629,1,1,1, 12630
1,12631,1,1,1, 12632
5,12632,3,3,1, 12635
30,12633,3,3,1, 12636
6,12635,2,2,1, 12637
7,12637,1,1,1, 12638
29,12638,4,4,1, 12642
9,12642,2,2,1, 12644
17,12644,3,3,1, 12647
18,12648,4,4,1, 12652
24,12654,1,1,0, 12655
1,12656,1,1,0, 12657
5,12657,3,3,1, 12660
30,12658,3,3,1, 12661
6,12660,2,2,1, 12662
31,12661,2,2,1, 12663
7,12662,1,1,0, 12663
17,12669,3,3,1, 12672
20,12673,6,6,1, 12679
2,12678,2,2,1, 12680
24,12679,1,1,0, 12680
1,12681,1,1,1, 12682
5,12682,3,3,1, 12685
30,12683,3,3,1, 12686
25,12685,2,2,1, 12687
31,12686,2,2,1, 12688
7,12687,1,1,0, 12688
28,12684,5,5,1, 12689
26,12687,3,3,1, 12690
29,12688,4,4,1, 12692
11,12689,4,4,1, 12693
17,12694,3,3,1, 12697
2,12703,2,2,1, 12705
24,12704,1,1,0, 12705
19,12701,5,5,1, 12706
21,12702,5,5,1, 12707
1,12706,1,1,0, 12707
3,12707,3,3,1, 12710
27,12707,4,4,1, 12711
25,12710,2,2,1, 12712
28,12709,5,5,1, 12714
26,12712,3,3,1, 12715
8,12716,1,1,0, 12717
14,12719,3,3,1, 12722
13,12719,4,4,1, 12723
12,12720,5,5,1, 12725
2,12728,2,2,1, 12730
24,12729,1,1,0, 12730
19,12726,5,5,1, 12731
23,12728,3,3,1, 12731
1,12731,1,1,1, 12732
3,12732,3,3,1, 12735
8,12741,1,1,0, 12742
16,12744,2,2,1, 12746
14,12744,3,3,1, 12747
13,12744,4,4,1, 12748
15,12746,2,2,1, 12748
22,12751,4,4,1, 12755
24,12754,1,1,0, 12755
21,12752,5,5,1, 12757
8,12766,1,1,1, 12767
16,12769,2,2,1, 12771
14,12769,3,3,1, 12772
22,12776,4,4,1, 12780
24,12779,1,1,1, 12780
23,12778,3,3,1, 12781
8,12791,1,1,1, 12792
16,12794,2,2,1, 12796
13,12794,4,4,1, 12798
15,12796,2,2,1, 12798
24,12804,1,1,1, 12805
23,12803,3,3,1, 12806
5,12807,3,3,1, 12810
31,12811,2,2,1, 12813
7,12812,1,1,1, 12813
8,12816,1,1,0, 12817
16,12819,2,2,1, 12821
14,12819,3,3,1, 12822
22,12826,4,4,1, 12830
24,12829,1,1,0, 12830
30,12833,3,3,1, 12836
6,12835,2,2,1, 12837
7,12837,1,1,1, 12838
29,12838,4,4,1, 12842
8,12841,1,1,0, 12842
9,12842,2,2,1, 12844
13,12844,4,4,1, 12848
24,12854,1,1,0, 12855
21,12852,5,5,1, 12857
1,12856,1,1,0, 12857
5,12857,3,3,1, 12860
6,12860,2,2,1, 12862
25,12860,2,2,1, 12862
31,12861,2,2,1, 12863
7,12862,1,1,0, 12863
8,12866,1,1,0, 12867
9,12867,2,2,1, 12869
16,12869,2,2,1, 12871
17,12869,3,3,1, 12872
22,12876,4,4,1, 12880
24,12879,1,1,1, 12880
1,12881,1,1,1, 12882
5,12882,3,3,1, 12885
6,12885,2,2,1, 12887
7,12887,1,1,1, 12888
29,12888,4,4,1, 12892
8,12891,1,1,0, 12892
16,12894,2,2,1, 12896
14,12894,3,3,1, 12897
17,12894,3,3,1, 12897
13,12894,4,4,1, 12898
15,12896,2,2,1, 12898
24,12904,1,1,1, 12905
1,12906,1,1,1, 12907
5,12907,3,3,1, 12910
31,12911,2,2,1, 12913
7,12912,1,1,0, 12913
29,12913,4,4,1, 12917
9,12917,2,2,1, 12919
17,12919,3,3,1, 12922
24,12929,1,1,1, 12930
1,12931,1,1,1, 12932
30,12933,3,3,1, 12936
25,12935,2,2,1, 12937
7,12937,1,1,1, 12938
17,12944,3,3,1, 12947
18,12948,4,4,1, 12952
2,12953,2,2,1, 12955
24,12954,1,1,1, 12955
1,12956,1,1,0, 12957
6,12960,2,2,1, 12962
7,12962,1,1,0, 12963
26,12962,3,3,1, 12965
29,12963,4,4,1, 12967
17,12969,3,3,1, 12972
2,12978,2,2,1, 12980
24,12979,1,1,1, 12980
1,12981,1,1,1, 12982
5,12982,3,3,1, 12985
30,12983,3,3,1, 12986
6,12985,2,2,1, 12987
25,12985,2,2,1, 12987
31,12986,2,2,1, 12988
7,12987,1,1,0, 12988
9,12992,2,2,1, 12994
17,12994,3,3,1, 12997
24,13004,1,1,1, 13005
23,13003,3,3,1, 13006
21,13002,5,5,1, 13007
1,13006,1,1,0, 13007
5,13007,3,3,1, 13010
30,13008,3,3,1, 13011
31,13011,2,2,1, 13013
7,13012,1,1,1, 13013
26,13012,3,3,1, 13015
29,13013,4,4,1, 13017
8,13016,1,1,1, 13017
9,13017,2,2,1, 13019
16,13019,2,2,1, 13021
14,13019,3,3,1, 13022
17,13019,3,3,1, 13022
15,13021,2,2,1, 13023
22,13026,4,4,1, 13030
24,13029,1,1,1, 13030
23,13028,3,3,1, 13031
1,13031,1,1,1, 13032
30,13033,3,3,1, 13036
25,13035,2,2,1, 13037
31,13036,2,2,1, 13038
7,13037,1,1,1, 13038
29,13038,4,4,1, 13042
8,13041,1,1,0, 13042
9,13042,2,2,1, 13044
14,13044,3,3,1, 13047
13,13044,4,4,1, 13048
22,13051,4,4,1, 13055
24,13054,1,1,1, 13055
21,13052,5,5,1, 13057
1,13056,1,1,0, 13057
5,13057,3,3,1, 13060
6,13060,2,2,1, 13062
25,13060,2,2,1, 13062
7,13062,1,1,0, 13063
26,13062,3,3,1, 13065
8,13066,1,1,0, 13067
14,13069,3,3,1, 13072
17,13069,3,3,1, 13072
15,13071,2,2,1, 13073
18,13073,4,4,1, 13077
22,13076,4,4,1, 13080
2,13078,2,2,1, 13080
24,13079,1,1,1, 13080
1,13081,1,1,1, 13082
3,13082,3,3,1, 13085
30,13083,3,3,1, 13086
6,13085,2,2,1, 13087
25,13085,2,2,1, 13087
31,13086,2,2,1, 13088
7,13087,1,1,1, 13088
28,13084,5,5,1, 13089
29,13088,4,4,1, 13092
8,13091,1,1,0, 13092
11,13089,4,4,1, 13093
9,13092,2,2,1, 13094
14,13094,3,3,1, 13097
13,13094,4,4,1, 13098
18,13098,4,4,1, 13102
20,13098,6,6,1, 13104
22,13101,4,4,1, 13105
24,13104,1,1,0, 13105
1,13106,1,1,1, 13107
3,13107,3,3,1, 13110
5,13107,3,3,1, 13110
30,13108,3,3,1, 13111
6,13110,2,2,1, 13112
7,13112,1,1,1, 13113
29,13113,4,4,1, 13117
8,13116,1,1,0, 13117
13,13119,4,4,1, 13123
22,13126,4,4,1, 13130
24,13129,1,1,0, 13130
31,13136,2,2,1, 13138
7,13137,1,1,0, 13138
29,13138,4,4,1, 13142
8,13141,1,1,1, 13142
16,13144,2,2,1, 13146
14,13144,3,3,1, 13147
15,13146,2,2,1, 13148
22,13151,4,4,1, 13155
24,13154,1,1,0, 13155
23,13153,3,3,1, 13156
30,13158,3,3,1, 13161
7,13162,1,1,1, 13163
29,13163,4,4,1, 13167
8,13166,1,1,0, 13167
16,13169,2,2,1, 13171
14,13169,3,3,1, 13172
13,13169,4,4,1, 13173
15,13171,2,2,1, 13173
24,13179,1,1,1, 13180
30,13183,3,3,1, 13186
7,13187,1,1,1, 13188
24,13204,1,1,1, 13205
30,13208,3,3,1, 13211
31,13211,2,2,1, 13213
7,13212,1,1,1, 13213
29,13213,4,4,1, 13217
11,13214,4,4,1, 13218
12,13220,5,5,1, 13225
18,13223,4,4,1, 13227
2,13228,2,2,1, 13230
24,13229,1,1,1, 13230
19,13226,5,5,1, 13231
1,13231,1,1,1, 13232
4,13231,4,4,1, 13235
5,13232,3,3,1, 13235
30,13233,3,3,1, 13236
6,13235,2,2,1, 13237
7,13237,1,1,1, 13238
29,13238,4,4,1, 13242
9,13242,2,2,1, 13244
24,13254,1,1,1, 13255
1,13256,1,1,1, 13257
5,13257,3,3,1, 13260
30,13258,3,3,1, 13261
24,13279,1,1,0, 13280
21,13277,5,5,1, 13282
1,13281,1,1,0, 13282
8,13291,1,1,1, 13292
16,13294,2,2,1, 13296
14,13294,3,3,1, 13297
13,13294,4,4,1, 13298
24,13304,1,1,0, 13305
23,13303,3,3,1, 13306
1,13306,1,1,0, 13307
25,13310,2,2,1, 13312
8,13316,1,1,1, 13317
14,13319,3,3,1, 13322
17,13319,3,3,1, 13322
24,13329,1,1,0, 13330
23,13328,3,3,1, 13331
21,13327,5,5,1, 13332
1,13331,1,1,1, 13332
8,13341,1,1,0, 13342
16,13344,2,2,1, 13346
14,13344,3,3,1, 13347
13,13344,4,4,1, 13348
22,13351,4,4,1, 13355
2,13353,2,2,1, 13355
24,13354,1,1,1, 13355
19,13351,5,5,1, 13356
23,13353,3,3,1, 13356
21,13352,5,5,1, 13357
1,13356,1,1,1, 13357
4,13356,4,4,1, 13360
25,13360,2,2,1, 13362
29,13363,4,4,1, 13367
8,13366,1,1,0, 13367
11,13364,4,4,1, 13368
13,13369,4,4,1, 13373
15,13371,2,2,1, 13373
12,13370,5,5,1, 13375
18,13373,4,4,1, 13377
20,13373,6,6,1, 13379
24,13379,1,1,0, 13380
19,13376,5,5,1, 13381
23,13378,3,3,1, 13381
1,13381,1,1,1, 13382
6,13385,2,2,1, 13387
25,13385,2,2,1, 13387
31,13386,2,2,1, 13388
7,13387,1,1,0, 13388
8,13391,1,1,0, 13392
14,13394,3,3,1, 13397
18,13398,4,4,1, 13402
24,13404,1,1,1, 13405
21,13402,5,5,1, 13407
1,13406,1,1,1, 13407
30,13408,3,3,1, 13411
31,13411,2,2,1, 13413
7,13412,1,1,0, 13413
29,13413,4,4,1, 13417
8,13416,1,1,0, 13417
16,13419,2,2,1, 13421
14,13419,3,3,1, 13422
15,13421,2,2,1, 13423
22,13426,4,4,1, 13430
2,13428,2,2,1, 13430
24,13429,1,1,1, 13430
1,13431,1,1,1, 13432
5,13432,3,3,1, 13435
25,13435,2,2,1, 13437
31,13436,2,2,1, 13438
7,13437,1,1,0, 13438
8,13441,1,1,1, 13442
9,13442,2,2,1, 13444
16,13444,2,2,1, 13446
14,13444,3,3,1, 13447
18,13448,4,4,1, 13452
24,13454,1,1,0, 13455
21,13452,5,5,1, 13457
1,13456,1,1,1, 13457
5,13457,3,3,1, 13460
25,13460,2,2,1, 13462
31,13461,2,2,1, 13463
7,13462,1,1,1, 13463
29,13463,4,4,1, 13467
8,13466,1,1,1, 13467
14,13469,3,3,1, 13472
22,13476,4,4,1, 13480
2,13478,2,2,1, 13480
24,13479,1,1,0, 13480
1,13481,1,1,0, 13482
6,13485,2,2,1, 13487
31,13486,2,2,1, 13488
7,13487,1,1,0, 13488
28,13484,5,5,1, 13489
8,13491,1,1,0, 13492
11,13489,4,4,1, 13493
14,13494,3,3,1, 13497
17,13494,3,3,1, 13497
22,13501,4,4,1, 13505
2,13503,2,2,1, 13505
24,13504,1,1,0, 13505
23,13503,3,3,1, 13506
1,13506,1,1,1, 13507
6,13510,2,2,1, 13512
25,13510,2,2,1, 13512
7,13512,1,1,0, 13513
8,13516,1,1,1, 13517
9,13517,2,2,1, 13519
16,13519,2,2,1, 13521
17,13519,3,3,1, 13522
15,13521,2,2,1, 13523
18,13523,4,4,1, 13527
20,13523,6,6,1, 13529
24,13529,1,1,0, 13530
19,13526,5,5,1, 13531
1,13531,1,1,1, 13532
6,13535,2,2,1, 13537
7,13537,1,1,1, 13538
28,13534,5,5,1, 13539
29,13538,4,4,1, 13542
11,13539,4,4,1, 13543
17,13544,3,3,1, 13547
20,13548,6,6,1, 13554
2,13553,2,2,1, 13555
24,13554,1,1,0, 13555
1,13556,1,1,0, 13557
3,13557,3,3,1, 13560
5,13557,3,3,1, 13560
27,13557,4,4,1, 13561
25,13560,2,2,1, 13562
7,13562,1,1,1, 13563
29,13563,4,4,1, 13567
24,13579,1,1,1, 13580
31,13586,2,2,1, 13588
7,13587,1,1,0, 13588
24,13604,1,1,0, 13605
30,13608,3,3,1, 13611
7,13612,1,1,0, 13613
29,13613,4,4,1, 13617
24,13629,1,1,1, 13630
23,13628,3,3,1, 13631
21,13627,5,5,1, 13632
5,13632,3,3,1, 13635
6,13635,2,2,1, 13637
7,13637,1,1,1, 13638
29,13638,4,4,1, 13642
8,13641,1,1,1, 13642
16,13644,2,2,1, 13646
14,13644,3,3,1, 13647
13,13644,4,4,1, 13648
22,13651,4,4,1, 13655
24,13654,1,1,1, 13655
21,13652,5,5,1, 13657
5,13657,3,3,1, 13660
30,13658,3,3,1, 13661
31,13661,2,2,1, 13663
7,13662,1,1,1, 13663
8,13666,1,1,0, 13667
14,13669,3,3,1, 13672
13,13669,4,4,1, 13673
24,13679,1,1,1, 13680
1,13681,1,1,1, 13682
5,13682,3,3,1, 13685
6,13685,2,2,1, 13687
31,13686,2,2,1, 13688
7,13687,1,1,1, 13688
8,13691,1,1,0, 13692
9,13692,2,2,1, 13694
16,13694,2,2,1, 13696
22,13701,4,4,1, 13705
24,13704,1,1,1, 13705
23,13703,3,3,1, 13706
1,13706,1,1,1, 13707
5,13707,3,3,1, 13710
30,13708,3,3,1, 13711
7,13712,1,1,1, 13713
8,13716,1,1,1, 13717
14,13719,3,3,1, 13722
13,13719,4,4,1, 13723
22,13726,4,4,1, 13730
24,13729,1,1,1, 13730
23,13728,3,3,1, 13731
1,13731,1,1,0, 13732
6,13735,2,2,1, 13737
25,13735,2,2,1, 13737
7,13737,1,1,0, 13738
29,13738,4,4,1, 13742
8,13741,1,1,1, 13742
14,13744,3,3,1, 13747
17,13744,3,3,1, 13747
13,13744,4,4,1, 13748
22,13751,4,4,1, 13755
24,13754,1,1,1, 13755
21,13752,5,5,1, 13757
1,13756,1,1,1, 13757
30,13758,3,3,1, 13761
6,13760,2,2,1, 13762
7,13762,1,1,1, 13763
26,13762,3,3,1, 13765
29,13763,4,4,1, 13767
8,13766,1,1,0, 13767
14,13769,3,3,1, 13772
13,13769,4,4,1, 13773
12,13770,5,5,1, 13775
20,13773,6,6,1, 13779
22,13776,4,4,1, 13780
2,13778,2,2,1, 13780
24,13779,1,1,1, 13780
19,13776,5,5,1, 13781
21,13777,5,5,1, 13782
1,13781,1,1,0, 13782
5,13782,3,3,1, 13785
27,13782,4,4,1, 13786
30,13783,3,3,1, 13786
31,13786,2,2,1, 13788
7,13787,1,1,1, 13788
26,13787,3,3,1, 13790
29,13788,4,4,1, 13792
8,13791,1,1,1, 13792
11,13789,4,4,1, 13793
16,13794,2,2,1, 13796
13,13794,4,4,1, 13798
15,13796,2,2,1, 13798
20,13798,6,6,1, 13804
2,13803,2,2,1, 13805
24,13804,1,1,1, 13805
19,13801,5,5,1, 13806
23,13803,3,3,1, 13806
1,13806,1,1,0, 13807
4,13806,4,4,1, 13810
5,13807,3,3,1, 13810
27,13807,4,4,1, 13811
30,13808,3,3,1, 13811
6,13810,2,2,1, 13812
25,13810,2,2,1, 13812
7,13812,1,1,0, 13813
26,13812,3,3,1, 13815
8,13816,1,1,1, 13817
11,13814,4,4,1, 13818
16,13819,2,2,1, 13821
17,13819,3,3,1, 13822
18,13823,4,4,1, 13827
22,13826,4,4,1, 13830
24,13829,1,1,1, 13830
1,13831,1,1,1, 13832
3,13832,3,3,1, 13835
6,13835,2,2,1, 13837
31,13836,2,2,1, 13838
7,13837,1,1,1, 13838
26,13837,3,3,1, 13840
8,13841,1,1,0, 13842
16,13844,2,2,1, 13846
14,13844,3,3,1, 13847
15,13846,2,2,1, 13848
12,13845,5,5,1, 13850
18,13848,4,4,1, 13852
20,13848,6,6,1, 13854
2,13853,2,2,1, 13855
24,13854,1,1,0, 13855
19,13851,5,5,1, 13856
1,13856,1,1,1, 13857
4,13856,4,4,1, 13860
30,13858,3,3,1, 13861
6,13860,2,2,1, 13862
31,13861,2,2,1, 13863
7,13862,1,1,0, 13863
24,13879,1,1,1, 13880
5,13882,3,3,1, 13885
30,13883,3,3,1, 13886
7,13887,1,1,0, 13888
24,13904,1,1,1, 13905
5,13907,3,3,1, 13910
30,13908,3,3,1, 13911
7,13912,1,1,1, 13913
24,13929,1,1,0, 13930
5,13932,3,3,1, 13935
30,13933,3,3,1, 13936
31,13936,2,2,1, 13938
7,13937,1,1,0, 13938
29,13938,4,4,1, 13942
24,13954,1,1,1, 13955
6,13960,2,2,1, 13962
25,13960,2,2,1, 13962
31,13961,2,2,1, 13963
7,13962,1,1,0, 13963
8,13966,1,1,0, 13967
14,13969,3,3,1, 13972
17,13969,3,3,1, 13972
15,13971,2,2,1, 13973
18,13973,4,4,1, 13977
22,13976,4,4,1, 13980
2,13978,2,2,1, 13980
24,13979,1,1,0, 13980
21,13977,5,5,1, 13982
1,13981,1,1,0, 13982
6,13985,2,2,1, 13987
7,13987,1,1,1, 13988
29,13988,4,4,1, 13992
8,13991,1,1,0, 13992
16,13994,2,2,1, 13996
18,13998,4,4,1, 14002
22,14001,4,4,1, 14005
2,14003,2,2,1, 14005
24,14004,1,1,0, 14005
23,14003,3,3,1, 14006
1,14006,1,1,1, 14007
30,14008,3,3,1, 14011
7,14012,1,1,0, 14013
8,14016,1,1,1, 14017
9,14017,2,2,1, 14019
16,14019,2,2,1, 14021
2,14028,2,2,1, 14030
24,14029,1,1,0, 14030
21,14027,5,5,1, 14032
1,14031,1,1,1, 14032
6,14035,2,2,1, 14037
7,14037,1,1,0, 14038
26,14037,3,3,1, 14040
29,14038,4,4,1, 14042
8,14041,1,1,0, 14042
16,14044,2,2,1, 14046
14,14044,3,3,1, 14047
20,14048,6,6,1, 14054
2,14053,2,2,1, 14055
24,14054,1,1,1, 14055
19,14051,5,5,1, 14056
21,14052,5,5,1, 14057
1,14056,1,1,0, 14057
4,14056,4,4,1, 14060
3,14057,3,3,1, 14060
5,14057,3,3,1, 14060
27,14057,4,4,1, 14061
31,14061,2,2,1, 14063
7,14062,1,1,0, 14063
26,14062,3,3,1, 14065
29,14063,4,4,1, 14067
8,14066,1,1,0, 14067
17,14069,3,3,1, 14072
13,14069,4,4,1, 14073
15,14071,2,2,1, 14073
12,14070,5,5,1, 14075
20,14073,6,6,1, 14079
2,14078,2,2,1, 14080
24,14079,1,1,1, 14080
21,14077,5,5,1, 14082
1,14081,1,1,1, 14082
3,14082,3,3,1, 14085
25,14085,2,2,1, 14087
7,14087,1,1,1, 14088
29,14088,4,4,1, 14092
8,14091,1,1,0, 14092
9,14092,2,2,1, 14094
17,14094,3,3,1, 14097
13,14094,4,4,1, 14098
18,14098,4,4,1, 14102
22,14101,4,4,1, 14105
24,14104,1,1,1, 14105
23,14103,3,3,1, 14106
5,14107,3,3,1, 14110
30,14108,3,3,1, 14111
6,14110,2,2,1, 14112
7,14112,1,1,1, 14113
29,14113,4,4,1, 14117
8,14116,1,1,1, 14117
15,14121,2,2,1, 14123
24,14129,1,1,1, 14130
23,14128,3,3,1, 14131
5,14132,3,3,1, 14135
30,14133,3,3,1, 14136
31,14136,2,2,1, 14138
7,14137,1,1,0, 14138
8,14141,1,1,1, 14142
15,14146,2,2,1, 14148
24,14154,1,1,1, 14155
21,14152,5,5,1, 14157
30,14158,3,3,1, 14161
7,14162,1,1,0, 14163
8,14166,1,1,0, 14167
14,14169,3,3,1, 14172
15,14171,2,2,1, 14173
22,14176,4,4,1, 14180
24,14179,1,1,0, 14180
23,14178,3,3,1, 14181
5,14182,3,3,1, 14185
30,14183,3,3,1, 14186
31,14186,2,2,1, 14188
7,14187,1,1,1, 14188
8,14191,1,1,1, 14192
15,14196,2,2,1, 14198
22,14201,4,4,1, 14205
24,14204,1,1,1, 14205
21,14202,5,5,1, 14207
1,14206,1,1,1, 14207
5,14207,3,3,1, 14210
30,14208,3,3,1, 14211
6,14210,2,2,1, 14212
31,14211,2,2,1, 14213
8,14216,1,1,0, 14217
17,14219,3,3,1, 14222
24,14229,1,1,0, 14230
23,14228,3,3,1, 14231
1,14231,1,1,1, 14232
8,14241,1,1,0, 14242
9,14242,2,2,1, 14244
16,14244,2,2,1, 14246
14,14244,3,3,1, 14247
17,14244,3,3,1, 14247
13,14244,4,4,1, 14248
22,14251,4,4,1, 14255
24,14254,1,1,0, 14255
23,14253,3,3,1, 14256
21,14252,5,5,1, 14257
1,14256,1,1,1, 14257
8,14266,1,1,1, 14267
9,14267,2,2,1, 14269
17,14269,3,3,1, 14272
13,14269,4,4,1, 14273
24,14279,1,1,0, 14280
1,14281,1,1,0, 14282
25,14285,2,2,1, 14287
8,14291,1,1,1, 14292
14,14294,3,3,1, 14297
17,14294,3,3,1, 14297
13,14294,4,4,1, 14298
22,14301,4,4,1, 14305
24,14304,1,1,1, 14305
23,14303,3,3,1, 14306
1,14306,1,1,0, 14307
25,14310,2,2,1, 14312
8,14316,1,1,0, 14317
14,14319,3,3,1, 14322
17,14319,3,3,1, 14322
13,14319,4,4,1, 14323
22,14326,4,4,1, 14330
2,14328,2,2,1, 14330
24,14329,1,1,0, 14330
19,14326,5,5,1, 14331
1,14331,1,1,0, 14332
5,14332,3,3,1, 14335
25,14335,2,2,1, 14337
31,14336,2,2,1, 14338
7,14337,1,1,1, 14338
29,14338,4,4,1, 14342
9,14342,2,2,1, 14344
12,14345,5,5,1, 14350
24,14354,1,1,1, 14355
19,14351,5,5,1, 14356
1,14356,1,1,0, 14357
4,14356,4,4,1, 14360
27,14357,4,4,1, 14361
25,14360,2,2,1, 14362
7,14362,1,1,0, 14363
26,14362,3,3,1, 14365
9,14367,2,2,1, 14369
12,14370,5,5,1, 14375
18,14373,4,4,1, 14377
20,14373,6,6,1, 14379
24,14379,1,1,1, 14380
19,14376,5,5,1, 14381
1,14381,1,1,1, 14382
27,14382,4,4,1, 14386
25,14385,2,2,1, 14387
7,14387,1,1,0, 14388
28,14384,5,5,1, 14389
29,14388,4,4,1, 14392
9,14392,2,2,1, 14394
24,14404,1,1,1, 14405
6,14410,2,2,1, 14412
31,14411,2,2,1, 14413
7,14412,1,1,1, 14413
24,14429,1,1,1, 14430
30,14433,3,3,1, 14436
7,14437,1,1,1, 14438
8,14441,1,1,1, 14442
13,14444,4,4,1, 14448
22,14451,4,4,1, 14455
24,14454,1,1,1, 14455
23,14453,3,3,1, 14456
30,14458,3,3,1, 14461
31,14461,2,2,1, 14463
7,14462,1,1,0, 14463
29,14463,4,4,1, 14467
8,14466,1,1,1, 14467
16,14469,2,2,1, 14471
14,14469,3,3,1, 14472
24,14479,1,1,0, 14480
23,14478,3,3,1, 14481
5,14482,3,3,1, 14485
30,14483,3,3,1, 14486
31,14486,2,2,1, 14488
7,14487,1,1,0, 14488
8,14491,1,1,1, 14492
17,14494,3,3,1, 14497
13,14494,4,4,1, 14498
15,14496,2,2,1, 14498
22,14501,4,4,1, 14505
2,14503,2,2,1, 14505
24,14504,1,1,1, 14505
1,14506,1,1,1, 14507
30,14508,3,3,1, 14511
6,14510,2,2,1, 14512
25,14510,2,2,1, 14512
7,14512,1,1,0, 14513
29,14513,4,4,1, 14517
8,14516,1,1,1, 14517
16,14519,2,2,1, 14521
17,14519,3,3,1, 14522
13,14519,4,4,1, 14523
15,14521,2,2,1, 14523
22,14526,4,4,1, 14530
24,14529,1,1,0, 14530
23,14528,3,3,1, 14531
1,14531,1,1,0, 14532
5,14532,3,3,1, 14535
30,14533,3,3,1, 14536
25,14535,2,2,1, 14537
31,14536,2,2,1, 14538
7,14537,1,1,1, 14538
8,14541,1,1,1, 14542
11,14539,4,4,1, 14543
9,14542,2,2,1, 14544
16,14544,2,2,1, 14546
14,14544,3,3,1, 14547
17,14544,3,3,1, 14547
12,14545,5,5,1, 14550
18,14548,4,4,1, 14552
22,14551,4,4,1, 14555
2,14553,2,2,1, 14555
24,14554,1,1,0, 14555
19,14551,5,5,1, 14556
1,14556,1,1,0, 14557
4,14556,4,4,1, 14560
5,14557,3,3,1, 14560
27,14557,4,4,1, 14561
6,14560,2,2,1, 14562
25,14560,2,2,1, 14562
31,14561,2,2,1, 14563
7,14562,1,1,1, 14563
26,14562,3,3,1, 14565
8,14566,1,1,1, 14567
14,14569,3,3,1, 14572
17,14569,3,3,1, 14572
13,14569,4,4,1, 14573
15,14571,2,2,1, 14573
18,14573,4,4,1, 14577
20,14573,6,6,1, 14579
22,14576,4,4,1, 14580
2,14578,2,2,1, 14580
24,14579,1,1,1, 14580
1,14581,1,1,1, 14582
30,14583,3,3,1, 14586
25,14585,2,2,1, 14587
7,14587,1,1,0, 14588
8,14591,1,1,0, 14592
24,14604,1,1,0, 14605
23,14603,3,3,1, 14606
21,14602,5,5,1, 14607
30,14608,3,3,1, 14611
6,14610,2,2,1, 14612
31,14611,2,2,1, 14613
7,14612,1,1,0, 14613
29,14613,4,4,1, 14617
8,14616,1,1,1, 14617
16,14619,2,2,1, 14621
15,14621,2,2,1, 14623
24,14629,1,1,1, 14630
23,14628,3,3,1, 14631
6,14635,2,2,1, 14637
31,14636,2,2,1, 14638
7,14637,1,1,1, 14638
29,14638,4,4,1, 14642
8,14641,1,1,0, 14642
14,14644,3,3,1, 14647
13,14644,4,4,1, 14648
15,14646,2,2,1, 14648
24,14654,1,1,0, 14655
23,14653,3,3,1, 14656
21,14652,5,5,1, 14657
7,14662,1,1,0, 14663
8,14666,1,1,0, 14667
16,14669,2,2,1, 14671
15,14671,2,2,1, 14673
24,14679,1,1,0, 14680
30,14683,3,3,1, 14686
6,14685,2,2,1, 14687
31,14686,2,2,1, 14688
7,14687,1,1,1, 14688
18,14698,4,4,1, 14702
24,14704,1,1,1, 14705
1,14706,1,1,1, 14707
30,14708,3,3,1, 14711
6,14710,2,2,1, 14712
25,14710,2,2,1, 14712
31,14711,2,2,1, 14713
7,14712,1,1,0, 14713
9,14717,2,2,1, 14719
18,14723,4,4,1, 14727
2,14728,2,2,1, 14730
24,14729,1,1,1, 14730
1,14731,1,1,1, 14732
7,14737,1,1,1, 14738
29,14738,4,4,1, 14742
9,14742,2,2,1, 14744
17,14744,3,3,1, 14747
24,14754,1,1,0, 14755
1,14756,1,1,0, 14757
30,14758,3,3,1, 14761
7,14762,1,1,0, 14763
17,14769,3,3,1, 14772
22,14776,4,4,1, 14780
24,14779,1,1,0, 14780
23,14778,3,3,1, 14781
21,14777,5,5,1, 14782
1,14781,1,1,0, 14782
5,14782,3,3,1, 14785
30,14783,3,3,1, 14786
25,14785,2,2,1, 14787
31,14786,2,2,1, 14788
7,14787,1,1,1, 14788
29,14788,4,4,1, 14792
8,14791,1,1,0, 14792
9,14792,2,2,1, 14794
16,14794,2,2,1, 14796
15,14796,2,2,1, 14798
12,14795,5,5,1, 14800
18,14798,4,4,1, 14802
2,14803,2,2,1, 14805
24,14804,1,1,0, 14805
19,14801,5,5,1, 14806
21,14802,5,5,1, 14807
1,14806,1,1,0, 14807
3,14807,3,3,1, 14810
5,14807,3,3,1, 14810
30,14808,3,3,1, 14811
25,14810,2,2,1, 14812
31,14811,2,2,1, 14813
7,14812,1,1,1, 14813
29,14813,4,4,1, 14817
8,14816,1,1,0, 14817
16,14819,2,2,1, 14821
14,14819,3,3,1, 14822
17,14819,3,3,1, 14822
13,14819,4,4,1, 14823
15,14821,2,2,1, 14823
20,14823,6,6,1, 14829
22,14826,4,4,1, 14830
24,14829,1,1,1, 14830
19,14826,5,5,1, 14831
1,14831,1,1,0, 14832
4,14831,4,4,1, 14835
3,14832,3,3,1, 14835
5,14832,3,3,1, 14835
30,14833,3,3,1, 14836
25,14835,2,2,1, 14837
31,14836,2,2,1, 14838
7,14837,1,1,1, 14838
28,14834,5,5,1, 14839
29,14838,4,4,1, 14842
8,14841,1,1,0, 14842
11,14839,4,4,1, 14843
9,14842,2,2,1, 14844
16,14844,2,2,1, 14846
14,14844,3,3,1, 14847
15,14846,2,2,1, 14848
22,14851,4,4,1, 14855
24,14854,1,1,1, 14855
30,14858,3,3,1, 14861
31,14861,2,2,1, 14863
7,14862,1,1,1, 14863
8,14866,1,1,1, 14867
16,14869,2,2,1, 14871
14,14869,3,3,1, 14872
15,14871,2,2,1, 14873
24,14879,1,1,1, 14880
21,14877,5,5,1, 14882
5,14882,3,3,1, 14885
6,14885,2,2,1, 14887
31,14886,2,2,1, 14888
7,14887,1,1,1, 14888
8,14891,1,1,1, 14892
14,14894,3,3,1, 14897
15,14896,2,2,1, 14898
22,14901,4,4,1, 14905
24,14904,1,1,0, 14905
23,14903,3,3,1, 14906
30,14908,3,3,1, 14911
6,14910,2,2,1, 14912
31,14911,2,2,1, 14913
7,14912,1,1,0, 14913
29,14913,4,4,1, 14917
8,14916,1,1,0, 14917
16,14919,2,2,1, 14921
15,14921,2,2,1, 14923
24,14929,1,1,1, 14930
30,14933,3,3,1, 14936
7,14937,1,1,1, 14938
29,14938,4,4,1, 14942
8,14941,1,1,0, 14942
16,14944,2,2,1, 14946
14,14944,3,3,1, 14947
22,14951,4,4,1, 14955
24,14954,1,1,0, 14955
23,14953,3,3,1, 14956
1,14956,1,1,0, 14957
5,14957,3,3,1, 14960
6,14960,2,2,1, 14962
7,14962,1,1,0, 14963
9,14967,2,2,1, 14969
24,14979,1,1,0, 14980
1,14981,1,1,1, 14982
30,14983,3,3,1, 14986
6,14985,2,2,1, 14987
25,14985,2,2,1, 14987
31,14986,2,2,1, 14988
7,14987,1,1,0, 14988
9,14992,2,2,1, 14994
17,14994,3,3,1, 14997
24,15004,1,1,1, 15005
1,15006,1,1,1, 15007
6,15010,2,2,1, 15012
7,15012,1,1,0, 15013
17,15019,3,3,1, 15022
24,15029,1,1,0, 15030
1,15031,1,1,0, 15032
5,15032,3,3,1, 15035
30,15033,3,3,1, 15036
7,15037,1,1,0, 15038
17,15044,3,3,1, 15047
2,15053,2,2,1, 15055
24,15054,1,1,0, 15055
1,15056,1,1,0, 15057
30,15058,3,3,1, 15061
25,15060,2,2,1, 15062
31,15061,2,2,1, 15063
7,15062,1,1,1, 15063
26,15062,3,3,1, 15065
8,15066,1,1,1, 15067
9,15067,2,2,1, 15069
16,15069,2,2,1, 15071
14,15069,3,3,1, 15072
13,15069,4,4,1, 15073
2,15078,2,2,1, 15080
24,15079,1,1,1, 15080
23,15078,3,3,1, 15081
1,15081,1,1,0, 15082
6,15085,2,2,1, 15087
25,15085,2,2,1, 15087
7,15087,1,1,0, 15088
8,15091,1,1,1, 15092
14,15094,3,3,1, 15097
22,15101,4,4,1, 15105
2,15103,2,2,1, 15105
24,15104,1,1,0, 15105
1,15106,1,1,0, 15107
4,15106,4,4,1, 15110
3,15107,3,3,1, 15110
27,15107,4,4,1, 15111
30,15108,3,3,1, 15111
6,15110,2,2,1, 15112
25,15110,2,2,1, 15112
31,15111,2,2,1, 15113
7,15112,1,1,1, 15113
26,15112,3,3,1, 15115
29,15113,4,4,1, 15117
8,15116,1,1,1, 15117
11,15114,4,4,1, 15118
16,15119,2,2,1, 15121
14,15119,3,3,1, 15122
17,15119,3,3,1, 15122
15,15121,2,2,1, 15123
12,15120,5,5,1, 15125
18,15123,4,4,1, 15127
20,15123,6,6,1, 15129
22,15126,4,4,1, 15130
24,15129,1,1,0, 15130
21,15127,5,5,1, 15132
1,15131,1,1,1, 15132
4,15131,4,4,1, 15135
3,15132,3,3,1, 15135
6,15135,2,2,1, 15137
25,15135,2,2,1, 15137
31,15136,2,2,1, 15138
7,15137,1,1,1, 15138
8,15141,1,1,0, 15142
16,15144,2,2,1, 15146
14,15144,3,3,1, 15147
15,15146,2,2,1, 15148
18,15148,4,4,1, 15152
24,15154,1,1,0, 15155
23,15153,3,3,1, 15156
1,15156,1,1,0, 15157
27,15157,4,4,1, 15161
30,15158,3,3,1, 15161
25,15160,2,2,1, 15162
7,15162,1,1,1, 15163
28,15159,5,5,1, 15164
29,15163,4,4,1, 15167
8,15166,1,1,1, 15167
11,15164,4,4,1, 15168
9,15167,2,2,1, 15169
14,15169,3,3,1, 15172
17,15169,3,3,1, 15172
13,15169,4,4,1, 15173
24,15179,1,1,0, 15180
23,15178,3,3,1, 15181
5,15182,3,3,1, 15185
31,15186,2,2,1, 15188
7,15187,1,1,0, 15188
8,15191,1,1,1, 15192
14,15194,3,3,1, 15197
22,15201,4,4,1, 15205
24,15204,1,1,1, 15205
23,15203,3,3,1, 15206
21,15202,5,5,1, 15207
30,15208,3,3,1, 15211
6,15210,2,2,1, 15212
31,15211,2,2,1, 15213
7,15212,1,1,0, 15213
29,15213,4,4,1, 15217
8,15216,1,1,0, 15217
14,15219,3,3,1, 15222
15,15221,2,2,1, 15223
24,15229,1,1,1, 15230
23,15228,3,3,1, 15231
21,15227,5,5,1, 15232
5,15232,3,3,1, 15235
30,15233,3,3,1, 15236
6,15235,2,2,1, 15237
31,15236,2,2,1, 15238
7,15237,1,1,1, 15238
29,15238,4,4,1, 15242
8,15241,1,1,0, 15242
14,15244,3,3,1, 15247
22,15251,4,4,1, 15255
24,15254,1,1,1, 15255
23,15253,3,3,1, 15256
21,15252,5,5,1, 15257
24,15279,1,1,0, 15280
1,15281,1,1,0, 15282
25,15285,2,2,1, 15287
24,15304,1,1,1, 15305
1,15306,1,1,1, 15307
25,15310,2,2,1, 15312
9,15317,2,2,1, 15319
17,15319,3,3,1, 15322
24,15329,1,1,1, 15330
1,15331,1,1,0, 15332
9,15342,2,2,1, 15344
2,15353,2,2,1, 15355
24,15354,1,1,0, 15355
1,15356,1,1,1, 15357
5,15357,3,3,1, 15360
30,15358,3,3,1, 15361
25,15360,2,2,1, 15362
7,15362,1,1,0, 15363
26,15362,3,3,1, 15365
8,15366,1,1,0, 15367
9,15367,2,2,1, 15369
16,15369,2,2,1, 15371
14,15369,3,3,1, 15372
18,15373,4,4,1, 15377
24,15379,1,1,0, 15380
1,15381,1,1,1, 15382
31,15386,2,2,1, 15388
7,15387,1,1,1, 15388
29,15388,4,4,1, 15392
8,15391,1,1,0, 15392
9,15392,2,2,1, 15394
14,15394,3,3,1, 15397
17,15394,3,3,1, 15397
13,15394,4,4,1, 15398
2,15403,2,2,1, 15405
24,15404,1,1,1, 15405
23,15403,3,3,1, 15406
21,15402,5,5,1, 15407
1,15406,1,1,1, 15407
4,15406,4,4,1, 15410
3,15407,3,3,1, 15410
5,15407,3,3,1, 15410
27,15407,4,4,1, 15411
6,15410,2,2,1, 15412
31,15411,2,2,1, 15413
7,15412,1,1,0, 15413
28,15409,5,5,1, 15414
29,15413,4,4,1, 15417
8,15416,1,1,0, 15417
14,15419,3,3,1, 15422
13,15419,4,4,1, 15423
22,15426,4,4,1, 15430
2,15428,2,2,1, 15430
24,15429,1,1,1, 15430
19,15426,5,5,1, 15431
23,15428,3,3,1, 15431
1,15431,1,1,0, 15432
4,15431,4,4,1, 15435
3,15432,3,3,1, 15435
5,15432,3,3,1, 15435
27,15432,4,4,1, 15436
6,15435,2,2,1, 15437
25,15435,2,2,1, 15437
7,15437,1,1,0, 15438
28,15434,5,5,1, 15439
26,15437,3,3,1, 15440
29,15438,4,4,1, 15442
8,15441,1,1,1, 15442
9,15442,2,2,1, 15444
14,15444,3,3,1, 15447
17,15444,3,3,1, 15447
12,15445,5,5,1, 15450
24,15454,1,1,0, 15455
23,15453,3,3,1, 15456
31,15461,2,2,1, 15463
7,15462,1,1,1, 15463
29,15463,4,4,1, 15467
8,15466,1,1,0, 15467
14,15469,3,3,1, 15472
15,15471,2,2,1, 15473
22,15476,4,4,1, 15480
24,15479,1,1,1, 15480
23,15478,3,3,1, 15481
5,15482,3,3,1, 15485
6,15485,2,2,1, 15487
31,15486,2,2,1, 15488
7,15487,1,1,1, 15488
29,15488,4,4,1, 15492
8,15491,1,1,1, 15492
14,15494,3,3,1, 15497
13,15494,4,4,1, 15498
22,15501,4,4,1, 15505
24,15504,1,1,0, 15505
5,15507,3,3,1, 15510
30,15508,3,3,1, 15511
6,15510,2,2,1, 15512
7,15512,1,1,1, 15513
8,15516,1,1,0, 15517
16,15519,2,2,1, 15521
14,15519,3,3,1, 15522
13,15519,4,4,1, 15523
24,15529,1,1,1, 15530
21,15527,5,5,1, 15532
7,15537,1,1,1, 15538
29,15538,4,4,1, 15542
8,15541,1,1,1, 15542
16,15544,2,2,1, 15546
18,15548,4,4,1, 15552
20,15548,6,6,1, 15554
22,15551,4,4,1, 15555
2,15553,2,2,1, 15555
24,15554,1,1,1, 15555
21,15552,5,5,1, 15557
1,15556,1,1,0, 15557
3,15557,3,3,1, 15560
30,15558,3,3,1, 15561
25,15560,2,2,1, 15562
31,15561,2,2,1, 15563
7,15562,1,1,0, 15563
8,15566,1,1,1, 15567
16,15569,2,2,1, 15571
17,15569,3,3,1, 15572
15,15571,2,2,1, 15573
24,15579,1,1,0, 15580
23,15578,3,3,1, 15581
1,15581,1,1,1, 15582
6,15585,2,2,1, 15587
31,15586,2,2,1, 15588
7,15587,1,1,1, 15588
8,15591,1,1,1, 15592
9,15592,2,2,1, 15594
17,15594,3,3,1, 15597
22,15601,4,4,1, 15605
24,15604,1,1,0, 15605
23,15603,3,3,1, 15606
21,15602,5,5,1, 15607
1,15606,1,1,0, 15607
5,15607,3,3,1, 15610
6,15610,2,2,1, 15612
25,15610,2,2,1, 15612
7,15612,1,1,1, 15613
29,15613,4,4,1, 15617
8,15616,1,1,1, 15617
16,15619,2,2,1, 15621
13,15619,4,4,1, 15623
22,15626,4,4,1, 15630
24,15629,1,1,1, 15630
23,15628,3,3,1, 15631
1,15631,1,1,1, 15632
25,15635,2,2,1, 15637
31,15636,2,2,1, 15638
7,15637,1,1,1, 15638
29,15638,4,4,1, 15642
17,15644,3,3,1, 15647
24,15654,1,1,1, 15655
1,15656,1,1,0, 15657
5,15657,3,3,1, 15660
25,15660,2,2,1, 15662
31,15661,2,2,1, 15663
7,15662,1,1,0, 15663
29,15663,4,4,1, 15667
9,15667,2,2,1, 15669
17,15669,3,3,1, 15672
24,15679,1,1,1, 15680
1,15681,1,1,1, 15682
30,15683,3,3,1, 15686
6,15685,2,2,1, 15687
25,15685,2,2,1, 15687
31,15686,2,2,1, 15688
7,15687,1,1,0, 15688
29,15688,4,4,1, 15692
9,15692,2,2,1, 15694
17,15694,3,3,1, 15697
18,15698,4,4,1, 15702
2,15703,2,2,1, 15705
24,15704,1,1,0, 15705
1,15706,1,1,0, 15707
6,15710,2,2,1, 15712
25,15710,2,2,1, 15712
31,15711,2,2,1, 15713
7,15712,1,1,0, 15713
9,15717,2,2,1, 15719
12,15720,5,5,1, 15725
20,15723,6,6,1, 15729
2,15728,2,2,1, 15730
24,15729,1,1,1, 15730
19,15726,5,5,1, 15731
1,15731,1,1,0, 15732
5,15732,3,3,1, 15735
7,15737,1,1,1, 15738
29,15738,4,4,1, 15742
8,15741,1,1,0, 15742
11,15739,4,4,1, 15743
16,15744,2,2,1, 15746
17,15744,3,3,1, 15747
15,15746,2,2,1, 15748
18,15748,4,4,1, 15752
22,15751,4,4,1, 15755
2,15753,2,2,1, 15755
24,15754,1,1,1, 15755
19,15751,5,5,1, 15756
21,15752,5,5,1, 15757
1,15756,1,1,0, 15757
3,15757,3,3,1, 15760
27,15757,4,4,1, 15761
30,15758,3,3,1, 15761
6,15760,2,2,1, 15762
7,15762,1,1,0, 15763
8,15766,1,1,1, 15767
16,15769,2,2,1, 15771
13,15769,4,4,1, 15773
15,15771,2,2,1, 15773
24,15779,1,1,0, 15780
5,15782,3,3,1, 15785
31,15786,2,2,1, 15788
7,15787,1,1,1, 15788
29,15788,4,4,1, 15792
8,15791,1,1,1, 15792
15,15796,2,2,1, 15798
24,15804,1,1,1, 15805
21,15802,5,5,1, 15807
31,15811,2,2,1, 15813
7,15812,1,1,0, 15813
29,15813,4,4,1, 15817
8,15816,1,1,0, 15817
16,15819,2,2,1, 15821
24,15829,1,1,0, 15830
21,15827,5,5,1, 15832
30,15833,3,3,1, 15836
6,15835,2,2,1, 15837
7,15837,1,1,1, 15838
8,15841,1,1,1, 15842
16,15844,2,2,1, 15846
14,15844,3,3,1, 15847
15,15846,2,2,1, 15848
24,15854,1,1,0, 15855
23,15853,3,3,1, 15856
5,15857,3,3,1, 15860
6,15860,2,2,1, 15862
31,15861,2,2,1, 15863
7,15862,1,1,0, 15863
8,15866,1,1,1, 15867
16,15869,2,2,1, 15871
17,15869,3,3,1, 15872
15,15871,2,2,1, 15873
24,15879,1,1,1, 15880
21,15877,5,5,1, 15882
1,15881,1,1,1, 15882
30,15883,3,3,1, 15886
25,15885,2,2,1, 15887
31,15886,2,2,1, 15888
7,15887,1,1,0, 15888
8,15891,1,1,1, 15892
9,15892,2,2,1, 15894
16,15894,2,2,1, 15896
13,15894,4,4,1, 15898
24,15904,1,1,0, 15905
21,15902,5,5,1, 15907
1,15906,1,1,1, 15907
5,15907,3,3,1, 15910
6,15910,2,2,1, 15912
7,15912,1,1,0, 15913
8,15916,1,1,0, 15917
9,15917,2,2,1, 15919
16,15919,2,2,1, 15921
17,15919,3,3,1, 15922
13,15919,4,4,1, 15923
15,15921,2,2,1, 15923
22,15926,4,4,1, 15930
24,15929,1,1,1, 15930
23,15928,3,3,1, 15931
1,15931,1,1,1, 15932
5,15932,3,3,1, 15935
30,15933,3,3,1, 15936
6,15935,2,2,1, 15937
7,15937,1,1,1, 15938
29,15938,4,4,1, 15942
8,15941,1,1,0, 15942
9,15942,2,2,1, 15944
16,15944,2,2,1, 15946
17,15944,3,3,1, 15947
22,15951,4,4,1, 15955
2,15953,2,2,1, 15955
24,15954,1,1,1, 15955
19,15951,5,5,1, 15956
1,15956,1,1,0, 15957
5,15957,3,3,1, 15960
27,15957,4,4,1, 15961
30,15958,3,3,1, 15961
25,15960,2,2,1, 15962
28,15959,5,5,1, 15964
8,15966,1,1,0, 15967
11,15964,4,4,1, 15968
14,15969,3,3,1, 15972
17,15969,3,3,1, 15972
12,15970,5,5,1, 15975
18,15973,4,4,1, 15977
20,15973,6,6,1, 15979
24,15979,1,1,1, 15980
19,15976,5,5,1, 15981
23,15978,3,3,1, 15981
1,15981,1,1,1, 15982
4,15981,4,4,1, 15985
3,15982,3,3,1, 15985
27,15982,4,4,1, 15986
8,15991,1,1,0, 15992
16,15994,2,2,1, 15996
14,15994,3,3,1, 15997
17,15994,3,3,1, 15997
18,15998,4,4,1, 16002
20,15998,6,6,1, 16004
2,16003,2,2,1, 16005
24,16004,1,1,0, 16005
1,16006,1,1,1, 16007
4,16006,4,4,1, 16010
8,16016,1,1,0, 16017
16,16019,2,2,1, 16021
13,16019,4,4,1, 16023
22,16026,4,4,1, 16030
24,16029,1,1,0, 16030
23,16028,3,3,1, 16031
21,16027,5,5,1, 16032
24,16054,1,1,0, 16055
29,16063,4,4,1, 16067
24,16079,1,1,0, 16080
30,16083,3,3,1, 16086
31,16086,2,2,1, 16088
7,16087,1,1,0, 16088
29,16088,4,4,1, 16092
24,16104,1,1,0, 16105
30,16108,3,3,1, 16111
7,16112,1,1,1, 16113
29,16113,4,4,1, 16117
9,16117,2,2,1, 16119
24,16129,1,1,0, 16130
19,16126,5,5,1, 16131
1,16131,1,1,1, 16132
27,16132,4,4,1, 16136
30,16133,3,3,1, 16136
7,16137,1,1,1, 16138
26,16137,3,3,1, 16140
29,16138,4,4,1, 16142
8,16141,1,1,0, 16142
9,16142,2,2,1, 16144
16,16144,2,2,1, 16146
17,16144,3,3,1, 16147
15,16146,2,2,1, 16148
22,16151,4,4,1, 16155
2,16153,2,2,1, 16155
24,16154,1,1,1, 16155
23,16153,3,3,1, 16156
1,16156,1,1,1, 16157
30,16158,3,3,1, 16161
31,16161,2,2,1, 16163
7,16162,1,1,0, 16163
29,16163,4,4,1, 16167
8,16166,1,1,1, 16167
14,16169,3,3,1, 16172
17,16169,3,3,1, 16172
22,16176,4,4,1, 16180
24,16179,1,1,0, 16180
1,16181,1,1,1, 16182
5,16182,3,3,1, 16185
6,16185,2,2,1, 16187
25,16185,2,2,1, 16187
31,16186,2,2,1, 16188
7,16187,1,1,1, 16188
26,16187,3,3,1, 16190
8,16191,1,1,1, 16192
9,16192,2,2,1, 16194
14,16194,3,3,1, 16197
13,16194,4,4,1, 16198
15,16196,2,2,1, 16198
2,16203,2,2,1, 16205
24,16204,1,1,1, 16205
23,16203,3,3,1, 16206
1,16206,1,1,1, 16207
5,16207,3,3,1, 16210
25,16210,2,2,1, 16212
31,16211,2,2,1, 16213
7,16212,1,1,1, 16213
29,16213,4,4,1, 16217
8,16216,1,1,1, 16217
16,16219,2,2,1, 16221
14,16219,3,3,1, 16222
17,16219,3,3,1, 16222
13,16219,4,4,1, 16223
15,16221,2,2,1, 16223
2,16228,2,2,1, 16230
24,16229,1,1,0, 16230
1,16231,1,1,0, 16232
30,16233,3,3,1, 16236
25,16235,2,2,1, 16237
7,16237,1,1,0, 16238
8,16241,1,1,0, 16242
16,16244,2,2,1, 16246
14,16244,3,3,1, 16247
17,16244,3,3,1, 16247
13,16244,4,4,1, 16248
15,16246,2,2,1, 16248
18,16248,4,4,1, 16252
24,16254,1,1,0, 16255
19,16251,5,5,1, 16256
23,16253,3,3,1, 16256
21,16252,5,5,1, 16257
1,16256,1,1,0, 16257
4,16256,4,4,1, 16260
30,16258,3,3,1, 16261
6,16260,2,2,1, 16262
25,16260,2,2,1, 16262
7,16262,1,1,0, 16263
29,16263,4,4,1, 16267
8,16266,1,1,1, 16267
14,16269,3,3,1, 16272
12,16270,5,5,1, 16275
24,16279,1,1,1, 16280
21,16277,5,5,1, 16282
1,16281,1,1,1, 16282
3,16282,3,3,1, 16285
5,16282,3,3,1, 16285
30,16283,3,3,1, 16286
6,16285,2,2,1, 16287
7,16287,1,1,0, 16288
28,16284,5,5,1, 16289
29,16288,4,4,1, 16292
8,16291,1,1,0, 16292
16,16294,2,2,1, 16296
14,16294,3,3,1, 16297
17,16294,3,3,1, 16297
15,16296,2,2,1, 16298
12,16295,5,5,1, 16300
20,16298,6,6,1, 16304
2,16303,2,2,1, 16305
24,16304,1,1,0, 16305
1,16306,1,1,0, 16307
4,16306,4,4,1, 16310
5,16307,3,3,1, 16310
30,16308,3,3,1, 16311
7,16312,1,1,1, 16313
29,16313,4,4,1, 16317
8,16316,1,1,1, 16317
16,16319,2,2,1, 16321
24,16329,1,1,1, 16330
23,16328,3,3,1, 16331
21,16327,5,5,1, 16332
7,16337,1,1,0, 16338
29,16338,4,4,1, 16342
24,16354,1,1,0, 16355
30,16358,3,3,1, 16361
31,16361,2,2,1, 16363
7,16362,1,1,0, 16363
24,16379,1,1,0, 16380
30,16383,3,3,1, 16386
6,16385,2,2,1, 16387
31,16386,2,2,1, 16388
7,16387,1,1,0, 16388
24,16404,1,1,1, 16405
5,16407,3,3,1, 16410
6,16410,2,2,1, 16412
7,16412,1,1,0, 16413
28,16409,5,5,1, 16414
26,16412,3,3,1, 16415
17,16419,3,3,1, 16422
24,16429,1,1,1, 16430
1,16431,1,1,0, 16432
30,16433,3,3,1, 16436
6,16435,2,2,1, 16437
25,16435,2,2,1, 16437
7,16437,1,1,0, 16438
29,16438,4,4,1, 16442
8,16441,1,1,1, 16442
9,16442,2,2,1, 16444
16,16444,2,2,1, 16446
14,16444,3,3,1, 16447
17,16444,3,3,1, 16447
15,16446,2,2,1, 16448
24,16454,1,1,1, 16455
23,16453,3,3,1, 16456
21,16452,5,5,1, 16457
1,16456,1,1,0, 16457
5,16457,3,3,1, 16460
6,16460,2,2,1, 16462
7,16462,1,1,0, 16463
8,16466,1,1,1, 16467
9,16467,2,2,1, 16469
16,16469,2,2,1, 16471
14,16469,3,3,1, 16472
17,16469,3,3,1, 16472
15,16471,2,2,1, 16473
24,16479,1,1,0, 16480
21,16477,5,5,1, 16482
1,16481,1,1,1, 16482
5,16482,3,3,1, 16485
6,16485,2,2,1, 16487
25,16485,2,2,1, 16487
31,16486,2,2,1, 16488
7,16487,1,1,0, 16488
8,16491,1,1,1, 16492
9,16492,2,2,1, 16494
17,16494,3,3,1, 16497
13,16494,4,4,1, 16498
24,16504,1,1,0, 16505
23,16503,3,3,1, 16506
21,16502,5,5,1, 16507
1,16506,1,1,0, 16507
6,16510,2,2,1, 16512
25,16510,2,2,1, 16512
31,16511,2,2,1, 16513
7,16512,1,1,1, 16513
29,16513,4,4,1, 16517
8,16516,1,1,0, 16517
16,16519,2,2,1, 16521
13,16519,4,4,1, 16523
18,16523,4,4,1, 16527
20,16523,6,6,1, 16529
22,16526,4,4,1, 16530
2,16528,2,2,1, 16530
24,16529,1,1,0, 16530
23,16528,3,3,1, 16531
1,16531,1,1,1, 16532
5,16532,3,3,1, 16535
30,16533,3,3,1, 16536
6,16535,2,2,1, 16537
25,16535,2,2,1, 16537
31,16536,2,2,1, 16538
7,16537,1,1,0, 16538
28,16534,5,5,1, 16539
29,16538,4,4,1, 16542
8,16541,1,1,0, 16542
9,16542,2,2,1, 16544
14,16544,3,3,1, 16547
12,16545,5,5,1, 16550
18,16548,4,4,1, 16552
22,16551,4,4,1, 16555
2,16553,2,2,1, 16555
24,16554,1,1,0, 16555
23,16553,3,3,1, 16556
21,16552,5,5,1, 16557
1,16556,1,1,1, 16557
3,16557,3,3,1, 16560
28,16559,5,5,1, 16564
8,16566,1,1,0, 16567
11,16564,4,4,1, 16568
13,16569,4,4,1, 16573
15,16571,2,2,1, 16573
20,16573,6,6,1, 16579
2,16578,2,2,1, 16580
24,16579,1,1,0, 16580
21,16577,5,5,1, 16582
1,16581,1,1,1, 16582
3,16582,3,3,1, 16585
27,16582,4,4,1, 16586
26,16587,3,3,1, 16590
8,16591,1,1,1, 16592
16,16594,2,2,1, 16596
14,16594,3,3,1, 16597
15,16596,2,2,1, 16598
24,16604,1,1,0, 16605
24,16629,1,1,1, 16630
24,16654,1,1,0, 16655
30,16658,3,3,1, 16661
6,16660,2,2,1, 16662
7,16662,1,1,0, 16663
24,16679,1,1,1, 16680
31,16686,2,2,1, 16688
7,16687,1,1,0, 16688
29,16688,4,4,1, 16692
17,16694,3,3,1, 16697
18,16698,4,4,1, 16702
22,16701,4,4,1, 16705
24,16704,1,1,0, 16705
23,16703,3,3,1, 16706
21,16702,5,5,1, 16707
1,16706,1,1,1, 16707
7,16712,1,1,1, 16713
26,16712,3,3,1, 16715
8,16716,1,1,1, 16717
14,16719,3,3,1, 16722
12,16720,5,5,1, 16725
20,16723,6,6,1, 16729
22,16726,4,4,1, 16730
24,16729,1,1,1, 16730
23,16728,3,3,1, 16731
21,16727,5,5,1, 16732
1,16731,1,1,1, 16732
3,16732,3,3,1, 16735
5,16732,3,3,1, 16735
30,16733,3,3,1, 16736
6,16735,2,2,1, 16737
25,16735,2,2,1, 16737
7,16737,1,1,1, 16738
28,16734,5,5,1, 16739
26,16737,3,3,1, 16740
8,16741,1,1,0, 16742
16,16744,2,2,1, 16746
17,16744,3,3,1, 16747
15,16746,2,2,1, 16748
20,16748,6,6,1, 16754
22,16751,4,4,1, 16755
2,16753,2,2,1, 16755
24,16754,1,1,0, 16755
23,16753,3,3,1, 16756
21,16752,5,5,1, 16757
1,16756,1,1,1, 16757
27,16757,4,4,1, 16761
6,16760,2,2,1, 16762
7,16762,1,1,0, 16763
8,16766,1,1,0, 16767
11,16764,4,4,1, 16768
9,16767,2,2,1, 16769
15,16771,2,2,1, 16773
24,16779,1,1,1, 16780
23,16778,3,3,1, 16781
1,16781,1,1,0, 16782
5,16782,3,3,1, 16785
30,16783,3,3,1, 16786
25,16785,2,2,1, 16787
7,16787,1,1,1, 16788
8,16791,1,1,0, 16792
9,16792,2,2,1, 16794
16,16794,2,2,1, 16796
14,16794,3,3,1, 16797
13,16794,4,4,1, 16798
24,16804,1,1,0, 16805
23,16803,3,3,1, 16806
21,16802,5,5,1, 16807
1,16806,1,1,0, 16807
5,16807,3,3,1, 16810
30,16808,3,3,1, 16811
6,16810,2,2,1, 16812
25,16810,2,2,1, 16812
31,16811,2,2,1, 16813
7,16812,1,1,0, 16813
8,16816,1,1,0, 16817
9,16817,2,2,1, 16819
16,16819,2,2,1, 16821
17,16819,3,3,1, 16822
13,16819,4,4,1, 16823
15,16821,2,2,1, 16823
24,16829,1,1,0, 16830
23,16828,3,3,1, 16831
21,16827,5,5,1, 16832
1,16831,1,1,0, 16832
5,16832,3,3,1, 16835
30,16833,3,3,1, 16836
7,16837,1,1,1, 16838
8,16841,1,1,0, 16842
17,16844,3,3,1, 16847
13,16844,4,4,1, 16848
15,16846,2,2,1, 16848
24,16854,1,1,0, 16855
1,16856,1,1,0, 16857
31,16861,2,2,1, 16863
7,16862,1,1,1, 16863
29,16863,4,4,1, 16867
9,16867,2,2,1, 16869
20,16873,6,6,1, 16879
24,16879,1,1,0, 16880
19,16876,5,5,1, 16881
1,16881,1,1,0, 16882
4,16881,4,4,1, 16885
5,16882,3,3,1, 16885
7,16887,1,1,1, 16888
26,16887,3,3,1, 16890
29,16888,4,4,1, 16892
17,16894,3,3,1, 16897
2,16903,2,2,1, 16905
24,16904,1,1,1, 16905
1,16906,1,1,0, 16907
5,16907,3,3,1, 16910
25,16910,2,2,1, 16912
7,16912,1,1,0, 16913
9,16917,2,2,1, 16919
18,16923,4,4,1, 16927
24,16929,1,1,1, 16930
1,16931,1,1,1, 16932
25,16935,2,2,1, 16937
31,16936,2,2,1, 16938
7,16937,1,1,0, 16938
26,16937,3,3,1, 16940
9,16942,2,2,1, 16944
18,16948,4,4,1, 16952
2,16953,2,2,1, 16955
24,16954,1,1,0, 16955
1,16956,1,1,0, 16957
6,16960,2,2,1, 16962
31,16961,2,2,1, 16963
7,16962,1,1,1, 16963
8,16966,1,1,0, 16967
16,16969,2,2,1, 16971
14,16969,3,3,1, 16972
13,16969,4,4,1, 16973
15,16971,2,2,1, 16973
22,16976,4,4,1, 16980
2,16978,2,2,1, 16980
24,16979,1,1,1, 16980
1,16981,1,1,0, 16982
5,16982,3,3,1, 16985
30,16983,3,3,1, 16986
6,16985,2,2,1, 16987
25,16985,2,2,1, 16987
7,16987,1,1,1, 16988
8,16991,1,1,0, 16992
16,16994,2,2,1, 16996
14,16994,3,3,1, 16997
13,16994,4,4,1, 16998
22,17001,4,4,1, 17005
24,17004,1,1,0, 17005
23,17003,3,3,1, 17006
6,17010,2,2,1, 17012
31,17011,2,2,1, 17013
7,17012,1,1,1, 17013
29,17013,4,4,1, 17017
8,17016,1,1,1, 17017
14,17019,3,3,1, 17022
24,17029,1,1,0, 17030
23,17028,3,3,1, 17031
21,17027,5,5,1, 17032
30,17033,3,3,1, 17036
6,17035,2,2,1, 17037
7,17037,1,1,0, 17038
8,17041,1,1,1, 17042
16,17044,2,2,1, 17046
14,17044,3,3,1, 17047
15,17046,2,2,1, 17048
22,17051,4,4,1, 17055
24,17054,1,1,0, 17055
21,17052,5,5,1, 17057
7,17062,1,1,0, 17063
8,17066,1,1,1, 17067
14,17069,3,3,1, 17072
13,17069,4,4,1, 17073
15,17071,2,2,1, 17073
24,17079,1,1,0, 17080
21,17077,5,5,1, 17082
6,17085,2,2,1, 17087
7,17087,1,1,1, 17088
29,17088,4,4,1, 17092
8,17091,1,1,0, 17092
14,17094,3,3,1, 17097
13,17094,4,4,1, 17098
12,17095,5,5,1, 17100
2,17103,2,2,1, 17105
24,17104,1,1,0, 17105
1,17106,1,1,1, 17107
4,17106,4,4,1, 17110
3,17107,3,3,1, 17110
30,17108,3,3,1, 17111
6,17110,2,2,1, 17112
7,17112,1,1,1, 17113
29,17113,4,4,1, 17117
8,17116,1,1,1, 17117
11,17114,4,4,1, 17118
14,17119,3,3,1, 17122
17,17119,3,3,1, 17122
13,17119,4,4,1, 17123
15,17121,2,2,1, 17123
20,17123,6,6,1, 17129
22,17126,4,4,1, 17130
2,17128,2,2,1, 17130
24,17129,1,1,1, 17130
19,17126,5,5,1, 17131
23,17128,3,3,1, 17131
1,17131,1,1,1, 17132
5,17132,3,3,1, 17135
27,17132,4,4,1, 17136
30,17133,3,3,1, 17136
25,17135,2,2,1, 17137
7,17137,1,1,0, 17138
28,17134,5,5,1, 17139
26,17137,3,3,1, 17140
29,17138,4,4,1, 17142
8,17141,1,1,0, 17142
9,17142,2,2,1, 17144
16,17144,2,2,1, 17146
17,17144,3,3,1, 17147
13,17144,4,4,1, 17148
20,17148,6,6,1, 17154
2,17153,2,2,1, 17155
24,17154,1,1,0, 17155
1,17156,1,1,0, 17157
5,17157,3,3,1, 17160
27,17157,4,4,1, 17161
6,17160,2,2,1, 17162
31,17161,2,2,1, 17163
7,17162,1,1,0, 17163
18,17173,4,4,1, 17177
20,17173,6,6,1, 17179
2,17178,2,2,1, 17180
24,17179,1,1,1, 17180
5,17182,3,3,1, 17185
7,17187,1,1,0, 17188
29,17188,4,4,1, 17192
24,17204,1,1,1, 17205
30,17208,3,3,1, 17211
31,17211,2,2,1, 17213
7,17212,1,1,1, 17213
29,17213,4,4,1, 17217
24,17229,1,1,0, 17230
5,17232,3,3,1, 17235
30,17233,3,3,1, 17236
6,17235,2,2,1, 17237
7,17237,1,1,0, 17238
29,17238,4,4,1, 17242
22,17251,4,4,1, 17255
24,17254,1,1,0, 17255
23,17253,3,3,1, 17256
21,17252,5,5,1, 17257
30,17258,3,3,1, 17261
31,17261,2,2,1, 17263
7,17262,1,1,0, 17263
29,17263,4,4,1, 17267
8,17266,1,1,1, 17267
13,17269,4,4,1, 17273
22,17276,4,4,1, 17280
24,17279,1,1,1, 17280
25,17285,2,2,1, 17287
7,17287,1,1,0, 17288
29,17288,4,4,1, 17292
8,17291,1,1,1, 17292
16,17294,2,2,1, 17296
14,17294,3,3,1, 17297
17,17294,3,3,1, 17297
13,17294,4,4,1, 17298
22,17301,4,4,1, 17305
24,17304,1,1,1, 17305
1,17306,1,1,1, 17307
5,17307,3,3,1, 17310
30,17308,3,3,1, 17311
6,17310,2,2,1, 17312
7,17312,1,1,0, 17313
29,17313,4,4,1, 17317
8,17316,1,1,1, 17317
9,17317,2,2,1, 17319
16,17319,2,2,1, 17321
17,17319,3,3,1, 17322
22,17326,4,4,1, 17330
2,17328,2,2,1, 17330
24,17329,1,1,1, 17330
19,17326,5,5,1, 17331
23,17328,3,3,1, 17331
21,17327,5,5,1, 17332
1,17331,1,1,0, 17332
5,17332,3,3,1, 17335
30,17333,3,3,1, 17336
7,17337,1,1,0, 17338
29,17338,4,4,1, 17342
8,17341,1,1,1, 17342
18,17348,4,4,1, 17352
24,17354,1,1,0, 17355
1,17356,1,1,0, 17357
25,17360,2,2,1, 17362
31,17361,2,2,1, 17363
7,17362,1,1,0, 17363
26,17362,3,3,1, 17365
8,17366,1,1,0, 17367
9,17367,2,2,1, 17369
16,17369,2,2,1, 17371
14,17369,3,3,1, 17372
18,17373,4,4,1, 17377
24,17379,1,1,0, 17380
1,17381,1,1,1, 17382
30,17383,3,3,1, 17386
25,17385,2,2,1, 17387
31,17386,2,2,1, 17388
7,17387,1,1,1, 17388
29,17388,4,4,1, 17392
8,17391,1,1,0, 17392
16,17394,2,2,1, 17396
14,17394,3,3,1, 17397
22,17401,4,4,1, 17405
2,17403,2,2,1, 17405
24,17404,1,1,1, 17405
23,17403,3,3,1, 17406
21,17402,5,5,1, 17407
1,17406,1,1,0, 17407
5,17407,3,3,1, 17410
30,17408,3,3,1, 17411
25,17410,2,2,1, 17412
31,17411,2,2,1, 17413
7,17412,1,1,0, 17413
26,17412,3,3,1, 17415
29,17413,4,4,1, 17417
8,17416,1,1,1, 17417
16,17419,2,2,1, 17421
13,17419,4,4,1, 17423
24,17429,1,1,0, 17430
23,17428,3,3,1, 17431
21,17427,5,5,1, 17432
1,17431,1,1,1, 17432
5,17432,3,3,1, 17435
30,17433,3,3,1, 17436
6,17435,2,2,1, 17437
31,17436,2,2,1, 17438
7,17437,1,1,1, 17438
28,17434,5,5,1, 17439
26,17437,3,3,1, 17440
29,17438,4,4,1, 17442
8,17441,1,1,1, 17442
11,17439,4,4,1, 17443
16,17444,2,2,1, 17446
13,17444,4,4,1, 17448
22,17451,4,4,1, 17455
2,17453,2,2,1, 17455
24,17454,1,1,0, 17455
19,17451,5,5,1, 17456
21,17452,5,5,1, 17457
1,17456,1,1,0, 17457
30,17458,3,3,1, 17461
6,17460,2,2,1, 17462
31,17461,2,2,1, 17463
7,17462,1,1,1, 17463
28,17459,5,5,1, 17464
26,17462,3,3,1, 17465
29,17463,4,4,1, 17467
8,17466,1,1,1, 17467
14,17469,3,3,1, 17472
17,17469,3,3,1, 17472
15,17471,2,2,1, 17473
12,17470,5,5,1, 17475
2,17478,2,2,1, 17480
24,17479,1,1,0, 17480
19,17476,5,5,1, 17481
1,17481,1,1,0, 17482
4,17481,4,4,1, 17485
3,17482,3,3,1, 17485
28,17484,5,5,1, 17489
11,17489,4,4,1, 17493
17,17494,3,3,1, 17497
12,17495,5,5,1, 17500
20,17498,6,6,1, 17504
24,17504,1,1,1, 17505
19,17501,5,5,1, 17506
24,17529,1,1,0, 17530
24,17554,1,1,0, 17555
22,17576,4,4,1, 17580
24,17579,1,1,1, 17580
21,17577,5,5,1, 17582
30,17583,3,3,1, 17586
7,17587,1,1,0, 17588
8,17591,1,1,1, 17592
22,17601,4,4,1, 17605
24,17604,1,1,1, 17605
23,17603,3,3,1, 17606
30,17608,3,3,1, 17611
6,17610,2,2,1, 17612
31,17611,2,2,1, 17613
7,17612,1,1,1, 17613
8,17616,1,1,1, 17617
9,17617,2,2,1, 17619
16,17619,2,2,1, 17621
17,17619,3,3,1, 17622
13,17619,4,4,1, 17623
15,17621,2,2,1, 17623
22,17626,4,4,1, 17630
24,17629,1,1,0, 17630
23,17628,3,3,1, 17631
1,17631,1,1,1, 17632
5,17632,3,3,1, 17635
25,17635,2,2,1, 17637
31,17636,2,2,1, 17638
7,17637,1,1,1, 17638
8,17641,1,1,1, 17642
9,17642,2,2,1, 17644
16,17644,2,2,1, 17646
24,17654,1,1,0, 17655
23,17653,3,3,1, 17656
21,17652,5,5,1, 17657
1,17656,1,1,1, 17657
6,17660,2,2,1, 17662
25,17660,2,2,1, 17662
31,17661,2,2,1, 17663
7,17662,1,1,1, 17663
29,17663,4,4,1, 17667
8,17666,1,1,1, 17667
16,17669,2,2,1, 17671
13,17669,4,4,1, 17673
24,17679,1,1,1, 17680
21,17677,5,5,1, 17682
1,17681,1,1,0, 17682
5,17682,3,3,1, 17685
27,17682,4,4,1, 17686
30,17683,3,3,1, 17686
25,17685,2,2,1, 17687
31,17686,2,2,1, 17688
7,17687,1,1,0, 17688
28,17684,5,5,1, 17689
26,17687,3,3,1, 17690
8,17691,1,1,1, 17692
9,17692,2,2,1, 17694
16,17694,2,2,1, 17696
13,17694,4,4,1, 17698
15,17696,2,2,1, 17698
12,17695,5,5,1, 17700
18,17698,4,4,1, 17702
20,17698,6,6,1, 17704
24,17704,1,1,1, 17705
23,17703,3,3,1, 17706
21,17702,5,5,1, 17707
1,17706,1,1,0, 17707
4,17706,4,4,1, 17710
3,17707,3,3,1, 17710
30,17708,3,3,1, 17711
6,17710,2,2,1, 17712
25,17710,2,2,1, 17712
7,17712,1,1,1, 17713
8,17716,1,1,1, 17717
11,17714,4,4,1, 17718
9,17717,2,2,1, 17719
14,17719,3,3,1, 17722
15,17721,2,2,1, 17723
20,17723,6,6,1, 17729
22,17726,4,4,1, 17730
2,17728,2,2,1, 17730
24,17729,1,1,0, 17730
1,17731,1,1,1, 17732
5,17732,3,3,1, 17735
30,17733,3,3,1, 17736
31,17736,2,2,1, 17738
7,17737,1,1,1, 17738
28,17734,5,5,1, 17739
26,17737,3,3,1, 17740
8,17741,1,1,0, 17742
11,17739,4,4,1, 17743
24,17754,1,1,0, 17755
23,17753,3,3,1, 17756
21,17752,5,5,1, 17757
1,17756,1,1,1, 17757
5,17757,3,3,1, 17760
6,17760,2,2,1, 17762
25,17760,2,2,1, 17762
31,17761,2,2,1, 17763
7,17762,1,1,1, 17763
29,17763,4,4,1, 17767
8,17766,1,1,0, 17767
9,17767,2,2,1, 17769
14,17769,3,3,1, 17772
13,17769,4,4,1, 17773
15,17771,2,2,1, 17773
18,17773,4,4,1, 17777
2,17778,2,2,1, 17780
24,17779,1,1,0, 17780
23,17778,3,3,1, 17781
7,17787,1,1,1, 17788
29,17788,4,4,1, 17792
8,17791,1,1,0, 17792
16,17794,2,2,1, 17796
13,17794,4,4,1, 17798
24,17804,1,1,0, 17805
7,17812,1,1,0, 17813
29,17813,4,4,1, 17817
24,17829,1,1,0, 17830
30,17833,3,3,1, 17836
7,17837,1,1,0, 17838
29,17838,4,4,1, 17842
24,17854,1,1,1, 17855
5,17857,3,3,1, 17860
7,17862,1,1,1, 17863
24,17879,1,1,1, 17880
1,17881,1,1,0, 17882
27,17882,4,4,1, 17886
6,17885,2,2,1, 17887
25,17885,2,2,1, 17887
7,17887,1,1,0, 17888
11,17889,4,4,1, 17893
9,17892,2,2,1, 17894
17,17894,3,3,1, 17897
20,17898,6,6,1, 17904
24,17904,1,1,0, 17905
23,17903,3,3,1, 17906
1,17906,1,1,1, 17907
3,17907,3,3,1, 17910
25,17910,2,2,1, 17912
31,17911,2,2,1, 17913
7,17912,1,1,0, 17913
29,17913,4,4,1, 17917
8,17916,1,1,1, 17917
11,17914,4,4,1, 17918
9,17917,2,2,1, 17919
13,17919,4,4,1, 17923
12,17920,5,5,1, 17925
22,17926,4,4,1, 17930
2,17928,2,2,1, 17930
24,17929,1,1,1, 17930
1,17931,1,1,0, 17932
4,17931,4,4,1, 17935
30,17933,3,3,1, 17936
6,17935,2,2,1, 17937
25,17935,2,2,1, 17937
7,17937,1,1,1, 17938
8,17941,1,1,0, 17942
11,17939,4,4,1, 17943
14,17944,3,3,1, 17947
15,17946,2,2,1, 17948
18,17948,4,4,1, 17952
24,17954,1,1,1, 17955
23,17953,3,3,1, 17956
1,17956,1,1,0, 17957
3,17957,3,3,1, 17960
5,17957,3,3,1, 17960
25,17960,2,2,1, 17962
31,17961,2,2,1, 17963
7,17962,1,1,0, 17963
26,17962,3,3,1, 17965
29,17963,4,4,1, 17967
8,17966,1,1,0, 17967
14,17969,3,3,1, 17972
13,17969,4,4,1, 17973
22,17976,4,4,1, 17980
24,17979,1,1,0, 17980
23,17978,3,3,1, 17981
5,17982,3,3,1, 17985
7,17987,1,1,0, 17988
8,17991,1,1,1, 17992
16,17994,2,2,1, 17996
15,17996,2,2,1, 17998
24,18004,1,1,1, 18005
21,18002,5,5,1, 18007
30,18008,3,3,1, 18011
6,18010,2,2,1, 18012
7,18012,1,1,1, 18013
8,18016,1,1,1, 18017
14,18019,3,3,1, 18022
24,18029,1,1,1, 18030
21,18027,5,5,1, 18032
30,18033,3,3,1, 18036
7,18037,1,1,1, 18038
8,18041,1,1,0, 18042
24,18054,1,1,1, 18055
23,18053,3,3,1, 18056
21,18052,5,5,1, 18057
5,18057,3,3,1, 18060
6,18060,2,2,1, 18062
31,18061,2,2,1, 18063
7,18062,1,1,0, 18063
29,18063,4,4,1, 18067
8,18066,1,1,0, 18067
9,18067,2,2,1, 18069
16,18069,2,2,1, 18071
14,18069,3,3,1, 18072
17,18069,3,3,1, 18072
15,18071,2,2,1, 18073
24,18079,1,1,1, 18080
21,18077,5,5,1, 18082
1,18081,1,1,1, 18082
25,18085,2,2,1, 18087
7,18087,1,1,0, 18088
29,18088,4,4,1, 18092
8,18091,1,1,1, 18092
16,18094,2,2,1, 18096
17,18094,3,3,1, 18097
24,18104,1,1,1, 18105
23,18103,3,3,1, 18106
21,18102,5,5,1, 18107
1,18106,1,1,0, 18107
27,18107,4,4,1, 18111
30,18108,3,3,1, 18111
6,18110,2,2,1, 18112
31,18111,2,2,1, 18113
7,18112,1,1,0, 18113
28,18109,5,5,1, 18114
29,18113,4,4,1, 18117
8,18116,1,1,1, 18117
16,18119,2,2,1, 18121
14,18119,3,3,1, 18122
17,18119,3,3,1, 18122
18,18123,4,4,1, 18127
22,18126,4,4,1, 18130
2,18128,2,2,1, 18130
24,18129,1,1,1, 18130
23,18128,3,3,1, 18131
1,18131,1,1,0, 18132
27,18132,4,4,1, 18136
25,18135,2,2,1, 18137
7,18137,1,1,0, 18138
28,18134,5,5,1, 18139
8,18141,1,1,0, 18142
9,18142,2,2,1, 18144
17,18144,3,3,1, 18147
13,18144,4,4,1, 18148
12,18145,5,5,1, 18150
18,18148,4,4,1, 18152
2,18153,2,2,1, 18155
24,18154,1,1,1, 18155
23,18153,3,3,1, 18156
1,18156,1,1,1, 18157
6,18160,2,2,1, 18162
25,18160,2,2,1, 18162
31,18161,2,2,1, 18163
7,18162,1,1,0, 18163
28,18159,5,5,1, 18164
8,18166,1,1,0, 18167
11,18164,4,4,1, 18168
9,18167,2,2,1, 18169
16,18169,2,2,1, 18171
14,18169,3,3,1, 18172
17,18169,3,3,1, 18172
22,18176,4,4,1, 18180
24,18179,1,1,0, 18180
1,18181,1,1,1, 18182
4,18181,4,4,1, 18185
30,18183,3,3,1, 18186
6,18185,2,2,1, 18187
7,18187,1,1,1, 18188
8,18191,1,1,1, 18192
14,18194,3,3,1, 18197
13,18194,4,4,1, 18198
24,18204,1,1,1, 18205
23,18203,3,3,1, 18206
21,18202,5,5,1, 18207
5,18207,3,3,1, 18210
6,18210,2,2,1, 18212
31,18211,2,2,1, 18213
7,18212,1,1,1, 18213
8,18216,1,1,0, 18217
16,18219,2,2,1, 18221
13,18219,4,4,1, 18223
24,18229,1,1,1, 18230
30,18233,3,3,1, 18236
6,18235,2,2,1, 18237
7,18237,1,1,1, 18238
24,18254,1,1,1, 18255
30,18258,3,3,1, 18261
31,18261,2,2,1, 18263
7,18262,1,1,1, 18263
29,18263,4,4,1, 18267
24,18279,1,1,1, 18280
30,18283,3,3,1, 18286
6,18285,2,2,1, 18287
31,18286,2,2,1, 18288
7,18287,1,1,1, 18288
17,18294,3,3,1, 18297
2,18303,2,2,1, 18305
24,18304,1,1,0, 18305
19,18301,5,5,1, 18306
1,18306,1,1,0, 18307
27,18307,4,4,1, 18311
25,18310,2,2,1, 18312
7,18312,1,1,1, 18313
26,18312,3,3,1, 18315
11,18314,4,4,1, 18318
17,18319,3,3,1, 18322
12,18320,5,5,1, 18325
18,18323,4,4,1, 18327
22,18326,4,4,1, 18330
24,18329,1,1,0, 18330
19,18326,5,5,1, 18331
23,18328,3,3,1, 18331
1,18331,1,1,1, 18332
3,18332,3,3,1, 18335
30,18333,3,3,1, 18336
31,18336,2,2,1, 18338
7,18337,1,1,0, 18338
29,18338,4,4,1, 18342
8,18341,1,1,0, 18342
11,18339,4,4,1, 18343
9,18342,2,2,1, 18344
13,18344,4,4,1, 18348
15,18346,2,2,1, 18348
12,18345,5,5,1, 18350
18,18348,4,4,1, 18352
24,18354,1,1,0, 18355
23,18353,3,3,1, 18356
21,18352,5,5,1, 18357
1,18356,1,1,1, 18357
5,18357,3,3,1, 18360
27,18357,4,4,1, 18361
30,18358,3,3,1, 18361
6,18360,2,2,1, 18362
25,18360,2,2,1, 18362
7,18362,1,1,1, 18363
8,18366,1,1,0, 18367
16,18369,2,2,1, 18371
14,18369,3,3,1, 18372
13,18369,4,4,1, 18373
22,18376,4,4,1, 18380
24,18379,1,1,0, 18380
23,18378,3,3,1, 18381
5,18382,3,3,1, 18385
30,18383,3,3,1, 18386
6,18385,2,2,1, 18387
31,18386,2,2,1, 18388
7,18387,1,1,0, 18388
8,18391,1,1,1, 18392
16,18394,2,2,1, 18396
13,18394,4,4,1, 18398
15,18396,2,2,1, 18398
24,18404,1,1,1, 18405
21,18402,5,5,1, 18407
6,18410,2,2,1, 18412
7,18412,1,1,1, 18413
8,18416,1,1,0, 18417
16,18419,2,2,1, 18421
13,18419,4,4,1, 18423
15,18421,2,2,1, 18423
22,18426,4,4,1, 18430
24,18429,1,1,0, 18430
6,18435,2,2,1, 18437
31,18436,2,2,1, 18438
7,18437,1,1,1, 18438
8,18441,1,1,1, 18442
14,18444,3,3,1, 18447
13,18444,4,4,1, 18448
22,18451,4,4,1, 18455
24,18454,1,1,0, 18455
21,18452,5,5,1, 18457
5,18457,3,3,1, 18460
30,18458,3,3,1, 18461
31,18461,2,2,1, 18463
7,18462,1,1,1, 18463
8,18466,1,1,0, 18467
14,18469,3,3,1, 18472
17,18469,3,3,1, 18472
15,18471,2,2,1, 18473
22,18476,4,4,1, 18480
24,18479,1,1,0, 18480
21,18477,5,5,1, 18482
1,18481,1,1,0, 18482
5,18482,3,3,1, 18485
6,18485,2,2,1, 18487
7,18487,1,1,0, 18488
9,18492,2,2,1, 18494
17,18494,3,3,1, 18497
24,18504,1,1,1, 18505
1,18506,1,1,1, 18507
5,18507,3,3,1, 18510
30,18508,3,3,1, 18511
25,18510,2,2,1, 18512
7,18512,1,1,1, 18513
29,18513,4,4,1, 18517
9,18517,2,2,1, 18519
24,18529,1,1,0, 18530
1,18531,1,1,0, 18532
5,18532,3,3,1, 18535
30,18533,3,3,1, 18536
6,18535,2,2,1, 18537
7,18537,1,1,1, 18538
26,18537,3,3,1, 18540
29,18538,4,4,1, 18542
9,18542,2,2,1, 18544
17,18544,3,3,1, 18547
18,18548,4,4,1, 18552
2,18553,2,2,1, 18555
24,18554,1,1,0, 18555
1,18556,1,1,0, 18557
30,18558,3,3,1, 18561
31,18561,2,2,1, 18563
7,18562,1,1,0, 18563
26,18562,3,3,1, 18565
29,18563,4,4,1, 18567
9,18567,2,2,1, 18569
17,18569,3,3,1, 18572
18,18573,4,4,1, 18577
2,18578,2,2,1, 18580
24,18579,1,1,0, 18580
1,18581,1,1,1, 18582
30,18583,3,3,1, 18586
25,18585,2,2,1, 18587
7,18587,1,1,1, 18588
26,18587,3,3,1, 18590
29,18588,4,4,1, 18592
8,18591,1,1,0, 18592
13,18594,4,4,1, 18598
15,18596,2,2,1, 18598
22,18601,4,4,1, 18605
2,18603,2,2,1, 18605
24,18604,1,1,0, 18605
23,18603,3,3,1, 18606
1,18606,1,1,0, 18607
6,18610,2,2,1, 18612
7,18612,1,1,1, 18613
26,18612,3,3,1, 18615
29,18613,4,4,1, 18617
8,18616,1,1,1, 18617
9,18617,2,2,1, 18619
12,18620,5,5,1, 18625
24,18629,1,1,1, 18630
23,18628,3,3,1, 18631
21,18627,5,5,1, 18632
1,18631,1,1,1, 18632
4,18631,4,4,1, 18635
27,18632,4,4,1, 18636
25,18635,2,2,1, 18637
7,18637,1,1,1, 18638
28,18634,5,5,1, 18639
29,18638,4,4,1, 18642
8,18641,1,1,1, 18642
11,18639,4,4,1, 18643
9,18642,2,2,1, 18644
16,18644,2,2,1, 18646
13,18644,4,4,1, 18648
12,18645,5,5,1, 18650
20,18648,6,6,1, 18654
24,18654,1,1,1, 18655
21,18652,5,5,1, 18657
6,18660,2,2,1, 18662
7,18662,1,1,0, 18663
29,18663,4,4,1, 18667
8,18666,1,1,0, 18667
14,18669,3,3,1, 18672
22,18676,4,4,1, 18680
24,18679,1,1,1, 18680
21,18677,5,5,1, 18682
6,18685,2,2,1, 18687
31,18686,2,2,1, 18688
7,18687,1,1,0, 18688
29,18688,4,4,1, 18692
8,18691,1,1,1, 18692
22,18701,4,4,1, 18705
24,18704,1,1,0, 18705
23,18703,3,3,1, 18706
21,18702,5,5,1, 18707
30,18708,3,3,1, 18711
31,18711,2,2,1, 18713
7,18712,1,1,0, 18713
8,18716,1,1,0, 18717
14,18719,3,3,1, 18722
15,18721,2,2,1, 18723
22,18726,4,4,1, 18730
24,18729,1,1,1, 18730
23,18728,3,3,1, 18731
5,18732,3,3,1, 18735
6,18735,2,2,1, 18737
31,18736,2,2,1, 18738
7,18737,1,1,1, 18738
8,18741,1,1,1, 18742
24,18754,1,1,0, 18755
30,18758,3,3,1, 18761
6,18760,2,2,1, 18762
7,18762,1,1,1, 18763
29,18763,4,4,1, 18767
8,18766,1,1,1, 18767
9,18767,2,2,1, 18769
16,18769,2,2,1, 18771
14,18769,3,3,1, 18772
17,18769,3,3,1, 18772
13,18769,4,4,1, 18773
22,18776,4,4,1, 18780
24,18779,1,1,0, 18780
23,18778,3,3,1, 18781
1,18781,1,1,0, 18782
5,18782,3,3,1, 18785
6,18785,2,2,1, 18787
25,18785,2,2,1, 18787
31,18786,2,2,1, 18788
7,18787,1,1,0, 18788
8,18791,1,1,1, 18792
9,18792,2,2,1, 18794
17,18794,3,3,1, 18797
15,18796,2,2,1, 18798
24,18804,1,1,0, 18805
23,18803,3,3,1, 18806
21,18802,5,5,1, 18807
1,18806,1,1,0, 18807
25,18810,2,2,1, 18812
7,18812,1,1,0, 18813
8,18816,1,1,1, 18817
9,18817,2,2,1, 18819
17,18819,3,3,1, 18822
13,18819,4,4,1, 18823
15,18821,2,2,1, 18823
20,18823,6,6,1, 18829
22,18826,4,4,1, 18830
2,18828,2,2,1, 18830
24,18829,1,1,0, 18830
19,18826,5,5,1, 18831
23,18828,3,3,1, 18831
1,18831,1,1,0, 18832
3,18832,3,3,1, 18835
27,18832,4,4,1, 18836
6,18835,2,2,1, 18837
31,18836,2,2,1, 18838
7,18837,1,1,0, 18838
28,18834,5,5,1, 18839
8,18841,1,1,1, 18842
9,18842,2,2,1, 18844
14,18844,3,3,1, 18847
18,18848,4,4,1, 18852
22,18851,4,4,1, 18855
24,18854,1,1,0, 18855
1,18856,1,1,0, 18857
25,18860,2,2,1, 18862
7,18862,1,1,0, 18863
29,18863,4,4,1, 18867
8,18866,1,1,0, 18867
16,18869,2,2,1, 18871
14,18869,3,3,1, 18872
13,18869,4,4,1, 18873
2,18878,2,2,1, 18880
24,18879,1,1,0, 18880
1,18881,1,1,0, 18882
5,18882,3,3,1, 18885
30,18883,3,3,1, 18886
6,18885,2,2,1, 18887
7,18887,1,1,0, 18888
8,18891,1,1,1, 18892
14,18894,3,3,1, 18897
17,18894,3,3,1, 18897
13,18894,4,4,1, 18898
18,18898,4,4,1, 18902
2,18903,2,2,1, 18905
24,18904,1,1,0, 18905
1,18906,1,1,1, 18907
5,18907,3,3,1, 18910
6,18910,2,2,1, 18912
25,18910,2,2,1, 18912
31,18911,2,2,1, 18913
7,18912,1,1,0, 18913
29,18913,4,4,1, 18917
17,18919,3,3,1, 18922
24,18929,1,1,0, 18930
1,18931,1,1,0, 18932
30,18933,3,3,1, 18936
6,18935,2,2,1, 18937
31,18936,2,2,1, 18938
7,18937,1,1,0, 18938
26,18937,3,3,1, 18940
9,18942,2,2,1, 18944
18,18948,4,4,1, 18952
2,18953,2,2,1, 18955
24,18954,1,1,0, 18955
19,18951,5,5,1, 18956
1,18956,1,1,1, 18957
4,18956,4,4,1, 18960
3,18957,3,3,1, 18960
27,18957,4,4,1, 18961
30,18958,3,3,1, 18961
6,18960,2,2,1, 18962
7,18962,1,1,0, 18963
24,18979,1,1,1, 18980
6,18985,2,2,1, 18987
31,18986,2,2,1, 18988
7,18987,1,1,0, 18988
24,19004,1,1,0, 19005
23,19003,3,3,1, 19006
21,19002,5,5,1, 19007
5,19007,3,3,1, 19010
31,19011,2,2,1, 19013
7,19012,1,1,1, 19013
8,19016,1,1,0, 19017
16,19019,2,2,1, 19021
14,19019,3,3,1, 19022
24,19029,1,1,0, 19030
23,19028,3,3,1, 19031
21,19027,5,5,1, 19032
5,19032,3,3,1, 19035
30,19033,3,3,1, 19036
6,19035,2,2,1, 19037
31,19036,2,2,1, 19038
8,19041,1,1,0, 19042
16,19044,2,2,1, 19046
24,19054,1,1,1, 19055
8,19066,1,1,0, 19067
9,19067,2,2,1, 19069
13,19069,4,4,1, 19073
15,19071,2,2,1, 19073
22,19076,4,4,1, 19080
24,19079,1,1,1, 19080
21,19077,5,5,1, 19082
1,19081,1,1,0, 19082
8,19091,1,1,0, 19092
9,19092,2,2,1, 19094
16,19094,2,2,1, 19096
14,19094,3,3,1, 19097
17,19094,3,3,1, 19097
15,19096,2,2,1, 19098
24,19104,1,1,1, 19105
23,19103,3,3,1, 19106
21,19102,5,5,1, 19107
1,19106,1,1,0, 19107
8,19116,1,1,0, 19117
16,19119,2,2,1, 19121
14,19119,3,3,1, 19122
13,19119,4,4,1, 19123
22,19126,4,4,1, 19130
24,19129,1,1,0, 19130
23,19128,3,3,1, 19131
21,19127,5,5,1, 19132
1,19131,1,1,1, 19132
26,19137,3,3,1, 19140
8,19141,1,1,0, 19142
16,19144,2,2,1, 19146
13,19144,4,4,1, 19148
2,19153,2,2,1, 19155
24,19154,1,1,1, 19155
1,19156,1,1,0, 19157
6,19160,2,2,1, 19162
31,19161,2,2,1, 19163
7,19162,1,1,0, 19163
26,19162,3,3,1, 19165
24,19179,1,1,1, 19180
1,19181,1,1,0, 19182
6,19185,2,2,1, 19187
7,19187,1,1,1, 19188
26,19187,3,3,1, 19190
12,19195,5,5,1, 19200
18,19198,4,4,1, 19202
2,19203,2,2,1, 19205
24,19204,1,1,1, 19205
19,19201,5,5,1, 19206
1,19206,1,1,1, 19207
3,19207,3,3,1, 19210
30,19208,3,3,1, 19211
25,19210,2,2,1, 19212
31,19211,2,2,1, 19213
7,19212,1,1,1, 19213
28,19209,5,5,1, 19214
26,19212,3,3,1, 19215
29,19213,4,4,1, 19217
11,19214,4,4,1, 19218
9,19217,2,2,1, 19219
12,19220,5,5,1, 19225
24,19229,1,1,1, 19230
1,19231,1,1,1, 19232
4,19231,4,4,1, 19235
3,19232,3,3,1, 19235
5,19232,3,3,1, 19235
27,19232,4,4,1, 19236
30,19233,3,3,1, 19236
31,19236,2,2,1, 19238
7,19237,1,1,0, 19238
26,19237,3,3,1, 19240
17,19244,3,3,1, 19247
12,19245,5,5,1, 19250
18,19248,4,4,1, 19252
22,19251,4,4,1, 19255
2,19253,2,2,1, 19255
24,19254,1,1,0, 19255
19,19251,5,5,1, 19256
23,19253,3,3,1, 19256
1,19256,1,1,0, 19257
4,19256,4,4,1, 19260
3,19257,3,3,1, 19260
5,19257,3,3,1, 19260
30,19258,3,3,1, 19261
6,19260,2,2,1, 19262
25,19260,2,2,1, 19262
31,19261,2,2,1, 19263
7,19262,1,1,1, 19263
29,19263,4,4,1, 19267
8,19266,1,1,0, 19267
16,19269,2,2,1, 19271
14,19269,3,3,1, 19272
22,19276,4,4,1, 19280
24,19279,1,1,1, 19280
30,19283,3,3,1, 19286
6,19285,2,2,1, 19287
31,19286,2,2,1, 19288
7,19287,1,1,0, 19288
29,19288,4,4,1, 19292
8,19291,1,1,1, 19292
16,19294,2,2,1, 19296
14,19294,3,3,1, 19297
15,19296,2,2,1, 19298
24,19304,1,1,0, 19305
23,19303,3,3,1, 19306
21,19302,5,5,1, 19307
5,19307,3,3,1, 19310
30,19308,3,3,1, 19311
6,19310,2,2,1, 19312
31,19311,2,2,1, 19313
7,19312,1,1,1, 19313
29,19313,4,4,1, 19317
8,19316,1,1,0, 19317
14,19319,3,3,1, 19322
24,19329,1,1,0, 19330
23,19328,3,3,1, 19331
21,19327,5,5,1, 19332
7,19337,1,1,1, 19338
8,19341,1,1,0, 19342
16,19344,2,2,1, 19346
14,19344,3,3,1, 19347
13,19344,4,4,1, 19348
22,19351,4,4,1, 19355
24,19354,1,1,1, 19355
23,19353,3,3,1, 19356
21,19352,5,5,1, 19357
30,19358,3,3,1, 19361
6,19360,2,2,1, 19362
31,19361,2,2,1, 19363
7,19362,1,1,1, 19363
8,19366,1,1,1, 19367
9,19367,2,2,1, 19369
17,19369,3,3,1, 19372
24,19379,1,1,1, 19380
21,19377,5,5,1, 19382
1,19381,1,1,0, 19382
5,19382,3,3,1, 19385
6,19385,2,2,1, 19387
31,19386,2,2,1, 19388
7,19387,1,1,1, 19388
29,19388,4,4,1, 19392
8,19391,1,1,1, 19392
9,19392,2,2,1, 19394
16,19394,2,2,1, 19396
17,19394,3,3,1, 19397
13,19394,4,4,1, 19398
15,19396,2,2,1, 19398
18,19398,4,4,1, 19402
24,19404,1,1,0, 19405
21,19402,5,5,1, 19407
1,19406,1,1,1, 19407
30,19408,3,3,1, 19411
7,19412,1,1,0, 19413
29,19413,4,4,1, 19417
8,19416,1,1,1, 19417
14,19419,3,3,1, 19422
13,19419,4,4,1, 19423
18,19423,4,4,1, 19427
24,19429,1,1,1, 19430
23,19428,3,3,1, 19431
1,19431,1,1,0, 19432
31,19436,2,2,1, 19438
7,19437,1,1,0, 19438
26,19437,3,3,1, 19440
29,19438,4,4,1, 19442
8,19441,1,1,1, 19442
9,19442,2,2,1, 19444
16,19444,2,2,1, 19446
18,19448,4,4,1, 19452
24,19454,1,1,0, 19455
1,19456,1,1,1, 19457
5,19457,3,3,1, 19460
25,19460,2,2,1, 19462
7,19462,1,1,0, 19463
29,19463,4,4,1, 19467
9,19467,2,2,1, 19469
2,19478,2,2,1, 19480
24,19479,1,1,0, 19480
1,19481,1,1,0, 19482
30,19483,3,3,1, 19486
31,19486,2,2,1, 19488
7,19487,1,1,0, 19488
29,19488,4,4,1, 19492
17,19494,3,3,1, 19497
24,19504,1,1,1, 19505
1,19506,1,1,0, 19507
4,19506,4,4,1, 19510
3,19507,3,3,1, 19510
5,19507,3,3,1, 19510
27,19507,4,4,1, 19511
7,19512,1,1,0, 19513
26,19512,3,3,1, 19515
29,19513,4,4,1, 19517
11,19514,4,4,1, 19518
9,19517,2,2,1, 19519
17,19519,3,3,1, 19522
18,19523,4,4,1, 19527
24,19529,1,1,1, 19530
1,19531,1,1,1, 19532
5,19532,3,3,1, 19535
27,19532,4,4,1, 19536
30,19533,3,3,1, 19536
25,19535,2,2,1, 19537
31,19536,2,2,1, 19538
7,19537,1,1,0, 19538
26,19537,3,3,1, 19540
11,19539,4,4,1, 19543
12,19545,5,5,1, 19550
18,19548,4,4,1, 19552
24,19554,1,1,0, 19555
1,19556,1,1,1, 19557
4,19556,4,4,1, 19560
3,19557,3,3,1, 19560
6,19560,2,2,1, 19562
31,19561,2,2,1, 19563
7,19562,1,1,0, 19563
29,19563,4,4,1, 19567
8,19566,1,1,1, 19567
14,19569,3,3,1, 19572
13,19569,4,4,1, 19573
24,19579,1,1,1, 19580
23,19578,3,3,1, 19581
21,19577,5,5,1, 19582
6,19585,2,2,1, 19587
7,19587,1,1,1, 19588
8,19591,1,1,0, 19592
14,19594,3,3,1, 19597
22,19601,4,4,1, 19605
24,19604,1,1,1, 19605
23,19603,3,3,1, 19606
21,19602,5,5,1, 19607
5,19607,3,3,1, 19610
6,19610,2,2,1, 19612
31,19611,2,2,1, 19613
7,19612,1,1,1, 19613
8,19616,1,1,0, 19617
16,19619,2,2,1, 19621
14,19619,3,3,1, 19622
13,19619,4,4,1, 19623
15,19621,2,2,1, 19623
24,19629,1,1,0, 19630
21,19627,5,5,1, 19632
5,19632,3,3,1, 19635
30,19633,3,3,1, 19636
7,19637,1,1,1, 19638
8,19641,1,1,0, 19642
16,19644,2,2,1, 19646
13,19644,4,4,1, 19648
22,19651,4,4,1, 19655
24,19654,1,1,1, 19655
21,19652,5,5,1, 19657
5,19657,3,3,1, 19660
30,19658,3,3,1, 19661
6,19660,2,2,1, 19662
31,19661,2,2,1, 19663
7,19662,1,1,0, 19663
29,19663,4,4,1, 19667
8,19666,1,1,1, 19667
9,19667,2,2,1, 19669
17,19669,3,3,1, 19672
13,19669,4,4,1, 19673
15,19671,2,2,1, 19673
24,19679,1,1,0, 19680
23,19678,3,3,1, 19681
21,19677,5,5,1, 19682
1,19681,1,1,1, 19682
8,19691,1,1,0, 19692
9,19692,2,2,1, 19694
15,19696,2,2,1, 19698
24,19704,1,1,0, 19705
1,19706,1,1,1, 19707
25,19710,2,2,1, 19712
8,19716,1,1,1, 19717
9,19717,2,2,1, 19719
14,19719,3,3,1, 19722
13,19719,4,4,1, 19723
24,19729,1,1,1, 19730
21,19727,5,5,1, 19732
1,19731,1,1,0, 19732
26,19737,3,3,1, 19740
8,19741,1,1,1, 19742
9,19742,2,2,1, 19744
17,19744,3,3,1, 19747
24,19754,1,1,0, 19755
21,19752,5,5,1, 19757
1,19756,1,1,0, 19757
8,19766,1,1,1, 19767
9,19767,2,2,1, 19769
16,19769,2,2,1, 19771
17,19769,3,3,1, 19772
13,19769,4,4,1, 19773
18,19773,4,4,1, 19777
22,19776,4,4,1, 19780
24,19779,1,1,0, 19780
21,19777,5,5,1, 19782
1,19781,1,1,1, 19782
6,19785,2,2,1, 19787
25,19785,2,2,1, 19787
31,19786,2,2,1, 19788
7,19787,1,1,1, 19788
29,19788,4,4,1, 19792
8,19791,1,1,0, 19792
16,19794,2,2,1, 19796
17,19794,3,3,1, 19797
15,19796,2,2,1, 19798
12,19795,5,5,1, 19800
18,19798,4,4,1, 19802
24,19804,1,1,1, 19805
1,19806,1,1,0, 19807
4,19806,4,4,1, 19810
3,19807,3,3,1, 19810
6,19810,2,2,1, 19812
25,19810,2,2,1, 19812
7,19812,1,1,1, 19813
26,19812,3,3,1, 19815
11,19814,4,4,1, 19818
20,19823,6,6,1, 19829
24,19829,1,1,1, 19830
19,19826,5,5,1, 19831
1,19831,1,1,0, 19832
3,19832,3,3,1, 19835
5,19832,3,3,1, 19835
6,19835,2,2,1, 19837
7,19837,1,1,0, 19838
28,19834,5,5,1, 19839
26,19837,3,3,1, 19840
11,19839,4,4,1, 19843
17,19844,3,3,1, 19847
12,19845,5,5,1, 19850
20,19848,6,6,1, 19854
24,19854,1,1,1, 19855
1,19856,1,1,0, 19857
4,19856,4,4,1, 19860
5,19857,3,3,1, 19860
30,19858,3,3,1, 19861
31,19861,2,2,1, 19863
7,19862,1,1,0, 19863
29,19863,4,4,1, 19867
24,19879,1,1,1, 19880
30,19883,3,3,1, 19886
6,19885,2,2,1, 19887
31,19886,2,2,1, 19888
7,19887,1,1,1, 19888
29,19888,4,4,1, 19892
24,19904,1,1,1, 19905
23,19903,3,3,1, 19906
31,19911,2,2,1, 19913
7,19912,1,1,1, 19913
8,19916,1,1,0, 19917
16,19919,2,2,1, 19921
14,19919,3,3,1, 19922
15,19921,2,2,1, 19923
22,19926,4,4,1, 19930
24,19929,1,1,1, 19930
23,19928,3,3,1, 19931
21,19927,5,5,1, 19932
30,19933,3,3,1, 19936
7,19937,1,1,1, 19938
8,19941,1,1,1, 19942
16,19944,2,2,1, 19946
14,19944,3,3,1, 19947
24,19954,1,1,1, 19955
23,19953,3,3,1, 19956
5,19957,3,3,1, 19960
30,19958,3,3,1, 19961
6,19960,2,2,1, 19962
7,19962,1,1,0, 19963
29,19963,4,4,1, 19967
8,19966,1,1,1, 19967
9,19967,2,2,1, 19969
14,19969,3,3,1, 19972
17,19969,3,3,1, 19972
13,19969,4,4,1, 19973
15,19971,2,2,1, 19973
22,19976,4,4,1, 19980
24,19979,1,1,0, 19980
21,19977,5,5,1, 19982
1,19981,1,1,1, 19982
31,19986,2,2,1, 19988
7,19987,1,1,1, 19988
29,19988,4,4,1, 19992
8,19991,1,1,1, 19992
9,19992,2,2,1, 19994
14,19994,3,3,1, 19997
15,19996,2,2,1, 19998
22,20001,4,4,1, 20005
24,20004,1,1,1, 20005
1,20006,1,1,0, 20007
30,20008,3,3,1, 20011
7,20012,1,1,1, 20013
29,20013,4,4,1, 20017
8,20016,1,1,1, 20017
9,20017,2,2,1, 20019
16,20019,2,2,1, 20021
17,20019,3,3,1, 20022
13,20019,4,4,1, 20023
24,20029,1,1,1, 20030
1,20031,1,1,1, 20032
5,20032,3,3,1, 20035
30,20033,3,3,1, 20036
25,20035,2,2,1, 20037
31,20036,2,2,1, 20038
7,20037,1,1,1, 20038
29,20038,4,4,1, 20042
8,20041,1,1,0, 20042
9,20042,2,2,1, 20044
17,20044,3,3,1, 20047
13,20044,4,4,1, 20048
15,20046,2,2,1, 20048
24,20054,1,1,0, 20055
21,20052,5,5,1, 20057
1,20056,1,1,0, 20057
5,20057,3,3,1, 20060
25,20060,2,2,1, 20062
31,20061,2,2,1, 20063
7,20062,1,1,1, 20063
26,20062,3,3,1, 20065
29,20063,4,4,1, 20067
8,20066,1,1,0, 20067
16,20069,2,2,1, 20071
24,20079,1,1,0, 20080
21,20077,5,5,1, 20082
1,20081,1,1,1, 20082
5,20082,3,3,1, 20085
7,20087,1,1,0, 20088
26,20087,3,3,1, 20090
8,20091,1,1,1, 20092
16,20094,2,2,1, 20096
17,20094,3,3,1, 20097
13,20094,4,4,1, 20098
22,20101,4,4,1, 20105
24,20104,1,1,1, 20105
1,20106,1,1,0, 20107
30,20108,3,3,1, 20111
25,20110,2,2,1, 20112
7,20112,1,1,0, 20113
26,20112,3,3,1, 20115
8,20116,1,1,1, 20117
9,20117,2,2,1, 20119
14,20119,3,3,1, 20122
17,20119,3,3,1, 20122
22,20126,4,4,1, 20130
24,20129,1,1,0, 20130
21,20127,5,5,1, 20132
1,20131,1,1,1, 20132
5,20132,3,3,1, 20135
30,20133,3,3,1, 20136
6,20135,2,2,1, 20137
7,20137,1,1,1, 20138
26,20137,3,3,1, 20140
8,20141,1,1,0, 20142
16,20144,2,2,1, 20146
14,20144,3,3,1, 20147
17,20144,3,3,1, 20147
18,20148,4,4,1, 20152
24,20154,1,1,0, 20155
1,20156,1,1,0, 20157
30,20158,3,3,1, 20161
25,20160,2,2,1, 20162
7,20162,1,1,0, 20163
12,20170,5,5,1, 20175
24,20179,1,1,0, 20180
1,20181,1,1,0, 20182
4,20181,4,4,1, 20185
30,20183,3,3,1, 20186
6,20185,2,2,1, 20187
7,20187,1,1,0, 20188
26,20187,3,3,1, 20190
29,20188,4,4,1, 20192
9,20192,2,2,1, 20194
12,20195,5,5,1, 20200
2,20203,2,2,1, 20205
24,20204,1,1,1, 20205
19,20201,5,5,1, 20206
1,20206,1,1,0, 20207
3,20207,3,3,1, 20210
5,20207,3,3,1, 20210
27,20207,4,4,1, 20211
30,20208,3,3,1, 20211
31,20211,2,2,1, 20213
7,20212,1,1,0, 20213
26,20212,3,3,1, 20215
29,20213,4,4,1, 20217
11,20214,4,4,1, 20218
12,20220,5,5,1, 20225
18,20223,4,4,1, 20227
2,20228,2,2,1, 20230
24,20229,1,1,0, 20230
1,20231,1,1,0, 20232
4,20231,4,4,1, 20235
5,20232,3,3,1, 20235
30,20233,3,3,1, 20236
6,20235,2,2,1, 20237
31,20236,2,2,1, 20238
7,20237,1,1,0, 20238
24,20254,1,1,0, 20255
23,20253,3,3,1, 20256
5,20257,3,3,1, 20260
30,20258,3,3,1, 20261
7,20262,1,1,0, 20263
29,20263,4,4,1, 20267
8,20266,1,1,1, 20267
16,20269,2,2,1, 20271
14,20269,3,3,1, 20272
22,20276,4,4,1, 20280
24,20279,1,1,1, 20280
21,20277,5,5,1, 20282
6,20285,2,2,1, 20287
31,20286,2,2,1, 20288
7,20287,1,1,0, 20288
29,20288,4,4,1, 20292
8,20291,1,1,0, 20292
16,20294,2,2,1, 20296
14,20294,3,3,1, 20297
15,20296,2,2,1, 20298
24,20304,1,1,1, 20305
23,20303,3,3,1, 20306
21,20302,5,5,1, 20307
5,20307,3,3,1, 20310
6,20310,2,2,1, 20312
31,20311,2,2,1, 20313
7,20312,1,1,0, 20313
8,20316,1,1,0, 20317
16,20319,2,2,1, 20321
13,20319,4,4,1, 20323
22,20326,4,4,1, 20330
24,20329,1,1,0, 20330
5,20332,3,3,1, 20335
30,20333,3,3,1, 20336
7,20337,1,1,1, 20338
8,20341,1,1,1, 20342
9,20342,2,2,1, 20344
17,20344,3,3,1, 20347
15,20346,2,2,1, 20348
22,20351,4,4,1, 20355
24,20354,1,1,1, 20355
1,20356,1,1,1, 20357
8,20366,1,1,1, 20367
14,20369,3,3,1, 20372
17,20369,3,3,1, 20372
13,20369,4,4,1, 20373
22,20376,4,4,1, 20380
24,20379,1,1,0, 20380
21,20377,5,5,1, 20382
1,20381,1,1,0, 20382
8,20391,1,1,1, 20392
16,20394,2,2,1, 20396
14,20394,3,3,1, 20397
13,20394,4,4,1, 20398
24,20404,1,1,1, 20405
1,20406,1,1,0, 20407
8,20416,1,1,0, 20417
9,20417,2,2,1, 20419
15,20421,2,2,1, 20423
18,20423,4,4,1, 20427
22,20426,4,4,1, 20430
24,20429,1,1,0, 20430
1,20431,1,1,0, 20432
25,20435,2,2,1, 20437
8,20441,1,1,1, 20442
16,20444,2,2,1, 20446
14,20444,3,3,1, 20447
17,20444,3,3,1, 20447
13,20444,4,4,1, 20448
22,20451,4,4,1, 20455
2,20453,2,2,1, 20455
24,20454,1,1,1, 20455
1,20456,1,1,0, 20457
5,20457,3,3,1, 20460
6,20460,2,2,1, 20462
7,20462,1,1,0, 20463
29,20463,4,4,1, 20467
8,20466,1,1,1, 20467
14,20469,3,3,1, 20472
17,20469,3,3,1, 20472
22,20476,4,4,1, 20480
24,20479,1,1,0, 20480
23,20478,3,3,1, 20481
21,20477,5,5,1, 20482
1,20481,1,1,0, 20482
30,20483,3,3,1, 20486
25,20485,2,2,1, 20487
7,20487,1,1,0, 20488
9,20492,2,2,1, 20494
17,20494,3,3,1, 20497
2,20503,2,2,1, 20505
24,20504,1,1,0, 20505
1,20506,1,1,0, 20507
6,20510,2,2,1, 20512
7,20512,1,1,0, 20513
29,20513,4,4,1, 20517
11,20514,4,4,1, 20518
17,20519,3,3,1, 20522
24,20529,1,1,0, 20530
19,20526,5,5,1, 20531
1,20531,1,1,0, 20532
3,20532,3,3,1, 20535
27,20532,4,4,1, 20536
30,20533,3,3,1, 20536
6,20535,2,2,1, 20537
7,20537,1,1,1, 20538
29,20538,4,4,1, 20542
18,20548,4,4,1, 20552
20,20548,6,6,1, 20554
2,20553,2,2,1, 20555
24,20554,1,1,1, 20555
1,20556,1,1,1, 20557
4,20556,4,4,1, 20560
3,20557,3,3,1, 20560
7,20562,1,1,0, 20563
26,20562,3,3,1, 20565
12,20570,5,5,1, 20575
2,20578,2,2,1, 20580
24,20579,1,1,1, 20580
1,20581,1,1,1, 20582
4,20581,4,4,1, 20585
27,20582,4,4,1, 20586
7,20587,1,1,1, 20588
28,20584,5,5,1, 20589
8,20591,1,1,0, 20592
11,20589,4,4,1, 20593
9,20592,2,2,1, 20594
16,20594,2,2,1, 20596
13,20594,4,4,1, 20598
15,20596,2,2,1, 20598
20,20598,6,6,1, 20604
22,20601,4,4,1, 20605
24,20604,1,1,0, 20605
19,20601,5,5,1, 20606
1,20606,1,1,1, 20607
4,20606,4,4,1, 20610
3,20607,3,3,1, 20610
6,20610,2,2,1, 20612
7,20612,1,1,0, 20613
8,20616,1,1,1, 20617
16,20619,2,2,1, 20621
24,20629,1,1,0, 20630
23,20628,3,3,1, 20631
5,20632,3,3,1, 20635
7,20637,1,1,0, 20638
29,20638,4,4,1, 20642
8,20641,1,1,1, 20642
13,20644,4,4,1, 20648
15,20646,2,2,1, 20648
22,20651,4,4,1, 20655
24,20654,1,1,0, 20655
30,20658,3,3,1, 20661
6,20660,2,2,1, 20662
31,20661,2,2,1, 20663
7,20662,1,1,0, 20663
29,20663,4,4,1, 20667
8,20666,1,1,1, 20667
14,20669,3,3,1, 20672
22,20676,4,4,1, 20680
24,20679,1,1,1, 20680
23,20678,3,3,1, 20681
21,20677,5,5,1, 20682
5,20682,3,3,1, 20685
30,20683,3,3,1, 20686
31,20686,2,2,1, 20688
7,20687,1,1,0, 20688
29,20688,4,4,1, 20692
8,20691,1,1,0, 20692
16,20694,2,2,1, 20696
14,20694,3,3,1, 20697
24,20704,1,1,1, 20705
23,20703,3,3,1, 20706
21,20702,5,5,1, 20707
30,20708,3,3,1, 20711
7,20712,1,1,1, 20713
29,20713,4,4,1, 20717
8,20716,1,1,0, 20717
9,20717,2,2,1, 20719
16,20719,2,2,1, 20721
14,20719,3,3,1, 20722
13,20719,4,4,1, 20723
24,20729,1,1,0, 20730
23,20728,3,3,1, 20731
1,20731,1,1,1, 20732
30,20733,3,3,1, 20736
25,20735,2,2,1, 20737
31,20736,2,2,1, 20738
7,20737,1,1,0, 20738
29,20738,4,4,1, 20742
8,20741,1,1,1, 20742
16,20744,2,2,1, 20746
14,20744,3,3,1, 20747
13,20744,4,4,1, 20748
24,20754,1,1,0, 20755
1,20756,1,1,1, 20757
30,20758,3,3,1, 20761
25,20760,2,2,1, 20762
7,20762,1,1,1, 20763
8,20766,1,1,0, 20767
24,20779,1,1,1, 20780
23,20778,3,3,1, 20781
21,20777,5,5,1, 20782
1,20781,1,1,0, 20782
30,20783,3,3,1, 20786
6,20785,2,2,1, 20787
7,20787,1,1,0, 20788
29,20788,4,4,1, 20792
8,20791,1,1,1, 20792
16,20794,2,2,1, 20796
24,20804,1,1,0, 20805
23,20803,3,3,1, 20806
21,20802,5,5,1, 20807
1,20806,1,1,1, 20807
5,20807,3,3,1, 20810
25,20810,2,2,1, 20812
31,20811,2,2,1, 20813
7,20812,1,1,1, 20813
26,20812,3,3,1, 20815
8,20816,1,1,1, 20817
9,20817,2,2,1, 20819
16,20819,2,2,1, 20821
14,20819,3,3,1, 20822
17,20819,3,3,1, 20822
13,20819,4,4,1, 20823
18,20823,4,4,1, 20827
20,20823,6,6,1, 20829
24,20829,1,1,0, 20830
19,20826,5,5,1, 20831
1,20831,1,1,0, 20832
4,20831,4,4,1, 20835
27,20832,4,4,1, 20836
31,20836,2,2,1, 20838
7,20837,1,1,1, 20838
29,20838,4,4,1, 20842
11,20839,4,4,1, 20843
17,20844,3,3,1, 20847
12,20845,5,5,1, 20850
2,20853,2,2,1, 20855
24,20854,1,1,1, 20855
19,20851,5,5,1, 20856
1,20856,1,1,0, 20857
4,20856,4,4,1, 20860
27,20857,4,4,1, 20861
31,20861,2,2,1, 20863
7,20862,1,1,1, 20863
28,20859,5,5,1, 20864
26,20862,3,3,1, 20865
12,20870,5,5,1, 20875
2,20878,2,2,1, 20880
24,20879,1,1,0, 20880
19,20876,5,5,1, 20881
1,20881,1,1,0, 20882
25,20885,2,2,1, 20887
7,20887,1,1,1, 20888
28,20884,5,5,1, 20889
29,20888,4,4,1, 20892
9,20892,2,2,1, 20894
12,20895,5,5,1, 20900
24,20904,1,1,1, 20905
19,20901,5,5,1, 20906
1,20906,1,1,0, 20907
3,20907,3,3,1, 20910
6,20910,2,2,1, 20912
7,20912,1,1,1, 20913
29,20913,4,4,1, 20917
24,20929,1,1,1, 20930
21,20927,5,5,1, 20932
30,20933,3,3,1, 20936
6,20935,2,2,1, 20937
7,20937,1,1,0, 20938
29,20938,4,4,1, 20942
8,20941,1,1,0, 20942
13,20944,4,4,1, 20948
15,20946,2,2,1, 20948
22,20951,4,4,1, 20955
24,20954,1,1,0, 20955
21,20952,5,5,1, 20957
5,20957,3,3,1, 20960
30,20958,3,3,1, 20961
31,20961,2,2,1, 20963
7,20962,1,1,0, 20963
8,20966,1,1,1, 20967
16,20969,2,2,1, 20971
13,20969,4,4,1, 20973
15,20971,2,2,1, 20973
24,20979,1,1,1, 20980
21,20977,5,5,1, 20982
5,20982,3,3,1, 20985
30,20983,3,3,1, 20986
6,20985,2,2,1, 20987
7,20987,1,1,1, 20988
29,20988,4,4,1, 20992
8,20991,1,1,1, 20992
14,20994,3,3,1, 20997
22,21001,4,4,1, 21005
24,21004,1,1,0, 21005
23,21003,3,3,1, 21006
21,21002,5,5,1, 21007
30,21008,3,3,1, 21011
31,21011,2,2,1, 21013
7,21012,1,1,1, 21013
29,21013,4,4,1, 21017
8,21016,1,1,0, 21017
9,21017,2,2,1, 21019
16,21019,2,2,1, 21021
14,21019,3,3,1, 21022
17,21019,3,3,1, 21022
24,21029,1,1,1, 21030
21,21027,5,5,1, 21032
1,21031,1,1,1, 21032
30,21033,3,3,1, 21036
6,21035,2,2,1, 21037
7,21037,1,1,0, 21038
29,21038,4,4,1, 21042
8,21041,1,1,1, 21042
17,21044,3,3,1, 21047
15,21046,2,2,1, 21048
18,21048,4,4,1, 21052
2,21053,2,2,1, 21055
24,21054,1,1,1, 21055
19,21051,5,5,1, 21056
23,21053,3,3,1, 21056
1,21056,1,1,0, 21057
3,21057,3,3,1, 21060
30,21058,3,3,1, 21061
25,21060,2,2,1, 21062
7,21062,1,1,1, 21063
26,21062,3,3,1, 21065
29,21063,4,4,1, 21067
8,21066,1,1,0, 21067
13,21069,4,4,1, 21073
18,21073,4,4,1, 21077
24,21079,1,1,0, 21080
23,21078,3,3,1, 21081
21,21077,5,5,1, 21082
1,21081,1,1,0, 21082
4,21081,4,4,1, 21085
3,21082,3,3,1, 21085
7,21087,1,1,1, 21088
8,21091,1,1,1, 21092
11,21089,4,4,1, 21093
9,21092,2,2,1, 21094
16,21094,2,2,1, 21096
13,21094,4,4,1, 21098
15,21096,2,2,1, 21098
2,21103,2,2,1, 21105
24,21104,1,1,0, 21105
19,21101,5,5,1, 21106
23,21103,3,3,1, 21106
21,21102,5,5,1, 21107
1,21106,1,1,0, 21107
5,21107,3,3,1, 21110
25,21110,2,2,1, 21112
31,21111,2,2,1, 21113
7,21112,1,1,0, 21113
8,21116,1,1,0, 21117
9,21117,2,2,1, 21119
16,21119,2,2,1, 21121
14,21119,3,3,1, 21122
17,21119,3,3,1, 21122
12,21120,5,5,1, 21125
20,21123,6,6,1, 21129
2,21128,2,2,1, 21130
24,21129,1,1,0, 21130
19,21126,5,5,1, 21131
1,21131,1,1,1, 21132
3,21132,3,3,1, 21135
27,21132,4,4,1, 21136
30,21133,3,3,1, 21136
31,21136,2,2,1, 21138
7,21137,1,1,1, 21138
24,21154,1,1,1, 21155
7,21162,1,1,1, 21163
29,21163,4,4,1, 21167
24,21179,1,1,1, 21180
5,21182,3,3,1, 21185
30,21183,3,3,1, 21186
31,21186,2,2,1, 21188
7,21187,1,1,1, 21188
29,21188,4,4,1, 21192
24,21204,1,1,0, 21205
31,21211,2,2,1, 21213
7,21212,1,1,0, 21213
29,21213,4,4,1, 21217
22,21226,4,4,1, 21230
24,21229,1,1,1, 21230
23,21228,3,3,1, 21231
30,21233,3,3,1, 21236
7,21237,1,1,0, 21238
29,21238,4,4,1, 21242
8,21241,1,1,1, 21242
9,21242,2,2,1, 21244
14,21244,3,3,1, 21247
24,21254,1,1,1, 21255
23,21253,3,3,1, 21256
21,21252,5,5,1, 21257
1,21256,1,1,0, 21257
30,21258,3,3,1, 21261
6,21260,2,2,1, 21262
31,21261,2,2,1, 21263
7,21262,1,1,0, 21263
29,21263,4,4,1, 21267
8,21266,1,1,1, 21267
9,21267,2,2,1, 21269
17,21269,3,3,1, 21272
15,21271,2,2,1, 21273
22,21276,4,4,1, 21280
24,21279,1,1,0, 21280
1,21281,1,1,1, 21282
30,21283,3,3,1, 21286
6,21285,2,2,1, 21287
7,21287,1,1,0, 21288
26,21287,3,3,1, 21290
8,21291,1,1,0, 21292
9,21292,2,2,1, 21294
16,21294,2,2,1, 21296
13,21294,4,4,1, 21298
15,21296,2,2,1, 21298
18,21298,4,4,1, 21302
22,21301,4,4,1, 21305
2,21303,2,2,1, 21305
24,21304,1,1,0, 21305
21,21302,5,5,1, 21307
1,21306,1,1,1, 21307
25,21310,2,2,1, 21312
7,21312,1,1,1, 21313
29,21313,4,4,1, 21317
8,21316,1,1,1, 21317
9,21317,2,2,1, 21319
14,21319,3,3,1, 21322
17,21319,3,3,1, 21322
15,21321,2,2,1, 21323
22,21326,4,4,1, 21330
24,21329,1,1,1, 21330
21,21327,5,5,1, 21332
1,21331,1,1,0, 21332
31,21336,2,2,1, 21338
7,21337,1,1,1, 21338
29,21338,4,4,1, 21342
8,21341,1,1,1, 21342
16,21344,2,2,1, 21346
14,21344,3,3,1, 21347
17,21344,3,3,1, 21347
13,21344,4,4,1, 21348
24,21354,1,1,1, 21355
23,21353,3,3,1, 21356
1,21356,1,1,0, 21357
5,21357,3,3,1, 21360
6,21360,2,2,1, 21362
31,21361,2,2,1, 21363
7,21362,1,1,1, 21363
26,21362,3,3,1, 21365
8,21366,1,1,0, 21367
11,21364,4,4,1, 21368
9,21367,2,2,1, 21369
13,21369,4,4,1, 21373
15,21371,2,2,1, 21373
12,21370,5,5,1, 21375
20,21373,6,6,1, 21379
22,21376,4,4,1, 21380
2,21378,2,2,1, 21380
24,21379,1,1,0, 21380
19,21376,5,5,1, 21381
23,21378,3,3,1, 21381
1,21381,1,1,1, 21382
30,21383,3,3,1, 21386
6,21385,2,2,1, 21387
7,21387,1,1,1, 21388
28,21384,5,5,1, 21389
29,21388,4,4,1, 21392
8,21391,1,1,1, 21392
16,21394,2,2,1, 21396
15,21396,2,2,1, 21398
18,21398,4,4,1, 21402
22,21401,4,4,1, 21405
2,21403,2,2,1, 21405
24,21404,1,1,1, 21405
23,21403,3,3,1, 21406
21,21402,5,5,1, 21407
1,21406,1,1,1, 21407
3,21407,3,3,1, 21410
5,21407,3,3,1, 21410
6,21410,2,2,1, 21412
7,21412,1,1,0, 21413
26,21412,3,3,1, 21415
29,21413,4,4,1, 21417
11,21414,4,4,1, 21418
9,21417,2,2,1, 21419
2,21428,2,2,1, 21430
24,21429,1,1,0, 21430
19,21426,5,5,1, 21431
1,21431,1,1,0, 21432
3,21432,3,3,1, 21435
30,21433,3,3,1, 21436
7,21437,1,1,0, 21438
24,21454,1,1,0, 21455
6,21460,2,2,1, 21462
31,21461,2,2,1, 21463
7,21462,1,1,0, 21463
29,21463,4,4,1, 21467
24,21479,1,1,1, 21480
30,21483,3,3,1, 21486
7,21487,1,1,0, 21488
29,21488,4,4,1, 21492
24,21504,1,1,0, 21505
5,21507,3,3,1, 21510
6,21510,2,2,1, 21512
7,21512,1,1,1, 21513
8,21516,1,1,1, 21517
16,21519,2,2,1, 21521
15,21521,2,2,1, 21523
22,21526,4,4,1, 21530
24,21529,1,1,0, 21530
21,21527,5,5,1, 21532
6,21535,2,2,1, 21537
7,21537,1,1,0, 21538
29,21538,4,4,1, 21542
8,21541,1,1,1, 21542
16,21544,2,2,1, 21546
22,21551,4,4,1, 21555
24,21554,1,1,0, 21555
21,21552,5,5,1, 21557
1,21556,1,1,1, 21557
5,21557,3,3,1, 21560
25,21560,2,2,1, 21562
7,21562,1,1,1, 21563
8,21566,1,1,1, 21567
9,21567,2,2,1, 21569
16,21569,2,2,1, 21571
14,21569,3,3,1, 21572
15,21571,2,2,1, 21573
24,21579,1,1,1, 21580
1,21581,1,1,1, 21582
6,21585,2,2,1, 21587
7,21587,1,1,1, 21588
29,21588,4,4,1, 21592
8,21591,1,1,1, 21592
16,21594,2,2,1, 21596
14,21594,3,3,1, 21597
17,21594,3,3,1, 21597
13,21594,4,4,1, 21598
15,21596,2,2,1, 21598
24,21604,1,1,0, 21605
21,21602,5,5,1, 21607
1,21606,1,1,1, 21607
30,21608,3,3,1, 21611
25,21610,2,2,1, 21612
7,21612,1,1,0, 21613
29,21613,4,4,1, 21617
8,21616,1,1,1, 21617
9,21617,2,2,1, 21619
16,21619,2,2,1, 21621
14,21619,3,3,1, 21622
17,21619,3,3,1, 21622
15,21621,2,2,1, 21623
18,21623,4,4,1, 21627
22,21626,4,4,1, 21630
2,21628,2,2,1, 21630
24,21629,1,1,0, 21630
21,21627,5,5,1, 21632
1,21631,1,1,1, 21632
5,21632,3,3,1, 21635
7,21637,1,1,0, 21638
26,21637,3,3,1, 21640
29,21638,4,4,1, 21642
8,21641,1,1,0, 21642
9,21642,2,2,1, 21644
16,21644,2,2,1, 21646
14,21644,3,3,1, 21647
17,21644,3,3,1, 21647
15,21646,2,2,1, 21648
20,21648,6,6,1, 21654
2,21653,2,2,1, 21655
24,21654,1,1,1, 21655
19,21651,5,5,1, 21656
23,21653,3,3,1, 21656
21,21652,5,5,1, 21657
1,21656,1,1,1, 21657
4,21656,4,4,1, 21660
3,21657,3,3,1, 21660
5,21657,3,3,1, 21660
27,21657,4,4,1, 21661
30,21658,3,3,1, 21661
6,21660,2,2,1, 21662
31,21661,2,2,1, 21663
7,21662,1,1,1, 21663
28,21659,5,5,1, 21664
26,21662,3,3,1, 21665
29,21663,4,4,1, 21667
11,21664,4,4,1, 21668
9,21667,2,2,1, 21669
17,21669,3,3,1, 21672
12,21670,5,5,1, 21675
20,21673,6,6,1, 21679
24,21679,1,1,1, 21680
19,21676,5,5,1, 21681
1,21681,1,1,0, 21682
5,21682,3,3,1, 21685
25,21685,2,2,1, 21687
31,21686,2,2,1, 21688
7,21687,1,1,0, 21688
24,21704,1,1,1, 21705
30,21708,3,3,1, 21711
31,21711,2,2,1, 21713
7,21712,1,1,1, 21713
24,21729,1,1,1, 21730
5,21732,3,3,1, 21735
30,21733,3,3,1, 21736
31,21736,2,2,1, 21738
7,21737,1,1,0, 21738
29,21738,4,4,1, 21742
24,21754,1,1,1, 21755
5,21757,3,3,1, 21760
6,21760,2,2,1, 21762
31,21761,2,2,1, 21763
7,21762,1,1,0, 21763
8,21766,1,1,1, 21767
16,21769,2,2,1, 21771
13,21769,4,4,1, 21773
15,21771,2,2,1, 21773
24,21779,1,1,1, 21780
21,21777,5,5,1, 21782
5,21782,3,3,1, 21785
30,21783,3,3,1, 21786
8,21791,1,1,1, 21792
16,21794,2,2,1, 21796
15,21796,2,2,1, 21798
22,21801,4,4,1, 21805
24,21804,1,1,0, 21805
1,21806,1,1,1, 21807
25,21810,2,2,1, 21812
8,21816,1,1,1, 21817
9,21817,2,2,1, 21819
14,21819,3,3,1, 21822
17,21819,3,3,1, 21822
15,21821,2,2,1, 21823
22,21826,4,4,1, 21830
24,21829,1,1,1, 21830
23,21828,3,3,1, 21831
21,21827,5,5,1, 21832
1,21831,1,1,1, 21832
25,21835,2,2,1, 21837
8,21841,1,1,1, 21842
9,21842,2,2,1, 21844
16,21844,2,2,1, 21846
13,21844,4,4,1, 21848
24,21854,1,1,0, 21855
21,21852,5,5,1, 21857
1,21856,1,1,0, 21857
8,21866,1,1,0, 21867
9,21867,2,2,1, 21869
14,21869,3,3,1, 21872
17,21869,3,3,1, 21872
13,21869,4,4,1, 21873
15,21871,2,2,1, 21873
18,21873,4,4,1, 21877
22,21876,4,4,1, 21880
24,21879,1,1,1, 21880
1,21881,1,1,0, 21882
25,21885,2,2,1, 21887
26,21887,3,3,1, 21890
29,21888,4,4,1, 21892
8,21891,1,1,0, 21892
9,21892,2,2,1, 21894
14,21894,3,3,1, 21897
17,21894,3,3,1, 21897
12,21895,5,5,1, 21900
24,21904,1,1,0, 21905
19,21901,5,5,1, 21906
23,21903,3,3,1, 21906
1,21906,1,1,1, 21907
4,21906,4,4,1, 21910
3,21907,3,3,1, 21910
5,21907,3,3,1, 21910
7,21912,1,1,1, 21913
28,21909,5,5,1, 21914
26,21912,3,3,1, 21915
29,21913,4,4,1, 21917
8,21916,1,1,1, 21917
11,21914,4,4,1, 21918
16,21919,2,2,1, 21921
17,21919,3,3,1, 21922
15,21921,2,2,1, 21923
12,21920,5,5,1, 21925
18,21923,4,4,1, 21927
20,21923,6,6,1, 21929
24,21929,1,1,0, 21930
21,21927,5,5,1, 21932
1,21931,1,1,0, 21932
30,21933,3,3,1, 21936
31,21936,2,2,1, 21938
7,21937,1,1,0, 21938
26,21937,3,3,1, 21940
8,21941,1,1,0, 21942
11,21939,4,4,1, 21943
14,21944,3,3,1, 21947
15,21946,2,2,1, 21948
18,21948,4,4,1, 21952
20,21948,6,6,1, 21954
22,21951,4,4,1, 21955
24,21954,1,1,0, 21955
19,21951,5,5,1, 21956
23,21953,3,3,1, 21956
1,21956,1,1,1, 21957
3,21957,3,3,1, 21960
31,21961,2,2,1, 21963
7,21962,1,1,0, 21963
29,21963,4,4,1, 21967
8,21966,1,1,0, 21967
16,21969,2,2,1, 21971
24,21979,1,1,1, 21980
6,21985,2,2,1, 21987
31,21986,2,2,1, 21988
7,21987,1,1,0, 21988
29,21988,4,4,1, 21992
24,22004,1,1,1, 22005
30,22008,3,3,1, 22011
6,22010,2,2,1, 22012
31,22011,2,2,1, 22013
7,22012,1,1,0, 22013
24,22029,1,1,0, 22030
5,22032,3,3,1, 22035
7,22037,1,1,1, 22038
29,22038,4,4,1, 22042
24,22054,1,1,1, 22055
5,22057,3,3,1, 22060
30,22058,3,3,1, 22061
31,22061,2,2,1, 22063
7,22062,1,1,0, 22063
29,22063,4,4,1, 22067
22,22076,4,4,1, 22080
24,22079,1,1,1, 22080
21,22077,5,5,1, 22082
1,22081,1,1,0, 22082
30,22083,3,3,1, 22086
6,22085,2,2,1, 22087
25,22085,2,2,1, 22087
31,22086,2,2,1, 22088
7,22087,1,1,1, 22088
26,22087,3,3,1, 22090
8,22091,1,1,1, 22092
13,22094,4,4,1, 22098
15,22096,2,2,1, 22098
22,22101,4,4,1, 22105
24,22104,1,1,1, 22105
23,22103,3,3,1, 22106
21,22102,5,5,1, 22107
1,22106,1,1,0, 22107
5,22107,3,3,1, 22110
30,22108,3,3,1, 22111
31,22111,2,2,1, 22113
7,22112,1,1,1, 22113
26,22112,3,3,1, 22115
8,22116,1,1,1, 22117
15,22121,2,2,1, 22123
22,22126,4,4,1, 22130
2,22128,2,2,1, 22130
24,22129,1,1,1, 22130
1,22131,1,1,1, 22132
6,22135,2,2,1, 22137
31,22136,2,2,1, 22138
7,22137,1,1,1, 22138
8,22141,1,1,0, 22142
9,22142,2,2,1, 22144
17,22144,3,3,1, 22147
20,22148,6,6,1, 22154
2,22153,2,2,1, 22155
24,22154,1,1,0, 22155
23,22153,3,3,1, 22156
1,22156,1,1,0, 22157
30,22158,3,3,1, 22161
25,22160,2,2,1, 22162
7,22162,1,1,1, 22163
28,22159,5,5,1, 22164
8,22166,1,1,0, 22167
11,22164,4,4,1, 22168
16,22169,2,2,1, 22171
14,22169,3,3,1, 22172
15,22171,2,2,1, 22173
12,22170,5,5,1, 22175
22,22176,4,4,1, 22180
2,22178,2,2,1, 22180
24,22179,1,1,0, 22180
21,22177,5,5,1, 22182
1,22181,1,1,1, 22182
4,22181,4,4,1, 22185
27,22182,4,4,1, 22186
6,22185,2,2,1, 22187
31,22186,2,2,1, 22188
7,22187,1,1,0, 22188
28,22184,5,5,1, 22189
29,22188,4,4,1, 22192
8,22191,1,1,0, 22192
9,22192,2,2,1, 22194
14,22194,3,3,1, 22197
17,22194,3,3,1, 22197
12,22195,5,5,1, 22200
18,22198,4,4,1, 22202
20,22198,6,6,1, 22204
22,22201,4,4,1, 22205
24,22204,1,1,1, 22205
19,22201,5,5,1, 22206
1,22206,1,1,0, 22207
4,22206,4,4,1, 22210
25,22210,2,2,1, 22212
7,22212,1,1,0, 22213
28,22209,5,5,1, 22214
8,22216,1,1,0, 22217
16,22219,2,2,1, 22221
15,22221,2,2,1, 22223
24,22229,1,1,1, 22230
23,22228,3,3,1, 22231
21,22227,5,5,1, 22232
6,22235,2,2,1, 22237
31,22236,2,2,1, 22238
7,22237,1,1,0, 22238
8,22241,1,1,0, 22242
24,22254,1,1,1, 22255
21,22252,5,5,1, 22257
7,22262,1,1,1, 22263
29,22263,4,4,1, 22267
8,22266,1,1,1, 22267
14,22269,3,3,1, 22272
22,22276,4,4,1, 22280
24,22279,1,1,0, 22280
5,22282,3,3,1, 22285
30,22283,3,3,1, 22286
7,22287,1,1,0, 22288
8,22291,1,1,1, 22292
22,22301,4,4,1, 22305
24,22304,1,1,1, 22305
5,22307,3,3,1, 22310
30,22308,3,3,1, 22311
31,22311,2,2,1, 22313
7,22312,1,1,0, 22313
29,22313,4,4,1, 22317
8,22316,1,1,1, 22317
9,22317,2,2,1, 22319
16,22319,2,2,1, 22321
13,22319,4,4,1, 22323
15,22321,2,2,1, 22323
18,22323,4,4,1, 22327
24,22329,1,1,0, 22330
23,22328,3,3,1, 22331
1,22331,1,1,0, 22332
5,22332,3,3,1, 22335
30,22333,3,3,1, 22336
6,22335,2,2,1, 22337
25,22335,2,2,1, 22337
31,22336,2,2,1, 22338
7,22337,1,1,1, 22338
8,22341,1,1,0, 22342
9,22342,2,2,1, 22344
14,22344,3,3,1, 22347
22,22351,4,4,1, 22355
24,22354,1,1,0, 22355
21,22352,5,5,1, 22357
1,22356,1,1,0, 22357
6,22360,2,2,1, 22362
7,22362,1,1,0, 22363
8,22366,1,1,0, 22367
16,22369,2,2,1, 22371
15,22371,2,2,1, 22373
24,22379,1,1,1, 22380
1,22381,1,1,0, 22382
5,22382,3,3,1, 22385
25,22385,2,2,1, 22387
31,22386,2,2,1, 22388
7,22387,1,1,1, 22388
8,22391,1,1,0, 22392
22,22401,4,4,1, 22405
24,22404,1,1,1, 22405
23,22403,3,3,1, 22406
21,22402,5,5,1, 22407
1,22406,1,1,1, 22407
30,22408,3,3,1, 22411
6,22410,2,2,1, 22412
31,22411,2,2,1, 22413
7,22412,1,1,1, 22413
29,22413,4,4,1, 22417
8,22416,1,1,1, 22417
24,22429,1,1,0, 22430
1,22431,1,1,0, 22432
30,22433,3,3,1, 22436
31,22436,2,2,1, 22438
7,22437,1,1,1, 22438
29,22438,4,4,1, 22442
8,22441,1,1,0, 22442
16,22444,2,2,1, 22446
17,22444,3,3,1, 22447
2,22453,2,2,1, 22455
24,22454,1,1,0, 22455
21,22452,5,5,1, 22457
1,22456,1,1,1, 22457
5,22457,3,3,1, 22460
6,22460,2,2,1, 22462
7,22462,1,1,0, 22463
26,22462,3,3,1, 22465
8,22466,1,1,1, 22467
16,22469,2,2,1, 22471
17,22469,3,3,1, 22472
2,22478,2,2,1, 22480
24,22479,1,1,0, 22480
1,22481,1,1,1, 22482
5,22482,3,3,1, 22485
30,22483,3,3,1, 22486
31,22486,2,2,1, 22488
7,22487,1,1,0, 22488
29,22488,4,4,1, 22492
8,22491,1,1,1, 22492
11,22489,4,4,1, 22493
9,22492,2,2,1, 22494
17,22494,3,3,1, 22497
13,22494,4,4,1, 22498
12,22495,5,5,1, 22500
18,22498,4,4,1, 22502
20,22498,6,6,1, 22504
22,22501,4,4,1, 22505
2,22503,2,2,1, 22505
24,22504,1,1,1, 22505
23,22503,3,3,1, 22506
1,22506,1,1,1, 22507
4,22506,4,4,1, 22510
3,22507,3,3,1, 22510
27,22507,4,4,1, 22511
7,22512,1,1,1, 22513
28,22509,5,5,1, 22514
29,22513,4,4,1, 22517
8,22516,1,1,1, 22517
11,22514,4,4,1, 22518
16,22519,2,2,1, 22521
14,22519,3,3,1, 22522
17,22519,3,3,1, 22522
12,22520,5,5,1, 22525
18,22523,4,4,1, 22527
24,22529,1,1,1, 22530
19,22526,5,5,1, 22531
1,22531,1,1,1, 22532
4,22531,4,4,1, 22535
3,22532,3,3,1, 22535
6,22535,2,2,1, 22537
25,22535,2,2,1, 22537
31,22536,2,2,1, 22538
7,22537,1,1,0, 22538
28,22534,5,5,1, 22539
26,22537,3,3,1, 22540
8,22541,1,1,0, 22542
11,22539,4,4,1, 22543
16,22544,2,2,1, 22546
15,22546,2,2,1, 22548
22,22551,4,4,1, 22555
24,22554,1,1,0, 22555
23,22553,3,3,1, 22556
5,22557,3,3,1, 22560
30,22558,3,3,1, 22561
31,22561,2,2,1, 22563
7,22562,1,1,0, 22563
8,22566,1,1,0, 22567
14,22569,3,3,1, 22572
13,22569,4,4,1, 22573
22,22576,4,4,1, 22580
24,22579,1,1,0, 22580
7,22587,1,1,0, 22588
29,22588,4,4,1, 22592
24,22604,1,1,0, 22605
31,22611,2,2,1, 22613
7,22612,1,1,0, 22613
29,22613,4,4,1, 22617
24,22629,1,1,1, 22630
5,22632,3,3,1, 22635
30,22633,3,3,1, 22636
6,22635,2,2,1, 22637
7,22637,1,1,0, 22638
29,22638,4,4,1, 22642
24,22654,1,1,0, 22655
1,22656,1,1,0, 22657
5,22657,3,3,1, 22660
6,22660,2,2,1, 22662
7,22662,1,1,1, 22663
29,22663,4,4,1, 22667
9,22667,2,2,1, 22669
17,22669,3,3,1, 22672
2,22678,2,2,1, 22680
24,22679,1,1,0, 22680
1,22681,1,1,0, 22682
7,22687,1,1,0, 22688
26,22687,3,3,1, 22690
8,22691,1,1,0, 22692
9,22692,2,2,1, 22694
14,22694,3,3,1, 22697
17,22694,3,3,1, 22697
15,22696,2,2,1, 22698
18,22698,4,4,1, 22702
24,22704,1,1,0, 22705
23,22703,3,3,1, 22706
21,22702,5,5,1, 22707
1,22706,1,1,0, 22707
5,22707,3,3,1, 22710
25,22710,2,2,1, 22712
7,22712,1,1,1, 22713
29,22713,4,4,1, 22717
8,22716,1,1,0, 22717
9,22717,2,2,1, 22719
16,22719,2,2,1, 22721
13,22719,4,4,1, 22723
2,22728,2,2,1, 22730
24,22729,1,1,0, 22730
23,22728,3,3,1, 22731
1,22731,1,1,0, 22732
3,22732,3,3,1, 22735
5,22732,3,3,1, 22735
31,22736,2,2,1, 22738
7,22737,1,1,1, 22738
26,22737,3,3,1, 22740
29,22738,4,4,1, 22742
8,22741,1,1,1, 22742
11,22739,4,4,1, 22743
9,22742,2,2,1, 22744
16,22744,2,2,1, 22746
14,22744,3,3,1, 22747
17,22744,3,3,1, 22747
13,22744,4,4,1, 22748
15,22746,2,2,1, 22748
12,22745,5,5,1, 22750
18,22748,4,4,1, 22752
2,22753,2,2,1, 22755
24,22754,1,1,0, 22755
23,22753,3,3,1, 22756
1,22756,1,1,1, 22757
4,22756,4,4,1, 22760
27,22757,4,4,1, 22761
31,22761,2,2,1, 22763
7,22762,1,1,0, 22763
26,22762,3,3,1, 22765
8,22766,1,1,0, 22767
14,22769,3,3,1, 22772
17,22769,3,3,1, 22772
18,22773,4,4,1, 22777
22,22776,4,4,1, 22780
2,22778,2,2,1, 22780
24,22779,1,1,1, 22780
19,22776,5,5,1, 22781
23,22778,3,3,1, 22781
1,22781,1,1,0, 22782
3,22782,3,3,1, 22785
5,22782,3,3,1, 22785
30,22783,3,3,1, 22786
31,22786,2,2,1, 22788
7,22787,1,1,1, 22788
8,22791,1,1,0, 22792
16,22794,2,2,1, 22796
13,22794,4,4,1, 22798
22,22801,4,4,1, 22805
24,22804,1,1,0, 22805
23,22803,3,3,1, 22806
6,22810,2,2,1, 22812
7,22812,1,1,1, 22813
8,22816,1,1,1, 22817
16,22819,2,2,1, 22821
14,22819,3,3,1, 22822
13,22819,4,4,1, 22823
22,22826,4,4,1, 22830
24,22829,1,1,0, 22830
23,22828,3,3,1, 22831
21,22827,5,5,1, 22832
5,22832,3,3,1, 22835
30,22833,3,3,1, 22836
6,22835,2,2,1, 22837
7,22837,1,1,1, 22838
29,22838,4,4,1, 22842
8,22841,1,1,1, 22842
15,22846,2,2,1, 22848
24,22854,1,1,0, 22855
23,22853,3,3,1, 22856
5,22857,3,3,1, 22860
7,22862,1,1,0, 22863
24,22879,1,1,0, 22880
6,22885,2,2,1, 22887
31,22886,2,2,1, 22888
7,22887,1,1,0, 22888
29,22888,4,4,1, 22892
11,22889,4,4,1, 22893
9,22892,2,2,1, 22894
12,22895,5,5,1, 22900
20,22898,6,6,1, 22904
2,22903,2,2,1, 22905
24,22904,1,1,0, 22905
1,22906,1,1,0, 22907
6,22910,2,2,1, 22912
31,22911,2,2,1, 22913
7,22912,1,1,1, 22913
29,22913,4,4,1, 22917
11,22914,4,4,1, 22918
9,22917,2,2,1, 22919
17,22919,3,3,1, 22922
18,22923,4,4,1, 22927
20,22923,6,6,1, 22929
24,22929,1,1,0, 22930
1,22931,1,1,1, 22932
25,22935,2,2,1, 22937
17,22944,3,3,1, 22947
24,22954,1,1,1, 22955
1,22956,1,1,1, 22957
8,22966,1,1,1, 22967
9,22967,2,2,1, 22969
13,22969,4,4,1, 22973
24,22979,1,1,1, 22980
21,22977,5,5,1, 22982
1,22981,1,1,0, 22982
8,22991,1,1,0, 22992
16,22994,2,2,1, 22996
14,22994,3,3,1, 22997
15,22996,2,2,1, 22998
22,23001,4,4,1, 23005
24,23004,1,1,1, 23005
23,23003,3,3,1, 23006
1,23006,1,1,0, 23007
8,23016,1,1,1, 23017
16,23019,2,2,1, 23021
14,23019,3,3,1, 23022
17,23019,3,3,1, 23022
15,23021,2,2,1, 23023
22,23026,4,4,1, 23030
24,23029,1,1,0, 23030
23,23028,3,3,1, 23031
1,23031,1,1,1, 23032
30,23033,3,3,1, 23036
25,23035,2,2,1, 23037
31,23036,2,2,1, 23038
7,23037,1,1,1, 23038
8,23041,1,1,0, 23042
16,23044,2,2,1, 23046
13,23044,4,4,1, 23048
24,23054,1,1,1, 23055
21,23052,5,5,1, 23057
1,23056,1,1,0, 23057
5,23057,3,3,1, 23060
30,23058,3,3,1, 23061
31,23061,2,2,1, 23063
7,23062,1,1,0, 23063
26,23062,3,3,1, 23065
8,23066,1,1,1, 23067
14,23069,3,3,1, 23072
18,23073,4,4,1, 23077
2,23078,2,2,1, 23080
24,23079,1,1,0, 23080
23,23078,3,3,1, 23081
21,23077,5,5,1, 23082
1,23081,1,1,1, 23082
30,23083,3,3,1, 23086
31,23086,2,2,1, 23088
7,23087,1,1,1, 23088
26,23087,3,3,1, 23090
29,23088,4,4,1, 23092
8,23091,1,1,1, 23092
17,23094,3,3,1, 23097
18,23098,4,4,1, 23102
22,23101,4,4,1, 23105
24,23104,1,1,0, 23105
23,23103,3,3,1, 23106
1,23106,1,1,1, 23107
6,23110,2,2,1, 23112
25,23110,2,2,1, 23112
7,23112,1,1,1, 23113
8,23116,1,1,1, 23117
15,23121,2,2,1, 23123
12,23120,5,5,1, 23125
20,23123,6,6,1, 23129
22,23126,4,4,1, 23130
24,23129,1,1,1, 23130
21,23127,5,5,1, 23132
1,23131,1,1,0, 23132
3,23132,3,3,1, 23135
6,23135,2,2,1, 23137
25,23135,2,2,1, 23137
31,23136,2,2,1, 23138
7,23137,1,1,1, 23138
26,23137,3,3,1, 23140
8,23141,1,1,1, 23142
9,23142,2,2,1, 23144
14,23144,3,3,1, 23147
13,23144,4,4,1, 23148
15,23146,2,2,1, 23148
22,23151,4,4,1, 23155
24,23154,1,1,0, 23155
19,23151,5,5,1, 23156
23,23153,3,3,1, 23156
21,23152,5,5,1, 23157
1,23156,1,1,0, 23157
4,23156,4,4,1, 23160
5,23157,3,3,1, 23160
6,23160,2,2,1, 23162
25,23160,2,2,1, 23162
31,23161,2,2,1, 23163
7,23162,1,1,0, 23163
28,23159,5,5,1, 23164
26,23162,3,3,1, 23165
29,23163,4,4,1, 23167
9,23167,2,2,1, 23169
12,23170,5,5,1, 23175
18,23173,4,4,1, 23177
20,23173,6,6,1, 23179
24,23179,1,1,1, 23180
5,23182,3,3,1, 23185
30,23183,3,3,1, 23186
6,23185,2,2,1, 23187
7,23187,1,1,0, 23188
29,23188,4,4,1, 23192
24,23204,1,1,1, 23205
30,23208,3,3,1, 23211
6,23210,2,2,1, 23212
31,23211,2,2,1, 23213
7,23212,1,1,0, 23213
29,23213,4,4,1, 23217
24,23229,1,1,0, 23230
5,23232,3,3,1, 23235
30,23233,3,3,1, 23236
7,23237,1,1,0, 23238
24,23254,1,1,0, 23255
6,23260,2,2,1, 23262
7,23262,1,1,0, 23263
8,23266,1,1,0, 23267
14,23269,3,3,1, 23272
13,23269,4,4,1, 23273
22,23276,4,4,1, 23280
24,23279,1,1,0, 23280
21,23277,5,5,1, 23282
5,23282,3,3,1, 23285
30,23283,3,3,1, 23286
6,23285,2,2,1, 23287
25,23285,2,2,1, 23287
31,23286,2,2,1, 23288
7,23287,1,1,0, 23288
29,23288,4,4,1, 23292
8,23291,1,1,1, 23292
16,23294,2,2,1, 23296
14,23294,3,3,1, 23297
17,23294,3,3,1, 23297
13,23294,4,4,1, 23298
24,23304,1,1,0, 23305
23,23303,3,3,1, 23306
21,23302,5,5,1, 23307
1,23306,1,1,0, 23307
7,23312,1,1,1, 23313
29,23313,4,4,1, 23317
8,23316,1,1,0, 23317
17,23319,3,3,1, 23322
13,23319,4,4,1, 23323
24,23329,1,1,1, 23330
21,23327,5,5,1, 23332
1,23331,1,1,1, 23332
5,23332,3,3,1, 23335
25,23335,2,2,1, 23337
31,23336,2,2,1, 23338
7,23337,1,1,0, 23338
29,23338,4,4,1, 23342
8,23341,1,1,1, 23342
9,23342,2,2,1, 23344
16,23344,2,2,1, 23346
22,23351,4,4,1, 23355
24,23354,1,1,1, 23355
21,23352,5,5,1, 23357
1,23356,1,1,1, 23357
5,23357,3,3,1, 23360
30,23358,3,3,1, 23361
25,23360,2,2,1, 23362
7,23362,1,1,1, 23363
26,23362,3,3,1, 23365
8,23366,1,1,1, 23367
9,23367,2,2,1, 23369
16,23369,2,2,1, 23371
14,23369,3,3,1, 23372
18,23373,4,4,1, 23377
24,23379,1,1,0, 23380
1,23381,1,1,0, 23382
25,23385,2,2,1, 23387
31,23386,2,2,1, 23388
7,23387,1,1,1, 23388
26,23387,3,3,1, 23390
8,23391,1,1,0, 23392
14,23394,3,3,1, 23397
2,23403,2,2,1, 23405
24,23404,1,1,0, 23405
21,23402,5,5,1, 23407
1,23406,1,1,0, 23407
31,23411,2,2,1, 23413
7,23412,1,1,1, 23413
29,23413,4,4,1, 23417
8,23416,1,1,0, 23417
9,23417,2,2,1, 23419
24,23429,1,1,0, 23430
21,23427,5,5,1, 23432
1,23431,1,1,0, 23432
6,23435,2,2,1, 23437
25,23435,2,2,1, 23437
31,23436,2,2,1, 23438
7,23437,1,1,1, 23438
26,23437,3,3,1, 23440
8,23441,1,1,1, 23442
9,23442,2,2,1, 23444
16,23444,2,2,1, 23446
14,23444,3,3,1, 23447
15,23446,2,2,1, 23448
18,23448,4,4,1, 23452
22,23451,4,4,1, 23455
2,23453,2,2,1, 23455
24,23454,1,1,0, 23455
1,23456,1,1,1, 23457
6,23460,2,2,1, 23462
31,23461,2,2,1, 23463
7,23462,1,1,0, 23463
26,23462,3,3,1, 23465
29,23463,4,4,1, 23467
8,23466,1,1,0, 23467
11,23464,4,4,1, 23468
17,23469,3,3,1, 23472
12,23470,5,5,1, 23475
22,23476,4,4,1, 23480
2,23478,2,2,1, 23480
24,23479,1,1,0, 23480
21,23477,5,5,1, 23482
1,23481,1,1,1, 23482
4,23481,4,4,1, 23485
27,23482,4,4,1, 23486
30,23483,3,3,1, 23486
25,23485,2,2,1, 23487
31,23486,2,2,1, 23488
7,23487,1,1,1, 23488
28,23484,5,5,1, 23489
26,23487,3,3,1, 23490
29,23488,4,4,1, 23492
8,23491,1,1,1, 23492
17,23494,3,3,1, 23497
13,23494,4,4,1, 23498
15,23496,2,2,1, 23498
20,23498,6,6,1, 23504
22,23501,4,4,1, 23505
24,23504,1,1,1, 23505
19,23501,5,5,1, 23506
23,23503,3,3,1, 23506
21,23502,5,5,1, 23507
1,23506,1,1,0, 23507
30,23508,3,3,1, 23511
31,23511,2,2,1, 23513
7,23512,1,1,1, 23513
29,23513,4,4,1, 23517
8,23516,1,1,1, 23517
9,23517,2,2,1, 23519
15,23521,2,2,1, 23523
18,23523,4,4,1, 23527
20,23523,6,6,1, 23529
22,23526,4,4,1, 23530
24,23529,1,1,1, 23530
21,23527,5,5,1, 23532
30,23533,3,3,1, 23536
6,23535,2,2,1, 23537
7,23537,1,1,1, 23538
29,23538,4,4,1, 23542
8,23541,1,1,0, 23542
14,23544,3,3,1, 23547
13,23544,4,4,1, 23548
24,23554,1,1,1, 23555
5,23557,3,3,1, 23560
7,23562,1,1,1, 23563
29,23563,4,4,1, 23567
24,23579,1,1,1, 23580
6,23585,2,2,1, 23587
7,23587,1,1,0, 23588
29,23588,4,4,1, 23592
24,23604,1,1,0, 23605
30,23608,3,3,1, 23611
31,23611,2,2,1, 23613
7,23612,1,1,0, 23613
29,23613,4,4,1, 23617
24,23629,1,1,0, 23630
30,23633,3,3,1, 23636
25,23635,2,2,1, 23637
7,23637,1,1,1, 23638
24,23654,1,1,1, 23655
1,23656,1,1,0, 23657
5,23657,3,3,1, 23660
30,23658,3,3,1, 23661
6,23660,2,2,1, 23662
7,23662,1,1,1, 23663
8,23666,1,1,0, 23667
16,23669,2,2,1, 23671
17,23669,3,3,1, 23672
13,23669,4,4,1, 23673
15,23671,2,2,1, 23673
22,23676,4,4,1, 23680
24,23679,1,1,0, 23680
1,23681,1,1,0, 23682
25,23685,2,2,1, 23687
7,23687,1,1,0, 23688
8,23691,1,1,0, 23692
9,23692,2,2,1, 23694
16,23694,2,2,1, 23696
14,23694,3,3,1, 23697
17,23694,3,3,1, 23697
24,23704,1,1,1, 23705
21,23702,5,5,1, 23707
1,23706,1,1,1, 23707
5,23707,3,3,1, 23710
25,23710,2,2,1, 23712
31,23711,2,2,1, 23713
7,23712,1,1,0, 23713
8,23716,1,1,1, 23717
9,23717,2,2,1, 23719
17,23719,3,3,1, 23722
2,23728,2,2,1, 23730
24,23729,1,1,0, 23730
1,23731,1,1,1, 23732
5,23732,3,3,1, 23735
25,23735,2,2,1, 23737
7,23737,1,1,1, 23738
29,23738,4,4,1, 23742
8,23741,1,1,1, 23742
16,23744,2,2,1, 23746
14,23744,3,3,1, 23747
17,23744,3,3,1, 23747
13,23744,4,4,1, 23748
18,23748,4,4,1, 23752
22,23751,4,4,1, 23755
2,23753,2,2,1, 23755
24,23754,1,1,1, 23755
1,23756,1,1,0, 23757
5,23757,3,3,1, 23760
30,23758,3,3,1, 23761
6,23760,2,2,1, 23762
25,23760,2,2,1, 23762
31,23761,2,2,1, 23763
7,23762,1,1,0, 23763
29,23763,4,4,1, 23767
8,23766,1,1,1, 23767
16,23769,2,2,1, 23771
14,23769,3,3,1, 23772
24,23779,1,1,0, 23780
23,23778,3,3,1, 23781
21,23777,5,5,1, 23782
1,23781,1,1,1, 23782
25,23785,2,2,1, 23787
8,23791,1,1,0, 23792
16,23794,2,2,1, 23796
14,23794,3,3,1, 23797
17,23794,3,3,1, 23797
15,23796,2,2,1, 23798
20,23798,6,6,1, 23804
22,23801,4,4,1, 23805
2,23803,2,2,1, 23805
24,23804,1,1,0, 23805
21,23802,5,5,1, 23807
1,23806,1,1,1, 23807
4,23806,4,4,1, 23810
3,23807,3,3,1, 23810
25,23810,2,2,1, 23812
26,23812,3,3,1, 23815
8,23816,1,1,1, 23817
11,23814,4,4,1, 23818
9,23817,2,2,1, 23819
16,23819,2,2,1, 23821
14,23819,3,3,1, 23822
13,23819,4,4,1, 23823
15,23821,2,2,1, 23823
12,23820,5,5,1, 23825
18,23823,4,4,1, 23827
2,23828,2,2,1, 23830
24,23829,1,1,1, 23830
19,23826,5,5,1, 23831
23,23828,3,3,1, 23831
21,23827,5,5,1, 23832
1,23831,1,1,0, 23832
4,23831,4,4,1, 23835
8,23841,1,1,0, 23842
14,23844,3,3,1, 23847
13,23844,4,4,1, 23848
24,23854,1,1,0, 23855
23,23853,3,3,1, 23856
8,23866,1,1,0, 23867
16,23869,2,2,1, 23871
22,23876,4,4,1, 23880
24,23879,1,1,1, 23880
21,23877,5,5,1, 23882
6,23885,2,2,1, 23887
7,23887,1,1,1, 23888
24,23904,1,1,1, 23905
30,23908,3,3,1, 23911
31,23911,2,2,1, 23913
7,23912,1,1,1, 23913
29,23913,4,4,1, 23917
24,23929,1,1,1, 23930
5,23932,3,3,1, 23935
30,23933,3,3,1, 23936
31,23936,2,2,1, 23938
7,23937,1,1,1, 23938
29,23938,4,4,1, 23942
9,23942,2,2,1, 23944
24,23954,1,1,1, 23955
1,23956,1,1,1, 23957
5,23957,3,3,1, 23960
30,23958,3,3,1, 23961
6,23960,2,2,1, 23962
31,23961,2,2,1, 23963
7,23962,1,1,0, 23963
29,23963,4,4,1, 23967
24,23979,1,1,1, 23980
1,23981,1,1,1, 23982
5,23982,3,3,1, 23985
25,23985,2,2,1, 23987
31,23986,2,2,1, 23988
7,23987,1,1,0, 23988
29,23988,4,4,1, 23992
8,23991,1,1,1, 23992
9,23992,2,2,1, 23994
16,23994,2,2,1, 23996
17,23994,3,3,1, 23997
13,23994,4,4,1, 23998
22,24001,4,4,1, 24005
24,24004,1,1,0, 24005
23,24003,3,3,1, 24006
21,24002,5,5,1, 24007
1,24006,1,1,1, 24007
5,24007,3,3,1, 24010
31,24011,2,2,1, 24013
7,24012,1,1,1, 24013
8,24016,1,1,0, 24017
16,24019,2,2,1, 24021
14,24019,3,3,1, 24022
17,24019,3,3,1, 24022
13,24019,4,4,1, 24023
15,24021,2,2,1, 24023
22,24026,4,4,1, 24030
24,24029,1,1,1, 24030
21,24027,5,5,1, 24032
1,24031,1,1,1, 24032
5,24032,3,3,1, 24035
30,24033,3,3,1, 24036
31,24036,2,2,1, 24038
7,24037,1,1,1, 24038
29,24038,4,4,1, 24042
8,24041,1,1,1, 24042
16,24044,2,2,1, 24046
14,24044,3,3,1, 24047
17,24044,3,3,1, 24047
13,24044,4,4,1, 24048
2,24053,2,2,1, 24055
24,24054,1,1,0, 24055
23,24053,3,3,1, 24056
1,24056,1,1,1, 24057
4,24056,4,4,1, 24060
5,24057,3,3,1, 24060
6,24060,2,2,1, 24062
25,24060,2,2,1, 24062
7,24062,1,1,1, 24063
26,24062,3,3,1, 24065
29,24063,4,4,1, 24067
8,24066,1,1,1, 24067
14,24069,3,3,1, 24072
13,24069,4,4,1, 24073
15,24071,2,2,1, 24073
12,24070,5,5,1, 24075
18,24073,4,4,1, 24077
20,24073,6,6,1, 24079
2,24078,2,2,1, 24080
24,24079,1,1,1, 24080
19,24076,5,5,1, 24081
21,24077,5,5,1, 24082
1,24081,1,1,0, 24082
4,24081,4,4,1, 24085
6,24085,2,2,1, 24087
7,24087,1,1,0, 24088
28,24084,5,5,1, 24089
29,24088,4,4,1, 24092
8,24091,1,1,0, 24092
11,24089,4,4,1, 24093
16,24094,2,2,1, 24096
17,24094,3,3,1, 24097
15,24096,2,2,1, 24098
12,24095,5,5,1, 24100
20,24098,6,6,1, 24104
24,24104,1,1,0, 24105
21,24102,5,5,1, 24107
1,24106,1,1,1, 24107
6,24110,2,2,1, 24112
25,24110,2,2,1, 24112
31,24111,2,2,1, 24113
7,24112,1,1,1, 24113
29,24113,4,4,1, 24117
8,24116,1,1,1, 24117
9,24117,2,2,1, 24119
16,24119,2,2,1, 24121
18,24123,4,4,1, 24127
2,24128,2,2,1, 24130
24,24129,1,1,0, 24130
1,24131,1,1,1, 24132
4,24131,4,4,1, 24135
5,24132,3,3,1, 24135
30,24133,3,3,1, 24136
6,24135,2,2,1, 24137
25,24135,2,2,1, 24137
7,24137,1,1,1, 24138
29,24138,4,4,1, 24142
11,24139,4,4,1, 24143
9,24142,2,2,1, 24144
17,24144,3,3,1, 24147
24,24154,1,1,0, 24155
24,24179,1,1,0, 24180
24,24204,1,1,1, 24205
22,24226,4,4,1, 24230
24,24229,1,1,0, 24230
23,24228,3,3,1, 24231
21,24227,5,5,1, 24232
8,24241,1,1,0, 24242
15,24246,2,2,1, 24248
22,24251,4,4,1, 24255
24,24254,1,1,1, 24255
21,24252,5,5,1, 24257
1,24256,1,1,1, 24257
30,24258,3,3,1, 24261
31,24261,2,2,1, 24263
7,24262,1,1,0, 24263
8,24266,1,1,0, 24267
16,24269,2,2,1, 24271
17,24269,3,3,1, 24272
13,24269,4,4,1, 24273
22,24276,4,4,1, 24280
24,24279,1,1,1, 24280
23,24278,3,3,1, 24281
1,24281,1,1,1, 24282
5,24282,3,3,1, 24285
30,24283,3,3,1, 24286
6,24285,2,2,1, 24287
25,24285,2,2,1, 24287
7,24287,1,1,0, 24288
29,24288,4,4,1, 24292
8,24291,1,1,1, 24292
9,24292,2,2,1, 24294
16,24294,2,2,1, 24296
13,24294,4,4,1, 24298
12,24295,5,5,1, 24300
24,24304,1,1,1, 24305
1,24306,1,1,0, 24307
4,24306,4,4,1, 24310
3,24307,3,3,1, 24310
30,24308,3,3,1, 24311
7,24312,1,1,1, 24313
28,24309,5,5,1, 24314
8,24316,1,1,1, 24317
9,24317,2,2,1, 24319
13,24319,4,4,1, 24323
18,24323,4,4,1, 24327
24,24329,1,1,1, 24330
1,24331,1,1,0, 24332
25,24335,2,2,1, 24337
7,24337,1,1,1, 24338
29,24338,4,4,1, 24342
8,24341,1,1,1, 24342
9,24342,2,2,1, 24344
14,24344,3,3,1, 24347
15,24346,2,2,1, 24348
18,24348,4,4,1, 24352
22,24351,4,4,1, 24355
2,24353,2,2,1, 24355
24,24354,1,1,1, 24355
1,24356,1,1,1, 24357
30,24358,3,3,1, 24361
6,24360,2,2,1, 24362
31,24361,2,2,1, 24363
7,24362,1,1,1, 24363
8,24366,1,1,1, 24367
9,24367,2,2,1, 24369
14,24369,3,3,1, 24372
18,24373,4,4,1, 24377
24,24379,1,1,0, 24380
23,24378,3,3,1, 24381
1,24381,1,1,0, 24382
25,24385,2,2,1, 24387
31,24386,2,2,1, 24388
7,24387,1,1,0, 24388
26,24387,3,3,1, 24390
29,24388,4,4,1, 24392
8,24391,1,1,0, 24392
9,24392,2,2,1, 24394
16,24394,2,2,1, 24396
14,24394,3,3,1, 24397
17,24394,3,3,1, 24397
13,24394,4,4,1, 24398
2,24403,2,2,1, 24405
24,24404,1,1,1, 24405
1,24406,1,1,1, 24407
5,24407,3,3,1, 24410
6,24410,2,2,1, 24412
7,24412,1,1,1, 24413
26,24412,3,3,1, 24415
29,24413,4,4,1, 24417
8,24416,1,1,0, 24417
15,24421,2,2,1, 24423
12,24420,5,5,1, 24425
18,24423,4,4,1, 24427
20,24423,6,6,1, 24429
24,24429,1,1,1, 24430
1,24431,1,1,0, 24432
4,24431,4,4,1, 24435
5,24432,3,3,1, 24435
27,24432,4,4,1, 24436
25,24435,2,2,1, 24437
7,24437,1,1,1, 24438
28,24434,5,5,1, 24439
26,24437,3,3,1, 24440
8,24441,1,1,0, 24442
16,24444,2,2,1, 24446
13,24444,4,4,1, 24448
24,24454,1,1,1, 24455
23,24453,3,3,1, 24456
5,24457,3,3,1, 24460
6,24460,2,2,1, 24462
7,24462,1,1,0, 24463
8,24466,1,1,1, 24467
16,24469,2,2,1, 24471
15,24471,2,2,1, 24473
24,24479,1,1,1, 24480
31,24486,2,2,1, 24488
7,24487,1,1,0, 24488
29,24488,4,4,1, 24492
8,24491,1,1,0, 24492
16,24494,2,2,1, 24496
14,24494,3,3,1, 24497
22,24501,4,4,1, 24505
24,24504,1,1,0, 24505
5,24507,3,3,1, 24510
6,24510,2,2,1, 24512
31,24511,2,2,1, 24513
7,24512,1,1,1, 24513
29,24513,4,4,1, 24517
8,24516,1,1,0, 24517
16,24519,2,2,1, 24521
14,24519,3,3,1, 24522
24,24529,1,1,0, 24530
21,24527,5,5,1, 24532
30,24533,3,3,1, 24536
31,24536,2,2,1, 24538
7,24537,1,1,1, 24538
8,24541,1,1,0, 24542
14,24544,3,3,1, 24547
15,24546,2,2,1, 24548
24,24554,1,1,0, 24555
23,24553,3,3,1, 24556
21,24552,5,5,1, 24557
1,24556,1,1,0, 24557
5,24557,3,3,1, 24560
31,24561,2,2,1, 24563
7,24562,1,1,1, 24563
29,24563,4,4,1, 24567
8,24566,1,1,0, 24567
16,24569,2,2,1, 24571
14,24569,3,3,1, 24572
13,24569,4,4,1, 24573
24,24579,1,1,1, 24580
1,24581,1,1,1, 24582
5,24582,3,3,1, 24585
6,24585,2,2,1, 24587
31,24586,2,2,1, 24588
7,24587,1,1,1, 24588
8,24591,1,1,1, 24592
16,24594,2,2,1, 24596
17,24594,3,3,1, 24597
13,24594,4,4,1, 24598
18,24598,4,4,1, 24602
24,24604,1,1,0, 24605
1,24606,1,1,1, 24607
30,24608,3,3,1, 24611
25,24610,2,2,1, 24612
7,24612,1,1,1, 24613
17,24619,3,3,1, 24622
18,24623,4,4,1, 24627
2,24628,2,2,1, 24630
24,24629,1,1,0, 24630
1,24631,1,1,1, 24632
5,24632,3,3,1, 24635
30,24633,3,3,1, 24636
7,24637,1,1,0, 24638
29,24638,4,4,1, 24642
24,24654,1,1,1, 24655
1,24656,1,1,1, 24657
5,24657,3,3,1, 24660
30,24658,3,3,1, 24661
6,24660,2,2,1, 24662
25,24660,2,2,1, 24662
31,24661,2,2,1, 24663
7,24662,1,1,1, 24663
26,24662,3,3,1, 24665
29,24663,4,4,1, 24667
11,24664,4,4,1, 24668
12,24670,5,5,1, 24675
18,24673,4,4,1, 24677
20,24673,6,6,1, 24679
24,24679,1,1,1, 24680
19,24676,5,5,1, 24681
1,24681,1,1,1, 24682
3,24682,3,3,1, 24685
5,24682,3,3,1, 24685
27,24682,4,4,1, 24686
6,24685,2,2,1, 24687
25,24685,2,2,1, 24687
7,24687,1,1,1, 24688
28,24684,5,5,1, 24689
26,24687,3,3,1, 24690
11,24689,4,4,1, 24693
17,24694,3,3,1, 24697
12,24695,5,5,1, 24700
20,24698,6,6,1, 24704
2,24703,2,2,1, 24705
24,24704,1,1,1, 24705
19,24701,5,5,1, 24706
1,24706,1,1,0, 24707
4,24706,4,4,1, 24710
3,24707,3,3,1, 24710
27,24707,4,4,1, 24711
6,24710,2,2,1, 24712
31,24711,2,2,1, 24713
7,24712,1,1,1, 24713
26,24712,3,3,1, 24715
29,24713,4,4,1, 24717
8,24716,1,1,0, 24717
16,24719,2,2,1, 24721
14,24719,3,3,1, 24722
17,24719,3,3,1, 24722
24,24729,1,1,1, 24730
23,24728,3,3,1, 24731
31,24736,2,2,1, 24738
7,24737,1,1,1, 24738
29,24738,4,4,1, 24742
8,24741,1,1,1, 24742
13,24744,4,4,1, 24748
15,24746,2,2,1, 24748
24,24754,1,1,1, 24755
21,24752,5,5,1, 24757
30,24758,3,3,1, 24761
6,24760,2,2,1, 24762
31,24761,2,2,1, 24763
7,24762,1,1,0, 24763
29,24763,4,4,1, 24767
8,24766,1,1,0, 24767
14,24769,3,3,1, 24772
13,24769,4,4,1, 24773
24,24779,1,1,0, 24780
23,24778,3,3,1, 24781
30,24783,3,3,1, 24786
6,24785,2,2,1, 24787
7,24787,1,1,0, 24788
29,24788,4,4,1, 24792
8,24791,1,1,0, 24792
13,24794,4,4,1, 24798
24,24804,1,1,0, 24805
5,24807,3,3,1, 24810
30,24808,3,3,1, 24811
31,24811,2,2,1, 24813
7,24812,1,1,0, 24813
29,24813,4,4,1, 24817
8,24816,1,1,0, 24817
16,24819,2,2,1, 24821
14,24819,3,3,1, 24822
13,24819,4,4,1, 24823
15,24821,2,2,1, 24823
24,24829,1,1,1, 24830
21,24827,5,5,1, 24832
1,24831,1,1,0, 24832
5,24832,3,3,1, 24835
30,24833,3,3,1, 24836
6,24835,2,2,1, 24837
25,24835,2,2,1, 24837
7,24837,1,1,1, 24838
29,24838,4,4,1, 24842
8,24841,1,1,1, 24842
16,24844,2,2,1, 24846
14,24844,3,3,1, 24847
18,24848,4,4,1, 24852
2,24853,2,2,1, 24855
24,24854,1,1,0, 24855
23,24853,3,3,1, 24856
21,24852,5,5,1, 24857
1,24856,1,1,0, 24857
25,24860,2,2,1, 24862
28,24859,5,5,1, 24864
8,24866,1,1,1, 24867
11,24864,4,4,1, 24868
16,24869,2,2,1, 24871
13,24869,4,4,1, 24873
22,24876,4,4,1, 24880
2,24878,2,2,1, 24880
24,24879,1,1,0, 24880
19,24876,5,5,1, 24881
21,24877,5,5,1, 24882
1,24881,1,1,0, 24882
3,24882,3,3,1, 24885
27,24882,4,4,1, 24886
28,24884,5,5,1, 24889
8,24891,1,1,1, 24892
11,24889,4,4,1, 24893
14,24894,3,3,1, 24897
13,24894,4,4,1, 24898
15,24896,2,2,1, 24898
18,24898,4,4,1, 24902
24,24904,1,1,0, 24905
19,24901,5,5,1, 24906
23,24903,3,3,1, 24906
21,24902,5,5,1, 24907
1,24906,1,1,0, 24907
4,24906,4,4,1, 24910
25,24910,2,2,1, 24912
26,24912,3,3,1, 24915
8,24916,1,1,1, 24917
11,24914,4,4,1, 24918
14,24919,3,3,1, 24922
15,24921,2,2,1, 24923
20,24923,6,6,1, 24929
24,24929,1,1,1, 24930
19,24926,5,5,1, 24931
23,24928,3,3,1, 24931
1,24931,1,1,0, 24932
4,24931,4,4,1, 24935
3,24932,3,3,1, 24935
8,24941,1,1,1, 24942
14,24944,3,3,1, 24947
13,24944,4,4,1, 24948
22,24951,4,4,1, 24955
24,24954,1,1,1, 24955
21,24952,5,5,1, 24957
30,24958,3,3,1, 24961
7,24962,1,1,1, 24963
24,24979,1,1,0, 24980
6,24985,2,2,1, 24987
31,24986,2,2,1, 24988
7,24987,1,1,1, 24988
29,24988,4,4,1, 24992
24,25004,1,1,1, 25005
30,25008,3,3,1, 25011
7,25012,1,1,1, 25013
29,25013,4,4,1, 25017
24,25029,1,1,1, 25030
30,25033,3,3,1, 25036
7,25037,1,1,1, 25038
9,25042,2,2,1, 25044
17,25044,3,3,1, 25047
24,25054,1,1,0, 25055
1,25056,1,1,1, 25057
5,25057,3,3,1, 25060
6,25060,2,2,1, 25062
31,25061,2,2,1, 25063
7,25062,1,1,1, 25063
29,25063,4,4,1, 25067
8,25066,1,1,0, 25067
17,25069,3,3,1, 25072
15,25071,2,2,1, 25073
18,25073,4,4,1, 25077
24,25079,1,1,1, 25080
21,25077,5,5,1, 25082
1,25081,1,1,0, 25082
5,25082,3,3,1, 25085
30,25083,3,3,1, 25086
25,25085,2,2,1, 25087
7,25087,1,1,0, 25088
29,25088,4,4,1, 25092
8,25091,1,1,0, 25092
9,25092,2,2,1, 25094
16,25094,2,2,1, 25096
14,25094,3,3,1, 25097
15,25096,2,2,1, 25098
18,25098,4,4,1, 25102
2,25103,2,2,1, 25105
24,25104,1,1,0, 25105
1,25106,1,1,1, 25107
30,25108,3,3,1, 25111
25,25110,2,2,1, 25112
31,25111,2,2,1, 25113
7,25112,1,1,0, 25113
26,25112,3,3,1, 25115
29,25113,4,4,1, 25117
8,25116,1,1,0, 25117
14,25119,3,3,1, 25122
18,25123,4,4,1, 25127
2,25128,2,2,1, 25130
24,25129,1,1,1, 25130
21,25127,5,5,1, 25132
1,25131,1,1,0, 25132
3,25132,3,3,1, 25135
5,25132,3,3,1, 25135
30,25133,3,3,1, 25136
25,25135,2,2,1, 25137
31,25136,2,2,1, 25138
7,25137,1,1,0, 25138
28,25134,5,5,1, 25139
8,25141,1,1,0, 25142
14,25144,3,3,1, 25147
17,25144,3,3,1, 25147
2,25153,2,2,1, 25155
24,25154,1,1,1, 25155
21,25152,5,5,1, 25157
1,25156,1,1,0, 25157
4,25156,4,4,1, 25160
31,25161,2,2,1, 25163
7,25162,1,1,0, 25163
26,25162,3,3,1, 25165
29,25163,4,4,1, 25167
8,25166,1,1,1, 25167
11,25164,4,4,1, 25168
17,25169,3,3,1, 25172
12,25170,5,5,1, 25175
2,25178,2,2,1, 25180
24,25179,1,1,0, 25180
19,25176,5,5,1, 25181
1,25181,1,1,0, 25182
7,25187,1,1,0, 25188
28,25184,5,5,1, 25189
29,25188,4,4,1, 25192
8,25191,1,1,0, 25192
9,25192,2,2,1, 25194
14,25194,3,3,1, 25197
17,25194,3,3,1, 25197
12,25195,5,5,1, 25200
22,25201,4,4,1, 25205
24,25204,1,1,1, 25205
23,25203,3,3,1, 25206
30,25208,3,3,1, 25211
7,25212,1,1,1, 25213
8,25216,1,1,0, 25217
16,25219,2,2,1, 25221
14,25219,3,3,1, 25222
13,25219,4,4,1, 25223
24,25229,1,1,1, 25230
21,25227,5,5,1, 25232
5,25232,3,3,1, 25235
31,25236,2,2,1, 25238
7,25237,1,1,1, 25238
29,25238,4,4,1, 25242
8,25241,1,1,0, 25242
14,25244,3,3,1, 25247
13,25244,4,4,1, 25248
15,25246,2,2,1, 25248
24,25254,1,1,0, 25255
23,25253,3,3,1, 25256
21,25252,5,5,1, 25257
5,25257,3,3,1, 25260
30,25258,3,3,1, 25261
7,25262,1,1,1, 25263
8,25266,1,1,0, 25267
16,25269,2,2,1, 25271
13,25269,4,4,1, 25273
15,25271,2,2,1, 25273
24,25279,1,1,0, 25280
23,25278,3,3,1, 25281
21,25277,5,5,1, 25282
5,25282,3,3,1, 25285
7,25287,1,1,0, 25288
8,25291,1,1,1, 25292
16,25294,2,2,1, 25296
14,25294,3,3,1, 25297
13,25294,4,4,1, 25298
15,25296,2,2,1, 25298
24,25304,1,1,0, 25305
1,25306,1,1,1, 25307
6,25310,2,2,1, 25312
25,25310,2,2,1, 25312
7,25312,1,1,1, 25313
8,25316,1,1,0, 25317
14,25319,3,3,1, 25322
17,25319,3,3,1, 25322
22,25326,4,4,1, 25330
24,25329,1,1,0, 25330
23,25328,3,3,1, 25331
21,25327,5,5,1, 25332
1,25331,1,1,1, 25332
5,25332,3,3,1, 25335
30,25333,3,3,1, 25336
6,25335,2,2,1, 25337
25,25335,2,2,1, 25337
7,25337,1,1,1, 25338
8,25341,1,1,0, 25342
14,25344,3,3,1, 25347
2,25353,2,2,1, 25355
24,25354,1,1,0, 25355
21,25352,5,5,1, 25357
1,25356,1,1,1, 25357
30,25358,3,3,1, 25361
6,25360,2,2,1, 25362
25,25360,2,2,1, 25362
7,25362,1,1,0, 25363
26,25362,3,3,1, 25365
29,25363,4,4,1, 25367
8,25366,1,1,0, 25367
16,25369,2,2,1, 25371
14,25369,3,3,1, 25372
24,25379,1,1,0, 25380
21,25377,5,5,1, 25382
1,25381,1,1,1, 25382
5,25382,3,3,1, 25385
30,25383,3,3,1, 25386
6,25385,2,2,1, 25387
25,25385,2,2,1, 25387
31,25386,2,2,1, 25388
7,25387,1,1,1, 25388
26,25387,3,3,1, 25390
29,25388,4,4,1, 25392
9,25392,2,2,1, 25394
17,25394,3,3,1, 25397
24,25404,1,1,1, 25405
1,25406,1,1,1, 25407
6,25410,2,2,1, 25412
25,25410,2,2,1, 25412
31,25411,2,2,1, 25413
7,25412,1,1,1, 25413
26,25412,3,3,1, 25415
29,25413,4,4,1, 25417
17,25419,3,3,1, 25422
18,25423,4,4,1, 25427
24,25429,1,1,1, 25430
1,25431,1,1,1, 25432
3,25432,3,3,1, 25435
5,25432,3,3,1, 25435
7,25437,1,1,1, 25438
28,25434,5,5,1, 25439
26,25437,3,3,1, 25440
29,25438,4,4,1, 25442
12,25445,5,5,1, 25450
24,25454,1,1,1, 25455
19,25451,5,5,1, 25456
1,25456,1,1,0, 25457
4,25456,4,4,1, 25460
3,25457,3,3,1, 25460
31,25461,2,2,1, 25463
7,25462,1,1,1, 25463
11,25464,4,4,1, 25468
2,25478,2,2,1, 25480
24,25479,1,1,0, 25480
1,25481,1,1,0, 25482
5,25482,3,3,1, 25485
27,25482,4,4,1, 25486
6,25485,2,2,1, 25487
31,25486,2,2,1, 25488
7,25487,1,1,1, 25488
26,25487,3,3,1, 25490
29,25488,4,4,1, 25492
8,25491,1,1,1, 25492
11,25489,4,4,1, 25493
9,25492,2,2,1, 25494
16,25494,2,2,1, 25496
17,25494,3,3,1, 25497
13,25494,4,4,1, 25498
18,25498,4,4,1, 25502
24,25504,1,1,0, 25505
23,25503,3,3,1, 25506
5,25507,3,3,1, 25510
31,25511,2,2,1, 25513
7,25512,1,1,1, 25513
29,25513,4,4,1, 25517
8,25516,1,1,1, 25517
22,25526,4,4,1, 25530
24,25529,1,1,0, 25530
23,25528,3,3,1, 25531
5,25532,3,3,1, 25535
31,25536,2,2,1, 25538
7,25537,1,1,0, 25538
29,25538,4,4,1, 25542
8,25541,1,1,1, 25542
16,25544,2,2,1, 25546
13,25544,4,4,1, 25548
15,25546,2,2,1, 25548
22,25551,4,4,1, 25555
24,25554,1,1,0, 25555
23,25553,3,3,1, 25556
21,25552,5,5,1, 25557
5,25557,3,3,1, 25560
30,25558,3,3,1, 25561
7,25562,1,1,0, 25563
8,25566,1,1,1, 25567
14,25569,3,3,1, 25572
15,25571,2,2,1, 25573
24,25579,1,1,0, 25580
5,25582,3,3,1, 25585
30,25583,3,3,1, 25586
6,25585,2,2,1, 25587
31,25586,2,2,1, 25588
7,25587,1,1,0, 25588
29,25588,4,4,1, 25592
8,25591,1,1,1, 25592
16,25594,2,2,1, 25596
14,25594,3,3,1, 25597
15,25596,2,2,1, 25598
24,25604,1,1,1, 25605
23,25603,3,3,1, 25606
1,25606,1,1,0, 25607
25,25610,2,2,1, 25612
8,25616,1,1,1, 25617
16,25619,2,2,1, 25621
22,25626,4,4,1, 25630
24,25629,1,1,1, 25630
23,25628,3,3,1, 25631
21,25627,5,5,1, 25632
1,25631,1,1,1, 25632
8,25641,1,1,1, 25642
15,25646,2,2,1, 25648
24,25654,1,1,1, 25655
21,25652,5,5,1, 25657
1,25656,1,1,1, 25657
8,25666,1,1,0, 25667
9,25667,2,2,1, 25669
17,25669,3,3,1, 25672
13,25669,4,4,1, 25673
22,25676,4,4,1, 25680
24,25679,1,1,1, 25680
23,25678,3,3,1, 25681
1,25681,1,1,1, 25682
8,25691,1,1,1, 25692
14,25694,3,3,1, 25697
13,25694,4,4,1, 25698
12,25695,5,5,1, 25700
2,25703,2,2,1, 25705
24,25704,1,1,0, 25705
1,25706,1,1,1, 25707
30,25708,3,3,1, 25711
6,25710,2,2,1, 25712
25,25710,2,2,1, 25712
31,25711,2,2,1, 25713
7,25712,1,1,1, 25713
29,25713,4,4,1, 25717
8,25716,1,1,0, 25717
11,25714,4,4,1, 25718
16,25719,2,2,1, 25721
17,25719,3,3,1, 25722
20,25723,6,6,1, 25729
22,25726,4,4,1, 25730
24,25729,1,1,1, 25730
19,25726,5,5,1, 25731
21,25727,5,5,1, 25732
1,25731,1,1,1, 25732
3,25732,3,3,1, 25735
27,25732,4,4,1, 25736
25,25735,2,2,1, 25737
31,25736,2,2,1, 25738
7,25737,1,1,0, 25738
28,25734,5,5,1, 25739
26,25737,3,3,1, 25740
29,25738,4,4,1, 25742
8,25741,1,1,1, 25742
11,25739,4,4,1, 25743
9,25742,2,2,1, 25744
14,25744,3,3,1, 25747
2,25753,2,2,1, 25755
24,25754,1,1,0, 25755
1,25756,1,1,1, 25757
5,25757,3,3,1, 25760
6,25760,2,2,1, 25762
31,25761,2,2,1, 25763
7,25762,1,1,0, 25763
8,25766,1,1,1, 25767
14,25769,3,3,1, 25772
17,25769,3,3,1, 25772
15,25771,2,2,1, 25773
18,25773,4,4,1, 25777
24,25779,1,1,1, 25780
21,25777,5,5,1, 25782
1,25781,1,1,0, 25782
5,25782,3,3,1, 25785
7,25787,1,1,1, 25788
29,25788,4,4,1, 25792
8,25791,1,1,1, 25792
9,25792,2,2,1, 25794
14,25794,3,3,1, 25797
13,25794,4,4,1, 25798
15,25796,2,2,1, 25798
18,25798,4,4,1, 25802
24,25804,1,1,0, 25805
1,25806,1,1,0, 25807
6,25810,2,2,1, 25812
25,25810,2,2,1, 25812
31,25811,2,2,1, 25813
7,25812,1,1,0, 25813
9,25817,2,2,1, 25819
18,25823,4,4,1, 25827
24,25829,1,1,0, 25830
1,25831,1,1,1, 25832
30,25833,3,3,1, 25836
25,25835,2,2,1, 25837
31,25836,2,2,1, 25838
7,25837,1,1,1, 25838
17,25844,3,3,1, 25847
12,25845,5,5,1, 25850
2,25853,2,2,1, 25855
24,25854,1,1,1, 25855
1,25856,1,1,0, 25857
27,25857,4,4,1, 25861
30,25858,3,3,1, 25861
25,25860,2,2,1, 25862
31,25861,2,2,1, 25863
7,25862,1,1,0, 25863
28,25859,5,5,1, 25864
29,25863,4,4,1, 25867
11,25864,4,4,1, 25868
9,25867,2,2,1, 25869
24,25879,1,1,1, 25880
30,25883,3,3,1, 25886
6,25885,2,2,1, 25887
7,25887,1,1,1, 25888
24,25904,1,1,1, 25905
23,25903,3,3,1, 25906
7,25912,1,1,1, 25913
8,25916,1,1,1, 25917
15,25921,2,2,1, 25923
22,25926,4,4,1, 25930
24,25929,1,1,0, 25930
5,25932,3,3,1, 25935
30,25933,3,3,1, 25936
6,25935,2,2,1, 25937
31,25936,2,2,1, 25938
7,25937,1,1,1, 25938
8,25941,1,1,0, 25942
16,25944,2,2,1, 25946
13,25944,4,4,1, 25948
24,25954,1,1,1, 25955
21,25952,5,5,1, 25957
6,25960,2,2,1, 25962
7,25962,1,1,0, 25963
29,25963,4,4,1, 25967
8,25966,1,1,0, 25967
14,25969,3,3,1, 25972
18,25973,4,4,1, 25977
20,25973,6,6,1, 25979
24,25979,1,1,1, 25980
23,25978,3,3,1, 25981
21,25977,5,5,1, 25982
1,25981,1,1,0, 25982
30,25983,3,3,1, 25986
6,25985,2,2,1, 25987
31,25986,2,2,1, 25988
7,25987,1,1,0, 25988
8,25991,1,1,1, 25992
9,25992,2,2,1, 25994
16,25994,2,2,1, 25996
13,25994,4,4,1, 25998
22,26001,4,4,1, 26005
24,26004,1,1,1, 26005
1,26006,1,1,0, 26007
6,26010,2,2,1, 26012
31,26011,2,2,1, 26013
7,26012,1,1,1, 26013
29,26013,4,4,1, 26017
8,26016,1,1,1, 26017
16,26019,2,2,1, 26021
14,26019,3,3,1, 26022
22,26026,4,4,1, 26030
24,26029,1,1,0, 26030
23,26028,3,3,1, 26031
1,26031,1,1,1, 26032
25,26035,2,2,1, 26037
7,26037,1,1,1, 26038
29,26038,4,4,1, 26042
8,26041,1,1,1, 26042
9,26042,2,2,1, 26044
16,26044,2,2,1, 26046
13,26044,4,4,1, 26048
24,26054,1,1,0, 26055
21,26052,5,5,1, 26057
1,26056,1,1,0, 26057
5,26057,3,3,1, 26060
30,26058,3,3,1, 26061
6,26060,2,2,1, 26062
7,26062,1,1,0, 26063
8,26066,1,1,0, 26067
9,26067,2,2,1, 26069
16,26069,2,2,1, 26071
13,26069,4,4,1, 26073
24,26079,1,1,1, 26080
23,26078,3,3,1, 26081
1,26081,1,1,0, 26082
30,26083,3,3,1, 26086
7,26087,1,1,1, 26088
26,26087,3,3,1, 26090
8,26091,1,1,1, 26092
9,26092,2,2,1, 26094
17,26094,3,3,1, 26097
18,26098,4,4,1, 26102
24,26104,1,1,1, 26105
1,26106,1,1,0, 26107
25,26110,2,2,1, 26112
31,26111,2,2,1, 26113
7,26112,1,1,0, 26113
26,26112,3,3,1, 26115
8,26116,1,1,0, 26117
16,26119,2,2,1, 26121
13,26119,4,4,1, 26123
2,26128,2,2,1, 26130
24,26129,1,1,1, 26130
23,26128,3,3,1, 26131
1,26131,1,1,0, 26132
5,26132,3,3,1, 26135
31,26136,2,2,1, 26138
7,26137,1,1,1, 26138
26,26137,3,3,1, 26140
8,26141,1,1,1, 26142
11,26139,4,4,1, 26143
9,26142,2,2,1, 26144
14,26144,3,3,1, 26147
13,26144,4,4,1, 26148
12,26145,5,5,1, 26150
20,26148,6,6,1, 26154
22,26151,4,4,1, 26155
24,26154,1,1,0, 26155
19,26151,5,5,1, 26156
23,26153,3,3,1, 26156
21,26152,5,5,1, 26157
1,26156,1,1,1, 26157
4,26156,4,4,1, 26160
3,26157,3,3,1, 26160
5,26157,3,3,1, 26160
25,26160,2,2,1, 26162
31,26161,2,2,1, 26163
7,26162,1,1,0, 26163
28,26159,5,5,1, 26164
8,26166,1,1,1, 26167
11,26164,4,4,1, 26168
16,26169,2,2,1, 26171
13,26169,4,4,1, 26173
15,26171,2,2,1, 26173
18,26173,4,4,1, 26177
2,26178,2,2,1, 26180
24,26179,1,1,0, 26180
19,26176,5,5,1, 26181
23,26178,3,3,1, 26181
1,26181,1,1,1, 26182
3,26182,3,3,1, 26185
5,26182,3,3,1, 26185
27,26182,4,4,1, 26186
25,26185,2,2,1, 26187
31,26186,2,2,1, 26188
7,26187,1,1,1, 26188
8,26191,1,1,1, 26192
11,26189,4,4,1, 26193
14,26194,3,3,1, 26197
17,26194,3,3,1, 26197
13,26194,4,4,1, 26198
22,26201,4,4,1, 26205
24,26204,1,1,1, 26205
30,26208,3,3,1, 26211
6,26210,2,2,1, 26212
31,26211,2,2,1, 26213
7,26212,1,1,0, 26213
29,26213,4,4,1, 26217
24,26229,1,1,0, 26230
30,26233,3,3,1, 26236
31,26236,2,2,1, 26238
7,26237,1,1,0, 26238
29,26238,4,4,1, 26242
24,26254,1,1,0, 26255
5,26257,3,3,1, 26260
30,26258,3,3,1, 26261
6,26260,2,2,1, 26262
31,26261,2,2,1, 26263
7,26262,1,1,1, 26263
24,26279,1,1,0, 26280
7,26287,1,1,0, 26288
24,26304,1,1,0, 26305
1,26306,1,1,0, 26307
30,26308,3,3,1, 26311
25,26310,2,2,1, 26312
31,26311,2,2,1, 26313
7,26312,1,1,1, 26313
8,26316,1,1,1, 26317
16,26319,2,2,1, 26321
13,26319,4,4,1, 26323
15,26321,2,2,1, 26323
18,26323,4,4,1, 26327
22,26326,4,4,1, 26330
24,26329,1,1,1, 26330
1,26331,1,1,1, 26332
6,26335,2,2,1, 26337
7,26337,1,1,0, 26338
26,26337,3,3,1, 26340
8,26341,1,1,0, 26342
14,26344,3,3,1, 26347
12,26345,5,5,1, 26350
18,26348,4,4,1, 26352
20,26348,6,6,1, 26354
22,26351,4,4,1, 26355
24,26354,1,1,1, 26355
23,26353,3,3,1, 26356
1,26356,1,1,0, 26357
5,26357,3,3,1, 26360
30,26358,3,3,1, 26361
31,26361,2,2,1, 26363
7,26362,1,1,0, 26363
28,26359,5,5,1, 26364
26,26362,3,3,1, 26365
8,26366,1,1,0, 26367
9,26367,2,2,1, 26369
14,26369,3,3,1, 26372
13,26369,4,4,1, 26373
15,26371,2,2,1, 26373
22,26376,4,4,1, 26380
24,26379,1,1,0, 26380
21,26377,5,5,1, 26382
1,26381,1,1,0, 26382
27,26382,4,4,1, 26386
7,26387,1,1,0, 26388
28,26384,5,5,1, 26389
26,26387,3,3,1, 26390
8,26391,1,1,1, 26392
14,26394,3,3,1, 26397
17,26394,3,3,1, 26397
13,26394,4,4,1, 26398
15,26396,2,2,1, 26398
20,26398,6,6,1, 26404
22,26401,4,4,1, 26405
2,26403,2,2,1, 26405
24,26404,1,1,0, 26405
19,26401,5,5,1, 26406
23,26403,3,3,1, 26406
21,26402,5,5,1, 26407
1,26406,1,1,1, 26407
4,26406,4,4,1, 26410
7,26412,1,1,0, 26413
28,26409,5,5,1, 26414
29,26413,4,4,1, 26417
8,26416,1,1,1, 26417
17,26419,3,3,1, 26422
13,26419,4,4,1, 26423
20,26423,6,6,1, 26429
22,26426,4,4,1, 26430
2,26428,2,2,1, 26430
24,26429,1,1,1, 26430
21,26427,5,5,1, 26432
1,26431,1,1,1, 26432
4,26431,4,4,1, 26435
3,26432,3,3,1, 26435
6,26435,2,2,1, 26437
31,26436,2,2,1, 26438
7,26437,1,1,0, 26438
28,26434,5,5,1, 26439
29,26438,4,4,1, 26442
8,26441,1,1,0, 26442
11,26439,4,4,1, 26443
9,26442,2,2,1, 26444
16,26444,2,2,1, 26446
13,26444,4,4,1, 26448
15,26446,2,2,1, 26448
24,26454,1,1,0, 26455
30,26458,3,3,1, 26461
31,26461,2,2,1, 26463
7,26462,1,1,1, 26463
8,26466,1,1,1, 26467
14,26469,3,3,1, 26472
15,26471,2,2,1, 26473
24,26479,1,1,1, 26480
21,26477,5,5,1, 26482
5,26482,3,3,1, 26485
30,26483,3,3,1, 26486
6,26485,2,2,1, 26487
31,26486,2,2,1, 26488
7,26487,1,1,0, 26488
29,26488,4,4,1, 26492
8,26491,1,1,1, 26492
14,26494,3,3,1, 26497
22,26501,4,4,1, 26505
24,26504,1,1,0, 26505
21,26502,5,5,1, 26507
30,26508,3,3,1, 26511
31,26511,2,2,1, 26513
7,26512,1,1,0, 26513
29,26513,4,4,1, 26517
8,26516,1,1,0, 26517
16,26519,2,2,1, 26521
24,26529,1,1,0, 26530
5,26532,3,3,1, 26535
30,26533,3,3,1, 26536
6,26535,2,2,1, 26537
7,26537,1,1,0, 26538
24,26554,1,1,1, 26555
1,26556,1,1,1, 26557
5,26557,3,3,1, 26560
7,26562,1,1,1, 26563
29,26563,4,4,1, 26567
11,26564,4,4,1, 26568
9,26567,2,2,1, 26569
17,26569,3,3,1, 26572
12,26570,5,5,1, 26575
2,26578,2,2,1, 26580
24,26579,1,1,0, 26580
19,26576,5,5,1, 26581
1,26581,1,1,1, 26582
4,26581,4,4,1, 26585
5,26582,3,3,1, 26585
31,26586,2,2,1, 26588
7,26587,1,1,1, 26588
26,26587,3,3,1, 26590
18,26598,4,4,1, 26602
2,26603,2,2,1, 26605
24,26604,1,1,1, 26605
1,26606,1,1,1, 26607
5,26607,3,3,1, 26610
25,26610,2,2,1, 26612
7,26612,1,1,0, 26613
26,26612,3,3,1, 26615
29,26613,4,4,1, 26617
22,26626,4,4,1, 26630
24,26629,1,1,0, 26630
23,26628,3,3,1, 26631
1,26631,1,1,0, 26632
7,26637,1,1,0, 26638
26,26637,3,3,1, 26640
8,26641,1,1,0, 26642
16,26644,2,2,1, 26646
14,26644,3,3,1, 26647
15,26646,2,2,1, 26648
24,26654,1,1,0, 26655
21,26652,5,5,1, 26657
1,26656,1,1,0, 26657
5,26657,3,3,1, 26660
30,26658,3,3,1, 26661
6,26660,2,2,1, 26662
7,26662,1,1,1, 26663
26,26662,3,3,1, 26665
29,26663,4,4,1, 26667
8,26666,1,1,1, 26667
16,26669,2,2,1, 26671
14,26669,3,3,1, 26672
18,26673,4,4,1, 26677
22,26676,4,4,1, 26680
2,26678,2,2,1, 26680
24,26679,1,1,0, 26680
23,26678,3,3,1, 26681
1,26681,1,1,1, 26682
5,26682,3,3,1, 26685
31,26686,2,2,1, 26688
7,26687,1,1,1, 26688
26,26687,3,3,1, 26690
8,26691,1,1,0, 26692
9,26692,2,2,1, 26694
17,26694,3,3,1, 26697
13,26694,4,4,1, 26698
15,26696,2,2,1, 26698
18,26698,4,4,1, 26702
24,26704,1,1,0, 26705
19,26701,5,5,1, 26706
23,26703,3,3,1, 26706
1,26706,1,1,1, 26707
4,26706,4,4,1, 26710
3,26707,3,3,1, 26710
30,26708,3,3,1, 26711
6,26710,2,2,1, 26712
25,26710,2,2,1, 26712
31,26711,2,2,1, 26713
7,26712,1,1,0, 26713
28,26709,5,5,1, 26714
29,26713,4,4,1, 26717
8,26716,1,1,0, 26717
9,26717,2,2,1, 26719
14,26719,3,3,1, 26722
12,26720,5,5,1, 26725
18,26723,4,4,1, 26727
22,26726,4,4,1, 26730
24,26729,1,1,0, 26730
19,26726,5,5,1, 26731
21,26727,5,5,1, 26732
30,26733,3,3,1, 26736
6,26735,2,2,1, 26737
31,26736,2,2,1, 26738
7,26737,1,1,1, 26738
8,26741,1,1,1, 26742
14,26744,3,3,1, 26747
22,26751,4,4,1, 26755
24,26754,1,1,1, 26755
5,26757,3,3,1, 26760
7,26762,1,1,0, 26763
8,26766,1,1,0, 26767
16,26769,2,2,1, 26771
22,26776,4,4,1, 26780
24,26779,1,1,1, 26780
23,26778,3,3,1, 26781
5,26782,3,3,1, 26785
30,26783,3,3,1, 26786
6,26785,2,2,1, 26787
31,26786,2,2,1, 26788
7,26787,1,1,0, 26788
8,26791,1,1,0, 26792
14,26794,3,3,1, 26797
15,26796,2,2,1, 26798
24,26804,1,1,0, 26805
23,26803,3,3,1, 26806
5,26807,3,3,1, 26810
30,26808,3,3,1, 26811
6,26810,2,2,1, 26812
7,26812,1,1,1, 26813
29,26813,4,4,1, 26817
8,26816,1,1,1, 26817
16,26819,2,2,1, 26821
13,26819,4,4,1, 26823
24,26829,1,1,0, 26830
23,26828,3,3,1, 26831
6,26835,2,2,1, 26837
7,26837,1,1,0, 26838
29,26838,4,4,1, 26842
8,26841,1,1,1, 26842
9,26842,2,2,1, 26844
16,26844,2,2,1, 26846
17,26844,3,3,1, 26847
13,26844,4,4,1, 26848
22,26851,4,4,1, 26855
24,26854,1,1,1, 26855
1,26856,1,1,0, 26857
30,26858,3,3,1, 26861
6,26860,2,2,1, 26862
25,26860,2,2,1, 26862
31,26861,2,2,1, 26863
7,26862,1,1,1, 26863
8,26866,1,1,1, 26867
16,26869,2,2,1, 26871
14,26869,3,3,1, 26872
17,26869,3,3,1, 26872
12,26870,5,5,1, 26875
20,26873,6,6,1, 26879
24,26879,1,1,0, 26880
19,26876,5,5,1, 26881
23,26878,3,3,1, 26881
21,26877,5,5,1, 26882
1,26881,1,1,0, 26882
5,26882,3,3,1, 26885
6,26885,2,2,1, 26887
25,26885,2,2,1, 26887
7,26887,1,1,1, 26888
29,26888,4,4,1, 26892
18,26898,4,4,1, 26902
2,26903,2,2,1, 26905
24,26904,1,1,1, 26905
1,26906,1,1,1, 26907
24,26929,1,1,1, 26930
1,26931,1,1,1, 26932
25,26935,2,2,1, 26937
17,26944,3,3,1, 26947
18,26948,4,4,1, 26952
2,26953,2,2,1, 26955
24,26954,1,1,0, 26955
1,26956,1,1,0, 26957
25,26960,2,2,1, 26962
2,26978,2,2,1, 26980
24,26979,1,1,1, 26980
1,26981,1,1,1, 26982
25,26985,2,2,1, 26987
28,26984,5,5,1, 26989
26,26987,3,3,1, 26990
8,26991,1,1,0, 26992
11,26989,4,4,1, 26993
9,26992,2,2,1, 26994
16,26994,2,2,1, 26996
14,26994,3,3,1, 26997
17,26994,3,3,1, 26997
13,26994,4,4,1, 26998
15,26996,2,2,1, 26998
12,26995,5,5,1, 27000
18,26998,4,4,1, 27002
20,26998,6,6,1, 27004
22,27001,4,4,1, 27005
24,27004,1,1,1, 27005
19,27001,5,5,1, 27006
23,27003,3,3,1, 27006
21,27002,5,5,1, 27007
1,27006,1,1,1, 27007
5,27007,3,3,1, 27010
27,27007,4,4,1, 27011
6,27010,2,2,1, 27012
25,27010,2,2,1, 27012
7,27012,1,1,1, 27013
29,27013,4,4,1, 27017
8,27016,1,1,1, 27017
16,27019,2,2,1, 27021
14,27019,3,3,1, 27022
24,27029,1,1,0, 27030
21,27027,5,5,1, 27032
6,27035,2,2,1, 27037
7,27037,1,1,0, 27038
29,27038,4,4,1, 27042
8,27041,1,1,1, 27042
14,27044,3,3,1, 27047
24,27054,1,1,0, 27055
23,27053,3,3,1, 27056
21,27052,5,5,1, 27057
5,27057,3,3,1, 27060
30,27058,3,3,1, 27061
31,27061,2,2,1, 27063
7,27062,1,1,0, 27063
8,27066,1,1,0, 27067
24,27079,1,1,1, 27080
23,27078,3,3,1, 27081
21,27077,5,5,1, 27082
5,27082,3,3,1, 27085
30,27083,3,3,1, 27086
7,27087,1,1,1, 27088
8,27091,1,1,0, 27092
16,27094,2,2,1, 27096
13,27094,4,4,1, 27098
22,27101,4,4,1, 27105
24,27104,1,1,1, 27105
23,27103,3,3,1, 27106
21,27102,5,5,1, 27107
6,27110,2,2,1, 27112
7,27112,1,1,1, 27113
29,27113,4,4,1, 27117
8,27116,1,1,1, 27117
13,27119,4,4,1, 27123
24,27129,1,1,1, 27130
23,27128,3,3,1, 27131
1,27131,1,1,0, 27132
30,27133,3,3,1, 27136
6,27135,2,2,1, 27137
31,27136,2,2,1, 27138
7,27137,1,1,0, 27138
29,27138,4,4,1, 27142
8,27141,1,1,1, 27142
9,27142,2,2,1, 27144
16,27144,2,2,1, 27146
13,27144,4,4,1, 27148
15,27146,2,2,1, 27148
24,27154,1,1,0, 27155
23,27153,3,3,1, 27156
21,27152,5,5,1, 27157
1,27156,1,1,0, 27157
30,27158,3,3,1, 27161
7,27162,1,1,1, 27163
17,27169,3,3,1, 27172
18,27173,4,4,1, 27177
24,27179,1,1,0, 27180
1,27181,1,1,0, 27182
5,27182,3,3,1, 27185
30,27183,3,3,1, 27186
6,27185,2,2,1, 27187
25,27185,2,2,1, 27187
7,27187,1,1,0, 27188
9,27192,2,2,1, 27194
17,27194,3,3,1, 27197
24,27204,1,1,0, 27205
1,27206,1,1,0, 27207
30,27208,3,3,1, 27211
6,27210,2,2,1, 27212
31,27211,2,2,1, 27213
7,27212,1,1,0, 27213
26,27212,3,3,1, 27215
29,27213,4,4,1, 27217
17,27219,3,3,1, 27222
12,27220,5,5,1, 27225
20,27223,6,6,1, 27229
2,27228,2,2,1, 27230
24,27229,1,1,1, 27230
1,27231,1,1,0, 27232
5,27232,3,3,1, 27235
27,27232,4,4,1, 27236
30,27233,3,3,1, 27236
25,27235,2,2,1, 27237
7,27237,1,1,0, 27238
26,27237,3,3,1, 27240
29,27238,4,4,1, 27242
9,27242,2,2,1, 27244
17,27244,3,3,1, 27247
12,27245,5,5,1, 27250
20,27248,6,6,1, 27254
24,27254,1,1,1, 27255
1,27256,1,1,1, 27257
27,27257,4,4,1, 27261
31,27261,2,2,1, 27263
7,27262,1,1,1, 27263
8,27266,1,1,1, 27267
11,27264,4,4,1, 27268
9,27267,2,2,1, 27269
16,27269,2,2,1, 27271
14,27269,3,3,1, 27272
17,27269,3,3,1, 27272
13,27269,4,4,1, 27273
15,27271,2,2,1, 27273
20,27273,6,6,1, 27279
2,27278,2,2,1, 27280
24,27279,1,1,1, 27280
21,27277,5,5,1, 27282
1,27281,1,1,1, 27282
4,27281,4,4,1, 27285
5,27282,3,3,1, 27285
27,27282,4,4,1, 27286
30,27283,3,3,1, 27286
7,27287,1,1,0, 27288
8,27291,1,1,1, 27292
9,27292,2,2,1, 27294
16,27294,2,2,1, 27296
14,27294,3,3,1, 27297
17,27294,3,3,1, 27297
15,27296,2,2,1, 27298
22,27301,4,4,1, 27305
24,27304,1,1,0, 27305
21,27302,5,5,1, 27307
5,27307,3,3,1, 27310
30,27308,3,3,1, 27311
6,27310,2,2,1, 27312
31,27311,2,2,1, 27313
7,27312,1,1,0, 27313
29,27313,4,4,1, 27317
8,27316,1,1,1, 27317
16,27319,2,2,1, 27321
14,27319,3,3,1, 27322
13,27319,4,4,1, 27323
24,27329,1,1,0, 27330
23,27328,3,3,1, 27331
30,27333,3,3,1, 27336
7,27337,1,1,0, 27338
8,27341,1,1,1, 27342
16,27344,2,2,1, 27346
14,27344,3,3,1, 27347
15,27346,2,2,1, 27348
24,27354,1,1,0, 27355
21,27352,5,5,1, 27357
5,27357,3,3,1, 27360
6,27360,2,2,1, 27362
7,27362,1,1,1, 27363
29,27363,4,4,1, 27367
8,27366,1,1,0, 27367
16,27369,2,2,1, 27371
15,27371,2,2,1, 27373
22,27376,4,4,1, 27380
24,27379,1,1,0, 27380
21,27377,5,5,1, 27382
5,27382,3,3,1, 27385
6,27385,2,2,1, 27387
7,27387,1,1,0, 27388
8,27391,1,1,0, 27392
16,27394,2,2,1, 27396
14,27394,3,3,1, 27397
13,27394,4,4,1, 27398
24,27404,1,1,0, 27405
1,27406,1,1,0, 27407
25,27410,2,2,1, 27412
7,27412,1,1,0, 27413
29,27413,4,4,1, 27417
17,27419,3,3,1, 27422
24,27429,1,1,0, 27430
1,27431,1,1,0, 27432
5,27432,3,3,1, 27435
30,27433,3,3,1, 27436
25,27435,2,2,1, 27437
31,27436,2,2,1, 27438
7,27437,1,1,1, 27438
24,27454,1,1,0, 27455
1,27456,1,1,0, 27457
6,27460,2,2,1, 27462
25,27460,2,2,1, 27462
7,27462,1,1,0, 27463
9,27467,2,2,1, 27469
24,27479,1,1,0, 27480
1,27481,1,1,1, 27482
30,27483,3,3,1, 27486
6,27485,2,2,1, 27487
7,27487,1,1,0, 27488
17,27494,3,3,1, 27497
24,27504,1,1,0, 27505
1,27506,1,1,1, 27507
5,27507,3,3,1, 27510
30,27508,3,3,1, 27511
6,27510,2,2,1, 27512
25,27510,2,2,1, 27512
31,27511,2,2,1, 27513
7,27512,1,1,0, 27513
29,27513,4,4,1, 27517
8,27516,1,1,1, 27517
17,27519,3,3,1, 27522
15,27521,2,2,1, 27523
24,27529,1,1,1, 27530
23,27528,3,3,1, 27531
1,27531,1,1,0, 27532
5,27532,3,3,1, 27535
30,27533,3,3,1, 27536
6,27535,2,2,1, 27537
31,27536,2,2,1, 27538
28,27534,5,5,1, 27539
26,27537,3,3,1, 27540
8,27541,1,1,0, 27542
11,27539,4,4,1, 27543
9,27542,2,2,1, 27544
16,27544,2,2,1, 27546
14,27544,3,3,1, 27547
12,27545,5,5,1, 27550
18,27548,4,4,1, 27552
20,27548,6,6,1, 27554
2,27553,2,2,1, 27555
24,27554,1,1,1, 27555
19,27551,5,5,1, 27556
23,27553,3,3,1, 27556
21,27552,5,5,1, 27557
1,27556,1,1,0, 27557
8,27566,1,1,1, 27567
11,27564,4,4,1, 27568
16,27569,2,2,1, 27571
14,27569,3,3,1, 27572
17,27569,3,3,1, 27572
13,27569,4,4,1, 27573
15,27571,2,2,1, 27573
18,27573,4,4,1, 27577
22,27576,4,4,1, 27580
24,27579,1,1,1, 27580
19,27576,5,5,1, 27581
21,27577,5,5,1, 27582
1,27581,1,1,1, 27582
4,27581,4,4,1, 27585
26,27587,3,3,1, 27590
8,27591,1,1,0, 27592
11,27589,4,4,1, 27593
16,27594,2,2,1, 27596
17,27594,3,3,1, 27597
13,27594,4,4,1, 27598
22,27601,4,4,1, 27605
2,27603,2,2,1, 27605
24,27604,1,1,1, 27605
19,27601,5,5,1, 27606
23,27603,3,3,1, 27606
1,27606,1,1,1, 27607
4,27606,4,4,1, 27610
3,27607,3,3,1, 27610
8,27616,1,1,1, 27617
14,27619,3,3,1, 27622
13,27619,4,4,1, 27623
15,27621,2,2,1, 27623
24,27629,1,1,0, 27630
21,27627,5,5,1, 27632
8,27641,1,1,1, 27642
16,27644,2,2,1, 27646
14,27644,3,3,1, 27647
22,27651,4,4,1, 27655
24,27654,1,1,0, 27655
7,27662,1,1,0, 27663
8,27666,1,1,0, 27667
16,27669,2,2,1, 27671
14,27669,3,3,1, 27672
13,27669,4,4,1, 27673
15,27671,2,2,1, 27673
24,27679,1,1,0, 27680
31,27686,2,2,1, 27688
7,27687,1,1,0, 27688
8,27691,1,1,0, 27692
16,27694,2,2,1, 27696
14,27694,3,3,1, 27697
24,27704,1,1,1, 27705
23,27703,3,3,1, 27706
21,27702,5,5,1, 27707
5,27707,3,3,1, 27710
6,27710,2,2,1, 27712
7,27712,1,1,1, 27713
8,27716,1,1,0, 27717
16,27719,2,2,1, 27721
14,27719,3,3,1, 27722
17,27719,3,3,1, 27722
24,27729,1,1,1, 27730
1,27731,1,1,1, 27732
30,27733,3,3,1, 27736
6,27735,2,2,1, 27737
25,27735,2,2,1, 27737
31,27736,2,2,1, 27738
7,27737,1,1,0, 27738
29,27738,4,4,1, 27742
17,27744,3,3,1, 27747
18,27748,4,4,1, 27752
24,27754,1,1,0, 27755
1,27756,1,1,0, 27757
5,27757,3,3,1, 27760
6,27760,2,2,1, 27762
25,27760,2,2,1, 27762
31,27761,2,2,1, 27763
7,27762,1,1,0, 27763
26,27762,3,3,1, 27765
11,27764,4,4,1, 27768
9,27767,2,2,1, 27769
17,27769,3,3,1, 27772
18,27773,4,4,1, 27777
2,27778,2,2,1, 27780
24,27779,1,1,1, 27780
19,27776,5,5,1, 27781
1,27781,1,1,1, 27782
4,27781,4,4,1, 27785
5,27782,3,3,1, 27785
27,27782,4,4,1, 27786
7,27787,1,1,0, 27788
28,27784,5,5,1, 27789
29,27788,4,4,1, 27792
9,27792,2,2,1, 27794
18,27798,4,4,1, 27802
20,27798,6,6,1, 27804
2,27803,2,2,1, 27805
24,27804,1,1,0, 27805
19,27801,5,5,1, 27806
1,27806,1,1,1, 27807
27,27807,4,4,1, 27811
25,27810,2,2,1, 27812
31,27811,2,2,1, 27813
7,27812,1,1,1, 27813
29,27813,4,4,1, 27817
22,27826,4,4,1, 27830
24,27829,1,1,0, 27830
21,27827,5,5,1, 27832
6,27835,2,2,1, 27837
31,27836,2,2,1, 27838
7,27837,1,1,1, 27838
8,27841,1,1,0, 27842
16,27844,2,2,1, 27846
14,27844,3,3,1, 27847
13,27844,4,4,1, 27848
24,27854,1,1,0, 27855
23,27853,3,3,1, 27856
5,27857,3,3,1, 27860
30,27858,3,3,1, 27861
6,27860,2,2,1, 27862
7,27862,1,1,1, 27863
29,27863,4,4,1, 27867
8,27866,1,1,0, 27867
16,27869,2,2,1, 27871
13,27869,4,4,1, 27873
24,27879,1,1,1, 27880
30,27883,3,3,1, 27886
7,27887,1,1,1, 27888
8,27891,1,1,0, 27892
16,27894,2,2,1, 27896
14,27894,3,3,1, 27897
15,27896,2,2,1, 27898
22,27901,4,4,1, 27905
24,27904,1,1,0, 27905
21,27902,5,5,1, 27907
5,27907,3,3,1, 27910
7,27912,1,1,1, 27913
29,27913,4,4,1, 27917
8,27916,1,1,1, 27917
14,27919,3,3,1, 27922
24,27929,1,1,1, 27930
21,27927,5,5,1, 27932
1,27931,1,1,1, 27932
5,27932,3,3,1, 27935
31,27936,2,2,1, 27938
7,27937,1,1,1, 27938
29,27938,4,4,1, 27942
8,27941,1,1,0, 27942
16,27944,2,2,1, 27946
14,27944,3,3,1, 27947
17,27944,3,3,1, 27947
15,27946,2,2,1, 27948
22,27951,4,4,1, 27955
24,27954,1,1,0, 27955
23,27953,3,3,1, 27956
21,27952,5,5,1, 27957
1,27956,1,1,0, 27957
5,27957,3,3,1, 27960
6,27960,2,2,1, 27962
7,27962,1,1,1, 27963
8,27966,1,1,1, 27967
9,27967,2,2,1, 27969
14,27969,3,3,1, 27972
17,27969,3,3,1, 27972
13,27969,4,4,1, 27973
24,27979,1,1,0, 27980
21,27977,5,5,1, 27982
1,27981,1,1,0, 27982
30,27983,3,3,1, 27986
25,27985,2,2,1, 27987
7,27987,1,1,1, 27988
8,27991,1,1,0, 27992
9,27992,2,2,1, 27994
17,27994,3,3,1, 27997
13,27994,4,4,1, 27998
22,28001,4,4,1, 28005
24,28004,1,1,0, 28005
21,28002,5,5,1, 28007
1,28006,1,1,0, 28007
4,28006,4,4,1, 28010
27,28007,4,4,1, 28011
6,28010,2,2,1, 28012
7,28012,1,1,1, 28013
8,28016,1,1,1, 28017
11,28014,4,4,1, 28018
9,28017,2,2,1, 28019
16,28019,2,2,1, 28021
20,28023,6,6,1, 28029
24,28029,1,1,0, 28030
1,28031,1,1,1, 28032
4,28031,4,4,1, 28035
3,28032,3,3,1, 28035
30,28033,3,3,1, 28036
6,28035,2,2,1, 28037
25,28035,2,2,1, 28037
7,28037,1,1,0, 28038
9,28042,2,2,1, 28044
17,28044,3,3,1, 28047
2,28053,2,2,1, 28055
24,28054,1,1,1, 28055
19,28051,5,5,1, 28056
1,28056,1,1,0, 28057
4,28056,4,4,1, 28060
6,28060,2,2,1, 28062
7,28062,1,1,0, 28063
26,28062,3,3,1, 28065
29,28063,4,4,1, 28067
17,28069,3,3,1, 28072
18,28073,4,4,1, 28077
20,28073,6,6,1, 28079
24,28079,1,1,1, 28080
19,28076,5,5,1, 28081
1,28081,1,1,0, 28082
4,28081,4,4,1, 28085
5,28082,3,3,1, 28085
27,28082,4,4,1, 28086
30,28083,3,3,1, 28086
6,28085,2,2,1, 28087
25,28085,2,2,1, 28087
7,28087,1,1,1, 28088
28,28084,5,5,1, 28089
29,28088,4,4,1, 28092
24,28104,1,1,0, 28105
5,28107,3,3,1, 28110
30,28108,3,3,1, 28111
7,28112,1,1,0, 28113
24,28129,1,1,1, 28130
5,28132,3,3,1, 28135
7,28137,1,1,0, 28138
8,28141,1,1,1, 28142
22,28151,4,4,1, 28155
24,28154,1,1,1, 28155
23,28153,3,3,1, 28156
30,28158,3,3,1, 28161
6,28160,2,2,1, 28162
31,28161,2,2,1, 28163
7,28162,1,1,0, 28163
8,28166,1,1,1, 28167
22,28176,4,4,1, 28180
24,28179,1,1,1, 28180
23,28178,3,3,1, 28181
21,28177,5,5,1, 28182
6,28185,2,2,1, 28187
31,28186,2,2,1, 28188
7,28187,1,1,0, 28188
8,28191,1,1,0, 28192
17,28194,3,3,1, 28197
13,28194,4,4,1, 28198
15,28196,2,2,1, 28198
22,28201,4,4,1, 28205
24,28204,1,1,0, 28205
21,28202,5,5,1, 28207
1,28206,1,1,1, 28207
5,28207,3,3,1, 28210
25,28210,2,2,1, 28212
7,28212,1,1,0, 28213
8,28216,1,1,0, 28217
16,28219,2,2,1, 28221
13,28219,4,4,1, 28223
18,28223,4,4,1, 28227
22,28226,4,4,1, 28230
2,28228,2,2,1, 28230
24,28229,1,1,0, 28230
23,28228,3,3,1, 28231
21,28227,5,5,1, 28232
1,28231,1,1,0, 28232
5,28232,3,3,1, 28235
6,28235,2,2,1, 28237
25,28235,2,2,1, 28237
31,28236,2,2,1, 28238
7,28237,1,1,0, 28238
29,28238,4,4,1, 28242
8,28241,1,1,0, 28242
17,28244,3,3,1, 28247
13,28244,4,4,1, 28248
12,28245,5,5,1, 28250
22,28251,4,4,1, 28255
24,28254,1,1,1, 28255
19,28251,5,5,1, 28256
23,28253,3,3,1, 28256
21,28252,5,5,1, 28257
1,28256,1,1,1, 28257
27,28257,4,4,1, 28261
25,28260,2,2,1, 28262
31,28261,2,2,1, 28263
7,28262,1,1,1, 28263
26,28262,3,3,1, 28265
29,28263,4,4,1, 28267
8,28266,1,1,1, 28267
14,28269,3,3,1, 28272
20,28273,6,6,1, 28279
22,28276,4,4,1, 28280
24,28279,1,1,0, 28280
1,28281,1,1,0, 28282
4,28281,4,4,1, 28285
3,28282,3,3,1, 28285
5,28282,3,3,1, 28285
30,28283,3,3,1, 28286
25,28285,2,2,1, 28287
7,28287,1,1,1, 28288
26,28287,3,3,1, 28290
29,28288,4,4,1, 28292
8,28291,1,1,1, 28292
11,28289,4,4,1, 28293
9,28292,2,2,1, 28294
16,28294,2,2,1, 28296
14,28294,3,3,1, 28297
17,28294,3,3,1, 28297
13,28294,4,4,1, 28298
12,28295,5,5,1, 28300
18,28298,4,4,1, 28302
20,28298,6,6,1, 28304
2,28303,2,2,1, 28305
24,28304,1,1,1, 28305
21,28302,5,5,1, 28307
6,28310,2,2,1, 28312
7,28312,1,1,1, 28313
29,28313,4,4,1, 28317
8,28316,1,1,1, 28317
14,28319,3,3,1, 28322
24,28329,1,1,1, 28330
5,28332,3,3,1, 28335
31,28336,2,2,1, 28338
7,28337,1,1,1, 28338
8,28341,1,1,0, 28342
16,28344,2,2,1, 28346
14,28344,3,3,1, 28347
15,28346,2,2,1, 28348
22,28351,4,4,1, 28355
24,28354,1,1,0, 28355
5,28357,3,3,1, 28360
6,28360,2,2,1, 28362
31,28361,2,2,1, 28363
7,28362,1,1,1, 28363
29,28363,4,4,1, 28367
8,28366,1,1,0, 28367
16,28369,2,2,1, 28371
15,28371,2,2,1, 28373
22,28376,4,4,1, 28380
24,28379,1,1,1, 28380
30,28383,3,3,1, 28386
7,28387,1,1,1, 28388
29,28388,4,4,1, 28392
8,28391,1,1,1, 28392
16,28394,2,2,1, 28396
13,28394,4,4,1, 28398
15,28396,2,2,1, 28398
24,28404,1,1,0, 28405
7,28412,1,1,0, 28413
29,28413,4,4,1, 28417
9,28417,2,2,1, 28419
24,28429,1,1,0, 28430
1,28431,1,1,0, 28432
30,28433,3,3,1, 28436
25,28435,2,2,1, 28437
31,28436,2,2,1, 28438
7,28437,1,1,1, 28438
24,28454,1,1,0, 28455
1,28456,1,1,0, 28457
5,28457,3,3,1, 28460
25,28460,2,2,1, 28462
7,28462,1,1,0, 28463
29,28463,4,4,1, 28467
24,28479,1,1,1, 28480
1,28481,1,1,0, 28482
30,28483,3,3,1, 28486
6,28485,2,2,1, 28487
31,28486,2,2,1, 28488
7,28487,1,1,1, 28488
29,28488,4,4,1, 28492
17,28494,3,3,1, 28497
22,28501,4,4,1, 28505
24,28504,1,1,1, 28505
23,28503,3,3,1, 28506
1,28506,1,1,1, 28507
5,28507,3,3,1, 28510
30,28508,3,3,1, 28511
7,28512,1,1,0, 28513
8,28516,1,1,0, 28517
17,28519,3,3,1, 28522
18,28523,4,4,1, 28527
22,28526,4,4,1, 28530
2,28528,2,2,1, 28530
24,28529,1,1,1, 28530
23,28528,3,3,1, 28531
21,28527,5,5,1, 28532
1,28531,1,1,1, 28532
30,28533,3,3,1, 28536
7,28537,1,1,1, 28538
26,28537,3,3,1, 28540
8,28541,1,1,0, 28542
11,28539,4,4,1, 28543
9,28542,2,2,1, 28544
14,28544,3,3,1, 28547
13,28544,4,4,1, 28548
15,28546,2,2,1, 28548
22,28551,4,4,1, 28555
2,28553,2,2,1, 28555
24,28554,1,1,1, 28555
19,28551,5,5,1, 28556
21,28552,5,5,1, 28557
1,28556,1,1,1, 28557
5,28557,3,3,1, 28560
30,28558,3,3,1, 28561
6,28560,2,2,1, 28562
31,28561,2,2,1, 28563
7,28562,1,1,0, 28563
28,28559,5,5,1, 28564
26,28562,3,3,1, 28565
29,28563,4,4,1, 28567
8,28566,1,1,0, 28567
9,28567,2,2,1, 28569
14,28569,3,3,1, 28572
17,28569,3,3,1, 28572
15,28571,2,2,1, 28573
18,28573,4,4,1, 28577
20,28573,6,6,1, 28579
22,28576,4,4,1, 28580
24,28579,1,1,0, 28580
21,28577,5,5,1, 28582
1,28581,1,1,0, 28582
4,28581,4,4,1, 28585
5,28582,3,3,1, 28585
6,28585,2,2,1, 28587
31,28586,2,2,1, 28588
7,28587,1,1,1, 28588
29,28588,4,4,1, 28592
8,28591,1,1,0, 28592
17,28594,3,3,1, 28597
12,28595,5,5,1, 28600
22,28601,4,4,1, 28605
2,28603,2,2,1, 28605
24,28604,1,1,0, 28605
23,28603,3,3,1, 28606
21,28602,5,5,1, 28607
1,28606,1,1,0, 28607
3,28607,3,3,1, 28610
30,28608,3,3,1, 28611
6,28610,2,2,1, 28612
7,28612,1,1,1, 28613
26,28612,3,3,1, 28615
29,28613,4,4,1, 28617
8,28616,1,1,1, 28617
11,28614,4,4,1, 28618
16,28619,2,2,1, 28621
14,28619,3,3,1, 28622
13,28619,4,4,1, 28623
15,28621,2,2,1, 28623
24,28629,1,1,1, 28630
19,28626,5,5,1, 28631
23,28628,3,3,1, 28631
1,28631,1,1,0, 28632
27,28632,4,4,1, 28636
6,28635,2,2,1, 28637
25,28635,2,2,1, 28637
31,28636,2,2,1, 28638
7,28637,1,1,1, 28638
28,28634,5,5,1, 28639
26,28637,3,3,1, 28640
29,28638,4,4,1, 28642
8,28641,1,1,0, 28642
11,28639,4,4,1, 28643
16,28644,2,2,1, 28646
14,28644,3,3,1, 28647
13,28644,4,4,1, 28648
12,28645,5,5,1, 28650
18,28648,4,4,1, 28652
24,28654,1,1,1, 28655
19,28651,5,5,1, 28656
21,28652,5,5,1, 28657
1,28656,1,1,0, 28657
3,28657,3,3,1, 28660
6,28660,2,2,1, 28662
7,28662,1,1,1, 28663
29,28663,4,4,1, 28667
8,28666,1,1,1, 28667
14,28669,3,3,1, 28672
24,28679,1,1,1, 28680
21,28677,5,5,1, 28682
5,28682,3,3,1, 28685
6,28685,2,2,1, 28687
7,28687,1,1,1, 28688
29,28688,4,4,1, 28692
8,28691,1,1,0, 28692
13,28694,4,4,1, 28698
22,28701,4,4,1, 28705
24,28704,1,1,1, 28705
23,28703,3,3,1, 28706
8,28716,1,1,1, 28717
22,28726,4,4,1, 28730
24,28729,1,1,0, 28730
8,28741,1,1,0, 28742
14,28744,3,3,1, 28747
24,28754,1,1,1, 28755
23,28753,3,3,1, 28756
8,28766,1,1,1, 28767
9,28767,2,2,1, 28769
16,28769,2,2,1, 28771
14,28769,3,3,1, 28772
13,28769,4,4,1, 28773
24,28779,1,1,1, 28780
1,28781,1,1,0, 28782
25,28785,2,2,1, 28787
9,28792,2,2,1, 28794
17,28794,3,3,1, 28797
12,28795,5,5,1, 28800
2,28803,2,2,1, 28805
24,28804,1,1,1, 28805
1,28806,1,1,1, 28807
6,28810,2,2,1, 28812
25,28810,2,2,1, 28812
7,28812,1,1,0, 28813
26,28812,3,3,1, 28815
17,28819,3,3,1, 28822
2,28828,2,2,1, 28830
24,28829,1,1,1, 28830
1,28831,1,1,1, 28832
5,28832,3,3,1, 28835
30,28833,3,3,1, 28836
25,28835,2,2,1, 28837
31,28836,2,2,1, 28838
7,28837,1,1,1, 28838
26,28837,3,3,1, 28840
9,28842,2,2,1, 28844
24,28854,1,1,0, 28855
1,28856,1,1,1, 28857
5,28857,3,3,1, 28860
6,28860,2,2,1, 28862
25,28860,2,2,1, 28862
31,28861,2,2,1, 28863
7,28862,1,1,1, 28863
26,28862,3,3,1, 28865
29,28863,4,4,1, 28867
9,28867,2,2,1, 28869
18,28873,4,4,1, 28877
22,28876,4,4,1, 28880
24,28879,1,1,1, 28880
23,28878,3,3,1, 28881
21,28877,5,5,1, 28882
1,28881,1,1,1, 28882
7,28887,1,1,0, 28888
29,28888,4,4,1, 28892
8,28891,1,1,0, 28892
17,28894,3,3,1, 28897
13,28894,4,4,1, 28898
15,28896,2,2,1, 28898
22,28901,4,4,1, 28905
2,28903,2,2,1, 28905
24,28904,1,1,0, 28905
23,28903,3,3,1, 28906
21,28902,5,5,1, 28907
1,28906,1,1,1, 28907
5,28907,3,3,1, 28910
27,28907,4,4,1, 28911
30,28908,3,3,1, 28911
25,28910,2,2,1, 28912
31,28911,2,2,1, 28913
7,28912,1,1,0, 28913
8,28916,1,1,0, 28917
16,28919,2,2,1, 28921
14,28919,3,3,1, 28922
17,28919,3,3,1, 28922
12,28920,5,5,1, 28925
18,28923,4,4,1, 28927
22,28926,4,4,1, 28930
24,28929,1,1,1, 28930
23,28928,3,3,1, 28931
21,28927,5,5,1, 28932
1,28931,1,1,0, 28932
4,28931,4,4,1, 28935
5,28932,3,3,1, 28935
30,28933,3,3,1, 28936
6,28935,2,2,1, 28937
25,28935,2,2,1, 28937
31,28936,2,2,1, 28938
7,28937,1,1,0, 28938
28,28934,5,5,1, 28939
29,28938,4,4,1, 28942
8,28941,1,1,0, 28942
11,28939,4,4,1, 28943
16,28944,2,2,1, 28946
22,28951,4,4,1, 28955
24,28954,1,1,0, 28955
23,28953,3,3,1, 28956
5,28957,3,3,1, 28960
6,28960,2,2,1, 28962
31,28961,2,2,1, 28963
7,28962,1,1,1, 28963
8,28966,1,1,0, 28967
16,28969,2,2,1, 28971
13,28969,4,4,1, 28973
15,28971,2,2,1, 28973
24,28979,1,1,0, 28980
21,28977,5,5,1, 28982
5,28982,3,3,1, 28985
6,28985,2,2,1, 28987
31,28986,2,2,1, 28988
7,28987,1,1,0, 28988
29,28988,4,4,1, 28992
8,28991,1,1,0, 28992
14,28994,3,3,1, 28997
13,28994,4,4,1, 28998
22,29001,4,4,1, 29005
24,29004,1,1,1, 29005
23,29003,3,3,1, 29006
21,29002,5,5,1, 29007
5,29007,3,3,1, 29010
30,29008,3,3,1, 29011
6,29010,2,2,1, 29012
7,29012,1,1,0, 29013
29,29013,4,4,1, 29017
24,29029,1,1,1, 29030
31,29036,2,2,1, 29038
7,29037,1,1,1, 29038
24,29054,1,1,1, 29055
1,29056,1,1,0, 29057
5,29057,3,3,1, 29060
6,29060,2,2,1, 29062
25,29060,2,2,1, 29062
31,29061,2,2,1, 29063
7,29062,1,1,0, 29063
9,29067,2,2,1, 29069
17,29069,3,3,1, 29072
24,29079,1,1,0, 29080
1,29081,1,1,1, 29082
30,29083,3,3,1, 29086
6,29085,2,2,1, 29087
25,29085,2,2,1, 29087
31,29086,2,2,1, 29088
7,29087,1,1,0, 29088
9,29092,2,2,1, 29094
24,29104,1,1,1, 29105
1,29106,1,1,1, 29107
5,29107,3,3,1, 29110
30,29108,3,3,1, 29111
25,29110,2,2,1, 29112
31,29111,2,2,1, 29113
7,29112,1,1,0, 29113
29,29113,4,4,1, 29117
8,29116,1,1,1, 29117
16,29119,2,2,1, 29121
14,29119,3,3,1, 29122
22,29126,4,4,1, 29130
24,29129,1,1,1, 29130
23,29128,3,3,1, 29131
21,29127,5,5,1, 29132
1,29131,1,1,1, 29132
25,29135,2,2,1, 29137
8,29141,1,1,0, 29142
9,29142,2,2,1, 29144
16,29144,2,2,1, 29146
17,29144,3,3,1, 29147
15,29146,2,2,1, 29148
24,29154,1,1,1, 29155
23,29153,3,3,1, 29156
21,29152,5,5,1, 29157
1,29156,1,1,0, 29157
25,29160,2,2,1, 29162
26,29162,3,3,1, 29165
8,29166,1,1,0, 29167
16,29169,2,2,1, 29171
17,29169,3,3,1, 29172
15,29171,2,2,1, 29173
24,29179,1,1,0, 29180
23,29178,3,3,1, 29181
1,29181,1,1,1, 29182
26,29187,3,3,1, 29190
8,29191,1,1,0, 29192
17,29194,3,3,1, 29197
15,29196,2,2,1, 29198
18,29198,4,4,1, 29202
24,29204,1,1,0, 29205
21,29202,5,5,1, 29207
1,29206,1,1,1, 29207
25,29210,2,2,1, 29212
28,29209,5,5,1, 29214
26,29212,3,3,1, 29215
8,29216,1,1,0, 29217
11,29214,4,4,1, 29218
9,29217,2,2,1, 29219
16,29219,2,2,1, 29221
13,29219,4,4,1, 29223
12,29220,5,5,1, 29225
20,29223,6,6,1, 29229
2,29228,2,2,1, 29230
24,29229,1,1,1, 29230
19,29226,5,5,1, 29231
23,29228,3,3,1, 29231
1,29231,1,1,1, 29232
4,29231,4,4,1, 29235
30,29233,3,3,1, 29236
6,29235,2,2,1, 29237
31,29236,2,2,1, 29238
7,29237,1,1,0, 29238
28,29234,5,5,1, 29239
8,29241,1,1,0, 29242
11,29239,4,4,1, 29243
9,29242,2,2,1, 29244
16,29244,2,2,1, 29246
14,29244,3,3,1, 29247
15,29246,2,2,1, 29248
12,29245,5,5,1, 29250
22,29251,4,4,1, 29255
2,29253,2,2,1, 29255
24,29254,1,1,1, 29255
21,29252,5,5,1, 29257
1,29256,1,1,1, 29257
4,29256,4,4,1, 29260
3,29257,3,3,1, 29260
5,29257,3,3,1, 29260
7,29262,1,1,1, 29263
29,29263,4,4,1, 29267
8,29266,1,1,1, 29267
16,29269,2,2,1, 29271
13,29269,4,4,1, 29273
24,29279,1,1,0, 29280
21,29277,5,5,1, 29282
6,29285,2,2,1, 29287
31,29286,2,2,1, 29288
7,29287,1,1,1, 29288
8,29291,1,1,0, 29292
24,29304,1,1,1, 29305
23,29303,3,3,1, 29306
6,29310,2,2,1, 29312
7,29312,1,1,1, 29313
8,29316,1,1,0, 29317
14,29319,3,3,1, 29322
15,29321,2,2,1, 29323
24,29329,1,1,0, 29330
23,29328,3,3,1, 29331
31,29336,2,2,1, 29338
7,29337,1,1,1, 29338
8,29341,1,1,0, 29342
14,29344,3,3,1, 29347
13,29344,4,4,1, 29348
15,29346,2,2,1, 29348
24,29354,1,1,0, 29355
7,29362,1,1,1, 29363
24,29379,1,1,0, 29380
1,29381,1,1,0, 29382
6,29385,2,2,1, 29387
25,29385,2,2,1, 29387
7,29387,1,1,1, 29388
9,29392,2,2,1, 29394
24,29404,1,1,0, 29405
1,29406,1,1,0, 29407
5,29407,3,3,1, 29410
31,29411,2,2,1, 29413
7,29412,1,1,0, 29413
26,29412,3,3,1, 29415
29,29413,4,4,1, 29417
18,29423,4,4,1, 29427
2,29428,2,2,1, 29430
24,29429,1,1,0, 29430
1,29431,1,1,0, 29432
5,29432,3,3,1, 29435
6,29435,2,2,1, 29437
31,29436,2,2,1, 29438
7,29437,1,1,0, 29438
26,29437,3,3,1, 29440
29,29438,4,4,1, 29442
9,29442,2,2,1, 29444
18,29448,4,4,1, 29452
24,29454,1,1,0, 29455
19,29451,5,5,1, 29456
1,29456,1,1,1, 29457
3,29457,3,3,1, 29460
5,29457,3,3,1, 29460
27,29457,4,4,1, 29461
30,29458,3,3,1, 29461
31,29461,2,2,1, 29463
7,29462,1,1,1, 29463
28,29459,5,5,1, 29464
8,29466,1,1,1, 29467
9,29467,2,2,1, 29469
14,29469,3,3,1, 29472
13,29469,4,4,1, 29473
15,29471,2,2,1, 29473
12,29470,5,5,1, 29475
18,29473,4,4,1, 29477
22,29476,4,4,1, 29480
24,29479,1,1,0, 29480
23,29478,3,3,1, 29481
1,29481,1,1,0, 29482
3,29482,3,3,1, 29485
30,29483,3,3,1, 29486
6,29485,2,2,1, 29487
7,29487,1,1,1, 29488
29,29488,4,4,1, 29492
8,29491,1,1,0, 29492
14,29494,3,3,1, 29497
17,29494,3,3,1, 29497
12,29495,5,5,1, 29500
22,29501,4,4,1, 29505
2,29503,2,2,1, 29505
24,29504,1,1,0, 29505
23,29503,3,3,1, 29506
1,29506,1,1,0, 29507
5,29507,3,3,1, 29510
27,29507,4,4,1, 29511
25,29510,2,2,1, 29512
7,29512,1,1,0, 29513
28,29509,5,5,1, 29514
26,29512,3,3,1, 29515
8,29516,1,1,0, 29517
11,29514,4,4,1, 29518
16,29519,2,2,1, 29521
13,29519,4,4,1, 29523
15,29521,2,2,1, 29523
12,29520,5,5,1, 29525
18,29523,4,4,1, 29527
22,29526,4,4,1, 29530
24,29529,1,1,0, 29530
19,29526,5,5,1, 29531
23,29528,3,3,1, 29531
5,29532,3,3,1, 29535
30,29533,3,3,1, 29536
7,29537,1,1,1, 29538
8,29541,1,1,1, 29542
13,29544,4,4,1, 29548
15,29546,2,2,1, 29548
22,29551,4,4,1, 29555
24,29554,1,1,0, 29555
30,29558,3,3,1, 29561
31,29561,2,2,1, 29563
7,29562,1,1,1, 29563
8,29566,1,1,1, 29567
16,29569,2,2,1, 29571
22,29576,4,4,1, 29580
24,29579,1,1,0, 29580
23,29578,3,3,1, 29581
30,29583,3,3,1, 29586
6,29585,2,2,1, 29587
7,29587,1,1,0, 29588
29,29588,4,4,1, 29592
8,29591,1,1,0, 29592
14,29594,3,3,1, 29597
13,29594,4,4,1, 29598
22,29601,4,4,1, 29605
24,29604,1,1,1, 29605
23,29603,3,3,1, 29606
30,29608,3,3,1, 29611
6,29610,2,2,1, 29612
7,29612,1,1,1, 29613
8,29616,1,1,1, 29617
16,29619,2,2,1, 29621
24,29629,1,1,1, 29630
5,29632,3,3,1, 29635
30,29633,3,3,1, 29636
6,29635,2,2,1, 29637
7,29637,1,1,0, 29638
29,29638,4,4,1, 29642
8,29641,1,1,0, 29642
9,29642,2,2,1, 29644
16,29644,2,2,1, 29646
13,29644,4,4,1, 29648
24,29654,1,1,1, 29655
1,29656,1,1,0, 29657
30,29658,3,3,1, 29661
31,29661,2,2,1, 29663
7,29662,1,1,1, 29663
8,29666,1,1,1, 29667
9,29667,2,2,1, 29669
16,29669,2,2,1, 29671
15,29671,2,2,1, 29673
22,29676,4,4,1, 29680
24,29679,1,1,1, 29680
21,29677,5,5,1, 29682
1,29681,1,1,1, 29682
4,29681,4,4,1, 29685
5,29682,3,3,1, 29685
6,29685,2,2,1, 29687
25,29685,2,2,1, 29687
31,29686,2,2,1, 29688
7,29687,1,1,1, 29688
8,29691,1,1,1, 29692
9,29692,2,2,1, 29694
16,29694,2,2,1, 29696
15,29696,2,2,1, 29698
20,29698,6,6,1, 29704
22,29701,4,4,1, 29705
24,29704,1,1,0, 29705
1,29706,1,1,1, 29707
5,29707,3,3,1, 29710
31,29711,2,2,1, 29713
7,29712,1,1,1, 29713
17,29719,3,3,1, 29722
24,29729,1,1,1, 29730
1,29731,1,1,1, 29732
5,29732,3,3,1, 29735
30,29733,3,3,1, 29736
6,29735,2,2,1, 29737
7,29737,1,1,0, 29738
29,29738,4,4,1, 29742
9,29742,2,2,1, 29744
18,29748,4,4,1, 29752
2,29753,2,2,1, 29755
24,29754,1,1,0, 29755
1,29756,1,1,0, 29757
25,29760,2,2,1, 29762
31,29761,2,2,1, 29763
7,29762,1,1,1, 29763
29,29763,4,4,1, 29767
17,29769,3,3,1, 29772
24,29779,1,1,0, 29780
1,29781,1,1,1, 29782
5,29782,3,3,1, 29785
25,29785,2,2,1, 29787
31,29786,2,2,1, 29788
7,29787,1,1,1, 29788
17,29794,3,3,1, 29797
2,29803,2,2,1, 29805
24,29804,1,1,1, 29805
1,29806,1,1,0, 29807
5,29807,3,3,1, 29810
30,29808,3,3,1, 29811
7,29812,1,1,1, 29813
28,29809,5,5,1, 29814
26,29812,3,3,1, 29815
29,29813,4,4,1, 29817
8,29816,1,1,1, 29817
11,29814,4,4,1, 29818
9,29817,2,2,1, 29819
14,29819,3,3,1, 29822
15,29821,2,2,1, 29823
20,29823,6,6,1, 29829
22,29826,4,4,1, 29830
24,29829,1,1,0, 29830
21,29827,5,5,1, 29832
1,29831,1,1,0, 29832
5,29832,3,3,1, 29835
31,29836,2,2,1, 29838
7,29837,1,1,0, 29838
28,29834,5,5,1, 29839
26,29837,3,3,1, 29840
8,29841,1,1,1, 29842
11,29839,4,4,1, 29843
14,29844,3,3,1, 29847
15,29846,2,2,1, 29848
12,29845,5,5,1, 29850
22,29851,4,4,1, 29855
2,29853,2,2,1, 29855
24,29854,1,1,1, 29855
23,29853,3,3,1, 29856
21,29852,5,5,1, 29857
1,29856,1,1,1, 29857
27,29857,4,4,1, 29861
6,29860,2,2,1, 29862
25,29860,2,2,1, 29862
7,29862,1,1,0, 29863
26,29862,3,3,1, 29865
8,29866,1,1,1, 29867
9,29867,2,2,1, 29869
16,29869,2,2,1, 29871
14,29869,3,3,1, 29872
17,29869,3,3,1, 29872
15,29871,2,2,1, 29873
12,29870,5,5,1, 29875
18,29873,4,4,1, 29877
20,29873,6,6,1, 29879
22,29876,4,4,1, 29880
24,29879,1,1,0, 29880
19,29876,5,5,1, 29881
31,29886,2,2,1, 29888
7,29887,1,1,1, 29888
29,29888,4,4,1, 29892
8,29891,1,1,1, 29892
14,29894,3,3,1, 29897
13,29894,4,4,1, 29898
15,29896,2,2,1, 29898
22,29901,4,4,1, 29905
24,29904,1,1,1, 29905
21,29902,5,5,1, 29907
5,29907,3,3,1, 29910
30,29908,3,3,1, 29911
31,29911,2,2,1, 29913
7,29912,1,1,0, 29913
29,29913,4,4,1, 29917
8,29916,1,1,0, 29917
14,29919,3,3,1, 29922
24,29929,1,1,0, 29930
23,29928,3,3,1, 29931
5,29932,3,3,1, 29935
7,29937,1,1,0, 29938
29,29938,4,4,1, 29942
8,29941,1,1,1, 29942
24,29954,1,1,1, 29955
23,29953,3,3,1, 29956
5,29957,3,3,1, 29960
30,29958,3,3,1, 29961
6,29960,2,2,1, 29962
7,29962,1,1,0, 29963
8,29966,1,1,1, 29967
14,29969,3,3,1, 29972
22,29976,4,4,1, 29980
24,29979,1,1,0, 29980
23,29978,3,3,1, 29981
30,29983,3,3,1, 29986
31,29986,2,2,1, 29988
7,29987,1,1,0, 29988
26,29987,3,3,1, 29990
8,29991,1,1,0, 29992
9,29992,2,2,1, 29994
14,29994,3,3,1, 29997
17,29994,3,3,1, 29997
15,29996,2,2,1, 29998
18,29998,4,4,1, 30002
22,30001,4,4,1, 30005
24,30004,1,1,1, 30005
1,30006,1,1,0, 30007
5,30007,3,3,1, 30010
30,30008,3,3,1, 30011
31,30011,2,2,1, 30013
7,30012,1,1,0, 30013
8,30016,1,1,0, 30017
17,30019,3,3,1, 30022
13,30019,4,4,1, 30023
22,30026,4,4,1, 30030
24,30029,1,1,0, 30030
23,30028,3,3,1, 30031
21,30027,5,5,1, 30032
1,30031,1,1,0, 30032
5,30032,3,3,1, 30035
30,30033,3,3,1, 30036
25,30035,2,2,1, 30037
31,30036,2,2,1, 30038
7,30037,1,1,0, 30038
26,30037,3,3,1, 30040
8,30041,1,1,1, 30042
16,30044,2,2,1, 30046
17,30044,3,3,1, 30047
13,30044,4,4,1, 30048
12,30045,5,5,1, 30050
20,30048,6,6,1, 30054
24,30054,1,1,0, 30055
1,30056,1,1,1, 30057
4,30056,4,4,1, 30060
3,30057,3,3,1, 30060
6,30060,2,2,1, 30062
25,30060,2,2,1, 30062
7,30062,1,1,1, 30063
28,30059,5,5,1, 30064
29,30063,4,4,1, 30067
11,30064,4,4,1, 30068
9,30067,2,2,1, 30069
17,30069,3,3,1, 30072
20,30073,6,6,1, 30079
24,30079,1,1,1, 30080
19,30076,5,5,1, 30081
1,30081,1,1,0, 30082
5,30082,3,3,1, 30085
30,30083,3,3,1, 30086
6,30085,2,2,1, 30087
7,30087,1,1,1, 30088
28,30084,5,5,1, 30089
26,30087,3,3,1, 30090
9,30092,2,2,1, 30094
24,30104,1,1,1, 30105
1,30106,1,1,0, 30107
5,30107,3,3,1, 30110
30,30108,3,3,1, 30111
25,30110,2,2,1, 30112
7,30112,1,1,0, 30113
29,30113,4,4,1, 30117
9,30117,2,2,1, 30119
17,30119,3,3,1, 30122
24,30129,1,1,0, 30130
5,30132,3,3,1, 30135
30,30133,3,3,1, 30136
7,30137,1,1,1, 30138
29,30138,4,4,1, 30142
22,30151,4,4,1, 30155
24,30154,1,1,1, 30155
21,30152,5,5,1, 30157
5,30157,3,3,1, 30160
7,30162,1,1,0, 30163
29,30163,4,4,1, 30167
8,30166,1,1,0, 30167
16,30169,2,2,1, 30171
14,30169,3,3,1, 30172
13,30169,4,4,1, 30173
15,30171,2,2,1, 30173
22,30176,4,4,1, 30180
24,30179,1,1,1, 30180
31,30186,2,2,1, 30188
7,30187,1,1,0, 30188
8,30191,1,1,0, 30192
16,30194,2,2,1, 30196
13,30194,4,4,1, 30198
22,30201,4,4,1, 30205
24,30204,1,1,1, 30205
23,30203,3,3,1, 30206
30,30208,3,3,1, 30211
6,30210,2,2,1, 30212
31,30211,2,2,1, 30213
7,30212,1,1,1, 30213
8,30216,1,1,0, 30217
13,30219,4,4,1, 30223
24,30229,1,1,1, 30230
23,30228,3,3,1, 30231
21,30227,5,5,1, 30232
1,30231,1,1,0, 30232
31,30236,2,2,1, 30238
7,30237,1,1,1, 30238
8,30241,1,1,1, 30242
14,30244,3,3,1, 30247
18,30248,4,4,1, 30252
22,30251,4,4,1, 30255
24,30254,1,1,0, 30255
1,30256,1,1,0, 30257
5,30257,3,3,1, 30260
6,30260,2,2,1, 30262
25,30260,2,2,1, 30262
7,30262,1,1,0, 30263
8,30266,1,1,0, 30267
9,30267,2,2,1, 30269
16,30269,2,2,1, 30271
2,30278,2,2,1, 30280
24,30279,1,1,0, 30280
23,30278,3,3,1, 30281
21,30277,5,5,1, 30282
1,30281,1,1,1, 30282
30,30283,3,3,1, 30286
6,30285,2,2,1, 30287
31,30286,2,2,1, 30288
7,30287,1,1,1, 30288
26,30287,3,3,1, 30290
29,30288,4,4,1, 30292
8,30291,1,1,1, 30292
9,30292,2,2,1, 30294
14,30294,3,3,1, 30297
13,30294,4,4,1, 30298
15,30296,2,2,1, 30298
18,30298,4,4,1, 30302
20,30298,6,6,1, 30304
24,30304,1,1,0, 30305
19,30301,5,5,1, 30306
21,30302,5,5,1, 30307
1,30306,1,1,0, 30307
5,30307,3,3,1, 30310
27,30307,4,4,1, 30311
25,30310,2,2,1, 30312
7,30312,1,1,1, 30313
28,30309,5,5,1, 30314
26,30312,3,3,1, 30315
29,30313,4,4,1, 30317
8,30316,1,1,1, 30317
11,30314,4,4,1, 30318
16,30319,2,2,1, 30321
14,30319,3,3,1, 30322
13,30319,4,4,1, 30323
15,30321,2,2,1, 30323
18,30323,4,4,1, 30327
20,30323,6,6,1, 30329
2,30328,2,2,1, 30330
24,30329,1,1,0, 30330
19,30326,5,5,1, 30331
23,30328,3,3,1, 30331
1,30331,1,1,0, 30332
4,30331,4,4,1, 30335
27,30332,4,4,1, 30336
28,30334,5,5,1, 30339
26,30337,3,3,1, 30340
8,30341,1,1,0, 30342
16,30344,2,2,1, 30346
13,30344,4,4,1, 30348
18,30348,4,4,1, 30352
2,30353,2,2,1, 30355
24,30354,1,1,1, 30355
1,30356,1,1,1, 30357
4,30356,4,4,1, 30360
24,30379,1,1,1, 30380
24,30404,1,1,1, 30405
24,30429,1,1,1, 30430
5,30432,3,3,1, 30435
7,30437,1,1,1, 30438
29,30438,4,4,1, 30442
22,30451,4,4,1, 30455
24,30454,1,1,1, 30455
23,30453,3,3,1, 30456
21,30452,5,5,1, 30457
7,30462,1,1,0, 30463
8,30466,1,1,1, 30467
9,30467,2,2,1, 30469
14,30469,3,3,1, 30472
17,30469,3,3,1, 30472
13,30469,4,4,1, 30473
15,30471,2,2,1, 30473
24,30479,1,1,1, 30480
21,30477,5,5,1, 30482
1,30481,1,1,1, 30482
6,30485,2,2,1, 30487
25,30485,2,2,1, 30487
31,30486,2,2,1, 30488
7,30487,1,1,0, 30488
8,30491,1,1,0, 30492
16,30494,2,2,1, 30496
17,30494,3,3,1, 30497
15,30496,2,2,1, 30498
2,30503,2,2,1, 30505
24,30504,1,1,0, 30505
23,30503,3,3,1, 30506
1,30506,1,1,0, 30507
25,30510,2,2,1, 30512
7,30512,1,1,1, 30513
26,30512,3,3,1, 30515
29,30513,4,4,1, 30517
8,30516,1,1,1, 30517
9,30517,2,2,1, 30519
14,30519,3,3,1, 30522
13,30519,4,4,1, 30523
15,30521,2,2,1, 30523
22,30526,4,4,1, 30530
24,30529,1,1,0, 30530
23,30528,3,3,1, 30531
1,30531,1,1,1, 30532
5,30532,3,3,1, 30535
27,30532,4,4,1, 30536
25,30535,2,2,1, 30537
31,30536,2,2,1, 30538
7,30537,1,1,1, 30538
8,30541,1,1,0, 30542
11,30539,4,4,1, 30543
15,30546,2,2,1, 30548
12,30545,5,5,1, 30550
20,30548,6,6,1, 30554
22,30551,4,4,1, 30555
24,30554,1,1,1, 30555
23,30553,3,3,1, 30556
21,30552,5,5,1, 30557
1,30556,1,1,0, 30557
5,30557,3,3,1, 30560
27,30557,4,4,1, 30561
30,30558,3,3,1, 30561
25,30560,2,2,1, 30562
31,30561,2,2,1, 30563
7,30562,1,1,0, 30563
8,30566,1,1,1, 30567
17,30569,3,3,1, 30572
12,30570,5,5,1, 30575
18,30573,4,4,1, 30577
20,30573,6,6,1, 30579
2,30578,2,2,1, 30580
24,30579,1,1,1, 30580
1,30581,1,1,1, 30582
3,30582,3,3,1, 30585
27,30582,4,4,1, 30586
30,30583,3,3,1, 30586
6,30585,2,2,1, 30587
31,30586,2,2,1, 30588
7,30587,1,1,0, 30588
28,30584,5,5,1, 30589
8,30591,1,1,1, 30592
16,30594,2,2,1, 30596
14,30594,3,3,1, 30597
24,30604,1,1,1, 30605
23,30603,3,3,1, 30606
5,30607,3,3,1, 30610
7,30612,1,1,0, 30613
29,30613,4,4,1, 30617
8,30616,1,1,0, 30617
16,30619,2,2,1, 30621
14,30619,3,3,1, 30622
15,30621,2,2,1, 30623
24,30629,1,1,1, 30630
23,30628,3,3,1, 30631
5,30632,3,3,1, 30635
7,30637,1,1,1, 30638
8,30641,1,1,1, 30642
14,30644,3,3,1, 30647
13,30644,4,4,1, 30648
24,30654,1,1,0, 30655
23,30653,3,3,1, 30656
21,30652,5,5,1, 30657
5,30657,3,3,1, 30660
7,30662,1,1,0, 30663
29,30663,4,4,1, 30667
8,30666,1,1,1, 30667
16,30669,2,2,1, 30671
24,30679,1,1,0, 30680
5,30682,3,3,1, 30685
30,30683,3,3,1, 30686
6,30685,2,2,1, 30687
31,30686,2,2,1, 30688
7,30687,1,1,1, 30688
29,30688,4,4,1, 30692
24,30704,1,1,0, 30705
1,30706,1,1,1, 30707
7,30712,1,1,1, 30713
29,30713,4,4,1, 30717
9,30717,2,2,1, 30719
17,30719,3,3,1, 30722
24,30729,1,1,1, 30730
1,30731,1,1,1, 30732
25,30735,2,2,1, 30737
31,30736,2,2,1, 30738
7,30737,1,1,0, 30738
9,30742,2,2,1, 30744
17,30744,3,3,1, 30747
24,30754,1,1,1, 30755
1,30756,1,1,1, 30757
5,30757,3,3,1, 30760
25,30760,2,2,1, 30762
31,30761,2,2,1, 30763
7,30762,1,1,0, 30763
29,30763,4,4,1, 30767
24,30779,1,1,0, 30780
21,30777,5,5,1, 30782
1,30781,1,1,1, 30782
5,30782,3,3,1, 30785
30,30783,3,3,1, 30786
6,30785,2,2,1, 30787
25,30785,2,2,1, 30787
31,30786,2,2,1, 30788
7,30787,1,1,1, 30788
29,30788,4,4,1, 30792
8,30791,1,1,1, 30792
16,30794,2,2,1, 30796
14,30794,3,3,1, 30797
13,30794,4,4,1, 30798
22,30801,4,4,1, 30805
2,30803,2,2,1, 30805
24,30804,1,1,0, 30805
23,30803,3,3,1, 30806
21,30802,5,5,1, 30807
1,30806,1,1,0, 30807
5,30807,3,3,1, 30810
31,30811,2,2,1, 30813
7,30812,1,1,0, 30813
28,30809,5,5,1, 30814
8,30816,1,1,1, 30817
11,30814,4,4,1, 30818
9,30817,2,2,1, 30819
14,30819,3,3,1, 30822
20,30823,6,6,1, 30829
22,30826,4,4,1, 30830
2,30828,2,2,1, 30830
24,30829,1,1,0, 30830
1,30831,1,1,0, 30832
3,30832,3,3,1, 30835
5,30832,3,3,1, 30835
30,30833,3,3,1, 30836
6,30835,2,2,1, 30837
25,30835,2,2,1, 30837
7,30837,1,1,0, 30838
26,30837,3,3,1, 30840
8,30841,1,1,1, 30842
9,30842,2,2,1, 30844
16,30844,2,2,1, 30846
14,30844,3,3,1, 30847
13,30844,4,4,1, 30848
15,30846,2,2,1, 30848
20,30848,6,6,1, 30854
2,30853,2,2,1, 30855
24,30854,1,1,0, 30855
19,30851,5,5,1, 30856
1,30856,1,1,1, 30857
5,30857,3,3,1, 30860
27,30857,4,4,1, 30861
30,30858,3,3,1, 30861
6,30860,2,2,1, 30862
25,30860,2,2,1, 30862
7,30862,1,1,0, 30863
28,30859,5,5,1, 30864
26,30862,3,3,1, 30865
29,30863,4,4,1, 30867
8,30866,1,1,0, 30867
9,30867,2,2,1, 30869
14,30869,3,3,1, 30872
18,30873,4,4,1, 30877
22,30876,4,4,1, 30880
2,30878,2,2,1, 30880
24,30879,1,1,1, 30880
19,30876,5,5,1, 30881
23,30878,3,3,1, 30881
1,30881,1,1,1, 30882
3,30882,3,3,1, 30885
6,30885,2,2,1, 30887
7,30887,1,1,0, 30888
8,30891,1,1,0, 30892
16,30894,2,2,1, 30896
13,30894,4,4,1, 30898
24,30904,1,1,1, 30905
23,30903,3,3,1, 30906
31,30911,2,2,1, 30913
7,30912,1,1,1, 30913
29,30913,4,4,1, 30917
8,30916,1,1,0, 30917
16,30919,2,2,1, 30921
13,30919,4,4,1, 30923
15,30921,2,2,1, 30923
24,30929,1,1,1, 30930
23,30928,3,3,1, 30931
21,30927,5,5,1, 30932
5,30932,3,3,1, 30935
30,30933,3,3,1, 30936
6,30935,2,2,1, 30937
7,30937,1,1,1, 30938
8,30941,1,1,0, 30942
16,30944,2,2,1, 30946
14,30944,3,3,1, 30947
15,30946,2,2,1, 30948
24,30954,1,1,1, 30955
21,30952,5,5,1, 30957
5,30957,3,3,1, 30960
30,30958,3,3,1, 30961
6,30960,2,2,1, 30962
7,30962,1,1,1, 30963
24,30979,1,1,0, 30980
5,30982,3,3,1, 30985
30,30983,3,3,1, 30986
6,30985,2,2,1, 30987
7,30987,1,1,0, 30988
26,30987,3,3,1, 30990
11,30989,4,4,1, 30993
17,30994,3,3,1, 30997
12,30995,5,5,1, 31000
24,31004,1,1,1, 31005
1,31006,1,1,0, 31007
5,31007,3,3,1, 31010
27,31007,4,4,1, 31011
6,31010,2,2,1, 31012
25,31010,2,2,1, 31012
7,31012,1,1,1, 31013
28,31009,5,5,1, 31014
26,31012,3,3,1, 31015
29,31013,4,4,1, 31017
9,31017,2,2,1, 31019
24,31029,1,1,0, 31030
1,31031,1,1,1, 31032
30,31033,3,3,1, 31036
7,31037,1,1,0, 31038
29,31038,4,4,1, 31042
17,31044,3,3,1, 31047
24,31054,1,1,1, 31055
1,31056,1,1,1, 31057
5,31057,3,3,1, 31060
6,31060,2,2,1, 31062
25,31060,2,2,1, 31062
7,31062,1,1,0, 31063
29,31063,4,4,1, 31067
8,31066,1,1,0, 31067
16,31069,2,2,1, 31071
17,31069,3,3,1, 31072
13,31069,4,4,1, 31073
15,31071,2,2,1, 31073
22,31076,4,4,1, 31080
24,31079,1,1,1, 31080
21,31077,5,5,1, 31082
1,31081,1,1,0, 31082
30,31083,3,3,1, 31086
31,31086,2,2,1, 31088
7,31087,1,1,0, 31088
8,31091,1,1,0, 31092
9,31092,2,2,1, 31094
16,31094,2,2,1, 31096
17,31094,3,3,1, 31097
24,31104,1,1,1, 31105
23,31103,3,3,1, 31106
1,31106,1,1,0, 31107
5,31107,3,3,1, 31110
6,31110,2,2,1, 31112
7,31112,1,1,1, 31113
8,31116,1,1,0, 31117
9,31117,2,2,1, 31119
17,31119,3,3,1, 31122
18,31123,4,4,1, 31127
22,31126,4,4,1, 31130
2,31128,2,2,1, 31130
24,31129,1,1,0, 31130
23,31128,3,3,1, 31131
1,31131,1,1,0, 31132
3,31132,3,3,1, 31135
5,31132,3,3,1, 31135
30,31133,3,3,1, 31136
31,31136,2,2,1, 31138
7,31137,1,1,1, 31138
28,31134,5,5,1, 31139
26,31137,3,3,1, 31140
29,31138,4,4,1, 31142
8,31141,1,1,0, 31142
15,31146,2,2,1, 31148
12,31145,5,5,1, 31150
20,31148,6,6,1, 31154
24,31154,1,1,1, 31155
23,31153,3,3,1, 31156
21,31152,5,5,1, 31157
1,31156,1,1,1, 31157
4,31156,4,4,1, 31160
3,31157,3,3,1, 31160
5,31157,3,3,1, 31160
6,31160,2,2,1, 31162
7,31162,1,1,1, 31163
8,31166,1,1,0, 31167
11,31164,4,4,1, 31168
16,31169,2,2,1, 31171
14,31169,3,3,1, 31172
12,31170,5,5,1, 31175
2,31178,2,2,1, 31180
24,31179,1,1,0, 31180
23,31178,3,3,1, 31181
1,31181,1,1,1, 31182
4,31181,4,4,1, 31185
3,31182,3,3,1, 31185
27,31182,4,4,1, 31186
30,31183,3,3,1, 31186
6,31185,2,2,1, 31187
25,31185,2,2,1, 31187
7,31187,1,1,0, 31188
8,31191,1,1,0, 31192
16,31194,2,2,1, 31196
15,31196,2,2,1, 31198
22,31201,4,4,1, 31205
24,31204,1,1,0, 31205
31,31211,2,2,1, 31213
7,31212,1,1,1, 31213
29,31213,4,4,1, 31217
8,31216,1,1,1, 31217
14,31219,3,3,1, 31222
24,31229,1,1,1, 31230
23,31228,3,3,1, 31231
21,31227,5,5,1, 31232
5,31232,3,3,1, 31235
30,31233,3,3,1, 31236
6,31235,2,2,1, 31237
31,31236,2,2,1, 31238
8,31241,1,1,1, 31242
16,31244,2,2,1, 31246
22,31251,4,4,1, 31255
24,31254,1,1,0, 31255
23,31253,3,3,1, 31256
21,31252,5,5,1, 31257
8,31266,1,1,1, 31267
16,31269,2,2,1, 31271
14,31269,3,3,1, 31272
24,31279,1,1,1, 31280
21,31277,5,5,1, 31282
8,31291,1,1,0, 31292
13,31294,4,4,1, 31298
18,31298,4,4,1, 31302
24,31304,1,1,0, 31305
19,31301,5,5,1, 31306
23,31303,3,3,1, 31306
1,31306,1,1,0, 31307
4,31306,4,4,1, 31310
3,31307,3,3,1, 31310
25,31310,2,2,1, 31312
8,31316,1,1,0, 31317
14,31319,3,3,1, 31322
13,31319,4,4,1, 31323
18,31323,4,4,1, 31327
20,31323,6,6,1, 31329
24,31329,1,1,1, 31330
1,31331,1,1,1, 31332
4,31331,4,4,1, 31335
3,31332,3,3,1, 31335
25,31335,2,2,1, 31337
26,31337,3,3,1, 31340
29,31338,4,4,1, 31342
9,31342,2,2,1, 31344
17,31344,3,3,1, 31347
24,31354,1,1,1, 31355
1,31356,1,1,1, 31357
25,31360,2,2,1, 31362
31,31361,2,2,1, 31363
7,31362,1,1,0, 31363
9,31367,2,2,1, 31369
17,31369,3,3,1, 31372
24,31379,1,1,1, 31380
1,31381,1,1,0, 31382
7,31387,1,1,0, 31388
9,31392,2,2,1, 31394
17,31394,3,3,1, 31397
24,31404,1,1,0, 31405
1,31406,1,1,1, 31407
30,31408,3,3,1, 31411
6,31410,2,2,1, 31412
7,31412,1,1,1, 31413
29,31413,4,4,1, 31417
9,31417,2,2,1, 31419
17,31419,3,3,1, 31422
24,31429,1,1,1, 31430
23,31428,3,3,1, 31431
1,31431,1,1,0, 31432
30,31433,3,3,1, 31436
25,31435,2,2,1, 31437
7,31437,1,1,1, 31438
8,31441,1,1,0, 31442
17,31444,3,3,1, 31447
15,31446,2,2,1, 31448
12,31445,5,5,1, 31450
2,31453,2,2,1, 31455
24,31454,1,1,1, 31455
19,31451,5,5,1, 31456
23,31453,3,3,1, 31456
21,31452,5,5,1, 31457
1,31456,1,1,0, 31457
4,31456,4,4,1, 31460
3,31457,3,3,1, 31460
5,31457,3,3,1, 31460
6,31460,2,2,1, 31462
25,31460,2,2,1, 31462
7,31462,1,1,0, 31463
8,31466,1,1,0, 31467
15,31471,2,2,1, 31473
22,31476,4,4,1, 31480
24,31479,1,1,0, 31480
23,31478,3,3,1, 31481
21,31477,5,5,1, 31482
30,31483,3,3,1, 31486
31,31486,2,2,1, 31488
7,31487,1,1,1, 31488
8,31491,1,1,1, 31492
16,31494,2,2,1, 31496
14,31494,3,3,1, 31497
15,31496,2,2,1, 31498
24,31504,1,1,0, 31505
5,31507,3,3,1, 31510
30,31508,3,3,1, 31511
6,31510,2,2,1, 31512
7,31512,1,1,0, 31513
29,31513,4,4,1, 31517
8,31516,1,1,0, 31517
14,31519,3,3,1, 31522
13,31519,4,4,1, 31523
15,31521,2,2,1, 31523
24,31529,1,1,0, 31530
23,31528,3,3,1, 31531
21,31527,5,5,1, 31532
6,31535,2,2,1, 31537
31,31536,2,2,1, 31538
7,31537,1,1,0, 31538
8,31541,1,1,0, 31542
14,31544,3,3,1, 31547
24,31554,1,1,1, 31555
21,31552,5,5,1, 31557
7,31562,1,1,0, 31563
8,31566,1,1,0, 31567
16,31569,2,2,1, 31571
14,31569,3,3,1, 31572
13,31569,4,4,1, 31573
15,31571,2,2,1, 31573
24,31579,1,1,0, 31580
23,31578,3,3,1, 31581
1,31581,1,1,0, 31582
30,31583,3,3,1, 31586
6,31585,2,2,1, 31587
25,31585,2,2,1, 31587
7,31587,1,1,1, 31588
29,31588,4,4,1, 31592
8,31591,1,1,1, 31592
9,31592,2,2,1, 31594
14,31594,3,3,1, 31597
17,31594,3,3,1, 31597
15,31596,2,2,1, 31598
24,31604,1,1,1, 31605
21,31602,5,5,1, 31607
1,31606,1,1,1, 31607
25,31610,2,2,1, 31612
7,31612,1,1,1, 31613
8,31616,1,1,0, 31617
9,31617,2,2,1, 31619
16,31619,2,2,1, 31621
13,31619,4,4,1, 31623
15,31621,2,2,1, 31623
24,31629,1,1,1, 31630
1,31631,1,1,1, 31632
5,31632,3,3,1, 31635
30,31633,3,3,1, 31636
31,31636,2,2,1, 31638
7,31637,1,1,1, 31638
29,31638,4,4,1, 31642
12,31645,5,5,1, 31650
18,31648,4,4,1, 31652
2,31653,2,2,1, 31655
24,31654,1,1,1, 31655
19,31651,5,5,1, 31656
1,31656,1,1,0, 31657
3,31657,3,3,1, 31660
27,31657,4,4,1, 31661
30,31658,3,3,1, 31661
7,31662,1,1,1, 31663
9,31667,2,2,1, 31669
17,31669,3,3,1, 31672
2,31678,2,2,1, 31680
24,31679,1,1,0, 31680
1,31681,1,1,0, 31682
4,31681,4,4,1, 31685
3,31682,3,3,1, 31685
27,31682,4,4,1, 31686
31,31686,2,2,1, 31688
7,31687,1,1,0, 31688
28,31684,5,5,1, 31689
29,31688,4,4,1, 31692
9,31692,2,2,1, 31694
12,31695,5,5,1, 31700
18,31698,4,4,1, 31702
20,31698,6,6,1, 31704
2,31703,2,2,1, 31705
24,31704,1,1,1, 31705
1,31706,1,1,1, 31707
27,31707,4,4,1, 31711
30,31708,3,3,1, 31711
6,31710,2,2,1, 31712
31,31711,2,2,1, 31713
7,31712,1,1,0, 31713
26,31712,3,3,1, 31715
29,31713,4,4,1, 31717
11,31714,4,4,1, 31718
9,31717,2,2,1, 31719
20,31723,6,6,1, 31729
2,31728,2,2,1, 31730
24,31729,1,1,0, 31730
5,31732,3,3,1, 31735
30,31733,3,3,1, 31736
6,31735,2,2,1, 31737
31,31736,2,2,1, 31738
7,31737,1,1,0, 31738
29,31738,4,4,1, 31742
8,31741,1,1,0, 31742
14,31744,3,3,1, 31747
13,31744,4,4,1, 31748
15,31746,2,2,1, 31748
22,31751,4,4,1, 31755
24,31754,1,1,0, 31755
23,31753,3,3,1, 31756
30,31758,3,3,1, 31761
6,31760,2,2,1, 31762
7,31762,1,1,1, 31763
8,31766,1,1,1, 31767
16,31769,2,2,1, 31771
24,31779,1,1,0, 31780
23,31778,3,3,1, 31781
6,31785,2,2,1, 31787
31,31786,2,2,1, 31788
7,31787,1,1,1, 31788
29,31788,4,4,1, 31792
8,31791,1,1,1, 31792
14,31794,3,3,1, 31797
15,31796,2,2,1, 31798
24,31804,1,1,1, 31805
21,31802,5,5,1, 31807
31,31811,2,2,1, 31813
7,31812,1,1,0, 31813
29,31813,4,4,1, 31817
8,31816,1,1,1, 31817
16,31819,2,2,1, 31821
15,31821,2,2,1, 31823
24,31829,1,1,0, 31830
23,31828,3,3,1, 31831
5,31832,3,3,1, 31835
30,31833,3,3,1, 31836
6,31835,2,2,1, 31837
25,31835,2,2,1, 31837
31,31836,2,2,1, 31838
7,31837,1,1,1, 31838
8,31841,1,1,0, 31842
9,31842,2,2,1, 31844
16,31844,2,2,1, 31846
20,31848,6,6,1, 31854
2,31853,2,2,1, 31855
24,31854,1,1,1, 31855
23,31853,3,3,1, 31856
21,31852,5,5,1, 31857
1,31856,1,1,0, 31857
5,31857,3,3,1, 31860
27,31857,4,4,1, 31861
30,31858,3,3,1, 31861
6,31860,2,2,1, 31862
25,31860,2,2,1, 31862
7,31862,1,1,1, 31863
28,31859,5,5,1, 31864
26,31862,3,3,1, 31865
8,31866,1,1,1, 31867
16,31869,2,2,1, 31871
14,31869,3,3,1, 31872
17,31869,3,3,1, 31872
22,31876,4,4,1, 31880
2,31878,2,2,1, 31880
24,31879,1,1,1, 31880
1,31881,1,1,0, 31882
30,31883,3,3,1, 31886
6,31885,2,2,1, 31887
25,31885,2,2,1, 31887
31,31886,2,2,1, 31888
7,31887,1,1,1, 31888
26,31887,3,3,1, 31890
29,31888,4,4,1, 31892
8,31891,1,1,1, 31892
16,31894,2,2,1, 31896
14,31894,3,3,1, 31897
22,31901,4,4,1, 31905
2,31903,2,2,1, 31905
24,31904,1,1,1, 31905
1,31906,1,1,1, 31907
5,31907,3,3,1, 31910
30,31908,3,3,1, 31911
6,31910,2,2,1, 31912
7,31912,1,1,1, 31913
26,31912,3,3,1, 31915
8,31916,1,1,0, 31917
9,31917,2,2,1, 31919
16,31919,2,2,1, 31921
15,31921,2,2,1, 31923
2,31928,2,2,1, 31930
24,31929,1,1,0, 31930
21,31927,5,5,1, 31932
1,31931,1,1,0, 31932
5,31932,3,3,1, 31935
30,31933,3,3,1, 31936
6,31935,2,2,1, 31937
7,31937,1,1,0, 31938
26,31937,3,3,1, 31940
8,31941,1,1,0, 31942
9,31942,2,2,1, 31944
14,31944,3,3,1, 31947
13,31944,4,4,1, 31948
15,31946,2,2,1, 31948
18,31948,4,4,1, 31952
2,31953,2,2,1, 31955
24,31954,1,1,0, 31955
23,31953,3,3,1, 31956
21,31952,5,5,1, 31957
1,31956,1,1,1, 31957
5,31957,3,3,1, 31960
30,31958,3,3,1, 31961
6,31960,2,2,1, 31962
25,31960,2,2,1, 31962
31,31961,2,2,1, 31963
7,31962,1,1,0, 31963
26,31962,3,3,1, 31965
8,31966,1,1,0, 31967
13,31969,4,4,1, 31973
15,31971,2,2,1, 31973
12,31970,5,5,1, 31975
18,31973,4,4,1, 31977
22,31976,4,4,1, 31980
2,31978,2,2,1, 31980
24,31979,1,1,1, 31980
23,31978,3,3,1, 31981
30,31983,3,3,1, 31986
31,31986,2,2,1, 31988
7,31987,1,1,0, 31988
24,32004,1,1,0, 32005
31,32011,2,2,1, 32013
7,32012,1,1,1, 32013
29,32013,4,4,1, 32017
24,32029,1,1,0, 32030
5,32032,3,3,1, 32035
30,32033,3,3,1, 32036
7,32037,1,1,1, 32038
29,32038,4,4,1, 32042
24,32054,1,1,1, 32055
5,32057,3,3,1, 32060
7,32062,1,1,1, 32063
24,32079,1,1,1, 32080
3,32082,3,3,1, 32085
5,32082,3,3,1, 32085
30,32083,3,3,1, 32086
25,32085,2,2,1, 32087
7,32087,1,1,0, 32088
26,32087,3,3,1, 32090
8,32091,1,1,0, 32092
16,32094,2,2,1, 32096
24,32104,1,1,0, 32105
23,32103,3,3,1, 32106
21,32102,5,5,1, 32107
1,32106,1,1,1, 32107
5,32107,3,3,1, 32110
6,32110,2,2,1, 32112
31,32111,2,2,1, 32113
7,32112,1,1,0, 32113
8,32116,1,1,1, 32117
9,32117,2,2,1, 32119
16,32119,2,2,1, 32121
14,32119,3,3,1, 32122
17,32119,3,3,1, 32122
13,32119,4,4,1, 32123
22,32126,4,4,1, 32130
24,32129,1,1,1, 32130
23,32128,3,3,1, 32131
1,32131,1,1,1, 32132
6,32135,2,2,1, 32137
7,32137,1,1,0, 32138
29,32138,4,4,1, 32142
8,32141,1,1,0, 32142
16,32144,2,2,1, 32146
15,32146,2,2,1, 32148
24,32154,1,1,1, 32155
23,32153,3,3,1, 32156
1,32156,1,1,1, 32157
5,32157,3,3,1, 32160
7,32162,1,1,0, 32163
8,32166,1,1,1, 32167
17,32169,3,3,1, 32172
15,32171,2,2,1, 32173
24,32179,1,1,1, 32180
1,32181,1,1,1, 32182
5,32182,3,3,1, 32185
30,32183,3,3,1, 32186
6,32185,2,2,1, 32187
25,32185,2,2,1, 32187
7,32187,1,1,1, 32188
8,32191,1,1,0, 32192
14,32194,3,3,1, 32197
15,32196,2,2,1, 32198
20,32198,6,6,1, 32204
24,32204,1,1,0, 32205
1,32206,1,1,1, 32207
3,32207,3,3,1, 32210
5,32207,3,3,1, 32210
30,32208,3,3,1, 32211
31,32211,2,2,1, 32213
7,32212,1,1,1, 32213
8,32216,1,1,1, 32217
16,32219,2,2,1, 32221
15,32221,2,2,1, 32223
18,32223,4,4,1, 32227
24,32229,1,1,0, 32230
23,32228,3,3,1, 32231
21,32227,5,5,1, 32232
1,32231,1,1,0, 32232
5,32232,3,3,1, 32235
6,32235,2,2,1, 32237
25,32235,2,2,1, 32237
31,32236,2,2,1, 32238
8,32241,1,1,1, 32242
9,32242,2,2,1, 32244
17,32244,3,3,1, 32247
13,32244,4,4,1, 32248
15,32246,2,2,1, 32248
22,32251,4,4,1, 32255
24,32254,1,1,0, 32255
19,32251,5,5,1, 32256
21,32252,5,5,1, 32257
1,32256,1,1,0, 32257
25,32260,2,2,1, 32262
8,32266,1,1,1, 32267
16,32269,2,2,1, 32271
17,32269,3,3,1, 32272
15,32271,2,2,1, 32273
12,32270,5,5,1, 32275
20,32273,6,6,1, 32279
2,32278,2,2,1, 32280
24,32279,1,1,1, 32280
21,32277,5,5,1, 32282
1,32281,1,1,1, 32282
3,32282,3,3,1, 32285
26,32287,3,3,1, 32290
8,32291,1,1,0, 32292
11,32289,4,4,1, 32293
14,32294,3,3,1, 32297
13,32294,4,4,1, 32298
15,32296,2,2,1, 32298
12,32295,5,5,1, 32300
18,32298,4,4,1, 32302
20,32298,6,6,1, 32304
22,32301,4,4,1, 32305
24,32304,1,1,0, 32305
21,32302,5,5,1, 32307
1,32306,1,1,1, 32307
4,32306,4,4,1, 32310
3,32307,3,3,1, 32310
27,32307,4,4,1, 32311
25,32310,2,2,1, 32312
28,32309,5,5,1, 32314
26,32312,3,3,1, 32315
8,32316,1,1,1, 32317
17,32319,3,3,1, 32322
13,32319,4,4,1, 32323
18,32323,4,4,1, 32327
24,32329,1,1,1, 32330
1,32331,1,1,1, 32332
25,32335,2,2,1, 32337
8,32341,1,1,0, 32342
13,32344,4,4,1, 32348
2,32353,2,2,1, 32355
24,32354,1,1,0, 32355
21,32352,5,5,1, 32357
1,32356,1,1,0, 32357
31,32361,2,2,1, 32363
7,32362,1,1,1, 32363
29,32363,4,4,1, 32367
8,32366,1,1,0, 32367
9,32367,2,2,1, 32369
14,32369,3,3,1, 32372
13,32369,4,4,1, 32373
15,32371,2,2,1, 32373
18,32373,4,4,1, 32377
2,32378,2,2,1, 32380
24,32379,1,1,0, 32380
1,32381,1,1,0, 32382
6,32385,2,2,1, 32387
7,32387,1,1,1, 32388
26,32387,3,3,1, 32390
2,32403,2,2,1, 32405
24,32404,1,1,0, 32405
1,32406,1,1,1, 32407
25,32410,2,2,1, 32412
31,32411,2,2,1, 32413
7,32412,1,1,1, 32413
24,32429,1,1,0, 32430
5,32432,3,3,1, 32435
30,32433,3,3,1, 32436
31,32436,2,2,1, 32438
7,32437,1,1,1, 32438
24,32454,1,1,0, 32455
6,32460,2,2,1, 32462
7,32462,1,1,1, 32463
29,32463,4,4,1, 32467
24,32479,1,1,0, 32480
23,32478,3,3,1, 32481
21,32477,5,5,1, 32482
31,32486,2,2,1, 32488
7,32487,1,1,1, 32488
8,32491,1,1,1, 32492
14,32494,3,3,1, 32497
24,32504,1,1,0, 32505
5,32507,3,3,1, 32510
30,32508,3,3,1, 32511
6,32510,2,2,1, 32512
31,32511,2,2,1, 32513
7,32512,1,1,0, 32513
29,32513,4,4,1, 32517
8,32516,1,1,0, 32517
9,32517,2,2,1, 32519
16,32519,2,2,1, 32521
14,32519,3,3,1, 32522
17,32519,3,3,1, 32522
13,32519,4,4,1, 32523
18,32523,4,4,1, 32527
22,32526,4,4,1, 32530
24,32529,1,1,0, 32530
1,32531,1,1,1, 32532
31,32536,2,2,1, 32538
7,32537,1,1,1, 32538
8,32541,1,1,0, 32542
9,32542,2,2,1, 32544
16,32544,2,2,1, 32546
14,32544,3,3,1, 32547
15,32546,2,2,1, 32548
22,32551,4,4,1, 32555
24,32554,1,1,0, 32555
23,32553,3,3,1, 32556
21,32552,5,5,1, 32557
1,32556,1,1,1, 32557
5,32557,3,3,1, 32560
31,32561,2,2,1, 32563
7,32562,1,1,1, 32563
8,32566,1,1,0, 32567
22,32576,4,4,1, 32580
24,32579,1,1,0, 32580
23,32578,3,3,1, 32581
21,32577,5,5,1, 32582
1,32581,1,1,1, 32582
5,32582,3,3,1, 32585
30,32583,3,3,1, 32586
31,32586,2,2,1, 32588
7,32587,1,1,0, 32588
29,32588,4,4,1, 32592
8,32591,1,1,1, 32592
16,32594,2,2,1, 32596
24,32604,1,1,0, 32605
23,32603,3,3,1, 32606
21,32602,5,5,1, 32607
1,32606,1,1,0, 32607
5,32607,3,3,1, 32610
30,32608,3,3,1, 32611
25,32610,2,2,1, 32612
7,32612,1,1,0, 32613
8,32616,1,1,0, 32617
16,32619,2,2,1, 32621
15,32621,2,2,1, 32623
22,32626,4,4,1, 32630
2,32628,2,2,1, 32630
24,32629,1,1,1, 32630
1,32631,1,1,0, 32632
4,32631,4,4,1, 32635
5,32632,3,3,1, 32635
27,32632,4,4,1, 32636
6,32635,2,2,1, 32637
25,32635,2,2,1, 32637
7,32637,1,1,0, 32638
28,32634,5,5,1, 32639
26,32637,3,3,1, 32640
8,32641,1,1,0, 32642
11,32639,4,4,1, 32643
9,32642,2,2,1, 32644
16,32644,2,2,1, 32646
14,32644,3,3,1, 32647
17,32644,3,3,1, 32647
13,32644,4,4,1, 32648
15,32646,2,2,1, 32648
12,32645,5,5,1, 32650
22,32651,4,4,1, 32655
2,32653,2,2,1, 32655
24,32654,1,1,1, 32655
21,32652,5,5,1, 32657
1,32656,1,1,0, 32657
30,32658,3,3,1, 32661
6,32660,2,2,1, 32662
31,32661,2,2,1, 32663
7,32662,1,1,1, 32663
28,32659,5,5,1, 32664
8,32666,1,1,0, 32667
11,32664,4,4,1, 32668
16,32669,2,2,1, 32671
14,32669,3,3,1, 32672
17,32669,3,3,1, 32672
2,32678,2,2,1, 32680
24,32679,1,1,0, 32680
1,32681,1,1,1, 32682
5,32682,3,3,1, 32685
30,32683,3,3,1, 32686
31,32686,2,2,1, 32688
7,32687,1,1,0, 32688
29,32688,4,4,1, 32692
17,32694,3,3,1, 32697
20,32698,6,6,1, 32704
24,32704,1,1,1, 32705
1,32706,1,1,0, 32707
30,32708,3,3,1, 32711
31,32711,2,2,1, 32713
7,32712,1,1,1, 32713
28,32709,5,5,1, 32714
17,32719,3,3,1, 32722
18,32723,4,4,1, 32727
2,32728,2,2,1, 32730
24,32729,1,1,0, 32730
1,32731,1,1,1, 32732
5,32732,3,3,1, 32735
27,32732,4,4,1, 32736
6,32735,2,2,1, 32737
31,32736,2,2,1, 32738
7,32737,1,1,0, 32738
28,32734,5,5,1, 32739
26,32737,3,3,1, 32740
9,32742,2,2,1, 32744
17,32744,3,3,1, 32747
18,32748,4,4,1, 32752
20,32748,6,6,1, 32754
24,32754,1,1,1, 32755
1,32756,1,1,1, 32757
3,32757,3,3,1, 32760
5,32757,3,3,1, 32760
6,32760,2,2,1, 32762
7,32762,1,1,1, 32763
29,32763,4,4,1, 32767
24,32779,1,1,0, 32780
7,32787,1,1,0, 32788
29,32788,4,4,1, 32792
8,32791,1,1,0, 32792
16,32794,2,2,1, 32796
14,32794,3,3,1, 32797
13,32794,4,4,1, 32798
24,32804,1,1,0, 32805
21,32802,5,5,1, 32807
6,32810,2,2,1, 32812
7,32812,1,1,0, 32813
8,32816,1,1,0, 32817
14,32819,3,3,1, 32822
13,32819,4,4,1, 32823
24,32829,1,1,0, 32830
23,32828,3,3,1, 32831
21,32827,5,5,1, 32832
30,32833,3,3,1, 32836
7,32837,1,1,0, 32838
8,32841,1,1,0, 32842
14,32844,3,3,1, 32847
15,32846,2,2,1, 32848
24,32854,1,1,1, 32855
23,32853,3,3,1, 32856
21,32852,5,5,1, 32857
25,32860,2,2,1, 32862
7,32862,1,1,1, 32863
29,32863,4,4,1, 32867
8,32866,1,1,0, 32867
16,32869,2,2,1, 32871
22,32876,4,4,1, 32880
24,32879,1,1,1, 32880
1,32881,1,1,1, 32882
5,32882,3,3,1, 32885
25,32885,2,2,1, 32887
31,32886,2,2,1, 32888
7,32887,1,1,1, 32888
29,32888,4,4,1, 32892
8,32891,1,1,1, 32892
9,32892,2,2,1, 32894
17,32894,3,3,1, 32897
15,32896,2,2,1, 32898
22,32901,4,4,1, 32905
24,32904,1,1,1, 32905
23,32903,3,3,1, 32906
21,32902,5,5,1, 32907
1,32906,1,1,1, 32907
6,32910,2,2,1, 32912
7,32912,1,1,0, 32913
29,32913,4,4,1, 32917
8,32916,1,1,0, 32917
13,32919,4,4,1, 32923
24,32929,1,1,0, 32930
21,32927,5,5,1, 32932
1,32931,1,1,0, 32932
5,32932,3,3,1, 32935
7,32937,1,1,0, 32938
8,32941,1,1,0, 32942
14,32944,3,3,1, 32947
17,32944,3,3,1, 32947
13,32944,4,4,1, 32948
15,32946,2,2,1, 32948
18,32948,4,4,1, 32952
24,32954,1,1,1, 32955
23,32953,3,3,1, 32956
21,32952,5,5,1, 32957
1,32956,1,1,1, 32957
30,32958,3,3,1, 32961
25,32960,2,2,1, 32962
31,32961,2,2,1, 32963
7,32962,1,1,1, 32963
8,32966,1,1,0, 32967
9,32967,2,2,1, 32969
14,32969,3,3,1, 32972
13,32969,4,4,1, 32973
15,32971,2,2,1, 32973
22,32976,4,4,1, 32980
2,32978,2,2,1, 32980
24,32979,1,1,0, 32980
1,32981,1,1,0, 32982
6,32985,2,2,1, 32987
25,32985,2,2,1, 32987
7,32987,1,1,1, 32988
28,32984,5,5,1, 32989
29,32988,4,4,1, 32992
8,32991,1,1,0, 32992
9,32992,2,2,1, 32994
17,32994,3,3,1, 32997
12,32995,5,5,1, 33000
18,32998,4,4,1, 33002
20,32998,6,6,1, 33004
22,33001,4,4,1, 33005
2,33003,2,2,1, 33005
24,33004,1,1,0, 33005
21,33002,5,5,1, 33007
1,33006,1,1,1, 33007
3,33007,3,3,1, 33010
5,33007,3,3,1, 33010
25,33010,2,2,1, 33012
31,33011,2,2,1, 33013
7,33012,1,1,1, 33013
28,33009,5,5,1, 33014
29,33013,4,4,1, 33017
8,33016,1,1,1, 33017
17,33019,3,3,1, 33022
15,33021,2,2,1, 33023
12,33020,5,5,1, 33025
18,33023,4,4,1, 33027
20,33023,6,6,1, 33029
22,33026,4,4,1, 33030
2,33028,2,2,1, 33030
24,33029,1,1,1, 33030
19,33026,5,5,1, 33031
23,33028,3,3,1, 33031
1,33031,1,1,0, 33032
4,33031,4,4,1, 33035
27,33032,4,4,1, 33036
6,33035,2,2,1, 33037
31,33036,2,2,1, 33038
7,33037,1,1,0, 33038
8,33041,1,1,0, 33042
16,33044,2,2,1, 33046
22,33051,4,4,1, 33055
24,33054,1,1,0, 33055
23,33053,3,3,1, 33056
31,33061,2,2,1, 33063
7,33062,1,1,1, 33063
29,33063,4,4,1, 33067
24,33079,1,1,1, 33080
7,33087,1,1,1, 33088
29,33088,4,4,1, 33092
24,33104,1,1,1, 33105
5,33107,3,3,1, 33110
6,33110,2,2,1, 33112
7,33112,1,1,1, 33113
24,33129,1,1,0, 33130
5,33132,3,3,1, 33135
30,33133,3,3,1, 33136
6,33135,2,2,1, 33137
7,33137,1,1,1, 33138
17,33144,3,3,1, 33147
24,33154,1,1,0, 33155
1,33156,1,1,1, 33157
5,33157,3,3,1, 33160
6,33160,2,2,1, 33162
31,33161,2,2,1, 33163
7,33162,1,1,0, 33163
29,33163,4,4,1, 33167
8,33166,1,1,1, 33167
16,33169,2,2,1, 33171
14,33169,3,3,1, 33172
15,33171,2,2,1, 33173
24,33179,1,1,1, 33180
23,33178,3,3,1, 33181
21,33177,5,5,1, 33182
1,33181,1,1,0, 33182
5,33182,3,3,1, 33185
6,33185,2,2,1, 33187
25,33185,2,2,1, 33187
31,33186,2,2,1, 33188
7,33187,1,1,0, 33188
26,33187,3,3,1, 33190
29,33188,4,4,1, 33192
8,33191,1,1,0, 33192
9,33192,2,2,1, 33194
16,33194,2,2,1, 33196
17,33194,3,3,1, 33197
18,33198,4,4,1, 33202
22,33201,4,4,1, 33205
2,33203,2,2,1, 33205
24,33204,1,1,1, 33205
23,33203,3,3,1, 33206
1,33206,1,1,1, 33207
30,33208,3,3,1, 33211
6,33210,2,2,1, 33212
25,33210,2,2,1, 33212
31,33211,2,2,1, 33213
7,33212,1,1,1, 33213
26,33212,3,3,1, 33215
29,33213,4,4,1, 33217
8,33216,1,1,1, 33217
9,33217,2,2,1, 33219
16,33219,2,2,1, 33221
14,33219,3,3,1, 33222
17,33219,3,3,1, 33222
13,33219,4,4,1, 33223
15,33221,2,2,1, 33223
20,33223,6,6,1, 33229
22,33226,4,4,1, 33230
2,33228,2,2,1, 33230
24,33229,1,1,1, 33230
19,33226,5,5,1, 33231
23,33228,3,3,1, 33231
1,33231,1,1,1, 33232
4,33231,4,4,1, 33235
5,33232,3,3,1, 33235
27,33232,4,4,1, 33236
6,33235,2,2,1, 33237
7,33237,1,1,0, 33238
26,33237,3,3,1, 33240
29,33238,4,4,1, 33242
8,33241,1,1,0, 33242
14,33244,3,3,1, 33247
13,33244,4,4,1, 33248
15,33246,2,2,1, 33248
18,33248,4,4,1, 33252
2,33253,2,2,1, 33255
24,33254,1,1,0, 33255
19,33251,5,5,1, 33256
23,33253,3,3,1, 33256
21,33252,5,5,1, 33257
1,33256,1,1,0, 33257
5,33257,3,3,1, 33260
27,33257,4,4,1, 33261
30,33258,3,3,1, 33261
6,33260,2,2,1, 33262
31,33261,2,2,1, 33263
7,33262,1,1,0, 33263
28,33259,5,5,1, 33264
26,33262,3,3,1, 33265
8,33266,1,1,1, 33267
15,33271,2,2,1, 33273
12,33270,5,5,1, 33275
22,33276,4,4,1, 33280
2,33278,2,2,1, 33280
24,33279,1,1,0, 33280
21,33277,5,5,1, 33282
1,33281,1,1,1, 33282
5,33282,3,3,1, 33285
27,33282,4,4,1, 33286
30,33283,3,3,1, 33286
7,33287,1,1,1, 33288
28,33284,5,5,1, 33289
29,33288,4,4,1, 33292
8,33291,1,1,1, 33292
24,33304,1,1,1, 33305
23,33303,3,3,1, 33306
21,33302,5,5,1, 33307
8,33316,1,1,0, 33317
13,33319,4,4,1, 33323
22,33326,4,4,1, 33330
24,33329,1,1,1, 33330
8,33341,1,1,1, 33342
16,33344,2,2,1, 33346
13,33344,4,4,1, 33348
22,33351,4,4,1, 33355
24,33354,1,1,0, 33355
21,33352,5,5,1, 33357
24,33379,1,1,1, 33380
24,33404,1,1,1, 33405
1,33406,1,1,0, 33407
30,33408,3,3,1, 33411
6,33410,2,2,1, 33412
25,33410,2,2,1, 33412
31,33411,2,2,1, 33413
7,33412,1,1,1, 33413
29,33413,4,4,1, 33417
24,33429,1,1,0, 33430
1,33431,1,1,0, 33432
30,33433,3,3,1, 33436
6,33435,2,2,1, 33437
31,33436,2,2,1, 33438
7,33437,1,1,0, 33438
24,33454,1,1,0, 33455
1,33456,1,1,0, 33457
6,33460,2,2,1, 33462
7,33462,1,1,1, 33463
26,33462,3,3,1, 33465
8,33466,1,1,0, 33467
16,33469,2,2,1, 33471
17,33469,3,3,1, 33472
15,33471,2,2,1, 33473
18,33473,4,4,1, 33477
24,33479,1,1,0, 33480
23,33478,3,3,1, 33481
21,33477,5,5,1, 33482
1,33481,1,1,1, 33482
6,33485,2,2,1, 33487
25,33485,2,2,1, 33487
7,33487,1,1,0, 33488
29,33488,4,4,1, 33492
8,33491,1,1,0, 33492
16,33494,2,2,1, 33496
17,33494,3,3,1, 33497
13,33494,4,4,1, 33498
15,33496,2,2,1, 33498
2,33503,2,2,1, 33505
24,33504,1,1,0, 33505
19,33501,5,5,1, 33506
23,33503,3,3,1, 33506
21,33502,5,5,1, 33507
1,33506,1,1,1, 33507
3,33507,3,3,1, 33510
30,33508,3,3,1, 33511
25,33510,2,2,1, 33512
7,33512,1,1,1, 33513
26,33512,3,3,1, 33515
8,33516,1,1,0, 33517
9,33517,2,2,1, 33519
17,33519,3,3,1, 33522
13,33519,4,4,1, 33523
12,33520,5,5,1, 33525
18,33523,4,4,1, 33527
20,33523,6,6,1, 33529
22,33526,4,4,1, 33530
24,33529,1,1,1, 33530
19,33526,5,5,1, 33531
23,33528,3,3,1, 33531
21,33527,5,5,1, 33532
1,33531,1,1,0, 33532
5,33532,3,3,1, 33535
30,33533,3,3,1, 33536
25,33535,2,2,1, 33537
7,33537,1,1,0, 33538
26,33537,3,3,1, 33540
8,33541,1,1,1, 33542
16,33544,2,2,1, 33546
14,33544,3,3,1, 33547
17,33544,3,3,1, 33547
15,33546,2,2,1, 33548
12,33545,5,5,1, 33550
18,33548,4,4,1, 33552
20,33548,6,6,1, 33554
2,33553,2,2,1, 33555
24,33554,1,1,1, 33555
19,33551,5,5,1, 33556
21,33552,5,5,1, 33557
1,33556,1,1,0, 33557
4,33556,4,4,1, 33560
3,33557,3,3,1, 33560
5,33557,3,3,1, 33560
30,33558,3,3,1, 33561
6,33560,2,2,1, 33562
31,33561,2,2,1, 33563
7,33562,1,1,0, 33563
29,33563,4,4,1, 33567
8,33566,1,1,0, 33567
22,33576,4,4,1, 33580
24,33579,1,1,0, 33580
21,33577,5,5,1, 33582
5,33582,3,3,1, 33585
31,33586,2,2,1, 33588
7,33587,1,1,0, 33588
29,33588,4,4,1, 33592
8,33591,1,1,1, 33592
15,33596,2,2,1, 33598
24,33604,1,1,0, 33605
23,33603,3,3,1, 33606
5,33607,3,3,1, 33610
31,33611,2,2,1, 33613
7,33612,1,1,0, 33613
29,33613,4,4,1, 33617
8,33616,1,1,1, 33617
13,33619,4,4,1, 33623
22,33626,4,4,1, 33630
24,33629,1,1,1, 33630
23,33628,3,3,1, 33631
30,33633,3,3,1, 33636
31,33636,2,2,1, 33638
7,33637,1,1,0, 33638
29,33638,4,4,1, 33642
8,33641,1,1,1, 33642
16,33644,2,2,1, 33646
13,33644,4,4,1, 33648
15,33646,2,2,1, 33648
24,33654,1,1,0, 33655
23,33653,3,3,1, 33656
21,33652,5,5,1, 33657
30,33658,3,3,1, 33661
6,33660,2,2,1, 33662
7,33662,1,1,0, 33663
9,33667,2,2,1, 33669
24,33679,1,1,1, 33680
1,33681,1,1,0, 33682
5,33682,3,3,1, 33685
6,33685,2,2,1, 33687
25,33685,2,2,1, 33687
31,33686,2,2,1, 33688
7,33687,1,1,0, 33688
29,33688,4,4,1, 33692
9,33692,2,2,1, 33694
24,33704,1,1,0, 33705
1,33706,1,1,1, 33707
5,33707,3,3,1, 33710
30,33708,3,3,1, 33711
7,33712,1,1,1, 33713
28,33709,5,5,1, 33714
18,33723,4,4,1, 33727
2,33728,2,2,1, 33730
24,33729,1,1,0, 33730
1,33731,1,1,1, 33732
31,33736,2,2,1, 33738
7,33737,1,1,1, 33738
29,33738,4,4,1, 33742
9,33742,2,2,1, 33744
17,33744,3,3,1, 33747
2,33753,2,2,1, 33755
24,33754,1,1,1, 33755
1,33756,1,1,0, 33757
30,33758,3,3,1, 33761
31,33761,2,2,1, 33763
7,33762,1,1,0, 33763
26,33762,3,3,1, 33765
8,33766,1,1,0, 33767
9,33767,2,2,1, 33769
16,33769,2,2,1, 33771
14,33769,3,3,1, 33772
13,33769,4,4,1, 33773
22,33776,4,4,1, 33780
2,33778,2,2,1, 33780
24,33779,1,1,1, 33780
1,33781,1,1,0, 33782
7,33787,1,1,1, 33788
26,33787,3,3,1, 33790
8,33791,1,1,1, 33792
16,33794,2,2,1, 33796
14,33794,3,3,1, 33797
17,33794,3,3,1, 33797
18,33798,4,4,1, 33802
2,33803,2,2,1, 33805
24,33804,1,1,1, 33805
1,33806,1,1,0, 33807
5,33807,3,3,1, 33810
30,33808,3,3,1, 33811
25,33810,2,2,1, 33812
7,33812,1,1,1, 33813
26,33812,3,3,1, 33815
29,33813,4,4,1, 33817
8,33816,1,1,0, 33817
16,33819,2,2,1, 33821
17,33819,3,3,1, 33822
12,33820,5,5,1, 33825
20,33823,6,6,1, 33829
24,33829,1,1,0, 33830
21,33827,5,5,1, 33832
1,33831,1,1,1, 33832
4,33831,4,4,1, 33835
3,33832,3,3,1, 33835
27,33832,4,4,1, 33836
7,33837,1,1,1, 33838
28,33834,5,5,1, 33839
26,33837,3,3,1, 33840
8,33841,1,1,1, 33842
16,33844,2,2,1, 33846
13,33844,4,4,1, 33848
24,33854,1,1,0, 33855
19,33851,5,5,1, 33856
21,33852,5,5,1, 33857
1,33856,1,1,0, 33857
4,33856,4,4,1, 33860
5,33857,3,3,1, 33860
27,33857,4,4,1, 33861
30,33858,3,3,1, 33861
25,33860,2,2,1, 33862
31,33861,2,2,1, 33863
7,33862,1,1,0, 33863
26,33862,3,3,1, 33865
8,33866,1,1,0, 33867
16,33869,2,2,1, 33871
13,33869,4,4,1, 33873
15,33871,2,2,1, 33873
22,33876,4,4,1, 33880
24,33879,1,1,1, 33880
23,33878,3,3,1, 33881
21,33877,5,5,1, 33882
30,33883,3,3,1, 33886
7,33887,1,1,1, 33888
8,33891,1,1,0, 33892
14,33894,3,3,1, 33897
15,33896,2,2,1, 33898
24,33904,1,1,1, 33905
21,33902,5,5,1, 33907
5,33907,3,3,1, 33910
31,33911,2,2,1, 33913
7,33912,1,1,0, 33913
29,33913,4,4,1, 33917
8,33916,1,1,0, 33917
22,33926,4,4,1, 33930
24,33929,1,1,1, 33930
21,33927,5,5,1, 33932
5,33932,3,3,1, 33935
30,33933,3,3,1, 33936
31,33936,2,2,1, 33938
7,33937,1,1,0, 33938
8,33941,1,1,1, 33942
22,33951,4,4,1, 33955
24,33954,1,1,1, 33955
5,33957,3,3,1, 33960
31,33961,2,2,1, 33963
7,33962,1,1,1, 33963
8,33966,1,1,1, 33967
16,33969,2,2,1, 33971
13,33969,4,4,1, 33973
15,33971,2,2,1, 33973
22,33976,4,4,1, 33980
24,33979,1,1,0, 33980
21,33977,5,5,1, 33982
1,33981,1,1,0, 33982
30,33983,3,3,1, 33986
6,33985,2,2,1, 33987
25,33985,2,2,1, 33987
31,33986,2,2,1, 33988
7,33987,1,1,0, 33988
29,33988,4,4,1, 33992
8,33991,1,1,0, 33992
9,33992,2,2,1, 33994
14,33994,3,3,1, 33997
17,33994,3,3,1, 33997
13,33994,4,4,1, 33998
24,34004,1,1,0, 34005
21,34002,5,5,1, 34007
1,34006,1,1,1, 34007
30,34008,3,3,1, 34011
25,34010,2,2,1, 34012
31,34011,2,2,1, 34013
7,34012,1,1,0, 34013
29,34013,4,4,1, 34017
8,34016,1,1,0, 34017
16,34019,2,2,1, 34021
14,34019,3,3,1, 34022
17,34019,3,3,1, 34022
24,34029,1,1,1, 34030
1,34031,1,1,0, 34032
5,34032,3,3,1, 34035
30,34033,3,3,1, 34036
6,34035,2,2,1, 34037
7,34037,1,1,0, 34038
17,34044,3,3,1, 34047
18,34048,4,4,1, 34052
2,34053,2,2,1, 34055
24,34054,1,1,0, 34055
1,34056,1,1,0, 34057
5,34057,3,3,1, 34060
30,34058,3,3,1, 34061
7,34062,1,1,0, 34063
26,34062,3,3,1, 34065
29,34063,4,4,1, 34067
17,34069,3,3,1, 34072
18,34073,4,4,1, 34077
24,34079,1,1,0, 34080
1,34081,1,1,0, 34082
25,34085,2,2,1, 34087
7,34087,1,1,1, 34088
18,34098,4,4,1, 34102
24,34104,1,1,1, 34105
1,34106,1,1,0, 34107
25,34110,2,2,1, 34112
7,34112,1,1,1, 34113
26,34112,3,3,1, 34115
29,34113,4,4,1, 34117
18,34123,4,4,1, 34127
24,34129,1,1,1, 34130
1,34131,1,1,1, 34132
25,34135,2,2,1, 34137
31,34136,2,2,1, 34138
7,34137,1,1,0, 34138
29,34138,4,4,1, 34142
8,34141,1,1,1, 34142
16,34144,2,2,1, 34146
17,34144,3,3,1, 34147
15,34146,2,2,1, 34148
12,34145,5,5,1, 34150
20,34148,6,6,1, 34154
22,34151,4,4,1, 34155
2,34153,2,2,1, 34155
24,34154,1,1,1, 34155
21,34152,5,5,1, 34157
1,34156,1,1,1, 34157
3,34157,3,3,1, 34160
27,34157,4,4,1, 34161
6,34160,2,2,1, 34162
7,34162,1,1,0, 34163
26,34162,3,3,1, 34165
8,34166,1,1,1, 34167
11,34164,4,4,1, 34168
9,34167,2,2,1, 34169
18,34173,4,4,1, 34177
22,34176,4,4,1, 34180
24,34179,1,1,0, 34180
19,34176,5,5,1, 34181
21,34177,5,5,1, 34182
1,34181,1,1,0, 34182
3,34182,3,3,1, 34185
5,34182,3,3,1, 34185
31,34186,2,2,1, 34188
7,34187,1,1,1, 34188
28,34184,5,5,1, 34189
29,34188,4,4,1, 34192
8,34191,1,1,1, 34192
17,34194,3,3,1, 34197
13,34194,4,4,1, 34198
22,34201,4,4,1, 34205
24,34204,1,1,1, 34205
19,34201,5,5,1, 34206
21,34202,5,5,1, 34207
1,34206,1,1,1, 34207
5,34207,3,3,1, 34210
27,34207,4,4,1, 34211
6,34210,2,2,1, 34212
7,34212,1,1,1, 34213
28,34209,5,5,1, 34214
8,34216,1,1,1, 34217
13,34219,4,4,1, 34223
22,34226,4,4,1, 34230
24,34229,1,1,0, 34230
23,34228,3,3,1, 34231
31,34236,2,2,1, 34238
7,34237,1,1,1, 34238
29,34238,4,4,1, 34242
8,34241,1,1,1, 34242
16,34244,2,2,1, 34246
14,34244,3,3,1, 34247
13,34244,4,4,1, 34248
24,34254,1,1,1, 34255
21,34252,5,5,1, 34257
5,34257,3,3,1, 34260
30,34258,3,3,1, 34261
31,34261,2,2,1, 34263
7,34262,1,1,0, 34263
29,34263,4,4,1, 34267
8,34266,1,1,0, 34267
13,34269,4,4,1, 34273
24,34279,1,1,0, 34280
21,34277,5,5,1, 34282
30,34283,3,3,1, 34286
31,34286,2,2,1, 34288
7,34287,1,1,0, 34288
8,34291,1,1,1, 34292
14,34294,3,3,1, 34297
15,34296,2,2,1, 34298
22,34301,4,4,1, 34305
24,34304,1,1,1, 34305
21,34302,5,5,1, 34307
5,34307,3,3,1, 34310
30,34308,3,3,1, 34311
6,34310,2,2,1, 34312
31,34311,2,2,1, 34313
7,34312,1,1,1, 34313
8,34316,1,1,1, 34317
14,34319,3,3,1, 34322
17,34319,3,3,1, 34322
22,34326,4,4,1, 34330
24,34329,1,1,0, 34330
23,34328,3,3,1, 34331
21,34327,5,5,1, 34332
1,34331,1,1,0, 34332
25,34335,2,2,1, 34337
8,34341,1,1,0, 34342
9,34342,2,2,1, 34344
16,34344,2,2,1, 34346
17,34344,3,3,1, 34347
13,34344,4,4,1, 34348
15,34346,2,2,1, 34348
22,34351,4,4,1, 34355
24,34354,1,1,1, 34355
21,34352,5,5,1, 34357
1,34356,1,1,1, 34357
8,34366,1,1,0, 34367
24,34379,1,1,0, 34380
21,34377,5,5,1, 34382
1,34381,1,1,0, 34382
8,34391,1,1,1, 34392
9,34392,2,2,1, 34394
14,34394,3,3,1, 34397
17,34394,3,3,1, 34397
13,34394,4,4,1, 34398
18,34398,4,4,1, 34402
24,34404,1,1,1, 34405
1,34406,1,1,0, 34407
25,34410,2,2,1, 34412
26,34412,3,3,1, 34415
9,34417,2,2,1, 34419
17,34419,3,3,1, 34422
18,34423,4,4,1, 34427
24,34429,1,1,0, 34430
1,34431,1,1,0, 34432
25,34435,2,2,1, 34437
31,34436,2,2,1, 34438
7,34437,1,1,0, 34438
29,34438,4,4,1, 34442
9,34442,2,2,1, 34444
18,34448,4,4,1, 34452
24,34454,1,1,0, 34455
1,34456,1,1,1, 34457
25,34460,2,2,1, 34462
7,34462,1,1,0, 34463
29,34463,4,4,1, 34467
9,34467,2,2,1, 34469
18,34473,4,4,1, 34477
24,34479,1,1,1, 34480
1,34481,1,1,0, 34482
30,34483,3,3,1, 34486
7,34487,1,1,0, 34488
9,34492,2,2,1, 34494
17,34494,3,3,1, 34497
18,34498,4,4,1, 34502
24,34504,1,1,0, 34505
21,34502,5,5,1, 34507
1,34506,1,1,1, 34507
4,34506,4,4,1, 34510
3,34507,3,3,1, 34510
5,34507,3,3,1, 34510
30,34508,3,3,1, 34511
7,34512,1,1,1, 34513
26,34512,3,3,1, 34515
29,34513,4,4,1, 34517
8,34516,1,1,1, 34517
9,34517,2,2,1, 34519
14,34519,3,3,1, 34522
13,34519,4,4,1, 34523
12,34520,5,5,1, 34525
20,34523,6,6,1, 34529
2,34528,2,2,1, 34530
24,34529,1,1,1, 34530
1,34531,1,1,0, 34532
4,34531,4,4,1, 34535
3,34532,3,3,1, 34535
30,34533,3,3,1, 34536
6,34535,2,2,1, 34537
31,34536,2,2,1, 34538
7,34537,1,1,1, 34538
28,34534,5,5,1, 34539
26,34537,3,3,1, 34540
8,34541,1,1,1, 34542
24,34554,1,1,1, 34555
23,34553,3,3,1, 34556
30,34558,3,3,1, 34561
7,34562,1,1,1, 34563
29,34563,4,4,1, 34567
8,34566,1,1,1, 34567
16,34569,2,2,1, 34571
14,34569,3,3,1, 34572
15,34571,2,2,1, 34573
22,34576,4,4,1, 34580
24,34579,1,1,1, 34580
23,34578,3,3,1, 34581
21,34577,5,5,1, 34582
5,34582,3,3,1, 34585
30,34583,3,3,1, 34586
31,34586,2,2,1, 34588
7,34587,1,1,0, 34588
8,34591,1,1,0, 34592
16,34594,2,2,1, 34596
24,34604,1,1,0, 34605
23,34603,3,3,1, 34606
21,34602,5,5,1, 34607
30,34608,3,3,1, 34611
7,34612,1,1,0, 34613
29,34613,4,4,1, 34617
8,34616,1,1,0, 34617
13,34619,4,4,1, 34623
22,34626,4,4,1, 34630
24,34629,1,1,0, 34630
23,34628,3,3,1, 34631
7,34637,1,1,0, 34638
8,34641,1,1,1, 34642
16,34644,2,2,1, 34646
14,34644,3,3,1, 34647
13,34644,4,4,1, 34648
15,34646,2,2,1, 34648
22,34651,4,4,1, 34655
24,34654,1,1,1, 34655
23,34653,3,3,1, 34656
1,34656,1,1,0, 34657
30,34658,3,3,1, 34661
25,34660,2,2,1, 34662
7,34662,1,1,0, 34663
8,34666,1,1,0, 34667
16,34669,2,2,1, 34671
17,34669,3,3,1, 34672
24,34679,1,1,1, 34680
1,34681,1,1,0, 34682
5,34682,3,3,1, 34685
6,34685,2,2,1, 34687
7,34687,1,1,1, 34688
8,34691,1,1,0, 34692
9,34692,2,2,1, 34694
16,34694,2,2,1, 34696
14,34694,3,3,1, 34697
17,34694,3,3,1, 34697
15,34696,2,2,1, 34698
24,34704,1,1,0, 34705
23,34703,3,3,1, 34706
1,34706,1,1,1, 34707
5,34707,3,3,1, 34710
25,34710,2,2,1, 34712
31,34711,2,2,1, 34713
7,34712,1,1,0, 34713
8,34716,1,1,1, 34717
9,34717,2,2,1, 34719
16,34719,2,2,1, 34721
17,34719,3,3,1, 34722
24,34729,1,1,0, 34730
21,34727,5,5,1, 34732
1,34731,1,1,1, 34732
6,34735,2,2,1, 34737
25,34735,2,2,1, 34737
7,34737,1,1,0, 34738
29,34738,4,4,1, 34742
8,34741,1,1,0, 34742
13,34744,4,4,1, 34748
12,34745,5,5,1, 34750
18,34748,4,4,1, 34752
20,34748,6,6,1, 34754
22,34751,4,4,1, 34755
24,34754,1,1,0, 34755
19,34751,5,5,1, 34756
23,34753,3,3,1, 34756
1,34756,1,1,0, 34757
5,34757,3,3,1, 34760
30,34758,3,3,1, 34761
6,34760,2,2,1, 34762
25,34760,2,2,1, 34762
7,34762,1,1,0, 34763
8,34766,1,1,0, 34767
14,34769,3,3,1, 34772
17,34769,3,3,1, 34772
13,34769,4,4,1, 34773
15,34771,2,2,1, 34773
18,34773,4,4,1, 34777
2,34778,2,2,1, 34780
24,34779,1,1,0, 34780
21,34777,5,5,1, 34782
1,34781,1,1,0, 34782
25,34785,2,2,1, 34787
7,34787,1,1,0, 34788
8,34791,1,1,1, 34792
18,34798,4,4,1, 34802
2,34803,2,2,1, 34805
24,34804,1,1,0, 34805
1,34806,1,1,0, 34807
6,34810,2,2,1, 34812
25,34810,2,2,1, 34812
7,34812,1,1,1, 34813
26,34812,3,3,1, 34815
8,34816,1,1,0, 34817
9,34817,2,2,1, 34819
15,34821,2,2,1, 34823
22,34826,4,4,1, 34830
24,34829,1,1,1, 34830
23,34828,3,3,1, 34831
1,34831,1,1,1, 34832
5,34832,3,3,1, 34835
6,34835,2,2,1, 34837
25,34835,2,2,1, 34837
7,34837,1,1,0, 34838
26,34837,3,3,1, 34840
8,34841,1,1,1, 34842
14,34844,3,3,1, 34847
13,34844,4,4,1, 34848
18,34848,4,4,1, 34852
2,34853,2,2,1, 34855
24,34854,1,1,0, 34855
23,34853,3,3,1, 34856
1,34856,1,1,1, 34857
4,34856,4,4,1, 34860
27,34857,4,4,1, 34861
6,34860,2,2,1, 34862
31,34861,2,2,1, 34863
7,34862,1,1,1, 34863
28,34859,5,5,1, 34864
26,34862,3,3,1, 34865
17,34869,3,3,1, 34872
24,34879,1,1,0, 34880
19,34876,5,5,1, 34881
1,34881,1,1,0, 34882
4,34881,4,4,1, 34885
30,34883,3,3,1, 34886
7,34887,1,1,0, 34888
24,34904,1,1,1, 34905
5,34907,3,3,1, 34910
30,34908,3,3,1, 34911
6,34910,2,2,1, 34912
31,34911,2,2,1, 34913
7,34912,1,1,1, 34913
24,34929,1,1,0, 34930
6,34935,2,2,1, 34937
7,34937,1,1,0, 34938
29,34938,4,4,1, 34942
24,34954,1,1,0, 34955
5,34957,3,3,1, 34960
30,34958,3,3,1, 34961
31,34961,2,2,1, 34963
7,34962,1,1,0, 34963
8,34966,1,1,0, 34967
14,34969,3,3,1, 34972
13,34969,4,4,1, 34973
24,34979,1,1,1, 34980
21,34977,5,5,1, 34982
6,34985,2,2,1, 34987
7,34987,1,1,0, 34988
29,34988,4,4,1, 34992
8,34991,1,1,1, 34992
9,34992,2,2,1, 34994
14,34994,3,3,1, 34997
17,34994,3,3,1, 34997
22,35001,4,4,1, 35005
24,35004,1,1,1, 35005
1,35006,1,1,0, 35007
7,35012,1,1,1, 35013
8,35016,1,1,0, 35017
9,35017,2,2,1, 35019
16,35019,2,2,1, 35021
14,35019,3,3,1, 35022
15,35021,2,2,1, 35023
22,35026,4,4,1, 35030
24,35029,1,1,0, 35030
21,35027,5,5,1, 35032
1,35031,1,1,1, 35032
30,35033,3,3,1, 35036
6,35035,2,2,1, 35037
25,35035,2,2,1, 35037
31,35036,2,2,1, 35038
7,35037,1,1,1, 35038
8,35041,1,1,0, 35042
9,35042,2,2,1, 35044
14,35044,3,3,1, 35047
17,35044,3,3,1, 35047
13,35044,4,4,1, 35048
24,35054,1,1,1, 35055
23,35053,3,3,1, 35056
21,35052,5,5,1, 35057
1,35056,1,1,0, 35057
6,35060,2,2,1, 35062
7,35062,1,1,0, 35063
29,35063,4,4,1, 35067
8,35066,1,1,1, 35067
14,35069,3,3,1, 35072
22,35076,4,4,1, 35080
24,35079,1,1,0, 35080
1,35081,1,1,1, 35082
30,35083,3,3,1, 35086
25,35085,2,2,1, 35087
7,35087,1,1,0, 35088
26,35087,3,3,1, 35090
8,35091,1,1,1, 35092
9,35092,2,2,1, 35094
14,35094,3,3,1, 35097
17,35094,3,3,1, 35097
18,35098,4,4,1, 35102
2,35103,2,2,1, 35105
24,35104,1,1,1, 35105
23,35103,3,3,1, 35106
21,35102,5,5,1, 35107
1,35106,1,1,0, 35107
5,35107,3,3,1, 35110
30,35108,3,3,1, 35111
6,35110,2,2,1, 35112
7,35112,1,1,1, 35113
8,35116,1,1,1, 35117
9,35117,2,2,1, 35119
17,35119,3,3,1, 35122
22,35126,4,4,1, 35130
24,35129,1,1,0, 35130
1,35131,1,1,0, 35132
5,35132,3,3,1, 35135
6,35135,2,2,1, 35137
25,35135,2,2,1, 35137
31,35136,2,2,1, 35138
7,35137,1,1,1, 35138
29,35138,4,4,1, 35142
8,35141,1,1,1, 35142
16,35144,2,2,1, 35146
14,35144,3,3,1, 35147
15,35146,2,2,1, 35148
22,35151,4,4,1, 35155
24,35154,1,1,0, 35155
1,35156,1,1,1, 35157
5,35157,3,3,1, 35160
30,35158,3,3,1, 35161
7,35162,1,1,0, 35163
26,35162,3,3,1, 35165
29,35163,4,4,1, 35167
8,35166,1,1,0, 35167
17,35169,3,3,1, 35172
15,35171,2,2,1, 35173
18,35173,4,4,1, 35177
20,35173,6,6,1, 35179
22,35176,4,4,1, 35180
2,35178,2,2,1, 35180
24,35179,1,1,0, 35180
1,35181,1,1,1, 35182
3,35182,3,3,1, 35185
27,35182,4,4,1, 35186
30,35183,3,3,1, 35186
6,35185,2,2,1, 35187
25,35185,2,2,1, 35187
7,35187,1,1,0, 35188
28,35184,5,5,1, 35189
29,35188,4,4,1, 35192
8,35191,1,1,1, 35192
11,35189,4,4,1, 35193
16,35194,2,2,1, 35196
14,35194,3,3,1, 35197
17,35194,3,3,1, 35197
13,35194,4,4,1, 35198
15,35196,2,2,1, 35198
18,35198,4,4,1, 35202
22,35201,4,4,1, 35205
2,35203,2,2,1, 35205
24,35204,1,1,0, 35205
23,35203,3,3,1, 35206
21,35202,5,5,1, 35207
1,35206,1,1,1, 35207
5,35207,3,3,1, 35210
6,35210,2,2,1, 35212
31,35211,2,2,1, 35213
7,35212,1,1,1, 35213
28,35209,5,5,1, 35214
26,35212,3,3,1, 35215
29,35213,4,4,1, 35217
17,35219,3,3,1, 35222
12,35220,5,5,1, 35225
18,35223,4,4,1, 35227
24,35229,1,1,0, 35230
5,35232,3,3,1, 35235
7,35237,1,1,1, 35238
24,35254,1,1,1, 35255
7,35262,1,1,0, 35263
24,35279,1,1,0, 35280
5,35282,3,3,1, 35285
30,35283,3,3,1, 35286
6,35285,2,2,1, 35287
7,35287,1,1,1, 35288
29,35288,4,4,1, 35292
24,35304,1,1,0, 35305
30,35308,3,3,1, 35311
7,35312,1,1,1, 35313
8,35316,1,1,1, 35317
15,35321,2,2,1, 35323
22,35326,4,4,1, 35330
24,35329,1,1,1, 35330
1,35331,1,1,1, 35332
25,35335,2,2,1, 35337
31,35336,2,2,1, 35338
7,35337,1,1,0, 35338
29,35338,4,4,1, 35342
8,35341,1,1,0, 35342
9,35342,2,2,1, 35344
16,35344,2,2,1, 35346
13,35344,4,4,1, 35348
15,35346,2,2,1, 35348
24,35354,1,1,1, 35355
1,35356,1,1,0, 35357
30,35358,3,3,1, 35361
7,35362,1,1,0, 35363
29,35363,4,4,1, 35367
8,35366,1,1,0, 35367
9,35367,2,2,1, 35369
16,35369,2,2,1, 35371
14,35369,3,3,1, 35372
15,35371,2,2,1, 35373
24,35379,1,1,0, 35380
23,35378,3,3,1, 35381
1,35381,1,1,0, 35382
6,35385,2,2,1, 35387
7,35387,1,1,0, 35388
8,35391,1,1,1, 35392
9,35392,2,2,1, 35394
16,35394,2,2,1, 35396
17,35394,3,3,1, 35397
13,35394,4,4,1, 35398
24,35404,1,1,0, 35405
23,35403,3,3,1, 35406
21,35402,5,5,1, 35407
1,35406,1,1,1, 35407
5,35407,3,3,1, 35410
6,35410,2,2,1, 35412
31,35411,2,2,1, 35413
7,35412,1,1,0, 35413
8,35416,1,1,0, 35417
14,35419,3,3,1, 35422
17,35419,3,3,1, 35422
2,35428,2,2,1, 35430
24,35429,1,1,0, 35430
1,35431,1,1,0, 35432
31,35436,2,2,1, 35438
7,35437,1,1,0, 35438
26,35437,3,3,1, 35440
8,35441,1,1,0, 35442
18,35448,4,4,1, 35452
22,35451,4,4,1, 35455
24,35454,1,1,0, 35455
21,35452,5,5,1, 35457
1,35456,1,1,0, 35457
5,35457,3,3,1, 35460
30,35458,3,3,1, 35461
25,35460,2,2,1, 35462
31,35461,2,2,1, 35463
7,35462,1,1,0, 35463
26,35462,3,3,1, 35465
8,35466,1,1,0, 35467
9,35467,2,2,1, 35469
17,35469,3,3,1, 35472
13,35469,4,4,1, 35473
18,35473,4,4,1, 35477
22,35476,4,4,1, 35480
2,35478,2,2,1, 35480
24,35479,1,1,1, 35480
1,35481,1,1,1, 35482
31,35486,2,2,1, 35488
7,35487,1,1,1, 35488
26,35487,3,3,1, 35490
8,35491,1,1,0, 35492
9,35492,2,2,1, 35494
16,35494,2,2,1, 35496
13,35494,4,4,1, 35498
2,35503,2,2,1, 35505
24,35504,1,1,0, 35505
1,35506,1,1,1, 35507
3,35507,3,3,1, 35510
27,35507,4,4,1, 35511
30,35508,3,3,1, 35511
6,35510,2,2,1, 35512
25,35510,2,2,1, 35512
7,35512,1,1,0, 35513
26,35512,3,3,1, 35515
29,35513,4,4,1, 35517
8,35516,1,1,1, 35517
16,35519,2,2,1, 35521
14,35519,3,3,1, 35522
15,35521,2,2,1, 35523
2,35528,2,2,1, 35530
24,35529,1,1,0, 35530
19,35526,5,5,1, 35531
23,35528,3,3,1, 35531
21,35527,5,5,1, 35532
1,35531,1,1,0, 35532
3,35532,3,3,1, 35535
27,35532,4,4,1, 35536
30,35533,3,3,1, 35536
31,35536,2,2,1, 35538
7,35537,1,1,0, 35538
28,35534,5,5,1, 35539
8,35541,1,1,0, 35542
9,35542,2,2,1, 35544
16,35544,2,2,1, 35546
12,35545,5,5,1, 35550
18,35548,4,4,1, 35552
20,35548,6,6,1, 35554
22,35551,4,4,1, 35555
2,35553,2,2,1, 35555
24,35554,1,1,0, 35555
23,35553,3,3,1, 35556
30,35558,3,3,1, 35561
7,35562,1,1,0, 35563
8,35566,1,1,1, 35567
16,35569,2,2,1, 35571
13,35569,4,4,1, 35573
15,35571,2,2,1, 35573
22,35576,4,4,1, 35580
24,35579,1,1,0, 35580
21,35577,5,5,1, 35582
5,35582,3,3,1, 35585
30,35583,3,3,1, 35586
6,35585,2,2,1, 35587
7,35587,1,1,1, 35588
29,35588,4,4,1, 35592
8,35591,1,1,0, 35592
16,35594,2,2,1, 35596
14,35594,3,3,1, 35597
24,35604,1,1,1, 35605
30,35608,3,3,1, 35611
6,35610,2,2,1, 35612
7,35612,1,1,0, 35613
29,35613,4,4,1, 35617
24,35629,1,1,0, 35630
30,35633,3,3,1, 35636
7,35637,1,1,0, 35638
29,35638,4,4,1, 35642
24,35654,1,1,1, 35655
5,35657,3,3,1, 35660
30,35658,3,3,1, 35661
6,35660,2,2,1, 35662
7,35662,1,1,1, 35663
9,35667,2,2,1, 35669
17,35669,3,3,1, 35672
24,35679,1,1,0, 35680
1,35681,1,1,0, 35682
6,35685,2,2,1, 35687
31,35686,2,2,1, 35688
7,35687,1,1,0, 35688
9,35692,2,2,1, 35694
22,35701,4,4,1, 35705
24,35704,1,1,0, 35705
21,35702,5,5,1, 35707
1,35706,1,1,1, 35707
31,35711,2,2,1, 35713
7,35712,1,1,0, 35713
29,35713,4,4,1, 35717
8,35716,1,1,1, 35717
16,35719,2,2,1, 35721
17,35719,3,3,1, 35722
15,35721,2,2,1, 35723
18,35723,4,4,1, 35727
2,35728,2,2,1, 35730
24,35729,1,1,0, 35730
1,35731,1,1,0, 35732
30,35733,3,3,1, 35736
31,35736,2,2,1, 35738
7,35737,1,1,1, 35738
29,35738,4,4,1, 35742
8,35741,1,1,0, 35742
16,35744,2,2,1, 35746
17,35744,3,3,1, 35747
18,35748,4,4,1, 35752
20,35748,6,6,1, 35754
24,35754,1,1,1, 35755
19,35751,5,5,1, 35756
23,35753,3,3,1, 35756
21,35752,5,5,1, 35757
1,35756,1,1,0, 35757
5,35757,3,3,1, 35760
27,35757,4,4,1, 35761
30,35758,3,3,1, 35761
7,35762,1,1,1, 35763
29,35763,4,4,1, 35767
8,35766,1,1,0, 35767
9,35767,2,2,1, 35769
16,35769,2,2,1, 35771
13,35769,4,4,1, 35773
12,35770,5,5,1, 35775
18,35773,4,4,1, 35777
20,35773,6,6,1, 35779
22,35776,4,4,1, 35780
24,35779,1,1,0, 35780
19,35776,5,5,1, 35781
23,35778,3,3,1, 35781
21,35777,5,5,1, 35782
1,35781,1,1,1, 35782
4,35781,4,4,1, 35785
6,35785,2,2,1, 35787
25,35785,2,2,1, 35787
31,35786,2,2,1, 35788
7,35787,1,1,1, 35788
26,35787,3,3,1, 35790
29,35788,4,4,1, 35792
8,35791,1,1,0, 35792
9,35792,2,2,1, 35794
17,35794,3,3,1, 35797
13,35794,4,4,1, 35798
15,35796,2,2,1, 35798
12,35795,5,5,1, 35800
20,35798,6,6,1, 35804
22,35801,4,4,1, 35805
2,35803,2,2,1, 35805
24,35804,1,1,0, 35805
19,35801,5,5,1, 35806
21,35802,5,5,1, 35807
1,35806,1,1,1, 35807
4,35806,4,4,1, 35810
30,35808,3,3,1, 35811
31,35811,2,2,1, 35813
7,35812,1,1,1, 35813
29,35813,4,4,1, 35817
8,35816,1,1,1, 35817
14,35819,3,3,1, 35822
22,35826,4,4,1, 35830
24,35829,1,1,1, 35830
23,35828,3,3,1, 35831
21,35827,5,5,1, 35832
30,35833,3,3,1, 35836
7,35837,1,1,0, 35838
8,35841,1,1,0, 35842
16,35844,2,2,1, 35846
13,35844,4,4,1, 35848
15,35846,2,2,1, 35848
24,35854,1,1,1, 35855
23,35853,3,3,1, 35856
21,35852,5,5,1, 35857
5,35857,3,3,1, 35860
30,35858,3,3,1, 35861
6,35860,2,2,1, 35862
7,35862,1,1,1, 35863
8,35866,1,1,1, 35867
24,35879,1,1,0, 35880
23,35878,3,3,1, 35881
5,35882,3,3,1, 35885
30,35883,3,3,1, 35886
7,35887,1,1,0, 35888
24,35904,1,1,0, 35905
30,35908,3,3,1, 35911
6,35910,2,2,1, 35912
31,35911,2,2,1, 35913
7,35912,1,1,1, 35913
9,35917,2,2,1, 35919
24,35929,1,1,0, 35930
1,35931,1,1,0, 35932
5,35932,3,3,1, 35935
25,35935,2,2,1, 35937
31,35936,2,2,1, 35938
7,35937,1,1,0, 35938
29,35938,4,4,1, 35942
9,35942,2,2,1, 35944
24,35954,1,1,1, 35955
1,35956,1,1,1, 35957
30,35958,3,3,1, 35961
25,35960,2,2,1, 35962
7,35962,1,1,0, 35963
17,35969,3,3,1, 35972
18,35973,4,4,1, 35977
24,35979,1,1,1, 35980
1,35981,1,1,1, 35982
6,35985,2,2,1, 35987
7,35987,1,1,0, 35988
8,35991,1,1,0, 35992
15,35996,2,2,1, 35998
18,35998,4,4,1, 36002
20,35998,6,6,1, 36004
22,36001,4,4,1, 36005
2,36003,2,2,1, 36005
24,36004,1,1,1, 36005
23,36003,3,3,1, 36006
21,36002,5,5,1, 36007
1,36006,1,1,1, 36007
3,36007,3,3,1, 36010
30,36008,3,3,1, 36011
6,36010,2,2,1, 36012
25,36010,2,2,1, 36012
7,36012,1,1,0, 36013
29,36013,4,4,1, 36017
8,36016,1,1,0, 36017
14,36019,3,3,1, 36022
17,36019,3,3,1, 36022
15,36021,2,2,1, 36023
24,36029,1,1,1, 36030
19,36026,5,5,1, 36031
23,36028,3,3,1, 36031
21,36027,5,5,1, 36032
1,36031,1,1,0, 36032
3,36032,3,3,1, 36035
30,36033,3,3,1, 36036
25,36035,2,2,1, 36037
31,36036,2,2,1, 36038
7,36037,1,1,0, 36038
26,36037,3,3,1, 36040
8,36041,1,1,0, 36042
11,36039,4,4,1, 36043
16,36044,2,2,1, 36046
15,36046,2,2,1, 36048
18,36048,4,4,1, 36052
22,36051,4,4,1, 36055
24,36054,1,1,0, 36055
19,36051,5,5,1, 36056
21,36052,5,5,1, 36057
1,36056,1,1,1, 36057
5,36057,3,3,1, 36060
30,36058,3,3,1, 36061
6,36060,2,2,1, 36062
31,36061,2,2,1, 36063
7,36062,1,1,0, 36063
29,36063,4,4,1, 36067
8,36066,1,1,0, 36067
11,36064,4,4,1, 36068
16,36069,2,2,1, 36071
14,36069,3,3,1, 36072
15,36071,2,2,1, 36073
12,36070,5,5,1, 36075
2,36078,2,2,1, 36080
24,36079,1,1,1, 36080
23,36078,3,3,1, 36081
1,36081,1,1,0, 36082
4,36081,4,4,1, 36085
27,36082,4,4,1, 36086
6,36085,2,2,1, 36087
31,36086,2,2,1, 36088
7,36087,1,1,1, 36088
8,36091,1,1,0, 36092
9,36092,2,2,1, 36094
14,36094,3,3,1, 36097
18,36098,4,4,1, 36102
24,36104,1,1,0, 36105
19,36101,5,5,1, 36106
1,36106,1,1,1, 36107
30,36108,3,3,1, 36111
25,36110,2,2,1, 36112
31,36111,2,2,1, 36113
7,36112,1,1,1, 36113
28,36109,5,5,1, 36114
8,36116,1,1,0, 36117
11,36114,4,4,1, 36118
16,36119,2,2,1, 36121
13,36119,4,4,1, 36123
22,36126,4,4,1, 36130
24,36129,1,1,1, 36130
31,36136,2,2,1, 36138
7,36137,1,1,0, 36138
29,36138,4,4,1, 36142
8,36141,1,1,0, 36142
16,36144,2,2,1, 36146
13,36144,4,4,1, 36148
15,36146,2,2,1, 36148
22,36151,4,4,1, 36155
24,36154,1,1,1, 36155
30,36158,3,3,1, 36161
6,36160,2,2,1, 36162
7,36162,1,1,0, 36163
8,36166,1,1,1, 36167
14,36169,3,3,1, 36172
13,36169,4,4,1, 36173
15,36171,2,2,1, 36173
22,36176,4,4,1, 36180
24,36179,1,1,0, 36180
30,36183,3,3,1, 36186
7,36187,1,1,0, 36188
24,36204,1,1,1, 36205
5,36207,3,3,1, 36210
30,36208,3,3,1, 36211
7,36212,1,1,0, 36213
24,36229,1,1,0, 36230
1,36231,1,1,1, 36232
27,36232,4,4,1, 36236
30,36233,3,3,1, 36236
25,36235,2,2,1, 36237
31,36236,2,2,1, 36238
7,36237,1,1,1, 36238
28,36234,5,5,1, 36239
29,36238,4,4,1, 36242
9,36242,2,2,1, 36244
18,36248,4,4,1, 36252
20,36248,6,6,1, 36254
2,36253,2,2,1, 36255
24,36254,1,1,1, 36255
19,36251,5,5,1, 36256
1,36256,1,1,0, 36257
5,36257,3,3,1, 36260
30,36258,3,3,1, 36261
6,36260,2,2,1, 36262
25,36260,2,2,1, 36262
31,36261,2,2,1, 36263
7,36262,1,1,0, 36263
29,36263,4,4,1, 36267
24,36279,1,1,1, 36280
1,36281,1,1,1, 36282
8,36291,1,1,1, 36292
9,36292,2,2,1, 36294
16,36294,2,2,1, 36296
17,36294,3,3,1, 36297
22,36301,4,4,1, 36305
24,36304,1,1,1, 36305
23,36303,3,3,1, 36306
21,36302,5,5,1, 36307
1,36306,1,1,1, 36307
8,36316,1,1,1, 36317
16,36319,2,2,1, 36321
14,36319,3,3,1, 36322
24,36329,1,1,0, 36330
23,36328,3,3,1, 36331
1,36331,1,1,0, 36332
8,36341,1,1,1, 36342
24,36354,1,1,0, 36355
1,36356,1,1,1, 36357
26,36362,3,3,1, 36365
8,36366,1,1,0, 36367
16,36369,2,2,1, 36371
14,36369,3,3,1, 36372
18,36373,4,4,1, 36377
2,36378,2,2,1, 36380
24,36379,1,1,0, 36380
1,36381,1,1,1, 36382
5,36382,3,3,1, 36385
6,36385,2,2,1, 36387
25,36385,2,2,1, 36387
31,36386,2,2,1, 36388
7,36387,1,1,0, 36388
26,36387,3,3,1, 36390
8,36391,1,1,0, 36392
9,36392,2,2,1, 36394
16,36394,2,2,1, 36396
17,36394,3,3,1, 36397
15,36396,2,2,1, 36398
2,36403,2,2,1, 36405
24,36404,1,1,0, 36405
23,36403,3,3,1, 36406
21,36402,5,5,1, 36407
1,36406,1,1,1, 36407
30,36408,3,3,1, 36411
7,36412,1,1,0, 36413
8,36416,1,1,1, 36417
9,36417,2,2,1, 36419
16,36419,2,2,1, 36421
17,36419,3,3,1, 36422
13,36419,4,4,1, 36423
22,36426,4,4,1, 36430
24,36429,1,1,1, 36430
23,36428,3,3,1, 36431
1,36431,1,1,0, 36432
5,36432,3,3,1, 36435
30,36433,3,3,1, 36436
25,36435,2,2,1, 36437
7,36437,1,1,1, 36438
26,36437,3,3,1, 36440
29,36438,4,4,1, 36442
8,36441,1,1,1, 36442
9,36442,2,2,1, 36444
16,36444,2,2,1, 36446
14,36444,3,3,1, 36447
12,36445,5,5,1, 36450
18,36448,4,4,1, 36452
20,36448,6,6,1, 36454
24,36454,1,1,0, 36455
19,36451,5,5,1, 36456
21,36452,5,5,1, 36457
1,36456,1,1,0, 36457
5,36457,3,3,1, 36460
6,36460,2,2,1, 36462
7,36462,1,1,0, 36463
28,36459,5,5,1, 36464
29,36463,4,4,1, 36467
8,36466,1,1,0, 36467
11,36464,4,4,1, 36468
9,36467,2,2,1, 36469
14,36469,3,3,1, 36472
17,36469,3,3,1, 36472
13,36469,4,4,1, 36473
15,36471,2,2,1, 36473
18,36473,4,4,1, 36477
2,36478,2,2,1, 36480
24,36479,1,1,1, 36480
19,36476,5,5,1, 36481
21,36477,5,5,1, 36482
30,36483,3,3,1, 36486
31,36486,2,2,1, 36488
7,36487,1,1,0, 36488
29,36488,4,4,1, 36492
8,36491,1,1,0, 36492
16,36494,2,2,1, 36496
14,36494,3,3,1, 36497
13,36494,4,4,1, 36498
22,36501,4,4,1, 36505
24,36504,1,1,1, 36505
21,36502,5,5,1, 36507
6,36510,2,2,1, 36512
7,36512,1,1,0, 36513
29,36513,4,4,1, 36517
8,36516,1,1,1, 36517
16,36519,2,2,1, 36521
13,36519,4,4,1, 36523
15,36521,2,2,1, 36523
24,36529,1,1,1, 36530
7,36537,1,1,0, 36538
29,36538,4,4,1, 36542
8,36541,1,1,1, 36542
14,36544,3,3,1, 36547
24,36554,1,1,1, 36555
31,36561,2,2,1, 36563
7,36562,1,1,1, 36563
24,36579,1,1,1, 36580
30,36583,3,3,1, 36586
6,36585,2,2,1, 36587
31,36586,2,2,1, 36588
7,36587,1,1,1, 36588
29,36588,4,4,1, 36592
9,36592,2,2,1, 36594
24,36604,1,1,1, 36605
1,36606,1,1,0, 36607
30,36608,3,3,1, 36611
7,36612,1,1,0, 36613
29,36613,4,4,1, 36617
17,36619,3,3,1, 36622
24,36629,1,1,1, 36630
1,36631,1,1,0, 36632
5,36632,3,3,1, 36635
31,36636,2,2,1, 36638
7,36637,1,1,1, 36638
29,36638,4,4,1, 36642
9,36642,2,2,1, 36644
17,36644,3,3,1, 36647
22,36651,4,4,1, 36655
24,36654,1,1,0, 36655
1,36656,1,1,0, 36657
5,36657,3,3,1, 36660
6,36660,2,2,1, 36662
7,36662,1,1,1, 36663
8,36666,1,1,1, 36667
11,36664,4,4,1, 36668
16,36669,2,2,1, 36671
15,36671,2,2,1, 36673
12,36670,5,5,1, 36675
2,36678,2,2,1, 36680
24,36679,1,1,0, 36680
19,36676,5,5,1, 36681
21,36677,5,5,1, 36682
1,36681,1,1,1, 36682
30,36683,3,3,1, 36686
25,36685,2,2,1, 36687
7,36687,1,1,0, 36688
29,36688,4,4,1, 36692
8,36691,1,1,0, 36692
11,36689,4,4,1, 36693
16,36694,2,2,1, 36696
14,36694,3,3,1, 36697
12,36695,5,5,1, 36700
18,36698,4,4,1, 36702
20,36698,6,6,1, 36704
22,36701,4,4,1, 36705
2,36703,2,2,1, 36705
24,36704,1,1,1, 36705
21,36702,5,5,1, 36707
1,36706,1,1,0, 36707
5,36707,3,3,1, 36710
25,36710,2,2,1, 36712
31,36711,2,2,1, 36713
7,36712,1,1,0, 36713
29,36713,4,4,1, 36717
8,36716,1,1,0, 36717
16,36719,2,2,1, 36721
14,36719,3,3,1, 36722
17,36719,3,3,1, 36722
13,36719,4,4,1, 36723
18,36723,4,4,1, 36727
24,36729,1,1,1, 36730
23,36728,3,3,1, 36731
1,36731,1,1,0, 36732
30,36733,3,3,1, 36736
6,36735,2,2,1, 36737
25,36735,2,2,1, 36737
7,36737,1,1,1, 36738
26,36737,3,3,1, 36740
8,36741,1,1,1, 36742
9,36742,2,2,1, 36744
15,36746,2,2,1, 36748
18,36748,4,4,1, 36752
24,36754,1,1,1, 36755
1,36756,1,1,1, 36757
5,36757,3,3,1, 36760
30,36758,3,3,1, 36761
6,36760,2,2,1, 36762
31,36761,2,2,1, 36763
7,36762,1,1,1, 36763
8,36766,1,1,1, 36767
9,36767,2,2,1, 36769
16,36769,2,2,1, 36771
14,36769,3,3,1, 36772
17,36769,3,3,1, 36772
24,36779,1,1,0, 36780
23,36778,3,3,1, 36781
21,36777,5,5,1, 36782
1,36781,1,1,1, 36782
5,36782,3,3,1, 36785
30,36783,3,3,1, 36786
6,36785,2,2,1, 36787
31,36786,2,2,1, 36788
7,36787,1,1,0, 36788
26,36787,3,3,1, 36790
8,36791,1,1,1, 36792
9,36792,2,2,1, 36794
17,36794,3,3,1, 36797
13,36794,4,4,1, 36798
15,36796,2,2,1, 36798
18,36798,4,4,1, 36802
22,36801,4,4,1, 36805
2,36803,2,2,1, 36805
24,36804,1,1,1, 36805
23,36803,3,3,1, 36806
1,36806,1,1,0, 36807
3,36807,3,3,1, 36810
30,36808,3,3,1, 36811
25,36810,2,2,1, 36812
31,36811,2,2,1, 36813
7,36812,1,1,0, 36813
28,36809,5,5,1, 36814
8,36816,1,1,1, 36817
11,36814,4,4,1, 36818
14,36819,3,3,1, 36822
22,36826,4,4,1, 36830
24,36829,1,1,0, 36830
23,36828,3,3,1, 36831
30,36833,3,3,1, 36836
6,36835,2,2,1, 36837
31,36836,2,2,1, 36838
7,36837,1,1,0, 36838
8,36841,1,1,0, 36842
13,36844,4,4,1, 36848
22,36851,4,4,1, 36855
24,36854,1,1,1, 36855
6,36860,2,2,1, 36862
31,36861,2,2,1, 36863
7,36862,1,1,0, 36863
8,36866,1,1,0, 36867
16,36869,2,2,1, 36871
15,36871,2,2,1, 36873
24,36879,1,1,0, 36880
23,36878,3,3,1, 36881
30,36883,3,3,1, 36886
7,36887,1,1,1, 36888
8,36891,1,1,0, 36892
16,36894,2,2,1, 36896
15,36896,2,2,1, 36898
24,36904,1,1,1, 36905
21,36902,5,5,1, 36907
30,36908,3,3,1, 36911
6,36910,2,2,1, 36912
7,36912,1,1,0, 36913
29,36913,4,4,1, 36917
8,36916,1,1,1, 36917
16,36919,2,2,1, 36921
17,36919,3,3,1, 36922
13,36919,4,4,1, 36923
24,36929,1,1,1, 36930
1,36931,1,1,0, 36932
5,36932,3,3,1, 36935
6,36935,2,2,1, 36937
31,36936,2,2,1, 36938
7,36937,1,1,1, 36938
17,36944,3,3,1, 36947
24,36954,1,1,1, 36955
1,36956,1,1,0, 36957
30,36958,3,3,1, 36961
6,36960,2,2,1, 36962
31,36961,2,2,1, 36963
7,36962,1,1,0, 36963
17,36969,3,3,1, 36972
24,36979,1,1,1, 36980
1,36981,1,1,1, 36982
6,36985,2,2,1, 36987
25,36985,2,2,1, 36987
7,36987,1,1,1, 36988
29,36988,4,4,1, 36992
9,36992,2,2,1, 36994
17,36994,3,3,1, 36997
2,37003,2,2,1, 37005
24,37004,1,1,1, 37005
1,37006,1,1,1, 37007
30,37008,3,3,1, 37011
6,37010,2,2,1, 37012
31,37011,2,2,1, 37013
7,37012,1,1,0, 37013
29,37013,4,4,1, 37017
22,37026,4,4,1, 37030
24,37029,1,1,1, 37030
21,37027,5,5,1, 37032
1,37031,1,1,1, 37032
5,37032,3,3,1, 37035
30,37033,3,3,1, 37036
31,37036,2,2,1, 37038
26,37037,3,3,1, 37040
8,37041,1,1,0, 37042
9,37042,2,2,1, 37044
16,37044,2,2,1, 37046
17,37044,3,3,1, 37047
15,37046,2,2,1, 37048
18,37048,4,4,1, 37052
22,37051,4,4,1, 37055
24,37054,1,1,1, 37055
23,37053,3,3,1, 37056
1,37056,1,1,0, 37057
25,37060,2,2,1, 37062
26,37062,3,3,1, 37065
8,37066,1,1,1, 37067
9,37067,2,2,1, 37069
16,37069,2,2,1, 37071
17,37069,3,3,1, 37072
13,37069,4,4,1, 37073
12,37070,5,5,1, 37075
2,37078,2,2,1, 37080
24,37079,1,1,1, 37080
1,37081,1,1,1, 37082
25,37085,2,2,1, 37087
28,37084,5,5,1, 37089
8,37091,1,1,1, 37092
14,37094,3,3,1, 37097
17,37094,3,3,1, 37097
18,37098,4,4,1, 37102
20,37098,6,6,1, 37104
24,37104,1,1,1, 37105
19,37101,5,5,1, 37106
23,37103,3,3,1, 37106
1,37106,1,1,1, 37107
4,37106,4,4,1, 37110
3,37107,3,3,1, 37110
25,37110,2,2,1, 37112
26,37112,3,3,1, 37115
8,37116,1,1,1, 37117
11,37114,4,4,1, 37118
17,37119,3,3,1, 37122
13,37119,4,4,1, 37123
18,37123,4,4,1, 37127
20,37123,6,6,1, 37129
2,37128,2,2,1, 37130
24,37129,1,1,0, 37130
23,37128,3,3,1, 37131
21,37127,5,5,1, 37132
8,37141,1,1,1, 37142
15,37146,2,2,1, 37148
24,37154,1,1,1, 37155
23,37153,3,3,1, 37156
6,37160,2,2,1, 37162
31,37161,2,2,1, 37163
7,37162,1,1,1, 37163
8,37166,1,1,0, 37167
14,37169,3,3,1, 37172
22,37176,4,4,1, 37180
24,37179,1,1,1, 37180
21,37177,5,5,1, 37182
6,37185,2,2,1, 37187
31,37186,2,2,1, 37188
7,37187,1,1,0, 37188
29,37188,4,4,1, 37192
8,37191,1,1,0, 37192
16,37194,2,2,1, 37196
14,37194,3,3,1, 37197
13,37194,4,4,1, 37198
24,37204,1,1,0, 37205
21,37202,5,5,1, 37207
30,37208,3,3,1, 37211
6,37210,2,2,1, 37212
31,37211,2,2,1, 37213
7,37212,1,1,1, 37213
8,37216,1,1,0, 37217
16,37219,2,2,1, 37221
14,37219,3,3,1, 37222
15,37221,2,2,1, 37223
22,37226,4,4,1, 37230
24,37229,1,1,1, 37230
21,37227,5,5,1, 37232
5,37232,3,3,1, 37235
30,37233,3,3,1, 37236
31,37236,2,2,1, 37238
7,37237,1,1,1, 37238
29,37238,4,4,1, 37242
8,37241,1,1,0, 37242
9,37242,2,2,1, 37244
22,37251,4,4,1, 37255
24,37254,1,1,0, 37255
21,37252,5,5,1, 37257
1,37256,1,1,0, 37257
5,37257,3,3,1, 37260
30,37258,3,3,1, 37261
25,37260,2,2,1, 37262
31,37261,2,2,1, 37263
7,37262,1,1,1, 37263
29,37263,4,4,1, 37267
8,37266,1,1,1, 37267
9,37267,2,2,1, 37269
16,37269,2,2,1, 37271
13,37269,4,4,1, 37273
22,37276,4,4,1, 37280
24,37279,1,1,0, 37280
23,37278,3,3,1, 37281
21,37277,5,5,1, 37282
1,37281,1,1,0, 37282
6,37285,2,2,1, 37287
7,37287,1,1,0, 37288
29,37288,4,4,1, 37292
9,37292,2,2,1, 37294
24,37304,1,1,0, 37305
1,37306,1,1,1, 37307
5,37307,3,3,1, 37310
6,37310,2,2,1, 37312
25,37310,2,2,1, 37312
7,37312,1,1,0, 37313
9,37317,2,2,1, 37319
24,37329,1,1,0, 37330
1,37331,1,1,1, 37332
5,37332,3,3,1, 37335
30,37333,3,3,1, 37336
6,37335,2,2,1, 37337
31,37336,2,2,1, 37338
7,37337,1,1,0, 37338
26,37337,3,3,1, 37340
29,37338,4,4,1, 37342
9,37342,2,2,1, 37344
2,37353,2,2,1, 37355
24,37354,1,1,1, 37355
1,37356,1,1,0, 37357
30,37358,3,3,1, 37361
31,37361,2,2,1, 37363
7,37362,1,1,0, 37363
29,37363,4,4,1, 37367
17,37369,3,3,1, 37372
18,37373,4,4,1, 37377
24,37379,1,1,1, 37380
1,37381,1,1,1, 37382
5,37382,3,3,1, 37385
7,37387,1,1,0, 37388
26,37387,3,3,1, 37390
29,37388,4,4,1, 37392
8,37391,1,1,1, 37392
9,37392,2,2,1, 37394
13,37394,4,4,1, 37398
15,37396,2,2,1, 37398
12,37395,5,5,1, 37400
20,37398,6,6,1, 37404
2,37403,2,2,1, 37405
24,37404,1,1,0, 37405
21,37402,5,5,1, 37407
1,37406,1,1,0, 37407
4,37406,4,4,1, 37410
3,37407,3,3,1, 37410
25,37410,2,2,1, 37412
31,37411,2,2,1, 37413
7,37412,1,1,0, 37413
28,37409,5,5,1, 37414
26,37412,3,3,1, 37415
8,37416,1,1,1, 37417
16,37419,2,2,1, 37421
18,37423,4,4,1, 37427
20,37423,6,6,1, 37429
2,37428,2,2,1, 37430
24,37429,1,1,0, 37430
19,37426,5,5,1, 37431
23,37428,3,3,1, 37431
21,37427,5,5,1, 37432
1,37431,1,1,0, 37432
4,37431,4,4,1, 37435
30,37433,3,3,1, 37436
7,37437,1,1,0, 37438
28,37434,5,5,1, 37439
8,37441,1,1,1, 37442
11,37439,4,4,1, 37443
9,37442,2,2,1, 37444
16,37444,2,2,1, 37446
12,37445,5,5,1, 37450
18,37448,4,4,1, 37452
22,37451,4,4,1, 37455
24,37454,1,1,0, 37455
23,37453,3,3,1, 37456
21,37452,5,5,1, 37457
5,37457,3,3,1, 37460
6,37460,2,2,1, 37462
7,37462,1,1,1, 37463
29,37463,4,4,1, 37467
8,37466,1,1,1, 37467
16,37469,2,2,1, 37471
14,37469,3,3,1, 37472
22,37476,4,4,1, 37480
24,37479,1,1,1, 37480
6,37485,2,2,1, 37487
7,37487,1,1,0, 37488
8,37491,1,1,0, 37492
16,37494,2,2,1, 37496
22,37501,4,4,1, 37505
24,37504,1,1,0, 37505
23,37503,3,3,1, 37506
21,37502,5,5,1, 37507
5,37507,3,3,1, 37510
7,37512,1,1,1, 37513
29,37513,4,4,1, 37517
8,37516,1,1,0, 37517
16,37519,2,2,1, 37521
22,37526,4,4,1, 37530
24,37529,1,1,0, 37530
23,37528,3,3,1, 37531
7,37537,1,1,1, 37538
8,37541,1,1,1, 37542
14,37544,3,3,1, 37547
24,37554,1,1,1, 37555
23,37553,3,3,1, 37556
5,37557,3,3,1, 37560
31,37561,2,2,1, 37563
7,37562,1,1,1, 37563
8,37566,1,1,1, 37567
14,37569,3,3,1, 37572
24,37579,1,1,1, 37580
23,37578,3,3,1, 37581
21,37577,5,5,1, 37582
1,37581,1,1,1, 37582
25,37585,2,2,1, 37587
7,37587,1,1,1, 37588
8,37591,1,1,1, 37592
17,37594,3,3,1, 37597
15,37596,2,2,1, 37598
24,37604,1,1,0, 37605
1,37606,1,1,1, 37607
30,37608,3,3,1, 37611
6,37610,2,2,1, 37612
25,37610,2,2,1, 37612
7,37612,1,1,1, 37613
29,37613,4,4,1, 37617
8,37616,1,1,0, 37617
9,37617,2,2,1, 37619
15,37621,2,2,1, 37623
22,37626,4,4,1, 37630
24,37629,1,1,1, 37630
23,37628,3,3,1, 37631
21,37627,5,5,1, 37632
1,37631,1,1,0, 37632
25,37635,2,2,1, 37637
7,37637,1,1,1, 37638
26,37637,3,3,1, 37640
8,37641,1,1,1, 37642
9,37642,2,2,1, 37644
16,37644,2,2,1, 37646
14,37644,3,3,1, 37647
17,37644,3,3,1, 37647
24,37654,1,1,1, 37655
21,37652,5,5,1, 37657
1,37656,1,1,0, 37657
5,37657,3,3,1, 37660
25,37660,2,2,1, 37662
31,37661,2,2,1, 37663
7,37662,1,1,1, 37663
26,37662,3,3,1, 37665
8,37666,1,1,1, 37667
11,37664,4,4,1, 37668
16,37669,2,2,1, 37671
14,37669,3,3,1, 37672
17,37669,3,3,1, 37672
13,37669,4,4,1, 37673
15,37671,2,2,1, 37673
22,37676,4,4,1, 37680
24,37679,1,1,1, 37680
21,37677,5,5,1, 37682
1,37681,1,1,0, 37682
4,37681,4,4,1, 37685
3,37682,3,3,1, 37685
5,37682,3,3,1, 37685
27,37682,4,4,1, 37686
6,37685,2,2,1, 37687
31,37686,2,2,1, 37688
7,37687,1,1,0, 37688
11,37689,4,4,1, 37693
17,37694,3,3,1, 37697
18,37698,4,4,1, 37702
20,37698,6,6,1, 37704
24,37704,1,1,1, 37705
1,37706,1,1,1, 37707
5,37707,3,3,1, 37710
27,37707,4,4,1, 37711
6,37710,2,2,1, 37712
31,37711,2,2,1, 37713
7,37712,1,1,0, 37713
29,37713,4,4,1, 37717
11,37714,4,4,1, 37718
9,37717,2,2,1, 37719
2,37728,2,2,1, 37730
24,37729,1,1,1, 37730
19,37726,5,5,1, 37731
1,37731,1,1,1, 37732
4,37731,4,4,1, 37735
3,37732,3,3,1, 37735
5,37732,3,3,1, 37735
30,37733,3,3,1, 37736
31,37736,2,2,1, 37738
7,37737,1,1,0, 37738
29,37738,4,4,1, 37742
17,37744,3,3,1, 37747
12,37745,5,5,1, 37750
18,37748,4,4,1, 37752
24,37754,1,1,0, 37755
5,37757,3,3,1, 37760
7,37762,1,1,0, 37763
24,37779,1,1,1, 37780
5,37782,3,3,1, 37785
6,37785,2,2,1, 37787
7,37787,1,1,0, 37788
8,37791,1,1,1, 37792
22,37801,4,4,1, 37805
24,37804,1,1,0, 37805
23,37803,3,3,1, 37806
6,37810,2,2,1, 37812
7,37812,1,1,1, 37813
29,37813,4,4,1, 37817
8,37816,1,1,0, 37817
16,37819,2,2,1, 37821
14,37819,3,3,1, 37822
22,37826,4,4,1, 37830
24,37829,1,1,0, 37830
23,37828,3,3,1, 37831
5,37832,3,3,1, 37835
6,37835,2,2,1, 37837
31,37836,2,2,1, 37838
7,37837,1,1,1, 37838
8,37841,1,1,1, 37842
15,37846,2,2,1, 37848
24,37854,1,1,1, 37855
21,37852,5,5,1, 37857
1,37856,1,1,1, 37857
30,37858,3,3,1, 37861
6,37860,2,2,1, 37862
25,37860,2,2,1, 37862
31,37861,2,2,1, 37863
7,37862,1,1,0, 37863
8,37866,1,1,1, 37867
17,37869,3,3,1, 37872
13,37869,4,4,1, 37873
15,37871,2,2,1, 37873
24,37879,1,1,1, 37880
1,37881,1,1,0, 37882
5,37882,3,3,1, 37885
30,37883,3,3,1, 37886
25,37885,2,2,1, 37887
31,37886,2,2,1, 37888
7,37887,1,1,1, 37888
29,37888,4,4,1, 37892
8,37891,1,1,0, 37892
16,37894,2,2,1, 37896
14,37894,3,3,1, 37897
15,37896,2,2,1, 37898
24,37904,1,1,1, 37905
21,37902,5,5,1, 37907
1,37906,1,1,0, 37907
30,37908,3,3,1, 37911
6,37910,2,2,1, 37912
31,37911,2,2,1, 37913
7,37912,1,1,1, 37913
26,37912,3,3,1, 37915
8,37916,1,1,1, 37917
16,37919,2,2,1, 37921
13,37919,4,4,1, 37923
2,37928,2,2,1, 37930
24,37929,1,1,1, 37930
1,37931,1,1,1, 37932
5,37932,3,3,1, 37935
25,37935,2,2,1, 37937
7,37937,1,1,0, 37938
26,37937,3,3,1, 37940
8,37941,1,1,0, 37942
17,37944,3,3,1, 37947
13,37944,4,4,1, 37948
22,37951,4,4,1, 37955
2,37953,2,2,1, 37955
24,37954,1,1,0, 37955
21,37952,5,5,1, 37957
1,37956,1,1,1, 37957
5,37957,3,3,1, 37960
6,37960,2,2,1, 37962
25,37960,2,2,1, 37962
7,37962,1,1,1, 37963
8,37966,1,1,1, 37967
11,37964,4,4,1, 37968
16,37969,2,2,1, 37971
14,37969,3,3,1, 37972
15,37971,2,2,1, 37973
12,37970,5,5,1, 37975
24,37979,1,1,0, 37980
19,37976,5,5,1, 37981
1,37981,1,1,1, 37982
4,37981,4,4,1, 37985
3,37982,3,3,1, 37985
27,37982,4,4,1, 37986
30,37983,3,3,1, 37986
6,37985,2,2,1, 37987
31,37986,2,2,1, 37988
7,37987,1,1,0, 37988
28,37984,5,5,1, 37989
29,37988,4,4,1, 37992
8,37991,1,1,1, 37992
9,37992,2,2,1, 37994
14,37994,3,3,1, 37997
15,37996,2,2,1, 37998
18,37998,4,4,1, 38002
20,37998,6,6,1, 38004
22,38001,4,4,1, 38005
2,38003,2,2,1, 38005
24,38004,1,1,0, 38005
21,38002,5,5,1, 38007
1,38006,1,1,0, 38007
3,38007,3,3,1, 38010
5,38007,3,3,1, 38010
27,38007,4,4,1, 38011
31,38011,2,2,1, 38013
7,38012,1,1,1, 38013
29,38013,4,4,1, 38017
8,38016,1,1,0, 38017
11,38014,4,4,1, 38018
16,38019,2,2,1, 38021
17,38019,3,3,1, 38022
13,38019,4,4,1, 38023
2,38028,2,2,1, 38030
24,38029,1,1,0, 38030
23,38028,3,3,1, 38031
1,38031,1,1,1, 38032
3,38032,3,3,1, 38035
27,38032,4,4,1, 38036
31,38036,2,2,1, 38038
7,38037,1,1,0, 38038
8,38041,1,1,0, 38042
16,38044,2,2,1, 38046
14,38044,3,3,1, 38047
15,38046,2,2,1, 38048
22,38051,4,4,1, 38055
24,38054,1,1,1, 38055
30,38058,3,3,1, 38061
7,38062,1,1,0, 38063
29,38063,4,4,1, 38067
8,38066,1,1,0, 38067
16,38069,2,2,1, 38071
13,38069,4,4,1, 38073
15,38071,2,2,1, 38073
24,38079,1,1,1, 38080
30,38083,3,3,1, 38086
6,38085,2,2,1, 38087
31,38086,2,2,1, 38088
7,38087,1,1,1, 38088
24,38104,1,1,1, 38105
5,38107,3,3,1, 38110
6,38110,2,2,1, 38112
7,38112,1,1,0, 38113
24,38129,1,1,0, 38130
7,38137,1,1,1, 38138
29,38138,4,4,1, 38142
11,38139,4,4,1, 38143
9,38142,2,2,1, 38144
17,38144,3,3,1, 38147
12,38145,5,5,1, 38150
20,38148,6,6,1, 38154
2,38153,2,2,1, 38155
24,38154,1,1,0, 38155
1,38156,1,1,0, 38157
4,38156,4,4,1, 38160
5,38157,3,3,1, 38160
31,38161,2,2,1, 38163
7,38162,1,1,1, 38163
29,38163,4,4,1, 38167
24,38179,1,1,0, 38180
21,38177,5,5,1, 38182
1,38181,1,1,1, 38182
5,38182,3,3,1, 38185
30,38183,3,3,1, 38186
7,38187,1,1,1, 38188
29,38188,4,4,1, 38192
8,38191,1,1,0, 38192
9,38192,2,2,1, 38194
16,38194,2,2,1, 38196
13,38194,4,4,1, 38198
15,38196,2,2,1, 38198
24,38204,1,1,1, 38205
23,38203,3,3,1, 38206
1,38206,1,1,0, 38207
5,38207,3,3,1, 38210
31,38211,2,2,1, 38213
7,38212,1,1,0, 38213
8,38216,1,1,0, 38217
9,38217,2,2,1, 38219
15,38221,2,2,1, 38223
22,38226,4,4,1, 38230
24,38229,1,1,1, 38230
23,38228,3,3,1, 38231
1,38231,1,1,0, 38232
25,38235,2,2,1, 38237
8,38241,1,1,0, 38242
9,38242,2,2,1, 38244
14,38244,3,3,1, 38247
22,38251,4,4,1, 38255
24,38254,1,1,0, 38255
23,38253,3,3,1, 38256
1,38256,1,1,1, 38257
8,38266,1,1,1, 38267
9,38267,2,2,1, 38269
14,38269,3,3,1, 38272
2,38278,2,2,1, 38280
24,38279,1,1,0, 38280
1,38281,1,1,0, 38282
26,38287,3,3,1, 38290
8,38291,1,1,0, 38292
9,38292,2,2,1, 38294
2,38303,2,2,1, 38305
24,38304,1,1,0, 38305
23,38303,3,3,1, 38306
1,38306,1,1,1, 38307
25,38310,2,2,1, 38312
26,38312,3,3,1, 38315
8,38316,1,1,0, 38317
9,38317,2,2,1, 38319
14,38319,3,3,1, 38322
17,38319,3,3,1, 38322
18,38323,4,4,1, 38327
24,38329,1,1,0, 38330
21,38327,5,5,1, 38332
1,38331,1,1,0, 38332
7,38337,1,1,0, 38338
28,38334,5,5,1, 38339
26,38337,3,3,1, 38340
8,38341,1,1,1, 38342
11,38339,4,4,1, 38343
15,38346,2,2,1, 38348
18,38348,4,4,1, 38352
20,38348,6,6,1, 38354
24,38354,1,1,0, 38355
1,38356,1,1,0, 38357
4,38356,4,4,1, 38360
3,38357,3,3,1, 38360
30,38358,3,3,1, 38361
31,38361,2,2,1, 38363
7,38362,1,1,0, 38363
28,38359,5,5,1, 38364
26,38362,3,3,1, 38365
8,38366,1,1,1, 38367
15,38371,2,2,1, 38373
12,38370,5,5,1, 38375
18,38373,4,4,1, 38377
22,38376,4,4,1, 38380
2,38378,2,2,1, 38380
24,38379,1,1,0, 38380
23,38378,3,3,1, 38381
21,38377,5,5,1, 38382
1,38381,1,1,0, 38382
4,38381,4,4,1, 38385
5,38382,3,3,1, 38385
27,38382,4,4,1, 38386
7,38387,1,1,1, 38388
8,38391,1,1,1, 38392
14,38394,3,3,1, 38397
13,38394,4,4,1, 38398
15,38396,2,2,1, 38398
24,38404,1,1,1, 38405
23,38403,3,3,1, 38406
5,38407,3,3,1, 38410
30,38408,3,3,1, 38411
6,38410,2,2,1, 38412
7,38412,1,1,0, 38413
29,38413,4,4,1, 38417
8,38416,1,1,1, 38417
14,38419,3,3,1, 38422
15,38421,2,2,1, 38423
24,38429,1,1,0, 38430
23,38428,3,3,1, 38431
21,38427,5,5,1, 38432
5,38432,3,3,1, 38435
6,38435,2,2,1, 38437
7,38437,1,1,1, 38438
29,38438,4,4,1, 38442
8,38441,1,1,0, 38442
15,38446,2,2,1, 38448
24,38454,1,1,1, 38455
5,38457,3,3,1, 38460
30,38458,3,3,1, 38461
6,38460,2,2,1, 38462
31,38461,2,2,1, 38463
7,38462,1,1,0, 38463
8,38466,1,1,1, 38467
14,38469,3,3,1, 38472
13,38469,4,4,1, 38473
22,38476,4,4,1, 38480
24,38479,1,1,1, 38480
6,38485,2,2,1, 38487
31,38486,2,2,1, 38488
7,38487,1,1,1, 38488
8,38491,1,1,1, 38492
17,38494,3,3,1, 38497
13,38494,4,4,1, 38498
15,38496,2,2,1, 38498
24,38504,1,1,1, 38505
21,38502,5,5,1, 38507
1,38506,1,1,1, 38507
5,38507,3,3,1, 38510
25,38510,2,2,1, 38512
31,38511,2,2,1, 38513
7,38512,1,1,1, 38513
29,38513,4,4,1, 38517
8,38516,1,1,0, 38517
17,38519,3,3,1, 38522
13,38519,4,4,1, 38523
22,38526,4,4,1, 38530
24,38529,1,1,1, 38530
21,38527,5,5,1, 38532
1,38531,1,1,0, 38532
30,38533,3,3,1, 38536
6,38535,2,2,1, 38537
25,38535,2,2,1, 38537
7,38537,1,1,0, 38538
26,38537,3,3,1, 38540
29,38538,4,4,1, 38542
8,38541,1,1,0, 38542
9,38542,2,2,1, 38544
17,38544,3,3,1, 38547
13,38544,4,4,1, 38548
15,38546,2,2,1, 38548
22,38551,4,4,1, 38555
24,38554,1,1,1, 38555
23,38553,3,3,1, 38556
21,38552,5,5,1, 38557
1,38556,1,1,1, 38557
30,38558,3,3,1, 38561
6,38560,2,2,1, 38562
7,38562,1,1,0, 38563
26,38562,3,3,1, 38565
29,38563,4,4,1, 38567
8,38566,1,1,1, 38567
9,38567,2,2,1, 38569
13,38569,4,4,1, 38573
18,38573,4,4,1, 38577
22,38576,4,4,1, 38580
24,38579,1,1,1, 38580
23,38578,3,3,1, 38581
21,38577,5,5,1, 38582
1,38581,1,1,0, 38582
30,38583,3,3,1, 38586
25,38585,2,2,1, 38587
7,38587,1,1,0, 38588
26,38587,3,3,1, 38590
29,38588,4,4,1, 38592
9,38592,2,2,1, 38594
2,38603,2,2,1, 38605
24,38604,1,1,1, 38605
1,38606,1,1,0, 38607
3,38607,3,3,1, 38610
27,38607,4,4,1, 38611
30,38608,3,3,1, 38611
25,38610,2,2,1, 38612
7,38612,1,1,0, 38613
28,38609,5,5,1, 38614
11,38614,4,4,1, 38618
12,38620,5,5,1, 38625
24,38629,1,1,0, 38630
1,38631,1,1,1, 38632
5,38632,3,3,1, 38635
31,38636,2,2,1, 38638
7,38637,1,1,1, 38638
29,38638,4,4,1, 38642
20,38648,6,6,1, 38654
24,38654,1,1,1, 38655
19,38651,5,5,1, 38656
1,38656,1,1,0, 38657
4,38656,4,4,1, 38660
3,38657,3,3,1, 38660
30,38658,3,3,1, 38661
6,38660,2,2,1, 38662
7,38662,1,1,0, 38663
26,38662,3,3,1, 38665
11,38664,4,4,1, 38668
9,38667,2,2,1, 38669
12,38670,5,5,1, 38675
20,38673,6,6,1, 38679
24,38679,1,1,1, 38680
19,38676,5,5,1, 38681
5,38682,3,3,1, 38685
31,38686,2,2,1, 38688
7,38687,1,1,1, 38688
8,38691,1,1,0, 38692
16,38694,2,2,1, 38696
14,38694,3,3,1, 38697
15,38696,2,2,1, 38698
22,38701,4,4,1, 38705
24,38704,1,1,0, 38705
21,38702,5,5,1, 38707
5,38707,3,3,1, 38710
6,38710,2,2,1, 38712
31,38711,2,2,1, 38713
7,38712,1,1,0, 38713
8,38716,1,1,0, 38717
15,38721,2,2,1, 38723
22,38726,4,4,1, 38730
24,38729,1,1,0, 38730
21,38727,5,5,1, 38732
30,38733,3,3,1, 38736
6,38735,2,2,1, 38737
7,38737,1,1,0, 38738
8,38741,1,1,0, 38742
16,38744,2,2,1, 38746
13,38744,4,4,1, 38748
15,38746,2,2,1, 38748
22,38751,4,4,1, 38755
24,38754,1,1,0, 38755
23,38753,3,3,1, 38756
21,38752,5,5,1, 38757
5,38757,3,3,1, 38760
6,38760,2,2,1, 38762
7,38762,1,1,1, 38763
29,38763,4,4,1, 38767
8,38766,1,1,0, 38767
15,38771,2,2,1, 38773
24,38779,1,1,1, 38780
21,38777,5,5,1, 38782
5,38782,3,3,1, 38785
7,38787,1,1,0, 38788
8,38791,1,1,1, 38792
9,38792,2,2,1, 38794
16,38794,2,2,1, 38796
17,38794,3,3,1, 38797
24,38804,1,1,0, 38805
23,38803,3,3,1, 38806
21,38802,5,5,1, 38807
1,38806,1,1,0, 38807
5,38807,3,3,1, 38810
30,38808,3,3,1, 38811
6,38810,2,2,1, 38812
31,38811,2,2,1, 38813
7,38812,1,1,0, 38813
29,38813,4,4,1, 38817
8,38816,1,1,1, 38817
14,38819,3,3,1, 38822
17,38819,3,3,1, 38822
15,38821,2,2,1, 38823
24,38829,1,1,1, 38830
23,38828,3,3,1, 38831
21,38827,5,5,1, 38832
1,38831,1,1,1, 38832
30,38833,3,3,1, 38836
6,38835,2,2,1, 38837
31,38836,2,2,1, 38838
7,38837,1,1,1, 38838
8,38841,1,1,1, 38842
17,38844,3,3,1, 38847
13,38844,4,4,1, 38848
22,38851,4,4,1, 38855
24,38854,1,1,1, 38855
23,38853,3,3,1, 38856
1,38856,1,1,1, 38857
25,38860,2,2,1, 38862
7,38862,1,1,0, 38863
29,38863,4,4,1, 38867
8,38866,1,1,0, 38867
9,38867,2,2,1, 38869
18,38873,4,4,1, 38877
24,38879,1,1,0, 38880
23,38878,3,3,1, 38881
1,38881,1,1,1, 38882
7,38887,1,1,0, 38888
28,38884,5,5,1, 38889
29,38888,4,4,1, 38892
8,38891,1,1,1, 38892
11,38889,4,4,1, 38893
16,38894,2,2,1, 38896
17,38894,3,3,1, 38897
24,38904,1,1,1, 38905
19,38901,5,5,1, 38906
23,38903,3,3,1, 38906
1,38906,1,1,0, 38907
4,38906,4,4,1, 38910
27,38907,4,4,1, 38911
6,38910,2,2,1, 38912
25,38910,2,2,1, 38912
31,38911,2,2,1, 38913
7,38912,1,1,1, 38913
28,38909,5,5,1, 38914
26,38912,3,3,1, 38915
29,38913,4,4,1, 38917
8,38916,1,1,0, 38917
17,38919,3,3,1, 38922
12,38920,5,5,1, 38925
18,38923,4,4,1, 38927
2,38928,2,2,1, 38930
24,38929,1,1,1, 38930
19,38926,5,5,1, 38931
23,38928,3,3,1, 38931
21,38927,5,5,1, 38932
1,38931,1,1,0, 38932
30,38933,3,3,1, 38936
6,38935,2,2,1, 38937
25,38935,2,2,1, 38937
31,38936,2,2,1, 38938
7,38937,1,1,1, 38938
28,38934,5,5,1, 38939
8,38941,1,1,1, 38942
11,38939,4,4,1, 38943
16,38944,2,2,1, 38946
17,38944,3,3,1, 38947
18,38948,4,4,1, 38952
20,38948,6,6,1, 38954
24,38954,1,1,0, 38955
19,38951,5,5,1, 38956
5,38957,3,3,1, 38960
30,38958,3,3,1, 38961
7,38962,1,1,1, 38963
29,38963,4,4,1, 38967
24,38979,1,1,0, 38980
5,38982,3,3,1, 38985
30,38983,3,3,1, 38986
31,38986,2,2,1, 38988
7,38987,1,1,0, 38988
24,39004,1,1,1, 39005
5,39007,3,3,1, 39010
7,39012,1,1,0, 39013
24,39029,1,1,0, 39030
31,39036,2,2,1, 39038
7,39037,1,1,0, 39038
24,39054,1,1,1, 39055
21,39052,5,5,1, 39057
5,39057,3,3,1, 39060
7,39062,1,1,1, 39063
8,39066,1,1,1, 39067
9,39067,2,2,1, 39069
16,39069,2,2,1, 39071
14,39069,3,3,1, 39072
15,39071,2,2,1, 39073
22,39076,4,4,1, 39080
24,39079,1,1,1, 39080
23,39078,3,3,1, 39081
1,39081,1,1,1, 39082
6,39085,2,2,1, 39087
25,39085,2,2,1, 39087
7,39087,1,1,1, 39088
29,39088,4,4,1, 39092
8,39091,1,1,1, 39092
16,39094,2,2,1, 39096
13,39094,4,4,1, 39098
15,39096,2,2,1, 39098
2,39103,2,2,1, 39105
24,39104,1,1,0, 39105
23,39103,3,3,1, 39106
1,39106,1,1,1, 39107
5,39107,3,3,1, 39110
30,39108,3,3,1, 39111
6,39110,2,2,1, 39112
25,39110,2,2,1, 39112
7,39112,1,1,0, 39113
26,39112,3,3,1, 39115
29,39113,4,4,1, 39117
8,39116,1,1,0, 39117
9,39117,2,2,1, 39119
13,39119,4,4,1, 39123
15,39121,2,2,1, 39123
22,39126,4,4,1, 39130
24,39129,1,1,1, 39130
1,39131,1,1,1, 39132
30,39133,3,3,1, 39136
6,39135,2,2,1, 39137
25,39135,2,2,1, 39137
7,39137,1,1,0, 39138
26,39137,3,3,1, 39140
29,39138,4,4,1, 39142
8,39141,1,1,1, 39142
9,39142,2,2,1, 39144
13,39144,4,4,1, 39148
15,39146,2,2,1, 39148
2,39153,2,2,1, 39155
24,39154,1,1,0, 39155
21,39152,5,5,1, 39157
1,39156,1,1,0, 39157
5,39157,3,3,1, 39160
30,39158,3,3,1, 39161
6,39160,2,2,1, 39162
7,39162,1,1,0, 39163
26,39162,3,3,1, 39165
29,39163,4,4,1, 39167
8,39166,1,1,0, 39167
9,39167,2,2,1, 39169
16,39169,2,2,1, 39171
13,39169,4,4,1, 39173
15,39171,2,2,1, 39173
18,39173,4,4,1, 39177
20,39173,6,6,1, 39179
24,39179,1,1,0, 39180
23,39178,3,3,1, 39181
1,39181,1,1,0, 39182
27,39182,4,4,1, 39186
7,39187,1,1,0, 39188
28,39184,5,5,1, 39189
8,39191,1,1,1, 39192
11,39189,4,4,1, 39193
9,39192,2,2,1, 39194
16,39194,2,2,1, 39196
18,39198,4,4,1, 39202
20,39198,6,6,1, 39204
22,39201,4,4,1, 39205
2,39203,2,2,1, 39205
24,39204,1,1,0, 39205
21,39202,5,5,1, 39207
1,39206,1,1,0, 39207
30,39208,3,3,1, 39211
6,39210,2,2,1, 39212
25,39210,2,2,1, 39212
7,39212,1,1,1, 39213
26,39212,3,3,1, 39215
29,39213,4,4,1, 39217
8,39216,1,1,1, 39217
11,39214,4,4,1, 39218
16,39219,2,2,1, 39221
17,39219,3,3,1, 39222
13,39219,4,4,1, 39223
20,39223,6,6,1, 39229
22,39226,4,4,1, 39230
24,39229,1,1,1, 39230
19,39226,5,5,1, 39231
1,39231,1,1,1, 39232
4,39231,4,4,1, 39235
3,39232,3,3,1, 39235
31,39236,2,2,1, 39238
7,39237,1,1,1, 39238
8,39241,1,1,0, 39242
16,39244,2,2,1, 39246
14,39244,3,3,1, 39247
24,39254,1,1,0, 39255
5,39257,3,3,1, 39260
30,39258,3,3,1, 39261
6,39260,2,2,1, 39262
31,39261,2,2,1, 39263
7,39262,1,1,0, 39263
29,39263,4,4,1, 39267
8,39266,1,1,1, 39267
14,39269,3,3,1, 39272
13,39269,4,4,1, 39273
22,39276,4,4,1, 39280
24,39279,1,1,0, 39280
21,39277,5,5,1, 39282
8,39291,1,1,1, 39292
16,39294,2,2,1, 39296
14,39294,3,3,1, 39297
24,39304,1,1,1, 39305
24,39329,1,1,0, 39330
24,39354,1,1,1, 39355
1,39356,1,1,0, 39357
17,39369,3,3,1, 39372
24,39379,1,1,1, 39380
1,39381,1,1,1, 39382
5,39382,3,3,1, 39385
30,39383,3,3,1, 39386
25,39385,2,2,1, 39387
31,39386,2,2,1, 39388
7,39387,1,1,1, 39388
17,39394,3,3,1, 39397
24,39404,1,1,0, 39405
21,39402,5,5,1, 39407
1,39406,1,1,1, 39407
25,39410,2,2,1, 39412
7,39412,1,1,0, 39413
8,39416,1,1,0, 39417
14,39419,3,3,1, 39422
18,39423,4,4,1, 39427
22,39426,4,4,1, 39430
2,39428,2,2,1, 39430
24,39429,1,1,1, 39430
1,39431,1,1,0, 39432
5,39432,3,3,1, 39435
25,39435,2,2,1, 39437
7,39437,1,1,1, 39438
8,39441,1,1,1, 39442
16,39444,2,2,1, 39446
17,39444,3,3,1, 39447
24,39454,1,1,0, 39455
21,39452,5,5,1, 39457
1,39456,1,1,1, 39457
30,39458,3,3,1, 39461
7,39462,1,1,1, 39463
26,39462,3,3,1, 39465
29,39463,4,4,1, 39467
8,39466,1,1,1, 39467
9,39467,2,2,1, 39469
16,39469,2,2,1, 39471
17,39469,3,3,1, 39472
13,39469,4,4,1, 39473
12,39470,5,5,1, 39475
18,39473,4,4,1, 39477
20,39473,6,6,1, 39479
24,39479,1,1,1, 39480
19,39476,5,5,1, 39481
1,39481,1,1,0, 39482
6,39485,2,2,1, 39487
25,39485,2,2,1, 39487
31,39486,2,2,1, 39488
7,39487,1,1,0, 39488
28,39484,5,5,1, 39489
26,39487,3,3,1, 39490
29,39488,4,4,1, 39492
8,39491,1,1,0, 39492
11,39489,4,4,1, 39493
9,39492,2,2,1, 39494
17,39494,3,3,1, 39497
15,39496,2,2,1, 39498
18,39498,4,4,1, 39502
24,39504,1,1,1, 39505
23,39503,3,3,1, 39506
1,39506,1,1,0, 39507
4,39506,4,4,1, 39510
7,39512,1,1,1, 39513
8,39516,1,1,0, 39517
9,39517,2,2,1, 39519
17,39519,3,3,1, 39522
13,39519,4,4,1, 39523
18,39523,4,4,1, 39527
2,39528,2,2,1, 39530
24,39529,1,1,1, 39530
23,39528,3,3,1, 39531
21,39527,5,5,1, 39532
1,39531,1,1,1, 39532
4,39531,4,4,1, 39535
3,39532,3,3,1, 39535
5,39532,3,3,1, 39535
27,39532,4,4,1, 39536
30,39533,3,3,1, 39536
6,39535,2,2,1, 39537
7,39537,1,1,1, 39538
29,39538,4,4,1, 39542
8,39541,1,1,0, 39542
14,39544,3,3,1, 39547
22,39551,4,4,1, 39555
24,39554,1,1,0, 39555
21,39552,5,5,1, 39557
5,39557,3,3,1, 39560
30,39558,3,3,1, 39561
6,39560,2,2,1, 39562
31,39561,2,2,1, 39563
7,39562,1,1,1, 39563
8,39566,1,1,0, 39567
16,39569,2,2,1, 39571
14,39569,3,3,1, 39572
13,39569,4,4,1, 39573
22,39576,4,4,1, 39580
24,39579,1,1,1, 39580
21,39577,5,5,1, 39582
31,39586,2,2,1, 39588
7,39587,1,1,1, 39588
29,39588,4,4,1, 39592
8,39591,1,1,0, 39592
16,39594,2,2,1, 39596
14,39594,3,3,1, 39597
13,39594,4,4,1, 39598
22,39601,4,4,1, 39605
24,39604,1,1,1, 39605
21,39602,5,5,1, 39607
5,39607,3,3,1, 39610
30,39608,3,3,1, 39611
6,39610,2,2,1, 39612
7,39612,1,1,0, 39613
29,39613,4,4,1, 39617
8,39616,1,1,1, 39617
16,39619,2,2,1, 39621
14,39619,3,3,1, 39622
22,39626,4,4,1, 39630
24,39629,1,1,1, 39630
21,39627,5,5,1, 39632
30,39633,3,3,1, 39636
31,39636,2,2,1, 39638
7,39637,1,1,0, 39638
8,39641,1,1,0, 39642
9,39642,2,2,1, 39644
16,39644,2,2,1, 39646
17,39644,3,3,1, 39647
13,39644,4,4,1, 39648
15,39646,2,2,1, 39648
24,39654,1,1,1, 39655
1,39656,1,1,1, 39657
5,39657,3,3,1, 39660
30,39658,3,3,1, 39661
7,39662,1,1,1, 39663
17,39669,3,3,1, 39672
24,39679,1,1,1, 39680
1,39681,1,1,0, 39682
7,39687,1,1,1, 39688
26,39687,3,3,1, 39690
29,39688,4,4,1, 39692
11,39689,4,4,1, 39693
12,39695,5,5,1, 39700
24,39704,1,1,1, 39705
1,39706,1,1,1, 39707
30,39708,3,3,1, 39711
6,39710,2,2,1, 39712
25,39710,2,2,1, 39712
31,39711,2,2,1, 39713
7,39712,1,1,0, 39713
26,39712,3,3,1, 39715
29,39713,4,4,1, 39717
17,39719,3,3,1, 39722
24,39729,1,1,0, 39730
1,39731,1,1,1, 39732
5,39732,3,3,1, 39735
30,39733,3,3,1, 39736
6,39735,2,2,1, 39737
7,39737,1,1,1, 39738
26,39737,3,3,1, 39740
9,39742,2,2,1, 39744
18,39748,4,4,1, 39752
22,39751,4,4,1, 39755
24,39754,1,1,0, 39755
21,39752,5,5,1, 39757
1,39756,1,1,0, 39757
30,39758,3,3,1, 39761
6,39760,2,2,1, 39762
25,39760,2,2,1, 39762
31,39761,2,2,1, 39763
7,39762,1,1,0, 39763
8,39766,1,1,1, 39767
14,39769,3,3,1, 39772
13,39769,4,4,1, 39773
15,39771,2,2,1, 39773
22,39776,4,4,1, 39780
24,39779,1,1,0, 39780
21,39777,5,5,1, 39782
1,39781,1,1,0, 39782
30,39783,3,3,1, 39786
25,39785,2,2,1, 39787
7,39787,1,1,1, 39788
8,39791,1,1,0, 39792
9,39792,2,2,1, 39794
13,39794,4,4,1, 39798
18,39798,4,4,1, 39802
20,39798,6,6,1, 39804
2,39803,2,2,1, 39805
24,39804,1,1,0, 39805
21,39802,5,5,1, 39807
1,39806,1,1,0, 39807
4,39806,4,4,1, 39810
5,39807,3,3,1, 39810
30,39808,3,3,1, 39811
6,39810,2,2,1, 39812
25,39810,2,2,1, 39812
7,39812,1,1,1, 39813
29,39813,4,4,1, 39817
8,39816,1,1,1, 39817
11,39814,4,4,1, 39818
13,39819,4,4,1, 39823
12,39820,5,5,1, 39825
18,39823,4,4,1, 39827
20,39823,6,6,1, 39829
22,39826,4,4,1, 39830
2,39828,2,2,1, 39830
24,39829,1,1,1, 39830
19,39826,5,5,1, 39831
1,39831,1,1,1, 39832
3,39832,3,3,1, 39835
5,39832,3,3,1, 39835
27,39832,4,4,1, 39836
6,39835,2,2,1, 39837
31,39836,2,2,1, 39838
7,39837,1,1,1, 39838
26,39837,3,3,1, 39840
8,39841,1,1,1, 39842
14,39844,3,3,1, 39847
13,39844,4,4,1, 39848
24,39854,1,1,0, 39855
23,39853,3,3,1, 39856
21,39852,5,5,1, 39857
6,39860,2,2,1, 39862
31,39861,2,2,1, 39863
7,39862,1,1,1, 39863
29,39863,4,4,1, 39867
8,39866,1,1,0, 39867
22,39876,4,4,1, 39880
24,39879,1,1,0, 39880
23,39878,3,3,1, 39881
5,39882,3,3,1, 39885
7,39887,1,1,1, 39888
8,39891,1,1,0, 39892
16,39894,2,2,1, 39896
14,39894,3,3,1, 39897
13,39894,4,4,1, 39898
15,39896,2,2,1, 39898
22,39901,4,4,1, 39905
24,39904,1,1,0, 39905
6,39910,2,2,1, 39912
31,39911,2,2,1, 39913
7,39912,1,1,1, 39913
8,39916,1,1,0, 39917
13,39919,4,4,1, 39923
24,39929,1,1,1, 39930
23,39928,3,3,1, 39931
21,39927,5,5,1, 39932
5,39932,3,3,1, 39935
30,39933,3,3,1, 39936
31,39936,2,2,1, 39938
7,39937,1,1,0, 39938
8,39941,1,1,1, 39942
16,39944,2,2,1, 39946
14,39944,3,3,1, 39947
13,39944,4,4,1, 39948
24,39954,1,1,0, 39955
1,39956,1,1,0, 39957
30,39958,3,3,1, 39961
6,39960,2,2,1, 39962
25,39960,2,2,1, 39962
31,39961,2,2,1, 39963
7,39962,1,1,1, 39963
29,39963,4,4,1, 39967
8,39966,1,1,0, 39967
9,39967,2,2,1, 39969
17,39969,3,3,1, 39972
24,39979,1,1,1, 39980
21,39977,5,5,1, 39982
1,39981,1,1,0, 39982
30,39983,3,3,1, 39986
7,39987,1,1,1, 39988
8,39991,1,1,1, 39992
14,39994,3,3,1, 39997
22,40001,4,4,1, 40005
24,40004,1,1,1, 40005
23,40003,3,3,1, 40006
21,40002,5,5,1, 40007
1,40006,1,1,1, 40007
30,40008,3,3,1, 40011
25,40010,2,2,1, 40012
31,40011,2,2,1, 40013
7,40012,1,1,0, 40013
26,40012,3,3,1, 40015
8,40016,1,1,0, 40017
9,40017,2,2,1, 40019
13,40019,4,4,1, 40023
22,40026,4,4,1, 40030
2,40028,2,2,1, 40030
24,40029,1,1,0, 40030
1,40031,1,1,1, 40032
30,40033,3,3,1, 40036
6,40035,2,2,1, 40037
31,40036,2,2,1, 40038
7,40037,1,1,0, 40038
9,40042,2,2,1, 40044
2,40053,2,2,1, 40055
24,40054,1,1,0, 40055
1,40056,1,1,1, 40057
5,40057,3,3,1, 40060
6,40060,2,2,1, 40062
25,40060,2,2,1, 40062
31,40061,2,2,1, 40063
7,40062,1,1,0, 40063
26,40062,3,3,1, 40065
29,40063,4,4,1, 40067
17,40069,3,3,1, 40072
18,40073,4,4,1, 40077
2,40078,2,2,1, 40080
24,40079,1,1,0, 40080
1,40081,1,1,1, 40082
3,40082,3,3,1, 40085
5,40082,3,3,1, 40085
30,40083,3,3,1, 40086
31,40086,2,2,1, 40088
7,40087,1,1,0, 40088
28,40084,5,5,1, 40089
26,40087,3,3,1, 40090
29,40088,4,4,1, 40092
11,40089,4,4,1, 40093
9,40092,2,2,1, 40094
12,40095,5,5,1, 40100
2,40103,2,2,1, 40105
24,40104,1,1,0, 40105
1,40106,1,1,1, 40107
4,40106,4,4,1, 40110
27,40107,4,4,1, 40111
25,40110,2,2,1, 40112
11,40114,4,4,1, 40118
9,40117,2,2,1, 40119
17,40119,3,3,1, 40122
18,40123,4,4,1, 40127
24,40129,1,1,0, 40130
21,40127,5,5,1, 40132
1,40131,1,1,0, 40132
4,40131,4,4,1, 40135
3,40132,3,3,1, 40135
8,40141,1,1,0, 40142
15,40146,2,2,1, 40148
22,40151,4,4,1, 40155
24,40154,1,1,1, 40155
8,40166,1,1,1, 40167
24,40179,1,1,0, 40180
21,40177,5,5,1, 40182
8,40191,1,1,0, 40192
22,40201,4,4,1, 40205
24,40204,1,1,0, 40205
6,40210,2,2,1, 40212
31,40211,2,2,1, 40213
7,40212,1,1,1, 40213
8,40216,1,1,0, 40217
22,40226,4,4,1, 40230
24,40229,1,1,1, 40230
23,40228,3,3,1, 40231
6,40235,2,2,1, 40237
31,40236,2,2,1, 40238
7,40237,1,1,1, 40238
29,40238,4,4,1, 40242
8,40241,1,1,0, 40242
16,40244,2,2,1, 40246
17,40244,3,3,1, 40247
13,40244,4,4,1, 40248
24,40254,1,1,0, 40255
21,40252,5,5,1, 40257
1,40256,1,1,1, 40257
30,40258,3,3,1, 40261
25,40260,2,2,1, 40262
7,40262,1,1,0, 40263
29,40263,4,4,1, 40267
8,40266,1,1,1, 40267
16,40269,2,2,1, 40271
13,40269,4,4,1, 40273
24,40279,1,1,1, 40280
21,40277,5,5,1, 40282
1,40281,1,1,1, 40282
5,40282,3,3,1, 40285
30,40283,3,3,1, 40286
6,40285,2,2,1, 40287
25,40285,2,2,1, 40287
7,40287,1,1,0, 40288
29,40288,4,4,1, 40292
8,40291,1,1,0, 40292
9,40292,2,2,1, 40294
16,40294,2,2,1, 40296
14,40294,3,3,1, 40297
17,40294,3,3,1, 40297
15,40296,2,2,1, 40298
24,40304,1,1,0, 40305
23,40303,3,3,1, 40306
1,40306,1,1,0, 40307
4,40306,4,4,1, 40310
27,40307,4,4,1, 40311
6,40310,2,2,1, 40312
25,40310,2,2,1, 40312
31,40311,2,2,1, 40313
7,40312,1,1,0, 40313
29,40313,4,4,1, 40317
8,40316,1,1,1, 40317
11,40314,4,4,1, 40318
9,40317,2,2,1, 40319
17,40319,3,3,1, 40322
24,40329,1,1,0, 40330
21,40327,5,5,1, 40332
1,40331,1,1,0, 40332
30,40333,3,3,1, 40336
6,40335,2,2,1, 40337
25,40335,2,2,1, 40337
31,40336,2,2,1, 40338
7,40337,1,1,1, 40338
8,40341,1,1,0, 40342
9,40342,2,2,1, 40344
13,40344,4,4,1, 40348
22,40351,4,4,1, 40355
24,40354,1,1,0, 40355
21,40352,5,5,1, 40357
1,40356,1,1,1, 40357
7,40362,1,1,0, 40363
8,40366,1,1,1, 40367
16,40369,2,2,1, 40371
14,40369,3,3,1, 40372
22,40376,4,4,1, 40380
24,40379,1,1,0, 40380
23,40378,3,3,1, 40381
21,40377,5,5,1, 40382
1,40381,1,1,0, 40382
25,40385,2,2,1, 40387
7,40387,1,1,0, 40388
29,40388,4,4,1, 40392
8,40391,1,1,1, 40392
18,40398,4,4,1, 40402
24,40404,1,1,1, 40405
1,40406,1,1,1, 40407
30,40408,3,3,1, 40411
31,40411,2,2,1, 40413
7,40412,1,1,0, 40413
26,40412,3,3,1, 40415
8,40416,1,1,1, 40417
17,40419,3,3,1, 40422
18,40423,4,4,1, 40427
2,40428,2,2,1, 40430
24,40429,1,1,0, 40430
21,40427,5,5,1, 40432
1,40431,1,1,0, 40432
4,40431,4,4,1, 40435
3,40432,3,3,1, 40435
5,40432,3,3,1, 40435
30,40433,3,3,1, 40436
25,40435,2,2,1, 40437
7,40437,1,1,1, 40438
28,40434,5,5,1, 40439
26,40437,3,3,1, 40440
29,40438,4,4,1, 40442
8,40441,1,1,0, 40442
9,40442,2,2,1, 40444
16,40444,2,2,1, 40446
14,40444,3,3,1, 40447
13,40444,4,4,1, 40448
15,40446,2,2,1, 40448
12,40445,5,5,1, 40450
20,40448,6,6,1, 40454
2,40453,2,2,1, 40455
24,40454,1,1,0, 40455
1,40456,1,1,1, 40457
3,40457,3,3,1, 40460
5,40457,3,3,1, 40460
30,40458,3,3,1, 40461
25,40460,2,2,1, 40462
31,40461,2,2,1, 40463
7,40462,1,1,0, 40463
28,40459,5,5,1, 40464
26,40462,3,3,1, 40465
29,40463,4,4,1, 40467
8,40466,1,1,0, 40467
24,40479,1,1,0, 40480
21,40477,5,5,1, 40482
30,40483,3,3,1, 40486
31,40486,2,2,1, 40488
7,40487,1,1,0, 40488
29,40488,4,4,1, 40492
8,40491,1,1,0, 40492
13,40494,4,4,1, 40498
24,40504,1,1,0, 40505
5,40507,3,3,1, 40510
30,40508,3,3,1, 40511
6,40510,2,2,1, 40512
31,40511,2,2,1, 40513
7,40512,1,1,1, 40513
29,40513,4,4,1, 40517
8,40516,1,1,0, 40517
13,40519,4,4,1, 40523
15,40521,2,2,1, 40523
22,40526,4,4,1, 40530
24,40529,1,1,1, 40530
23,40528,3,3,1, 40531
5,40532,3,3,1, 40535
30,40533,3,3,1, 40536
6,40535,2,2,1, 40537
31,40536,2,2,1, 40538
7,40537,1,1,0, 40538
29,40538,4,4,1, 40542
8,40541,1,1,0, 40542
13,40544,4,4,1, 40548
15,40546,2,2,1, 40548
24,40554,1,1,1, 40555
23,40553,3,3,1, 40556
21,40552,5,5,1, 40557
6,40560,2,2,1, 40562
31,40561,2,2,1, 40563
7,40562,1,1,0, 40563
29,40563,4,4,1, 40567
8,40566,1,1,1, 40567
17,40569,3,3,1, 40572
15,40571,2,2,1, 40573
22,40576,4,4,1, 40580
24,40579,1,1,1, 40580
23,40578,3,3,1, 40581
1,40581,1,1,1, 40582
8,40591,1,1,1, 40592
14,40594,3,3,1, 40597
22,40601,4,4,1, 40605
24,40604,1,1,0, 40605
21,40602,5,5,1, 40607
1,40606,1,1,1, 40607
25,40610,2,2,1, 40612
8,40616,1,1,1, 40617
9,40617,2,2,1, 40619
13,40619,4,4,1, 40623
15,40621,2,2,1, 40623
24,40629,1,1,1, 40630
1,40631,1,1,1, 40632
25,40635,2,2,1, 40637
26,40637,3,3,1, 40640
8,40641,1,1,0, 40642
17,40644,3,3,1, 40647
13,40644,4,4,1, 40648
15,40646,2,2,1, 40648
24,40654,1,1,1, 40655
21,40652,5,5,1, 40657
1,40656,1,1,1, 40657
26,40662,3,3,1, 40665
8,40666,1,1,1, 40667
9,40667,2,2,1, 40669
16,40669,2,2,1, 40671
22,40676,4,4,1, 40680
24,40679,1,1,0, 40680
23,40678,3,3,1, 40681
21,40677,5,5,1, 40682
1,40681,1,1,0, 40682
5,40682,3,3,1, 40685
6,40685,2,2,1, 40687
31,40686,2,2,1, 40688
7,40687,1,1,0, 40688
9,40692,2,2,1, 40694
17,40694,3,3,1, 40697
2,40703,2,2,1, 40705
24,40704,1,1,0, 40705
1,40706,1,1,1, 40707
30,40708,3,3,1, 40711
25,40710,2,2,1, 40712
31,40711,2,2,1, 40713
7,40712,1,1,0, 40713
29,40713,4,4,1, 40717
9,40717,2,2,1, 40719
20,40723,6,6,1, 40729
24,40729,1,1,0, 40730
1,40731,1,1,1, 40732
4,40731,4,4,1, 40735
3,40732,3,3,1, 40735
5,40732,3,3,1, 40735
30,40733,3,3,1, 40736
6,40735,2,2,1, 40737
25,40735,2,2,1, 40737
31,40736,2,2,1, 40738
7,40737,1,1,0, 40738
26,40737,3,3,1, 40740
17,40744,3,3,1, 40747
2,40753,2,2,1, 40755
24,40754,1,1,0, 40755
1,40756,1,1,1, 40757
5,40757,3,3,1, 40760
27,40757,4,4,1, 40761
7,40762,1,1,1, 40763
29,40763,4,4,1, 40767
18,40773,4,4,1, 40777
24,40779,1,1,0, 40780
19,40776,5,5,1, 40781
1,40781,1,1,0, 40782
3,40782,3,3,1, 40785
27,40782,4,4,1, 40786
30,40783,3,3,1, 40786
6,40785,2,2,1, 40787
25,40785,2,2,1, 40787
7,40787,1,1,0, 40788
26,40787,3,3,1, 40790
29,40788,4,4,1, 40792
8,40791,1,1,0, 40792
17,40794,3,3,1, 40797
18,40798,4,4,1, 40802
20,40798,6,6,1, 40804
24,40804,1,1,1, 40805
23,40803,3,3,1, 40806
21,40802,5,5,1, 40807
1,40806,1,1,0, 40807
3,40807,3,3,1, 40810
30,40808,3,3,1, 40811
6,40810,2,2,1, 40812
25,40810,2,2,1, 40812
7,40812,1,1,0, 40813
28,40809,5,5,1, 40814
8,40816,1,1,0, 40817
11,40814,4,4,1, 40818
16,40819,2,2,1, 40821
14,40819,3,3,1, 40822
13,40819,4,4,1, 40823
15,40821,2,2,1, 40823
22,40826,4,4,1, 40830
24,40829,1,1,0, 40830
23,40828,3,3,1, 40831
5,40832,3,3,1, 40835
7,40837,1,1,0, 40838
8,40841,1,1,1, 40842
14,40844,3,3,1, 40847
22,40851,4,4,1, 40855
24,40854,1,1,1, 40855
5,40857,3,3,1, 40860
7,40862,1,1,1, 40863
29,40863,4,4,1, 40867
8,40866,1,1,0, 40867
14,40869,3,3,1, 40872
13,40869,4,4,1, 40873
24,40879,1,1,1, 40880
21,40877,5,5,1, 40882
5,40882,3,3,1, 40885
30,40883,3,3,1, 40886
7,40887,1,1,1, 40888
8,40891,1,1,1, 40892
14,40894,3,3,1, 40897
15,40896,2,2,1, 40898
24,40904,1,1,1, 40905
23,40903,3,3,1, 40906
21,40902,5,5,1, 40907
5,40907,3,3,1, 40910
30,40908,3,3,1, 40911
6,40910,2,2,1, 40912
31,40911,2,2,1, 40913
7,40912,1,1,1, 40913
8,40916,1,1,1, 40917
16,40919,2,2,1, 40921
14,40919,3,3,1, 40922
13,40919,4,4,1, 40923
15,40921,2,2,1, 40923
24,40929,1,1,1, 40930
21,40927,5,5,1, 40932
1,40931,1,1,1, 40932
30,40933,3,3,1, 40936
31,40936,2,2,1, 40938
7,40937,1,1,0, 40938
8,40941,1,1,0, 40942
14,40944,3,3,1, 40947
24,40954,1,1,0, 40955
23,40953,3,3,1, 40956
1,40956,1,1,1, 40957
25,40960,2,2,1, 40962
31,40961,2,2,1, 40963
7,40962,1,1,0, 40963
8,40966,1,1,0, 40967
9,40967,2,2,1, 40969
16,40969,2,2,1, 40971
17,40969,3,3,1, 40972
15,40971,2,2,1, 40973
22,40976,4,4,1, 40980
24,40979,1,1,0, 40980
23,40978,3,3,1, 40981
21,40977,5,5,1, 40982
1,40981,1,1,1, 40982
5,40982,3,3,1, 40985
30,40983,3,3,1, 40986
6,40985,2,2,1, 40987
25,40985,2,2,1, 40987
31,40986,2,2,1, 40988
7,40987,1,1,0, 40988
29,40988,4,4,1, 40992
9,40992,2,2,1, 40994
18,40998,4,4,1, 41002
24,41004,1,1,1, 41005
1,41006,1,1,0, 41007
6,41010,2,2,1, 41012
25,41010,2,2,1, 41012
7,41012,1,1,1, 41013
9,41017,2,2,1, 41019
24,41029,1,1,1, 41030
1,41031,1,1,0, 41032
5,41032,3,3,1, 41035
30,41033,3,3,1, 41036
25,41035,2,2,1, 41037
31,41036,2,2,1, 41038
7,41037,1,1,0, 41038
26,41037,3,3,1, 41040
9,41042,2,2,1, 41044
17,41044,3,3,1, 41047
18,41048,4,4,1, 41052
24,41054,1,1,1, 41055
1,41056,1,1,1, 41057
25,41060,2,2,1, 41062
31,41061,2,2,1, 41063
7,41062,1,1,0, 41063
24,41079,1,1,1, 41080
1,41081,1,1,1, 41082
5,41082,3,3,1, 41085
25,41085,2,2,1, 41087
7,41087,1,1,0, 41088
29,41088,4,4,1, 41092
8,41091,1,1,0, 41092
9,41092,2,2,1, 41094
16,41094,2,2,1, 41096
18,41098,4,4,1, 41102
20,41098,6,6,1, 41104
22,41101,4,4,1, 41105
24,41104,1,1,0, 41105
21,41102,5,5,1, 41107
1,41106,1,1,0, 41107
5,41107,3,3,1, 41110
27,41107,4,4,1, 41111
30,41108,3,3,1, 41111
6,41110,2,2,1, 41112
25,41110,2,2,1, 41112
31,41111,2,2,1, 41113
7,41112,1,1,1, 41113
26,41112,3,3,1, 41115
8,41116,1,1,0, 41117
11,41114,4,4,1, 41118
9,41117,2,2,1, 41119
16,41119,2,2,1, 41121
17,41119,3,3,1, 41122
15,41121,2,2,1, 41123
18,41123,4,4,1, 41127
24,41129,1,1,1, 41130
19,41126,5,5,1, 41131
23,41128,3,3,1, 41131
1,41131,1,1,1, 41132
3,41132,3,3,1, 41135
6,41135,2,2,1, 41137
25,41135,2,2,1, 41137
31,41136,2,2,1, 41138
7,41137,1,1,1, 41138
28,41134,5,5,1, 41139
26,41137,3,3,1, 41140
8,41141,1,1,0, 41142
9,41142,2,2,1, 41144
13,41144,4,4,1, 41148
22,41151,4,4,1, 41155
24,41154,1,1,1, 41155
19,41151,5,5,1, 41156
23,41153,3,3,1, 41156
21,41152,5,5,1, 41157
1,41156,1,1,0, 41157
4,41156,4,4,1, 41160
27,41157,4,4,1, 41161
7,41162,1,1,0, 41163
29,41163,4,4,1, 41167
8,41166,1,1,0, 41167
14,41169,3,3,1, 41172
13,41169,4,4,1, 41173
15,41171,2,2,1, 41173
22,41176,4,4,1, 41180
24,41179,1,1,1, 41180
5,41182,3,3,1, 41185
6,41185,2,2,1, 41187
7,41187,1,1,0, 41188
29,41188,4,4,1, 41192
8,41191,1,1,0, 41192
16,41194,2,2,1, 41196
14,41194,3,3,1, 41197
15,41196,2,2,1, 41198
24,41204,1,1,1, 41205
5,41207,3,3,1, 41210
31,41211,2,2,1, 41213
7,41212,1,1,0, 41213
8,41216,1,1,1, 41217
13,41219,4,4,1, 41223
15,41221,2,2,1, 41223
24,41229,1,1,0, 41230
23,41228,3,3,1, 41231
5,41232,3,3,1, 41235
7,41237,1,1,1, 41238
8,41241,1,1,0, 41242
13,41244,4,4,1, 41248
22,41251,4,4,1, 41255
24,41254,1,1,1, 41255
21,41252,5,5,1, 41257
5,41257,3,3,1, 41260
30,41258,3,3,1, 41261
6,41260,2,2,1, 41262
7,41262,1,1,0, 41263
29,41263,4,4,1, 41267
8,41266,1,1,0, 41267
16,41269,2,2,1, 41271
14,41269,3,3,1, 41272
17,41269,3,3,1, 41272
13,41269,4,4,1, 41273
15,41271,2,2,1, 41273
22,41276,4,4,1, 41280
24,41279,1,1,1, 41280
23,41278,3,3,1, 41281
21,41277,5,5,1, 41282
1,41281,1,1,0, 41282
30,41283,3,3,1, 41286
25,41285,2,2,1, 41287
7,41287,1,1,0, 41288
29,41288,4,4,1, 41292
17,41294,3,3,1, 41297
24,41304,1,1,1, 41305
1,41306,1,1,1, 41307
5,41307,3,3,1, 41310
31,41311,2,2,1, 41313
7,41312,1,1,1, 41313
17,41319,3,3,1, 41322
24,41329,1,1,0, 41330
1,41331,1,1,1, 41332
5,41332,3,3,1, 41335
30,41333,3,3,1, 41336
6,41335,2,2,1, 41337
31,41336,2,2,1, 41338
7,41337,1,1,0, 41338
9,41342,2,2,1, 41344
17,41344,3,3,1, 41347
18,41348,4,4,1, 41352
20,41348,6,6,1, 41354
2,41353,2,2,1, 41355
24,41354,1,1,0, 41355
19,41351,5,5,1, 41356
1,41356,1,1,0, 41357
30,41358,3,3,1, 41361
25,41360,2,2,1, 41362
31,41361,2,2,1, 41363
7,41362,1,1,1, 41363
29,41363,4,4,1, 41367
9,41367,2,2,1, 41369
24,41379,1,1,1, 41380
1,41381,1,1,1, 41382
5,41382,3,3,1, 41385
30,41383,3,3,1, 41386
25,41385,2,2,1, 41387
7,41387,1,1,0, 41388
26,41387,3,3,1, 41390
8,41391,1,1,0, 41392
16,41394,2,2,1, 41396
17,41394,3,3,1, 41397
13,41394,4,4,1, 41398
15,41396,2,2,1, 41398
18,41398,4,4,1, 41402
24,41404,1,1,0, 41405
23,41403,3,3,1, 41406
1,41406,1,1,1, 41407
6,41410,2,2,1, 41412
25,41410,2,2,1, 41412
31,41411,2,2,1, 41413
7,41412,1,1,0, 41413
26,41412,3,3,1, 41415
8,41416,1,1,0, 41417
13,41419,4,4,1, 41423
15,41421,2,2,1, 41423
18,41423,4,4,1, 41427
2,41428,2,2,1, 41430
24,41429,1,1,1, 41430
1,41431,1,1,0, 41432
5,41432,3,3,1, 41435
6,41435,2,2,1, 41437
7,41437,1,1,0, 41438
8,41441,1,1,0, 41442
9,41442,2,2,1, 41444
14,41444,3,3,1, 41447
13,41444,4,4,1, 41448
22,41451,4,4,1, 41455
24,41454,1,1,0, 41455
23,41453,3,3,1, 41456
1,41456,1,1,0, 41457
4,41456,4,4,1, 41460
3,41457,3,3,1, 41460
5,41457,3,3,1, 41460
30,41458,3,3,1, 41461
26,41462,3,3,1, 41465
8,41466,1,1,1, 41467
16,41469,2,2,1, 41471
14,41469,3,3,1, 41472
15,41471,2,2,1, 41473
22,41476,4,4,1, 41480
2,41478,2,2,1, 41480
24,41479,1,1,1, 41480
19,41476,5,5,1, 41481
23,41478,3,3,1, 41481
21,41477,5,5,1, 41482
1,41481,1,1,1, 41482
3,41482,3,3,1, 41485
27,41482,4,4,1, 41486
25,41485,2,2,1, 41487
28,41484,5,5,1, 41489
8,41491,1,1,1, 41492
9,41492,2,2,1, 41494
14,41494,3,3,1, 41497
13,41494,4,4,1, 41498
18,41498,4,4,1, 41502
2,41503,2,2,1, 41505
24,41504,1,1,1, 41505
1,41506,1,1,1, 41507
28,41509,5,5,1, 41514
26,41512,3,3,1, 41515
8,41516,1,1,0, 41517
16,41519,2,2,1, 41521
13,41519,4,4,1, 41523
15,41521,2,2,1, 41523
22,41526,4,4,1, 41530
24,41529,1,1,1, 41530
21,41527,5,5,1, 41532
8,41541,1,1,1, 41542
16,41544,2,2,1, 41546
24,41554,1,1,0, 41555
23,41553,3,3,1, 41556
29,41563,4,4,1, 41567
8,41566,1,1,0, 41567
13,41569,4,4,1, 41573
24,41579,1,1,1, 41580
30,41583,3,3,1, 41586
6,41585,2,2,1, 41587
7,41587,1,1,0, 41588
8,41591,1,1,1, 41592
16,41594,2,2,1, 41596
14,41594,3,3,1, 41597
24,41604,1,1,0, 41605
23,41603,3,3,1, 41606
31,41611,2,2,1, 41613
7,41612,1,1,1, 41613
8,41616,1,1,0, 41617
16,41619,2,2,1, 41621
14,41619,3,3,1, 41622
13,41619,4,4,1, 41623
15,41621,2,2,1, 41623
24,41629,1,1,0, 41630
1,41631,1,1,1, 41632
30,41633,3,3,1, 41636
7,41637,1,1,1, 41638
17,41644,3,3,1, 41647
24,41654,1,1,1, 41655
1,41656,1,1,1, 41657
6,41660,2,2,1, 41662
7,41662,1,1,1, 41663
17,41669,3,3,1, 41672
24,41679,1,1,1, 41680
1,41681,1,1,0, 41682
30,41683,3,3,1, 41686
25,41685,2,2,1, 41687
31,41686,2,2,1, 41688
7,41687,1,1,0, 41688
29,41688,4,4,1, 41692
9,41692,2,2,1, 41694
24,41704,1,1,0, 41705
1,41706,1,1,0, 41707
5,41707,3,3,1, 41710
25,41710,2,2,1, 41712
7,41712,1,1,0, 41713
29,41713,4,4,1, 41717
9,41717,2,2,1, 41719
18,41723,4,4,1, 41727
2,41728,2,2,1, 41730
24,41729,1,1,0, 41730
21,41727,5,5,1, 41732
1,41731,1,1,0, 41732
5,41732,3,3,1, 41735
30,41733,3,3,1, 41736
25,41735,2,2,1, 41737
31,41736,2,2,1, 41738
7,41737,1,1,0, 41738
26,41737,3,3,1, 41740
29,41738,4,4,1, 41742
8,41741,1,1,0, 41742
9,41742,2,2,1, 41744
16,41744,2,2,1, 41746
18,41748,4,4,1, 41752
20,41748,6,6,1, 41754
22,41751,4,4,1, 41755
2,41753,2,2,1, 41755
24,41754,1,1,1, 41755
23,41753,3,3,1, 41756
21,41752,5,5,1, 41757
1,41756,1,1,0, 41757
3,41757,3,3,1, 41760
5,41757,3,3,1, 41760
27,41757,4,4,1, 41761
30,41758,3,3,1, 41761
7,41762,1,1,1, 41763
28,41759,5,5,1, 41764
8,41766,1,1,1, 41767
16,41769,2,2,1, 41771
13,41769,4,4,1, 41773
12,41770,5,5,1, 41775
18,41773,4,4,1, 41777
22,41776,4,4,1, 41780
2,41778,2,2,1, 41780
24,41779,1,1,1, 41780
19,41776,5,5,1, 41781
21,41777,5,5,1, 41782
1,41781,1,1,0, 41782
5,41782,3,3,1, 41785
27,41782,4,4,1, 41786
7,41787,1,1,1, 41788
26,41787,3,3,1, 41790
8,41791,1,1,1, 41792
17,41794,3,3,1, 41797
13,41794,4,4,1, 41798
12,41795,5,5,1, 41800
18,41798,4,4,1, 41802
22,41801,4,4,1, 41805
2,41803,2,2,1, 41805
24,41804,1,1,1, 41805
19,41801,5,5,1, 41806
21,41802,5,5,1, 41807
1,41806,1,1,1, 41807
4,41806,4,4,1, 41810
3,41807,3,3,1, 41810
30,41808,3,3,1, 41811
6,41810,2,2,1, 41812
31,41811,2,2,1, 41813
7,41812,1,1,0, 41813
29,41813,4,4,1, 41817
8,41816,1,1,1, 41817
16,41819,2,2,1, 41821
14,41819,3,3,1, 41822
13,41819,4,4,1, 41823
24,41829,1,1,1, 41830
21,41827,5,5,1, 41832
5,41832,3,3,1, 41835
31,41836,2,2,1, 41838
7,41837,1,1,0, 41838
29,41838,4,4,1, 41842
8,41841,1,1,0, 41842
14,41844,3,3,1, 41847
13,41844,4,4,1, 41848
15,41846,2,2,1, 41848
24,41854,1,1,1, 41855
21,41852,5,5,1, 41857
30,41858,3,3,1, 41861
6,41860,2,2,1, 41862
7,41862,1,1,0, 41863
8,41866,1,1,0, 41867
16,41869,2,2,1, 41871
13,41869,4,4,1, 41873
15,41871,2,2,1, 41873
22,41876,4,4,1, 41880
24,41879,1,1,0, 41880
5,41882,3,3,1, 41885
6,41885,2,2,1, 41887
31,41886,2,2,1, 41888
7,41887,1,1,1, 41888
8,41891,1,1,0, 41892
16,41894,2,2,1, 41896
13,41894,4,4,1, 41898
15,41896,2,2,1, 41898
24,41904,1,1,1, 41905
5,41907,3,3,1, 41910
30,41908,3,3,1, 41911
7,41912,1,1,0, 41913
29,41913,4,4,1, 41917
9,41917,2,2,1, 41919
17,41919,3,3,1, 41922
24,41929,1,1,1, 41930
1,41931,1,1,1, 41932
25,41935,2,2,1, 41937
31,41936,2,2,1, 41938
7,41937,1,1,0, 41938
29,41938,4,4,1, 41942
9,41942,2,2,1, 41944
24,41954,1,1,0, 41955
1,41956,1,1,1, 41957
6,41960,2,2,1, 41962
25,41960,2,2,1, 41962
31,41961,2,2,1, 41963
7,41962,1,1,1, 41963
17,41969,3,3,1, 41972
24,41979,1,1,1, 41980
1,41981,1,1,0, 41982
5,41982,3,3,1, 41985
27,41982,4,4,1, 41986
30,41983,3,3,1, 41986
6,41985,2,2,1, 41987
31,41986,2,2,1, 41988
7,41987,1,1,0, 41988
28,41984,5,5,1, 41989
26,41987,3,3,1, 41990
9,41992,2,2,1, 41994
12,41995,5,5,1, 42000
20,41998,6,6,1, 42004
22,42001,4,4,1, 42005
2,42003,2,2,1, 42005
24,42004,1,1,1, 42005
21,42002,5,5,1, 42007
1,42006,1,1,0, 42007
5,42007,3,3,1, 42010
30,42008,3,3,1, 42011
25,42010,2,2,1, 42012
7,42012,1,1,0, 42013
29,42013,4,4,1, 42017
8,42016,1,1,0, 42017
9,42017,2,2,1, 42019
14,42019,3,3,1, 42022
24,42029,1,1,1, 42030
1,42031,1,1,0, 42032
25,42035,2,2,1, 42037
7,42037,1,1,0, 42038
29,42038,4,4,1, 42042
8,42041,1,1,0, 42042
13,42044,4,4,1, 42048
24,42054,1,1,0, 42055
23,42053,3,3,1, 42056
21,42052,5,5,1, 42057
1,42056,1,1,0, 42057
5,42057,3,3,1, 42060
30,42058,3,3,1, 42061
25,42060,2,2,1, 42062
7,42062,1,1,0, 42063
29,42063,4,4,1, 42067
8,42066,1,1,1, 42067
17,42069,3,3,1, 42072
13,42069,4,4,1, 42073
22,42076,4,4,1, 42080
24,42079,1,1,0, 42080
23,42078,3,3,1, 42081
1,42081,1,1,0, 42082
5,42082,3,3,1, 42085
25,42085,2,2,1, 42087
7,42087,1,1,1, 42088
26,42087,3,3,1, 42090
29,42088,4,4,1, 42092
8,42091,1,1,0, 42092
9,42092,2,2,1, 42094
18,42098,4,4,1, 42102
22,42101,4,4,1, 42105
24,42104,1,1,1, 42105
1,42106,1,1,1, 42107
4,42106,4,4,1, 42110
30,42108,3,3,1, 42111
6,42110,2,2,1, 42112
7,42112,1,1,0, 42113
26,42112,3,3,1, 42115
29,42113,4,4,1, 42117
8,42116,1,1,0, 42117
16,42119,2,2,1, 42121
14,42119,3,3,1, 42122
15,42121,2,2,1, 42123
12,42120,5,5,1, 42125
18,42123,4,4,1, 42127
20,42123,6,6,1, 42129
2,42128,2,2,1, 42130
24,42129,1,1,1, 42130
19,42126,5,5,1, 42131
21,42127,5,5,1, 42132
1,42131,1,1,1, 42132
4,42131,4,4,1, 42135
3,42132,3,3,1, 42135
5,42132,3,3,1, 42135
6,42135,2,2,1, 42137
7,42137,1,1,0, 42138
8,42141,1,1,1, 42142
15,42146,2,2,1, 42148
24,42154,1,1,1, 42155
23,42153,3,3,1, 42156
21,42152,5,5,1, 42157
7,42162,1,1,0, 42163
8,42166,1,1,1, 42167
16,42169,2,2,1, 42171
14,42169,3,3,1, 42172
13,42169,4,4,1, 42173
15,42171,2,2,1, 42173
24,42179,1,1,1, 42180
23,42178,3,3,1, 42181
21,42177,5,5,1, 42182
6,42185,2,2,1, 42187
31,42186,2,2,1, 42188
7,42187,1,1,1, 42188
29,42188,4,4,1, 42192
8,42191,1,1,1, 42192
13,42194,4,4,1, 42198
24,42204,1,1,0, 42205
23,42203,3,3,1, 42206
5,42207,3,3,1, 42210
30,42208,3,3,1, 42211
31,42211,2,2,1, 42213
7,42212,1,1,1, 42213
8,42216,1,1,0, 42217
16,42219,2,2,1, 42221
14,42219,3,3,1, 42222
15,42221,2,2,1, 42223
24,42229,1,1,1, 42230
23,42228,3,3,1, 42231
21,42227,5,5,1, 42232
6,42235,2,2,1, 42237
7,42237,1,1,0, 42238
29,42238,4,4,1, 42242
8,42241,1,1,0, 42242
9,42242,2,2,1, 42244
16,42244,2,2,1, 42246
15,42246,2,2,1, 42248
24,42254,1,1,1, 42255
1,42256,1,1,0, 42257
5,42257,3,3,1, 42260
6,42260,2,2,1, 42262
31,42261,2,2,1, 42263
7,42262,1,1,0, 42263
29,42263,4,4,1, 42267
8,42266,1,1,0, 42267
9,42267,2,2,1, 42269
13,42269,4,4,1, 42273
24,42279,1,1,1, 42280
23,42278,3,3,1, 42281
1,42281,1,1,1, 42282
30,42283,3,3,1, 42286
6,42285,2,2,1, 42287
7,42287,1,1,0, 42288
26,42287,3,3,1, 42290
29,42288,4,4,1, 42292
8,42291,1,1,0, 42292
9,42292,2,2,1, 42294
14,42294,3,3,1, 42297
17,42294,3,3,1, 42297
24,42304,1,1,1, 42305
1,42306,1,1,0, 42307
6,42310,2,2,1, 42312
31,42311,2,2,1, 42313
7,42312,1,1,1, 42313
26,42312,3,3,1, 42315
29,42313,4,4,1, 42317
8,42316,1,1,1, 42317
14,42319,3,3,1, 42322
17,42319,3,3,1, 42322
15,42321,2,2,1, 42323
22,42326,4,4,1, 42330
2,42328,2,2,1, 42330
24,42329,1,1,0, 42330
23,42328,3,3,1, 42331
1,42331,1,1,0, 42332
5,42332,3,3,1, 42335
25,42335,2,2,1, 42337
31,42336,2,2,1, 42338
7,42337,1,1,0, 42338
26,42337,3,3,1, 42340
29,42338,4,4,1, 42342
8,42341,1,1,1, 42342
16,42344,2,2,1, 42346
17,42344,3,3,1, 42347
15,42346,2,2,1, 42348
22,42351,4,4,1, 42355
24,42354,1,1,0, 42355
23,42353,3,3,1, 42356
1,42356,1,1,1, 42357
25,42360,2,2,1, 42362
31,42361,2,2,1, 42363
7,42362,1,1,0, 42363
29,42363,4,4,1, 42367
17,42369,3,3,1, 42372
12,42370,5,5,1, 42375
24,42379,1,1,0, 42380
1,42381,1,1,0, 42382
4,42381,4,4,1, 42385
25,42385,2,2,1, 42387
9,42392,2,2,1, 42394
12,42395,5,5,1, 42400
2,42403,2,2,1, 42405
24,42404,1,1,0, 42405
19,42401,5,5,1, 42406
1,42406,1,1,1, 42407
3,42407,3,3,1, 42410
27,42407,4,4,1, 42411
26,42412,3,3,1, 42415
20,42423,6,6,1, 42429
24,42429,1,1,1, 42430
1,42431,1,1,1, 42432
3,42432,3,3,1, 42435
25,42435,2,2,1, 42437
26,42437,3,3,1, 42440
9,42442,2,2,1, 42444
12,42445,5,5,1, 42450
20,42448,6,6,1, 42454
2,42453,2,2,1, 42455
24,42454,1,1,1, 42455
8,42466,1,1,0, 42467
16,42469,2,2,1, 42471
13,42469,4,4,1, 42473
24,42479,1,1,1, 42480
23,42478,3,3,1, 42481
21,42477,5,5,1, 42482
31,42486,2,2,1, 42488
7,42487,1,1,0, 42488
29,42488,4,4,1, 42492
8,42491,1,1,0, 42492
16,42494,2,2,1, 42496
15,42496,2,2,1, 42498
22,42501,4,4,1, 42505
24,42504,1,1,1, 42505
23,42503,3,3,1, 42506
5,42507,3,3,1, 42510
7,42512,1,1,0, 42513
29,42513,4,4,1, 42517
8,42516,1,1,0, 42517
16,42519,2,2,1, 42521
22,42526,4,4,1, 42530
24,42529,1,1,1, 42530
23,42528,3,3,1, 42531
30,42533,3,3,1, 42536
31,42536,2,2,1, 42538
7,42537,1,1,0, 42538
29,42538,4,4,1, 42542
8,42541,1,1,1, 42542
16,42544,2,2,1, 42546
14,42544,3,3,1, 42547
13,42544,4,4,1, 42548
15,42546,2,2,1, 42548
22,42551,4,4,1, 42555
24,42554,1,1,1, 42555
23,42553,3,3,1, 42556
21,42552,5,5,1, 42557
5,42557,3,3,1, 42560
30,42558,3,3,1, 42561
31,42561,2,2,1, 42563
7,42562,1,1,0, 42563
29,42563,4,4,1, 42567
8,42566,1,1,0, 42567
11,42564,4,4,1, 42568
9,42567,2,2,1, 42569
16,42569,2,2,1, 42571
13,42569,4,4,1, 42573
20,42573,6,6,1, 42579
24,42579,1,1,0, 42580
19,42576,5,5,1, 42581
21,42577,5,5,1, 42582
1,42581,1,1,0, 42582
3,42582,3,3,1, 42585
5,42582,3,3,1, 42585
27,42582,4,4,1, 42586
30,42583,3,3,1, 42586
6,42585,2,2,1, 42587
31,42586,2,2,1, 42588
7,42587,1,1,1, 42588
28,42584,5,5,1, 42589
26,42587,3,3,1, 42590
8,42591,1,1,0, 42592
16,42594,2,2,1, 42596
14,42594,3,3,1, 42597
17,42594,3,3,1, 42597
18,42598,4,4,1, 42602
20,42598,6,6,1, 42604
24,42604,1,1,0, 42605
21,42602,5,5,1, 42607
1,42606,1,1,1, 42607
31,42611,2,2,1, 42613
7,42612,1,1,1, 42613
29,42613,4,4,1, 42617
8,42616,1,1,1, 42617
9,42617,2,2,1, 42619
16,42619,2,2,1, 42621
14,42619,3,3,1, 42622
17,42619,3,3,1, 42622
24,42629,1,1,0, 42630
1,42631,1,1,0, 42632
30,42633,3,3,1, 42636
7,42637,1,1,1, 42638
17,42644,3,3,1, 42647
24,42654,1,1,0, 42655
1,42656,1,1,1, 42657
30,42658,3,3,1, 42661
25,42660,2,2,1, 42662
31,42661,2,2,1, 42663
7,42662,1,1,1, 42663
29,42663,4,4,1, 42667
9,42667,2,2,1, 42669
24,42679,1,1,0, 42680
1,42681,1,1,0, 42682
6,42685,2,2,1, 42687
25,42685,2,2,1, 42687
31,42686,2,2,1, 42688
7,42687,1,1,0, 42688
24,42704,1,1,1, 42705
1,42706,1,1,1, 42707
27,42707,4,4,1, 42711
6,42710,2,2,1, 42712
25,42710,2,2,1, 42712
31,42711,2,2,1, 42713
7,42712,1,1,0, 42713
29,42713,4,4,1, 42717
17,42719,3,3,1, 42722
12,42720,5,5,1, 42725
24,42729,1,1,0, 42730
23,42728,3,3,1, 42731
1,42731,1,1,0, 42732
5,42732,3,3,1, 42735
30,42733,3,3,1, 42736
6,42735,2,2,1, 42737
31,42736,2,2,1, 42738
7,42737,1,1,0, 42738
26,42737,3,3,1, 42740
8,42741,1,1,1, 42742
16,42744,2,2,1, 42746
14,42744,3,3,1, 42747
17,42744,3,3,1, 42747
13,42744,4,4,1, 42748
15,42746,2,2,1, 42748
22,42751,4,4,1, 42755
2,42753,2,2,1, 42755
24,42754,1,1,1, 42755
23,42753,3,3,1, 42756
21,42752,5,5,1, 42757
1,42756,1,1,0, 42757
7,42762,1,1,1, 42763
26,42762,3,3,1, 42765
29,42763,4,4,1, 42767
8,42766,1,1,1, 42767
16,42769,2,2,1, 42771
17,42769,3,3,1, 42772
13,42769,4,4,1, 42773
15,42771,2,2,1, 42773
18,42773,4,4,1, 42777
2,42778,2,2,1, 42780
24,42779,1,1,0, 42780
23,42778,3,3,1, 42781
21,42777,5,5,1, 42782
1,42781,1,1,1, 42782
30,42783,3,3,1, 42786
6,42785,2,2,1, 42787
7,42787,1,1,1, 42788
26,42787,3,3,1, 42790
29,42788,4,4,1, 42792
8,42791,1,1,0, 42792
16,42794,2,2,1, 42796
13,42794,4,4,1, 42798
15,42796,2,2,1, 42798
22,42801,4,4,1, 42805
24,42804,1,1,0, 42805
21,42802,5,5,1, 42807
1,42806,1,1,1, 42807
30,42808,3,3,1, 42811
6,42810,2,2,1, 42812
7,42812,1,1,0, 42813
26,42812,3,3,1, 42815
8,42816,1,1,0, 42817
16,42819,2,2,1, 42821
14,42819,3,3,1, 42822
17,42819,3,3,1, 42822
15,42821,2,2,1, 42823
18,42823,4,4,1, 42827
24,42829,1,1,1, 42830
19,42826,5,5,1, 42831
23,42828,3,3,1, 42831
21,42827,5,5,1, 42832
1,42831,1,1,0, 42832
4,42831,4,4,1, 42835
30,42833,3,3,1, 42836
25,42835,2,2,1, 42837
31,42836,2,2,1, 42838
7,42837,1,1,1, 42838
28,42834,5,5,1, 42839
26,42837,3,3,1, 42840
24,42854,1,1,1, 42855
5,42857,3,3,1, 42860
31,42861,2,2,1, 42863
7,42862,1,1,0, 42863
24,42879,1,1,1, 42880
6,42885,2,2,1, 42887
7,42887,1,1,0, 42888
24,42904,1,1,0, 42905
30,42908,3,3,1, 42911
6,42910,2,2,1, 42912
31,42911,2,2,1, 42913
7,42912,1,1,0, 42913
24,42929,1,1,1, 42930
30,42933,3,3,1, 42936
31,42936,2,2,1, 42938
7,42937,1,1,0, 42938
16,42944,2,2,1, 42946
22,42951,4,4,1, 42955
24,42954,1,1,0, 42955
1,42956,1,1,1, 42957
6,42960,2,2,1, 42962
31,42961,2,2,1, 42963
7,42962,1,1,0, 42963
8,42966,1,1,0, 42967
9,42967,2,2,1, 42969
16,42969,2,2,1, 42971
14,42969,3,3,1, 42972
13,42969,4,4,1, 42973
24,42979,1,1,0, 42980
21,42977,5,5,1, 42982
1,42981,1,1,0, 42982
5,42982,3,3,1, 42985
31,42986,2,2,1, 42988
7,42987,1,1,0, 42988
29,42988,4,4,1, 42992
8,42991,1,1,1, 42992
14,42994,3,3,1, 42997
15,42996,2,2,1, 42998
22,43001,4,4,1, 43005
24,43004,1,1,0, 43005
21,43002,5,5,1, 43007
1,43006,1,1,0, 43007
30,43008,3,3,1, 43011
25,43010,2,2,1, 43012
31,43011,2,2,1, 43013
7,43012,1,1,0, 43013
29,43013,4,4,1, 43017
8,43016,1,1,0, 43017
9,43017,2,2,1, 43019
16,43019,2,2,1, 43021
14,43019,3,3,1, 43022
13,43019,4,4,1, 43023
15,43021,2,2,1, 43023
24,43029,1,1,1, 43030
23,43028,3,3,1, 43031
21,43027,5,5,1, 43032
1,43031,1,1,1, 43032
30,43033,3,3,1, 43036
6,43035,2,2,1, 43037
7,43037,1,1,0, 43038
8,43041,1,1,0, 43042
9,43042,2,2,1, 43044
16,43044,2,2,1, 43046
14,43044,3,3,1, 43047
13,43044,4,4,1, 43048
18,43048,4,4,1, 43052
22,43051,4,4,1, 43055
24,43054,1,1,0, 43055
23,43053,3,3,1, 43056
1,43056,1,1,0, 43057
6,43060,2,2,1, 43062
7,43062,1,1,0, 43063
29,43063,4,4,1, 43067
8,43066,1,1,0, 43067
16,43069,2,2,1, 43071
15,43071,2,2,1, 43073
24,43079,1,1,0, 43080
23,43078,3,3,1, 43081
1,43081,1,1,0, 43082
4,43081,4,4,1, 43085
3,43082,3,3,1, 43085
5,43082,3,3,1, 43085
6,43085,2,2,1, 43087
7,43087,1,1,0, 43088
28,43084,5,5,1, 43089
12,43095,5,5,1, 43100
2,43103,2,2,1, 43105
24,43104,1,1,0, 43105
1,43106,1,1,1, 43107
4,43106,4,4,1, 43110
3,43107,3,3,1, 43110
5,43107,3,3,1, 43110
6,43110,2,2,1, 43112
25,43110,2,2,1, 43112
7,43112,1,1,1, 43113
28,43109,5,5,1, 43114
9,43117,2,2,1, 43119
17,43119,3,3,1, 43122
12,43120,5,5,1, 43125
18,43123,4,4,1, 43127
2,43128,2,2,1, 43130
24,43129,1,1,0, 43130
1,43131,1,1,0, 43132
4,43131,4,4,1, 43135
6,43135,2,2,1, 43137
25,43135,2,2,1, 43137
7,43137,1,1,1, 43138
28,43134,5,5,1, 43139
29,43138,4,4,1, 43142
17,43144,3,3,1, 43147
12,43145,5,5,1, 43150
18,43148,4,4,1, 43152
2,43153,2,2,1, 43155
24,43154,1,1,1, 43155
1,43156,1,1,0, 43157
5,43157,3,3,1, 43160
30,43158,3,3,1, 43161
25,43160,2,2,1, 43162
31,43161,2,2,1, 43163
7,43162,1,1,1, 43163
26,43162,3,3,1, 43165
9,43167,2,2,1, 43169
12,43170,5,5,1, 43175
18,43173,4,4,1, 43177
24,43179,1,1,0, 43180
1,43181,1,1,0, 43182
4,43181,4,4,1, 43185
5,43182,3,3,1, 43185
27,43182,4,4,1, 43186
25,43185,2,2,1, 43187
7,43187,1,1,0, 43188
8,43191,1,1,0, 43192
16,43194,2,2,1, 43196
14,43194,3,3,1, 43197
13,43194,4,4,1, 43198
22,43201,4,4,1, 43205
24,43204,1,1,0, 43205
23,43203,3,3,1, 43206
21,43202,5,5,1, 43207
5,43207,3,3,1, 43210
30,43208,3,3,1, 43211
31,43211,2,2,1, 43213
7,43212,1,1,0, 43213
29,43213,4,4,1, 43217
8,43216,1,1,0, 43217
16,43219,2,2,1, 43221
13,43219,4,4,1, 43223
22,43226,4,4,1, 43230
24,43229,1,1,0, 43230
7,43237,1,1,0, 43238
29,43238,4,4,1, 43242
8,43241,1,1,1, 43242
16,43244,2,2,1, 43246
13,43244,4,4,1, 43248
15,43246,2,2,1, 43248
24,43254,1,1,0, 43255
5,43257,3,3,1, 43260
31,43261,2,2,1, 43263
7,43262,1,1,0, 43263
29,43263,4,4,1, 43267
8,43266,1,1,1, 43267
16,43269,2,2,1, 43271
14,43269,3,3,1, 43272
13,43269,4,4,1, 43273
15,43271,2,2,1, 43273
22,43276,4,4,1, 43280
24,43279,1,1,1, 43280
23,43278,3,3,1, 43281
31,43286,2,2,1, 43288
7,43287,1,1,1, 43288
29,43288,4,4,1, 43292
8,43291,1,1,1, 43292
16,43294,2,2,1, 43296
13,43294,4,4,1, 43298
15,43296,2,2,1, 43298
22,43301,4,4,1, 43305
24,43304,1,1,0, 43305
21,43302,5,5,1, 43307
1,43306,1,1,1, 43307
5,43307,3,3,1, 43310
30,43308,3,3,1, 43311
25,43310,2,2,1, 43312
31,43311,2,2,1, 43313
7,43312,1,1,1, 43313
28,43309,5,5,1, 43314
8,43316,1,1,0, 43317
13,43319,4,4,1, 43323
2,43328,2,2,1, 43330
24,43329,1,1,1, 43330
1,43331,1,1,1, 43332
5,43332,3,3,1, 43335
6,43335,2,2,1, 43337
31,43336,2,2,1, 43338
9,43342,2,2,1, 43344
17,43344,3,3,1, 43347
18,43348,4,4,1, 43352
24,43354,1,1,1, 43355
1,43356,1,1,1, 43357
25,43360,2,2,1, 43362
26,43362,3,3,1, 43365
9,43367,2,2,1, 43369
2,43378,2,2,1, 43380
24,43379,1,1,1, 43380
1,43381,1,1,0, 43382
17,43394,3,3,1, 43397
18,43398,4,4,1, 43402
2,43403,2,2,1, 43405
24,43404,1,1,1, 43405
1,43406,1,1,1, 43407
11,43414,4,4,1, 43418
24,43429,1,1,0, 43430
23,43428,3,3,1, 43431
21,43427,5,5,1, 43432
1,43431,1,1,1, 43432
4,43431,4,4,1, 43435
27,43432,4,4,1, 43436
29,43438,4,4,1, 43442
8,43441,1,1,1, 43442
11,43439,4,4,1, 43443
14,43444,3,3,1, 43447
17,43444,3,3,1, 43447
13,43444,4,4,1, 43448
12,43445,5,5,1, 43450
20,43448,6,6,1, 43454
22,43451,4,4,1, 43455
24,43454,1,1,0, 43455
19,43451,5,5,1, 43456
23,43453,3,3,1, 43456
1,43456,1,1,0, 43457
3,43457,3,3,1, 43460
27,43457,4,4,1, 43461
6,43460,2,2,1, 43462
31,43461,2,2,1, 43463
7,43462,1,1,0, 43463
28,43459,5,5,1, 43464
26,43462,3,3,1, 43465
29,43463,4,4,1, 43467
8,43466,1,1,0, 43467
11,43464,4,4,1, 43468
16,43469,2,2,1, 43471
14,43469,3,3,1, 43472
18,43473,4,4,1, 43477
24,43479,1,1,1, 43480
23,43478,3,3,1, 43481
1,43481,1,1,1, 43482
30,43483,3,3,1, 43486
6,43485,2,2,1, 43487
7,43487,1,1,0, 43488
8,43491,1,1,0, 43492
11,43489,4,4,1, 43493
9,43492,2,2,1, 43494
14,43494,3,3,1, 43497
17,43494,3,3,1, 43497
13,43494,4,4,1, 43498
24,43504,1,1,0, 43505
23,43503,3,3,1, 43506
21,43502,5,5,1, 43507
5,43507,3,3,1, 43510
6,43510,2,2,1, 43512
7,43512,1,1,0, 43513
8,43516,1,1,1, 43517
14,43519,3,3,1, 43522
13,43519,4,4,1, 43523
15,43521,2,2,1, 43523
24,43529,1,1,0, 43530
23,43528,3,3,1, 43531
5,43532,3,3,1, 43535
7,43537,1,1,0, 43538
8,43541,1,1,1, 43542
14,43544,3,3,1, 43547
24,43554,1,1,1, 43555
23,43553,3,3,1, 43556
30,43558,3,3,1, 43561
7,43562,1,1,0, 43563
29,43563,4,4,1, 43567
8,43566,1,1,1, 43567
14,43569,3,3,1, 43572
24,43579,1,1,1, 43580
30,43583,3,3,1, 43586
6,43585,2,2,1, 43587
7,43587,1,1,1, 43588
29,43588,4,4,1, 43592
8,43591,1,1,1, 43592
13,43594,4,4,1, 43598
15,43596,2,2,1, 43598
2,43603,2,2,1, 43605
24,43604,1,1,0, 43605
19,43601,5,5,1, 43606
21,43602,5,5,1, 43607
1,43606,1,1,1, 43607
4,43606,4,4,1, 43610
5,43607,3,3,1, 43610
27,43607,4,4,1, 43611
25,43610,2,2,1, 43612
31,43611,2,2,1, 43613
7,43612,1,1,0, 43613
26,43612,3,3,1, 43615
29,43613,4,4,1, 43617
8,43616,1,1,0, 43617
16,43619,2,2,1, 43621
14,43619,3,3,1, 43622
13,43619,4,4,1, 43623
22,43626,4,4,1, 43630
24,43629,1,1,1, 43630
23,43628,3,3,1, 43631
21,43627,5,5,1, 43632
1,43631,1,1,1, 43632
5,43632,3,3,1, 43635
30,43633,3,3,1, 43636
31,43636,2,2,1, 43638
7,43637,1,1,1, 43638
29,43638,4,4,1, 43642
8,43641,1,1,1, 43642
14,43644,3,3,1, 43647
24,43654,1,1,1, 43655
23,43653,3,3,1, 43656
21,43652,5,5,1, 43657
1,43656,1,1,1, 43657
5,43657,3,3,1, 43660
7,43662,1,1,0, 43663
29,43663,4,4,1, 43667
8,43666,1,1,0, 43667
13,43669,4,4,1, 43673
24,43679,1,1,0, 43680
21,43677,5,5,1, 43682
1,43681,1,1,1, 43682
30,43683,3,3,1, 43686
25,43685,2,2,1, 43687
31,43686,2,2,1, 43688
7,43687,1,1,1, 43688
17,43694,3,3,1, 43697
24,43704,1,1,0, 43705
1,43706,1,1,1, 43707
25,43710,2,2,1, 43712
31,43711,2,2,1, 43713
7,43712,1,1,1, 43713
29,43713,4,4,1, 43717
9,43717,2,2,1, 43719
18,43723,4,4,1, 43727
2,43728,2,2,1, 43730
24,43729,1,1,0, 43730
1,43731,1,1,1, 43732
30,43733,3,3,1, 43736
6,43735,2,2,1, 43737
7,43737,1,1,1, 43738
29,43738,4,4,1, 43742
24,43754,1,1,0, 43755
1,43756,1,1,1, 43757
5,43757,3,3,1, 43760
31,43761,2,2,1, 43763
7,43762,1,1,0, 43763
26,43762,3,3,1, 43765
17,43769,3,3,1, 43772
24,43779,1,1,1, 43780
1,43781,1,1,0, 43782
5,43782,3,3,1, 43785
30,43783,3,3,1, 43786
31,43786,2,2,1, 43788
7,43787,1,1,1, 43788
8,43791,1,1,0, 43792
13,43794,4,4,1, 43798
15,43796,2,2,1, 43798
18,43798,4,4,1, 43802
2,43803,2,2,1, 43805
24,43804,1,1,0, 43805
19,43801,5,5,1, 43806
23,43803,3,3,1, 43806
1,43806,1,1,1, 43807
30,43808,3,3,1, 43811
25,43810,2,2,1, 43812
7,43812,1,1,0, 43813
28,43809,5,5,1, 43814
8,43816,1,1,0, 43817
11,43814,4,4,1, 43818
16,43819,2,2,1, 43821
13,43819,4,4,1, 43823
12,43820,5,5,1, 43825
24,43829,1,1,0, 43830
19,43826,5,5,1, 43831
23,43828,3,3,1, 43831
21,43827,5,5,1, 43832
1,43831,1,1,1, 43832
4,43831,4,4,1, 43835
3,43832,3,3,1, 43835
27,43832,4,4,1, 43836
25,43835,2,2,1, 43837
31,43836,2,2,1, 43838
7,43837,1,1,1, 43838
26,43837,3,3,1, 43840
29,43838,4,4,1, 43842
8,43841,1,1,0, 43842
11,43839,4,4,1, 43843
9,43842,2,2,1, 43844
14,43844,3,3,1, 43847
13,43844,4,4,1, 43848
24,43854,1,1,0, 43855
19,43851,5,5,1, 43856
1,43856,1,1,0, 43857
5,43857,3,3,1, 43860
27,43857,4,4,1, 43861
30,43858,3,3,1, 43861
25,43860,2,2,1, 43862
31,43861,2,2,1, 43863
7,43862,1,1,0, 43863
28,43859,5,5,1, 43864
29,43863,4,4,1, 43867
8,43866,1,1,0, 43867
9,43867,2,2,1, 43869
14,43869,3,3,1, 43872
17,43869,3,3,1, 43872
22,43876,4,4,1, 43880
24,43879,1,1,1, 43880
5,43882,3,3,1, 43885
30,43883,3,3,1, 43886
6,43885,2,2,1, 43887
7,43887,1,1,0, 43888
8,43891,1,1,0, 43892
14,43894,3,3,1, 43897
13,43894,4,4,1, 43898
15,43896,2,2,1, 43898
24,43904,1,1,0, 43905
5,43907,3,3,1, 43910
6,43910,2,2,1, 43912
7,43912,1,1,1, 43913
29,43913,4,4,1, 43917
8,43916,1,1,1, 43917
14,43919,3,3,1, 43922
15,43921,2,2,1, 43923
24,43929,1,1,1, 43930
5,43932,3,3,1, 43935
7,43937,1,1,1, 43938
8,43941,1,1,1, 43942
16,43944,2,2,1, 43946
14,43944,3,3,1, 43947
13,43944,4,4,1, 43948
24,43954,1,1,0, 43955
30,43958,3,3,1, 43961
7,43962,1,1,1, 43963
29,43963,4,4,1, 43967
8,43966,1,1,0, 43967
13,43969,4,4,1, 43973
22,43976,4,4,1, 43980
24,43979,1,1,0, 43980
23,43978,3,3,1, 43981
1,43981,1,1,0, 43982
5,43982,3,3,1, 43985
30,43983,3,3,1, 43986
6,43985,2,2,1, 43987
31,43986,2,2,1, 43988
7,43987,1,1,0, 43988
8,43991,1,1,0, 43992
14,43994,3,3,1, 43997
22,44001,4,4,1, 44005
24,44004,1,1,0, 44005
1,44006,1,1,0, 44007
6,44010,2,2,1, 44012
25,44010,2,2,1, 44012
7,44012,1,1,1, 44013
8,44016,1,1,0, 44017
14,44019,3,3,1, 44022
17,44019,3,3,1, 44022
15,44021,2,2,1, 44023
22,44026,4,4,1, 44030
24,44029,1,1,1, 44030
23,44028,3,3,1, 44031
1,44031,1,1,1, 44032
5,44032,3,3,1, 44035
30,44033,3,3,1, 44036
7,44037,1,1,1, 44038
29,44038,4,4,1, 44042
8,44041,1,1,0, 44042
16,44044,2,2,1, 44046
17,44044,3,3,1, 44047
13,44044,4,4,1, 44048
22,44051,4,4,1, 44055
24,44054,1,1,0, 44055
1,44056,1,1,1, 44057
5,44057,3,3,1, 44060
6,44060,2,2,1, 44062
25,44060,2,2,1, 44062
7,44062,1,1,0, 44063
26,44062,3,3,1, 44065
29,44063,4,4,1, 44067
8,44066,1,1,0, 44067
13,44069,4,4,1, 44073
15,44071,2,2,1, 44073
18,44073,4,4,1, 44077
22,44076,4,4,1, 44080
24,44079,1,1,0, 44080
1,44081,1,1,1, 44082
30,44083,3,3,1, 44086
6,44085,2,2,1, 44087
25,44085,2,2,1, 44087
7,44087,1,1,1, 44088
26,44087,3,3,1, 44090
29,44088,4,4,1, 44092
8,44091,1,1,0, 44092
17,44094,3,3,1, 44097
13,44094,4,4,1, 44098
12,44095,5,5,1, 44100
18,44098,4,4,1, 44102
2,44103,2,2,1, 44105
24,44104,1,1,0, 44105
19,44101,5,5,1, 44106
23,44103,3,3,1, 44106
21,44102,5,5,1, 44107
1,44106,1,1,1, 44107
4,44106,4,4,1, 44110
25,44110,2,2,1, 44112
28,44109,5,5,1, 44114
8,44116,1,1,0, 44117
11,44114,4,4,1, 44118
9,44117,2,2,1, 44119
14,44119,3,3,1, 44122
15,44121,2,2,1, 44123
18,44123,4,4,1, 44127
22,44126,4,4,1, 44130
24,44129,1,1,1, 44130
23,44128,3,3,1, 44131
1,44131,1,1,1, 44132
3,44132,3,3,1, 44135
26,44137,3,3,1, 44140
9,44142,2,2,1, 44144
20,44148,6,6,1, 44154
24,44154,1,1,1, 44155
19,44151,5,5,1, 44156
1,44156,1,1,0, 44157
4,44156,4,4,1, 44160
27,44157,4,4,1, 44161
25,44160,2,2,1, 44162
11,44164,4,4,1, 44168
24,44179,1,1,0, 44180
24,44204,1,1,0, 44205
31,44211,2,2,1, 44213
7,44212,1,1,0, 44213
24,44229,1,1,1, 44230
5,44232,3,3,1, 44235
6,44235,2,2,1, 44237
31,44236,2,2,1, 44238
7,44237,1,1,0, 44238
29,44238,4,4,1, 44242
8,44241,1,1,1, 44242
14,44244,3,3,1, 44247
13,44244,4,4,1, 44248
22,44251,4,4,1, 44255
24,44254,1,1,0, 44255
21,44252,5,5,1, 44257
5,44257,3,3,1, 44260
30,44258,3,3,1, 44261
6,44260,2,2,1, 44262
31,44261,2,2,1, 44263
7,44262,1,1,1, 44263
29,44263,4,4,1, 44267
8,44266,1,1,0, 44267
16,44269,2,2,1, 44271
17,44269,3,3,1, 44272
15,44271,2,2,1, 44273
22,44276,4,4,1, 44280
24,44279,1,1,0, 44280
23,44278,3,3,1, 44281
21,44277,5,5,1, 44282
1,44281,1,1,0, 44282
5,44282,3,3,1, 44285
30,44283,3,3,1, 44286
6,44285,2,2,1, 44287
25,44285,2,2,1, 44287
31,44286,2,2,1, 44288
7,44287,1,1,0, 44288
29,44288,4,4,1, 44292
8,44291,1,1,0, 44292
9,44292,2,2,1, 44294
14,44294,3,3,1, 44297
17,44294,3,3,1, 44297
24,44304,1,1,0, 44305
1,44306,1,1,0, 44307
30,44308,3,3,1, 44311
31,44311,2,2,1, 44313
7,44312,1,1,0, 44313
8,44316,1,1,0, 44317
14,44319,3,3,1, 44322
17,44319,3,3,1, 44322
15,44321,2,2,1, 44323
18,44323,4,4,1, 44327
22,44326,4,4,1, 44330
24,44329,1,1,0, 44330
23,44328,3,3,1, 44331
21,44327,5,5,1, 44332
1,44331,1,1,1, 44332
5,44332,3,3,1, 44335
30,44333,3,3,1, 44336
6,44335,2,2,1, 44337
25,44335,2,2,1, 44337
31,44336,2,2,1, 44338
7,44337,1,1,1, 44338
29,44338,4,4,1, 44342
8,44341,1,1,1, 44342
9,44342,2,2,1, 44344
16,44344,2,2,1, 44346
22,44351,4,4,1, 44355
24,44354,1,1,0, 44355
23,44353,3,3,1, 44356
1,44356,1,1,0, 44357
5,44357,3,3,1, 44360
30,44358,3,3,1, 44361
6,44360,2,2,1, 44362
25,44360,2,2,1, 44362
31,44361,2,2,1, 44363
7,44362,1,1,0, 44363
29,44363,4,4,1, 44367
8,44366,1,1,1, 44367
17,44369,3,3,1, 44372
18,44373,4,4,1, 44377
22,44376,4,4,1, 44380
24,44379,1,1,0, 44380
23,44378,3,3,1, 44381
21,44377,5,5,1, 44382
1,44381,1,1,0, 44382
5,44382,3,3,1, 44385
25,44385,2,2,1, 44387
31,44386,2,2,1, 44388
7,44387,1,1,0, 44388
26,44387,3,3,1, 44390
29,44388,4,4,1, 44392
8,44391,1,1,1, 44392
9,44392,2,2,1, 44394
16,44394,2,2,1, 44396
17,44394,3,3,1, 44397
15,44396,2,2,1, 44398
18,44398,4,4,1, 44402
24,44404,1,1,1, 44405
19,44401,5,5,1, 44406
21,44402,5,5,1, 44407
1,44406,1,1,0, 44407
27,44407,4,4,1, 44411
28,44409,5,5,1, 44414
26,44412,3,3,1, 44415
8,44416,1,1,0, 44417
16,44419,2,2,1, 44421
14,44419,3,3,1, 44422
17,44419,3,3,1, 44422
13,44419,4,4,1, 44423
12,44420,5,5,1, 44425
24,44429,1,1,1, 44430
19,44426,5,5,1, 44431
23,44428,3,3,1, 44431
21,44427,5,5,1, 44432
1,44431,1,1,1, 44432
3,44432,3,3,1, 44435
27,44432,4,4,1, 44436
25,44435,2,2,1, 44437
28,44434,5,5,1, 44439
8,44441,1,1,1, 44442
9,44442,2,2,1, 44444
16,44444,2,2,1, 44446
14,44444,3,3,1, 44447
24,44454,1,1,1, 44455
21,44452,5,5,1, 44457
24,44479,1,1,1, 44480
24,44504,1,1,1, 44505
7,44512,1,1,1, 44513
24,44529,1,1,1, 44530
5,44532,3,3,1, 44535
31,44536,2,2,1, 44538
7,44537,1,1,0, 44538
29,44538,4,4,1, 44542
24,44554,1,1,0, 44555
1,44556,1,1,0, 44557
5,44557,3,3,1, 44560
6,44560,2,2,1, 44562
25,44560,2,2,1, 44562
7,44562,1,1,0, 44563
29,44563,4,4,1, 44567
8,44566,1,1,0, 44567
14,44569,3,3,1, 44572
17,44569,3,3,1, 44572
22,44576,4,4,1, 44580
24,44579,1,1,1, 44580
1,44581,1,1,1, 44582
5,44582,3,3,1, 44585
6,44585,2,2,1, 44587
7,44587,1,1,1, 44588
29,44588,4,4,1, 44592
8,44591,1,1,1, 44592
9,44592,2,2,1, 44594
14,44594,3,3,1, 44597
17,44594,3,3,1, 44597
13,44594,4,4,1, 44598
15,44596,2,2,1, 44598
22,44601,4,4,1, 44605
24,44604,1,1,1, 44605
23,44603,3,3,1, 44606
1,44606,1,1,0, 44607
30,44608,3,3,1, 44611
25,44610,2,2,1, 44612
31,44611,2,2,1, 44613
7,44612,1,1,1, 44613
8,44616,1,1,0, 44617
9,44617,2,2,1, 44619
14,44619,3,3,1, 44622
15,44621,2,2,1, 44623
24,44629,1,1,1, 44630
1,44631,1,1,0, 44632
4,44631,4,4,1, 44635
3,44632,3,3,1, 44635
6,44635,2,2,1, 44637
25,44635,2,2,1, 44637
31,44636,2,2,1, 44638
7,44637,1,1,1, 44638
29,44638,4,4,1, 44642
8,44641,1,1,0, 44642
11,44639,4,4,1, 44643
17,44644,3,3,1, 44647
15,44646,2,2,1, 44648
24,44654,1,1,1, 44655
1,44656,1,1,0, 44657
30,44658,3,3,1, 44661
7,44662,1,1,1, 44663
29,44663,4,4,1, 44667
8,44666,1,1,1, 44667
16,44669,2,2,1, 44671
14,44669,3,3,1, 44672
17,44669,3,3,1, 44672
18,44673,4,4,1, 44677
2,44678,2,2,1, 44680
24,44679,1,1,0, 44680
23,44678,3,3,1, 44681
1,44681,1,1,1, 44682
6,44685,2,2,1, 44687
25,44685,2,2,1, 44687
7,44687,1,1,1, 44688
29,44688,4,4,1, 44692
8,44691,1,1,0, 44692
9,44692,2,2,1, 44694
15,44696,2,2,1, 44698
22,44701,4,4,1, 44705
24,44704,1,1,1, 44705
23,44703,3,3,1, 44706
1,44706,1,1,1, 44707
30,44708,3,3,1, 44711
6,44710,2,2,1, 44712
31,44711,2,2,1, 44713
7,44712,1,1,1, 44713
8,44716,1,1,0, 44717
9,44717,2,2,1, 44719
16,44719,2,2,1, 44721
14,44719,3,3,1, 44722
13,44719,4,4,1, 44723
22,44726,4,4,1, 44730
2,44728,2,2,1, 44730
24,44729,1,1,0, 44730
23,44728,3,3,1, 44731
1,44731,1,1,0, 44732
31,44736,2,2,1, 44738
7,44737,1,1,1, 44738
26,44737,3,3,1, 44740
8,44741,1,1,0, 44742
16,44744,2,2,1, 44746
15,44746,2,2,1, 44748
12,44745,5,5,1, 44750
20,44748,6,6,1, 44754
24,44754,1,1,1, 44755
21,44752,5,5,1, 44757
1,44756,1,1,1, 44757
4,44756,4,4,1, 44760
3,44757,3,3,1, 44760
5,44757,3,3,1, 44760
30,44758,3,3,1, 44761
6,44760,2,2,1, 44762
7,44762,1,1,0, 44763
26,44762,3,3,1, 44765
29,44763,4,4,1, 44767
8,44766,1,1,1, 44767
9,44767,2,2,1, 44769
16,44769,2,2,1, 44771
17,44769,3,3,1, 44772
15,44771,2,2,1, 44773
12,44770,5,5,1, 44775
18,44773,4,4,1, 44777
24,44779,1,1,0, 44780
1,44781,1,1,0, 44782
3,44782,3,3,1, 44785
27,44782,4,4,1, 44786
25,44785,2,2,1, 44787
7,44787,1,1,1, 44788
29,44788,4,4,1, 44792
8,44791,1,1,0, 44792
11,44789,4,4,1, 44793
16,44794,2,2,1, 44796
15,44796,2,2,1, 44798
12,44795,5,5,1, 44800
18,44798,4,4,1, 44802
20,44798,6,6,1, 44804
24,44804,1,1,1, 44805
6,44810,2,2,1, 44812
31,44811,2,2,1, 44813
7,44812,1,1,0, 44813
29,44813,4,4,1, 44817
8,44816,1,1,1, 44817
16,44819,2,2,1, 44821
15,44821,2,2,1, 44823
24,44829,1,1,0, 44830
21,44827,5,5,1, 44832
31,44836,2,2,1, 44838
7,44837,1,1,0, 44838
8,44841,1,1,1, 44842
16,44844,2,2,1, 44846
13,44844,4,4,1, 44848
15,44846,2,2,1, 44848
22,44851,4,4,1, 44855
24,44854,1,1,1, 44855
23,44853,3,3,1, 44856
30,44858,3,3,1, 44861
31,44861,2,2,1, 44863
7,44862,1,1,1, 44863
29,44863,4,4,1, 44867
8,44866,1,1,1, 44867
16,44869,2,2,1, 44871
24,44879,1,1,0, 44880
5,44882,3,3,1, 44885
6,44885,2,2,1, 44887
31,44886,2,2,1, 44888
7,44887,1,1,0, 44888
8,44891,1,1,1, 44892
13,44894,4,4,1, 44898
24,44904,1,1,1, 44905
23,44903,3,3,1, 44906
1,44906,1,1,0, 44907
5,44907,3,3,1, 44910
7,44912,1,1,0, 44913
29,44913,4,4,1, 44917
8,44916,1,1,0, 44917
14,44919,3,3,1, 44922
13,44919,4,4,1, 44923
15,44921,2,2,1, 44923
24,44929,1,1,0, 44930
21,44927,5,5,1, 44932
1,44931,1,1,0, 44932
25,44935,2,2,1, 44937
7,44937,1,1,1, 44938
29,44938,4,4,1, 44942
9,44942,2,2,1, 44944
24,44954,1,1,0, 44955
1,44956,1,1,1, 44957
6,44960,2,2,1, 44962
25,44960,2,2,1, 44962
31,44961,2,2,1, 44963
7,44962,1,1,0, 44963
29,44963,4,4,1, 44967
9,44967,2,2,1, 44969
17,44969,3,3,1, 44972
24,44979,1,1,1, 44980
1,44981,1,1,0, 44982
30,44983,3,3,1, 44986
6,44985,2,2,1, 44987
31,44986,2,2,1, 44988
7,44987,1,1,1, 44988
26,44987,3,3,1, 44990
29,44988,4,4,1, 44992
12,44995,5,5,1, 45000
18,44998,4,4,1, 45002
20,44998,6,6,1, 45004
2,45003,2,2,1, 45005
24,45004,1,1,0, 45005
1,45006,1,1,0, 45007
5,45007,3,3,1, 45010
25,45010,2,2,1, 45012
31,45011,2,2,1, 45013
7,45012,1,1,0, 45013
9,45017,2,2,1, 45019
17,45019,3,3,1, 45022
18,45023,4,4,1, 45027
2,45028,2,2,1, 45030
24,45029,1,1,0, 45030
1,45031,1,1,0, 45032
6,45035,2,2,1, 45037
25,45035,2,2,1, 45037
31,45036,2,2,1, 45038
7,45037,1,1,0, 45038
26,45037,3,3,1, 45040
16,45044,2,2,1, 45046
18,45048,4,4,1, 45052
24,45054,1,1,1, 45055
1,45056,1,1,1, 45057
5,45057,3,3,1, 45060
30,45058,3,3,1, 45061
31,45061,2,2,1, 45063
7,45062,1,1,0, 45063
8,45066,1,1,1, 45067
9,45067,2,2,1, 45069
14,45069,3,3,1, 45072
18,45073,4,4,1, 45077
22,45076,4,4,1, 45080
24,45079,1,1,0, 45080
23,45078,3,3,1, 45081
1,45081,1,1,1, 45082
5,45082,3,3,1, 45085
30,45083,3,3,1, 45086
31,45086,2,2,1, 45088
7,45087,1,1,1, 45088
26,45087,3,3,1, 45090
29,45088,4,4,1, 45092
8,45091,1,1,1, 45092
16,45094,2,2,1, 45096
14,45094,3,3,1, 45097
17,45094,3,3,1, 45097
13,45094,4,4,1, 45098
2,45103,2,2,1, 45105
24,45104,1,1,1, 45105
23,45103,3,3,1, 45106
1,45106,1,1,0, 45107
30,45108,3,3,1, 45111
7,45112,1,1,0, 45113
8,45116,1,1,0, 45117
9,45117,2,2,1, 45119
16,45119,2,2,1, 45121
14,45119,3,3,1, 45122
13,45119,4,4,1, 45123
12,45120,5,5,1, 45125
18,45123,4,4,1, 45127
22,45126,4,4,1, 45130
2,45128,2,2,1, 45130
24,45129,1,1,1, 45130
1,45131,1,1,0, 45132
4,45131,4,4,1, 45135
3,45132,3,3,1, 45135
27,45132,4,4,1, 45136
30,45133,3,3,1, 45136
6,45135,2,2,1, 45137
25,45135,2,2,1, 45137
7,45137,1,1,0, 45138
8,45141,1,1,1, 45142
14,45144,3,3,1, 45147
13,45144,4,4,1, 45148
15,45146,2,2,1, 45148
24,45154,1,1,1, 45155
1,45156,1,1,1, 45157
3,45157,3,3,1, 45160
27,45157,4,4,1, 45161
6,45160,2,2,1, 45162
25,45160,2,2,1, 45162
7,45162,1,1,1, 45163
8,45166,1,1,0, 45167
16,45169,2,2,1, 45171
14,45169,3,3,1, 45172
15,45171,2,2,1, 45173
24,45179,1,1,0, 45180
21,45177,5,5,1, 45182
30,45183,3,3,1, 45186
31,45186,2,2,1, 45188
7,45187,1,1,0, 45188
8,45191,1,1,0, 45192
24,45204,1,1,0, 45205
6,45210,2,2,1, 45212
7,45212,1,1,1, 45213
8,45216,1,1,1, 45217
22,45226,4,4,1, 45230
24,45229,1,1,0, 45230
23,45228,3,3,1, 45231
6,45235,2,2,1, 45237
31,45236,2,2,1, 45238
7,45237,1,1,1, 45238
29,45238,4,4,1, 45242
8,45241,1,1,0, 45242
14,45244,3,3,1, 45247
13,45244,4,4,1, 45248
15,45246,2,2,1, 45248
22,45251,4,4,1, 45255
24,45254,1,1,0, 45255
23,45253,3,3,1, 45256
21,45252,5,5,1, 45257
30,45258,3,3,1, 45261
31,45261,2,2,1, 45263
7,45262,1,1,0, 45263
29,45263,4,4,1, 45267
8,45266,1,1,0, 45267
9,45267,2,2,1, 45269
13,45269,4,4,1, 45273
15,45271,2,2,1, 45273
24,45279,1,1,0, 45280
1,45281,1,1,0, 45282
30,45283,3,3,1, 45286
7,45287,1,1,0, 45288
8,45291,1,1,1, 45292
16,45294,2,2,1, 45296
14,45294,3,3,1, 45297
15,45296,2,2,1, 45298
24,45304,1,1,0, 45305
23,45303,3,3,1, 45306
1,45306,1,1,1, 45307
30,45308,3,3,1, 45311
6,45310,2,2,1, 45312
7,45312,1,1,1, 45313
8,45316,1,1,0, 45317
9,45317,2,2,1, 45319
17,45319,3,3,1, 45322
13,45319,4,4,1, 45323
15,45321,2,2,1, 45323
22,45326,4,4,1, 45330
24,45329,1,1,0, 45330
23,45328,3,3,1, 45331
1,45331,1,1,1, 45332
5,45332,3,3,1, 45335
30,45333,3,3,1, 45336
31,45336,2,2,1, 45338
7,45337,1,1,1, 45338
8,45341,1,1,1, 45342
9,45342,2,2,1, 45344
16,45344,2,2,1, 45346
18,45348,4,4,1, 45352
2,45353,2,2,1, 45355
24,45354,1,1,0, 45355
21,45352,5,5,1, 45357
1,45356,1,1,0, 45357
6,45360,2,2,1, 45362
25,45360,2,2,1, 45362
7,45362,1,1,1, 45363
8,45366,1,1,0, 45367
16,45369,2,2,1, 45371
14,45369,3,3,1, 45372
17,45369,3,3,1, 45372
18,45373,4,4,1, 45377
2,45378,2,2,1, 45380
24,45379,1,1,0, 45380
1,45381,1,1,1, 45382
5,45382,3,3,1, 45385
30,45383,3,3,1, 45386
6,45385,2,2,1, 45387
31,45386,2,2,1, 45388
7,45387,1,1,0, 45388
17,45394,3,3,1, 45397
24,45404,1,1,0, 45405
1,45406,1,1,1, 45407
30,45408,3,3,1, 45411
6,45410,2,2,1, 45412
7,45412,1,1,0, 45413
24,45429,1,1,0, 45430
1,45431,1,1,1, 45432
30,45433,3,3,1, 45436
25,45435,2,2,1, 45437
7,45437,1,1,0, 45438
29,45438,4,4,1, 45442
9,45442,2,2,1, 45444
17,45444,3,3,1, 45447
12,45445,5,5,1, 45450
20,45448,6,6,1, 45454
24,45454,1,1,1, 45455
1,45456,1,1,1, 45457
4,45456,4,4,1, 45460
3,45457,3,3,1, 45460
30,45458,3,3,1, 45461
25,45460,2,2,1, 45462
7,45462,1,1,0, 45463
17,45469,3,3,1, 45472
12,45470,5,5,1, 45475
20,45473,6,6,1, 45479
2,45478,2,2,1, 45480
24,45479,1,1,0, 45480
21,45477,5,5,1, 45482
1,45481,1,1,0, 45482
4,45481,4,4,1, 45485
3,45482,3,3,1, 45485
5,45482,3,3,1, 45485
30,45483,3,3,1, 45486
6,45485,2,2,1, 45487
7,45487,1,1,1, 45488
28,45484,5,5,1, 45489
26,45487,3,3,1, 45490
8,45491,1,1,0, 45492
11,45489,4,4,1, 45493
9,45492,2,2,1, 45494
14,45494,3,3,1, 45497
13,45494,4,4,1, 45498
15,45496,2,2,1, 45498
18,45498,4,4,1, 45502
24,45504,1,1,0, 45505
23,45503,3,3,1, 45506
21,45502,5,5,1, 45507
1,45506,1,1,1, 45507
4,45506,4,4,1, 45510
3,45507,3,3,1, 45510
6,45510,2,2,1, 45512
25,45510,2,2,1, 45512
31,45511,2,2,1, 45513
7,45512,1,1,1, 45513
29,45513,4,4,1, 45517
8,45516,1,1,1, 45517
11,45514,4,4,1, 45518
16,45519,2,2,1, 45521
14,45519,3,3,1, 45522
12,45520,5,5,1, 45525
18,45523,4,4,1, 45527
24,45529,1,1,1, 45530
23,45528,3,3,1, 45531
5,45532,3,3,1, 45535
6,45535,2,2,1, 45537
7,45537,1,1,0, 45538
8,45541,1,1,1, 45542
16,45544,2,2,1, 45546
14,45544,3,3,1, 45547
22,45551,4,4,1, 45555
24,45554,1,1,0, 45555
23,45553,3,3,1, 45556
6,45560,2,2,1, 45562
7,45562,1,1,0, 45563
29,45563,4,4,1, 45567
8,45566,1,1,0, 45567
13,45569,4,4,1, 45573
24,45579,1,1,0, 45580
21,45577,5,5,1, 45582
6,45585,2,2,1, 45587
7,45587,1,1,1, 45588
29,45588,4,4,1, 45592
8,45591,1,1,1, 45592
14,45594,3,3,1, 45597
13,45594,4,4,1, 45598
24,45604,1,1,1, 45605
23,45603,3,3,1, 45606
5,45607,3,3,1, 45610
30,45608,3,3,1, 45611
7,45612,1,1,0, 45613
8,45616,1,1,0, 45617
16,45619,2,2,1, 45621
14,45619,3,3,1, 45622
24,45629,1,1,0, 45630
21,45627,5,5,1, 45632
1,45631,1,1,0, 45632
5,45632,3,3,1, 45635
30,45633,3,3,1, 45636
6,45635,2,2,1, 45637
25,45635,2,2,1, 45637
7,45637,1,1,0, 45638
8,45641,1,1,1, 45642
9,45642,2,2,1, 45644
16,45644,2,2,1, 45646
14,45644,3,3,1, 45647
17,45644,3,3,1, 45647
15,45646,2,2,1, 45648
22,45651,4,4,1, 45655
24,45654,1,1,0, 45655
1,45656,1,1,1, 45657
5,45657,3,3,1, 45660
30,45658,3,3,1, 45661
25,45660,2,2,1, 45662
31,45661,2,2,1, 45663
7,45662,1,1,0, 45663
8,45666,1,1,0, 45667
16,45669,2,2,1, 45671
14,45669,3,3,1, 45672
17,45669,3,3,1, 45672
13,45669,4,4,1, 45673
2,45678,2,2,1, 45680
24,45679,1,1,1, 45680
1,45681,1,1,1, 45682
30,45683,3,3,1, 45686
6,45685,2,2,1, 45687
25,45685,2,2,1, 45687
7,45687,1,1,0, 45688
20,45698,6,6,1, 45704
24,45704,1,1,1, 45705
19,45701,5,5,1, 45706
1,45706,1,1,1, 45707
3,45707,3,3,1, 45710
5,45707,3,3,1, 45710
27,45707,4,4,1, 45711
30,45708,3,3,1, 45711
6,45710,2,2,1, 45712
25,45710,2,2,1, 45712
31,45711,2,2,1, 45713
7,45712,1,1,1, 45713
28,45709,5,5,1, 45714
26,45712,3,3,1, 45715
29,45713,4,4,1, 45717
11,45714,4,4,1, 45718
9,45717,2,2,1, 45719
12,45720,5,5,1, 45725
18,45723,4,4,1, 45727
24,45729,1,1,1, 45730
1,45731,1,1,1, 45732
3,45732,3,3,1, 45735
27,45732,4,4,1, 45736
26,45737,3,3,1, 45740
20,45748,6,6,1, 45754
2,45753,2,2,1, 45755
24,45754,1,1,0, 45755
1,45756,1,1,1, 45757
4,45756,4,4,1, 45760
24,45779,1,1,1, 45780
23,45778,3,3,1, 45781
8,45791,1,1,1, 45792
13,45794,4,4,1, 45798
22,45801,4,4,1, 45805
24,45804,1,1,0, 45805
8,45816,1,1,0, 45817
13,45819,4,4,1, 45823
15,45821,2,2,1, 45823
24,45829,1,1,1, 45830
23,45828,3,3,1, 45831
21,45827,5,5,1, 45832
7,45837,1,1,0, 45838
29,45838,4,4,1, 45842
8,45841,1,1,1, 45842
13,45844,4,4,1, 45848
22,45851,4,4,1, 45855
24,45854,1,1,0, 45855
23,45853,3,3,1, 45856
21,45852,5,5,1, 45857
30,45858,3,3,1, 45861
6,45860,2,2,1, 45862
31,45861,2,2,1, 45863
7,45862,1,1,0, 45863
8,45866,1,1,1, 45867
16,45869,2,2,1, 45871
14,45869,3,3,1, 45872
17,45869,3,3,1, 45872
13,45869,4,4,1, 45873
15,45871,2,2,1, 45873
24,45879,1,1,0, 45880
21,45877,5,5,1, 45882
1,45881,1,1,1, 45882
31,45886,2,2,1, 45888
7,45887,1,1,0, 45888
8,45891,1,1,1, 45892
9,45892,2,2,1, 45894
14,45894,3,3,1, 45897
22,45901,4,4,1, 45905
24,45904,1,1,1, 45905
21,45902,5,5,1, 45907
1,45906,1,1,1, 45907
5,45907,3,3,1, 45910
25,45910,2,2,1, 45912
7,45912,1,1,0, 45913
29,45913,4,4,1, 45917
8,45916,1,1,0, 45917
17,45919,3,3,1, 45922
13,45919,4,4,1, 45923
24,45929,1,1,0, 45930
21,45927,5,5,1, 45932
1,45931,1,1,0, 45932
30,45933,3,3,1, 45936
7,45937,1,1,1, 45938
29,45938,4,4,1, 45942
8,45941,1,1,0, 45942
9,45942,2,2,1, 45944
17,45944,3,3,1, 45947
18,45948,4,4,1, 45952
22,45951,4,4,1, 45955
24,45954,1,1,1, 45955
19,45951,5,5,1, 45956
23,45953,3,3,1, 45956
21,45952,5,5,1, 45957
1,45956,1,1,1, 45957
4,45956,4,4,1, 45960
31,45961,2,2,1, 45963
7,45962,1,1,0, 45963
29,45963,4,4,1, 45967
8,45966,1,1,0, 45967
16,45969,2,2,1, 45971
15,45971,2,2,1, 45973
20,45973,6,6,1, 45979
2,45978,2,2,1, 45980
24,45979,1,1,0, 45980
23,45978,3,3,1, 45981
21,45977,5,5,1, 45982
1,45981,1,1,0, 45982
6,45985,2,2,1, 45987
31,45986,2,2,1, 45988
7,45987,1,1,0, 45988
28,45984,5,5,1, 45989
26,45987,3,3,1, 45990
29,45988,4,4,1, 45992
8,45991,1,1,0, 45992
17,45994,3,3,1, 45997
15,45996,2,2,1, 45998
22,46001,4,4,1, 46005
24,46004,1,1,1, 46005
1,46006,1,1,0, 46007
3,46007,3,3,1, 46010
27,46007,4,4,1, 46011
30,46008,3,3,1, 46011
7,46012,1,1,0, 46013
28,46009,5,5,1, 46014
26,46012,3,3,1, 46015
29,46013,4,4,1, 46017
8,46016,1,1,1, 46017
11,46014,4,4,1, 46018
9,46017,2,2,1, 46019
16,46019,2,2,1, 46021
18,46023,4,4,1, 46027
24,46029,1,1,1, 46030
1,46031,1,1,0, 46032
30,46033,3,3,1, 46036
25,46035,2,2,1, 46037
7,46037,1,1,0, 46038
26,46037,3,3,1, 46040
29,46038,4,4,1, 46042
18,46048,4,4,1, 46052
2,46053,2,2,1, 46055
24,46054,1,1,1, 46055
1,46056,1,1,0, 46057
30,46058,3,3,1, 46061
25,46060,2,2,1, 46062
7,46062,1,1,1, 46063
18,46073,4,4,1, 46077
2,46078,2,2,1, 46080
24,46079,1,1,1, 46080
1,46081,1,1,1, 46082
5,46082,3,3,1, 46085
7,46087,1,1,1, 46088
29,46088,4,4,1, 46092
2,46103,2,2,1, 46105
24,46104,1,1,1, 46105
1,46106,1,1,1, 46107
5,46107,3,3,1, 46110
6,46110,2,2,1, 46112
7,46112,1,1,0, 46113
2,46128,2,2,1, 46130
24,46129,1,1,0, 46130
19,46126,5,5,1, 46131
21,46127,5,5,1, 46132
1,46131,1,1,0, 46132
4,46131,4,4,1, 46135
3,46132,3,3,1, 46135
5,46132,3,3,1, 46135
30,46133,3,3,1, 46136
25,46135,2,2,1, 46137
7,46137,1,1,0, 46138
29,46138,4,4,1, 46142
8,46141,1,1,0, 46142
9,46142,2,2,1, 46144
16,46144,2,2,1, 46146
14,46144,3,3,1, 46147
15,46146,2,2,1, 46148
12,46145,5,5,1, 46150
22,46151,4,4,1, 46155
24,46154,1,1,1, 46155
19,46151,5,5,1, 46156
1,46156,1,1,1, 46157
4,46156,4,4,1, 46160
30,46158,3,3,1, 46161
31,46161,2,2,1, 46163
7,46162,1,1,0, 46163
8,46166,1,1,0, 46167
16,46169,2,2,1, 46171
14,46169,3,3,1, 46172
13,46169,4,4,1, 46173
22,46176,4,4,1, 46180
24,46179,1,1,1, 46180
23,46178,3,3,1, 46181
5,46182,3,3,1, 46185
6,46185,2,2,1, 46187
7,46187,1,1,0, 46188
8,46191,1,1,0, 46192
14,46194,3,3,1, 46197
13,46194,4,4,1, 46198
15,46196,2,2,1, 46198
24,46204,1,1,0, 46205
23,46203,3,3,1, 46206
5,46207,3,3,1, 46210
6,46210,2,2,1, 46212
7,46212,1,1,1, 46213
8,46216,1,1,1, 46217
14,46219,3,3,1, 46222
13,46219,4,4,1, 46223
24,46229,1,1,0, 46230
23,46228,3,3,1, 46231
6,46235,2,2,1, 46237
7,46237,1,1,0, 46238
29,46238,4,4,1, 46242
8,46241,1,1,0, 46242
14,46244,3,3,1, 46247
13,46244,4,4,1, 46248
15,46246,2,2,1, 46248
24,46254,1,1,0, 46255
30,46258,3,3,1, 46261
31,46261,2,2,1, 46263
7,46262,1,1,1, 46263
8,46266,1,1,0, 46267
16,46269,2,2,1, 46271
13,46269,4,4,1, 46273
15,46271,2,2,1, 46273
24,46279,1,1,0, 46280
23,46278,3,3,1, 46281
1,46281,1,1,1, 46282
30,46283,3,3,1, 46286
6,46285,2,2,1, 46287
25,46285,2,2,1, 46287
31,46286,2,2,1, 46288
7,46287,1,1,0, 46288
29,46288,4,4,1, 46292
8,46291,1,1,1, 46292
13,46294,4,4,1, 46298
24,46304,1,1,1, 46305
1,46306,1,1,1, 46307
6,46310,2,2,1, 46312
25,46310,2,2,1, 46312
31,46311,2,2,1, 46313
7,46312,1,1,1, 46313
8,46316,1,1,0, 46317
14,46319,3,3,1, 46322
13,46319,4,4,1, 46323
2,46328,2,2,1, 46330
24,46329,1,1,0, 46330
23,46328,3,3,1, 46331
21,46327,5,5,1, 46332
1,46331,1,1,0, 46332
25,46335,2,2,1, 46337
7,46337,1,1,0, 46338
26,46337,3,3,1, 46340
29,46338,4,4,1, 46342
8,46341,1,1,1, 46342
9,46342,2,2,1, 46344
16,46344,2,2,1, 46346
14,46344,3,3,1, 46347
15,46346,2,2,1, 46348
18,46348,4,4,1, 46352
2,46353,2,2,1, 46355
24,46354,1,1,1, 46355
1,46356,1,1,1, 46357
5,46357,3,3,1, 46360
30,46358,3,3,1, 46361
25,46360,2,2,1, 46362
31,46361,2,2,1, 46363
7,46362,1,1,0, 46363
29,46363,4,4,1, 46367
24,46379,1,1,0, 46380
1,46381,1,1,1, 46382
5,46382,3,3,1, 46385
30,46383,3,3,1, 46386
6,46385,2,2,1, 46387
31,46386,2,2,1, 46388
7,46387,1,1,0, 46388
24,46404,1,1,0, 46405
1,46406,1,1,1, 46407
30,46408,3,3,1, 46411
7,46412,1,1,1, 46413
26,46412,3,3,1, 46415
20,46423,6,6,1, 46429
2,46428,2,2,1, 46430
24,46429,1,1,0, 46430
19,46426,5,5,1, 46431
1,46431,1,1,1, 46432
5,46432,3,3,1, 46435
27,46432,4,4,1, 46436
25,46435,2,2,1, 46437
31,46436,2,2,1, 46438
7,46437,1,1,1, 46438
26,46437,3,3,1, 46440
11,46439,4,4,1, 46443
18,46448,4,4,1, 46452
24,46454,1,1,0, 46455
19,46451,5,5,1, 46456
23,46453,3,3,1, 46456
1,46456,1,1,1, 46457
4,46456,4,4,1, 46460
27,46457,4,4,1, 46461
30,46458,3,3,1, 46461
7,46462,1,1,1, 46463
29,46463,4,4,1, 46467
8,46466,1,1,1, 46467
11,46464,4,4,1, 46468
9,46467,2,2,1, 46469
13,46469,4,4,1, 46473
12,46470,5,5,1, 46475
2,46478,2,2,1, 46480
24,46479,1,1,0, 46480
21,46477,5,5,1, 46482
1,46481,1,1,0, 46482
4,46481,4,4,1, 46485
31,46486,2,2,1, 46488
7,46487,1,1,1, 46488
28,46484,5,5,1, 46489
8,46491,1,1,0, 46492
14,46494,3,3,1, 46497
22,46501,4,4,1, 46505
2,46503,2,2,1, 46505
24,46504,1,1,0, 46505
23,46503,3,3,1, 46506
21,46502,5,5,1, 46507
1,46506,1,1,0, 46507
30,46508,3,3,1, 46511
6,46510,2,2,1, 46512
31,46511,2,2,1, 46513
7,46512,1,1,0, 46513
28,46509,5,5,1, 46514
26,46512,3,3,1, 46515
8,46516,1,1,0, 46517
16,46519,2,2,1, 46521
17,46519,3,3,1, 46522
13,46519,4,4,1, 46523
12,46520,5,5,1, 46525
18,46523,4,4,1, 46527
22,46526,4,4,1, 46530
24,46529,1,1,1, 46530
23,46528,3,3,1, 46531
21,46527,5,5,1, 46532
1,46531,1,1,1, 46532
3,46532,3,3,1, 46535
27,46532,4,4,1, 46536
6,46535,2,2,1, 46537
25,46535,2,2,1, 46537
31,46536,2,2,1, 46538
7,46537,1,1,1, 46538
28,46534,5,5,1, 46539
8,46541,1,1,0, 46542
13,46544,4,4,1, 46548
15,46546,2,2,1, 46548
24,46554,1,1,1, 46555
21,46552,5,5,1, 46557
6,46560,2,2,1, 46562
7,46562,1,1,0, 46563
29,46563,4,4,1, 46567
8,46566,1,1,0, 46567
16,46569,2,2,1, 46571
22,46576,4,4,1, 46580
24,46579,1,1,0, 46580
23,46578,3,3,1, 46581
30,46583,3,3,1, 46586
6,46585,2,2,1, 46587
31,46586,2,2,1, 46588
7,46587,1,1,0, 46588
8,46591,1,1,1, 46592
15,46596,2,2,1, 46598
24,46604,1,1,0, 46605
21,46602,5,5,1, 46607
5,46607,3,3,1, 46610
30,46608,3,3,1, 46611
31,46611,2,2,1, 46613
7,46612,1,1,1, 46613
29,46613,4,4,1, 46617
8,46616,1,1,1, 46617
13,46619,4,4,1, 46623
22,46626,4,4,1, 46630
24,46629,1,1,0, 46630
21,46627,5,5,1, 46632
5,46632,3,3,1, 46635
6,46635,2,2,1, 46637
7,46637,1,1,1, 46638
8,46641,1,1,1, 46642
17,46644,3,3,1, 46647
13,46644,4,4,1, 46648
15,46646,2,2,1, 46648
24,46654,1,1,1, 46655
1,46656,1,1,1, 46657
30,46658,3,3,1, 46661
31,46661,2,2,1, 46663
7,46662,1,1,1, 46663
29,46663,4,4,1, 46667
8,46666,1,1,0, 46667
9,46667,2,2,1, 46669
14,46669,3,3,1, 46672
22,46676,4,4,1, 46680
24,46679,1,1,1, 46680
23,46678,3,3,1, 46681
1,46681,1,1,0, 46682
31,46686,2,2,1, 46688
7,46687,1,1,1, 46688
26,46687,3,3,1, 46690
29,46688,4,4,1, 46692
8,46691,1,1,0, 46692
9,46692,2,2,1, 46694
15,46696,2,2,1, 46698
22,46701,4,4,1, 46705
24,46704,1,1,0, 46705
1,46706,1,1,0, 46707
30,46708,3,3,1, 46711
6,46710,2,2,1, 46712
31,46711,2,2,1, 46713
7,46712,1,1,1, 46713
29,46713,4,4,1, 46717
8,46716,1,1,1, 46717
9,46717,2,2,1, 46719
22,46726,4,4,1, 46730
24,46729,1,1,1, 46730
21,46727,5,5,1, 46732
1,46731,1,1,0, 46732
5,46732,3,3,1, 46735
30,46733,3,3,1, 46736
25,46735,2,2,1, 46737
7,46737,1,1,0, 46738
29,46738,4,4,1, 46742
8,46741,1,1,1, 46742
13,46744,4,4,1, 46748
12,46745,5,5,1, 46750
2,46753,2,2,1, 46755
24,46754,1,1,0, 46755
23,46753,3,3,1, 46756
21,46752,5,5,1, 46757
1,46756,1,1,0, 46757
3,46757,3,3,1, 46760
5,46757,3,3,1, 46760
27,46757,4,4,1, 46761
30,46758,3,3,1, 46761
25,46760,2,2,1, 46762
7,46762,1,1,0, 46763
29,46763,4,4,1, 46767
8,46766,1,1,0, 46767
9,46767,2,2,1, 46769
17,46769,3,3,1, 46772
13,46769,4,4,1, 46773
12,46770,5,5,1, 46775
18,46773,4,4,1, 46777
20,46773,6,6,1, 46779
22,46776,4,4,1, 46780
24,46779,1,1,0, 46780
19,46776,5,5,1, 46781
23,46778,3,3,1, 46781
1,46781,1,1,1, 46782
4,46781,4,4,1, 46785
27,46782,4,4,1, 46786
30,46783,3,3,1, 46786
7,46787,1,1,1, 46788
28,46784,5,5,1, 46789
26,46787,3,3,1, 46790
29,46788,4,4,1, 46792
8,46791,1,1,1, 46792
9,46792,2,2,1, 46794
17,46794,3,3,1, 46797
13,46794,4,4,1, 46798
15,46796,2,2,1, 46798
12,46795,5,5,1, 46800
18,46798,4,4,1, 46802
20,46798,6,6,1, 46804
22,46801,4,4,1, 46805
24,46804,1,1,0, 46805
5,46807,3,3,1, 46810
30,46808,3,3,1, 46811
6,46810,2,2,1, 46812
24,46829,1,1,0, 46830
24,46854,1,1,0, 46855
24,46879,1,1,1, 46880
24,46904,1,1,1, 46905
21,46902,5,5,1, 46907
1,46906,1,1,0, 46907
25,46910,2,2,1, 46912
29,46913,4,4,1, 46917
8,46916,1,1,1, 46917
14,46919,3,3,1, 46922
24,46929,1,1,0, 46930
23,46928,3,3,1, 46931
21,46927,5,5,1, 46932
1,46931,1,1,0, 46932
30,46933,3,3,1, 46936
31,46936,2,2,1, 46938
7,46937,1,1,1, 46938
29,46938,4,4,1, 46942
8,46941,1,1,0, 46942
9,46942,2,2,1, 46944
17,46944,3,3,1, 46947
13,46944,4,4,1, 46948
15,46946,2,2,1, 46948
18,46948,4,4,1, 46952
24,46954,1,1,1, 46955
21,46952,5,5,1, 46957
1,46956,1,1,1, 46957
5,46957,3,3,1, 46960
30,46958,3,3,1, 46961
31,46961,2,2,1, 46963
7,46962,1,1,1, 46963
8,46966,1,1,1, 46967
9,46967,2,2,1, 46969
16,46969,2,2,1, 46971
13,46969,4,4,1, 46973
15,46971,2,2,1, 46973
12,46970,5,5,1, 46975
24,46979,1,1,0, 46980
23,46978,3,3,1, 46981
21,46977,5,5,1, 46982
1,46981,1,1,0, 46982
5,46982,3,3,1, 46985
27,46982,4,4,1, 46986
30,46983,3,3,1, 46986
6,46985,2,2,1, 46987
25,46985,2,2,1, 46987
31,46986,2,2,1, 46988
7,46987,1,1,1, 46988
28,46984,5,5,1, 46989
26,46987,3,3,1, 46990
29,46988,4,4,1, 46992
8,46991,1,1,0, 46992
9,46992,2,2,1, 46994
13,46994,4,4,1, 46998
12,46995,5,5,1, 47000
22,47001,4,4,1, 47005
2,47003,2,2,1, 47005
24,47004,1,1,1, 47005
19,47001,5,5,1, 47006
1,47006,1,1,1, 47007
4,47006,4,4,1, 47010
5,47007,3,3,1, 47010
27,47007,4,4,1, 47011
30,47008,3,3,1, 47011
6,47010,2,2,1, 47012
31,47011,2,2,1, 47013
7,47012,1,1,1, 47013
26,47012,3,3,1, 47015
29,47013,4,4,1, 47017
8,47016,1,1,1, 47017
11,47014,4,4,1, 47018
16,47019,2,2,1, 47021
14,47019,3,3,1, 47022
13,47019,4,4,1, 47023
20,47023,6,6,1, 47029
22,47026,4,4,1, 47030
2,47028,2,2,1, 47030
24,47029,1,1,1, 47030
1,47031,1,1,0, 47032
4,47031,4,4,1, 47035
27,47032,4,4,1, 47036
30,47033,3,3,1, 47036
6,47035,2,2,1, 47037
31,47036,2,2,1, 47038
7,47037,1,1,1, 47038
8,47041,1,1,1, 47042
17,47044,3,3,1, 47047
15,47046,2,2,1, 47048
18,47048,4,4,1, 47052
20,47048,6,6,1, 47054
24,47054,1,1,1, 47055
23,47053,3,3,1, 47056
30,47058,3,3,1, 47061
6,47060,2,2,1, 47062
7,47062,1,1,1, 47063
29,47063,4,4,1, 47067
8,47066,1,1,1, 47067
16,47069,2,2,1, 47071
13,47069,4,4,1, 47073
24,47079,1,1,0, 47080
23,47078,3,3,1, 47081
21,47077,5,5,1, 47082
6,47085,2,2,1, 47087
7,47087,1,1,0, 47088
8,47091,1,1,1, 47092
16,47094,2,2,1, 47096
14,47094,3,3,1, 47097
22,47101,4,4,1, 47105
24,47104,1,1,1, 47105
7,47112,1,1,0, 47113
29,47113,4,4,1, 47117
8,47116,1,1,0, 47117
16,47119,2,2,1, 47121
13,47119,4,4,1, 47123
22,47126,4,4,1, 47130
24,47129,1,1,1, 47130
5,47132,3,3,1, 47135
31,47136,2,2,1, 47138
7,47137,1,1,1, 47138
24,47154,1,1,0, 47155
31,47161,2,2,1, 47163
7,47162,1,1,0, 47163
9,47167,2,2,1, 47169
17,47169,3,3,1, 47172
24,47179,1,1,1, 47180
1,47181,1,1,1, 47182
5,47182,3,3,1, 47185
6,47185,2,2,1, 47187
25,47185,2,2,1, 47187
7,47187,1,1,1, 47188
26,47187,3,3,1, 47190
18,47198,4,4,1, 47202
24,47204,1,1,0, 47205
1,47206,1,1,1, 47207
25,47210,2,2,1, 47212
7,47212,1,1,0, 47213
28,47209,5,5,1, 47214
26,47212,3,3,1, 47215
29,47213,4,4,1, 47217
11,47214,4,4,1, 47218
20,47223,6,6,1, 47229
24,47229,1,1,1, 47230
19,47226,5,5,1, 47231
1,47231,1,1,1, 47232
4,47231,4,4,1, 47235
3,47232,3,3,1, 47235
5,47232,3,3,1, 47235
27,47232,4,4,1, 47236
30,47233,3,3,1, 47236
31,47236,2,2,1, 47238
7,47237,1,1,1, 47238
28,47234,5,5,1, 47239
29,47238,4,4,1, 47242
8,47241,1,1,0, 47242
11,47239,4,4,1, 47243
16,47244,2,2,1, 47246
15,47246,2,2,1, 47248
12,47245,5,5,1, 47250
22,47251,4,4,1, 47255
24,47254,1,1,0, 47255
23,47253,3,3,1, 47256
1,47256,1,1,1, 47257
30,47258,3,3,1, 47261
6,47260,2,2,1, 47262
7,47262,1,1,0, 47263
29,47263,4,4,1, 47267
8,47266,1,1,0, 47267
11,47264,4,4,1, 47268
16,47269,2,2,1, 47271
13,47269,4,4,1, 47273
15,47271,2,2,1, 47273
12,47270,5,5,1, 47275
2,47278,2,2,1, 47280
24,47279,1,1,1, 47280
23,47278,3,3,1, 47281
1,47281,1,1,0, 47282
4,47281,4,4,1, 47285
5,47282,3,3,1, 47285
27,47282,4,4,1, 47286
31,47286,2,2,1, 47288
7,47287,1,1,0, 47288
28,47284,5,5,1, 47289
29,47288,4,4,1, 47292
8,47291,1,1,0, 47292
9,47292,2,2,1, 47294
16,47294,2,2,1, 47296
17,47294,3,3,1, 47297
13,47294,4,4,1, 47298
22,47301,4,4,1, 47305
24,47304,1,1,1, 47305
23,47303,3,3,1, 47306
5,47307,3,3,1, 47310
6,47310,2,2,1, 47312
31,47311,2,2,1, 47313
7,47312,1,1,0, 47313
29,47313,4,4,1, 47317
8,47316,1,1,0, 47317
15,47321,2,2,1, 47323
24,47329,1,1,0, 47330
5,47332,3,3,1, 47335
30,47333,3,3,1, 47336
31,47336,2,2,1, 47338
7,47337,1,1,0, 47338
8,47341,1,1,1, 47342
16,47344,2,2,1, 47346
14,47344,3,3,1, 47347
13,47344,4,4,1, 47348
24,47354,1,1,0, 47355
23,47353,3,3,1, 47356
21,47352,5,5,1, 47357
8,47366,1,1,0, 47367
16,47369,2,2,1, 47371
14,47369,3,3,1, 47372
15,47371,2,2,1, 47373
22,47376,4,4,1, 47380
24,47379,1,1,0, 47380
21,47377,5,5,1, 47382
8,47391,1,1,1, 47392
24,47404,1,1,0, 47405
23,47403,3,3,1, 47406
1,47406,1,1,0, 47407
25,47410,2,2,1, 47412
8,47416,1,1,1, 47417
16,47419,2,2,1, 47421
14,47419,3,3,1, 47422
17,47419,3,3,1, 47422
15,47421,2,2,1, 47423
24,47429,1,1,1, 47430
21,47427,5,5,1, 47432
1,47431,1,1,1, 47432
25,47435,2,2,1, 47437
8,47441,1,1,0, 47442
16,47444,2,2,1, 47446
17,47444,3,3,1, 47447
15,47446,2,2,1, 47448
22,47451,4,4,1, 47455
24,47454,1,1,0, 47455
1,47456,1,1,0, 47457
30,47458,3,3,1, 47461
6,47460,2,2,1, 47462
31,47461,2,2,1, 47463
7,47462,1,1,1, 47463
8,47466,1,1,0, 47467
9,47467,2,2,1, 47469
16,47469,2,2,1, 47471
17,47469,3,3,1, 47472
2,47478,2,2,1, 47480
24,47479,1,1,1, 47480
1,47481,1,1,1, 47482
30,47483,3,3,1, 47486
6,47485,2,2,1, 47487
7,47487,1,1,0, 47488
26,47487,3,3,1, 47490
29,47488,4,4,1, 47492
18,47498,4,4,1, 47502
24,47504,1,1,0, 47505
1,47506,1,1,0, 47507
4,47506,4,4,1, 47510
5,47507,3,3,1, 47510
27,47507,4,4,1, 47511
30,47508,3,3,1, 47511
31,47511,2,2,1, 47513
7,47512,1,1,1, 47513
11,47514,4,4,1, 47518
9,47517,2,2,1, 47519
17,47519,3,3,1, 47522
12,47520,5,5,1, 47525
2,47528,2,2,1, 47530
24,47529,1,1,1, 47530
1,47531,1,1,0, 47532
4,47531,4,4,1, 47535
5,47532,3,3,1, 47535
30,47533,3,3,1, 47536
7,47537,1,1,1, 47538
28,47534,5,5,1, 47539
26,47537,3,3,1, 47540
11,47539,4,4,1, 47543
17,47544,3,3,1, 47547
12,47545,5,5,1, 47550
24,47554,1,1,0, 47555
19,47551,5,5,1, 47556
1,47556,1,1,1, 47557
6,47560,2,2,1, 47562
31,47561,2,2,1, 47563
7,47562,1,1,0, 47563
28,47559,5,5,1, 47564
11,47564,4,4,1, 47568
12,47570,5,5,1, 47575
20,47573,6,6,1, 47579
2,47578,2,2,1, 47580
24,47579,1,1,0, 47580
21,47577,5,5,1, 47582
30,47583,3,3,1, 47586
6,47585,2,2,1, 47587
31,47586,2,2,1, 47588
7,47587,1,1,1, 47588
8,47591,1,1,0, 47592
16,47594,2,2,1, 47596
22,47601,4,4,1, 47605
24,47604,1,1,1, 47605
21,47602,5,5,1, 47607
5,47607,3,3,1, 47610
7,47612,1,1,0, 47613
8,47616,1,1,0, 47617
14,47619,3,3,1, 47622
13,47619,4,4,1, 47623
15,47621,2,2,1, 47623
24,47629,1,1,0, 47630
5,47632,3,3,1, 47635
31,47636,2,2,1, 47638
7,47637,1,1,1, 47638
8,47641,1,1,0, 47642
14,47644,3,3,1, 47647
15,47646,2,2,1, 47648
22,47651,4,4,1, 47655
24,47654,1,1,0, 47655
23,47653,3,3,1, 47656
30,47658,3,3,1, 47661
6,47660,2,2,1, 47662
31,47661,2,2,1, 47663
7,47662,1,1,1, 47663
29,47663,4,4,1, 47667
8,47666,1,1,1, 47667
24,47679,1,1,1, 47680
23,47678,3,3,1, 47681
30,47683,3,3,1, 47686
7,47687,1,1,1, 47688
29,47688,4,4,1, 47692
8,47691,1,1,0, 47692
9,47692,2,2,1, 47694
16,47694,2,2,1, 47696
14,47694,3,3,1, 47697
17,47694,3,3,1, 47697
13,47694,4,4,1, 47698
24,47704,1,1,1, 47705
21,47702,5,5,1, 47707
1,47706,1,1,1, 47707
30,47708,3,3,1, 47711
31,47711,2,2,1, 47713
7,47712,1,1,1, 47713
8,47716,1,1,0, 47717
15,47721,2,2,1, 47723
24,47729,1,1,0, 47730
21,47727,5,5,1, 47732
1,47731,1,1,0, 47732
5,47732,3,3,1, 47735
25,47735,2,2,1, 47737
7,47737,1,1,0, 47738
29,47738,4,4,1, 47742
8,47741,1,1,1, 47742
16,47744,2,2,1, 47746
14,47744,3,3,1, 47747
17,47744,3,3,1, 47747
15,47746,2,2,1, 47748
18,47748,4,4,1, 47752
20,47748,6,6,1, 47754
24,47754,1,1,1, 47755
19,47751,5,5,1, 47756
21,47752,5,5,1, 47757
1,47756,1,1,0, 47757
31,47761,2,2,1, 47763
7,47762,1,1,0, 47763
28,47759,5,5,1, 47764
26,47762,3,3,1, 47765
8,47766,1,1,0, 47767
9,47767,2,2,1, 47769
17,47769,3,3,1, 47772
15,47771,2,2,1, 47773
18,47773,4,4,1, 47777
20,47773,6,6,1, 47779
24,47779,1,1,1, 47780
21,47777,5,5,1, 47782
1,47781,1,1,1, 47782
4,47781,4,4,1, 47785
7,47787,1,1,0, 47788
26,47787,3,3,1, 47790
29,47788,4,4,1, 47792
8,47791,1,1,0, 47792
11,47789,4,4,1, 47793
9,47792,2,2,1, 47794
16,47794,2,2,1, 47796
14,47794,3,3,1, 47797
13,47794,4,4,1, 47798
12,47795,5,5,1, 47800
20,47798,6,6,1, 47804
2,47803,2,2,1, 47805
24,47804,1,1,1, 47805
23,47803,3,3,1, 47806
1,47806,1,1,0, 47807
3,47807,3,3,1, 47810
27,47807,4,4,1, 47811
31,47811,2,2,1, 47813
7,47812,1,1,0, 47813
8,47816,1,1,0, 47817
11,47814,4,4,1, 47818
9,47817,2,2,1, 47819
14,47819,3,3,1, 47822
18,47823,4,4,1, 47827
24,47829,1,1,0, 47830
23,47828,3,3,1, 47831
5,47832,3,3,1, 47835
30,47833,3,3,1, 47836
6,47835,2,2,1, 47837
31,47836,2,2,1, 47838
7,47837,1,1,1, 47838
8,47841,1,1,1, 47842
15,47846,2,2,1, 47848
22,47851,4,4,1, 47855
24,47854,1,1,1, 47855
23,47853,3,3,1, 47856
21,47852,5,5,1, 47857
5,47857,3,3,1, 47860
30,47858,3,3,1, 47861
31,47861,2,2,1, 47863
7,47862,1,1,0, 47863
8,47866,1,1,0, 47867
16,47869,2,2,1, 47871
13,47869,4,4,1, 47873
24,47879,1,1,0, 47880
23,47878,3,3,1, 47881
5,47882,3,3,1, 47885
31,47886,2,2,1, 47888
7,47887,1,1,0, 47888
29,47888,4,4,1, 47892
24,47904,1,1,1, 47905
5,47907,3,3,1, 47910
7,47912,1,1,1, 47913
29,47913,4,4,1, 47917
24,47929,1,1,1, 47930
1,47931,1,1,0, 47932
5,47932,3,3,1, 47935
6,47935,2,2,1, 47937
25,47935,2,2,1, 47937
7,47937,1,1,1, 47938
11,47939,4,4,1, 47943
9,47942,2,2,1, 47944
18,47948,4,4,1, 47952
2,47953,2,2,1, 47955
24,47954,1,1,0, 47955
1,47956,1,1,1, 47957
6,47960,2,2,1, 47962
7,47962,1,1,0, 47963
26,47962,3,3,1, 47965
29,47963,4,4,1, 47967
9,47967,2,2,1, 47969
17,47969,3,3,1, 47972
18,47973,4,4,1, 47977
24,47979,1,1,1, 47980
1,47981,1,1,1, 47982
6,47985,2,2,1, 47987
25,47985,2,2,1, 47987
7,47987,1,1,1, 47988
8,47991,1,1,0, 47992
16,47994,2,2,1, 47996
14,47994,3,3,1, 47997
17,47994,3,3,1, 47997
18,47998,4,4,1, 48002
22,48001,4,4,1, 48005
24,48004,1,1,1, 48005
23,48003,3,3,1, 48006
21,48002,5,5,1, 48007
1,48006,1,1,0, 48007
7,48012,1,1,0, 48013
29,48013,4,4,1, 48017
8,48016,1,1,1, 48017
9,48017,2,2,1, 48019
16,48019,2,2,1, 48021
14,48019,3,3,1, 48022
15,48021,2,2,1, 48023
18,48023,4,4,1, 48027
22,48026,4,4,1, 48030
24,48029,1,1,0, 48030
23,48028,3,3,1, 48031
1,48031,1,1,0, 48032
5,48032,3,3,1, 48035
6,48035,2,2,1, 48037
25,48035,2,2,1, 48037
31,48036,2,2,1, 48038
7,48037,1,1,1, 48038
26,48037,3,3,1, 48040
29,48038,4,4,1, 48042
8,48041,1,1,1, 48042
9,48042,2,2,1, 48044
14,48044,3,3,1, 48047
17,48044,3,3,1, 48047
13,48044,4,4,1, 48048
15,48046,2,2,1, 48048
12,48045,5,5,1, 48050
18,48048,4,4,1, 48052
20,48048,6,6,1, 48054
22,48051,4,4,1, 48055
24,48054,1,1,1, 48055
19,48051,5,5,1, 48056
1,48056,1,1,1, 48057
5,48057,3,3,1, 48060
6,48060,2,2,1, 48062
25,48060,2,2,1, 48062
31,48061,2,2,1, 48063
7,48062,1,1,0, 48063
29,48063,4,4,1, 48067
8,48066,1,1,1, 48067
16,48069,2,2,1, 48071
14,48069,3,3,1, 48072
15,48071,2,2,1, 48073
24,48079,1,1,0, 48080
23,48078,3,3,1, 48081
21,48077,5,5,1, 48082
6,48085,2,2,1, 48087
31,48086,2,2,1, 48088
7,48087,1,1,1, 48088
29,48088,4,4,1, 48092
8,48091,1,1,1, 48092
16,48094,2,2,1, 48096
15,48096,2,2,1, 48098
24,48104,1,1,1, 48105
23,48103,3,3,1, 48106
31,48111,2,2,1, 48113
7,48112,1,1,0, 48113
29,48113,4,4,1, 48117
8,48116,1,1,0, 48117
14,48119,3,3,1, 48122
13,48119,4,4,1, 48123
24,48129,1,1,0, 48130
5,48132,3,3,1, 48135
30,48133,3,3,1, 48136
7,48137,1,1,1, 48138
29,48138,4,4,1, 48142
24,48154,1,1,1, 48155
5,48157,3,3,1, 48160
31,48161,2,2,1, 48163
7,48162,1,1,0, 48163
17,48169,3,3,1, 48172
24,48179,1,1,0, 48180
1,48181,1,1,1, 48182
30,48183,3,3,1, 48186
6,48185,2,2,1, 48187
7,48187,1,1,1, 48188
17,48194,3,3,1, 48197
24,48204,1,1,0, 48205
1,48206,1,1,0, 48207
6,48210,2,2,1, 48212
25,48210,2,2,1, 48212
31,48211,2,2,1, 48213
7,48212,1,1,1, 48213
9,48217,2,2,1, 48219
17,48219,3,3,1, 48222
22,48226,4,4,1, 48230
24,48229,1,1,0, 48230
23,48228,3,3,1, 48231
1,48231,1,1,0, 48232
5,48232,3,3,1, 48235
6,48235,2,2,1, 48237
25,48235,2,2,1, 48237
31,48236,2,2,1, 48238
7,48237,1,1,0, 48238
8,48241,1,1,1, 48242
14,48244,3,3,1, 48247
15,48246,2,2,1, 48248
18,48248,4,4,1, 48252
2,48253,2,2,1, 48255
24,48254,1,1,1, 48255
19,48251,5,5,1, 48256
1,48256,1,1,1, 48257
4,48256,4,4,1, 48260
6,48260,2,2,1, 48262
7,48262,1,1,1, 48263
26,48262,3,3,1, 48265
29,48263,4,4,1, 48267
8,48266,1,1,1, 48267
11,48264,4,4,1, 48268
9,48267,2,2,1, 48269
16,48269,2,2,1, 48271
13,48269,4,4,1, 48273
15,48271,2,2,1, 48273
2,48278,2,2,1, 48280
24,48279,1,1,0, 48280
23,48278,3,3,1, 48281
1,48281,1,1,1, 48282
30,48283,3,3,1, 48286
7,48287,1,1,1, 48288
26,48287,3,3,1, 48290
8,48291,1,1,1, 48292
9,48292,2,2,1, 48294
15,48296,2,2,1, 48298
24,48304,1,1,0, 48305
1,48306,1,1,0, 48307
30,48308,3,3,1, 48311
7,48312,1,1,0, 48313
8,48316,1,1,1, 48317
9,48317,2,2,1, 48319
16,48319,2,2,1, 48321
17,48319,3,3,1, 48322
2,48328,2,2,1, 48330
24,48329,1,1,0, 48330
23,48328,3,3,1, 48331
1,48331,1,1,0, 48332
30,48333,3,3,1, 48336
6,48335,2,2,1, 48337
25,48335,2,2,1, 48337
31,48336,2,2,1, 48338
7,48337,1,1,1, 48338
26,48337,3,3,1, 48340
8,48341,1,1,1, 48342
18,48348,4,4,1, 48352
2,48353,2,2,1, 48355
24,48354,1,1,0, 48355
21,48352,5,5,1, 48357
1,48356,1,1,0, 48357
25,48360,2,2,1, 48362
31,48361,2,2,1, 48363
7,48362,1,1,0, 48363
26,48362,3,3,1, 48365
29,48363,4,4,1, 48367
8,48366,1,1,0, 48367
9,48367,2,2,1, 48369
16,48369,2,2,1, 48371
17,48369,3,3,1, 48372
15,48371,2,2,1, 48373
22,48376,4,4,1, 48380
2,48378,2,2,1, 48380
24,48379,1,1,0, 48380
19,48376,5,5,1, 48381
23,48378,3,3,1, 48381
21,48377,5,5,1, 48382
1,48381,1,1,1, 48382
4,48381,4,4,1, 48385
3,48382,3,3,1, 48385
30,48383,3,3,1, 48386
7,48387,1,1,1, 48388
8,48391,1,1,0, 48392
14,48394,3,3,1, 48397
15,48396,2,2,1, 48398
22,48401,4,4,1, 48405
24,48404,1,1,0, 48405
21,48402,5,5,1, 48407
5,48407,3,3,1, 48410
30,48408,3,3,1, 48411
6,48410,2,2,1, 48412
7,48412,1,1,1, 48413
8,48416,1,1,0, 48417
16,48419,2,2,1, 48421
14,48419,3,3,1, 48422
13,48419,4,4,1, 48423
15,48421,2,2,1, 48423
22,48426,4,4,1, 48430
24,48429,1,1,0, 48430
21,48427,5,5,1, 48432
5,48432,3,3,1, 48435
30,48433,3,3,1, 48436
6,48435,2,2,1, 48437
7,48437,1,1,1, 48438
29,48438,4,4,1, 48442
8,48441,1,1,1, 48442
14,48444,3,3,1, 48447
13,48444,4,4,1, 48448
15,48446,2,2,1, 48448
22,48451,4,4,1, 48455
24,48454,1,1,1, 48455
5,48457,3,3,1, 48460
6,48460,2,2,1, 48462
7,48462,1,1,0, 48463
8,48466,1,1,1, 48467
22,48476,4,4,1, 48480
24,48479,1,1,1, 48480
23,48478,3,3,1, 48481
21,48477,5,5,1, 48482
5,48482,3,3,1, 48485
7,48487,1,1,0, 48488
29,48488,4,4,1, 48492
24,48504,1,1,1, 48505
1,48506,1,1,0, 48507
25,48510,2,2,1, 48512
31,48511,2,2,1, 48513
7,48512,1,1,0, 48513
29,48513,4,4,1, 48517
9,48517,2,2,1, 48519
24,48529,1,1,1, 48530
1,48531,1,1,0, 48532
5,48532,3,3,1, 48535
7,48537,1,1,0, 48538
29,48538,4,4,1, 48542
24,48554,1,1,0, 48555
1,48556,1,1,1, 48557
5,48557,3,3,1, 48560
31,48561,2,2,1, 48563
7,48562,1,1,0, 48563
29,48563,4,4,1, 48567
9,48567,2,2,1, 48569
17,48569,3,3,1, 48572
24,48579,1,1,1, 48580
1,48581,1,1,1, 48582
30,48583,3,3,1, 48586
31,48586,2,2,1, 48588
7,48587,1,1,1, 48588
28,48584,5,5,1, 48589
26,48587,3,3,1, 48590
8,48591,1,1,0, 48592
9,48592,2,2,1, 48594
16,48594,2,2,1, 48596
17,48594,3,3,1, 48597
13,48594,4,4,1, 48598
12,48595,5,5,1, 48600
18,48598,4,4,1, 48602
22,48601,4,4,1, 48605
24,48604,1,1,0, 48605
21,48602,5,5,1, 48607
1,48606,1,1,0, 48607
6,48610,2,2,1, 48612
7,48612,1,1,0, 48613
26,48612,3,3,1, 48615
8,48616,1,1,1, 48617
9,48617,2,2,1, 48619
17,48619,3,3,1, 48622
12,48620,5,5,1, 48625
18,48623,4,4,1, 48627
24,48629,1,1,1, 48630
19,48626,5,5,1, 48631
21,48627,5,5,1, 48632
1,48631,1,1,1, 48632
4,48631,4,4,1, 48635
27,48632,4,4,1, 48636
30,48633,3,3,1, 48636
6,48635,2,2,1, 48637
25,48635,2,2,1, 48637
31,48636,2,2,1, 48638
7,48637,1,1,0, 48638
26,48637,3,3,1, 48640
8,48641,1,1,1, 48642
14,48644,3,3,1, 48647
18,48648,4,4,1, 48652
22,48651,4,4,1, 48655
24,48654,1,1,1, 48655
23,48653,3,3,1, 48656
21,48652,5,5,1, 48657
1,48656,1,1,0, 48657
7,48662,1,1,1, 48663
26,48662,3,3,1, 48665
29,48663,4,4,1, 48667
8,48666,1,1,1, 48667
9,48667,2,2,1, 48669
14,48669,3,3,1, 48672
17,48669,3,3,1, 48672
15,48671,2,2,1, 48673
2,48678,2,2,1, 48680
24,48679,1,1,1, 48680
23,48678,3,3,1, 48681
1,48681,1,1,1, 48682
5,48682,3,3,1, 48685
30,48683,3,3,1, 48686
31,48686,2,2,1, 48688
7,48687,1,1,0, 48688
26,48687,3,3,1, 48690
8,48691,1,1,0, 48692
9,48692,2,2,1, 48694
14,48694,3,3,1, 48697
13,48694,4,4,1, 48698
24,48704,1,1,0, 48705
23,48703,3,3,1, 48706
21,48702,5,5,1, 48707
1,48706,1,1,1, 48707
6,48710,2,2,1, 48712
31,48711,2,2,1, 48713
7,48712,1,1,0, 48713
29,48713,4,4,1, 48717
8,48716,1,1,0, 48717
9,48717,2,2,1, 48719
14,48719,3,3,1, 48722
13,48719,4,4,1, 48723
15,48721,2,2,1, 48723
18,48723,4,4,1, 48727
24,48729,1,1,0, 48730
21,48727,5,5,1, 48732
1,48731,1,1,1, 48732
30,48733,3,3,1, 48736
31,48736,2,2,1, 48738
7,48737,1,1,1, 48738
29,48738,4,4,1, 48742
8,48741,1,1,1, 48742
11,48739,4,4,1, 48743
9,48742,2,2,1, 48744
17,48744,3,3,1, 48747
15,48746,2,2,1, 48748
18,48748,4,4,1, 48752
20,48748,6,6,1, 48754
24,48754,1,1,1, 48755
19,48751,5,5,1, 48756
21,48752,5,5,1, 48757
1,48756,1,1,1, 48757
3,48757,3,3,1, 48760
30,48758,3,3,1, 48761
6,48760,2,2,1, 48762
31,48761,2,2,1, 48763
7,48762,1,1,0, 48763
8,48766,1,1,1, 48767
15,48771,2,2,1, 48773
24,48779,1,1,1, 48780
21,48777,5,5,1, 48782
7,48787,1,1,1, 48788
29,48788,4,4,1, 48792
8,48791,1,1,1, 48792
13,48794,4,4,1, 48798
24,48804,1,1,1, 48805
21,48802,5,5,1, 48807
5,48807,3,3,1, 48810
6,48810,2,2,1, 48812
31,48811,2,2,1, 48813
8,48816,1,1,1, 48817
16,48819,2,2,1, 48821
14,48819,3,3,1, 48822
13,48819,4,4,1, 48823
22,48826,4,4,1, 48830
24,48829,1,1,0, 48830
21,48827,5,5,1, 48832
8,48841,1,1,1, 48842
14,48844,3,3,1, 48847
13,48844,4,4,1, 48848
24,48854,1,1,0, 48855
17,48869,3,3,1, 48872
24,48879,1,1,0, 48880
1,48881,1,1,0, 48882
25,48885,2,2,1, 48887
24,48904,1,1,0, 48905
1,48906,1,1,1, 48907
25,48910,2,2,1, 48912
29,48913,4,4,1, 48917
9,48917,2,2,1, 48919
12,48920,5,5,1, 48925
18,48923,4,4,1, 48927
20,48923,6,6,1, 48929
24,48929,1,1,1, 48930
19,48926,5,5,1, 48931
1,48931,1,1,1, 48932
3,48932,3,3,1, 48935
30,48933,3,3,1, 48936
25,48935,2,2,1, 48937
7,48937,1,1,0, 48938
28,48934,5,5,1, 48939
26,48937,3,3,1, 48940
11,48939,4,4,1, 48943
17,48944,3,3,1, 48947
12,48945,5,5,1, 48950
20,48948,6,6,1, 48954
22,48951,4,4,1, 48955
2,48953,2,2,1, 48955
24,48954,1,1,0, 48955
23,48953,3,3,1, 48956
1,48956,1,1,1, 48957
4,48956,4,4,1, 48960
3,48957,3,3,1, 48960
27,48957,4,4,1, 48961
25,48960,2,2,1, 48962
7,48962,1,1,1, 48963
8,48966,1,1,1, 48967
16,48969,2,2,1, 48971
15,48971,2,2,1, 48973
22,48976,4,4,1, 48980
24,48979,1,1,0, 48980
23,48978,3,3,1, 48981
21,48977,5,5,1, 48982
5,48982,3,3,1, 48985
30,48983,3,3,1, 48986
6,48985,2,2,1, 48987
31,48986,2,2,1, 48988
7,48987,1,1,0, 48988
29,48988,4,4,1, 48992
8,48991,1,1,0, 48992
16,48994,2,2,1, 48996
15,48996,2,2,1, 48998
22,49001,4,4,1, 49005
24,49004,1,1,0, 49005
23,49003,3,3,1, 49006
5,49007,3,3,1, 49010
30,49008,3,3,1, 49011
6,49010,2,2,1, 49012
31,49011,2,2,1, 49013
7,49012,1,1,0, 49013
29,49013,4,4,1, 49017
8,49016,1,1,1, 49017
16,49019,2,2,1, 49021
24,49029,1,1,1, 49030
23,49028,3,3,1, 49031
6,49035,2,2,1, 49037
7,49037,1,1,0, 49038
8,49041,1,1,1, 49042
16,49044,2,2,1, 49046
14,49044,3,3,1, 49047
13,49044,4,4,1, 49048
22,49051,4,4,1, 49055
24,49054,1,1,1, 49055
23,49053,3,3,1, 49056
21,49052,5,5,1, 49057
5,49057,3,3,1, 49060
30,49058,3,3,1, 49061
7,49062,1,1,1, 49063
29,49063,4,4,1, 49067
8,49066,1,1,1, 49067
12,49070,5,5,1, 49075
18,49073,4,4,1, 49077
22,49076,4,4,1, 49080
2,49078,2,2,1, 49080
24,49079,1,1,0, 49080
23,49078,3,3,1, 49081
1,49081,1,1,0, 49082
4,49081,4,4,1, 49085
3,49082,3,3,1, 49085
27,49082,4,4,1, 49086
6,49085,2,2,1, 49087
25,49085,2,2,1, 49087
7,49087,1,1,1, 49088
28,49084,5,5,1, 49089
26,49087,3,3,1, 49090
8,49091,1,1,1, 49092
17,49094,3,3,1, 49097
15,49096,2,2,1, 49098
18,49098,4,4,1, 49102
20,49098,6,6,1, 49104
24,49104,1,1,0, 49105
21,49102,5,5,1, 49107
1,49106,1,1,0, 49107
3,49107,3,3,1, 49110
5,49107,3,3,1, 49110
30,49108,3,3,1, 49111
6,49110,2,2,1, 49112
7,49112,1,1,0, 49113
26,49112,3,3,1, 49115
8,49116,1,1,1, 49117
11,49114,4,4,1, 49118
9,49117,2,2,1, 49119
14,49119,3,3,1, 49122
17,49119,3,3,1, 49122
13,49119,4,4,1, 49123
15,49121,2,2,1, 49123
12,49120,5,5,1, 49125
2,49128,2,2,1, 49130
24,49129,1,1,0, 49130
23,49128,3,3,1, 49131
21,49127,5,5,1, 49132
1,49131,1,1,1, 49132
6,49135,2,2,1, 49137
7,49137,1,1,1, 49138
26,49137,3,3,1, 49140
29,49138,4,4,1, 49142
8,49141,1,1,1, 49142
24,49154,1,1,0, 49155
21,49152,5,5,1, 49157
31,49161,2,2,1, 49163
7,49162,1,1,1, 49163
8,49166,1,1,1, 49167
16,49169,2,2,1, 49171
15,49171,2,2,1, 49173
24,49179,1,1,0, 49180
30,49183,3,3,1, 49186
31,49186,2,2,1, 49188
7,49187,1,1,0, 49188
24,49204,1,1,0, 49205
5,49207,3,3,1, 49210
6,49210,2,2,1, 49212
31,49211,2,2,1, 49213
7,49212,1,1,0, 49213
24,49229,1,1,0, 49230
5,49232,3,3,1, 49235
6,49235,2,2,1, 49237
7,49237,1,1,0, 49238
29,49238,4,4,1, 49242
17,49244,3,3,1, 49247
2,49253,2,2,1, 49255
24,49254,1,1,1, 49255
1,49256,1,1,0, 49257
3,49257,3,3,1, 49260
5,49257,3,3,1, 49260
30,49258,3,3,1, 49261
6,49260,2,2,1, 49262
31,49261,2,2,1, 49263
7,49262,1,1,0, 49263
28,49259,5,5,1, 49264
9,49267,2,2,1, 49269
17,49269,3,3,1, 49272
12,49270,5,5,1, 49275
18,49273,4,4,1, 49277
20,49273,6,6,1, 49279
2,49278,2,2,1, 49280
24,49279,1,1,1, 49280
19,49276,5,5,1, 49281
23,49278,3,3,1, 49281
1,49281,1,1,0, 49282
4,49281,4,4,1, 49285
3,49282,3,3,1, 49285
27,49282,4,4,1, 49286
7,49287,1,1,0, 49288
26,49287,3,3,1, 49290
8,49291,1,1,1, 49292
11,49289,4,4,1, 49293
9,49292,2,2,1, 49294
14,49294,3,3,1, 49297
13,49294,4,4,1, 49298
12,49295,5,5,1, 49300
20,49298,6,6,1, 49304
24,49304,1,1,1, 49305
21,49302,5,5,1, 49307
6,49310,2,2,1, 49312
7,49312,1,1,0, 49313
8,49316,1,1,0, 49317
16,49319,2,2,1, 49321
15,49321,2,2,1, 49323
24,49329,1,1,1, 49330
30,49333,3,3,1, 49336
7,49337,1,1,1, 49338
29,49338,4,4,1, 49342
8,49341,1,1,0, 49342
16,49344,2,2,1, 49346
14,49344,3,3,1, 49347
13,49344,4,4,1, 49348
24,49354,1,1,0, 49355
23,49353,3,3,1, 49356
21,49352,5,5,1, 49357
31,49361,2,2,1, 49363
7,49362,1,1,0, 49363
8,49366,1,1,0, 49367
16,49369,2,2,1, 49371
13,49369,4,4,1, 49373
24,49379,1,1,1, 49380
5,49382,3,3,1, 49385
7,49387,1,1,0, 49388
29,49388,4,4,1, 49392
8,49391,1,1,1, 49392
24,49404,1,1,0, 49405
21,49402,5,5,1, 49407
1,49406,1,1,0, 49407
5,49407,3,3,1, 49410
30,49408,3,3,1, 49411
6,49410,2,2,1, 49412
31,49411,2,2,1, 49413
7,49412,1,1,1, 49413
29,49413,4,4,1, 49417
8,49416,1,1,1, 49417
9,49417,2,2,1, 49419
17,49419,3,3,1, 49422
2,49428,2,2,1, 49430
24,49429,1,1,0, 49430
23,49428,3,3,1, 49431
21,49427,5,5,1, 49432
1,49431,1,1,1, 49432
4,49431,4,4,1, 49435
3,49432,3,3,1, 49435
5,49432,3,3,1, 49435
6,49435,2,2,1, 49437
31,49436,2,2,1, 49438
7,49437,1,1,1, 49438
28,49434,5,5,1, 49439
26,49437,3,3,1, 49440
8,49441,1,1,0, 49442
11,49439,4,4,1, 49443
9,49442,2,2,1, 49444
17,49444,3,3,1, 49447
13,49444,4,4,1, 49448
15,49446,2,2,1, 49448
18,49448,4,4,1, 49452
22,49451,4,4,1, 49455
2,49453,2,2,1, 49455
24,49454,1,1,0, 49455
23,49453,3,3,1, 49456
1,49456,1,1,1, 49457
4,49456,4,4,1, 49460
27,49457,4,4,1, 49461
30,49458,3,3,1, 49461
25,49460,2,2,1, 49462
31,49461,2,2,1, 49463
7,49462,1,1,1, 49463
8,49466,1,1,1, 49467
11,49464,4,4,1, 49468
9,49467,2,2,1, 49469
16,49469,2,2,1, 49471
13,49469,4,4,1, 49473
15,49471,2,2,1, 49473
20,49473,6,6,1, 49479
22,49476,4,4,1, 49480
24,49479,1,1,1, 49480
23,49478,3,3,1, 49481
21,49477,5,5,1, 49482
1,49481,1,1,1, 49482
4,49481,4,4,1, 49485
5,49482,3,3,1, 49485
27,49482,4,4,1, 49486
30,49483,3,3,1, 49486
7,49487,1,1,0, 49488
26,49487,3,3,1, 49490
8,49491,1,1,1, 49492
13,49494,4,4,1, 49498
22,49501,4,4,1, 49505
24,49504,1,1,0, 49505
21,49502,5,5,1, 49507
30,49508,3,3,1, 49511
7,49512,1,1,1, 49513
29,49513,4,4,1, 49517
8,49516,1,1,0, 49517
16,49519,2,2,1, 49521
14,49519,3,3,1, 49522
13,49519,4,4,1, 49523
22,49526,4,4,1, 49530
24,49529,1,1,0, 49530
23,49528,3,3,1, 49531
21,49527,5,5,1, 49532
7,49537,1,1,0, 49538
29,49538,4,4,1, 49542
24,49554,1,1,0, 49555
30,49558,3,3,1, 49561
7,49562,1,1,1, 49563
24,49579,1,1,1, 49580
5,49582,3,3,1, 49585
31,49586,2,2,1, 49588
7,49587,1,1,1, 49588
24,49604,1,1,1, 49605
1,49606,1,1,0, 49607
30,49608,3,3,1, 49611
6,49610,2,2,1, 49612
25,49610,2,2,1, 49612
31,49611,2,2,1, 49613
7,49612,1,1,1, 49613
29,49613,4,4,1, 49617
17,49619,3,3,1, 49622
24,49629,1,1,0, 49630
1,49631,1,1,0, 49632
5,49632,3,3,1, 49635
30,49633,3,3,1, 49636
25,49635,2,2,1, 49637
7,49637,1,1,1, 49638
8,49641,1,1,0, 49642
14,49644,3,3,1, 49647
17,49644,3,3,1, 49647
13,49644,4,4,1, 49648
15,49646,2,2,1, 49648
18,49648,4,4,1, 49652
22,49651,4,4,1, 49655
24,49654,1,1,1, 49655
1,49656,1,1,1, 49657
5,49657,3,3,1, 49660
30,49658,3,3,1, 49661
6,49660,2,2,1, 49662
31,49661,2,2,1, 49663
7,49662,1,1,0, 49663
26,49662,3,3,1, 49665
29,49663,4,4,1, 49667
8,49666,1,1,1, 49667
14,49669,3,3,1, 49672
17,49669,3,3,1, 49672
22,49676,4,4,1, 49680
24,49679,1,1,1, 49680
23,49678,3,3,1, 49681
21,49677,5,5,1, 49682
1,49681,1,1,1, 49682
5,49682,3,3,1, 49685
30,49683,3,3,1, 49686
7,49687,1,1,0, 49688
26,49687,3,3,1, 49690
29,49688,4,4,1, 49692
8,49691,1,1,1, 49692
13,49694,4,4,1, 49698
22,49701,4,4,1, 49705
24,49704,1,1,1, 49705
21,49702,5,5,1, 49707
1,49706,1,1,0, 49707
5,49707,3,3,1, 49710
25,49710,2,2,1, 49712
31,49711,2,2,1, 49713
7,49712,1,1,1, 49713
26,49712,3,3,1, 49715
29,49713,4,4,1, 49717
8,49716,1,1,1, 49717
16,49719,2,2,1, 49721
17,49719,3,3,1, 49722
13,49719,4,4,1, 49723
18,49723,4,4,1, 49727
2,49728,2,2,1, 49730
24,49729,1,1,1, 49730
23,49728,3,3,1, 49731
21,49727,5,5,1, 49732
1,49731,1,1,0, 49732
3,49732,3,3,1, 49735
5,49732,3,3,1, 49735
27,49732,4,4,1, 49736
30,49733,3,3,1, 49736
31,49736,2,2,1, 49738
7,49737,1,1,0, 49738
8,49741,1,1,0, 49742
9,49742,2,2,1, 49744
14,49744,3,3,1, 49747
15,49746,2,2,1, 49748
12,49745,5,5,1, 49750
22,49751,4,4,1, 49755
2,49753,2,2,1, 49755
24,49754,1,1,1, 49755
19,49751,5,5,1, 49756
23,49753,3,3,1, 49756
1,49756,1,1,1, 49757
4,49756,4,4,1, 49760
25,49760,2,2,1, 49762
7,49762,1,1,1, 49763
26,49762,3,3,1, 49765
29,49763,4,4,1, 49767
8,49766,1,1,0, 49767
9,49767,2,2,1, 49769
17,49769,3,3,1, 49772
12,49770,5,5,1, 49775
2,49778,2,2,1, 49780
24,49779,1,1,1, 49780
23,49778,3,3,1, 49781
1,49781,1,1,0, 49782
5,49782,3,3,1, 49785
30,49783,3,3,1, 49786
6,49785,2,2,1, 49787
25,49785,2,2,1, 49787
31,49786,2,2,1, 49788
7,49787,1,1,1, 49788
26,49787,3,3,1, 49790
29,49788,4,4,1, 49792
8,49791,1,1,0, 49792
9,49792,2,2,1, 49794
15,49796,2,2,1, 49798
20,49798,6,6,1, 49804
22,49801,4,4,1, 49805
2,49803,2,2,1, 49805
24,49804,1,1,0, 49805
21,49802,5,5,1, 49807
8,49816,1,1,1, 49817
16,49819,2,2,1, 49821
14,49819,3,3,1, 49822
15,49821,2,2,1, 49823
24,49829,1,1,0, 49830
23,49828,3,3,1, 49831
21,49827,5,5,1, 49832
8,49841,1,1,1, 49842
16,49844,2,2,1, 49846
14,49844,3,3,1, 49847
13,49844,4,4,1, 49848
24,49854,1,1,1, 49855
24,49879,1,1,0, 49880
24,49904,1,1,1, 49905
5,49907,3,3,1, 49910
7,49912,1,1,1, 49913
11,49914,4,4,1, 49918
9,49917,2,2,1, 49919
17,49919,3,3,1, 49922
24,49929,1,1,0, 49930
19,49926,5,5,1, 49931
1,49931,1,1,0, 49932
4,49931,4,4,1, 49935
3,49932,3,3,1, 49935
5,49932,3,3,1, 49935
27,49932,4,4,1, 49936
7,49937,1,1,0, 49938
26,49937,3,3,1, 49940
29,49938,4,4,1, 49942
9,49942,2,2,1, 49944
12,49945,5,5,1, 49950
18,49948,4,4,1, 49952
22,49951,4,4,1, 49955
2,49953,2,2,1, 49955
24,49954,1,1,0, 49955
23,49953,3,3,1, 49956
1,49956,1,1,1, 49957
4,49956,4,4,1, 49960
5,49957,3,3,1, 49960
30,49958,3,3,1, 49961
6,49960,2,2,1, 49962
31,49961,2,2,1, 49963
7,49962,1,1,1, 49963
8,49966,1,1,1, 49967
9,49967,2,2,1, 49969
14,49969,3,3,1, 49972
17,49969,3,3,1, 49972
13,49969,4,4,1, 49973
15,49971,2,2,1, 49973
12,49970,5,5,1, 49975
18,49973,4,4,1, 49977
22,49976,4,4,1, 49980
2,49978,2,2,1, 49980
24,49979,1,1,1, 49980
23,49978,3,3,1, 49981
21,49977,5,5,1, 49982
1,49981,1,1,1, 49982
4,49981,4,4,1, 49985
30,49983,3,3,1, 49986
6,49985,2,2,1, 49987
31,49986,2,2,1, 49988
7,49987,1,1,0, 49988
8,49991,1,1,1, 49992
14,49994,3,3,1, 49997
15,49996,2,2,1, 49998
22,50001,4,4,1, 50005
24,50004,1,1,1, 50005
30,50008,3,3,1, 50011
6,50010,2,2,1, 50012
7,50012,1,1,1, 50013
8,50016,1,1,0, 50017
13,50019,4,4,1, 50023
15,50021,2,2,1, 50023
24,50029,1,1,0, 50030
30,50033,3,3,1, 50036
6,50035,2,2,1, 50037
7,50037,1,1,0, 50038
29,50038,4,4,1, 50042
8,50041,1,1,0, 50042
16,50044,2,2,1, 50046
13,50044,4,4,1, 50048
22,50051,4,4,1, 50055
24,50054,1,1,1, 50055
6,50060,2,2,1, 50062
31,50061,2,2,1, 50063
7,50062,1,1,1, 50063
29,50063,4,4,1, 50067
8,50066,1,1,1, 50067
16,50069,2,2,1, 50071
24,50079,1,1,1, 50080
23,50078,3,3,1, 50081
21,50077,5,5,1, 50082
5,50082,3,3,1, 50085
30,50083,3,3,1, 50086
6,50085,2,2,1, 50087
7,50087,1,1,1, 50088
8,50091,1,1,0, 50092
11,50089,4,4,1, 50093
9,50092,2,2,1, 50094
16,50094,2,2,1, 50096
14,50094,3,3,1, 50097
15,50096,2,2,1, 50098
2,50103,2,2,1, 50105
24,50104,1,1,1, 50105
23,50103,3,3,1, 50106
21,50102,5,5,1, 50107
1,50106,1,1,0, 50107
6,50110,2,2,1, 50112
25,50110,2,2,1, 50112
31,50111,2,2,1, 50113
7,50112,1,1,0, 50113
26,50112,3,3,1, 50115
8,50116,1,1,1, 50117
9,50117,2,2,1, 50119
16,50119,2,2,1, 50121
14,50119,3,3,1, 50122
17,50119,3,3,1, 50122
15,50121,2,2,1, 50123
24,50129,1,1,1, 50130
1,50131,1,1,0, 50132
5,50132,3,3,1, 50135
30,50133,3,3,1, 50136
7,50137,1,1,0, 50138
26,50137,3,3,1, 50140
29,50138,4,4,1, 50142
8,50141,1,1,0, 50142
17,50144,3,3,1, 50147
13,50144,4,4,1, 50148
18,50148,4,4,1, 50152
2,50153,2,2,1, 50155
24,50154,1,1,0, 50155
23,50153,3,3,1, 50156
1,50156,1,1,0, 50157
5,50157,3,3,1, 50160
25,50160,2,2,1, 50162
7,50162,1,1,1, 50163
26,50162,3,3,1, 50165
29,50163,4,4,1, 50167
8,50166,1,1,0, 50167
9,50167,2,2,1, 50169
16,50169,2,2,1, 50171
18,50173,4,4,1, 50177
2,50178,2,2,1, 50180
24,50179,1,1,1, 50180
1,50181,1,1,1, 50182
30,50183,3,3,1, 50186
31,50186,2,2,1, 50188
7,50187,1,1,1, 50188
8,50191,1,1,1, 50192
13,50194,4,4,1, 50198
15,50196,2,2,1, 50198
18,50198,4,4,1, 50202
22,50201,4,4,1, 50205
24,50204,1,1,0, 50205
19,50201,5,5,1, 50206
1,50206,1,1,0, 50207
3,50207,3,3,1, 50210
27,50207,4,4,1, 50211
6,50210,2,2,1, 50212
25,50210,2,2,1, 50212
7,50212,1,1,0, 50213
8,50216,1,1,0, 50217
11,50214,4,4,1, 50218
9,50217,2,2,1, 50219
14,50219,3,3,1, 50222
13,50219,4,4,1, 50223
24,50229,1,1,0, 50230
30,50233,3,3,1, 50236
31,50236,2,2,1, 50238
7,50237,1,1,1, 50238
24,50254,1,1,1, 50255
30,50258,3,3,1, 50261
31,50261,2,2,1, 50263
7,50262,1,1,1, 50263
29,50263,4,4,1, 50267
24,50279,1,1,1, 50280
5,50282,3,3,1, 50285
7,50287,1,1,1, 50288
29,50288,4,4,1, 50292
24,50304,1,1,0, 50305
5,50307,3,3,1, 50310
7,50312,1,1,1, 50313
24,50329,1,1,0, 50330
23,50328,3,3,1, 50331
21,50327,5,5,1, 50332
1,50331,1,1,1, 50332
4,50331,4,4,1, 50335
3,50332,3,3,1, 50335
5,50332,3,3,1, 50335
27,50332,4,4,1, 50336
30,50333,3,3,1, 50336
25,50335,2,2,1, 50337
7,50337,1,1,0, 50338
29,50338,4,4,1, 50342
8,50341,1,1,1, 50342
16,50344,2,2,1, 50346
17,50344,3,3,1, 50347
13,50344,4,4,1, 50348
2,50353,2,2,1, 50355
24,50354,1,1,0, 50355
1,50356,1,1,1, 50357
4,50356,4,4,1, 50360
5,50357,3,3,1, 50360
27,50357,4,4,1, 50361
6,50360,2,2,1, 50362
25,50360,2,2,1, 50362
31,50361,2,2,1, 50363
7,50362,1,1,0, 50363
29,50363,4,4,1, 50367
8,50366,1,1,0, 50367
11,50364,4,4,1, 50368
16,50369,2,2,1, 50371
14,50369,3,3,1, 50372
17,50369,3,3,1, 50372
15,50371,2,2,1, 50373
24,50379,1,1,1, 50380
23,50378,3,3,1, 50381
1,50381,1,1,0, 50382
5,50382,3,3,1, 50385
27,50382,4,4,1, 50386
31,50386,2,2,1, 50388
7,50387,1,1,0, 50388
26,50387,3,3,1, 50390
8,50391,1,1,0, 50392
11,50389,4,4,1, 50393
16,50394,2,2,1, 50396
17,50394,3,3,1, 50397
13,50394,4,4,1, 50398
15,50396,2,2,1, 50398
12,50395,5,5,1, 50400
2,50403,2,2,1, 50405
24,50404,1,1,1, 50405
23,50403,3,3,1, 50406
21,50402,5,5,1, 50407
1,50406,1,1,1, 50407
4,50406,4,4,1, 50410
3,50407,3,3,1, 50410
5,50407,3,3,1, 50410
27,50407,4,4,1, 50411
7,50412,1,1,1, 50413
8,50416,1,1,1, 50417
13,50419,4,4,1, 50423
22,50426,4,4,1, 50430
24,50429,1,1,0, 50430
23,50428,3,3,1, 50431
30,50433,3,3,1, 50436
6,50435,2,2,1, 50437
31,50436,2,2,1, 50438
7,50437,1,1,0, 50438
8,50441,1,1,1, 50442
16,50444,2,2,1, 50446
22,50451,4,4,1, 50455
24,50454,1,1,0, 50455
23,50453,3,3,1, 50456
21,50452,5,5,1, 50457
5,50457,3,3,1, 50460
30,50458,3,3,1, 50461
31,50461,2,2,1, 50463
7,50462,1,1,1, 50463
8,50466,1,1,0, 50467
15,50471,2,2,1, 50473
22,50476,4,4,1, 50480
24,50479,1,1,1, 50480
21,50477,5,5,1, 50482
6,50485,2,2,1, 50487
7,50487,1,1,0, 50488
8,50491,1,1,1, 50492
22,50501,4,4,1, 50505
24,50504,1,1,0, 50505
23,50503,3,3,1, 50506
30,50508,3,3,1, 50511
31,50511,2,2,1, 50513
7,50512,1,1,0, 50513
8,50516,1,1,0, 50517
9,50517,2,2,1, 50519
14,50519,3,3,1, 50522
17,50519,3,3,1, 50522
18,50523,4,4,1, 50527
2,50528,2,2,1, 50530
24,50529,1,1,1, 50530
1,50531,1,1,0, 50532
5,50532,3,3,1, 50535
7,50537,1,1,1, 50538
26,50537,3,3,1, 50540
29,50538,4,4,1, 50542
8,50541,1,1,1, 50542
16,50544,2,2,1, 50546
15,50546,2,2,1, 50548
2,50553,2,2,1, 50555
24,50554,1,1,1, 50555
1,50556,1,1,0, 50557
25,50560,2,2,1, 50562
31,50561,2,2,1, 50563
7,50562,1,1,1, 50563
26,50562,3,3,1, 50565
8,50566,1,1,0, 50567
9,50567,2,2,1, 50569
16,50569,2,2,1, 50571
17,50569,3,3,1, 50572
13,50569,4,4,1, 50573
15,50571,2,2,1, 50573
20,50573,6,6,1, 50579
22,50576,4,4,1, 50580
2,50578,2,2,1, 50580
24,50579,1,1,1, 50580
23,50578,3,3,1, 50581
1,50581,1,1,1, 50582
3,50582,3,3,1, 50585
5,50582,3,3,1, 50585
27,50582,4,4,1, 50586
6,50585,2,2,1, 50587
31,50586,2,2,1, 50588
7,50587,1,1,0, 50588
28,50584,5,5,1, 50589
11,50589,4,4,1, 50593
9,50592,2,2,1, 50594
12,50595,5,5,1, 50600
24,50604,1,1,1, 50605
19,50601,5,5,1, 50606
1,50606,1,1,0, 50607
4,50606,4,4,1, 50610
3,50607,3,3,1, 50610
30,50608,3,3,1, 50611
6,50610,2,2,1, 50612
31,50611,2,2,1, 50613
7,50612,1,1,0, 50613
29,50613,4,4,1, 50617
24,50629,1,1,0, 50630
5,50632,3,3,1, 50635
30,50633,3,3,1, 50636
7,50637,1,1,0, 50638
24,50654,1,1,0, 50655
6,50660,2,2,1, 50662
7,50662,1,1,0, 50663
29,50663,4,4,1, 50667
24,50679,1,1,1, 50680
5,50682,3,3,1, 50685
7,50687,1,1,1, 50688
29,50688,4,4,1, 50692
8,50691,1,1,1, 50692
15,50696,2,2,1, 50698
24,50704,1,1,1, 50705
30,50708,3,3,1, 50711
25,50710,2,2,1, 50712
7,50712,1,1,1, 50713
8,50716,1,1,1, 50717
9,50717,2,2,1, 50719
17,50719,3,3,1, 50722
24,50729,1,1,0, 50730
1,50731,1,1,0, 50732
5,50732,3,3,1, 50735
25,50735,2,2,1, 50737
7,50737,1,1,1, 50738
8,50741,1,1,0, 50742
16,50744,2,2,1, 50746
17,50744,3,3,1, 50747
15,50746,2,2,1, 50748
24,50754,1,1,0, 50755
21,50752,5,5,1, 50757
1,50756,1,1,1, 50757
30,50758,3,3,1, 50761
25,50760,2,2,1, 50762
31,50761,2,2,1, 50763
7,50762,1,1,1, 50763
8,50766,1,1,0, 50767
15,50771,2,2,1, 50773
20,50773,6,6,1, 50779
24,50779,1,1,0, 50780
23,50778,3,3,1, 50781
21,50777,5,5,1, 50782
1,50781,1,1,1, 50782
4,50781,4,4,1, 50785
27,50782,4,4,1, 50786
25,50785,2,2,1, 50787
7,50787,1,1,1, 50788
26,50787,3,3,1, 50790
29,50788,4,4,1, 50792
8,50791,1,1,0, 50792
9,50792,2,2,1, 50794
17,50794,3,3,1, 50797
13,50794,4,4,1, 50798
15,50796,2,2,1, 50798
20,50798,6,6,1, 50804
22,50801,4,4,1, 50805
2,50803,2,2,1, 50805
24,50804,1,1,0, 50805
19,50801,5,5,1, 50806
23,50803,3,3,1, 50806
1,50806,1,1,1, 50807
5,50807,3,3,1, 50810
27,50807,4,4,1, 50811
6,50810,2,2,1, 50812
31,50811,2,2,1, 50813
7,50812,1,1,1, 50813
28,50809,5,5,1, 50814
26,50812,3,3,1, 50815
8,50816,1,1,0, 50817
11,50814,4,4,1, 50818
9,50817,2,2,1, 50819
17,50819,3,3,1, 50822
20,50823,6,6,1, 50829
22,50826,4,4,1, 50830
24,50829,1,1,0, 50830
19,50826,5,5,1, 50831
23,50828,3,3,1, 50831
1,50831,1,1,1, 50832
6,50835,2,2,1, 50837
31,50836,2,2,1, 50838
7,50837,1,1,1, 50838
8,50841,1,1,1, 50842
16,50844,2,2,1, 50846
14,50844,3,3,1, 50847
17,50844,3,3,1, 50847
13,50844,4,4,1, 50848
18,50848,4,4,1, 50852
20,50848,6,6,1, 50854
24,50854,1,1,1, 50855
5,50857,3,3,1, 50860
30,50858,3,3,1, 50861
6,50860,2,2,1, 50862
31,50861,2,2,1, 50863
7,50862,1,1,0, 50863
8,50866,1,1,0, 50867
16,50869,2,2,1, 50871
13,50869,4,4,1, 50873
15,50871,2,2,1, 50873
22,50876,4,4,1, 50880
24,50879,1,1,0, 50880
21,50877,5,5,1, 50882
30,50883,3,3,1, 50886
7,50887,1,1,0, 50888
29,50888,4,4,1, 50892
8,50891,1,1,1, 50892
16,50894,2,2,1, 50896
14,50894,3,3,1, 50897
13,50894,4,4,1, 50898
24,50904,1,1,1, 50905
23,50903,3,3,1, 50906
5,50907,3,3,1, 50910
7,50912,1,1,1, 50913
8,50916,1,1,1, 50917
16,50919,2,2,1, 50921
14,50919,3,3,1, 50922
22,50926,4,4,1, 50930
24,50929,1,1,0, 50930
23,50928,3,3,1, 50931
6,50935,2,2,1, 50937
31,50936,2,2,1, 50938
7,50937,1,1,0, 50938
29,50938,4,4,1, 50942
8,50941,1,1,1, 50942
14,50944,3,3,1, 50947
13,50944,4,4,1, 50948
15,50946,2,2,1, 50948
22,50951,4,4,1, 50955
24,50954,1,1,0, 50955
21,50952,5,5,1, 50957
1,50956,1,1,1, 50957
5,50957,3,3,1, 50960
31,50961,2,2,1, 50963
7,50962,1,1,1, 50963
26,50962,3,3,1, 50965
29,50963,4,4,1, 50967
8,50966,1,1,0, 50967
9,50967,2,2,1, 50969
14,50969,3,3,1, 50972
17,50969,3,3,1, 50972
18,50973,4,4,1, 50977
22,50976,4,4,1, 50980
24,50979,1,1,1, 50980
1,50981,1,1,0, 50982
7,50987,1,1,0, 50988
29,50988,4,4,1, 50992
8,50991,1,1,0, 50992
11,50989,4,4,1, 50993
18,50998,4,4,1, 51002
22,51001,4,4,1, 51005
24,51004,1,1,0, 51005
19,51001,5,5,1, 51006
21,51002,5,5,1, 51007
1,51006,1,1,0, 51007
4,51006,4,4,1, 51010
3,51007,3,3,1, 51010
5,51007,3,3,1, 51010
6,51010,2,2,1, 51012
7,51012,1,1,0, 51013
26,51012,3,3,1, 51015
8,51016,1,1,1, 51017
11,51014,4,4,1, 51018
9,51017,2,2,1, 51019
16,51019,2,2,1, 51021
14,51019,3,3,1, 51022
17,51019,3,3,1, 51022
20,51023,6,6,1, 51029
24,51029,1,1,0, 51030
1,51031,1,1,0, 51032
4,51031,4,4,1, 51035
3,51032,3,3,1, 51035
6,51035,2,2,1, 51037
7,51037,1,1,1, 51038
29,51038,4,4,1, 51042
9,51042,2,2,1, 51044
24,51054,1,1,0, 51055
1,51056,1,1,1, 51057
31,51061,2,2,1, 51063
7,51062,1,1,0, 51063
29,51063,4,4,1, 51067
9,51067,2,2,1, 51069
24,51079,1,1,0, 51080
1,51081,1,1,0, 51082
5,51082,3,3,1, 51085
30,51083,3,3,1, 51086
6,51085,2,2,1, 51087
7,51087,1,1,1, 51088
9,51092,2,2,1, 51094
24,51104,1,1,1, 51105
1,51106,1,1,0, 51107
25,51110,2,2,1, 51112
31,51111,2,2,1, 51113
7,51112,1,1,0, 51113
9,51117,2,2,1, 51119
17,51119,3,3,1, 51122
24,51129,1,1,1, 51130
1,51131,1,1,1, 51132
5,51132,3,3,1, 51135
6,51135,2,2,1, 51137
31,51136,2,2,1, 51138
7,51137,1,1,1, 51138
29,51138,4,4,1, 51142
8,51141,1,1,0, 51142
11,51139,4,4,1, 51143
16,51144,2,2,1, 51146
14,51144,3,3,1, 51147
12,51145,5,5,1, 51150
18,51148,4,4,1, 51152
20,51148,6,6,1, 51154
2,51153,2,2,1, 51155
24,51154,1,1,0, 51155
1,51156,1,1,1, 51157
4,51156,4,4,1, 51160
5,51157,3,3,1, 51160
27,51157,4,4,1, 51161
30,51158,3,3,1, 51161
6,51160,2,2,1, 51162
7,51162,1,1,1, 51163
8,51166,1,1,0, 51167
11,51164,4,4,1, 51168
16,51169,2,2,1, 51171
17,51169,3,3,1, 51172
13,51169,4,4,1, 51173
15,51171,2,2,1, 51173
20,51173,6,6,1, 51179
2,51178,2,2,1, 51180
24,51179,1,1,0, 51180
19,51176,5,5,1, 51181
23,51178,3,3,1, 51181
5,51182,3,3,1, 51185
30,51183,3,3,1, 51186
8,51191,1,1,0, 51192
16,51194,2,2,1, 51196
14,51194,3,3,1, 51197
22,51201,4,4,1, 51205
24,51204,1,1,1, 51205
23,51203,3,3,1, 51206
8,51216,1,1,1, 51217
14,51219,3,3,1, 51222
13,51219,4,4,1, 51223
15,51221,2,2,1, 51223
22,51226,4,4,1, 51230
24,51229,1,1,0, 51230
23,51228,3,3,1, 51231
21,51227,5,5,1, 51232
8,51241,1,1,0, 51242
14,51244,3,3,1, 51247
15,51246,2,2,1, 51248
24,51254,1,1,0, 51255
23,51253,3,3,1, 51256
8,51266,1,1,1, 51267
16,51269,2,2,1, 51271
14,51269,3,3,1, 51272
24,51279,1,1,0, 51280
21,51277,5,5,1, 51282
25,51285,2,2,1, 51287
28,51284,5,5,1, 51289
29,51288,4,4,1, 51292
8,51291,1,1,0, 51292
17,51294,3,3,1, 51297
15,51296,2,2,1, 51298
12,51295,5,5,1, 51300
2,51303,2,2,1, 51305
24,51304,1,1,1, 51305
19,51301,5,5,1, 51306
23,51303,3,3,1, 51306
1,51306,1,1,1, 51307
4,51306,4,4,1, 51310
3,51307,3,3,1, 51310
5,51307,3,3,1, 51310
27,51307,4,4,1, 51311
31,51311,2,2,1, 51313
7,51312,1,1,1, 51313
28,51309,5,5,1, 51314
8,51316,1,1,0, 51317
9,51317,2,2,1, 51319
13,51319,4,4,1, 51323
15,51321,2,2,1, 51323
12,51320,5,5,1, 51325
20,51323,6,6,1, 51329
24,51329,1,1,0, 51330
23,51328,3,3,1, 51331
1,51331,1,1,1, 51332
4,51331,4,4,1, 51335
27,51332,4,4,1, 51336
30,51333,3,3,1, 51336
7,51337,1,1,0, 51338
29,51338,4,4,1, 51342
8,51341,1,1,0, 51342
11,51339,4,4,1, 51343
16,51344,2,2,1, 51346
22,51351,4,4,1, 51355
24,51354,1,1,0, 51355
19,51351,5,5,1, 51356
23,51353,3,3,1, 51356
21,51352,5,5,1, 51357
1,51356,1,1,1, 51357
4,51356,4,4,1, 51360
27,51357,4,4,1, 51361
30,51358,3,3,1, 51361
6,51360,2,2,1, 51362
31,51361,2,2,1, 51363
7,51362,1,1,1, 51363
26,51362,3,3,1, 51365
8,51366,1,1,1, 51367
16,51369,2,2,1, 51371
15,51371,2,2,1, 51373
24,51379,1,1,0, 51380
23,51378,3,3,1, 51381
21,51377,5,5,1, 51382
5,51382,3,3,1, 51385
31,51386,2,2,1, 51388
7,51387,1,1,0, 51388
29,51388,4,4,1, 51392
24,51404,1,1,1, 51405
5,51407,3,3,1, 51410
30,51408,3,3,1, 51411
7,51412,1,1,0, 51413
29,51413,4,4,1, 51417
24,51429,1,1,0, 51430
5,51432,3,3,1, 51435
31,51436,2,2,1, 51438
7,51437,1,1,1, 51438
29,51438,4,4,1, 51442
24,51454,1,1,1, 51455
7,51462,1,1,1, 51463
9,51467,2,2,1, 51469
17,51469,3,3,1, 51472
12,51470,5,5,1, 51475
20,51473,6,6,1, 51479
24,51479,1,1,1, 51480
19,51476,5,5,1, 51481
1,51481,1,1,0, 51482
30,51483,3,3,1, 51486
6,51485,2,2,1, 51487
31,51486,2,2,1, 51488
7,51487,1,1,1, 51488
26,51487,3,3,1, 51490
8,51491,1,1,1, 51492
16,51494,2,2,1, 51496
13,51494,4,4,1, 51498
15,51496,2,2,1, 51498
2,51503,2,2,1, 51505
24,51504,1,1,0, 51505
1,51506,1,1,0, 51507
7,51512,1,1,1, 51513
8,51516,1,1,1, 51517
16,51519,2,2,1, 51521
17,51519,3,3,1, 51522
13,51519,4,4,1, 51523
18,51523,4,4,1, 51527
22,51526,4,4,1, 51530
24,51529,1,1,0, 51530
23,51528,3,3,1, 51531
1,51531,1,1,0, 51532
30,51533,3,3,1, 51536
25,51535,2,2,1, 51537
7,51537,1,1,0, 51538
8,51541,1,1,1, 51542
16,51544,2,2,1, 51546
14,51544,3,3,1, 51547
17,51544,3,3,1, 51547
13,51544,4,4,1, 51548
15,51546,2,2,1, 51548
2,51553,2,2,1, 51555
24,51554,1,1,1, 51555
1,51556,1,1,1, 51557
30,51558,3,3,1, 51561
31,51561,2,2,1, 51563
7,51562,1,1,0, 51563
8,51566,1,1,1, 51567
9,51567,2,2,1, 51569
16,51569,2,2,1, 51571
14,51569,3,3,1, 51572
17,51569,3,3,1, 51572
15,51571,2,2,1, 51573
22,51576,4,4,1, 51580
24,51579,1,1,0, 51580
23,51578,3,3,1, 51581
1,51581,1,1,1, 51582
5,51582,3,3,1, 51585
7,51587,1,1,1, 51588
28,51584,5,5,1, 51589
26,51587,3,3,1, 51590
8,51591,1,1,0, 51592
11,51589,4,4,1, 51593
9,51592,2,2,1, 51594
14,51594,3,3,1, 51597
13,51594,4,4,1, 51598
15,51596,2,2,1, 51598
12,51595,5,5,1, 51600
22,51601,4,4,1, 51605
2,51603,2,2,1, 51605
24,51604,1,1,1, 51605
19,51601,5,5,1, 51606
23,51603,3,3,1, 51606
1,51606,1,1,0, 51607
3,51607,3,3,1, 51610
31,51611,2,2,1, 51613
7,51612,1,1,0, 51613
28,51609,5,5,1, 51614
8,51616,1,1,1, 51617
9,51617,2,2,1, 51619
13,51619,4,4,1, 51623
15,51621,2,2,1, 51623
18,51623,4,4,1, 51627
20,51623,6,6,1, 51629
2,51628,2,2,1, 51630
24,51629,1,1,1, 51630
23,51628,3,3,1, 51631
5,51632,3,3,1, 51635
30,51633,3,3,1, 51636
7,51637,1,1,0, 51638
8,51641,1,1,1, 51642
16,51644,2,2,1, 51646
14,51644,3,3,1, 51647
15,51646,2,2,1, 51648
22,51651,4,4,1, 51655
24,51654,1,1,1, 51655
31,51661,2,2,1, 51663
7,51662,1,1,0, 51663
8,51666,1,1,0, 51667
16,51669,2,2,1, 51671
24,51679,1,1,1, 51680
5,51682,3,3,1, 51685
30,51683,3,3,1, 51686
31,51686,2,2,1, 51688
7,51687,1,1,0, 51688
24,51704,1,1,0, 51705
5,51707,3,3,1, 51710
31,51711,2,2,1, 51713
7,51712,1,1,0, 51713
24,51729,1,1,0, 51730
6,51735,2,2,1, 51737
7,51737,1,1,0, 51738
29,51738,4,4,1, 51742
17,51744,3,3,1, 51747
24,51754,1,1,1, 51755
1,51756,1,1,0, 51757
5,51757,3,3,1, 51760
30,51758,3,3,1, 51761
6,51760,2,2,1, 51762
31,51761,2,2,1, 51763
7,51762,1,1,0, 51763
9,51767,2,2,1, 51769
17,51769,3,3,1, 51772
24,51779,1,1,0, 51780
23,51778,3,3,1, 51781
21,51777,5,5,1, 51782
1,51781,1,1,0, 51782
30,51783,3,3,1, 51786
25,51785,2,2,1, 51787
31,51786,2,2,1, 51788
7,51787,1,1,0, 51788
8,51791,1,1,0, 51792
9,51792,2,2,1, 51794
16,51794,2,2,1, 51796
14,51794,3,3,1, 51797
13,51794,4,4,1, 51798
15,51796,2,2,1, 51798
24,51804,1,1,0, 51805
1,51806,1,1,0, 51807
5,51807,3,3,1, 51810
25,51810,2,2,1, 51812
7,51812,1,1,0, 51813
26,51812,3,3,1, 51815
29,51813,4,4,1, 51817
8,51816,1,1,0, 51817
9,51817,2,2,1, 51819
16,51819,2,2,1, 51821
13,51819,4,4,1, 51823
15,51821,2,2,1, 51823
18,51823,4,4,1, 51827
22,51826,4,4,1, 51830
24,51829,1,1,0, 51830
21,51827,5,5,1, 51832
1,51831,1,1,0, 51832
5,51832,3,3,1, 51835
31,51836,2,2,1, 51838
7,51837,1,1,0, 51838
29,51838,4,4,1, 51842
8,51841,1,1,0, 51842
16,51844,2,2,1, 51846
14,51844,3,3,1, 51847
17,51844,3,3,1, 51847
13,51844,4,4,1, 51848
18,51848,4,4,1, 51852
22,51851,4,4,1, 51855
2,51853,2,2,1, 51855
24,51854,1,1,0, 51855
21,51852,5,5,1, 51857
1,51856,1,1,1, 51857
27,51857,4,4,1, 51861
6,51860,2,2,1, 51862
25,51860,2,2,1, 51862
31,51861,2,2,1, 51863
7,51862,1,1,1, 51863
26,51862,3,3,1, 51865
29,51863,4,4,1, 51867
8,51866,1,1,1, 51867
11,51864,4,4,1, 51868
16,51869,2,2,1, 51871
17,51869,3,3,1, 51872
13,51869,4,4,1, 51873
20,51873,6,6,1, 51879
22,51876,4,4,1, 51880
2,51878,2,2,1, 51880
24,51879,1,1,0, 51880
19,51876,5,5,1, 51881
23,51878,3,3,1, 51881
21,51877,5,5,1, 51882
1,51881,1,1,0, 51882
4,51881,4,4,1, 51885
25,51885,2,2,1, 51887
31,51886,2,2,1, 51888
7,51887,1,1,1, 51888
8,51891,1,1,0, 51892
14,51894,3,3,1, 51897
13,51894,4,4,1, 51898
15,51896,2,2,1, 51898
20,51898,6,6,1, 51904
2,51903,2,2,1, 51905
24,51904,1,1,0, 51905
19,51901,5,5,1, 51906
1,51906,1,1,1, 51907
27,51907,4,4,1, 51911
30,51908,3,3,1, 51911
31,51911,2,2,1, 51913
7,51912,1,1,0, 51913
11,51914,4,4,1, 51918
17,51919,3,3,1, 51922
12,51920,5,5,1, 51925
20,51923,6,6,1, 51929
24,51929,1,1,0, 51930
19,51926,5,5,1, 51931
30,51933,3,3,1, 51936
7,51937,1,1,0, 51938
24,51954,1,1,1, 51955
31,51961,2,2,1, 51963
7,51962,1,1,0, 51963
29,51963,4,4,1, 51967
24,51979,1,1,1, 51980
5,51982,3,3,1, 51985
30,51983,3,3,1, 51986
31,51986,2,2,1, 51988
7,51987,1,1,1, 51988
29,51988,4,4,1, 51992
24,52004,1,1,0, 52005
21,52002,5,5,1, 52007
6,52010,2,2,1, 52012
31,52011,2,2,1, 52013
7,52012,1,1,1, 52013
29,52013,4,4,1, 52017
8,52016,1,1,0, 52017
13,52019,4,4,1, 52023
15,52021,2,2,1, 52023
24,52029,1,1,0, 52030
23,52028,3,3,1, 52031
5,52032,3,3,1, 52035
6,52035,2,2,1, 52037
31,52036,2,2,1, 52038
7,52037,1,1,0, 52038
8,52041,1,1,0, 52042
16,52044,2,2,1, 52046
14,52044,3,3,1, 52047
13,52044,4,4,1, 52048
15,52046,2,2,1, 52048
22,52051,4,4,1, 52055
24,52054,1,1,1, 52055
23,52053,3,3,1, 52056
1,52056,1,1,1, 52057
30,52058,3,3,1, 52061
6,52060,2,2,1, 52062
25,52060,2,2,1, 52062
7,52062,1,1,0, 52063
8,52066,1,1,0, 52067
9,52067,2,2,1, 52069
14,52069,3,3,1, 52072
13,52069,4,4,1, 52073
18,52073,4,4,1, 52077
22,52076,4,4,1, 52080
24,52079,1,1,0, 52080
21,52077,5,5,1, 52082
1,52081,1,1,0, 52082
6,52085,2,2,1, 52087
25,52085,2,2,1, 52087
7,52087,1,1,1, 52088
26,52087,3,3,1, 52090
29,52088,4,4,1, 52092
8,52091,1,1,1, 52092
16,52094,2,2,1, 52096
14,52094,3,3,1, 52097
17,52094,3,3,1, 52097
13,52094,4,4,1, 52098
2,52103,2,2,1, 52105
24,52104,1,1,0, 52105
21,52102,5,5,1, 52107
1,52106,1,1,0, 52107
30,52108,3,3,1, 52111
31,52111,2,2,1, 52113
7,52112,1,1,0, 52113
29,52113,4,4,1, 52117
8,52116,1,1,1, 52117
18,52123,4,4,1, 52127
2,52128,2,2,1, 52130
24,52129,1,1,0, 52130
21,52127,5,5,1, 52132
1,52131,1,1,0, 52132
5,52132,3,3,1, 52135
7,52137,1,1,1, 52138
29,52138,4,4,1, 52142
8,52141,1,1,0, 52142
9,52142,2,2,1, 52144
16,52144,2,2,1, 52146
14,52144,3,3,1, 52147
17,52144,3,3,1, 52147
22,52151,4,4,1, 52155
24,52154,1,1,0, 52155
21,52152,5,5,1, 52157
1,52156,1,1,1, 52157
5,52157,3,3,1, 52160
25,52160,2,2,1, 52162
7,52162,1,1,0, 52163
26,52162,3,3,1, 52165
29,52163,4,4,1, 52167
8,52166,1,1,1, 52167
14,52169,3,3,1, 52172
17,52169,3,3,1, 52172
13,52169,4,4,1, 52173
15,52171,2,2,1, 52173
18,52173,4,4,1, 52177
22,52176,4,4,1, 52180
2,52178,2,2,1, 52180
24,52179,1,1,1, 52180
19,52176,5,5,1, 52181
23,52178,3,3,1, 52181
21,52177,5,5,1, 52182
1,52181,1,1,1, 52182
4,52181,4,4,1, 52185
3,52182,3,3,1, 52185
7,52187,1,1,0, 52188
28,52184,5,5,1, 52189
26,52187,3,3,1, 52190
29,52188,4,4,1, 52192
11,52189,4,4,1, 52193
9,52192,2,2,1, 52194
17,52194,3,3,1, 52197
12,52195,5,5,1, 52200
24,52204,1,1,1, 52205
19,52201,5,5,1, 52206
1,52206,1,1,0, 52207
4,52206,4,4,1, 52210
3,52207,3,3,1, 52210
5,52207,3,3,1, 52210
30,52208,3,3,1, 52211
6,52210,2,2,1, 52212
31,52211,2,2,1, 52213
7,52212,1,1,0, 52213
24,52229,1,1,0, 52230
5,52232,3,3,1, 52235
30,52233,3,3,1, 52236
6,52235,2,2,1, 52237
7,52237,1,1,0, 52238
24,52254,1,1,1, 52255
30,52258,3,3,1, 52261
6,52260,2,2,1, 52262
7,52262,1,1,0, 52263
24,52279,1,1,0, 52280
5,52282,3,3,1, 52285
30,52283,3,3,1, 52286
6,52285,2,2,1, 52287
31,52286,2,2,1, 52288
7,52287,1,1,0, 52288
29,52288,4,4,1, 52292
8,52291,1,1,1, 52292
16,52294,2,2,1, 52296
15,52296,2,2,1, 52298
22,52301,4,4,1, 52305
24,52304,1,1,1, 52305
21,52302,5,5,1, 52307
5,52307,3,3,1, 52310
30,52308,3,3,1, 52311
31,52311,2,2,1, 52313
7,52312,1,1,0, 52313
29,52313,4,4,1, 52317
8,52316,1,1,1, 52317
17,52319,3,3,1, 52322
13,52319,4,4,1, 52323
22,52326,4,4,1, 52330
24,52329,1,1,0, 52330
23,52328,3,3,1, 52331
21,52327,5,5,1, 52332
1,52331,1,1,0, 52332
5,52332,3,3,1, 52335
6,52335,2,2,1, 52337
25,52335,2,2,1, 52337
7,52337,1,1,0, 52338
8,52341,1,1,1, 52342
9,52342,2,2,1, 52344
16,52344,2,2,1, 52346
14,52344,3,3,1, 52347
17,52344,3,3,1, 52347
15,52346,2,2,1, 52348
22,52351,4,4,1, 52355
24,52354,1,1,0, 52355
23,52353,3,3,1, 52356
21,52352,5,5,1, 52357
1,52356,1,1,1, 52357
5,52357,3,3,1, 52360
30,52358,3,3,1, 52361
6,52360,2,2,1, 52362
25,52360,2,2,1, 52362
31,52361,2,2,1, 52363
7,52362,1,1,0, 52363
29,52363,4,4,1, 52367
8,52366,1,1,0, 52367
9,52367,2,2,1, 52369
17,52369,3,3,1, 52372
22,52376,4,4,1, 52380
24,52379,1,1,0, 52380
21,52377,5,5,1, 52382
1,52381,1,1,0, 52382
30,52383,3,3,1, 52386
25,52385,2,2,1, 52387
8,52391,1,1,0, 52392
16,52394,2,2,1, 52396
17,52394,3,3,1, 52397
18,52398,4,4,1, 52402
22,52401,4,4,1, 52405
24,52404,1,1,0, 52405
23,52403,3,3,1, 52406
21,52402,5,5,1, 52407
1,52406,1,1,0, 52407
26,52412,3,3,1, 52415
8,52416,1,1,1, 52417
9,52417,2,2,1, 52419
13,52419,4,4,1, 52423
22,52426,4,4,1, 52430
24,52429,1,1,0, 52430
23,52428,3,3,1, 52431
1,52431,1,1,1, 52432
25,52435,2,2,1, 52437
26,52437,3,3,1, 52440
8,52441,1,1,0, 52442
9,52442,2,2,1, 52444
14,52444,3,3,1, 52447
12,52445,5,5,1, 52450
18,52448,4,4,1, 52452
24,52454,1,1,0, 52455
19,52451,5,5,1, 52456
21,52452,5,5,1, 52457
1,52456,1,1,1, 52457
27,52457,4,4,1, 52461
25,52460,2,2,1, 52462
26,52462,3,3,1, 52465
8,52466,1,1,0, 52467
9,52467,2,2,1, 52469
14,52469,3,3,1, 52472
17,52469,3,3,1, 52472
15,52471,2,2,1, 52473
12,52470,5,5,1, 52475
22,52476,4,4,1, 52480
24,52479,1,1,0, 52480
23,52478,3,3,1, 52481
1,52481,1,1,0, 52482
4,52481,4,4,1, 52485
27,52482,4,4,1, 52486
25,52485,2,2,1, 52487
7,52487,1,1,1, 52488
26,52487,3,3,1, 52490
8,52491,1,1,0, 52492
24,52504,1,1,1, 52505
23,52503,3,3,1, 52506
21,52502,5,5,1, 52507
5,52507,3,3,1, 52510
30,52508,3,3,1, 52511
7,52512,1,1,0, 52513
24,52529,1,1,0, 52530
5,52532,3,3,1, 52535
30,52533,3,3,1, 52536
31,52536,2,2,1, 52538
7,52537,1,1,0, 52538
29,52538,4,4,1, 52542
24,52554,1,1,1, 52555
5,52557,3,3,1, 52560
6,52560,2,2,1, 52562
7,52562,1,1,1, 52563
24,52579,1,1,0, 52580
7,52587,1,1,1, 52588
29,52588,4,4,1, 52592
24,52604,1,1,1, 52605
1,52606,1,1,0, 52607
30,52608,3,3,1, 52611
31,52611,2,2,1, 52613
7,52612,1,1,1, 52613
29,52613,4,4,1, 52617
8,52616,1,1,0, 52617
14,52619,3,3,1, 52622
17,52619,3,3,1, 52622
15,52621,2,2,1, 52623
22,52626,4,4,1, 52630
24,52629,1,1,1, 52630
23,52628,3,3,1, 52631
21,52627,5,5,1, 52632
1,52631,1,1,0, 52632
7,52637,1,1,0, 52638
29,52638,4,4,1, 52642
8,52641,1,1,0, 52642
9,52642,2,2,1, 52644
17,52644,3,3,1, 52647
24,52654,1,1,0, 52655
23,52653,3,3,1, 52656
1,52656,1,1,1, 52657
5,52657,3,3,1, 52660
30,52658,3,3,1, 52661
6,52660,2,2,1, 52662
25,52660,2,2,1, 52662
31,52661,2,2,1, 52663
7,52662,1,1,1, 52663
29,52663,4,4,1, 52667
8,52666,1,1,0, 52667
16,52669,2,2,1, 52671
17,52669,3,3,1, 52672
13,52669,4,4,1, 52673
15,52671,2,2,1, 52673
2,52678,2,2,1, 52680
24,52679,1,1,1, 52680
23,52678,3,3,1, 52681
21,52677,5,5,1, 52682
1,52681,1,1,0, 52682
30,52683,3,3,1, 52686
6,52685,2,2,1, 52687
31,52686,2,2,1, 52688
7,52687,1,1,0, 52688
29,52688,4,4,1, 52692
8,52691,1,1,1, 52692
9,52692,2,2,1, 52694
14,52694,3,3,1, 52697
24,52704,1,1,0, 52705
23,52703,3,3,1, 52706
21,52702,5,5,1, 52707
1,52706,1,1,1, 52707
30,52708,3,3,1, 52711
7,52712,1,1,0, 52713
26,52712,3,3,1, 52715
8,52716,1,1,0, 52717
16,52719,2,2,1, 52721
15,52721,2,2,1, 52723
22,52726,4,4,1, 52730
24,52729,1,1,0, 52730
19,52726,5,5,1, 52731
23,52728,3,3,1, 52731
21,52727,5,5,1, 52732
1,52731,1,1,0, 52732
4,52731,4,4,1, 52735
27,52732,4,4,1, 52736
30,52733,3,3,1, 52736
6,52735,2,2,1, 52737
25,52735,2,2,1, 52737
31,52736,2,2,1, 52738
7,52737,1,1,0, 52738
26,52737,3,3,1, 52740
8,52741,1,1,1, 52742
11,52739,4,4,1, 52743
9,52742,2,2,1, 52744
16,52744,2,2,1, 52746
17,52744,3,3,1, 52747
13,52744,4,4,1, 52748
22,52751,4,4,1, 52755
2,52753,2,2,1, 52755
24,52754,1,1,1, 52755
19,52751,5,5,1, 52756
23,52753,3,3,1, 52756
21,52752,5,5,1, 52757
1,52756,1,1,0, 52757
4,52756,4,4,1, 52760
27,52757,4,4,1, 52761
6,52760,2,2,1, 52762
25,52760,2,2,1, 52762
31,52761,2,2,1, 52763
7,52762,1,1,1, 52763
28,52759,5,5,1, 52764
17,52769,3,3,1, 52772
12,52770,5,5,1, 52775
18,52773,4,4,1, 52777
2,52778,2,2,1, 52780
24,52779,1,1,0, 52780
19,52776,5,5,1, 52781
1,52781,1,1,1, 52782
3,52782,3,3,1, 52785
5,52782,3,3,1, 52785
27,52782,4,4,1, 52786
30,52783,3,3,1, 52786
6,52785,2,2,1, 52787
25,52785,2,2,1, 52787
7,52787,1,1,0, 52788
29,52788,4,4,1, 52792
24,52804,1,1,1, 52805
5,52807,3,3,1, 52810
31,52811,2,2,1, 52813
7,52812,1,1,1, 52813
24,52829,1,1,0, 52830
6,52835,2,2,1, 52837
7,52837,1,1,1, 52838
24,52854,1,1,1, 52855
30,52858,3,3,1, 52861
31,52861,2,2,1, 52863
7,52862,1,1,0, 52863
8,52866,1,1,1, 52867
16,52869,2,2,1, 52871
14,52869,3,3,1, 52872
15,52871,2,2,1, 52873
24,52879,1,1,0, 52880
23,52878,3,3,1, 52881
6,52885,2,2,1, 52887
7,52887,1,1,1, 52888
29,52888,4,4,1, 52892
8,52891,1,1,0, 52892
9,52892,2,2,1, 52894
15,52896,2,2,1, 52898
22,52901,4,4,1, 52905
24,52904,1,1,0, 52905
23,52903,3,3,1, 52906
21,52902,5,5,1, 52907
1,52906,1,1,0, 52907
30,52908,3,3,1, 52911
25,52910,2,2,1, 52912
31,52911,2,2,1, 52913
7,52912,1,1,1, 52913
8,52916,1,1,0, 52917
9,52917,2,2,1, 52919
16,52919,2,2,1, 52921
14,52919,3,3,1, 52922
17,52919,3,3,1, 52922
13,52919,4,4,1, 52923
24,52929,1,1,1, 52930
1,52931,1,1,1, 52932
30,52933,3,3,1, 52936
31,52936,2,2,1, 52938
7,52937,1,1,1, 52938
29,52938,4,4,1, 52942
8,52941,1,1,1, 52942
9,52942,2,2,1, 52944
16,52944,2,2,1, 52946
14,52944,3,3,1, 52947
13,52944,4,4,1, 52948
15,52946,2,2,1, 52948
22,52951,4,4,1, 52955
24,52954,1,1,0, 52955
23,52953,3,3,1, 52956
1,52956,1,1,0, 52957
5,52957,3,3,1, 52960
31,52961,2,2,1, 52963
7,52962,1,1,1, 52963
26,52962,3,3,1, 52965
29,52963,4,4,1, 52967
8,52966,1,1,0, 52967
9,52967,2,2,1, 52969
16,52969,2,2,1, 52971
13,52969,4,4,1, 52973
22,52976,4,4,1, 52980
24,52979,1,1,1, 52980
23,52978,3,3,1, 52981
1,52981,1,1,1, 52982
30,52983,3,3,1, 52986
6,52985,2,2,1, 52987
31,52986,2,2,1, 52988
7,52987,1,1,1, 52988
26,52987,3,3,1, 52990
8,52991,1,1,1, 52992
11,52989,4,4,1, 52993
17,52994,3,3,1, 52997
15,52996,2,2,1, 52998
18,52998,4,4,1, 53002
22,53001,4,4,1, 53005
2,53003,2,2,1, 53005
24,53004,1,1,0, 53005
19,53001,5,5,1, 53006
21,53002,5,5,1, 53007
1,53006,1,1,1, 53007
4,53006,4,4,1, 53010
5,53007,3,3,1, 53010
30,53008,3,3,1, 53011
7,53012,1,1,0, 53013
28,53009,5,5,1, 53014
8,53016,1,1,0, 53017
11,53014,4,4,1, 53018
15,53021,2,2,1, 53023
18,53023,4,4,1, 53027
24,53029,1,1,0, 53030
1,53031,1,1,1, 53032
5,53032,3,3,1, 53035
30,53033,3,3,1, 53036
6,53035,2,2,1, 53037
25,53035,2,2,1, 53037
7,53037,1,1,0, 53038
28,53034,5,5,1, 53039
26,53037,3,3,1, 53040
29,53038,4,4,1, 53042
8,53041,1,1,0, 53042
11,53039,4,4,1, 53043
9,53042,2,2,1, 53044
18,53048,4,4,1, 53052
20,53048,6,6,1, 53054
24,53054,1,1,1, 53055
19,53051,5,5,1, 53056
1,53056,1,1,0, 53057
4,53056,4,4,1, 53060
3,53057,3,3,1, 53060
5,53057,3,3,1, 53060
30,53058,3,3,1, 53061
7,53062,1,1,1, 53063
8,53066,1,1,0, 53067
24,53079,1,1,1, 53080
23,53078,3,3,1, 53081
5,53082,3,3,1, 53085
31,53086,2,2,1, 53088
7,53087,1,1,1, 53088
29,53088,4,4,1, 53092
8,53091,1,1,0, 53092
16,53094,2,2,1, 53096
15,53096,2,2,1, 53098
22,53101,4,4,1, 53105
24,53104,1,1,1, 53105
23,53103,3,3,1, 53106
7,53112,1,1,1, 53113
29,53113,4,4,1, 53117
8,53116,1,1,0, 53117
14,53119,3,3,1, 53122
13,53119,4,4,1, 53123
15,53121,2,2,1, 53123
22,53126,4,4,1, 53130
24,53129,1,1,0, 53130
23,53128,3,3,1, 53131
5,53132,3,3,1, 53135
30,53133,3,3,1, 53136
6,53135,2,2,1, 53137
31,53136,2,2,1, 53138
7,53137,1,1,1, 53138
29,53138,4,4,1, 53142
24,53154,1,1,0, 53155
24,53179,1,1,0, 53180
1,53181,1,1,0, 53182
9,53192,2,2,1, 53194
18,53198,4,4,1, 53202
2,53203,2,2,1, 53205
24,53204,1,1,1, 53205
1,53206,1,1,1, 53207
25,53210,2,2,1, 53212
26,53212,3,3,1, 53215
17,53219,3,3,1, 53222
2,53228,2,2,1, 53230
24,53229,1,1,0, 53230
1,53231,1,1,1, 53232
8,53241,1,1,1, 53242
9,53242,2,2,1, 53244
13,53244,4,4,1, 53248
20,53248,6,6,1, 53254
22,53251,4,4,1, 53255
24,53254,1,1,0, 53255
23,53253,3,3,1, 53256
1,53256,1,1,0, 53257
4,53256,4,4,1, 53260
5,53257,3,3,1, 53260
27,53257,4,4,1, 53261
25,53260,2,2,1, 53262
7,53262,1,1,1, 53263
28,53259,5,5,1, 53264
26,53262,3,3,1, 53265
29,53263,4,4,1, 53267
8,53266,1,1,1, 53267
17,53269,3,3,1, 53272
12,53270,5,5,1, 53275
18,53273,4,4,1, 53277
20,53273,6,6,1, 53279
22,53276,4,4,1, 53280
2,53278,2,2,1, 53280
24,53279,1,1,0, 53280
19,53276,5,5,1, 53281
23,53278,3,3,1, 53281
21,53277,5,5,1, 53282
1,53281,1,1,0, 53282
5,53282,3,3,1, 53285
30,53283,3,3,1, 53286
7,53287,1,1,1, 53288
28,53284,5,5,1, 53289
29,53288,4,4,1, 53292
8,53291,1,1,0, 53292
9,53292,2,2,1, 53294
13,53294,4,4,1, 53298
15,53296,2,2,1, 53298
22,53301,4,4,1, 53305
2,53303,2,2,1, 53305
24,53304,1,1,0, 53305
23,53303,3,3,1, 53306
21,53302,5,5,1, 53307
1,53306,1,1,1, 53307
6,53310,2,2,1, 53312
25,53310,2,2,1, 53312
7,53312,1,1,1, 53313
28,53309,5,5,1, 53314
26,53312,3,3,1, 53315
8,53316,1,1,1, 53317
11,53314,4,4,1, 53318
14,53319,3,3,1, 53322
13,53319,4,4,1, 53323
15,53321,2,2,1, 53323
24,53329,1,1,0, 53330
23,53328,3,3,1, 53331
21,53327,5,5,1, 53332
6,53335,2,2,1, 53337
7,53337,1,1,0, 53338
8,53341,1,1,1, 53342
16,53344,2,2,1, 53346
14,53344,3,3,1, 53347
24,53354,1,1,1, 53355
21,53352,5,5,1, 53357
5,53357,3,3,1, 53360
6,53360,2,2,1, 53362
7,53362,1,1,0, 53363
8,53366,1,1,0, 53367
14,53369,3,3,1, 53372
22,53376,4,4,1, 53380
24,53379,1,1,0, 53380
31,53386,2,2,1, 53388
7,53387,1,1,1, 53388
8,53391,1,1,0, 53392
16,53394,2,2,1, 53396
15,53396,2,2,1, 53398
22,53401,4,4,1, 53405
24,53404,1,1,0, 53405
23,53403,3,3,1, 53406
30,53408,3,3,1, 53411
31,53411,2,2,1, 53413
7,53412,1,1,0, 53413
29,53413,4,4,1, 53417
8,53416,1,1,1, 53417
14,53419,3,3,1, 53422
15,53421,2,2,1, 53423
22,53426,4,4,1, 53430
24,53429,1,1,0, 53430
23,53428,3,3,1, 53431
1,53431,1,1,1, 53432
5,53432,3,3,1, 53435
25,53435,2,2,1, 53437
7,53437,1,1,0, 53438
29,53438,4,4,1, 53442
8,53441,1,1,1, 53442
9,53442,2,2,1, 53444
14,53444,3,3,1, 53447
15,53446,2,2,1, 53448
24,53454,1,1,0, 53455
23,53453,3,3,1, 53456
21,53452,5,5,1, 53457
1,53456,1,1,1, 53457
5,53457,3,3,1, 53460
6,53460,2,2,1, 53462
25,53460,2,2,1, 53462
31,53461,2,2,1, 53463
7,53462,1,1,1, 53463
29,53463,4,4,1, 53467
9,53467,2,2,1, 53469
24,53479,1,1,1, 53480
1,53481,1,1,0, 53482
5,53482,3,3,1, 53485
30,53483,3,3,1, 53486
25,53485,2,2,1, 53487
31,53486,2,2,1, 53488
7,53487,1,1,1, 53488
17,53494,3,3,1, 53497
24,53504,1,1,0, 53505
1,53506,1,1,0, 53507
5,53507,3,3,1, 53510
7,53512,1,1,1, 53513
29,53513,4,4,1, 53517
9,53517,2,2,1, 53519
24,53529,1,1,1, 53530
1,53531,1,1,1, 53532
31,53536,2,2,1, 53538
7,53537,1,1,1, 53538
26,53537,3,3,1, 53540
18,53548,4,4,1, 53552
24,53554,1,1,0, 53555
1,53556,1,1,0, 53557
31,53561,2,2,1, 53563
7,53562,1,1,0, 53563
29,53563,4,4,1, 53567
8,53566,1,1,1, 53567
16,53569,2,2,1, 53571
14,53569,3,3,1, 53572
17,53569,3,3,1, 53572
18,53573,4,4,1, 53577
24,53579,1,1,1, 53580
19,53576,5,5,1, 53581
1,53581,1,1,0, 53582
3,53582,3,3,1, 53585
5,53582,3,3,1, 53585
27,53582,4,4,1, 53586
30,53583,3,3,1, 53586
25,53585,2,2,1, 53587
31,53586,2,2,1, 53588
7,53587,1,1,0, 53588
29,53588,4,4,1, 53592
8,53591,1,1,1, 53592
11,53589,4,4,1, 53593
16,53594,2,2,1, 53596
17,53594,3,3,1, 53597
13,53594,4,4,1, 53598
12,53595,5,5,1, 53600
20,53598,6,6,1, 53604
2,53603,2,2,1, 53605
24,53604,1,1,1, 53605
21,53602,5,5,1, 53607
1,53606,1,1,0, 53607
4,53606,4,4,1, 53610
30,53608,3,3,1, 53611
6,53610,2,2,1, 53612
25,53610,2,2,1, 53612
7,53612,1,1,0, 53613
26,53612,3,3,1, 53615
8,53616,1,1,1, 53617
11,53614,4,4,1, 53618
16,53619,2,2,1, 53621
14,53619,3,3,1, 53622
17,53619,3,3,1, 53622
15,53621,2,2,1, 53623
12,53620,5,5,1, 53625
20,53623,6,6,1, 53629
24,53629,1,1,1, 53630
19,53626,5,5,1, 53631
21,53627,5,5,1, 53632
1,53631,1,1,1, 53632
5,53632,3,3,1, 53635
7,53637,1,1,0, 53638
26,53637,3,3,1, 53640
29,53638,4,4,1, 53642
8,53641,1,1,1, 53642
11,53639,4,4,1, 53643
9,53642,2,2,1, 53644
16,53644,2,2,1, 53646
17,53644,3,3,1, 53647
15,53646,2,2,1, 53648
22,53651,4,4,1, 53655
24,53654,1,1,0, 53655
23,53653,3,3,1, 53656
6,53660,2,2,1, 53662
7,53662,1,1,0, 53663
8,53666,1,1,1, 53667
22,53676,4,4,1, 53680
24,53679,1,1,1, 53680
23,53678,3,3,1, 53681
7,53687,1,1,0, 53688
29,53688,4,4,1, 53692
8,53691,1,1,0, 53692
16,53694,2,2,1, 53696
24,53704,1,1,0, 53705
23,53703,3,3,1, 53706
21,53702,5,5,1, 53707
5,53707,3,3,1, 53710
30,53708,3,3,1, 53711
7,53712,1,1,1, 53713
8,53716,1,1,1, 53717
16,53719,2,2,1, 53721
15,53721,2,2,1, 53723
24,53729,1,1,0, 53730
23,53728,3,3,1, 53731
5,53732,3,3,1, 53735
6,53735,2,2,1, 53737
7,53737,1,1,1, 53738
29,53738,4,4,1, 53742
8,53741,1,1,0, 53742
16,53744,2,2,1, 53746
14,53744,3,3,1, 53747
15,53746,2,2,1, 53748
22,53751,4,4,1, 53755
24,53754,1,1,1, 53755
1,53756,1,1,0, 53757
5,53757,3,3,1, 53760
6,53760,2,2,1, 53762
25,53760,2,2,1, 53762
7,53762,1,1,1, 53763
29,53763,4,4,1, 53767
8,53766,1,1,1, 53767
17,53769,3,3,1, 53772
15,53771,2,2,1, 53773
24,53779,1,1,0, 53780
21,53777,5,5,1, 53782
1,53781,1,1,0, 53782
30,53783,3,3,1, 53786
6,53785,2,2,1, 53787
25,53785,2,2,1, 53787
7,53787,1,1,1, 53788
8,53791,1,1,1, 53792
9,53792,2,2,1, 53794
16,53794,2,2,1, 53796
17,53794,3,3,1, 53797
13,53794,4,4,1, 53798
22,53801,4,4,1, 53805
24,53804,1,1,1, 53805
23,53803,3,3,1, 53806
1,53806,1,1,1, 53807
30,53808,3,3,1, 53811
7,53812,1,1,0, 53813
29,53813,4,4,1, 53817
8,53816,1,1,0, 53817
9,53817,2,2,1, 53819
16,53819,2,2,1, 53821
17,53819,3,3,1, 53822
24,53829,1,1,1, 53830
1,53831,1,1,0, 53832
30,53833,3,3,1, 53836
25,53835,2,2,1, 53837
7,53837,1,1,1, 53838
26,53837,3,3,1, 53840
18,53848,4,4,1, 53852
2,53853,2,2,1, 53855
24,53854,1,1,1, 53855
1,53856,1,1,0, 53857
5,53857,3,3,1, 53860
30,53858,3,3,1, 53861
25,53860,2,2,1, 53862
7,53862,1,1,1, 53863
18,53873,4,4,1, 53877
2,53878,2,2,1, 53880
24,53879,1,1,0, 53880
1,53881,1,1,1, 53882
5,53882,3,3,1, 53885
25,53885,2,2,1, 53887
7,53887,1,1,1, 53888
9,53892,2,2,1, 53894
17,53894,3,3,1, 53897
18,53898,4,4,1, 53902
24,53904,1,1,1, 53905
1,53906,1,1,0, 53907
4,53906,4,4,1, 53910
5,53907,3,3,1, 53910
30,53908,3,3,1, 53911
6,53910,2,2,1, 53912
31,53911,2,2,1, 53913
7,53912,1,1,1, 53913
28,53909,5,5,1, 53914
29,53913,4,4,1, 53917
11,53914,4,4,1, 53918
9,53917,2,2,1, 53919
17,53919,3,3,1, 53922
18,53923,4,4,1, 53927
22,53926,4,4,1, 53930
2,53928,2,2,1, 53930
24,53929,1,1,1, 53930
19,53926,5,5,1, 53931
23,53928,3,3,1, 53931
1,53931,1,1,1, 53932
3,53932,3,3,1, 53935
30,53933,3,3,1, 53936
31,53936,2,2,1, 53938
7,53937,1,1,1, 53938
26,53937,3,3,1, 53940
8,53941,1,1,0, 53942
14,53944,3,3,1, 53947
15,53946,2,2,1, 53948
22,53951,4,4,1, 53955
24,53954,1,1,1, 53955
21,53952,5,5,1, 53957
5,53957,3,3,1, 53960
6,53960,2,2,1, 53962
7,53962,1,1,1, 53963
8,53966,1,1,0, 53967
14,53969,3,3,1, 53972
15,53971,2,2,1, 53973
22,53976,4,4,1, 53980
24,53979,1,1,0, 53980
5,53982,3,3,1, 53985
6,53985,2,2,1, 53987
31,53986,2,2,1, 53988
7,53987,1,1,0, 53988
29,53988,4,4,1, 53992
8,53991,1,1,1, 53992
16,53994,2,2,1, 53996
13,53994,4,4,1, 53998
22,54001,4,4,1, 54005
24,54004,1,1,0, 54005
30,54008,3,3,1, 54011
7,54012,1,1,1, 54013
29,54013,4,4,1, 54017
8,54016,1,1,1, 54017
16,54019,2,2,1, 54021
14,54019,3,3,1, 54022
13,54019,4,4,1, 54023
15,54021,2,2,1, 54023
22,54026,4,4,1, 54030
24,54029,1,1,0, 54030
21,54027,5,5,1, 54032
31,54036,2,2,1, 54038
7,54037,1,1,1, 54038
29,54038,4,4,1, 54042
8,54041,1,1,1, 54042
9,54042,2,2,1, 54044
14,54044,3,3,1, 54047
17,54044,3,3,1, 54047
12,54045,5,5,1, 54050
24,54054,1,1,0, 54055
19,54051,5,5,1, 54056
23,54053,3,3,1, 54056
1,54056,1,1,0, 54057
4,54056,4,4,1, 54060
3,54057,3,3,1, 54060
27,54057,4,4,1, 54061
6,54060,2,2,1, 54062
31,54061,2,2,1, 54063
7,54062,1,1,1, 54063
29,54063,4,4,1, 54067
8,54066,1,1,1, 54067
16,54069,2,2,1, 54071
14,54069,3,3,1, 54072
13,54069,4,4,1, 54073
22,54076,4,4,1, 54080
24,54079,1,1,1, 54080
23,54078,3,3,1, 54081
21,54077,5,5,1, 54082
1,54081,1,1,0, 54082
30,54083,3,3,1, 54086
25,54085,2,2,1, 54087
31,54086,2,2,1, 54088
7,54087,1,1,0, 54088
29,54088,4,4,1, 54092
8,54091,1,1,0, 54092
9,54092,2,2,1, 54094
14,54094,3,3,1, 54097
17,54094,3,3,1, 54097
15,54096,2,2,1, 54098
24,54104,1,1,1, 54105
1,54106,1,1,0, 54107
6,54110,2,2,1, 54112
25,54110,2,2,1, 54112
7,54112,1,1,1, 54113
9,54117,2,2,1, 54119
24,54129,1,1,1, 54130
1,54131,1,1,1, 54132
30,54133,3,3,1, 54136
7,54137,1,1,0, 54138
24,54154,1,1,1, 54155
1,54156,1,1,1, 54157
5,54157,3,3,1, 54160
30,54158,3,3,1, 54161
6,54160,2,2,1, 54162
7,54162,1,1,0, 54163
26,54162,3,3,1, 54165
9,54167,2,2,1, 54169
12,54170,5,5,1, 54175
18,54173,4,4,1, 54177
2,54178,2,2,1, 54180
24,54179,1,1,0, 54180
19,54176,5,5,1, 54181
1,54181,1,1,0, 54182
4,54181,4,4,1, 54185
3,54182,3,3,1, 54185
27,54182,4,4,1, 54186
30,54183,3,3,1, 54186
6,54185,2,2,1, 54187
7,54187,1,1,1, 54188
26,54187,3,3,1, 54190
29,54188,4,4,1, 54192
11,54189,4,4,1, 54193
9,54192,2,2,1, 54194
2,54203,2,2,1, 54205
24,54204,1,1,0, 54205
23,54203,3,3,1, 54206
21,54202,5,5,1, 54207
1,54206,1,1,1, 54207
7,54212,1,1,0, 54213
26,54212,3,3,1, 54215
8,54216,1,1,0, 54217
9,54217,2,2,1, 54219
14,54219,3,3,1, 54222
13,54219,4,4,1, 54223
15,54221,2,2,1, 54223
22,54226,4,4,1, 54230
2,54228,2,2,1, 54230
24,54229,1,1,0, 54230
1,54231,1,1,0, 54232
6,54235,2,2,1, 54237
25,54235,2,2,1, 54237
7,54237,1,1,0, 54238
26,54237,3,3,1, 54240
29,54238,4,4,1, 54242
8,54241,1,1,1, 54242
15,54246,2,2,1, 54248
22,54251,4,4,1, 54255
24,54254,1,1,1, 54255
23,54253,3,3,1, 54256
5,54257,3,3,1, 54260
31,54261,2,2,1, 54263
7,54262,1,1,0, 54263
8,54266,1,1,1, 54267
13,54269,4,4,1, 54273
22,54276,4,4,1, 54280
24,54279,1,1,1, 54280
23,54278,3,3,1, 54281
21,54277,5,5,1, 54282
30,54283,3,3,1, 54286
6,54285,2,2,1, 54287
31,54286,2,2,1, 54288
7,54287,1,1,0, 54288
8,54291,1,1,0, 54292
14,54294,3,3,1, 54297
15,54296,2,2,1, 54298
24,54304,1,1,0, 54305
23,54303,3,3,1, 54306
5,54307,3,3,1, 54310
6,54310,2,2,1, 54312
7,54312,1,1,1, 54313
29,54313,4,4,1, 54317
8,54316,1,1,0, 54317
16,54319,2,2,1, 54321
13,54319,4,4,1, 54323
24,54329,1,1,1, 54330
30,54333,3,3,1, 54336
31,54336,2,2,1, 54338
7,54337,1,1,1, 54338
8,54341,1,1,1, 54342
9,54342,2,2,1, 54344
14,54344,3,3,1, 54347
12,54345,5,5,1, 54350
22,54351,4,4,1, 54355
2,54353,2,2,1, 54355
24,54354,1,1,1, 54355
21,54352,5,5,1, 54357
1,54356,1,1,1, 54357
4,54356,4,4,1, 54360
30,54358,3,3,1, 54361
6,54360,2,2,1, 54362
7,54362,1,1,1, 54363
8,54366,1,1,0, 54367
9,54367,2,2,1, 54369
16,54369,2,2,1, 54371
22,54376,4,4,1, 54380
24,54379,1,1,1, 54380
23,54378,3,3,1, 54381
1,54381,1,1,0, 54382
5,54382,3,3,1, 54385
25,54385,2,2,1, 54387
7,54387,1,1,1, 54388
29,54388,4,4,1, 54392
8,54391,1,1,1, 54392
9,54392,2,2,1, 54394
16,54394,2,2,1, 54396
17,54394,3,3,1, 54397
24,54404,1,1,1, 54405
21,54402,5,5,1, 54407
1,54406,1,1,1, 54407
5,54407,3,3,1, 54410
30,54408,3,3,1, 54411
25,54410,2,2,1, 54412
7,54412,1,1,0, 54413
8,54416,1,1,0, 54417
14,54419,3,3,1, 54422
17,54419,3,3,1, 54422
13,54419,4,4,1, 54423
24,54429,1,1,1, 54430
1,54431,1,1,0, 54432
5,54432,3,3,1, 54435
30,54433,3,3,1, 54436
31,54436,2,2,1, 54438
7,54437,1,1,1, 54438
8,54441,1,1,1, 54442
9,54442,2,2,1, 54444
15,54446,2,2,1, 54448
24,54454,1,1,1, 54455
1,54456,1,1,1, 54457
5,54457,3,3,1, 54460
30,54458,3,3,1, 54461
6,54460,2,2,1, 54462
31,54461,2,2,1, 54463
7,54462,1,1,0, 54463
8,54466,1,1,1, 54467
9,54467,2,2,1, 54469
14,54469,3,3,1, 54472
13,54469,4,4,1, 54473
15,54471,2,2,1, 54473
24,54479,1,1,1, 54480
19,54476,5,5,1, 54481
23,54478,3,3,1, 54481
1,54481,1,1,1, 54482
4,54481,4,4,1, 54485
25,54485,2,2,1, 54487
7,54487,1,1,1, 54488
28,54484,5,5,1, 54489
29,54488,4,4,1, 54492
8,54491,1,1,1, 54492
16,54494,2,2,1, 54496
14,54494,3,3,1, 54497
17,54494,3,3,1, 54497
15,54496,2,2,1, 54498
12,54495,5,5,1, 54500
18,54498,4,4,1, 54502
2,54503,2,2,1, 54505
24,54504,1,1,1, 54505
23,54503,3,3,1, 54506
21,54502,5,5,1, 54507
1,54506,1,1,0, 54507
4,54506,4,4,1, 54510
5,54507,3,3,1, 54510
30,54508,3,3,1, 54511
6,54510,2,2,1, 54512
7,54512,1,1,1, 54513
28,54509,5,5,1, 54514
26,54512,3,3,1, 54515
29,54513,4,4,1, 54517
8,54516,1,1,0, 54517
9,54517,2,2,1, 54519
16,54519,2,2,1, 54521
14,54519,3,3,1, 54522
17,54519,3,3,1, 54522
2,54528,2,2,1, 54530
24,54529,1,1,0, 54530
1,54531,1,1,1, 54532
5,54532,3,3,1, 54535
6,54535,2,2,1, 54537
31,54536,2,2,1, 54538
7,54537,1,1,1, 54538
26,54537,3,3,1, 54540
29,54538,4,4,1, 54542
17,54544,3,3,1, 54547
18,54548,4,4,1, 54552
24,54554,1,1,1, 54555
1,54556,1,1,0, 54557
9,54567,2,2,1, 54569
24,54579,1,1,0, 54580
1,54581,1,1,1, 54582
25,54585,2,2,1, 54587
26,54587,3,3,1, 54590
24,54604,1,1,0, 54605
1,54606,1,1,0, 54607
25,54610,2,2,1, 54612
26,54612,3,3,1, 54615
11,54614,4,4,1, 54618
22,54626,4,4,1, 54630
24,54629,1,1,1, 54630
21,54627,5,5,1, 54632
8,54641,1,1,0, 54642
13,54644,4,4,1, 54648
24,54654,1,1,1, 54655
5,54657,3,3,1, 54660
31,54661,2,2,1, 54663
7,54662,1,1,0, 54663
8,54666,1,1,1, 54667
15,54671,2,2,1, 54673
22,54676,4,4,1, 54680
24,54679,1,1,1, 54680
5,54682,3,3,1, 54685
30,54683,3,3,1, 54686
31,54686,2,2,1, 54688
7,54687,1,1,0, 54688
29,54688,4,4,1, 54692
8,54691,1,1,0, 54692
14,54694,3,3,1, 54697
22,54701,4,4,1, 54705
24,54704,1,1,0, 54705
23,54703,3,3,1, 54706
30,54708,3,3,1, 54711
6,54710,2,2,1, 54712
31,54711,2,2,1, 54713
7,54712,1,1,0, 54713
8,54716,1,1,0, 54717
14,54719,3,3,1, 54722
18,54723,4,4,1, 54727
20,54723,6,6,1, 54729
22,54726,4,4,1, 54730
24,54729,1,1,0, 54730
21,54727,5,5,1, 54732
1,54731,1,1,0, 54732
25,54735,2,2,1, 54737
31,54736,2,2,1, 54738
7,54737,1,1,1, 54738
8,54741,1,1,0, 54742
13,54744,4,4,1, 54748
22,54751,4,4,1, 54755
24,54754,1,1,0, 54755
23,54753,3,3,1, 54756
21,54752,5,5,1, 54757
1,54756,1,1,0, 54757
30,54758,3,3,1, 54761
25,54760,2,2,1, 54762
7,54762,1,1,0, 54763
29,54763,4,4,1, 54767
8,54766,1,1,1, 54767
9,54767,2,2,1, 54769
16,54769,2,2,1, 54771
14,54769,3,3,1, 54772
15,54771,2,2,1, 54773
24,54779,1,1,0, 54780
23,54778,3,3,1, 54781
1,54781,1,1,1, 54782
5,54782,3,3,1, 54785
25,54785,2,2,1, 54787
7,54787,1,1,1, 54788
29,54788,4,4,1, 54792
8,54791,1,1,0, 54792
9,54792,2,2,1, 54794
14,54794,3,3,1, 54797
17,54794,3,3,1, 54797
13,54794,4,4,1, 54798
24,54804,1,1,0, 54805
1,54806,1,1,0, 54807
6,54810,2,2,1, 54812
25,54810,2,2,1, 54812
7,54812,1,1,1, 54813
8,54816,1,1,1, 54817
14,54819,3,3,1, 54822
17,54819,3,3,1, 54822
13,54819,4,4,1, 54823
22,54826,4,4,1, 54830
24,54829,1,1,1, 54830
1,54831,1,1,1, 54832
30,54833,3,3,1, 54836
7,54837,1,1,1, 54838
8,54841,1,1,1, 54842
16,54844,2,2,1, 54846
14,54844,3,3,1, 54847
17,54844,3,3,1, 54847
15,54846,2,2,1, 54848
22,54851,4,4,1, 54855
24,54854,1,1,0, 54855
23,54853,3,3,1, 54856
21,54852,5,5,1, 54857
1,54856,1,1,1, 54857
30,54858,3,3,1, 54861
6,54860,2,2,1, 54862
25,54860,2,2,1, 54862
7,54862,1,1,1, 54863
26,54862,3,3,1, 54865
8,54866,1,1,1, 54867
16,54869,2,2,1, 54871
17,54869,3,3,1, 54872
15,54871,2,2,1, 54873
18,54873,4,4,1, 54877
22,54876,4,4,1, 54880
2,54878,2,2,1, 54880
24,54879,1,1,1, 54880
1,54881,1,1,1, 54882
6,54885,2,2,1, 54887
7,54887,1,1,0, 54888
8,54891,1,1,0, 54892
9,54892,2,2,1, 54894
16,54894,2,2,1, 54896
17,54894,3,3,1, 54897
15,54896,2,2,1, 54898
12,54895,5,5,1, 54900
18,54898,4,4,1, 54902
2,54903,2,2,1, 54905
24,54904,1,1,0, 54905
1,54906,1,1,1, 54907
4,54906,4,4,1, 54910
3,54907,3,3,1, 54910
5,54907,3,3,1, 54910
31,54911,2,2,1, 54913
7,54912,1,1,1, 54913
26,54912,3,3,1, 54915
12,54920,5,5,1, 54925
18,54923,4,4,1, 54927
24,54929,1,1,0, 54930
19,54926,5,5,1, 54931
1,54931,1,1,1, 54932
31,54936,2,2,1, 54938
7,54937,1,1,1, 54938
28,54934,5,5,1, 54939
26,54937,3,3,1, 54940
29,54938,4,4,1, 54942
11,54939,4,4,1, 54943
9,54942,2,2,1, 54944
20,54948,6,6,1, 54954
2,54953,2,2,1, 54955
24,54954,1,1,0, 54955
19,54951,5,5,1, 54956
5,54957,3,3,1, 54960
31,54961,2,2,1, 54963
7,54962,1,1,1, 54963
29,54963,4,4,1, 54967
24,54979,1,1,1, 54980
30,54983,3,3,1, 54986
6,54985,2,2,1, 54987
7,54987,1,1,1, 54988
29,54988,4,4,1, 54992
24,55004,1,1,1, 55005
5,55007,3,3,1, 55010
7,55012,1,1,0, 55013
8,55016,1,1,0, 55017
16,55019,2,2,1, 55021
13,55019,4,4,1, 55023
22,55026,4,4,1, 55030
24,55029,1,1,0, 55030
23,55028,3,3,1, 55031
21,55027,5,5,1, 55032
5,55032,3,3,1, 55035
31,55036,2,2,1, 55038
7,55037,1,1,0, 55038
29,55038,4,4,1, 55042
8,55041,1,1,0, 55042
16,55044,2,2,1, 55046
14,55044,3,3,1, 55047
13,55044,4,4,1, 55048
22,55051,4,4,1, 55055
24,55054,1,1,0, 55055
23,55053,3,3,1, 55056
5,55057,3,3,1, 55060
7,55062,1,1,1, 55063
8,55066,1,1,0, 55067
9,55067,2,2,1, 55069
14,55069,3,3,1, 55072
17,55069,3,3,1, 55072
13,55069,4,4,1, 55073
24,55079,1,1,0, 55080
23,55078,3,3,1, 55081
1,55081,1,1,1, 55082
6,55085,2,2,1, 55087
7,55087,1,1,0, 55088
8,55091,1,1,1, 55092
9,55092,2,2,1, 55094
16,55094,2,2,1, 55096
14,55094,3,3,1, 55097
24,55104,1,1,0, 55105
21,55102,5,5,1, 55107
1,55106,1,1,0, 55107
5,55107,3,3,1, 55110
25,55110,2,2,1, 55112
7,55112,1,1,1, 55113
8,55116,1,1,1, 55117
16,55119,2,2,1, 55121
15,55121,2,2,1, 55123
22,55126,4,4,1, 55130
2,55128,2,2,1, 55130
24,55129,1,1,0, 55130
23,55128,3,3,1, 55131
21,55127,5,5,1, 55132
1,55131,1,1,0, 55132
5,55132,3,3,1, 55135
7,55137,1,1,1, 55138
29,55138,4,4,1, 55142
8,55141,1,1,0, 55142
17,55144,3,3,1, 55147
18,55148,4,4,1, 55152
2,55153,2,2,1, 55155
24,55154,1,1,0, 55155
23,55153,3,3,1, 55156
21,55152,5,5,1, 55157
1,55156,1,1,0, 55157
5,55157,3,3,1, 55160
30,55158,3,3,1, 55161
7,55162,1,1,1, 55163
26,55162,3,3,1, 55165
29,55163,4,4,1, 55167
8,55166,1,1,1, 55167
16,55169,2,2,1, 55171
13,55169,4,4,1, 55173
15,55171,2,2,1, 55173
20,55173,6,6,1, 55179
24,55179,1,1,1, 55180
19,55176,5,5,1, 55181
21,55177,5,5,1, 55182
1,55181,1,1,0, 55182
4,55181,4,4,1, 55185
3,55182,3,3,1, 55185
30,55183,3,3,1, 55186
7,55187,1,1,0, 55188
26,55187,3,3,1, 55190
8,55191,1,1,0, 55192
9,55192,2,2,1, 55194
16,55194,2,2,1, 55196
14,55194,3,3,1, 55197
13,55194,4,4,1, 55198
18,55198,4,4,1, 55202
20,55198,6,6,1, 55204
2,55203,2,2,1, 55205
24,55204,1,1,0, 55205
19,55201,5,5,1, 55206
1,55206,1,1,1, 55207
5,55207,3,3,1, 55210
27,55207,4,4,1, 55211
30,55208,3,3,1, 55211
25,55210,2,2,1, 55212
31,55211,2,2,1, 55213
7,55212,1,1,1, 55213
26,55212,3,3,1, 55215
11,55214,4,4,1, 55218
9,55217,2,2,1, 55219
24,55229,1,1,1, 55230
19,55226,5,5,1, 55231
1,55231,1,1,1, 55232
3,55232,3,3,1, 55235
27,55232,4,4,1, 55236
30,55233,3,3,1, 55236
7,55237,1,1,1, 55238
28,55234,5,5,1, 55239
26,55237,3,3,1, 55240
29,55238,4,4,1, 55242
24,55254,1,1,1, 55255
5,55257,3,3,1, 55260
30,55258,3,3,1, 55261
6,55260,2,2,1, 55262
7,55262,1,1,1, 55263
24,55279,1,1,0, 55280
31,55286,2,2,1, 55288
7,55287,1,1,1, 55288
29,55288,4,4,1, 55292
24,55304,1,1,1, 55305
23,55303,3,3,1, 55306
21,55302,5,5,1, 55307
7,55312,1,1,0, 55313
8,55316,1,1,1, 55317
14,55319,3,3,1, 55322
24,55329,1,1,1, 55330
6,55335,2,2,1, 55337
31,55336,2,2,1, 55338
7,55337,1,1,1, 55338
8,55341,1,1,0, 55342
16,55344,2,2,1, 55346
14,55344,3,3,1, 55347
24,55354,1,1,0, 55355
1,55356,1,1,0, 55357
5,55357,3,3,1, 55360
30,55358,3,3,1, 55361
6,55360,2,2,1, 55362
31,55361,2,2,1, 55363
7,55362,1,1,0, 55363
29,55363,4,4,1, 55367
8,55366,1,1,0, 55367
9,55367,2,2,1, 55369
24,55379,1,1,1, 55380
1,55381,1,1,0, 55382
30,55383,3,3,1, 55386
6,55385,2,2,1, 55387
25,55385,2,2,1, 55387
31,55386,2,2,1, 55388
7,55387,1,1,0, 55388
29,55388,4,4,1, 55392
8,55391,1,1,0, 55392
16,55394,2,2,1, 55396
22,55401,4,4,1, 55405
24,55404,1,1,1, 55405
1,55406,1,1,0, 55407
5,55407,3,3,1, 55410
30,55408,3,3,1, 55411
6,55410,2,2,1, 55412
25,55410,2,2,1, 55412
7,55412,1,1,0, 55413
8,55416,1,1,1, 55417
9,55417,2,2,1, 55419
16,55419,2,2,1, 55421
14,55419,3,3,1, 55422
13,55419,4,4,1, 55423
18,55423,4,4,1, 55427
24,55429,1,1,0, 55430
23,55428,3,3,1, 55431
1,55431,1,1,1, 55432
5,55432,3,3,1, 55435
30,55433,3,3,1, 55436
6,55435,2,2,1, 55437
25,55435,2,2,1, 55437
7,55437,1,1,1, 55438
26,55437,3,3,1, 55440
8,55441,1,1,0, 55442
18,55448,4,4,1, 55452
22,55451,4,4,1, 55455
24,55454,1,1,1, 55455
23,55453,3,3,1, 55456
1,55456,1,1,0, 55457
5,55457,3,3,1, 55460
6,55460,2,2,1, 55462
31,55461,2,2,1, 55463
7,55462,1,1,1, 55463
8,55466,1,1,0, 55467
16,55469,2,2,1, 55471
17,55469,3,3,1, 55472
24,55479,1,1,1, 55480
21,55477,5,5,1, 55482
1,55481,1,1,0, 55482
6,55485,2,2,1, 55487
7,55487,1,1,1, 55488
29,55488,4,4,1, 55492
8,55491,1,1,0, 55492
9,55492,2,2,1, 55494
16,55494,2,2,1, 55496
14,55494,3,3,1, 55497
13,55494,4,4,1, 55498
24,55504,1,1,0, 55505
23,55503,3,3,1, 55506
21,55502,5,5,1, 55507
1,55506,1,1,0, 55507
30,55508,3,3,1, 55511
7,55512,1,1,0, 55513
26,55512,3,3,1, 55515
29,55513,4,4,1, 55517
8,55516,1,1,0, 55517
16,55519,2,2,1, 55521
14,55519,3,3,1, 55522
13,55519,4,4,1, 55523
20,55523,6,6,1, 55529
22,55526,4,4,1, 55530
2,55528,2,2,1, 55530
24,55529,1,1,0, 55530
23,55528,3,3,1, 55531
1,55531,1,1,0, 55532
3,55532,3,3,1, 55535
31,55536,2,2,1, 55538
7,55537,1,1,0, 55538
28,55534,5,5,1, 55539
26,55537,3,3,1, 55540
8,55541,1,1,1, 55542
11,55539,4,4,1, 55543
17,55544,3,3,1, 55547
12,55545,5,5,1, 55550
22,55551,4,4,1, 55555
24,55554,1,1,0, 55555
19,55551,5,5,1, 55556
1,55556,1,1,1, 55557
5,55557,3,3,1, 55560
30,55558,3,3,1, 55561
31,55561,2,2,1, 55563
7,55562,1,1,1, 55563
8,55566,1,1,1, 55567
11,55564,4,4,1, 55568
9,55567,2,2,1, 55569
16,55569,2,2,1, 55571
17,55569,3,3,1, 55572
18,55573,4,4,1, 55577
22,55576,4,4,1, 55580
2,55578,2,2,1, 55580
24,55579,1,1,1, 55580
21,55577,5,5,1, 55582
1,55581,1,1,1, 55582
5,55582,3,3,1, 55585
30,55583,3,3,1, 55586
7,55587,1,1,0, 55588
28,55584,5,5,1, 55589
26,55587,3,3,1, 55590
8,55591,1,1,0, 55592
11,55589,4,4,1, 55593
9,55592,2,2,1, 55594
13,55594,4,4,1, 55598
20,55598,6,6,1, 55604
2,55603,2,2,1, 55605
24,55604,1,1,0, 55605
1,55606,1,1,1, 55607
4,55606,4,4,1, 55610
27,55607,4,4,1, 55611
25,55610,2,2,1, 55612
31,55611,2,2,1, 55613
7,55612,1,1,0, 55613
26,55612,3,3,1, 55615
8,55616,1,1,1, 55617
9,55617,2,2,1, 55619
16,55619,2,2,1, 55621
22,55626,4,4,1, 55630
24,55629,1,1,1, 55630
31,55636,2,2,1, 55638
7,55637,1,1,0, 55638
8,55641,1,1,1, 55642
14,55644,3,3,1, 55647
13,55644,4,4,1, 55648
24,55654,1,1,0, 55655
23,55653,3,3,1, 55656
30,55658,3,3,1, 55661
7,55662,1,1,0, 55663
29,55663,4,4,1, 55667
8,55666,1,1,0, 55667
13,55669,4,4,1, 55673
24,55679,1,1,0, 55680
31,55686,2,2,1, 55688
7,55687,1,1,1, 55688
8,55691,1,1,1, 55692
16,55694,2,2,1, 55696
14,55694,3,3,1, 55697
22,55701,4,4,1, 55705
24,55704,1,1,0, 55705
21,55702,5,5,1, 55707
6,55710,2,2,1, 55712
7,55712,1,1,0, 55713
29,55713,4,4,1, 55717
8,55716,1,1,0, 55717
22,55726,4,4,1, 55730
24,55729,1,1,0, 55730
1,55731,1,1,1, 55732
5,55732,3,3,1, 55735
6,55735,2,2,1, 55737
7,55737,1,1,1, 55738
8,55741,1,1,1, 55742
9,55742,2,2,1, 55744
17,55744,3,3,1, 55747
24,55754,1,1,0, 55755
21,55752,5,5,1, 55757
1,55756,1,1,0, 55757
8,55766,1,1,1, 55767
9,55767,2,2,1, 55769
16,55769,2,2,1, 55771
17,55769,3,3,1, 55772
22,55776,4,4,1, 55780
24,55779,1,1,1, 55780
23,55778,3,3,1, 55781
1,55781,1,1,1, 55782
25,55785,2,2,1, 55787
8,55791,1,1,0, 55792
17,55794,3,3,1, 55797
22,55801,4,4,1, 55805
24,55804,1,1,1, 55805
1,55806,1,1,0, 55807
28,55809,5,5,1, 55814
8,55816,1,1,1, 55817
9,55817,2,2,1, 55819
16,55819,2,2,1, 55821
18,55823,4,4,1, 55827
24,55829,1,1,1, 55830
23,55828,3,3,1, 55831
1,55831,1,1,0, 55832
25,55835,2,2,1, 55837
26,55837,3,3,1, 55840
8,55841,1,1,1, 55842
16,55844,2,2,1, 55846
17,55844,3,3,1, 55847
13,55844,4,4,1, 55848
22,55851,4,4,1, 55855
24,55854,1,1,0, 55855
1,55856,1,1,0, 55857
6,55860,2,2,1, 55862
25,55860,2,2,1, 55862
7,55862,1,1,0, 55863
8,55866,1,1,1, 55867
9,55867,2,2,1, 55869
14,55869,3,3,1, 55872
13,55869,4,4,1, 55873
18,55873,4,4,1, 55877
2,55878,2,2,1, 55880
24,55879,1,1,1, 55880
23,55878,3,3,1, 55881
1,55881,1,1,0, 55882
7,55887,1,1,1, 55888
29,55888,4,4,1, 55892
8,55891,1,1,1, 55892
9,55892,2,2,1, 55894
17,55894,3,3,1, 55897
13,55894,4,4,1, 55898
24,55904,1,1,1, 55905
21,55902,5,5,1, 55907
1,55906,1,1,0, 55907
25,55910,2,2,1, 55912
7,55912,1,1,1, 55913
26,55912,3,3,1, 55915
29,55913,4,4,1, 55917
8,55916,1,1,0, 55917
16,55919,2,2,1, 55921
14,55919,3,3,1, 55922
17,55919,3,3,1, 55922
12,55920,5,5,1, 55925
18,55923,4,4,1, 55927
2,55928,2,2,1, 55930
24,55929,1,1,1, 55930
19,55926,5,5,1, 55931
1,55931,1,1,0, 55932
4,55931,4,4,1, 55935
3,55932,3,3,1, 55935
5,55932,3,3,1, 55935
27,55932,4,4,1, 55936
30,55933,3,3,1, 55936
25,55935,2,2,1, 55937
7,55937,1,1,1, 55938
29,55938,4,4,1, 55942
8,55941,1,1,1, 55942
14,55944,3,3,1, 55947
17,55944,3,3,1, 55947
12,55945,5,5,1, 55950
18,55948,4,4,1, 55952
22,55951,4,4,1, 55955
24,55954,1,1,0, 55955
23,55953,3,3,1, 55956
5,55957,3,3,1, 55960
7,55962,1,1,1, 55963
8,55966,1,1,1, 55967
13,55969,4,4,1, 55973
22,55976,4,4,1, 55980
24,55979,1,1,1, 55980
23,55978,3,3,1, 55981
5,55982,3,3,1, 55985
30,55983,3,3,1, 55986
6,55985,2,2,1, 55987
7,55987,1,1,0, 55988
8,55991,1,1,1, 55992
22,56001,4,4,1, 56005
24,56004,1,1,1, 56005
23,56003,3,3,1, 56006
6,56010,2,2,1, 56012
31,56011,2,2,1, 56013
7,56012,1,1,0, 56013
29,56013,4,4,1, 56017
8,56016,1,1,1, 56017
16,56019,2,2,1, 56021
24,56029,1,1,0, 56030
5,56032,3,3,1, 56035
6,56035,2,2,1, 56037
7,56037,1,1,0, 56038
29,56038,4,4,1, 56042
8,56041,1,1,0, 56042
14,56044,3,3,1, 56047
13,56044,4,4,1, 56048
24,56054,1,1,1, 56055
19,56051,5,5,1, 56056
23,56053,3,3,1, 56056
21,56052,5,5,1, 56057
1,56056,1,1,0, 56057
4,56056,4,4,1, 56060
3,56057,3,3,1, 56060
30,56058,3,3,1, 56061
25,56060,2,2,1, 56062
31,56061,2,2,1, 56063
7,56062,1,1,1, 56063
28,56059,5,5,1, 56064
26,56062,3,3,1, 56065
8,56066,1,1,1, 56067
9,56067,2,2,1, 56069
16,56069,2,2,1, 56071
14,56069,3,3,1, 56072
12,56070,5,5,1, 56075
20,56073,6,6,1, 56079
22,56076,4,4,1, 56080
24,56079,1,1,1, 56080
19,56076,5,5,1, 56081
1,56081,1,1,1, 56082
5,56082,3,3,1, 56085
30,56083,3,3,1, 56086
25,56085,2,2,1, 56087
7,56087,1,1,0, 56088
8,56091,1,1,0, 56092
17,56094,3,3,1, 56097
13,56094,4,4,1, 56098
22,56101,4,4,1, 56105
24,56104,1,1,1, 56105
21,56102,5,5,1, 56107
1,56106,1,1,0, 56107
5,56107,3,3,1, 56110
6,56110,2,2,1, 56112
25,56110,2,2,1, 56112
7,56112,1,1,1, 56113
8,56116,1,1,0, 56117
9,56117,2,2,1, 56119
14,56119,3,3,1, 56122
17,56119,3,3,1, 56122
22,56126,4,4,1, 56130
24,56129,1,1,1, 56130
1,56131,1,1,1, 56132
6,56135,2,2,1, 56137
7,56137,1,1,1, 56138
8,56141,1,1,0, 56142
14,56144,3,3,1, 56147
24,56154,1,1,0, 56155
23,56153,3,3,1, 56156
21,56152,5,5,1, 56157
1,56156,1,1,1, 56157
6,56160,2,2,1, 56162
25,56160,2,2,1, 56162
31,56161,2,2,1, 56163
7,56162,1,1,0, 56163
8,56166,1,1,0, 56167
9,56167,2,2,1, 56169
16,56169,2,2,1, 56171
13,56169,4,4,1, 56173
24,56179,1,1,1, 56180
1,56181,1,1,1, 56182
30,56183,3,3,1, 56186
25,56185,2,2,1, 56187
31,56186,2,2,1, 56188
7,56187,1,1,0, 56188
26,56187,3,3,1, 56190
8,56191,1,1,0, 56192
16,56194,2,2,1, 56196
14,56194,3,3,1, 56197
12,56195,5,5,1, 56200
18,56198,4,4,1, 56202
22,56201,4,4,1, 56205
24,56204,1,1,1, 56205
19,56201,5,5,1, 56206
21,56202,5,5,1, 56207
1,56206,1,1,1, 56207
27,56207,4,4,1, 56211
28,56209,5,5,1, 56214
8,56216,1,1,1, 56217
16,56219,2,2,1, 56221
18,56223,4,4,1, 56227
22,56226,4,4,1, 56230
2,56228,2,2,1, 56230
24,56229,1,1,1, 56230
23,56228,3,3,1, 56231
1,56231,1,1,0, 56232
8,56241,1,1,1, 56242
17,56244,3,3,1, 56247
24,56254,1,1,0, 56255
21,56252,5,5,1, 56257
1,56256,1,1,1, 56257
26,56262,3,3,1, 56265
8,56266,1,1,1, 56267
16,56269,2,2,1, 56271
22,56276,4,4,1, 56280
24,56279,1,1,1, 56280
21,56277,5,5,1, 56282
1,56281,1,1,1, 56282
26,56287,3,3,1, 56290
8,56291,1,1,0, 56292
24,56304,1,1,1, 56305
21,56302,5,5,1, 56307
1,56306,1,1,1, 56307
25,56310,2,2,1, 56312
31,56311,2,2,1, 56313
7,56312,1,1,0, 56313
26,56312,3,3,1, 56315
8,56316,1,1,0, 56317
16,56319,2,2,1, 56321
14,56319,3,3,1, 56322
13,56319,4,4,1, 56323
12,56320,5,5,1, 56325
18,56323,4,4,1, 56327
24,56329,1,1,1, 56330
1,56331,1,1,0, 56332
5,56332,3,3,1, 56335
30,56333,3,3,1, 56336
6,56335,2,2,1, 56337
25,56335,2,2,1, 56337
7,56337,1,1,0, 56338
28,56334,5,5,1, 56339
26,56337,3,3,1, 56340
29,56338,4,4,1, 56342
8,56341,1,1,0, 56342
11,56339,4,4,1, 56343
16,56344,2,2,1, 56346
13,56344,4,4,1, 56348
24,56354,1,1,0, 56355
5,56357,3,3,1, 56360
30,56358,3,3,1, 56361
6,56360,2,2,1, 56362
31,56361,2,2,1, 56363
7,56362,1,1,0, 56363
29,56363,4,4,1, 56367
8,56366,1,1,0, 56367
13,56369,4,4,1, 56373
22,56376,4,4,1, 56380
24,56379,1,1,0, 56380
23,56378,3,3,1, 56381
21,56377,5,5,1, 56382
5,56382,3,3,1, 56385
6,56385,2,2,1, 56387
31,56386,2,2,1, 56388
7,56387,1,1,0, 56388
8,56391,1,1,1, 56392
13,56394,4,4,1, 56398
24,56404,1,1,1, 56405
21,56402,5,5,1, 56407
5,56407,3,3,1, 56410
30,56408,3,3,1, 56411
6,56410,2,2,1, 56412
31,56411,2,2,1, 56413
7,56412,1,1,0, 56413
8,56416,1,1,1, 56417
16,56419,2,2,1, 56421
14,56419,3,3,1, 56422
22,56426,4,4,1, 56430
24,56429,1,1,0, 56430
30,56433,3,3,1, 56436
6,56435,2,2,1, 56437
31,56436,2,2,1, 56438
7,56437,1,1,1, 56438
29,56438,4,4,1, 56442
8,56441,1,1,1, 56442
16,56444,2,2,1, 56446
17,56444,3,3,1, 56447
24,56454,1,1,0, 56455
23,56453,3,3,1, 56456
21,56452,5,5,1, 56457
1,56456,1,1,1, 56457
25,56460,2,2,1, 56462
8,56466,1,1,0, 56467
9,56467,2,2,1, 56469
24,56479,1,1,0, 56480
21,56477,5,5,1, 56482
1,56481,1,1,0, 56482
8,56491,1,1,1, 56492
17,56494,3,3,1, 56497
24,56504,1,1,1, 56505
1,56506,1,1,0, 56507
25,56510,2,2,1, 56512
8,56516,1,1,1, 56517
16,56519,2,2,1, 56521
17,56519,3,3,1, 56522
24,56529,1,1,0, 56530
1,56531,1,1,1, 56532
25,56535,2,2,1, 56537
8,56541,1,1,1, 56542
16,56544,2,2,1, 56546
17,56544,3,3,1, 56547
24,56554,1,1,0, 56555
1,56556,1,1,0, 56557
5,56557,3,3,1, 56560
31,56561,2,2,1, 56563
7,56562,1,1,0, 56563
29,56563,4,4,1, 56567
8,56566,1,1,1, 56567
16,56569,2,2,1, 56571
17,56569,3,3,1, 56572
13,56569,4,4,1, 56573
22,56576,4,4,1, 56580
2,56578,2,2,1, 56580
24,56579,1,1,1, 56580
1,56581,1,1,0, 56582
25,56585,2,2,1, 56587
31,56586,2,2,1, 56588
7,56587,1,1,1, 56588
8,56591,1,1,1, 56592
9,56592,2,2,1, 56594
17,56594,3,3,1, 56597
12,56595,5,5,1, 56600
18,56598,4,4,1, 56602
24,56604,1,1,0, 56605
19,56601,5,5,1, 56606
1,56606,1,1,1, 56607
4,56606,4,4,1, 56610
27,56607,4,4,1, 56611
7,56612,1,1,0, 56613
26,56612,3,3,1, 56615
8,56616,1,1,0, 56617
11,56614,4,4,1, 56618
9,56617,2,2,1, 56619
18,56623,4,4,1, 56627
2,56628,2,2,1, 56630
24,56629,1,1,0, 56630
19,56626,5,5,1, 56631
1,56631,1,1,1, 56632
25,56635,2,2,1, 56637
7,56637,1,1,1, 56638
8,56641,1,1,1, 56642
9,56642,2,2,1, 56644
16,56644,2,2,1, 56646
12,56645,5,5,1, 56650
20,56648,6,6,1, 56654
24,56654,1,1,1, 56655
1,56656,1,1,1, 56657
27,56657,4,4,1, 56661
31,56661,2,2,1, 56663
7,56662,1,1,0, 56663
26,56662,3,3,1, 56665
8,56666,1,1,0, 56667
11,56664,4,4,1, 56668
16,56669,2,2,1, 56671
24,56679,1,1,0, 56680
6,56685,2,2,1, 56687
7,56687,1,1,0, 56688
8,56691,1,1,0, 56692
14,56694,3,3,1, 56697
22,56701,4,4,1, 56705
24,56704,1,1,0, 56705
21,56702,5,5,1, 56707
30,56708,3,3,1, 56711
7,56712,1,1,0, 56713
8,56716,1,1,1, 56717
16,56719,2,2,1, 56721
14,56719,3,3,1, 56722
22,56726,4,4,1, 56730
24,56729,1,1,0, 56730
7,56737,1,1,1, 56738
8,56741,1,1,1, 56742
14,56744,3,3,1, 56747
13,56744,4,4,1, 56748
22,56751,4,4,1, 56755
24,56754,1,1,1, 56755
5,56757,3,3,1, 56760
30,56758,3,3,1, 56761
6,56760,2,2,1, 56762
31,56761,2,2,1, 56763
7,56762,1,1,1, 56763
29,56763,4,4,1, 56767
8,56766,1,1,0, 56767
13,56769,4,4,1, 56773
22,56776,4,4,1, 56780
24,56779,1,1,0, 56780
1,56781,1,1,0, 56782
30,56783,3,3,1, 56786
6,56785,2,2,1, 56787
7,56787,1,1,0, 56788
8,56791,1,1,0, 56792
16,56794,2,2,1, 56796
17,56794,3,3,1, 56797
24,56804,1,1,1, 56805
1,56806,1,1,1, 56807
6,56810,2,2,1, 56812
7,56812,1,1,1, 56813
29,56813,4,4,1, 56817
8,56816,1,1,1, 56817
9,56817,2,2,1, 56819
17,56819,3,3,1, 56822
22,56826,4,4,1, 56830
24,56829,1,1,1, 56830
21,56827,5,5,1, 56832
1,56831,1,1,1, 56832
7,56837,1,1,1, 56838
29,56838,4,4,1, 56842
8,56841,1,1,0, 56842
9,56842,2,2,1, 56844
14,56844,3,3,1, 56847
17,56844,3,3,1, 56847
13,56844,4,4,1, 56848
2,56853,2,2,1, 56855
24,56854,1,1,1, 56855
1,56856,1,1,0, 56857
5,56857,3,3,1, 56860
25,56860,2,2,1, 56862
31,56861,2,2,1, 56863
7,56862,1,1,0, 56863
8,56866,1,1,1, 56867
14,56869,3,3,1, 56872
22,56876,4,4,1, 56880
24,56879,1,1,1, 56880
21,56877,5,5,1, 56882
1,56881,1,1,1, 56882
25,56885,2,2,1, 56887
7,56887,1,1,1, 56888
29,56888,4,4,1, 56892
8,56891,1,1,0, 56892
9,56892,2,2,1, 56894
16,56894,2,2,1, 56896
14,56894,3,3,1, 56897
17,56894,3,3,1, 56897
12,56895,5,5,1, 56900
20,56898,6,6,1, 56904
24,56904,1,1,1, 56905
1,56906,1,1,0, 56907
27,56907,4,4,1, 56911
31,56911,2,2,1, 56913
7,56912,1,1,1, 56913
28,56909,5,5,1, 56914
26,56912,3,3,1, 56915
8,56916,1,1,0, 56917
11,56914,4,4,1, 56918
16,56919,2,2,1, 56921
24,56929,1,1,1, 56930
1,56931,1,1,0, 56932
27,56932,4,4,1, 56936
25,56935,2,2,1, 56937
31,56936,2,2,1, 56938
7,56937,1,1,0, 56938
28,56934,5,5,1, 56939
26,56937,3,3,1, 56940
8,56941,1,1,0, 56942
11,56939,4,4,1, 56943
9,56942,2,2,1, 56944
12,56945,5,5,1, 56950
18,56948,4,4,1, 56952
2,56953,2,2,1, 56955
24,56954,1,1,0, 56955
1,56956,1,1,0, 56957
3,56957,3,3,1, 56960
31,56961,2,2,1, 56963
7,56962,1,1,0, 56963
28,56959,5,5,1, 56964
26,56962,3,3,1, 56965
8,56966,1,1,0, 56967
11,56964,4,4,1, 56968
24,56979,1,1,0, 56980
7,56987,1,1,0, 56988
8,56991,1,1,1, 56992
16,56994,2,2,0, 56996
24,57004,1,1,0, 57005
5,57007,3,3,1, 57010
30,57008,3,3,1, 57011
7,57012,1,1,0, 57013
8,57016,1,1,1, 57017
16,57019,2,2,0, 57021
24,57029,1,1,1, 57030
21,57027,5,5,1, 57032
6,57035,2,2,1, 57037
7,57037,1,1,0, 57038
8,57041,1,1,0, 57042
16,57044,2,2,1, 57046
24,57054,1,1,0, 57055
21,57052,5,5,1, 57057
5,57057,3,3,1, 57060
7,57062,1,1,1, 57063
29,57063,4,4,1, 57067
8,57066,1,1,1, 57067
16,57069,2,2,0, 57071
14,57069,3,3,1, 57072
22,57076,4,4,1, 57080
24,57079,1,1,0, 57080
21,57077,5,5,1, 57082
1,57081,1,1,0, 57082
6,57085,2,2,1, 57087
25,57085,2,2,1, 57087
31,57086,2,2,1, 57088
7,57087,1,1,0, 57088
8,57091,1,1,0, 57092
16,57094,2,2,1, 57096
14,57094,3,3,1, 57097
17,57094,3,3,1, 57097
24,57104,1,1,0, 57105
1,57106,1,1,0, 57107
30,57108,3,3,1, 57111
31,57111,2,2,1, 57113
7,57112,1,1,1, 57113
8,57116,1,1,1, 57117
16,57119,2,2,0, 57121
17,57119,3,3,1, 57122
13,57119,4,4,1, 57123
24,57129,1,1,1, 57130
1,57131,1,1,1, 57132
5,57132,3,3,1, 57135
30,57133,3,3,1, 57136
31,57136,2,2,1, 57138
7,57137,1,1,1, 57138
8,57141,1,1,0, 57142
16,57144,2,2,1, 57146
14,57144,3,3,1, 57147
13,57144,4,4,1, 57148
24,57154,1,1,0, 57155
1,57156,1,1,0, 57157
5,57157,3,3,1, 57160
25,57160,2,2,1, 57162
31,57161,2,2,1, 57163
8,57166,1,1,0, 57167
9,57167,2,2,1, 57169
16,57169,2,2,1, 57171
18,57173,4,4,1, 57177
24,57179,1,1,1, 57180
1,57181,1,1,1, 57182
25,57185,2,2,1, 57187
26,57187,3,3,1, 57190
8,57191,1,1,1, 57192
16,57194,2,2,0, 57196
18,57198,4,4,1, 57202
2,57203,2,2,1, 57205
24,57204,1,1,0, 57205
1,57206,1,1,1, 57207
28,57209,5,5,1, 57214
8,57216,1,1,1, 57217
11,57214,4,4,1, 57218
29,57213,4,6,1, 57219
9,57217,2,2,1, 57219
16,57219,2,2,1, 57221
17,57219,3,3,1, 57222
13,57219,4,6,1, 57225
2,57228,2,2,1, 57230
24,57229,1,1,0, 57230
19,57226,5,5,1, 57231
1,57231,1,1,1, 57232
4,57231,4,4,1, 57235
27,57232,4,4,1, 57236
5,57232,3,5,1, 57237
28,57234,5,5,1, 57239
26,57237,3,3,1, 57240
8,57241,1,1,1, 57242
11,57239,4,4,1, 57243
9,57242,2,2,1, 57244
16,57244,2,2,0, 57246
13,57244,4,6,1, 57250
12,57245,5,5,1, 57250
18,57248,4,4,1, 57252
2,57253,2,2,1, 57255
24,57254,1,1,1, 57255
19,57251,5,5,1, 57256
8,57266,1,1,0, 57267
16,57269,2,2,1, 57271
14,57269,3,5,1, 57274
24,57279,1,1,0, 57280
31,57286,2,2,1, 57288
7,57287,1,1,0, 57288
29,57288,4,4,1, 57292
8,57291,1,1,1, 57292
16,57294,2,2,0, 57296
14,57294,3,5,1, 57299
22,57301,4,4,1, 57305
24,57304,1,1,0, 57305
21,57302,5,5,1, 57307
31,57311,2,2,1, 57313
7,57312,1,1,0, 57313
29,57313,4,4,1, 57317
8,57316,1,1,0, 57317
16,57319,2,2,1, 57321
24,57329,1,1,1, 57330
21,57327,5,5,1, 57332
7,57337,1,1,0, 57338
8,57341,1,1,1, 57342
16,57344,2,2,0, 57346
14,57344,3,5,1, 57349
24,57354,1,1,1, 57355
30,57358,3,3,1, 57361
31,57361,2,2,1, 57363
7,57362,1,1,0, 57363
26,57362,3,3,1, 57365
29,57363,4,4,1, 57367
8,57366,1,1,1, 57367
9,57367,2,2,1, 57369
16,57369,2,2,0, 57371
18,57373,4,4,1, 57377
22,57376,4,4,1, 57380
2,57378,2,2,1, 57380
24,57379,1,1,1, 57380
1,57381,1,1,1, 57382
25,57385,2,2,1, 57387
31,57386,2,2,1, 57388
7,57387,1,1,1, 57388
29,57388,4,4,1, 57392
8,57391,1,1,1, 57392
11,57389,4,4,1, 57393
9,57392,2,2,1, 57394
16,57394,2,2,0, 57396
17,57394,3,3,1, 57397
14,57394,3,5,1, 57399
18,57398,4,4,1, 57402
20,57398,6,6,1, 57404
24,57404,1,1,0, 57405
1,57406,1,1,0, 57407
4,57406,4,4,1, 57410
3,57407,3,3,1, 57410
27,57407,4,4,1, 57411
30,57408,3,3,1, 57411
5,57407,3,5,1, 57412
7,57412,1,1,0, 57413
29,57413,4,4,1, 57417
8,57416,1,1,0, 57417
9,57417,2,2,1, 57419
16,57419,2,2,0, 57421
17,57419,3,3,1, 57422
20,57423,6,6,1, 57429
24,57429,1,1,1, 57430
19,57426,5,5,1, 57431
21,57427,5,5,1, 57432
1,57431,1,1,0, 57432
4,57431,4,4,1, 57435
30,57433,3,3,1, 57436
31,57436,2,2,1, 57438
7,57437,1,1,1, 57438
8,57441,1,1,1, 57442
16,57444,2,2,0, 57446
24,57454,1,1,1, 57455
21,57452,5,5,1, 57457
7,57462,1,1,0, 57463
29,57463,4,4,1, 57467
8,57466,1,1,0, 57467
16,57469,2,2,0, 57471
14,57469,3,5,1, 57474
22,57476,4,4,1, 57480
24,57479,1,1,1, 57480
30,57483,3,3,1, 57486
7,57487,1,1,1, 57488
29,57488,4,4,1, 57492
8,57491,1,1,0, 57492
16,57494,2,2,1, 57496
24,57504,1,1,0, 57505
21,57502,5,5,1, 57507
30,57508,3,3,1, 57511
7,57512,1,1,0, 57513
29,57513,4,4,1, 57517
8,57516,1,1,1, 57517
16,57519,2,2,0, 57521
14,57519,3,5,1, 57524
22,57526,4,4,1, 57530
24,57529,1,1,1, 57530
21,57527,5,5,1, 57532
30,57533,3,3,1, 57536
25,57535,2,2,1, 57537
7,57537,1,1,0, 57538
29,57538,4,4,1, 57542
8,57541,1,1,0, 57542
16,57544,2,2,1, 57546
24,57554,1,1,0, 57555
1,57556,1,1,1, 57557
25,57560,2,2,1, 57562
8,57566,1,1,0, 57567
9,57567,2,2,1, 57569
16,57569,2,2,0, 57571
17,57569,3,3,1, 57572
24,57579,1,1,1, 57580
1,57581,1,1,1, 57582
25,57585,2,2,1, 57587
8,57591,1,1,0, 57592
9,57592,2,2,1, 57594
16,57594,2,2,0, 57596
17,57594,3,3,1, 57597
24,57604,1,1,0, 57605
1,57606,1,1,0, 57607
25,57610,2,2,1, 57612
26,57612,3,3,1, 57615
8,57616,1,1,0, 57617
16,57619,2,2,0, 57621
13,57619,4,6,1, 57625
24,57629,1,1,0, 57630
19,57626,5,5,1, 57631
1,57631,1,1,1, 57632
3,57632,3,3,1, 57635
5,57632,3,5,1, 57637
28,57634,5,5,1, 57639
8,57641,1,1,1, 57642
11,57639,4,4,1, 57643
9,57642,2,2,1, 57644
14,57644,3,5,1, 57649
2,57653,2,2,1, 57655
24,57654,1,1,0, 57655
19,57651,5,5,1, 57656
21,57652,5,5,1, 57657
1,57656,1,1,0, 57657
3,57657,3,3,1, 57660
27,57657,4,4,1, 57661
5,57657,3,5,1, 57662
25,57660,2,2,1, 57662
7,57662,1,1,1, 57663
26,57662,3,3,1, 57665
29,57663,4,4,1, 57667
8,57666,1,1,0, 57667
14,57669,3,5,1, 57674
24,57679,1,1,0, 57680
30,57683,3,3,1, 57686
31,57686,2,2,1, 57688
7,57687,1,1,0, 57688
29,57688,4,4,1, 57692
8,57691,1,1,1, 57692
14,57694,3,5,1, 57699
24,57704,1,1,1, 57705
7,57712,1,1,0, 57713
29,57713,4,4,1, 57717
8,57716,1,1,1, 57717
24,57729,1,1,0, 57730
7,57737,1,1,0, 57738
8,57741,1,1,1, 57742
22,57751,4,4,1, 57755
24,57754,1,1,1, 57755
21,57752,5,5,1, 57757
30,57758,3,3,1, 57761
7,57762,1,1,1, 57763
8,57766,1,1,0, 57767
17,57769,3,3,1, 57772
24,57779,1,1,0, 57780
21,57777,5,5,1, 57782
1,57781,1,1,0, 57782
7,57787,1,1,0, 57788
29,57788,4,4,1, 57792
8,57791,1,1,0, 57792
14,57794,3,5,1, 57799
24,57804,1,1,0, 57805
21,57802,5,5,1, 57807
1,57806,1,1,1, 57807
7,57812,1,1,1, 57813
29,57813,4,4,1, 57817
8,57816,1,1,1, 57817
20,57823,6,6,1, 57829
22,57826,4,4,1, 57830
24,57829,1,1,1, 57830
1,57831,1,1,0, 57832
3,57832,3,3,1, 57835
30,57833,3,3,1, 57836
25,57835,2,2,1, 57837
7,57837,1,1,0, 57838
29,57838,4,4,1, 57842
8,57841,1,1,1, 57842
9,57842,2,2,1, 57844
13,57844,4,6,1, 57850
12,57845,5,5,1, 57850
18,57848,4,4,1, 57852
20,57848,6,6,1, 57854
24,57854,1,1,0, 57855
1,57856,1,1,0, 57857
4,57856,4,4,1, 57860
3,57857,3,3,1, 57860
7,57862,1,1,0, 57863
28,57859,5,5,1, 57864
26,57862,3,3,1, 57865
29,57863,4,4,1, 57867
8,57866,1,1,0, 57867
11,57864,4,4,1, 57868
9,57867,2,2,1, 57869
14,57869,3,5,1, 57874
18,57873,4,4,1, 57877
24,57879,1,1,0, 57880
21,57877,5,5,1, 57882
1,57881,1,1,1, 57882
3,57882,3,3,1, 57885
30,57883,3,3,1, 57886
25,57885,2,2,1, 57887
7,57887,1,1,0, 57888
28,57884,5,5,1, 57889
26,57887,3,3,1, 57890
29,57888,4,4,1, 57892
8,57891,1,1,0, 57892
11,57889,4,4,1, 57893
17,57894,3,3,1, 57897
12,57895,5,5,1, 57900
18,57898,4,4,1, 57902
24,57904,1,1,0, 57905
7,57912,1,1,0, 57913
29,57913,4,4,1, 57917
8,57916,1,1,0, 57917
14,57919,3,5,1, 57924
22,57926,4,4,1, 57930
24,57929,1,1,0, 57930
21,57927,5,5,1, 57932
7,57937,1,1,1, 57938
8,57941,1,1,0, 57942
14,57944,3,5,1, 57949
24,57954,1,1,0, 57955
7,57962,1,1,1, 57963
29,57963,4,4,1, 57967
8,57966,1,1,1, 57967
22,57976,4,4,1, 57980
24,57979,1,1,1, 57980
21,57977,5,5,1, 57982
30,57983,3,3,1, 57986
31,57986,2,2,1, 57988
7,57987,1,1,0, 57988
29,57988,4,4,1, 57992
8,57991,1,1,1, 57992
24,58004,1,1,1, 58005
21,58002,5,5,1, 58007
1,58006,1,1,0, 58007
31,58011,2,2,1, 58013
7,58012,1,1,0, 58013
29,58013,4,4,1, 58017
8,58016,1,1,1, 58017
13,58019,4,6,1, 58025
24,58029,1,1,0, 58030
21,58027,5,5,1, 58032
1,58031,1,1,0, 58032
30,58033,3,3,1, 58036
5,58032,3,5,1, 58037
25,58035,2,2,1, 58037
8,58041,1,1,1, 58042
17,58044,3,3,1, 58047
18,58048,4,4,1, 58052
2,58053,2,2,1, 58055
24,58054,1,1,0, 58055
1,58056,1,1,1, 58057
8,58066,1,1,0, 58067
17,58069,3,3,1, 58072
18,58073,4,4,1, 58077
24,58079,1,1,0, 58080
1,58081,1,1,0, 58082
3,58082,3,3,1, 58085
28,58084,5,5,1, 58089
26,58087,3,3,1, 58090
8,58091,1,1,0, 58092
11,58089,4,4,1, 58093
12,58095,5,7,1, 58102
18,58098,4,4,1, 58102
24,58104,1,1,1, 58105
1,58106,1,1,0, 58107
3,58107,3,3,1, 58110
27,58107,4,4,1, 58111
28,58109,5,5,1, 58114
8,58116,1,1,0, 58117
12,58120,5,7,1, 58127
20,58123,6,6,1, 58129
24,58129,1,1,1, 58130
1,58131,1,1,0, 58132
27,58132,4,4,1, 58136
25,58135,2,2,1, 58137
26,58137,3,3,1, 58140
29,58138,4,4,1, 58142
8,58141,1,1,1, 58142
11,58139,4,4,1, 58143
12,58145,5,7,1, 58152
20,58148,6,6,1, 58154
24,58154,1,1,0, 58155
1,58156,1,1,1, 58157
3,58157,3,3,1, 58160
27,58157,4,4,1, 58161
7,58162,1,1,0, 58163
8,58166,1,1,0, 58167
11,58164,4,4,1, 58168
17,58169,3,3,1, 58172
12,58170,5,7,1, 58177
24,58179,1,1,1, 58180
7,58187,1,1,0, 58188
8,58191,1,1,0, 58192
24,58204,1,1,0, 58205
7,58212,1,1,1, 58213
8,58216,1,1,0, 58217
24,58229,1,1,1, 58230
7,58237,1,1,1, 58238
8,58241,1,1,1, 58242
22,58251,4,4,1, 58255
24,58254,1,1,0, 58255
21,58252,5,5,1, 58257
5,58257,3,5,1, 58262
7,58262,1,1,1, 58263
8,58266,1,1,1, 58267
14,58269,3,5,1, 58274
24,58279,1,1,1, 58280
21,58277,5,5,1, 58282
1,58281,1,1,0, 58282
30,58283,3,3,1, 58286
31,58286,2,2,1, 58288
7,58287,1,1,0, 58288
26,58287,3,3,1, 58290
8,58291,1,1,0, 58292
11,58289,4,4,1, 58293
17,58294,3,3,1, 58297
12,58295,5,7,1, 58302
18,58298,4,4,1, 58302
20,58298,6,6,1, 58304
2,58303,2,2,1, 58305
24,58304,1,1,1, 58305
1,58306,1,1,0, 58307
30,58308,3,3,1, 58311
5,58307,3,5,1, 58312
25,58310,2,2,1, 58312
31,58311,2,2,1, 58313
7,58312,1,1,1, 58313
28,58309,5,5,1, 58314
29,58313,4,4,1, 58317
8,58316,1,1,1, 58317
11,58314,4,4,1, 58318
17,58319,3,3,1, 58322
14,58319,3,5,1, 58324
13,58319,4,6,1, 58325
18,58323,4,4,1, 58327
22,58326,4,4,1, 58330
2,58328,2,2,1, 58330
24,58329,1,1,0, 58330
21,58327,5,5,1, 58332
1,58331,1,1,1, 58332
5,58332,3,5,1, 58337
31,58336,2,2,1, 58338
7,58337,1,1,0, 58338
26,58337,3,3,1, 58340
29,58338,4,4,1, 58342
8,58341,1,1,0, 58342
14,58344,3,5,1, 58349
13,58344,4,6,1, 58350
22,58351,4,4,1, 58355
24,58354,1,1,1, 58355
21,58352,5,5,1, 58357
1,58356,1,1,0, 58357
5,58357,3,5,1, 58362
7,58362,1,1,0, 58363
26,58362,3,3,1, 58365
8,58366,1,1,1, 58367
17,58369,3,3,1, 58372
13,58369,4,6,1, 58375
18,58373,4,4,1, 58377
22,58376,4,4,1, 58380
24,58379,1,1,1, 58380
21,58377,5,5,1, 58382
1,58381,1,1,0, 58382
7,58387,1,1,1, 58388
26,58387,3,3,1, 58390
8,58391,1,1,0, 58392
9,58392,2,2,1, 58394
24,58404,1,1,1, 58405
1,58406,1,1,1, 58407
7,58412,1,1,1, 58413
26,58412,3,3,1, 58415
8,58416,1,1,1, 58417
20,58423,6,6,1, 58429
2,58428,2,2,1, 58430
24,58429,1,1,1, 58430
1,58431,1,1,1, 58432
7,58437,1,1,1, 58438
28,58434,5,5,1, 58439
8,58441,1,1,0, 58442
11,58439,4,4,1, 58443
9,58442,2,2,1, 58444
17,58444,3,3,1, 58447
20,58448,6,6,1, 58454
2,58453,2,2,1, 58455
24,58454,1,1,1, 58455
7,58462,1,1,1, 58463
8,58466,1,1,0, 58467
24,58479,1,1,0, 58480
31,58486,2,2,1, 58488
7,58487,1,1,1, 58488
8,58491,1,1,1, 58492
24,58504,1,1,1, 58505
7,58512,1,1,1, 58513
8,58516,1,1,1, 58517
24,58529,1,1,0, 58530
7,58537,1,1,1, 58538
8,58541,1,1,0, 58542
24,58554,1,1,0, 58555
21,58552,5,5,1, 58557
30,58558,3,3,1, 58561
25,58560,2,2,1, 58562
31,58561,2,2,1, 58563
7,58562,1,1,0, 58563
29,58563,4,4,1, 58567
8,58566,1,1,1, 58567
13,58569,4,6,1, 58575
24,58579,1,1,0, 58580
1,58581,1,1,1, 58582
25,58585,2,2,1, 58587
31,58586,2,2,1, 58588
7,58587,1,1,1, 58588
29,58588,4,4,1, 58592
8,58591,1,1,1, 58592
9,58592,2,2,1, 58594
17,58594,3,3,1, 58597
24,58604,1,1,0, 58605
1,58606,1,1,0, 58607
3,58607,3,3,1, 58610
27,58607,4,4,1, 58611
25,58610,2,2,1, 58612
7,58612,1,1,1, 58613
28,58609,5,5,1, 58614
29,58613,4,4,1, 58617
8,58616,1,1,1, 58617
18,58623,4,4,1, 58627
22,58626,4,4,1, 58630
2,58628,2,2,1, 58630
24,58629,1,1,1, 58630
19,58626,5,5,1, 58631
21,58627,5,5,1, 58632
1,58631,1,1,0, 58632
3,58632,3,3,1, 58635
30,58633,3,3,1, 58636
5,58632,3,5,1, 58637
7,58637,1,1,1, 58638
28,58634,5,5,1, 58639
29,58638,4,4,1, 58642
8,58641,1,1,0, 58642
11,58639,4,4,1, 58643
9,58642,2,2,1, 58644
17,58644,3,3,1, 58647
14,58644,3,5,1, 58649
18,58648,4,4,1, 58652
22,58651,4,4,1, 58655
2,58653,2,2,1, 58655
24,58654,1,1,1, 58655
19,58651,5,5,1, 58656
1,58656,1,1,1, 58657
3,58657,3,3,1, 58660
31,58661,2,2,1, 58663
7,58662,1,1,1, 58663
26,58662,3,3,1, 58665
29,58663,4,4,1, 58667
8,58666,1,1,1, 58667
11,58664,4,4,1, 58668
14,58669,3,5,1, 58674
13,58669,4,6,1, 58675
12,58670,5,7,1, 58677
20,58673,6,6,1, 58679
22,58676,4,4,1, 58680
24,58679,1,1,0, 58680
19,58676,5,5,1, 58681
7,58687,1,1,1, 58688
8,58691,1,1,0, 58692
22,58701,4,4,1, 58705
24,58704,1,1,1, 58705
21,58702,5,5,1, 58707
30,58708,3,3,1, 58711
5,58707,3,5,1, 58712
31,58711,2,2,1, 58713
7,58712,1,1,0, 58713
29,58713,4,4,1, 58717
8,58716,1,1,0, 58717
13,58719,4,6,1, 58725
24,58729,1,1,0, 58730
7,58737,1,1,1, 58738
8,58741,1,1,0, 58742
22,58751,4,4,1, 58755
24,58754,1,1,0, 58755
21,58752,5,5,1, 58757
30,58758,3,3,1, 58761
31,58761,2,2,1, 58763
7,58762,1,1,0, 58763
29,58763,4,4,1, 58767
8,58766,1,1,0, 58767
22,58776,4,4,1, 58780
24,58779,1,1,1, 58780
7,58787,1,1,1, 58788
29,58788,4,4,1, 58792
8,58791,1,1,1, 58792
14,58794,3,5,1, 58799
12,58795,5,7,1, 58802
2,58803,2,2,1, 58805
24,58804,1,1,0, 58805
19,58801,5,5,1, 58806
21,58802,5,5,1, 58807
1,58806,1,1,0, 58807
3,58807,3,3,1, 58810
25,58810,2,2,1, 58812
7,58812,1,1,1, 58813
28,58809,5,5,1, 58814
26,58812,3,3,1, 58815
29,58813,4,4,1, 58817
8,58816,1,1,1, 58817
9,58817,2,2,1, 58819
17,58819,3,3,1, 58822
13,58819,4,6,1, 58825
24,58829,1,1,0, 58830
21,58827,5,5,1, 58832
1,58831,1,1,0, 58832
30,58833,3,3,1, 58836
5,58832,3,5,1, 58837
25,58835,2,2,1, 58837
7,58837,1,1,0, 58838
8,58841,1,1,0, 58842
17,58844,3,3,1, 58847
13,58844,4,6,1, 58850
24,58854,1,1,0, 58855
21,58852,5,5,1, 58857
1,58856,1,1,0, 58857
30,58858,3,3,1, 58861
5,58857,3,5,1, 58862
25,58860,2,2,1, 58862
8,58866,1,1,0, 58867
17,58869,3,3,1, 58872
24,58879,1,1,1, 58880
1,58881,1,1,1, 58882
8,58891,1,1,0, 58892
9,58892,2,2,1, 58894
17,58894,3,3,1, 58897
24,58904,1,1,0, 58905
1,58906,1,1,1, 58907
25,58910,2,2,1, 58912
8,58916,1,1,1, 58917
9,58917,2,2,1, 58919
17,58919,3,3,1, 58922
12,58920,5,7,1, 58927
20,58923,6,6,1, 58929
24,58929,1,1,0, 58930
19,58926,5,5,1, 58931
1,58931,1,1,0, 58932
3,58932,3,3,1, 58935
25,58935,2,2,1, 58937
28,58934,5,5,1, 58939
26,58937,3,3,1, 58940
8,58941,1,1,0, 58942
2,58953,2,2,1, 58955
24,58954,1,1,0, 58955
1,58956,1,1,1, 58957
3,58957,3,3,1, 58960
27,58957,4,4,1, 58961
8,58966,1,1,1, 58967
24,58979,1,1,1, 58980
31,58986,2,2,1, 58988
7,58987,1,1,1, 58988
8,58991,1,1,1, 58992
24,59004,1,1,0, 59005
31,59011,2,2,1, 59013
7,59012,1,1,0, 59013
8,59016,1,1,0, 59017
24,59029,1,1,1, 59030
30,59033,3,3,1, 59036
31,59036,2,2,1, 59038
7,59037,1,1,0, 59038
8,59041,1,1,0, 59042
14,59044,3,5,1, 59049
13,59044,4,6,1, 59050
24,59054,1,1,0, 59055
30,59058,3,3,1, 59061
31,59061,2,2,1, 59063
7,59062,1,1,0, 59063
8,59066,1,1,0, 59067
9,59067,2,2,1, 59069
17,59069,3,3,1, 59072
14,59069,3,5,1, 59074
22,59076,4,4,1, 59080
24,59079,1,1,0, 59080
1,59081,1,1,0, 59082
5,59082,3,5,1, 59087
25,59085,2,2,1, 59087
7,59087,1,1,0, 59088
29,59088,4,4,1, 59092
8,59091,1,1,0, 59092
9,59092,2,2,1, 59094
17,59094,3,3,1, 59097
13,59094,4,6,1, 59100
22,59101,4,4,1, 59105
24,59104,1,1,1, 59105
21,59102,5,5,1, 59107
1,59106,1,1,1, 59107
25,59110,2,2,1, 59112
7,59112,1,1,1, 59113
8,59116,1,1,0, 59117
17,59119,3,3,1, 59122
2,59128,2,2,1, 59130
24,59129,1,1,0, 59130
1,59131,1,1,1, 59132
5,59132,3,5,1, 59137
31,59136,2,2,1, 59138
7,59137,1,1,0, 59138
8,59141,1,1,0, 59142
17,59144,3,3,1, 59147
12,59145,5,7,1, 59152
18,59148,4,4,1, 59152
20,59148,6,6,1, 59154
22,59151,4,4,1, 59155
2,59153,2,2,1, 59155
24,59154,1,1,0, 59155
19,59151,5,5,1, 59156
1,59156,1,1,1, 59157
27,59157,4,4,1, 59161
30,59158,3,3,1, 59161
5,59157,3,5,1, 59162
31,59161,2,2,1, 59163
7,59162,1,1,0, 59163
26,59162,3,3,1, 59165
8,59166,1,1,1, 59167
9,59167,2,2,1, 59169
13,59169,4,6,1, 59175
12,59170,5,7,1, 59177
22,59176,4,4,1, 59180
2,59178,2,2,1, 59180
24,59179,1,1,0, 59180
19,59176,5,5,1, 59181
1,59181,1,1,1, 59182
30,59183,3,3,1, 59186
7,59187,1,1,0, 59188
26,59187,3,3,1, 59190
29,59188,4,4,1, 59192
8,59191,1,1,1, 59192
11,59189,4,4,1, 59193
9,59192,2,2,1, 59194
17,59194,3,3,1, 59197
14,59194,3,5,1, 59199
18,59198,4,4,1, 59202
22,59201,4,4,1, 59205
2,59203,2,2,1, 59205
24,59204,1,1,0, 59205
30,59208,3,3,1, 59211
31,59211,2,2,1, 59213
7,59212,1,1,0, 59213
8,59216,1,1,0, 59217
14,59219,3,5,1, 59224
24,59229,1,1,0, 59230
21,59227,5,5,1, 59232
30,59233,3,3,1, 59236
31,59236,2,2,1, 59238
7,59237,1,1,0, 59238
29,59238,4,4,1, 59242
8,59241,1,1,0, 59242
14,59244,3,5,1, 59249
24,59254,1,1,0, 59255
30,59258,3,3,1, 59261
5,59257,3,5,1, 59262
31,59261,2,2,1, 59263
7,59262,1,1,1, 59263
8,59266,1,1,0, 59267
14,59269,3,5,1, 59274
13,59269,4,6,1, 59275
22,59276,4,4,1, 59280
24,59279,1,1,1, 59280
8,59291,1,1,0, 59292
24,59304,1,1,1, 59305
1,59306,1,1,0, 59307
25,59310,2,2,1, 59312
8,59316,1,1,1, 59317
9,59317,2,2,1, 59319
17,59319,3,3,1, 59322
24,59329,1,1,0, 59330
1,59331,1,1,1, 59332
8,59341,1,1,0, 59342
9,59342,2,2,1, 59344
17,59344,3,3,1, 59347
24,59354,1,1,1, 59355
1,59356,1,1,0, 59357
8,59366,1,1,1, 59367
9,59367,2,2,1, 59369
24,59379,1,1,1, 59380
1,59381,1,1,1, 59382
25,59385,2,2,1, 59387
7,59387,1,1,0, 59388
26,59387,3,3,1, 59390
29,59388,4,4,1, 59392
8,59391,1,1,0, 59392
9,59392,2,2,1, 59394
17,59394,3,3,1, 59397
18,59398,4,4,1, 59402
24,59404,1,1,0, 59405
1,59406,1,1,0, 59407
25,59410,2,2,1, 59412
31,59411,2,2,1, 59413
7,59412,1,1,0, 59413
8,59416,1,1,1, 59417
9,59417,2,2,1, 59419
18,59423,4,4,1, 59427
2,59428,2,2,1, 59430
24,59429,1,1,0, 59430
1,59431,1,1,1, 59432
7,59437,1,1,0, 59438
8,59441,1,1,1, 59442
18,59448,4,4,1, 59452
24,59454,1,1,0, 59455
1,59456,1,1,0, 59457
25,59460,2,2,1, 59462
7,59462,1,1,0, 59463
26,59462,3,3,1, 59465
8,59466,1,1,1, 59467
9,59467,2,2,1, 59469
17,59469,3,3,1, 59472
18,59473,4,4,1, 59477
20,59473,6,6,1, 59479
2,59478,2,2,1, 59480
24,59479,1,1,0, 59480
19,59476,5,5,1, 59481
1,59481,1,1,0, 59482
27,59482,4,4,1, 59486
25,59485,2,2,1, 59487
31,59486,2,2,1, 59488
7,59487,1,1,1, 59488
8,59491,1,1,0, 59492
13,59494,4,6,1, 59500
12,59495,5,7,1, 59502
20,59498,6,6,1, 59504
24,59504,1,1,1, 59505
1,59506,1,1,0, 59507
5,59507,3,5,1, 59512
25,59510,2,2,1, 59512
31,59511,2,2,1, 59513
7,59512,1,1,0, 59513
26,59512,3,3,1, 59515
8,59516,1,1,1, 59517
11,59514,4,4,1, 59518
17,59519,3,3,1, 59522
14,59519,3,5,1, 59524
22,59526,4,4,1, 59530
24,59529,1,1,0, 59530
30,59533,3,3,1, 59536
5,59532,3,5,1, 59537
7,59537,1,1,0, 59538
8,59541,1,1,1, 59542
13,59544,4,6,1, 59550
24,59554,1,1,1, 59555
31,59561,2,2,1, 59563
7,59562,1,1,0, 59563
8,59566,1,1,0, 59567
14,59569,3,5,1, 59574
22,59576,4,4,1, 59580
24,59579,1,1,0, 59580
30,59583,3,3,1, 59586
31,59586,2,2,1, 59588
7,59587,1,1,1, 59588
29,59588,4,4,1, 59592
8,59591,1,1,1, 59592
13,59594,4,6,1, 59600
24,59604,1,1,1, 59605
30,59608,3,3,1, 59611
7,59612,1,1,1, 59613
8,59616,1,1,0, 59617
12,59620,5,7,1, 59627
18,59623,4,4,1, 59627
20,59623,6,6,1, 59629
24,59629,1,1,1, 59630
21,59627,5,5,1, 59632
1,59631,1,1,0, 59632
3,59632,3,3,1, 59635
27,59632,4,4,1, 59636
30,59633,3,3,1, 59636
5,59632,3,5,1, 59637
7,59637,1,1,1, 59638
29,59638,4,4,1, 59642
8,59641,1,1,0, 59642
9,59642,2,2,1, 59644
24,59654,1,1,1, 59655
21,59652,5,5,1, 59657
1,59656,1,1,1, 59657
30,59658,3,3,1, 59661
7,59662,1,1,0, 59663
29,59663,4,4,1, 59667
8,59666,1,1,0, 59667
17,59669,3,3,1, 59672
14,59669,3,5,1, 59674
22,59676,4,4,1, 59680
24,59679,1,1,0, 59680
1,59681,1,1,1, 59682
5,59682,3,5,1, 59687
25,59685,2,2,1, 59687
7,59687,1,1,1, 59688
29,59688,4,4,1, 59692
8,59691,1,1,0, 59692
17,59694,3,3,1, 59697
13,59694,4,6,1, 59700
24,59704,1,1,1, 59705
1,59706,1,1,0, 59707
5,59707,3,5,1, 59712
31,59711,2,2,1, 59713
7,59712,1,1,1, 59713
8,59716,1,1,1, 59717
9,59717,2,2,1, 59719
17,59719,3,3,1, 59722
14,59719,3,5,1, 59724
24,59729,1,1,0, 59730
1,59731,1,1,1, 59732
5,59732,3,5,1, 59737
31,59736,2,2,1, 59738
7,59737,1,1,1, 59738
29,59738,4,4,1, 59742
8,59741,1,1,0, 59742
17,59744,3,3,1, 59747
14,59744,3,5,1, 59749
12,59745,5,7,1, 59752
18,59748,4,4,1, 59752
2,59753,2,2,1, 59755
24,59754,1,1,1, 59755
21,59752,5,5,1, 59757
1,59756,1,1,0, 59757
3,59757,3,3,1, 59760
27,59757,4,4,1, 59761
5,59757,3,5,1, 59762
7,59762,1,1,0, 59763
26,59762,3,3,1, 59765
29,59763,4,4,1, 59767
8,59766,1,1,1, 59767
14,59769,3,5,1, 59774
18,59773,4,4,1, 59777
22,59776,4,4,1, 59780
24,59779,1,1,0, 59780
21,59777,5,5,1, 59782
1,59781,1,1,1, 59782
5,59782,3,5,1, 59787
25,59785,2,2,1, 59787
31,59786,2,2,1, 59788
7,59787,1,1,1, 59788
26,59787,3,3,1, 59790
8,59791,1,1,0, 59792
17,59794,3,3,1, 59797
14,59794,3,5,1, 59799
24,59804,1,1,0, 59805
1,59806,1,1,1, 59807
25,59810,2,2,1, 59812
8,59816,1,1,0, 59817
9,59817,2,2,1, 59819
17,59819,3,3,1, 59822
18,59823,4,4,1, 59827
2,59828,2,2,1, 59830
24,59829,1,1,0, 59830
1,59831,1,1,0, 59832
25,59835,2,2,1, 59837
8,59841,1,1,1, 59842
17,59844,3,3,1, 59847
24,59854,1,1,0, 59855
1,59856,1,1,0, 59857
25,59860,2,2,1, 59862
8,59866,1,1,0, 59867
9,59867,2,2,1, 59869
18,59873,4,4,1, 59877
24,59879,1,1,1, 59880
19,59876,5,5,1, 59881
1,59881,1,1,1, 59882
3,59882,3,3,1, 59885
8,59891,1,1,1, 59892
24,59904,1,1,0, 59905
7,59912,1,1,0, 59913
8,59916,1,1,1, 59917
24,59929,1,1,0, 59930
7,59937,1,1,1, 59938
29,59938,4,4,1, 59942
8,59941,1,1,1, 59942
24,59954,1,1,0, 59955
21,59952,5,5,1, 59957
30,59958,3,3,1, 59961
7,59962,1,1,1, 59963
29,59963,4,4,1, 59967
8,59966,1,1,1, 59967
13,59969,4,6,1, 59975
24,59979,1,1,0, 59980
5,59982,3,5,1, 59987
31,59986,2,2,1, 59988
7,59987,1,1,1, 59988
29,59988,4,4,1, 59992
8,59991,1,1,0, 59992
11,59989,4,4,1, 59993
9,59992,2,2,1, 59994
14,59994,3,5,1, 59999
13,59994,4,6,1, 60000
12,59995,5,7,1, 60002
18,59998,4,4,1, 60002
22,60001,4,4,1, 60005
24,60004,1,1,0, 60005
19,60001,5,5,1, 60006
21,60002,5,5,1, 60007
1,60006,1,1,0, 60007
25,60010,2,2,1, 60012
31,60011,2,2,1, 60013
7,60012,1,1,0, 60013
28,60009,5,5,1, 60014
26,60012,3,3,1, 60015
29,60013,4,4,1, 60017
8,60016,1,1,0, 60017
11,60014,4,4,1, 60018
17,60019,3,3,1, 60022
18,60023,4,4,1, 60027
2,60028,2,2,1, 60030
24,60029,1,1,0, 60030
21,60027,5,5,1, 60032
1,60031,1,1,1, 60032
30,60033,3,3,1, 60036
5,60032,3,5,1, 60037
25,60035,2,2,1, 60037
7,60037,1,1,0, 60038
28,60034,5,5,1, 60039
29,60038,4,4,1, 60042
8,60041,1,1,0, 60042
11,60039,4,4,1, 60043
9,60042,2,2,1, 60044
17,60044,3,3,1, 60047
12,60045,5,7,1, 60052
18,60048,4,4,1, 60052
22,60051,4,4,1, 60055
24,60054,1,1,0, 60055
21,60052,5,5,1, 60057
1,60056,1,1,1, 60057
30,60058,3,3,1, 60061
5,60057,3,5,1, 60062
25,60060,2,2,1, 60062
7,60062,1,1,0, 60063
29,60063,4,4,1, 60067
8,60066,1,1,0, 60067
24,60079,1,1,1, 60080
7,60087,1,1,0, 60088
8,60091,1,1,1, 60092
24,60104,1,1,1, 60105
7,60112,1,1,1, 60113
8,60116,1,1,0, 60117
24,60129,1,1,1, 60130
7,60137,1,1,0, 60138
8,60141,1,1,1, 60142
24,60154,1,1,1, 60155
7,60162,1,1,0, 60163
8,60166,1,1,0, 60167
12,60170,5,7,1, 60177
2,60178,2,2,1, 60180
24,60179,1,1,1, 60180
1,60181,1,1,1, 60182
3,60182,3,3,1, 60185
31,60186,2,2,1, 60188
7,60187,1,1,0, 60188
8,60191,1,1,1, 60192
11,60189,4,4,1, 60193
24,60204,1,1,0, 60205
1,60206,1,1,1, 60207
25,60210,2,2,1, 60212
7,60212,1,1,0, 60213
8,60216,1,1,1, 60217
9,60217,2,2,1, 60219
24,60229,1,1,0, 60230
1,60231,1,1,1, 60232
31,60236,2,2,1, 60238
7,60237,1,1,1, 60238
8,60241,1,1,0, 60242
18,60248,4,4,1, 60252
2,60253,2,2,1, 60255
24,60254,1,1,1, 60255
1,60256,1,1,1, 60257
25,60260,2,2,1, 60262
31,60261,2,2,1, 60263
7,60262,1,1,1, 60263
26,60262,3,3,1, 60265
29,60263,4,4,1, 60267
8,60266,1,1,0, 60267
9,60267,2,2,1, 60269
14,60269,3,5,1, 60274
2,60278,2,2,1, 60280
24,60279,1,1,0, 60280
21,60277,5,5,1, 60282
1,60281,1,1,1, 60282
25,60285,2,2,1, 60287
31,60286,2,2,1, 60288
7,60287,1,1,0, 60288
8,60291,1,1,1, 60292
17,60294,3,3,1, 60297
14,60294,3,5,1, 60299
18,60298,4,4,1, 60302
22,60301,4,4,1, 60305
2,60303,2,2,1, 60305
24,60304,1,1,1, 60305
1,60306,1,1,1, 60307
30,60308,3,3,1, 60311
7,60312,1,1,1, 60313
28,60309,5,5,1, 60314
26,60312,3,3,1, 60315
29,60313,4,4,1, 60317
8,60316,1,1,1, 60317
11,60314,4,4,1, 60318
20,60323,6,6,1, 60329
22,60326,4,4,1, 60330
24,60329,1,1,0, 60330
19,60326,5,5,1, 60331
21,60327,5,5,1, 60332
1,60331,1,1,0, 60332
3,60332,3,3,1, 60335
27,60332,4,4,1, 60336
5,60332,3,5,1, 60337
25,60335,2,2,1, 60337
7,60337,1,1,1, 60338
28,60334,5,5,1, 60339
26,60337,3,3,1, 60340
29,60338,4,4,1, 60342
8,60341,1,1,0, 60342
11,60339,4,4,1, 60343
17,60344,3,3,1, 60347
14,60344,3,5,1, 60349
13,60344,4,6,1, 60350
18,60348,4,4,1, 60352
20,60348,6,6,1, 60354
24,60354,1,1,1, 60355
21,60352,5,5,1, 60357
5,60357,3,5,1, 60362
7,60362,1,1,0, 60363
8,60366,1,1,0, 60367
22,60376,4,4,1, 60380
24,60379,1,1,0, 60380
21,60377,5,5,1, 60382
30,60383,3,3,1, 60386
7,60387,1,1,1, 60388
29,60388,4,4,1, 60392
8,60391,1,1,0, 60392
14,60394,3,5,1, 60399
24,60404,1,1,0, 60405
21,60402,5,5,1, 60407
5,60407,3,5,1, 60412
7,60412,1,1,0, 60413
8,60416,1,1,0, 60417
13,60419,4,6,1, 60425
22,60426,4,4,1, 60430
24,60429,1,1,1, 60430
21,60427,5,5,1, 60432
30,60433,3,3,1, 60436
7,60437,1,1,1, 60438
29,60438,4,4,1, 60442
8,60441,1,1,0, 60442
14,60444,3,5,1, 60449
24,60454,1,1,1, 60455
21,60452,5,5,1, 60457
31,60461,2,2,1, 60463
7,60462,1,1,1, 60463
8,60466,1,1,0, 60467
9,60467,2,2,1, 60469
17,60469,3,3,1, 60472
14,60469,3,5,1, 60474
13,60469,4,6,1, 60475
24,60479,1,1,1, 60480
21,60477,5,5,1, 60482
1,60481,1,1,1, 60482
31,60486,2,2,1, 60488
7,60487,1,1,0, 60488
8,60491,1,1,0, 60492
9,60492,2,2,1, 60494
17,60494,3,3,1, 60497
14,60494,3,5,1, 60499
24,60504,1,1,0, 60505
1,60506,1,1,1, 60507
8,60516,1,1,1, 60517
18,60523,4,4,1, 60527
24,60529,1,1,1, 60530
1,60531,1,1,1, 60532
25,60535,2,2,1, 60537
26,60537,3,3,1, 60540
8,60541,1,1,0, 60542
24,60554,1,1,0, 60555
1,60556,1,1,1, 60557
25,60560,2,2,1, 60562
8,60566,1,1,1, 60567
9,60567,2,2,1, 60569
17,60569,3,3,1, 60572
2,60578,2,2,1, 60580
24,60579,1,1,1, 60580
1,60581,1,1,0, 60582
25,60585,2,2,1, 60587
8,60591,1,1,1, 60592
9,60592,2,2,1, 60594
18,60598,4,4,1, 60602
2,60603,2,2,1, 60605
24,60604,1,1,1, 60605
1,60606,1,1,1, 60607
27,60607,4,4,1, 60611
25,60610,2,2,1, 60612
7,60612,1,1,0, 60613
28,60609,5,5,1, 60614
26,60612,3,3,1, 60615
29,60613,4,4,1, 60617
8,60616,1,1,0, 60617
9,60617,2,2,1, 60619
17,60619,3,3,1, 60622
13,60619,4,6,1, 60625
18,60623,4,4,1, 60627
22,60626,4,4,1, 60630
24,60629,1,1,0, 60630
19,60626,5,5,1, 60631
1,60631,1,1,0, 60632
7,60637,1,1,1, 60638
28,60634,5,5,1, 60639
26,60637,3,3,1, 60640
29,60638,4,4,1, 60642
8,60641,1,1,1, 60642
11,60639,4,4,1, 60643
9,60642,2,2,1, 60644
17,60644,3,3,1, 60647
18,60648,4,4,1, 60652
22,60651,4,4,1, 60655
2,60653,2,2,1, 60655
24,60654,1,1,1, 60655
19,60651,5,5,1, 60656
21,60652,5,5,1, 60657
31,60661,2,2,1, 60663
7,60662,1,1,0, 60663
29,60663,4,4,1, 60667
8,60666,1,1,1, 60667
24,60679,1,1,0, 60680
21,60677,5,5,1, 60682
30,60683,3,3,1, 60686
31,60686,2,2,1, 60688
7,60687,1,1,0, 60688
8,60691,1,1,0, 60692
24,60704,1,1,1, 60705
30,60708,3,3,1, 60711
5,60707,3,5,1, 60712
31,60711,2,2,1, 60713
7,60712,1,1,0, 60713
29,60713,4,4,1, 60717
8,60716,1,1,0, 60717
14,60719,3,5,1, 60724
13,60719,4,6,1, 60725
22,60726,4,4,1, 60730
24,60729,1,1,1, 60730
30,60733,3,3,1, 60736
5,60732,3,5,1, 60737
7,60737,1,1,1, 60738
8,60741,1,1,0, 60742
24,60754,1,1,1, 60755
25,60760,2,2,1, 60762
7,60762,1,1,1, 60763
8,60766,1,1,0, 60767
24,60779,1,1,1, 60780
1,60781,1,1,1, 60782
25,60785,2,2,1, 60787
7,60787,1,1,1, 60788
8,60791,1,1,1, 60792
17,60794,3,3,1, 60797
24,60804,1,1,0, 60805
1,60806,1,1,1, 60807
7,60812,1,1,0, 60813
8,60816,1,1,1, 60817
9,60817,2,2,1, 60819
24,60829,1,1,0, 60830
1,60831,1,1,0, 60832
7,60837,1,1,1, 60838
8,60841,1,1,0, 60842
11,60839,4,4,1, 60843
17,60844,3,3,1, 60847
14,60844,3,5,1, 60849
12,60845,5,7,1, 60852
18,60848,4,4,1, 60852
20,60848,6,6,1, 60854
24,60854,1,1,0, 60855
19,60851,5,5,1, 60856
1,60856,1,1,1, 60857
7,60862,1,1,0, 60863
29,60863,4,4,1, 60867
8,60866,1,1,0, 60867
9,60867,2,2,1, 60869
13,60869,4,6,1, 60875
18,60873,4,4,1, 60877
2,60878,2,2,1, 60880
24,60879,1,1,1, 60880
1,60881,1,1,0, 60882
5,60882,3,5,1, 60887
7,60887,1,1,0, 60888
26,60887,3,3,1, 60890
29,60888,4,4,1, 60892
8,60891,1,1,0, 60892
9,60892,2,2,1, 60894
17,60894,3,3,1, 60897
14,60894,3,5,1, 60899
13,60894,4,6,1, 60900
2,60903,2,2,1, 60905
24,60904,1,1,1, 60905
1,60906,1,1,1, 60907
25,60910,2,2,1, 60912
7,60912,1,1,1, 60913
8,60916,1,1,1, 60917
13,60919,4,6,1, 60925
18,60923,4,4,1, 60927
22,60926,4,4,1, 60930
2,60928,2,2,1, 60930
24,60929,1,1,0, 60930
21,60927,5,5,1, 60932
1,60931,1,1,0, 60932
5,60932,3,5,1, 60937
31,60936,2,2,1, 60938
7,60937,1,1,0, 60938
8,60941,1,1,1, 60942
18,60948,4,4,1, 60952
2,60953,2,2,1, 60955
24,60954,1,1,1, 60955
1,60956,1,1,0, 60957
3,60957,3,3,1, 60960
25,60960,2,2,1, 60962
31,60961,2,2,1, 60963
7,60962,1,1,1, 60963
26,60962,3,3,1, 60965
8,60966,1,1,0, 60967
11,60964,4,4,1, 60968
12,60970,5,7,1, 60977
18,60973,4,4,1, 60977
20,60973,6,6,1, 60979
24,60979,1,1,0, 60980
19,60976,5,5,1, 60981
1,60981,1,1,1, 60982
3,60982,3,3,1, 60985
7,60987,1,1,0, 60988
8,60991,1,1,0, 60992
24,61004,1,1,0, 61005
7,61012,1,1,0, 61013
8,61016,1,1,0, 61017
24,61029,1,1,1, 61030
31,61036,2,2,1, 61038
7,61037,1,1,1, 61038
29,61038,4,4,1, 61042
8,61041,1,1,1, 61042
14,61044,3,5,1, 61049
24,61054,1,1,1, 61055
21,61052,5,5,1, 61057
7,61062,1,1,0, 61063
29,61063,4,4,1, 61067
8,61066,1,1,1, 61067
24,61079,1,1,0, 61080
31,61086,2,2,1, 61088
7,61087,1,1,1, 61088
28,61084,5,5,1, 61089
26,61087,3,3,1, 61090
29,61088,4,4,1, 61092
8,61091,1,1,0, 61092
9,61092,2,2,1, 61094
17,61094,3,3,1, 61097
24,61104,1,1,0, 61105
1,61106,1,1,0, 61107
31,61111,2,2,1, 61113
7,61112,1,1,0, 61113
29,61113,4,4,1, 61117
8,61116,1,1,0, 61117
9,61117,2,2,1, 61119
17,61119,3,3,1, 61122
14,61119,3,5,1, 61124
24,61129,1,1,1, 61130
21,61127,5,5,1, 61132
1,61131,1,1,1, 61132
30,61133,3,3,1, 61136
7,61137,1,1,1, 61138
29,61138,4,4,1, 61142
8,61141,1,1,0, 61142
9,61142,2,2,1, 61144
14,61144,3,5,1, 61149
13,61144,4,6,1, 61150
24,61154,1,1,1, 61155
1,61156,1,1,1, 61157
30,61158,3,3,1, 61161
7,61162,1,1,1, 61163
8,61166,1,1,0, 61167
22,61176,4,4,1, 61180
24,61179,1,1,1, 61180
1,61181,1,1,0, 61182
30,61183,3,3,1, 61186
7,61187,1,1,1, 61188
8,61191,1,1,1, 61192
9,61192,2,2,1, 61194
13,61194,4,6,1, 61200
12,61195,5,7,1, 61202
20,61198,6,6,1, 61204
24,61204,1,1,0, 61205
1,61206,1,1,0, 61207
30,61208,3,3,1, 61211
31,61211,2,2,1, 61213
7,61212,1,1,0, 61213
29,61213,4,4,1, 61217
8,61216,1,1,1, 61217
14,61219,3,5,1, 61224
13,61219,4,6,1, 61225
18,61223,4,4,1, 61227
22,61226,4,4,1, 61230
2,61228,2,2,1, 61230
24,61229,1,1,0, 61230
21,61227,5,5,1, 61232
1,61231,1,1,1, 61232
7,61237,1,1,1, 61238
26,61237,3,3,1, 61240
29,61238,4,4,1, 61242
8,61241,1,1,0, 61242
18,61248,4,4,1, 61252
24,61254,1,1,0, 61255
1,61256,1,1,1, 61257
30,61258,3,3,1, 61261
5,61257,3,5,1, 61262
31,61261,2,2,1, 61263
7,61262,1,1,1, 61263
8,61266,1,1,0, 61267
14,61269,3,5,1, 61274
22,61276,4,4,1, 61280
24,61279,1,1,0, 61280
21,61277,5,5,1, 61282
1,61281,1,1,1, 61282
25,61285,2,2,1, 61287
31,61286,2,2,1, 61288
7,61287,1,1,0, 61288
26,61287,3,3,1, 61290
29,61288,4,4,1, 61292
8,61291,1,1,0, 61292
9,61292,2,2,1, 61294
17,61294,3,3,1, 61297
18,61298,4,4,1, 61302
22,61301,4,4,1, 61305
24,61304,1,1,0, 61305
1,61306,1,1,1, 61307
3,61307,3,3,1, 61310
7,61312,1,1,0, 61313
8,61316,1,1,1, 61317
9,61317,2,2,1, 61319
18,61323,4,4,1, 61327
2,61328,2,2,1, 61330
24,61329,1,1,0, 61330
1,61331,1,1,0, 61332
27,61332,4,4,1, 61336
7,61337,1,1,0, 61338
29,61338,4,4,1, 61342
8,61341,1,1,0, 61342
9,61342,2,2,1, 61344
14,61344,3,5,1, 61349
12,61345,5,7,1, 61352
18,61348,4,4,1, 61352
2,61353,2,2,1, 61355
24,61354,1,1,0, 61355
21,61352,5,5,1, 61357
1,61356,1,1,0, 61357
3,61357,3,3,1, 61360
25,61360,2,2,1, 61362
31,61361,2,2,1, 61363
7,61362,1,1,1, 61363
26,61362,3,3,1, 61365
8,61366,1,1,0, 61367
11,61364,4,4,1, 61368
14,61369,3,5,1, 61374
13,61369,4,6,1, 61375
20,61373,6,6,1, 61379
2,61378,2,2,1, 61380
24,61379,1,1,1, 61380
19,61376,5,5,1, 61381
1,61381,1,1,1, 61382
27,61382,4,4,1, 61386
30,61383,3,3,1, 61386
5,61382,3,5,1, 61387
25,61385,2,2,1, 61387
31,61386,2,2,1, 61388
8,61391,1,1,0, 61392
9,61392,2,2,1, 61394
17,61394,3,3,1, 61397
14,61394,3,5,1, 61399
24,61404,1,1,1, 61405
21,61402,5,5,1, 61407
30,61408,3,3,1, 61411
31,61411,2,2,1, 61413
29,61413,4,4,1, 61417
8,61416,1,1,0, 61417
22,61426,4,4,1, 61430
24,61429,1,1,0, 61430
5,61432,3,5,1, 61437
31,61436,2,2,1, 61438
8,61441,1,1,1, 61442
22,61451,4,4,1, 61455
24,61454,1,1,1, 61455
5,61457,3,5,1, 61462
31,61461,2,2,1, 61463
29,61463,4,4,1, 61467
8,61466,1,1,1, 61467
24,61479,1,1,0, 61480
8,61491,1,1,1, 61492
24,61504,1,1,0, 61505
1,61506,1,1,0, 61507
25,61510,2,2,1, 61512
8,61516,1,1,1, 61517
9,61517,2,2,1, 61519
24,61529,1,1,0, 61530
1,61531,1,1,0, 61532
25,61535,2,2,1, 61537
8,61541,1,1,0, 61542
24,61554,1,1,0, 61555
1,61556,1,1,0, 61557
28,61559,5,5,1, 61564
8,61566,1,1,0, 61567
11,61564,4,4,1, 61568
17,61569,3,3,1, 61572
14,61569,3,5,1, 61574
13,61569,4,8,1, 61577
20,61573,6,6,1, 61579
22,61576,4,4,1, 61580
24,61579,1,1,1, 61580
21,61577,5,5,1, 61582
1,61581,1,1,0, 61582
25,61585,2,2,1, 61587
31,61586,2,2,0, 61588
29,61588,4,4,1, 61592
8,61591,1,1,0, 61592
9,61592,2,2,1, 61594
17,61594,3,3,1, 61597
14,61594,3,5,1, 61599
18,61598,4,4,1, 61602
22,61601,4,4,1, 61605
2,61603,2,2,1, 61605
24,61604,1,1,0, 61605
1,61606,1,1,0, 61607
5,61607,3,5,1, 61612
25,61610,2,2,1, 61612
31,61611,2,2,1, 61613
26,61612,3,3,1, 61615
8,61616,1,1,0, 61617
18,61623,4,4,1, 61627
24,61629,1,1,0, 61630
1,61631,1,1,0, 61632
31,61636,2,2,0, 61638
8,61641,1,1,1, 61642
9,61642,2,2,1, 61644
24,61654,1,1,1, 61655
1,61656,1,1,1, 61657
25,61660,2,2,1, 61662
31,61661,2,2,0, 61663
8,61666,1,1,0, 61667
9,61667,2,2,1, 61669
18,61673,4,4,1, 61677
2,61678,2,2,1, 61680
24,61679,1,1,1, 61680
1,61681,1,1,1, 61682
3,61682,3,3,1, 61685
31,61686,2,2,1, 61688
8,61691,1,1,1, 61692
11,61689,4,4,1, 61693
9,61692,2,2,1, 61694
17,61694,3,3,1, 61697
13,61694,4,8,1, 61702
12,61695,5,7,1, 61702
18,61698,4,4,1, 61702
24,61704,1,1,1, 61705
1,61706,1,1,0, 61707
3,61707,3,3,1, 61710
27,61707,4,4,1, 61711
25,61710,2,2,1, 61712
31,61711,2,2,0, 61713
8,61716,1,1,1, 61717
22,61726,4,4,1, 61730
24,61729,1,1,1, 61730
31,61736,2,2,1, 61738
8,61741,1,1,1, 61742
22,61751,4,4,1, 61755
24,61754,1,1,0, 61755
31,61761,2,2,1, 61763
8,61766,1,1,1, 61767
14,61769,3,5,1, 61774
24,61779,1,1,0, 61780
31,61786,2,2,0, 61788
8,61791,1,1,0, 61792
22,61801,4,4,1, 61805
24,61804,1,1,0, 61805
31,61811,2,2,0, 61813
29,61813,4,4,1, 61817
8,61816,1,1,0, 61817
9,61817,2,2,1, 61819
14,61819,3,5,1, 61824
22,61826,4,4,1, 61830
24,61829,1,1,1, 61830
21,61827,5,5,1, 61832
1,61831,1,1,1, 61832
30,61833,3,3,1, 61836
5,61832,3,5,1, 61837
31,61836,2,2,0, 61838
29,61838,4,4,1, 61842
8,61841,1,1,0, 61842
14,61844,3,5,1, 61849
24,61854,1,1,1, 61855
1,61856,1,1,1, 61857
31,61861,2,2,1, 61863
8,61866,1,1,0, 61867
24,61879,1,1,1, 61880
1,61881,1,1,1, 61882
30,61883,3,3,1, 61886
25,61885,2,2,1, 61887
31,61886,2,2,1, 61888
8,61891,1,1,1, 61892
17,61894,3,3,1, 61897
18,61898,4,4,1, 61902
24,61904,1,1,0, 61905
1,61906,1,1,0, 61907
30,61908,3,3,1, 61911
5,61907,3,5,1, 61912
25,61910,2,2,1, 61912
31,61911,2,2,0, 61913
26,61912,3,3,1, 61915
29,61913,4,4,1, 61917
8,61916,1,1,0, 61917
17,61919,3,3,1, 61922
13,61919,4,8,1, 61927
18,61923,4,4,1, 61927
20,61923,6,6,1, 61929
24,61929,1,1,0, 61930
19,61926,5,5,1, 61931
1,61931,1,1,0, 61932
3,61932,3,3,1, 61935
30,61933,3,3,1, 61936
5,61932,3,5,1, 61937
25,61935,2,2,1, 61937
31,61936,2,2,0, 61938
28,61934,5,5,1, 61939
26,61937,3,3,1, 61940
29,61938,4,4,1, 61942
8,61941,1,1,1, 61942
11,61939,4,4,1, 61943
9,61942,2,2,1, 61944
17,61944,3,3,1, 61947
18,61948,4,4,1, 61952
22,61951,4,4,1, 61955
24,61954,1,1,1, 61955
21,61952,5,5,1, 61957
1,61956,1,1,0, 61957
3,61957,3,3,1, 61960
27,61957,4,4,1, 61961
30,61958,3,3,1, 61961
31,61961,2,2,1, 61963
8,61966,1,1,0, 61967
9,61967,2,2,1, 61969
13,61969,4,8,1, 61977
12,61970,5,7,1, 61977
20,61973,6,6,1, 61979
22,61976,4,4,1, 61980
24,61979,1,1,1, 61980
19,61976,5,5,1, 61981
1,61981,1,1,0, 61982
3,61982,3,3,1, 61985
27,61982,4,4,1, 61986
30,61983,3,3,1, 61986
31,61986,2,2,1, 61988
29,61988,4,4,1, 61992
8,61991,1,1,1, 61992
14,61994,3,5,1, 61999
22,62001,4,4,1, 62005
24,62004,1,1,1, 62005
21,62002,5,5,1, 62007
30,62008,3,3,1, 62011
5,62007,3,5,1, 62012
31,62011,2,2,1, 62013
8,62016,1,1,1, 62017
14,62019,3,5,1, 62024
24,62029,1,1,1, 62030
21,62027,5,5,1, 62032
5,62032,3,5,1, 62037
31,62036,2,2,0, 62038
8,62041,1,1,0, 62042
14,62044,3,5,1, 62049
24,62054,1,1,1, 62055
21,62052,5,5,1, 62057
30,62058,3,3,1, 62061
31,62061,2,2,0, 62063
8,62066,1,1,1, 62067
22,62076,4,4,1, 62080
24,62079,1,1,0, 62080
21,62077,5,5,1, 62082
30,62083,3,3,1, 62086
31,62086,2,2,1, 62088
29,62088,4,4,1, 62092
8,62091,1,1,1, 62092
9,62092,2,2,1, 62094
17,62094,3,3,1, 62097
14,62094,3,5,1, 62099
24,62104,1,1,0, 62105
21,62102,5,5,1, 62107
1,62106,1,1,0, 62107
30,62108,3,3,1, 62111
5,62107,3,5,1, 62112
31,62111,2,2,0, 62113
29,62113,4,4,1, 62117
8,62116,1,1,0, 62117
24,62129,1,1,1, 62130
21,62127,5,5,1, 62132
1,62131,1,1,0, 62132
5,62132,3,5,1, 62137
25,62135,2,2,1, 62137
31,62136,2,2,0, 62138
26,62137,3,3,1, 62140
29,62138,4,4,1, 62142
8,62141,1,1,0, 62142
17,62144,3,3,1, 62147
24,62154,1,1,1, 62155
1,62156,1,1,1, 62157
26,62162,3,3,1, 62165
8,62166,1,1,1, 62167
9,62167,2,2,1, 62169
17,62169,3,3,1, 62172
24,62179,1,1,1, 62180
1,62181,1,1,1, 62182
25,62185,2,2,1, 62187
8,62191,1,1,0, 62192
9,62192,2,2,1, 62194
17,62194,3,3,1, 62197
2,62203,2,2,1, 62205
24,62204,1,1,1, 62205
1,62206,1,1,0, 62207
27,62207,4,4,1, 62211
28,62209,5,5,1, 62214
8,62216,1,1,1, 62217
11,62214,4,4,1, 62218
9,62217,2,2,1, 62219
13,62219,4,8,1, 62227
20,62223,6,6,1, 62229
24,62229,1,1,1, 62230
19,62226,5,5,1, 62231
1,62231,1,1,1, 62232
25,62235,2,2,1, 62237
28,62234,5,5,1, 62239
26,62237,3,3,1, 62240
8,62241,1,1,1, 62242
11,62239,4,4,1, 62243
13,62244,4,8,1, 62252
18,62248,4,4,1, 62252
20,62248,6,6,1, 62254
22,62251,4,4,1, 62255
24,62254,1,1,0, 62255
19,62251,5,5,1, 62256
30,62258,3,3,1, 62261
31,62261,2,2,0, 62263
8,62266,1,1,0, 62267
14,62269,3,5,1, 62274
24,62279,1,1,0, 62280
30,62283,3,3,1, 62286
31,62286,2,2,0, 62288
8,62291,1,1,0, 62292
24,62304,1,1,1, 62305
5,62307,3,5,1, 62312
31,62311,2,2,0, 62313
8,62316,1,1,0, 62317
24,62329,1,1,1, 62330
21,62327,5,5,1, 62332
30,62333,3,3,1, 62336
31,62336,2,2,1, 62338
8,62341,1,1,0, 62342
24,62354,1,1,0, 62355
21,62352,5,5,1, 62357
25,62360,2,2,1, 62362
31,62361,2,2,1, 62363
29,62363,4,4,1, 62367
8,62366,1,1,1, 62367
17,62369,3,3,1, 62372
14,62369,3,5,1, 62374
22,62376,4,4,1, 62380
24,62379,1,1,1, 62380
1,62381,1,1,0, 62382
30,62383,3,3,1, 62386
31,62386,2,2,1, 62388
8,62391,1,1,1, 62392
9,62392,2,2,1, 62394
14,62394,3,5,1, 62399
18,62398,4,4,1, 62402
22,62401,4,4,1, 62405
24,62404,1,1,0, 62405
21,62402,5,5,1, 62407
1,62406,1,1,0, 62407
30,62408,3,3,1, 62411
31,62411,2,2,0, 62413
8,62416,1,1,0, 62417
17,62419,3,3,1, 62422
18,62423,4,4,1, 62427
20,62423,6,6,1, 62429
2,62428,2,2,1, 62430
24,62429,1,1,0, 62430
19,62426,5,5,1, 62431
1,62431,1,1,1, 62432
3,62432,3,3,1, 62435
27,62432,4,4,1, 62436
30,62433,3,3,1, 62436
25,62435,2,2,1, 62437
31,62436,2,2,1, 62438
28,62434,5,5,1, 62439
8,62441,1,1,1, 62442
11,62439,4,4,1, 62443
14,62444,3,5,1, 62449
13,62444,4,8,1, 62452
22,62451,4,4,1, 62455
2,62453,2,2,1, 62455
24,62454,1,1,0, 62455
19,62451,5,5,1, 62456
1,62456,1,1,0, 62457
3,62457,3,3,1, 62460
27,62457,4,4,1, 62461
31,62461,2,2,0, 62463
28,62459,5,5,1, 62464
29,62463,4,4,1, 62467
8,62466,1,1,1, 62467
17,62469,3,3,1, 62472
12,62470,5,7,1, 62477
2,62478,2,2,1, 62480
24,62479,1,1,1, 62480
19,62476,5,5,1, 62481
21,62477,5,5,1, 62482
1,62481,1,1,0, 62482
3,62482,3,3,1, 62485
5,62482,3,5,1, 62487
31,62486,2,2,0, 62488
8,62491,1,1,0, 62492
22,62501,4,4,1, 62505
24,62504,1,1,0, 62505
30,62508,3,3,1, 62511
31,62511,2,2,0, 62513
8,62516,1,1,1, 62517
22,62526,4,4,1, 62530
24,62529,1,1,1, 62530
21,62527,5,5,1, 62532
30,62533,3,3,1, 62536
5,62532,3,5,1, 62537
31,62536,2,2,1, 62538
29,62538,4,4,1, 62542
8,62541,1,1,0, 62542
14,62544,3,5,1, 62549
24,62554,1,1,1, 62555
30,62558,3,3,1, 62561
5,62557,3,5,1, 62562
31,62561,2,2,1, 62563
29,62563,4,4,1, 62567
8,62566,1,1,1, 62567
14,62569,3,5,1, 62574
24,62579,1,1,1, 62580
5,62582,3,5,1, 62587
31,62586,2,2,0, 62588
29,62588,4,4,1, 62592
8,62591,1,1,0, 62592
17,62594,3,3,1, 62597
14,62594,3,5,1, 62599
24,62604,1,1,1, 62605
21,62602,5,5,1, 62607
1,62606,1,1,1, 62607
5,62607,3,5,1, 62612
25,62610,2,2,1, 62612
8,62616,1,1,1, 62617
9,62617,2,2,1, 62619
17,62619,3,3,1, 62622
24,62629,1,1,0, 62630
1,62631,1,1,1, 62632
8,62641,1,1,1, 62642
9,62642,2,2,1, 62644
2,62653,2,2,1, 62655
24,62654,1,1,0, 62655
1,62656,1,1,1, 62657
26,62662,3,3,1, 62665
8,62666,1,1,0, 62667
17,62669,3,3,1, 62672
24,62679,1,1,1, 62680
1,62681,1,1,1, 62682
25,62685,2,2,1, 62687
8,62691,1,1,0, 62692
9,62692,2,2,1, 62694
17,62694,3,3,1, 62697
18,62698,4,4,1, 62702
20,62698,6,6,1, 62704
24,62704,1,1,1, 62705
19,62701,5,5,1, 62706
1,62706,1,1,1, 62707
3,62707,3,3,1, 62710
25,62710,2,2,1, 62712
31,62711,2,2,1, 62713
28,62709,5,5,1, 62714
26,62712,3,3,1, 62715
8,62716,1,1,1, 62717
11,62714,4,4,1, 62718
14,62719,3,5,1, 62724
18,62723,4,4,1, 62727
2,62728,2,2,1, 62730
24,62729,1,1,1, 62730
19,62726,5,5,1, 62731
1,62731,1,1,1, 62732
3,62732,3,3,1, 62735
27,62732,4,4,1, 62736
30,62733,3,3,1, 62736
25,62735,2,2,1, 62737
31,62736,2,2,1, 62738
28,62734,5,5,1, 62739
29,62738,4,4,1, 62742
8,62741,1,1,1, 62742
14,62744,3,5,1, 62749
24,62754,1,1,1, 62755
30,62758,3,3,1, 62761
31,62761,2,2,0, 62763
8,62766,1,1,1, 62767
24,62779,1,1,1, 62780
21,62777,5,5,1, 62782
30,62783,3,3,1, 62786
5,62782,3,5,1, 62787
31,62786,2,2,0, 62788
29,62788,4,4,1, 62792
8,62791,1,1,1, 62792
22,62801,4,4,1, 62805
24,62804,1,1,0, 62805
21,62802,5,5,1, 62807
30,62808,3,3,1, 62811
31,62811,2,2,1, 62813
8,62816,1,1,0, 62817
14,62819,3,5,1, 62824
24,62829,1,1,1, 62830
30,62833,3,3,1, 62836
31,62836,2,2,0, 62838
8,62841,1,1,1, 62842
14,62844,3,5,1, 62849
24,62854,1,1,0, 62855
1,62856,1,1,0, 62857
30,62858,3,3,1, 62861
5,62857,3,5,1, 62862
31,62861,2,2,0, 62863
8,62866,1,1,0, 62867
17,62869,3,3,1, 62872
22,62876,4,4,1, 62880
24,62879,1,1,1, 62880
21,62877,5,5,1, 62882
1,62881,1,1,0, 62882
5,62882,3,5,1, 62887
31,62886,2,2,1, 62888
26,62887,3,3,1, 62890
29,62888,4,4,1, 62892
8,62891,1,1,0, 62892
14,62894,3,5,1, 62899
22,62901,4,4,1, 62905
24,62904,1,1,1, 62905
21,62902,5,5,1, 62907
1,62906,1,1,0, 62907
25,62910,2,2,1, 62912
31,62911,2,2,1, 62913
26,62912,3,3,1, 62915
29,62913,4,4,1, 62917
8,62916,1,1,1, 62917
18,62923,4,4,1, 62927
24,62929,1,1,1, 62930
21,62927,5,5,1, 62932
1,62931,1,1,0, 62932
5,62932,3,5,1, 62937
31,62936,2,2,1, 62938
29,62938,4,4,1, 62942
8,62941,1,1,0, 62942
9,62942,2,2,1, 62944
17,62944,3,3,1, 62947
24,62954,1,1,0, 62955
1,62956,1,1,0, 62957
5,62957,3,5,1, 62962
31,62961,2,2,1, 62963
8,62966,1,1,1, 62967
9,62967,2,2,1, 62969
17,62969,3,3,1, 62972
22,62976,4,4,1, 62980
24,62979,1,1,0, 62980
1,62981,1,1,0, 62982
30,62983,3,3,1, 62986
25,62985,2,2,1, 62987
31,62986,2,2,1, 62988
26,62987,3,3,1, 62990
8,62991,1,1,1, 62992
9,62992,2,2,1, 62994
20,62998,6,6,1, 63004
22,63001,4,4,1, 63005
2,63003,2,2,1, 63005
24,63004,1,1,1, 63005
1,63006,1,1,0, 63007
3,63007,3,3,1, 63010
27,63007,4,4,1, 63011
5,63007,3,5,1, 63012
28,63009,5,5,1, 63014
8,63016,1,1,0, 63017
17,63019,3,3,1, 63022
18,63023,4,4,1, 63027
20,63023,6,6,1, 63029
24,63029,1,1,1, 63030
19,63026,5,5,1, 63031
1,63031,1,1,1, 63032
27,63032,4,4,1, 63036
30,63033,3,3,1, 63036
31,63036,2,2,1, 63038
8,63041,1,1,1, 63042
14,63044,3,5,1, 63049
13,63044,4,8,1, 63052
12,63045,5,7,1, 63052
22,63051,4,4,1, 63055
24,63054,1,1,0, 63055
19,63051,5,5,1, 63056
21,63052,5,5,1, 63057
1,63056,1,1,1, 63057
3,63057,3,3,1, 63060
30,63058,3,3,1, 63061
5,63057,3,5,1, 63062
28,63059,5,5,1, 63064
26,63062,3,3,1, 63065
8,63066,1,1,1, 63067
17,63069,3,3,1, 63072
12,63070,5,7,1, 63077
20,63073,6,6,1, 63079
24,63079,1,1,0, 63080
19,63076,5,5,1, 63081
1,63081,1,1,1, 63082
3,63082,3,3,1, 63085
8,63091,1,1,1, 63092
24,63104,1,1,1, 63105
8,63116,1,1,0, 63117
24,63129,1,1,0, 63130
8,63141,1,1,0, 63142
24,63154,1,1,0, 63155
8,63166,1,1,1, 63167
24,63179,1,1,1, 63180
21,63177,5,5,1, 63182
30,63183,3,3,1, 63186
31,63186,2,2,1, 63188
8,63191,1,1,1, 63192
9,63192,2,2,1, 63194
17,63194,3,3,1, 63197
24,63204,1,1,1, 63205
21,63202,5,5,1, 63207
1,63206,1,1,1, 63207
30,63208,3,3,1, 63211
5,63207,3,5,1, 63212
31,63211,2,2,1, 63213
8,63216,1,1,1, 63217
24,63229,1,1,0, 63230
1,63231,1,1,0, 63232
5,63232,3,5,1, 63237
8,63241,1,1,0, 63242
24,63254,1,1,0, 63255
21,63252,5,5,1, 63257
1,63256,1,1,1, 63257
3,63257,3,3,1, 63260
30,63258,3,3,1, 63261
25,63260,2,2,1, 63262
31,63261,2,2,1, 63263
8,63266,1,1,0, 63267
17,63269,3,3,1, 63272
14,63269,3,9,1, 63278
24,63279,1,1,0, 63280
21,63277,5,5,1, 63282
1,63281,1,1,1, 63282
3,63282,3,3,1, 63285
31,63286,2,2,1, 63288
28,63284,5,5,1, 63289
29,63288,4,4,1, 63292
8,63291,1,1,0, 63292
9,63292,2,2,1, 63294
18,63298,4,4,1, 63302
14,63294,3,9,1, 63303
20,63298,6,6,1, 63304
2,63303,2,2,1, 63305
24,63304,1,1,1, 63305
1,63306,1,1,0, 63307
5,63307,3,5,1, 63312
25,63310,2,2,1, 63312
31,63311,2,2,1, 63313
28,63309,5,5,1, 63314
8,63316,1,1,1, 63317
9,63317,2,2,1, 63319
17,63319,3,3,1, 63322
13,63319,4,8,1, 63327
20,63323,6,6,1, 63329
24,63329,1,1,0, 63330
19,63326,5,5,1, 63331
21,63327,5,5,1, 63332
1,63331,1,1,0, 63332
27,63332,4,4,1, 63336
28,63334,5,5,1, 63339
8,63341,1,1,1, 63342
2,63353,2,2,1, 63355
24,63354,1,1,0, 63355
19,63351,5,5,1, 63356
1,63356,1,1,0, 63357
3,63357,3,3,1, 63360
30,63358,3,3,1, 63361
5,63357,3,5,1, 63362
28,63359,5,5,1, 63364
29,63363,4,4,1, 63367
8,63366,1,1,0, 63367
9,63367,2,2,1, 63369
17,63369,3,3,1, 63372
24,63379,1,1,0, 63380
19,63376,5,5,1, 63381
1,63381,1,1,1, 63382
5,63382,3,5,1, 63387
25,63385,2,2,1, 63387
8,63391,1,1,0, 63392
14,63394,3,7,1, 63401
24,63404,1,1,0, 63405
21,63402,5,5,1, 63407
30,63408,3,3,1, 63411
8,63416,1,1,1, 63417
14,63419,3,7,1, 63426
24,63429,1,1,0, 63430
30,63433,3,3,1, 63436
31,63436,2,2,1, 63438
29,63438,4,4,1, 63442
8,63441,1,1,0, 63442
24,63454,1,1,1, 63455
30,63458,3,3,1, 63461
31,63461,2,2,1, 63463
8,63466,1,1,0, 63467
24,63479,1,1,0, 63480
8,63491,1,1,0, 63492
9,63492,2,2,1, 63494
20,63498,6,6,1, 63504
2,63503,2,2,1, 63505
24,63504,1,1,0, 63505
19,63501,5,5,1, 63506
1,63506,1,1,0, 63507
3,63507,3,3,1, 63510
30,63508,3,3,1, 63511
31,63511,2,2,1, 63513
28,63509,5,5,1, 63514
29,63513,4,4,1, 63517
8,63516,1,1,1, 63517
9,63517,2,2,1, 63519
17,63519,3,3,1, 63522
18,63523,4,4,1, 63527
20,63523,6,6,1, 63529
2,63528,2,2,1, 63530
24,63529,1,1,1, 63530
19,63526,5,5,1, 63531
21,63527,5,5,1, 63532
1,63531,1,1,0, 63532
27,63532,4,4,1, 63536
25,63535,2,2,1, 63537
31,63536,2,2,1, 63538
29,63538,4,4,1, 63542
8,63541,1,1,1, 63542
9,63542,2,2,1, 63544
17,63544,3,3,1, 63547
13,63544,4,6,1, 63550
18,63548,4,4,1, 63552
2,63553,2,2,1, 63555
24,63554,1,1,1, 63555
19,63551,5,5,1, 63556
1,63556,1,1,1, 63557
30,63558,3,3,1, 63561
28,63559,5,5,1, 63564
29,63563,4,4,1, 63567
8,63566,1,1,1, 63567
17,63569,3,3,1, 63572
13,63569,4,6,1, 63575
18,63573,4,4,1, 63577
20,63573,6,6,1, 63579
24,63579,1,1,0, 63580
21,63577,5,5,1, 63582
30,63583,3,3,1, 63586
29,63588,4,4,1, 63592
8,63591,1,1,0, 63592
13,63594,4,6,1, 63600
24,63604,1,1,1, 63605
21,63602,5,5,1, 63607
29,63613,4,4,1, 63617
8,63616,1,1,1, 63617
14,63619,3,7,1, 63626
24,63629,1,1,1, 63630
21,63627,5,5,1, 63632
31,63636,2,2,1, 63638
29,63638,4,4,1, 63642
8,63641,1,1,1, 63642
24,63654,1,1,0, 63655
8,63666,1,1,0, 63667
13,63669,4,6,1, 63675
24,63679,1,1,1, 63680
3,63682,3,3,1, 63685
30,63683,3,3,1, 63686
25,63685,2,2,1, 63687
28,63684,5,5,1, 63689
29,63688,4,4,1, 63692
8,63691,1,1,1, 63692
9,63692,2,2,1, 63694
17,63694,3,3,1, 63697
13,63694,4,6,1, 63700
18,63698,4,4,1, 63702
20,63698,6,6,1, 63704
2,63703,2,2,1, 63705
24,63704,1,1,1, 63705
19,63701,5,5,1, 63706
1,63706,1,1,0, 63707
3,63707,3,3,1, 63710
30,63708,3,3,1, 63711
25,63710,2,2,1, 63712
8,63716,1,1,1, 63717
9,63717,2,2,1, 63719
13,63719,4,6,1, 63725
14,63719,3,7,1, 63726
18,63723,4,4,1, 63727
2,63728,2,2,1, 63730
24,63729,1,1,0, 63730
19,63726,5,5,1, 63731
21,63727,5,5,1, 63732
1,63731,1,1,1, 63732
3,63732,3,3,1, 63735
27,63732,4,4,1, 63736
25,63735,2,2,1, 63737
28,63734,5,5,1, 63739
29,63738,4,4,1, 63742
8,63741,1,1,0, 63742
13,63744,4,6,1, 63750
24,63754,1,1,0, 63755
21,63752,5,5,1, 63757
30,63758,3,3,1, 63761
31,63761,2,2,1, 63763
29,63763,4,4,1, 63767
8,63766,1,1,1, 63767
24,63779,1,1,1, 63780
8,63791,1,1,0, 63792
24,63804,1,1,1, 63805
8,63816,1,1,1, 63817
24,63829,1,1,1, 63830
8,63841,1,1,0, 63842
20,63848,6,6,1, 63854
24,63854,1,1,1, 63855
1,63856,1,1,0, 63857
25,63860,2,2,1, 63862
8,63866,1,1,0, 63867
18,63873,4,4,1, 63877
20,63873,6,6,1, 63879
2,63878,2,2,1, 63880
24,63879,1,1,1, 63880
19,63876,5,5,1, 63881
1,63881,1,1,0, 63882
27,63882,4,4,1, 63886
25,63885,2,2,1, 63887
31,63886,2,2,1, 63888
8,63891,1,1,0, 63892
17,63894,3,3,1, 63897
20,63898,6,6,1, 63904
2,63903,2,2,1, 63905
24,63904,1,1,1, 63905
21,63902,5,5,1, 63907
1,63906,1,1,1, 63907
27,63907,4,4,1, 63911
30,63908,3,3,1, 63911
8,63916,1,1,0, 63917
20,63923,6,6,1, 63929
2,63928,2,2,1, 63930
24,63929,1,1,0, 63930
19,63926,5,5,1, 63931
21,63927,5,5,1, 63932
1,63931,1,1,1, 63932
3,63932,3,3,1, 63935
27,63932,4,4,1, 63936
25,63935,2,2,1, 63937
8,63941,1,1,1, 63942
14,63944,3,7,1, 63951
20,63948,6,6,1, 63954
2,63953,2,2,1, 63955
24,63954,1,1,1, 63955
19,63951,5,5,1, 63956
21,63952,5,5,1, 63957
1,63956,1,1,1, 63957
27,63957,4,4,1, 63961
29,63963,4,4,1, 63967
8,63966,1,1,0, 63967
17,63969,3,3,1, 63972
13,63969,4,6,1, 63975
14,63969,3,7,1, 63976
24,63979,1,1,0, 63980
21,63977,5,5,1, 63982
1,63981,1,1,0, 63982
25,63985,2,2,1, 63987
8,63991,1,1,0, 63992
13,63994,4,6,1, 64000
14,63994,3,7,1, 64001
18,63998,4,4,1, 64002
24,64004,1,1,0, 64005
21,64002,5,5,1, 64007
1,64006,1,1,0, 64007
25,64010,2,2,1, 64012
29,64013,4,4,1, 64017
8,64016,1,1,1, 64017
17,64019,3,3,1, 64022
14,64019,3,7,1, 64026
18,64023,4,4,1, 64027
24,64029,1,1,1, 64030
19,64026,5,5,1, 64031
21,64027,5,5,1, 64032
1,64031,1,1,0, 64032
30,64033,3,3,1, 64036
8,64041,1,1,1, 64042
24,64054,1,1,0, 64055
19,64051,5,5,1, 64056
1,64056,1,1,0, 64057
30,64058,3,3,1, 64061
25,64060,2,2,1, 64062
31,64061,2,2,1, 64063
29,64063,4,4,1, 64067
8,64066,1,1,1, 64067
13,64069,4,6,1, 64075
14,64069,3,7,1, 64076
18,64073,4,4,1, 64077
20,64073,6,6,1, 64079
24,64079,1,1,0, 64080
21,64077,5,5,1, 64082
1,64081,1,1,1, 64082
3,64082,3,3,1, 64085
30,64083,3,3,1, 64086
8,64091,1,1,1, 64092
14,64094,3,7,1, 64101
24,64104,1,1,0, 64105
21,64102,5,5,1, 64107
8,64116,1,1,0, 64117
14,64119,3,7,1, 64126
24,64129,1,1,1, 64130
21,64127,5,5,1, 64132
29,64138,4,4,1, 64142
8,64141,1,1,1, 64142
24,64154,1,1,1, 64155
21,64152,5,5,1, 64157
29,64163,4,4,1, 64167
8,64166,1,1,1, 64167
14,64169,3,7,1, 64176
24,64179,1,1,0, 64180
30,64183,3,3,1, 64186
8,64191,1,1,1, 64192
2,64203,2,2,1, 64205
24,64204,1,1,0, 64205
21,64202,5,5,1, 64207
1,64206,1,1,0, 64207
27,64207,4,4,1, 64211
8,64216,1,1,0, 64217
17,64219,3,3,1, 64222
13,64219,4,6,1, 64225
14,64219,3,7,1, 64226
20,64223,6,6,1, 64229
24,64229,1,1,0, 64230
21,64227,5,5,1, 64232
1,64231,1,1,0, 64232
3,64232,3,3,1, 64235
27,64232,4,4,1, 64236
30,64233,3,3,1, 64236
8,64241,1,1,1, 64242
17,64244,3,3,1, 64247
13,64244,4,6,1, 64250
20,64248,6,6,1, 64254
2,64253,2,2,1, 64255
24,64254,1,1,0, 64255
1,64256,1,1,1, 64257
3,64257,3,3,1, 64260
27,64257,4,4,1, 64261
30,64258,3,3,1, 64261
28,64259,5,5,1, 64264
8,64266,1,1,1, 64267
20,64273,6,6,1, 64279
24,64279,1,1,1, 64280
1,64281,1,1,0, 64282
3,64282,3,3,1, 64285
25,64285,2,2,1, 64287
8,64291,1,1,0, 64292
2,64303,2,2,1, 64305
24,64304,1,1,1, 64305
1,64306,1,1,0, 64307
3,64307,3,3,1, 64310
8,64316,1,1,0, 64317
18,64323,4,4,1, 64327
2,64328,2,2,1, 64330
24,64329,1,1,1, 64330
19,64326,5,5,1, 64331
1,64331,1,1,1, 64332
27,64332,4,4,1, 64336
28,64334,5,5,1, 64339
8,64341,1,1,0, 64342
18,64348,4,4,1, 64352
20,64348,6,6,1, 64354
2,64353,2,2,1, 64355
24,64354,1,1,1, 64355
1,64356,1,1,1, 64357
27,64357,4,4,1, 64361
25,64360,2,2,1, 64362
29,64363,4,4,1, 64367
8,64366,1,1,1, 64367
17,64369,3,3,1, 64372
13,64369,4,6,1, 64375
18,64373,4,4,1, 64377
24,64379,1,1,0, 64380
21,64377,5,5,1, 64382
30,64383,3,3,1, 64386
8,64391,1,1,1, 64392
24,64404,1,1,0, 64405
31,64411,2,2,1, 64413
29,64413,4,4,1, 64417
8,64416,1,1,1, 64417
24,64429,1,1,1, 64430
30,64433,3,3,1, 64436
8,64441,1,1,0, 64442
13,64444,4,6,1, 64450
24,64454,1,1,0, 64455
29,64463,4,4,1, 64467
8,64466,1,1,0, 64467
24,64479,1,1,0, 64480
30,64483,3,3,1, 64486
28,64484,5,5,1, 64489
8,64491,1,1,0, 64492
13,64494,4,6,1, 64500
18,64498,4,4,1, 64502
24,64504,1,1,0, 64505
19,64501,5,5,1, 64506
1,64506,1,1,0, 64507
27,64507,4,4,1, 64511
25,64510,2,2,1, 64512
28,64509,5,5,1, 64514
29,64513,4,4,1, 64517
8,64516,1,1,1, 64517
18,64523,4,4,1, 64527
20,64523,6,6,1, 64529
24,64529,1,1,1, 64530
21,64527,5,5,1, 64532
1,64531,1,1,1, 64532
27,64532,4,4,1, 64536
30,64533,3,3,1, 64536
25,64535,2,2,1, 64537
8,64541,1,1,1, 64542
17,64544,3,3,1, 64547
13,64544,4,6,1, 64550
24,64554,1,1,0, 64555
19,64551,5,5,1, 64556
1,64556,1,1,0, 64557
3,64557,3,3,1, 64560
27,64557,4,4,1, 64561
30,64558,3,3,1, 64561
8,64566,1,1,1, 64567
14,64569,3,7,1, 64576
24,64579,1,1,1, 64580
21,64577,5,5,1, 64582
1,64581,1,1,0, 64582
3,64582,3,3,1, 64585
31,64586,2,2,1, 64588
28,64584,5,5,1, 64589
8,64591,1,1,1, 64592
17,64594,3,3,1, 64597
2,64603,2,2,1, 64605
24,64604,1,1,1, 64605
21,64602,5,5,1, 64607
1,64606,1,1,0, 64607
3,64607,3,3,1, 64610
27,64607,4,4,1, 64611
30,64608,3,3,1, 64611
8,64616,1,1,0, 64617
17,64619,3,3,1, 64622
13,64619,4,6,1, 64625
2,64628,2,2,1, 64630
24,64629,1,1,1, 64630
1,64631,1,1,0, 64632
30,64633,3,3,1, 64636
31,64636,2,2,1, 64638
28,64634,5,5,1, 64639
29,64638,4,4,1, 64642
8,64641,1,1,0, 64642
20,64648,6,6,1, 64654
24,64654,1,1,1, 64655
1,64656,1,1,0, 64657
3,64657,3,3,1, 64660
30,64658,3,3,1, 64661
25,64660,2,2,1, 64662
8,64666,1,1,0, 64667
17,64669,3,3,1, 64672
13,64669,4,6,1, 64675
20,64673,6,6,1, 64679
2,64678,2,2,1, 64680
24,64679,1,1,1, 64680
19,64676,5,5,1, 64681
30,64683,3,3,1, 64686
31,64686,2,2,1, 64688
29,64688,4,4,1, 64692
8,64691,1,1,1, 64692
13,64694,4,6,1, 64700
24,64704,1,1,0, 64705
30,64708,3,3,1, 64711
31,64711,2,2,1, 64713
29,64713,4,4,1, 64717
8,64716,1,1,1, 64717
13,64719,4,6,1, 64725
24,64729,1,1,0, 64730
30,64733,3,3,1, 64736
31,64736,2,2,1, 64738
8,64741,1,1,1, 64742
13,64744,4,6,1, 64750
24,64754,1,1,0, 64755
31,64761,2,2,1, 64763
8,64766,1,1,0, 64767
13,64769,4,6,1, 64775
24,64779,1,1,1, 64780
21,64777,5,5,1, 64782
3,64782,3,3,1, 64785
30,64783,3,3,1, 64786
29,64788,4,4,1, 64792
8,64791,1,1,0, 64792
13,64794,4,6,1, 64800
2,64803,2,2,1, 64805
24,64804,1,1,0, 64805
1,64806,1,1,0, 64807
27,64807,4,4,1, 64811
30,64808,3,3,1, 64811
28,64809,5,5,1, 64814
8,64816,1,1,1, 64817
13,64819,4,6,1, 64825
18,64823,4,4,1, 64827
20,64823,6,6,1, 64829
2,64828,2,2,1, 64830
24,64829,1,1,0, 64830
1,64831,1,1,1, 64832
27,64832,4,4,1, 64836
30,64833,3,3,1, 64836
31,64836,2,2,1, 64838
28,64834,5,5,1, 64839
8,64841,1,1,1, 64842
17,64844,3,3,1, 64847
13,64844,4,6,1, 64850
18,64848,4,4,1, 64852
20,64848,6,6,1, 64854
2,64853,2,2,1, 64855
24,64854,1,1,0, 64855
21,64852,5,5,1, 64857
1,64856,1,1,1, 64857
3,64857,3,3,1, 64860
27,64857,4,4,1, 64861
25,64860,2,2,1, 64862
8,64866,1,1,0, 64867
18,64873,4,4,1, 64877
20,64873,6,6,1, 64879
24,64879,1,1,1, 64880
19,64876,5,5,1, 64881
1,64881,1,1,1, 64882
3,64882,3,3,1, 64885
27,64882,4,4,1, 64886
28,64884,5,5,1, 64889
29,64888,4,4,1, 64892
8,64891,1,1,0, 64892
13,64894,4,6,1, 64900
24,64904,1,1,1, 64905
30,64908,3,3,1, 64911
8,64916,1,1,0, 64917
24,64929,1,1,1, 64930
21,64927,5,5,1, 64932
30,64933,3,3,1, 64936
31,64936,2,2,1, 64938
8,64941,1,1,0, 64942
13,64944,4,6,1, 64950
24,64954,1,1,0, 64955
21,64952,5,5,1, 64957
31,64961,2,2,1, 64963
8,64966,1,1,0, 64967
13,64969,4,6,1, 64975
24,64979,1,1,1, 64980
21,64977,5,5,1, 64982
8,64991,1,1,0, 64992
18,64998,4,4,1, 65002
1,65006,1,1,1, 65007
3,65007,3,3,1, 65010
25,65010,2,2,1, 65012
8,65016,1,1,0, 65017
18,65023,4,4,1, 65027
1,65031,1,1,0, 65032
3,65032,3,3,1, 65035
28,65034,5,5,1, 65039
8,65041,1,1,0, 65042
17,65044,3,3,1, 65047
20,65048,6,6,1, 65054
2,65053,2,2,1, 65055
1,65056,1,1,1, 65057
28,65059,5,5,1, 65064
8,65066,1,1,1, 65067
20,65073,6,6,1, 65079
19,65076,5,5,1, 65081
1,65081,1,1,1, 65082
31,65086,2,2,1, 65088
28,65084,5,5,1, 65089
8,65091,1,1,0, 65092
17,65094,3,3,1, 65097
13,65094,4,6,1, 65100
24,65104,1,1,0, 65105
21,65102,5,5,1, 65107
1,65106,1,1,0, 65107
27,65107,4,4,1, 65111
25,65110,2,2,1, 65112
8,65116,1,1,1, 65117
20,65123,6,6,1, 65129
24,65129,1,1,1, 65130
19,65126,5,5,1, 65131
1,65131,1,1,1, 65132
27,65132,4,4,1, 65136
28,65134,5,5,1, 65139
8,65141,1,1,0, 65142
17,65144,3,3,1, 65147
18,65148,4,4,1, 65152
24,65154,1,1,1, 65155
1,65156,1,1,1, 65157
27,65157,4,4,1, 65161
28,65159,5,5,1, 65164
8,65166,1,1,1, 65167
17,65169,3,3,1, 65172
18,65173,4,4,1, 65177
2,65178,2,2,1, 65180
24,65179,1,1,1, 65180
1,65181,1,1,0, 65182
8,65191,1,1,1, 65192
17,65194,3,3,1, 65197
18,65198,4,4,1, 65202
20,65198,6,6,1, 65204
24,65204,1,1,0, 65205
19,65201,5,5,1, 65206
1,65206,1,1,1, 65207
3,65207,3,3,1, 65210
30,65208,3,3,1, 65211
31,65211,2,2,1, 65213
8,65216,1,1,1, 65217
24,65229,1,1,1, 65230
8,65241,1,1,1, 65242
13,65244,4,6,1, 65250
24,65254,1,1,1, 65255
30,65258,3,3,1, 65261
31,65261,2,2,1, 65263
29,65263,4,4,1, 65267
8,65266,1,1,0, 65267
24,65279,1,1,1, 65280
21,65277,5,5,1, 65282
31,65286,2,2,1, 65288
29,65288,4,4,1, 65292
8,65291,1,1,1, 65292
13,65294,4,6,1, 65300
24,65304,1,1,0, 65305
21,65302,5,5,1, 65307
8,65316,1,1,0, 65317
24,65329,1,1,0, 65330
19,65326,5,5,1, 65331
1,65331,1,1,0, 65332
27,65332,4,4,1, 65336
30,65333,3,3,1, 65336
25,65335,2,2,1, 65337
28,65334,5,5,1, 65339
8,65341,1,1,1, 65342
17,65344,3,3,1, 65347
18,65348,4,4,1, 65352
2,65353,2,2,1, 65355
24,65354,1,1,0, 65355
21,65352,5,5,1, 65357
1,65356,1,1,0, 65357
3,65357,3,3,1, 65360
25,65360,2,2,1, 65362
28,65359,5,5,1, 65364
8,65366,1,1,0, 65367
18,65373,4,4,1, 65377
20,65373,6,6,1, 65379
2,65378,2,2,1, 65380
24,65379,1,1,1, 65380
1,65381,1,1,1, 65382
3,65382,3,3,1, 65385
30,65383,3,3,1, 65386
25,65385,2,2,1, 65387
31,65386,2,2,1, 65388
28,65384,5,5,1, 65389
8,65391,1,1,0, 65392
18,65398,4,4,1, 65402
24,65404,1,1,0, 65405
21,65402,5,5,1, 65407
1,65406,1,1,0, 65407
27,65407,4,4,1, 65411
30,65408,3,3,1, 65411
25,65410,2,2,1, 65412
28,65409,5,5,1, 65414
8,65416,1,1,0, 65417
18,65423,4,4,1, 65427
2,65428,2,2,1, 65430
24,65429,1,1,1, 65430
19,65426,5,5,1, 65431
21,65427,5,5,1, 65432
1,65431,1,1,1, 65432
27,65432,4,4,1, 65436
30,65433,3,3,1, 65436
29,65438,4,4,1, 65442
8,65441,1,1,1, 65442
13,65444,4,6,1, 65450
24,65454,1,1,1, 65455
21,65452,5,5,1, 65457
31,65461,2,2,1, 65463
8,65466,1,1,0, 65467
13,65469,4,6,1, 65475
24,65479,1,1,0, 65480
30,65483,3,3,1, 65486
31,65486,2,2,1, 65488
29,65488,4,4,1, 65492
8,65491,1,1,0, 65492
24,65504,1,1,1, 65505
21,65502,5,5,1, 65507
30,65508,3,3,1, 65511
31,65511,2,2,1, 65513
8,65516,1,1,1, 65517
24,65529,1,1,0, 65530
30,65533,3,3,1, 65536
31,65536,2,2,1, 65538
8,65541,1,1,0, 65542
17,65544,3,3,1, 65547
13,65544,4,6,1, 65550
20,65548,6,6,1, 65554
2,65553,2,2,1, 65555
24,65554,1,1,0, 65555
19,65551,5,5,1, 65556
21,65552,5,5,1, 65557
1,65556,1,1,1, 65557
30,65558,3,3,1, 65561
31,65561,2,2,1, 65563
8,65566,1,1,0, 65567
17,65569,3,3,1, 65572
13,65569,4,6,1, 65575
24,65579,1,1,0, 65580
1,65581,1,1,1, 65582
27,65582,4,4,1, 65586
25,65585,2,2,1, 65587
8,65591,1,1,1, 65592
20,65598,6,6,1, 65604
2,65603,2,2,1, 65605
24,65604,1,1,1, 65605
21,65602,5,5,1, 65607
1,65606,1,1,0, 65607
25,65610,2,2,1, 65612
29,65613,4,4,1, 65617
8,65616,1,1,1, 65617
17,65619,3,3,1, 65622
18,65623,4,4,1, 65627
24,65629,1,1,0, 65630
19,65626,5,5,1, 65631
1,65631,1,1,0, 65632
3,65632,3,3,1, 65635
27,65632,4,4,1, 65636
25,65635,2,2,1, 65637
28,65634,5,5,1, 65639
29,65638,4,4,1, 65642
8,65641,1,1,1, 65642
17,65644,3,3,1, 65647
13,65644,4,6,1, 65650
18,65648,4,4,1, 65652
2,65653,2,2,1, 65655
24,65654,1,1,0, 65655
21,65652,5,5,1, 65657
1,65656,1,1,0, 65657
3,65657,3,3,1, 65660
31,65661,2,2,1, 65663
28,65659,5,5,1, 65664
29,65663,4,4,1, 65667
8,65666,1,1,1, 65667
17,65669,3,3,1, 65672
20,65673,6,6,1, 65679
2,65678,2,2,1, 65680
24,65679,1,1,0, 65680
1,65681,1,1,1, 65682
3,65682,3,3,1, 65685
29,65688,4,4,1, 65692
8,65691,1,1,0, 65692
13,65694,4,6,1, 65700
24,65704,1,1,1, 65705
21,65702,5,5,1, 65707
30,65708,3,3,1, 65711
31,65711,2,2,1, 65713
8,65716,1,1,0, 65717
24,65729,1,1,1, 65730
30,65733,3,3,1, 65736
8,65741,1,1,0, 65742
24,65754,1,1,0, 65755
31,65761,2,2,1, 65763
8,65766,1,1,1, 65767
13,65769,4,6,1, 65775
24,65779,1,1,1, 65780
30,65783,3,3,1, 65786
29,65788,4,4,1, 65792
8,65791,1,1,0, 65792
17,65794,3,3,1, 65797
24,65804,1,1,1, 65805
21,65802,5,5,1, 65807
1,65806,1,1,1, 65807
25,65810,2,2,1, 65812
28,65809,5,5,1, 65814
8,65816,1,1,0, 65817
13,65819,4,6,1, 65825
20,65823,6,6,1, 65829
24,65829,1,1,1, 65830
19,65826,5,5,1, 65831
21,65827,5,5,1, 65832
1,65831,1,1,1, 65832
27,65832,4,4,1, 65836
31,65836,2,2,1, 65838
8,65841,1,1,0, 65842
13,65844,4,6,1, 65850
18,65848,4,4,1, 65852
20,65848,6,6,1, 65854
24,65854,1,1,1, 65855
19,65851,5,5,1, 65856
1,65856,1,1,0, 65857
25,65860,2,2,1, 65862
31,65861,2,2,1, 65863
28,65859,5,5,1, 65864
8,65866,1,1,0, 65867
13,65869,4,6,1, 65875
18,65873,4,4,1, 65877
20,65873,6,6,1, 65879
24,65879,1,1,1, 65880
19,65876,5,5,1, 65881
21,65877,5,5,1, 65882
1,65881,1,1,1, 65882
3,65882,3,3,1, 65885
8,65891,1,1,1, 65892
17,65894,3,3,1, 65897
2,65903,2,2,1, 65905
24,65904,1,1,1, 65905
19,65901,5,5,1, 65906
1,65906,1,1,1, 65907
3,65907,3,3,1, 65910
30,65908,3,3,1, 65911
25,65910,2,2,1, 65912
29,65913,4,4,1, 65917
8,65916,1,1,0, 65917
17,65919,3,3,1, 65922
18,65923,4,4,1, 65927
20,65923,6,6,1, 65929
2,65928,2,2,1, 65930
24,65929,1,1,1, 65930
19,65926,5,5,1, 65931
21,65927,5,5,1, 65932
1,65931,1,1,0, 65932
3,65932,3,3,1, 65935
31,65936,2,2,1, 65938
29,65938,4,4,1, 65942
8,65941,1,1,0, 65942
24,65954,1,1,1, 65955
30,65958,3,3,1, 65961
8,65966,1,1,1, 65967
24,65979,1,1,1, 65980
21,65977,5,5,1, 65982
29,65988,4,4,1, 65992
8,65991,1,1,1, 65992
13,65994,4,6,1, 66000
24,66004,1,1,0, 66005
8,66016,1,1,1, 66017
13,66019,4,6,1, 66025
24,66029,1,1,0, 66030
21,66027,5,5,1, 66032
31,66036,2,2,1, 66038
29,66038,4,4,1, 66042
8,66041,1,1,0, 66042
2,66053,2,2,1, 66055
24,66054,1,1,1, 66055
1,66056,1,1,1, 66057
3,66057,3,3,1, 66060
27,66057,4,4,1, 66061
30,66058,3,3,1, 66061
28,66059,5,5,1, 66064
29,66063,4,4,1, 66067
8,66066,1,1,1, 66067
13,66069,4,6,1, 66075
18,66073,4,4,1, 66077
20,66073,6,6,1, 66079
2,66078,2,2,1, 66080
24,66079,1,1,0, 66080
1,66081,1,1,1, 66082
3,66082,3,3,1, 66085
30,66083,3,3,1, 66086
8,66091,1,1,1, 66092
17,66094,3,3,1, 66097
18,66098,4,4,1, 66102
20,66098,6,6,1, 66104
2,66103,2,2,1, 66105
24,66104,1,1,1, 66105
21,66102,5,5,1, 66107
1,66106,1,1,1, 66107
3,66107,3,3,1, 66110
25,66110,2,2,1, 66112
31,66111,2,2,1, 66113
8,66116,1,1,0, 66117
2,66128,2,2,1, 66130
24,66129,1,1,0, 66130
19,66126,5,5,1, 66131
21,66127,5,5,1, 66132
1,66131,1,1,1, 66132
3,66132,3,3,1, 66135
27,66132,4,4,1, 66136
28,66134,5,5,1, 66139
8,66141,1,1,1, 66142
13,66144,4,6,1, 66150
18,66148,4,4,1, 66152
20,66148,6,6,1, 66154
2,66153,2,2,1, 66155
24,66154,1,1,1, 66155
1,66156,1,1,1, 66157
3,66157,3,3,1, 66160
31,66161,2,2,1, 66163
8,66166,1,1,0, 66167
13,66169,4,6,1, 66175
24,66179,1,1,0, 66180
21,66177,5,5,1, 66182
30,66183,3,3,1, 66186
31,66186,2,2,1, 66188
8,66191,1,1,1, 66192
24,66204,1,1,0, 66205
21,66202,5,5,1, 66207
30,66208,3,3,1, 66211
31,66211,2,2,1, 66213
8,66216,1,1,0, 66217
13,66219,4,6,1, 66225
24,66229,1,1,0, 66230
21,66227,5,5,1, 66232
30,66233,3,3,1, 66236
8,66241,1,1,0, 66242
13,66244,4,6,1, 66250
24,66254,1,1,0, 66255
21,66252,5,5,1, 66257
30,66258,3,3,1, 66261
31,66261,2,2,1, 66263
29,66263,4,4,1, 66267
8,66266,1,1,0, 66267
18,66273,4,4,1, 66277
1,66281,1,1,1, 66282
3,66282,3,3,1, 66285
28,66284,5,5,1, 66289
8,66291,1,1,1, 66292
18,66298,4,4,1, 66302
20,66298,6,6,1, 66304
19,66301,5,5,1, 66306
1,66306,1,1,0, 66307
3,66307,3,3,1, 66310
27,66307,4,4,1, 66311
28,66309,5,5,1, 66314
8,66316,1,1,1, 66317
18,66323,4,4,1, 66327
20,66323,6,6,1, 66329
1,66331,1,1,0, 66332
3,66332,3,3,1, 66335
27,66332,4,4,1, 66336
8,66341,1,1,0, 66342
17,66344,3,3,1, 66347
18,66348,4,4,1, 66352
2,66353,2,2,1, 66355
1,66356,1,1,1, 66357
28,66359,5,5,1, 66364
8,66366,1,1,1, 66367
20,66373,6,6,1, 66379
2,66378,2,2,1, 66380
24,66379,1,1,0, 66380
21,66377,5,5,1, 66382
1,66381,1,1,0, 66382
3,66382,3,3,1, 66385
27,66382,4,4,1, 66386
30,66383,3,3,1, 66386
25,66385,2,2,1, 66387
31,66386,2,2,1, 66388
29,66388,4,4,1, 66392
8,66391,1,1,0, 66392
17,66394,3,3,1, 66397
13,66394,4,6,1, 66400
20,66398,6,6,1, 66404
24,66404,1,1,1, 66405
19,66401,5,5,1, 66406
1,66406,1,1,0, 66407
27,66407,4,4,1, 66411
30,66408,3,3,1, 66411
25,66410,2,2,1, 66412
31,66411,2,2,1, 66413
8,66416,1,1,1, 66417
24,66429,1,1,1, 66430
8,66441,1,1,1, 66442
24,66454,1,1,0, 66455
8,66466,1,1,1, 66467
24,66479,1,1,0, 66480
8,66491,1,1,1, 66492
24,66504,1,1,1, 66505
8,66516,1,1,0, 66517
17,66519,3,3,1, 66522
13,66519,4,6,1, 66525
24,66529,1,1,1, 66530
19,66526,5,5,1, 66531
1,66531,1,1,0, 66532
8,66541,1,1,1, 66542
13,66544,4,6,1, 66550
18,66548,4,4,1, 66552
24,66554,1,1,0, 66555
21,66552,5,5,1, 66557
1,66556,1,1,0, 66557
31,66561,2,2,1, 66563
29,66563,4,4,1, 66567
8,66566,1,1,1, 66567
24,66579,1,1,1, 66580
1,66581,1,1,0, 66582
31,66586,2,2,1, 66588
29,66588,4,4,1, 66592
8,66591,1,1,1, 66592
17,66594,3,3,1, 66597
18,66598,4,4,1, 66602
24,66604,1,1,0, 66605
19,66601,5,5,1, 66606
21,66602,5,5,1, 66607
1,66606,1,1,0, 66607
27,66607,4,4,1, 66611
30,66608,3,3,1, 66611
25,66610,2,2,1, 66612
31,66611,2,2,1, 66613
8,66616,1,1,0, 66617
17,66619,3,3,1, 66622
18,66623,4,4,1, 66627
20,66623,6,6,1, 66629
24,66629,1,1,0, 66630
19,66626,5,5,1, 66631
1,66631,1,1,1, 66632
27,66632,4,4,1, 66636
30,66633,3,3,1, 66636
25,66635,2,2,1, 66637
31,66636,2,2,1, 66638
29,66638,4,4,1, 66642
8,66641,1,1,0, 66642
20,66648,6,6,1, 66654
2,66653,2,2,1, 66655
24,66654,1,1,0, 66655
19,66651,5,5,1, 66656
21,66652,5,5,1, 66657
1,66656,1,1,0, 66657
30,66658,3,3,1, 66661
31,66661,2,2,1, 66663
8,66666,1,1,1, 66667
13,66669,4,6,1, 66675
18,66673,4,4,1, 66677
20,66673,6,6,1, 66679
2,66678,2,2,1, 66680
24,66679,1,1,1, 66680
19,66676,5,5,1, 66681
1,66681,1,1,1, 66682
25,66685,2,2,1, 66687
28,66684,5,5,1, 66689
29,66688,4,4,1, 66692
8,66691,1,1,1, 66692
17,66694,3,3,1, 66697
13,66694,4,6,1, 66700
24,66704,1,1,0, 66705
21,66702,5,5,1, 66707
1,66706,1,1,1, 66707
25,66710,2,2,1, 66712
31,66711,2,2,1, 66713
8,66716,1,1,1, 66717
13,66719,4,6,1, 66725
18,66723,4,4,1, 66727
2,66728,2,2,1, 66730
24,66729,1,1,1, 66730
19,66726,5,5,1, 66731
1,66731,1,1,1, 66732
3,66732,3,3,1, 66735
25,66735,2,2,1, 66737
31,66736,2,2,1, 66738
8,66741,1,1,0, 66742
18,66748,4,4,1, 66752
2,66753,2,2,1, 66755
24,66754,1,1,0, 66755
19,66751,5,5,1, 66756
21,66752,5,5,1, 66757
1,66756,1,1,1, 66757
27,66757,4,4,1, 66761
30,66758,3,3,1, 66761
8,66766,1,1,0, 66767
13,66769,4,6,1, 66775
24,66779,1,1,0, 66780
30,66783,3,3,1, 66786
31,66786,2,2,1, 66788
8,66791,1,1,1, 66792
13,66794,4,6,1, 66800
24,66804,1,1,1, 66805
31,66811,2,2,1, 66813
8,66816,1,1,1, 66817
24,66829,1,1,1, 66830
30,66833,3,3,1, 66836
31,66836,2,2,1, 66838
8,66841,1,1,0, 66842
13,66844,4,6,1, 66850
24,66854,1,1,1, 66855
31,66861,2,2,1, 66863
29,66863,4,4,1, 66867
8,66866,1,1,0, 66867
2,66878,2,2,1, 66880
24,66879,1,1,1, 66880
1,66881,1,1,1, 66882
3,66882,3,3,1, 66885
27,66882,4,4,1, 66886
30,66883,3,3,1, 66886
31,66886,2,2,1, 66888
29,66888,4,4,1, 66892
8,66891,1,1,0, 66892
17,66894,3,3,1, 66897
13,66894,4,6,1, 66900
18,66898,4,4,1, 66902
20,66898,6,6,1, 66904
2,66903,2,2,1, 66905
24,66904,1,1,1, 66905
19,66901,5,5,1, 66906
21,66902,5,5,1, 66907
1,66906,1,1,1, 66907
3,66907,3,3,1, 66910
25,66910,2,2,1, 66912
28,66909,5,5,1, 66914
8,66916,1,1,1, 66917
17,66919,3,3,1, 66922
2,66928,2,2,1, 66930
24,66929,1,1,1, 66930
19,66926,5,5,1, 66931
21,66927,5,5,1, 66932
1,66931,1,1,1, 66932
3,66932,3,3,1, 66935
25,66935,2,2,1, 66937
8,66941,1,1,1, 66942
13,66944,4,6,1, 66950
18,66948,4,4,1, 66952
20,66948,6,6,1, 66954
24,66954,1,1,0, 66955
19,66951,5,5,1, 66956
1,66956,1,1,1, 66957
27,66957,4,4,1, 66961
30,66958,3,3,1, 66961
31,66961,2,2,1, 66963
29,66963,4,4,1, 66967
8,66966,1,1,1, 66967
17,66969,3,3,1, 66972
13,66969,4,6,1, 66975
18,66973,4,4,1, 66977
20,66973,6,6,1, 66979
24,66979,1,1,0, 66980
21,66977,5,5,1, 66982
30,66983,3,3,1, 66986
31,66986,2,2,1, 66988
29,66988,4,4,1, 66992
8,66991,1,1,1, 66992
24,67004,1,1,0, 67005
31,67011,2,2,1, 67013
29,67013,4,4,1, 67017
8,67016,1,1,1, 67017
24,67029,1,1,1, 67030
21,67027,5,5,1, 67032
31,67036,2,2,1, 67038
8,67041,1,1,1, 67042
24,67054,1,1,0, 67055
21,67052,5,5,1, 67057
8,67066,1,1,0, 67067
13,67069,4,6,1, 67075
24,67079,1,1,1, 67080
21,67077,5,5,1, 67082
25,67085,2,2,1, 67087
31,67086,2,2,1, 67088
28,67084,5,5,1, 67089
8,67091,1,1,1, 67092
17,67094,3,3,1, 67097
13,67094,4,6,1, 67100
18,67098,4,4,1, 67102
2,67103,2,2,1, 67105
24,67104,1,1,1, 67105
19,67101,5,5,1, 67106
1,67106,1,1,1, 67107
3,67107,3,3,1, 67110
27,67107,4,4,1, 67111
25,67110,2,2,1, 67112
31,67111,2,2,1, 67113
28,67109,5,5,1, 67114
29,67113,4,4,1, 67117
8,67116,1,1,1, 67117
17,67119,3,3,1, 67122
18,67123,4,4,1, 67127
2,67128,2,2,1, 67130
24,67129,1,1,0, 67130
19,67126,5,5,1, 67131
21,67127,5,5,1, 67132
1,67131,1,1,1, 67132
25,67135,2,2,1, 67137
31,67136,2,2,1, 67138
8,67141,1,1,1, 67142
17,67144,3,3,1, 67147
2,67153,2,2,1, 67155
24,67154,1,1,1, 67155
19,67151,5,5,1, 67156
21,67152,5,5,1, 67157
1,67156,1,1,1, 67157
30,67158,3,3,1, 67161
28,67159,5,5,1, 67164
8,67166,1,1,1, 67167
13,67169,4,6,1, 67175
20,67173,6,6,1, 67179
2,67178,2,2,1, 67180
24,67179,1,1,0, 67180
1,67181,1,1,1, 67182
3,67182,3,3,1, 67185
25,67185,2,2,1, 67187
31,67186,2,2,1, 67188
28,67184,5,5,1, 67189
29,67188,4,4,1, 67192
8,67191,1,1,0, 67192
13,67194,4,6,1, 67200
8,67216,1,1,0, 67217
8,67241,1,1,0, 67242
8,67266,1,1,1, 67267
8,67291,1,1,0, 67292
18,67298,4,4,1, 67302
20,67298,6,6,1, 67304
2,67303,2,2,1, 67305
24,67304,1,1,0, 67305
19,67301,5,5,1, 67306
21,67302,5,5,1, 67307
1,67306,1,1,0, 67307
30,67308,3,3,1, 67311
25,67310,2,2,1, 67312
8,67316,1,1,1, 67317
18,67323,4,4,1, 67327
24,67329,1,1,1, 67330
19,67326,5,5,1, 67331
21,67327,5,5,1, 67332
1,67331,1,1,0, 67332
30,67333,3,3,1, 67336
25,67335,2,2,1, 67337
28,67334,5,5,1, 67339
8,67341,1,1,0, 67342
24,67354,1,1,0, 67355
21,67352,5,5,1, 67357
1,67356,1,1,1, 67357
31,67361,2,2,1, 67363
28,67359,5,5,1, 67364
8,67366,1,1,0, 67367
17,67369,3,3,1, 67372
13,67369,4,6,1, 67375
2,67378,2,2,1, 67380
24,67379,1,1,1, 67380
21,67377,5,5,1, 67382
1,67381,1,1,1, 67382
3,67382,3,3,1, 67385
27,67382,4,4,1, 67386
29,67388,4,4,1, 67392
8,67391,1,1,1, 67392
13,67394,4,6,1, 67400
20,67398,6,6,1, 67404
24,67404,1,1,0, 67405
19,67401,5,5,1, 67406
1,67406,1,1,1, 67407
27,67407,4,4,1, 67411
31,67411,2,2,1, 67413
29,67413,4,4,1, 67417
8,67416,1,1,1, 67417
18,67423,4,4,1, 67427
24,67429,1,1,0, 67430
21,67427,5,5,1, 67432
1,67431,1,1,1, 67432
27,67432,4,4,1, 67436
30,67433,3,3,1, 67436
28,67434,5,5,1, 67439
29,67438,4,4,1, 67442
8,67441,1,1,1, 67442
18,67448,4,4,1, 67452
20,67448,6,6,1, 67454
2,67453,2,2,1, 67455
24,67454,1,1,1, 67455
19,67451,5,5,1, 67456
1,67456,1,1,1, 67457
30,67458,3,3,1, 67461
28,67459,5,5,1, 67464
8,67466,1,1,0, 67467
17,67469,3,3,1, 67472
18,67473,4,4,1, 67477
24,67479,1,1,0, 67480
19,67476,5,5,1, 67481
21,67477,5,5,1, 67482
1,67481,1,1,1, 67482
3,67482,3,3,1, 67485
30,67483,3,3,1, 67486
29,67488,4,4,1, 67492
8,67491,1,1,1, 67492
13,67494,4,6,1, 67500
24,67504,1,1,1, 67505
30,67508,3,3,1, 67511
31,67511,2,2,1, 67513
8,67516,1,1,1, 67517
13,67519,4,6,1, 67525
24,67529,1,1,1, 67530
21,67527,5,5,1, 67532
31,67536,2,2,1, 67538
8,67541,1,1,1, 67542
24,67554,1,1,0, 67555
31,67561,2,2,1, 67563
8,67566,1,1,1, 67567
24,67579,1,1,1, 67580
30,67583,3,3,1, 67586
29,67588,4,4,1, 67592
8,67591,1,1,0, 67592
17,67594,3,3,1, 67597
18,67598,4,4,1, 67602
24,67604,1,1,1, 67605
21,67602,5,5,1, 67607
1,67606,1,1,1, 67607
27,67607,4,4,1, 67611
25,67610,2,2,1, 67612
31,67611,2,2,1, 67613
29,67613,4,4,1, 67617
8,67616,1,1,1, 67617
18,67623,4,4,1, 67627
24,67629,1,1,0, 67630
1,67631,1,1,1, 67632
27,67632,4,4,1, 67636
30,67633,3,3,1, 67636
29,67638,4,4,1, 67642
8,67641,1,1,0, 67642
17,67644,3,3,1, 67647
18,67648,4,4,1, 67652
20,67648,6,6,1, 67654
24,67654,1,1,0, 67655
19,67651,5,5,1, 67656
21,67652,5,5,1, 67657
1,67656,1,1,1, 67657
3,67657,3,3,1, 67660
30,67658,3,3,1, 67661
25,67660,2,2,1, 67662
31,67661,2,2,1, 67663
8,67666,1,1,0, 67667
2,67678,2,2,1, 67680
24,67679,1,1,0, 67680
1,67681,1,1,1, 67682
27,67682,4,4,1, 67686
30,67683,3,3,1, 67686
25,67685,2,2,1, 67687
31,67686,2,2,1, 67688
8,67691,1,1,0, 67692
17,67694,3,3,1, 67697
20,67698,6,6,1, 67704
24,67704,1,1,1, 67705
19,67701,5,5,1, 67706
1,67706,1,1,0, 67707
27,67707,4,4,1, 67711
30,67708,3,3,1, 67711
25,67710,2,2,1, 67712
28,67709,5,5,1, 67714
8,67716,1,1,1, 67717
17,67719,3,3,1, 67722
13,67719,4,6,1, 67725
2,67728,2,2,1, 67730
24,67729,1,1,0, 67730
19,67726,5,5,1, 67731
1,67731,1,1,0, 67732
30,67733,3,3,1, 67736
28,67734,5,5,1, 67739
29,67738,4,4,1, 67742
8,67741,1,1,0, 67742
13,67744,4,6,1, 67750
24,67754,1,1,1, 67755
21,67752,5,5,1, 67757
31,67761,2,2,1, 67763
29,67763,4,4,1, 67767
8,67766,1,1,0, 67767
13,67769,4,6,1, 67775
24,67779,1,1,1, 67780
21,67777,5,5,1, 67782
8,67791,1,1,0, 67792
8,67816,1,1,0, 67817
8,67841,1,1,0, 67842
17,67844,3,3,1, 67847
18,67848,4,4,1, 67852
20,67848,6,6,1, 67854
2,67853,2,2,1, 67855
1,67856,1,1,1, 67857
27,67857,4,4,1, 67861
25,67860,2,2,1, 67862
8,67866,1,1,0, 67867
20,67873,6,6,1, 67879
19,67876,5,5,1, 67881
1,67881,1,1,0, 67882
3,67882,3,3,1, 67885
27,67882,4,4,1, 67886
30,67883,3,3,1, 67886
28,67884,5,5,1, 67889
8,67891,1,1,1, 67892
18,67898,4,4,1, 67902
2,67903,2,2,1, 67905
24,67904,1,1,1, 67905
19,67901,5,5,1, 67906
1,67906,1,1,1, 67907
3,67907,3,3,1, 67910
27,67907,4,4,1, 67911
25,67910,2,2,1, 67912
8,67916,1,1,0, 67917
17,67919,3,3,1, 67922
18,67923,4,4,1, 67927
20,67923,6,6,1, 67929
24,67929,1,1,0, 67930
19,67926,5,5,1, 67931
8,67941,1,1,0, 67942
24,67954,1,1,1, 67955
8,67966,1,1,1, 67967
24,67979,1,1,0, 67980
29,67988,4,4,1, 67992
8,67991,1,1,0, 67992
13,67994,4,6,1, 68000
24,68004,1,1,1, 68005
8,68016,1,1,0, 68017
24,68029,1,1,1, 68030
31,68036,2,2,1, 68038
29,68038,4,4,1, 68042
8,68041,1,1,0, 68042
17,68044,3,3,1, 68047
2,68053,2,2,1, 68055
24,68054,1,1,0, 68055
19,68051,5,5,1, 68056
1,68056,1,1,1, 68057
27,68057,4,4,1, 68061
25,68060,2,2,1, 68062
28,68059,5,5,1, 68064
8,68066,1,1,1, 68067
17,68069,3,3,1, 68072
24,68079,1,1,0, 68080
21,68077,5,5,1, 68082
1,68081,1,1,0, 68082
3,68082,3,3,1, 68085
27,68082,4,4,1, 68086
30,68083,3,3,1, 68086
25,68085,2,2,1, 68087
29,68088,4,4,1, 68092
8,68091,1,1,0, 68092
13,68094,4,6,1, 68100
20,68098,6,6,1, 68104
24,68104,1,1,1, 68105
19,68101,5,5,1, 68106
1,68106,1,1,0, 68107
27,68107,4,4,1, 68111
30,68108,3,3,1, 68111
31,68111,2,2,1, 68113
8,68116,1,1,0, 68117
17,68119,3,3,1, 68122
13,68119,4,6,1, 68125
18,68123,4,4,1, 68127
20,68123,6,6,1, 68129
2,68128,2,2,1, 68130
24,68129,1,1,0, 68130
19,68126,5,5,1, 68131
1,68131,1,1,1, 68132
3,68132,3,3,1, 68135
27,68132,4,4,1, 68136
30,68133,3,3,1, 68136
8,68141,1,1,0, 68142
17,68144,3,3,1, 68147
24,68154,1,1,1, 68155
1,68156,1,1,1, 68157
29,68163,4,4,1, 68167
8,68166,1,1,1, 68167
17,68169,3,3,1, 68172
2,68178,2,2,1, 68180
24,68179,1,1,0, 68180
1,68181,1,1,1, 68182
30,68183,3,3,1, 68186
25,68185,2,2,1, 68187
31,68186,2,2,1, 68188
29,68188,4,4,1, 68192
8,68191,1,1,1, 68192
17,68194,3,3,1, 68197
13,68194,4,6,1, 68200
24,68204,1,1,0, 68205
19,68201,5,5,1, 68206
21,68202,5,5,1, 68207
1,68206,1,1,0, 68207
27,68207,4,4,1, 68211
30,68208,3,3,1, 68211
25,68210,2,2,1, 68212
31,68211,2,2,1, 68213
8,68216,1,1,0, 68217
24,68229,1,1,1, 68230
21,68227,5,5,1, 68232
31,68236,2,2,1, 68238
29,68238,4,4,1, 68242
8,68241,1,1,0, 68242
13,68244,4,6,1, 68250
24,68254,1,1,1, 68255
30,68258,3,3,1, 68261
8,68266,1,1,1, 68267
24,68279,1,1,1, 68280
30,68283,3,3,1, 68286
31,68286,2,2,1, 68288
29,68288,4,4,1, 68292
8,68291,1,1,1, 68292
13,68294,4,6,1, 68300
24,68304,1,1,0, 68305
30,68308,3,3,1, 68311
29,68313,4,4,1, 68317
8,68316,1,1,1, 68317
17,68319,3,3,1, 68322
13,68319,4,6,1, 68325
18,68323,4,4,1, 68327
2,68328,2,2,1, 68330
24,68329,1,1,1, 68330
1,68331,1,1,1, 68332
3,68332,3,3,1, 68335
27,68332,4,4,1, 68336
31,68336,2,2,1, 68338
8,68341,1,1,0, 68342
17,68344,3,3,1, 68347
18,68348,4,4,1, 68352
20,68348,6,6,1, 68354
24,68354,1,1,0, 68355
1,68356,1,1,1, 68357
3,68357,3,3,1, 68360
27,68357,4,4,1, 68361
25,68360,2,2,1, 68362
31,68361,2,2,1, 68363
28,68359,5,5,1, 68364
29,68363,4,4,1, 68367
8,68366,1,1,0, 68367
13,68369,4,6,1, 68375
18,68373,4,4,1, 68377
20,68373,6,6,1, 68379
2,68378,2,2,1, 68380
24,68379,1,1,1, 68380
19,68376,5,5,1, 68381
21,68377,5,5,1, 68382
1,68381,1,1,0, 68382
27,68382,4,4,1, 68386
31,68386,2,2,1, 68388
29,68388,4,4,1, 68392
8,68391,1,1,1, 68392
17,68394,3,3,1, 68397
13,68394,4,6,1, 68400
2,68403,2,2,1, 68405
24,68404,1,1,1, 68405
1,68406,1,1,0, 68407
29,68413,4,4,1, 68417
8,68416,1,1,0, 68417
18,68423,4,4,1, 68427
24,68429,1,1,0, 68430
1,68431,1,1,0, 68432
27,68432,4,4,1, 68436
25,68435,2,2,1, 68437
29,68438,4,4,1, 68442
8,68441,1,1,0, 68442
13,68444,4,6,1, 68450
20,68448,6,6,1, 68454
24,68454,1,1,0, 68455
1,68456,1,1,1, 68457
3,68457,3,3,1, 68460
25,68460,2,2,1, 68462
29,68463,4,4,1, 68467
8,68466,1,1,1, 68467
24,68479,1,1,1, 68480
30,68483,3,3,1, 68486
8,68491,1,1,1, 68492
24,68504,1,1,1, 68505
29,68513,4,4,1, 68517
8,68516,1,1,0, 68517
24,68529,1,1,0, 68530
21,68527,5,5,1, 68532
8,68541,1,1,1, 68542
24,68554,1,1,0, 68555
21,68552,5,5,1, 68557
30,68558,3,3,1, 68561
8,68566,1,1,1, 68567
17,68569,3,3,1, 68572
18,68573,4,4,1, 68577
24,68579,1,1,1, 68580
19,68576,5,5,1, 68581
1,68581,1,1,0, 68582
27,68582,4,4,1, 68586
31,68586,2,2,1, 68588
29,68588,4,4,1, 68592
8,68591,1,1,1, 68592
18,68598,4,4,1, 68602
2,68603,2,2,1, 68605
24,68604,1,1,0, 68605
19,68601,5,5,1, 68606
21,68602,5,5,1, 68607
1,68606,1,1,0, 68607
27,68607,4,4,1, 68611
25,68610,2,2,1, 68612
31,68611,2,2,1, 68613
29,68613,4,4,1, 68617
8,68616,1,1,1, 68617
17,68619,3,3,1, 68622
18,68623,4,4,1, 68627
2,68628,2,2,1, 68630
24,68629,1,1,0, 68630
19,68626,5,5,1, 68631
21,68627,5,5,1, 68632
1,68631,1,1,1, 68632
30,68633,3,3,1, 68636
8,68641,1,1,0, 68642
13,68644,4,6,1, 68650
20,68648,6,6,1, 68654
24,68654,1,1,0, 68655
19,68651,5,5,1, 68656
1,68656,1,1,0, 68657
30,68658,3,3,1, 68661
25,68660,2,2,1, 68662
31,68661,2,2,1, 68663
8,68666,1,1,1, 68667
17,68669,3,3,1, 68672
20,68673,6,6,1, 68679
2,68678,2,2,1, 68680
24,68679,1,1,1, 68680
1,68681,1,1,0, 68682
30,68683,3,3,1, 68686
29,68688,4,4,1, 68692
8,68691,1,1,1, 68692
17,68694,3,3,1, 68697
13,68694,4,6,1, 68700
18,68698,4,4,1, 68702
2,68703,2,2,1, 68705
24,68704,1,1,0, 68705
19,68701,5,5,1, 68706
1,68706,1,1,1, 68707
25,68710,2,2,1, 68712
28,68709,5,5,1, 68714
29,68713,4,4,1, 68717
8,68716,1,1,1, 68717
24,68729,1,1,1, 68730
21,68727,5,5,1, 68732
30,68733,3,3,1, 68736
29,68738,4,4,1, 68742
8,68741,1,1,1, 68742
24,68754,1,1,1, 68755
21,68752,5,5,1, 68757
29,68763,4,4,1, 68767
8,68766,1,1,0, 68767
13,68769,4,6,1, 68775
24,68779,1,1,1, 68780
29,68788,4,4,1, 68792
8,68791,1,1,1, 68792
13,68794,4,6,1, 68800
24,68804,1,1,1, 68805
21,68802,5,5,1, 68807
31,68811,2,2,1, 68813
29,68813,4,4,1, 68817
8,68816,1,1,1, 68817
17,68819,3,3,1, 68822
13,68819,4,6,1, 68825
18,68823,4,4,1, 68827
24,68829,1,1,1, 68830
21,68827,5,5,1, 68832
1,68831,1,1,0, 68832
3,68832,3,3,1, 68835
27,68832,4,4,1, 68836
30,68833,3,3,1, 68836
31,68836,2,2,1, 68838
28,68834,5,5,1, 68839
29,68838,4,4,1, 68842
8,68841,1,1,1, 68842
17,68844,3,3,1, 68847
13,68844,4,6,1, 68850
20,68848,6,6,1, 68854
24,68854,1,1,0, 68855
19,68851,5,5,1, 68856
1,68856,1,1,1, 68857
3,68857,3,3,1, 68860
27,68857,4,4,1, 68861
25,68860,2,2,1, 68862
31,68861,2,2,1, 68863
28,68859,5,5,1, 68864
29,68863,4,4,1, 68867
8,68866,1,1,0, 68867
17,68869,3,3,1, 68872
13,68869,4,6,1, 68875
20,68873,6,6,1, 68879
2,68878,2,2,1, 68880
24,68879,1,1,1, 68880
21,68877,5,5,1, 68882
1,68881,1,1,1, 68882
27,68882,4,4,1, 68886
29,68888,4,4,1, 68892
8,68891,1,1,0, 68892
17,68894,3,3,1, 68897
18,68898,4,4,1, 68902
24,68904,1,1,0, 68905
21,68902,5,5,1, 68907
1,68906,1,1,0, 68907
27,68907,4,4,1, 68911
30,68908,3,3,1, 68911
28,68909,5,5,1, 68914
8,68916,1,1,1, 68917
17,68919,3,3,1, 68922
20,68923,6,6,1, 68929
24,68929,1,1,1, 68930
19,68926,5,5,1, 68931
21,68927,5,5,1, 68932
30,68933,3,3,1, 68936
8,68941,1,1,1, 68942
24,68954,1,1,0, 68955
21,68952,5,5,1, 68957
31,68961,2,2,1, 68963
29,68963,4,4,1, 68967
8,68966,1,1,0, 68967
24,68979,1,1,0, 68980
30,68983,3,3,1, 68986
31,68986,2,2,1, 68988
8,68991,1,1,1, 68992
24,69004,1,1,0, 69005
30,69008,3,3,1, 69011
31,69011,2,2,1, 69013
8,69016,1,1,0, 69017
24,69029,1,1,0, 69030
3,69032,3,3,1, 69035
28,69034,5,5,1, 69039
8,69041,1,1,0, 69042
18,69048,4,4,1, 69052
24,69054,1,1,0, 69055
1,69056,1,1,0, 69057
27,69057,4,4,1, 69061
30,69058,3,3,1, 69061
28,69059,5,5,1, 69064
8,69066,1,1,1, 69067
18,69073,4,4,1, 69077
24,69079,1,1,1, 69080
19,69076,5,5,1, 69081
1,69081,1,1,0, 69082
21,69077,5,7,1, 69084
3,69082,3,3,1, 69085
25,69085,2,2,1, 69087
31,69086,2,2,1, 69088
8,69091,1,1,0, 69092
17,69094,3,3,1, 69097
13,69094,4,8,1, 69102
18,69098,4,4,1, 69102
20,69098,6,6,1, 69104
24,69104,1,1,1, 69105
1,69106,1,1,0, 69107
21,69102,5,7,1, 69109
3,69107,3,3,1, 69110
27,69107,4,4,1, 69111
30,69108,3,3,1, 69111
31,69111,2,2,1, 69113
28,69109,5,5,1, 69114
8,69116,1,1,1, 69117
17,69119,3,3,1, 69122
18,69123,4,4,1, 69127
24,69129,1,1,1, 69130
19,69126,5,5,1, 69131
1,69131,1,1,1, 69132
31,69136,2,2,1, 69138
8,69141,1,1,0, 69142
18,69148,4,4,1, 69152
24,69154,1,1,1, 69155
1,69156,1,1,1, 69157
30,69158,3,3,1, 69161
25,69160,2,2,1, 69162
8,69166,1,1,0, 69167
17,69169,3,3,1, 69172
24,69179,1,1,1, 69180
1,69181,1,1,1, 69182
31,69186,2,2,1, 69188
8,69191,1,1,1, 69192
17,69194,3,3,1, 69197
18,69198,4,4,1, 69202
24,69204,1,1,1, 69205
1,69206,1,1,0, 69207
21,69202,5,7,1, 69209
30,69208,3,3,1, 69211
25,69210,2,2,1, 69212
28,69209,5,7,1, 69216
8,69216,1,1,0, 69217
17,69219,3,3,1, 69222
13,69219,4,8,1, 69227
24,69229,1,1,0, 69230
8,69241,1,1,1, 69242
24,69254,1,1,1, 69255
8,69266,1,1,0, 69267
24,69279,1,1,0, 69280
31,69286,2,2,1, 69288
8,69291,1,1,0, 69292
24,69304,1,1,0, 69305
31,69311,2,2,1, 69313
8,69316,1,1,0, 69317
24,69329,1,1,0, 69330
1,69331,1,1,0, 69332
28,69334,5,7,1, 69341
8,69341,1,1,0, 69342
13,69344,4,8,1, 69352
18,69348,4,4,1, 69352
24,69354,1,1,1, 69355
19,69351,5,5,1, 69356
1,69356,1,1,0, 69357
25,69360,2,2,1, 69362
28,69359,5,7,1, 69366
8,69366,1,1,0, 69367
18,69373,4,4,1, 69377
20,69373,6,6,1, 69379
24,69379,1,1,1, 69380
1,69381,1,1,1, 69382
21,69377,5,7,1, 69384
30,69383,3,3,1, 69386
25,69385,2,2,1, 69387
31,69386,2,2,1, 69388
28,69384,5,7,1, 69391
8,69391,1,1,1, 69392
13,69394,4,8,1, 69402
18,69398,4,4,1, 69402
24,69404,1,1,1, 69405
19,69401,5,5,1, 69406
1,69406,1,1,1, 69407
30,69408,3,3,1, 69411
25,69410,2,2,1, 69412
31,69411,2,2,1, 69413
28,69409,5,7,1, 69416
8,69416,1,1,1, 69417
17,69419,3,3,1, 69422
18,69423,4,4,1, 69427
20,69423,6,6,1, 69429
2,69428,2,2,1, 69430
24,69429,1,1,0, 69430
1,69431,1,1,0, 69432
31,69436,2,2,1, 69438
28,69434,5,7,1, 69441
8,69441,1,1,1, 69442
13,69444,4,8,1, 69452
18,69448,4,4,1, 69452
2,69453,2,2,1, 69455
24,69454,1,1,0, 69455
1,69456,1,1,0, 69457
21,69452,5,7,1, 69459
31,69461,2,2,1, 69463
8,69466,1,1,1, 69467
24,69479,1,1,1, 69480
30,69483,3,3,1, 69486
8,69491,1,1,0, 69492
24,69504,1,1,1, 69505
31,69511,2,2,1, 69513
8,69516,1,1,1, 69517
24,69529,1,1,0, 69530
30,69533,3,3,1, 69536
8,69541,1,1,1, 69542
24,69554,1,1,1, 69555
31,69561,2,2,1, 69563
8,69566,1,1,1, 69567
17,69569,3,3,1, 69572
13,69569,4,8,1, 69577
24,69579,1,1,1, 69580
19,69576,5,5,1, 69581
1,69581,1,1,0, 69582
21,69577,5,7,1, 69584
31,69586,2,2,1, 69588
28,69584,5,7,1, 69591
8,69591,1,1,1, 69592
2,69603,2,2,1, 69605
24,69604,1,1,0, 69605
1,69606,1,1,0, 69607
3,69607,3,3,1, 69610
31,69611,2,2,1, 69613
8,69616,1,1,0, 69617
24,69629,1,1,0, 69630
1,69631,1,1,1, 69632
30,69633,3,3,1, 69636
31,69636,2,2,1, 69638
8,69641,1,1,0, 69642
2,69653,2,2,1, 69655
24,69654,1,1,0, 69655
1,69656,1,1,0, 69657
3,69657,3,3,1, 69660
30,69658,3,3,1, 69661
8,69666,1,1,0, 69667
2,69678,2,2,1, 69680
24,69679,1,1,0, 69680
1,69681,1,1,0, 69682
30,69683,3,3,1, 69686
8,69691,1,1,1, 69692
13,69694,4,8,1, 69702
18,69698,4,4,1, 69702
20,69698,6,6,1, 69704
2,69703,2,2,1, 69705
24,69704,1,1,0, 69705
19,69701,5,5,1, 69706
1,69706,1,1,0, 69707
3,69707,3,3,1, 69710
30,69708,3,3,1, 69711
31,69711,2,2,1, 69713
28,69709,5,7,1, 69716
8,69716,1,1,0, 69717
13,69719,4,8,1, 69727
18,69723,4,4,1, 69727
24,69729,1,1,0, 69730
1,69731,1,1,0, 69732
21,69727,5,7,1, 69734
31,69736,2,2,1, 69738
8,69741,1,1,1, 69742
17,69744,3,3,1, 69747
20,69748,6,6,1, 69754
24,69754,1,1,0, 69755
1,69756,1,1,1, 69757
30,69758,3,3,1, 69761
8,69766,1,1,0, 69767
17,69769,3,3,1, 69772
2,69778,2,2,1, 69780
24,69779,1,1,0, 69780
1,69781,1,1,0, 69782
21,69777,5,7,1, 69784
25,69785,2,2,1, 69787
8,69791,1,1,0, 69792
13,69794,4,8,1, 69802
20,69798,6,6,1, 69804
24,69804,1,1,0, 69805
19,69801,5,5,1, 69806
1,69806,1,1,0, 69807
30,69808,3,3,1, 69811
25,69810,2,2,1, 69812
8,69816,1,1,1, 69817
17,69819,3,3,1, 69822
20,69823,6,6,1, 69829
2,69828,2,2,1, 69830
24,69829,1,1,1, 69830
19,69826,5,5,1, 69831
1,69831,1,1,0, 69832
25,69835,2,2,1, 69837
8,69841,1,1,1, 69842
20,69848,6,6,1, 69854
2,69853,2,2,1, 69855
24,69854,1,1,1, 69855
19,69851,5,5,1, 69856
1,69856,1,1,1, 69857
21,69852,5,7,1, 69859
30,69858,3,3,1, 69861
31,69861,2,2,1, 69863
8,69866,1,1,1, 69867
24,69879,1,1,0, 69880
31,69886,2,2,1, 69888
8,69891,1,1,1, 69892
24,69904,1,1,1, 69905
8,69916,1,1,1, 69917
24,69929,1,1,0, 69930
8,69941,1,1,1, 69942
24,69954,1,1,0, 69955
8,69966,1,1,1, 69967
24,69979,1,1,1, 69980
1,69981,1,1,1, 69982
31,69986,2,2,1, 69988
8,69991,1,1,0, 69992
2,70003,2,2,1, 70005
24,70004,1,1,0, 70005
1,70006,1,1,1, 70007
8,70016,1,1,1, 70017
2,70028,2,2,1, 70030
24,70029,1,1,1, 70030
1,70031,1,1,0, 70032
31,70036,2,2,1, 70038
8,70041,1,1,1, 70042
17,70044,3,3,1, 70047
20,70048,6,6,1, 70054
24,70054,1,1,1, 70055
19,70051,5,5,1, 70056
1,70056,1,1,0, 70057
21,70052,5,7,1, 70059
25,70060,2,2,1, 70062
31,70061,2,2,1, 70063
8,70066,1,1,0, 70067
18,70073,4,4,1, 70077
20,70073,6,6,1, 70079
24,70079,1,1,1, 70080
1,70081,1,1,0, 70082
25,70085,2,2,1, 70087
8,70091,1,1,0, 70092
13,70094,4,8,1, 70102
2,70103,2,2,1, 70105
24,70104,1,1,1, 70105
19,70101,5,5,1, 70106
1,70106,1,1,0, 70107
31,70111,2,2,1, 70113
8,70116,1,1,0, 70117
17,70119,3,3,1, 70122
13,70119,4,8,1, 70127
2,70128,2,2,1, 70130
24,70129,1,1,1, 70130
1,70131,1,1,1, 70132
8,70141,1,1,0, 70142
18,70148,4,4,1, 70152
20,70148,6,6,1, 70154
2,70153,2,2,1, 70155
24,70154,1,1,1, 70155
1,70156,1,1,0, 70157
25,70160,2,2,1, 70162
31,70161,2,2,0, 70163
8,70166,1,1,1, 70167
13,70169,4,8,1, 70177
18,70173,4,4,1, 70177
24,70179,1,1,0, 70180
1,70181,1,1,1, 70182
25,70185,2,2,1, 70187
31,70186,2,2,0, 70188
8,70191,1,1,0, 70192
17,70194,3,3,1, 70197
13,70194,4,8,1, 70202
18,70198,4,4,1, 70202
20,70198,6,6,1, 70204
24,70204,1,1,0, 70205
19,70201,5,5,1, 70206
1,70206,1,1,1, 70207
31,70211,2,2,1, 70213
8,70216,1,1,0, 70217
18,70223,4,4,1, 70227
2,70228,2,2,1, 70230
24,70229,1,1,0, 70230
1,70231,1,1,1, 70232
21,70227,5,7,1, 70234
31,70236,2,2,1, 70238
8,70241,1,1,1, 70242
17,70244,3,3,1, 70247
18,70248,4,4,1, 70252
20,70248,6,6,1, 70254
24,70254,1,1,1, 70255
19,70251,5,5,1, 70256
1,70256,1,1,0, 70257
21,70252,5,7,1, 70259
31,70261,2,2,1, 70263
8,70266,1,1,1, 70267
13,70269,4,8,1, 70277
18,70273,4,4,1, 70277
20,70273,6,6,1, 70279
2,70278,2,2,1, 70280
24,70279,1,1,0, 70280
31,70286,2,2,0, 70288
8,70291,1,1,1, 70292
24,70304,1,1,0, 70305
