Time,  Packets Generated,  Packets Reached,High Priority Packets Generated, High Priority Packets reached, Packet Dropped, Packet Dropped due to Faulty Node, High Prio Packet Dropped due to Faulty Node, Low Prio Packet Dropped due to Faulty Node 
5,1,1,1,1,0,0,0,0
10,6,5,5,4,0,0,0,0
15,8,7,6,6,0,0,0,0
20,17,12,10,9,1,1,0,1
25,25,21,13,12,2,2,1,1
30,32,28,17,16,2,2,1,1
35,45,36,22,19,3,3,1,2
40,56,49,29,26,4,4,1,3
45,63,57,31,29,4,4,1,3
50,76,65,36,32,5,5,1,4
55,87,78,40,36,6,6,1,5
60,94,86,44,42,6,6,1,5
65,107,94,49,44,7,7,2,5
70,118,107,56,53,7,7,2,5
75,125,116,60,56,7,7,2,5
80,138,124,68,62,8,8,2,6
85,149,137,73,69,8,8,2,6
90,156,146,77,73,8,8,2,6
95,169,152,84,77,11,9,3,6
100,180,163,91,86,13,9,3,6
105,187,170,94,90,15,9,3,6
110,200,175,100,92,19,10,4,6
115,211,187,106,100,21,10,4,6
120,218,194,108,104,22,10,4,6
125,231,200,112,107,27,11,4,7
130,242,209,117,111,29,11,4,7
135,249,217,121,117,31,11,4,7
140,262,223,129,119,33,12,5,7
145,273,235,134,127,35,12,5,7
150,280,243,137,131,36,12,5,7
155,293,248,143,134,41,13,6,7
160,304,253,149,136,48,13,6,7
165,311,259,152,140,50,13,6,7
170,324,263,159,142,58,14,7,7
175,335,267,166,143,66,14,7,7
180,342,273,171,148,67,14,7,7
185,355,277,177,151,75,15,7,8
190,366,279,181,151,84,15,7,8
195,373,284,185,154,88,15,7,8
200,386,286,192,156,97,16,7,9
205,397,289,197,158,106,16,7,9
210,404,294,200,161,109,16,7,9
215,417,298,204,164,116,17,8,9
220,428,300,208,164,126,17,8,9
225,435,304,211,168,130,17,8,9
230,448,308,216,170,137,18,9,9
235,459,310,222,172,148,18,9,9
240,466,314,224,175,152,18,9,9
245,479,315,227,175,162,19,9,10
250,490,317,230,177,172,19,9,10
255,497,321,231,179,176,19,9,10
260,510,324,240,182,182,20,10,10
265,521,326,242,183,195,20,10,10
270,528,329,245,185,199,20,10,10
275,541,331,251,186,206,21,10,11
280,552,335,254,189,216,21,10,11
285,559,337,256,189,222,21,10,11
290,572,339,260,190,230,22,10,12
295,583,344,268,195,237,22,10,12
300,590,350,271,199,240,22,10,12
305,603,353,281,202,245,23,11,12
310,614,361,283,209,253,23,11,12
315,621,365,287,213,256,23,11,12
320,634,368,295,216,261,24,12,12
325,645,374,299,222,269,24,12,12
330,652,380,303,227,271,24,12,12
335,665,387,312,233,274,25,13,12
340,676,395,319,240,278,25,13,12
345,683,401,323,246,282,25,13,12
350,696,404,332,248,289,26,14,12
355,707,407,336,251,300,26,14,12
360,714,409,342,253,305,26,14,12
365,727,409,348,253,316,27,15,12
370,738,410,356,254,328,27,15,12
375,745,412,358,255,333,27,15,12
380,758,413,363,256,343,28,16,12
385,769,415,372,258,352,28,16,12
390,776,419,374,260,357,28,16,12
395,789,419,379,260,368,29,17,12
400,800,420,382,261,380,29,17,12
405,807,422,385,262,385,29,17,12
410,820,422,389,262,396,30,17,13
415,831,422,391,262,408,30,17,13
420,838,425,394,264,413,30,17,13
425,851,426,400,265,423,31,17,14
430,862,426,407,265,434,31,17,14
435,869,430,407,267,439,31,17,14
440,882,430,416,267,451,32,18,14
445,893,431,419,268,461,32,18,14
450,900,434,423,271,466,32,18,14
455,913,436,431,273,473,33,18,15
460,924,444,436,280,478,33,18,15
465,931,449,438,283,481,33,18,15
470,944,454,445,288,487,34,19,15
475,955,460,451,294,493,34,19,15
480,962,464,456,298,498,34,19,15
485,975,465,460,299,509,35,19,16
490,986,467,465,300,519,35,19,16
495,993,469,469,302,524,35,19,16
500,1006,472,477,304,529,36,19,17
505,1017,476,482,307,541,36,19,17
510,1024,477,484,307,546,36,19,17
515,1037,480,491,309,553,37,19,18
520,1048,484,496,313,564,37,19,18
525,1055,486,498,314,569,37,19,18
530,1068,489,508,316,575,38,20,18
535,1079,492,513,319,587,38,20,18
540,1086,493,515,319,593,38,20,18
545,1099,495,520,320,601,39,21,18
550,1110,500,525,324,610,39,21,18
555,1117,503,529,327,614,39,21,18
560,1130,504,538,328,624,40,21,19
565,1141,505,546,329,636,40,21,19
570,1148,506,549,329,642,40,21,19
575,1161,507,556,330,651,41,21,20
580,1172,510,563,332,662,41,21,20
585,1179,511,566,333,668,41,21,20
590,1192,511,570,333,680,42,22,20
595,1203,511,575,333,692,42,22,20
600,1210,513,579,334,697,42,22,20
605,1223,513,585,334,709,43,23,20
610,1234,514,591,335,719,43,23,20
615,1241,517,593,336,724,43,23,20
620,1254,518,597,337,735,44,23,21
625,1265,518,604,337,746,44,23,21
630,1272,521,607,338,751,44,23,21
635,1285,522,615,339,762,45,24,21
640,1296,523,617,340,772,45,24,21
645,1303,526,619,342,777,45,24,21
650,1316,527,626,343,787,46,25,21
655,1327,527,629,343,800,46,25,21
660,1334,530,632,346,804,46,25,21
665,1347,532,638,348,812,47,25,22
670,1358,533,645,349,822,47,25,22
675,1365,538,649,353,826,47,25,22
680,1378,541,655,355,834,48,26,22
685,1389,546,660,360,842,48,26,22
690,1396,549,664,362,846,48,26,22
695,1409,553,671,365,852,49,27,22
700,1420,559,676,370,860,49,27,22
705,1427,562,679,372,865,49,27,22
710,1440,564,686,374,872,50,27,23
715,1451,571,691,380,879,50,27,23
720,1458,575,694,383,882,50,27,23
725,1471,578,701,386,890,51,27,24
730,1482,582,703,389,900,51,27,24
735,1489,585,707,391,904,51,27,24
740,1502,587,716,393,911,52,28,24
745,1513,591,725,396,921,52,28,24
750,1520,592,726,396,928,52,28,24
755,1533,592,731,396,940,53,28,25
760,1544,593,738,397,950,53,28,25
765,1551,594,742,398,957,53,28,25
770,1564,594,747,398,968,54,28,26
775,1575,596,751,399,979,54,28,26
780,1582,597,752,399,985,54,28,26
785,1595,597,759,399,996,55,29,26
790,1606,599,765,401,1006,55,29,26
795,1613,601,766,402,1012,55,29,26
800,1626,602,773,403,1023,56,30,26
805,1637,603,778,404,1034,56,30,26
810,1644,604,783,405,1040,56,30,26
815,1657,605,791,406,1048,57,30,27
820,1668,608,796,409,1059,57,30,27
825,1675,610,801,411,1065,57,30,27
830,1688,612,808,413,1073,58,30,28
835,1699,616,812,416,1081,58,30,28
840,1706,620,813,418,1086,58,30,28
845,1719,621,822,419,1095,59,31,28
850,1730,625,826,422,1104,59,31,28
855,1737,630,830,426,1106,59,31,28
860,1750,633,836,428,1115,60,31,29
865,1761,635,841,430,1124,60,31,29
870,1768,640,843,433,1128,60,31,29
875,1781,641,845,434,1139,61,31,30
880,1792,643,850,436,1146,61,31,30
885,1799,648,854,440,1150,61,31,30
890,1812,650,860,441,1160,62,32,30
895,1823,655,868,446,1165,62,32,30
900,1830,659,872,450,1170,62,32,30
905,1843,661,875,451,1182,63,32,31
910,1854,663,882,453,1190,63,32,31
915,1861,668,886,456,1192,63,32,31
920,1874,672,895,459,1200,64,33,31
925,1885,673,897,460,1211,64,33,31
930,1892,677,900,463,1215,64,33,31
935,1905,679,910,464,1223,65,34,31
940,1916,679,916,464,1237,65,34,31
945,1923,680,922,465,1243,65,34,31
950,1936,680,929,465,1255,66,35,31
955,1947,680,935,465,1266,66,35,31
960,1954,681,937,465,1273,66,35,31
965,1967,682,945,466,1283,67,35,32
970,1978,684,951,468,1294,67,35,32
975,1985,685,951,468,1300,67,35,32
980,1998,686,955,469,1312,68,35,33
985,2009,687,959,470,1322,68,35,33
990,2016,688,962,471,1328,68,35,33
995,2029,689,971,472,1337,69,36,33
1000,2040,691,976,473,1349,69,36,33
1005,2047,692,981,474,1355,69,36,33
1010,2060,692,988,474,1366,70,36,34
1015,2071,694,994,475,1377,70,36,34
1020,2078,695,995,476,1383,70,36,34
1025,2091,696,1004,477,1394,71,37,34
1030,2102,698,1012,479,1403,71,37,34
1035,2109,701,1015,481,1408,71,37,34
1040,2122,703,1021,483,1416,72,37,35
1045,2133,709,1026,488,1423,72,37,35
1050,2140,713,1028,490,1427,72,37,35
1055,2153,715,1034,491,1435,73,37,36
1060,2164,721,1039,496,1443,73,37,36
1065,2171,726,1044,501,1445,73,37,36
1070,2184,729,1050,504,1454,74,38,36
1075,2195,732,1056,506,1463,74,38,36
1080,2202,737,1061,510,1464,74,38,36
1085,2215,738,1069,511,1477,75,39,36
1090,2226,740,1073,513,1486,75,39,36
1095,2233,744,1077,516,1488,75,39,36
1100,2246,747,1084,518,1497,76,39,37
1105,2257,751,1092,522,1506,76,39,37
1110,2264,753,1094,523,1510,76,39,37
1115,2277,757,1100,527,1520,77,39,38
1120,2288,758,1104,528,1529,77,39,38
1125,2295,761,1109,530,1533,77,39,38
1130,2308,762,1114,531,1546,78,39,39
1135,2319,763,1117,532,1555,78,39,39
1140,2326,766,1119,533,1559,78,39,39
1145,2339,766,1127,533,1570,79,40,39
1150,2350,767,1133,534,1582,79,40,39
1155,2357,769,1134,534,1588,79,40,39
1160,2370,770,1142,535,1599,80,41,39
1165,2381,772,1149,537,1607,80,41,39
1170,2388,775,1153,539,1613,80,41,39
1175,2401,776,1159,540,1624,81,42,39
1180,2412,777,1166,541,1633,81,42,39
1185,2419,780,1169,542,1639,81,42,39
1190,2432,781,1178,543,1648,82,43,39
1195,2443,784,1181,545,1658,82,43,39
1200,2450,787,1181,546,1663,82,43,39
1205,2463,788,1187,547,1673,83,43,40
1210,2474,789,1191,548,1685,83,43,40
1215,2481,791,1193,548,1690,83,43,40
1220,2494,791,1198,548,1702,84,43,41
1225,2505,793,1205,550,1712,84,43,41
1230,2512,795,1210,551,1717,84,43,41
1235,2525,798,1215,554,1727,85,44,41
1240,2536,800,1220,555,1736,85,44,41
1245,2543,802,1222,556,1741,85,44,41
1250,2556,804,1229,558,1748,86,44,42
1255,2567,811,1237,564,1754,86,44,42
1260,2574,815,1239,566,1759,86,44,42
1265,2587,819,1248,570,1764,87,44,43
1270,2598,824,1251,574,1774,87,44,43
1275,2605,825,1253,574,1780,87,44,43
1280,2618,828,1262,577,1786,88,44,44
1285,2629,833,1268,582,1795,88,44,44
1290,2636,836,1272,584,1799,88,44,44
1295,2649,839,1279,586,1805,89,44,45
1300,2660,847,1282,594,1813,89,44,45
1305,2667,849,1284,595,1817,89,44,45
1310,2680,853,1290,599,1826,90,45,45
1315,2691,857,1294,602,1834,90,45,45
1320,2698,859,1297,603,1838,90,45,45
1325,2711,861,1303,605,1849,91,46,45
1330,2722,862,1308,606,1859,91,46,45
1335,2729,863,1310,606,1866,91,46,45
1340,2742,864,1318,607,1875,92,46,46
1345,2753,867,1323,610,1886,92,46,46
1350,2760,869,1326,611,1889,92,46,46
1355,2773,870,1333,612,1901,93,46,47
1360,2784,870,1340,612,1913,93,46,47
1365,2791,871,1344,612,1920,93,46,47
1370,2804,871,1352,612,1933,94,47,47
1375,2815,871,1355,612,1943,94,47,47
1380,2822,874,1359,614,1948,94,47,47
1385,2835,875,1366,615,1958,95,48,47
1390,2846,876,1372,616,1969,95,48,47
1395,2853,879,1377,618,1974,95,48,47
1400,2866,880,1381,619,1985,96,48,48
1405,2877,881,1388,620,1996,96,48,48
1410,2884,883,1391,621,2001,96,48,48
1415,2897,883,1397,621,2012,97,48,49
1420,2908,884,1403,622,2024,97,48,49
1425,2915,886,1405,622,2029,97,48,49
1430,2928,886,1411,622,2040,98,49,49
1435,2939,889,1415,625,2050,98,49,49
1440,2946,891,1417,626,2055,98,49,49
1445,2959,891,1422,626,2068,99,50,49
1450,2970,893,1430,628,2077,99,50,49
1455,2977,895,1434,629,2082,99,50,49
1460,2990,897,1442,631,2091,100,50,50
1465,3001,901,1448,635,2099,100,50,50
1470,3008,904,1451,637,2104,100,50,50
1475,3021,907,1456,640,2113,101,50,51
1480,3032,909,1459,642,2123,101,50,51
1485,3039,912,1461,644,2127,101,50,51
1490,3052,914,1466,645,2137,102,51,51
1495,3063,917,1472,647,2145,102,51,51
1500,3070,920,1473,648,2150,102,51,51
1505,3083,922,1478,650,2158,103,51,52
1510,3094,930,1485,657,2161,103,51,52
1515,3101,937,1488,663,2164,103,51,52
1520,3114,941,1496,666,2170,104,51,53
1525,3125,947,1501,671,2177,104,51,53
1530,3132,951,1504,674,2180,104,51,53
1535,3145,954,1509,677,2190,105,51,54
1540,3156,957,1511,679,2199,105,51,54
1545,3163,961,1514,681,2201,105,51,54
1550,3176,966,1518,686,2210,106,51,55
1555,3187,970,1524,689,2215,106,51,55
1560,3194,974,1528,692,2220,106,51,55
1565,3207,974,1531,692,2232,107,51,56
1570,3218,975,1538,693,2241,107,51,56
1575,3225,978,1542,696,2247,107,51,56
1580,3238,979,1550,697,2257,108,52,56
1585,3249,980,1557,698,2267,108,52,56
1590,3256,983,1562,700,2273,108,52,56
1595,3269,983,1568,700,2284,109,53,56
1600,3280,985,1574,702,2294,109,53,56
1605,3287,988,1577,704,2299,109,53,56
1610,3300,989,1583,705,2310,110,53,57
1615,3311,991,1591,707,2319,110,53,57
1620,3318,994,1595,709,2324,110,53,57
1625,3331,994,1604,709,2335,111,53,58
1630,3342,994,1609,709,2348,111,53,58
1635,3349,995,1613,709,2354,111,53,58
1640,3362,995,1622,709,2365,112,54,58
1645,3373,995,1629,709,2378,112,54,58
1650,3380,996,1636,710,2384,112,54,58
1655,3393,996,1645,710,2393,113,55,58
1660,3404,999,1651,713,2405,113,55,58
1665,3411,1000,1655,713,2411,113,55,58
1670,3424,1001,1661,714,2422,114,55,59
1675,3435,1004,1668,717,2431,114,55,59
1680,3442,1005,1669,717,2437,114,55,59
1685,3455,1007,1675,719,2446,115,56,59
1690,3466,1009,1678,720,2457,115,56,59
1695,3473,1010,1681,721,2463,115,56,59
1700,3486,1012,1687,723,2472,116,56,60
1705,3497,1016,1692,727,2479,116,56,60
1710,3504,1019,1695,730,2484,116,56,60
1715,3517,1021,1700,731,2493,117,56,61
1720,3528,1027,1705,737,2500,117,56,61
1725,3535,1029,1705,738,2506,117,56,61
1730,3548,1033,1711,742,2513,118,56,62
1735,3559,1038,1714,747,2521,118,56,62
1740,3566,1041,1717,748,2523,118,56,62
1745,3579,1044,1722,751,2532,119,57,62
1750,3590,1048,1727,755,2542,119,57,62
1755,3597,1050,1729,756,2547,119,57,62
1760,3610,1052,1735,757,2556,120,58,62
1765,3621,1053,1739,758,2568,120,58,62
1770,3628,1057,1744,762,2571,120,58,62
1775,3641,1060,1750,764,2579,121,59,62
1780,3652,1062,1756,766,2589,121,59,62
1785,3659,1066,1760,769,2593,121,59,62
1790,3672,1068,1767,770,2602,122,60,62
1795,3683,1072,1773,774,2610,122,60,62
1800,3690,1075,1775,776,2614,122,60,62
1805,3703,1077,1780,778,2626,123,61,62
1810,3714,1077,1786,778,2636,123,61,62
1815,3721,1080,1789,780,2641,123,61,62
1820,3734,1080,1797,780,2653,124,61,63
1825,3745,1080,1800,780,2665,124,61,63
1830,3752,1082,1802,780,2670,124,61,63
1835,3765,1082,1808,780,2682,125,61,64
1840,3776,1083,1813,781,2692,125,61,64
1845,3783,1086,1817,783,2697,125,61,64
1850,3796,1087,1822,784,2709,126,62,64
1855,3807,1091,1829,788,2714,126,62,64
1860,3814,1095,1833,791,2719,126,62,64
1865,3827,1096,1840,792,2728,127,62,65
1870,3838,1101,1846,797,2737,127,62,65
1875,3845,1103,1851,798,2742,127,62,65
1880,3858,1105,1861,800,2751,128,63,65
1885,3869,1110,1867,804,2757,128,63,65
1890,3876,1114,1872,808,2762,128,63,65
1895,3889,1116,1879,810,2772,129,64,65
1900,3900,1119,1883,813,2781,129,64,65
1905,3907,1122,1886,814,2783,129,64,65
1910,3920,1129,1893,821,2791,130,64,66
1915,3931,1130,1894,821,2801,130,64,66
1920,3938,1132,1898,823,2804,130,64,66
1925,3951,1135,1904,826,2814,131,64,67
1930,3962,1140,1912,831,2822,131,64,67
1935,3969,1141,1915,832,2828,131,64,67
1940,3982,1142,1920,832,2838,132,64,68
1945,3993,1145,1925,835,2848,132,64,68
1950,4000,1147,1929,837,2852,132,64,68
1955,4013,1150,1937,840,2862,133,65,68
1960,4024,1151,1943,841,2873,133,65,68
1965,4031,1154,1948,843,2876,133,65,68
1970,4044,1157,1956,846,2885,134,66,68
1975,4055,1158,1961,847,2897,134,66,68
1980,4062,1159,1963,848,2903,134,66,68
1985,4075,1159,1971,848,2915,135,67,68
1990,4086,1159,1976,848,2926,135,67,68
1995,4093,1160,1976,848,2933,135,67,68
2000,4106,1160,1981,848,2945,136,67,69
2005,4117,1160,1988,848,2956,136,67,69
2010,4124,1161,1992,848,2963,136,67,69
2015,4137,1161,1999,848,2975,137,68,69
2020,4148,1161,2005,848,2987,137,68,69
2025,4155,1162,2007,848,2993,137,68,69
2030,4168,1162,2012,848,3003,138,69,69
2035,4179,1164,2017,849,3015,138,69,69
2040,4186,1166,2021,850,3020,138,69,69
2045,4199,1167,2030,851,3030,139,70,69
2050,4210,1171,2035,854,3039,139,70,69
2055,4217,1173,2038,856,3044,139,70,69
2060,4230,1173,2042,856,3056,140,71,69
2065,4241,1176,2048,859,3065,140,71,69
2070,4248,1178,2053,861,3070,140,71,69
2075,4261,1179,2059,862,3079,141,71,70
2080,4272,1183,2063,865,3087,141,71,70
2085,4279,1188,2067,869,3090,141,71,70
2090,4292,1191,2073,872,3099,142,72,70
2095,4303,1196,2079,876,3104,142,72,70
2100,4310,1203,2084,883,3107,142,72,70
2105,4323,1205,2092,884,3114,143,72,71
2110,4334,1213,2099,891,3120,143,72,71
2115,4341,1216,2102,893,3125,143,72,71
2120,4354,1217,2108,894,3135,144,73,71
2125,4365,1222,2113,899,3143,144,73,71
2130,4372,1224,2118,901,3148,144,73,71
2135,4385,1228,2125,904,3155,145,74,71
2140,4396,1232,2128,907,3163,145,74,71
2145,4403,1235,2132,909,3167,145,74,71
2150,4416,1239,2141,913,3173,146,74,72
2155,4427,1242,2144,916,3184,146,74,72
2160,4434,1244,2146,917,3190,146,74,72
2165,4447,1245,2152,917,3199,147,75,72
2170,4458,1249,2160,921,3207,147,75,72
2175,4465,1252,2164,923,3213,147,75,72
2180,4478,1253,2170,924,3223,148,75,73
2185,4489,1254,2174,925,3233,148,75,73
2190,4496,1257,2179,928,3239,148,75,73
2195,4509,1258,2187,929,3248,149,75,74
2200,4520,1260,2192,931,3258,149,75,74
2205,4527,1265,2196,934,3261,149,75,74
2210,4540,1269,2202,937,3270,150,75,75
2215,4551,1270,2208,938,3279,150,75,75
2220,4558,1274,2214,942,3284,150,75,75
2225,4571,1274,2221,942,3295,151,75,76
2230,4582,1275,2225,943,3306,151,75,76
2235,4589,1278,2229,946,3311,151,75,76
2240,4602,1278,2235,946,3322,152,75,77
2245,4613,1279,2238,947,3333,152,75,77
2250,4620,1282,2242,949,3338,152,75,77
2255,4633,1282,2247,949,3348,153,75,78
2260,4644,1285,2255,952,3357,153,75,78
2265,4651,1288,2257,954,3363,153,75,78
2270,4664,1288,2263,954,3374,154,76,78
2275,4675,1289,2266,954,3386,154,76,78
2280,4682,1290,2269,954,3392,154,76,78
2285,4695,1290,2277,954,3402,155,77,78
2290,4706,1293,2280,957,3413,155,77,78
2295,4713,1294,2285,957,3419,155,77,78
2300,4726,1295,2294,958,3430,156,78,78
2305,4737,1297,2297,960,3440,156,78,78
2310,4744,1298,2303,961,3446,156,78,78
2315,4757,1300,2308,963,3456,157,78,79
2320,4768,1304,2312,967,3464,157,78,79
2325,4775,1307,2315,969,3467,157,78,79
2330,4788,1313,2323,975,3474,158,79,79
2335,4799,1316,2328,978,3483,158,79,79
2340,4806,1318,2330,980,3488,158,79,79
2345,4819,1322,2338,983,3494,159,80,79
2350,4830,1326,2343,986,3503,159,80,79
2355,4837,1330,2347,990,3507,159,80,79
2360,4850,1334,2354,993,3516,160,81,79
2365,4861,1334,2358,993,3527,160,81,79
2370,4868,1337,2361,994,3530,160,81,79
2375,4881,1338,2364,994,3543,161,81,80
2380,4892,1341,2371,997,3550,161,81,80
2385,4899,1346,2374,1001,3553,161,81,80
2390,4912,1348,2382,1003,3561,162,81,81
2395,4923,1351,2387,1006,3571,162,81,81
2400,4930,1355,2391,1010,3575,162,81,81
2405,4943,1358,2400,1013,3583,163,82,81
2410,4954,1359,2403,1014,3595,163,82,81
2415,4961,1361,2405,1015,3600,163,82,81
2420,4974,1361,2411,1015,3612,164,83,81
2425,4985,1362,2416,1016,3622,164,83,81
2430,4992,1365,2420,1018,3627,164,83,81
2435,5005,1366,2428,1019,3637,165,83,82
2440,5016,1367,2436,1020,3647,165,83,82
2445,5023,1371,2440,1023,3652,165,83,82
2450,5036,1372,2447,1024,3663,166,83,83
2455,5047,1373,2450,1025,3674,166,83,83
2460,5054,1375,2455,1026,3679,166,83,83
2465,5067,1375,2461,1026,3691,167,84,83
2470,5078,1378,2469,1029,3698,167,84,83
2475,5085,1381,2471,1032,3704,167,84,83
2480,5098,1382,2476,1033,3714,168,84,84
2485,5109,1385,2481,1035,3724,168,84,84
2490,5116,1386,2485,1036,3730,168,84,84
2495,5129,1386,2491,1036,3743,169,85,84
2500,5140,1387,2498,1036,3753,169,85,84
2505,5147,1388,2502,1036,3759,169,85,84
2510,5160,1389,2508,1037,3768,170,85,85
2515,5171,1393,2515,1041,3778,170,85,85
2520,5178,1394,2521,1041,3784,170,85,85
2525,5191,1396,2527,1043,3793,171,86,85
2530,5202,1400,2534,1046,3801,171,86,85
2535,5209,1402,2536,1048,3807,171,86,85
2540,5222,1405,2542,1051,3815,172,86,86
2545,5233,1410,2546,1055,3823,172,86,86
2550,5240,1412,2549,1056,3828,172,86,86
2555,5253,1414,2556,1057,3835,173,87,86
2560,5264,1422,2563,1065,3841,173,87,86
2565,5271,1425,2567,1068,3845,173,87,86
2570,5284,1428,2573,1071,3854,174,88,86
2575,5295,1430,2579,1073,3865,174,88,86
2580,5302,1433,2583,1075,3868,174,88,86
2585,5315,1436,2588,1077,3877,175,88,87
2590,5326,1438,2595,1079,3887,175,88,87
2595,5333,1441,2599,1080,3890,175,88,87
2600,5346,1443,2605,1082,3900,176,88,88
2605,5357,1446,2609,1085,3911,176,88,88
2610,5364,1450,2612,1088,3914,176,88,88
2615,5377,1452,2616,1090,3925,177,89,88
2620,5388,1454,2620,1092,3933,177,89,88
2625,5395,1457,2623,1093,3938,177,89,88
2630,5408,1457,2628,1093,3949,178,89,89
2635,5419,1457,2634,1093,3959,178,89,89
2640,5426,1461,2638,1096,3965,178,89,89
2645,5439,1461,2643,1096,3978,179,89,90
2650,5450,1462,2650,1097,3987,179,89,90
2655,5457,1465,2652,1099,3992,179,89,90
2660,5470,1465,2657,1099,4005,180,89,91
2665,5481,1466,2660,1100,4015,180,89,91
2670,5488,1468,2664,1101,4020,180,89,91
2675,5501,1468,2670,1101,4030,181,89,92
2680,5512,1471,2675,1104,4041,181,89,92
2685,5519,1473,2677,1105,4046,181,89,92
2690,5532,1474,2682,1106,4056,182,90,92
2695,5543,1476,2689,1108,4066,182,90,92
2700,5550,1479,2692,1110,4071,182,90,92
2705,5563,1480,2696,1111,4082,183,91,92
2710,5574,1483,2703,1114,4088,183,91,92
2715,5581,1488,2708,1118,4093,183,91,92
2720,5594,1488,2711,1118,4105,184,91,93
2725,5605,1492,2716,1121,4112,184,91,93
2730,5612,1496,2718,1123,4116,184,91,93
2735,5625,1500,2727,1127,4122,185,92,93
2740,5636,1505,2733,1132,4131,185,92,93
2745,5643,1507,2734,1133,4136,185,92,93
2750,5656,1509,2739,1134,4144,186,93,93
2755,5667,1516,2745,1141,4149,186,93,93
2760,5674,1522,2749,1146,4151,186,93,93
2765,5687,1526,2755,1149,4158,187,93,94
2770,5698,1529,2757,1152,4169,187,93,94
2775,5705,1531,2760,1153,4174,187,93,94
2780,5718,1533,2767,1154,4183,188,93,95
2785,5729,1534,2771,1155,4193,188,93,95
2790,5736,1538,2775,1159,4198,188,93,95
2795,5749,1539,2780,1159,4208,189,94,95
2800,5760,1540,2784,1160,4218,189,94,95
2805,5767,1543,2788,1163,4224,189,94,95
2810,5780,1544,2795,1164,4235,190,95,95
2815,5791,1546,2801,1166,4244,190,95,95
2820,5798,1548,2803,1166,4250,190,95,95
2825,5811,1549,2811,1167,4261,191,96,95
2830,5822,1551,2817,1169,4270,191,96,95
2835,5829,1552,2822,1170,4277,191,96,95
2840,5842,1553,2828,1170,4287,192,96,96
2845,5853,1555,2834,1172,4298,192,96,96
2850,5860,1556,2838,1173,4304,192,96,96
2855,5873,1557,2848,1173,4313,193,97,96
2860,5884,1559,2855,1175,4325,193,97,96
2865,5891,1560,2858,1175,4331,193,97,96
2870,5904,1561,2863,1175,4342,194,98,96
2875,5915,1564,2870,1177,4351,194,98,96
2880,5922,1565,2870,1177,4357,194,98,96
2885,5935,1568,2878,1180,4365,195,99,96
2890,5946,1571,2883,1182,4375,195,99,96
2895,5953,1572,2886,1182,4381,195,99,96
2900,5966,1575,2895,1184,4388,196,99,97
2905,5977,1580,2901,1189,4397,196,99,97
2910,5984,1582,2905,1191,4401,196,99,97
2915,5997,1587,2916,1196,4406,197,100,97
2920,6008,1592,2919,1200,4415,197,100,97
2925,6015,1595,2923,1202,4420,197,100,97
2930,6028,1596,2927,1203,4431,198,101,97
2935,6039,1599,2932,1205,4439,198,101,97
2940,6046,1603,2935,1208,4443,198,101,97
2945,6059,1605,2943,1210,4452,199,102,97
2950,6070,1607,2947,1212,4461,199,102,97
2955,6077,1612,2952,1217,4464,199,102,97
2960,6090,1613,2954,1218,4477,200,102,98
2965,6101,1614,2958,1219,4486,200,102,98
2970,6108,1617,2961,1220,4490,200,102,98
2975,6121,1618,2968,1221,4503,201,102,99
2980,6132,1618,2973,1221,4512,201,102,99
2985,6139,1622,2979,1224,4516,201,102,99
2990,6152,1623,2987,1225,4528,202,103,99
2995,6163,1624,2993,1226,4537,202,103,99
3000,6170,1627,2997,1228,4543,202,103,99
3005,6183,1628,3003,1229,4554,203,103,100
3010,6194,1628,3008,1229,4564,203,103,100
3015,6201,1631,3014,1231,4570,203,103,100
3020,6214,1632,3019,1232,4580,204,103,101
3025,6225,1633,3027,1233,4591,204,103,101
3030,6232,1637,3029,1235,4594,204,103,101
3035,6245,1640,3035,1237,4603,205,103,102
3040,6256,1642,3039,1239,4613,205,103,102
3045,6263,1646,3042,1242,4617,205,103,102
3050,6276,1648,3050,1244,4626,206,103,103
3055,6287,1651,3053,1247,4636,206,103,103
3060,6294,1653,3057,1249,4640,206,103,103
3065,6307,1656,3064,1251,4649,207,104,103
3070,6318,1660,3072,1255,4658,207,104,103
3075,6325,1662,3076,1256,4663,207,104,103
3080,6338,1664,3082,1258,4673,208,104,104
3085,6349,1667,3087,1260,4682,208,104,104
3090,6356,1669,3093,1262,4686,208,104,104
3095,6369,1672,3102,1265,4694,209,104,105
3100,6380,1675,3106,1267,4705,209,104,105
3105,6387,1677,3108,1268,4709,209,104,105
3110,6400,1681,3117,1272,4716,210,105,105
3115,6411,1684,3121,1274,4727,210,105,105
3120,6418,1685,3124,1275,4733,210,105,105
3125,6431,1687,3130,1277,4742,211,106,105
3130,6442,1689,3134,1278,4752,211,106,105
3135,6449,1692,3137,1280,4757,211,106,105
3140,6462,1693,3141,1281,4767,212,107,105
3145,6473,1697,3146,1284,4775,212,107,105
3150,6480,1700,3149,1286,4780,212,107,105
3155,6493,1701,3154,1287,4790,213,107,106
3160,6504,1704,3163,1290,4799,213,107,106
3165,6511,1705,3167,1290,4805,213,107,106
3170,6524,1706,3174,1291,4817,214,107,107
3175,6535,1706,3176,1291,4829,214,107,107
3180,6542,1708,3180,1291,4833,214,107,107
3185,6555,1708,3187,1291,4845,215,108,107
3190,6566,1709,3191,1292,4856,215,108,107
3195,6573,1712,3193,1294,4861,215,108,107
3200,6586,1713,3200,1295,4872,216,108,108
3205,6597,1713,3206,1295,4882,216,108,108
3210,6604,1716,3208,1296,4888,216,108,108
3215,6617,1716,3215,1296,4899,217,109,108
3220,6628,1717,3219,1297,4911,217,109,108
3225,6635,1719,3222,1299,4916,217,109,108
3230,6648,1721,3228,1300,4926,218,110,108
3235,6659,1723,3231,1302,4935,218,110,108
3240,6666,1726,3235,1303,4940,218,110,108
3245,6679,1727,3239,1303,4950,219,110,109
3250,6690,1730,3246,1306,4958,219,110,109
3255,6697,1734,3250,1309,4962,219,110,109
3260,6710,1737,3255,1312,4971,220,110,110
3265,6721,1742,3260,1316,4978,220,110,110
3270,6728,1746,3262,1319,4982,220,110,110
3275,6741,1748,3268,1320,4992,221,111,110
3280,6752,1750,3275,1322,5000,221,111,110
3285,6759,1755,3279,1326,5003,221,111,110
3290,6772,1758,3284,1329,5012,222,112,110
3295,6783,1763,3291,1333,5018,222,112,110
3300,6790,1768,3297,1338,5021,222,112,110
3305,6803,1773,3304,1342,5028,223,113,110
3310,6814,1776,3308,1345,5037,223,113,110
3315,6821,1780,3312,1348,5040,223,113,110
3320,6834,1784,3320,1352,5048,224,114,110
3325,6845,1788,3325,1356,5057,224,114,110
3330,6852,1791,3330,1359,5061,224,114,110
3335,6865,1792,3337,1360,5071,225,115,110
3340,6876,1796,3342,1364,5080,225,115,110
3345,6883,1797,3343,1364,5086,225,115,110
3350,6896,1799,3348,1366,5097,226,116,110
3355,6907,1801,3353,1368,5106,226,116,110
3360,6914,1802,3357,1368,5111,226,116,110
3365,6927,1803,3361,1369,5123,227,117,110
3370,6938,1807,3369,1373,5131,227,117,110
3375,6945,1808,3372,1373,5137,227,117,110
3380,6958,1808,3378,1373,5149,228,117,111
3385,6969,1808,3382,1373,5161,228,117,111
3390,6976,1809,3385,1374,5167,228,117,111
3395,6989,1809,3393,1374,5180,229,118,111
3400,7000,1809,3399,1374,5191,229,118,111
3405,7007,1810,3402,1375,5197,229,118,111
3410,7020,1810,3407,1375,5210,230,119,111
3415,7031,1810,3414,1375,5221,230,119,111
3420,7038,1812,3417,1377,5225,230,119,111
3425,7051,1812,3422,1377,5238,231,119,112
3430,7062,1813,3426,1378,5247,231,119,112
3435,7069,1816,3428,1380,5252,231,119,112
3440,7082,1819,3432,1382,5262,232,120,112
3445,7093,1821,3437,1384,5270,232,120,112
3450,7100,1826,3441,1389,5274,232,120,112
3455,7113,1828,3448,1391,5284,233,120,113
3460,7124,1829,3453,1392,5294,233,120,113
3465,7131,1832,3457,1395,5299,233,120,113
3470,7144,1834,3463,1396,5308,234,121,113
3475,7155,1836,3468,1398,5319,234,121,113
3480,7162,1839,3473,1401,5322,234,121,113
3485,7175,1842,3478,1404,5332,235,121,114
3490,7186,1844,3486,1406,5340,235,121,114
3495,7193,1848,3490,1409,5344,235,121,114
3500,7206,1852,3498,1413,5352,236,122,114
3505,7217,1855,3502,1416,5361,236,122,114
3510,7224,1858,3504,1417,5366,236,122,114
3515,7237,1862,3510,1420,5375,237,123,114
3520,7248,1865,3517,1423,5382,237,123,114
3525,7255,1869,3520,1426,5386,237,123,114
3530,7268,1872,3526,1429,5394,238,123,115
3535,7279,1877,3533,1433,5401,238,123,115
3540,7286,1881,3538,1437,5405,238,123,115
3545,7299,1882,3545,1438,5416,239,124,115
3550,7310,1885,3550,1441,5424,239,124,115
3555,7317,1888,3553,1443,5429,239,124,115
3560,7330,1890,3560,1445,5439,240,125,115
3565,7341,1893,3567,1448,5448,240,125,115
3570,7348,1895,3572,1449,5453,240,125,115
3575,7361,1897,3582,1451,5461,241,125,116
3580,7372,1902,3590,1456,5469,241,125,116
3585,7379,1905,3595,1458,5474,241,125,116
3590,7392,1905,3604,1458,5485,242,126,116
3595,7403,1905,3609,1458,5497,242,126,116
3600,7410,1907,3612,1459,5503,242,126,116
3605,7423,1907,3620,1459,5514,243,127,116
3610,7434,1907,3628,1459,5526,243,127,116
3615,7441,1909,3632,1459,5531,243,127,116
3620,7454,1909,3639,1459,5542,244,128,116
3625,7465,1910,3644,1460,5555,244,128,116
3630,7472,1912,3649,1462,5560,244,128,116
3635,7485,1913,3659,1463,5571,245,129,116
3640,7496,1914,3664,1464,5581,245,129,116
3645,7503,1917,3666,1466,5586,245,129,116
3650,7516,1918,3670,1467,5596,246,129,117
3655,7527,1921,3675,1470,5606,246,129,117
3660,7534,1923,3678,1471,5611,246,129,117
3665,7547,1924,3680,1471,5623,247,129,118
3670,7558,1924,3681,1471,5634,247,129,118
3675,7565,1926,3686,1472,5639,247,129,118
3680,7578,1928,3691,1474,5650,248,130,118
3685,7589,1929,3695,1475,5660,248,130,118
3690,7596,1931,3699,1477,5665,248,130,118
3695,7609,1934,3707,1480,5672,249,131,118
3700,7620,1939,3713,1484,5680,249,131,118
3705,7627,1942,3716,1487,5685,249,131,118
3710,7640,1945,3722,1489,5692,250,131,119
3715,7651,1950,3727,1493,5699,250,131,119
3720,7658,1954,3729,1496,5704,250,131,119
3725,7671,1957,3735,1499,5713,251,132,119
3730,7682,1963,3743,1505,5717,251,132,119
3735,7689,1968,3748,1509,5719,251,132,119
3740,7702,1974,3759,1515,5724,252,133,119
3745,7713,1982,3766,1523,5729,252,133,119
3750,7720,1987,3770,1527,5732,252,133,119
3755,7733,1991,3777,1531,5741,253,133,120
3760,7744,1993,3781,1532,5751,253,133,120
3765,7751,1995,3785,1534,5756,253,133,120
3770,7764,1996,3793,1535,5764,254,134,120
3775,7775,2001,3795,1539,5774,254,134,120
3780,7782,2002,3798,1539,5780,254,134,120
3785,7795,2002,3802,1539,5791,255,134,121
3790,7806,2002,3804,1539,5804,255,134,121
3795,7813,2003,3808,1539,5810,255,134,121
3800,7826,2003,3817,1539,5821,256,135,121
3805,7837,2003,3822,1539,5834,256,135,121
3810,7844,2004,3826,1540,5840,256,135,121
3815,7857,2004,3836,1540,5851,257,136,121
3820,7868,2004,3841,1540,5864,257,136,121
3825,7875,2005,3843,1541,5870,257,136,121
3830,7888,2005,3849,1541,5882,258,136,122
3835,7899,2005,3855,1541,5894,258,136,122
3840,7906,2006,3859,1542,5900,258,136,122
3845,7919,2006,3865,1542,5912,259,137,122
3850,7930,2006,3870,1542,5924,259,137,122
3855,7937,2008,3873,1543,5929,259,137,122
3860,7950,2009,3880,1544,5940,260,137,123
3865,7961,2011,3884,1546,5950,260,137,123
3870,7968,2013,3887,1548,5955,260,137,123
3875,7981,2015,3894,1549,5964,261,137,124
3880,7992,2016,3897,1550,5975,261,137,124
3885,7999,2020,3902,1554,5979,261,137,124
3890,8012,2021,3902,1554,5991,262,137,125
3895,8023,2024,3908,1557,5998,262,137,125
3900,8030,2029,3912,1561,6000,262,137,125
3905,8043,2033,3915,1564,6009,263,137,126
3910,8054,2038,3920,1569,6015,263,137,126
3915,8061,2042,3923,1571,6017,263,137,126
3920,8074,2046,3929,1575,6024,264,137,127
3925,8085,2054,3934,1583,6030,264,137,127
3930,8092,2058,3935,1585,6034,264,137,127
3935,8105,2060,3943,1586,6040,265,137,128
3940,8116,2066,3951,1592,6047,265,137,128
3945,8123,2071,3955,1597,6052,265,137,128
3950,8136,2074,3961,1599,6060,266,137,129
3955,8147,2077,3967,1602,6069,266,137,129
3960,8154,2080,3972,1605,6073,266,137,129
3965,8167,2084,3979,1609,6081,267,137,130
3970,8178,2086,3986,1611,6092,267,137,130
3975,8185,2088,3988,1612,6097,267,137,130
3980,8198,2088,3993,1612,6108,268,138,130
3985,8209,2090,4001,1614,6119,268,138,130
3990,8216,2092,4003,1615,6124,268,138,130
3995,8229,2093,4008,1616,6134,269,138,131
4000,8240,2095,4013,1618,6145,269,138,131
4005,8247,2097,4015,1619,6150,269,138,131
4010,8260,2097,4020,1619,6161,270,139,131
4015,8271,2099,4024,1621,6172,270,139,131
4020,8278,2101,4030,1623,6177,270,139,131
4025,8291,2101,4034,1623,6189,271,139,132
4030,8302,2103,4041,1624,6198,271,139,132
4035,8309,2106,4046,1627,6203,271,139,132
4040,8322,2107,4052,1628,6214,272,140,132
4045,8333,2108,4055,1628,6225,272,140,132
4050,8340,2110,4057,1628,6230,272,140,132
4055,8353,2111,4064,1629,6240,273,141,132
4060,8364,2115,4069,1632,6249,273,141,132
4065,8371,2117,4072,1633,6254,273,141,132
4070,8384,2119,4078,1635,6263,274,142,132
4075,8395,2124,4085,1640,6268,274,142,132
4080,8402,2130,4087,1645,6272,274,142,132
4085,8415,2132,4092,1646,6283,275,143,132
4090,8426,2135,4100,1649,6290,275,143,132
4095,8433,2139,4105,1652,6292,275,143,132
4100,8446,2141,4111,1654,6303,276,143,133
4105,8457,2144,4117,1657,6312,276,143,133
4110,8464,2147,4119,1659,6317,276,143,133
4115,8477,2148,4123,1659,6326,277,143,134
4120,8488,2152,4131,1663,6333,277,143,134
4125,8495,2156,4135,1667,6339,277,143,134
4130,8508,2158,4142,1668,6349,278,143,135
4135,8519,2161,4147,1671,6358,278,143,135
4140,8526,2162,4151,1672,6364,278,143,135
4145,8539,2163,4158,1673,6374,279,143,136
4150,8550,2166,4161,1676,6384,279,143,136
4155,8557,2167,4167,1677,6390,279,143,136
4160,8570,2168,4175,1678,6401,280,144,136
4165,8581,2170,4180,1680,6411,280,144,136
4170,8588,2171,4183,1680,6417,280,144,136
4175,8601,2172,4192,1681,6428,281,145,136
4180,8612,2173,4199,1682,6439,281,145,136
4185,8619,2174,4202,1683,6445,281,145,136
4190,8632,2175,4210,1683,6454,282,146,136
4195,8643,2180,4216,1688,6463,282,146,136
4200,8650,2181,4219,1688,6469,282,146,136
4205,8663,2182,4226,1689,6478,283,147,136
4210,8674,2186,4231,1692,6488,283,147,136
4215,8681,2189,4235,1694,6491,283,147,136
4220,8694,2193,4242,1697,6499,284,147,137
4225,8705,2195,4247,1698,6510,284,147,137
4230,8712,2196,4250,1698,6516,284,147,137
4235,8725,2196,4252,1698,6528,285,147,138
4240,8736,2197,4256,1698,6537,285,147,138
4245,8743,2201,4258,1701,6542,285,147,138
4250,8756,2201,4265,1701,6552,286,148,138
4255,8767,2203,4269,1702,6563,286,148,138
4260,8774,2206,4273,1703,6568,286,148,138
4265,8787,2209,4282,1706,6575,287,149,138
4270,8798,2213,4287,1709,6583,287,149,138
4275,8805,2217,4289,1713,6588,287,149,138
4280,8818,2219,4297,1715,6596,288,150,138
4285,8829,2223,4302,1719,6605,288,150,138
4290,8836,2226,4305,1721,6610,288,150,138
4295,8849,2226,4309,1721,6620,289,150,139
4300,8860,2229,4313,1724,6631,289,150,139
4305,8867,2231,4314,1724,6636,289,150,139
4310,8880,2233,4321,1726,6643,290,150,140
4315,8891,2241,4326,1733,6649,290,150,140
4320,8898,2244,4328,1735,6654,290,150,140
4325,8911,2244,4335,1735,6665,291,151,140
4330,8922,2248,4343,1739,6673,291,151,140
4335,8929,2252,4347,1742,6675,291,151,140
4340,8942,2255,4353,1745,6686,292,151,141
4345,8953,2256,4357,1746,6696,292,151,141
4350,8960,2258,4360,1747,6701,292,151,141
4355,8973,2259,4364,1747,6713,293,151,142
4360,8984,2259,4368,1747,6724,293,151,142
4365,8991,2261,4369,1747,6729,293,151,142
4370,9004,2263,4376,1748,6738,294,152,142
4375,9015,2265,4379,1750,6750,294,152,142
4380,9022,2269,4385,1754,6752,294,152,142
4385,9035,2271,4390,1755,6762,295,153,142
4390,9046,2274,4398,1758,6772,295,153,142
4395,9053,2278,4402,1761,6774,295,153,142
4400,9066,2281,4409,1764,6784,296,153,143
4405,9077,2283,4415,1766,6794,296,153,143
4410,9084,2287,4422,1770,6796,296,153,143
4415,9097,2288,4428,1771,6809,297,154,143
4420,9108,2289,4436,1772,6819,297,154,143
4425,9115,2291,4440,1774,6824,297,154,143
4430,9128,2292,4448,1775,6833,298,155,143
4435,9139,2295,4453,1778,6844,298,155,143
4440,9146,2297,4456,1778,6849,298,155,143
4445,9159,2298,4461,1779,6859,299,155,144
4450,9170,2301,4465,1782,6869,299,155,144
4455,9177,2303,4470,1784,6874,299,155,144
4460,9190,2304,4476,1785,6883,300,155,145
4465,9201,2308,4481,1788,6892,300,155,145
4470,9208,2311,4484,1789,6897,300,155,145
4475,9221,2313,4490,1791,6906,301,156,145
4480,9232,2317,4497,1795,6913,301,156,145
4485,9239,2321,4502,1798,6918,301,156,145
4490,9252,2321,4509,1798,6928,302,157,145
4495,9263,2324,4516,1801,6936,302,157,145
4500,9270,2329,4518,1804,6940,302,157,145
4505,9283,2332,4523,1807,6950,303,158,145
4510,9294,2334,4526,1809,6959,303,158,145
4515,9301,2338,4530,1812,6962,303,158,145
4520,9314,2339,4536,1813,6972,304,159,145
4525,9325,2346,4542,1819,6978,304,159,145
4530,9332,2348,4543,1820,6983,304,159,145
4535,9345,2349,4549,1821,6994,305,159,146
4540,9356,2350,4553,1822,7005,305,159,146
4545,9363,2353,4557,1825,7010,305,159,146
4550,9376,2355,4562,1826,7020,306,160,146
4555,9387,2357,4568,1828,7029,306,160,146
4560,9394,2358,4570,1828,7035,306,160,146
4565,9407,2360,4577,1830,7046,307,160,147
4570,9418,2361,4581,1831,7057,307,160,147
4575,9425,2363,4586,1833,7061,307,160,147
4580,9438,2366,4594,1836,7069,308,160,148
4585,9449,2368,4601,1838,7080,308,160,148
4590,9456,2370,4605,1839,7086,308,160,148
4595,9469,2372,4615,1840,7095,309,161,148
4600,9480,2375,4621,1843,7105,309,161,148
4605,9487,2376,4624,1844,7111,309,161,148
4610,9500,2378,4633,1846,7120,310,161,149
4615,9511,2379,4637,1847,7132,310,161,149
4620,9518,2380,4642,1848,7138,310,161,149
4625,9531,2380,4651,1848,7150,311,162,149
4630,9542,2380,4655,1848,7162,311,162,149
4635,9549,2381,4658,1849,7168,311,162,149
4640,9562,2381,4664,1849,7180,312,163,149
4645,9573,2382,4670,1850,7190,312,163,149
4650,9580,2385,4672,1851,7195,312,163,149
4655,9593,2387,4683,1853,7203,313,164,149
4660,9604,2391,4690,1857,7212,313,164,149
4665,9611,2394,4695,1860,7217,313,164,149
4670,9624,2394,4702,1860,7227,314,164,150
4675,9635,2398,4708,1863,7235,314,164,150
4680,9642,2402,4711,1867,7240,314,164,150
4685,9655,2403,4719,1868,7251,315,165,150
4690,9666,2407,4726,1872,7258,315,165,150
4695,9673,2410,4730,1874,7263,315,165,150
4700,9686,2411,4734,1875,7273,316,166,150
4705,9697,2415,4740,1879,7282,316,166,150
4710,9704,2418,4744,1881,7286,316,166,150
4715,9717,2419,4750,1882,7295,317,167,150
4720,9728,2426,4754,1889,7302,317,167,150
4725,9735,2430,4759,1892,7303,317,167,150
4730,9748,2435,4767,1897,7309,318,168,150
4735,9759,2442,4772,1904,7317,318,168,150
4740,9766,2446,4777,1907,7319,318,168,150
4745,9779,2448,4783,1908,7328,319,168,151
4750,9790,2449,4787,1909,7340,319,168,151
4755,9797,2451,4791,1910,7346,319,168,151
4760,9810,2452,4795,1910,7357,320,168,152
4765,9821,2454,4797,1912,7366,320,168,152
4770,9828,2457,4800,1914,7371,320,168,152
4775,9841,2459,4807,1915,7381,321,169,152
4780,9852,2459,4812,1915,7392,321,169,152
4785,9859,2462,4817,1918,7397,321,169,152
4790,9872,2464,4823,1920,7406,322,170,152
4795,9883,2466,4830,1922,7415,322,170,152
4800,9890,2469,4835,1925,7421,322,170,152
4805,9903,2471,4842,1926,7431,323,170,153
4810,9914,2473,4848,1928,7440,323,170,153
4815,9921,2476,4852,1929,7445,323,170,153
4820,9934,2477,4858,1929,7454,324,171,153
4825,9945,2480,4863,1932,7464,324,171,153
4830,9952,2483,4865,1933,7469,324,171,153
4835,9965,2485,4871,1935,7479,325,171,154
4840,9976,2486,4874,1936,7489,325,171,154
4845,9983,2489,4876,1937,7494,325,171,154
4850,9996,2491,4879,1938,7504,326,172,154
4855,10007,2493,4883,1939,7513,326,172,154
4860,10014,2496,4886,1941,7517,326,172,154
4865,10027,2500,4895,1945,7523,327,172,155
4870,10038,2507,4900,1951,7530,327,172,155
4875,10045,2510,4901,1953,7535,327,172,155
4880,10058,2514,4907,1956,7543,328,173,155
4885,10069,2519,4915,1961,7549,328,173,155
4890,10076,2522,4917,1963,7554,328,173,155
4895,10089,2524,4926,1965,7562,329,174,155
4900,10100,2527,4928,1967,7572,329,174,155
4905,10107,2530,4929,1968,7577,329,174,155
4910,10120,2532,4939,1970,7583,330,175,155
4915,10131,2540,4947,1977,7589,330,175,155
4920,10138,2542,4951,1978,7595,330,175,155
4925,10151,2542,4956,1978,7607,331,175,156
4930,10162,2542,4961,1978,7620,331,175,156
4935,10169,2543,4965,1979,7626,331,175,156
4940,10182,2543,4971,1979,7639,332,176,156
4945,10193,2543,4976,1979,7649,332,176,156
4950,10200,2544,4979,1979,7656,332,176,156
4955,10213,2544,4984,1979,7667,333,177,156
4960,10224,2544,4989,1979,7680,333,177,156
4965,10231,2545,4992,1979,7686,333,177,156
4970,10244,2545,4999,1979,7698,334,178,156
4975,10255,2545,5006,1979,7710,334,178,156
4980,10262,2546,5007,1979,7716,334,178,156
4985,10275,2546,5012,1979,7729,335,179,156
4990,10286,2546,5016,1979,7740,335,179,156
4995,10293,2548,5020,1981,7744,335,179,156
5000,10306,2550,5025,1982,7756,336,179,157
5005,10317,2550,5033,1982,7767,336,179,157
5010,10324,2553,5039,1985,7770,336,179,157
5015,10337,2556,5044,1987,7781,337,180,157
5020,10348,2556,5052,1987,7792,337,180,157
5025,10355,2558,5054,1988,7797,337,180,157
5030,10368,2560,5059,1989,7806,338,181,157
5035,10379,2564,5068,1993,7815,338,181,157
5040,10386,2568,5074,1996,7817,338,181,157
5045,10399,2572,5084,2000,7825,339,182,157
5050,10410,2575,5089,2003,7834,339,182,157
5055,10417,2579,5093,2006,7838,339,182,157
5060,10430,2581,5102,2008,7846,340,183,157
5065,10441,2587,5105,2013,7854,340,183,157
5070,10448,2590,5107,2015,7858,340,183,157
5075,10461,2591,5112,2015,7867,341,184,157
5080,10472,2597,5116,2021,7874,341,184,157
5085,10479,2601,5121,2025,7876,341,184,157
5090,10492,2606,5126,2029,7884,342,184,158
5095,10503,2611,5130,2033,7890,342,184,158
5100,10510,2615,5135,2037,7894,342,184,158
5105,10523,2617,5140,2039,7904,343,185,158
5110,10534,2621,5146,2042,7911,343,185,158
5115,10541,2625,5151,2045,7915,343,185,158
5120,10554,2625,5160,2045,7926,344,186,158
5125,10565,2626,5167,2046,7937,344,186,158
5130,10572,2629,5168,2047,7943,344,186,158
5135,10585,2629,5175,2047,7955,345,187,158
5140,10596,2629,5177,2047,7966,345,187,158
5145,10603,2632,5180,2049,7971,345,187,158
5150,10616,2633,5188,2050,7981,346,187,159
5155,10627,2634,5195,2051,7990,346,187,159
5160,10634,2638,5200,2054,7996,346,187,159
5165,10647,2638,5204,2054,8008,347,187,160
5170,10658,2638,5206,2054,8019,347,187,160
5175,10665,2641,5210,2056,8024,347,187,160
5180,10678,2642,5217,2057,8035,348,187,161
5185,10689,2642,5223,2057,8045,348,187,161
5190,10696,2646,5225,2060,8050,348,187,161
5195,10709,2647,5234,2061,8060,349,188,161
5200,10720,2648,5236,2062,8072,349,188,161
5205,10727,2650,5242,2064,8077,349,188,161
5210,10740,2651,5248,2065,8086,350,188,162
5215,10751,2654,5254,2068,8095,350,188,162
5220,10758,2658,5256,2070,8099,350,188,162
5225,10771,2661,5263,2073,8106,351,188,163
5230,10782,2667,5268,2078,8113,351,188,163
5235,10789,2671,5274,2082,8117,351,188,163
5240,10802,2673,5281,2083,8126,352,189,163
5245,10813,2678,5288,2088,8135,352,189,163
5250,10820,2681,5292,2091,8139,352,189,163
5255,10833,2684,5299,2094,8145,353,189,164
5260,10844,2689,5303,2098,8155,353,189,164
5265,10851,2690,5303,2098,8161,353,189,164
5270,10864,2692,5309,2100,8169,354,189,165
5275,10875,2697,5316,2105,8176,354,189,165
5280,10882,2701,5319,2109,8180,354,189,165
5285,10895,2705,5327,2113,8188,355,190,165
5290,10906,2707,5334,2115,8198,355,190,165
5295,10913,2709,5337,2117,8204,355,190,165
5300,10926,2711,5345,2118,8213,356,191,165
5305,10937,2712,5351,2119,8225,356,191,165
5310,10944,2713,5355,2120,8231,356,191,165
5315,10957,2713,5365,2120,8242,357,192,165
5320,10968,2713,5370,2120,8255,357,192,165
5325,10975,2714,5374,2121,8261,357,192,165
5330,10988,2714,5380,2121,8274,358,193,165
5335,10999,2714,5388,2121,8285,358,193,165
5340,11006,2716,5393,2121,8290,358,193,165
5345,11019,2717,5400,2122,8300,359,194,165
5350,11030,2718,5406,2123,8310,359,194,165
5355,11037,2721,5410,2126,8316,359,194,165
5360,11050,2722,5414,2127,8328,360,194,166
5365,11061,2724,5419,2129,8337,360,194,166
5370,11068,2726,5422,2129,8342,360,194,166
5375,11081,2726,5429,2129,8354,361,194,167
5380,11092,2728,5433,2131,8363,361,194,167
5385,11099,2731,5438,2133,8368,361,194,167
5390,11112,2731,5443,2133,8379,362,195,167
5395,11123,2734,5449,2136,8388,362,195,167
5400,11130,2737,5454,2139,8393,362,195,167
5405,11143,2737,5460,2139,8404,363,196,167
5410,11154,2740,5466,2142,8414,363,196,167
5415,11161,2742,5469,2143,8419,363,196,167
5420,11174,2744,5474,2145,8427,364,196,168
5425,11185,2749,5477,2149,8436,364,196,168
5430,11192,2751,5481,2151,8441,364,196,168
5435,11205,2753,5488,2152,8450,365,197,168
5440,11216,2758,5494,2157,8458,365,197,168
5445,11223,2760,5499,2158,8463,365,197,168
5450,11236,2762,5508,2160,8471,366,198,168
5455,11247,2766,5514,2164,8480,366,198,168
5460,11254,2769,5519,2166,8484,366,198,168
5465,11267,2774,5528,2170,8490,367,199,168
5470,11278,2779,5533,2174,8499,367,199,168
5475,11285,2781,5537,2175,8503,367,199,168
5480,11298,2784,5541,2177,8512,368,199,169
5485,11309,2788,5545,2180,8521,368,199,169
5490,11316,2791,5551,2183,8524,368,199,169
5495,11329,2793,5556,2184,8535,369,199,170
5500,11340,2795,5561,2186,8545,369,199,170
5505,11347,2797,5563,2187,8550,369,199,170
5510,11360,2798,5566,2187,8561,370,200,170
5515,11371,2800,5572,2189,8569,370,200,170
5520,11378,2804,5574,2191,8573,370,200,170
5525,11391,2806,5580,2193,8584,371,200,171
5530,11402,2808,5585,2195,8592,371,200,171
5535,11409,2813,5588,2199,8595,371,200,171
5540,11422,2814,5593,2199,8606,372,201,171
5545,11433,2817,5596,2202,8616,372,201,171
5550,11440,2820,5600,2205,8619,372,201,171
5555,11453,2823,5607,2208,8629,373,201,172
5560,11464,2825,5612,2210,8637,373,201,172
5565,11471,2830,5616,2214,8640,373,201,172
5570,11484,2833,5623,2217,8649,374,202,172
5575,11495,2836,5629,2220,8659,374,202,172
5580,11502,2837,5631,2220,8664,374,202,172
5585,11515,2839,5636,2222,8675,375,202,173
5590,11526,2840,5640,2223,8686,375,202,173
5595,11533,2842,5641,2224,8691,375,202,173
5600,11546,2843,5644,2224,8703,376,202,174
5605,11557,2845,5649,2225,8711,376,202,174
5610,11564,2847,5652,2226,8717,376,202,174
5615,11577,2850,5654,2228,8727,377,202,175
5620,11588,2851,5658,2229,8736,377,202,175
5625,11595,2853,5661,2230,8742,377,202,175
5630,11608,2854,5667,2231,8751,378,202,176
5635,11619,2857,5673,2233,8762,378,202,176
5640,11626,2858,5676,2234,8768,378,202,176
5645,11639,2858,5682,2234,8778,379,203,176
5650,11650,2860,5687,2236,8790,379,203,176
5655,11657,2861,5691,2236,8796,379,203,176
5660,11670,2861,5696,2236,8807,380,203,177
5665,11681,2863,5701,2237,8818,380,203,177
5670,11688,2864,5704,2237,8824,380,203,177
5675,11701,2864,5707,2237,8835,381,203,178
5680,11712,2869,5714,2241,8841,381,203,178
5685,11719,2873,5719,2245,8846,381,203,178
5690,11732,2873,5724,2245,8857,382,203,179
5695,11743,2878,5731,2249,8864,382,203,179
5700,11750,2881,5736,2252,8869,382,203,179
5705,11763,2882,5743,2253,8880,383,204,179
5710,11774,2884,5748,2254,8887,383,204,179
5715,11781,2889,5750,2258,8892,383,204,179
5720,11794,2891,5755,2260,8902,384,205,179
5725,11805,2895,5759,2263,8910,384,205,179
5730,11812,2897,5760,2263,8915,384,205,179
5735,11825,2899,5767,2265,8923,385,205,180
5740,11836,2909,5775,2274,8925,385,205,180
5745,11843,2914,5777,2277,8928,385,205,180
5750,11856,2918,5782,2280,8936,386,206,180
5755,11867,2922,5791,2284,8942,386,206,180
5760,11874,2926,5793,2287,8948,386,206,180
5765,11887,2928,5801,2288,8957,387,207,180
5770,11898,2931,5808,2291,8967,387,207,180
5775,11905,2934,5813,2293,8970,387,207,180
5780,11918,2937,5821,2295,8977,388,208,180
5785,11929,2939,5828,2297,8989,388,208,180
5790,11936,2941,5831,2299,8995,388,208,180
5795,11949,2943,5836,2301,9004,389,208,181
5800,11960,2944,5841,2302,9016,389,208,181
5805,11967,2946,5846,2304,9020,389,208,181
5810,11980,2948,5850,2305,9031,390,208,182
5815,11991,2949,5857,2306,9042,390,208,182
5820,11998,2950,5857,2306,9048,390,208,182
5825,12011,2950,5865,2306,9060,391,208,183
5830,12022,2950,5870,2306,9072,391,208,183
5835,12029,2951,5876,2307,9078,391,208,183
5840,12042,2951,5882,2307,9091,392,209,183
5845,12053,2951,5886,2307,9102,392,209,183
5850,12060,2952,5891,2308,9108,392,209,183
5855,12073,2953,5897,2309,9119,393,209,184
5860,12084,2955,5904,2311,9129,393,209,184
5865,12091,2956,5909,2312,9135,393,209,184
5870,12104,2958,5915,2314,9146,394,210,184
5875,12115,2960,5919,2316,9155,394,210,184
5880,12122,2962,5925,2318,9160,394,210,184
5885,12135,2963,5934,2319,9169,395,211,184
5890,12146,2966,5939,2322,9179,395,211,184
5895,12153,2969,5941,2323,9184,395,211,184
5900,12166,2970,5947,2324,9194,396,211,185
5905,12177,2976,5953,2330,9200,396,211,185
5910,12184,2980,5957,2333,9203,396,211,185
5915,12197,2982,5960,2335,9214,397,212,185
5920,12208,2987,5966,2339,9218,397,212,185
5925,12215,2992,5968,2343,9222,397,212,185
5930,12228,2993,5977,2344,9232,398,213,185
5935,12239,2995,5982,2346,9241,398,213,185
5940,12246,2999,5987,2350,9247,398,213,185
5945,12259,3001,5991,2351,9257,399,213,186
5950,12270,3002,5992,2352,9268,399,213,186
5955,12277,3004,5995,2352,9272,399,213,186
5960,12290,3005,6001,2352,9284,400,213,187
5965,12301,3008,6003,2355,9293,400,213,187
5970,12308,3010,6005,2355,9298,400,213,187
5975,12321,3011,6010,2355,9309,401,214,187
5980,12332,3015,6015,2359,9317,401,214,187
5985,12339,3017,6018,2359,9321,401,214,187
5990,12352,3019,6023,2360,9332,402,214,188
5995,12363,3020,6025,2361,9342,402,214,188
6000,12370,3024,6028,2364,9345,402,214,188
6005,12383,3026,6032,2366,9357,403,214,189
6010,12394,3026,6034,2366,9366,403,214,189
6015,12401,3031,6036,2369,9370,403,214,189
6020,12414,3034,6041,2371,9379,404,215,189
6025,12425,3037,6045,2374,9388,404,215,189
6030,12432,3040,6048,2376,9391,404,215,189
6035,12445,3044,6053,2380,9400,405,216,189
6040,12456,3047,6061,2383,9408,405,216,189
6045,12463,3051,6065,2386,9412,405,216,189
6050,12476,3053,6066,2387,9423,406,216,190
6055,12487,3055,6073,2388,9431,406,216,190
6060,12494,3057,6076,2389,9436,406,216,190
6065,12507,3059,6083,2391,9445,407,216,191
6070,12518,3061,6084,2392,9457,407,216,191
6075,12525,3062,6088,2392,9463,407,216,191
6080,12538,3062,6094,2392,9474,408,217,191
6085,12549,3064,6101,2394,9485,408,217,191
6090,12556,3065,6102,2394,9491,408,217,191
6095,12569,3066,6108,2395,9500,409,218,191
6100,12580,3070,6113,2398,9510,409,218,191
6105,12587,3071,6118,2399,9516,409,218,191
6110,12600,3072,6123,2400,9526,410,218,192
6115,12611,3074,6130,2402,9536,410,218,192
6120,12618,3076,6134,2403,9542,410,218,192
6125,12631,3077,6141,2404,9551,411,218,193
6130,12642,3079,6147,2406,9562,411,218,193
6135,12649,3081,6149,2407,9568,411,218,193
6140,12662,3082,6153,2408,9580,412,218,194
6145,12673,3083,6160,2409,9589,412,218,194
6150,12680,3085,6164,2411,9595,412,218,194
6155,12693,3086,6170,2412,9605,413,219,194
6160,12704,3089,6175,2414,9615,413,219,194
6165,12711,3091,6177,2414,9619,413,219,194
6170,12724,3094,6180,2417,9629,414,219,195
6175,12735,3098,6186,2420,9636,414,219,195
6180,12742,3101,6189,2423,9641,414,219,195
6185,12755,3102,6190,2423,9652,415,219,196
6190,12766,3107,6195,2427,9658,415,219,196
6195,12773,3112,6199,2431,9660,415,219,196
6200,12786,3116,6205,2434,9667,416,219,197
6205,12797,3119,6210,2437,9678,416,219,197
6210,12804,3122,6214,2439,9681,416,219,197
6215,12817,3123,6219,2440,9692,417,219,198
6220,12828,3126,6227,2443,9701,417,219,198
6225,12835,3129,6230,2445,9705,417,219,198
6230,12848,3133,6237,2449,9713,418,220,198
6235,12859,3135,6243,2451,9723,418,220,198
6240,12866,3140,6247,2454,9725,418,220,198
6245,12879,3141,6256,2455,9736,419,221,198
6250,12890,3143,6260,2457,9747,419,221,198
6255,12897,3145,6264,2459,9752,419,221,198
6260,12910,3146,6269,2460,9763,420,221,199
6265,12921,3146,6274,2460,9774,420,221,199
6270,12928,3149,6275,2462,9779,420,221,199
6275,12941,3150,6282,2463,9789,421,222,199
6280,12952,3152,6287,2465,9799,421,222,199
6285,12959,3154,6292,2466,9805,421,222,199
6290,12972,3155,6300,2467,9815,422,223,199
6295,12983,3156,6308,2468,9825,422,223,199
6300,12990,3160,6312,2472,9830,422,223,199
6305,13003,3162,6320,2474,9839,423,224,199
6310,13014,3166,6326,2478,9847,423,224,199
6315,13021,3169,6329,2481,9852,423,224,199
6320,13034,3170,6338,2482,9861,424,225,199
6325,13045,3174,6344,2485,9870,424,225,199
6330,13052,3176,6349,2487,9876,424,225,199
6335,13065,3176,6357,2487,9888,425,226,199
6340,13076,3178,6361,2489,9897,425,226,199
6345,13083,3180,6364,2490,9903,425,226,199
6350,13096,3182,6367,2492,9913,426,226,200
6355,13107,3185,6371,2495,9921,426,226,200
6360,13114,3188,6373,2497,9926,426,226,200
6365,13127,3192,6381,2500,9932,427,226,201
6370,13138,3196,6386,2504,9942,427,226,201
6375,13145,3198,6387,2505,9947,427,226,201
6380,13158,3200,6393,2507,9955,428,226,202
6385,13169,3205,6398,2511,9964,428,226,202
6390,13176,3207,6402,2512,9967,428,226,202
6395,13189,3213,6409,2517,9974,429,227,202
6400,13200,3218,6415,2522,9982,429,227,202
6405,13207,3220,6417,2523,9986,429,227,202
6410,13220,3223,6422,2526,9996,430,228,202
6415,13231,3225,6428,2528,10006,430,228,202
6420,13238,3227,6432,2529,10010,430,228,202
6425,13251,3228,6438,2530,10022,431,228,203
6430,13262,3228,6444,2530,10034,431,228,203
6435,13269,3230,6445,2530,10039,431,228,203
6440,13282,3230,6448,2530,10051,432,229,203
6445,13293,3231,6453,2531,10062,432,229,203
6450,13300,3233,6458,2532,10067,432,229,203
6455,13313,3233,6464,2532,10079,433,230,203
6460,13324,3233,6469,2532,10091,433,230,203
6465,13331,3235,6475,2534,10096,433,230,203
6470,13344,3235,6486,2534,10106,434,231,203
6475,13355,3235,6490,2534,10120,434,231,203
6480,13362,3237,6492,2535,10125,434,231,203
6485,13375,3237,6500,2535,10137,435,231,204
6490,13386,3237,6504,2535,10149,435,231,204
6495,13393,3239,6507,2535,10154,435,231,204
6500,13406,3239,6515,2535,10166,436,231,205
6505,13417,3240,6524,2536,10177,436,231,205
6510,13424,3242,6529,2538,10182,436,231,205
6515,13437,3243,6535,2539,10192,437,231,206
6520,13448,3245,6539,2541,10202,437,231,206
6525,13455,3248,6541,2542,10207,437,231,206
6530,13468,3251,6549,2544,10214,438,232,206
6535,13479,3258,6555,2550,10220,438,232,206
6540,13486,3261,6556,2551,10225,438,232,206
6545,13499,3264,6563,2553,10233,439,232,207
6550,13510,3268,6568,2556,10241,439,232,207
6555,13517,3271,6573,2559,10246,439,232,207
6560,13530,3274,6580,2561,10253,440,232,208
6565,13541,3281,6589,2568,10259,440,232,208
6570,13548,3284,6591,2570,10264,440,232,208
6575,13561,3286,6597,2572,10272,441,232,209
6580,13572,3293,6604,2579,10276,441,232,209
6585,13579,3299,6608,2584,10279,441,232,209
6590,13592,3304,6616,2589,10285,442,233,209
6595,13603,3307,6622,2592,10295,442,233,209
6600,13610,3310,6623,2593,10300,442,233,209
6605,13623,3313,6628,2596,10309,443,233,210
6610,13634,3317,6634,2600,10317,443,233,210
6615,13641,3319,6635,2600,10321,443,233,210
6620,13654,3321,6641,2601,10333,444,234,210
6625,13665,3322,6647,2602,10343,444,234,210
6630,13672,3324,6650,2604,10347,444,234,210
6635,13685,3326,6656,2605,10358,445,234,211
6640,13696,3327,6662,2606,10369,445,234,211
6645,13703,3329,6665,2608,10374,445,234,211
6650,13716,3330,6669,2609,10385,446,234,212
6655,13727,3331,6673,2610,10396,446,234,212
6660,13734,3332,6674,2610,10402,446,234,212
6665,13747,3334,6681,2612,10413,447,234,213
6670,13758,3334,6684,2612,10424,447,234,213
6675,13765,3336,6687,2613,10429,447,234,213
6680,13778,3337,6691,2613,10441,448,234,214
6685,13789,3338,6699,2614,10451,448,234,214
6690,13796,3340,6701,2615,10455,448,234,214
6695,13809,3343,6709,2618,10464,449,235,214
6700,13820,3345,6716,2619,10475,449,235,214
6705,13827,3346,6720,2620,10481,449,235,214
6710,13840,3346,6726,2620,10491,450,235,215
6715,13851,3348,6729,2622,10503,450,235,215
6720,13858,3349,6732,2622,10509,450,235,215
6725,13871,3350,6736,2623,10520,451,236,215
6730,13882,3353,6740,2625,10526,451,236,215
6735,13889,3358,6741,2628,10531,451,236,215
6740,13902,3360,6746,2630,10539,452,236,216
6745,13913,3364,6751,2633,10546,452,236,216
6750,13920,3370,6754,2638,10550,452,236,216
6755,13933,3370,6757,2638,10561,453,236,217
6760,13944,3374,6763,2641,10567,453,236,217
6765,13951,3380,6767,2647,10571,453,236,217
6770,13964,3381,6770,2648,10582,454,236,218
6775,13975,3382,6775,2649,10591,454,236,218
6780,13982,3386,6778,2651,10596,454,236,218
6785,13995,3389,6786,2654,10605,455,237,218
6790,14006,3391,6790,2656,10614,455,237,218
6795,14013,3394,6791,2657,10619,455,237,218
6800,14026,3395,6799,2658,10630,456,238,218
6805,14037,3396,6801,2659,10641,456,238,218
6810,14044,3398,6802,2660,10646,456,238,218
6815,14057,3399,6808,2661,10656,457,239,218
6820,14068,3401,6816,2663,10667,457,239,218
6825,14075,3405,6820,2666,10669,457,239,218
6830,14088,3408,6827,2668,10680,458,240,218
6835,14099,3410,6834,2670,10689,458,240,218
6840,14106,3413,6838,2672,10692,458,240,218
6845,14119,3416,6842,2674,10702,459,240,219
6850,14130,3416,6846,2674,10714,459,240,219
6855,14137,3419,6850,2676,10718,459,240,219
6860,14150,3421,6856,2678,10728,460,240,220
6865,14161,3422,6859,2679,10739,460,240,220
6870,14168,3425,6863,2681,10741,460,240,220
6875,14181,3428,6867,2683,10752,461,240,221
6880,14192,3429,6870,2684,10762,461,240,221
6885,14199,3432,6873,2686,10766,461,240,221
6890,14212,3434,6878,2687,10776,462,240,222
6895,14223,3437,6884,2690,10784,462,240,222
6900,14230,3442,6886,2693,10788,462,240,222
6905,14243,3442,6894,2693,10796,463,240,223
6910,14254,3447,6899,2698,10806,463,240,223
6915,14261,3450,6904,2701,10811,463,240,223
6920,14274,3452,6913,2703,10819,464,241,223
6925,14285,3455,6921,2706,10828,464,241,223
6930,14292,3458,6924,2707,10834,464,241,223
6935,14305,3459,6929,2708,10844,465,241,224
6940,14316,3460,6933,2708,10855,465,241,224
6945,14323,3462,6938,2710,10861,465,241,224
6950,14336,3464,6946,2712,10869,466,242,224
6955,14347,3466,6951,2713,10880,466,242,224
6960,14354,3469,6953,2714,10885,466,242,224
6965,14367,3469,6956,2714,10897,467,242,225
6970,14378,3471,6959,2715,10906,467,242,225
6975,14385,3474,6966,2718,10911,467,242,225
6980,14398,3475,6971,2719,10922,468,242,226
6985,14409,3478,6976,2721,10931,468,242,226
6990,14416,3480,6978,2722,10936,468,242,226
6995,14429,3480,6984,2722,10945,469,243,226
7000,14440,3485,6989,2726,10954,469,243,226
7005,14447,3488,6994,2729,10959,469,243,226
7010,14460,3490,7000,2731,10968,470,244,226
7015,14471,3496,7007,2737,10975,470,244,226
7020,14478,3497,7011,2738,10981,470,244,226
7025,14491,3499,7015,2739,10990,471,244,227
7030,14502,3504,7019,2743,10998,471,244,227
7035,14509,3505,7021,2743,11003,471,244,227
7040,14522,3509,7028,2746,11011,472,245,227
7045,14533,3513,7032,2749,11020,472,245,227
7050,14540,3515,7035,2750,11024,472,245,227
7055,14553,3518,7043,2752,11032,473,246,227
7060,14564,3523,7049,2757,11040,473,246,227
7065,14571,3526,7052,2759,11045,473,246,227
7070,14584,3530,7061,2762,11052,474,247,227
7075,14595,3536,7070,2768,11058,474,247,227
7080,14602,3538,7073,2770,11062,474,247,227
7085,14615,3541,7078,2772,11074,475,247,228
7090,14626,3541,7081,2772,11085,475,247,228
7095,14633,3542,7084,2773,11091,475,247,228
7100,14646,3542,7089,2773,11103,476,248,228
7105,14657,3542,7095,2773,11115,476,248,228
7110,14664,3543,7097,2773,11121,476,248,228
7115,14677,3543,7103,2773,11133,477,248,229
7120,14688,3543,7108,2773,11143,477,248,229
7125,14695,3547,7110,2776,11148,477,248,229
7130,14708,3548,7118,2777,11157,478,248,230
7135,14719,3548,7121,2777,11171,478,248,230
7140,14726,3550,7124,2778,11176,478,248,230
7145,14739,3551,7133,2779,11187,479,249,230
7150,14750,3552,7137,2780,11196,479,249,230
7155,14757,3555,7141,2781,11202,479,249,230
7160,14770,3556,7149,2782,11213,480,250,230
7165,14781,3558,7158,2784,11220,480,250,230
7170,14788,3562,7162,2787,11226,480,250,230
7175,14801,3563,7169,2788,11236,481,251,230
7180,14812,3563,7173,2788,11249,481,251,230
7185,14819,3565,7177,2789,11254,481,251,230
7190,14832,3567,7183,2791,11264,482,252,230
7195,14843,3569,7186,2793,11274,482,252,230
7200,14850,3571,7189,2794,11278,482,252,230
7205,14863,3574,7196,2797,11286,483,252,231
7210,14874,3578,7201,2801,11296,483,252,231
7215,14881,3580,7201,2801,11301,483,252,231
7220,14894,3582,7208,2803,11309,484,253,231
7225,14905,3586,7214,2807,11319,484,253,231
7230,14912,3588,7217,2808,11324,484,253,231
7235,14925,3590,7220,2809,11333,485,253,232
7240,14936,3594,7226,2812,11342,485,253,232
7245,14943,3596,7230,2814,11347,485,253,232
7250,14956,3598,7235,2815,11357,486,254,232
7255,14967,3601,7241,2818,11366,486,254,232
7260,14974,3603,7245,2819,11371,486,254,232
7265,14987,3605,7253,2821,11380,487,255,232
7270,14998,3608,7255,2823,11390,487,255,232
7275,15005,3610,7257,2824,11395,487,255,232
7280,15018,3612,7262,2825,11404,488,256,232
7285,15029,3615,7268,2828,11413,488,256,232
7290,15036,3618,7272,2831,11418,488,256,232
7295,15049,3622,7280,2834,11423,489,256,233
7300,15060,3628,7285,2839,11432,489,256,233
7305,15067,3631,7290,2842,11435,489,256,233
7310,15080,3636,7296,2846,11442,490,257,233
7315,15091,3641,7301,2851,11448,490,257,233
7320,15098,3645,7304,2854,11452,490,257,233
7325,15111,3648,7312,2857,11459,491,257,234
7330,15122,3654,7317,2863,11466,491,257,234
7335,15129,3658,7322,2867,11471,491,257,234
7340,15142,3659,7330,2868,11479,492,257,235
7345,15153,3661,7337,2870,11489,492,257,235
7350,15160,3665,7341,2873,11494,492,257,235
7355,15173,3666,7348,2874,11505,493,258,235
7360,15184,3666,7352,2874,11517,493,258,235
7365,15191,3669,7355,2877,11522,493,258,235
7370,15204,3669,7356,2877,11535,494,259,235
7375,15215,3670,7363,2878,11542,494,259,235
7380,15222,3674,7368,2882,11548,494,259,235
7385,15235,3674,7372,2882,11560,495,260,235
7390,15246,3674,7375,2882,11572,495,260,235
7395,15253,3675,7382,2883,11578,495,260,235
7400,15266,3675,7386,2883,11590,496,261,235
7405,15277,3675,7390,2883,11602,496,261,235
7410,15284,3676,7391,2883,11608,496,261,235
7415,15297,3676,7394,2883,11621,497,261,236
7420,15308,3676,7400,2883,11632,497,261,236
7425,15315,3679,7405,2885,11635,497,261,236
7430,15328,3682,7412,2887,11645,498,261,237
7435,15339,3684,7417,2889,11655,498,261,237
7440,15346,3687,7421,2891,11658,498,261,237
7445,15359,3689,7429,2893,11670,499,262,237
7450,15370,3691,7437,2895,11679,499,262,237
7455,15377,3692,7440,2896,11685,499,262,237
7460,15390,3694,7447,2897,11694,500,263,237
7465,15401,3697,7451,2900,11704,500,263,237
7470,15408,3698,7455,2901,11710,500,263,237
7475,15421,3700,7458,2903,11721,501,263,238
7480,15432,3702,7463,2904,11730,501,263,238
7485,15439,3704,7465,2904,11735,501,263,238
7490,15452,3708,7473,2908,11741,502,263,239
7495,15463,3714,7476,2913,11749,502,263,239
7500,15470,3716,7479,2915,11754,502,263,239
7505,15483,3719,7487,2918,11761,503,263,240
7510,15494,3726,7494,2925,11766,503,263,240
7515,15501,3730,7496,2927,11770,503,263,240
7520,15514,3735,7504,2931,11776,504,263,241
7525,15525,3742,7509,2937,11781,504,263,241
7530,15532,3747,7512,2941,11785,504,263,241
7535,15545,3749,7519,2942,11795,505,263,242
7540,15556,3752,7525,2945,11802,505,263,242
7545,15563,3756,7529,2948,11805,505,263,242
7550,15576,3758,7535,2949,11816,506,264,242
7555,15587,3761,7542,2952,11824,506,264,242
7560,15594,3765,7545,2956,11829,506,264,242
7565,15607,3768,7553,2959,11837,507,265,242
7570,15618,3770,7560,2961,11847,507,265,242
7575,15625,3771,7564,2961,11854,507,265,242
7580,15638,3771,7575,2961,11865,508,265,243
7585,15649,3771,7581,2961,11878,508,265,243
7590,15656,3772,7584,2961,11884,508,265,243
7595,15669,3772,7592,2961,11895,509,265,244
7600,15680,3772,7601,2961,11908,509,265,244
7605,15687,3773,7605,2962,11914,509,265,244
7610,15700,3773,7609,2962,11927,510,265,245
7615,15711,3773,7614,2962,11938,510,265,245
7620,15718,3774,7618,2963,11944,510,265,245
7625,15731,3774,7625,2963,11955,511,266,245
7630,15742,3774,7631,2963,11968,511,266,245
7635,15749,3775,7635,2964,11974,511,266,245
7640,15762,3775,7642,2964,11985,512,267,245
7645,15773,3777,7646,2965,11996,512,267,245
7650,15780,3778,7650,2965,12002,512,267,245
7655,15793,3778,7657,2965,12013,513,268,245
7660,15804,3780,7661,2967,12024,513,268,245
7665,15811,3781,7662,2968,12030,513,268,245
7670,15824,3782,7671,2969,12039,514,269,245
7675,15835,3786,7678,2973,12049,514,269,245
7680,15842,3788,7680,2974,12053,514,269,245
7685,15855,3792,7689,2978,12060,515,270,245
7690,15866,3798,7694,2983,12068,515,270,245
7695,15873,3802,7699,2986,12070,515,270,245
7700,15886,3806,7705,2989,12077,516,270,246
7705,15897,3810,7708,2992,12087,516,270,246
7710,15904,3813,7711,2993,12091,516,270,246
7715,15917,3817,7717,2997,12099,517,270,247
7720,15928,3821,7720,3000,12106,517,270,247
7725,15935,3825,7722,3002,12109,517,270,247
7730,15948,3830,7728,3007,12117,518,270,248
7735,15959,3832,7733,3009,12126,518,270,248
7740,15966,3836,7737,3012,12129,518,270,248
7745,15979,3839,7745,3015,12137,519,271,248
7750,15990,3843,7755,3019,12144,519,271,248
7755,15997,3848,7758,3022,12148,519,271,248
7760,16010,3852,7765,3025,12156,520,272,248
7765,16021,3853,7772,3026,12166,520,272,248
7770,16028,3857,7777,3029,12171,520,272,248
7775,16041,3857,7782,3029,12183,521,273,248
7780,16052,3859,7791,3031,12190,521,273,248
7785,16059,3863,7794,3034,12196,521,273,248
7790,16072,3864,7798,3035,12207,522,274,248
7795,16083,3864,7804,3035,12216,522,274,248
7800,16090,3868,7809,3038,12222,522,274,248
7805,16103,3868,7817,3038,12235,523,274,249
7810,16114,3868,7824,3038,12246,523,274,249
7815,16121,3869,7827,3039,12252,523,274,249
7820,16134,3869,7837,3039,12263,524,275,249
7825,16145,3869,7844,3039,12276,524,275,249
7830,16152,3870,7849,3040,12282,524,275,249
7835,16165,3870,7857,3040,12294,525,275,250
7840,16176,3871,7860,3040,12305,525,275,250
7845,16183,3872,7861,3040,12311,525,275,250
7850,16196,3873,7865,3041,12322,526,276,250
7855,16207,3874,7871,3042,12333,526,276,250
7860,16214,3875,7875,3043,12339,526,276,250
7865,16227,3876,7884,3044,12350,527,276,251
7870,16238,3878,7887,3045,12360,527,276,251
7875,16245,3879,7891,3045,12366,527,276,251
7880,16258,3881,7897,3047,12376,528,276,252
7885,16269,3884,7902,3050,12385,528,276,252
7890,16276,3885,7905,3051,12391,528,276,252
7895,16289,3887,7912,3052,12399,529,276,253
7900,16300,3893,7918,3057,12407,529,276,253
7905,16307,3896,7922,3060,12411,529,276,253
7910,16320,3900,7930,3063,12418,530,277,253
7915,16331,3904,7935,3066,12424,530,277,253
7920,16338,3911,7939,3072,12426,530,277,253
7925,16351,3916,7943,3076,12434,531,277,254
7930,16362,3921,7948,3081,12440,531,277,254
7935,16369,3926,7952,3084,12442,531,277,254
7940,16382,3928,7958,3085,12452,532,277,255
7945,16393,3933,7964,3090,12459,532,277,255
7950,16400,3937,7969,3093,12461,532,277,255
7955,16413,3941,7977,3097,12471,533,277,256
7960,16424,3943,7981,3099,12481,533,277,256
7965,16431,3946,7986,3101,12483,533,277,256
7970,16444,3948,7989,3102,12495,534,277,257
7975,16455,3950,7996,3104,12504,534,277,257
7980,16462,3952,7999,3106,12509,534,277,257
7985,16475,3954,8007,3108,12518,535,277,258
7990,16486,3956,8012,3110,12529,535,277,258
7995,16493,3958,8013,3110,12535,535,277,258
8000,16506,3958,8017,3110,12547,536,277,259
8005,16517,3959,8023,3111,12558,536,277,259
8010,16524,3961,8027,3111,12563,536,277,259
8015,16537,3961,8032,3111,12575,537,277,260
8020,16548,3961,8038,3111,12587,537,277,260
8025,16555,3963,8041,3111,12592,537,277,260
8030,16568,3963,8047,3111,12604,538,277,261
8035,16579,3965,8053,3112,12614,538,277,261
8040,16586,3967,8055,3113,12619,538,277,261
8045,16599,3968,8059,3114,12630,539,277,262
8050,16610,3970,8065,3115,12640,539,277,262
8055,16617,3972,8069,3116,12645,539,277,262
8060,16630,3973,8075,3117,12653,540,277,263
8065,16641,3976,8079,3119,12664,540,277,263
8070,16648,3979,8082,3120,12669,540,277,263
8075,16661,3980,8090,3121,12677,541,277,264
8080,16672,3984,8092,3124,12688,541,277,264
8085,16679,3986,8097,3126,12693,541,277,264
8090,16692,3989,8105,3129,12700,542,277,265
8095,16703,3992,8107,3131,12711,542,277,265
8100,16710,3995,8109,3133,12715,542,277,265
8105,16723,3996,8113,3134,12725,543,277,266
8110,16734,4000,8117,3138,12732,543,277,266
8115,16741,4005,8118,3141,12736,543,277,266
8120,16754,4008,8124,3144,12743,544,277,267
8125,16765,4017,8130,3153,12748,544,277,267
8130,16772,4020,8132,3155,12752,544,277,267
8135,16785,4023,8138,3158,12760,545,277,268
8140,16796,4024,8142,3159,12771,545,277,268
8145,16803,4027,8146,3162,12775,545,277,268
8150,16816,4031,8153,3165,12783,546,277,269
8155,16827,4034,8160,3168,12791,546,277,269
8160,16834,4039,8163,3172,12795,546,277,269
8165,16847,4041,8169,3173,12804,547,278,269
8170,16858,4043,8174,3175,12814,547,278,269
8175,16865,4044,8177,3176,12821,547,278,269
8180,16878,4045,8183,3176,12831,548,278,270
8185,16889,4045,8188,3176,12844,548,278,270
8190,16896,4047,8191,3177,12848,548,278,270
8195,16909,4049,8199,3179,12856,549,278,271
8200,16920,4051,8206,3181,12869,549,278,271
8205,16927,4053,8209,3182,12873,549,278,271
8210,16940,4055,8215,3183,12882,550,278,272
8215,16951,4056,8218,3184,12895,550,278,272
8220,16958,4057,8222,3185,12900,550,278,272
8225,16971,4058,8228,3186,12912,551,278,273
8230,16982,4058,8234,3186,12924,551,278,273
8235,16989,4059,8238,3187,12930,551,278,273
8240,17002,4059,8243,3187,12943,552,279,273
8245,17013,4060,8250,3187,12953,552,279,273
8250,17020,4061,8251,3187,12959,552,279,273
8255,17033,4062,8257,3188,12971,553,279,274
8260,17044,4063,8263,3189,12981,553,279,274
8265,17051,4064,8267,3189,12987,553,279,274
8270,17064,4065,8275,3190,12997,554,280,274
8275,17075,4069,8282,3193,13004,554,280,274
8280,17082,4073,8285,3195,13009,554,280,274
8285,17095,4075,8293,3197,13018,555,281,274
8290,17106,4078,8299,3199,13026,555,281,274
8295,17113,4082,8303,3201,13031,555,281,274
8300,17126,4083,8309,3202,13041,556,282,274
8305,17137,4087,8313,3206,13049,556,282,274
8310,17144,4090,8315,3208,13054,556,282,274
8315,17157,4091,8321,3209,13064,557,283,274
8320,17168,4099,8329,3216,13067,557,283,274
8325,17175,4104,8335,3221,13070,557,283,274
8330,17188,4108,8342,3225,13076,558,283,275
8335,17199,4114,8348,3231,13084,558,283,275
8340,17206,4117,8352,3233,13088,558,283,275
8345,17219,4118,8356,3233,13099,559,283,276
8350,17230,4121,8360,3236,13107,559,283,276
8355,17237,4125,8363,3238,13112,559,283,276
8360,17250,4126,8368,3238,13121,560,283,277
8365,17261,4130,8371,3242,13131,560,283,277
8370,17268,4132,8374,3243,13136,560,283,277
8375,17281,4134,8380,3244,13145,561,284,277
8380,17292,4136,8383,3246,13155,561,284,277
8385,17299,4139,8386,3248,13160,561,284,277
8390,17312,4140,8392,3249,13170,562,284,278
8395,17323,4144,8401,3253,13178,562,284,278
8400,17330,4147,8405,3256,13183,562,284,278
8405,17343,4148,8411,3257,13194,563,284,279
8410,17354,4149,8416,3258,13205,563,284,279
8415,17361,4150,8418,3258,13211,563,284,279
8420,17374,4152,8421,3259,13221,564,284,280
8425,17385,4153,8424,3260,13232,564,284,280
8430,17392,4154,8425,3260,13238,564,284,280
8435,17405,4155,8432,3261,13248,565,285,280
8440,17416,4156,8437,3262,13260,565,285,280
8445,17423,4159,8441,3264,13263,565,285,280
8450,17436,4161,8446,3265,13274,566,286,280
8455,17447,4164,8453,3268,13282,566,286,280
8460,17454,4166,8455,3269,13288,566,286,280
8465,17467,4170,8460,3272,13297,567,286,281
8470,17478,4172,8465,3274,13306,567,286,281
8475,17485,4173,8471,3275,13312,567,286,281
8480,17498,4174,8476,3276,13323,568,286,282
8485,17509,4176,8482,3277,13333,568,286,282
8490,17516,4177,8486,3277,13339,568,286,282
8495,17529,4177,8490,3277,13350,569,286,283
8500,17540,4179,8497,3278,13360,569,286,283
8505,17547,4182,8501,3280,13365,569,286,283
8510,17560,4183,8505,3281,13375,570,287,283
8515,17571,4190,8512,3287,13380,570,287,283
8520,17578,4194,8516,3289,13383,570,287,283
8525,17591,4197,8523,3292,13393,571,288,283
8530,17602,4197,8528,3292,13405,571,288,283
8535,17609,4199,8534,3293,13409,571,288,283
8540,17622,4199,8537,3293,13423,572,288,284
8545,17633,4199,8541,3293,13434,572,288,284
8550,17640,4201,8547,3294,13439,572,288,284
8555,17653,4201,8555,3294,13449,573,288,285
8560,17664,4202,8561,3295,13462,573,288,285
8565,17671,4204,8563,3296,13467,573,288,285
8570,17684,4204,8570,3296,13478,574,289,285
8575,17695,4204,8571,3296,13491,574,289,285
8580,17702,4207,8575,3298,13494,574,289,285
8585,17715,4210,8582,3300,13503,575,289,286
8590,17726,4212,8588,3302,13512,575,289,286
8595,17733,4216,8591,3306,13516,575,289,286
8600,17746,4218,8596,3308,13526,576,289,287
8605,17757,4220,8602,3310,13536,576,289,287
8610,17764,4223,8603,3311,13540,576,289,287
8615,17777,4227,8610,3314,13550,577,289,288
8620,17788,4228,8615,3315,13558,577,289,288
8625,17795,4234,8617,3319,13561,577,289,288
8630,17808,4237,8623,3321,13568,578,290,288
8635,17819,4242,8629,3325,13576,578,290,288
8640,17826,4246,8632,3328,13580,578,290,288
8645,17839,4249,8637,3330,13588,579,290,289
8650,17850,4255,8644,3335,13594,579,290,289
8655,17857,4258,8647,3337,13599,579,290,289
8660,17870,4260,8654,3339,13606,580,290,290
8665,17881,4266,8660,3344,13613,580,290,290
8670,17888,4270,8665,3348,13618,580,290,290
8675,17901,4273,8672,3350,13625,581,290,291
8680,17912,4278,8678,3355,13632,581,290,291
8685,17919,4282,8679,3357,13637,581,290,291
8690,17932,4286,8686,3360,13642,582,290,292
8695,17943,4293,8692,3367,13650,582,290,292
8700,17950,4294,8697,3368,13655,582,290,292
8705,17963,4295,8703,3368,13666,583,291,292
8710,17974,4297,8711,3370,13676,583,291,292
8715,17981,4298,8714,3370,13682,583,291,292
8720,17994,4299,8722,3371,13692,584,291,293
8725,18005,4302,8727,3374,13703,584,291,293
8730,18012,4303,8732,3375,13708,584,291,293
8735,18025,4304,8741,3375,13718,585,291,294
8740,18036,4306,8747,3377,13729,585,291,294
8745,18043,4307,8750,3377,13736,585,291,294
8750,18056,4307,8758,3377,13747,586,292,294
8755,18067,4307,8765,3377,13760,586,292,294
8760,18074,4308,8771,3378,13766,586,292,294
8765,18087,4308,8773,3378,13779,587,292,295
8770,18098,4308,8776,3378,13790,587,292,295
8775,18105,4309,8779,3379,13796,587,292,295
8780,18118,4309,8785,3379,13809,588,292,296
8785,18129,4309,8792,3379,13820,588,292,296
8790,18136,4310,8794,3380,13826,588,292,296
8795,18149,4311,8801,3381,13837,589,292,297
8800,18160,4312,8808,3382,13848,589,292,297
8805,18167,4314,8809,3383,13853,589,292,297
8810,18180,4314,8813,3383,13864,590,293,297
8815,18191,4316,8820,3385,13875,590,293,297
8820,18198,4318,8825,3387,13880,590,293,297
8825,18211,4318,8832,3387,13891,591,294,297
8830,18222,4321,8837,3389,13901,591,294,297
8835,18229,4323,8842,3391,13906,591,294,297
8840,18242,4324,8849,3392,13917,592,294,298
8845,18253,4328,8856,3395,13925,592,294,298
8850,18260,4331,8859,3397,13929,592,294,298
8855,18273,4334,8865,3399,13938,593,294,299
8860,18284,4338,8871,3403,13945,593,294,299
8865,18291,4342,8873,3405,13948,593,294,299
8870,18304,4344,8877,3406,13956,594,294,300
8875,18315,4350,8881,3412,13964,594,294,300
8880,18322,4354,8885,3415,13966,594,294,300
8885,18335,4361,8892,3421,13972,595,294,301
8890,18346,4365,8898,3425,13980,595,294,301
8895,18353,4367,8901,3426,13984,595,294,301
8900,18366,4370,8909,3428,13994,596,294,302
8905,18377,4372,8915,3430,14004,596,294,302
8910,18384,4376,8920,3434,14007,596,294,302
8915,18397,4380,8928,3437,14015,597,294,303
8920,18408,4383,8935,3440,14023,597,294,303
8925,18415,4388,8940,3445,14027,597,294,303
8930,18428,4390,8949,3446,14037,598,295,303
8935,18439,4390,8954,3446,14048,598,295,303
8940,18446,4393,8956,3448,14053,598,295,303
8945,18459,4393,8965,3448,14064,599,296,303
8950,18470,4393,8971,3448,14076,599,296,303
8955,18477,4396,8972,3449,14081,599,296,303
8960,18490,4397,8978,3450,14092,600,296,304
8965,18501,4397,8981,3450,14103,600,296,304
8970,18508,4400,8987,3453,14108,600,296,304
8975,18521,4401,8992,3454,14119,601,296,305
8980,18532,4401,8997,3454,14130,601,296,305
8985,18539,4404,9000,3456,14135,601,296,305
8990,18552,4404,9004,3456,14147,602,296,306
8995,18563,4408,9011,3459,14154,602,296,306
9000,18570,4411,9016,3462,14159,602,296,306
9005,18583,4412,9024,3463,14170,603,297,306
9010,18594,4414,9030,3465,14178,603,297,306
9015,18601,4418,9033,3468,14183,603,297,306
9020,18614,4418,9037,3468,14195,604,298,306
9025,18625,4422,9042,3472,14202,604,298,306
9030,18632,4425,9046,3474,14207,604,298,306
9035,18645,4425,9051,3474,14216,605,298,307
9040,18656,4434,9059,3483,14220,605,298,307
9045,18663,4438,9061,3486,14224,605,298,307
9050,18676,4444,9071,3491,14227,606,299,307
9055,18687,4450,9075,3496,14234,606,299,307
9060,18694,4454,9076,3499,14240,606,299,307
9065,18707,4455,9081,3500,14250,607,299,308
9070,18718,4456,9085,3501,14261,607,299,308
9075,18725,4459,9089,3503,14265,607,299,308
9080,18738,4460,9099,3504,14275,608,300,308
9085,18749,4463,9106,3507,14286,608,300,308
9090,18756,4465,9109,3508,14291,608,300,308
9095,18769,4466,9115,3509,14302,609,300,309
9100,18780,4467,9118,3510,14313,609,300,309
9105,18787,4469,9121,3512,14318,609,300,309
9110,18800,4471,9130,3513,14326,610,300,310
9115,18811,4473,9135,3515,14338,610,300,310
9120,18818,4475,9137,3516,14342,610,300,310
9125,18831,4477,9141,3517,14353,611,300,311
9130,18842,4478,9149,3518,14364,611,300,311
9135,18849,4481,9154,3521,14368,611,300,311
9140,18862,4481,9161,3521,14380,612,300,312
9145,18873,4481,9168,3521,14392,612,300,312
9150,18880,4482,9173,3521,14398,612,300,312
9155,18893,4482,9179,3521,14410,613,300,313
9160,18904,4482,9186,3521,14422,613,300,313
9165,18911,4484,9189,3522,14427,613,300,313
9170,18924,4486,9194,3524,14437,614,300,314
9175,18935,4488,9199,3525,14447,614,300,314
9180,18942,4490,9202,3527,14452,614,300,314
9185,18955,4491,9209,3528,14463,615,300,315
9190,18966,4492,9212,3528,14474,615,300,315
9195,18973,4494,9217,3529,14479,615,300,315
9200,18986,4496,9225,3531,14489,616,301,315
9205,18997,4499,9229,3534,14498,616,301,315
9210,19004,4501,9230,3534,14503,616,301,315
9215,19017,4502,9236,3535,14513,617,302,315
9220,19028,4506,9240,3538,14521,617,302,315
9225,19035,4510,9245,3541,14524,617,302,315
9230,19048,4512,9252,3543,14532,618,303,315
9235,19059,4518,9254,3548,14541,618,303,315
9240,19066,4521,9257,3551,14545,618,303,315
9245,19079,4523,9265,3552,14553,619,303,316
9250,19090,4524,9271,3553,14565,619,303,316
9255,19097,4526,9277,3555,14571,619,303,316
9260,19110,4527,9283,3556,14581,620,303,317
9265,19121,4527,9288,3556,14593,620,303,317
9270,19128,4529,9293,3558,14599,620,303,317
9275,19141,4531,9300,3560,14608,621,304,317
9280,19152,4532,9304,3561,14620,621,304,317
9285,19159,4534,9306,3561,14625,621,304,317
9290,19172,4536,9311,3562,14635,622,304,318
9295,19183,4538,9318,3564,14642,622,304,318
9300,19190,4544,9322,3569,14645,622,304,318
9305,19203,4547,9332,3572,14653,623,304,319
9310,19214,4550,9336,3575,14664,623,304,319
9315,19221,4553,9340,3576,14667,623,304,319
9320,19234,4555,9346,3578,14678,624,304,320
9325,19245,4555,9349,3578,14689,624,304,320
9330,19252,4558,9351,3580,14694,624,304,320
9335,19265,4561,9358,3582,14702,625,304,321
9340,19276,4564,9364,3585,14711,625,304,321
9345,19283,4567,9366,3587,14716,625,304,321
9350,19296,4569,9370,3588,14725,626,304,322
9355,19307,4574,9374,3593,14732,626,304,322
9360,19314,4579,9377,3596,14735,626,304,322
9365,19327,4581,9383,3598,14744,627,304,323
9370,19338,4586,9391,3603,14751,627,304,323
9375,19345,4589,9394,3604,14756,627,304,323
9380,19358,4592,9401,3607,14765,628,304,324
9385,19369,4596,9407,3610,14771,628,304,324
9390,19376,4600,9409,3613,14776,628,304,324
9395,19389,4603,9415,3616,14786,629,305,324
9400,19400,4605,9421,3618,14793,629,305,324
9405,19407,4609,9424,3622,14798,629,305,324
9410,19420,4612,9432,3625,14806,630,305,325
9415,19431,4615,9436,3628,14814,630,305,325
9420,19438,4620,9440,3632,14817,630,305,325
9425,19451,4624,9448,3636,14825,631,305,326
9430,19462,4629,9454,3641,14832,631,305,326
9435,19469,4630,9457,3642,14839,631,305,326
9440,19482,4630,9463,3642,14851,632,305,327
9445,19493,4630,9471,3642,14862,632,305,327
9450,19500,4631,9472,3642,14869,632,305,327
9455,19513,4631,9477,3642,14882,633,305,328
9460,19524,4631,9485,3642,14892,633,305,328
9465,19531,4632,9489,3643,14899,633,305,328
9470,19544,4632,9495,3643,14911,634,305,329
9475,19555,4632,9500,3643,14922,634,305,329
9480,19562,4634,9503,3645,14927,634,305,329
9485,19575,4637,9508,3647,14937,635,305,330
9490,19586,4637,9515,3647,14949,635,305,330
9495,19593,4638,9518,3648,14955,635,305,330
9500,19606,4640,9524,3648,14965,636,306,330
9505,19617,4640,9528,3648,14977,636,306,330
9510,19624,4641,9531,3649,14983,636,306,330
9515,19637,4643,9538,3650,14993,637,306,331
9520,19648,4643,9542,3650,15005,637,306,331
9525,19655,4644,9545,3651,15011,637,306,331
9530,19668,4646,9552,3652,15022,638,307,331
9535,19679,4646,9558,3652,15033,638,307,331
9540,19686,4648,9561,3653,15038,638,307,331
9545,19699,4651,9569,3655,15047,639,308,331
9550,19710,4653,9573,3656,15057,639,308,331
9555,19717,4656,9577,3657,15061,639,308,331
9560,19730,4658,9583,3659,15070,640,308,332
9565,19741,4663,9591,3664,15078,640,308,332
9570,19748,4665,9597,3666,15083,640,308,332
9575,19761,4668,9603,3669,15091,641,308,333
9580,19772,4672,9608,3673,15100,641,308,333
9585,19779,4675,9612,3675,15104,641,308,333
9590,19792,4678,9615,3676,15113,642,308,334
9595,19803,4680,9622,3678,15123,642,308,334
9600,19810,4683,9628,3680,15127,642,308,334
9605,19823,4685,9633,3681,15136,643,308,335
9610,19834,4688,9637,3684,15146,643,308,335
9615,19841,4690,9642,3686,15151,643,308,335
9620,19854,4693,9650,3689,15159,644,309,335
9625,19865,4698,9657,3693,15166,644,309,335
9630,19872,4701,9661,3696,15170,644,309,335
9635,19885,4704,9665,3698,15180,645,310,335
9640,19896,4708,9670,3702,15187,645,310,335
9645,19903,4712,9674,3705,15190,645,310,335
9650,19916,4717,9679,3709,15197,646,310,336
9655,19927,4724,9684,3715,15202,646,310,336
9660,19934,4728,9688,3718,15205,646,310,336
9665,19947,4731,9693,3719,15214,647,311,336
9670,19958,4734,9697,3722,15223,647,311,336
9675,19965,4737,9699,3723,15227,647,311,336
9680,19978,4739,9706,3724,15237,648,312,336
9685,19989,4739,9709,3724,15250,648,312,336
9690,19996,4740,9713,3725,15256,648,312,336
9695,20009,4742,9718,3726,15267,649,313,336
9700,20020,4742,9726,3726,15277,649,313,336
9705,20027,4743,9729,3726,15284,649,313,336
9710,20040,4745,9734,3726,15294,650,313,337
9715,20051,4745,9738,3726,15306,650,313,337
9720,20058,4746,9744,3727,15312,650,313,337
9725,20071,4748,9753,3729,15322,651,314,337
9730,20082,4748,9759,3729,15334,651,314,337
9735,20089,4749,9762,3729,15340,651,314,337
9740,20102,4751,9771,3729,15350,652,314,338
9745,20113,4751,9774,3729,15362,652,314,338
9750,20120,4752,9776,3730,15368,652,314,338
9755,20133,4754,9780,3730,15378,653,314,339
9760,20144,4754,9786,3730,15390,653,314,339
9765,20151,4755,9788,3730,15396,653,314,339
9770,20164,4758,9793,3732,15405,654,314,340
9775,20175,4759,9796,3732,15416,654,314,340
9780,20182,4760,9801,3733,15422,654,314,340
9785,20195,4762,9806,3734,15430,655,314,341
9790,20206,4766,9811,3738,15440,655,314,341
9795,20213,4768,9816,3740,15445,655,314,341
9800,20226,4772,9822,3742,15453,656,315,341
9805,20237,4775,9828,3744,15461,656,315,341
9810,20244,4778,9830,3746,15466,656,315,341
9815,20257,4781,9835,3748,15476,657,315,342
9820,20268,4783,9839,3750,15484,657,315,342
9825,20275,4787,9843,3754,15487,657,315,342
9830,20288,4791,9846,3756,15497,658,316,342
9835,20299,4793,9848,3757,15505,658,316,342
9840,20306,4798,9853,3762,15507,658,316,342
9845,20319,4802,9858,3765,15514,659,316,343
9850,20330,4809,9864,3771,15520,659,316,343
9855,20337,4813,9868,3775,15523,659,316,343
9860,20350,4816,9872,3777,15534,660,317,343
9865,20361,4817,9876,3778,15543,660,317,343
9870,20368,4822,9881,3783,15545,660,317,343
9875,20381,4825,9889,3786,15555,661,317,344
9880,20392,4828,9895,3789,15563,661,317,344
9885,20399,4830,9899,3790,15569,661,317,344
9890,20412,4832,9905,3792,15579,662,317,345
9895,20423,4832,9909,3792,15590,662,317,345
9900,20430,4833,9912,3792,15597,662,317,345
9905,20443,4835,9919,3794,15607,663,317,346
9910,20454,4835,9924,3794,15619,663,317,346
9915,20461,4836,9925,3795,15625,663,317,346
9920,20474,4838,9934,3796,15634,664,318,346
9925,20485,4838,9939,3796,15646,664,318,346
9930,20492,4839,9943,3797,15653,664,318,346
9935,20505,4841,9950,3799,15663,665,318,347
9940,20516,4841,9956,3799,15674,665,318,347
9945,20523,4842,9960,3800,15681,665,318,347
9950,20536,4844,9964,3801,15692,666,318,348
9955,20547,4845,9968,3801,15702,666,318,348
9960,20554,4846,9972,3801,15708,666,318,348
9965,20567,4848,9978,3803,15717,667,319,348
9970,20578,4850,9982,3804,15728,667,319,348
9975,20585,4851,9985,3805,15734,667,319,348
9980,20598,4853,9991,3805,15742,668,320,348
9985,20609,4856,10000,3807,15753,668,320,348
9990,20616,4859,10006,3809,15757,668,320,348
9995,20629,4862,10016,3811,15764,669,321,348
10000,20640,4866,10019,3814,15774,669,321,348
10005,20647,4868,10022,3814,15779,669,321,348
10010,20660,4870,10027,3815,15789,670,322,348
10015,20671,4871,10034,3816,15799,670,322,348
10020,20678,4874,10037,3819,15804,670,322,348
10025,20691,4877,10042,3820,15813,671,322,349
10030,20702,4881,10047,3824,15820,671,322,349
10035,20709,4885,10049,3826,15824,671,322,349
10040,20722,4888,10053,3827,15832,672,323,349
10045,20733,4891,10059,3829,15839,672,323,349
10050,20740,4896,10064,3834,15842,672,323,349
10055,20753,4902,10069,3839,15850,673,324,349
10060,20764,4907,10076,3844,15854,673,324,349
10065,20771,4913,10078,3848,15858,673,324,349
10070,20784,4915,10082,3850,15868,674,324,350
10075,20795,4918,10088,3853,15874,674,324,350
10080,20802,4923,10092,3857,15877,674,324,350
10085,20815,4926,10100,3859,15886,675,325,350
10090,20826,4928,10105,3861,15898,675,325,350
10095,20833,4929,10109,3861,15904,675,325,350
10100,20846,4931,10117,3863,15914,676,326,350
10105,20857,4931,10124,3863,15925,676,326,350
10110,20864,4932,10128,3864,15932,676,326,350
10115,20877,4934,10132,3864,15942,677,327,350
10120,20888,4934,10136,3864,15953,677,327,350
10125,20895,4935,10139,3865,15960,677,327,350
10130,20908,4937,10149,3866,15968,678,328,350
10135,20919,4937,10152,3866,15982,678,328,350
10140,20926,4938,10156,3867,15988,678,328,350
10145,20939,4940,10161,3867,15999,679,329,350
10150,20950,4940,10165,3867,16010,679,329,350
10155,20957,4941,10168,3867,16016,679,329,350
10160,20970,4943,10174,3868,16027,680,329,351
10165,20981,4943,10179,3868,16038,680,329,351
10170,20988,4944,10182,3869,16044,680,329,351
10175,21001,4947,10189,3871,16053,681,330,351
10180,21012,4949,10193,3872,16063,681,330,351
10185,21019,4950,10193,3872,16069,681,330,351
10190,21032,4952,10200,3873,16079,682,330,352
10195,21043,4956,10204,3876,16087,682,330,352
10200,21050,4959,10208,3877,16091,682,330,352
10205,21063,4963,10215,3880,16099,683,331,352
10210,21074,4966,10218,3882,16108,683,331,352
10215,21081,4969,10221,3883,16112,683,331,352
10220,21094,4973,10230,3887,16121,684,332,352
10225,21105,4974,10234,3887,16130,684,332,352
10230,21112,4978,10237,3890,16134,684,332,352
10235,21125,4981,10243,3893,16143,685,332,353
10240,21136,4987,10250,3899,16148,685,332,353
10245,21143,4991,10252,3902,16152,685,332,353
10250,21156,4994,10258,3903,16158,686,333,353
10255,21167,5000,10262,3909,16165,686,333,353
10260,21174,5004,10263,3911,16170,686,333,353
10265,21187,5007,10271,3913,16178,687,334,353
10270,21198,5007,10273,3913,16190,687,334,353
10275,21205,5010,10277,3915,16194,687,334,353
10280,21218,5013,10285,3917,16201,688,334,354
10285,21229,5017,10293,3921,16209,688,334,354
10290,21236,5022,10298,3925,16214,688,334,354
10295,21249,5024,10305,3926,16224,689,335,354
10300,21260,5024,10312,3926,16235,689,335,354
10305,21267,5025,10314,3926,16242,689,335,354
10310,21280,5027,10317,3927,16252,690,335,355
10315,21291,5027,10324,3927,16264,690,335,355
10320,21298,5028,10327,3927,16270,690,335,355
10325,21311,5030,10333,3928,16280,691,336,355
10330,21322,5030,10334,3928,16292,691,336,355
10335,21329,5031,10336,3928,16298,691,336,355
10340,21342,5033,10344,3929,16309,692,336,356
10345,21353,5033,10350,3929,16320,692,336,356
10350,21360,5034,10353,3930,16326,692,336,356
10355,21373,5036,10359,3932,16337,693,336,357
10360,21384,5036,10365,3932,16348,693,336,357
10365,21391,5037,10369,3933,16354,693,336,357
10370,21404,5040,10376,3934,16363,694,336,358
10375,21415,5042,10381,3936,16373,694,336,358
10380,21422,5043,10382,3936,16379,694,336,358
10385,21435,5046,10389,3937,16387,695,336,359
10390,21446,5048,10394,3939,16398,695,336,359
10395,21453,5049,10400,3940,16404,695,336,359
10400,21466,5051,10407,3942,16413,696,336,360
10405,21477,5056,10417,3947,16419,696,336,360
10410,21484,5060,10421,3951,16423,696,336,360
10415,21497,5063,10424,3952,16433,697,336,361
10420,21508,5067,10427,3955,16441,697,336,361
10425,21515,5069,10429,3956,16446,697,336,361
10430,21528,5073,10437,3959,16451,698,337,361
10435,21539,5081,10440,3966,16458,698,337,361
10440,21546,5085,10444,3969,16460,698,337,361
10445,21559,5088,10452,3970,16469,699,337,362
10450,21570,5090,10459,3972,16477,699,337,362
10455,21577,5095,10463,3976,16480,699,337,362
10460,21590,5099,10471,3978,16488,700,338,362
10465,21601,5102,10475,3981,16498,700,338,362
10470,21608,5104,10481,3983,16504,700,338,362
10475,21621,5106,10490,3984,16514,701,339,362
10480,21632,5106,10494,3984,16525,701,339,362
10485,21639,5107,10496,3985,16532,701,339,362
10490,21652,5109,10504,3986,16542,702,340,362
10495,21663,5109,10511,3986,16554,702,340,362
10500,21670,5110,10516,3987,16560,702,340,362
10505,21683,5112,10519,3987,16571,703,340,363
10510,21694,5112,10527,3987,16582,703,340,363
10515,21701,5113,10530,3988,16588,703,340,363
10520,21714,5115,10536,3989,16599,704,341,363
10525,21725,5115,10541,3989,16610,704,341,363
10530,21732,5116,10543,3989,16616,704,341,363
10535,21745,5118,10550,3989,16627,705,341,364
10540,21756,5118,10553,3989,16638,705,341,364
10545,21763,5119,10558,3990,16644,705,341,364
10550,21776,5121,10564,3990,16654,706,342,364
10555,21787,5123,10569,3992,16664,706,342,364
10560,21794,5124,10571,3992,16670,706,342,364
10565,21807,5127,10574,3994,16680,707,342,365
10570,21818,5129,10579,3996,16689,707,342,365
10575,21825,5131,10582,3997,16694,707,342,365
10580,21838,5134,10592,4000,16700,708,343,365
10585,21849,5143,10600,4009,16705,708,343,365
10590,21856,5148,10603,4012,16707,708,343,365
10595,21869,5154,10611,4017,16711,709,343,366
10600,21880,5159,10615,4021,16719,709,343,366
10605,21887,5166,10619,4027,16721,709,343,366
10610,21900,5172,10628,4032,16725,710,344,366
10615,21911,5176,10631,4035,16734,710,344,366
10620,21918,5181,10637,4040,16735,710,344,366
10625,21931,5184,10644,4042,16746,711,345,366
10630,21942,5184,10651,4042,16758,711,345,366
10635,21949,5185,10654,4042,16763,711,345,366
10640,21962,5187,10661,4044,16773,712,345,367
10645,21973,5187,10665,4044,16785,712,345,367
10650,21980,5188,10669,4045,16792,712,345,367
10655,21993,5190,10674,4045,16803,713,346,367
10660,22004,5190,10678,4045,16814,713,346,367
10665,22011,5191,10681,4045,16820,713,346,367
10670,22024,5193,10689,4047,16829,714,346,368
10675,22035,5193,10693,4047,16842,714,346,368
10680,22042,5194,10695,4047,16848,714,346,368
10685,22055,5196,10702,4048,16859,715,346,369
10690,22066,5196,10707,4048,16870,715,346,369
10695,22073,5197,10709,4048,16876,715,346,369
10700,22086,5199,10714,4049,16887,716,346,370
10705,22097,5199,10720,4049,16898,716,346,370
10710,22104,5200,10723,4050,16904,716,346,370
10715,22117,5202,10729,4050,16914,717,346,371
10720,22128,5202,10734,4050,16926,717,346,371
10725,22135,5203,10737,4051,16932,717,346,371
10730,22148,5205,10741,4051,16942,718,346,372
10735,22159,5207,10746,4052,16952,718,346,372
10740,22166,5210,10747,4053,16956,718,346,372
10745,22179,5213,10753,4056,16965,719,346,373
10750,22190,5216,10757,4059,16974,719,346,373
10755,22197,5218,10759,4060,16979,719,346,373
10760,22210,5222,10767,4063,16985,720,346,374
10765,22221,5227,10771,4067,16993,720,346,374
10770,22228,5231,10773,4069,16997,720,346,374
10775,22241,5235,10779,4072,17003,721,346,375
10780,22252,5240,10783,4076,17010,721,346,375
10785,22259,5244,10785,4079,17014,721,346,375
10790,22272,5250,10792,4083,17019,722,347,375
10795,22283,5258,10798,4091,17024,722,347,375
10800,22290,5262,10801,4093,17028,722,347,375
10805,22303,5264,10804,4093,17038,723,348,375
10810,22314,5266,10809,4095,17047,723,348,375
10815,22321,5269,10814,4098,17051,723,348,375
10820,22334,5273,10821,4102,17058,724,348,376
10825,22345,5274,10825,4103,17070,724,348,376
10830,22352,5275,10827,4103,17076,724,348,376
10835,22365,5277,10831,4104,17088,725,349,376
10840,22376,5277,10838,4104,17098,725,349,376
10845,22383,5278,10841,4104,17105,725,349,376
10850,22396,5280,10850,4106,17114,726,350,376
10855,22407,5280,10856,4106,17127,726,350,376
10860,22414,5281,10860,4107,17133,726,350,376
10865,22427,5283,10866,4107,17144,727,351,376
10870,22438,5283,10872,4107,17154,727,351,376
10875,22445,5284,10875,4108,17161,727,351,376
10880,22458,5286,10881,4109,17171,728,351,377
10885,22469,5286,10887,4109,17182,728,351,377
10890,22476,5287,10889,4110,17189,728,351,377
10895,22489,5289,10892,4111,17200,729,351,378
10900,22500,5289,10898,4111,17211,729,351,378
10905,22507,5290,10900,4112,17217,729,351,378
10910,22520,5292,10907,4114,17227,730,351,379
10915,22531,5292,10909,4114,17239,730,351,379
10920,22538,5295,10914,4116,17243,730,351,379
10925,22551,5297,10923,4118,17253,731,352,379
10930,22562,5298,10927,4118,17264,731,352,379
10935,22569,5300,10930,4119,17269,731,352,379
10940,22582,5303,10939,4122,17277,732,353,379
10945,22593,5308,10946,4127,17285,732,353,379
10950,22600,5310,10948,4128,17290,732,353,379
10955,22613,5312,10951,4129,17301,733,353,380
10960,22624,5315,10959,4132,17308,733,353,380
10965,22631,5319,10963,4134,17312,733,353,380
10970,22644,5324,10971,4138,17317,734,353,381
10975,22655,5328,10976,4142,17325,734,353,381
10980,22662,5332,10977,4144,17330,734,353,381
10985,22675,5336,10986,4147,17337,735,354,381
10990,22686,5341,10992,4152,17343,735,354,381
10995,22693,5346,10993,4155,17347,735,354,381
11000,22706,5350,10999,4157,17354,736,355,381
11005,22717,5356,11005,4163,17360,736,355,381
11010,22724,5359,11008,4165,17364,736,355,381
11015,22737,5363,11014,4168,17372,737,355,382
11020,22748,5365,11019,4169,17382,737,355,382
11025,22755,5368,11023,4171,17386,737,355,382
11030,22768,5371,11031,4174,17397,738,355,383
11035,22779,5371,11036,4174,17408,738,355,383
11040,22786,5372,11038,4174,17413,738,355,383
11045,22799,5374,11046,4176,17425,739,356,383
11050,22810,5374,11050,4176,17436,739,356,383
11055,22817,5375,11053,4176,17442,739,356,383
11060,22830,5377,11060,4178,17453,740,356,384
11065,22841,5377,11066,4178,17464,740,356,384
11070,22848,5378,11068,4179,17470,740,356,384
11075,22861,5380,11078,4181,17481,741,357,384
11080,22872,5380,11083,4181,17492,741,357,384
11085,22879,5381,11088,4182,17498,741,357,384
11090,22892,5383,11094,4182,17508,742,358,384
11095,22903,5383,11101,4182,17519,742,358,384
11100,22910,5384,11105,4183,17526,742,358,384
11105,22923,5386,11111,4185,17537,743,359,384
11110,22934,5386,11116,4185,17548,743,359,384
11115,22941,5389,11122,4187,17552,743,359,384
11120,22954,5391,11131,4188,17561,744,359,385
11125,22965,5393,11133,4190,17572,744,359,385
11130,22972,5396,11136,4191,17576,744,359,385
11135,22985,5398,11143,4193,17585,745,360,385
11140,22996,5402,11151,4197,17593,745,360,385
11145,23003,5404,11152,4197,17599,745,360,385
11150,23016,5406,11159,4198,17610,746,361,385
11155,23027,5410,11167,4202,17616,746,361,385
11160,23034,5413,11169,4203,17621,746,361,385
11165,23047,5417,11175,4205,17629,747,362,385
11170,23058,5421,11180,4208,17636,747,362,385
11175,23065,5425,11182,4211,17640,747,362,385
11180,23078,5429,11189,4215,17647,748,363,385
11185,23089,5432,11193,4217,17654,748,363,385
11190,23096,5438,11197,4222,17658,748,363,385
11195,23109,5442,11206,4225,17664,749,363,386
11200,23120,5445,11210,4227,17674,749,363,386
11205,23127,5447,11213,4228,17680,749,363,386
11210,23140,5449,11218,4229,17689,750,364,386
11215,23151,5451,11224,4231,17699,750,364,386
11220,23158,5453,11227,4233,17705,750,364,386
11225,23171,5456,11233,4235,17715,751,365,386
11230,23182,5458,11238,4237,17723,751,365,386
11235,23189,5460,11239,4238,17729,751,365,386
11240,23202,5462,11242,4238,17739,752,366,386
11245,23213,5464,11249,4239,17749,752,366,386
11250,23220,5465,11253,4240,17755,752,366,386
11255,23233,5469,11258,4243,17764,753,367,386
11260,23244,5471,11259,4244,17773,753,367,386
11265,23251,5472,11263,4245,17778,753,367,386
11270,23264,5476,11272,4249,17785,754,367,387
11275,23275,5477,11278,4250,17798,754,367,387
11280,23282,5478,11283,4251,17804,754,367,387
11285,23295,5480,11290,4253,17815,755,368,387
11290,23306,5480,11296,4253,17826,755,368,387
11295,23313,5481,11296,4253,17832,755,368,387
11300,23326,5483,11303,4254,17842,756,369,387
11305,23337,5484,11310,4255,17852,756,369,387
11310,23344,5487,11313,4258,17857,756,369,387
11315,23357,5489,11319,4260,17867,757,369,388
11320,23368,5490,11322,4261,17878,757,369,388
11325,23375,5493,11324,4262,17882,757,369,388
11330,23388,5496,11330,4263,17890,758,369,389
11335,23399,5496,11333,4263,17902,758,369,389
11340,23406,5498,11337,4265,17907,758,369,389
11345,23419,5501,11343,4267,17914,759,369,390
11350,23430,5504,11350,4270,17924,759,369,390
11355,23437,5508,11354,4273,17928,759,369,390
11360,23450,5512,11362,4276,17936,760,369,391
11365,23461,5513,11365,4277,17948,760,369,391
11370,23468,5517,11368,4279,17951,760,369,391
11375,23481,5519,11376,4281,17961,761,370,391
11380,23492,5522,11380,4283,17969,761,370,391
11385,23499,5527,11385,4287,17972,761,370,391
11390,23512,5529,11390,4288,17982,762,371,391
11395,23523,5531,11397,4290,17992,762,371,391
11400,23530,5532,11401,4291,17998,762,371,391
11405,23543,5534,11407,4293,18008,763,372,391
11410,23554,5536,11413,4295,18018,763,372,391
11415,23561,5537,11418,4295,18024,763,372,391
11420,23574,5540,11423,4296,18033,764,372,392
11425,23585,5542,11427,4297,18042,764,372,392
11430,23592,5544,11432,4299,18048,764,372,392
11435,23605,5547,11439,4302,18056,765,373,392
11440,23616,5550,11443,4304,18066,765,373,392
11445,23623,5551,11447,4305,18072,765,373,392
11450,23636,5553,11453,4307,18082,766,373,393
11455,23647,5556,11460,4309,18090,766,373,393
11460,23654,5558,11463,4310,18095,766,373,393
11465,23667,5561,11467,4312,18105,767,373,394
11470,23678,5563,11473,4314,18114,767,373,394
11475,23685,5565,11475,4316,18119,767,373,394
11480,23698,5568,11481,4317,18128,768,374,394
11485,23709,5573,11485,4321,18135,768,374,394
11490,23716,5576,11489,4324,18140,768,374,394
11495,23729,5579,11495,4326,18148,769,375,394
11500,23740,5580,11499,4327,18159,769,375,394
11505,23747,5582,11500,4327,18165,769,375,394
11510,23760,5584,11505,4328,18175,770,376,394
11515,23771,5584,11508,4328,18187,770,376,394
11520,23778,5586,11508,4328,18192,770,376,394
11525,23791,5588,11513,4329,18202,771,377,394
11530,23802,5590,11519,4331,18211,771,377,394
11535,23809,5592,11523,4333,18217,771,377,394
11540,23822,5595,11533,4335,18224,772,378,394
11545,23833,5597,11538,4337,18234,772,378,394
11550,23840,5603,11544,4342,18236,772,378,394
11555,23853,5606,11549,4343,18245,773,379,394
11560,23864,5609,11556,4346,18254,773,379,394
11565,23871,5613,11560,4349,18257,773,379,394
11570,23884,5617,11570,4353,18265,774,379,395
11575,23895,5618,11573,4354,18276,774,379,395
11580,23902,5622,11577,4357,18280,774,379,395
11585,23915,5624,11586,4358,18289,775,380,395
11590,23926,5624,11592,4358,18302,775,380,395
11595,23933,5625,11595,4358,18308,775,380,395
11600,23946,5627,11603,4360,18318,776,381,395
11605,23957,5627,11607,4360,18330,776,381,395
11610,23964,5628,11610,4361,18336,776,381,395
11615,23977,5630,11615,4361,18345,777,382,395
11620,23988,5632,11623,4362,18356,777,382,395
11625,23995,5633,11627,4362,18362,777,382,395
11630,24008,5635,11633,4364,18373,778,383,395
11635,24019,5636,11638,4365,18383,778,383,395
11640,24026,5637,11642,4366,18389,778,383,395
11645,24039,5640,11651,4369,18398,779,383,396
11650,24050,5642,11657,4371,18407,779,383,396
11655,24057,5644,11660,4372,18412,779,383,396
11660,24070,5647,11664,4373,18421,780,383,397
11665,24081,5650,11667,4375,18431,780,383,397
11670,24088,5651,11670,4375,18437,780,383,397
11675,24101,5654,11677,4377,18446,781,384,397
11680,24112,5656,11681,4378,18455,781,384,397
11685,24119,5659,11684,4380,18460,781,384,397
11690,24132,5662,11689,4382,18469,782,384,398
11695,24143,5666,11693,4385,18476,782,384,398
11700,24150,5671,11696,4388,18478,782,384,398
11705,24163,5676,11699,4391,18486,783,384,399
11710,24174,5679,11703,4394,18493,783,384,399
11715,24181,5685,11707,4399,18495,783,384,399
11720,24194,5689,11714,4402,18501,784,385,399
11725,24205,5693,11717,4406,18511,784,385,399
11730,24212,5697,11721,4408,18514,784,385,399
11735,24225,5701,11727,4410,18521,785,386,399
11740,24236,5704,11729,4412,18532,785,386,399
11745,24243,5707,11733,4415,18536,785,386,399
11750,24256,5710,11740,4417,18544,786,387,399
11755,24267,5712,11745,4418,18555,786,387,399
11760,24274,5713,11748,4418,18561,786,387,399
11765,24287,5715,11753,4419,18570,787,388,399
11770,24298,5717,11759,4421,18581,787,388,399
11775,24305,5718,11764,4422,18587,787,388,399
11780,24318,5720,11770,4423,18596,788,388,400
11785,24329,5722,11776,4425,18607,788,388,400
11790,24336,5723,11782,4425,18613,788,388,400
11795,24349,5725,11787,4425,18623,789,389,400
11800,24360,5727,11792,4426,18633,789,389,400
11805,24367,5728,11796,4427,18639,789,389,400
11810,24380,5730,11804,4429,18649,790,390,400
11815,24391,5732,11810,4431,18658,790,390,400
11820,24398,5734,11816,4433,18664,790,390,400
11825,24411,5736,11819,4434,18675,791,391,400
11830,24422,5737,11822,4434,18685,791,391,400
11835,24429,5738,11824,4434,18691,791,391,400
11840,24442,5741,11831,4437,18701,792,392,400
11845,24453,5742,11835,4437,18710,792,392,400
11850,24460,5744,11838,4439,18715,792,392,400
11855,24473,5748,11844,4442,18724,793,393,400
11860,24484,5750,11847,4444,18733,793,393,400
11865,24491,5754,11852,4448,18736,793,393,400
11870,24504,5756,11861,4450,18748,794,393,401
11875,24515,5757,11866,4451,18758,794,393,401
11880,24522,5760,11869,4453,18762,794,393,401
11885,24535,5763,11876,4455,18772,795,393,402
11890,24546,5765,11884,4457,18779,795,393,402
11895,24553,5770,11886,4461,18783,795,393,402
11900,24566,5772,11892,4462,18792,796,394,402
11905,24577,5776,11897,4466,18799,796,394,402
11910,24584,5780,11900,4470,18803,796,394,402
11915,24597,5783,11903,4472,18813,797,395,402
11920,24608,5785,11908,4474,18823,797,395,402
11925,24615,5786,11912,4474,18828,797,395,402
11930,24628,5788,11917,4475,18840,798,395,403
11935,24639,5788,11920,4475,18851,798,395,403
11940,24646,5789,11923,4475,18856,798,395,403
11945,24659,5791,11931,4477,18868,799,395,404
11950,24670,5791,11933,4477,18879,799,395,404
11955,24677,5792,11935,4477,18885,799,395,404
11960,24690,5794,11941,4478,18895,800,395,405
11965,24701,5794,11949,4478,18906,800,395,405
11970,24708,5795,11953,4479,18913,800,395,405
11975,24721,5797,11960,4480,18922,801,396,405
11980,24732,5799,11966,4482,18932,801,396,405
11985,24739,5800,11969,4482,18939,801,396,405
11990,24752,5802,11976,4484,18947,802,396,406
11995,24763,5804,11981,4486,18959,802,396,406
12000,24770,5805,11982,4486,18965,802,396,406
12005,24783,5807,11990,4487,18974,803,396,407
12010,24794,5809,11998,4488,18985,803,396,407
12015,24801,5810,12001,4489,18991,803,396,407
12020,24814,5812,12008,4490,19001,804,397,407
12025,24825,5814,12014,4492,19011,804,397,407
12030,24832,5817,12018,4493,19015,804,397,407
12035,24845,5820,12025,4495,19024,805,397,408
12040,24856,5824,12031,4499,19032,805,397,408
12045,24863,5827,12034,4501,19036,805,397,408
12050,24876,5832,12041,4504,19042,806,398,408
12055,24887,5835,12042,4506,19051,806,398,408
12060,24894,5839,12046,4509,19054,806,398,408
12065,24907,5842,12052,4510,19061,807,399,408
12070,24918,5849,12058,4517,19068,807,399,408
12075,24925,5853,12060,4519,19072,807,399,408
12080,24938,5856,12065,4521,19080,808,400,408
12085,24949,5859,12069,4524,19089,808,400,408
12090,24956,5863,12074,4527,19092,808,400,408
12095,24969,5867,12080,4530,19099,809,401,408
12100,24980,5871,12083,4534,19108,809,401,408
12105,24987,5875,12086,4537,19111,809,401,408
12110,25000,5879,12088,4539,19120,810,401,409
12115,25011,5883,12090,4542,19128,810,401,409
12120,25018,5886,12092,4543,19131,810,401,409
12125,25031,5889,12097,4546,19141,811,402,409
12130,25042,5889,12103,4546,19152,811,402,409
12135,25049,5890,12107,4546,19158,811,402,409
12140,25062,5892,12112,4546,19168,812,403,409
12145,25073,5892,12116,4546,19180,812,403,409
12150,25080,5893,12120,4546,19186,812,403,409
12155,25093,5895,12128,4548,19197,813,403,410
12160,25104,5895,12131,4548,19209,813,403,410
12165,25111,5896,12137,4549,19215,813,403,410
12170,25124,5898,12144,4549,19225,814,404,410
12175,25135,5898,12150,4549,19237,814,404,410
12180,25142,5899,12151,4549,19243,814,404,410
12185,25155,5901,12158,4551,19253,815,404,411
12190,25166,5901,12166,4551,19265,815,404,411
12195,25173,5902,12169,4552,19271,815,404,411
12200,25186,5904,12175,4553,19282,816,405,411
12205,25197,5904,12178,4553,19293,816,405,411
12210,25204,5905,12183,4554,19299,816,405,411
12215,25217,5907,12188,4555,19310,817,406,411
12220,25228,5907,12195,4555,19321,817,406,411
12225,25235,5908,12197,4555,19327,817,406,411
12230,25248,5910,12203,4555,19337,818,407,411
12235,25259,5912,12208,4557,19347,818,407,411
12240,25266,5915,12211,4558,19351,818,407,411
12245,25279,5917,12219,4559,19359,819,407,412
12250,25290,5920,12220,4561,19370,819,407,412
12255,25297,5923,12223,4563,19374,819,407,412
12260,25310,5926,12227,4565,19383,820,408,412
12265,25321,5932,12232,4570,19389,820,408,412
12270,25328,5935,12235,4572,19393,820,408,412
12275,25341,5938,12241,4573,19399,821,408,413
12280,25352,5943,12246,4578,19408,821,408,413
12285,25359,5947,12250,4582,19411,821,408,413
12290,25372,5951,12254,4585,19419,822,408,414
12295,25383,5956,12259,4590,19425,822,408,414
12300,25390,5962,12262,4594,19427,822,408,414
12305,25403,5966,12266,4597,19435,823,408,415
12310,25414,5971,12273,4602,19441,823,408,415
12315,25421,5974,12274,4604,19447,823,408,415
12320,25434,5976,12279,4605,19456,824,408,416
12325,25445,5979,12282,4608,19466,824,408,416
12330,25452,5980,12285,4608,19471,824,408,416
12335,25465,5982,12290,4609,19482,825,408,417
12340,25476,5982,12297,4609,19493,825,408,417
12345,25483,5983,12300,4609,19500,825,408,417
12350,25496,5985,12304,4609,19510,826,409,417
12355,25507,5985,12309,4609,19521,826,409,417
12360,25514,5986,12313,4610,19528,826,409,417
12365,25527,5988,12319,4611,19538,827,409,418
12370,25538,5988,12323,4611,19550,827,409,418
12375,25545,5989,12327,4612,19556,827,409,418
12380,25558,5991,12332,4614,19567,828,409,419
12385,25569,5991,12336,4614,19577,828,409,419
12390,25576,5992,12339,4615,19584,828,409,419
12395,25589,5994,12346,4616,19594,829,410,419
12400,25600,5994,12351,4616,19605,829,410,419
12405,25607,5995,12355,4617,19612,829,410,419
12410,25620,5997,12362,4618,19622,830,411,419
12415,25631,5998,12369,4619,19633,830,411,419
12420,25638,6000,12373,4620,19638,830,411,419
12425,25651,6002,12380,4621,19649,831,411,420
12430,25662,6003,12387,4622,19659,831,411,420
12435,25669,6006,12391,4624,19663,831,411,420
12440,25682,6008,12399,4625,19672,832,412,420
12445,25693,6012,12404,4628,19681,832,412,420
12450,25700,6014,12409,4630,19686,832,412,420
12455,25713,6017,12418,4631,19694,833,413,420
12460,25724,6020,12420,4633,19704,833,413,420
12465,25731,6023,12425,4635,19708,833,413,420
12470,25744,6027,12427,4637,19717,834,413,421
12475,25755,6028,12432,4637,19724,834,413,421
12480,25762,6034,12435,4642,19728,834,413,421
12485,25775,6037,12440,4644,19736,835,414,421
12490,25786,6042,12447,4648,19742,835,414,421
12495,25793,6047,12451,4652,19745,835,414,421
12500,25806,6052,12461,4656,19751,836,415,421
12505,25817,6058,12466,4662,19758,836,415,421
12510,25824,6062,12468,4664,19762,836,415,421
12515,25837,6065,12475,4665,19770,837,415,422
12520,25848,6067,12481,4667,19781,837,415,422
12525,25855,6068,12484,4668,19787,837,415,422
12530,25868,6072,12489,4670,19795,838,416,422
12535,25879,6075,12494,4672,19803,838,416,422
12540,25886,6077,12495,4674,19809,838,416,422
12545,25899,6081,12501,4677,19816,839,416,423
12550,25910,6082,12506,4678,19828,839,416,423
12555,25917,6083,12509,4679,19834,839,416,423
12560,25930,6085,12517,4680,19843,840,416,424
12565,25941,6085,12521,4680,19856,840,416,424
12570,25948,6086,12525,4681,19861,840,416,424
12575,25961,6088,12530,4682,19872,841,417,424
12580,25972,6088,12536,4682,19884,841,417,424
12585,25979,6089,12540,4683,19889,841,417,424
12590,25992,6091,12545,4683,19900,842,417,425
12595,26003,6091,12552,4683,19912,842,417,425
12600,26010,6092,12555,4684,19918,842,417,425
12605,26023,6094,12563,4686,19928,843,417,426
12610,26034,6094,12569,4686,19939,843,417,426
12615,26041,6097,12573,4688,19944,843,417,426
12620,26054,6099,12581,4689,19954,844,418,426
12625,26065,6099,12585,4689,19966,844,418,426
12630,26072,6102,12589,4691,19970,844,418,426
12635,26085,6104,12593,4692,19980,845,418,427
12640,26096,6108,12600,4696,19986,845,418,427
12645,26103,6112,12602,4699,19991,845,418,427
12650,26116,6115,12608,4700,20001,846,419,427
12655,26127,6116,12611,4701,20010,846,419,427
12660,26134,6120,12613,4704,20014,846,419,427
12665,26147,6122,12619,4705,20022,847,419,428
12670,26158,6128,12624,4710,20029,847,419,428
12675,26165,6131,12625,4711,20033,847,419,428
12680,26178,6135,12631,4714,20041,848,419,429
12685,26189,6137,12638,4716,20052,848,419,429
12690,26196,6138,12643,4717,20058,848,419,429
12695,26209,6141,12651,4719,20066,849,420,429
12700,26220,6144,12659,4721,20076,849,420,429
12705,26227,6145,12662,4722,20082,849,420,429
12710,26240,6149,12669,4725,20088,850,420,430
12715,26251,6152,12675,4728,20099,850,420,430
12720,26258,6153,12678,4728,20104,850,420,430
12725,26271,6158,12686,4732,20112,851,421,430
12730,26282,6160,12691,4734,20120,851,421,430
12735,26289,6164,12694,4738,20125,851,421,430
12740,26302,6168,12702,4741,20133,852,422,430
12745,26313,6169,12708,4742,20143,852,422,430
12750,26320,6170,12711,4743,20149,852,422,430
12755,26333,6172,12717,4744,20160,853,423,430
12760,26344,6172,12724,4744,20171,853,423,430
12765,26351,6173,12727,4745,20178,853,423,430
12770,26364,6175,12732,4747,20189,854,423,431
12775,26375,6175,12736,4747,20200,854,423,431
12780,26382,6176,12740,4747,20206,854,423,431
12785,26395,6178,12745,4749,20217,855,424,431
12790,26406,6180,12752,4751,20226,855,424,431
12795,26413,6182,12756,4753,20231,855,424,431
12800,26426,6184,12764,4754,20241,856,424,432
12805,26437,6185,12771,4755,20252,856,424,432
12810,26444,6187,12772,4756,20257,856,424,432
12815,26457,6189,12779,4756,20267,857,424,433
12820,26468,6189,12783,4756,20279,857,424,433
12825,26475,6191,12786,4758,20284,857,424,433
12830,26488,6193,12794,4760,20294,858,425,433
12835,26499,6196,12801,4763,20302,858,425,433
12840,26506,6199,12804,4765,20307,858,425,433
12845,26519,6202,12809,4767,20316,859,425,434
12850,26530,6206,12816,4770,20322,859,425,434
12855,26537,6210,12819,4773,20326,859,425,434
12860,26550,6214,12828,4777,20332,860,426,434
12865,26561,6219,12830,4781,20342,860,426,434
12870,26568,6222,12834,4784,20346,860,426,434
12875,26581,6225,12838,4785,20354,861,427,434
12880,26592,6231,12845,4790,20360,861,427,434
12885,26599,6233,12847,4791,20366,861,427,434
12890,26612,6236,12853,4794,20376,862,428,434
12895,26623,6238,12860,4796,20385,862,428,434
12900,26630,6240,12864,4797,20389,862,428,434
12905,26643,6243,12868,4799,20400,863,429,434
12910,26654,6244,12875,4800,20409,863,429,434
12915,26661,6246,12877,4802,20415,863,429,434
12920,26674,6249,12883,4804,20423,864,429,435
12925,26685,6254,12890,4809,20430,864,429,435
12930,26692,6256,12893,4811,20436,864,429,435
12935,26705,6258,12899,4812,20446,865,430,435
12940,26716,6262,12904,4815,20453,865,430,435
12945,26723,6265,12907,4817,20458,865,430,435
12950,26736,6267,12915,4818,20469,866,431,435
12955,26747,6267,12920,4818,20480,866,431,435
12960,26754,6268,12923,4818,20486,866,431,435
12965,26767,6270,12932,4819,20497,867,432,435
12970,26778,6270,12938,4819,20508,867,432,435
12975,26785,6271,12943,4819,20513,867,432,435
12980,26798,6273,12950,4820,20524,868,432,436
12985,26809,6273,12957,4820,20535,868,432,436
12990,26816,6275,12960,4820,20541,868,432,436
12995,26829,6277,12966,4821,20551,869,433,436
13000,26840,6277,12974,4821,20562,869,433,436
13005,26847,6280,12981,4824,20567,869,433,436
13010,26860,6283,12989,4827,20575,870,434,436
13015,26871,6285,12996,4829,20584,870,434,436
13020,26878,6289,12997,4831,20588,870,434,436
13025,26891,6292,13002,4833,20598,871,434,437
13030,26902,6294,13007,4835,20605,871,434,437
13035,26909,6300,13010,4839,20609,871,434,437
13040,26922,6302,13016,4839,20618,872,434,438
13045,26933,6304,13022,4841,20627,872,434,438
13050,26940,6308,13025,4844,20631,872,434,438
13055,26953,6312,13032,4847,20639,873,434,439
13060,26964,6314,13038,4849,20650,873,434,439
13065,26971,6315,13041,4849,20656,873,434,439
13070,26984,6317,13049,4850,20664,874,435,439
13075,26995,6320,13053,4852,20675,874,435,439
13080,27002,6321,13058,4853,20681,874,435,439
13085,27015,6324,13064,4854,20689,875,435,440
13090,27026,6328,13069,4857,20698,875,435,440
13095,27033,6329,13073,4858,20704,875,435,440
13100,27046,6332,13082,4861,20712,876,436,440
13105,27057,6335,13090,4864,20721,876,436,440
13110,27064,6337,13094,4866,20727,876,436,440
13115,27077,6340,13103,4869,20735,877,436,441
13120,27088,6343,13106,4871,20744,877,436,441
13125,27095,6345,13110,4873,20750,877,436,441
13130,27108,6348,13119,4876,20758,878,436,442
13135,27119,6351,13125,4879,20768,878,436,442
13140,27126,6352,13129,4879,20773,878,436,442
13145,27139,6356,13136,4883,20781,879,437,442
13150,27150,6357,13140,4884,20793,879,437,442
13155,27157,6358,13145,4885,20799,879,437,442
13160,27170,6360,13152,4885,20810,880,438,442
13165,27181,6362,13158,4887,20819,880,438,442
13170,27188,6364,13159,4887,20823,880,438,442
13175,27201,6366,13163,4887,20833,881,439,442
13180,27212,6369,13169,4890,20843,881,439,442
13185,27219,6372,13172,4892,20847,881,439,442
13190,27232,6375,13180,4894,20855,882,440,442
13195,27243,6377,13187,4896,20864,882,440,442
13200,27250,6383,13189,4900,20867,882,440,442
13205,27263,6386,13197,4902,20875,883,441,442
13210,27274,6388,13203,4904,20885,883,441,442
13215,27281,6392,13209,4908,20889,883,441,442
13220,27294,6394,13214,4909,20900,884,442,442
13225,27305,6394,13220,4909,20911,884,442,442
13230,27312,6395,13224,4910,20917,884,442,442
13235,27325,6397,13229,4910,20927,885,443,442
13240,27336,6397,13232,4910,20939,885,443,442
13245,27343,6398,13236,4910,20945,885,443,442
13250,27356,6400,13241,4910,20954,886,443,443
13255,27367,6403,13248,4912,20964,886,443,443
13260,27374,6404,13250,4912,20970,886,443,443
13265,27387,6407,13258,4914,20980,887,444,443
13270,27398,6408,13263,4914,20990,887,444,443
13275,27405,6409,13265,4914,20996,887,444,443
13280,27418,6411,13269,4914,21007,888,445,443
13285,27429,6412,13273,4914,21017,888,445,443
13290,27436,6413,13276,4915,21023,888,445,443
13295,27449,6415,13282,4917,21033,889,445,444
13300,27460,6417,13286,4919,21043,889,445,444
13305,27467,6418,13288,4920,21049,889,445,444
13310,27480,6422,13293,4922,21056,890,445,445
13315,27491,6425,13298,4924,21065,890,445,445
13320,27498,6427,13302,4926,21071,890,445,445
13325,27511,6429,13308,4928,21080,891,445,446
13330,27522,6436,13315,4935,21086,891,445,446
13335,27529,6438,13317,4936,21091,891,445,446
13340,27542,6441,13321,4938,21099,892,445,447
13345,27553,6445,13327,4942,21107,892,445,447
13350,27560,6450,13329,4945,21110,892,445,447
13355,27573,6454,13333,4948,21119,893,446,447
13360,27584,6457,13337,4950,21126,893,446,447
13365,27591,6461,13341,4954,21130,893,446,447
13370,27604,6464,13347,4955,21138,894,447,447
13375,27615,6465,13348,4956,21150,894,447,447
13380,27622,6468,13353,4958,21152,894,447,447
13385,27635,6471,13355,4959,21163,895,448,447
13390,27646,6473,13359,4961,21171,895,448,447
13395,27653,6477,13363,4963,21175,895,448,447
13400,27666,6481,13370,4966,21183,896,448,448
13405,27677,6484,13375,4969,21193,896,448,448
13410,27684,6485,13380,4970,21199,896,448,448
13415,27697,6487,13386,4972,21209,897,448,449
13420,27708,6487,13390,4972,21221,897,448,449
13425,27715,6488,13393,4973,21227,897,448,449
13430,27728,6490,13396,4974,21237,898,448,450
13435,27739,6490,13400,4974,21249,898,448,450
13440,27746,6491,13403,4975,21255,898,448,450
13445,27759,6493,13407,4975,21266,899,448,451
13450,27770,6493,13416,4975,21276,899,448,451
13455,27777,6494,13422,4976,21283,899,448,451
13460,27790,6496,13427,4977,21294,900,448,452
13465,27801,6496,13430,4977,21305,900,448,452
13470,27808,6497,13432,4977,21311,900,448,452
13475,27821,6499,13437,4977,21321,901,448,453
13480,27832,6501,13442,4979,21331,901,448,453
13485,27839,6502,13448,4980,21337,901,448,453
13490,27852,6504,13453,4981,21346,902,449,453
13495,27863,6507,13457,4984,21356,902,449,453
13500,27870,6508,13461,4984,21362,902,449,453
13505,27883,6510,13467,4985,21373,903,449,454
13510,27894,6512,13475,4987,21382,903,449,454
13515,27901,6515,13480,4990,21386,903,449,454
13520,27914,6518,13486,4991,21394,904,449,455
13525,27925,6521,13491,4994,21404,904,449,455
13530,27932,6523,13495,4996,21409,904,449,455
13535,27945,6526,13502,4999,21418,905,450,455
13540,27956,6530,13508,5003,21425,905,450,455
13545,27963,6533,13512,5006,21429,905,450,455
13550,27976,6536,13518,5007,21437,906,451,455
13555,27987,6541,13522,5012,21446,906,451,455
13560,27994,6545,13525,5014,21449,906,451,455
13565,28007,6549,13531,5016,21454,907,451,456
13570,28018,6556,13536,5022,21459,907,451,456
13575,28025,6563,13539,5028,21462,907,451,456
13580,28038,6567,13543,5030,21470,908,452,456
13585,28049,6574,13552,5037,21473,908,452,456
13590,28056,6578,13556,5040,21477,908,452,456
13595,28069,6581,13561,5043,21488,909,453,456
13600,28080,6581,13564,5043,21499,909,453,456
13605,28087,6582,13566,5044,21505,909,453,456
13610,28100,6584,13573,5046,21515,910,454,456
13615,28111,6584,13577,5046,21526,910,454,456
13620,28118,6585,13579,5047,21533,910,454,456
13625,28131,6587,13583,5048,21543,911,455,456
13630,28142,6587,13588,5048,21555,911,455,456
13635,28149,6588,13592,5049,21561,911,455,456
13640,28162,6590,13598,5050,21571,912,455,457
13645,28173,6590,13602,5050,21582,912,455,457
13650,28180,6591,13604,5050,21589,912,455,457
13655,28193,6593,13615,5051,21600,913,456,457
13660,28204,6593,13621,5051,21611,913,456,457
13665,28211,6594,13624,5051,21617,913,456,457
13670,28224,6596,13627,5051,21628,914,457,457
13675,28235,6596,13634,5051,21639,914,457,457
13680,28242,6597,13638,5052,21645,914,457,457
13685,28255,6599,13645,5052,21656,915,458,457
13690,28266,6599,13647,5052,21667,915,458,457
13695,28273,6601,13650,5054,21672,915,458,457
13700,28286,6603,13660,5056,21681,916,459,457
13705,28297,6607,13665,5059,21690,916,459,457
13710,28304,6609,13669,5059,21695,916,459,457
13715,28317,6611,13674,5061,21706,917,459,458
13720,28328,6614,13677,5063,21714,917,459,458
13725,28335,6617,13679,5064,21718,917,459,458
13730,28348,6619,13682,5065,21728,918,459,459
13735,28359,6622,13687,5067,21737,918,459,459
13740,28366,6624,13688,5067,21742,918,459,459
13745,28379,6627,13695,5070,21749,919,459,460
13750,28390,6633,13700,5075,21756,919,459,460
13755,28397,6636,13700,5076,21761,919,459,460
13760,28410,6641,13707,5081,21767,920,459,461
13765,28421,6646,13711,5086,21775,920,459,461
13770,28428,6649,13715,5087,21778,920,459,461
13775,28441,6654,13722,5091,21784,921,459,462
13780,28452,6659,13727,5096,21792,921,459,462
13785,28459,6664,13732,5100,21794,921,459,462
13790,28472,6667,13739,5103,21804,922,459,463
13795,28483,6669,13744,5104,21813,922,459,463
13800,28490,6671,13746,5106,21819,922,459,463
13805,28503,6674,13753,5108,21827,923,460,463
13810,28514,6677,13760,5110,21837,923,460,463
13815,28521,6678,13765,5111,21843,923,460,463
13820,28534,6680,13772,5111,21852,924,461,463
13825,28545,6683,13778,5114,21862,924,461,463
13830,28552,6684,13780,5114,21868,924,461,463
13835,28565,6688,13786,5116,21876,925,461,464
13840,28576,6690,13790,5117,21885,925,461,464
13845,28583,6692,13792,5118,21891,925,461,464
13850,28596,6694,13797,5118,21901,926,462,464
13855,28607,6694,13804,5118,21913,926,462,464
13860,28614,6695,13809,5119,21919,926,462,464
13865,28627,6697,13815,5119,21930,927,463,464
13870,28638,6697,13819,5119,21941,927,463,464
13875,28645,6698,13820,5119,21947,927,463,464
13880,28658,6700,13824,5120,21958,928,463,465
13885,28669,6700,13830,5120,21969,928,463,465
13890,28676,6701,13831,5120,21975,928,463,465
13895,28689,6703,13840,5122,21984,929,464,465
13900,28700,6704,13845,5123,21996,929,464,465
13905,28707,6706,13848,5124,22001,929,464,465
13910,28720,6709,13856,5127,22010,930,465,465
13915,28731,6712,13864,5130,22017,930,465,465
13920,28738,6716,13868,5132,22021,930,465,465
13925,28751,6720,13874,5136,22029,931,465,466
13930,28762,6723,13880,5139,22037,931,465,466
13935,28769,6728,13883,5142,22041,931,465,466
13940,28782,6731,13889,5144,22049,932,465,467
13945,28793,6733,13896,5146,22060,932,465,467
13950,28800,6734,13901,5147,22066,932,465,467
13955,28813,6737,13904,5149,22075,933,465,468
13960,28824,6739,13909,5151,22085,933,465,468
13965,28831,6740,13914,5152,22091,933,465,468
13970,28844,6742,13917,5153,22101,934,465,469
13975,28855,6743,13922,5153,22112,934,465,469
13980,28862,6744,13925,5154,22118,934,465,469
13985,28875,6747,13934,5156,22125,935,465,470
13990,28886,6750,13937,5159,22136,935,465,470
13995,28893,6751,13939,5159,22142,935,465,470
14000,28906,6753,13943,5159,22152,936,465,471
14005,28917,6755,13949,5161,22162,936,465,471
14010,28924,6756,13952,5162,22168,936,465,471
14015,28937,6759,13959,5164,22176,937,465,472
14020,28948,6763,13964,5167,22184,937,465,472
14025,28955,6765,13969,5168,22190,937,465,472
14030,28968,6769,13976,5171,22197,938,466,472
14035,28979,6771,13977,5172,22208,938,466,472
14040,28986,6772,13980,5173,22214,938,466,472
14045,28999,6776,13986,5175,22222,939,467,472
14050,29010,6777,13989,5175,22232,939,467,472
14055,29017,6780,13990,5177,22237,939,467,472
14060,29030,6783,13994,5179,22247,940,467,473
14065,29041,6784,13996,5179,22256,940,467,473
14070,29048,6788,13999,5182,22260,940,467,473
14075,29061,6793,14009,5187,22266,941,468,473
14080,29072,6798,14014,5191,22273,941,468,473
14085,29079,6801,14017,5193,22278,941,468,473
14090,29092,6803,14022,5194,22288,942,469,473
14095,29103,6804,14027,5195,22298,942,469,473
14100,29110,6808,14032,5198,22301,942,469,473
14105,29123,6811,14040,5199,22310,943,470,473
14110,29134,6814,14048,5202,22318,943,470,473
14115,29141,6818,14049,5204,22323,943,470,473
14120,29154,6821,14054,5206,22332,944,470,474
14125,29165,6824,14061,5209,22339,944,470,474
14130,29172,6827,14064,5211,22345,944,470,474
14135,29185,6830,14072,5213,22353,945,470,475
14140,29196,6832,14076,5215,22364,945,470,475
14145,29203,6833,14080,5215,22370,945,470,475
14150,29216,6835,14090,5216,22379,946,471,475
14155,29227,6835,14097,5216,22392,946,471,475
14160,29234,6836,14101,5217,22398,946,471,475
14165,29247,6838,14108,5219,22409,947,471,476
14170,29258,6838,14113,5219,22420,947,471,476
14175,29265,6839,14117,5220,22426,947,471,476
14180,29278,6841,14125,5221,22436,948,472,476
14185,29289,6841,14130,5221,22448,948,472,476
14190,29296,6842,14133,5222,22454,948,472,476
14195,29309,6845,14138,5223,22462,949,473,476
14200,29320,6848,14142,5225,22472,949,473,476
14205,29327,6849,14146,5225,22478,949,473,476
14210,29340,6851,14150,5226,22488,950,473,477
14215,29351,6853,14155,5228,22498,950,473,477
14220,29358,6854,14158,5229,22504,950,473,477
14225,29371,6857,14165,5231,22511,951,474,477
14230,29382,6860,14169,5234,22521,951,474,477
14235,29389,6862,14172,5236,22527,951,474,477
14240,29402,6866,14177,5239,22535,952,474,478
14245,29413,6869,14181,5242,22543,952,474,478
14250,29420,6874,14185,5246,22546,952,474,478
14255,29433,6878,14192,5248,22552,953,474,479
14260,29444,6885,14200,5255,22558,953,474,479
14265,29451,6888,14203,5256,22562,953,474,479
14270,29464,6891,14212,5258,22570,954,474,480
14275,29475,6893,14216,5260,22581,954,474,480
14280,29482,6898,14220,5263,22584,954,474,480
14285,29495,6901,14226,5264,22593,955,474,481
14290,29506,6902,14232,5265,22604,955,474,481
14295,29513,6905,14236,5267,22607,955,474,481
14300,29526,6909,14247,5270,22615,956,475,481
14305,29537,6913,14255,5274,22624,956,475,481
14310,29544,6914,14257,5274,22630,956,475,481
14315,29557,6916,14264,5275,22640,957,476,481
14320,29568,6916,14268,5275,22652,957,476,481
14325,29575,6917,14271,5276,22658,957,476,481
14330,29588,6919,14277,5278,22669,958,477,481
14335,29599,6919,14282,5278,22680,958,477,481
14340,29606,6920,14285,5279,22686,958,477,481
14345,29619,6922,14291,5281,22697,959,477,482
14350,29630,6922,14297,5281,22708,959,477,482
14355,29637,6923,14301,5282,22714,959,477,482
14360,29650,6925,14308,5283,22725,960,477,483
14365,29661,6925,14316,5283,22736,960,477,483
14370,29668,6926,14322,5284,22742,960,477,483
14375,29681,6928,14329,5285,22753,961,477,484
14380,29692,6929,14332,5285,22763,961,477,484
14385,29699,6931,14337,5286,22767,961,477,484
14390,29712,6935,14343,5289,22775,962,477,485
14395,29723,6938,14347,5291,22784,962,477,485
14400,29730,6940,14350,5292,22790,962,477,485
14405,29743,6943,14358,5294,22799,963,478,485
14410,29754,6946,14362,5297,22807,963,478,485
14415,29761,6950,14368,5301,22811,963,478,485
14420,29774,6953,14375,5302,22818,964,478,486
14425,29785,6959,14383,5308,22824,964,478,486
14430,29792,6964,14387,5311,22827,964,478,486
14435,29805,6969,14395,5314,22833,965,479,486
14440,29816,6972,14398,5317,22843,965,479,486
14445,29823,6976,14401,5319,22846,965,479,486
14450,29836,6982,14410,5324,22851,966,480,486
14455,29847,6988,14418,5329,22857,966,480,486
14460,29854,6993,14420,5333,22861,966,480,486
14465,29867,6995,14424,5334,22871,967,480,487
14470,29878,6995,14429,5334,22883,967,480,487
14475,29885,6996,14430,5334,22889,967,480,487
14480,29898,6998,14440,5336,22900,968,480,488
14485,29909,6998,14444,5336,22911,968,480,488
14490,29916,6999,14448,5336,22917,968,480,488
14495,29929,7001,14455,5338,22928,969,480,489
14500,29940,7001,14459,5338,22938,969,480,489
14505,29947,7002,14462,5339,22945,969,480,489
14510,29960,7004,14471,5339,22954,970,481,489
14515,29971,7004,14475,5339,22966,970,481,489
14520,29978,7005,14480,5340,22972,970,481,489
14525,29991,7007,14487,5341,22984,971,482,489
14530,30002,7007,14493,5341,22995,971,482,489
14535,30009,7008,14497,5342,23001,971,482,489
14540,30022,7010,14505,5344,23010,972,482,490
14545,30033,7010,14512,5344,23022,972,482,490
14550,30040,7011,14516,5345,23029,972,482,490
14555,30053,7013,14517,5345,23040,973,482,491
14560,30064,7013,14525,5345,23050,973,482,491
14565,30071,7014,14528,5345,23057,973,482,491
14570,30084,7016,14531,5345,23066,974,482,492
14575,30095,7018,14538,5347,23077,974,482,492
14580,30102,7021,14543,5349,23081,974,482,492
14585,30115,7024,14551,5352,23090,975,482,493
14590,30126,7026,14553,5353,23100,975,482,493
14595,30133,7028,14557,5355,23105,975,482,493
14600,30146,7030,14562,5356,23114,976,482,494
14605,30157,7034,14566,5359,23122,976,482,494
14610,30164,7037,14567,5361,23127,976,482,494
14615,30177,7041,14574,5364,23133,977,482,495
14620,30188,7046,14580,5368,23141,977,482,495
14625,30195,7049,14583,5370,23146,977,482,495
14630,30208,7052,14591,5373,23152,978,482,496
14635,30219,7057,14593,5377,23161,978,482,496
14640,30226,7062,14595,5380,23164,978,482,496
14645,30239,7066,14603,5383,23172,979,483,496
14650,30250,7068,14607,5385,23181,979,483,496
14655,30257,7072,14612,5389,23185,979,483,496
14660,30270,7075,14616,5391,23195,980,484,496
14665,30281,7076,14621,5391,23205,980,484,496
14670,30288,7077,14625,5392,23211,980,484,496
14675,30301,7081,14631,5394,23218,981,485,496
14680,30312,7084,14635,5396,23228,981,485,496
14685,30319,7085,14638,5397,23234,981,485,496
14690,30332,7088,14645,5399,23241,982,486,496
14695,30343,7092,14651,5403,23251,982,486,496
14700,30350,7094,14653,5405,23256,982,486,496
14705,30363,7098,14660,5408,23264,983,487,496
14710,30374,7101,14664,5411,23273,983,487,496
14715,30381,7103,14667,5412,23278,983,487,496
14720,30394,7106,14674,5415,23288,984,487,497
14725,30405,7106,14679,5415,23299,984,487,497
14730,30412,7107,14684,5415,23304,984,487,497
14735,30425,7109,14691,5416,23316,985,488,497
14740,30436,7109,14698,5416,23327,985,488,497
14745,30443,7110,14700,5416,23333,985,488,497
14750,30456,7112,14706,5416,23342,986,488,498
14755,30467,7112,14708,5416,23355,986,488,498
14760,30474,7113,14711,5416,23361,986,488,498
14765,30487,7115,14719,5417,23371,987,489,498
14770,30498,7116,14724,5418,23382,987,489,498
14775,30505,7118,14728,5419,23387,987,489,498
14780,30518,7120,14731,5419,23397,988,489,499
14785,30529,7122,14740,5421,23406,988,489,499
14790,30536,7124,14744,5422,23412,988,489,499
14795,30549,7126,14747,5422,23423,989,489,500
14800,30560,7126,14753,5422,23434,989,489,500
14805,30567,7128,14756,5422,23438,989,489,500
14810,30580,7132,14767,5425,23446,990,490,500
14815,30591,7136,14775,5429,23453,990,490,500
14820,30598,7141,14780,5434,23456,990,490,500
14825,30611,7145,14787,5437,23463,991,491,500
14830,30622,7150,14793,5442,23471,991,491,500
14835,30629,7154,14796,5445,23475,991,491,500
14840,30642,7156,14804,5446,23483,992,492,500
14845,30653,7159,14809,5449,23494,992,492,500
14850,30660,7160,14813,5450,23500,992,492,500
14855,30673,7163,14822,5452,23509,993,493,500
14860,30684,7165,14829,5453,23519,993,493,500
14865,30691,7166,14832,5453,23525,993,493,500
14870,30704,7169,14840,5456,23533,994,493,501
14875,30715,7171,14843,5457,23544,994,493,501
14880,30722,7172,14844,5457,23550,994,493,501
14885,30735,7174,14849,5459,23561,995,494,501
14890,30746,7175,14851,5460,23571,995,494,501
14895,30753,7176,14854,5460,23577,995,494,501
14900,30766,7180,14864,5463,23582,996,495,501
14905,30777,7187,14870,5470,23589,996,495,501
14910,30784,7189,14873,5472,23594,996,495,501
14915,30797,7194,14882,5476,23600,997,495,502
14920,30808,7198,14887,5479,23609,997,495,502
14925,30815,7199,14890,5480,23616,997,495,502
14930,30828,7201,14898,5481,23626,998,495,503
14935,30839,7201,14902,5481,23637,998,495,503
14940,30846,7202,14906,5482,23643,998,495,503
14945,30859,7204,14911,5483,23653,999,495,504
14950,30870,7206,14916,5485,23664,999,495,504
14955,30877,7208,14918,5485,23669,999,495,504
14960,30890,7210,14924,5485,23679,1000,496,504
14965,30901,7211,14929,5486,23688,1000,496,504
14970,30908,7216,14933,5490,23691,1000,496,504
14975,30921,7220,14942,5493,23697,1001,497,504
14980,30932,7223,14947,5496,23707,1001,497,504
14985,30939,7227,14951,5499,23712,1001,497,504
14990,30952,7229,14955,5499,23723,1002,498,504
14995,30963,7231,14961,5501,23732,1002,498,504
15000,30970,7233,14963,5503,23737,1002,498,504
15005,30983,7236,14971,5506,23744,1003,498,505
15010,30994,7238,14979,5508,23756,1003,498,505
15015,31001,7239,14984,5509,23762,1003,498,505
15020,31014,7241,14991,5509,23772,1004,499,505
15025,31025,7241,14998,5509,23784,1004,499,505
15030,31032,7242,15001,5509,23790,1004,499,505
15035,31045,7244,15006,5510,23799,1005,500,505
15040,31056,7247,15010,5513,23809,1005,500,505
15045,31063,7248,15014,5514,23815,1005,500,505
15050,31076,7250,15019,5515,23826,1006,501,505
15055,31087,7251,15025,5516,23836,1006,501,505
15060,31094,7252,15028,5516,23842,1006,501,505
15065,31107,7255,15033,5518,23851,1007,501,506
15070,31118,7257,15038,5519,23861,1007,501,506
15075,31125,7258,15042,5520,23867,1007,501,506
15080,31138,7261,15047,5521,23877,1008,502,506
15085,31149,7262,15052,5521,23886,1008,502,506
15090,31156,7264,15056,5523,23892,1008,502,506
15095,31169,7268,15059,5525,23901,1009,502,507
15100,31180,7269,15063,5526,23910,1009,502,507
15105,31187,7271,15064,5527,23916,1009,502,507
15110,31200,7274,15069,5528,23926,1010,503,507
15115,31211,7276,15073,5530,23934,1010,503,507
15120,31218,7279,15074,5532,23939,1010,503,507
15125,31231,7281,15077,5533,23949,1011,503,508
15130,31242,7285,15084,5537,23956,1011,503,508
15135,31249,7289,15089,5541,23959,1011,503,508
15140,31262,7294,15096,5545,23965,1012,504,508
15145,31273,7299,15102,5550,23974,1012,504,508
15150,31280,7302,15107,5553,23977,1012,504,508
15155,31293,7306,15116,5556,23984,1013,505,508
15160,31304,7308,15120,5558,23995,1013,505,508
15165,31311,7313,15124,5561,23997,1013,505,508
15170,31324,7316,15129,5563,24007,1014,506,508
15175,31335,7317,15135,5564,24016,1014,506,508
15180,31342,7322,15139,5568,24019,1014,506,508
15185,31355,7325,15144,5569,24027,1015,506,509
15190,31366,7326,15149,5570,24040,1015,506,509
15195,31373,7327,15152,5570,24046,1015,506,509
15200,31386,7329,15156,5571,24056,1016,506,510
15205,31397,7329,15163,5571,24068,1016,506,510
15210,31404,7330,15167,5571,24074,1016,506,510
15215,31417,7332,15172,5572,24084,1017,506,511
15220,31428,7332,15175,5572,24096,1017,506,511
15225,31435,7333,15178,5572,24102,1017,506,511
15230,31448,7335,15185,5573,24111,1018,507,511
15235,31459,7335,15188,5573,24124,1018,507,511
15240,31466,7336,15195,5574,24130,1018,507,511
15245,31479,7338,15205,5576,24141,1019,508,511
15250,31490,7338,15208,5576,24152,1019,508,511
15255,31497,7339,15210,5576,24158,1019,508,511
15260,31510,7342,15216,5578,24168,1020,509,511
15265,31521,7343,15222,5579,24178,1020,509,511
15270,31528,7344,15226,5580,24184,1020,509,511
15275,31541,7347,15231,5581,24192,1021,510,511
15280,31552,7350,15236,5583,24201,1021,510,511
15285,31559,7352,15238,5584,24207,1021,510,511
15290,31572,7356,15244,5586,24214,1022,510,512
15295,31583,7360,15248,5589,24222,1022,510,512
15300,31590,7364,15250,5591,24226,1022,510,512
15305,31603,7368,15261,5595,24232,1023,511,512
15310,31614,7374,15266,5601,24240,1023,511,512
15315,31621,7376,15269,5602,24245,1023,511,512
15320,31634,7380,15273,5604,24254,1024,511,513
15325,31645,7382,15277,5606,24263,1024,511,513
15330,31652,7384,15279,5607,24268,1024,511,513
15335,31665,7386,15286,5607,24278,1025,511,514
15340,31676,7387,15292,5608,24289,1025,511,514
15345,31683,7389,15296,5609,24293,1025,511,514
15350,31696,7391,15300,5610,24302,1026,511,515
15355,31707,7395,15303,5614,24311,1026,511,515
15360,31714,7399,15309,5617,24313,1026,511,515
15365,31727,7403,15319,5620,24321,1027,512,515
15370,31738,7407,15325,5624,24330,1027,512,515
15375,31745,7411,15330,5628,24334,1027,512,515
15380,31758,7413,15335,5628,24344,1028,513,515
15385,31769,7415,15342,5630,24352,1028,513,515
15390,31776,7419,15346,5633,24357,1028,513,515
15395,31789,7421,15351,5634,24367,1029,514,515
15400,31800,7421,15354,5634,24379,1029,514,515
15405,31807,7422,15356,5634,24385,1029,514,515
15410,31820,7424,15361,5635,24396,1030,514,516
15415,31831,7424,15369,5635,24407,1030,514,516
15420,31838,7425,15372,5635,24413,1030,514,516
15425,31851,7427,15379,5636,24423,1031,514,517
15430,31862,7427,15381,5636,24435,1031,514,517
15435,31869,7428,15383,5636,24441,1031,514,517
15440,31882,7431,15390,5638,24449,1032,514,518
15445,31893,7433,15396,5640,24460,1032,514,518
15450,31900,7434,15400,5641,24466,1032,514,518
15455,31913,7437,15408,5643,24474,1033,515,518
15460,31924,7438,15412,5643,24486,1033,515,518
15465,31931,7439,15416,5643,24492,1033,515,518
15470,31944,7441,15422,5644,24500,1034,515,519
15475,31955,7443,15430,5646,24511,1034,515,519
15480,31962,7445,15433,5647,24517,1034,515,519
15485,31975,7448,15441,5649,24526,1035,515,520
15490,31986,7450,15445,5650,24536,1035,515,520
15495,31993,7451,15449,5651,24542,1035,515,520
15500,32006,7455,15456,5655,24551,1036,515,521
15505,32017,7457,15458,5656,24560,1036,515,521
15510,32024,7460,15462,5658,24563,1036,515,521
15515,32037,7466,15469,5662,24570,1037,515,522
15520,32048,7470,15476,5666,24577,1037,515,522
15525,32055,7474,15479,5669,24580,1037,515,522
15530,32068,7479,15487,5673,24588,1038,515,523
15535,32079,7483,15495,5677,24596,1038,515,523
15540,32086,7485,15497,5678,24600,1038,515,523
15545,32099,7487,15502,5680,24612,1039,515,524
15550,32110,7487,15509,5680,24623,1039,515,524
15555,32117,7489,15511,5681,24628,1039,515,524
15560,32130,7491,15514,5682,24639,1040,515,525
15565,32141,7493,15519,5684,24648,1040,515,525
15570,32148,7496,15526,5687,24651,1040,515,525
15575,32161,7498,15531,5688,24663,1041,515,526
15580,32172,7498,15536,5688,24673,1041,515,526
15585,32179,7502,15539,5691,24677,1041,515,526
15590,32192,7505,15543,5693,24686,1042,515,527
15595,32203,7506,15550,5694,24695,1042,515,527
15600,32210,7512,15553,5698,24698,1042,515,527
15605,32223,7514,15561,5700,24707,1043,516,527
15610,32234,7515,15564,5701,24717,1043,516,527
15615,32241,7519,15567,5705,24722,1043,516,527
15620,32254,7522,15576,5707,24729,1044,516,528
15625,32265,7525,15582,5710,24739,1044,516,528
15630,32272,7526,15586,5710,24746,1044,516,528
15635,32285,7528,15595,5711,24756,1045,517,528
15640,32296,7528,15599,5711,24768,1045,517,528
15645,32303,7529,15603,5711,24774,1045,517,528
15650,32316,7531,15608,5713,24784,1046,518,528
15655,32327,7533,15612,5714,24794,1046,518,528
15660,32334,7534,15614,5714,24800,1046,518,528
15665,32347,7536,15619,5715,24811,1047,519,528
15670,32358,7537,15624,5716,24821,1047,519,528
15675,32365,7538,15626,5716,24827,1047,519,528
15680,32378,7541,15633,5717,24835,1048,520,528
15685,32389,7544,15637,5719,24845,1048,520,528
15690,32396,7545,15642,5720,24851,1048,520,528
15695,32409,7548,15651,5722,24859,1049,521,528
15700,32420,7551,15657,5724,24868,1049,521,528
15705,32427,7553,15662,5726,24874,1049,521,528
15710,32440,7556,15668,5727,24883,1050,521,529
15715,32451,7558,15673,5728,24893,1050,521,529
15720,32458,7559,15677,5728,24899,1050,521,529
15725,32471,7563,15685,5730,24906,1051,521,530
15730,32482,7567,15693,5734,24915,1051,521,530
15735,32489,7570,15695,5735,24919,1051,521,530
15740,32502,7574,15704,5738,24926,1052,522,530
15745,32513,7581,15711,5744,24931,1052,522,530
15750,32520,7586,15716,5748,24933,1052,522,530
15755,32533,7588,15726,5749,24944,1053,523,530
15760,32544,7589,15731,5750,24954,1053,523,530
15765,32551,7593,15736,5753,24956,1053,523,530
15770,32564,7596,15743,5755,24966,1054,523,531
15775,32575,7597,15746,5756,24977,1054,523,531
15780,32582,7599,15746,5756,24983,1054,523,531
15785,32595,7601,15750,5756,24993,1055,523,532
15790,32606,7604,15755,5759,25001,1055,523,532
15795,32613,7608,15757,5761,25005,1055,523,532
15800,32626,7610,15764,5761,25015,1056,523,533
15805,32637,7613,15768,5764,25023,1056,523,533
15810,32644,7618,15772,5768,25026,1056,523,533
15815,32657,7620,15776,5769,25037,1057,524,533
15820,32668,7620,15782,5769,25048,1057,524,533
15825,32675,7621,15785,5770,25054,1057,524,533
15830,32688,7623,15791,5771,25065,1058,525,533
15835,32699,7623,15794,5771,25076,1058,525,533
15840,32706,7624,15796,5772,25082,1058,525,533
15845,32719,7626,15801,5772,25093,1059,526,533
15850,32730,7626,15809,5772,25104,1059,526,533
15855,32737,7627,15812,5773,25110,1059,526,533
15860,32750,7628,15815,5773,25122,1060,526,534
15865,32761,7629,15821,5774,25132,1060,526,534
15870,32768,7630,15825,5775,25138,1060,526,534
15875,32781,7632,15832,5777,25147,1061,526,535
15880,32792,7634,15836,5778,25158,1061,526,535
15885,32799,7636,15841,5780,25162,1061,526,535
15890,32812,7641,15849,5784,25169,1062,527,535
15895,32823,7643,15854,5786,25179,1062,527,535
15900,32830,7645,15859,5788,25185,1062,527,535
15905,32843,7648,15867,5791,25194,1063,528,535
15910,32854,7650,15871,5792,25203,1063,528,535
15915,32861,7652,15874,5794,25209,1063,528,535
15920,32874,7655,15881,5796,25217,1064,528,536
15925,32885,7660,15886,5800,25225,1064,528,536
15930,32892,7663,15891,5802,25229,1064,528,536
15935,32905,7665,15895,5804,25239,1065,528,537
15940,32916,7668,15898,5806,25248,1065,528,537
15945,32923,7670,15901,5806,25253,1065,528,537
15950,32936,7673,15907,5808,25262,1066,528,538
15955,32947,7675,15913,5810,25271,1066,528,538
15960,32954,7679,15919,5814,25275,1066,528,538
15965,32967,7681,15924,5815,25285,1067,529,538
15970,32978,7685,15933,5818,25292,1067,529,538
15975,32985,7689,15938,5821,25296,1067,529,538
15980,32998,7691,15944,5822,25306,1068,530,538
15985,33009,7693,15949,5824,25316,1068,530,538
15990,33016,7695,15950,5825,25321,1068,530,538
15995,33029,7696,15954,5825,25332,1069,531,538
16000,33040,7698,15959,5827,25342,1069,531,538
16005,33047,7701,15963,5829,25344,1069,531,538
16010,33060,7704,15972,5832,25353,1070,532,538
16015,33071,7707,15977,5835,25362,1070,532,538
16020,33078,7711,15980,5837,25366,1070,532,538
16025,33091,7714,15986,5839,25376,1071,533,538
16030,33102,7717,15991,5842,25385,1071,533,538
16035,33109,7718,15996,5843,25391,1071,533,538
16040,33122,7720,16002,5845,25401,1072,533,539
16045,33133,7720,16007,5845,25413,1072,533,539
16050,33140,7721,16011,5846,25419,1072,533,539
16055,33153,7722,16017,5847,25430,1073,533,540
16060,33164,7722,16021,5847,25442,1073,533,540
16065,33171,7723,16025,5848,25448,1073,533,540
16070,33184,7724,16027,5848,25460,1074,534,540
16075,33195,7724,16034,5848,25470,1074,534,540
16080,33202,7725,16039,5849,25477,1074,534,540
16085,33215,7727,16043,5851,25487,1075,534,541
16090,33226,7728,16049,5852,25498,1075,534,541
16095,33233,7729,16053,5853,25504,1075,534,541
16100,33246,7732,16061,5856,25513,1076,534,542
16105,33257,7734,16063,5857,25523,1076,534,542
16110,33264,7735,16065,5858,25529,1076,534,542
16115,33277,7737,16071,5860,25539,1077,534,543
16120,33288,7739,16079,5862,25549,1077,534,543
16125,33295,7740,16081,5862,25555,1077,534,543
16130,33308,7742,16088,5864,25564,1078,534,544
16135,33319,7744,16094,5866,25574,1078,534,544
16140,33326,7747,16097,5868,25579,1078,534,544
16145,33339,7750,16103,5871,25588,1079,534,545
16150,33350,7754,16111,5874,25595,1079,534,545
16155,33357,7757,16114,5875,25600,1079,534,545
16160,33370,7758,16119,5875,25612,1080,534,546
16165,33381,7759,16124,5875,25621,1080,534,546
16170,33388,7762,16129,5878,25626,1080,534,546
16175,33401,7764,16135,5879,25636,1081,534,547
16180,33412,7769,16143,5884,25643,1081,534,547
16185,33419,7772,16147,5886,25646,1081,534,547
16190,33432,7776,16154,5890,25652,1082,534,548
16195,33443,7783,16159,5896,25657,1082,534,548
16200,33450,7790,16164,5902,25658,1082,534,548
16205,33463,7793,16173,5904,25667,1083,535,548
16210,33474,7797,16183,5908,25675,1083,535,548
16215,33481,7802,16186,5911,25679,1083,535,548
16220,33494,7803,16194,5912,25690,1084,536,548
16225,33505,7803,16198,5912,25701,1084,536,548
16230,33512,7804,16202,5913,25708,1084,536,548
16235,33525,7806,16210,5915,25718,1085,537,548
16240,33536,7806,16218,5915,25730,1085,537,548
16245,33543,7807,16221,5915,25736,1085,537,548
16250,33556,7809,16224,5916,25747,1086,538,548
16255,33567,7809,16229,5916,25758,1086,538,548
16260,33574,7810,16234,5917,25764,1086,538,548
16265,33587,7812,16239,5918,25775,1087,538,549
16270,33598,7812,16246,5918,25786,1087,538,549
16275,33605,7813,16250,5918,25792,1087,538,549
16280,33618,7814,16257,5919,25804,1088,539,549
16285,33629,7814,16262,5919,25815,1088,539,549
16290,33636,7815,16264,5919,25821,1088,539,549
16295,33649,7817,16271,5921,25832,1089,539,550
16300,33660,7817,16277,5921,25843,1089,539,550
16305,33667,7818,16280,5921,25849,1089,539,550
16310,33680,7820,16286,5922,25859,1090,540,550
16315,33691,7823,16293,5925,25867,1090,540,550
16320,33698,7825,16297,5926,25873,1090,540,550
16325,33711,7828,16302,5929,25882,1091,540,551
16330,33722,7832,16308,5933,25890,1091,540,551
16335,33729,7834,16310,5934,25895,1091,540,551
16340,33742,7835,16317,5935,25905,1092,541,551
16345,33753,7837,16323,5937,25915,1092,541,551
16350,33760,7840,16326,5938,25919,1092,541,551
16355,33773,7845,16333,5942,25926,1093,542,551
16360,33784,7848,16337,5945,25935,1093,542,551
16365,33791,7852,16339,5947,25939,1093,542,551
16370,33804,7856,16347,5950,25943,1094,542,552
16375,33815,7863,16353,5957,25949,1094,542,552
16380,33822,7869,16358,5961,25951,1094,542,552
16385,33835,7872,16363,5963,25961,1095,542,553
16390,33846,7874,16370,5965,25971,1095,542,553
16395,33853,7876,16374,5965,25976,1095,542,553
16400,33866,7879,16382,5968,25983,1096,542,554
16405,33877,7882,16387,5971,25993,1096,542,554
16410,33884,7885,16390,5974,25999,1096,542,554
16415,33897,7887,16395,5975,26008,1097,542,555
16420,33908,7888,16398,5976,26020,1097,542,555
16425,33915,7891,16403,5979,26023,1097,542,555
16430,33928,7895,16410,5983,26033,1098,542,556
16435,33939,7895,16416,5983,26044,1098,542,556
16440,33946,7896,16419,5983,26050,1098,542,556
16445,33959,7898,16427,5985,26060,1099,543,556
16450,33970,7898,16433,5985,26072,1099,543,556
16455,33977,7899,16435,5986,26078,1099,543,556
16460,33990,7900,16440,5986,26089,1100,544,556
16465,34001,7900,16447,5986,26101,1100,544,556
16470,34008,7901,16450,5986,26107,1100,544,556
16475,34021,7902,16456,5986,26119,1101,545,556
16480,34032,7902,16459,5986,26130,1101,545,556
16485,34039,7903,16462,5987,26136,1101,545,556
16490,34052,7906,16467,5990,26145,1102,545,557
16495,34063,7907,16472,5990,26156,1102,545,557
16500,34070,7908,16478,5991,26162,1102,545,557
16505,34083,7909,16481,5992,26172,1103,545,558
16510,34094,7911,16484,5994,26183,1103,545,558
16515,34101,7912,16491,5995,26189,1103,545,558
16520,34114,7914,16498,5997,26199,1104,545,559
16525,34125,7916,16503,5999,26209,1104,545,559
16530,34132,7917,16507,6000,26214,1104,545,559
16535,34145,7922,16517,6005,26220,1105,546,559
16540,34156,7929,16525,6011,26223,1105,546,559
16545,34163,7935,16527,6015,26226,1105,546,559
16550,34176,7940,16534,6019,26231,1106,546,560
16555,34187,7949,16541,6028,26237,1106,546,560
16560,34194,7953,16544,6030,26240,1106,546,560
16565,34207,7954,16550,6031,26251,1107,547,560
16570,34218,7956,16556,6033,26259,1107,547,560
16575,34225,7961,16560,6037,26264,1107,547,560
16580,34238,7963,16569,6039,26275,1108,548,560
16585,34249,7963,16574,6039,26286,1108,548,560
16590,34256,7964,16578,6039,26292,1108,548,560
16595,34269,7966,16587,6040,26302,1109,549,560
16600,34280,7966,16591,6040,26314,1109,549,560
16605,34287,7967,16595,6041,26320,1109,549,560
16610,34300,7968,16600,6041,26332,1110,550,560
16615,34311,7968,16605,6041,26343,1110,550,560
16620,34318,7969,16607,6042,26349,1110,550,560
16625,34331,7971,16612,6043,26359,1111,550,561
16630,34342,7971,16618,6043,26371,1111,550,561
16635,34349,7972,16623,6043,26377,1111,550,561
16640,34362,7973,16628,6044,26389,1112,551,561
16645,34373,7973,16633,6044,26400,1112,551,561
16650,34380,7974,16636,6044,26406,1112,551,561
16655,34393,7975,16644,6045,26417,1113,552,561
16660,34404,7975,16648,6045,26429,1113,552,561
16665,34411,7976,16651,6046,26435,1113,552,561
16670,34424,7979,16659,6049,26443,1114,553,561
16675,34435,7981,16666,6051,26454,1114,553,561
16680,34442,7983,16671,6053,26459,1114,553,561
16685,34455,7985,16677,6054,26468,1115,553,562
16690,34466,7989,16682,6057,26477,1115,553,562
16695,34473,7992,16685,6059,26481,1115,553,562
16700,34486,7996,16693,6062,26489,1116,554,562
16705,34497,8000,16700,6066,26496,1116,554,562
16710,34504,8003,16701,6067,26501,1116,554,562
16715,34517,8005,16708,6069,26510,1117,555,562
16720,34528,8008,16713,6072,26520,1117,555,562
16725,34535,8011,16718,6075,26524,1117,555,562
16730,34548,8014,16725,6078,26533,1118,556,562
16735,34559,8017,16729,6080,26542,1118,556,562
16740,34566,8020,16732,6081,26546,1118,556,562
16745,34579,8023,16737,6083,26554,1119,556,563
16750,34590,8027,16743,6086,26562,1119,556,563
16755,34597,8030,16745,6087,26567,1119,556,563
16760,34610,8032,16749,6088,26577,1120,556,564
16765,34621,8036,16755,6091,26584,1120,556,564
16770,34628,8039,16758,6092,26589,1120,556,564
16775,34641,8040,16763,6092,26600,1121,556,565
16780,34652,8041,16771,6093,26611,1121,556,565
16785,34659,8044,16776,6096,26614,1121,556,565
16790,34672,8047,16783,6099,26621,1122,556,566
16795,34683,8050,16786,6102,26633,1122,556,566
16800,34690,8054,16790,6105,26635,1122,556,566
16805,34703,8056,16795,6106,26646,1123,556,567
16810,34714,8057,16801,6107,26657,1123,556,567
16815,34721,8061,16803,6109,26660,1123,556,567
16820,34734,8063,16811,6111,26668,1124,556,568
16825,34745,8065,16813,6113,26680,1124,556,568
16830,34752,8066,16817,6113,26686,1124,556,568
16835,34765,8068,16822,6115,26696,1125,556,569
16840,34776,8068,16829,6115,26707,1125,556,569
16845,34783,8069,16830,6115,26714,1125,556,569
16850,34796,8070,16835,6116,26726,1126,557,569
16855,34807,8070,16840,6116,26737,1126,557,569
16860,34814,8071,16845,6117,26743,1126,557,569
16865,34827,8072,16852,6118,26754,1127,558,569
16870,34838,8072,16859,6118,26765,1127,558,569
16875,34845,8073,16865,6119,26772,1127,558,569
16880,34858,8075,16871,6120,26781,1128,558,570
16885,34869,8077,16877,6121,26792,1128,558,570
16890,34876,8078,16878,6121,26798,1128,558,570
16895,34889,8081,16881,6123,26808,1129,558,571
16900,34900,8082,16886,6124,26818,1129,558,571
16905,34907,8083,16890,6125,26824,1129,558,571
16910,34920,8085,16894,6126,26835,1130,559,571
16915,34931,8087,16901,6128,26843,1130,559,571
16920,34938,8089,16904,6129,26849,1130,559,571
16925,34951,8092,16910,6132,26859,1131,560,571
16930,34962,8095,16916,6135,26866,1131,560,571
16935,34969,8098,16919,6137,26871,1131,560,571
16940,34982,8101,16923,6138,26879,1132,560,572
16945,34993,8106,16929,6142,26886,1132,560,572
16950,35000,8109,16931,6144,26891,1132,560,572
16955,35013,8112,16937,6146,26901,1133,560,573
16960,35024,8114,16944,6148,26909,1133,560,573
16965,35031,8118,16946,6150,26913,1133,560,573
16970,35044,8123,16953,6153,26919,1134,561,573
16975,35055,8126,16955,6155,26929,1134,561,573
16980,35062,8129,16959,6157,26931,1134,561,573
16985,35075,8136,16970,6163,26937,1135,562,573
16990,35086,8140,16978,6167,26945,1135,562,573
16995,35093,8143,16979,6169,26950,1135,562,573
17000,35106,8146,16987,6172,26959,1136,563,573
17005,35117,8148,16990,6174,26968,1136,563,573
17010,35124,8151,16992,6176,26972,1136,563,573
17015,35137,8154,16997,6178,26983,1137,563,574
17020,35148,8157,17003,6181,26991,1137,563,574
17025,35155,8158,17006,6181,26997,1137,563,574
17030,35168,8160,17015,6182,27007,1138,564,574
17035,35179,8160,17022,6182,27019,1138,564,574
17040,35186,8161,17026,6183,27024,1138,564,574
17045,35199,8163,17033,6184,27036,1139,564,575
17050,35210,8163,17038,6184,27047,1139,564,575
17055,35217,8164,17041,6185,27053,1139,564,575
17060,35230,8166,17047,6186,27064,1140,565,575
17065,35241,8166,17051,6186,27075,1140,565,575
17070,35248,8167,17056,6187,27081,1140,565,575
17075,35261,8169,17062,6187,27092,1141,566,575
17080,35272,8169,17068,6187,27103,1141,566,575
17085,35279,8170,17069,6187,27109,1141,566,575
17090,35292,8173,17075,6188,27117,1142,566,576
17095,35303,8175,17079,6189,27127,1142,566,576
17100,35310,8176,17082,6189,27134,1142,566,576
17105,35323,8178,17090,6190,27143,1143,566,577
17110,35334,8180,17094,6192,27154,1143,566,577
17115,35341,8181,17098,6193,27160,1143,566,577
17120,35354,8183,17098,6193,27171,1144,566,578
17125,35365,8184,17105,6194,27180,1144,566,578
17130,35372,8187,17111,6197,27185,1144,566,578
17135,35385,8189,17117,6198,27194,1145,567,578
17140,35396,8191,17123,6199,27204,1145,567,578
17145,35403,8193,17127,6200,27209,1145,567,578
17150,35416,8197,17133,6204,27218,1146,568,578
17155,35427,8201,17139,6208,27225,1146,568,578
17160,35434,8205,17141,6210,27228,1146,568,578
17165,35447,8210,17146,6214,27236,1147,568,579
17170,35458,8213,17152,6217,27243,1147,568,579
17175,35465,8217,17154,6220,27248,1147,568,579
17180,35478,8221,17164,6223,27252,1148,569,579
17185,35489,8228,17168,6229,27259,1148,569,579
17190,35496,8233,17170,6233,27263,1148,569,579
17195,35509,8237,17181,6236,27268,1149,570,579
17200,35520,8240,17186,6238,27279,1149,570,579
17205,35527,8242,17187,6239,27285,1149,570,579
17210,35540,8246,17195,6243,27293,1150,571,579
17215,35551,8247,17200,6243,27303,1150,571,579
17220,35558,8249,17202,6244,27309,1150,571,579
17225,35571,8253,17209,6248,27318,1151,572,579
17230,35582,8255,17214,6250,27327,1151,572,579
17235,35589,8256,17217,6250,27333,1151,572,579
17240,35602,8258,17226,6252,27344,1152,572,580
17245,35613,8258,17230,6252,27355,1152,572,580
17250,35620,8259,17236,6253,27361,1152,572,580
17255,35633,8261,17240,6253,27371,1153,572,581
17260,35644,8261,17245,6253,27383,1153,572,581
17265,35651,8262,17247,6253,27389,1153,572,581
17270,35664,8264,17255,6254,27398,1154,572,582
17275,35675,8264,17260,6254,27411,1154,572,582
17280,35682,8265,17262,6254,27417,1154,572,582
17285,35695,8267,17268,6255,27427,1155,573,582
17290,35706,8267,17272,6255,27438,1155,573,582
17295,35713,8268,17275,6256,27445,1155,573,582
17300,35726,8270,17280,6257,27456,1156,574,582
17305,35737,8271,17287,6258,27465,1156,574,582
17310,35744,8274,17292,6260,27470,1156,574,582
17315,35757,8276,17300,6261,27480,1157,575,582
17320,35768,8276,17303,6261,27492,1157,575,582
17325,35775,8278,17306,6262,27497,1157,575,582
17330,35788,8281,17316,6265,27506,1158,576,582
17335,35799,8283,17324,6267,27514,1158,576,582
17340,35806,8288,17326,6270,27518,1158,576,582
17345,35819,8291,17328,6271,27528,1159,576,583
17350,35830,8293,17335,6273,27536,1159,576,583
17355,35837,8297,17339,6275,27539,1159,576,583
17360,35850,8301,17344,6277,27546,1160,576,584
17365,35861,8305,17351,6281,27554,1160,576,584
17370,35868,8310,17355,6285,27557,1160,576,584
17375,35881,8314,17362,6289,27565,1161,576,585
17380,35892,8316,17369,6291,27576,1161,576,585
17385,35899,8317,17373,6292,27582,1161,576,585
17390,35912,8319,17379,6293,27591,1162,576,586
17395,35923,8322,17382,6296,27600,1162,576,586
17400,35930,8324,17385,6298,27606,1162,576,586
17405,35943,8327,17394,6301,27614,1163,576,587
17410,35954,8330,17401,6304,27623,1163,576,587
17415,35961,8332,17405,6306,27629,1163,576,587
17420,35974,8335,17412,6308,27637,1164,577,587
17425,35985,8338,17418,6310,27647,1164,577,587
17430,35992,8339,17422,6311,27653,1164,577,587
17435,36005,8342,17430,6313,27661,1165,578,587
17440,36016,8346,17435,6316,27669,1165,578,587
17445,36023,8348,17436,6317,27675,1165,578,587
17450,36036,8352,17442,6321,27683,1166,579,587
17455,36047,8353,17448,6322,27694,1166,579,587
17460,36054,8354,17452,6322,27699,1166,579,587
17465,36067,8356,17460,6324,27711,1167,580,587
17470,36078,8356,17466,6324,27722,1167,580,587
17475,36085,8358,17471,6326,27726,1167,580,587
17480,36098,8360,17478,6326,27738,1168,580,588
17485,36109,8361,17485,6327,27748,1168,580,588
17490,36116,8363,17488,6327,27753,1168,580,588
17495,36129,8365,17495,6329,27764,1169,580,589
17500,36140,8366,17502,6330,27774,1169,580,589
17505,36147,8369,17506,6332,27778,1169,580,589
17510,36160,8371,17513,6332,27788,1170,581,589
17515,36171,8373,17516,6334,27797,1170,581,589
17520,36178,8376,17517,6335,27802,1170,581,589
17525,36191,8379,17521,6336,27811,1171,582,589
17530,36202,8382,17527,6339,27820,1171,582,589
17535,36209,8385,17532,6342,27824,1171,582,589
17540,36222,8387,17540,6344,27833,1172,583,589
17545,36233,8389,17546,6346,27841,1172,583,589
17550,36240,8394,17550,6350,27846,1172,583,589
17555,36253,8396,17556,6352,27854,1173,583,590
17560,36264,8400,17562,6355,27863,1173,583,590
17565,36271,8404,17567,6359,27867,1173,583,590
17570,36284,8407,17576,6361,27875,1174,584,590
17575,36295,8409,17581,6362,27886,1174,584,590
17580,36302,8410,17584,6363,27892,1174,584,590
17585,36315,8413,17590,6365,27901,1175,585,590
17590,36326,8415,17594,6366,27911,1175,585,590
17595,36333,8416,17598,6367,27917,1175,585,590
17600,36346,8418,17601,6368,27927,1176,585,591
17605,36357,8419,17606,6368,27938,1176,585,591
17610,36364,8420,17609,6368,27944,1176,585,591
17615,36377,8424,17617,6371,27952,1177,586,591
17620,36388,8426,17624,6372,27961,1177,586,591
17625,36395,8428,17628,6373,27967,1177,586,591
17630,36408,8431,17633,6374,27975,1178,586,592
17635,36419,8434,17639,6376,27984,1178,586,592
17640,36426,8436,17643,6378,27990,1178,586,592
17645,36439,8440,17649,6382,27998,1179,586,593
17650,36450,8442,17651,6383,28008,1179,586,593
17655,36457,8443,17653,6383,28014,1179,586,593
17660,36470,8446,17660,6384,28022,1180,587,593
17665,36481,8450,17663,6387,28030,1180,587,593
17670,36488,8452,17667,6389,28036,1180,587,593
17675,36501,8454,17674,6391,28047,1181,588,593
17680,36512,8454,17678,6391,28058,1181,588,593
17685,36519,8456,17684,6393,28062,1181,588,593
17690,36532,8458,17690,6394,28072,1182,588,594
17695,36543,8458,17695,6394,28085,1182,588,594
17700,36550,8460,17697,6395,28089,1182,588,594
17705,36563,8462,17702,6396,28100,1183,588,595
17710,36574,8462,17707,6396,28111,1183,588,595
17715,36581,8464,17710,6397,28117,1183,588,595
17720,36594,8466,17716,6397,28126,1184,589,595
17725,36605,8467,17722,6398,28138,1184,589,595
17730,36612,8470,17726,6400,28142,1184,589,595
17735,36625,8472,17729,6400,28151,1185,589,596
17740,36636,8473,17732,6401,28163,1185,589,596
17745,36643,8475,17735,6402,28168,1185,589,596
17750,36656,8477,17742,6402,28177,1186,590,596
17755,36667,8480,17748,6405,28187,1186,590,596
17760,36674,8482,17750,6406,28192,1186,590,596
17765,36687,8485,17756,6408,28200,1187,590,597
17770,36698,8486,17763,6409,28211,1187,590,597
17775,36705,8489,17766,6411,28216,1187,590,597
17780,36718,8491,17770,6412,28225,1188,590,598
17785,36729,8494,17774,6414,28234,1188,590,598
17790,36736,8497,17778,6416,28239,1188,590,598
17795,36749,8500,17785,6419,28247,1189,591,598
17800,36760,8503,17790,6421,28256,1189,591,598
17805,36767,8507,17793,6424,28260,1189,591,598
17810,36780,8510,17799,6426,28267,1190,591,599
17815,36791,8518,17807,6433,28271,1190,591,599
17820,36798,8523,17810,6436,28274,1190,591,599
17825,36811,8528,17817,6441,28282,1191,591,600
17830,36822,8531,17822,6443,28290,1191,591,600
17835,36829,8533,17824,6444,28296,1191,591,600
17840,36842,8536,17828,6445,28304,1192,591,601
17845,36853,8539,17833,6448,28314,1192,591,601
17850,36860,8540,17838,6448,28320,1192,591,601
17855,36873,8542,17844,6450,28328,1193,591,602
17860,36884,8547,17848,6454,28336,1193,591,602
17865,36891,8549,17850,6456,28342,1193,591,602
17870,36904,8554,17857,6459,28348,1194,591,603
17875,36915,8555,17863,6460,28360,1194,591,603
17880,36922,8556,17866,6460,28366,1194,591,603
17885,36935,8558,17869,6460,28377,1195,591,604
17890,36946,8558,17875,6460,28388,1195,591,604
17895,36953,8559,17878,6461,28394,1195,591,604
17900,36966,8561,17885,6462,28405,1196,592,604
17905,36977,8561,17889,6462,28416,1196,592,604
17910,36984,8562,17891,6463,28422,1196,592,604
17915,36997,8564,17896,6463,28433,1197,593,604
17920,37008,8564,17903,6463,28444,1197,593,604
17925,37015,8565,17905,6463,28450,1197,593,604
17930,37028,8567,17912,6465,28461,1198,594,604
17935,37039,8569,17919,6467,28470,1198,594,604
17940,37046,8571,17920,6467,28475,1198,594,604
17945,37059,8573,17930,6468,28486,1199,594,605
17950,37070,8575,17936,6470,28495,1199,594,605
17955,37077,8578,17941,6472,28499,1199,594,605
17960,37090,8580,17946,6473,28510,1200,594,606
17965,37101,8581,17951,6474,28520,1200,594,606
17970,37108,8584,17955,6476,28524,1200,594,606
17975,37121,8587,17961,6478,28532,1201,595,606
17980,37132,8590,17964,6481,28540,1201,595,606
17985,37139,8595,17967,6484,28543,1201,595,606
17990,37152,8599,17974,6488,28549,1202,595,607
17995,37163,8603,17979,6492,28559,1202,595,607
18000,37170,8606,17981,6494,28563,1202,595,607
18005,37183,8610,17985,6497,28572,1203,596,607
18010,37194,8615,17990,6502,28579,1203,596,607
18015,37201,8616,17992,6502,28584,1203,596,607
18020,37214,8620,17994,6504,28594,1204,596,608
18025,37225,8622,17999,6506,28602,1204,596,608
18030,37232,8624,18003,6508,28608,1204,596,608
18035,37245,8627,18009,6509,28617,1205,597,608
18040,37256,8629,18013,6511,28626,1205,597,608
18045,37263,8631,18017,6513,28632,1205,597,608
18050,37276,8635,18024,6517,28639,1206,597,609
18055,37287,8638,18032,6520,28648,1206,597,609
18060,37294,8640,18035,6522,28654,1206,597,609
18065,37307,8643,18044,6525,28662,1207,598,609
18070,37318,8644,18050,6526,28674,1207,598,609
18075,37325,8645,18054,6526,28680,1207,598,609
18080,37338,8647,18060,6527,28690,1208,598,610
18085,37349,8647,18067,6527,28702,1208,598,610
18090,37356,8648,18072,6527,28708,1208,598,610
18095,37369,8650,18081,6528,28718,1209,599,610
18100,37380,8650,18087,6528,28730,1209,599,610
18105,37387,8651,18091,6528,28736,1209,599,610
18110,37400,8653,18097,6529,28746,1210,600,610
18115,37411,8653,18103,6529,28758,1210,600,610
18120,37418,8656,18106,6531,28762,1210,600,610
18125,37431,8658,18113,6532,28772,1211,601,610
18130,37442,8659,18119,6533,28783,1211,601,610
18135,37449,8661,18121,6533,28788,1211,601,610
18140,37462,8663,18129,6535,28798,1212,602,610
18145,37473,8663,18132,6535,28810,1212,602,610
18150,37480,8666,18133,6536,28814,1212,602,610
18155,37493,8668,18137,6536,28824,1213,602,611
18160,37504,8669,18139,6537,28835,1213,602,611
18165,37511,8671,18140,6537,28839,1213,602,611
18170,37524,8674,18146,6540,28849,1214,602,612
18175,37535,8676,18151,6542,28857,1214,602,612
18180,37542,8681,18155,6545,28861,1214,602,612
18185,37555,8684,18165,6548,28867,1215,603,612
18190,37566,8690,18170,6553,28876,1215,603,612
18195,37573,8693,18173,6555,28879,1215,603,612
18200,37586,8698,18182,6558,28883,1216,604,612
18205,37597,8701,18188,6560,28895,1216,604,612
18210,37604,8702,18191,6561,28902,1216,604,612
18215,37617,8704,18197,6561,28910,1217,605,612
18220,37628,8707,18201,6563,28921,1217,605,612
18225,37635,8708,18205,6564,28927,1217,605,612
18230,37648,8710,18208,6564,28937,1218,606,612
18235,37659,8711,18215,6564,28948,1218,606,612
18240,37666,8712,18220,6564,28954,1218,606,612
18245,37679,8714,18226,6565,28963,1219,607,612
18250,37690,8718,18232,6569,28972,1219,607,612
18255,37697,8719,18234,6570,28978,1219,607,612
18260,37710,8722,18238,6572,28987,1220,607,613
18265,37721,8723,18243,6572,28997,1220,607,613
18270,37728,8725,18248,6574,29003,1220,607,613
18275,37741,8729,18256,6577,29010,1221,607,614
18280,37752,8732,18262,6580,29019,1221,607,614
18285,37759,8734,18265,6582,29025,1221,607,614
18290,37772,8736,18271,6583,29035,1222,608,614
18295,37783,8737,18279,6584,29045,1222,608,614
18300,37790,8739,18281,6586,29051,1222,608,614
18305,37803,8742,18286,6588,29059,1223,608,615
18310,37814,8746,18292,6592,29068,1223,608,615
18315,37821,8749,18294,6594,29072,1223,608,615
18320,37834,8753,18303,6597,29080,1224,609,615
18325,37845,8757,18307,6600,29088,1224,609,615
18330,37852,8761,18310,6602,29091,1224,609,615
18335,37865,8764,18315,6603,29101,1225,609,616
18340,37876,8765,18322,6604,29109,1225,609,616
18345,37883,8770,18325,6607,29111,1225,609,616
18350,37896,8773,18329,6608,29122,1226,609,617
18355,37907,8775,18335,6610,29131,1226,609,617
18360,37914,8779,18340,6614,29134,1226,609,617
18365,37927,8781,18346,6616,29145,1227,609,618
18370,37938,8783,18351,6618,29153,1227,609,618
18375,37945,8788,18355,6623,29157,1227,609,618
18380,37958,8791,18360,6624,29167,1228,609,619
18385,37969,8791,18366,6624,29178,1228,609,619
18390,37976,8792,18369,6625,29184,1228,609,619
18395,37989,8794,18376,6626,29195,1229,609,620
18400,38000,8794,18381,6626,29206,1229,609,620
18405,38007,8795,18385,6627,29212,1229,609,620
18410,38020,8797,18391,6627,29222,1230,610,620
18415,38031,8797,18400,6627,29233,1230,610,620
18420,38038,8798,18404,6627,29240,1230,610,620
18425,38051,8800,18410,6628,29251,1231,611,620
18430,38062,8800,18417,6628,29262,1231,611,620
18435,38069,8801,18419,6628,29268,1231,611,620
18440,38082,8803,18428,6629,29275,1232,612,620
18445,38093,8805,18434,6631,29288,1232,612,620
18450,38100,8806,18436,6631,29294,1232,612,620
18455,38113,8809,18444,6633,29301,1233,613,620
18460,38124,8811,18451,6635,29312,1233,613,620
18465,38131,8812,18453,6635,29319,1233,613,620
18470,38144,8815,18459,6636,29328,1234,613,621
18475,38155,8817,18463,6637,29338,1234,613,621
18480,38162,8818,18468,6638,29344,1234,613,621
18485,38175,8821,18477,6640,29352,1235,613,622
18490,38186,8823,18481,6641,29363,1235,613,622
18495,38193,8825,18483,6642,29368,1235,613,622
18500,38206,8827,18489,6643,29377,1236,613,623
18505,38217,8829,18492,6644,29388,1236,613,623
18510,38224,8831,18495,6645,29393,1236,613,623
18515,38237,8834,18503,6648,29401,1237,614,623
18520,38248,8837,18507,6650,29411,1237,614,623
18525,38255,8840,18512,6652,29415,1237,614,623
18530,38268,8843,18518,6655,29424,1238,615,623
18535,38279,8846,18524,6657,29433,1238,615,623
18540,38286,8848,18527,6659,29438,1238,615,623
18545,38299,8850,18531,6660,29447,1239,615,624
18550,38310,8853,18536,6663,29457,1239,615,624
18555,38317,8855,18539,6664,29462,1239,615,624
18560,38330,8859,18546,6666,29470,1240,616,624
18565,38341,8862,18552,6668,29478,1240,616,624
18570,38348,8865,18555,6669,29482,1240,616,624
18575,38361,8869,18561,6673,29490,1241,616,625
18580,38372,8874,18566,6677,29495,1241,616,625
18585,38379,8880,18570,6682,29497,1241,616,625
18590,38392,8883,18576,6685,29507,1242,616,626
18595,38403,8884,18581,6686,29518,1242,616,626
18600,38410,8888,18584,6688,29520,1242,616,626
18605,38423,8891,18589,6690,29531,1243,617,626
18610,38434,8893,18595,6692,29539,1243,617,626
18615,38441,8898,18598,6696,29542,1243,617,626
18620,38454,8902,18608,6700,29550,1244,618,626
18625,38465,8904,18609,6702,29560,1244,618,626
18630,38472,8908,18612,6704,29563,1244,618,626
18635,38485,8910,18613,6704,29575,1245,618,627
18640,38496,8910,18617,6704,29586,1245,618,627
18645,38503,8911,18621,6704,29592,1245,618,627
18650,38516,8913,18628,6705,29602,1246,618,628
18655,38527,8913,18635,6705,29614,1246,618,628
18660,38534,8914,18637,6705,29619,1246,618,628
18665,38547,8916,18641,6706,29631,1247,619,628
18670,38558,8916,18647,6706,29642,1247,619,628
18675,38565,8917,18651,6707,29648,1247,619,628
18680,38578,8919,18657,6709,29659,1248,620,628
18685,38589,8919,18662,6709,29670,1248,620,628
18690,38596,8920,18666,6710,29676,1248,620,628
18695,38609,8922,18670,6710,29687,1249,621,628
18700,38620,8923,18676,6710,29697,1249,621,628
18705,38627,8924,18680,6710,29703,1249,621,628
18710,38640,8926,18686,6711,29711,1250,621,629
18715,38651,8929,18689,6713,29721,1250,621,629
18720,38658,8930,18695,6714,29728,1250,621,629
18725,38671,8933,18698,6716,29737,1251,621,630
18730,38682,8935,18704,6718,29747,1251,621,630
18735,38689,8937,18705,6718,29752,1251,621,630
18740,38702,8939,18711,6718,29762,1252,622,630
18745,38713,8940,18715,6718,29773,1252,622,630
18750,38720,8942,18719,6720,29778,1252,622,630
18755,38733,8945,18728,6723,29785,1253,623,630
18760,38744,8950,18736,6728,29793,1253,623,630
18765,38751,8953,18738,6730,29798,1253,623,630
18770,38764,8958,18749,6735,29801,1254,624,630
18775,38775,8964,18754,6740,29809,1254,624,630
18780,38782,8970,18756,6744,29812,1254,624,630
18785,38795,8973,18760,6745,29822,1255,625,630
18790,38806,8976,18763,6747,29829,1255,625,630
18795,38813,8980,18767,6750,29832,1255,625,630
18800,38826,8985,18774,6754,29839,1256,625,631
18805,38837,8990,18780,6758,29845,1256,625,631
18810,38844,8993,18783,6760,29851,1256,625,631
18815,38857,8997,18793,6763,29858,1257,626,631
18820,38868,9000,18801,6766,29867,1257,626,631
18825,38875,9002,18805,6768,29873,1257,626,631
18830,38888,9005,18812,6770,29880,1258,627,631
18835,38899,9008,18820,6773,29890,1258,627,631
18840,38906,9010,18822,6774,29896,1258,627,631
18845,38919,9012,18826,6775,29907,1259,627,632
18850,38930,9012,18831,6775,29918,1259,627,632
18855,38937,9013,18835,6775,29924,1259,627,632
18860,38950,9015,18843,6777,29934,1260,627,633
18865,38961,9015,18849,6777,29945,1260,627,633
18870,38968,9016,18853,6778,29951,1260,627,633
18875,38981,9018,18857,6778,29963,1261,628,633
18880,38992,9018,18865,6778,29973,1261,628,633
18885,38999,9019,18868,6778,29980,1261,628,633
18890,39012,9021,18871,6779,29991,1262,629,633
18895,39023,9021,18878,6779,30002,1262,629,633
18900,39030,9022,18883,6780,30007,1262,629,633
18905,39043,9024,18893,6781,30018,1263,630,633
18910,39054,9024,18896,6781,30030,1263,630,633
18915,39061,9025,18901,6781,30036,1263,630,633
18920,39074,9027,18907,6782,30045,1264,631,633
18925,39085,9028,18913,6783,30057,1264,631,633
18930,39092,9031,18916,6785,30061,1264,631,633
18935,39105,9033,18922,6786,30071,1265,632,633
18940,39116,9033,18927,6786,30082,1265,632,633
18945,39123,9036,18930,6789,30087,1265,632,633
18950,39136,9039,18937,6790,30093,1266,633,633
18955,39147,9044,18942,6794,30103,1266,633,633
18960,39154,9046,18944,6795,30108,1266,633,633
18965,39167,9050,18951,6799,30115,1267,633,634
18970,39178,9053,18958,6802,30124,1267,633,634
18975,39185,9058,18962,6806,30127,1267,633,634
18980,39198,9061,18970,6808,30134,1268,634,634
18985,39209,9066,18976,6812,30142,1268,634,634
18990,39216,9070,18981,6815,30146,1268,634,634
18995,39229,9073,18987,6816,30154,1269,634,635
19000,39240,9077,18992,6819,30162,1269,634,635
19005,39247,9081,18995,6822,30166,1269,634,635
19010,39260,9084,18999,6824,30176,1270,634,636
19015,39271,9086,19004,6826,30183,1270,634,636
19020,39278,9092,19008,6832,30186,1270,634,636
19025,39291,9094,19014,6833,30195,1271,634,637
19030,39302,9098,19021,6836,30204,1271,634,637
19035,39309,9099,19024,6836,30210,1271,634,637
19040,39322,9101,19033,6838,30218,1272,635,637
19045,39333,9106,19038,6842,30227,1272,635,637
19050,39340,9107,19043,6842,30232,1272,635,637
19055,39353,9112,19052,6846,30239,1273,636,637
19060,39364,9113,19061,6847,30251,1273,636,637
19065,39371,9114,19064,6847,30256,1273,636,637
19070,39384,9116,19069,6849,30268,1274,636,638
19075,39395,9116,19074,6849,30279,1274,636,638
19080,39402,9117,19076,6850,30285,1274,636,638
19085,39415,9119,19083,6851,30296,1275,636,639
19090,39426,9119,19087,6851,30307,1275,636,639
19095,39433,9120,19091,6852,30313,1275,636,639
19100,39446,9122,19096,6852,30324,1276,637,639
19105,39457,9122,19099,6852,30335,1276,637,639
19110,39464,9123,19104,6853,30340,1276,637,639
19115,39477,9125,19113,6855,30352,1277,638,639
19120,39488,9125,19118,6855,30362,1277,638,639
19125,39495,9126,19122,6856,30369,1277,638,639
19130,39508,9128,19131,6857,30379,1278,639,639
19135,39519,9128,19137,6857,30390,1278,639,639
19140,39526,9130,19140,6858,30396,1278,639,639
19145,39539,9132,19149,6859,30406,1279,640,639
19150,39550,9132,19155,6859,30418,1279,640,639
19155,39557,9134,19160,6860,30423,1279,640,639
19160,39570,9136,19165,6862,30433,1280,641,639
19165,39581,9139,19169,6864,30442,1280,641,639
19170,39588,9141,19171,6864,30447,1280,641,639
19175,39601,9143,19177,6866,30457,1281,642,639
19180,39612,9146,19182,6868,30466,1281,642,639
19185,39619,9149,19188,6871,30469,1281,642,639
19190,39632,9153,19193,6874,30479,1282,643,639
19195,39643,9156,19201,6876,30485,1282,643,639
19200,39650,9160,19204,6879,30490,1282,643,639
19205,39663,9163,19211,6880,30496,1283,643,640
19210,39674,9169,19216,6886,30505,1283,643,640
19215,39681,9171,19218,6888,30510,1283,643,640
19220,39694,9176,19227,6892,30515,1284,643,641
19225,39705,9181,19231,6896,30523,1284,643,641
19230,39712,9185,19236,6898,30526,1284,643,641
19235,39725,9190,19241,6901,30532,1285,643,642
19240,39736,9194,19249,6905,30541,1285,643,642
19245,39743,9196,19253,6907,30547,1285,643,642
19250,39756,9200,19258,6909,30554,1286,643,643
19255,39767,9202,19261,6911,30565,1286,643,643
19260,39774,9203,19264,6911,30570,1286,643,643
19265,39787,9207,19267,6913,30579,1287,644,643
19270,39798,9209,19271,6914,30587,1287,644,643
19275,39805,9213,19275,6917,30592,1287,644,643
19280,39818,9216,19284,6920,30600,1288,645,643
19285,39829,9216,19291,6920,30612,1288,645,643
19290,39836,9217,19296,6921,30619,1288,645,643
19295,39849,9219,19300,6922,30630,1289,645,644
19300,39860,9219,19304,6922,30641,1289,645,644
19305,39867,9220,19307,6922,30647,1289,645,644
19310,39880,9222,19310,6922,30658,1290,646,644
19315,39891,9222,19316,6922,30668,1290,646,644
19320,39898,9223,19322,6923,30674,1290,646,644
19325,39911,9225,19327,6924,30685,1291,646,645
19330,39922,9225,19329,6924,30697,1291,646,645
19335,39929,9226,19333,6924,30703,1291,646,645
19340,39942,9228,19338,6924,30714,1292,646,646
19345,39953,9228,19342,6924,30725,1292,646,646
19350,39960,9230,19343,6924,30730,1292,646,646
19355,39973,9232,19349,6926,30740,1293,646,647
19360,39984,9233,19354,6927,30751,1293,646,647
19365,39991,9235,19355,6927,30756,1293,646,647
19370,40004,9237,19359,6927,30766,1294,646,648
19375,40015,9239,19366,6929,30775,1294,646,648
19380,40022,9242,19368,6931,30780,1294,646,648
19385,40035,9244,19374,6931,30788,1295,647,648
19390,40046,9249,19380,6935,30797,1295,647,648
19395,40053,9253,19387,6939,30799,1295,647,648
19400,40066,9258,19397,6943,30805,1296,648,648
19405,40077,9264,19403,6949,30812,1296,648,648
19410,40084,9268,19406,6951,30815,1296,648,648
19415,40097,9272,19408,6953,30825,1297,648,649
19420,40108,9273,19413,6953,30835,1297,648,649
19425,40115,9274,19416,6954,30841,1297,648,649
19430,40128,9277,19424,6956,30848,1298,648,650
19435,40139,9280,19432,6958,30858,1298,648,650
19440,40146,9282,19433,6959,30864,1298,648,650
19445,40159,9285,19441,6961,30872,1299,649,650
19450,40170,9288,19444,6963,30882,1299,649,650
19455,40177,9289,19446,6963,30888,1299,649,650
19460,40190,9294,19455,6967,30893,1300,650,650
19465,40201,9298,19457,6971,30903,1300,650,650
19470,40208,9299,19460,6971,30908,1300,650,650
19475,40221,9304,19464,6974,30917,1301,650,651
19480,40232,9304,19468,6974,30928,1301,650,651
19485,40239,9305,19471,6975,30934,1301,650,651
19490,40252,9307,19481,6977,30945,1302,651,651
19495,40263,9307,19484,6977,30956,1302,651,651
19500,40270,9308,19487,6977,30962,1302,651,651
19505,40283,9310,19494,6978,30973,1303,651,652
19510,40294,9310,19496,6978,30984,1303,651,652
19515,40301,9312,19501,6980,30988,1303,651,652
19520,40314,9314,19510,6982,31000,1304,652,652
19525,40325,9315,19514,6983,31010,1304,652,652
19530,40332,9318,19517,6984,31014,1304,652,652
19535,40345,9320,19524,6985,31025,1305,652,653
19540,40356,9322,19531,6987,31034,1305,652,653
19545,40363,9325,19535,6988,31038,1305,652,653
19550,40376,9327,19538,6988,31049,1306,652,654
19555,40387,9327,19541,6988,31060,1306,652,654
19560,40394,9329,19546,6990,31065,1306,652,654
19565,40407,9331,19552,6990,31076,1307,652,655
19570,40418,9331,19556,6990,31087,1307,652,655
19575,40425,9333,19559,6991,31092,1307,652,655
19580,40438,9335,19563,6991,31101,1308,652,656
19585,40449,9339,19567,6994,31109,1308,652,656
19590,40456,9342,19571,6996,31114,1308,652,656
19595,40469,9345,19580,6999,31120,1309,653,656
19600,40480,9349,19587,7003,31129,1309,653,656
19605,40487,9352,19589,7005,31135,1309,653,656
19610,40500,9354,19597,7006,31142,1310,653,657
19615,40511,9358,19601,7010,31153,1310,653,657
19620,40518,9360,19604,7010,31157,1310,653,657
19625,40531,9364,19608,7012,31166,1311,653,658
19630,40542,9366,19611,7014,31175,1311,653,658
19635,40549,9369,19613,7016,31180,1311,653,658
19640,40562,9371,19618,7016,31189,1312,653,659
19645,40573,9376,19625,7021,31196,1312,653,659
19650,40580,9380,19629,7024,31199,1312,653,659
19655,40593,9383,19634,7027,31210,1313,654,659
19660,40604,9385,19639,7029,31217,1313,654,659
19665,40611,9389,19642,7032,31221,1313,654,659
19670,40624,9394,19650,7037,31226,1314,654,660
19675,40635,9398,19654,7040,31237,1314,654,660
19680,40642,9399,19656,7041,31243,1314,654,660
19685,40655,9402,19663,7042,31250,1315,655,660
19690,40666,9405,19665,7045,31260,1315,655,660
19695,40673,9407,19667,7046,31266,1315,655,660
19700,40686,9410,19672,7048,31274,1316,655,661
19705,40697,9411,19677,7048,31285,1316,655,661
19710,40704,9413,19680,7049,31291,1316,655,661
19715,40717,9416,19682,7050,31300,1317,655,662
19720,40728,9420,19689,7053,31307,1317,655,662
19725,40735,9423,19691,7055,31312,1317,655,662
19730,40748,9427,19698,7057,31320,1318,656,662
19735,40759,9427,19703,7057,31331,1318,656,662
19740,40766,9428,19705,7057,31338,1318,656,662
19745,40779,9430,19713,7058,31349,1319,657,662
19750,40790,9430,19721,7058,31359,1319,657,662
19755,40797,9431,19726,7059,31366,1319,657,662
19760,40810,9433,19730,7060,31376,1320,657,663
19765,40821,9433,19733,7060,31388,1320,657,663
19770,40828,9434,19737,7061,31394,1320,657,663
19775,40841,9436,19741,7061,31403,1321,658,663
19780,40852,9437,19749,7062,31415,1321,658,663
19785,40859,9440,19754,7065,31419,1321,658,663
19790,40872,9442,19760,7066,31428,1322,658,664
19795,40883,9443,19765,7067,31439,1322,658,664
19800,40890,9446,19769,7070,31444,1322,658,664
19805,40903,9448,19774,7072,31455,1323,658,665
19810,40914,9449,19781,7073,31465,1323,658,665
19815,40921,9451,19785,7075,31470,1323,658,665
19820,40934,9453,19790,7075,31481,1324,658,666
19825,40945,9455,19800,7077,31490,1324,658,666
19830,40952,9458,19802,7078,31494,1324,658,666
19835,40965,9460,19806,7079,31503,1325,658,667
19840,40976,9464,19811,7082,31512,1325,658,667
19845,40983,9466,19813,7083,31517,1325,658,667
19850,40996,9469,19821,7084,31524,1326,659,667
19855,41007,9475,19828,7089,31530,1326,659,667
19860,41014,9480,19830,7093,31534,1326,659,667
19865,41027,9483,19837,7095,31540,1327,659,668
19870,41038,9488,19847,7100,31550,1327,659,668
19875,41045,9489,19850,7101,31556,1327,659,668
19880,41058,9492,19858,7103,31563,1328,660,668
19885,41069,9494,19864,7104,31574,1328,660,668
19890,41076,9496,19868,7105,31580,1328,660,668
19895,41089,9499,19875,7107,31588,1329,661,668
19900,41100,9501,19881,7109,31599,1329,661,668
19905,41107,9502,19884,7110,31605,1329,661,668
19910,41120,9505,19893,7112,31613,1330,662,668
19915,41131,9508,19900,7114,31622,1330,662,668
19920,41138,9510,19902,7115,31628,1330,662,668
19925,41151,9514,19910,7119,31636,1331,663,668
19930,41162,9517,19916,7122,31645,1331,663,668
19935,41169,9519,19919,7123,31649,1331,663,668
19940,41182,9523,19930,7127,31659,1332,664,668
19945,41193,9523,19939,7127,31670,1332,664,668
19950,41200,9524,19943,7127,31676,1332,664,668
19955,41213,9526,19948,7128,31687,1333,665,668
19960,41224,9526,19954,7128,31698,1333,665,668
19965,41231,9527,19958,7129,31703,1333,665,668
19970,41244,9529,19962,7130,31715,1334,666,668
19975,41255,9529,19967,7130,31726,1334,666,668
19980,41262,9531,19972,7131,31730,1334,666,668
19985,41275,9533,19977,7132,31742,1335,666,669
19990,41286,9533,19983,7132,31753,1335,666,669
19995,41293,9535,19988,7133,31758,1335,666,669
20000,41306,9537,19993,7135,31768,1336,666,670
20005,41317,9537,19997,7135,31779,1336,666,670
20010,41324,9540,19998,7137,31784,1336,666,670
20015,41337,9543,20007,7140,31791,1337,667,670
20020,41348,9545,20014,7142,31802,1337,667,670
20025,41355,9548,20017,7144,31807,1337,667,670
20030,41368,9551,20022,7146,31815,1338,668,670
20035,41379,9553,20028,7148,31824,1338,668,670
20040,41386,9558,20032,7152,31828,1338,668,670
20045,41399,9561,20036,7153,31836,1339,669,670
20050,41410,9563,20039,7154,31846,1339,669,670
20055,41417,9567,20041,7156,31850,1339,669,670
20060,41430,9571,20048,7159,31857,1340,669,671
20065,41441,9574,20051,7161,31867,1340,669,671
20070,41448,9576,20054,7163,31872,1340,669,671
20075,41461,9578,20058,7164,31881,1341,669,672
20080,41472,9580,20060,7165,31891,1341,669,672
20085,41479,9583,20062,7168,31896,1341,669,672
20090,41492,9585,20066,7169,31906,1342,670,672
20095,41503,9590,20072,7174,31911,1342,670,672
20100,41510,9593,20076,7176,31917,1342,670,672
20105,41523,9596,20083,7178,31924,1343,670,673
20110,41534,9599,20089,7181,31934,1343,670,673
20115,41541,9601,20092,7182,31940,1343,670,673
20120,41554,9605,20097,7185,31949,1344,671,673
20125,41565,9607,20106,7187,31957,1344,671,673
20130,41572,9609,20108,7188,31963,1344,671,673
20135,41585,9611,20114,7189,31971,1345,672,673
20140,41596,9614,20123,7192,31981,1345,672,673
20145,41603,9616,20128,7193,31987,1345,672,673
20150,41616,9620,20135,7197,31995,1346,673,673
20155,41627,9624,20142,7201,32002,1346,673,673
20160,41634,9625,20144,7201,32009,1346,673,673
20165,41647,9626,20150,7201,32021,1347,674,673
20170,41658,9626,20154,7201,32032,1347,674,673
20175,41665,9627,20158,7201,32038,1347,674,673
20180,41678,9629,20165,7202,32048,1348,674,674
20185,41689,9629,20172,7202,32060,1348,674,674
20190,41696,9630,20174,7202,32066,1348,674,674
20195,41709,9632,20182,7203,32076,1349,675,674
20200,41720,9632,20188,7203,32088,1349,675,674
20205,41727,9634,20193,7205,32093,1349,675,674
20210,41740,9636,20201,7207,32103,1350,676,674
20215,41751,9637,20207,7208,32112,1350,676,674
20220,41758,9642,20210,7212,32115,1350,676,674
20225,41771,9646,20217,7216,32124,1351,676,675
20230,41782,9647,20221,7217,32134,1351,676,675
20235,41789,9650,20225,7219,32138,1351,676,675
20240,41802,9652,20227,7220,32150,1352,676,676
20245,41813,9655,20234,7223,32158,1352,676,676
20250,41820,9658,20236,7224,32162,1352,676,676
20255,41833,9661,20241,7226,32171,1353,676,677
20260,41844,9665,20249,7230,32179,1353,676,677
20265,41851,9666,20252,7231,32185,1353,676,677
20270,41864,9668,20259,7232,32193,1354,677,677
20275,41875,9670,20264,7233,32205,1354,677,677
20280,41882,9671,20266,7234,32211,1354,677,677
20285,41895,9672,20272,7234,32221,1355,678,677
20290,41906,9674,20277,7236,32232,1355,678,677
20295,41913,9675,20281,7236,32238,1355,678,677
20300,41926,9678,20287,7238,32246,1356,679,677
20305,41937,9681,20291,7241,32255,1356,679,677
20310,41944,9683,20296,7243,32261,1356,679,677
20315,41957,9685,20301,7244,32271,1357,680,677
20320,41968,9687,20303,7245,32280,1357,680,677
20325,41975,9689,20307,7246,32285,1357,680,677
20330,41988,9693,20314,7249,32292,1358,681,677
20335,41999,9699,20322,7255,32298,1358,681,677
20340,42006,9702,20325,7258,32303,1358,681,677
20345,42019,9703,20330,7258,32315,1359,681,678
20350,42030,9703,20334,7258,32327,1359,681,678
20355,42037,9704,20336,7258,32333,1359,681,678
20360,42050,9705,20341,7258,32345,1360,682,678
20365,42061,9705,20347,7258,32356,1360,682,678
20370,42068,9708,20353,7261,32359,1360,682,678
20375,42081,9710,20358,7262,32371,1361,683,678
20380,42092,9711,20362,7263,32380,1361,683,678
20385,42099,9713,20364,7263,32386,1361,683,678
20390,42112,9714,20371,7263,32395,1362,684,678
20395,42123,9718,20376,7267,32405,1362,684,678
20400,42130,9720,20378,7268,32410,1362,684,678
20405,42143,9723,20386,7271,32418,1363,685,678
20410,42154,9724,20390,7272,32430,1363,685,678
20415,42161,9727,20394,7274,32434,1363,685,678
20420,42174,9729,20400,7275,32444,1364,685,679
20425,42185,9732,20409,7278,32451,1364,685,679
20430,42192,9738,20414,7283,32453,1364,685,679
20435,42205,9740,20419,7285,32463,1365,686,679
20440,42216,9742,20427,7287,32474,1365,686,679
20445,42223,9743,20432,7288,32480,1365,686,679
20450,42236,9744,20438,7288,32491,1366,687,679
20455,42247,9745,20445,7289,32502,1366,687,679
20460,42254,9746,20448,7290,32508,1366,687,679
20465,42267,9748,20452,7291,32518,1367,687,680
20470,42278,9750,20459,7292,32528,1367,687,680
20475,42285,9751,20462,7293,32534,1367,687,680
20480,42298,9753,20469,7294,32544,1368,688,680
20485,42309,9755,20472,7295,32554,1368,688,680
20490,42316,9756,20476,7296,32560,1368,688,680
20495,42329,9758,20482,7297,32569,1369,688,681
20500,42340,9762,20490,7301,32577,1369,688,681
20505,42347,9764,20493,7302,32583,1369,688,681
20510,42360,9766,20499,7304,32593,1370,689,681
20515,42371,9769,20503,7306,32601,1370,689,681
20520,42378,9771,20506,7308,32607,1370,689,681
20525,42391,9774,20511,7310,32617,1371,689,682
20530,42402,9776,20516,7312,32625,1371,689,682
20535,42409,9779,20520,7315,32630,1371,689,682
20540,42422,9781,20526,7317,32640,1372,689,683
20545,42433,9784,20530,7320,32648,1372,689,683
20550,42440,9787,20531,7321,32653,1372,689,683
20555,42453,9789,20542,7322,32662,1373,689,684
20560,42464,9789,20546,7322,32674,1373,689,684
20565,42471,9794,20551,7326,32675,1373,689,684
20570,42484,9798,20556,7329,32685,1374,690,684
20575,42495,9799,20559,7330,32695,1374,690,684
20580,42502,9802,20564,7333,32700,1374,690,684
20585,42515,9804,20569,7334,32709,1375,691,684
20590,42526,9807,20575,7337,32718,1375,691,684
20595,42533,9812,20580,7341,32720,1375,691,684
20600,42546,9814,20587,7343,32730,1376,692,684
20605,42557,9816,20594,7345,32740,1376,692,684
20610,42564,9818,20595,7346,32746,1376,692,684
20615,42577,9820,20603,7348,32756,1377,692,685
20620,42588,9820,20611,7348,32768,1377,692,685
20625,42595,9821,20615,7348,32774,1377,692,685
20630,42608,9822,20620,7349,32785,1378,693,685
20635,42619,9822,20622,7349,32797,1378,693,685
20640,42626,9823,20624,7350,32803,1378,693,685
20645,42639,9825,20630,7351,32813,1379,693,686
20650,42650,9825,20636,7351,32825,1379,693,686
20655,42657,9826,20640,7352,32831,1379,693,686
20660,42670,9829,20648,7354,32840,1380,694,686
20665,42681,9830,20651,7355,32851,1380,694,686
20670,42688,9831,20654,7356,32857,1380,694,686
20675,42701,9834,20658,7358,32867,1381,694,687
20680,42712,9836,20665,7359,32875,1381,694,687
20685,42719,9838,20668,7360,32881,1381,694,687
20690,42732,9841,20675,7362,32889,1382,694,688
20695,42743,9845,20682,7365,32898,1382,694,688
20700,42750,9846,20687,7366,32904,1382,694,688
20705,42763,9848,20690,7367,32914,1383,694,689
20710,42774,9849,20694,7368,32924,1383,694,689
20715,42781,9852,20699,7370,32929,1383,694,689
20720,42794,9855,20706,7372,32937,1384,695,689
20725,42805,9860,20710,7376,32944,1384,695,689
20730,42812,9863,20714,7379,32948,1384,695,689
20735,42825,9868,20721,7384,32956,1385,696,689
20740,42836,9872,20727,7388,32964,1385,696,689
20745,42843,9874,20731,7390,32968,1385,696,689
20750,42856,9878,20739,7393,32977,1386,697,689
20755,42867,9879,20746,7394,32986,1386,697,689
20760,42874,9885,20751,7398,32987,1386,697,689
20765,42887,9887,20755,7399,32999,1387,698,689
20770,42898,9888,20759,7400,33009,1387,698,689
20775,42905,9891,20762,7402,33014,1387,698,689
20780,42918,9894,20766,7404,33023,1388,698,690
20785,42929,9895,20771,7405,33032,1388,698,690
20790,42936,9899,20775,7409,33037,1388,698,690
20795,42949,9900,20782,7409,33046,1389,699,690
20800,42960,9903,20788,7412,33055,1389,699,690
20805,42967,9908,20791,7416,33059,1389,699,690
20810,42980,9909,20793,7416,33071,1390,699,691
20815,42991,9909,20795,7416,33081,1390,699,691
20820,42998,9913,20798,7419,33085,1390,699,691
20825,43011,9915,20804,7421,33095,1391,699,692
20830,43022,9915,20809,7421,33107,1391,699,692
20835,43029,9916,20815,7422,33113,1391,699,692
20840,43042,9918,20821,7423,33124,1392,699,693
20845,43053,9918,20825,7423,33135,1392,699,693
20850,43060,9919,20827,7423,33141,1392,699,693
20855,43073,9920,20832,7424,33153,1393,700,693
20860,43084,9921,20838,7424,33163,1393,700,693
20865,43091,9922,20843,7425,33169,1393,700,693
20870,43104,9924,20847,7427,33179,1394,700,694
20875,43115,9925,20853,7428,33189,1394,700,694
20880,43122,9927,20853,7429,33195,1394,700,694
20885,43135,9929,20857,7430,33205,1395,700,695
20890,43146,9931,20861,7431,33215,1395,700,695
20895,43153,9932,20864,7431,33221,1395,700,695
20900,43166,9936,20869,7435,33230,1396,701,695
20905,43177,9939,20875,7437,33238,1396,701,695
20910,43184,9941,20879,7438,33243,1396,701,695
20915,43197,9943,20886,7440,33252,1397,702,695
20920,43208,9948,20891,7444,33259,1397,702,695
20925,43215,9952,20895,7448,33263,1397,702,695
20930,43228,9955,20899,7451,33273,1398,703,695
20935,43239,9956,20902,7452,33282,1398,703,695
20940,43246,9959,20904,7453,33286,1398,703,695
20945,43259,9960,20910,7453,33296,1399,703,696
20950,43270,9962,20915,7455,33307,1399,703,696
20955,43277,9966,20920,7458,33310,1399,703,696
20960,43290,9968,20927,7460,33319,1400,703,697
20965,43301,9971,20934,7463,33328,1400,703,697
20970,43308,9976,20938,7467,33332,1400,703,697
20975,43321,9979,20945,7470,33339,1401,703,698
20980,43332,9981,20948,7472,33351,1401,703,698
20985,43339,9984,20953,7475,33354,1401,703,698
20990,43352,9987,20959,7477,33364,1402,703,699
20995,43363,9988,20964,7478,33374,1402,703,699
21000,43370,9990,20964,7479,33380,1402,703,699
21005,43383,9992,20970,7481,33391,1403,703,700
21010,43394,9992,20974,7481,33402,1403,703,700
21015,43401,9993,20975,7481,33408,1403,703,700
21020,43414,9995,20981,7482,33418,1404,703,701
21025,43425,9995,20986,7482,33430,1404,703,701
21030,43432,9996,20991,7483,33436,1404,703,701
21035,43445,9998,20999,7485,33447,1405,703,702
21040,43456,9998,21006,7485,33458,1405,703,702
21045,43463,9999,21008,7486,33464,1405,703,702
21050,43476,10001,21014,7487,33474,1406,704,702
21055,43487,10002,21016,7487,33485,1406,704,702
21060,43494,10003,21019,7487,33491,1406,704,702
21065,43507,10006,21026,7489,33499,1407,705,702
21070,43518,10008,21034,7491,33509,1407,705,702
21075,43525,10010,21039,7493,33515,1407,705,702
21080,43538,10013,21043,7496,33525,1408,705,703
21085,43549,10016,21048,7499,33533,1408,705,703
21090,43556,10017,21051,7499,33539,1408,705,703
21095,43569,10022,21061,7503,33544,1409,705,704
21100,43580,10029,21066,7509,33551,1409,705,704
21105,43587,10032,21071,7510,33554,1409,705,704
21110,43600,10035,21073,7511,33565,1410,706,704
21115,43611,10038,21079,7514,33572,1410,706,704
21120,43618,10042,21084,7518,33575,1410,706,704
21125,43631,10044,21093,7519,33585,1411,706,705
21130,43642,10046,21100,7521,33595,1411,706,705
21135,43649,10048,21103,7522,33601,1411,706,705
21140,43662,10050,21111,7523,33611,1412,707,705
21145,43673,10051,21116,7524,33621,1412,707,705
21150,43680,10054,21119,7525,33626,1412,707,705
21155,43693,10056,21129,7526,33635,1413,708,705
21160,43704,10056,21133,7526,33648,1413,708,705
21165,43711,10059,21135,7528,33652,1413,708,705
21170,43724,10061,21138,7528,33663,1414,708,706
21175,43735,10062,21143,7529,33673,1414,708,706
21180,43742,10064,21147,7531,33677,1414,708,706
21185,43755,10068,21153,7535,33686,1415,708,707
21190,43766,10071,21161,7538,33694,1415,708,707
21195,43773,10074,21163,7540,33699,1415,708,707
21200,43786,10076,21167,7541,33709,1416,708,708
21205,43797,10079,21175,7544,33717,1416,708,708
21210,43804,10083,21179,7548,33721,1416,708,708
21215,43817,10086,21187,7550,33731,1417,709,708
21220,43828,10089,21193,7553,33739,1417,709,708
21225,43835,10090,21197,7554,33745,1417,709,708
21230,43848,10092,21202,7555,33753,1418,709,709
21235,43859,10094,21207,7556,33765,1418,709,709
21240,43866,10095,21208,7556,33771,1418,709,709
21245,43879,10097,21215,7558,33779,1419,709,710
21250,43890,10100,21219,7561,33789,1419,709,710
21255,43897,10102,21223,7562,33795,1419,709,710
21260,43910,10104,21226,7563,33805,1420,709,711
21265,43921,10105,21229,7564,33815,1420,709,711
21270,43928,10107,21231,7565,33821,1420,709,711
21275,43941,10110,21235,7566,33830,1421,710,711
21280,43952,10113,21238,7568,33838,1421,710,711
21285,43959,10115,21242,7569,33843,1421,710,711
21290,43972,10120,21247,7573,33851,1422,711,711
21295,43983,10124,21253,7577,33858,1422,711,711
21300,43990,10127,21258,7580,33863,1422,711,711
21305,44003,10131,21266,7583,33871,1423,712,711
21310,44014,10131,21268,7583,33882,1423,712,711
21315,44021,10132,21272,7583,33888,1423,712,711
21320,44034,10134,21280,7584,33900,1424,713,711
21325,44045,10135,21285,7585,33910,1424,713,711
21330,44052,10138,21289,7588,33914,1424,713,711
21335,44065,10140,21293,7589,33925,1425,713,712
21340,44076,10141,21300,7590,33935,1425,713,712
21345,44083,10143,21303,7591,33940,1425,713,712
21350,44096,10145,21307,7591,33951,1426,714,712
21355,44107,10147,21313,7593,33960,1426,714,712
21360,44114,10149,21317,7594,33964,1426,714,712
21365,44127,10153,21325,7597,33973,1427,714,713
21370,44138,10155,21330,7599,33981,1427,714,713
21375,44145,10161,21335,7605,33984,1427,714,713
21380,44158,10164,21341,7608,33993,1428,714,714
21385,44169,10168,21350,7612,34001,1428,714,714
21390,44176,10169,21355,7613,34007,1428,714,714
21395,44189,10171,21361,7613,34018,1429,715,714
21400,44200,10171,21368,7613,34029,1429,715,714
21405,44207,10172,21371,7613,34035,1429,715,714
21410,44220,10174,21378,7615,34046,1430,716,714
21415,44231,10174,21382,7615,34057,1430,716,714
21420,44238,10175,21384,7616,34063,1430,716,714
21425,44251,10177,21389,7618,34072,1431,716,715
21430,44262,10180,21397,7620,34081,1431,716,715
21435,44269,10182,21401,7622,34087,1431,716,715
21440,44282,10184,21407,7622,34096,1432,716,716
21445,44293,10187,21414,7625,34106,1432,716,716
21450,44300,10188,21416,7626,34112,1432,716,716
21455,44313,10191,21420,7627,34121,1433,716,717
21460,44324,10193,21427,7629,34130,1433,716,717
21465,44331,10195,21430,7630,34135,1433,716,717
21470,44344,10199,21435,7633,34143,1434,716,718
21475,44355,10205,21442,7638,34149,1434,716,718
21480,44362,10208,21444,7640,34154,1434,716,718
21485,44375,10211,21453,7643,34163,1435,717,718
21490,44386,10212,21461,7644,34173,1435,717,718
21495,44393,10215,21467,7647,34178,1435,717,718
21500,44406,10217,21475,7647,34188,1436,718,718
21505,44417,10217,21482,7647,34200,1436,718,718
21510,44424,10220,21486,7650,34204,1436,718,718
21515,44437,10222,21489,7650,34214,1437,719,718
21520,44448,10224,21497,7652,34221,1437,719,718
21525,44455,10229,21501,7656,34225,1437,719,718
21530,44468,10232,21506,7659,34235,1438,720,718
21535,44479,10235,21512,7662,34242,1438,720,718
21540,44486,10238,21516,7665,34247,1438,720,718
21545,44499,10241,21520,7666,34257,1439,721,718
21550,44510,10245,21527,7670,34265,1439,721,718
21555,44517,10248,21530,7671,34269,1439,721,718
21560,44530,10250,21539,7673,34278,1440,722,718
21565,44541,10250,21543,7673,34291,1440,722,718
21570,44548,10251,21546,7674,34297,1440,722,718
21575,44561,10253,21552,7675,34308,1441,722,719
21580,44572,10253,21554,7675,34319,1441,722,719
21585,44579,10254,21559,7676,34325,1441,722,719
21590,44592,10257,21563,7677,34333,1442,722,720
21595,44603,10258,21572,7678,34344,1442,722,720
21600,44610,10260,21576,7680,34350,1442,722,720
21605,44623,10262,21577,7681,34361,1443,722,721
21610,44634,10264,21585,7682,34369,1443,722,721
21615,44641,10266,21588,7683,34375,1443,722,721
21620,44654,10269,21592,7685,34384,1444,722,722
21625,44665,10270,21598,7686,34394,1444,722,722
21630,44672,10272,21600,7687,34400,1444,722,722
21635,44685,10275,21605,7688,34409,1445,723,722
21640,44696,10278,21610,7690,34417,1445,723,722
21645,44703,10280,21613,7691,34422,1445,723,722
21650,44716,10284,21619,7694,34430,1446,723,723
21655,44727,10288,21624,7697,34438,1446,723,723
21660,44734,10290,21626,7698,34444,1446,723,723
21665,44747,10294,21632,7702,34451,1447,723,724
21670,44758,10296,21634,7704,34462,1447,723,724
21675,44765,10298,21637,7705,34466,1447,723,724
21680,44778,10300,21643,7705,34477,1448,723,725
21685,44789,10301,21648,7706,34488,1448,723,725
21690,44796,10303,21649,7707,34493,1448,723,725
21695,44809,10305,21655,7708,34503,1449,723,726
21700,44820,10306,21659,7709,34514,1449,723,726
21705,44827,10308,21662,7710,34519,1449,723,726
21710,44840,10310,21669,7712,34526,1450,723,727
21715,44851,10313,21673,7715,34538,1450,723,727
21720,44858,10315,21674,7715,34543,1450,723,727
21725,44871,10317,21679,7716,34552,1451,723,728
21730,44882,10319,21686,7718,34562,1451,723,728
21735,44889,10322,21691,7721,34566,1451,723,728
21740,44902,10325,21695,7722,34575,1452,723,729
21745,44913,10327,21699,7724,34585,1452,723,729
21750,44920,10331,21703,7727,34589,1452,723,729
21755,44933,10334,21711,7729,34599,1453,723,730
21760,44944,10337,21718,7732,34605,1453,723,730
21765,44951,10342,21723,7737,34609,1453,723,730
21770,44964,10344,21730,7738,34617,1454,723,731
21775,44975,10346,21736,7739,34629,1454,723,731
21780,44982,10347,21740,7739,34635,1454,723,731
21785,44995,10349,21748,7741,34644,1455,723,732
21790,45006,10353,21756,7745,34652,1455,723,732
21795,45013,10355,21760,7747,34658,1455,723,732
21800,45026,10358,21766,7749,34666,1456,723,733
21805,45037,10360,21768,7750,34677,1456,723,733
21810,45044,10361,21772,7751,34683,1456,723,733
21815,45057,10364,21776,7752,34692,1457,723,734
21820,45068,10367,21778,7754,34701,1457,723,734
21825,45075,10369,21782,7756,34706,1457,723,734
21830,45088,10371,21789,7757,34714,1458,724,734
21835,45099,10375,21792,7760,34723,1458,724,734
21840,45106,10378,21796,7762,34728,1458,724,734
21845,45119,10382,21803,7766,34736,1459,725,734
21850,45130,10383,21809,7767,34746,1459,725,734
21855,45137,10384,21812,7767,34752,1459,725,734
21860,45150,10386,21816,7768,34764,1460,725,735
21865,45161,10386,21820,7768,34775,1460,725,735
21870,45168,10388,21823,7768,34779,1460,725,735
21875,45181,10390,21831,7769,34791,1461,726,735
21880,45192,10391,21836,7770,34801,1461,726,735
21885,45199,10393,21838,7771,34806,1461,726,735
21890,45212,10395,21845,7773,34817,1462,726,736
21895,45223,10398,21852,7776,34824,1462,726,736
21900,45230,10402,21856,7780,34827,1462,726,736
21905,45243,10405,21864,7781,34837,1463,727,736
21910,45254,10407,21868,7783,34846,1463,727,736
21915,45261,10410,21869,7785,34851,1463,727,736
21920,45274,10413,21875,7787,34860,1464,727,737
21925,45285,10416,21881,7790,34868,1464,727,737
21930,45292,10420,21884,7794,34872,1464,727,737
21935,45305,10423,21889,7795,34881,1465,727,738
21940,45316,10424,21891,7796,34892,1465,727,738
21945,45323,10425,21894,7797,34898,1465,727,738
21950,45336,10427,21902,7797,34909,1466,728,738
21955,45347,10427,21910,7797,34919,1466,728,738
21960,45354,10428,21915,7797,34926,1466,728,738
21965,45367,10430,21921,7799,34937,1467,729,738
21970,45378,10431,21928,7799,34946,1467,729,738
21975,45385,10432,21931,7800,34953,1467,729,738
21980,45398,10434,21936,7800,34962,1468,730,738
21985,45409,10435,21943,7801,34974,1468,730,738
21990,45416,10436,21946,7801,34980,1468,730,738
21995,45429,10438,21954,7802,34990,1469,731,738
22000,45440,10440,21959,7804,35000,1469,731,738
22005,45447,10441,21961,7804,35006,1469,731,738
22010,45460,10443,21966,7805,35016,1470,731,739
22015,45471,10445,21971,7806,35025,1470,731,739
22020,45478,10447,21973,7807,35031,1470,731,739
22025,45491,10450,21979,7808,35038,1471,731,740
22030,45502,10454,21986,7811,35047,1471,731,740
22035,45509,10456,21988,7812,35053,1471,731,740
22040,45522,10459,21995,7813,35061,1472,731,741
22045,45533,10462,21999,7816,35071,1472,731,741
22050,45540,10465,22003,7818,35075,1472,731,741
22055,45553,10469,22010,7822,35083,1473,732,741
22060,45564,10473,22015,7825,35091,1473,732,741
22065,45571,10475,22020,7826,35096,1473,732,741
22070,45584,10478,22028,7829,35104,1474,732,742
22075,45595,10480,22034,7831,35114,1474,732,742
22080,45602,10483,22040,7834,35119,1474,732,742
22085,45615,10485,22047,7836,35127,1475,733,742
22090,45626,10493,22055,7844,35130,1475,733,742
22095,45633,10498,22058,7849,35134,1475,733,742
22100,45646,10503,22064,7852,35139,1476,733,743
22105,45657,10506,22067,7855,35150,1476,733,743
22110,45664,10509,22071,7858,35154,1476,733,743
22115,45677,10511,22075,7859,35164,1477,733,744
22120,45688,10513,22080,7861,35173,1477,733,744
22125,45695,10517,22082,7864,35178,1477,733,744
22130,45708,10519,22087,7866,35188,1478,733,745
22135,45719,10523,22094,7870,35194,1478,733,745
22140,45726,10525,22098,7872,35201,1478,733,745
22145,45739,10527,22102,7872,35212,1479,733,746
22150,45750,10527,22108,7872,35223,1479,733,746
22155,45757,10528,22109,7872,35229,1479,733,746
22160,45770,10530,22115,7874,35239,1480,733,747
22165,45781,10530,22123,7874,35251,1480,733,747
22170,45788,10531,22127,7875,35257,1480,733,747
22175,45801,10533,22133,7876,35267,1481,734,747
22180,45812,10533,22139,7876,35279,1481,734,747
22185,45819,10534,22144,7877,35285,1481,734,747
22190,45832,10536,22148,7878,35296,1482,734,748
22195,45843,10536,22155,7878,35307,1482,734,748
22200,45850,10537,22159,7878,35313,1482,734,748
22205,45863,10539,22167,7880,35323,1483,735,748
22210,45874,10541,22176,7882,35333,1483,735,748
22215,45881,10542,22179,7882,35339,1483,735,748
22220,45894,10544,22187,7883,35347,1484,735,749
22225,45905,10547,22193,7885,35358,1484,735,749
22230,45912,10548,22198,7885,35364,1484,735,749
22235,45925,10550,22204,7886,35373,1485,736,749
22240,45936,10554,22211,7890,35382,1485,736,749
22245,45943,10555,22214,7891,35388,1485,736,749
22250,45956,10559,22223,7895,35396,1486,737,749
22255,45967,10561,22227,7897,35406,1486,737,749
22260,45974,10563,22230,7898,35411,1486,737,749
22265,45987,10567,22235,7900,35419,1487,737,750
22270,45998,10570,22241,7903,35428,1487,737,750
22275,46005,10573,22245,7905,35432,1487,737,750
22280,46018,10576,22250,7906,35441,1488,738,750
22285,46029,10580,22257,7910,35446,1488,738,750
22290,46036,10587,22260,7915,35448,1488,738,750
22295,46049,10592,22264,7918,35455,1489,738,751
22300,46060,10594,22270,7920,35463,1489,738,751
22305,46067,10599,22271,7923,35468,1489,738,751
22310,46080,10601,22275,7924,35478,1490,738,752
22315,46091,10602,22281,7925,35488,1490,738,752
22320,46098,10606,22283,7927,35492,1490,738,752
22325,46111,10609,22292,7930,35500,1491,739,752
22330,46122,10611,22298,7932,35511,1491,739,752
22335,46129,10613,22300,7933,35516,1491,739,752
22340,46142,10615,22308,7935,35526,1492,739,753
22345,46153,10618,22313,7938,35534,1492,739,753
22350,46160,10621,22316,7940,35538,1492,739,753
22355,46173,10625,22321,7943,35547,1493,739,754
22360,46184,10625,22327,7943,35559,1493,739,754
22365,46191,10626,22332,7944,35565,1493,739,754
22370,46204,10628,22342,7945,35575,1494,739,755
22375,46215,10628,22347,7945,35587,1494,739,755
22380,46222,10629,22349,7945,35593,1494,739,755
22385,46235,10631,22356,7947,35604,1495,740,755
22390,46246,10631,22363,7947,35615,1495,740,755
22395,46253,10632,22367,7948,35621,1495,740,755
22400,46266,10634,22373,7950,35632,1496,740,756
22405,46277,10635,22378,7950,35642,1496,740,756
22410,46284,10636,22382,7950,35648,1496,740,756
22415,46297,10638,22390,7952,35659,1497,741,756
22420,46308,10639,22396,7952,35669,1497,741,756
22425,46315,10640,22400,7953,35675,1497,741,756
22430,46328,10642,22406,7953,35684,1498,741,757
22435,46339,10645,22413,7956,35693,1498,741,757
22440,46346,10647,22418,7958,35699,1498,741,757
22445,46359,10649,22423,7959,35710,1499,742,757
22450,46370,10650,22428,7959,35719,1499,742,757
22455,46377,10652,22431,7961,35725,1499,742,757
22460,46390,10655,22437,7962,35733,1500,743,757
22465,46401,10659,22443,7965,35741,1500,743,757
22470,46408,10662,22446,7967,35746,1500,743,757
22475,46421,10664,22450,7968,35756,1501,743,758
22480,46432,10668,22457,7971,35762,1501,743,758
22485,46439,10673,22461,7975,35765,1501,743,758
22490,46452,10678,22470,7979,35769,1502,744,758
22495,46463,10684,22475,7985,35778,1502,744,758
22500,46470,10687,22476,7987,35783,1502,744,758
22505,46483,10690,22480,7989,35792,1503,745,758
22510,46494,10695,22486,7993,35797,1503,745,758
22515,46501,10700,22489,7997,35800,1503,745,758
22520,46514,10705,22495,8001,35807,1504,746,758
22525,46525,10711,22501,8006,35812,1504,746,758
22530,46532,10713,22504,8008,35819,1504,746,758
22535,46545,10715,22509,8009,35828,1505,746,759
22540,46556,10715,22512,8009,35841,1505,746,759
22545,46563,10716,22517,8009,35847,1505,746,759
22550,46576,10718,22523,8009,35857,1506,747,759
22555,46587,10718,22529,8009,35869,1506,747,759
22560,46594,10719,22534,8010,35875,1506,747,759
22565,46607,10721,22539,8010,35886,1507,748,759
22570,46618,10721,22544,8010,35896,1507,748,759
22575,46625,10722,22546,8010,35903,1507,748,759
22580,46638,10724,22552,8012,35914,1508,748,760
22585,46649,10724,22559,8012,35925,1508,748,760
22590,46656,10725,22561,8012,35931,1508,748,760
22595,46669,10727,22570,8013,35941,1509,749,760
22600,46680,10727,22574,8013,35953,1509,749,760
22605,46687,10728,22577,8013,35959,1509,749,760
22610,46700,10730,22586,8013,35968,1510,750,760
22615,46711,10730,22591,8013,35981,1510,750,760
22620,46718,10731,22595,8013,35987,1510,750,760
22625,46731,10733,22601,8014,35997,1511,750,761
22630,46742,10733,22607,8014,36009,1511,750,761
22635,46749,10736,22610,8015,36013,1511,750,761
22640,46762,10738,22617,8017,36022,1512,750,762
22645,46773,10742,22624,8020,36030,1512,750,762
22650,46780,10744,22629,8021,36036,1512,750,762
22655,46793,10746,22634,8021,36045,1513,750,763
22660,46804,10750,22639,8025,36054,1513,750,763
22665,46811,10752,22641,8026,36058,1513,750,763
22670,46824,10755,22642,8027,36069,1514,750,764
22675,46835,10758,22648,8030,36076,1514,750,764
22680,46842,10762,22651,8033,36079,1514,750,764
22685,46855,10765,22657,8036,36087,1515,751,764
22690,46866,10772,22664,8043,36093,1515,751,764
22695,46873,10776,22666,8046,36097,1515,751,764
22700,46886,10780,22672,8049,36103,1516,751,765
22705,46897,10785,22677,8054,36111,1516,751,765
22710,46904,10789,22681,8058,36115,1516,751,765
22715,46917,10792,22687,8060,36124,1517,752,765
22720,46928,10794,22694,8061,36133,1517,752,765
22725,46935,10796,22699,8063,36139,1517,752,765
22730,46948,10799,22705,8065,36149,1518,753,765
22735,46959,10800,22712,8066,36159,1518,753,765
22740,46966,10801,22717,8067,36165,1518,753,765
22745,46979,10805,22724,8069,36172,1519,753,766
22750,46990,10807,22730,8070,36182,1519,753,766
22755,46997,10809,22733,8071,36187,1519,753,766
22760,47010,10814,22741,8075,36194,1520,754,766
22765,47021,10818,22744,8078,36202,1520,754,766
22770,47028,10820,22747,8079,36208,1520,754,766
22775,47041,10822,22750,8079,36218,1521,755,766
22780,47052,10822,22755,8079,36229,1521,755,766
22785,47059,10823,22759,8080,36236,1521,755,766
22790,47072,10825,22766,8081,36246,1522,755,767
22795,47083,10825,22769,8081,36258,1522,755,767
22800,47090,10826,22775,8082,36263,1522,755,767
22805,47103,10828,22781,8084,36274,1523,755,768
22810,47114,10828,22787,8084,36285,1523,755,768
22815,47121,10829,22790,8084,36292,1523,755,768
22820,47134,10831,22796,8084,36302,1524,755,769
22825,47145,10831,22799,8084,36313,1524,755,769
22830,47152,10834,22803,8087,36318,1524,755,769
22835,47165,10836,22807,8087,36328,1525,755,770
22840,47176,10837,22812,8088,36339,1525,755,770
22845,47183,10839,22813,8088,36344,1525,755,770
22850,47196,10842,22819,8090,36353,1526,755,771
22855,47207,10844,22826,8092,36361,1526,755,771
22860,47214,10848,22830,8096,36366,1526,755,771
22865,47227,10850,22838,8098,36376,1527,755,772
22870,47238,10853,22844,8101,36383,1527,755,772
22875,47245,10859,22849,8106,36385,1527,755,772
22880,47258,10862,22854,8109,36394,1528,755,773
22885,47269,10865,22857,8112,36404,1528,755,773
22890,47276,10868,22859,8114,36408,1528,755,773
22895,47289,10871,22864,8116,36416,1529,755,774
22900,47300,10874,22870,8119,36425,1529,755,774
22905,47307,10878,22872,8121,36429,1529,755,774
22910,47320,10880,22879,8121,36438,1530,755,775
22915,47331,10882,22882,8122,36449,1530,755,775
22920,47338,10883,22888,8123,36455,1530,755,775
22925,47351,10886,22893,8125,36464,1531,755,776
22930,47362,10888,22898,8126,36474,1531,755,776
22935,47369,10889,22901,8126,36480,1531,755,776
22940,47382,10892,22906,8128,36489,1532,756,776
22945,47393,10895,22912,8130,36498,1532,756,776
22950,47400,10896,22915,8130,36504,1532,756,776
22955,47413,10899,22920,8132,36513,1533,756,777
22960,47424,10903,22923,8135,36521,1533,756,777
22965,47431,10905,22925,8136,36526,1533,756,777
22970,47444,10907,22929,8137,36536,1534,756,778
22975,47455,10909,22931,8138,36545,1534,756,778
22980,47462,10911,22936,8140,36550,1534,756,778
22985,47475,10916,22941,8144,36559,1535,757,778
22990,47486,10919,22946,8146,36566,1535,757,778
22995,47493,10922,22951,8149,36570,1535,757,778
23000,47506,10925,22958,8151,36580,1536,758,778
23005,47517,10925,22961,8151,36592,1536,758,778
23010,47524,10926,22962,8152,36598,1536,758,778
23015,47537,10928,22965,8152,36609,1537,759,778
23020,47548,10930,22968,8154,36618,1537,759,778
23025,47555,10932,22972,8156,36623,1537,759,778
23030,47568,10934,22975,8156,36633,1538,760,778
23035,47579,10937,22982,8159,36640,1538,760,778
23040,47586,10942,22986,8163,36643,1538,760,778
23045,47599,10945,22993,8165,36650,1539,761,778
23050,47610,10947,23000,8167,36660,1539,761,778
23055,47617,10952,23004,8170,36664,1539,761,778
23060,47630,10956,23010,8174,36671,1540,761,779
23065,47641,10957,23017,8175,36684,1540,761,779
23070,47648,10958,23019,8175,36690,1540,761,779
23075,47661,10960,23025,8177,36701,1541,762,779
23080,47672,10960,23030,8177,36712,1541,762,779
23085,47679,10961,23036,8178,36718,1541,762,779
23090,47692,10963,23044,8180,36727,1542,763,779
23095,47703,10963,23049,8180,36740,1542,763,779
23100,47710,10964,23053,8181,36746,1542,763,779
23105,47723,10967,23061,8183,36755,1543,763,780
23110,47734,10969,23069,8185,36764,1543,763,780
23115,47741,10971,23072,8187,36770,1543,763,780
23120,47754,10975,23079,8189,36778,1544,764,780
23125,47765,10978,23087,8192,36786,1544,764,780
23130,47772,10980,23089,8193,36792,1544,764,780
23135,47785,10983,23095,8196,36802,1545,765,780
23140,47796,10985,23102,8198,36810,1545,765,780
23145,47803,10987,23106,8200,36816,1545,765,780
23150,47816,10989,23112,8202,36827,1546,766,780
23155,47827,10991,23118,8203,36835,1546,766,780
23160,47834,10993,23123,8205,36841,1546,766,780
23165,47847,10996,23130,8207,36849,1547,767,780
23170,47858,11000,23134,8210,36856,1547,767,780
23175,47865,11004,23138,8214,36860,1547,767,780
23180,47878,11006,23142,8214,36870,1548,767,781
23185,47889,11006,23144,8214,36883,1548,767,781
23190,47896,11008,23146,8214,36888,1548,767,781
23195,47909,11010,23149,8214,36899,1549,767,782
23200,47920,11010,23154,8214,36909,1549,767,782
23205,47927,11014,23157,8217,36912,1549,767,782
23210,47940,11016,23165,8219,36920,1550,768,782
23215,47951,11019,23171,8222,36930,1550,768,782
23220,47958,11025,23174,8226,36932,1550,768,782
23225,47971,11028,23180,8227,36942,1551,768,783
23230,47982,11031,23184,8230,36951,1551,768,783
23235,47989,11034,23189,8233,36954,1551,768,783
23240,48002,11037,23194,8236,36965,1552,769,783
23245,48013,11039,23200,8238,36974,1552,769,783
23250,48020,11041,23204,8240,36979,1552,769,783
23255,48033,11043,23209,8241,36990,1553,769,784
23260,48044,11045,23216,8243,36999,1553,769,784
23265,48051,11046,23219,8243,37005,1553,769,784
23270,48064,11048,23225,8245,37015,1554,770,784
23275,48075,11048,23232,8245,37027,1554,770,784
23280,48082,11049,23235,8246,37033,1554,770,784
23285,48095,11051,23239,8247,37042,1555,770,785
23290,48106,11054,23246,8250,37052,1555,770,785
23295,48113,11055,23249,8250,37058,1555,770,785
23300,48126,11057,23255,8251,37069,1556,771,785
23305,48137,11058,23263,8252,37079,1556,771,785
23310,48144,11059,23267,8253,37085,1556,771,785
23315,48157,11061,23275,8254,37095,1557,772,785
23320,48168,11064,23282,8257,37104,1557,772,785
23325,48175,11066,23287,8259,37109,1557,772,785
23330,48188,11069,23291,8261,37119,1558,773,785
23335,48199,11071,23295,8262,37128,1558,773,785
23340,48206,11073,23297,8264,37133,1558,773,785
23345,48219,11075,23301,8264,37143,1559,773,786
23350,48230,11077,23305,8266,37153,1559,773,786
23355,48237,11078,23308,8267,37159,1559,773,786
23360,48250,11082,23315,8270,37167,1560,774,786
23365,48261,11084,23323,8272,37176,1560,774,786
23370,48268,11087,23325,8274,37181,1560,774,786
23375,48281,11091,23332,8277,37189,1561,774,787
23380,48292,11094,23337,8280,37197,1561,774,787
23385,48299,11097,23341,8283,37201,1561,774,787
23390,48312,11102,23347,8287,37208,1562,774,788
23395,48323,11106,23352,8291,37216,1562,774,788
23400,48330,11110,23356,8294,37219,1562,774,788
23405,48343,11113,23362,8296,37226,1563,774,789
23410,48354,11119,23370,8302,37233,1563,774,789
23415,48361,11123,23373,8305,37238,1563,774,789
23420,48374,11125,23376,8305,37247,1564,775,789
23425,48385,11129,23380,8308,37256,1564,775,789
23430,48392,11132,23382,8309,37260,1564,775,789
23435,48405,11134,23388,8310,37270,1565,776,789
23440,48416,11134,23391,8310,37281,1565,776,789
23445,48423,11139,23397,8315,37284,1565,776,789
23450,48436,11141,23403,8316,37293,1566,776,790
23455,48447,11143,23409,8318,37302,1566,776,790
23460,48454,11145,23412,8320,37309,1566,776,790
23465,48467,11147,23420,8321,37319,1567,776,791
23470,48478,11147,23424,8321,37330,1567,776,791
23475,48485,11148,23428,8321,37336,1567,776,791
23480,48498,11150,23435,8323,37347,1568,777,791
23485,48509,11150,23440,8323,37359,1568,777,791
23490,48516,11151,23443,8323,37365,1568,777,791
23495,48529,11153,23450,8325,37375,1569,778,791
23500,48540,11153,23456,8325,37386,1569,778,791
23505,48547,11154,23460,8325,37393,1569,778,791
23510,48560,11156,23467,8327,37402,1570,779,791
23515,48571,11156,23471,8327,37415,1570,779,791
23520,48578,11157,23473,8328,37421,1570,779,791
23525,48591,11159,23477,8329,37430,1571,779,792
23530,48602,11161,23482,8330,37441,1571,779,792
23535,48609,11162,23483,8330,37447,1571,779,792
23540,48622,11165,23492,8332,37456,1572,780,792
23545,48633,11167,23497,8334,37466,1572,780,792
23550,48640,11168,23501,8334,37472,1572,780,792
23555,48653,11171,23509,8336,37479,1573,781,792
23560,48664,11174,23513,8338,37490,1573,781,792
23565,48671,11176,23516,8338,37495,1573,781,792
23570,48684,11179,23526,8341,37504,1574,782,792
23575,48695,11180,23530,8342,37515,1574,782,792
23580,48702,11183,23534,8343,37519,1574,782,792
23585,48715,11186,23540,8345,37527,1575,782,793
23590,48726,11189,23546,8347,37537,1575,782,793
23595,48733,11192,23551,8350,37541,1575,782,793
23600,48746,11196,23559,8353,37549,1576,783,793
23605,48757,11199,23563,8356,37558,1576,783,793
23610,48764,11202,23566,8358,37562,1576,783,793
23615,48777,11206,23573,8361,37569,1577,784,793
23620,48788,11210,23578,8364,37578,1577,784,793
23625,48795,11212,23580,8366,37583,1577,784,793
23630,48808,11214,23583,8366,37593,1578,784,794
23635,48819,11219,23590,8371,37598,1578,784,794
23640,48826,11225,23594,8375,37599,1578,784,794
23645,48839,11230,23600,8378,37607,1579,785,794
23650,48850,11232,23605,8380,37618,1579,785,794
23655,48857,11235,23607,8381,37622,1579,785,794
23660,48870,11237,23609,8381,37632,1580,785,795
23665,48881,11238,23614,8382,37641,1580,785,795
23670,48888,11242,23617,8385,37645,1580,785,795
23675,48901,11245,23621,8386,37655,1581,785,796
23680,48912,11246,23624,8387,37666,1581,785,796
23685,48919,11249,23628,8389,37669,1581,785,796
23690,48932,11252,23636,8391,37678,1582,786,796
23695,48943,11253,23642,8392,37690,1582,786,796
23700,48950,11254,23643,8393,37696,1582,786,796
23705,48963,11256,23650,8395,37706,1583,787,796
23710,48974,11256,23655,8395,37718,1583,787,796
23715,48981,11257,23656,8395,37724,1583,787,796
23720,48994,11259,23660,8396,37734,1584,787,797
23725,49005,11259,23666,8396,37745,1584,787,797
23730,49012,11260,23673,8397,37752,1584,787,797
23735,49025,11262,23680,8398,37761,1585,788,797
23740,49036,11262,23685,8398,37774,1585,788,797
23745,49043,11263,23688,8398,37780,1585,788,797
23750,49056,11266,23698,8400,37787,1586,789,797
23755,49067,11269,23705,8403,37798,1586,789,797
23760,49074,11270,23706,8403,37804,1586,789,797
23765,49087,11272,23714,8404,37813,1587,790,797
23770,49098,11274,23721,8406,37824,1587,790,797
23775,49105,11275,23725,8406,37830,1587,790,797
23780,49118,11278,23733,8408,37837,1588,790,798
23785,49129,11281,23738,8410,37848,1588,790,798
23790,49136,11282,23741,8411,37854,1588,790,798
23795,49149,11285,23746,8413,37863,1589,790,799
23800,49160,11289,23754,8417,37870,1589,790,799
23805,49167,11293,23761,8421,37874,1589,790,799
23810,49180,11296,23763,8422,37884,1590,790,800
23815,49191,11299,23770,8425,37892,1590,790,800
23820,49198,11301,23770,8425,37897,1590,790,800
23825,49211,11304,23775,8426,37907,1591,791,800
23830,49222,11306,23782,8427,37915,1591,791,800
23835,49229,11310,23786,8430,37919,1591,791,800
23840,49242,11313,23794,8432,37926,1592,792,800
23845,49253,11318,23797,8437,37935,1592,792,800
23850,49260,11322,23803,8440,37936,1592,792,800
23855,49273,11327,23811,8445,37942,1593,793,800
23860,49284,11333,23815,8450,37951,1593,793,800
23865,49291,11336,23817,8451,37954,1593,793,800
23870,49304,11338,23823,8452,37963,1594,793,801
23875,49315,11340,23827,8454,37975,1594,793,801
23880,49322,11344,23831,8457,37977,1594,793,801
23885,49335,11346,23835,8458,37988,1595,793,802
23890,49346,11347,23839,8459,37998,1595,793,802
23895,49353,11348,23842,8459,38005,1595,793,802
23900,49366,11350,23849,8460,38014,1596,793,803
23905,49377,11350,23856,8460,38026,1596,793,803
23910,49384,11351,23860,8460,38033,1596,793,803
23915,49397,11353,23868,8462,38042,1597,794,803
23920,49408,11353,23873,8462,38055,1597,794,803
23925,49415,11354,23877,8463,38061,1597,794,803
23930,49428,11356,23883,8464,38072,1598,794,804
23935,49439,11356,23888,8464,38083,1598,794,804
23940,49446,11357,23893,8465,38089,1598,794,804
23945,49459,11359,23898,8465,38100,1599,794,805
23950,49470,11359,23902,8465,38111,1599,794,805
23955,49477,11360,23904,8465,38117,1599,794,805
23960,49490,11362,23911,8467,38128,1600,794,806
23965,49501,11362,23917,8467,38139,1600,794,806
23970,49508,11363,23921,8468,38145,1600,794,806
23975,49521,11365,23928,8468,38154,1601,795,806
23980,49532,11368,23930,8470,38164,1601,795,806
23985,49539,11369,23933,8471,38170,1601,795,806
23990,49552,11373,23941,8475,38178,1602,795,807
23995,49563,11376,23946,8478,38186,1602,795,807
24000,49570,11379,23948,8479,38191,1602,795,807
24005,49583,11382,23953,8480,38200,1603,796,807
24010,49594,11385,23960,8482,38208,1603,796,807
24015,49601,11389,23965,8485,38212,1603,796,807
24020,49614,11392,23971,8487,38221,1604,797,807
24025,49625,11396,23976,8490,38228,1604,797,807
24030,49632,11400,23980,8493,38232,1604,797,807
24035,49645,11403,23984,8496,38241,1605,797,808
24040,49656,11409,23991,8501,38244,1605,797,808
24045,49663,11415,23994,8506,38247,1605,797,808
24050,49676,11421,24003,8511,38253,1606,798,808
24055,49687,11424,24008,8514,38262,1606,798,808
24060,49694,11426,24013,8516,38266,1606,798,808
24065,49707,11430,24021,8519,38274,1607,799,808
24070,49718,11432,24024,8521,38285,1607,799,808
24075,49725,11433,24028,8521,38292,1607,799,808
24080,49738,11435,24034,8522,38302,1608,799,809
24085,49749,11435,24038,8522,38314,1608,799,809
24090,49756,11436,24040,8522,38320,1608,799,809
24095,49769,11437,24045,8522,38331,1609,799,810
24100,49780,11437,24051,8522,38343,1609,799,810
24105,49787,11438,24055,8523,38349,1609,799,810
24110,49800,11440,24062,8525,38360,1610,800,810
24115,49811,11440,24067,8525,38371,1610,800,810
24120,49818,11441,24069,8525,38377,1610,800,810
24125,49831,11442,24075,8525,38389,1611,801,810
24130,49842,11442,24081,8525,38400,1611,801,810
24135,49849,11443,24083,8525,38406,1611,801,810
24140,49862,11444,24086,8526,38418,1612,801,811
24145,49873,11444,24092,8526,38429,1612,801,811
24150,49880,11445,24092,8526,38435,1612,801,811
24155,49893,11446,24100,8527,38445,1613,801,812
24160,49904,11449,24104,8530,38455,1613,801,812
24165,49911,11450,24108,8530,38461,1613,801,812
24170,49924,11452,24116,8531,38470,1614,802,812
24175,49935,11455,24121,8533,38479,1614,802,812
24180,49942,11458,24125,8535,38484,1614,802,812
24185,49955,11461,24132,8538,38492,1615,803,812
24190,49966,11468,24140,8545,38497,1615,803,812
24195,49973,11472,24142,8547,38501,1615,803,812
24200,49986,11476,24149,8551,38510,1616,803,813
24205,49997,11478,24152,8553,38518,1616,803,813
24210,50004,11482,24155,8556,38521,1616,803,813
24215,50017,11487,24162,8561,38529,1617,803,814
24220,50028,11487,24166,8561,38541,1617,803,814
24225,50035,11489,24169,8563,38546,1617,803,814
24230,50048,11490,24173,8563,38556,1618,803,815
24235,50059,11491,24177,8564,38567,1618,803,815
24240,50066,11495,24180,8568,38571,1618,803,815
24245,50079,11497,24185,8569,38580,1619,803,816
24250,50090,11500,24188,8572,38589,1619,803,816
24255,50097,11503,24191,8574,38594,1619,803,816
24260,50110,11504,24195,8574,38604,1620,804,816
24265,50121,11507,24199,8577,38613,1620,804,816
24270,50128,11510,24204,8580,38617,1620,804,816
24275,50141,11514,24212,8583,38625,1621,805,816
24280,50152,11515,24216,8584,38636,1621,805,816
24285,50159,11517,24221,8586,38641,1621,805,816
24290,50172,11520,24225,8588,38652,1622,806,816
24295,50183,11520,24229,8588,38663,1622,806,816
24300,50190,11521,24232,8588,38669,1622,806,816
24305,50203,11523,24238,8589,38680,1623,807,816
24310,50214,11523,24241,8589,38691,1623,807,816
24315,50221,11524,24245,8590,38697,1623,807,816
24320,50234,11525,24252,8591,38708,1624,808,816
24325,50245,11527,24260,8593,38718,1624,808,816
24330,50252,11528,24265,8593,38724,1624,808,816
24335,50265,11531,24273,8596,38733,1625,809,816
24340,50276,11533,24280,8597,38742,1625,809,816
24345,50283,11535,24283,8599,38748,1625,809,816
24350,50296,11536,24288,8600,38760,1626,809,817
24355,50307,11538,24293,8602,38769,1626,809,817
24360,50314,11539,24298,8603,38775,1626,809,817
24365,50327,11541,24304,8604,38785,1627,810,817
24370,50338,11543,24310,8605,38794,1627,810,817
24375,50345,11545,24312,8606,38800,1627,810,817
24380,50358,11548,24319,8608,38810,1628,811,817
24385,50369,11549,24325,8608,38820,1628,811,817
24390,50376,11550,24329,8609,38826,1628,811,817
24395,50389,11552,24334,8611,38836,1629,812,817
24400,50400,11557,24341,8616,38842,1629,812,817
24405,50407,11561,24343,8618,38845,1629,812,817
24410,50420,11566,24352,8623,38853,1630,813,817
24415,50431,11570,24357,8626,38861,1630,813,817
24420,50438,11573,24361,8628,38865,1630,813,817
24425,50451,11575,24367,8630,38875,1631,813,818
24430,50462,11575,24373,8630,38886,1631,813,818
24435,50469,11579,24378,8633,38890,1631,813,818
24440,50482,11582,24383,8635,38900,1632,813,819
24445,50493,11583,24386,8636,38910,1632,813,819
24450,50500,11586,24391,8638,38913,1632,813,819
24455,50513,11588,24396,8640,38924,1633,814,819
24460,50524,11589,24399,8641,38933,1633,814,819
24465,50531,11593,24402,8643,38937,1633,814,819
24470,50544,11596,24408,8645,38946,1634,814,820
24475,50555,11599,24411,8648,38955,1634,814,820
24480,50562,11603,24414,8651,38959,1634,814,820
24485,50575,11604,24418,8652,38971,1635,815,820
24490,50586,11604,24424,8652,38982,1635,815,820
24495,50593,11605,24427,8653,38988,1635,815,820
24500,50606,11607,24435,8655,38997,1636,815,821
24505,50617,11607,24443,8655,39010,1636,815,821
24510,50624,11608,24446,8656,39016,1636,815,821
24515,50637,11610,24450,8657,39026,1637,815,822
24520,50648,11610,24455,8657,39038,1637,815,822
24525,50655,11611,24457,8657,39044,1637,815,822
24530,50668,11614,24466,8659,39053,1638,816,822
24535,50679,11616,24470,8660,39063,1638,816,822
24540,50686,11617,24476,8661,39069,1638,816,822
24545,50699,11619,24480,8662,39079,1639,816,823
24550,50710,11621,24486,8664,39088,1639,816,823
24555,50717,11623,24490,8665,39094,1639,816,823
24560,50730,11627,24500,8669,39102,1640,816,824
24565,50741,11629,24505,8670,39111,1640,816,824
24570,50748,11632,24510,8672,39115,1640,816,824
24575,50761,11635,24513,8674,39126,1641,817,824
24580,50772,11636,24516,8674,39136,1641,817,824
24585,50779,11639,24519,8676,39140,1641,817,824
24590,50792,11643,24524,8679,39148,1642,818,824
24595,50803,11648,24531,8684,39154,1642,818,824
24600,50810,11653,24537,8688,39156,1642,818,824
24605,50823,11655,24546,8690,39168,1643,818,825
24610,50834,11656,24552,8691,39178,1643,818,825
24615,50841,11658,24554,8692,39183,1643,818,825
24620,50854,11660,24562,8694,39192,1644,818,826
24625,50865,11664,24567,8698,39200,1644,818,826
24630,50872,11668,24571,8701,39202,1644,818,826
24635,50885,11671,24578,8703,39212,1645,819,826
24640,50896,11675,24583,8707,39219,1645,819,826
24645,50903,11679,24585,8710,39224,1645,819,826
24650,50916,11680,24590,8710,39233,1646,819,827
24655,50927,11681,24594,8711,39244,1646,819,827
24660,50934,11684,24597,8713,39250,1646,819,827
24665,50947,11686,24602,8714,39260,1647,819,828
24670,50958,11686,24606,8714,39272,1647,819,828
24675,50965,11687,24609,8714,39278,1647,819,828
24680,50978,11689,24617,8716,39288,1648,820,828
24685,50989,11689,24623,8716,39300,1648,820,828
24690,50996,11690,24626,8717,39306,1648,820,828
24695,51009,11692,24633,8719,39316,1649,821,828
24700,51020,11692,24638,8719,39328,1649,821,828
24705,51027,11693,24641,8720,39334,1649,821,828
24710,51040,11695,24645,8721,39343,1650,821,829
24715,51051,11696,24652,8722,39354,1650,821,829
24720,51058,11697,24656,8723,39361,1650,821,829
24725,51071,11699,24663,8725,39370,1651,822,829
24730,51082,11701,24668,8726,39381,1651,822,829
24735,51089,11702,24673,8726,39387,1651,822,829
24740,51102,11704,24678,8727,39398,1652,822,830
24745,51113,11705,24684,8728,39408,1652,822,830
24750,51120,11706,24687,8728,39414,1652,822,830
24755,51133,11709,24691,8730,39423,1653,822,831
24760,51144,11712,24696,8733,39431,1653,822,831
24765,51151,11716,24700,8735,39435,1653,822,831
24770,51164,11718,24707,8737,39443,1654,822,832
24775,51175,11724,24717,8743,39450,1654,822,832
24780,51182,11727,24718,8744,39455,1654,822,832
24785,51195,11729,24724,8745,39464,1655,823,832
24790,51206,11732,24730,8748,39473,1655,823,832
24795,51213,11735,24734,8751,39478,1655,823,832
24800,51226,11737,24739,8752,39488,1656,824,832
24805,51237,11738,24743,8753,39498,1656,824,832
24810,51244,11741,24747,8755,39503,1656,824,832
24815,51257,11743,24751,8757,39513,1657,824,833
24820,51268,11749,24760,8763,39517,1657,824,833
24825,51275,11753,24762,8766,39521,1657,824,833
24830,51288,11756,24769,8768,39531,1658,824,834
24835,51299,11758,24774,8770,39540,1658,824,834
24840,51306,11763,24780,8774,39541,1658,824,834
24845,51319,11765,24785,8775,39553,1659,825,834
24850,51330,11767,24791,8777,39562,1659,825,834
24855,51337,11772,24795,8781,39565,1659,825,834
24860,51350,11773,24800,8782,39576,1660,826,834
24865,51361,11773,24805,8782,39587,1660,826,834
24870,51368,11774,24809,8782,39594,1660,826,834
24875,51381,11776,24815,8784,39602,1661,826,835
24880,51392,11776,24818,8784,39616,1661,826,835
24885,51399,11777,24822,8784,39622,1661,826,835
24890,51412,11778,24827,8784,39633,1662,827,835
24895,51423,11778,24834,8784,39644,1662,827,835
24900,51430,11779,24839,8785,39651,1662,827,835
24905,51443,11781,24847,8787,39661,1663,827,836
24910,51454,11781,24850,8787,39673,1663,827,836
24915,51461,11782,24853,8788,39679,1663,827,836
24920,51474,11783,24858,8788,39691,1664,828,836
24925,51485,11783,24863,8788,39702,1664,828,836
24930,51492,11784,24867,8789,39708,1664,828,836
24935,51505,11785,24871,8789,39718,1665,828,837
24940,51516,11787,24874,8790,39729,1665,828,837
24945,51523,11788,24877,8790,39735,1665,828,837
24950,51536,11789,24882,8790,39745,1666,829,837
24955,51547,11791,24887,8791,39756,1666,829,837
24960,51554,11792,24890,8792,39762,1666,829,837
24965,51567,11795,24897,8794,39769,1667,830,837
24970,51578,11799,24902,8797,39779,1667,830,837
24975,51585,11801,24904,8799,39784,1667,830,837
24980,51598,11805,24913,8801,39790,1668,831,837
24985,51609,11809,24917,8804,39800,1668,831,837
24990,51616,11811,24920,8805,39805,1668,831,837
24995,51629,11814,24924,8806,39813,1669,831,838
25000,51640,11818,24929,8810,39821,1669,831,838
25005,51647,11822,24932,8813,39825,1669,831,838
25010,51660,11825,24938,8815,39833,1670,832,838
25015,51671,11830,24943,8820,39840,1670,832,838
25020,51678,11833,24946,8822,39844,1670,832,838
25025,51691,11838,24953,8826,39853,1671,832,839
25030,51702,11839,24957,8827,39863,1671,832,839
25035,51709,11841,24960,8829,39868,1671,832,839
25040,51722,11843,24966,8830,39879,1672,832,840
25045,51733,11844,24971,8831,39889,1672,832,840
25050,51740,11846,24975,8832,39893,1672,832,840
25055,51753,11848,24982,8833,39905,1673,833,840
25060,51764,11849,24989,8834,39915,1673,833,840
25065,51771,11852,24994,8837,39917,1673,833,840
25070,51784,11855,24999,8838,39928,1674,833,841
25075,51795,11858,25006,8841,39936,1674,833,841
25080,51802,11862,25008,8843,39939,1674,833,841
25085,51815,11865,25012,8844,39949,1675,834,841
25090,51826,11868,25020,8847,39957,1675,834,841
25095,51833,11872,25025,8851,39961,1675,834,841
25100,51846,11875,25036,8854,39969,1676,834,842
25105,51857,11876,25041,8855,39981,1676,834,842
25110,51864,11877,25043,8855,39987,1676,834,842
25115,51877,11879,25048,8855,39998,1677,834,843
25120,51888,11879,25052,8855,40009,1677,834,843
25125,51895,11880,25055,8856,40015,1677,834,843
25130,51908,11882,25060,8857,40023,1678,834,844
25135,51919,11885,25066,8859,40033,1678,834,844
25140,51926,11886,25069,8860,40040,1678,834,844
25145,51939,11888,25074,8861,40049,1679,834,845
25150,51950,11890,25079,8862,40060,1679,834,845
25155,51957,11891,25084,8862,40066,1679,834,845
25160,51970,11894,25090,8864,40075,1680,835,845
25165,51981,11896,25097,8866,40085,1680,835,845
25170,51988,11897,25099,8866,40091,1680,835,845
25175,52001,11900,25105,8868,40100,1681,836,845
25180,52012,11901,25109,8868,40111,1681,836,845
25185,52019,11902,25112,8868,40117,1681,836,845
25190,52032,11905,25119,8870,40126,1682,836,846
25195,52043,11908,25127,8873,40134,1682,836,846
25200,52050,11910,25131,8875,40140,1682,836,846
25205,52063,11912,25137,8877,40150,1683,837,846
25210,52074,11916,25144,8880,40157,1683,837,846
25215,52081,11920,25150,8884,40161,1683,837,846
25220,52094,11923,25154,8886,40170,1684,837,847
25225,52105,11924,25156,8886,40181,1684,837,847
25230,52112,11926,25158,8887,40186,1684,837,847
25235,52125,11929,25161,8888,40196,1685,837,848
25240,52136,11930,25165,8888,40205,1685,837,848
25245,52143,11934,25169,8891,40209,1685,837,848
25250,52156,11937,25174,8892,40219,1686,837,849
25255,52167,11939,25179,8894,40228,1686,837,849
25260,52174,11942,25183,8897,40232,1686,837,849
25265,52187,11947,25189,8901,40239,1687,838,849
25270,52198,11952,25194,8905,40245,1687,838,849
25275,52205,11956,25197,8907,40248,1687,838,849
25280,52218,11959,25203,8909,40258,1688,839,849
25285,52229,11962,25211,8912,40265,1688,839,849
25290,52236,11967,25217,8917,40268,1688,839,849
25295,52249,11970,25221,8920,40278,1689,840,849
25300,52260,11973,25227,8923,40285,1689,840,849
25305,52267,11976,25232,8926,40291,1689,840,849
25310,52280,11978,25240,8927,40299,1690,841,849
25315,52291,11978,25246,8927,40313,1690,841,849
25320,52298,11979,25251,8928,40319,1690,841,849
25325,52311,11981,25261,8930,40329,1691,842,849
25330,52322,11981,25264,8930,40340,1691,842,849
25335,52329,11982,25267,8930,40347,1691,842,849
25340,52342,11984,25271,8930,40357,1692,842,850
25345,52353,11984,25277,8930,40369,1692,842,850
25350,52360,11985,25280,8930,40375,1692,842,850
25355,52373,11987,25286,8932,40386,1693,842,851
25360,52384,11987,25289,8932,40397,1693,842,851
25365,52391,11988,25294,8933,40403,1693,842,851
25370,52404,11990,25300,8935,40414,1694,842,852
25375,52415,11991,25306,8935,40424,1694,842,852
25380,52422,11992,25308,8935,40430,1694,842,852
25385,52435,11994,25313,8937,40440,1695,843,852
25390,52446,11995,25315,8938,40451,1695,843,852
25395,52453,11996,25318,8938,40457,1695,843,852
25400,52466,11998,25325,8939,40467,1696,844,852
25405,52477,11999,25331,8940,40478,1696,844,852
25410,52484,12000,25334,8940,40484,1696,844,852
25415,52497,12003,25341,8941,40493,1697,845,852
25420,52508,12006,25346,8944,40502,1697,845,852
25425,52515,12008,25348,8945,40507,1697,845,852
25430,52528,12012,25355,8947,40513,1698,845,853
25435,52539,12015,25358,8950,40524,1698,845,853
25440,52546,12018,25360,8951,40528,1698,845,853
25445,52559,12022,25365,8954,40536,1699,845,854
25450,52570,12024,25370,8955,40543,1699,845,854
25455,52577,12030,25373,8960,40547,1699,845,854
25460,52590,12033,25379,8961,40553,1700,846,854
25465,52601,12039,25384,8966,40559,1700,846,854
25470,52608,12045,25388,8971,40561,1700,846,854
25475,52621,12052,25394,8977,40568,1701,847,854
25480,52632,12053,25401,8978,40577,1701,847,854
25485,52639,12057,25403,8980,40582,1701,847,854
25490,52652,12059,25406,8980,40592,1702,847,855
25495,52663,12059,25410,8980,40601,1702,847,855
25500,52670,12063,25413,8984,40607,1702,847,855
25505,52683,12066,25419,8985,40616,1703,848,855
25510,52694,12068,25424,8987,40624,1703,848,855
25515,52701,12072,25427,8990,40628,1703,848,855
25520,52714,12075,25430,8992,40639,1704,848,856
25525,52725,12075,25434,8992,40650,1704,848,856
25530,52732,12076,25436,8992,40656,1704,848,856
25535,52745,12078,25442,8992,40667,1705,848,857
25540,52756,12078,25450,8992,40678,1705,848,857
25545,52763,12079,25454,8992,40684,1705,848,857
25550,52776,12081,25461,8993,40695,1706,848,858
25555,52787,12081,25464,8993,40706,1706,848,858
25560,52794,12082,25469,8994,40712,1706,848,858
25565,52807,12084,25476,8995,40723,1707,849,858
25570,52818,12084,25482,8995,40734,1707,849,858
25575,52825,12085,25483,8995,40740,1707,849,858
25580,52838,12087,25491,8996,40751,1708,850,858
25585,52849,12088,25498,8997,40761,1708,850,858
25590,52856,12089,25501,8998,40767,1708,850,858
25595,52869,12091,25506,8998,40777,1709,851,858
25600,52880,12093,25512,9000,40787,1709,851,858
25605,52887,12094,25516,9000,40793,1709,851,858
25610,52900,12098,25524,9003,40801,1710,852,858
25615,52911,12100,25530,9004,40810,1710,852,858
25620,52918,12102,25532,9006,40816,1710,852,858
25625,52931,12105,25538,9008,40824,1711,852,859
25630,52942,12108,25543,9010,40833,1711,852,859
25635,52949,12112,25545,9012,40837,1711,852,859
25640,52962,12115,25551,9014,40845,1712,852,860
25645,52973,12118,25554,9017,40854,1712,852,860
25650,52980,12123,25558,9020,40856,1712,852,860
25655,52993,12126,25565,9022,40864,1713,853,860
25660,53004,12132,25573,9028,40869,1713,853,860
25665,53011,12138,25575,9033,40873,1713,853,860
25670,53024,12142,25581,9035,40879,1714,854,860
25675,53035,12150,25589,9043,40882,1714,854,860
25680,53042,12157,25595,9050,40884,1714,854,860
25685,53055,12159,25602,9051,40895,1715,855,860
25690,53066,12159,25607,9051,40907,1715,855,860
25695,53073,12160,25610,9051,40912,1715,855,860
25700,53086,12162,25615,9052,40922,1716,856,860
25705,53097,12162,25622,9052,40935,1716,856,860
25710,53104,12163,25625,9053,40941,1716,856,860
25715,53117,12165,25632,9054,40951,1717,857,860
25720,53128,12165,25636,9054,40963,1717,857,860
25725,53135,12166,25638,9054,40969,1717,857,860
25730,53148,12168,25643,9054,40978,1718,857,861
25735,53159,12168,25648,9054,40990,1718,857,861
25740,53166,12169,25651,9055,40997,1718,857,861
25745,53179,12171,25656,9056,41007,1719,858,861
25750,53190,12171,25658,9056,41019,1719,858,861
25755,53197,12172,25662,9057,41025,1719,858,861
25760,53210,12174,25669,9059,41035,1720,859,861
25765,53221,12174,25678,9059,41047,1720,859,861
25770,53228,12175,25683,9060,41053,1720,859,861
25775,53241,12177,25689,9060,41064,1721,860,861
25780,53252,12177,25694,9060,41075,1721,860,861
25785,53259,12178,25698,9060,41081,1721,860,861
25790,53272,12180,25705,9062,41090,1722,860,862
25795,53283,12182,25709,9063,41101,1722,860,862
25800,53290,12184,25712,9065,41106,1722,860,862
25805,53303,12186,25717,9065,41115,1723,860,863
25810,53314,12190,25725,9068,41124,1723,860,863
25815,53321,12192,25728,9069,41129,1723,860,863
25820,53334,12195,25737,9071,41136,1724,861,863
25825,53345,12199,25743,9074,41145,1724,861,863
25830,53352,12202,25747,9076,41150,1724,861,863
25835,53365,12204,25753,9078,41159,1725,861,864
25840,53376,12208,25758,9081,41168,1725,861,864
25845,53383,12211,25760,9083,41172,1725,861,864
25850,53396,12213,25763,9084,41182,1726,861,865
25855,53407,12217,25767,9087,41190,1726,861,865
25860,53414,12219,25771,9089,41195,1726,861,865
25865,53427,12221,25773,9090,41206,1727,861,866
25870,53438,12224,25777,9092,41213,1727,861,866
25875,53445,12228,25782,9096,41217,1727,861,866
25880,53458,12232,25788,9100,41224,1728,861,867
25885,53469,12238,25795,9106,41228,1728,861,867
25890,53476,12244,25797,9111,41232,1728,861,867
25895,53489,12247,25806,9113,41239,1729,861,868
25900,53500,12250,25815,9116,41247,1729,861,868
25905,53507,12254,25817,9118,41251,1729,861,868
25910,53520,12257,25824,9120,41263,1730,862,868
25915,53531,12259,25828,9122,41272,1730,862,868
25920,53538,12263,25832,9125,41274,1730,862,868
25925,53551,12266,25839,9127,41284,1731,863,868
25930,53562,12266,25846,9127,41296,1731,863,868
25935,53569,12267,25850,9127,41302,1731,863,868
25940,53582,12269,25856,9128,41313,1732,863,869
25945,53593,12269,25859,9128,41324,1732,863,869
25950,53600,12270,25861,9129,41330,1732,863,869
25955,53613,12272,25867,9130,41341,1733,864,869
25960,53624,12272,25869,9130,41352,1733,864,869
25965,53631,12273,25871,9130,41358,1733,864,869
25970,53644,12275,25881,9131,41368,1734,865,869
25975,53655,12275,25890,9131,41380,1734,865,869
25980,53662,12276,25890,9131,41386,1734,865,869
25985,53675,12278,25898,9132,41397,1735,865,870
25990,53686,12278,25903,9132,41408,1735,865,870
25995,53693,12279,25909,9133,41414,1735,865,870
26000,53706,12282,25915,9134,41423,1736,865,871
26005,53717,12284,25922,9135,41433,1736,865,871
26010,53724,12285,25926,9136,41439,1736,865,871
26015,53737,12289,25934,9140,41446,1737,865,872
26020,53748,12295,25941,9146,41453,1737,865,872
26025,53755,12297,25946,9148,41458,1737,865,872
26030,53768,12300,25953,9151,41467,1738,866,872
26035,53779,12303,25960,9153,41474,1738,866,872
26040,53786,12307,25964,9157,41479,1738,866,872
26045,53799,12309,25967,9157,41489,1739,866,873
26050,53810,12313,25975,9161,41497,1739,866,873
26055,53817,12315,25978,9161,41502,1739,866,873
26060,53830,12318,25984,9163,41511,1740,866,874
26065,53841,12319,25986,9164,41522,1740,866,874
26070,53848,12321,25990,9164,41527,1740,866,874
26075,53861,12323,25997,9164,41537,1741,866,875
26080,53872,12323,26003,9164,41549,1741,866,875
26085,53879,12325,26006,9166,41554,1741,866,875
26090,53892,12328,26014,9168,41562,1742,867,875
26095,53903,12329,26017,9169,41573,1742,867,875
26100,53910,12332,26019,9170,41578,1742,867,875
26105,53923,12334,26024,9172,41587,1743,867,876
26110,53934,12335,26028,9173,41599,1743,867,876
26115,53941,12338,26030,9174,41603,1743,867,876
26120,53954,12340,26037,9175,41611,1744,867,877
26125,53965,12343,26041,9178,41622,1744,867,877
26130,53972,12345,26042,9178,41627,1744,867,877
26135,53985,12347,26047,9179,41635,1745,868,877
26140,53996,12350,26052,9182,41645,1745,868,877
26145,54003,12353,26056,9185,41650,1745,868,877
26150,54016,12356,26061,9187,41658,1746,868,878
26155,54027,12358,26066,9189,41667,1746,868,878
26160,54034,12361,26067,9190,41672,1746,868,878
26165,54047,12364,26073,9192,41680,1747,868,879
26170,54058,12371,26079,9199,41685,1747,868,879
26175,54065,12377,26083,9203,41688,1747,868,879
26180,54078,12381,26091,9205,41693,1748,869,879
26185,54089,12384,26098,9207,41705,1748,869,879
26190,54096,12385,26101,9207,41711,1748,869,879
26195,54109,12387,26107,9207,41720,1749,869,880
26200,54120,12389,26113,9208,41731,1749,869,880
26205,54127,12390,26117,9208,41737,1749,869,880
26210,54140,12392,26121,9208,41746,1750,870,880
26215,54151,12394,26126,9209,41756,1750,870,880
26220,54158,12395,26130,9209,41763,1750,870,880
26225,54171,12398,26138,9210,41770,1751,871,880
26230,54182,12401,26141,9213,41781,1751,871,880
26235,54189,12402,26143,9213,41787,1751,871,880
26240,54202,12405,26152,9215,41795,1752,872,880
26245,54213,12407,26158,9216,41806,1752,872,880
26250,54220,12408,26162,9217,41812,1752,872,880
26255,54233,12410,26167,9218,41822,1753,872,881
26260,54244,12412,26169,9219,41832,1753,872,881
26265,54251,12413,26174,9220,41838,1753,872,881
26270,54264,12415,26179,9220,41847,1754,873,881
26275,54275,12418,26184,9223,41857,1754,873,881
26280,54282,12419,26189,9224,41863,1754,873,881
26285,54295,12421,26193,9224,41873,1755,873,882
26290,54306,12425,26198,9227,41881,1755,873,882
26295,54313,12427,26201,9228,41886,1755,873,882
26300,54326,12430,26206,9229,41893,1756,873,883
26305,54337,12435,26210,9233,41900,1756,873,883
26310,54344,12441,26214,9238,41903,1756,873,883
26315,54357,12446,26223,9242,41909,1757,874,883
26320,54368,12449,26224,9244,41919,1757,874,883
26325,54375,12452,26228,9246,41921,1757,874,883
26330,54388,12459,26233,9252,41928,1758,874,884
26335,54399,12461,26237,9254,41936,1758,874,884
26340,54406,12465,26242,9258,41939,1758,874,884
26345,54419,12468,26245,9260,41949,1759,874,885
26350,54430,12468,26247,9260,41962,1759,874,885
26355,54437,12469,26250,9260,41968,1759,874,885
26360,54450,12471,26259,9262,41978,1760,875,885
26365,54461,12471,26264,9262,41990,1760,875,885
26370,54468,12472,26270,9263,41996,1760,875,885
26375,54481,12474,26278,9264,42007,1761,876,885
26380,54492,12474,26281,9264,42018,1761,876,885
26385,54499,12475,26284,9264,42023,1761,876,885
26390,54512,12477,26289,9265,42035,1762,876,886
26395,54523,12477,26297,9265,42046,1762,876,886
26400,54530,12478,26301,9265,42051,1762,876,886
26405,54543,12480,26304,9266,42063,1763,876,887
26410,54554,12480,26307,9266,42074,1763,876,887
26415,54561,12481,26310,9267,42080,1763,876,887
26420,54574,12483,26315,9268,42091,1764,877,887
26425,54585,12483,26320,9268,42102,1764,877,887
26430,54592,12484,26326,9269,42107,1764,877,887
26435,54605,12486,26330,9269,42119,1765,877,888
26440,54616,12486,26334,9269,42130,1765,877,888
26445,54623,12488,26337,9271,42135,1765,877,888
26450,54636,12491,26342,9273,42145,1766,878,888
26455,54647,12497,26347,9278,42150,1766,878,888
26460,54654,12499,26350,9278,42155,1766,878,888
26465,54667,12502,26357,9280,42163,1767,879,888
26470,54678,12505,26364,9283,42172,1767,879,888
26475,54685,12507,26368,9284,42178,1767,879,888
26480,54698,12510,26375,9287,42186,1768,879,889
26485,54709,12514,26380,9290,42193,1768,879,889
26490,54716,12518,26382,9293,42198,1768,879,889
26495,54729,12521,26388,9295,42206,1769,880,889
26500,54740,12526,26392,9299,42213,1769,880,889
26505,54747,12531,26395,9302,42215,1769,880,889
26510,54760,12536,26403,9306,42220,1770,880,890
26515,54771,12541,26406,9310,42229,1770,880,890
26520,54778,12543,26409,9312,42235,1770,880,890
26525,54791,12545,26415,9312,42242,1771,880,891
26530,54802,12548,26416,9314,42254,1771,880,891
26535,54809,12549,26419,9315,42260,1771,880,891
26540,54822,12551,26426,9315,42268,1772,881,891
26545,54833,12554,26431,9318,42279,1772,881,891
26550,54840,12555,26434,9318,42285,1772,881,891
26555,54853,12557,26441,9319,42294,1773,881,892
26560,54864,12560,26447,9322,42303,1773,881,892
26565,54871,12562,26451,9323,42309,1773,881,892
26570,54884,12565,26459,9325,42317,1774,882,892
26575,54895,12569,26466,9329,42325,1774,882,892
26580,54902,12571,26469,9330,42330,1774,882,892
26585,54915,12574,26477,9333,42340,1775,882,893
26590,54926,12574,26479,9333,42352,1775,882,893
26595,54933,12575,26482,9333,42357,1775,882,893
26600,54946,12577,26485,9333,42368,1776,882,894
26605,54957,12577,26493,9333,42380,1776,882,894
26610,54964,12578,26499,9334,42385,1776,882,894
26615,54977,12580,26509,9336,42397,1777,882,895
26620,54988,12580,26512,9336,42408,1777,882,895
26625,54995,12583,26517,9338,42412,1777,882,895
26630,55008,12585,26524,9339,42423,1778,882,896
26635,55019,12586,26531,9340,42433,1778,882,896
26640,55026,12589,26533,9341,42437,1778,882,896
26645,55039,12591,26541,9342,42448,1779,883,896
26650,55050,12593,26547,9344,42457,1779,883,896
26655,55057,12596,26550,9346,42461,1779,883,896
26660,55070,12598,26558,9347,42470,1780,884,896
26665,55081,12599,26564,9348,42480,1780,884,896
26670,55088,12604,26568,9353,42484,1780,884,896
26675,55101,12606,26575,9355,42493,1781,884,897
26680,55112,12608,26580,9357,42503,1781,884,897
26685,55119,12612,26584,9361,42507,1781,884,897
26690,55132,12615,26587,9362,42515,1782,884,898
26695,55143,12619,26593,9366,42522,1782,884,898
26700,55150,12624,26596,9369,42526,1782,884,898
26705,55163,12627,26602,9372,42535,1783,885,898
26710,55174,12628,26605,9372,42546,1783,885,898
26715,55181,12629,26607,9372,42552,1783,885,898
26720,55194,12631,26614,9373,42560,1784,885,899
26725,55205,12633,26619,9375,42572,1784,885,899
26730,55212,12634,26621,9376,42578,1784,885,899
26735,55225,12637,26628,9378,42586,1785,885,900
26740,55236,12639,26631,9379,42596,1785,885,900
26745,55243,12641,26632,9380,42602,1785,885,900
26750,55256,12644,26637,9382,42610,1786,885,901
26755,55267,12646,26640,9384,42621,1786,885,901
26760,55274,12647,26645,9384,42627,1786,885,901
26765,55287,12650,26655,9387,42635,1787,886,901
26770,55298,12654,26664,9391,42643,1787,886,901
26775,55305,12656,26665,9392,42648,1787,886,901
26780,55318,12662,26672,9397,42655,1788,887,901
26785,55329,12664,26676,9398,42665,1788,887,901
26790,55336,12665,26678,9398,42671,1788,887,901
26795,55349,12670,26685,9402,42678,1789,887,902
26800,55360,12671,26689,9403,42689,1789,887,902
26805,55367,12672,26691,9403,42694,1789,887,902
26810,55380,12674,26697,9403,42705,1790,887,903
26815,55391,12675,26701,9404,42715,1790,887,903
26820,55398,12678,26704,9406,42720,1790,887,903
26825,55411,12680,26710,9408,42731,1791,887,904
26830,55422,12681,26716,9409,42741,1791,887,904
26835,55429,12683,26721,9411,42745,1791,887,904
26840,55442,12685,26730,9413,42755,1792,887,905
26845,55453,12685,26735,9413,42767,1792,887,905
26850,55460,12688,26738,9415,42772,1792,887,905
26855,55473,12690,26744,9415,42783,1793,888,905
26860,55484,12691,26749,9416,42793,1793,888,905
26865,55491,12693,26754,9417,42798,1793,888,905
26870,55504,12696,26761,9420,42807,1794,889,905
26875,55515,12699,26765,9423,42816,1794,889,905
26880,55522,12702,26767,9425,42820,1794,889,905
26885,55535,12705,26773,9426,42829,1795,889,906
26890,55546,12709,26779,9430,42836,1795,889,906
26895,55553,12713,26781,9433,42840,1795,889,906
26900,55566,12716,26788,9435,42848,1796,889,907
26905,55577,12719,26792,9437,42858,1796,889,907
26910,55584,12720,26795,9438,42864,1796,889,907
26915,55597,12722,26800,9438,42874,1797,890,907
26920,55608,12724,26808,9440,42884,1797,890,907
26925,55615,12725,26811,9440,42890,1797,890,907
26930,55628,12728,26818,9441,42899,1798,891,907
26935,55639,12730,26820,9442,42909,1798,891,907
26940,55646,12731,26824,9442,42915,1798,891,907
26945,55659,12733,26831,9443,42925,1799,892,907
26950,55670,12735,26835,9444,42935,1799,892,907
26955,55677,12736,26837,9444,42941,1799,892,907
26960,55690,12738,26842,9444,42951,1800,893,907
26965,55701,12739,26845,9444,42961,1800,893,907
26970,55708,12741,26847,9445,42967,1800,893,907
26975,55721,12745,26854,9448,42974,1801,893,908
26980,55732,12749,26856,9451,42982,1801,893,908
26985,55739,12752,26859,9454,42987,1801,893,908
26990,55752,12756,26865,9458,42995,1802,893,909
26995,55763,12759,26873,9461,43002,1802,893,909
27000,55770,12762,26876,9464,43007,1802,893,909
27005,55783,12767,26883,9468,43016,1803,894,909
27010,55794,12768,26888,9469,43025,1803,894,909
27015,55801,12770,26892,9471,43031,1803,894,909
27020,55814,12772,26898,9472,43041,1804,894,910
27025,55825,12773,26904,9473,43051,1804,894,910
27030,55832,12776,26907,9475,43056,1804,894,910
27035,55845,12778,26913,9476,43067,1805,895,910
27040,55856,12779,26916,9477,43077,1805,895,910
27045,55863,12782,26921,9479,43081,1805,895,910
27050,55876,12784,26927,9480,43089,1806,895,911
27055,55887,12788,26933,9484,43098,1806,895,911
27060,55894,12791,26937,9486,43102,1806,895,911
27065,55907,12795,26946,9488,43109,1807,896,911
27070,55918,12797,26950,9490,43119,1807,896,911
27075,55925,12801,26951,9492,43124,1807,896,911
27080,55938,12803,26955,9493,43134,1808,896,912
27085,55949,12804,26960,9494,43144,1808,896,912
27090,55956,12809,26964,9498,43147,1808,896,912
27095,55969,12811,26970,9499,43157,1809,896,913
27100,55980,12811,26972,9499,43169,1809,896,913
27105,55987,12812,26976,9500,43175,1809,896,913
27110,56000,12814,26982,9501,43184,1810,896,914
27115,56011,12814,26986,9501,43197,1810,896,914
27120,56018,12815,26989,9502,43203,1810,896,914
27125,56031,12817,26992,9502,43213,1811,897,914
27130,56042,12818,26996,9503,43224,1811,897,914
27135,56049,12819,26998,9503,43230,1811,897,914
27140,56062,12822,27003,9506,43240,1812,898,914
27145,56073,12824,27008,9507,43249,1812,898,914
27150,56080,12825,27010,9508,43255,1812,898,914
27155,56093,12829,27017,9511,43263,1813,898,915
27160,56104,12831,27023,9512,43272,1813,898,915
27165,56111,12833,27027,9513,43278,1813,898,915
27170,56124,12837,27034,9516,43285,1814,898,916
27175,56135,12840,27037,9518,43294,1814,898,916
27180,56142,12842,27038,9519,43299,1814,898,916
27185,56155,12845,27042,9520,43308,1815,898,917
27190,56166,12849,27047,9523,43316,1815,898,917
27195,56173,12852,27051,9525,43320,1815,898,917
27200,56186,12856,27057,9529,43330,1816,899,917
27205,56197,12858,27065,9531,43339,1816,899,917
27210,56204,12861,27070,9533,43342,1816,899,917
27215,56217,12863,27076,9534,43354,1817,899,918
27220,56228,12864,27080,9535,43364,1817,899,918
27225,56235,12866,27083,9537,43369,1817,899,918
27230,56248,12868,27090,9538,43380,1818,899,919
27235,56259,12870,27098,9540,43389,1818,899,919
27240,56266,12872,27102,9541,43394,1818,899,919
27245,56279,12874,27108,9542,43405,1819,899,920
27250,56290,12875,27113,9543,43415,1819,899,920
27255,56297,12877,27115,9543,43420,1819,899,920
27260,56310,12879,27119,9544,43431,1820,899,921
27265,56321,12880,27124,9545,43441,1820,899,921
27270,56328,12883,27128,9547,43445,1820,899,921
27275,56341,12886,27134,9549,43454,1821,899,922
27280,56352,12887,27140,9550,43463,1821,899,922
27285,56359,12892,27144,9554,43467,1821,899,922
27290,56372,12894,27148,9554,43478,1822,899,923
27295,56383,12894,27153,9554,43489,1822,899,923
27300,56390,12897,27158,9557,43492,1822,899,923
27305,56403,12900,27165,9560,43501,1823,900,923
27310,56414,12904,27169,9563,43509,1823,900,923
27315,56421,12908,27172,9566,43513,1823,900,923
27320,56434,12911,27182,9568,43519,1824,900,924
27325,56445,12914,27189,9570,43531,1824,900,924
27330,56452,12915,27193,9570,43537,1824,900,924
27335,56465,12918,27202,9573,43544,1825,901,924
27340,56476,12921,27207,9576,43555,1825,901,924
27345,56483,12922,27210,9576,43561,1825,901,924
27350,56496,12924,27214,9577,43572,1826,902,924
27355,56507,12925,27220,9577,43581,1826,902,924
27360,56514,12927,27224,9578,43587,1826,902,924
27365,56527,12931,27233,9582,43595,1827,903,924
27370,56538,12932,27239,9583,43606,1827,903,924
27375,56545,12933,27243,9584,43612,1827,903,924
27380,56558,12936,27248,9586,43620,1828,903,925
27385,56569,12938,27252,9587,43630,1828,903,925
27390,56576,12940,27256,9588,43635,1828,903,925
27395,56589,12944,27263,9592,43643,1829,904,925
27400,56600,12949,27269,9597,43650,1829,904,925
27405,56607,12952,27275,9600,43654,1829,904,925
27410,56620,12957,27280,9603,43660,1830,904,926
27415,56631,12958,27286,9604,43672,1830,904,926
27420,56638,12959,27291,9605,43678,1830,904,926
27425,56651,12961,27295,9606,43689,1831,904,927
27430,56662,12961,27299,9606,43701,1831,904,927
27435,56669,12964,27305,9609,43705,1831,904,927
27440,56682,12967,27316,9612,43713,1832,905,927
27445,56693,12969,27321,9614,43722,1832,905,927
27450,56700,12974,27325,9618,43725,1832,905,927
27455,56713,12978,27331,9620,43734,1833,906,927
27460,56724,12978,27334,9620,43746,1833,906,927
27465,56731,12981,27337,9621,43750,1833,906,927
27470,56744,12983,27343,9621,43758,1834,906,928
27475,56755,12987,27349,9625,43766,1834,906,928
27480,56762,12991,27352,9628,43770,1834,906,928
27485,56775,12994,27359,9631,43780,1835,906,929
27490,56786,12994,27363,9631,43792,1835,906,929
27495,56793,12995,27369,9631,43798,1835,906,929
27500,56806,12997,27374,9632,43809,1836,907,929
27505,56817,12997,27379,9632,43820,1836,907,929
27510,56824,12998,27382,9632,43826,1836,907,929
27515,56837,13000,27388,9633,43837,1837,908,929
27520,56848,13000,27394,9633,43848,1837,908,929
27525,56855,13001,27396,9633,43854,1837,908,929
27530,56868,13003,27404,9634,43864,1838,909,929
27535,56879,13005,27409,9636,43873,1838,909,929
27540,56886,13007,27412,9638,43879,1838,909,929
27545,56899,13009,27416,9639,43890,1839,909,930
27550,56910,13011,27422,9640,43898,1839,909,930
27555,56917,13014,27425,9642,43903,1839,909,930
27560,56930,13017,27430,9643,43912,1840,909,931
27565,56941,13019,27432,9645,43921,1840,909,931
27570,56948,13021,27436,9647,43926,1840,909,931
27575,56961,13025,27441,9650,43935,1841,910,931
27580,56972,13028,27448,9653,43943,1841,910,931
27585,56979,13031,27450,9655,43948,1841,910,931
27590,56992,13034,27453,9656,43957,1842,910,932
27595,57003,13038,27458,9659,43963,1842,910,932
27600,57010,13042,27459,9662,43968,1842,910,932
27605,57023,13045,27464,9664,43978,1843,911,932
27610,57034,13046,27468,9665,43987,1843,911,932
27615,57041,13050,27472,9669,43990,1843,911,932
27620,57054,13053,27480,9671,43998,1844,912,932
27625,57065,13055,27484,9673,44008,1844,912,932
27630,57072,13060,27487,9676,44012,1844,912,932
27635,57085,13063,27492,9677,44020,1845,913,932
27640,57096,13063,27498,9677,44031,1845,913,932
27645,57103,13067,27501,9679,44036,1845,913,932
27650,57116,13069,27508,9679,44044,1846,913,933
27655,57127,13071,27513,9681,44053,1846,913,933
27660,57134,13075,27517,9684,44058,1846,913,933
27665,57147,13078,27522,9685,44066,1847,913,934
27670,57158,13078,27526,9685,44079,1847,913,934
27675,57165,13079,27530,9685,44086,1847,913,934
27680,57178,13081,27533,9686,44097,1848,913,935
27685,57189,13081,27536,9686,44108,1848,913,935
27690,57196,13082,27540,9686,44114,1848,913,935
27695,57209,13084,27545,9687,44124,1849,913,936
27700,57220,13084,27550,9687,44136,1849,913,936
27705,57227,13085,27554,9688,44142,1849,913,936
27710,57240,13087,27562,9689,44150,1850,914,936
27715,57251,13090,27570,9692,44161,1850,914,936
27720,57258,13091,27571,9692,44167,1850,914,936
27725,57271,13094,27576,9694,44176,1851,915,936
27730,57282,13095,27581,9694,44187,1851,915,936
27735,57289,13096,27586,9695,44193,1851,915,936
27740,57302,13100,27595,9699,44200,1852,916,936
27745,57313,13102,27599,9701,44211,1852,916,936
27750,57320,13103,27601,9701,44217,1852,916,936
27755,57333,13106,27606,9703,44226,1853,916,937
27760,57344,13107,27609,9703,44237,1853,916,937
27765,57351,13108,27614,9703,44243,1853,916,937
27770,57364,13111,27620,9704,44252,1854,917,937
27775,57375,13115,27626,9707,44260,1854,917,937
27780,57382,13118,27629,9709,44263,1854,917,937
27785,57395,13123,27636,9713,44272,1855,917,938
27790,57406,13126,27641,9715,44279,1855,917,938
27795,57413,13131,27644,9719,44282,1855,917,938
27800,57426,13136,27652,9723,44289,1856,918,938
27805,57437,13139,27656,9725,44297,1856,918,938
27810,57444,13143,27657,9727,44301,1856,918,938
27815,57457,13146,27665,9729,44310,1857,919,938
27820,57468,13150,27672,9733,44317,1857,919,938
27825,57475,13154,27678,9737,44319,1857,919,938
27830,57488,13158,27684,9739,44328,1858,919,939
27835,57499,13160,27686,9741,44339,1858,919,939
27840,57506,13163,27691,9743,44342,1858,919,939
27845,57519,13165,27694,9744,44353,1859,919,940
27850,57530,13165,27696,9744,44365,1859,919,940
27855,57537,13166,27700,9744,44370,1859,919,940
27860,57550,13168,27704,9744,44381,1860,920,940
27865,57561,13168,27709,9744,44392,1860,920,940
27870,57568,13169,27712,9744,44399,1860,920,940
27875,57581,13171,27721,9744,44409,1861,921,940
27880,57592,13171,27725,9744,44421,1861,921,940
27885,57599,13172,27729,9744,44427,1861,921,940
27890,57612,13174,27736,9745,44438,1862,921,941
27895,57623,13174,27739,9745,44449,1862,921,941
27900,57630,13175,27741,9746,44455,1862,921,941
27905,57643,13177,27744,9746,44465,1863,921,942
27910,57654,13178,27748,9746,44476,1863,921,942
27915,57661,13179,27750,9747,44482,1863,921,942
27920,57674,13181,27756,9748,44491,1864,922,942
27925,57685,13184,27763,9751,44501,1864,922,942
27930,57692,13185,27767,9752,44507,1864,922,942
27935,57705,13188,27774,9754,44516,1865,922,943
27940,57716,13190,27780,9755,44526,1865,922,943
27945,57723,13191,27783,9756,44532,1865,922,943
27950,57736,13194,27790,9759,44540,1866,923,943
27955,57747,13198,27795,9762,44549,1866,923,943
27960,57754,13200,27797,9763,44554,1866,923,943
27965,57767,13203,27801,9765,44564,1867,923,944
27970,57778,13205,27806,9767,44572,1867,923,944
27975,57785,13209,27810,9769,44576,1867,923,944
27980,57798,13213,27817,9771,44582,1868,924,944
27985,57809,13220,27822,9777,44587,1868,924,944
27990,57816,13227,27826,9782,44588,1868,924,944
27995,57829,13232,27833,9786,44593,1869,924,945
28000,57840,13238,27836,9792,44601,1869,924,945
28005,57847,13242,27840,9795,44604,1869,924,945
28010,57860,13245,27846,9797,44613,1870,924,946
28015,57871,13248,27852,9800,44620,1870,924,946
28020,57878,13251,27856,9803,44627,1870,924,946
28025,57891,13253,27863,9804,44637,1871,925,946
28030,57902,13253,27867,9804,44649,1871,925,946
28035,57909,13254,27870,9804,44655,1871,925,946
28040,57922,13256,27877,9806,44665,1872,925,947
28045,57933,13256,27881,9806,44677,1872,925,947
28050,57940,13257,27886,9807,44683,1872,925,947
28055,57953,13259,27890,9807,44693,1873,925,948
28060,57964,13259,27894,9807,44704,1873,925,948
28065,57971,13260,27898,9807,44711,1873,925,948
28070,57984,13262,27902,9808,44722,1874,925,949
28075,57995,13262,27909,9808,44733,1874,925,949
28080,58002,13263,27914,9809,44739,1874,925,949
28085,58015,13265,27921,9810,44750,1875,926,949
28090,58026,13265,27930,9810,44761,1875,926,949
28095,58033,13266,27935,9811,44767,1875,926,949
28100,58046,13267,27939,9812,44779,1876,926,950
28105,58057,13267,27945,9812,44790,1876,926,950
28110,58064,13268,27951,9813,44796,1876,926,950
28115,58077,13270,27958,9814,44805,1877,926,951
28120,58088,13272,27964,9816,44816,1877,926,951
28125,58095,13274,27966,9816,44821,1877,926,951
28130,58108,13276,27970,9817,44831,1878,926,952
28135,58119,13280,27977,9820,44838,1878,926,952
28140,58126,13284,27980,9823,44842,1878,926,952
28145,58139,13286,27984,9824,44851,1879,927,952
28150,58150,13288,27988,9825,44859,1879,927,952
28155,58157,13295,27991,9831,44862,1879,927,952
28160,58170,13298,27997,9833,44869,1880,928,952
28165,58181,13303,28002,9837,44875,1880,928,952
28170,58188,13309,28006,9843,44878,1880,928,952
28175,58201,13315,28014,9848,44883,1881,929,952
28180,58212,13321,28019,9854,44890,1881,929,952
28185,58219,13324,28025,9857,44894,1881,929,952
28190,58232,13328,28031,9860,44903,1882,929,953
28195,58243,13328,28035,9860,44915,1882,929,953
28200,58250,13329,28039,9861,44920,1882,929,953
28205,58263,13331,28048,9863,44931,1883,930,953
28210,58274,13331,28053,9863,44942,1883,930,953
28215,58281,13332,28058,9863,44949,1883,930,953
28220,58294,13333,28069,9864,44960,1884,931,953
28225,58305,13333,28073,9864,44972,1884,931,953
28230,58312,13334,28076,9864,44978,1884,931,953
28235,58325,13335,28081,9865,44990,1885,931,954
28240,58336,13335,28088,9865,45001,1885,931,954
28245,58343,13336,28092,9866,45007,1885,931,954
28250,58356,13337,28102,9867,45019,1886,932,954
28255,58367,13337,28109,9867,45030,1886,932,954
28260,58374,13338,28112,9868,45036,1886,932,954
28265,58387,13339,28118,9869,45048,1887,933,954
28270,58398,13339,28122,9869,45059,1887,933,954
28275,58405,13340,28125,9870,45065,1887,933,954
28280,58418,13342,28132,9871,45076,1888,933,955
28285,58429,13342,28137,9871,45087,1888,933,955
28290,58436,13345,28141,9873,45091,1888,933,955
28295,58449,13346,28148,9873,45102,1889,934,955
28300,58460,13349,28154,9876,45111,1889,934,955
28305,58467,13351,28156,9877,45116,1889,934,955
28310,58480,13353,28160,9878,45126,1890,934,956
28315,58491,13358,28168,9883,45132,1890,934,956
28320,58498,13362,28173,9886,45136,1890,934,956
28325,58511,13365,28180,9889,45144,1891,935,956
28330,58522,13371,28186,9894,45149,1891,935,956
28335,58529,13377,28189,9899,45152,1891,935,956
28340,58542,13380,28196,9901,45158,1892,936,956
28345,58553,13388,28200,9908,45164,1892,936,956
28350,58560,13394,28207,9914,45164,1892,936,956
28355,58573,13399,28213,9918,45173,1893,936,957
28360,58584,13399,28217,9918,45185,1893,936,957
28365,58591,13400,28219,9918,45190,1893,936,957
28370,58604,13401,28224,9919,45201,1894,936,958
28375,58615,13401,28229,9919,45213,1894,936,958
28380,58622,13402,28233,9920,45220,1894,936,958
28385,58635,13404,28238,9921,45230,1895,936,959
28390,58646,13404,28243,9921,45241,1895,936,959
28395,58653,13405,28247,9922,45248,1895,936,959
28400,58666,13406,28251,9923,45260,1896,936,960
28405,58677,13406,28253,9923,45271,1896,936,960
28410,58684,13407,28257,9923,45277,1896,936,960
28415,58697,13408,28264,9923,45288,1897,937,960
28420,58708,13408,28269,9923,45300,1897,937,960
28425,58715,13409,28273,9924,45306,1897,937,960
28430,58728,13411,28280,9926,45316,1898,937,961
28435,58739,13411,28286,9926,45328,1898,937,961
28440,58746,13412,28288,9927,45334,1898,937,961
28445,58759,13414,28291,9928,45345,1899,938,961
28450,58770,13414,28294,9928,45356,1899,938,961
28455,58777,13415,28296,9928,45362,1899,938,961
28460,58790,13416,28303,9929,45372,1900,938,962
28465,58801,13420,28310,9933,45381,1900,938,962
28470,58808,13422,28314,9933,45386,1900,938,962
28475,58821,13424,28319,9934,45395,1901,939,962
28480,58832,13428,28323,9938,45404,1901,939,962
28485,58839,13431,28326,9940,45408,1901,939,962
28490,58852,13434,28333,9943,45416,1902,940,962
28495,58863,13437,28339,9946,45424,1902,940,962
28500,58870,13441,28343,9950,45429,1902,940,962
28505,58883,13443,28349,9952,45437,1903,941,962
28510,58894,13449,28356,9957,45444,1903,941,962
28515,58901,13454,28360,9960,45446,1903,941,962
28520,58914,13459,28367,9964,45451,1904,941,963
28525,58925,13466,28372,9971,45457,1904,941,963
28530,58932,13471,28376,9975,45460,1904,941,963
28535,58945,13474,28382,9977,45468,1905,942,963
28540,58956,13476,28386,9979,45480,1905,942,963
28545,58963,13478,28388,9980,45485,1905,942,963
28550,58976,13479,28395,9981,45493,1906,942,964
28555,58987,13482,28400,9984,45504,1906,942,964
28560,58994,13485,28403,9985,45509,1906,942,964
28565,59007,13486,28410,9986,45520,1907,943,964
28570,59018,13486,28416,9986,45532,1907,943,964
28575,59025,13487,28421,9987,45538,1907,943,964
28580,59038,13488,28425,9987,45548,1908,944,964
28585,59049,13488,28429,9987,45561,1908,944,964
28590,59056,13489,28431,9987,45567,1908,944,964
28595,59069,13490,28436,9987,45577,1909,944,965
28600,59080,13490,28442,9987,45590,1909,944,965
28605,59087,13491,28446,9988,45596,1909,944,965
28610,59100,13493,28456,9990,45607,1910,945,965
28615,59111,13493,28460,9990,45618,1910,945,965
28620,59118,13494,28463,9990,45624,1910,945,965
28625,59131,13496,28471,9991,45634,1911,946,965
28630,59142,13496,28476,9991,45646,1911,946,965
28635,59149,13497,28479,9992,45652,1911,946,965
28640,59162,13498,28483,9992,45664,1912,947,965
28645,59173,13499,28486,9992,45674,1912,947,965
28650,59180,13500,28490,9992,45680,1912,947,965
28655,59193,13502,28496,9993,45689,1913,947,966
28660,59204,13504,28503,9995,45700,1913,947,966
28665,59211,13505,28504,9996,45706,1913,947,966
28670,59224,13507,28508,9997,45716,1914,948,966
28675,59235,13511,28514,10001,45723,1914,948,966
28680,59242,13514,28516,10002,45728,1914,948,966
28685,59255,13516,28523,10003,45736,1915,949,966
28690,59266,13522,28528,10008,45743,1915,949,966
28695,59273,13526,28530,10011,45747,1915,949,966
28700,59286,13529,28534,10013,45756,1916,949,967
28705,59297,13533,28539,10016,45763,1916,949,967
28710,59304,13537,28544,10020,45766,1916,949,967
28715,59317,13541,28550,10024,45775,1917,950,967
28720,59328,13545,28557,10027,45781,1917,950,967
28725,59335,13551,28561,10031,45782,1917,950,967
28730,59348,13553,28567,10032,45794,1918,951,967
28735,59359,13554,28571,10033,45804,1918,951,967
28740,59366,13558,28574,10036,45807,1918,951,967
28745,59379,13562,28579,10039,45817,1919,951,968
28750,59390,13562,28583,10039,45826,1919,951,968
28755,59397,13565,28585,10040,45831,1919,951,968
28760,59410,13568,28593,10042,45840,1920,952,968
28765,59421,13569,28596,10043,45852,1920,952,968
28770,59428,13570,28600,10044,45858,1920,952,968
28775,59441,13572,28607,10046,45868,1921,952,969
28780,59452,13572,28613,10046,45879,1921,952,969
28785,59459,13573,28615,10047,45886,1921,952,969
28790,59472,13575,28621,10049,45896,1922,953,969
28795,59483,13575,28628,10049,45908,1922,953,969
28800,59490,13576,28631,10049,45914,1922,953,969
28805,59503,13578,28637,10050,45924,1923,953,970
28810,59514,13578,28645,10050,45936,1923,953,970
28815,59521,13579,28649,10051,45942,1923,953,970
28820,59534,13581,28656,10052,45952,1924,953,971
28825,59545,13581,28660,10052,45964,1924,953,971
28830,59552,13582,28662,10052,45970,1924,953,971
28835,59565,13586,28672,10056,45978,1925,954,971
28840,59576,13588,28680,10058,45988,1925,954,971
28845,59583,13589,28683,10059,45994,1925,954,971
28850,59596,13592,28691,10061,46002,1926,955,971
28855,59607,13594,28696,10062,46012,1926,955,971
28860,59614,13596,28699,10063,46018,1926,955,971
28865,59627,13600,28710,10067,46025,1927,956,971
28870,59638,13605,28717,10071,46033,1927,956,971
28875,59645,13607,28719,10072,46038,1927,956,971
28880,59658,13610,28726,10074,46046,1928,956,972
28885,59669,13614,28732,10077,46054,1928,956,972
28890,59676,13618,28736,10079,46058,1928,956,972
28895,59689,13621,28742,10080,46066,1929,957,972
28900,59700,13624,28747,10082,46075,1929,957,972
28905,59707,13627,28750,10084,46080,1929,957,972
28910,59720,13630,28758,10085,46084,1930,958,972
28915,59731,13639,28766,10094,46090,1930,958,972
28920,59738,13642,28769,10096,46095,1930,958,972
28925,59751,13644,28772,10097,46107,1931,958,973
28930,59762,13646,28778,10099,46115,1931,958,973
28935,59769,13650,28781,10103,46119,1931,958,973
28940,59782,13652,28787,10105,46130,1932,958,974
28945,59793,13654,28793,10107,46138,1932,958,974
28950,59800,13659,28797,10111,46140,1932,958,974
28955,59813,13662,28803,10113,46151,1933,959,974
28960,59824,13662,28808,10113,46162,1933,959,974
28965,59831,13663,28810,10113,46168,1933,959,974
28970,59844,13665,28819,10115,46178,1934,960,974
28975,59855,13665,28823,10115,46190,1934,960,974
28980,59862,13666,28826,10115,46195,1934,960,974
28985,59875,13668,28831,10116,46207,1935,961,974
28990,59886,13668,28834,10116,46218,1935,961,974
28995,59893,13669,28836,10117,46224,1935,961,974
29000,59906,13671,28839,10118,46235,1936,961,975
29005,59917,13671,28844,10118,46246,1936,961,975
29010,59924,13672,28848,10119,46252,1936,961,975
29015,59937,13674,28854,10120,46263,1937,962,975
29020,59948,13674,28859,10120,46274,1937,962,975
29025,59955,13675,28859,10120,46280,1937,962,975
29030,59968,13678,28865,10122,46289,1938,963,975
29035,59979,13680,28872,10124,46298,1938,963,975
29040,59986,13681,28877,10124,46305,1938,963,975
29045,59999,13684,28882,10126,46313,1939,963,976
29050,60010,13686,28886,10127,46324,1939,963,976
29055,60017,13687,28891,10128,46330,1939,963,976
29060,60030,13689,28897,10130,46339,1940,963,977
29065,60041,13693,28903,10133,46348,1940,963,977
29070,60048,13695,28908,10134,46353,1940,963,977
29075,60061,13697,28916,10135,46362,1941,964,977
29080,60072,13700,28921,10137,46372,1941,964,977
29085,60079,13702,28923,10137,46377,1941,964,977
29090,60092,13704,28929,10139,46385,1942,965,977
29095,60103,13710,28937,10145,46390,1942,965,977
29100,60110,13717,28942,10151,46392,1942,965,977
29105,60123,13721,28946,10153,46399,1943,965,978
29110,60134,13725,28950,10156,46406,1943,965,978
29115,60141,13732,28953,10162,46409,1943,965,978
29120,60154,13736,28962,10165,46415,1944,965,979
29125,60165,13739,28968,10167,46426,1944,965,979
29130,60172,13740,28969,10167,46432,1944,965,979
29135,60185,13742,28973,10167,46441,1945,965,980
29140,60196,13745,28977,10169,46451,1945,965,980
29145,60203,13746,28983,10170,46457,1945,965,980
29150,60216,13748,28988,10171,46468,1946,966,980
29155,60227,13750,28996,10173,46476,1946,966,980
29160,60234,13752,29000,10175,46482,1946,966,980
29165,60247,13756,29006,10178,46489,1947,967,980
29170,60258,13760,29011,10182,46498,1947,967,980
29175,60265,13761,29011,10182,46504,1947,967,980
29180,60278,13763,29015,10184,46515,1948,968,980
29185,60289,13763,29021,10184,46526,1948,968,980
29190,60296,13764,29025,10184,46531,1948,968,980
29195,60309,13766,29033,10185,46542,1949,969,980
29200,60320,13766,29040,10185,46554,1949,969,980
29205,60327,13767,29043,10186,46560,1949,969,980
29210,60340,13769,29049,10187,46570,1950,970,980
29215,60351,13769,29056,10187,46581,1950,970,980
29220,60358,13770,29061,10188,46588,1950,970,980
29225,60371,13772,29068,10189,46597,1951,971,980
29230,60382,13772,29071,10189,46610,1951,971,980
29235,60389,13775,29074,10191,46614,1951,971,980
29240,60402,13777,29082,10193,46623,1952,971,981
29245,60413,13780,29086,10196,46633,1952,971,981
29250,60420,13782,29090,10198,46638,1952,971,981
29255,60433,13785,29096,10200,46646,1953,971,982
29260,60444,13790,29103,10205,46653,1953,971,982
29265,60451,13793,29107,10208,46658,1953,971,982
29270,60464,13795,29113,10210,46667,1954,971,983
29275,60475,13799,29118,10214,46675,1954,971,983
29280,60482,13803,29120,10216,46679,1954,971,983
29285,60495,13807,29126,10218,46686,1955,971,984
29290,60506,13810,29132,10220,46696,1955,971,984
29295,60513,13811,29136,10221,46702,1955,971,984
29300,60526,13814,29147,10224,46708,1956,971,985
29305,60537,13818,29151,10227,46718,1956,971,985
29310,60544,13820,29153,10228,46724,1956,971,985
29315,60557,13824,29161,10231,46732,1957,972,985
29320,60568,13825,29166,10232,46742,1957,972,985
29325,60575,13827,29171,10234,46748,1957,972,985
29330,60588,13829,29173,10234,46758,1958,973,985
29335,60599,13831,29177,10236,46768,1958,973,985
29340,60606,13832,29180,10236,46774,1958,973,985
29345,60619,13835,29186,10238,46783,1959,973,986
29350,60630,13837,29190,10239,46793,1959,973,986
29355,60637,13839,29195,10241,46797,1959,973,986
29360,60650,13843,29201,10245,46807,1960,973,987
29365,60661,13846,29210,10247,46814,1960,973,987
29370,60668,13849,29214,10250,46818,1960,973,987
29375,60681,13852,29219,10251,46829,1961,974,987
29380,60692,13852,29226,10251,46840,1961,974,987
29385,60699,13853,29231,10252,46846,1961,974,987
29390,60712,13855,29236,10252,46857,1962,974,988
29395,60723,13856,29242,10253,46867,1962,974,988
29400,60730,13859,29249,10256,46870,1962,974,988
29405,60743,13861,29255,10258,46882,1963,975,988
29410,60754,13862,29259,10259,46892,1963,975,988
29415,60761,13864,29264,10261,46897,1963,975,988
29420,60774,13866,29272,10263,46907,1964,975,989
29425,60785,13868,29280,10265,46915,1964,975,989
29430,60792,13872,29282,10268,46920,1964,975,989
29435,60805,13874,29290,10269,46929,1965,976,989
29440,60816,13877,29298,10272,46937,1965,976,989
29445,60823,13882,29302,10276,46940,1965,976,989
29450,60836,13886,29305,10278,46949,1966,976,990
29455,60847,13887,29310,10279,46958,1966,976,990
29460,60854,13891,29314,10283,46963,1966,976,990
29465,60867,13893,29319,10284,46974,1967,977,990
29470,60878,13893,29324,10284,46985,1967,977,990
29475,60885,13894,29327,10284,46991,1967,977,990
29480,60898,13896,29334,10286,46999,1968,978,990
29485,60909,13897,29340,10287,47011,1968,978,990
29490,60916,13898,29341,10287,47018,1968,978,990
29495,60929,13900,29348,10289,47028,1969,979,990
29500,60940,13902,29349,10290,47038,1969,979,990
29505,60947,13903,29351,10290,47044,1969,979,990
29510,60960,13908,29359,10294,47051,1970,980,990
29515,60971,13912,29366,10298,47059,1970,980,990
29520,60978,13914,29370,10299,47063,1970,980,990
29525,60991,13917,29376,10300,47071,1971,980,991
29530,61002,13921,29382,10304,47081,1971,980,991
29535,61009,13922,29384,10305,47087,1971,980,991
29540,61022,13924,29390,10306,47096,1972,980,992
29545,61033,13928,29393,10309,47105,1972,980,992
29550,61040,13929,29397,10310,47111,1972,980,992
29555,61053,13932,29402,10312,47120,1973,980,993
29560,61064,13934,29406,10314,47130,1973,980,993
29565,61071,13936,29410,10316,47135,1973,980,993
29570,61084,13938,29413,10318,47146,1974,980,994
29575,61095,13940,29421,10320,47155,1974,980,994
29580,61102,13943,29424,10322,47159,1974,980,994
29585,61115,13945,29430,10323,47169,1975,981,994
29590,61126,13946,29435,10323,47179,1975,981,994
29595,61133,13950,29436,10325,47183,1975,981,994
29600,61146,13952,29440,10327,47192,1976,981,995
29605,61157,13958,29446,10333,47198,1976,981,995
29610,61164,13963,29450,10337,47201,1976,981,995
29615,61177,13967,29456,10339,47207,1977,981,996
29620,61188,13971,29461,10342,47215,1977,981,996
29625,61195,13977,29463,10346,47218,1977,981,996
29630,61208,13980,29469,10347,47224,1978,982,996
29635,61219,13983,29472,10350,47234,1978,982,996
29640,61226,13987,29477,10354,47238,1978,982,996
29645,61239,13990,29481,10356,47249,1979,982,997
29650,61250,13990,29486,10356,47259,1979,982,997
29655,61257,13991,29489,10357,47265,1979,982,997
29660,61270,13993,29495,10359,47277,1980,982,998
29665,61281,13993,29499,10359,47287,1980,982,998
29670,61288,13994,29504,10360,47294,1980,982,998
29675,61301,13996,29512,10362,47303,1981,983,998
29680,61312,13996,29518,10362,47315,1981,983,998
29685,61319,13997,29522,10362,47322,1981,983,998
29690,61332,13999,29531,10363,47331,1982,983,999
29695,61343,13999,29537,10363,47344,1982,983,999
29700,61350,14000,29542,10363,47350,1982,983,999
29705,61363,14002,29546,10364,47361,1983,984,999
29710,61374,14002,29550,10364,47372,1983,984,999
29715,61381,14003,29552,10365,47378,1983,984,999
29720,61394,14005,29560,10366,47388,1984,984,1000
29725,61405,14005,29567,10366,47400,1984,984,1000
29730,61412,14006,29570,10367,47406,1984,984,1000
29735,61425,14008,29576,10368,47416,1985,985,1000
29740,61436,14010,29580,10370,47426,1985,985,1000
29745,61443,14011,29583,10371,47432,1985,985,1000
29750,61456,14013,29589,10371,47441,1986,985,1001
29755,61467,14017,29595,10375,47450,1986,985,1001
29760,61474,14019,29599,10377,47455,1986,985,1001
29765,61487,14021,29603,10377,47465,1987,985,1002
29770,61498,14022,29608,10377,47476,1987,985,1002
29775,61505,14025,29612,10379,47480,1987,985,1002
29780,61518,14028,29620,10381,47488,1988,985,1003
29785,61529,14030,29625,10383,47499,1988,985,1003
29790,61536,14033,29630,10386,47503,1988,985,1003
29795,61549,14037,29634,10388,47511,1989,985,1004
29800,61560,14041,29641,10392,47518,1989,985,1004
29805,61567,14046,29646,10396,47520,1989,985,1004
29810,61580,14051,29652,10400,47527,1990,986,1004
29815,61591,14057,29659,10406,47532,1990,986,1004
29820,61598,14063,29663,10410,47534,1990,986,1004
29825,61611,14067,29668,10412,47542,1991,987,1004
29830,61622,14072,29673,10416,47549,1991,987,1004
29835,61629,14075,29675,10418,47554,1991,987,1004
29840,61642,14078,29683,10419,47563,1992,988,1004
29845,61653,14080,29689,10421,47572,1992,988,1004
29850,61660,14084,29693,10424,47575,1992,988,1004
29855,61673,14086,29696,10425,47587,1993,988,1005
29860,61684,14086,29703,10425,47598,1993,988,1005
29865,61691,14087,29705,10425,47604,1993,988,1005
29870,61704,14089,29711,10426,47615,1994,989,1005
29875,61715,14089,29716,10426,47626,1994,989,1005
29880,61722,14090,29718,10426,47632,1994,989,1005
29885,61735,14092,29726,10428,47643,1995,990,1005
29890,61746,14092,29732,10428,47654,1995,990,1005
29895,61753,14093,29733,10429,47660,1995,990,1005
29900,61766,14095,29740,10430,47671,1996,990,1006
29905,61777,14095,29746,10430,47682,1996,990,1006
29910,61784,14096,29748,10431,47688,1996,990,1006
29915,61797,14098,29757,10432,47698,1997,991,1006
29920,61808,14098,29762,10432,47710,1997,991,1006
29925,61815,14099,29765,10433,47716,1997,991,1006
29930,61828,14101,29769,10433,47727,1998,991,1007
29935,61839,14101,29772,10433,47737,1998,991,1007
29940,61846,14102,29776,10433,47744,1998,991,1007
29945,61859,14104,29782,10433,47753,1999,992,1007
29950,61870,14105,29788,10434,47764,1999,992,1007
29955,61877,14106,29789,10434,47771,1999,992,1007
29960,61890,14109,29794,10436,47780,2000,992,1008
29965,61901,14112,29799,10439,47788,2000,992,1008
29970,61908,14116,29803,10442,47792,2000,992,1008
29975,61921,14118,29808,10443,47802,2001,993,1008
29980,61932,14123,29813,10447,47808,2001,993,1008
29985,61939,14127,29817,10449,47811,2001,993,1008
29990,61952,14131,29824,10453,47820,2002,993,1009
29995,61963,14135,29833,10457,47827,2002,993,1009
30000,61970,14138,29838,10460,47832,2002,993,1009
30005,61983,14140,29843,10461,47842,2003,994,1009
30010,61994,14143,29848,10463,47851,2003,994,1009
30015,62001,14145,29849,10463,47856,2003,994,1009
30020,62014,14149,29857,10467,47864,2004,995,1009
30025,62025,14153,29861,10471,47872,2004,995,1009
30030,62032,14156,29865,10473,47876,2004,995,1009
30035,62045,14158,29871,10475,47885,2005,995,1010
30040,62056,14163,29876,10479,47892,2005,995,1010
30045,62063,14168,29880,10483,47895,2005,995,1010
30050,62076,14173,29889,10487,47900,2006,996,1010
30055,62087,14177,29895,10491,47908,2006,996,1010
30060,62094,14182,29899,10495,47911,2006,996,1010
30065,62107,14185,29907,10498,47920,2007,996,1011
30070,62118,14186,29914,10499,47932,2007,996,1011
30075,62125,14187,29915,10499,47938,2007,996,1011
30080,62138,14189,29924,10501,47948,2008,997,1011
30085,62149,14189,29929,10501,47960,2008,997,1011
30090,62156,14190,29933,10501,47966,2008,997,1011
30095,62169,14192,29937,10501,47976,2009,998,1011
30100,62180,14192,29941,10501,47987,2009,998,1011
30105,62187,14193,29944,10502,47994,2009,998,1011
30110,62200,14195,29950,10503,48005,2010,999,1011
30115,62211,14195,29955,10503,48015,2010,999,1011
30120,62218,14196,29961,10504,48021,2010,999,1011
30125,62231,14198,29965,10504,48032,2011,999,1012
30130,62242,14198,29969,10504,48044,2011,999,1012
30135,62249,14199,29971,10504,48050,2011,999,1012
30140,62262,14201,29978,10506,48059,2012,999,1013
30145,62273,14201,29981,10506,48071,2012,999,1013
30150,62280,14202,29984,10507,48078,2012,999,1013
30155,62293,14204,29990,10508,48089,2013,999,1014
30160,62304,14204,29995,10508,48099,2013,999,1014
30165,62311,14205,29999,10508,48106,2013,999,1014
30170,62324,14207,30005,10508,48115,2014,1000,1014
30175,62335,14210,30010,10510,48125,2014,1000,1014
30180,62342,14212,30012,10510,48130,2014,1000,1014
30185,62355,14214,30017,10510,48138,2015,1000,1015
30190,62366,14218,30023,10514,48148,2015,1000,1015
30195,62373,14221,30026,10515,48152,2015,1000,1015
30200,62386,14224,30032,10517,48162,2016,1000,1016
30205,62397,14225,30035,10518,48172,2016,1000,1016
30210,62404,14228,30041,10520,48176,2016,1000,1016
30215,62417,14232,30046,10522,48183,2017,1000,1017
30220,62428,14235,30048,10525,48193,2017,1000,1017
30225,62435,14239,30052,10527,48195,2017,1000,1017
30230,62448,14244,30060,10531,48201,2018,1000,1018
30235,62459,14249,30064,10536,48208,2018,1000,1018
30240,62466,14254,30066,10539,48211,2018,1000,1018
30245,62479,14257,30071,10540,48220,2019,1001,1018
30250,62490,14261,30078,10544,48228,2019,1001,1018
30255,62497,14263,30083,10545,48234,2019,1001,1018
30260,62510,14267,30089,10547,48241,2020,1001,1019
30265,62521,14270,30093,10550,48251,2020,1001,1019
30270,62528,14271,30097,10551,48257,2020,1001,1019
30275,62541,14275,30105,10555,48263,2021,1001,1020
30280,62552,14279,30111,10559,48272,2021,1001,1020
30285,62559,14282,30117,10562,48276,2021,1001,1020
30290,62572,14287,30122,10565,48285,2022,1002,1020
30295,62583,14287,30129,10565,48296,2022,1002,1020
30300,62590,14288,30130,10565,48302,2022,1002,1020
30305,62603,14290,30135,10567,48313,2023,1003,1020
30310,62614,14290,30141,10567,48323,2023,1003,1020
30315,62621,14291,30142,10567,48329,2023,1003,1020
30320,62634,14293,30146,10568,48340,2024,1003,1021
30325,62645,14293,30152,10568,48351,2024,1003,1021
30330,62652,14294,30155,10569,48358,2024,1003,1021
30335,62665,14296,30161,10569,48369,2025,1004,1021
30340,62676,14296,30165,10569,48379,2025,1004,1021
30345,62683,14297,30167,10570,48386,2025,1004,1021
30350,62696,14299,30176,10571,48396,2026,1005,1021
30355,62707,14299,30183,10571,48407,2026,1005,1021
30360,62714,14302,30188,10574,48412,2026,1005,1021
30365,62727,14304,30194,10576,48423,2027,1005,1022
30370,62738,14305,30198,10577,48433,2027,1005,1022
30375,62745,14308,30202,10579,48437,2027,1005,1022
30380,62758,14310,30211,10581,48446,2028,1006,1022
30385,62769,14312,30213,10583,48456,2028,1006,1022
30390,62776,14316,30217,10586,48459,2028,1006,1022
30395,62789,14319,30222,10587,48468,2029,1007,1022
30400,62800,14323,30226,10591,48476,2029,1007,1022
30405,62807,14327,30230,10595,48480,2029,1007,1022
30410,62820,14330,30236,10598,48488,2030,1007,1023
30415,62831,14333,30239,10600,48497,2030,1007,1023
30420,62838,14336,30242,10602,48501,2030,1007,1023
30425,62851,14339,30248,10604,48511,2031,1008,1023
30430,62862,14341,30255,10606,48521,2031,1008,1023
30435,62869,14342,30258,10606,48527,2031,1008,1023
30440,62882,14346,30263,10609,48535,2032,1008,1024
30445,62893,14348,30265,10611,48545,2032,1008,1024
30450,62900,14349,30268,10612,48551,2032,1008,1024
30455,62913,14353,30273,10614,48557,2033,1008,1025
30460,62924,14356,30277,10617,48567,2033,1008,1025
30465,62931,14358,30280,10618,48572,2033,1008,1025
30470,62944,14364,30285,10622,48579,2034,1009,1025
30475,62955,14367,30289,10624,48587,2034,1009,1025
30480,62962,14370,30292,10626,48592,2034,1009,1025
30485,62975,14374,30299,10629,48600,2035,1010,1025
30490,62986,14374,30306,10629,48611,2035,1010,1025
30495,62993,14375,30310,10630,48618,2035,1010,1025
30500,63006,14377,30316,10632,48628,2036,1011,1025
30505,63017,14377,30321,10632,48640,2036,1011,1025
30510,63024,14378,30322,10632,48646,2036,1011,1025
30515,63037,14380,30330,10633,48655,2037,1011,1026
30520,63048,14380,30335,10633,48667,2037,1011,1026
30525,63055,14381,30337,10633,48673,2037,1011,1026
30530,63068,14384,30345,10636,48682,2038,1012,1026
30535,63079,14386,30351,10638,48693,2038,1012,1026
30540,63086,14389,30354,10639,48697,2038,1012,1026
30545,63099,14392,30360,10640,48705,2039,1013,1026
30550,63110,14395,30367,10643,48713,2039,1013,1026
30555,63117,14400,30371,10647,48716,2039,1013,1026
30560,63130,14403,30377,10649,48726,2040,1014,1026
30565,63141,14403,30381,10649,48738,2040,1014,1026
30570,63148,14405,30384,10651,48743,2040,1014,1026
30575,63161,14407,30395,10653,48753,2041,1015,1026
30580,63172,14408,30403,10654,48764,2041,1015,1026
30585,63179,14410,30405,10654,48769,2041,1015,1026
30590,63192,14412,30412,10655,48778,2042,1016,1026
30595,63203,14415,30417,10658,48788,2042,1016,1026
30600,63210,14418,30418,10659,48792,2042,1016,1026
30605,63223,14420,30421,10659,48802,2043,1016,1027
30610,63234,14423,30425,10661,48811,2043,1016,1027
30615,63241,14425,30428,10662,48816,2043,1016,1027
30620,63254,14427,30436,10664,48825,2044,1017,1027
30625,63265,14429,30440,10666,48836,2044,1017,1027
30630,63272,14431,30442,10667,48841,2044,1017,1027
30635,63285,14434,30447,10670,48851,2045,1017,1028
30640,63296,14436,30452,10671,48859,2045,1017,1028
30645,63303,14439,30455,10673,48864,2045,1017,1028
30650,63316,14442,30461,10675,48872,2046,1017,1029
30655,63327,14448,30467,10680,48877,2046,1017,1029
30660,63334,14453,30470,10683,48880,2046,1017,1029
30665,63347,14457,30476,10687,48887,2047,1017,1030
30670,63358,14465,30482,10694,48891,2047,1017,1030
30675,63365,14469,30482,10696,48896,2047,1017,1030
30680,63378,14471,30488,10697,48906,2048,1017,1031
30685,63389,14473,30493,10699,48916,2048,1017,1031
30690,63396,14474,30498,10700,48922,2048,1017,1031
30695,63409,14476,30506,10701,48931,2049,1017,1032
30700,63420,14476,30510,10701,48943,2049,1017,1032
30705,63427,14477,30515,10701,48950,2049,1017,1032
30710,63440,14479,30520,10702,48959,2050,1017,1033
30715,63451,14479,30526,10702,48971,2050,1017,1033
30720,63458,14480,30532,10703,48978,2050,1017,1033
30725,63471,14482,30537,10704,48989,2051,1017,1034
30730,63482,14482,30541,10704,49000,2051,1017,1034
30735,63489,14483,30544,10705,49006,2051,1017,1034
30740,63502,14485,30553,10706,49017,2052,1018,1034
30745,63513,14485,30560,10706,49028,2052,1018,1034
30750,63520,14486,30565,10706,49034,2052,1018,1034
30755,63533,14488,30567,10706,49045,2053,1018,1035
30760,63544,14488,30571,10706,49056,2053,1018,1035
30765,63551,14489,30575,10707,49062,2053,1018,1035
30770,63564,14491,30582,10708,49073,2054,1019,1035
30775,63575,14491,30586,10708,49084,2054,1019,1035
30780,63582,14492,30591,10709,49090,2054,1019,1035
30785,63595,14495,30595,10710,49099,2055,1019,1036
30790,63606,14498,30602,10713,49108,2055,1019,1036
30795,63613,14501,30608,10716,49112,2055,1019,1036
30800,63626,14503,30612,10717,49123,2056,1019,1037
30805,63637,14505,30616,10718,49132,2056,1019,1037
30810,63644,14508,30620,10719,49136,2056,1019,1037
30815,63657,14510,30623,10719,49146,2057,1019,1038
30820,63668,14513,30627,10721,49154,2057,1019,1038
30825,63675,14518,30631,10724,49156,2057,1019,1038
30830,63688,14523,30639,10729,49162,2058,1020,1038
30835,63699,14528,30642,10733,49169,2058,1020,1038
30840,63706,14533,30646,10738,49172,2058,1020,1038
30845,63719,14538,30650,10741,49179,2059,1020,1039
30850,63730,14543,30657,10746,49183,2059,1020,1039
30855,63737,14550,30662,10752,49185,2059,1020,1039
30860,63750,14554,30666,10755,49195,2060,1021,1039
30865,63761,14556,30674,10757,49203,2060,1021,1039
30870,63768,14559,30677,10759,49208,2060,1021,1039
30875,63781,14562,30685,10761,49218,2061,1022,1039
30880,63792,14562,30692,10761,49229,2061,1022,1039
30885,63799,14563,30693,10761,49236,2061,1022,1039
30890,63812,14565,30697,10762,49246,2062,1022,1040
30895,63823,14565,30705,10762,49258,2062,1022,1040
30900,63830,14566,30709,10763,49264,2062,1022,1040
30905,63843,14568,30717,10764,49274,2063,1023,1040
30910,63854,14568,30722,10764,49285,2063,1023,1040
30915,63861,14569,30724,10764,49292,2063,1023,1040
30920,63874,14571,30730,10764,49302,2064,1023,1041
30925,63885,14571,30737,10764,49314,2064,1023,1041
30930,63892,14572,30740,10765,49320,2064,1023,1041
30935,63905,14574,30746,10765,49330,2065,1023,1042
30940,63916,14574,30751,10765,49342,2065,1023,1042
30945,63923,14575,30755,10765,49348,2065,1023,1042
30950,63936,14577,30761,10766,49358,2066,1023,1043
30955,63947,14577,30767,10766,49370,2066,1023,1043
30960,63954,14578,30772,10767,49376,2066,1023,1043
30965,63967,14580,30779,10768,49385,2067,1024,1043
30970,63978,14582,30786,10769,49396,2067,1024,1043
30975,63985,14583,30788,10770,49402,2067,1024,1043
30980,63998,14585,30792,10771,49413,2068,1024,1044
30985,64009,14588,30799,10773,49421,2068,1024,1044
30990,64016,14591,30803,10774,49425,2068,1024,1044
30995,64029,14594,30811,10776,49430,2069,1025,1044
31000,64040,14603,30818,10784,49436,2069,1025,1044
31005,64047,14608,30820,10787,49439,2069,1025,1044
31010,64060,14610,30824,10787,49447,2070,1025,1045
31015,64071,14617,30831,10794,49452,2070,1025,1045
31020,64078,14622,30836,10798,49455,2070,1025,1045
31025,64091,14625,30842,10800,49464,2071,1026,1045
31030,64102,14628,30848,10803,49473,2071,1026,1045
31035,64109,14631,30851,10805,49478,2071,1026,1045
31040,64122,14635,30858,10808,49484,2072,1027,1045
31045,64133,14641,30866,10814,49490,2072,1027,1045
31050,64140,14643,30870,10816,49497,2072,1027,1045
31055,64153,14645,30877,10817,49507,2073,1027,1046
31060,64164,14645,30882,10817,49519,2073,1027,1046
31065,64171,14646,30885,10817,49524,2073,1027,1046
31070,64184,14648,30893,10819,49535,2074,1028,1046
31075,64195,14648,30899,10819,49547,2074,1028,1046
31080,64202,14649,30902,10819,49552,2074,1028,1046
31085,64215,14651,30909,10820,49564,2075,1029,1046
31090,64226,14651,30912,10820,49575,2075,1029,1046
31095,64233,14652,30915,10820,49581,2075,1029,1046
31100,64246,14654,30922,10821,49591,2076,1030,1046
31105,64257,14654,30926,10821,49603,2076,1030,1046
31110,64264,14655,30928,10821,49609,2076,1030,1046
31115,64277,14657,30933,10821,49620,2077,1030,1047
31120,64288,14657,30938,10821,49631,2077,1030,1047
31125,64295,14658,30940,10821,49637,2077,1030,1047
31130,64308,14660,30950,10822,49648,2078,1031,1047
31135,64319,14660,30957,10822,49659,2078,1031,1047
31140,64326,14662,30958,10822,49664,2078,1031,1047
31145,64339,14664,30964,10822,49675,2079,1031,1048
31150,64350,14665,30971,10823,49685,2079,1031,1048
31155,64357,14668,30974,10824,49689,2079,1031,1048
31160,64370,14670,30979,10824,49698,2080,1031,1049
31165,64381,14672,30985,10826,49709,2080,1031,1049
31170,64388,14674,30989,10827,49714,2080,1031,1049
31175,64401,14677,30993,10829,49723,2081,1032,1049
31180,64412,14681,31001,10833,49731,2081,1032,1049
31185,64419,14683,31004,10834,49736,2081,1032,1049
31190,64432,14686,31012,10836,49744,2082,1033,1049
31195,64443,14691,31016,10841,49752,2082,1033,1049
31200,64450,14694,31020,10843,49755,2082,1033,1049
31205,64463,14699,31029,10847,49763,2083,1034,1049
31210,64474,14702,31034,10849,49771,2083,1034,1049
31215,64481,14706,31037,10852,49775,2083,1034,1049
31220,64494,14710,31044,10856,49783,2084,1034,1050
31225,64505,14713,31048,10859,49791,2084,1034,1050
31230,64512,14718,31053,10863,49793,2084,1034,1050
31235,64525,14722,31060,10866,49800,2085,1034,1051
31240,64536,14729,31068,10872,49805,2085,1034,1051
31245,64543,14732,31072,10874,49811,2085,1034,1051
31250,64556,14735,31078,10877,49819,2086,1034,1052
31255,64567,14737,31083,10878,49829,2086,1034,1052
31260,64574,14739,31087,10880,49835,2086,1034,1052
31265,64587,14743,31096,10883,49842,2087,1035,1052
31270,64598,14744,31100,10884,49854,2087,1035,1052
31275,64605,14745,31101,10884,49860,2087,1035,1052
31280,64618,14747,31106,10884,49870,2088,1035,1053
31285,64629,14747,31110,10884,49882,2088,1035,1053
31290,64636,14748,31115,10885,49888,2088,1035,1053
31295,64649,14750,31121,10886,49898,2089,1035,1054
31300,64660,14750,31127,10886,49910,2089,1035,1054
31305,64667,14751,31131,10887,49916,2089,1035,1054
31310,64680,14753,31137,10887,49925,2090,1036,1054
31315,64691,14753,31146,10887,49937,2090,1036,1054
31320,64698,14754,31150,10888,49944,2090,1036,1054
31325,64711,14756,31157,10889,49954,2091,1037,1054
31330,64722,14756,31163,10889,49966,2091,1037,1054
31335,64729,14757,31168,10890,49972,2091,1037,1054
31340,64742,14759,31179,10892,49981,2092,1038,1054
31345,64753,14759,31183,10892,49993,2092,1038,1054
31350,64760,14761,31186,10892,49999,2092,1038,1054
31355,64773,14763,31194,10894,50008,2093,1039,1054
31360,64784,14763,31198,10894,50021,2093,1039,1054
31365,64791,14765,31199,10894,50026,2093,1039,1054
31370,64804,14767,31202,10895,50036,2094,1039,1055
31375,64815,14770,31209,10898,50045,2094,1039,1055
31380,64822,14773,31215,10901,50049,2094,1039,1055
31385,64835,14776,31222,10903,50058,2095,1039,1056
31390,64846,14779,31228,10905,50067,2095,1039,1056
31395,64853,14782,31232,10906,50071,2095,1039,1056
31400,64866,14785,31237,10907,50079,2096,1039,1057
31405,64877,14788,31243,10910,50088,2096,1039,1057
31410,64884,14792,31245,10912,50091,2096,1039,1057
31415,64897,14796,31253,10916,50096,2097,1039,1058
31420,64908,14803,31261,10923,50104,2097,1039,1058
31425,64915,14807,31265,10925,50107,2097,1039,1058
31430,64928,14812,31272,10930,50115,2098,1040,1058
31435,64939,14816,31278,10934,50122,2098,1040,1058
31440,64946,14818,31280,10935,50128,2098,1040,1058
31445,64959,14821,31284,10937,50137,2099,1040,1059
31450,64970,14824,31290,10940,50145,2099,1040,1059
31455,64977,14826,31292,10942,50151,2099,1040,1059
31460,64990,14829,31300,10945,50160,2100,1041,1059
31465,65001,14831,31304,10946,50170,2100,1041,1059
31470,65008,14832,31309,10946,50176,2100,1041,1059
31475,65021,14835,31315,10949,50185,2101,1042,1059
31480,65032,14836,31319,10949,50195,2101,1042,1059
31485,65039,14838,31323,10950,50200,2101,1042,1059
31490,65052,14843,31328,10954,50208,2102,1043,1059
31495,65063,14846,31333,10957,50217,2102,1043,1059
31500,65070,14847,31335,10957,50223,2102,1043,1059
31505,65083,14849,31338,10957,50234,2103,1044,1059
31510,65094,14849,31343,10957,50245,2103,1044,1059
31515,65101,14850,31347,10958,50250,2103,1044,1059
31520,65114,14852,31350,10958,50262,2104,1045,1059
31525,65125,14852,31357,10958,50272,2104,1045,1059
31530,65132,14853,31361,10958,50278,2104,1045,1059
31535,65145,14855,31366,10958,50289,2105,1045,1060
31540,65156,14855,31372,10958,50300,2105,1045,1060
31545,65163,14858,31376,10960,50305,2105,1045,1060
31550,65176,14860,31381,10962,50316,2106,1045,1061
31555,65187,14861,31385,10963,50325,2106,1045,1061
31560,65194,14864,31389,10966,50330,2106,1045,1061
31565,65207,14866,31395,10966,50341,2107,1045,1062
31570,65218,14867,31403,10967,50348,2107,1045,1062
31575,65225,14871,31405,10970,50354,2107,1045,1062
31580,65238,14874,31411,10971,50362,2108,1046,1062
31585,65249,14877,31420,10974,50369,2108,1046,1062
31590,65256,14882,31422,10978,50374,2108,1046,1062
31595,65269,14885,31425,10980,50384,2109,1046,1063
31600,65280,14886,31429,10981,50393,2109,1046,1063
31605,65287,14891,31436,10986,50396,2109,1046,1063
31610,65300,14894,31444,10988,50404,2110,1046,1064
31615,65311,14896,31452,10990,50415,2110,1046,1064
31620,65318,14897,31455,10991,50421,2110,1046,1064
31625,65331,14899,31462,10993,50431,2111,1046,1065
31630,65342,14900,31464,10993,50442,2111,1046,1065
31635,65349,14901,31468,10994,50448,2111,1046,1065
31640,65362,14903,31471,10994,50457,2112,1047,1065
31645,65373,14906,31477,10996,50466,2112,1047,1065
31650,65380,14908,31480,10997,50472,2112,1047,1065
31655,65393,14911,31489,11000,50481,2113,1048,1065
31660,65404,14914,31496,11003,50489,2113,1048,1065
31665,65411,14916,31499,11005,50495,2113,1048,1065
31670,65424,14920,31507,11008,50502,2114,1048,1066
31675,65435,14923,31514,11011,50511,2114,1048,1066
31680,65442,14925,31520,11013,50517,2114,1048,1066
31685,65455,14928,31524,11016,50527,2115,1048,1067
31690,65466,14929,31529,11017,50536,2115,1048,1067
31695,65473,14932,31534,11020,50541,2115,1048,1067
31700,65486,14936,31540,11023,50548,2116,1049,1067
31705,65497,14939,31543,11025,50557,2116,1049,1067
31710,65504,14942,31545,11027,50562,2116,1049,1067
31715,65517,14944,31550,11029,50573,2117,1049,1068
31720,65528,14945,31558,11030,50582,2117,1049,1068
31725,65535,14948,31561,11031,50586,2117,1049,1068
31730,65548,14950,31566,11032,50596,2118,1049,1069
31735,65559,14953,31572,11035,50604,2118,1049,1069
31740,65566,14958,31576,11039,50608,2118,1049,1069
31745,65579,14961,31582,11042,50618,2119,1050,1069
31750,65590,14963,31588,11044,50626,2119,1050,1069
31755,65597,14968,31592,11048,50629,2119,1050,1069
31760,65610,14970,31602,11049,50637,2120,1051,1069
31765,65621,14971,31605,11050,50649,2120,1051,1069
31770,65628,14974,31609,11052,50654,2120,1051,1069
31775,65641,14977,31618,11054,50661,2121,1051,1070
31780,65652,14978,31622,11055,50674,2121,1051,1070
31785,65659,14979,31625,11055,50680,2121,1051,1070
31790,65672,14981,31633,11056,50691,2122,1052,1070
31795,65683,14981,31638,11056,50702,2122,1052,1070
31800,65690,14982,31642,11056,50708,2122,1052,1070
31805,65703,14984,31649,11057,50719,2123,1053,1070
31810,65714,14984,31656,11057,50730,2123,1053,1070
31815,65721,14985,31661,11058,50736,2123,1053,1070
31820,65734,14987,31663,11058,50746,2124,1053,1071
31825,65745,14989,31665,11059,50756,2124,1053,1071
31830,65752,14990,31669,11060,50762,2124,1053,1071
31835,65765,14993,31676,11063,50771,2125,1054,1071
31840,65776,14995,31680,11064,50781,2125,1054,1071
31845,65783,14996,31685,11065,50787,2125,1054,1071
31850,65796,15000,31690,11068,50795,2126,1054,1072
31855,65807,15002,31697,11070,50805,2126,1054,1072
31860,65814,15003,31702,11070,50811,2126,1054,1072
31865,65827,15007,31707,11072,50819,2127,1054,1073
31870,65838,15010,31713,11075,50828,2127,1054,1073
31875,65845,15011,31716,11075,50834,2127,1054,1073
31880,65858,15014,31722,11077,50841,2128,1054,1074
31885,65869,15023,31730,11085,50845,2128,1054,1074
31890,65876,15027,31735,11089,50848,2128,1054,1074
31895,65889,15031,31742,11093,50857,2129,1054,1075
31900,65900,15032,31749,11094,50867,2129,1054,1075
31905,65907,15035,31752,11096,50872,2129,1054,1075
31910,65920,15037,31756,11097,50882,2130,1054,1076
31915,65931,15038,31757,11098,50893,2130,1054,1076
31920,65938,15040,31757,11098,50898,2130,1054,1076
31925,65951,15043,31766,11100,50904,2131,1054,1077
31930,65962,15047,31772,11104,50913,2131,1054,1077
31935,65969,15050,31775,11106,50919,2131,1054,1077
31940,65982,15052,31783,11108,50929,2132,1055,1077
31945,65993,15053,31790,11109,50939,2132,1055,1077
31950,66000,15056,31792,11111,50944,2132,1055,1077
31955,66013,15058,31798,11112,50953,2133,1055,1078
31960,66024,15060,31802,11114,50963,2133,1055,1078
31965,66031,15064,31806,11117,50967,2133,1055,1078
31970,66044,15065,31811,11117,50979,2134,1056,1078
31975,66055,15065,31820,11117,50990,2134,1056,1078
31980,66062,15066,31823,11118,50996,2134,1056,1078
31985,66075,15068,31827,11119,51007,2135,1056,1079
31990,66086,15068,31832,11119,51018,2135,1056,1079
31995,66093,15069,31834,11120,51024,2135,1056,1079
32000,66106,15072,31843,11123,51033,2136,1057,1079
32005,66117,15073,31849,11123,51044,2136,1057,1079
32010,66124,15074,31850,11123,51050,2136,1057,1079
32015,66137,15076,31858,11125,51058,2137,1058,1079
32020,66148,15079,31863,11128,51069,2137,1058,1079
32025,66155,15080,31867,11129,51075,2137,1058,1079
32030,66168,15082,31871,11131,51085,2138,1059,1079
32035,66179,15084,31874,11132,51095,2138,1059,1079
32040,66186,15085,31876,11132,51101,2138,1059,1079
32045,66199,15088,31881,11134,51110,2139,1060,1079
32050,66210,15091,31886,11136,51118,2139,1060,1079
32055,66217,15094,31889,11139,51122,2139,1060,1079
32060,66230,15098,31894,11142,51131,2140,1060,1080
32065,66241,15103,31900,11146,51137,2140,1060,1080
32070,66248,15107,31904,11149,51141,2140,1060,1080
32075,66261,15110,31911,11151,51150,2141,1061,1080
32080,66272,15111,31916,11152,51160,2141,1061,1080
32085,66279,15114,31920,11154,51164,2141,1061,1080
32090,66292,15118,31929,11158,51172,2142,1061,1081
32095,66303,15121,31935,11161,51180,2142,1061,1081
32100,66310,15125,31938,11163,51184,2142,1061,1081
32105,66323,15127,31945,11164,51195,2143,1061,1082
32110,66334,15130,31948,11167,51204,2143,1061,1082
32115,66341,15133,31952,11170,51207,2143,1061,1082
32120,66354,15137,31956,11173,51216,2144,1061,1083
32125,66365,15138,31959,11174,51227,2144,1061,1083
32130,66372,15139,31964,11175,51233,2144,1061,1083
32135,66385,15140,31970,11175,51245,2145,1062,1083
32140,66396,15140,31974,11175,51256,2145,1062,1083
32145,66403,15141,31977,11175,51262,2145,1062,1083
32150,66416,15142,31982,11175,51274,2146,1062,1084
32155,66427,15142,31986,11175,51285,2146,1062,1084
32160,66434,15143,31990,11175,51291,2146,1062,1084
32165,66447,15144,31997,11175,51303,2147,1062,1085
32170,66458,15144,32003,11175,51314,2147,1062,1085
32175,66465,15145,32005,11175,51320,2147,1062,1085
32180,66478,15146,32012,11176,51331,2148,1063,1085
32185,66489,15148,32019,11178,51341,2148,1063,1085
32190,66496,15149,32021,11178,51347,2148,1063,1085
32195,66509,15151,32027,11179,51357,2149,1064,1085
32200,66520,15154,32035,11182,51366,2149,1064,1085
32205,66527,15155,32036,11182,51372,2149,1064,1085
32210,66540,15158,32041,11185,51382,2150,1064,1086
32215,66551,15160,32045,11187,51391,2150,1064,1086
32220,66558,15161,32047,11188,51397,2150,1064,1086
32225,66571,15164,32052,11190,51406,2151,1064,1087
32230,66582,15168,32058,11194,51413,2151,1064,1087
32235,66589,15172,32063,11198,51416,2151,1064,1087
32240,66602,15175,32068,11200,51425,2152,1064,1088
32245,66613,15180,32073,11205,51432,2152,1064,1088
32250,66620,15184,32076,11208,51436,2152,1064,1088
32255,66633,15188,32084,11212,51443,2153,1065,1088
32260,66644,15193,32090,11216,51450,2153,1065,1088
32265,66651,15195,32092,11217,51456,2153,1065,1088
32270,66664,15197,32099,11219,51465,2154,1065,1089
32275,66675,15200,32103,11222,51474,2154,1065,1089
32280,66682,15204,32108,11226,51477,2154,1065,1089
32285,66695,15206,32118,11228,51486,2155,1066,1089
32290,66706,15209,32124,11231,51494,2155,1066,1089
32295,66713,15215,32129,11236,51497,2155,1066,1089
32300,66726,15218,32134,11238,51506,2156,1066,1090
32305,66737,15218,32138,11238,51519,2156,1066,1090
32310,66744,15219,32142,11239,51525,2156,1066,1090
32315,66757,15220,32146,11239,51537,2157,1067,1090
32320,66768,15220,32151,11239,51547,2157,1067,1090
32325,66775,15221,32155,11240,51554,2157,1067,1090
32330,66788,15222,32161,11240,51565,2158,1067,1091
32335,66799,15222,32167,11240,51576,2158,1067,1091
32340,66806,15223,32171,11241,51583,2158,1067,1091
32345,66819,15225,32177,11242,51592,2159,1067,1092
32350,66830,15225,32182,11242,51605,2159,1067,1092
32355,66837,15226,32186,11243,51611,2159,1067,1092
32360,66850,15228,32194,11245,51621,2160,1067,1093
32365,66861,15230,32201,11247,51631,2160,1067,1093
32370,66868,15231,32204,11247,51637,2160,1067,1093
32375,66881,15232,32208,11247,51648,2161,1068,1093
32380,66892,15233,32215,11248,51659,2161,1068,1093
32385,66899,15234,32218,11249,51665,2161,1068,1093
32390,66912,15236,32222,11251,51675,2162,1068,1094
32395,66923,15237,32226,11251,51686,2162,1068,1094
32400,66930,15238,32230,11251,51692,2162,1068,1094
32405,66943,15239,32238,11252,51703,2163,1069,1094
32410,66954,15242,32243,11255,51712,2163,1069,1094
32415,66961,15244,32244,11255,51717,2163,1069,1094
32420,66974,15248,32253,11258,51723,2164,1069,1095
32425,66985,15253,32260,11263,51731,2164,1069,1095
32430,66992,15256,32261,11265,51736,2164,1069,1095
32435,67005,15259,32270,11267,51744,2165,1070,1095
32440,67016,15261,32274,11269,51755,2165,1070,1095
32445,67023,15264,32277,11271,51759,2165,1070,1095
32450,67036,15267,32287,11274,51763,2166,1070,1096
32455,67047,15278,32294,11284,51766,2166,1070,1096
32460,67054,15284,32298,11290,51769,2166,1070,1096
32465,67067,15287,32304,11292,51779,2167,1071,1096
32470,67078,15290,32312,11295,51785,2167,1071,1096
32475,67085,15294,32312,11297,51791,2167,1071,1096
32480,67098,15296,32322,11299,51800,2168,1072,1096
32485,67109,15298,32327,11301,51810,2168,1072,1096
32490,67116,15301,32329,11302,51815,2168,1072,1096
32495,67129,15302,32332,11302,51826,2169,1072,1097
32500,67140,15304,32338,11304,51834,2169,1072,1097
32505,67147,15307,32344,11307,51840,2169,1072,1097
32510,67160,15309,32350,11309,51851,2170,1073,1097
32515,67171,15309,32358,11309,51862,2170,1073,1097
32520,67178,15310,32362,11309,51868,2170,1073,1097
32525,67191,15312,32370,11311,51879,2171,1074,1097
32530,67202,15312,32375,11311,51890,2171,1074,1097
32535,67209,15313,32378,11312,51896,2171,1074,1097
32540,67222,15315,32382,11313,51907,2172,1075,1097
32545,67233,15315,32386,11313,51918,2172,1075,1097
32550,67240,15316,32389,11313,51924,2172,1075,1097
32555,67253,15317,32394,11314,51936,2173,1076,1097
32560,67264,15317,32402,11314,51947,2173,1076,1097
32565,67271,15318,32405,11314,51953,2173,1076,1097
32570,67284,15319,32408,11314,51965,2174,1076,1098
32575,67295,15320,32415,11314,51974,2174,1076,1098
32580,67302,15321,32420,11315,51981,2174,1076,1098
32585,67315,15322,32425,11316,51992,2175,1077,1098
32590,67326,15323,32430,11317,52003,2175,1077,1098
32595,67333,15324,32435,11318,52009,2175,1077,1098
32600,67346,15327,32444,11321,52017,2176,1078,1098
32605,67357,15330,32449,11323,52027,2176,1078,1098
32610,67364,15332,32451,11324,52032,2176,1078,1098
32615,67377,15335,32456,11326,52041,2177,1078,1099
32620,67388,15337,32461,11327,52050,2177,1078,1099
32625,67395,15340,32464,11328,52055,2177,1078,1099
32630,67408,15343,32470,11331,52062,2178,1078,1100
32635,67419,15349,32476,11336,52068,2178,1078,1100
32640,67426,15353,32477,11338,52072,2178,1078,1100
32645,67439,15359,32484,11343,52077,2179,1078,1101
32650,67450,15363,32489,11347,52085,2179,1078,1101
32655,67457,15367,32494,11351,52089,2179,1078,1101
32660,67470,15370,32498,11353,52098,2180,1078,1102
32665,67481,15373,32504,11356,52107,2180,1078,1102
32670,67488,15377,32509,11360,52110,2180,1078,1102
32675,67501,15381,32514,11363,52118,2181,1078,1103
32680,67512,15385,32516,11366,52126,2181,1078,1103
32685,67519,15389,32521,11369,52130,2181,1078,1103
32690,67532,15391,32528,11371,52139,2182,1079,1103
32695,67543,15394,32532,11373,52149,2182,1079,1103
32700,67550,15396,32535,11375,52154,2182,1079,1103
32705,67563,15399,32542,11377,52163,2183,1079,1104
32710,67574,15399,32550,11377,52174,2183,1079,1104
32715,67581,15400,32554,11378,52180,2183,1079,1104
32720,67594,15402,32562,11380,52191,2184,1080,1104
32725,67605,15402,32568,11380,52202,2184,1080,1104
32730,67612,15403,32573,11381,52209,2184,1080,1104
32735,67625,15404,32581,11382,52221,2185,1081,1104
32740,67636,15404,32589,11382,52232,2185,1081,1104
32745,67643,15405,32591,11383,52237,2185,1081,1104
32750,67656,15407,32596,11385,52248,2186,1081,1105
32755,67667,15407,32598,11385,52260,2186,1081,1105
32760,67674,15408,32602,11386,52266,2186,1081,1105
32765,67687,15409,32610,11387,52277,2187,1082,1105
32770,67698,15409,32612,11387,52289,2187,1082,1105
32775,67705,15410,32613,11388,52295,2187,1082,1105
32780,67718,15411,32617,11388,52307,2188,1083,1105
32785,67729,15411,32623,11388,52318,2188,1083,1105
32790,67736,15413,32628,11390,52323,2188,1083,1105
32795,67749,15414,32636,11391,52334,2189,1084,1105
32800,67760,15414,32640,11391,52345,2189,1084,1105
32805,67767,15416,32643,11392,52351,2189,1084,1105
32810,67780,15417,32647,11392,52361,2190,1084,1106
32815,67791,15422,32654,11397,52368,2190,1084,1106
32820,67798,15426,32658,11400,52371,2190,1084,1106
32825,67811,15429,32662,11402,52380,2191,1084,1107
32830,67822,15431,32667,11404,52390,2191,1084,1107
32835,67829,15434,32670,11406,52395,2191,1084,1107
32840,67842,15436,32675,11408,52404,2192,1084,1108
32845,67853,15440,32681,11411,52413,2192,1084,1108
32850,67860,15442,32681,11411,52418,2192,1084,1108
32855,67873,15444,32687,11412,52428,2193,1085,1108
32860,67884,15449,32694,11416,52433,2193,1085,1108
32865,67891,15454,32697,11420,52437,2193,1085,1108
32870,67904,15458,32706,11423,52441,2194,1086,1108
32875,67915,15464,32711,11428,52451,2194,1086,1108
32880,67922,15465,32716,11429,52457,2194,1086,1108
32885,67935,15469,32723,11432,52465,2195,1087,1108
32890,67946,15470,32726,11433,52476,2195,1087,1108
32895,67953,15471,32727,11433,52482,2195,1087,1108
32900,67966,15474,32733,11436,52491,2196,1087,1109
32905,67977,15476,32739,11438,52501,2196,1087,1109
32910,67984,15477,32744,11439,52506,2196,1087,1109
32915,67997,15480,32750,11441,52514,2197,1087,1110
32920,68008,15485,32757,11446,52522,2197,1087,1110
32925,68015,15488,32761,11449,52526,2197,1087,1110
32930,68028,15491,32767,11451,52537,2198,1088,1110
32935,68039,15491,32773,11451,52548,2198,1088,1110
32940,68046,15492,32776,11452,52554,2198,1088,1110
32945,68059,15494,32780,11454,52565,2199,1088,1111
32950,68070,15494,32786,11454,52576,2199,1088,1111
32955,68077,15495,32790,11454,52582,2199,1088,1111
32960,68090,15497,32794,11454,52593,2200,1089,1111
32965,68101,15497,32798,11454,52604,2200,1089,1111
32970,68108,15498,32800,11455,52610,2200,1089,1111
32975,68121,15500,32808,11456,52621,2201,1090,1111
32980,68132,15501,32812,11457,52631,2201,1090,1111
32985,68139,15503,32815,11458,52636,2201,1090,1111
32990,68152,15505,32819,11458,52647,2202,1090,1112
32995,68163,15506,32825,11459,52657,2202,1090,1112
33000,68170,15509,32829,11461,52660,2202,1090,1112
33005,68183,15511,32840,11463,52672,2203,1091,1112
33010,68194,15512,32843,11464,52682,2203,1091,1112
33015,68201,15514,32846,11466,52687,2203,1091,1112
33020,68214,15516,32849,11467,52697,2204,1091,1113
33025,68225,15516,32856,11467,52708,2204,1091,1113
33030,68232,15518,32859,11467,52713,2204,1091,1113
33035,68245,15522,32865,11469,52720,2205,1092,1113
33040,68256,15526,32871,11472,52728,2205,1092,1113
33045,68263,15531,32876,11476,52731,2205,1092,1113
33050,68276,15534,32882,11478,52739,2206,1093,1113
33055,68287,15537,32886,11481,52748,2206,1093,1113
33060,68294,15540,32887,11482,52754,2206,1093,1113
33065,68307,15542,32893,11484,52761,2207,1093,1114
33070,68318,15548,32898,11489,52770,2207,1093,1114
33075,68325,15551,32901,11491,52774,2207,1093,1114
33080,68338,15554,32907,11492,52781,2208,1093,1115
33085,68349,15557,32913,11494,52792,2208,1093,1115
33090,68356,15558,32915,11495,52798,2208,1093,1115
33095,68369,15560,32917,11495,52809,2209,1093,1116
33100,68380,15561,32923,11496,52819,2209,1093,1116
33105,68387,15562,32926,11496,52825,2209,1093,1116
33110,68400,15565,32933,11497,52833,2210,1094,1116
33115,68411,15568,32938,11499,52842,2210,1094,1116
33120,68418,15570,32941,11500,52848,2210,1094,1116
33125,68431,15572,32947,11501,52856,2211,1095,1116
33130,68442,15576,32954,11504,52866,2211,1095,1116
33135,68449,15577,32958,11504,52872,2211,1095,1116
33140,68462,15581,32966,11507,52880,2212,1096,1116
33145,68473,15583,32972,11508,52889,2212,1096,1116
33150,68480,15585,32977,11510,52895,2212,1096,1116
33155,68493,15588,32982,11511,52905,2213,1097,1116
33160,68504,15590,32986,11513,52914,2213,1097,1116
33165,68511,15591,32992,11514,52919,2213,1097,1116
33170,68524,15595,32998,11517,52926,2214,1097,1117
33175,68535,15600,33003,11522,52935,2214,1097,1117
33180,68542,15601,33004,11523,52941,2214,1097,1117
33185,68555,15603,33009,11523,52952,2215,1097,1118
33190,68566,15604,33015,11524,52962,2215,1097,1118
33195,68573,15607,33019,11526,52966,2215,1097,1118
33200,68586,15609,33023,11527,52976,2216,1098,1118
33205,68597,15609,33025,11527,52988,2216,1098,1118
33210,68604,15611,33027,11527,52993,2216,1098,1118
33215,68617,15613,33036,11529,53003,2217,1099,1118
33220,68628,15614,33040,11530,53013,2217,1099,1118
33225,68635,15617,33045,11533,53017,2217,1099,1118
33230,68648,15621,33051,11537,53026,2218,1099,1119
33235,68659,15623,33056,11539,53035,2218,1099,1119
33240,68666,15627,33060,11543,53039,2218,1099,1119
33245,68679,15630,33066,11545,53049,2219,1099,1120
33250,68690,15632,33070,11547,53057,2219,1099,1120
33255,68697,15637,33075,11551,53059,2219,1099,1120
33260,68710,15640,33084,11554,53067,2220,1099,1121
33265,68721,15641,33089,11555,53080,2220,1099,1121
33270,68728,15642,33094,11556,53086,2220,1099,1121
33275,68741,15644,33100,11557,53096,2221,1100,1121
33280,68752,15644,33106,11557,53108,2221,1100,1121
33285,68759,15645,33109,11557,53114,2221,1100,1121
33290,68772,15647,33115,11558,53123,2222,1100,1122
33295,68783,15650,33121,11561,53133,2222,1100,1122
33300,68790,15651,33121,11561,53139,2222,1100,1122
33305,68803,15653,33129,11563,53147,2223,1100,1123
33310,68814,15656,33133,11565,53158,2223,1100,1123
33315,68821,15657,33138,11566,53164,2223,1100,1123
33320,68834,15659,33144,11566,53172,2224,1101,1123
33325,68845,15663,33149,11569,53182,2224,1101,1123
33330,68852,15664,33151,11570,53188,2224,1101,1123
33335,68865,15666,33155,11570,53199,2225,1102,1123
33340,68876,15668,33160,11572,53208,2225,1102,1123
33345,68883,15669,33163,11572,53214,2225,1102,1123
33350,68896,15672,33169,11574,53223,2226,1102,1124
33355,68907,15675,33176,11577,53230,2226,1102,1124
33360,68914,15679,33180,11581,53234,2226,1102,1124
33365,68927,15682,33185,11583,53243,2227,1103,1124
33370,68938,15687,33188,11587,53250,2227,1103,1124
33375,68945,15692,33191,11590,53253,2227,1103,1124
33380,68958,15694,33198,11591,53264,2228,1104,1124
33385,68969,15694,33201,11591,53274,2228,1104,1124
33390,68976,15697,33201,11592,53279,2228,1104,1124
33395,68989,15699,33208,11593,53288,2229,1104,1125
33400,69000,15703,33214,11597,53296,2229,1104,1125
33405,69007,15707,33217,11600,53299,2229,1104,1125
33410,69020,15710,33221,11601,53309,2230,1104,1126
33415,69031,15713,33223,11604,53318,2230,1104,1126
33420,69038,15716,33225,11606,53322,2230,1104,1126
33425,69051,15718,33232,11606,53331,2231,1104,1127
33430,69062,15722,33237,11610,53340,2231,1104,1127
33435,69069,15724,33238,11611,53345,2231,1104,1127
33440,69082,15727,33243,11614,53355,2232,1105,1127
33445,69093,15728,33247,11615,53365,2232,1105,1127
33450,69100,15729,33249,11615,53371,2232,1105,1127
33455,69113,15731,33255,11617,53382,2233,1106,1127
33460,69124,15731,33259,11617,53393,2233,1106,1127
33465,69131,15732,33261,11617,53399,2233,1106,1127
33470,69144,15734,33271,11619,53409,2234,1107,1127
33475,69155,15734,33280,11619,53421,2234,1107,1127
33480,69162,15735,33283,11620,53427,2234,1107,1127
33485,69175,15738,33288,11621,53436,2235,1107,1128
33490,69186,15739,33292,11622,53447,2235,1107,1128
33495,69193,15740,33295,11623,53453,2235,1107,1128
33500,69206,15742,33301,11624,53463,2236,1107,1129
33505,69217,15744,33306,11625,53473,2236,1107,1129
33510,69224,15745,33311,11626,53479,2236,1107,1129
33515,69237,15748,33319,11628,53487,2237,1108,1129
33520,69248,15750,33325,11630,53498,2237,1108,1129
33525,69255,15751,33327,11630,53504,2237,1108,1129
33530,69268,15754,33334,11633,53511,2238,1108,1130
33535,69279,15756,33339,11634,53523,2238,1108,1130
33540,69286,15757,33339,11634,53529,2238,1108,1130
33545,69299,15760,33345,11636,53538,2239,1108,1131
33550,69310,15762,33348,11638,53547,2239,1108,1131
33555,69317,15766,33351,11641,53551,2239,1108,1131
33560,69330,15770,33357,11643,53558,2240,1109,1131
33565,69341,15774,33364,11647,53567,2240,1109,1131
33570,69348,15777,33369,11649,53571,2240,1109,1131
33575,69361,15781,33374,11651,53579,2241,1109,1132
33580,69372,15785,33381,11655,53586,2241,1109,1132
33585,69379,15789,33383,11657,53589,2241,1109,1132
33590,69392,15793,33387,11660,53598,2242,1109,1133
33595,69403,15798,33394,11665,53603,2242,1109,1133
33600,69410,15803,33397,11668,53606,2242,1109,1133
33605,69423,15807,33401,11671,53615,2243,1110,1133
33610,69434,15811,33406,11674,53623,2243,1110,1133
33615,69441,15812,33408,11675,53629,2243,1110,1133
33620,69454,15815,33415,11677,53637,2244,1110,1134
33625,69465,15817,33417,11679,53648,2244,1110,1134
33630,69472,15818,33422,11680,53654,2244,1110,1134
33635,69485,15820,33427,11681,53663,2245,1110,1135
33640,69496,15822,33434,11682,53672,2245,1110,1135
33645,69503,15825,33438,11685,53677,2245,1110,1135
33650,69516,15829,33447,11688,53686,2246,1111,1135
33655,69527,15829,33452,11688,53698,2246,1111,1135
33660,69534,15830,33455,11688,53703,2246,1111,1135
33665,69547,15832,33457,11688,53714,2247,1111,1136
33670,69558,15832,33463,11688,53725,2247,1111,1136
33675,69565,15833,33467,11688,53732,2247,1111,1136
33680,69578,15835,33473,11690,53742,2248,1112,1136
33685,69589,15835,33479,11690,53753,2248,1112,1136
33690,69596,15836,33481,11690,53760,2248,1112,1136
33695,69609,15838,33484,11691,53770,2249,1112,1137
33700,69620,15838,33488,11691,53782,2249,1112,1137
33705,69627,15839,33490,11691,53788,2249,1112,1137
33710,69640,15841,33498,11693,53798,2250,1113,1137
33715,69651,15842,33503,11694,53809,2250,1113,1137
33720,69658,15844,33506,11694,53814,2250,1113,1137
33725,69671,15846,33512,11694,53824,2251,1114,1137
33730,69682,15848,33519,11696,53834,2251,1114,1137
33735,69689,15851,33522,11698,53838,2251,1114,1137
33740,69702,15853,33528,11699,53849,2252,1114,1138
33745,69713,15855,33535,11701,53858,2252,1114,1138
33750,69720,15857,33538,11703,53863,2252,1114,1138
33755,69733,15860,33543,11704,53869,2253,1114,1139
33760,69744,15864,33547,11708,53880,2253,1114,1139
33765,69751,15866,33552,11710,53884,2253,1114,1139
33770,69764,15869,33559,11712,53891,2254,1115,1139
33775,69775,15873,33562,11715,53901,2254,1115,1139
33780,69782,15877,33567,11718,53904,2254,1115,1139
33785,69795,15880,33573,11720,53914,2255,1116,1139
33790,69806,15883,33578,11722,53921,2255,1116,1139
33795,69813,15886,33582,11725,53927,2255,1116,1139
33800,69826,15889,33588,11726,53935,2256,1117,1139
33805,69837,15891,33591,11727,53946,2256,1117,1139
33810,69844,15892,33594,11728,53952,2256,1117,1139
33815,69857,15895,33603,11731,53959,2257,1118,1139
33820,69868,15898,33604,11733,53970,2257,1118,1139
33825,69875,15899,33609,11734,53975,2257,1118,1139
33830,69888,15904,33614,11738,53983,2258,1118,1140
33835,69899,15908,33621,11741,53989,2258,1118,1140
33840,69906,15911,33626,11744,53995,2258,1118,1140
33845,69919,15915,33634,11747,54003,2259,1119,1140
33850,69930,15917,33638,11748,54012,2259,1119,1140
33855,69937,15919,33641,11749,54017,2259,1119,1140
33860,69950,15921,33649,11751,54029,2260,1120,1140
33865,69961,15921,33654,11751,54040,2260,1120,1140
33870,69968,15922,33657,11751,54045,2260,1120,1140
33875,69981,15924,33666,11752,54057,2261,1120,1141
33880,69992,15924,33674,11752,54068,2261,1120,1141
33885,69999,15925,33678,11753,54074,2261,1120,1141
33890,70012,15927,33685,11755,54085,2262,1120,1142
33895,70023,15927,33688,11755,54096,2262,1120,1142
33900,70030,15929,33691,11756,54101,2262,1120,1142
33905,70043,15931,33696,11757,54112,2263,1120,1143
33910,70054,15933,33705,11759,54121,2263,1120,1143
33915,70061,15936,33708,11761,54125,2263,1120,1143
33920,70074,15938,33715,11762,54136,2264,1121,1143
33925,70085,15939,33719,11763,54146,2264,1121,1143
33930,70092,15941,33723,11763,54151,2264,1121,1143
33935,70105,15943,33731,11763,54162,2265,1121,1144
33940,70116,15944,33736,11764,54172,2265,1121,1144
33945,70123,15946,33738,11764,54177,2265,1121,1144
33950,70136,15949,33744,11765,54184,2266,1121,1145
33955,70147,15953,33751,11769,54192,2266,1121,1145
33960,70154,15956,33753,11771,54197,2266,1121,1145
33965,70167,15960,33761,11774,54203,2267,1121,1146
33970,70178,15965,33767,11779,54213,2267,1121,1146
33975,70185,15969,33770,11781,54216,2267,1121,1146
33980,70198,15971,33775,11783,54225,2268,1122,1146
33985,70209,15972,33779,11783,54237,2268,1122,1146
33990,70216,15973,33781,11783,54243,2268,1122,1146
33995,70229,15976,33789,11785,54251,2269,1122,1147
34000,70240,15978,33794,11786,54262,2269,1122,1147
34005,70247,15979,33798,11786,54268,2269,1122,1147
34010,70260,15981,33804,11786,54277,2270,1123,1147
34015,70271,15983,33806,11787,54288,2270,1123,1147
34020,70278,15984,33808,11788,54294,2270,1123,1147
34025,70291,15987,33813,11791,54303,2271,1123,1148
34030,70302,15989,33817,11793,54312,2271,1123,1148
34035,70309,15991,33821,11795,54318,2271,1123,1148
34040,70322,15993,33826,11796,54327,2272,1123,1149
34045,70333,15996,33830,11798,54337,2272,1123,1149
34050,70340,15997,33834,11798,54343,2272,1123,1149
34055,70353,16000,33838,11799,54352,2273,1123,1150
34060,70364,16002,33844,11801,54362,2273,1123,1150
34065,70371,16003,33848,11802,54368,2273,1123,1150
34070,70384,16006,33855,11804,54376,2274,1124,1150
34075,70395,16012,33860,11809,54383,2274,1124,1150
34080,70402,16014,33864,11811,54387,2274,1124,1150
34085,70415,16017,33868,11813,54396,2275,1124,1151
34090,70426,16022,33873,11818,54404,2275,1124,1151
34095,70433,16024,33875,11818,54409,2275,1124,1151
34100,70446,16026,33882,11820,54420,2276,1125,1151
34105,70457,16028,33890,11822,54429,2276,1125,1151
34110,70464,16030,33891,11822,54434,2276,1125,1151
34115,70477,16032,33898,11823,54443,2277,1125,1152
34120,70488,16032,33902,11823,54455,2277,1125,1152
34125,70495,16035,33907,11826,54459,2277,1125,1152
34130,70508,16038,33911,11827,54468,2278,1125,1153
34135,70519,16041,33917,11830,54477,2278,1125,1153
34140,70526,16044,33919,11832,54482,2278,1125,1153
34145,70539,16047,33927,11834,54490,2279,1125,1154
34150,70550,16047,33934,11834,54501,2279,1125,1154
34155,70557,16051,33937,11837,54505,2279,1125,1154
34160,70570,16054,33945,11839,54514,2280,1126,1154
34165,70581,16055,33950,11840,54524,2280,1126,1154
34170,70588,16059,33952,11843,54529,2280,1126,1154
34175,70601,16062,33960,11845,54537,2281,1127,1154
34180,70612,16063,33966,11846,54548,2281,1127,1154
34185,70619,16066,33969,11849,54552,2281,1127,1154
34190,70632,16069,33974,11852,54562,2282,1128,1154
34195,70643,16069,33977,11852,54574,2282,1128,1154
34200,70650,16070,33981,11852,54580,2282,1128,1154
34205,70663,16072,33985,11852,54590,2283,1128,1155
34210,70674,16073,33989,11853,54601,2283,1128,1155
34215,70681,16074,33993,11854,54607,2283,1128,1155
34220,70694,16076,33996,11854,54618,2284,1129,1155
34225,70705,16077,34003,11855,54628,2284,1129,1155
34230,70712,16078,34006,11855,54634,2284,1129,1155
34235,70725,16081,34010,11858,54643,2285,1129,1156
34240,70736,16083,34015,11860,54652,2285,1129,1156
34245,70743,16085,34018,11862,54658,2285,1129,1156
34250,70756,16088,34023,11864,54667,2286,1129,1157
34255,70767,16090,34028,11865,54676,2286,1129,1157
34260,70774,16092,34032,11867,54682,2286,1129,1157
34265,70787,16095,34039,11869,54689,2287,1129,1158
34270,70798,16098,34043,11872,54700,2287,1129,1158
34275,70805,16099,34046,11873,54706,2287,1129,1158
34280,70818,16102,34052,11874,54716,2288,1130,1158
34285,70829,16103,34059,11875,54725,2288,1130,1158
34290,70836,16106,34064,11877,54729,2288,1130,1158
34295,70849,16111,34072,11880,54736,2289,1131,1158
34300,70860,16117,34078,11885,54743,2289,1131,1158
34305,70867,16120,34083,11888,54747,2289,1131,1158
34310,70880,16124,34090,11891,54754,2290,1132,1158
34315,70891,16131,34095,11897,54759,2290,1132,1158
34320,70898,16137,34100,11902,54760,2290,1132,1158
34325,70911,16140,34104,11903,54770,2291,1133,1158
34330,70922,16143,34108,11906,54779,2291,1133,1158
34335,70929,16145,34112,11907,54782,2291,1133,1158
34340,70942,16149,34121,11910,54791,2292,1133,1159
34345,70953,16150,34124,11911,54803,2292,1133,1159
34350,70960,16151,34129,11912,54809,2292,1133,1159
34355,70973,16153,34135,11913,54819,2293,1134,1159
34360,70984,16153,34142,11913,54831,2293,1134,1159
34365,70991,16154,34145,11913,54836,2293,1134,1159
34370,71004,16156,34152,11914,54848,2294,1135,1159
34375,71015,16156,34155,11914,54859,2294,1135,1159
34380,71022,16157,34158,11915,54865,2294,1135,1159
34385,71035,16159,34164,11917,54876,2295,1135,1160
34390,71046,16159,34170,11917,54887,2295,1135,1160
34395,71053,16160,34174,11918,54893,2295,1135,1160
34400,71066,16162,34180,11919,54904,2296,1136,1160
34405,71077,16162,34185,11919,54914,2296,1136,1160
34410,71084,16163,34187,11919,54921,2296,1136,1160
34415,71097,16165,34191,11919,54931,2297,1136,1161
34420,71108,16165,34196,11919,54942,2297,1136,1161
34425,71115,16166,34199,11919,54949,2297,1136,1161
34430,71128,16168,34206,11921,54960,2298,1137,1161
34435,71139,16169,34213,11921,54970,2298,1137,1161
34440,71146,16170,34218,11922,54976,2298,1137,1161
34445,71159,16173,34227,11924,54984,2299,1137,1162
34450,71170,16177,34232,11928,54993,2299,1137,1162
34455,71177,16180,34237,11930,54997,2299,1137,1162
34460,71190,16182,34241,11932,55007,2300,1137,1163
34465,71201,16184,34247,11934,55015,2300,1137,1163
34470,71208,16190,34252,11940,55018,2300,1137,1163
34475,71221,16192,34260,11942,55027,2301,1138,1163
34480,71232,16195,34265,11945,55035,2301,1138,1163
34485,71239,16199,34265,11947,55040,2301,1138,1163
34490,71252,16202,34271,11950,55048,2302,1138,1164
34495,71263,16208,34280,11956,55053,2302,1138,1164
34500,71270,16213,34284,11960,55057,2302,1138,1164
34505,71283,16217,34292,11963,55063,2303,1138,1165
34510,71294,16220,34297,11965,55073,2303,1138,1165
34515,71301,16222,34301,11966,55079,2303,1138,1165
34520,71314,16224,34306,11968,55089,2304,1138,1166
34525,71325,16226,34311,11970,55098,2304,1138,1166
34530,71332,16228,34315,11972,55103,2304,1138,1166
34535,71345,16232,34320,11975,55112,2305,1139,1166
34540,71356,16237,34327,11979,55117,2305,1139,1166
34545,71363,16241,34333,11983,55121,2305,1139,1166
34550,71376,16245,34338,11986,55130,2306,1140,1166
34555,71387,16245,34343,11986,55141,2306,1140,1166
34560,71394,16246,34344,11986,55148,2306,1140,1166
34565,71407,16248,34350,11988,55159,2307,1140,1167
34570,71418,16248,34352,11988,55170,2307,1140,1167
34575,71425,16249,34354,11988,55176,2307,1140,1167
34580,71438,16251,34361,11988,55185,2308,1141,1167
34585,71449,16251,34364,11988,55198,2308,1141,1167
34590,71456,16252,34369,11989,55204,2308,1141,1167
34595,71469,16254,34376,11991,55214,2309,1141,1168
34600,71480,16254,34379,11991,55225,2309,1141,1168
34605,71487,16256,34382,11992,55231,2309,1141,1168
34610,71500,16258,34389,11993,55241,2310,1142,1168
34615,71511,16259,34394,11994,55252,2310,1142,1168
34620,71518,16262,34400,11996,55256,2310,1142,1168
34625,71531,16264,34408,11998,55266,2311,1142,1169
34630,71542,16264,34412,11998,55278,2311,1142,1169
34635,71549,16266,34414,11999,55283,2311,1142,1169
34640,71562,16268,34422,12000,55294,2312,1143,1169
34645,71573,16270,34427,12002,55303,2312,1143,1169
34650,71580,16273,34431,12004,55307,2312,1143,1169
34655,71593,16275,34434,12004,55317,2313,1143,1170
34660,71604,16277,34440,12005,55327,2313,1143,1170
34665,71611,16280,34447,12008,55330,2313,1143,1170
34670,71624,16285,34454,12012,55337,2314,1144,1170
34675,71635,16288,34458,12015,55346,2314,1144,1170
34680,71642,16292,34461,12018,55349,2314,1144,1170
34685,71655,16296,34466,12020,55356,2315,1145,1170
34690,71666,16299,34471,12022,55366,2315,1145,1170
34695,71673,16302,34473,12023,55371,2315,1145,1170
34700,71686,16306,34480,12026,55377,2316,1146,1170
34705,71697,16311,34485,12030,55385,2316,1146,1170
34710,71704,16314,34487,12032,55390,2316,1146,1170
34715,71717,16318,34493,12036,55398,2317,1146,1171
34720,71728,16320,34498,12037,55407,2317,1146,1171
34725,71735,16324,34501,12041,55411,2317,1146,1171
34730,71748,16327,34506,12043,55419,2318,1147,1171
34735,71759,16330,34508,12045,55428,2318,1147,1171
34740,71766,16333,34512,12048,55432,2318,1147,1171
34745,71779,16337,34517,12050,55440,2319,1148,1171
34750,71790,16341,34524,12054,55448,2319,1148,1171
34755,71797,16342,34528,12055,55455,2319,1148,1171
34760,71810,16344,34532,12055,55464,2320,1148,1172
34765,71821,16344,34537,12055,55476,2320,1148,1172
34770,71828,16345,34541,12056,55483,2320,1148,1172
34775,71841,16347,34547,12057,55492,2321,1148,1173
34780,71852,16347,34551,12057,55504,2321,1148,1173
34785,71859,16348,34554,12057,55511,2321,1148,1173
34790,71872,16350,34562,12058,55521,2322,1149,1173
34795,71883,16350,34568,12058,55533,2322,1149,1173
34800,71890,16351,34571,12059,55539,2322,1149,1173
34805,71903,16353,34578,12059,55550,2323,1149,1174
34810,71914,16353,34583,12059,55561,2323,1149,1174
34815,71921,16354,34586,12060,55567,2323,1149,1174
34820,71934,16356,34593,12060,55578,2324,1150,1174
34825,71945,16356,34596,12060,55589,2324,1150,1174
34830,71952,16357,34600,12060,55595,2324,1150,1174
34835,71965,16359,34606,12061,55606,2325,1150,1175
34840,71976,16360,34614,12062,55616,2325,1150,1175
34845,71983,16363,34619,12064,55620,2325,1150,1175
34850,71996,16365,34622,12065,55631,2326,1150,1176
34855,72007,16366,34626,12066,55641,2326,1150,1176
34860,72014,16368,34630,12068,55646,2326,1150,1176
34865,72027,16370,34633,12068,55656,2327,1151,1176
34870,72038,16373,34638,12070,55665,2327,1151,1176
34875,72045,16377,34643,12074,55668,2327,1151,1176
34880,72058,16380,34646,12075,55676,2328,1151,1177
34885,72069,16383,34650,12077,55685,2328,1151,1177
34890,72076,16387,34652,12079,55688,2328,1151,1177
34895,72089,16393,34662,12083,55692,2329,1152,1177
34900,72100,16398,34667,12087,55700,2329,1152,1177
34905,72107,16403,34671,12091,55704,2329,1152,1177
34910,72120,16405,34675,12091,55711,2330,1152,1178
34915,72131,16414,34682,12100,55715,2330,1152,1178
34920,72138,16417,34684,12102,55721,2330,1152,1178
34925,72151,16420,34689,12103,55730,2331,1153,1178
34930,72162,16423,34695,12105,55739,2331,1153,1178
34935,72169,16425,34698,12106,55744,2331,1153,1178
34940,72182,16429,34706,12109,55751,2332,1154,1178
34945,72193,16431,34711,12111,55761,2332,1154,1178
34950,72200,16433,34715,12112,55766,2332,1154,1178
34955,72213,16435,34722,12113,55778,2333,1154,1179
34960,72224,16435,34726,12113,55789,2333,1154,1179
34965,72231,16436,34728,12113,55795,2333,1154,1179
34970,72244,16438,34736,12115,55806,2334,1155,1179
34975,72255,16438,34741,12115,55817,2334,1155,1179
34980,72262,16439,34745,12115,55822,2334,1155,1179
34985,72275,16441,34750,12116,55834,2335,1156,1179
34990,72286,16441,34757,12116,55845,2335,1156,1179
34995,72293,16442,34760,12117,55851,2335,1156,1179
35000,72306,16444,34769,12117,55862,2336,1156,1180
35005,72317,16444,34778,12117,55873,2336,1156,1180
35010,72324,16445,34782,12117,55879,2336,1156,1180
35015,72337,16447,34788,12117,55890,2337,1157,1180
35020,72348,16447,34792,12117,55901,2337,1157,1180
35025,72355,16449,34794,12118,55906,2337,1157,1180
35030,72368,16451,34798,12118,55916,2338,1158,1180
35035,72379,16453,34807,12120,55926,2338,1158,1180
35040,72386,16456,34811,12122,55930,2338,1158,1180
35045,72399,16458,34817,12124,55941,2339,1159,1180
35050,72410,16458,34823,12124,55952,2339,1159,1180
35055,72417,16460,34826,12126,55957,2339,1159,1180
35060,72430,16463,34834,12128,55963,2340,1160,1180
35065,72441,16467,34837,12131,55972,2340,1160,1180
35070,72448,16471,34841,12134,55977,2340,1160,1180
35075,72461,16473,34848,12135,55983,2341,1160,1181
35080,72472,16478,34855,12140,55993,2341,1160,1181
35085,72479,16482,34860,12144,55997,2341,1160,1181
35090,72492,16485,34866,12146,56006,2342,1161,1181
35095,72503,16488,34872,12148,56014,2342,1161,1181
35100,72510,16492,34875,12152,56018,2342,1161,1181
35105,72523,16496,34885,12155,56022,2343,1161,1182
35110,72534,16501,34891,12159,56032,2343,1161,1182
35115,72541,16503,34894,12160,56038,2343,1161,1182
35120,72554,16506,34900,12162,56045,2344,1161,1183
35125,72565,16509,34906,12165,56055,2344,1161,1183
35130,72572,16511,34909,12167,56061,2344,1161,1183
35135,72585,16514,34912,12169,56070,2345,1161,1184
35140,72596,16517,34917,12172,56078,2345,1161,1184
35145,72603,16519,34920,12173,56084,2345,1161,1184
35150,72616,16522,34927,12175,56094,2346,1162,1184
35155,72627,16523,34929,12175,56104,2346,1162,1184
35160,72634,16524,34931,12175,56110,2346,1162,1184
35165,72647,16528,34941,12179,56118,2347,1163,1184
35170,72658,16530,34946,12181,56128,2347,1163,1184
35175,72665,16531,34950,12182,56134,2347,1163,1184
35180,72678,16535,34955,12185,56143,2348,1163,1185
35185,72689,16537,34962,12186,56151,2348,1163,1185
35190,72696,16538,34967,12187,56157,2348,1163,1185
35195,72709,16540,34975,12189,56168,2349,1163,1186
35200,72720,16540,34982,12189,56179,2349,1163,1186
35205,72727,16541,34985,12189,56186,2349,1163,1186
35210,72740,16543,34995,12190,56195,2350,1164,1186
35215,72751,16544,35001,12191,56207,2350,1164,1186
35220,72758,16547,35004,12193,56211,2350,1164,1186
35225,72771,16549,35010,12194,56222,2351,1165,1186
35230,72782,16550,35020,12195,56230,2351,1165,1186
35235,72789,16555,35026,12200,56233,2351,1165,1186
35240,72802,16559,35032,12203,56241,2352,1165,1187
35245,72813,16563,35037,12207,56250,2352,1165,1187
35250,72820,16566,35040,12209,56254,2352,1165,1187
35255,72833,16568,35046,12211,56264,2353,1166,1187
35260,72844,16572,35053,12215,56272,2353,1166,1187
35265,72851,16573,35057,12215,56278,2353,1166,1187
35270,72864,16575,35062,12215,56288,2354,1167,1187
35275,72875,16575,35069,12215,56300,2354,1167,1187
35280,72882,16576,35070,12215,56306,2354,1167,1187
35285,72895,16578,35076,12215,56316,2355,1167,1188
35290,72906,16578,35082,12215,56328,2355,1167,1188
35295,72913,16579,35085,12216,56334,2355,1167,1188
35300,72926,16582,35094,12219,56344,2356,1168,1188
35305,72937,16583,35100,12220,56354,2356,1168,1188
35310,72944,16584,35102,12220,56360,2356,1168,1188
35315,72957,16587,35106,12221,56368,2357,1168,1189
35320,72968,16590,35110,12224,56378,2357,1168,1189
35325,72975,16591,35113,12225,56384,2357,1168,1189
35330,72988,16595,35120,12227,56391,2358,1168,1190
35335,72999,16597,35126,12229,56402,2358,1168,1190
35340,73006,16598,35129,12229,56408,2358,1168,1190
35345,73019,16600,35133,12230,56417,2359,1169,1190
35350,73030,16602,35136,12232,56428,2359,1169,1190
35355,73037,16603,35141,12232,56434,2359,1169,1190
35360,73050,16606,35150,12235,56442,2360,1170,1190
35365,73061,16610,35158,12239,56450,2360,1170,1190
35370,73068,16613,35160,12242,56455,2360,1170,1190
35375,73081,16616,35165,12243,56464,2361,1171,1190
35380,73092,16618,35168,12244,56472,2361,1171,1190
35385,73099,16624,35173,12250,56475,2361,1171,1190
35390,73112,16627,35177,12251,56484,2362,1171,1191
35395,73123,16632,35184,12256,56489,2362,1171,1191
35400,73130,16637,35187,12261,56493,2362,1171,1191
35405,73143,16639,35194,12261,56503,2363,1172,1191
35410,73154,16641,35198,12263,56512,2363,1172,1191
35415,73161,16645,35201,12265,56514,2363,1172,1191
35420,73174,16649,35210,12269,56524,2364,1173,1191
35425,73185,16651,35215,12271,56533,2364,1173,1191
35430,73192,16655,35217,12273,56536,2364,1173,1191
35435,73205,16657,35224,12274,56547,2365,1174,1191
35440,73216,16659,35228,12276,56557,2365,1174,1191
35445,73223,16662,35232,12278,56561,2365,1174,1191
35450,73236,16664,35237,12279,56572,2366,1175,1191
35455,73247,16666,35244,12281,56580,2366,1175,1191
35460,73254,16668,35247,12282,56586,2366,1175,1191
35465,73267,16670,35253,12283,56597,2367,1175,1192
35470,73278,16670,35260,12283,56608,2367,1175,1192
35475,73285,16671,35262,12283,56614,2367,1175,1192
35480,73298,16673,35267,12284,56625,2368,1175,1193
35485,73309,16673,35272,12284,56636,2368,1175,1193
35490,73316,16674,35277,12285,56642,2368,1175,1193
35495,73329,16676,35281,12286,56653,2369,1175,1194
35500,73340,16676,35288,12286,56664,2369,1175,1194
35505,73347,16677,35293,12286,56670,2369,1175,1194
35510,73360,16679,35300,12287,56678,2370,1176,1194
35515,73371,16682,35305,12289,56688,2370,1176,1194
35520,73378,16683,35308,12289,56695,2370,1176,1194
35525,73391,16685,35315,12290,56704,2371,1177,1194
35530,73402,16687,35320,12292,56715,2371,1177,1194
35535,73409,16688,35323,12293,56721,2371,1177,1194
35540,73422,16690,35326,12293,56730,2372,1177,1195
35545,73433,16692,35330,12295,56740,2372,1177,1195
35550,73440,16694,35335,12297,56746,2372,1177,1195
35555,73453,16697,35342,12299,56754,2373,1178,1195
35560,73464,16699,35347,12300,56765,2373,1178,1195
35565,73471,16701,35351,12301,56770,2373,1178,1195
35570,73484,16705,35358,12303,56776,2374,1178,1196
35575,73495,16711,35365,12309,56783,2374,1178,1196
35580,73502,16714,35369,12311,56788,2374,1178,1196
35585,73515,16717,35375,12314,56798,2375,1179,1196
35590,73526,16720,35381,12317,56805,2375,1179,1196
35595,73533,16723,35383,12320,56810,2375,1179,1196
35600,73546,16727,35394,12324,56815,2376,1180,1196
35605,73557,16734,35401,12331,56822,2376,1180,1196
35610,73564,16738,35404,12334,56826,2376,1180,1196
35615,73577,16740,35410,12336,56835,2377,1181,1196
35620,73588,16745,35416,12341,56841,2377,1181,1196
35625,73595,16750,35420,12346,56844,2377,1181,1196
35630,73608,16755,35427,12351,56851,2378,1182,1196
35635,73619,16761,35434,12356,56858,2378,1182,1196
35640,73626,16762,35437,12356,56863,2378,1182,1196
35645,73639,16764,35445,12357,56872,2379,1183,1196
35650,73650,16764,35450,12357,56886,2379,1183,1196
35655,73657,16765,35454,12358,56891,2379,1183,1196
35660,73670,16767,35462,12360,56901,2380,1183,1197
35665,73681,16767,35469,12360,56913,2380,1183,1197
35670,73688,16768,35471,12360,56920,2380,1183,1197
35675,73701,16770,35475,12360,56930,2381,1183,1198
35680,73712,16770,35478,12360,56942,2381,1183,1198
35685,73719,16771,35481,12361,56948,2381,1183,1198
35690,73732,16773,35486,12362,56959,2382,1184,1198
35695,73743,16773,35492,12362,56969,2382,1184,1198
35700,73750,16774,35494,12362,56976,2382,1184,1198
35705,73763,16776,35500,12363,56986,2383,1184,1199
35710,73774,16776,35503,12363,56998,2383,1184,1199
35715,73781,16777,35505,12363,57004,2383,1184,1199
35720,73794,16779,35513,12364,57014,2384,1185,1199
35725,73805,16779,35520,12364,57026,2384,1185,1199
35730,73812,16780,35524,12364,57032,2384,1185,1199
35735,73825,16782,35530,12366,57043,2385,1186,1199
35740,73836,16783,35537,12367,57053,2385,1186,1199
35745,73843,16785,35539,12368,57058,2385,1186,1199
35750,73856,16788,35545,12370,57066,2386,1187,1199
35755,73867,16790,35548,12372,57077,2386,1187,1199
35760,73874,16792,35549,12372,57082,2386,1187,1199
35765,73887,16796,35560,12376,57090,2387,1188,1199
35770,73898,16799,35565,12378,57097,2387,1188,1199
35775,73905,16804,35567,12381,57101,2387,1188,1199
35780,73918,16808,35573,12385,57109,2388,1189,1199
35785,73929,16811,35579,12388,57116,2388,1189,1199
35790,73936,16817,35584,12393,57118,2388,1189,1199
35795,73949,16822,35588,12397,57126,2389,1189,1200
35800,73960,16825,35593,12399,57133,2389,1189,1200
35805,73967,16829,35595,12401,57138,2389,1189,1200
35810,73980,16832,35600,12403,57146,2390,1189,1201
35815,73991,16839,35606,12410,57151,2390,1189,1201
35820,73998,16844,35611,12415,57154,2390,1189,1201
35825,74011,16848,35616,12418,57163,2391,1189,1202
35830,74022,16850,35621,12420,57172,2391,1189,1202
35835,74029,16851,35626,12421,57178,2391,1189,1202
35840,74042,16853,35635,12423,57188,2392,1190,1202
35845,74053,16853,35638,12423,57200,2392,1190,1202
35850,74060,16854,35642,12424,57206,2392,1190,1202
35855,74073,16856,35649,12424,57216,2393,1191,1202
35860,74084,16856,35657,12424,57228,2393,1191,1202
35865,74091,16857,35660,12424,57234,2393,1191,1202
35870,74104,16859,35665,12424,57244,2394,1192,1202
35875,74115,16859,35668,12424,57256,2394,1192,1202
35880,74122,16860,35671,12424,57262,2394,1192,1202
35885,74135,16862,35676,12424,57272,2395,1193,1202
35890,74146,16862,35679,12424,57284,2395,1193,1202
35895,74153,16863,35683,12424,57290,2395,1193,1202
35900,74166,16865,35691,12426,57299,2396,1193,1203
35905,74177,16865,35698,12426,57311,2396,1193,1203
35910,74184,16866,35701,12426,57318,2396,1193,1203
35915,74197,16868,35707,12426,57328,2397,1193,1204
35920,74208,16868,35711,12426,57340,2397,1193,1204
35925,74215,16869,35714,12427,57346,2397,1193,1204
35930,74228,16871,35719,12428,57355,2398,1193,1205
35935,74239,16875,35722,12431,57364,2398,1193,1205
35940,74246,16878,35726,12433,57368,2398,1193,1205
35945,74259,16880,35731,12433,57377,2399,1194,1205
35950,74270,16883,35737,12436,57387,2399,1194,1205
35955,74277,16885,35738,12436,57392,2399,1194,1205
35960,74290,16888,35746,12438,57399,2400,1194,1206
35965,74301,16892,35748,12441,57409,2400,1194,1206
35970,74308,16894,35749,12441,57414,2400,1194,1206
35975,74321,16897,35755,12442,57420,2401,1194,1207
35980,74332,16902,35759,12447,57429,2401,1194,1207
35985,74339,16905,35762,12449,57434,2401,1194,1207
35990,74352,16908,35770,12452,57441,2402,1194,1208
35995,74363,16913,35776,12457,57449,2402,1194,1208
36000,74370,16917,35780,12460,57452,2402,1194,1208
36005,74383,16922,35790,12465,57458,2403,1194,1209
36010,74394,16926,35796,12468,57467,2403,1194,1209
36015,74401,16929,35797,12470,57472,2403,1194,1209
36020,74414,16933,35804,12473,57480,2404,1195,1209
36025,74425,16935,35810,12475,57489,2404,1195,1209
36030,74432,16937,35814,12477,57495,2404,1195,1209
36035,74445,16940,35820,12480,57504,2405,1195,1210
36040,74456,16943,35829,12483,57512,2405,1195,1210
36045,74463,16946,35834,12485,57516,2405,1195,1210
36050,74476,16950,35839,12487,57523,2406,1195,1211
36055,74487,16953,35848,12490,57533,2406,1195,1211
36060,74494,16954,35852,12491,57540,2406,1195,1211
36065,74507,16956,35856,12491,57550,2407,1196,1211
36070,74518,16956,35863,12491,57562,2407,1196,1211
36075,74525,16957,35867,12491,57568,2407,1196,1211
36080,74538,16958,35872,12491,57578,2408,1197,1211
36085,74549,16958,35879,12491,57591,2408,1197,1211
36090,74556,16959,35881,12492,57597,2408,1197,1211
36095,74569,16960,35886,12493,57608,2409,1198,1211
36100,74580,16960,35890,12493,57620,2409,1198,1211
36105,74587,16961,35895,12494,57626,2409,1198,1211
36110,74600,16962,35899,12494,57636,2410,1198,1212
36115,74611,16962,35903,12494,57648,2410,1198,1212
36120,74618,16963,35907,12494,57655,2410,1198,1212
36125,74631,16965,35912,12495,57664,2411,1198,1213
36130,74642,16968,35916,12498,57674,2411,1198,1213
36135,74649,16972,35921,12501,57677,2411,1198,1213
36140,74662,16975,35928,12503,57685,2412,1198,1214
36145,74673,16977,35933,12505,57696,2412,1198,1214
36150,74680,16981,35938,12508,57698,2412,1198,1214
36155,74693,16983,35944,12510,57709,2413,1198,1215
36160,74704,16986,35952,12513,57716,2413,1198,1215
36165,74711,16991,35955,12517,57720,2413,1198,1215
36170,74724,16994,35963,12519,57728,2414,1199,1215
36175,74735,16996,35967,12520,57739,2414,1199,1215
36180,74742,16997,35971,12520,57745,2414,1199,1215
36185,74755,16999,35976,12521,57755,2415,1199,1216
36190,74766,17000,35982,12522,57766,2415,1199,1216
36195,74773,17001,35986,12523,57772,2415,1199,1216
36200,74786,17002,35991,12523,57783,2416,1200,1216
36205,74797,17004,35995,12524,57792,2416,1200,1216
36210,74804,17006,36000,12526,57798,2416,1200,1216
36215,74817,17009,36007,12528,57808,2417,1201,1216
36220,74828,17010,36012,12529,57817,2417,1201,1216
36225,74835,17012,36016,12531,57823,2417,1201,1216
36230,74848,17014,36021,12533,57833,2418,1202,1216
36235,74859,17017,36026,12535,57841,2418,1202,1216
36240,74866,17020,36030,12538,57845,2418,1202,1216
36245,74879,17023,36036,12540,57855,2419,1203,1216
36250,74890,17026,36041,12542,57863,2419,1203,1216
36255,74897,17028,36042,12543,57869,2419,1203,1216
36260,74910,17030,36046,12545,57879,2420,1203,1217
36265,74921,17033,36055,12548,57888,2420,1203,1217
36270,74928,17035,36059,12550,57892,2420,1203,1217
36275,74941,17037,36065,12552,57904,2421,1203,1218
36280,74952,17039,36072,12554,57913,2421,1203,1218
36285,74959,17042,36074,12556,57917,2421,1203,1218
36290,74972,17044,36081,12558,57926,2422,1203,1219
36295,74983,17044,36087,12558,57939,2422,1203,1219
36300,74990,17047,36090,12560,57943,2422,1203,1219
36305,75003,17049,36095,12561,57952,2423,1203,1220
36310,75014,17051,36100,12563,57962,2423,1203,1220
36315,75021,17054,36106,12566,57966,2423,1203,1220
36320,75034,17056,36112,12568,57975,2424,1203,1221
36325,75045,17060,36115,12572,57984,2424,1203,1221
36330,75052,17065,36120,12575,57986,2424,1203,1221
36335,75065,17068,36129,12577,57994,2425,1204,1221
36340,75076,17069,36131,12578,58007,2425,1204,1221
36345,75083,17070,36135,12579,58013,2425,1204,1221
36350,75096,17072,36142,12580,58023,2426,1204,1222
36355,75107,17072,36150,12580,58035,2426,1204,1222
36360,75114,17073,36151,12580,58041,2426,1204,1222
36365,75127,17075,36157,12581,58052,2427,1204,1223
36370,75138,17075,36161,12581,58063,2427,1204,1223
36375,75145,17076,36165,12582,58069,2427,1204,1223
36380,75158,17079,36172,12585,58078,2428,1205,1223
36385,75169,17081,36177,12587,58088,2428,1205,1223
36390,75176,17082,36178,12588,58094,2428,1205,1223
36395,75189,17084,36186,12590,58103,2429,1206,1223
36400,75200,17086,36193,12592,58114,2429,1206,1223
36405,75207,17087,36195,12593,58120,2429,1206,1223
36410,75220,17089,36202,12595,58131,2430,1207,1223
36415,75231,17090,36207,12595,58140,2430,1207,1223
36420,75238,17092,36209,12596,58146,2430,1207,1223
36425,75251,17095,36216,12599,58155,2431,1208,1223
36430,75262,17097,36220,12600,58165,2431,1208,1223
36435,75269,17098,36224,12601,58171,2431,1208,1223
36440,75282,17101,36234,12604,58178,2432,1208,1224
36445,75293,17107,36243,12610,58185,2432,1208,1224
36450,75300,17111,36247,12613,58188,2432,1208,1224
36455,75313,17114,36252,12616,58197,2433,1208,1225
36460,75324,17120,36258,12621,58203,2433,1208,1225
36465,75331,17123,36263,12624,58207,2433,1208,1225
36470,75344,17128,36270,12628,58214,2434,1209,1225
36475,75355,17132,36276,12631,58223,2434,1209,1225
36480,75362,17134,36280,12632,58227,2434,1209,1225
36485,75375,17135,36288,12633,58238,2435,1209,1226
36490,75386,17136,36294,12634,58249,2435,1209,1226
36495,75393,17138,36298,12635,58255,2435,1209,1226
36500,75406,17140,36304,12636,58266,2436,1209,1227
36505,75417,17140,36308,12636,58277,2436,1209,1227
36510,75424,17142,36311,12638,58282,2436,1209,1227
36515,75437,17143,36316,12638,58293,2437,1209,1228
36520,75448,17146,36322,12641,58301,2437,1209,1228
36525,75455,17151,36326,12645,58304,2437,1209,1228
36530,75468,17154,36331,12648,58314,2438,1209,1229
36535,75479,17156,36336,12650,58322,2438,1209,1229
36540,75486,17159,36337,12651,58326,2438,1209,1229
36545,75499,17163,36345,12655,58335,2439,1210,1229
36550,75510,17164,36350,12656,58345,2439,1210,1229
36555,75517,17166,36351,12657,58351,2439,1210,1229
36560,75530,17167,36356,12657,58363,2440,1210,1230
36565,75541,17167,36362,12657,58374,2440,1210,1230
36570,75548,17168,36366,12658,58380,2440,1210,1230
36575,75561,17169,36373,12659,58391,2441,1210,1231
36580,75572,17169,36381,12659,58403,2441,1210,1231
36585,75579,17170,36383,12659,58409,2441,1210,1231
36590,75592,17173,36389,12661,58419,2442,1211,1231
36595,75603,17174,36395,12661,58428,2442,1211,1231
36600,75610,17176,36398,12662,58434,2442,1211,1231
36605,75623,17179,36404,12664,58441,2443,1211,1232
36610,75634,17185,36409,12670,58448,2443,1211,1232
36615,75641,17187,36413,12671,58453,2443,1211,1232
36620,75654,17190,36418,12674,58462,2444,1212,1232
36625,75665,17195,36422,12679,58470,2444,1212,1232
36630,75672,17196,36425,12679,58475,2444,1212,1232
36635,75685,17199,36433,12682,58485,2445,1212,1233
36640,75696,17199,36439,12682,58497,2445,1212,1233
36645,75703,17200,36440,12682,58503,2445,1212,1233
36650,75716,17201,36443,12682,58515,2446,1212,1234
36655,75727,17201,36449,12682,58525,2446,1212,1234
36660,75734,17204,36453,12684,58530,2446,1212,1234
36665,75747,17206,36460,12686,58541,2447,1213,1234
36670,75758,17208,36466,12688,58549,2447,1213,1234
36675,75765,17211,36468,12690,58554,2447,1213,1234
36680,75778,17213,36475,12692,58564,2448,1214,1234
36685,75789,17215,36483,12694,58574,2448,1214,1234
36690,75796,17218,36488,12697,58578,2448,1214,1234
36695,75809,17221,36496,12699,58585,2449,1214,1235
36700,75820,17223,36500,12701,58595,2449,1214,1235
36705,75827,17228,36505,12706,58599,2449,1214,1235
36710,75840,17229,36508,12706,58611,2450,1215,1235
36715,75851,17229,36512,12706,58620,2450,1215,1235
36720,75858,17234,36515,12710,58624,2450,1215,1235
36725,75871,17236,36522,12711,58634,2451,1216,1235
36730,75882,17236,36525,12711,58646,2451,1216,1235
36735,75889,17237,36528,12711,58652,2451,1216,1235
36740,75902,17238,36533,12711,58663,2452,1216,1236
36745,75913,17239,36538,12711,58674,2452,1216,1236
36750,75920,17240,36540,12712,58680,2452,1216,1236
36755,75933,17241,36544,12712,58691,2453,1217,1236
36760,75944,17242,36548,12712,58702,2453,1217,1236
36765,75951,17243,36553,12712,58708,2453,1217,1236
36770,75964,17245,36558,12713,58717,2454,1217,1237
36775,75975,17248,36562,12715,58726,2454,1217,1237
36780,75982,17250,36566,12717,58732,2454,1217,1237
36785,75995,17253,36574,12719,58740,2455,1218,1237
36790,76006,17257,36580,12723,58749,2455,1218,1237
36795,76013,17258,36583,12723,58755,2455,1218,1237
36800,76026,17260,36588,12725,58764,2456,1218,1238
36805,76037,17263,36590,12727,58773,2456,1218,1238
36810,76044,17265,36591,12728,58779,2456,1218,1238
36815,76057,17267,36595,12730,58789,2457,1218,1239
36820,76068,17270,36599,12732,58796,2457,1218,1239
36825,76075,17273,36601,12734,58802,2457,1218,1239
36830,76088,17277,36608,12737,58809,2458,1219,1239
36835,76099,17281,36612,12740,58817,2458,1219,1239
36840,76106,17286,36616,12743,58819,2458,1219,1239
36845,76119,17288,36624,12745,58829,2459,1219,1240
36850,76130,17289,36630,12746,58841,2459,1219,1240
36855,76137,17291,36631,12746,58846,2459,1219,1240
36860,76150,17293,36638,12747,58856,2460,1220,1240
36865,76161,17294,36644,12748,58866,2460,1220,1240
36870,76168,17297,36647,12749,58871,2460,1220,1240
36875,76181,17299,36654,12750,58881,2461,1221,1240
36880,76192,17302,36660,12753,58889,2461,1221,1240
36885,76199,17306,36663,12755,58892,2461,1221,1240
36890,76212,17309,36670,12758,58901,2462,1222,1240
36895,76223,17310,36672,12759,58913,2462,1222,1240
36900,76230,17314,36676,12761,58915,2462,1222,1240
36905,76243,17318,36686,12765,58923,2463,1222,1241
36910,76254,17321,36690,12768,58933,2463,1222,1241
36915,76261,17322,36695,12768,58939,2463,1222,1241
36920,76274,17324,36703,12770,58950,2464,1223,1241
36925,76285,17324,36706,12770,58961,2464,1223,1241
36930,76292,17325,36709,12770,58967,2464,1223,1241
36935,76305,17326,36713,12770,58978,2465,1224,1241
36940,76316,17326,36716,12770,58990,2465,1224,1241
36945,76323,17327,36719,12771,58996,2465,1224,1241
36950,76336,17329,36725,12772,59005,2466,1224,1242
36955,76347,17331,36732,12774,59015,2466,1224,1242
36960,76354,17333,36736,12776,59021,2466,1224,1242
36965,76367,17336,36743,12778,59030,2467,1224,1243
36970,76378,17339,36750,12781,59039,2467,1224,1243
36975,76385,17340,36752,12781,59045,2467,1224,1243
36980,76398,17344,36758,12784,59053,2468,1225,1243
36985,76409,17347,36763,12786,59061,2468,1225,1243
36990,76416,17349,36764,12787,59067,2468,1225,1243
36995,76429,17351,36768,12788,59076,2469,1225,1244
37000,76440,17355,36773,12791,59084,2469,1225,1244
37005,76447,17358,36776,12793,59089,2469,1225,1244
37010,76460,17361,36781,12796,59098,2470,1225,1245
37015,76471,17362,36785,12797,59109,2470,1225,1245
37020,76478,17364,36789,12798,59113,2470,1225,1245
37025,76491,17366,36797,12800,59125,2471,1225,1246
37030,76502,17366,36803,12800,59136,2471,1225,1246
37035,76509,17368,36807,12801,59140,2471,1225,1246
37040,76522,17370,36815,12802,59152,2472,1226,1246
37045,76533,17370,36822,12802,59163,2472,1226,1246
37050,76540,17372,36824,12803,59168,2472,1226,1246
37055,76553,17374,36831,12805,59179,2473,1226,1247
37060,76564,17374,36836,12805,59190,2473,1226,1247
37065,76571,17377,36838,12806,59194,2473,1226,1247
37070,76584,17379,36847,12807,59201,2474,1226,1248
37075,76595,17383,36852,12811,59211,2474,1226,1248
37080,76602,17387,36855,12815,59215,2474,1226,1248
37085,76615,17389,36856,12815,59226,2475,1226,1249
37090,76626,17390,36860,12816,59236,2475,1226,1249
37095,76633,17393,36862,12818,59240,2475,1226,1249
37100,76646,17396,36869,12820,59248,2476,1226,1250
37105,76657,17397,36875,12821,59258,2476,1226,1250
37110,76664,17402,36879,12824,59261,2476,1226,1250
37115,76677,17406,36884,12827,59269,2477,1226,1251
37120,76688,17411,36891,12831,59274,2477,1226,1251
37125,76695,17414,36894,12833,59281,2477,1226,1251
37130,76708,17416,36900,12833,59288,2478,1226,1252
37135,76719,17419,36904,12835,59300,2478,1226,1252
37140,76726,17420,36907,12835,59306,2478,1226,1252
37145,76739,17423,36914,12836,59314,2479,1226,1253
37150,76750,17425,36920,12838,59325,2479,1226,1253
37155,76757,17426,36925,12838,59331,2479,1226,1253
37160,76770,17429,36930,12840,59341,2480,1227,1253
37165,76781,17430,36935,12841,59351,2480,1227,1253
37170,76788,17431,36940,12842,59357,2480,1227,1253
37175,76801,17434,36950,12845,59365,2481,1228,1253
37180,76812,17438,36957,12849,59373,2481,1228,1253
37185,76819,17440,36960,12850,59379,2481,1228,1253
37190,76832,17443,36966,12853,59388,2482,1228,1254
37195,76843,17446,36972,12855,59397,2482,1228,1254
37200,76850,17447,36976,12855,59403,2482,1228,1254
37205,76863,17451,36985,12858,59410,2483,1228,1255
37210,76874,17454,36990,12860,59419,2483,1228,1255
37215,76881,17456,36994,12861,59425,2483,1228,1255
37220,76894,17458,37000,12862,59434,2484,1229,1255
37225,76905,17460,37006,12864,59444,2484,1229,1255
37230,76912,17462,37010,12866,59450,2484,1229,1255
37235,76925,17464,37012,12867,59460,2485,1229,1256
37240,76936,17466,37018,12868,59469,2485,1229,1256
37245,76943,17469,37022,12871,59474,2485,1229,1256
37250,76956,17472,37027,12873,59484,2486,1230,1256
37255,76967,17474,37033,12875,59493,2486,1230,1256
37260,76974,17477,37036,12877,59496,2486,1230,1256
37265,76987,17480,37041,12879,59505,2487,1230,1257
37270,76998,17484,37049,12883,59513,2487,1230,1257
37275,77005,17486,37052,12884,59517,2487,1230,1257
37280,77018,17490,37057,12886,59527,2488,1231,1257
37285,77029,17491,37063,12887,59536,2488,1231,1257
37290,77036,17495,37067,12891,59540,2488,1231,1257
37295,77049,17499,37072,12893,59548,2489,1232,1257
37300,77060,17500,37075,12894,59559,2489,1232,1257
37305,77067,17503,37076,12895,59564,2489,1232,1257
37310,77080,17505,37082,12897,59572,2490,1233,1257
37315,77091,17507,37086,12899,59583,2490,1233,1257
37320,77098,17512,37091,12903,59586,2490,1233,1257
37325,77111,17514,37097,12904,59595,2491,1233,1258
37330,77122,17514,37104,12904,59608,2491,1233,1258
37335,77129,17515,37107,12905,59614,2491,1233,1258
37340,77142,17517,37113,12906,59624,2492,1233,1259
37345,77153,17517,37118,12906,59636,2492,1233,1259
37350,77160,17518,37121,12907,59642,2492,1233,1259
37355,77173,17520,37128,12907,59653,2493,1234,1259
37360,77184,17520,37133,12907,59664,2493,1234,1259
37365,77191,17521,37136,12907,59670,2493,1234,1259
37370,77204,17523,37140,12907,59680,2494,1235,1259
37375,77215,17524,37143,12907,59691,2494,1235,1259
37380,77222,17525,37146,12907,59697,2494,1235,1259
37385,77235,17527,37150,12908,59707,2495,1236,1259
37390,77246,17529,37154,12909,59717,2495,1236,1259
37395,77253,17530,37158,12910,59723,2495,1236,1259
37400,77266,17532,37161,12910,59733,2496,1237,1259
37405,77277,17534,37164,12911,59742,2496,1237,1259
37410,77284,17536,37167,12912,59748,2496,1237,1259
37415,77297,17538,37171,12913,59758,2497,1238,1259
37420,77308,17540,37176,12915,59767,2497,1238,1259
37425,77315,17542,37179,12916,59773,2497,1238,1259
37430,77328,17545,37189,12918,59781,2498,1239,1259
37435,77339,17549,37194,12922,59790,2498,1239,1259
37440,77346,17551,37197,12923,59794,2498,1239,1259
37445,77359,17555,37202,12926,59803,2499,1239,1260
37450,77370,17560,37208,12930,59809,2499,1239,1260
37455,77377,17564,37211,12933,59812,2499,1239,1260
37460,77390,17568,37214,12936,59821,2500,1239,1261
37465,77401,17573,37220,12941,59827,2500,1239,1261
37470,77408,17578,37225,12946,59829,2500,1239,1261
37475,77421,17584,37234,12950,59835,2501,1239,1262
37480,77432,17588,37239,12954,59843,2501,1239,1262
37485,77439,17592,37242,12958,59847,2501,1239,1262
37490,77452,17595,37246,12960,59856,2502,1239,1263
37495,77463,17598,37254,12963,59863,2502,1239,1263
37500,77470,17603,37258,12968,59867,2502,1239,1263
37505,77483,17605,37261,12969,59878,2503,1239,1264
37510,77494,17605,37265,12969,59889,2503,1239,1264
37515,77501,17606,37267,12970,59894,2503,1239,1264
37520,77514,17608,37271,12971,59906,2504,1240,1264
37525,77525,17608,37276,12971,59917,2504,1240,1264
37530,77532,17609,37281,12972,59923,2504,1240,1264
37535,77545,17611,37292,12973,59933,2505,1241,1264
37540,77556,17611,37297,12973,59945,2505,1241,1264
37545,77563,17612,37301,12973,59951,2505,1241,1264
37550,77576,17614,37309,12974,59960,2506,1241,1265
37555,77587,17614,37313,12974,59973,2506,1241,1265
37560,77594,17615,37317,12975,59979,2506,1241,1265
37565,77607,17617,37325,12976,59988,2507,1242,1265
37570,77618,17617,37334,12976,60000,2507,1242,1265
37575,77625,17618,37339,12976,60007,2507,1242,1265
37580,77638,17620,37348,12977,60016,2508,1243,1265
37585,77649,17623,37356,12980,60025,2508,1243,1265
37590,77656,17624,37361,12981,60032,2508,1243,1265
37595,77669,17626,37367,12982,60040,2509,1243,1266
37600,77680,17629,37369,12984,60051,2509,1243,1266
37605,77687,17630,37372,12984,60057,2509,1243,1266
37610,77700,17632,37380,12985,60066,2510,1244,1266
37615,77711,17634,37384,12987,60077,2510,1244,1266
37620,77718,17636,37390,12989,60082,2510,1244,1266
37625,77731,17639,37394,12991,60091,2511,1244,1267
37630,77742,17641,37400,12993,60101,2511,1244,1267
37635,77749,17643,37406,12995,60106,2511,1244,1267
37640,77762,17647,37414,12998,60114,2512,1245,1267
37645,77773,17648,37420,12998,60125,2512,1245,1267
37650,77780,17650,37425,13000,60130,2512,1245,1267
37655,77793,17653,37435,13002,60137,2513,1245,1268
37660,77804,17656,37441,13005,60148,2513,1245,1268
37665,77811,17659,37444,13006,60152,2513,1245,1268
37670,77824,17662,37449,13008,60160,2514,1245,1269
37675,77835,17665,37454,13010,60167,2514,1245,1269
37680,77842,17671,37459,13015,60170,2514,1245,1269
37685,77855,17677,37463,13019,60177,2515,1245,1270
37690,77866,17680,37467,13021,60183,2515,1245,1270
37695,77873,17686,37469,13025,60186,2515,1245,1270
37700,77886,17690,37474,13028,60193,2516,1245,1271
37705,77897,17694,37477,13032,60202,2516,1245,1271
37710,77904,17697,37478,13033,60206,2516,1245,1271
37715,77917,17699,37484,13033,60215,2517,1245,1272
37720,77928,17702,37487,13036,60226,2517,1245,1272
37725,77935,17704,37489,13036,60229,2517,1245,1272
37730,77948,17707,37491,13037,60240,2518,1246,1272
37735,77959,17709,37497,13039,60248,2518,1246,1272
37740,77966,17714,37500,13043,60252,2518,1246,1272
37745,77979,17716,37506,13044,60262,2519,1247,1272
37750,77990,17716,37510,13044,60274,2519,1247,1272
37755,77997,17717,37511,13044,60280,2519,1247,1272
37760,78010,17719,37518,13045,60291,2520,1248,1272
37765,78021,17719,37523,13045,60302,2520,1248,1272
37770,78028,17720,37526,13045,60308,2520,1248,1272
37775,78041,17722,37532,13047,60319,2521,1248,1273
37780,78052,17722,37536,13047,60330,2521,1248,1273
37785,78059,17723,37540,13048,60336,2521,1248,1273
37790,78072,17725,37545,13049,60346,2522,1248,1274
37795,78083,17725,37549,13049,60358,2522,1248,1274
37800,78090,17726,37550,13049,60364,2522,1248,1274
37805,78103,17728,37559,13051,60375,2523,1249,1274
37810,78114,17729,37563,13051,60384,2523,1249,1274
37815,78121,17730,37568,13052,60391,2523,1249,1274
37820,78134,17732,37570,13052,60400,2524,1249,1275
37825,78145,17735,37576,13055,60410,2524,1249,1275
37830,78152,17736,37580,13055,60416,2524,1249,1275
37835,78165,17738,37586,13056,60426,2525,1249,1276
37840,78176,17739,37592,13056,60437,2525,1249,1276
37845,78183,17740,37598,13057,60443,2525,1249,1276
37850,78196,17742,37604,13058,60453,2526,1250,1276
37855,78207,17744,37609,13060,60463,2526,1250,1276
37860,78214,17746,37612,13061,60468,2526,1250,1276
37865,78227,17748,37619,13063,60476,2527,1250,1277
37870,78238,17754,37627,13069,60482,2527,1250,1277
37875,78245,17759,37631,13073,60485,2527,1250,1277
37880,78258,17764,37638,13078,60492,2528,1250,1278
37885,78269,17769,37644,13083,60500,2528,1250,1278
37890,78276,17772,37646,13085,60504,2528,1250,1278
37895,78289,17774,37648,13085,60515,2529,1250,1279
37900,78300,17777,37655,13087,60521,2529,1250,1279
37905,78307,17782,37657,13091,60525,2529,1250,1279
37910,78320,17786,37666,13094,60531,2530,1251,1279
37915,78331,17790,37676,13098,60540,2530,1251,1279
37920,78338,17792,37680,13099,60546,2530,1251,1279
37925,78351,17795,37687,13101,60553,2531,1251,1280
37930,78362,17798,37695,13104,60563,2531,1251,1280
37935,78369,17800,37700,13106,60568,2531,1251,1280
37940,78382,17805,37706,13109,60575,2532,1251,1281
37945,78393,17810,37712,13113,60582,2532,1251,1281
37950,78400,17812,37715,13114,60588,2532,1251,1281
37955,78413,17814,37719,13115,60597,2533,1251,1282
37960,78424,17817,37721,13117,60607,2533,1251,1282
37965,78431,17818,37725,13117,60612,2533,1251,1282
37970,78444,17820,37730,13117,60623,2534,1251,1283
37975,78455,17820,37734,13117,60635,2534,1251,1283
37980,78462,17821,37738,13118,60641,2534,1251,1283
37985,78475,17823,37743,13119,60652,2535,1251,1284
37990,78486,17823,37748,13119,60663,2535,1251,1284
37995,78493,17824,37750,13120,60669,2535,1251,1284
38000,78506,17826,37758,13122,60680,2536,1251,1285
38005,78517,17826,37764,13122,60691,2536,1251,1285
38010,78524,17827,37766,13123,60697,2536,1251,1285
38015,78537,17829,37770,13123,60708,2537,1251,1286
38020,78548,17829,37774,13123,60719,2537,1251,1286
38025,78555,17831,37778,13125,60724,2537,1251,1286
38030,78568,17833,37781,13126,60735,2538,1251,1287
38035,78579,17833,37786,13126,60746,2538,1251,1287
38040,78586,17835,37790,13127,60750,2538,1251,1287
38045,78599,17838,37794,13128,60760,2539,1252,1287
38050,78610,17841,37801,13131,60768,2539,1252,1287
38055,78617,17845,37805,13135,60772,2539,1252,1287
38060,78630,17847,37811,13137,60781,2540,1252,1288
38065,78641,17851,37816,13141,60790,2540,1252,1288
38070,78648,17854,37820,13143,60794,2540,1252,1288
38075,78661,17857,37824,13144,60803,2541,1253,1288
38080,78672,17859,37831,13146,60812,2541,1253,1288
38085,78679,17863,37836,13149,60815,2541,1253,1288
38090,78692,17867,37840,13151,60823,2542,1254,1288
38095,78703,17872,37843,13155,60831,2542,1254,1288
38100,78710,17876,37845,13157,60834,2542,1254,1288
38105,78723,17880,37851,13160,60840,2543,1254,1289
38110,78734,17885,37856,13164,60848,2543,1254,1289
38115,78741,17887,37859,13166,60854,2543,1254,1289
38120,78754,17889,37865,13167,60863,2544,1254,1290
38125,78765,17893,37874,13171,60871,2544,1254,1290
38130,78772,17895,37876,13172,60877,2544,1254,1290
38135,78785,17898,37884,13174,60886,2545,1255,1290
38140,78796,17900,37891,13176,60896,2545,1255,1290
38145,78803,17901,37895,13177,60902,2545,1255,1290
38150,78816,17904,37900,13178,60911,2546,1255,1291
38155,78827,17905,37906,13179,60921,2546,1255,1291
38160,78834,17907,37909,13180,60927,2546,1255,1291
38165,78847,17910,37914,13181,60936,2547,1256,1291
38170,78858,17913,37919,13184,60945,2547,1256,1291
38175,78865,17914,37920,13184,60951,2547,1256,1291
38180,78878,17916,37926,13186,60961,2548,1256,1292
38185,78889,17916,37931,13186,60973,2548,1256,1292
38190,78896,17917,37935,13187,60979,2548,1256,1292
38195,78909,17919,37942,13189,60990,2549,1256,1293
38200,78920,17919,37946,13189,61001,2549,1256,1293
38205,78927,17921,37948,13190,61006,2549,1256,1293
38210,78940,17923,37952,13190,61017,2550,1256,1294
38215,78951,17923,37958,13190,61028,2550,1256,1294
38220,78958,17925,37962,13192,61032,2550,1256,1294
38225,78971,17927,37970,13194,61043,2551,1256,1295
38230,78982,17928,37977,13195,61053,2551,1256,1295
38235,78989,17930,37980,13196,61058,2551,1256,1295
38240,79002,17932,37989,13198,61068,2552,1256,1296
38245,79013,17934,37995,13200,61078,2552,1256,1296
38250,79020,17937,38000,13203,61083,2552,1256,1296
38255,79033,17939,38004,13204,61093,2553,1256,1297
38260,79044,17939,38010,13204,61104,2553,1256,1297
38265,79051,17941,38013,13205,61109,2553,1256,1297
38270,79064,17945,38020,13208,61117,2554,1256,1298
38275,79075,17949,38024,13212,61124,2554,1256,1298
38280,79082,17954,38029,13217,61128,2554,1256,1298
38285,79095,17958,38035,13219,61135,2555,1256,1299
38290,79106,17961,38040,13221,61143,2555,1256,1299
38295,79113,17966,38045,13226,61147,2555,1256,1299
38300,79126,17968,38051,13226,61156,2556,1256,1300
38305,79137,17970,38057,13227,61167,2556,1256,1300
38310,79144,17971,38060,13227,61173,2556,1256,1300
38315,79157,17973,38065,13228,61182,2557,1256,1301
38320,79168,17974,38071,13228,61194,2557,1256,1301
38325,79175,17975,38073,13228,61200,2557,1256,1301
38330,79188,17978,38082,13230,61208,2558,1256,1302
38335,79199,17981,38090,13232,61218,2558,1256,1302
38340,79206,17982,38091,13232,61224,2558,1256,1302
38345,79219,17985,38095,13233,61234,2559,1256,1303
38350,79230,17986,38102,13234,61243,2559,1256,1303
38355,79237,17988,38106,13235,61249,2559,1256,1303
38360,79250,17991,38109,13237,61259,2560,1257,1303
38365,79261,17993,38116,13238,61267,2560,1257,1303
38370,79268,17995,38119,13239,61273,2560,1257,1303
38375,79281,17999,38126,13243,61280,2561,1257,1304
38380,79292,18001,38132,13244,61290,2561,1257,1304
38385,79299,18003,38134,13245,61296,2561,1257,1304
38390,79312,18005,38139,13246,61304,2562,1257,1305
38395,79323,18011,38144,13252,61311,2562,1257,1305
38400,79330,18013,38146,13254,61317,2562,1257,1305
38405,79343,18016,38152,13256,61327,2563,1258,1305
38410,79354,18016,38158,13256,61338,2563,1258,1305
38415,79361,18018,38161,13257,61343,2563,1258,1305
38420,79374,18020,38168,13258,61354,2564,1258,1306
38425,79385,18021,38177,13259,61363,2564,1258,1306
38430,79392,18025,38181,13262,61365,2564,1258,1306
38435,79405,18028,38186,13265,61376,2565,1258,1307
38440,79416,18030,38190,13267,61385,2565,1258,1307
38445,79423,18033,38194,13269,61388,2565,1258,1307
38450,79436,18037,38202,13273,61398,2566,1258,1308
38455,79447,18038,38207,13274,61409,2566,1258,1308
38460,79454,18041,38212,13277,61412,2566,1258,1308
38465,79467,18043,38215,13277,61422,2567,1258,1309
38470,79478,18046,38221,13280,61432,2567,1258,1309
38475,79485,18048,38224,13281,61436,2567,1258,1309
38480,79498,18051,38230,13284,61447,2568,1259,1309
38485,79509,18051,38235,13284,61456,2568,1259,1309
38490,79516,18056,38237,13287,61460,2568,1259,1309
38495,79529,18058,38242,13288,61471,2569,1260,1309
38500,79540,18058,38247,13288,61482,2569,1260,1309
38505,79547,18059,38249,13289,61488,2569,1260,1309
38510,79560,18061,38258,13291,61497,2570,1260,1310
38515,79571,18063,38259,13293,61508,2570,1260,1310
38520,79578,18064,38264,13294,61514,2570,1260,1310
38525,79591,18067,38269,13296,61524,2571,1261,1310
38530,79602,18068,38273,13296,61533,2571,1261,1310
38535,79609,18069,38276,13296,61540,2571,1261,1310
38540,79622,18071,38281,13296,61547,2572,1262,1310
38545,79633,18074,38285,13299,61559,2572,1262,1310
38550,79640,18075,38289,13299,61565,2572,1262,1310
38555,79653,18077,38296,13301,61573,2573,1262,1311
38560,79664,18080,38301,13304,61583,2573,1262,1311
38565,79671,18081,38307,13305,61590,2573,1262,1311
38570,79684,18084,38312,13306,61600,2574,1263,1311
38575,79695,18086,38317,13307,61608,2574,1263,1311
38580,79702,18088,38318,13308,61614,2574,1263,1311
38585,79715,18091,38326,13310,61621,2575,1264,1311
38590,79726,18096,38331,13314,61628,2575,1264,1311
38595,79733,18100,38334,13317,61633,2575,1264,1311
38600,79746,18102,38341,13318,61642,2576,1264,1312
38605,79757,18109,38349,13324,61645,2576,1264,1312
38610,79764,18116,38354,13330,61648,2576,1264,1312
38615,79777,18120,38361,13332,61654,2577,1264,1313
38620,79788,18124,38370,13336,61662,2577,1264,1313
38625,79795,18129,38373,13339,61666,2577,1264,1313
38630,79808,18132,38380,13341,61675,2578,1264,1314
38635,79819,18134,38386,13343,61684,2578,1264,1314
38640,79826,18137,38388,13345,61689,2578,1264,1314
38645,79839,18139,38392,13346,61700,2579,1265,1314
38650,79850,18139,38396,13346,61711,2579,1265,1314
38655,79857,18140,38398,13346,61717,2579,1265,1314
38660,79870,18142,38404,13348,61728,2580,1265,1315
38665,79881,18142,38409,13348,61739,2580,1265,1315
38670,79888,18143,38413,13348,61745,2580,1265,1315
38675,79901,18145,38418,13349,61755,2581,1265,1316
38680,79912,18145,38423,13349,61767,2581,1265,1316
38685,79919,18146,38426,13350,61773,2581,1265,1316
38690,79932,18148,38433,13352,61784,2582,1266,1316
38695,79943,18148,38438,13352,61795,2582,1266,1316
38700,79950,18149,38443,13353,61800,2582,1266,1316
38705,79963,18151,38446,13353,61811,2583,1267,1316
38710,79974,18151,38451,13353,61823,2583,1267,1316
38715,79981,18152,38453,13354,61829,2583,1267,1316
38720,79994,18154,38460,13355,61840,2584,1268,1316
38725,80005,18155,38464,13356,61849,2584,1268,1316
38730,80012,18158,38468,13358,61853,2584,1268,1316
38735,80025,18162,38474,13361,61861,2585,1269,1316
38740,80036,18164,38478,13363,61872,2585,1269,1316
38745,80043,18165,38482,13363,61878,2585,1269,1316
38750,80056,18167,38487,13364,61887,2586,1270,1316
38755,80067,18170,38491,13366,61897,2586,1270,1316
38760,80074,18172,38493,13368,61902,2586,1270,1316
38765,80087,18174,38501,13369,61911,2587,1271,1316
38770,80098,18177,38507,13372,61920,2587,1271,1316
38775,80105,18180,38511,13374,61925,2587,1271,1316
38780,80118,18182,38514,13374,61934,2588,1271,1317
38785,80129,18184,38519,13376,61943,2588,1271,1317
38790,80136,18188,38523,13379,61947,2588,1271,1317
38795,80149,18192,38528,13381,61955,2589,1271,1318
38800,80160,18195,38534,13383,61963,2589,1271,1318
38805,80167,18199,38537,13386,61967,2589,1271,1318
38810,80180,18203,38543,13390,61976,2590,1271,1319
38815,80191,18206,38551,13393,61984,2590,1271,1319
38820,80198,18210,38553,13395,61988,2590,1271,1319
38825,80211,18213,38560,13397,61995,2591,1271,1320
38830,80222,18218,38565,13401,62004,2591,1271,1320
38835,80229,18219,38570,13402,62010,2591,1271,1320
38840,80242,18222,38579,13404,62017,2592,1271,1321
38845,80253,18226,38582,13407,62027,2592,1271,1321
38850,80260,18227,38586,13408,62033,2592,1271,1321
38855,80273,18231,38596,13411,62040,2593,1272,1321
38860,80284,18233,38599,13412,62051,2593,1272,1321
38865,80291,18234,38602,13412,62057,2593,1272,1321
38870,80304,18236,38608,13413,62066,2594,1273,1321
38875,80315,18240,38616,13417,62074,2594,1273,1321
38880,80322,18242,38620,13418,62080,2594,1273,1321
38885,80335,18244,38627,13420,62090,2595,1274,1321
38890,80346,18246,38629,13421,62100,2595,1274,1321
38895,80353,18247,38633,13422,62106,2595,1274,1321
38900,80366,18250,38641,13425,62115,2596,1275,1321
38905,80377,18252,38645,13426,62125,2596,1275,1321
38910,80384,18254,38650,13428,62129,2596,1275,1321
38915,80397,18258,38656,13431,62138,2597,1275,1322
38920,80408,18259,38663,13432,62149,2597,1275,1322
38925,80415,18260,38667,13432,62155,2597,1275,1322
38930,80428,18262,38671,13433,62166,2598,1275,1323
38935,80439,18262,38675,13433,62177,2598,1275,1323
38940,80446,18265,38680,13436,62181,2598,1275,1323
38945,80459,18267,38687,13438,62192,2599,1275,1324
38950,80470,18268,38693,13439,62202,2599,1275,1324
38955,80477,18270,38697,13441,62206,2599,1275,1324
38960,80490,18272,38700,13441,62218,2600,1275,1325
38965,80501,18274,38708,13443,62225,2600,1275,1325
38970,80508,18279,38713,13447,62227,2600,1275,1325
38975,80521,18282,38716,13448,62238,2601,1275,1326
38980,80532,18283,38720,13449,62249,2601,1275,1326
38985,80539,18287,38724,13451,62251,2601,1275,1326
38990,80552,18290,38730,13452,62260,2602,1275,1327
38995,80563,18291,38736,13453,62269,2602,1275,1327
39000,80570,18296,38739,13457,62274,2602,1275,1327
39005,80583,18298,38743,13457,62285,2603,1276,1327
39010,80594,18298,38747,13457,62296,2603,1276,1327
39015,80601,18299,38751,13457,62302,2603,1276,1327
39020,80614,18301,38758,13457,62310,2604,1277,1327
39025,80625,18303,38759,13458,62322,2604,1277,1327
39030,80632,18304,38763,13459,62328,2604,1277,1327
39035,80645,18306,38769,13461,62337,2605,1278,1327
39040,80656,18308,38776,13463,62348,2605,1278,1327
39045,80663,18309,38780,13464,62354,2605,1278,1327
39050,80676,18311,38787,13466,62363,2606,1279,1327
39055,80687,18313,38793,13467,62374,2606,1279,1327
39060,80694,18314,38796,13468,62380,2606,1279,1327
39065,80707,18316,38804,13470,62389,2607,1280,1327
39070,80718,18318,38807,13472,62400,2607,1280,1327
39075,80725,18319,38810,13472,62406,2607,1280,1327
39080,80738,18322,38819,13475,62414,2608,1280,1328
39085,80749,18324,38825,13476,62425,2608,1280,1328
39090,80756,18325,38830,13477,62431,2608,1280,1328
39095,80769,18328,38834,13478,62438,2609,1280,1329
39100,80780,18331,38839,13481,62448,2609,1280,1329
39105,80787,18335,38844,13484,62452,2609,1280,1329
39110,80800,18338,38852,13487,62460,2610,1281,1329
39115,80811,18342,38857,13491,62469,2610,1281,1329
39120,80818,18344,38859,13491,62473,2610,1281,1329
39125,80831,18349,38866,13495,62480,2611,1281,1330
39130,80842,18355,38872,13501,62486,2611,1281,1330
39135,80849,18360,38878,13505,62488,2611,1281,1330
39140,80862,18363,38884,13508,62499,2612,1282,1330
39145,80873,18364,38889,13509,62508,2612,1282,1330
39150,80880,18367,38890,13510,62513,2612,1282,1330
39155,80893,18369,38899,13512,62522,2613,1282,1331
39160,80904,18370,38903,13513,62534,2613,1282,1331
39165,80911,18373,38908,13515,62537,2613,1282,1331
39170,80924,18376,38915,13517,62547,2614,1282,1332
39175,80935,18377,38922,13518,62557,2614,1282,1332
39180,80942,18380,38925,13520,62562,2614,1282,1332
39185,80955,18383,38933,13522,62570,2615,1283,1332
39190,80966,18384,38940,13523,62581,2615,1283,1332
39195,80973,18387,38944,13525,62585,2615,1283,1332
39200,80986,18390,38948,13527,62595,2616,1284,1332
39205,80997,18391,38951,13528,62606,2616,1284,1332
39210,81004,18394,38956,13530,62609,2616,1284,1332
39215,81017,18397,38961,13531,62618,2617,1284,1333
39220,81028,18399,38969,13533,62628,2617,1284,1333
39225,81035,18402,38971,13536,62633,2617,1284,1333
39230,81048,18404,38977,13538,62643,2618,1285,1333
39235,81059,18404,38984,13538,62653,2618,1285,1333
39240,81066,18407,38988,13541,62659,2618,1285,1333
39245,81079,18410,38993,13543,62667,2619,1285,1334
39250,81090,18413,38996,13545,62677,2619,1285,1334
39255,81097,18414,38999,13546,62683,2619,1285,1334
39260,81110,18417,39001,13548,62693,2620,1285,1335
39265,81121,18418,39009,13548,62703,2620,1285,1335
39270,81128,18419,39012,13548,62709,2620,1285,1335
39275,81141,18421,39020,13549,62717,2621,1285,1336
39280,81152,18424,39024,13551,62728,2621,1285,1336
39285,81159,18425,39027,13551,62734,2621,1285,1336
39290,81172,18427,39033,13552,62743,2622,1286,1336
39295,81183,18428,39036,13552,62755,2622,1286,1336
39300,81190,18429,39041,13553,62761,2622,1286,1336
39305,81203,18433,39049,13557,62768,2623,1286,1337
39310,81214,18438,39054,13561,62775,2623,1286,1337
39315,81221,18440,39058,13563,62780,2623,1286,1337
39320,81234,18446,39066,13568,62786,2624,1286,1338
39325,81245,18449,39072,13570,62795,2624,1286,1338
39330,81252,18450,39074,13571,62801,2624,1286,1338
39335,81265,18452,39079,13572,62811,2625,1286,1339
39340,81276,18452,39086,13572,62823,2625,1286,1339
39345,81283,18454,39089,13572,62829,2625,1286,1339
39350,81296,18456,39093,13573,62839,2626,1286,1340
39355,81307,18456,39095,13573,62851,2626,1286,1340
39360,81314,18459,39097,13574,62855,2626,1286,1340
39365,81327,18461,39103,13575,62866,2627,1287,1340
39370,81338,18461,39110,13575,62877,2627,1287,1340
39375,81345,18463,39111,13575,62882,2627,1287,1340
39380,81358,18465,39119,13577,62893,2628,1288,1340
39385,81369,18467,39125,13579,62902,2628,1288,1340
39390,81376,18470,39128,13582,62906,2628,1288,1340
39395,81389,18472,39135,13583,62915,2629,1289,1340
39400,81400,18474,39142,13585,62925,2629,1289,1340
39405,81407,18477,39145,13588,62929,2629,1289,1340
39410,81420,18481,39152,13592,62937,2630,1289,1341
39415,81431,18484,39157,13595,62947,2630,1289,1341
39420,81438,18488,39162,13599,62950,2630,1289,1341
39425,81451,18491,39167,13601,62959,2631,1289,1342
39430,81462,18493,39172,13602,62967,2631,1289,1342
39435,81469,18498,39176,13606,62971,2631,1289,1342
39440,81482,18500,39181,13608,62981,2632,1289,1343
39445,81493,18503,39186,13610,62990,2632,1289,1343
39450,81500,18504,39188,13610,62996,2632,1289,1343
39455,81513,18506,39192,13612,63005,2633,1289,1344
39460,81524,18509,39197,13615,63015,2633,1289,1344
39465,81531,18510,39200,13615,63021,2633,1289,1344
39470,81544,18514,39208,13617,63026,2634,1290,1344
39475,81555,18521,39216,13624,63033,2634,1290,1344
39480,81562,18524,39220,13627,63037,2634,1290,1344
39485,81575,18529,39228,13632,63043,2635,1290,1345
39490,81586,18533,39234,13636,63053,2635,1290,1345
39495,81593,18534,39239,13637,63059,2635,1290,1345
39500,81606,18536,39246,13639,63070,2636,1290,1346
39505,81617,18536,39251,13639,63081,2636,1290,1346
39510,81624,18537,39254,13639,63087,2636,1290,1346
39515,81637,18539,39260,13639,63098,2637,1290,1347
39520,81648,18539,39266,13639,63109,2637,1290,1347
39525,81655,18540,39269,13640,63115,2637,1290,1347
39530,81668,18542,39275,13641,63126,2638,1290,1348
39535,81679,18542,39282,13641,63137,2638,1290,1348
39540,81686,18543,39285,13641,63143,2638,1290,1348
39545,81699,18545,39290,13642,63154,2639,1290,1349
39550,81710,18545,39297,13642,63165,2639,1290,1349
39555,81717,18547,39301,13643,63170,2639,1290,1349
39560,81730,18549,39310,13645,63181,2640,1291,1349
39565,81741,18551,39321,13647,63190,2640,1291,1349
39570,81748,18553,39323,13649,63195,2640,1291,1349
39575,81761,18555,39330,13649,63206,2641,1292,1349
39580,81772,18556,39336,13650,63216,2641,1292,1349
39585,81779,18558,39338,13651,63221,2641,1292,1349
39590,81792,18560,39342,13651,63232,2642,1292,1350
39595,81803,18561,39347,13652,63241,2642,1292,1350
39600,81810,18565,39350,13655,63245,2642,1292,1350
39605,81823,18568,39356,13657,63251,2643,1292,1351
39610,81834,18571,39360,13660,63262,2643,1292,1351
39615,81841,18575,39365,13664,63265,2643,1292,1351
39620,81854,18579,39372,13666,63272,2644,1293,1351
39625,81865,18584,39378,13671,63279,2644,1293,1351
39630,81872,18589,39382,13675,63282,2644,1293,1351
39635,81885,18593,39387,13679,63291,2645,1293,1352
39640,81896,18595,39390,13680,63299,2645,1293,1352
39645,81903,18598,39396,13683,63305,2645,1293,1352
39650,81916,18600,39401,13683,63314,2646,1293,1353
39655,81927,18601,39407,13683,63326,2646,1293,1353
39660,81934,18602,39412,13683,63332,2646,1293,1353
39665,81947,18604,39418,13685,63341,2647,1293,1354
39670,81958,18607,39427,13688,63350,2647,1293,1354
39675,81965,18609,39430,13689,63356,2647,1293,1354
39680,81978,18612,39434,13691,63365,2648,1293,1355
39685,81989,18614,39439,13692,63374,2648,1293,1355
39690,81996,18616,39444,13694,63380,2648,1293,1355
39695,82009,18618,39449,13694,63388,2649,1293,1356
39700,82020,18621,39453,13696,63399,2649,1293,1356
39705,82027,18622,39456,13696,63405,2649,1293,1356
39710,82040,18626,39464,13700,63413,2650,1294,1356
39715,82051,18629,39469,13703,63421,2650,1294,1356
39720,82058,18631,39475,13705,63427,2650,1294,1356
39725,82071,18635,39481,13708,63435,2651,1294,1357
39730,82082,18638,39489,13711,63444,2651,1294,1357
39735,82089,18639,39494,13712,63449,2651,1294,1357
39740,82102,18641,39499,13713,63460,2652,1294,1358
39745,82113,18641,39505,13713,63472,2652,1294,1358
39750,82120,18643,39510,13714,63476,2652,1294,1358
39755,82133,18645,39516,13716,63487,2653,1294,1359
39760,82144,18646,39521,13717,63498,2653,1294,1359
39765,82151,18648,39524,13718,63503,2653,1294,1359
39770,82164,18651,39534,13721,63511,2654,1295,1359
39775,82175,18653,39538,13723,63521,2654,1295,1359
39780,82182,18656,39542,13726,63525,2654,1295,1359
39785,82195,18659,39546,13728,63533,2655,1295,1360
39790,82206,18662,39551,13731,63543,2655,1295,1360
39795,82213,18667,39556,13736,63546,2655,1295,1360
39800,82226,18669,39560,13736,63555,2656,1295,1361
39805,82237,18672,39565,13739,63564,2656,1295,1361
39810,82244,18677,39570,13743,63567,2656,1295,1361
39815,82257,18679,39576,13744,63577,2657,1296,1361
39820,82268,18679,39582,13744,63589,2657,1296,1361
39825,82275,18680,39585,13745,63595,2657,1296,1361
39830,82288,18682,39594,13747,63602,2658,1296,1362
39835,82299,18685,39601,13749,63614,2658,1296,1362
39840,82306,18686,39605,13749,63620,2658,1296,1362
39845,82319,18689,39613,13751,63629,2659,1296,1363
39850,82330,18691,39619,13753,63639,2659,1296,1363
39855,82337,18692,39622,13753,63645,2659,1296,1363
39860,82350,18695,39629,13754,63655,2660,1297,1363
39865,82361,18696,39633,13754,63665,2660,1297,1363
39870,82368,18697,39637,13755,63671,2660,1297,1363
39875,82381,18700,39645,13757,63680,2661,1297,1364
39880,82392,18703,39648,13759,63689,2661,1297,1364
39885,82399,18704,39653,13760,63695,2661,1297,1364
39890,82412,18706,39658,13761,63705,2662,1298,1364
39895,82423,18708,39662,13763,63714,2662,1298,1364
39900,82430,18710,39665,13765,63720,2662,1298,1364
39905,82443,18712,39671,13766,63730,2663,1298,1365
39910,82454,18715,39678,13768,63738,2663,1298,1365
39915,82461,18717,39683,13770,63743,2663,1298,1365
39920,82474,18722,39689,13774,63751,2664,1298,1366
39925,82485,18726,39696,13778,63759,2664,1298,1366
39930,82492,18729,39700,13781,63763,2664,1298,1366
39935,82505,18731,39705,13782,63773,2665,1298,1367
39940,82516,18735,39709,13785,63781,2665,1298,1367
39945,82523,18739,39714,13789,63783,2665,1298,1367
39950,82536,18743,39719,13792,63791,2666,1298,1368
39955,82547,18745,39723,13794,63799,2666,1298,1368
39960,82554,18750,39726,13798,63803,2666,1298,1368
39965,82567,18754,39734,13801,63811,2667,1299,1368
39970,82578,18757,39741,13804,63821,2667,1299,1368
39975,82585,18760,39744,13805,63824,2667,1299,1368
39980,82598,18762,39749,13805,63835,2668,1300,1368
39985,82609,18764,39753,13807,63845,2668,1300,1368
39990,82616,18765,39756,13807,63851,2668,1300,1368
39995,82629,18767,39763,13808,63862,2669,1300,1369
40000,82640,18767,39768,13808,63872,2669,1300,1369
40005,82647,18768,39771,13808,63879,2669,1300,1369
40010,82660,18770,39777,13808,63888,2670,1301,1369
40015,82671,18770,39785,13808,63900,2670,1301,1369
40020,82678,18771,39789,13809,63907,2670,1301,1369
40025,82691,18773,39795,13810,63916,2671,1301,1370
40030,82702,18773,39800,13810,63929,2671,1301,1370
40035,82709,18774,39802,13810,63935,2671,1301,1370
40040,82722,18776,39810,13812,63945,2672,1301,1371
40045,82733,18776,39815,13812,63957,2672,1301,1371
40050,82740,18777,39818,13812,63963,2672,1301,1371
40055,82753,18780,39822,13813,63971,2673,1301,1372
40060,82764,18782,39828,13814,63982,2673,1301,1372
40065,82771,18783,39832,13815,63988,2673,1301,1372
40070,82784,18785,39838,13816,63997,2674,1301,1373
40075,82795,18787,39843,13818,64008,2674,1301,1373
40080,82802,18788,39847,13819,64014,2674,1301,1373
40085,82815,18790,39853,13820,64024,2675,1301,1374
40090,82826,18794,39861,13824,64032,2675,1301,1374
40095,82833,18796,39865,13826,64037,2675,1301,1374
40100,82846,18799,39871,13828,64047,2676,1302,1374
40105,82857,18802,39875,13830,64055,2676,1302,1374
40110,82864,18804,39880,13832,64060,2676,1302,1374
40115,82877,18807,39887,13835,64068,2677,1302,1375
40120,82888,18813,39894,13840,64075,2677,1302,1375
40125,82895,18816,39898,13843,64079,2677,1302,1375
40130,82908,18819,39904,13844,64087,2678,1303,1375
40135,82919,18823,39908,13847,64093,2678,1303,1375
40140,82926,18830,39913,13853,64094,2678,1303,1375
40145,82939,18836,39916,13857,64102,2679,1303,1376
40150,82950,18842,39924,13863,64105,2679,1303,1376
40155,82957,18847,39928,13868,64109,2679,1303,1376
40160,82970,18849,39935,13870,64119,2680,1303,1377
40165,82981,18851,39941,13872,64127,2680,1303,1377
40170,82988,18854,39944,13874,64134,2680,1303,1377
40175,83001,18855,39949,13874,64144,2681,1303,1378
40180,83012,18855,39954,13874,64157,2681,1303,1378
40185,83019,18856,39957,13874,64163,2681,1303,1378
40190,83032,18858,39964,13875,64173,2682,1303,1379
40195,83043,18858,39969,13875,64185,2682,1303,1379
40200,83050,18859,39972,13876,64191,2682,1303,1379
40205,83063,18860,39980,13876,64201,2683,1303,1380
40210,83074,18860,39986,13876,64214,2683,1303,1380
40215,83081,18861,39989,13877,64220,2683,1303,1380
40220,83094,18862,39996,13878,64232,2684,1303,1381
40225,83105,18862,40003,13878,64243,2684,1303,1381
40230,83112,18863,40008,13879,64249,2684,1303,1381
40235,83125,18865,40015,13880,64260,2685,1303,1382
40240,83136,18865,40017,13880,64271,2685,1303,1382
40245,83143,18866,40018,13880,64277,2685,1303,1382
40250,83156,18868,40022,13881,64287,2686,1303,1383
40255,83167,18868,40026,13881,64299,2686,1303,1383
40260,83174,18869,40029,13882,64305,2686,1303,1383
40265,83187,18872,40037,13885,64314,2687,1304,1383
40270,83198,18874,40043,13887,64324,2687,1304,1383
40275,83205,18877,40048,13890,64328,2687,1304,1383
40280,83218,18879,40054,13891,64338,2688,1304,1384
40285,83229,18882,40060,13894,64346,2688,1304,1384
40290,83236,18885,40063,13895,64351,2688,1304,1384
40295,83249,18888,40071,13897,64358,2689,1305,1384
40300,83260,18892,40077,13901,64366,2689,1305,1384
40305,83267,18897,40081,13905,64369,2689,1305,1384
40310,83280,18899,40087,13907,64379,2690,1306,1384
40315,83291,18903,40090,13910,64386,2690,1306,1384
40320,83298,18908,40093,13915,64390,2690,1306,1384
40325,83311,18910,40102,13917,64400,2691,1307,1384
40330,83322,18913,40108,13920,64408,2691,1307,1384
40335,83329,18916,40111,13922,64411,2691,1307,1384
40340,83342,18918,40116,13923,64423,2692,1307,1385
40345,83353,18920,40123,13925,64431,2692,1307,1385
40350,83360,18925,40127,13929,64434,2692,1307,1385
40355,83373,18927,40131,13930,64446,2693,1308,1385
40360,83384,18929,40135,13932,64455,2693,1308,1385
40365,83391,18932,40140,13935,64458,2693,1308,1385
40370,83404,18935,40147,13938,64469,2694,1309,1385
40375,83415,18935,40153,13938,64480,2694,1309,1385
40380,83422,18936,40156,13939,64486,2694,1309,1385
40385,83435,18938,40161,13940,64497,2695,1310,1385
40390,83446,18938,40167,13940,64508,2695,1310,1385
40395,83453,18939,40169,13940,64514,2695,1310,1385
40400,83466,18940,40173,13940,64526,2696,1311,1385
40405,83477,18940,40179,13940,64537,2696,1311,1385
40410,83484,18941,40183,13941,64543,2696,1311,1385
40415,83497,18943,40187,13942,64554,2697,1311,1386
40420,83508,18943,40190,13942,64565,2697,1311,1386
40425,83515,18944,40194,13943,64571,2697,1311,1386
40430,83528,18946,40201,13944,64579,2698,1311,1387
40435,83539,18949,40207,13947,64589,2698,1311,1387
40440,83546,18950,40211,13947,64596,2698,1311,1387
40445,83559,18951,40220,13948,64606,2699,1312,1387
40450,83570,18954,40224,13950,64616,2699,1312,1387
40455,83577,18955,40227,13950,64622,2699,1312,1387
40460,83590,18957,40232,13951,64633,2700,1313,1387
40465,83601,18959,40237,13952,64641,2700,1313,1387
40470,83608,18961,40242,13954,64647,2700,1313,1387
40475,83621,18963,40249,13956,64656,2701,1314,1387
40480,83632,18967,40256,13959,64665,2701,1314,1387
40485,83639,18969,40260,13960,64670,2701,1314,1387
40490,83652,18970,40263,13960,64681,2702,1315,1387
40495,83663,18972,40267,13962,64690,2702,1315,1387
40500,83670,18975,40273,13965,64695,2702,1315,1387
40505,83683,18978,40281,13967,64701,2703,1315,1388
40510,83694,18982,40284,13970,64711,2703,1315,1388
40515,83701,18986,40290,13973,64714,2703,1315,1388
40520,83714,18989,40297,13975,64721,2704,1315,1389
40525,83725,18995,40304,13980,64727,2704,1315,1389
40530,83732,19000,40306,13985,64732,2704,1315,1389
40535,83745,19002,40311,13987,64741,2705,1315,1390
40540,83756,19006,40315,13990,64750,2705,1315,1390
40545,83763,19008,40317,13991,64755,2705,1315,1390
40550,83776,19011,40320,13993,64764,2706,1315,1391
40555,83787,19015,40326,13996,64771,2706,1315,1391
40560,83794,19018,40328,13997,64775,2706,1315,1391
40565,83807,19021,40332,13999,64786,2707,1315,1392
40570,83818,19022,40337,14000,64795,2707,1315,1392
40575,83825,19027,40341,14003,64797,2707,1315,1392
40580,83838,19030,40347,14005,64808,2708,1315,1393
40585,83849,19030,40349,14005,64819,2708,1315,1393
40590,83856,19031,40354,14005,64824,2708,1315,1393
40595,83869,19032,40357,14005,64836,2709,1315,1394
40600,83880,19032,40365,14005,64848,2709,1315,1394
40605,83887,19033,40369,14005,64853,2709,1315,1394
40610,83900,19034,40375,14006,64866,2710,1316,1394
40615,83911,19034,40380,14006,64876,2710,1316,1394
40620,83918,19035,40384,14006,64883,2710,1316,1394
40625,83931,19036,40388,14006,64894,2711,1316,1395
40630,83942,19036,40392,14006,64906,2711,1316,1395
40635,83949,19037,40397,14007,64912,2711,1316,1395
40640,83962,19039,40407,14009,64923,2712,1317,1395
40645,83973,19039,40412,14009,64934,2712,1317,1395
40650,83980,19040,40415,14010,64940,2712,1317,1395
40655,83993,19042,40423,14012,64951,2713,1318,1395
40660,84004,19042,40428,14012,64962,2713,1318,1395
40665,84011,19043,40430,14012,64968,2713,1318,1395
40670,84024,19046,40439,14014,64977,2714,1319,1395
40675,84035,19047,40445,14014,64988,2714,1319,1395
40680,84042,19048,40448,14014,64994,2714,1319,1395
40685,84055,19049,40453,14015,65004,2715,1319,1396
40690,84066,19051,40456,14016,65015,2715,1319,1396
40695,84073,19054,40461,14019,65019,2715,1319,1396
40700,84086,19055,40468,14020,65029,2716,1320,1396
40705,84097,19058,40476,14023,65038,2716,1320,1396
40710,84104,19061,40478,14025,65042,2716,1320,1396
40715,84117,19064,40480,14027,65052,2717,1320,1397
40720,84128,19068,40487,14031,65059,2717,1320,1397
40725,84135,19072,40491,14033,65063,2717,1320,1397
40730,84148,19075,40495,14035,65071,2718,1320,1398
40735,84159,19081,40501,14040,65077,2718,1320,1398
40740,84166,19086,40506,14045,65079,2718,1320,1398
40745,84179,19091,40516,14050,65082,2719,1320,1399
40750,84190,19099,40521,14057,65089,2719,1320,1399
40755,84197,19104,40525,14061,65093,2719,1320,1399
40760,84210,19107,40531,14063,65101,2720,1320,1400
40765,84221,19110,40539,14066,65111,2720,1320,1400
40770,84228,19112,40540,14066,65116,2720,1320,1400
40775,84241,19114,40545,14067,65125,2721,1320,1401
40780,84252,19114,40551,14067,65136,2721,1320,1401
40785,84259,19118,40555,14070,65141,2721,1320,1401
40790,84272,19119,40562,14071,65152,2722,1320,1402
40795,84283,19119,40567,14071,65163,2722,1320,1402
40800,84290,19120,40571,14071,65170,2722,1320,1402
40805,84303,19121,40581,14072,65181,2723,1321,1402
40810,84314,19121,40585,14072,65193,2723,1321,1402
40815,84321,19122,40588,14073,65199,2723,1321,1402
40820,84334,19124,40594,14075,65210,2724,1322,1402
40825,84345,19124,40599,14075,65221,2724,1322,1402
40830,84352,19125,40601,14075,65227,2724,1322,1402
40835,84365,19126,40606,14076,65239,2725,1322,1403
40840,84376,19126,40611,14076,65250,2725,1322,1403
40845,84383,19127,40615,14077,65256,2725,1322,1403
40850,84396,19129,40619,14078,65267,2726,1322,1404
40855,84407,19129,40623,14078,65278,2726,1322,1404
40860,84414,19130,40628,14078,65284,2726,1322,1404
40865,84427,19133,40637,14081,65293,2727,1323,1404
40870,84438,19136,40642,14083,65302,2727,1323,1404
40875,84445,19137,40644,14083,65308,2727,1323,1404
40880,84458,19140,40651,14085,65316,2728,1323,1405
40885,84469,19143,40660,14088,65326,2728,1323,1405
40890,84476,19146,40665,14090,65330,2728,1323,1405
40895,84489,19149,40669,14093,65340,2729,1323,1406
40900,84500,19151,40674,14095,65349,2729,1323,1406
40905,84507,19153,40677,14095,65354,2729,1323,1406
40910,84520,19155,40682,14097,65365,2730,1323,1407
40915,84531,19156,40685,14098,65375,2730,1323,1407
40920,84538,19159,40687,14099,65378,2730,1323,1407
40925,84551,19163,40695,14103,65387,2731,1324,1407
40930,84562,19166,40699,14106,65395,2731,1324,1407
40935,84569,19170,40702,14108,65398,2731,1324,1407
40940,84582,19176,40711,14114,65404,2732,1325,1407
40945,84593,19181,40717,14119,65412,2732,1325,1407
40950,84600,19184,40721,14122,65416,2732,1325,1407
40955,84613,19185,40727,14122,65428,2733,1325,1408
40960,84624,19186,40735,14123,65438,2733,1325,1408
40965,84631,19188,40738,14124,65442,2733,1325,1408
40970,84644,19190,40742,14125,65453,2734,1325,1409
40975,84655,19192,40744,14127,65462,2734,1325,1409
40980,84662,19195,40748,14130,65465,2734,1325,1409
40985,84675,19198,40754,14132,65474,2735,1325,1410
40990,84686,19201,40759,14135,65484,2735,1325,1410
40995,84693,19204,40764,14138,65489,2735,1325,1410
41000,84706,19207,40775,14141,65496,2736,1326,1410
41005,84717,19209,40781,14143,65506,2736,1326,1410
41010,84724,19213,40785,14146,65511,2736,1326,1410
41015,84737,19214,40789,14147,65523,2737,1326,1411
41020,84748,19214,40796,14147,65534,2737,1326,1411
41025,84755,19215,40801,14148,65540,2737,1326,1411
41030,84768,19217,40808,14148,65550,2738,1326,1412
41035,84779,19217,40816,14148,65562,2738,1326,1412
41040,84786,19218,40818,14148,65568,2738,1326,1412
41045,84799,19220,40827,14149,65579,2739,1326,1413
41050,84810,19220,40832,14149,65590,2739,1326,1413
41055,84817,19221,40834,14149,65596,2739,1326,1413
41060,84830,19223,40842,14151,65605,2740,1327,1413
41065,84841,19225,40845,14152,65616,2740,1327,1413
41070,84848,19226,40848,14152,65622,2740,1327,1413
41075,84861,19229,40853,14154,65632,2741,1327,1414
41080,84872,19230,40855,14154,65642,2741,1327,1414
41085,84879,19231,40858,14155,65648,2741,1327,1414
41090,84892,19234,40863,14156,65657,2742,1327,1415
41095,84903,19236,40867,14157,65667,2742,1327,1415
41100,84910,19237,40871,14158,65673,2742,1327,1415
41105,84923,19240,40875,14159,65682,2743,1327,1416
41110,84934,19241,40881,14160,65693,2743,1327,1416
41115,84941,19243,40883,14161,65698,2743,1327,1416
41120,84954,19247,40888,14163,65705,2744,1327,1417
41125,84965,19252,40892,14167,65711,2744,1327,1417
41130,84972,19257,40894,14170,65715,2744,1327,1417
41135,84985,19260,40901,14173,65722,2745,1327,1418
41140,84996,19265,40906,14177,65729,2745,1327,1418
41145,85003,19269,40908,14180,65733,2745,1327,1418
41150,85016,19273,40913,14183,65741,2746,1327,1419
41155,85027,19277,40920,14187,65748,2746,1327,1419
41160,85034,19283,40923,14191,65750,2746,1327,1419
41165,85047,19287,40931,14194,65758,2747,1328,1419
41170,85058,19290,40935,14197,65767,2747,1328,1419
41175,85065,19294,40937,14199,65771,2747,1328,1419
41180,85078,19297,40949,14202,65778,2748,1329,1419
41185,85089,19299,40956,14204,65789,2748,1329,1419
41190,85096,19300,40959,14204,65796,2748,1329,1419
41195,85109,19302,40964,14206,65805,2749,1329,1420
41200,85120,19302,40967,14206,65818,2749,1329,1420
41205,85127,19303,40969,14206,65824,2749,1329,1420
41210,85140,19305,40975,14207,65835,2750,1330,1420
41215,85151,19305,40982,14207,65846,2750,1330,1420
41220,85158,19306,40983,14207,65852,2750,1330,1420
41225,85171,19308,40990,14208,65863,2751,1331,1420
41230,85182,19308,40997,14208,65874,2751,1331,1420
41235,85189,19309,41000,14209,65880,2751,1331,1420
41240,85202,19311,41008,14209,65891,2752,1331,1421
41245,85213,19311,41012,14209,65902,2752,1331,1421
41250,85220,19312,41017,14210,65908,2752,1331,1421
41255,85233,19314,41025,14211,65917,2753,1331,1422
41260,85244,19317,41033,14214,65927,2753,1331,1422
41265,85251,19318,41035,14214,65933,2753,1331,1422
41270,85264,19321,41042,14216,65941,2754,1332,1422
41275,85275,19324,41047,14219,65951,2754,1332,1422
41280,85282,19325,41048,14220,65957,2754,1332,1422
41285,85295,19328,41055,14222,65967,2755,1333,1422
41290,85306,19329,41060,14222,65976,2755,1333,1422
41295,85313,19332,41064,14225,65981,2755,1333,1422
41300,85326,19335,41073,14227,65990,2756,1334,1422
41305,85337,19339,41079,14231,65997,2756,1334,1422
41310,85344,19343,41085,14235,66000,2756,1334,1422
41315,85357,19348,41092,14240,66008,2757,1334,1423
41320,85368,19353,41097,14245,66015,2757,1334,1423
41325,85375,19358,41102,14250,66017,2757,1334,1423
41330,85388,19364,41110,14256,66024,2758,1335,1423
41335,85399,19367,41116,14259,66030,2758,1335,1423
41340,85406,19374,41119,14264,66032,2758,1335,1423
41345,85419,19377,41122,14266,66042,2759,1335,1424
41350,85430,19377,41126,14266,66053,2759,1335,1424
41355,85437,19379,41130,14267,66056,2759,1335,1424
41360,85450,19382,41134,14269,66066,2760,1335,1425
41365,85461,19384,41141,14271,66076,2760,1335,1425
41370,85468,19387,41143,14273,66080,2760,1335,1425
41375,85481,19389,41149,14274,66089,2761,1336,1425
41380,85492,19392,41153,14277,66100,2761,1336,1425
41385,85499,19393,41156,14278,66106,2761,1336,1425
41390,85512,19395,41160,14279,66117,2762,1336,1426
41395,85523,19395,41166,14279,66128,2762,1336,1426
41400,85530,19396,41168,14279,66134,2762,1336,1426
41405,85543,19398,41173,14279,66144,2763,1336,1427
41410,85554,19398,41176,14279,66156,2763,1336,1427
41415,85561,19399,41180,14280,66162,2763,1336,1427
41420,85574,19401,41182,14281,66173,2764,1336,1428
41425,85585,19401,41187,14281,66184,2764,1336,1428
41430,85592,19402,41190,14282,66190,2764,1336,1428
41435,85605,19404,41195,14283,66201,2765,1337,1428
41440,85616,19404,41196,14283,66212,2765,1337,1428
41445,85623,19405,41201,14284,66218,2765,1337,1428
41450,85636,19407,41207,14284,66227,2766,1337,1429
41455,85647,19409,41212,14285,66238,2766,1337,1429
41460,85654,19410,41213,14285,66244,2766,1337,1429
41465,85667,19413,41221,14288,66252,2767,1337,1430
41470,85678,19416,41229,14291,66262,2767,1337,1430
41475,85685,19417,41233,14292,66268,2767,1337,1430
41480,85698,19419,41238,14293,66279,2768,1338,1430
41485,85709,19420,41244,14294,66289,2768,1338,1430
41490,85716,19422,41247,14295,66294,2768,1338,1430
41495,85729,19424,41253,14296,66302,2769,1338,1431
41500,85740,19429,41258,14300,66310,2769,1338,1431
41505,85747,19433,41263,14303,66314,2769,1338,1431
41510,85760,19437,41267,14306,66323,2770,1338,1432
41515,85771,19438,41271,14307,66330,2770,1338,1432
41520,85778,19445,41276,14314,66333,2770,1338,1432
41525,85791,19448,41283,14316,66339,2771,1338,1433
41530,85802,19453,41287,14321,66347,2771,1338,1433
41535,85809,19458,41291,14325,66350,2771,1338,1433
41540,85822,19463,41296,14328,66358,2772,1339,1433
41545,85833,19466,41299,14331,66367,2772,1339,1433
41550,85840,19470,41303,14334,66370,2772,1339,1433
41555,85853,19474,41309,14336,66376,2773,1340,1433
41560,85864,19480,41313,14341,66383,2773,1340,1433
41565,85871,19482,41315,14343,66389,2773,1340,1433
41570,85884,19485,41321,14346,66396,2774,1340,1434
41575,85895,19489,41326,14349,66405,2774,1340,1434
41580,85902,19490,41327,14349,66412,2774,1340,1434
41585,85915,19492,41333,14350,66422,2775,1340,1435
41590,85926,19492,41338,14350,66433,2775,1340,1435
41595,85933,19493,41339,14350,66440,2775,1340,1435
41600,85946,19495,41349,14352,66450,2776,1341,1435
41605,85957,19495,41352,14352,66461,2776,1341,1435
41610,85964,19496,41355,14353,66468,2776,1341,1435
41615,85977,19498,41360,14355,66478,2777,1341,1436
41620,85988,19498,41364,14355,66490,2777,1341,1436
41625,85995,19499,41367,14356,66496,2777,1341,1436
41630,86008,19501,41376,14358,66507,2778,1342,1436
41635,86019,19501,41381,14358,66518,2778,1342,1436
41640,86026,19502,41385,14359,66523,2778,1342,1436
41645,86039,19504,41392,14359,66534,2779,1342,1437
41650,86050,19504,41397,14359,66546,2779,1342,1437
41655,86057,19505,41402,14360,66552,2779,1342,1437
41660,86070,19507,41411,14361,66562,2780,1342,1438
41665,86081,19507,41417,14361,66573,2780,1342,1438
41670,86088,19510,41420,14363,66578,2780,1342,1438
41675,86101,19512,41428,14364,66589,2781,1342,1439
41680,86112,19514,41434,14366,66598,2781,1342,1439
41685,86119,19516,41435,14367,66603,2781,1342,1439
41690,86132,19519,41442,14369,66611,2782,1342,1440
41695,86143,19523,41447,14372,66619,2782,1342,1440
41700,86150,19526,41449,14373,66624,2782,1342,1440
41705,86163,19528,41452,14375,66634,2783,1342,1441
41710,86174,19530,41455,14376,66643,2783,1342,1441
41715,86181,19534,41458,14380,66647,2783,1342,1441
41720,86194,19536,41465,14381,66655,2784,1343,1441
41725,86205,19539,41469,14384,66666,2784,1343,1441
41730,86212,19541,41472,14385,66670,2784,1343,1441
41735,86225,19546,41482,14389,66675,2785,1344,1441
41740,86236,19554,41489,14397,66681,2785,1344,1441
41745,86243,19556,41493,14398,66687,2785,1344,1441
41750,86256,19559,41500,14399,66694,2786,1344,1442
41755,86267,19562,41505,14402,66704,2786,1344,1442
41760,86274,19564,41508,14404,66710,2786,1344,1442
41765,86287,19566,41514,14406,66720,2787,1344,1443
41770,86298,19568,41521,14407,66729,2787,1344,1443
41775,86305,19570,41524,14409,66735,2787,1344,1443
41780,86318,19574,41531,14412,66741,2788,1344,1444
41785,86329,19579,41536,14417,66749,2788,1344,1444
41790,86336,19582,41539,14420,66753,2788,1344,1444
41795,86349,19588,41546,14425,66760,2789,1344,1445
41800,86360,19588,41551,14425,66771,2789,1344,1445
41805,86367,19589,41557,14426,66777,2789,1344,1445
41810,86380,19591,41561,14427,66788,2790,1345,1445
41815,86391,19591,41566,14427,66799,2790,1345,1445
41820,86398,19592,41570,14427,66806,2790,1345,1445
41825,86411,19594,41577,14429,66817,2791,1345,1446
41830,86422,19594,41583,14429,66828,2791,1345,1446
41835,86429,19595,41587,14430,66834,2791,1345,1446
41840,86442,19597,41594,14431,66845,2792,1345,1447
41845,86453,19597,41598,14431,66856,2792,1345,1447
41850,86460,19599,41599,14432,66861,2792,1345,1447
41855,86473,19601,41603,14433,66872,2793,1345,1448
41860,86484,19602,41606,14434,66882,2793,1345,1448
41865,86491,19604,41608,14434,66887,2793,1345,1448
41870,86504,19606,41611,14434,66898,2794,1346,1448
41875,86515,19607,41617,14435,66908,2794,1346,1448
41880,86522,19611,41621,14438,66910,2794,1346,1448
41885,86535,19615,41627,14440,66919,2795,1346,1449
41890,86546,19618,41632,14443,66927,2795,1346,1449
41895,86553,19621,41634,14444,66931,2795,1346,1449
41900,86566,19625,41641,14448,66939,2796,1346,1450
41905,86577,19630,41648,14453,66946,2796,1346,1450
41910,86584,19634,41650,14456,66950,2796,1346,1450
41915,86597,19638,41655,14458,66957,2797,1346,1451
41920,86608,19640,41662,14459,66967,2797,1346,1451
41925,86615,19643,41665,14462,66971,2797,1346,1451
41930,86628,19648,41673,14466,66978,2798,1347,1451
41935,86639,19653,41681,14471,66986,2798,1347,1451
41940,86646,19654,41684,14472,66992,2798,1347,1451
41945,86659,19657,41689,14474,67002,2799,1347,1452
41950,86670,19658,41694,14474,67011,2799,1347,1452
41955,86677,19660,41697,14476,67017,2799,1347,1452
41960,86690,19662,41702,14478,67027,2800,1347,1453
41965,86701,19665,41707,14480,67035,2800,1347,1453
41970,86708,19667,41709,14481,67041,2800,1347,1453
41975,86721,19671,41720,14484,67048,2801,1348,1453
41980,86732,19672,41720,14485,67060,2801,1348,1453
41985,86739,19673,41724,14485,67066,2801,1348,1453
41990,86752,19675,41733,14487,67077,2802,1349,1453
41995,86763,19675,41739,14487,67088,2802,1349,1453
42000,86770,19676,41741,14488,67094,2802,1349,1453
42005,86783,19678,41749,14489,67104,2803,1350,1453
42010,86794,19678,41756,14489,67116,2803,1350,1453
42015,86801,19679,41759,14490,67122,2803,1350,1453
42020,86814,19681,41762,14490,67133,2804,1350,1454
42025,86825,19683,41767,14492,67141,2804,1350,1454
42030,86832,19688,41771,14496,67144,2804,1350,1454
42035,86845,19691,41779,14499,67153,2805,1350,1455
42040,86856,19693,41784,14501,67162,2805,1350,1455
42045,86863,19696,41785,14502,67166,2805,1350,1455
42050,86876,19699,41792,14504,67175,2806,1350,1456
42055,86887,19702,41799,14507,67183,2806,1350,1456
42060,86894,19706,41800,14509,67187,2806,1350,1456
42065,86907,19709,41807,14511,67196,2807,1351,1456
42070,86918,19710,41811,14512,67207,2807,1351,1456
42075,86925,19711,41815,14513,67214,2807,1351,1456
42080,86938,19713,41823,14514,67222,2808,1351,1457
42085,86949,19714,41829,14515,67234,2808,1351,1457
42090,86956,19715,41834,14516,67241,2808,1351,1457
42095,86969,19717,41837,14517,67250,2809,1351,1458
42100,86980,19718,41842,14517,67261,2809,1351,1458
42105,86987,19719,41844,14517,67268,2809,1351,1458
42110,87000,19722,41851,14519,67275,2810,1351,1459
42115,87011,19725,41855,14521,67286,2810,1351,1459
42120,87018,19726,41860,14521,67292,2810,1351,1459
42125,87031,19729,41868,14524,67301,2811,1351,1460
42130,87042,19731,41874,14526,67311,2811,1351,1460
42135,87049,19732,41877,14526,67317,2811,1351,1460
42140,87062,19734,41883,14527,67326,2812,1352,1460
42145,87073,19737,41887,14529,67336,2812,1352,1460
42150,87080,19738,41891,14530,67342,2812,1352,1460
42155,87093,19740,41895,14530,67353,2813,1352,1461
42160,87104,19741,41902,14531,67363,2813,1352,1461
42165,87111,19742,41907,14532,67369,2813,1352,1461
42170,87124,19744,41914,14534,67378,2814,1352,1462
42175,87135,19748,41920,14537,67387,2814,1352,1462
42180,87142,19751,41924,14539,67391,2814,1352,1462
42185,87155,19755,41930,14543,67400,2815,1353,1462
42190,87166,19759,41937,14546,67407,2815,1353,1462
42195,87173,19761,41939,14548,67412,2815,1353,1462
42200,87186,19764,41945,14550,67421,2816,1354,1462
42205,87197,19768,41952,14554,67429,2816,1354,1462
42210,87204,19771,41955,14556,67433,2816,1354,1462
42215,87217,19774,41960,14558,67441,2817,1354,1463
42220,87228,19777,41963,14560,67450,2817,1354,1463
42225,87235,19782,41969,14564,67452,2817,1354,1463
42230,87248,19785,41977,14567,67458,2818,1355,1463
42235,87259,19793,41981,14574,67464,2818,1355,1463
42240,87266,19799,41985,14579,67467,2818,1355,1463
42245,87279,19803,41992,14582,67473,2819,1355,1464
42250,87290,19807,41999,14586,67482,2819,1355,1464
42255,87297,19808,42005,14587,67489,2819,1355,1464
42260,87310,19810,42008,14587,67500,2820,1355,1465
42265,87321,19810,42014,14587,67511,2820,1355,1465
42270,87328,19811,42018,14587,67516,2820,1355,1465
42275,87341,19813,42026,14589,67528,2821,1356,1465
42280,87352,19813,42032,14589,67539,2821,1356,1465
42285,87359,19814,42035,14590,67545,2821,1356,1465
42290,87372,19816,42043,14591,67556,2822,1356,1466
42295,87383,19816,42048,14591,67567,2822,1356,1466
42300,87390,19817,42052,14592,67573,2822,1356,1466
42305,87403,19819,42056,14592,67584,2823,1357,1466
42310,87414,19819,42061,14592,67595,2823,1357,1466
42315,87421,19820,42066,14593,67601,2823,1357,1466
42320,87434,19822,42075,14595,67612,2824,1358,1466
42325,87445,19822,42079,14595,67623,2824,1358,1466
42330,87452,19823,42082,14595,67629,2824,1358,1466
42335,87465,19825,42088,14595,67640,2825,1359,1466
42340,87476,19825,42092,14595,67651,2825,1359,1466
42345,87483,19826,42096,14595,67657,2825,1359,1466
42350,87496,19828,42104,14595,67668,2826,1359,1467
42355,87507,19830,42110,14597,67677,2826,1359,1467
42360,87514,19832,42112,14597,67682,2826,1359,1467
42365,87527,19834,42118,14598,67692,2827,1359,1468
42370,87538,19837,42126,14600,67700,2827,1359,1468
42375,87545,19840,42132,14603,67705,2827,1359,1468
42380,87558,19844,42139,14606,67712,2828,1360,1468
42385,87569,19848,42146,14610,67719,2828,1360,1468
42390,87576,19852,42149,14613,67723,2828,1360,1468
42395,87589,19856,42156,14617,67731,2829,1360,1469
42400,87600,19859,42161,14619,67740,2829,1360,1469
42405,87607,19863,42164,14622,67744,2829,1360,1469
42410,87620,19867,42170,14625,67751,2830,1360,1470
42415,87631,19870,42176,14627,67758,2830,1360,1470
42420,87638,19876,42180,14633,67762,2830,1360,1470
42425,87651,19878,42182,14633,67773,2831,1361,1470
42430,87662,19880,42188,14635,67781,2831,1361,1470
42435,87669,19882,42193,14637,67787,2831,1361,1470
42440,87682,19885,42200,14640,67794,2832,1362,1470
42445,87693,19888,42206,14643,67804,2832,1362,1470
42450,87700,19890,42208,14644,67810,2832,1362,1470
42455,87713,19892,42214,14645,67818,2833,1362,1471
42460,87724,19895,42219,14647,67829,2833,1362,1471
42465,87731,19896,42223,14648,67835,2833,1362,1471
42470,87744,19899,42227,14649,67845,2834,1363,1471
42475,87755,19901,42234,14651,67853,2834,1363,1471
42480,87762,19903,42239,14653,67859,2834,1363,1471
42485,87775,19907,42249,14657,67865,2835,1364,1471
42490,87786,19911,42253,14661,67875,2835,1364,1471
42495,87793,19912,42258,14662,67881,2835,1364,1471
42500,87806,19914,42265,14662,67891,2836,1364,1472
42505,87817,19914,42273,14662,67902,2836,1364,1472
42510,87824,19915,42278,14663,67909,2836,1364,1472
42515,87837,19917,42285,14664,67919,2837,1365,1472
42520,87848,19917,42291,14664,67931,2837,1365,1472
42525,87855,19918,42295,14664,67937,2837,1365,1472
42530,87868,19920,42300,14665,67948,2838,1365,1473
42535,87879,19921,42307,14666,67957,2838,1365,1473
42540,87886,19923,42309,14667,67963,2838,1365,1473
42545,87899,19925,42317,14668,67974,2839,1365,1474
42550,87910,19926,42320,14669,67984,2839,1365,1474
42555,87917,19928,42322,14669,67989,2839,1365,1474
42560,87930,19930,42327,14670,67999,2840,1365,1475
42565,87941,19931,42332,14671,68010,2840,1365,1475
42570,87948,19933,42336,14672,68015,2840,1365,1475
42575,87961,19935,42339,14672,68026,2841,1365,1476
42580,87972,19937,42347,14674,68035,2841,1365,1476
42585,87979,19940,42351,14677,68038,2841,1365,1476
42590,87992,19944,42359,14680,68048,2842,1365,1477
42595,88003,19946,42366,14682,68056,2842,1365,1477
42600,88010,19949,42369,14684,68060,2842,1365,1477
42605,88023,19953,42373,14687,68068,2843,1365,1478
42610,88034,19956,42377,14689,68076,2843,1365,1478
42615,88041,19962,42381,14694,68079,2843,1365,1478
42620,88054,19964,42387,14695,68086,2844,1365,1479
42625,88065,19968,42391,14699,68097,2844,1365,1479
42630,88072,19969,42395,14699,68103,2844,1365,1479
42635,88085,19972,42401,14701,68111,2845,1365,1480
42640,88096,19975,42405,14703,68120,2845,1365,1480
42645,88103,19977,42409,14705,68126,2845,1365,1480
42650,88116,19979,42414,14706,68136,2846,1365,1481
42655,88127,19981,42423,14708,68146,2846,1365,1481
42660,88134,19982,42425,14708,68152,2846,1365,1481
42665,88147,19984,42426,14708,68162,2847,1365,1482
42670,88158,19986,42430,14709,68172,2847,1365,1482
42675,88165,19987,42433,14710,68177,2847,1365,1482
42680,88178,19992,42441,14715,68186,2848,1365,1483
42685,88189,19994,42446,14716,68194,2848,1365,1483
42690,88196,19997,42448,14718,68199,2848,1365,1483
42695,88209,20001,42455,14720,68207,2849,1366,1483
42700,88220,20003,42458,14721,68217,2849,1366,1483
42705,88227,20004,42462,14722,68223,2849,1366,1483
42710,88240,20007,42466,14723,68231,2850,1366,1484
42715,88251,20011,42473,14726,68239,2850,1366,1484
42720,88258,20013,42477,14728,68245,2850,1366,1484
42725,88271,20015,42483,14729,68256,2851,1366,1485
42730,88282,20015,42484,14729,68267,2851,1366,1485
42735,88289,20017,42486,14729,68271,2851,1366,1485
42740,88302,20019,42494,14730,68283,2852,1366,1486
42745,88313,20019,42500,14730,68294,2852,1366,1486
42750,88320,20022,42507,14733,68297,2852,1366,1486
42755,88333,20024,42513,14734,68309,2853,1367,1486
42760,88344,20025,42519,14735,68319,2853,1367,1486
42765,88351,20027,42522,14737,68324,2853,1367,1486
42770,88364,20029,42529,14737,68331,2854,1368,1486
42775,88375,20032,42536,14740,68341,2854,1368,1486
42780,88382,20038,42542,14746,68343,2854,1368,1486
42785,88395,20041,42547,14748,68352,2855,1368,1487
42790,88406,20043,42551,14750,68362,2855,1368,1487
42795,88413,20046,42553,14751,68366,2855,1368,1487
42800,88426,20050,42558,14753,68374,2856,1369,1487
42805,88437,20053,42564,14756,68383,2856,1369,1487
42810,88444,20057,42566,14759,68387,2856,1369,1487
42815,88457,20059,42570,14759,68398,2857,1370,1487
42820,88468,20059,42576,14759,68409,2857,1370,1487
42825,88475,20060,42580,14760,68415,2857,1370,1487
42830,88488,20063,42587,14762,68424,2858,1371,1487
42835,88499,20065,42592,14763,68434,2858,1371,1487
42840,88506,20066,42595,14763,68440,2858,1371,1487
42845,88519,20069,42602,14766,68450,2859,1372,1487
42850,88530,20070,42609,14766,68460,2859,1372,1487
42855,88537,20071,42613,14767,68466,2859,1372,1487
42860,88550,20073,42619,14768,68476,2860,1373,1487
42865,88561,20075,42625,14770,68486,2860,1373,1487
42870,88568,20076,42628,14771,68492,2860,1373,1487
42875,88581,20078,42634,14772,68501,2861,1374,1487
42880,88592,20081,42638,14775,68510,2861,1374,1487
42885,88599,20083,42642,14776,68516,2861,1374,1487
42890,88612,20086,42647,14777,68525,2862,1375,1487
42895,88623,20087,42652,14778,68536,2862,1375,1487
42900,88630,20088,42657,14778,68542,2862,1375,1487
42905,88643,20092,42664,14782,68550,2863,1375,1488
42910,88654,20094,42668,14784,68559,2863,1375,1488
42915,88661,20098,42672,14788,68562,2863,1375,1488
42920,88674,20101,42677,14790,68570,2864,1375,1489
42925,88685,20105,42679,14793,68580,2864,1375,1489
42930,88692,20109,42683,14796,68582,2864,1375,1489
42935,88705,20113,42689,14799,68588,2865,1375,1490
42940,88716,20121,42696,14806,68592,2865,1375,1490
42945,88723,20126,42698,14810,68597,2865,1375,1490
42950,88736,20129,42708,14812,68603,2866,1375,1491
42955,88747,20132,42711,14815,68614,2866,1375,1491
42960,88754,20137,42716,14819,68616,2866,1375,1491
42965,88767,20140,42724,14820,68625,2867,1376,1491
42970,88778,20140,42729,14820,68637,2867,1376,1491
42975,88785,20141,42730,14820,68644,2867,1376,1491
42980,88798,20143,42735,14822,68654,2868,1376,1492
42985,88809,20143,42737,14822,68665,2868,1376,1492
42990,88816,20144,42743,14823,68672,2868,1376,1492
42995,88829,20146,42751,14824,68681,2869,1377,1492
43000,88840,20146,42756,14824,68694,2869,1377,1492
43005,88847,20147,42760,14824,68700,2869,1377,1492
43010,88860,20149,42762,14824,68710,2870,1377,1493
43015,88871,20149,42768,14824,68722,2870,1377,1493
43020,88878,20150,42772,14825,68728,2870,1377,1493
43025,88891,20152,42779,14826,68739,2871,1378,1493
43030,88902,20152,42783,14826,68750,2871,1378,1493
43035,88909,20153,42788,14827,68756,2871,1378,1493
43040,88922,20155,42793,14828,68767,2872,1378,1494
43045,88933,20155,42797,14828,68778,2872,1378,1494
43050,88940,20156,42801,14828,68784,2872,1378,1494
43055,88953,20159,42807,14830,68793,2873,1378,1495
43060,88964,20161,42811,14831,68803,2873,1378,1495
43065,88971,20162,42816,14832,68809,2873,1378,1495
43070,88984,20164,42819,14833,68819,2874,1378,1496
43075,88995,20167,42825,14835,68828,2874,1378,1496
43080,89002,20169,42828,14836,68833,2874,1378,1496
43085,89015,20171,42833,14837,68843,2875,1378,1497
43090,89026,20174,42837,14840,68852,2875,1378,1497
43095,89033,20177,42840,14841,68856,2875,1378,1497
43100,89046,20180,42850,14843,68864,2876,1379,1497
43105,89057,20186,42855,14848,68870,2876,1379,1497
43110,89064,20191,42861,14853,68871,2876,1379,1497
43115,89077,20196,42866,14856,68879,2877,1380,1497
43120,89088,20200,42869,14859,68886,2877,1380,1497
43125,89095,20204,42871,14862,68890,2877,1380,1497
43130,89108,20208,42876,14865,68898,2878,1381,1497
43135,89119,20214,42881,14871,68904,2878,1381,1497
43140,89126,20219,42885,14875,68906,2878,1381,1497
43145,89139,20223,42891,14878,68914,2879,1382,1497
43150,89150,20228,42897,14882,68921,2879,1382,1497
43155,89157,20229,42900,14882,68928,2879,1382,1497
43160,89170,20231,42906,14884,68939,2880,1382,1498
43165,89181,20231,42913,14884,68949,2880,1382,1498
43170,89188,20232,42916,14884,68955,2880,1382,1498
43175,89201,20234,42923,14885,68967,2881,1383,1498
43180,89212,20234,42930,14885,68977,2881,1383,1498
43185,89219,20235,42932,14886,68984,2881,1383,1498
43190,89232,20237,42941,14887,68994,2882,1384,1498
43195,89243,20237,42949,14887,69005,2882,1384,1498
43200,89250,20238,42951,14888,69012,2882,1384,1498
43205,89263,20240,42959,14890,69022,2883,1385,1498
43210,89274,20240,42963,14890,69033,2883,1385,1498
43215,89281,20241,42965,14891,69040,2883,1385,1498
43220,89294,20243,42972,14891,69051,2884,1386,1498
43225,89305,20243,42976,14891,69062,2884,1386,1498
43230,89312,20244,42977,14891,69068,2884,1386,1498
43235,89325,20246,42984,14893,69079,2885,1386,1499
43240,89336,20246,42989,14893,69090,2885,1386,1499
43245,89343,20247,42990,14893,69096,2885,1386,1499
43250,89356,20249,42995,14894,69107,2886,1386,1500
43255,89367,20250,42999,14895,69117,2886,1386,1500
43260,89374,20252,43002,14896,69122,2886,1386,1500
43265,89387,20254,43009,14897,69132,2887,1386,1501
43270,89398,20256,43013,14898,69142,2887,1386,1501
43275,89405,20259,43016,14900,69146,2887,1386,1501
43280,89418,20262,43021,14902,69154,2888,1386,1502
43285,89429,20265,43026,14905,69163,2888,1386,1502
43290,89436,20268,43030,14907,69168,2888,1386,1502
43295,89449,20270,43034,14907,69178,2889,1387,1502
43300,89460,20273,43039,14910,69187,2889,1387,1502
43305,89467,20276,43042,14912,69191,2889,1387,1502
43310,89480,20279,43050,14914,69198,2890,1388,1502
43315,89491,20285,43054,14919,69206,2890,1388,1502
43320,89498,20288,43059,14922,69208,2890,1388,1502
43325,89511,20294,43069,14928,69211,2891,1388,1503
43330,89522,20306,43078,14940,69213,2891,1388,1503
43335,89529,20311,43079,14943,69218,2891,1388,1503
43340,89542,20314,43089,14944,69225,2892,1389,1503
43345,89553,20318,43099,14948,69234,2892,1389,1503
43350,89560,20320,43101,14950,69240,2892,1389,1503
43355,89573,20322,43107,14951,69250,2893,1389,1504
43360,89584,20322,43112,14951,69262,2893,1389,1504
43365,89591,20323,43117,14952,69267,2893,1389,1504
43370,89604,20325,43125,14954,69278,2894,1390,1504
43375,89615,20325,43131,14954,69290,2894,1390,1504
43380,89622,20326,43137,14955,69295,2894,1390,1504
43385,89635,20328,43141,14955,69307,2895,1391,1504
43390,89646,20328,43146,14955,69318,2895,1391,1504
43395,89653,20329,43149,14956,69324,2895,1391,1504
43400,89666,20331,43156,14958,69335,2896,1391,1505
43405,89677,20331,43163,14958,69346,2896,1391,1505
43410,89684,20332,43165,14958,69352,2896,1391,1505
43415,89697,20334,43171,14958,69363,2897,1391,1506
43420,89708,20334,43175,14958,69374,2897,1391,1506
43425,89715,20335,43177,14959,69380,2897,1391,1506
43430,89728,20337,43186,14961,69391,2898,1391,1507
43435,89739,20337,43189,14961,69402,2898,1391,1507
43440,89746,20338,43193,14961,69408,2898,1391,1507
43445,89759,20340,43200,14962,69416,2899,1391,1508
43450,89770,20342,43205,14964,69428,2899,1391,1508
43455,89777,20345,43210,14966,69432,2899,1391,1508
43460,89790,20348,43219,14968,69438,2900,1392,1508
43465,89801,20351,43226,14971,69450,2900,1392,1508
43470,89808,20354,43229,14972,69454,2900,1392,1508
43475,89821,20356,43236,14974,69465,2901,1393,1508
43480,89832,20357,43242,14974,69474,2901,1393,1508
43485,89839,20361,43243,14976,69478,2901,1393,1508
43490,89852,20364,43247,14978,69486,2902,1393,1509
43495,89863,20370,43253,14983,69492,2902,1393,1509
43500,89870,20374,43257,14986,69495,2902,1393,1509
43505,89883,20379,43264,14990,69501,2903,1393,1510
43510,89894,20382,43267,14993,69512,2903,1393,1510
43515,89901,20384,43270,14994,69516,2903,1393,1510
43520,89914,20389,43278,14999,69522,2904,1393,1511
43525,89925,20395,43283,15004,69530,2904,1393,1511
43530,89932,20396,43287,15004,69536,2904,1393,1511
43535,89945,20399,43297,15007,69543,2905,1394,1511
43540,89956,20402,43303,15009,69553,2905,1394,1511
43545,89963,20404,43305,15011,69559,2905,1394,1511
43550,89976,20407,43310,15013,69569,2906,1394,1512
43555,89987,20409,43313,15014,69578,2906,1394,1512
43560,89994,20410,43314,15014,69584,2906,1394,1512
43565,90007,20412,43324,15016,69592,2907,1395,1512
43570,90018,20416,43329,15020,69600,2907,1395,1512
43575,90025,20419,43334,15022,69605,2907,1395,1512
43580,90038,20422,43339,15024,69615,2908,1395,1513
43585,90049,20422,43345,15024,69626,2908,1395,1513
43590,90056,20423,43347,15025,69633,2908,1395,1513
43595,90069,20425,43353,15026,69643,2909,1396,1513
43600,90080,20425,43356,15026,69655,2909,1396,1513
43605,90087,20426,43362,15027,69660,2909,1396,1513
43610,90100,20428,43368,15027,69672,2910,1397,1513
43615,90111,20428,43375,15027,69683,2910,1397,1513
43620,90118,20429,43381,15028,69689,2910,1397,1513
43625,90131,20431,43387,15030,69698,2911,1397,1514
43630,90142,20432,43392,15031,69710,2911,1397,1514
43635,90149,20434,43398,15033,69715,2911,1397,1514
43640,90162,20436,43405,15035,69726,2912,1398,1514
43645,90173,20437,43409,15036,69734,2912,1398,1514
43650,90180,20441,43411,15039,69739,2912,1398,1514
43655,90193,20443,43416,15040,69749,2913,1399,1514
43660,90204,20446,43420,15043,69757,2913,1399,1514
43665,90211,20450,43423,15046,69761,2913,1399,1514
43670,90224,20452,43426,15046,69770,2914,1400,1514
43675,90235,20455,43431,15049,69779,2914,1400,1514
43680,90242,20458,43432,15050,69784,2914,1400,1514
43685,90255,20460,43434,15050,69794,2915,1400,1515
43690,90266,20462,43439,15051,69803,2915,1400,1515
43695,90273,20465,43442,15054,69808,2915,1400,1515
43700,90286,20469,43449,15057,69815,2916,1400,1516
43705,90297,20473,43454,15061,69823,2916,1400,1516
43710,90304,20475,43459,15063,69829,2916,1400,1516
43715,90317,20477,43464,15064,69837,2917,1400,1517
43720,90328,20480,43470,15066,69848,2917,1400,1517
43725,90335,20481,43474,15067,69854,2917,1400,1517
43730,90348,20483,43480,15068,69863,2918,1401,1517
43735,90359,20486,43484,15071,69873,2918,1401,1517
43740,90366,20487,43485,15071,69879,2918,1401,1517
43745,90379,20490,43490,15073,69888,2919,1401,1518
43750,90390,20492,43492,15074,69898,2919,1401,1518
43755,90397,20493,43497,15074,69904,2919,1401,1518
43760,90410,20495,43500,15074,69914,2920,1401,1519
43765,90421,20498,43508,15077,69922,2920,1401,1519
43770,90428,20500,43514,15079,69928,2920,1401,1519
43775,90441,20503,43520,15082,69938,2921,1402,1519
43780,90452,20505,43526,15084,69947,2921,1402,1519
43785,90459,20506,43530,15084,69953,2921,1402,1519
43790,90472,20508,43537,15084,69962,2922,1403,1519
43795,90483,20512,43544,15087,69970,2922,1403,1519
43800,90490,20514,43547,15089,69975,2922,1403,1519
43805,90503,20518,43554,15092,69985,2923,1404,1519
43810,90514,20520,43560,15094,69994,2923,1404,1519
43815,90521,20523,43563,15096,69998,2923,1404,1519
43820,90534,20527,43570,15099,70006,2924,1405,1519
43825,90545,20532,43578,15103,70012,2924,1405,1519
43830,90552,20536,43581,15106,70016,2924,1405,1519
43835,90565,20539,43586,15108,70026,2925,1405,1520
43840,90576,20539,43591,15108,70036,2925,1405,1520
43845,90583,20543,43595,15110,70039,2925,1405,1520
43850,90596,20545,43600,15110,70049,2926,1406,1520
43855,90607,20548,43601,15113,70059,2926,1406,1520
43860,90614,20551,43604,15115,70063,2926,1406,1520
43865,90627,20554,43611,15117,70069,2927,1406,1521
43870,90638,20557,43614,15120,70081,2927,1406,1521
43875,90645,20560,43618,15123,70085,2927,1406,1521
43880,90658,20563,43626,15125,70093,2928,1407,1521
43885,90669,20565,43633,15127,70103,2928,1407,1521
43890,90676,20567,43638,15128,70109,2928,1407,1521
43895,90689,20569,43643,15128,70120,2929,1408,1521
43900,90700,20569,43647,15128,70131,2929,1408,1521
43905,90707,20570,43650,15128,70137,2929,1408,1521
43910,90720,20572,43657,15128,70146,2930,1409,1521
43915,90731,20572,43663,15128,70159,2930,1409,1521
43920,90738,20573,43668,15129,70165,2930,1409,1521
43925,90751,20575,43673,15129,70175,2931,1409,1522
43930,90762,20575,43677,15129,70187,2931,1409,1522
43935,90769,20576,43678,15129,70193,2931,1409,1522
43940,90782,20578,43686,15131,70203,2932,1410,1522
43945,90793,20580,43689,15132,70213,2932,1410,1522
43950,90800,20581,43693,15132,70219,2932,1410,1522
43955,90813,20583,43698,15133,70229,2933,1411,1522
43960,90824,20585,43704,15135,70239,2933,1411,1522
43965,90831,20586,43707,15135,70245,2933,1411,1522
43970,90844,20589,43716,15137,70253,2934,1412,1522
43975,90855,20591,43718,15138,70264,2934,1412,1522
43980,90862,20592,43720,15139,70270,2934,1412,1522
43985,90875,20595,43723,15141,70280,2935,1412,1523
43990,90886,20597,43728,15143,70289,2935,1412,1523
43995,90893,20599,43731,15144,70294,2935,1412,1523
44000,90906,20602,43739,15146,70301,2936,1413,1523
44005,90917,20607,43743,15151,70310,2936,1413,1523
44010,90924,20609,43746,15153,70315,2936,1413,1523
44015,90937,20611,43754,15154,70322,2937,1414,1523
44020,90948,20617,43758,15160,70330,2937,1414,1523
44025,90955,20621,43763,15164,70333,2937,1414,1523
44030,90968,20624,43769,15166,70342,2938,1415,1523
44035,90979,20630,43775,15171,70347,2938,1415,1523
44040,90986,20634,43776,15173,70351,2938,1415,1523
44045,90999,20637,43782,15174,70361,2939,1416,1523
44050,91010,20637,43786,15174,70372,2939,1416,1523
44055,91017,20641,43789,15176,70374,2939,1416,1523
44060,91030,20643,43793,15177,70385,2940,1416,1524
44065,91041,20646,43801,15180,70393,2940,1416,1524
44070,91048,20650,43806,15184,70397,2940,1416,1524
44075,91061,20653,43811,15186,70405,2941,1416,1525
44080,91072,20655,43818,15188,70415,2941,1416,1525
44085,91079,20659,43822,15191,70420,2941,1416,1525
44090,91092,20662,43829,15193,70429,2942,1416,1526
44095,91103,20663,43834,15194,70440,2942,1416,1526
44100,91110,20664,43837,15194,70446,2942,1416,1526
44105,91123,20666,43843,15195,70456,2943,1416,1527
44110,91134,20666,43850,15195,70468,2943,1416,1527
44115,91141,20667,43853,15196,70474,2943,1416,1527
44120,91154,20669,43860,15198,70485,2944,1417,1527
44125,91165,20669,43865,15198,70496,2944,1417,1527
44130,91172,20670,43868,15199,70502,2944,1417,1527
44135,91185,20672,43872,15200,70513,2945,1418,1527
44140,91196,20672,43879,15200,70524,2945,1418,1527
44145,91203,20673,43882,15201,70530,2945,1418,1527
44150,91216,20676,43891,15203,70537,2946,1418,1528
44155,91227,20679,43895,15206,70548,2946,1418,1528
44160,91234,20680,43897,15207,70554,2946,1418,1528
44165,91247,20683,43907,15210,70563,2947,1419,1528
44170,91258,20685,43913,15211,70573,2947,1419,1528
44175,91265,20686,43919,15212,70579,2947,1419,1528
44180,91278,20690,43930,15216,70587,2948,1420,1528
44185,91289,20693,43936,15218,70596,2948,1420,1528
44190,91296,20694,43940,15219,70602,2948,1420,1528
44195,91309,20697,43946,15222,70611,2949,1421,1528
44200,91320,20700,43951,15224,70619,2949,1421,1528
44205,91327,20704,43956,15227,70622,2949,1421,1528
44210,91340,20708,43964,15231,70630,2950,1422,1528
44215,91351,20712,43967,15235,70639,2950,1422,1528
44220,91358,20714,43971,15236,70644,2950,1422,1528
44225,91371,20715,43977,15237,70655,2951,1422,1529
44230,91382,20715,43983,15237,70666,2951,1422,1529
44235,91389,20717,43986,15237,70671,2951,1422,1529
44240,91402,20719,43994,15239,70680,2952,1423,1529
44245,91413,20721,43998,15241,70690,2952,1423,1529
44250,91420,20724,44001,15243,70696,2952,1423,1529
44255,91433,20725,44005,15243,70707,2953,1423,1530
44260,91444,20726,44011,15244,70716,2953,1423,1530
44265,91451,20730,44012,15246,70720,2953,1423,1530
44270,91464,20734,44018,15249,70729,2954,1424,1530
44275,91475,20737,44025,15252,70737,2954,1424,1530
44280,91482,20742,44031,15257,70739,2954,1424,1530
44285,91495,20746,44040,15261,70748,2955,1425,1530
44290,91506,20748,44044,15263,70758,2955,1425,1530
44295,91513,20749,44049,15264,70764,2955,1425,1530
44300,91526,20750,44053,15264,70776,2956,1426,1530
44305,91537,20750,44059,15264,70787,2956,1426,1530
44310,91544,20751,44063,15265,70793,2956,1426,1530
44315,91557,20753,44072,15266,70804,2957,1427,1530
44320,91568,20753,44076,15266,70815,2957,1427,1530
44325,91575,20754,44079,15266,70821,2957,1427,1530
44330,91588,20756,44082,15267,70831,2958,1427,1531
44335,91599,20757,44089,15268,70842,2958,1427,1531
44340,91606,20758,44092,15269,70848,2958,1427,1531
44345,91619,20759,44098,15270,70858,2959,1427,1532
44350,91630,20761,44103,15272,70869,2959,1427,1532
44355,91637,20762,44106,15272,70875,2959,1427,1532
44360,91650,20765,44113,15274,70884,2960,1428,1532
44365,91661,20768,44119,15277,70893,2960,1428,1532
44370,91668,20769,44122,15278,70899,2960,1428,1532
44375,91681,20771,44128,15280,70910,2961,1428,1533
44380,91692,20773,44132,15281,70918,2961,1428,1533
44385,91699,20775,44137,15282,70923,2961,1428,1533
44390,91712,20779,44141,15286,70933,2962,1428,1534
44395,91723,20781,44144,15287,70942,2962,1428,1534
44400,91730,20783,44144,15287,70947,2962,1428,1534
44405,91743,20787,44153,15290,70955,2963,1429,1534
44410,91754,20791,44159,15294,70962,2963,1429,1534
44415,91761,20796,44163,15297,70963,2963,1429,1534
44420,91774,20802,44171,15303,70970,2964,1430,1534
44425,91785,20807,44176,15308,70977,2964,1430,1534
44430,91792,20811,44178,15310,70981,2964,1430,1534
44435,91805,20813,44188,15312,70991,2965,1431,1534
44440,91816,20816,44194,15315,70998,2965,1431,1534
44445,91823,20821,44199,15320,71001,2965,1431,1534
44450,91836,20822,44204,15321,71013,2966,1431,1535
44455,91847,20822,44210,15321,71025,2966,1431,1535
44460,91854,20823,44212,15321,71030,2966,1431,1535
44465,91867,20824,44215,15321,71042,2967,1431,1536
44470,91878,20824,44219,15321,71053,2967,1431,1536
44475,91885,20825,44223,15321,71060,2967,1431,1536
44480,91898,20826,44228,15322,71070,2968,1431,1537
44485,91909,20826,44237,15322,71083,2968,1431,1537
44490,91916,20827,44241,15323,71089,2968,1431,1537
44495,91929,20828,44247,15324,71100,2969,1431,1538
44500,91940,20828,44250,15324,71112,2969,1431,1538
44505,91947,20829,44256,15324,71118,2969,1431,1538
44510,91960,20831,44261,15325,71129,2970,1431,1539
44515,91971,20831,44266,15325,71140,2970,1431,1539
44520,91978,20832,44269,15326,71146,2970,1431,1539
44525,91991,20833,44274,15326,71158,2971,1431,1540
44530,92002,20833,44279,15326,71169,2971,1431,1540
44535,92009,20834,44281,15327,71175,2971,1431,1540
44540,92022,20836,44288,15329,71184,2972,1432,1540
44545,92033,20838,44291,15330,71195,2972,1432,1540
44550,92040,20840,44297,15332,71200,2972,1432,1540
44555,92053,20842,44303,15333,71211,2973,1433,1540
44560,92064,20844,44307,15334,71220,2973,1433,1540
44565,92071,20847,44309,15335,71224,2973,1433,1540
44570,92084,20850,44314,15337,71234,2974,1434,1540
44575,92095,20853,44321,15339,71242,2974,1434,1540
44580,92102,20855,44321,15339,71247,2974,1434,1540
44585,92115,20856,44326,15339,71257,2975,1435,1540
44590,92126,20859,44332,15341,71266,2975,1435,1540
44595,92133,20863,44335,15344,71270,2975,1435,1540
44600,92146,20865,44339,15345,71280,2976,1436,1540
44605,92157,20867,44341,15347,71290,2976,1436,1540
44610,92164,20870,44344,15348,71293,2976,1436,1540
44615,92177,20874,44351,15352,71300,2977,1437,1540
44620,92188,20883,44357,15360,71304,2977,1437,1540
44625,92195,20889,44362,15365,71305,2977,1437,1540
44630,92208,20893,44368,15368,71312,2978,1438,1540
44635,92219,20899,44373,15374,71318,2978,1438,1540
44640,92226,20904,44374,15377,71322,2978,1438,1540
44645,92239,20906,44378,15378,71331,2979,1438,1541
44650,92250,20907,44382,15379,71342,2979,1438,1541
44655,92257,20911,44384,15382,71346,2979,1438,1541
44660,92270,20913,44390,15383,71356,2980,1439,1541
44665,92281,20913,44394,15383,71368,2980,1439,1541
44670,92288,20914,44397,15383,71374,2980,1439,1541
44675,92301,20916,44405,15385,71382,2981,1439,1542
44680,92312,20916,44412,15385,71395,2981,1439,1542
44685,92319,20917,44416,15385,71402,2981,1439,1542
44690,92332,20918,44423,15386,71412,2982,1439,1543
44695,92343,20918,44427,15386,71425,2982,1439,1543
44700,92350,20919,44430,15386,71431,2982,1439,1543
44705,92363,20920,44435,15386,71443,2983,1439,1544
44710,92374,20920,44441,15386,71454,2983,1439,1544
44715,92381,20921,44444,15386,71460,2983,1439,1544
44720,92394,20922,44451,15387,71472,2984,1439,1545
44725,92405,20922,44457,15387,71483,2984,1439,1545
44730,92412,20923,44460,15387,71489,2984,1439,1545
44735,92425,20924,44464,15387,71501,2985,1439,1546
44740,92436,20924,44467,15387,71512,2985,1439,1546
44745,92443,20925,44471,15387,71518,2985,1439,1546
44750,92456,20927,44476,15388,71528,2986,1439,1547
44755,92467,20930,44480,15390,71537,2986,1439,1547
44760,92474,20931,44481,15390,71543,2986,1439,1547
44765,92487,20933,44487,15391,71553,2987,1439,1548
44770,92498,20937,44495,15394,71560,2987,1439,1548
44775,92505,20940,44497,15395,71565,2987,1439,1548
44780,92518,20944,44506,15398,71573,2988,1439,1549
44785,92529,20949,44513,15403,71579,2988,1439,1549
44790,92536,20952,44514,15404,71584,2988,1439,1549
44795,92549,20954,44520,15405,71591,2989,1439,1550
44800,92560,20960,44526,15410,71597,2989,1439,1550
44805,92567,20967,44530,15416,71600,2989,1439,1550
44810,92580,20971,44537,15420,71606,2990,1439,1551
44815,92591,20976,44542,15425,71612,2990,1439,1551
44820,92598,20982,44544,15430,71616,2990,1439,1551
44825,92611,20984,44550,15431,71625,2991,1440,1551
44830,92622,20984,44555,15431,71638,2991,1440,1551
44835,92629,20985,44558,15431,71644,2991,1440,1551
44840,92642,20987,44561,15432,71654,2992,1440,1552
44845,92653,20987,44563,15432,71665,2992,1440,1552
44850,92660,20988,44565,15432,71671,2992,1440,1552
44855,92673,20990,44572,15434,71682,2993,1441,1552
44860,92684,20990,44576,15434,71694,2993,1441,1552
44865,92691,20991,44581,15435,71700,2993,1441,1552
44870,92704,20993,44585,15436,71711,2994,1441,1553
44875,92715,20993,44591,15436,71722,2994,1441,1553
44880,92722,20994,44593,15437,71728,2994,1441,1553
44885,92735,20996,44595,15437,71739,2995,1441,1554
44890,92746,20996,44603,15437,71749,2995,1441,1554
44895,92753,20997,44604,15437,71756,2995,1441,1554
44900,92766,20999,44611,15438,71767,2996,1442,1554
44905,92777,20999,44613,15438,71778,2996,1442,1554
44910,92784,21000,44619,15439,71784,2996,1442,1554
44915,92797,21002,44625,15440,71794,2997,1442,1555
44920,92808,21002,44627,15440,71806,2997,1442,1555
44925,92815,21003,44629,15440,71812,2997,1442,1555
44930,92828,21006,44637,15441,71819,2998,1443,1555
44935,92839,21009,44643,15443,71829,2998,1443,1555
44940,92846,21011,44645,15444,71835,2998,1443,1555
44945,92859,21014,44649,15445,71842,2999,1443,1556
44950,92870,21018,44652,15448,71852,2999,1443,1556
44955,92877,21021,44656,15450,71856,2999,1443,1556
44960,92890,21024,44662,15452,71866,3000,1444,1556
44965,92901,21026,44668,15453,71875,3000,1444,1556
44970,92908,21028,44671,15453,71880,3000,1444,1556
44975,92921,21031,44677,15456,71888,3001,1444,1557
44980,92932,21036,44681,15460,71896,3001,1444,1557
44985,92939,21038,44683,15461,71901,3001,1444,1557
44990,92952,21042,44690,15465,71908,3002,1445,1557
44995,92963,21046,44699,15468,71914,3002,1445,1557
45000,92970,21051,44702,15472,71918,3002,1445,1557
45005,92983,21055,44705,15474,71926,3003,1445,1558
45010,92994,21059,44710,15477,71933,3003,1445,1558
45015,93001,21063,44711,15480,71938,3003,1445,1558
45020,93014,21066,44716,15482,71946,3004,1445,1559
45025,93025,21069,44719,15484,71954,3004,1445,1559
45030,93032,21074,44722,15487,71957,3004,1445,1559
45035,93045,21078,44727,15490,71966,3005,1445,1560
45040,93056,21078,44732,15490,71977,3005,1445,1560
45045,93063,21082,44736,15493,71980,3005,1445,1560
45050,93076,21085,44744,15495,71989,3006,1446,1560
45055,93087,21088,44749,15498,71999,3006,1446,1560
45060,93094,21089,44753,15499,72004,3006,1446,1560
45065,93107,21091,44762,15501,72015,3007,1447,1560
45070,93118,21091,44766,15501,72027,3007,1447,1560
45075,93125,21092,44769,15501,72033,3007,1447,1560
45080,93138,21094,44776,15501,72042,3008,1447,1561
45085,93149,21094,44779,15501,72055,3008,1447,1561
45090,93156,21095,44782,15502,72060,3008,1447,1561
45095,93169,21097,44790,15503,72070,3009,1447,1562
45100,93180,21097,44796,15503,72082,3009,1447,1562
45105,93187,21098,44798,15503,72089,3009,1447,1562
45110,93200,21100,44803,15504,72099,3010,1447,1563
45115,93211,21100,44811,15504,72111,3010,1447,1563
45120,93218,21101,44813,15505,72117,3010,1447,1563
45125,93231,21103,44817,15506,72127,3011,1447,1564
45130,93242,21103,44823,15506,72139,3011,1447,1564
45135,93249,21104,44825,15507,72145,3011,1447,1564
45140,93262,21107,44834,15509,72152,3012,1448,1564
45145,93273,21110,44841,15512,72162,3012,1448,1564
45150,93280,21111,44843,15513,72169,3012,1448,1564
45155,93293,21114,44850,15516,72176,3013,1449,1564
45160,93304,21117,44857,15519,72187,3013,1449,1564
45165,93311,21119,44861,15520,72192,3013,1449,1564
45170,93324,21121,44867,15522,72200,3014,1449,1565
45175,93335,21124,44872,15524,72211,3014,1449,1565
45180,93342,21126,44874,15525,72216,3014,1449,1565
45185,93355,21128,44882,15526,72224,3015,1450,1565
45190,93366,21132,44887,15529,72234,3015,1450,1565
45195,93373,21134,44890,15530,72239,3015,1450,1565
45200,93386,21138,44898,15534,72246,3016,1451,1565
45205,93397,21143,44905,15539,72253,3016,1451,1565
45210,93404,21146,44909,15541,72258,3016,1451,1565
45215,93417,21149,44917,15543,72267,3017,1451,1566
45220,93428,21152,44921,15546,72276,3017,1451,1566
45225,93435,21154,44924,15547,72281,3017,1451,1566
45230,93448,21158,44929,15550,72289,3018,1451,1567
45235,93459,21164,44935,15555,72294,3018,1451,1567
45240,93466,21168,44940,15559,72297,3018,1451,1567
45245,93479,21173,44948,15563,72305,3019,1452,1567
45250,93490,21176,44955,15566,72313,3019,1452,1567
45255,93497,21180,44957,15568,72316,3019,1452,1567
45260,93510,21183,44966,15570,72325,3020,1453,1567
45265,93521,21187,44972,15574,72334,3020,1453,1567
45270,93528,21188,44975,15575,72339,3020,1453,1567
45275,93541,21190,44984,15576,72350,3021,1454,1567
45280,93552,21190,44991,15576,72362,3021,1454,1567
45285,93559,21191,44995,15577,72368,3021,1454,1567
45290,93572,21193,45001,15578,72378,3022,1454,1568
45295,93583,21193,45007,15578,72390,3022,1454,1568
45300,93590,21194,45011,15579,72395,3022,1454,1568
45305,93603,21196,45019,15580,72407,3023,1455,1568
45310,93614,21196,45023,15580,72418,3023,1455,1568
45315,93621,21197,45026,15580,72423,3023,1455,1568
45320,93634,21199,45032,15581,72435,3024,1455,1569
45325,93645,21199,45035,15581,72446,3024,1455,1569
45330,93652,21200,45037,15581,72452,3024,1455,1569
45335,93665,21202,45044,15581,72463,3025,1456,1569
45340,93676,21202,45050,15581,72474,3025,1456,1569
45345,93683,21203,45055,15582,72479,3025,1456,1569
45350,93696,21208,45062,15587,72487,3026,1457,1569
45355,93707,21212,45067,15590,72494,3026,1457,1569
45360,93714,21213,45071,15590,72501,3026,1457,1569
45365,93727,21215,45076,15590,72510,3027,1458,1569
45370,93738,21217,45083,15592,72521,3027,1458,1569
45375,93745,21220,45086,15593,72525,3027,1458,1569
45380,93758,21222,45094,15595,72534,3028,1459,1569
45385,93769,21225,45098,15598,72544,3028,1459,1569
45390,93776,21228,45102,15600,72548,3028,1459,1569
45395,93789,21230,45106,15601,72557,3029,1459,1570
45400,93800,21234,45113,15604,72565,3029,1459,1570
45405,93807,21238,45118,15608,72568,3029,1459,1570
45410,93820,21242,45125,15610,72574,3030,1460,1570
45415,93831,21247,45130,15615,72583,3030,1460,1570
45420,93838,21252,45133,15619,72586,3030,1460,1570
45425,93851,21254,45135,15619,72596,3031,1460,1571
45430,93862,21257,45139,15621,72604,3031,1460,1571
45435,93869,21262,45144,15625,72606,3031,1460,1571
45440,93882,21266,45154,15628,72612,3032,1461,1571
45445,93893,21269,45161,15631,72624,3032,1461,1571
45450,93900,21270,45166,15632,72630,3032,1461,1571
45455,93913,21273,45173,15634,72639,3033,1461,1572
45460,93924,21274,45176,15634,72649,3033,1461,1572
45465,93931,21276,45181,15635,72655,3033,1461,1572
45470,93944,21279,45189,15638,72663,3034,1461,1573
45475,93955,21283,45194,15641,72672,3034,1461,1573
45480,93962,21284,45197,15642,72678,3034,1461,1573
45485,93975,21286,45203,15643,72687,3035,1462,1573
45490,93986,21289,45208,15646,72697,3035,1462,1573
45495,93993,21290,45212,15646,72703,3035,1462,1573
45500,94006,21292,45220,15647,72712,3036,1463,1573
45505,94017,21295,45226,15649,72721,3036,1463,1573
45510,94024,21297,45228,15651,72727,3036,1463,1573
45515,94037,21299,45236,15652,72737,3037,1463,1574
45520,94048,21299,45241,15652,72749,3037,1463,1574
45525,94055,21300,45242,15652,72755,3037,1463,1574
45530,94068,21302,45248,15652,72764,3038,1463,1575
45535,94079,21302,45256,15652,72776,3038,1463,1575
45540,94086,21303,45259,15653,72783,3038,1463,1575
45545,94099,21305,45265,15655,72792,3039,1464,1575
45550,94110,21305,45273,15655,72805,3039,1464,1575
45555,94117,21307,45276,15656,72810,3039,1464,1575
45560,94130,21309,45281,15657,72820,3040,1465,1575
45565,94141,21309,45286,15657,72831,3040,1465,1575
45570,94148,21311,45291,15659,72837,3040,1465,1575
45575,94161,21313,45296,15659,72848,3041,1466,1575
45580,94172,21313,45303,15659,72859,3041,1466,1575
45585,94179,21316,45305,15660,72863,3041,1466,1575
45590,94192,21318,45312,15662,72872,3042,1466,1576
45595,94203,21321,45318,15665,72881,3042,1466,1576
45600,94210,21324,45321,15667,72886,3042,1466,1576
45605,94223,21327,45325,15669,72895,3043,1466,1577
45610,94234,21329,45331,15671,72903,3043,1466,1577
45615,94241,21334,45333,15675,72907,3043,1466,1577
45620,94254,21337,45340,15678,72916,3044,1467,1577
45625,94265,21341,45346,15681,72924,3044,1467,1577
45630,94272,21345,45353,15685,72926,3044,1467,1577
45635,94285,21348,45357,15687,72936,3045,1467,1578
45640,94296,21352,45362,15690,72944,3045,1467,1578
45645,94303,21353,45366,15690,72950,3045,1467,1578
45650,94316,21355,45374,15692,72960,3046,1468,1578
45655,94327,21357,45382,15694,72970,3046,1468,1578
45660,94334,21358,45385,15695,72976,3046,1468,1578
45665,94347,21360,45392,15696,72986,3047,1469,1578
45670,94358,21362,45397,15698,72996,3047,1469,1578
45675,94365,21363,45401,15699,73002,3047,1469,1578
45680,94378,21365,45405,15699,73013,3048,1469,1579
45685,94389,21366,45411,15700,73022,3048,1469,1579
45690,94396,21368,45415,15702,73028,3048,1469,1579
45695,94409,21371,45422,15704,73036,3049,1469,1580
45700,94420,21373,45426,15705,73046,3049,1469,1580
45705,94427,21375,45431,15707,73051,3049,1469,1580
45710,94440,21379,45435,15710,73060,3050,1469,1581
45715,94451,21384,45443,15714,73065,3050,1469,1581
45720,94458,21388,45449,15717,73069,3050,1469,1581
45725,94471,21393,45455,15721,73077,3051,1469,1582
45730,94482,21397,45460,15725,73085,3051,1469,1582
45735,94489,21399,45465,15727,73089,3051,1469,1582
45740,94502,21402,45468,15729,73100,3052,1469,1583
45745,94513,21402,45472,15729,73111,3052,1469,1583
45750,94520,21405,45474,15731,73115,3052,1469,1583
45755,94533,21408,45483,15734,73122,3053,1470,1583
45760,94544,21411,45490,15737,73132,3053,1470,1583
45765,94551,21414,45492,15738,73136,3053,1470,1583
45770,94564,21418,45499,15740,73143,3054,1470,1584
45775,94575,21419,45502,15741,73154,3054,1470,1584
45780,94582,21424,45506,15745,73157,3054,1470,1584
45785,94595,21427,45515,15748,73165,3055,1470,1585
45790,94606,21431,45520,15752,73175,3055,1470,1585
45795,94613,21432,45524,15753,73181,3055,1470,1585
45800,94626,21434,45528,15754,73192,3056,1470,1586
45805,94637,21434,45532,15754,73203,3056,1470,1586
45810,94644,21435,45536,15755,73209,3056,1470,1586
45815,94657,21437,45543,15756,73220,3057,1470,1587
45820,94668,21437,45550,15756,73231,3057,1470,1587
45825,94675,21438,45552,15757,73237,3057,1470,1587
45830,94688,21440,45559,15757,73247,3058,1471,1587
45835,94699,21440,45563,15757,73259,3058,1471,1587
45840,94706,21441,45567,15757,73265,3058,1471,1587
45845,94719,21443,45571,15757,73275,3059,1471,1588
45850,94730,21444,45578,15758,73286,3059,1471,1588
45855,94737,21445,45579,15758,73292,3059,1471,1588
45860,94750,21448,45587,15761,73301,3060,1471,1589
45865,94761,21450,45595,15763,73311,3060,1471,1589
45870,94768,21451,45598,15763,73317,3060,1471,1589
45875,94781,21454,45604,15765,73326,3061,1472,1589
45880,94792,21456,45609,15766,73336,3061,1472,1589
45885,94799,21457,45614,15766,73342,3061,1472,1589
45890,94812,21461,45621,15770,73349,3062,1472,1590
45895,94823,21466,45626,15774,73355,3062,1472,1590
45900,94830,21472,45632,15780,73357,3062,1472,1590
45905,94843,21477,45639,15784,73364,3063,1473,1590
45910,94854,21481,45644,15788,73373,3063,1473,1590
45915,94861,21483,45646,15788,73377,3063,1473,1590
45920,94874,21485,45653,15789,73388,3064,1473,1591
45925,94885,21486,45656,15790,73399,3064,1473,1591
45930,94892,21488,45660,15792,73403,3064,1473,1591
45935,94905,21492,45667,15795,73412,3065,1473,1592
45940,94916,21495,45674,15798,73419,3065,1473,1592
45945,94923,21500,45679,15802,73422,3065,1473,1592
45950,94936,21504,45686,15804,73430,3066,1473,1593
45955,94947,21509,45694,15809,73438,3066,1473,1593
45960,94954,21510,45697,15809,73444,3066,1473,1593
45965,94967,21512,45705,15809,73454,3067,1474,1593
45970,94978,21512,45710,15809,73466,3067,1474,1593
45975,94985,21513,45716,15810,73472,3067,1474,1593
45980,94998,21515,45726,15812,73483,3068,1475,1593
45985,95009,21515,45729,15812,73494,3068,1475,1593
45990,95016,21516,45733,15813,73500,3068,1475,1593
45995,95029,21518,45736,15813,73511,3069,1476,1593
46000,95040,21518,45742,15813,73522,3069,1476,1593
46005,95047,21519,45747,15813,73528,3069,1476,1593
46010,95060,21521,45757,15814,73538,3070,1477,1593
46015,95071,21522,45761,15814,73549,3070,1477,1593
46020,95078,21523,45767,15815,73555,3070,1477,1593
46025,95091,21525,45772,15816,73564,3071,1478,1593
46030,95102,21527,45778,15818,73575,3071,1478,1593
46035,95109,21528,45782,15819,73581,3071,1478,1593
46040,95122,21531,45787,15821,73589,3072,1478,1594
46045,95133,21534,45792,15824,73598,3072,1478,1594
46050,95140,21536,45794,15825,73604,3072,1478,1594
46055,95153,21539,45802,15828,73614,3073,1479,1594
46060,95164,21540,45806,15828,73624,3073,1479,1594
46065,95171,21543,45809,15829,73628,3073,1479,1594
46070,95184,21546,45814,15831,73637,3074,1480,1594
46075,95195,21550,45817,15834,73645,3074,1480,1594
46080,95202,21552,45818,15835,73650,3074,1480,1594
46085,95215,21557,45824,15839,73656,3075,1480,1595
46090,95226,21562,45827,15844,73664,3075,1480,1595
46095,95233,21566,45830,15847,73667,3075,1480,1595
46100,95246,21571,45837,15851,73673,3076,1481,1595
46105,95257,21576,45842,15855,73679,3076,1481,1595
46110,95264,21581,45847,15859,73682,3076,1481,1595
46115,95277,21584,45854,15861,73691,3077,1482,1595
46120,95288,21586,45860,15863,73700,3077,1482,1595
46125,95295,21592,45865,15868,73702,3077,1482,1595
46130,95308,21595,45873,15870,73711,3078,1483,1595
46135,95319,21595,45879,15870,73724,3078,1483,1595
46140,95326,21596,45881,15870,73730,3078,1483,1595
46145,95339,21598,45887,15872,73739,3079,1483,1596
46150,95350,21598,45889,15872,73752,3079,1483,1596
46155,95357,21599,45892,15872,73758,3079,1483,1596
46160,95370,21601,45898,15874,73769,3080,1483,1597
46165,95381,21601,45902,15874,73780,3080,1483,1597
46170,95388,21602,45905,15874,73786,3080,1483,1597
46175,95401,21604,45912,15876,73795,3081,1484,1597
46180,95412,21604,45919,15876,73808,3081,1484,1597
46185,95419,21605,45922,15877,73814,3081,1484,1597
46190,95432,21607,45928,15877,73824,3082,1485,1597
46195,95443,21607,45935,15877,73836,3082,1485,1597
46200,95450,21608,45938,15878,73842,3082,1485,1597
46205,95463,21610,45946,15879,73852,3083,1485,1598
46210,95474,21610,45956,15879,73864,3083,1485,1598
46215,95481,21611,45961,15880,73870,3083,1485,1598
46220,95494,21614,45967,15881,73879,3084,1486,1598
46225,95505,21615,45970,15881,73890,3084,1486,1598
46230,95512,21616,45974,15882,73896,3084,1486,1598
46235,95525,21620,45980,15885,73904,3085,1486,1599
46240,95536,21624,45985,15888,73912,3085,1486,1599
46245,95543,21627,45987,15890,73916,3085,1486,1599
46250,95556,21630,45994,15892,73924,3086,1486,1600
46255,95567,21633,45998,15895,73934,3086,1486,1600
46260,95574,21636,46004,15898,73938,3086,1486,1600
46265,95587,21639,46010,15900,73945,3087,1486,1601
46270,95598,21644,46015,15905,73953,3087,1486,1601
46275,95605,21648,46021,15909,73956,3087,1486,1601
46280,95618,21652,46027,15912,73964,3088,1486,1602
46285,95629,21658,46033,15918,73970,3088,1486,1602
46290,95636,21660,46036,15919,73976,3088,1486,1602
46295,95649,21662,46041,15919,73986,3089,1487,1602
46300,95660,21665,46048,15922,73994,3089,1487,1602
46305,95667,21668,46052,15924,73998,3089,1487,1602
46310,95680,21670,46061,15925,74008,3090,1487,1603
46315,95691,21672,46067,15927,74019,3090,1487,1603
46320,95698,21676,46070,15929,74021,3090,1487,1603
46325,95711,21679,46076,15931,74031,3091,1488,1603
46330,95722,21682,46083,15934,74039,3091,1488,1603
46335,95729,21685,46086,15936,74043,3091,1488,1603
46340,95742,21689,46093,15940,74052,3092,1488,1604
46345,95753,21690,46099,15941,74063,3092,1488,1604
46350,95760,21691,46102,15942,74069,3092,1488,1604
46355,95773,21693,46111,15943,74079,3093,1489,1604
46360,95784,21693,46117,15943,74091,3093,1489,1604
46365,95791,21694,46119,15944,74097,3093,1489,1604
46370,95804,21696,46126,15945,74107,3094,1489,1605
46375,95815,21696,46133,15945,74119,3094,1489,1605
46380,95822,21697,46138,15946,74125,3094,1489,1605
46385,95835,21699,46145,15946,74136,3095,1490,1605
46390,95846,21699,46149,15946,74147,3095,1490,1605
46395,95853,21700,46154,15946,74153,3095,1490,1605
46400,95866,21703,46159,15947,74162,3096,1490,1606
46405,95877,21705,46164,15949,74172,3096,1490,1606
46410,95884,21706,46168,15950,74178,3096,1490,1606
46415,95897,21709,46176,15952,74186,3097,1491,1606
46420,95908,21711,46184,15953,74197,3097,1491,1606
46425,95915,21712,46187,15954,74203,3097,1491,1606
46430,95928,21715,46191,15956,74212,3098,1491,1607
46435,95939,21718,46198,15959,74221,3098,1491,1607
46440,95946,21719,46200,15959,74227,3098,1491,1607
46445,95959,21722,46206,15961,74237,3099,1492,1607
46450,95970,21725,46212,15963,74244,3099,1492,1607
46455,95977,21728,46215,15964,74249,3099,1492,1607
46460,95990,21730,46218,15965,74260,3100,1492,1608
46465,96001,21731,46221,15966,74270,3100,1492,1608
46470,96008,21734,46225,15969,74274,3100,1492,1608
46475,96021,21737,46232,15971,74281,3101,1492,1609
46480,96032,21742,46234,15975,74290,3101,1492,1609
46485,96039,21744,46235,15975,74294,3101,1492,1609
46490,96052,21749,46243,15978,74299,3102,1493,1609
46495,96063,21755,46251,15984,74305,3102,1493,1609
46500,96070,21761,46253,15988,74309,3102,1493,1609
46505,96083,21764,46259,15990,74316,3103,1493,1610
46510,96094,21771,46264,15996,74322,3103,1493,1610
46515,96101,21776,46270,16000,74323,3103,1493,1610
46520,96114,21780,46276,16003,74333,3104,1494,1610
46525,96125,21780,46282,16003,74344,3104,1494,1610
46530,96132,21781,46285,16003,74350,3104,1494,1610
46535,96145,21783,46290,16004,74362,3105,1494,1611
46540,96156,21783,46294,16004,74372,3105,1494,1611
46545,96163,21784,46295,16004,74379,3105,1494,1611
46550,96176,21786,46304,16006,74390,3106,1494,1612
46555,96187,21786,46309,16006,74401,3106,1494,1612
46560,96194,21787,46314,16007,74407,3106,1494,1612
46565,96207,21789,46319,16008,74417,3107,1494,1613
46570,96218,21789,46325,16008,74429,3107,1494,1613
46575,96225,21790,46328,16008,74435,3107,1494,1613
46580,96238,21792,46332,16009,74445,3108,1494,1614
46585,96249,21792,46336,16009,74457,3108,1494,1614
46590,96256,21793,46340,16010,74463,3108,1494,1614
46595,96269,21795,46345,16012,74474,3109,1495,1614
46600,96280,21795,46350,16012,74485,3109,1495,1614
46605,96287,21796,46352,16013,74491,3109,1495,1614
46610,96300,21798,46357,16015,74500,3110,1495,1615
46615,96311,21800,46362,16017,74511,3110,1495,1615
46620,96318,21801,46366,16018,74517,3110,1495,1615
46625,96331,21804,46372,16019,74527,3111,1496,1615
46630,96342,21807,46378,16022,74535,3111,1496,1615
46635,96349,21809,46381,16024,74540,3111,1496,1615
46640,96362,21811,46388,16024,74548,3112,1496,1616
46645,96373,21816,46391,16028,74557,3112,1496,1616
46650,96380,21818,46395,16030,74561,3112,1496,1616
46655,96393,21822,46400,16032,74568,3113,1497,1616
46660,96404,21829,46406,16039,74574,3113,1497,1616
46665,96411,21832,46409,16041,74578,3113,1497,1616
46670,96424,21836,46417,16043,74584,3114,1498,1616
46675,96435,21841,46421,16047,74592,3114,1498,1616
46680,96442,21846,46424,16050,74595,3114,1498,1616
46685,96455,21850,46433,16053,74603,3115,1499,1616
46690,96466,21853,46441,16056,74613,3115,1499,1616
46695,96473,21854,46443,16056,74619,3115,1499,1616
46700,96486,21857,46448,16057,74626,3116,1499,1617
46705,96497,21862,46454,16061,74634,3116,1499,1617
46710,96504,21865,46458,16063,74638,3116,1499,1617
46715,96517,21868,46464,16065,74647,3117,1499,1618
46720,96528,21868,46469,16065,74659,3117,1499,1618
46725,96535,21869,46472,16066,74666,3117,1499,1618
46730,96548,21871,46480,16067,74676,3118,1499,1619
46735,96559,21871,46486,16067,74687,3118,1499,1619
46740,96566,21872,46489,16068,74694,3118,1499,1619
46745,96579,21874,46498,16070,74704,3119,1500,1619
46750,96590,21874,46502,16070,74716,3119,1500,1619
46755,96597,21875,46506,16070,74722,3119,1500,1619
46760,96610,21877,46514,16071,74732,3120,1501,1619
46765,96621,21877,46520,16071,74744,3120,1501,1619
46770,96628,21878,46523,16071,74750,3120,1501,1619
46775,96641,21880,46530,16071,74760,3121,1502,1619
46780,96652,21880,46538,16071,74771,3121,1502,1619
46785,96659,21881,46542,16072,74778,3121,1502,1619
46790,96672,21883,46549,16073,74788,3122,1502,1620
46795,96683,21883,46557,16073,74800,3122,1502,1620
46800,96690,21885,46562,16074,74805,3122,1502,1620
46805,96703,21887,46570,16075,74816,3123,1503,1620
46810,96714,21887,46574,16075,74826,3123,1503,1620
46815,96721,21890,46579,16078,74831,3123,1503,1620
46820,96734,21893,46586,16081,74839,3124,1503,1621
46825,96745,21896,46587,16083,74848,3124,1503,1621
46830,96752,21900,46591,16087,74852,3124,1503,1621
46835,96765,21903,46595,16088,74860,3125,1503,1622
46840,96776,21906,46599,16090,74869,3125,1503,1622
46845,96783,21909,46600,16092,74874,3125,1503,1622
46850,96796,21911,46604,16092,74884,3126,1504,1622
46855,96807,21913,46610,16093,74892,3126,1504,1622
46860,96814,21917,46614,16096,74897,3126,1504,1622
46865,96827,21919,46619,16098,74908,3127,1504,1623
46870,96838,21921,46625,16100,74916,3127,1504,1623
46875,96845,21924,46628,16101,74920,3127,1504,1623
46880,96858,21928,46632,16105,74930,3128,1504,1624
46885,96869,21931,46639,16107,74936,3128,1504,1624
46890,96876,21937,46642,16112,74939,3128,1504,1624
46895,96889,21941,46650,16116,74945,3129,1504,1625
46900,96900,21947,46655,16121,74951,3129,1504,1625
46905,96907,21953,46659,16127,74954,3129,1504,1625
46910,96920,21958,46669,16131,74956,3130,1504,1626
46915,96931,21966,46677,16139,74964,3130,1504,1626
46920,96938,21968,46679,16140,74970,3130,1504,1626
46925,96951,21970,46685,16142,74981,3131,1505,1626
46930,96962,21970,46692,16142,74992,3131,1505,1626
46935,96969,21971,46697,16142,74998,3131,1505,1626
46940,96982,21973,46705,16143,75007,3132,1506,1626
46945,96993,21973,46709,16143,75019,3132,1506,1626
46950,97000,21974,46712,16143,75026,3132,1506,1626
46955,97013,21976,46717,16144,75036,3133,1506,1627
46960,97024,21976,46723,16144,75048,3133,1506,1627
46965,97031,21977,46726,16145,75054,3133,1506,1627
46970,97044,21979,46732,16145,75064,3134,1507,1627
46975,97055,21979,46738,16145,75075,3134,1507,1627
46980,97062,21980,46742,16146,75082,3134,1507,1627
46985,97075,21982,46750,16147,75092,3135,1508,1627
46990,97086,21982,46754,16147,75104,3135,1508,1627
46995,97093,21983,46756,16147,75110,3135,1508,1627
47000,97106,21985,46765,16149,75120,3136,1508,1628
47005,97117,21985,46768,16149,75132,3136,1508,1628
47010,97124,21986,46773,16150,75138,3136,1508,1628
47015,97137,21988,46779,16151,75149,3137,1509,1628
47020,97148,21988,46786,16151,75160,3137,1509,1628
47025,97155,21990,46788,16151,75165,3137,1509,1628
47030,97168,21993,46795,16153,75173,3138,1510,1628
47035,97179,21997,46801,16156,75181,3138,1510,1628
47040,97186,22001,46803,16159,75185,3138,1510,1628
47045,97199,22003,46809,16160,75193,3139,1511,1628
47050,97210,22008,46813,16164,75200,3139,1511,1628
47055,97217,22014,46819,16170,75202,3139,1511,1628
47060,97230,22017,46826,16173,75211,3140,1512,1628
47065,97241,22023,46833,16178,75216,3140,1512,1628
47070,97248,22027,46835,16180,75220,3140,1512,1628
47075,97261,22030,46841,16182,75229,3141,1513,1628
47080,97272,22033,46845,16184,75239,3141,1513,1628
47085,97279,22034,46848,16184,75245,3141,1513,1628
47090,97292,22038,46856,16188,75251,3142,1513,1629
47095,97303,22044,46859,16193,75259,3142,1513,1629
47100,97310,22046,46861,16194,75264,3142,1513,1629
47105,97323,22050,46868,16196,75270,3143,1513,1630
47110,97334,22054,46875,16200,75279,3143,1513,1630
47115,97341,22056,46878,16201,75284,3143,1513,1630
47120,97354,22058,46884,16202,75296,3144,1513,1631
47125,97365,22058,46891,16202,75307,3144,1513,1631
47130,97372,22059,46897,16203,75312,3144,1513,1631
47135,97385,22061,46905,16204,75324,3145,1513,1632
47140,97396,22061,46914,16204,75335,3145,1513,1632
47145,97403,22062,46920,16205,75341,3145,1513,1632
47150,97416,22064,46926,16207,75352,3146,1513,1633
47155,97427,22064,46933,16207,75363,3146,1513,1633
47160,97434,22065,46934,16207,75369,3146,1513,1633
47165,97447,22067,46941,16207,75380,3147,1513,1634
47170,97458,22067,46947,16207,75391,3147,1513,1634
47175,97465,22068,46950,16207,75397,3147,1513,1634
47180,97478,22070,46958,16209,75408,3148,1514,1634
47185,97489,22070,46961,16209,75419,3148,1514,1634
47190,97496,22072,46966,16211,75424,3148,1514,1634
47195,97509,22074,46975,16213,75435,3149,1514,1635
47200,97520,22075,46978,16214,75445,3149,1514,1635
47205,97527,22078,46981,16215,75449,3149,1514,1635
47210,97540,22080,46984,16215,75460,3150,1514,1636
47215,97551,22082,46987,16217,75469,3150,1514,1636
47220,97558,22084,46991,16218,75474,3150,1514,1636
47225,97571,22087,46998,16220,75483,3151,1514,1637
47230,97582,22091,47006,16224,75491,3151,1514,1637
47235,97589,22093,47009,16225,75495,3151,1514,1637
47240,97602,22097,47013,16227,75502,3152,1514,1638
47245,97613,22102,47018,16231,75510,3152,1514,1638
47250,97620,22106,47019,16233,75514,3152,1514,1638
47255,97633,22110,47026,16237,75522,3153,1514,1639
47260,97644,22116,47033,16242,75527,3153,1514,1639
47265,97651,22121,47036,16245,75530,3153,1514,1639
47270,97664,22124,47043,16247,75539,3154,1515,1639
47275,97675,22127,47048,16249,75547,3154,1515,1639
47280,97682,22129,47052,16251,75553,3154,1515,1639
47285,97695,22132,47060,16254,75560,3155,1515,1640
47290,97706,22136,47064,16257,75570,3155,1515,1640
47295,97713,22137,47067,16257,75576,3155,1515,1640
47300,97726,22140,47072,16260,75586,3156,1515,1641
47305,97737,22141,47074,16260,75595,3156,1515,1641
47310,97744,22143,47078,16262,75601,3156,1515,1641
47315,97757,22147,47083,16264,75609,3157,1515,1642
47320,97768,22149,47089,16265,75619,3157,1515,1642
47325,97775,22150,47091,16266,75625,3157,1515,1642
47330,97788,22152,47096,16266,75635,3158,1515,1643
47335,97799,22152,47099,16266,75647,3158,1515,1643
47340,97806,22153,47102,16266,75652,3158,1515,1643
47345,97819,22155,47107,16266,75664,3159,1515,1644
47350,97830,22155,47116,16266,75674,3159,1515,1644
47355,97837,22156,47120,16267,75681,3159,1515,1644
47360,97850,22158,47126,16269,75691,3160,1515,1645
47365,97861,22158,47132,16269,75702,3160,1515,1645
47370,97868,22159,47135,16269,75709,3160,1515,1645
47375,97881,22161,47143,16270,75719,3161,1515,1646
47380,97892,22163,47153,16272,75728,3161,1515,1646
47385,97899,22165,47158,16273,75734,3161,1515,1646
47390,97912,22167,47162,16273,75745,3162,1516,1646
47395,97923,22169,47167,16275,75754,3162,1516,1646
47400,97930,22172,47172,16277,75758,3162,1516,1646
47405,97943,22174,47178,16278,75769,3163,1516,1647
47410,97954,22175,47183,16279,75778,3163,1516,1647
47415,97961,22180,47187,16284,75781,3163,1516,1647
47420,97974,22182,47195,16285,75791,3164,1517,1647
47425,97985,22184,47203,16287,75799,3164,1517,1647
47430,97992,22189,47208,16291,75802,3164,1517,1647
47435,98005,22192,47211,16293,75811,3165,1517,1648
47440,98016,22196,47216,16297,75818,3165,1517,1648
47445,98023,22199,47218,16299,75824,3165,1517,1648
47450,98036,22201,47223,16300,75832,3166,1517,1649
47455,98047,22203,47228,16301,75844,3166,1517,1649
47460,98054,22204,47229,16301,75850,3166,1517,1649
47465,98067,22207,47236,16303,75858,3167,1517,1650
47470,98078,22210,47244,16306,75868,3167,1517,1650
47475,98085,22211,47247,16306,75874,3167,1517,1650
47480,98098,22215,47256,16309,75880,3168,1517,1651
47485,98109,22218,47260,16311,75890,3168,1517,1651
47490,98116,22220,47264,16313,75896,3168,1517,1651
47495,98129,22224,47270,16315,75903,3169,1517,1652
47500,98140,22229,47276,16320,75911,3169,1517,1652
47505,98147,22231,47281,16322,75916,3169,1517,1652
47510,98160,22233,47289,16324,75923,3170,1518,1652
47515,98171,22239,47296,16329,75932,3170,1518,1652
47520,98178,22240,47300,16329,75938,3170,1518,1652
47525,98191,22242,47307,16329,75948,3171,1519,1652
47530,98202,22242,47314,16329,75959,3171,1519,1652
47535,98209,22243,47316,16330,75966,3171,1519,1652
47540,98222,22245,47324,16331,75975,3172,1519,1653
47545,98233,22245,47328,16331,75987,3172,1519,1653
47550,98240,22248,47330,16332,75992,3172,1519,1653
47555,98253,22250,47335,16332,76001,3173,1519,1654
47560,98264,22251,47339,16333,76012,3173,1519,1654
47565,98271,22253,47342,16334,76018,3173,1519,1654
47570,98284,22255,47347,16336,76029,3174,1520,1654
47575,98295,22255,47353,16336,76040,3174,1520,1654
47580,98302,22258,47358,16339,76044,3174,1520,1654
47585,98315,22260,47365,16340,76055,3175,1521,1654
47590,98326,22260,47366,16340,76066,3175,1521,1654
47595,98333,22263,47370,16342,76070,3175,1521,1654
47600,98346,22265,47377,16343,76080,3176,1521,1655
47605,98357,22268,47383,16346,76087,3176,1521,1655
47610,98364,22273,47386,16350,76091,3176,1521,1655
47615,98377,22275,47392,16352,76101,3177,1522,1655
47620,98388,22279,47402,16356,76108,3177,1522,1655
47625,98395,22283,47404,16358,76112,3177,1522,1655
47630,98408,22287,47413,16361,76119,3178,1523,1655
47635,98419,22292,47421,16366,76126,3178,1523,1655
47640,98426,22294,47422,16367,76132,3178,1523,1655
47645,98439,22296,47427,16367,76141,3179,1524,1655
47650,98450,22299,47433,16369,76150,3179,1524,1655
47655,98457,22301,47435,16370,76156,3179,1524,1655
47660,98470,22304,47443,16372,76164,3180,1524,1656
47665,98481,22306,47450,16374,76174,3180,1524,1656
47670,98488,22308,47452,16376,76180,3180,1524,1656
47675,98501,22311,47457,16377,76188,3181,1525,1656
47680,98512,22316,47464,16381,76195,3181,1525,1656
47685,98519,22319,47468,16383,76200,3181,1525,1656
47690,98532,22322,47475,16386,76208,3182,1525,1657
47695,98543,22326,47478,16390,76217,3182,1525,1657
47700,98550,22328,47482,16391,76221,3182,1525,1657
47705,98563,22330,47489,16391,76232,3183,1526,1657
47710,98574,22330,47496,16391,76244,3183,1526,1657
47715,98581,22331,47500,16392,76250,3183,1526,1657
47720,98594,22333,47504,16392,76261,3184,1526,1658
47725,98605,22333,47508,16392,76271,3184,1526,1658
47730,98612,22334,47512,16393,76277,3184,1526,1658
47735,98625,22336,47518,16394,76289,3185,1527,1658
47740,98636,22336,47522,16394,76299,3185,1527,1658
47745,98643,22338,47523,16394,76305,3185,1527,1658
47750,98656,22340,47529,16396,76315,3186,1527,1659
47755,98667,22341,47533,16397,76326,3186,1527,1659
47760,98674,22344,47539,16400,76330,3186,1527,1659
47765,98687,22346,47543,16401,76340,3187,1527,1660
47770,98698,22347,47552,16402,76350,3187,1527,1660
47775,98705,22349,47555,16403,76356,3187,1527,1660
47780,98718,22351,47563,16404,76367,3188,1528,1660
47785,98729,22351,47568,16404,76378,3188,1528,1660
47790,98736,22354,47572,16406,76382,3188,1528,1660
47795,98749,22356,47579,16407,76391,3189,1528,1661
47800,98760,22358,47584,16409,76401,3189,1528,1661
47805,98767,22361,47586,16411,76405,3189,1528,1661
47810,98780,22365,47592,16414,76412,3190,1529,1661
47815,98791,22369,47595,16417,76422,3190,1529,1661
47820,98798,22371,47597,16418,76427,3190,1529,1661
47825,98811,22373,47603,16419,76434,3191,1529,1662
47830,98822,22379,47608,16424,76442,3191,1529,1662
47835,98829,22382,47609,16425,76447,3191,1529,1662
47840,98842,22384,47613,16426,76456,3192,1529,1663
47845,98853,22388,47618,16429,76464,3192,1529,1663
47850,98860,22392,47621,16432,76467,3192,1529,1663
47855,98873,22397,47629,16437,76474,3193,1530,1663
47860,98884,22401,47634,16441,76483,3193,1530,1663
47865,98891,22402,47637,16441,76489,3193,1530,1663
47870,98904,22405,47643,16443,76498,3194,1530,1664
47875,98915,22406,47650,16444,76508,3194,1530,1664
47880,98922,22408,47654,16445,76514,3194,1530,1664
47885,98935,22410,47658,16447,76524,3195,1531,1664
47890,98946,22413,47664,16450,76533,3195,1531,1664
47895,98953,22415,47667,16451,76538,3195,1531,1664
47900,98966,22417,47673,16453,76547,3196,1531,1665
47905,98977,22422,47676,16457,76554,3196,1531,1665
47910,98984,22424,47680,16458,76559,3196,1531,1665
47915,98997,22425,47685,16459,76572,3197,1531,1666
47920,99008,22425,47690,16459,76582,3197,1531,1666
47925,99015,22426,47692,16459,76589,3197,1531,1666
47930,99028,22427,47699,16459,76600,3198,1532,1666
47935,99039,22427,47707,16459,76611,3198,1532,1666
47940,99046,22428,47709,16459,76618,3198,1532,1666
47945,99059,22429,47717,16459,76629,3199,1532,1667
47950,99070,22429,47720,16459,76641,3199,1532,1667
47955,99077,22430,47723,16459,76647,3199,1532,1667
47960,99090,22432,47728,16461,76656,3200,1532,1668
47965,99101,22432,47732,16461,76669,3200,1532,1668
47970,99108,22434,47732,16461,76674,3200,1532,1668
47975,99121,22435,47739,16462,76685,3201,1533,1668
47980,99132,22435,47743,16462,76695,3201,1533,1668
47985,99139,22440,47748,16466,76699,3201,1533,1668
47990,99152,22443,47755,16468,76707,3202,1533,1669
47995,99163,22447,47762,16472,76714,3202,1533,1669
48000,99170,22453,47767,16477,76716,3202,1533,1669
48005,99183,22456,47773,16479,76727,3203,1533,1670
48010,99194,22457,47777,16480,76735,3203,1533,1670
48015,99201,22462,47782,16483,76739,3203,1533,1670
48020,99214,22463,47788,16484,76750,3204,1533,1671
48025,99225,22464,47795,16484,76761,3204,1533,1671
48030,99232,22465,47799,16485,76767,3204,1533,1671
48035,99245,22466,47809,16486,76776,3205,1534,1671
48040,99256,22469,47813,16488,76787,3205,1534,1671
48045,99263,22470,47817,16489,76793,3205,1534,1671
48050,99276,22472,47822,16491,76803,3206,1534,1672
48055,99287,22475,47828,16493,76811,3206,1534,1672
48060,99294,22477,47830,16495,76817,3206,1534,1672
48065,99307,22480,47839,16498,76826,3207,1535,1672
48070,99318,22482,47846,16500,76835,3207,1535,1672
48075,99325,22484,47851,16502,76841,3207,1535,1672
48080,99338,22488,47862,16506,76848,3208,1535,1673
48085,99349,22492,47864,16509,76857,3208,1535,1673
48090,99356,22493,47868,16510,76863,3208,1535,1673
48095,99369,22496,47874,16513,76872,3209,1535,1674
48100,99380,22498,47878,16514,76881,3209,1535,1674
48105,99387,22500,47881,16516,76886,3209,1535,1674
48110,99400,22503,47887,16519,76896,3210,1535,1675
48115,99411,22505,47892,16520,76906,3210,1535,1675
48120,99418,22506,47895,16520,76911,3210,1535,1675
48125,99431,22510,47901,16523,76921,3211,1535,1676
48130,99442,22511,47907,16524,76930,3211,1535,1676
48135,99449,22516,47911,16528,76932,3211,1535,1676
48140,99462,22518,47917,16530,76943,3212,1535,1677
48145,99473,22521,47925,16533,76951,3212,1535,1677
48150,99480,22524,47927,16535,76955,3212,1535,1677
48155,99493,22526,47933,16537,76967,3213,1536,1677
48160,99504,22526,47937,16537,76978,3213,1536,1677
48165,99511,22528,47940,16539,76983,3213,1536,1677
48170,99524,22531,47946,16541,76992,3214,1536,1678
48175,99535,22531,47951,16541,77002,3214,1536,1678
48180,99542,22535,47954,16543,77007,3214,1536,1678
48185,99555,22538,47960,16546,77015,3215,1536,1679
48190,99566,22541,47964,16549,77024,3215,1536,1679
48195,99573,22544,47966,16551,77029,3215,1536,1679
48200,99586,22546,47973,16553,77039,3216,1536,1680
48205,99597,22549,47979,16556,77046,3216,1536,1680
48210,99604,22551,47980,16557,77053,3216,1536,1680
48215,99617,22552,47985,16557,77063,3217,1536,1681
48220,99628,22552,47989,16557,77075,3217,1536,1681
48225,99635,22553,47994,16557,77082,3217,1536,1681
48230,99648,22556,48000,16559,77089,3218,1536,1682
48235,99659,22558,48003,16561,77101,3218,1536,1682
48240,99666,22559,48007,16562,77107,3218,1536,1682
48245,99679,22561,48015,16564,77115,3219,1537,1682
48250,99690,22564,48022,16567,77126,3219,1537,1682
48255,99697,22565,48025,16567,77132,3219,1537,1682
48260,99710,22566,48032,16567,77143,3220,1538,1682
48265,99721,22568,48040,16569,77153,3220,1538,1682
48270,99728,22569,48042,16570,77159,3220,1538,1682
48275,99741,22570,48048,16570,77170,3221,1538,1683
48280,99752,22571,48051,16570,77181,3221,1538,1683
48285,99759,22572,48055,16571,77187,3221,1538,1683
48290,99772,22575,48063,16574,77195,3222,1538,1684
48295,99783,22579,48071,16578,77203,3222,1538,1684
48300,99790,22581,48073,16579,77209,3222,1538,1684
48305,99803,22582,48077,16580,77220,3223,1539,1684
48310,99814,22585,48084,16583,77229,3223,1539,1684
48315,99821,22587,48086,16584,77234,3223,1539,1684
48320,99834,22591,48094,16587,77241,3224,1539,1685
48325,99845,22594,48099,16590,77251,3224,1539,1685
48330,99852,22596,48105,16592,77256,3224,1539,1685
48335,99865,22598,48110,16593,77264,3225,1540,1685
48340,99876,22605,48117,16600,77269,3225,1540,1685
48345,99883,22608,48122,16603,77274,3225,1540,1685
48350,99896,22609,48124,16603,77287,3226,1540,1686
48355,99907,22609,48128,16603,77297,3226,1540,1686
48360,99914,22612,48129,16604,77302,3226,1540,1686
48365,99927,22614,48133,16606,77312,3227,1541,1686
48370,99938,22615,48134,16607,77322,3227,1541,1686
48375,99945,22619,48137,16610,77326,3227,1541,1686
48380,99958,22620,48141,16610,77335,3228,1542,1686
48385,99969,22622,48148,16612,77346,3228,1542,1686
48390,99976,22626,48150,16614,77349,3228,1542,1686
48395,99989,22629,48156,16616,77359,3229,1542,1687
48400,100000,22631,48161,16618,77368,3229,1542,1687
48405,100007,22634,48166,16620,77372,3229,1542,1687
48410,100020,22636,48170,16621,77382,3230,1542,1688
48415,100031,22639,48176,16624,77391,3230,1542,1688
48420,100038,22643,48182,16628,77394,3230,1542,1688
48425,100051,22646,48186,16630,77404,3231,1542,1689
48430,100062,22646,48188,16630,77416,3231,1542,1689
48435,100069,22647,48192,16630,77422,3231,1542,1689
48440,100082,22648,48197,16631,77433,3232,1543,1689
48445,100093,22648,48203,16631,77444,3232,1543,1689
48450,100100,22649,48205,16632,77451,3232,1543,1689
48455,100113,22651,48214,16634,77460,3233,1544,1689
48460,100124,22653,48220,16636,77471,3233,1544,1689
48465,100131,22654,48225,16636,77477,3233,1544,1689
48470,100144,22656,48234,16638,77485,3234,1544,1690
48475,100155,22659,48238,16641,77496,3234,1544,1690
48480,100162,22660,48242,16642,77502,3234,1544,1690
48485,100175,22662,48248,16643,77511,3235,1544,1691
48490,100186,22664,48257,16645,77522,3235,1544,1691
48495,100193,22665,48260,16645,77528,3235,1544,1691
48500,100206,22667,48267,16647,77538,3236,1545,1691
48505,100217,22669,48270,16648,77548,3236,1545,1691
48510,100224,22670,48273,16649,77554,3236,1545,1691
48515,100237,22672,48277,16650,77565,3237,1545,1692
48520,100248,22674,48282,16651,77574,3237,1545,1692
48525,100255,22675,48284,16652,77580,3237,1545,1692
48530,100268,22678,48288,16654,77589,3238,1545,1693
48535,100279,22681,48294,16657,77596,3238,1545,1693
48540,100286,22686,48297,16661,77599,3238,1545,1693
48545,100299,22691,48305,16666,77605,3239,1546,1693
48550,100310,22698,48311,16672,77611,3239,1546,1693
48555,100317,22702,48313,16674,77614,3239,1546,1693
48560,100330,22709,48320,16680,77620,3240,1546,1694
48565,100341,22712,48327,16683,77627,3240,1546,1694
48570,100348,22717,48329,16687,77631,3240,1546,1694
48575,100361,22718,48331,16687,77643,3241,1547,1694
48580,100372,22719,48337,16688,77652,3241,1547,1694
48585,100379,22722,48339,16690,77656,3241,1547,1694
48590,100392,22723,48343,16690,77667,3242,1548,1694
48595,100403,22725,48347,16692,77678,3242,1548,1694
48600,100410,22726,48353,16693,77683,3242,1548,1694
48605,100423,22728,48362,16694,77694,3243,1549,1694
48610,100434,22728,48367,16694,77706,3243,1549,1694
48615,100441,22729,48371,16695,77712,3243,1549,1694
48620,100454,22731,48379,16697,77723,3244,1550,1694
48625,100465,22731,48383,16697,77734,3244,1550,1694
48630,100472,22732,48388,16697,77740,3244,1550,1694
48635,100485,22733,48394,16697,77752,3245,1551,1694
48640,100496,22733,48398,16697,77763,3245,1551,1694
48645,100503,22734,48401,16698,77769,3245,1551,1694
48650,100516,22735,48406,16699,77781,3246,1551,1695
48655,100527,22735,48412,16699,77792,3246,1551,1695
48660,100534,22736,48416,16699,77798,3246,1551,1695
48665,100547,22738,48425,16701,77807,3247,1551,1696
48670,100558,22739,48432,16701,77818,3247,1551,1696
48675,100565,22740,48436,16702,77825,3247,1551,1696
48680,100578,22742,48443,16703,77835,3248,1552,1696
48685,100589,22744,48449,16705,77845,3248,1552,1696
48690,100596,22745,48453,16706,77851,3248,1552,1696
48695,100609,22746,48457,16707,77863,3249,1553,1696
48700,100620,22747,48461,16707,77873,3249,1553,1696
48705,100627,22749,48464,16708,77878,3249,1553,1696
48710,100640,22751,48468,16709,77887,3250,1554,1696
48715,100651,22754,48471,16711,77895,3250,1554,1696
48720,100658,22759,48476,16714,77898,3250,1554,1696
48725,100671,22764,48484,16717,77904,3251,1555,1696
48730,100682,22769,48490,16722,77912,3251,1555,1696
48735,100689,22773,48493,16724,77915,3251,1555,1696
48740,100702,22778,48498,16727,77923,3252,1556,1696
48745,100713,22782,48502,16730,77930,3252,1556,1696
48750,100720,22786,48505,16734,77934,3252,1556,1696
48755,100733,22788,48508,16735,77944,3253,1556,1697
48760,100744,22791,48514,16737,77951,3253,1556,1697
48765,100751,22794,48519,16739,77957,3253,1556,1697
48770,100764,22796,48522,16740,77966,3254,1556,1698
48775,100775,22799,48528,16742,77975,3254,1556,1698
48780,100782,22801,48530,16743,77981,3254,1556,1698
48785,100795,22803,48534,16744,77991,3255,1556,1699
48790,100806,22806,48540,16746,77999,3255,1556,1699
48795,100813,22808,48543,16748,78005,3255,1556,1699
48800,100826,22811,48547,16750,78015,3256,1556,1700
48805,100837,22812,48550,16750,78025,3256,1556,1700
48810,100844,22813,48553,16751,78031,3256,1556,1700
48815,100857,22816,48558,16753,78040,3257,1556,1701
48820,100868,22818,48565,16755,78049,3257,1556,1701
48825,100875,22820,48567,16756,78054,3257,1556,1701
48830,100888,22823,48571,16757,78063,3258,1556,1702
48835,100899,22827,48574,16760,78071,3258,1556,1702
48840,100906,22829,48577,16762,78076,3258,1556,1702
48845,100919,22832,48585,16764,78085,3259,1556,1703
48850,100930,22832,48589,16764,78098,3259,1556,1703
48855,100937,22833,48595,16765,78103,3259,1556,1703
48860,100950,22835,48602,16766,78113,3260,1556,1704
48865,100961,22835,48609,16766,78125,3260,1556,1704
48870,100968,22836,48611,16767,78132,3260,1556,1704
48875,100981,22838,48616,16767,78142,3261,1556,1705
48880,100992,22838,48620,16767,78154,3261,1556,1705
48885,100999,22841,48625,16769,78158,3261,1556,1705
48890,101012,22843,48631,16770,78169,3262,1557,1705
48895,101023,22845,48637,16772,78178,3262,1557,1705
48900,101030,22848,48641,16775,78181,3262,1557,1705
48905,101043,22851,48649,16778,78191,3263,1558,1705
48910,101054,22854,48654,16781,78199,3263,1558,1705
48915,101061,22857,48656,16783,78203,3263,1558,1705
48920,101074,22861,48663,16785,78211,3264,1559,1705
48925,101085,22863,48667,16787,78220,3264,1559,1705
48930,101092,22869,48671,16792,78223,3264,1559,1705
48935,101105,22871,48675,16792,78232,3265,1559,1706
48940,101116,22873,48680,16794,78242,3265,1559,1706
48945,101123,22875,48683,16795,78248,3265,1559,1706
48950,101136,22877,48686,16795,78257,3266,1559,1707
48955,101147,22879,48692,16796,78268,3266,1559,1707
48960,101154,22880,48695,16796,78274,3266,1559,1707
48965,101167,22882,48699,16796,78282,3267,1559,1708
48970,101178,22884,48701,16797,78294,3267,1559,1708
48975,101185,22885,48706,16798,78300,3267,1559,1708
48980,101198,22889,48713,16800,78307,3268,1559,1709
48985,101209,22891,48718,16801,78318,3268,1559,1709
48990,101216,22892,48723,16802,78324,3268,1559,1709
48995,101229,22896,48731,16805,78332,3269,1560,1709
49000,101240,22901,48738,16810,78338,3269,1560,1709
49005,101247,22904,48744,16813,78342,3269,1560,1709
49010,101260,22909,48749,16816,78351,3270,1561,1709
49015,101271,22911,48755,16818,78359,3270,1561,1709
49020,101278,22913,48757,16820,78365,3270,1561,1709
49025,101291,22915,48762,16822,78376,3271,1562,1709
49030,101302,22915,48769,16822,78386,3271,1562,1709
49035,101309,22916,48773,16822,78393,3271,1562,1709
49040,101322,22918,48782,16823,78404,3272,1563,1709
49045,101333,22918,48788,16823,78415,3272,1563,1709
49050,101340,22921,48791,16825,78418,3272,1563,1709
49055,101353,22923,48795,16825,78430,3273,1563,1710
49060,101364,22924,48802,16826,78439,3273,1563,1710
49065,101371,22927,48806,16828,78444,3273,1563,1710
49070,101384,22929,48809,16829,78455,3274,1563,1711
49075,101395,22929,48815,16829,78465,3274,1563,1711
49080,101402,22932,48817,16831,78470,3274,1563,1711
49085,101415,22934,48824,16831,78477,3275,1563,1712
49090,101426,22937,48828,16834,78489,3275,1563,1712
49095,101433,22940,48831,16836,78493,3275,1563,1712
49100,101446,22943,48839,16838,78501,3276,1564,1712
49105,101457,22946,48843,16841,78511,3276,1564,1712
49110,101464,22950,48847,16844,78514,3276,1564,1712
49115,101477,22952,48852,16845,78524,3277,1564,1713
49120,101488,22954,48857,16847,78532,3277,1564,1713
49125,101495,22959,48862,16851,78536,3277,1564,1713
49130,101508,22962,48868,16853,78544,3278,1565,1713
49135,101519,22964,48874,16855,78555,3278,1565,1713
49140,101526,22965,48877,16855,78561,3278,1565,1713
49145,101539,22968,48887,16858,78568,3279,1566,1713
49150,101550,22970,48892,16859,78580,3279,1566,1713
49155,101557,22971,48895,16860,78586,3279,1566,1713
49160,101570,22973,48904,16861,78594,3280,1567,1713
49165,101581,22976,48912,16864,78604,3280,1567,1713
49170,101588,22978,48914,16865,78610,3280,1567,1713
49175,101601,22980,48919,16866,78620,3281,1567,1714
49180,101612,22981,48922,16866,78631,3281,1567,1714
49185,101619,22982,48923,16866,78637,3281,1567,1714
49190,101632,22985,48929,16868,78646,3282,1567,1715
49195,101643,22987,48933,16870,78656,3282,1567,1715
49200,101650,22989,48937,16872,78660,3282,1567,1715
49205,101663,22994,48945,16875,78667,3283,1567,1716
49210,101674,22999,48950,16880,78675,3283,1567,1716
49215,101681,23000,48953,16880,78680,3283,1567,1716
49220,101694,23004,48958,16883,78689,3284,1568,1716
49225,101705,23007,48963,16885,78698,3284,1568,1716
49230,101712,23008,48966,16886,78704,3284,1568,1716
49235,101725,23010,48975,16888,78715,3285,1568,1717
49240,101736,23011,48983,16889,78725,3285,1568,1717
49245,101743,23014,48985,16891,78729,3285,1568,1717
49250,101756,23016,48993,16892,78740,3286,1569,1717
49255,101767,23016,48995,16892,78751,3286,1569,1717
49260,101774,23018,48998,16894,78755,3286,1569,1717
49265,101787,23020,49006,16896,78767,3287,1569,1718
49270,101798,23022,49012,16898,78776,3287,1569,1718
49275,101805,23025,49018,16901,78778,3287,1569,1718
49280,101818,23029,49026,16905,78789,3288,1570,1718
49285,101829,23031,49031,16907,78798,3288,1570,1718
49290,101836,23035,49034,16910,78801,3288,1570,1718
49295,101849,23038,49040,16912,78809,3289,1571,1718
49300,101860,23040,49046,16914,78818,3289,1571,1718
49305,101867,23045,49051,16918,78821,3289,1571,1718
49310,101880,23049,49060,16922,78829,3290,1572,1718
49315,101891,23050,49062,16923,78841,3290,1572,1718
49320,101898,23051,49066,16923,78847,3290,1572,1718
49325,101911,23053,49073,16923,78857,3291,1572,1719
49330,101922,23053,49079,16923,78869,3291,1572,1719
49335,101929,23054,49082,16923,78875,3291,1572,1719
49340,101942,23056,49090,16924,78883,3292,1572,1720
49345,101953,23059,49094,16927,78894,3292,1572,1720
49350,101960,23060,49098,16928,78900,3292,1572,1720
49355,101973,23062,49104,16929,78908,3293,1572,1721
49360,101984,23065,49110,16932,78919,3293,1572,1721
49365,101991,23066,49115,16932,78925,3293,1572,1721
49370,102004,23069,49125,16935,78932,3294,1573,1721
49375,102015,23072,49131,16938,78943,3294,1573,1721
49380,102022,23073,49137,16938,78949,3294,1573,1721
49385,102035,23076,49143,16940,78958,3295,1574,1721
49390,102046,23077,49148,16941,78969,3295,1574,1721
49395,102053,23078,49149,16941,78975,3295,1574,1721
49400,102066,23080,49152,16942,78986,3296,1574,1722
49405,102077,23082,49157,16943,78994,3296,1574,1722
49410,102084,23084,49161,16944,79000,3296,1574,1722
49415,102097,23086,49165,16944,79011,3297,1575,1722
49420,102108,23087,49167,16944,79020,3297,1575,1722
49425,102115,23090,49168,16945,79025,3297,1575,1722
49430,102128,23093,49173,16947,79033,3298,1575,1723
49435,102139,23098,49179,16951,79037,3298,1575,1723
49440,102146,23106,49183,16958,79039,3298,1575,1723
49445,102159,23111,49188,16961,79046,3299,1576,1723
49450,102170,23117,49193,16967,79052,3299,1576,1723
49455,102177,23121,49195,16969,79055,3299,1576,1723
49460,102190,23127,49203,16973,79059,3300,1577,1723
49465,102201,23132,49207,16977,79067,3300,1577,1723
49470,102208,23136,49212,16980,79072,3300,1577,1723
49475,102221,23138,49218,16980,79080,3301,1578,1723
49480,102232,23138,49223,16980,79094,3301,1578,1723
49485,102239,23139,49225,16981,79100,3301,1578,1723
49490,102252,23141,49230,16981,79110,3302,1578,1724
49495,102263,23141,49233,16981,79122,3302,1578,1724
49500,102270,23142,49237,16982,79128,3302,1578,1724
49505,102283,23144,49239,16982,79139,3303,1579,1724
49510,102294,23144,49243,16982,79149,3303,1579,1724
49515,102301,23145,49245,16982,79156,3303,1579,1724
49520,102314,23147,49250,16983,79166,3304,1579,1725
49525,102325,23147,49253,16983,79177,3304,1579,1725
49530,102332,23148,49259,16983,79184,3304,1579,1725
49535,102345,23150,49267,16985,79193,3305,1579,1726
49540,102356,23150,49272,16985,79205,3305,1579,1726
49545,102363,23151,49275,16985,79212,3305,1579,1726
49550,102376,23153,49280,16985,79223,3306,1580,1726
49555,102387,23153,49285,16985,79234,3306,1580,1726
49560,102394,23154,49290,16986,79240,3306,1580,1726
49565,102407,23156,49293,16987,79251,3307,1580,1727
49570,102418,23156,49300,16987,79262,3307,1580,1727
49575,102425,23157,49305,16988,79268,3307,1580,1727
49580,102438,23160,49313,16990,79278,3308,1580,1728
49585,102449,23162,49319,16992,79286,3308,1580,1728
49590,102456,23166,49322,16995,79290,3308,1580,1728
49595,102469,23170,49329,16998,79297,3309,1580,1729
49600,102480,23174,49335,17002,79304,3309,1580,1729
49605,102487,23178,49337,17005,79309,3309,1580,1729
49610,102500,23181,49346,17007,79315,3310,1581,1729
49615,102511,23186,49349,17011,79323,3310,1581,1729
49620,102518,23190,49350,17013,79328,3310,1581,1729
49625,102531,23193,49359,17016,79335,3311,1582,1729
49630,102542,23200,49366,17022,79340,3311,1582,1729
49635,102549,23205,49369,17025,79344,3311,1582,1729
49640,102562,23207,49373,17026,79355,3312,1583,1729
49645,102573,23208,49380,17027,79364,3312,1583,1729
49650,102580,23210,49384,17028,79369,3312,1583,1729
49655,102593,23213,49390,17030,79380,3313,1584,1729
49660,102604,23215,49395,17031,79389,3313,1584,1729
49665,102611,23216,49398,17031,79395,3313,1584,1729
49670,102624,23220,49401,17033,79403,3314,1584,1730
49675,102635,23224,49406,17036,79409,3314,1584,1730
49680,102642,23227,49409,17038,79414,3314,1584,1730
49685,102655,23230,49416,17040,79423,3315,1585,1730
49690,102666,23231,49422,17041,79434,3315,1585,1730
49695,102673,23232,49425,17042,79441,3315,1585,1730
49700,102686,23234,49434,17044,79450,3316,1586,1730
49705,102697,23234,49440,17044,79462,3316,1586,1730
49710,102704,23235,49443,17045,79469,3316,1586,1730
49715,102717,23237,49446,17046,79480,3317,1586,1731
49720,102728,23237,49452,17046,79490,3317,1586,1731
49725,102735,23238,49457,17046,79497,3317,1586,1731
49730,102748,23240,49463,17046,79507,3318,1587,1731
49735,102759,23240,49468,17046,79519,3318,1587,1731
49740,102766,23241,49471,17046,79525,3318,1587,1731
49745,102779,23243,49479,17047,79536,3319,1588,1731
49750,102790,23244,49488,17048,79544,3319,1588,1731
49755,102797,23249,49492,17052,79547,3319,1588,1731
49760,102810,23253,49498,17054,79555,3320,1589,1731
49765,102821,23255,49503,17056,79564,3320,1589,1731
49770,102828,23261,49507,17060,79567,3320,1589,1731
49775,102841,23263,49513,17062,79577,3321,1590,1731
49780,102852,23265,49520,17064,79587,3321,1590,1731
49785,102859,23268,49524,17066,79591,3321,1590,1731
49790,102872,23270,49534,17068,79598,3322,1591,1731
49795,102883,23276,49540,17073,79607,3322,1591,1731
49800,102890,23277,49544,17074,79613,3322,1591,1731
49805,102903,23281,49548,17077,79622,3323,1591,1732
49810,102914,23283,49555,17079,79631,3323,1591,1732
49815,102921,23284,49558,17079,79637,3323,1591,1732
49820,102934,23287,49563,17081,79646,3324,1592,1732
49825,102945,23289,49570,17083,79656,3324,1592,1732
49830,102952,23290,49573,17083,79662,3324,1592,1732
49835,102965,23293,49578,17084,79669,3325,1592,1733
49840,102976,23298,49584,17089,79678,3325,1592,1733
49845,102983,23300,49586,17090,79682,3325,1592,1733
49850,102996,23306,49593,17095,79688,3326,1592,1734
49855,103007,23309,49595,17097,79696,3326,1592,1734
49860,103014,23311,49596,17098,79703,3326,1592,1734
49865,103027,23313,49604,17100,79714,3327,1592,1735
49870,103038,23313,49606,17100,79725,3327,1592,1735
49875,103045,23314,49610,17101,79730,3327,1592,1735
49880,103058,23316,49618,17102,79742,3328,1593,1735
49885,103069,23316,49624,17102,79753,3328,1593,1735
49890,103076,23317,49627,17103,79759,3328,1593,1735
49895,103089,23319,49635,17104,79770,3329,1594,1735
49900,103100,23319,49638,17104,79781,3329,1594,1735
49905,103107,23321,49642,17105,79786,3329,1594,1735
49910,103120,23323,49648,17107,79797,3330,1594,1736
49915,103131,23324,49654,17108,79807,3330,1594,1736
49920,103138,23327,49657,17110,79811,3330,1594,1736
49925,103151,23329,49665,17111,79822,3331,1594,1737
49930,103162,23330,49668,17112,79832,3331,1594,1737
49935,103169,23332,49672,17113,79837,3331,1594,1737
49940,103182,23334,49678,17113,79848,3332,1595,1737
49945,103193,23335,49684,17114,79858,3332,1595,1737
49950,103200,23337,49686,17115,79863,3332,1595,1737
49955,103213,23339,49693,17116,79874,3333,1596,1737
49960,103224,23339,49695,17116,79885,3333,1596,1737
49965,103231,23342,49698,17118,79889,3333,1596,1737
49970,103244,23345,49707,17121,79897,3334,1597,1737
49975,103255,23348,49712,17124,79906,3334,1597,1737
49980,103262,23351,49717,17126,79911,3334,1597,1737
49985,103275,23354,49723,17127,79921,3335,1598,1737
49990,103286,23357,49729,17130,79929,3335,1598,1737
49995,103293,23359,49732,17130,79934,3335,1598,1737
50000,103306,23363,49740,17133,79940,3336,1598,1738
50005,103317,23369,49746,17139,79948,3336,1598,1738
50010,103324,23373,49751,17142,79951,3336,1598,1738
50015,103337,23378,49757,17146,79958,3337,1598,1739
50020,103348,23383,49763,17150,79963,3337,1598,1739
50025,103355,23387,49765,17153,79967,3337,1598,1739
50030,103368,23391,49775,17156,79973,3338,1598,1740
50035,103379,23395,49780,17159,79984,3338,1598,1740
50040,103386,23396,49784,17160,79990,3338,1598,1740
50045,103399,23399,49789,17161,79997,3339,1598,1741
50050,103410,23402,49793,17163,80008,3339,1598,1741
50055,103417,23403,49794,17163,80014,3339,1598,1741
50060,103430,23406,49802,17165,80021,3340,1599,1741
50065,103441,23408,49806,17167,80033,3340,1599,1741
50070,103448,23409,49807,17167,80039,3340,1599,1741
50075,103461,23412,49816,17169,80046,3341,1600,1741
50080,103472,23415,49823,17172,80056,3341,1600,1741
50085,103479,23417,49826,17174,80062,3341,1600,1741
50090,103492,23419,49831,17175,80072,3342,1600,1742
50095,103503,23419,49837,17175,80083,3342,1600,1742
50100,103510,23420,49841,17176,80089,3342,1600,1742
50105,103523,23422,49846,17177,80100,3343,1601,1742
50110,103534,23422,49853,17177,80111,3343,1601,1742
50115,103541,23423,49855,17177,80117,3343,1601,1742
50120,103554,23425,49859,17178,80128,3344,1601,1743
50125,103565,23425,49865,17178,80139,3344,1601,1743
50130,103572,23426,49869,17178,80145,3344,1601,1743
50135,103585,23428,49876,17178,80157,3345,1602,1743
50140,103596,23429,49883,17179,80166,3345,1602,1743
50145,103603,23431,49887,17180,80172,3345,1602,1743
50150,103616,23433,49894,17181,80182,3346,1603,1743
50155,103627,23434,49899,17182,80192,3346,1603,1743
50160,103634,23437,49901,17183,80197,3346,1603,1743
50165,103647,23439,49905,17183,80208,3347,1603,1744
50170,103658,23441,49912,17185,80216,3347,1603,1744
50175,103665,23446,49917,17190,80218,3347,1603,1744
50180,103678,23449,49922,17192,80228,3348,1604,1744
50185,103689,23451,49925,17194,80238,3348,1604,1744
50190,103696,23454,49928,17195,80242,3348,1604,1744
50195,103709,23456,49933,17196,80250,3349,1605,1744
50200,103720,23460,49938,17200,80259,3349,1605,1744
50205,103727,23463,49941,17202,80264,3349,1605,1744
50210,103740,23465,49948,17203,80272,3350,1605,1745
50215,103751,23470,49953,17207,80280,3350,1605,1745
50220,103758,23473,49956,17210,80285,3350,1605,1745
50225,103771,23475,49964,17211,80294,3351,1606,1745
50230,103782,23477,49967,17212,80305,3351,1606,1745
50235,103789,23478,49970,17212,80311,3351,1606,1745
50240,103802,23481,49978,17214,80321,3352,1607,1745
50245,103813,23482,49981,17214,80331,3352,1607,1745
50250,103820,23483,49984,17214,80337,3352,1607,1745
50255,103833,23485,49993,17216,80347,3353,1608,1745
50260,103844,23488,49997,17218,80356,3353,1608,1745
50265,103851,23489,50001,17218,80361,3353,1608,1745
50270,103864,23494,50008,17222,80368,3354,1609,1745
50275,103875,23498,50012,17226,80376,3354,1609,1745
50280,103882,23500,50016,17228,80382,3354,1609,1745
50285,103895,23503,50021,17230,80391,3355,1609,1746
50290,103906,23505,50025,17232,80401,3355,1609,1746
50295,103913,23506,50026,17232,80407,3355,1609,1746
50300,103926,23510,50031,17234,80416,3356,1610,1746
50305,103937,23512,50034,17235,80424,3356,1610,1746
50310,103944,23514,50040,17237,80429,3356,1610,1746
50315,103957,23520,50052,17243,80433,3357,1611,1746
50320,103968,23522,50057,17245,80446,3357,1611,1746
50325,103975,23525,50060,17247,80450,3357,1611,1746
50330,103988,23527,50064,17247,80460,3358,1611,1747
50335,103999,23527,50070,17247,80470,3358,1611,1747
50340,104006,23533,50075,17253,80472,3358,1611,1747
50345,104019,23537,50083,17256,80479,3359,1612,1747
50350,104030,23540,50090,17259,80488,3359,1612,1747
50355,104037,23544,50093,17262,80492,3359,1612,1747
50360,104050,23547,50101,17265,80500,3360,1612,1748
50365,104061,23549,50104,17267,80512,3360,1612,1748
50370,104068,23551,50106,17267,80516,3360,1612,1748
50375,104081,23554,50113,17269,80525,3361,1612,1749
50380,104092,23555,50118,17270,80537,3361,1612,1749
50385,104099,23556,50122,17271,80543,3361,1612,1749
50390,104112,23558,50129,17271,80554,3362,1613,1749
50395,104123,23558,50134,17271,80565,3362,1613,1749
50400,104130,23559,50136,17271,80571,3362,1613,1749
50405,104143,23561,50140,17272,80581,3363,1613,1750
50410,104154,23561,50146,17272,80593,3363,1613,1750
50415,104161,23562,50148,17272,80599,3363,1613,1750
50420,104174,23564,50157,17273,80609,3364,1613,1751
50425,104185,23564,50163,17273,80621,3364,1613,1751
50430,104192,23565,50166,17273,80627,3364,1613,1751
50435,104205,23567,50172,17275,80638,3365,1614,1751
50440,104216,23568,50176,17276,80648,3365,1614,1751
50445,104223,23569,50179,17277,80654,3365,1614,1751
50450,104236,23571,50183,17279,80664,3366,1614,1752
50455,104247,23573,50188,17280,80673,3366,1614,1752
50460,104254,23575,50189,17281,80679,3366,1614,1752
50465,104267,23578,50192,17283,80689,3367,1614,1753
50470,104278,23580,50197,17285,80697,3367,1614,1753
50475,104285,23582,50201,17287,80703,3367,1614,1753
50480,104298,23586,50208,17291,80710,3368,1614,1754
50485,104309,23590,50213,17295,80718,3368,1614,1754
50490,104316,23595,50217,17299,80721,3368,1614,1754
50495,104329,23598,50223,17301,80727,3369,1614,1755
50500,104340,23606,50231,17309,80732,3369,1614,1755
50505,104347,23610,50232,17311,80737,3369,1614,1755
50510,104360,23613,50239,17313,80747,3370,1615,1755
50515,104371,23614,50245,17314,80755,3370,1615,1755
50520,104378,23620,50249,17319,80757,3370,1615,1755
50525,104391,23623,50256,17320,80767,3371,1616,1755
50530,104402,23625,50261,17322,80776,3371,1616,1755
50535,104409,23629,50265,17325,80779,3371,1616,1755
50540,104422,23632,50267,17326,80790,3372,1616,1756
50545,104433,23633,50271,17327,80799,3372,1616,1756
50550,104440,23637,50273,17330,80803,3372,1616,1756
50555,104453,23639,50277,17330,80814,3373,1617,1756
50560,104464,23641,50280,17332,80822,3373,1617,1756
50565,104471,23645,50282,17335,80826,3373,1617,1756
50570,104484,23647,50289,17336,80837,3374,1618,1756
50575,104495,23647,50295,17336,80848,3374,1618,1756
50580,104502,23648,50298,17336,80854,3374,1618,1756
50585,104515,23650,50304,17337,80865,3375,1619,1756
50590,104526,23650,50311,17337,80876,3375,1619,1756
50595,104533,23651,50316,17337,80882,3375,1619,1756
50600,104546,23653,50323,17338,80893,3376,1620,1756
50605,104557,23653,50330,17338,80903,3376,1620,1756
50610,104564,23654,50334,17339,80910,3376,1620,1756
50615,104577,23657,50337,17341,80919,3377,1620,1757
50620,104588,23658,50343,17342,80930,3377,1620,1757
50625,104595,23659,50347,17342,80936,3377,1620,1757
50630,104608,23661,50352,17343,80946,3378,1621,1757
50635,104619,23662,50356,17343,80956,3378,1621,1757
50640,104626,23664,50358,17345,80962,3378,1621,1757
50645,104639,23666,50362,17346,80971,3379,1621,1758
50650,104650,23668,50367,17347,80981,3379,1621,1758
50655,104657,23670,50371,17348,80987,3379,1621,1758
50660,104670,23674,50378,17350,80994,3380,1621,1759
50665,104681,23677,50384,17353,81003,3380,1621,1759
50670,104688,23679,50388,17355,81009,3380,1621,1759
50675,104701,23683,50394,17357,81017,3381,1622,1759
50680,104712,23687,50400,17361,81024,3381,1622,1759
50685,104719,23691,50404,17364,81028,3381,1622,1759
50690,104732,23693,50410,17366,81038,3382,1622,1760
50695,104743,23697,50417,17370,81046,3382,1622,1760
50700,104750,23699,50420,17371,81051,3382,1622,1760
50705,104763,23703,50425,17374,81059,3383,1622,1761
50710,104774,23707,50431,17377,81066,3383,1622,1761
50715,104781,23711,50435,17380,81070,3383,1622,1761
50720,104794,23714,50443,17383,81079,3384,1623,1761
50725,104805,23716,50447,17385,81089,3384,1623,1761
50730,104812,23718,50449,17385,81094,3384,1623,1761
50735,104825,23720,50453,17386,81105,3385,1623,1762
50740,104836,23721,50459,17387,81115,3385,1623,1762
50745,104843,23723,50464,17389,81119,3385,1623,1762
50750,104856,23727,50471,17392,81127,3386,1624,1762
50755,104867,23729,50474,17394,81137,3386,1624,1762
50760,104874,23733,50478,17397,81140,3386,1624,1762
50765,104887,23736,50484,17400,81148,3387,1624,1763
50770,104898,23739,50488,17403,81158,3387,1624,1763
50775,104905,23741,50492,17405,81164,3387,1624,1763
50780,104918,23743,50497,17405,81174,3388,1625,1763
50785,104929,23743,50499,17405,81186,3388,1625,1763
50790,104936,23744,50500,17405,81192,3388,1625,1763
50795,104949,23746,50506,17406,81201,3389,1626,1763
50800,104960,23746,50509,17406,81213,3389,1626,1763
50805,104967,23747,50513,17407,81220,3389,1626,1763
50810,104980,23749,50516,17408,81231,3390,1626,1764
50815,104991,23749,50522,17408,81242,3390,1626,1764
50820,104998,23750,50527,17409,81248,3390,1626,1764
50825,105011,23752,50534,17410,81257,3391,1627,1764
50830,105022,23754,50538,17411,81268,3391,1627,1764
50835,105029,23755,50541,17411,81274,3391,1627,1764
50840,105042,23757,50547,17413,81283,3392,1627,1765
50845,105053,23759,50551,17414,81294,3392,1627,1765
50850,105060,23760,50555,17414,81300,3392,1627,1765
50855,105073,23762,50558,17414,81310,3393,1627,1766
50860,105084,23764,50563,17415,81320,3393,1627,1766
50865,105091,23765,50568,17416,81326,3393,1627,1766
50870,105104,23767,50574,17417,81335,3394,1627,1767
50875,105115,23769,50578,17418,81346,3394,1627,1767
50880,105122,23770,50582,17418,81352,3394,1627,1767
50885,105135,23772,50587,17419,81363,3395,1628,1767
50890,105146,23775,50594,17422,81370,3395,1628,1767
50895,105153,23778,50598,17424,81375,3395,1628,1767
50900,105166,23781,50601,17426,81385,3396,1628,1768
50905,105177,23783,50605,17428,81394,3396,1628,1768
50910,105184,23786,50608,17429,81397,3396,1628,1768
50915,105197,23789,50612,17431,81406,3397,1628,1769
50920,105208,23793,50616,17435,81414,3397,1628,1769
50925,105215,23797,50620,17438,81417,3397,1628,1769
50930,105228,23801,50624,17440,81425,3398,1629,1769
50935,105239,23806,50630,17445,81432,3398,1629,1769
50940,105246,23810,50634,17448,81435,3398,1629,1769
50945,105259,23814,50643,17452,81441,3399,1629,1770
50950,105270,23819,50647,17456,81450,3399,1629,1770
50955,105277,23824,50653,17461,81453,3399,1629,1770
50960,105290,23826,50657,17462,81463,3400,1630,1770
50965,105301,23828,50661,17463,81473,3400,1630,1770
50970,105308,23831,50662,17464,81477,3400,1630,1770
50975,105321,23834,50667,17465,81483,3401,1630,1771
50980,105332,23839,50670,17469,81493,3401,1630,1771
50985,105339,23840,50674,17469,81499,3401,1630,1771
50990,105352,23844,50680,17472,81506,3402,1630,1772
50995,105363,23849,50686,17476,81512,3402,1630,1772
51000,105370,23852,50690,17478,81518,3402,1630,1772
51005,105383,23854,50699,17479,81527,3403,1631,1772
51010,105394,23854,50704,17479,81539,3403,1631,1772
51015,105401,23855,50710,17480,81546,3403,1631,1772
51020,105414,23857,50716,17482,81556,3404,1631,1773
51025,105425,23857,50723,17482,81567,3404,1631,1773
51030,105432,23858,50728,17483,81574,3404,1631,1773
51035,105445,23860,50735,17485,81584,3405,1631,1774
51040,105456,23860,50742,17485,81596,3405,1631,1774
51045,105463,23861,50748,17486,81602,3405,1631,1774
51050,105476,23863,50753,17486,81613,3406,1632,1774
51055,105487,23863,50761,17486,81624,3406,1632,1774
51060,105494,23864,50764,17486,81630,3406,1632,1774
51065,105507,23866,50770,17486,81641,3407,1633,1774
51070,105518,23866,50775,17486,81652,3407,1633,1774
51075,105525,23867,50780,17486,81658,3407,1633,1774
51080,105538,23869,50788,17487,81669,3408,1633,1775
51085,105549,23869,50791,17487,81680,3408,1633,1775
51090,105556,23871,50793,17487,81685,3408,1633,1775
51095,105569,23873,50799,17487,81696,3409,1633,1776
51100,105580,23874,50803,17488,81706,3409,1633,1776
51105,105587,23877,50805,17489,81710,3409,1633,1776
51110,105600,23879,50812,17491,81720,3410,1633,1777
51115,105611,23882,50816,17494,81729,3410,1633,1777
51120,105618,23884,50820,17495,81734,3410,1633,1777
51125,105631,23887,50825,17497,81743,3411,1633,1778
51130,105642,23890,50830,17500,81751,3411,1633,1778
51135,105649,23893,50833,17502,81756,3411,1633,1778
51140,105662,23897,50843,17505,81763,3412,1633,1779
51145,105673,23904,50852,17511,81768,3412,1633,1779
51150,105680,23909,50856,17516,81771,3412,1633,1779
51155,105693,23911,50861,17518,81781,3413,1633,1780
51160,105704,23915,50866,17522,81788,3413,1633,1780
51165,105711,23918,50868,17524,81792,3413,1633,1780
51170,105724,23923,50876,17529,81798,3414,1634,1780
51175,105735,23929,50882,17535,81804,3414,1634,1780
51180,105742,23933,50884,17538,81809,3414,1634,1780
51185,105755,23935,50891,17539,81818,3415,1635,1780
51190,105766,23938,50894,17542,81828,3415,1635,1780
51195,105773,23942,50897,17544,81830,3415,1635,1780
51200,105786,23945,50903,17547,81839,3416,1636,1780
51205,105797,23947,50910,17549,81848,3416,1636,1780
51210,105804,23949,50912,17550,81855,3416,1636,1780
51215,105817,23951,50921,17552,81865,3417,1637,1780
51220,105828,23951,50928,17552,81877,3417,1637,1780
51225,105835,23952,50931,17553,81883,3417,1637,1780
51230,105848,23954,50936,17554,81892,3418,1637,1781
51235,105859,23954,50941,17554,81904,3418,1637,1781
51240,105866,23955,50945,17554,81911,3418,1637,1781
51245,105879,23957,50950,17555,81920,3419,1637,1782
51250,105890,23957,50957,17555,81933,3419,1637,1782
51255,105897,23958,50958,17556,81939,3419,1637,1782
51260,105910,23960,50966,17557,81948,3420,1638,1782
51265,105921,23960,50970,17557,81960,3420,1638,1782
51270,105928,23961,50974,17558,81967,3420,1638,1782
51275,105941,23963,50982,17560,81977,3421,1638,1783
51280,105952,23963,50987,17560,81989,3421,1638,1783
51285,105959,23964,50992,17561,81995,3421,1638,1783
51290,105972,23966,51000,17563,82005,3422,1639,1783
51295,105983,23968,51003,17565,82015,3422,1639,1783
51300,105990,23969,51007,17565,82021,3422,1639,1783
51305,106003,23971,51014,17567,82031,3423,1639,1784
51310,106014,23972,51019,17568,82042,3423,1639,1784
51315,106021,23974,51021,17568,82047,3423,1639,1784
51320,106034,23977,51026,17570,82055,3424,1640,1784
51325,106045,23980,51030,17572,82065,3424,1640,1784
51330,106052,23982,51036,17574,82070,3424,1640,1784
51335,106065,23985,51042,17575,82078,3425,1640,1785
51340,106076,23988,51046,17577,82088,3425,1640,1785
51345,106083,23990,51048,17577,82093,3425,1640,1785
51350,106096,23993,51056,17579,82101,3426,1641,1785
51355,106107,23998,51063,17584,82108,3426,1641,1785
51360,106114,24002,51070,17588,82112,3426,1641,1785
51365,106127,24004,51075,17589,82123,3427,1642,1785
51370,106138,24007,51080,17592,82130,3427,1642,1785
51375,106145,24011,51083,17594,82134,3427,1642,1785
51380,106158,24016,51090,17599,82140,3428,1642,1786
51385,106169,24019,51093,17601,82147,3428,1642,1786
51390,106176,24025,51095,17606,82151,3428,1642,1786
51395,106189,24029,51103,17610,82157,3429,1643,1786
51400,106200,24033,51109,17614,82164,3429,1643,1786
51405,106207,24037,51111,17616,82169,3429,1643,1786
51410,106220,24039,51116,17617,82179,3430,1643,1787
51415,106231,24043,51123,17621,82187,3430,1643,1787
51420,106238,24047,51126,17624,82190,3430,1643,1787
51425,106251,24050,51134,17627,82199,3431,1643,1788
51430,106262,24052,51138,17629,82210,3431,1643,1788
51435,106269,24053,51143,17630,82216,3431,1643,1788
51440,106282,24055,51151,17631,82225,3432,1643,1789
51445,106293,24055,51157,17631,82238,3432,1643,1789
51450,106300,24056,51160,17632,82244,3432,1643,1789
51455,106313,24058,51168,17634,82253,3433,1644,1789
51460,106324,24058,51173,17634,82266,3433,1644,1789
51465,106331,24059,51176,17635,82272,3433,1644,1789
51470,106344,24061,51178,17636,82283,3434,1645,1789
51475,106355,24061,51184,17636,82294,3434,1645,1789
51480,106362,24062,51187,17636,82300,3434,1645,1789
51485,106375,24064,51193,17637,82311,3435,1646,1789
51490,106386,24064,51195,17637,82321,3435,1646,1789
51495,106393,24065,51200,17638,82328,3435,1646,1789
51500,106406,24067,51207,17639,82337,3436,1646,1790
51505,106417,24068,51209,17639,82349,3436,1646,1790
51510,106424,24069,51212,17639,82355,3436,1646,1790
51515,106437,24072,51219,17641,82363,3437,1646,1791
51520,106448,24074,51223,17642,82374,3437,1646,1791
51525,106455,24075,51224,17643,82380,3437,1646,1791
51530,106468,24077,51228,17643,82390,3438,1646,1792
51535,106479,24079,51233,17644,82399,3438,1646,1792
51540,106486,24083,51236,17646,82403,3438,1646,1792
51545,106499,24086,51239,17648,82413,3439,1646,1793
51550,106510,24088,51243,17650,82422,3439,1646,1793
51555,106517,24090,51246,17650,82427,3439,1646,1793
51560,106530,24094,51254,17653,82435,3440,1647,1793
51565,106541,24097,51260,17656,82444,3440,1647,1793
51570,106548,24100,51263,17658,82448,3440,1647,1793
51575,106561,24102,51267,17660,82458,3441,1647,1794
51580,106572,24106,51273,17664,82465,3441,1647,1794
51585,106579,24109,51275,17665,82470,3441,1647,1794
51590,106592,24114,51284,17669,82475,3442,1647,1795
51595,106603,24120,51290,17674,82481,3442,1647,1795
51600,106610,24126,51292,17678,82484,3442,1647,1795
51605,106623,24129,51295,17680,82493,3443,1647,1796
51610,106634,24134,51302,17685,82499,3443,1647,1796
51615,106641,24136,51305,17686,82505,3443,1647,1796
51620,106654,24141,51313,17690,82512,3444,1648,1796
51625,106665,24142,51317,17691,82523,3444,1648,1796
51630,106672,24143,51319,17692,82529,3444,1648,1796
51635,106685,24147,51326,17694,82536,3445,1649,1796
51640,106696,24150,51332,17697,82546,3445,1649,1796
51645,106703,24151,51336,17698,82552,3445,1649,1796
51650,106716,24153,51341,17698,82563,3446,1650,1796
51655,106727,24153,51348,17698,82574,3446,1650,1796
51660,106734,24154,51350,17698,82580,3446,1650,1796
51665,106747,24156,51355,17699,82590,3447,1651,1796
51670,106758,24156,51358,17699,82602,3447,1651,1796
51675,106765,24157,51361,17699,82608,3447,1651,1796
51680,106778,24159,51364,17700,82618,3448,1651,1797
51685,106789,24159,51369,17700,82629,3448,1651,1797
51690,106796,24160,51374,17701,82636,3448,1651,1797
51695,106809,24162,51380,17702,82645,3449,1652,1797
51700,106820,24162,51384,17702,82658,3449,1652,1797
51705,106827,24163,51386,17702,82664,3449,1652,1797
51710,106840,24165,51395,17703,82674,3450,1652,1798
51715,106851,24167,51400,17705,82684,3450,1652,1798
51720,106858,24169,51403,17705,82689,3450,1652,1798
51725,106871,24171,51411,17706,82698,3451,1652,1799
51730,106882,24172,51414,17707,82710,3451,1652,1799
51735,106889,24175,51418,17709,82714,3451,1652,1799
51740,106902,24177,51422,17709,82725,3452,1652,1800
51745,106913,24179,51429,17711,82733,3452,1652,1800
51750,106920,24183,51435,17715,82736,3452,1652,1800
51755,106933,24187,51444,17719,82742,3453,1653,1800
51760,106944,24193,51447,17724,82751,3453,1653,1800
51765,106951,24195,51452,17726,82755,3453,1653,1800
51770,106964,24198,51457,17727,82764,3454,1654,1800
51775,106975,24204,51466,17733,82769,3454,1654,1800
51780,106982,24209,51469,17736,82773,3454,1654,1800
51785,106995,24211,51472,17737,82782,3455,1654,1801
51790,107006,24214,51477,17740,82792,3455,1654,1801
51795,107013,24215,51483,17741,82798,3455,1654,1801
51800,107026,24218,51489,17743,82806,3456,1654,1802
51805,107037,24221,51497,17745,82815,3456,1654,1802
51810,107044,24223,51499,17746,82821,3456,1654,1802
51815,107057,24226,51505,17747,82830,3457,1655,1802
51820,107068,24228,51512,17749,82840,3457,1655,1802
51825,107075,24229,51515,17749,82846,3457,1655,1802
51830,107088,24232,51523,17751,82854,3458,1656,1802
51835,107099,24235,51529,17754,82864,3458,1656,1802
51840,107106,24236,51533,17755,82869,3458,1656,1802
51845,107119,24240,51538,17758,82877,3459,1656,1803
51850,107130,24245,51545,17763,82884,3459,1656,1803
51855,107137,24246,51548,17763,82891,3459,1656,1803
51860,107150,24248,51554,17764,82901,3460,1657,1803
51865,107161,24248,51560,17764,82913,3460,1657,1803
51870,107168,24249,51563,17765,82918,3460,1657,1803
51875,107181,24251,51573,17767,82928,3461,1657,1804
51880,107192,24251,51577,17767,82941,3461,1657,1804
51885,107199,24252,51582,17768,82947,3461,1657,1804
51890,107212,24254,51589,17769,82957,3462,1657,1805
51895,107223,24255,51595,17770,82967,3462,1657,1805
51900,107230,24257,51596,17770,82973,3462,1657,1805
51905,107243,24259,51604,17771,82982,3463,1657,1806
51910,107254,24260,51608,17772,82994,3463,1657,1806
51915,107261,24264,51614,17775,82996,3463,1657,1806
51920,107274,24267,51619,17777,83006,3464,1657,1807
51925,107285,24269,51622,17779,83015,3464,1657,1807
51930,107292,24274,51626,17782,83017,3464,1657,1807
51935,107305,24278,51632,17786,83026,3465,1658,1807
51940,107316,24280,51634,17788,83036,3465,1658,1807
51945,107323,24283,51637,17790,83040,3465,1658,1807
51950,107336,24284,51644,17791,83051,3466,1659,1807
51955,107347,24286,51650,17793,83060,3466,1659,1807
51960,107354,24289,51653,17795,83065,3466,1659,1807
51965,107367,24290,51660,17795,83075,3467,1660,1807
51970,107378,24292,51667,17797,83086,3467,1660,1807
51975,107385,24293,51671,17798,83092,3467,1660,1807
51980,107398,24296,51681,17800,83099,3468,1661,1807
51985,107409,24300,51689,17804,83108,3468,1661,1807
51990,107416,24302,51691,17805,83114,3468,1661,1807
51995,107429,24305,51697,17807,83122,3469,1662,1807
52000,107440,24308,51703,17809,83132,3469,1662,1807
52005,107447,24309,51705,17810,83138,3469,1662,1807
52010,107460,24311,51711,17812,83146,3470,1662,1808
52015,107471,24315,51715,17815,83156,3470,1662,1808
52020,107478,24317,51717,17816,83160,3470,1662,1808
52025,107491,24321,51721,17819,83168,3471,1662,1809
52030,107502,24324,51724,17821,83177,3471,1662,1809
52035,107509,24325,51726,17821,83184,3471,1662,1809
52040,107522,24327,51731,17822,83194,3472,1662,1810
52045,107533,24327,51736,17822,83206,3472,1662,1810
52050,107540,24328,51739,17823,83212,3472,1662,1810
52055,107553,24329,51746,17824,83224,3473,1663,1810
52060,107564,24329,51752,17824,83235,3473,1663,1810
52065,107571,24331,51756,17825,83239,3473,1663,1810
52070,107584,24333,51766,17826,83250,3474,1664,1810
52075,107595,24333,51773,17826,83262,3474,1664,1810
52080,107602,24335,51775,17826,83267,3474,1664,1810
52085,107615,24336,51781,17826,83278,3475,1665,1810
52090,107626,24337,51785,17827,83289,3475,1665,1810
52095,107633,24339,51788,17829,83294,3475,1665,1810
52100,107646,24340,51797,17829,83304,3476,1666,1810
52105,107657,24341,51800,17830,83315,3476,1666,1810
52110,107664,24343,51802,17830,83321,3476,1666,1810
52115,107677,24345,51811,17831,83331,3477,1666,1811
52120,107688,24345,51816,17831,83343,3477,1666,1811
52125,107695,24347,51817,17832,83348,3477,1666,1811
52130,107708,24348,51823,17833,83359,3478,1666,1812
52135,107719,24349,51827,17834,83368,3478,1666,1812
52140,107726,24355,51832,17840,83371,3478,1666,1812
52145,107739,24359,51839,17843,83379,3479,1667,1812
52150,107750,24363,51845,17847,83386,3479,1667,1812
52155,107757,24367,51847,17849,83390,3479,1667,1812
52160,107770,24369,51852,17850,83398,3480,1668,1812
52165,107781,24374,51856,17854,83406,3480,1668,1812
52170,107788,24379,51860,17857,83409,3480,1668,1812
52175,107801,24380,51866,17858,83418,3481,1668,1813
52180,107812,24385,51870,17862,83426,3481,1668,1813
52185,107819,24387,51875,17864,83432,3481,1668,1813
52190,107832,24390,51883,17867,83441,3482,1669,1813
52195,107843,24392,51886,17868,83451,3482,1669,1813
52200,107850,24393,51888,17868,83457,3482,1669,1813
52205,107863,24395,51894,17869,83467,3483,1670,1813
52210,107874,24398,51899,17872,83476,3483,1670,1813
52215,107881,24399,51901,17872,83482,3483,1670,1813
52220,107894,24401,51907,17873,83492,3484,1671,1813
52225,107905,24405,51913,17876,83498,3484,1671,1813
52230,107912,24408,51916,17878,83503,3484,1671,1813
52235,107925,24413,51923,17883,83510,3485,1671,1814
52240,107936,24416,51927,17885,83519,3485,1671,1814
52245,107943,24417,51932,17886,83525,3485,1671,1814
52250,107956,24418,51938,17886,83536,3486,1671,1815
52255,107967,24418,51944,17886,83548,3486,1671,1815
52260,107974,24419,51946,17887,83554,3486,1671,1815
52265,107987,24421,51955,17888,83565,3487,1672,1815
52270,107998,24421,51957,17888,83577,3487,1672,1815
52275,108005,24422,51960,17888,83583,3487,1672,1815
52280,108018,24423,51967,17889,83595,3488,1673,1815
52285,108029,24423,51970,17889,83606,3488,1673,1815
52290,108036,24425,51973,17889,83611,3488,1673,1815
52295,108049,24426,51978,17890,83622,3489,1673,1816
52300,108060,24427,51983,17891,83633,3489,1673,1816
52305,108067,24430,51985,17893,83637,3489,1673,1816
52310,108080,24431,51991,17893,83649,3490,1674,1816
52315,108091,24431,51994,17893,83659,3490,1674,1816
52320,108098,24433,51996,17895,83665,3490,1674,1816
52325,108111,24436,52001,17898,83675,3491,1675,1816
52330,108122,24437,52007,17899,83683,3491,1675,1816
52335,108129,24441,52011,17901,83687,3491,1675,1816
52340,108142,24445,52018,17905,83695,3492,1676,1816
52345,108153,24446,52022,17906,83707,3492,1676,1816
52350,108160,24448,52024,17906,83711,3492,1676,1816
52355,108173,24451,52032,17909,83718,3493,1677,1816
52360,108184,24455,52036,17913,83729,3493,1677,1816
52365,108191,24458,52039,17915,83733,3493,1677,1816
52370,108204,24461,52048,17918,83740,3494,1678,1816
52375,108215,24467,52055,17924,83746,3494,1678,1816
52380,108222,24472,52061,17929,83750,3494,1678,1816
52385,108235,24474,52069,17931,83760,3495,1679,1816
52390,108246,24477,52075,17934,83769,3495,1679,1816
52395,108253,24478,52078,17935,83775,3495,1679,1816
52400,108266,24481,52088,17938,83783,3496,1680,1816
52405,108277,24484,52093,17940,83793,3496,1680,1816
52410,108284,24485,52097,17941,83799,3496,1680,1816
52415,108297,24486,52100,17941,83810,3497,1680,1817
52420,108308,24488,52105,17942,83819,3497,1680,1817
52425,108315,24490,52110,17944,83825,3497,1680,1817
52430,108328,24493,52115,17946,83835,3498,1681,1817
52435,108339,24494,52120,17946,83844,3498,1681,1817
52440,108346,24496,52124,17948,83850,3498,1681,1817
52445,108359,24498,52128,17949,83859,3499,1682,1817
52450,108370,24502,52132,17952,83866,3499,1682,1817
52455,108377,24505,52134,17954,83872,3499,1682,1817
52460,108390,24507,52140,17955,83880,3500,1682,1818
52465,108401,24511,52145,17959,83889,3500,1682,1818
52470,108408,24512,52149,17960,83895,3500,1682,1818
52475,108421,24514,52154,17962,83906,3501,1682,1819
52480,108432,24514,52159,17962,83917,3501,1682,1819
52485,108439,24515,52159,17962,83924,3501,1682,1819
52490,108452,24517,52166,17964,83935,3502,1682,1820
52495,108463,24518,52174,17965,83943,3502,1682,1820
52500,108470,24522,52176,17967,83948,3502,1682,1820
52505,108483,24524,52186,17969,83958,3503,1683,1820
52510,108494,24528,52193,17973,83965,3503,1683,1820
52515,108501,24531,52194,17975,83970,3503,1683,1820
52520,108514,24532,52202,17976,83981,3504,1684,1820
52525,108525,24534,52206,17978,83991,3504,1684,1820
52530,108532,24537,52208,17979,83994,3504,1684,1820
52535,108545,24539,52211,17980,84005,3505,1685,1820
52540,108556,24541,52214,17982,84014,3505,1685,1820
52545,108563,24545,52219,17986,84018,3505,1685,1820
52550,108576,24546,52226,17987,84029,3506,1686,1820
52555,108587,24546,52234,17987,84041,3506,1686,1820
52560,108594,24547,52237,17988,84047,3506,1686,1820
52565,108607,24548,52241,17989,84058,3507,1687,1820
52570,108618,24548,52249,17989,84070,3507,1687,1820
52575,108625,24549,52251,17989,84076,3507,1687,1820
52580,108638,24551,52258,17990,84085,3508,1688,1820
52585,108649,24553,52264,17991,84096,3508,1688,1820
52590,108656,24555,52269,17992,84100,3508,1688,1820
52595,108669,24559,52275,17995,84108,3509,1689,1820
52600,108680,24563,52279,17998,84117,3509,1689,1820
52605,108687,24564,52282,17998,84123,3509,1689,1820
52610,108700,24567,52292,18001,84129,3510,1689,1821
52615,108711,24573,52296,18006,84137,3510,1689,1821
52620,108718,24575,52300,18007,84143,3510,1689,1821
52625,108731,24577,52306,18008,84151,3511,1689,1822
52630,108742,24581,52314,18012,84161,3511,1689,1822
52635,108749,24582,52317,18013,84167,3511,1689,1822
52640,108762,24583,52323,18013,84178,3512,1690,1822
52645,108773,24583,52330,18013,84190,3512,1690,1822
52650,108780,24585,52335,18015,84195,3512,1690,1822
52655,108793,24587,52342,18017,84206,3513,1690,1823
52660,108804,24588,52346,18018,84216,3513,1690,1823
52665,108811,24591,52350,18020,84220,3513,1690,1823
52670,108824,24593,52359,18022,84230,3514,1691,1823
52675,108835,24595,52365,18024,84240,3514,1691,1823
52680,108842,24598,52370,18025,84244,3514,1691,1823
52685,108855,24600,52376,18026,84255,3515,1692,1823
52690,108866,24601,52382,18027,84265,3515,1692,1823
52695,108873,24604,52386,18029,84269,3515,1692,1823
52700,108886,24607,52393,18031,84278,3516,1692,1824
52705,108897,24610,52397,18034,84286,3516,1692,1824
52710,108904,24613,52398,18035,84291,3516,1692,1824
52715,108917,24616,52407,18038,84299,3517,1693,1824
52720,108928,24617,52412,18039,84310,3517,1693,1824
52725,108935,24620,52414,18041,84315,3517,1693,1824
52730,108948,24623,52420,18042,84322,3518,1693,1825
52735,108959,24625,52426,18044,84331,3518,1693,1825
52740,108966,24630,52428,18048,84336,3518,1693,1825
52745,108979,24633,52433,18049,84344,3519,1693,1826
52750,108990,24634,52438,18050,84356,3519,1693,1826
52755,108997,24635,52440,18050,84362,3519,1693,1826
52760,109010,24638,52447,18053,84370,3520,1694,1826
52765,109021,24641,52448,18056,84380,3520,1694,1826
52770,109028,24642,52453,18057,84386,3520,1694,1826
52775,109041,24644,52461,18058,84393,3521,1695,1826
52780,109052,24647,52465,18060,84405,3521,1695,1826
52785,109059,24648,52465,18060,84411,3521,1695,1826
52790,109072,24650,52472,18060,84418,3522,1696,1826
52795,109083,24653,52477,18062,84429,3522,1696,1826
52800,109090,24654,52480,18062,84436,3522,1696,1826
52805,109103,24656,52487,18063,84445,3523,1697,1826
52810,109114,24658,52493,18064,84455,3523,1697,1826
52815,109121,24659,52497,18064,84462,3523,1697,1826
52820,109134,24662,52502,18066,84470,3524,1697,1827
52825,109145,24665,52508,18069,84480,3524,1697,1827
52830,109152,24666,52511,18070,84486,3524,1697,1827
52835,109165,24669,52520,18072,84494,3525,1698,1827
52840,109176,24672,52526,18074,84504,3525,1698,1827
52845,109183,24675,52529,18076,84508,3525,1698,1827
52850,109196,24678,52537,18078,84517,3526,1699,1827
52855,109207,24682,52544,18082,84524,3526,1699,1827
52860,109214,24685,52545,18083,84529,3526,1699,1827
52865,109227,24688,52553,18084,84537,3527,1700,1827
52870,109238,24691,52559,18087,84547,3527,1700,1827
52875,109245,24693,52562,18087,84552,3527,1700,1827
52880,109258,24695,52567,18089,84562,3528,1701,1827
52885,109269,24696,52571,18090,84573,3528,1701,1827
52890,109276,24699,52575,18091,84577,3528,1701,1827
52895,109289,24701,52579,18092,84588,3529,1701,1828
52900,109300,24702,52586,18093,84598,3529,1701,1828
52905,109307,24704,52587,18094,84603,3529,1701,1828
52910,109320,24707,52593,18095,84611,3530,1702,1828
52915,109331,24708,52595,18096,84623,3530,1702,1828
52920,109338,24711,52597,18097,84627,3530,1702,1828
52925,109351,24713,52600,18097,84636,3531,1702,1829
52930,109362,24715,52606,18099,84644,3531,1702,1829
52935,109369,24719,52607,18101,84649,3531,1702,1829
52940,109382,24722,52616,18104,84658,3532,1702,1830
52945,109393,24726,52621,18108,84666,3532,1702,1830
52950,109400,24729,52625,18111,84670,3532,1702,1830
52955,109413,24732,52629,18113,84680,3533,1702,1831
52960,109424,24733,52636,18114,84691,3533,1702,1831
52965,109431,24734,52639,18114,84696,3533,1702,1831
52970,109444,24737,52645,18117,84706,3534,1702,1832
52975,109455,24739,52648,18118,84716,3534,1702,1832
52980,109462,24740,52651,18118,84722,3534,1702,1832
52985,109475,24744,52657,18122,84730,3535,1703,1832
52990,109486,24748,52660,18125,84738,3535,1703,1832
52995,109493,24750,52661,18126,84743,3535,1703,1832
53000,109506,24754,52670,18130,84751,3536,1704,1832
53005,109517,24757,52677,18132,84760,3536,1704,1832
53010,109524,24758,52680,18133,84766,3536,1704,1832
53015,109537,24761,52689,18135,84774,3537,1704,1833
53020,109548,24764,52691,18137,84784,3537,1704,1833
53025,109555,24765,52694,18138,84790,3537,1704,1833
53030,109568,24768,52702,18140,84799,3538,1704,1834
53035,109579,24770,52711,18142,84809,3538,1704,1834
53040,109586,24771,52714,18143,84815,3538,1704,1834
53045,109599,24774,52725,18146,84822,3539,1705,1834
53050,109610,24776,52729,18148,84834,3539,1705,1834
53055,109617,24777,52730,18148,84840,3539,1705,1834
53060,109630,24779,52736,18149,84850,3540,1705,1835
53065,109641,24780,52740,18150,84860,3540,1705,1835
53070,109648,24783,52746,18153,84865,3540,1705,1835
53075,109661,24785,52755,18155,84874,3541,1705,1836
53080,109672,24787,52759,18157,84885,3541,1705,1836
53085,109679,24789,52763,18158,84890,3541,1705,1836
53090,109692,24791,52768,18158,84899,3542,1706,1836
53095,109703,24794,52775,18161,84908,3542,1706,1836
53100,109710,24797,52777,18163,84912,3542,1706,1836
53105,109723,24801,52781,18166,84922,3543,1706,1837
53110,109734,24802,52787,18167,84931,3543,1706,1837
53115,109741,24807,52791,18172,84934,3543,1706,1837
53120,109754,24810,52796,18173,84942,3544,1707,1837
53125,109765,24813,52803,18176,84952,3544,1707,1837
53130,109772,24814,52810,18177,84958,3544,1707,1837
53135,109785,24816,52819,18179,84968,3545,1708,1837
53140,109796,24816,52826,18179,84980,3545,1708,1837
53145,109803,24817,52831,18179,84986,3545,1708,1837
53150,109816,24819,52840,18180,84996,3546,1709,1837
53155,109827,24820,52848,18180,85006,3546,1709,1837
53160,109834,24822,52850,18181,85012,3546,1709,1837
53165,109847,24825,52858,18184,85019,3547,1709,1838
53170,109858,24828,52863,18187,85029,3547,1709,1838
53175,109865,24830,52870,18189,85035,3547,1709,1838
53180,109878,24834,52877,18191,85041,3548,1709,1839
53185,109889,24837,52881,18193,85051,3548,1709,1839
53190,109896,24839,52883,18194,85057,3548,1709,1839
53195,109909,24842,52885,18195,85067,3549,1710,1839
53200,109920,24844,52890,18196,85074,3549,1710,1839
53205,109927,24848,52895,18199,85079,3549,1710,1839
53210,109940,24851,52901,18201,85087,3550,1710,1840
53215,109951,24855,52906,18204,85095,3550,1710,1840
53220,109958,24856,52906,18204,85102,3550,1710,1840
53225,109971,24858,52915,18205,85111,3551,1711,1840
53230,109982,24859,52922,18206,85123,3551,1711,1840
53235,109989,24862,52926,18208,85127,3551,1711,1840
53240,110002,24864,52936,18210,85136,3552,1711,1841
53245,110013,24866,52943,18212,85144,3552,1711,1841
53250,110020,24872,52948,18217,85147,3552,1711,1841
53255,110033,24875,52955,18219,85156,3553,1712,1841
53260,110044,24878,52959,18222,85164,3553,1712,1841
53265,110051,24883,52961,18226,85168,3553,1712,1841
53270,110064,24886,52967,18229,85177,3554,1712,1842
53275,110075,24888,52970,18231,85187,3554,1712,1842
53280,110082,24891,52972,18233,85191,3554,1712,1842
53285,110095,24893,52981,18233,85201,3555,1713,1842
53290,110106,24893,52985,18233,85213,3555,1713,1842
53295,110113,24894,52991,18234,85219,3555,1713,1842
53300,110126,24896,53002,18236,85229,3556,1713,1843
53305,110137,24896,53007,18236,85241,3556,1713,1843
53310,110144,24897,53011,18237,85247,3556,1713,1843
53315,110157,24899,53015,18237,85258,3557,1714,1843
53320,110168,24899,53021,18237,85269,3557,1714,1843
53325,110175,24900,53026,18238,85275,3557,1714,1843
53330,110188,24903,53033,18240,85284,3558,1714,1844
53335,110199,24905,53038,18242,85294,3558,1714,1844
53340,110206,24906,53039,18242,85300,3558,1714,1844
53345,110219,24910,53047,18245,85309,3559,1715,1844
53350,110230,24912,53054,18247,85317,3559,1715,1844
53355,110237,24915,53058,18250,85322,3559,1715,1844
53360,110250,24918,53068,18253,85329,3560,1716,1844
53365,110261,24921,53073,18256,85339,3560,1716,1844
53370,110268,24923,53077,18258,85345,3560,1716,1844
53375,110281,24925,53080,18259,85354,3561,1716,1845
53380,110292,24928,53086,18262,85364,3561,1716,1845
53385,110299,24930,53091,18264,85369,3561,1716,1845
53390,110312,24933,53100,18267,85378,3562,1716,1846
53395,110323,24936,53106,18270,85386,3562,1716,1846
53400,110330,24940,53110,18273,85390,3562,1716,1846
53405,110343,24943,53119,18276,85398,3563,1716,1847
53410,110354,24947,53125,18280,85406,3563,1716,1847
53415,110361,24952,53129,18283,85409,3563,1716,1847
53420,110374,24954,53136,18285,85417,3564,1717,1847
53425,110385,24962,53144,18292,85420,3564,1717,1847
53430,110392,24967,53148,18297,85424,3564,1717,1847
53435,110405,24971,53153,18300,85432,3565,1717,1848
53440,110416,24974,53160,18303,85442,3565,1717,1848
53445,110423,24975,53164,18304,85448,3565,1717,1848
53450,110436,24977,53173,18305,85458,3566,1718,1848
53455,110447,24977,53178,18305,85470,3566,1718,1848
53460,110454,24978,53181,18306,85476,3566,1718,1848
53465,110467,24980,53190,18307,85484,3567,1719,1848
53470,110478,24980,53195,18307,85497,3567,1719,1848
53475,110485,24981,53198,18307,85504,3567,1719,1848
53480,110498,24983,53204,18309,85514,3568,1719,1849
53485,110509,24983,53209,18309,85525,3568,1719,1849
53490,110516,24984,53213,18309,85531,3568,1719,1849
53495,110529,24986,53218,18310,85541,3569,1719,1850
53500,110540,24986,53221,18310,85554,3569,1719,1850
53505,110547,24987,53222,18310,85560,3569,1719,1850
53510,110560,24989,53226,18310,85569,3570,1719,1851
53515,110571,24989,53230,18310,85582,3570,1719,1851
53520,110578,24990,53234,18310,85588,3570,1719,1851
53525,110591,24992,53241,18311,85597,3571,1720,1851
53530,110602,24992,53244,18311,85610,3571,1720,1851
53535,110609,24993,53248,18312,85616,3571,1720,1851
53540,110622,24995,53253,18312,85625,3572,1721,1851
53545,110633,24996,53257,18313,85637,3572,1721,1851
53550,110640,24998,53259,18315,85642,3572,1721,1851
53555,110653,25000,53266,18316,85650,3573,1722,1851
53560,110664,25003,53269,18318,85661,3573,1722,1851
53565,110671,25006,53273,18321,85665,3573,1722,1851
53570,110684,25009,53280,18322,85673,3574,1723,1851
53575,110695,25012,53285,18324,85683,3574,1723,1851
53580,110702,25015,53291,18326,85687,3574,1723,1851
53585,110715,25017,53298,18327,85697,3575,1724,1851
53590,110726,25020,53304,18330,85706,3575,1724,1851
53595,110733,25022,53306,18331,85711,3575,1724,1851
53600,110746,25025,53311,18332,85720,3576,1724,1852
53605,110757,25028,53315,18335,85727,3576,1724,1852
53610,110764,25032,53317,18338,85731,3576,1724,1852
53615,110777,25037,53326,18343,85738,3577,1725,1852
53620,110788,25042,53332,18347,85743,3577,1725,1852
53625,110795,25047,53334,18350,85747,3577,1725,1852
53630,110808,25053,53343,18355,85753,3578,1725,1853
53635,110819,25057,53348,18358,85761,3578,1725,1853
53640,110826,25062,53354,18363,85764,3578,1725,1853
53645,110839,25064,53359,18364,85773,3579,1725,1854
53650,110850,25066,53364,18365,85783,3579,1725,1854
53655,110857,25068,53368,18367,85788,3579,1725,1854
53660,110870,25074,53373,18371,85796,3580,1726,1854
53665,110881,25075,53378,18371,85805,3580,1726,1854
53670,110888,25078,53383,18374,85809,3580,1726,1854
53675,110901,25081,53391,18376,85819,3581,1727,1854
53680,110912,25081,53399,18376,85831,3581,1727,1854
53685,110919,25082,53401,18376,85837,3581,1727,1854
53690,110932,25084,53406,18378,85848,3582,1727,1855
53695,110943,25084,53407,18378,85859,3582,1727,1855
53700,110950,25085,53412,18378,85864,3582,1727,1855
53705,110963,25087,53421,18380,85876,3583,1728,1855
53710,110974,25087,53428,18380,85887,3583,1728,1855
53715,110981,25088,53433,18381,85893,3583,1728,1855
53720,110994,25090,53440,18382,85903,3584,1728,1856
53725,111005,25090,53445,18382,85914,3584,1728,1856
53730,111012,25091,53448,18382,85921,3584,1728,1856
53735,111025,25093,53455,18383,85931,3585,1728,1857
53740,111036,25093,53459,18383,85943,3585,1728,1857
53745,111043,25094,53461,18383,85949,3585,1728,1857
53750,111056,25096,53467,18385,85960,3586,1728,1858
53755,111067,25096,53473,18385,85971,3586,1728,1858
53760,111074,25098,53474,18386,85976,3586,1728,1858
53765,111087,25100,53478,18387,85987,3587,1729,1858
53770,111098,25100,53483,18387,85998,3587,1729,1858
53775,111105,25102,53487,18388,86003,3587,1729,1858
53780,111118,25104,53492,18390,86014,3588,1729,1859
53785,111129,25105,53494,18390,86024,3588,1729,1859
53790,111136,25107,53496,18391,86029,3588,1729,1859
53795,111149,25110,53501,18392,86037,3589,1729,1860
53800,111160,25112,53510,18394,86048,3589,1729,1860
53805,111167,25114,53515,18395,86053,3589,1729,1860
53810,111180,25118,53523,18398,86059,3590,1730,1860
53815,111191,25124,53530,18404,86066,3590,1730,1860
53820,111198,25128,53535,18408,86070,3590,1730,1860
53825,111211,25130,53540,18409,86079,3591,1731,1860
53830,111222,25134,53545,18413,86087,3591,1731,1860
53835,111229,25138,53551,18417,86090,3591,1731,1860
53840,111242,25143,53557,18421,86098,3592,1732,1860
53845,111253,25146,53561,18423,86105,3592,1732,1860
53850,111260,25151,53564,18427,86108,3592,1732,1860
53855,111273,25156,53569,18431,86116,3593,1733,1860
53860,111284,25160,53576,18435,86122,3593,1733,1860
53865,111291,25164,53578,18438,86127,3593,1733,1860
53870,111304,25167,53583,18440,86135,3594,1733,1861
53875,111315,25171,53591,18444,86143,3594,1733,1861
53880,111322,25173,53592,18445,86149,3594,1733,1861
53885,111335,25176,53598,18447,86157,3595,1733,1862
53890,111346,25178,53603,18448,86167,3595,1733,1862
53895,111353,25180,53606,18450,86173,3595,1733,1862
53900,111366,25184,53613,18453,86180,3596,1734,1862
53905,111377,25189,53620,18458,86187,3596,1734,1862
53910,111384,25190,53622,18458,86194,3596,1734,1862
53915,111397,25192,53629,18460,86204,3597,1735,1862
53920,111408,25192,53634,18460,86215,3597,1735,1862
53925,111415,25193,53636,18460,86222,3597,1735,1862
53930,111428,25195,53640,18460,86232,3598,1735,1863
53935,111439,25195,53645,18460,86244,3598,1735,1863
53940,111446,25196,53647,18460,86250,3598,1735,1863
53945,111459,25198,53655,18462,86261,3599,1735,1864
53950,111470,25198,53657,18462,86272,3599,1735,1864
53955,111477,25199,53661,18462,86278,3599,1735,1864
53960,111490,25201,53668,18462,86288,3600,1735,1865
53965,111501,25201,53673,18462,86299,3600,1735,1865
53970,111508,25202,53678,18463,86306,3600,1735,1865
53975,111521,25204,53682,18464,86316,3601,1735,1866
53980,111532,25204,53682,18464,86328,3601,1735,1866
53985,111539,25207,53688,18467,86332,3601,1735,1866
53990,111552,25209,53693,18469,86342,3602,1735,1867
53995,111563,25210,53699,18470,86351,3602,1735,1867
54000,111570,25213,53701,18472,86356,3602,1735,1867
54005,111583,25217,53709,18476,86364,3603,1735,1868
54010,111594,25218,53714,18477,86374,3603,1735,1868
54015,111601,25223,53719,18481,86377,3603,1735,1868
54020,111614,25227,53725,18484,86386,3604,1735,1869
54025,111625,25230,53729,18487,86395,3604,1735,1869
54030,111632,25233,53735,18490,86398,3604,1735,1869
54035,111645,25236,53739,18493,86407,3605,1735,1870
54040,111656,25240,53744,18497,86415,3605,1735,1870
54045,111663,25244,53748,18501,86418,3605,1735,1870
54050,111676,25248,53758,18505,86425,3606,1735,1871
54055,111687,25250,53766,18507,86437,3606,1735,1871
54060,111694,25251,53770,18507,86443,3606,1735,1871
54065,111707,25253,53776,18508,86453,3607,1735,1872
54070,111718,25255,53782,18510,86462,3607,1735,1872
54075,111725,25257,53786,18511,86468,3607,1735,1872
54080,111738,25261,53792,18514,86475,3608,1735,1873
54085,111749,25263,53795,18515,86486,3608,1735,1873
54090,111756,25264,53800,18516,86492,3608,1735,1873
54095,111769,25268,53807,18519,86500,3609,1736,1873
54100,111780,25269,53813,18520,86510,3609,1736,1873
54105,111787,25271,53816,18521,86516,3609,1736,1873
54110,111800,25275,53823,18524,86525,3610,1737,1873
54115,111811,25277,53830,18526,86534,3610,1737,1873
54120,111818,25278,53833,18527,86540,3610,1737,1873
54125,111831,25281,53839,18530,86549,3611,1738,1873
54130,111842,25284,53847,18533,86557,3611,1738,1873
54135,111849,25286,53849,18534,86562,3611,1738,1873
54140,111862,25290,53857,18536,86568,3612,1738,1874
54145,111873,25294,53862,18539,86578,3612,1738,1874
54150,111880,25295,53866,18540,86585,3612,1738,1874
54155,111893,25297,53872,18540,86595,3613,1738,1875
54160,111904,25297,53876,18540,86607,3613,1738,1875
54165,111911,25299,53877,18540,86612,3613,1738,1875
54170,111924,25301,53881,18540,86622,3614,1739,1875
54175,111935,25304,53886,18543,86629,3614,1739,1875
54180,111942,25310,53890,18548,86631,3614,1739,1875
54185,111955,25313,53896,18550,86640,3615,1739,1876
54190,111966,25314,53900,18551,86651,3615,1739,1876
54195,111973,25318,53903,18554,86655,3615,1739,1876
54200,111986,25320,53909,18556,86664,3616,1739,1877
54205,111997,25322,53915,18558,86675,3616,1739,1877
54210,112004,25326,53921,18562,86678,3616,1739,1877
54215,112017,25329,53930,18564,86686,3617,1740,1877
54220,112028,25332,53935,18567,86696,3617,1740,1877
54225,112035,25335,53936,18568,86700,3617,1740,1877
54230,112048,25337,53941,18569,86711,3618,1741,1877
54235,112059,25337,53948,18569,86722,3618,1741,1877
54240,112066,25338,53952,18570,86728,3618,1741,1877
54245,112079,25340,53956,18571,86739,3619,1741,1878
54250,112090,25340,53961,18571,86750,3619,1741,1878
54255,112097,25341,53964,18572,86756,3619,1741,1878
54260,112110,25344,53972,18575,86764,3620,1741,1879
54265,112121,25347,53979,18577,86774,3620,1741,1879
54270,112128,25348,53981,18577,86780,3620,1741,1879
54275,112141,25350,53984,18579,86791,3621,1742,1879
54280,112152,25351,53987,18579,86801,3621,1742,1879
54285,112159,25352,53991,18580,86807,3621,1742,1879
54290,112172,25354,53995,18581,86817,3622,1742,1880
54295,112183,25356,54002,18583,86826,3622,1742,1880
54300,112190,25359,54007,18586,86830,3622,1742,1880
54305,112203,25364,54011,18589,86838,3623,1743,1880
54310,112214,25367,54019,18592,86846,3623,1743,1880
54315,112221,25370,54022,18594,86851,3623,1743,1880
54320,112234,25374,54029,18596,86858,3624,1743,1881
54325,112245,25376,54037,18598,86868,3624,1743,1881
54330,112252,25378,54039,18599,86874,3624,1743,1881
54335,112265,25381,54044,18601,86884,3625,1744,1881
54340,112276,25384,54049,18603,86892,3625,1744,1881
54345,112283,25387,54052,18605,86896,3625,1744,1881
54350,112296,25389,54060,18607,86905,3626,1745,1881
54355,112307,25393,54062,18610,86914,3626,1745,1881
54360,112314,25396,54068,18612,86918,3626,1745,1881
54365,112327,25399,54076,18614,86927,3627,1745,1882
54370,112338,25400,54080,18615,86938,3627,1745,1882
54375,112345,25402,54082,18615,86943,3627,1745,1882
54380,112358,25404,54090,18615,86953,3628,1746,1882
54385,112369,25406,54094,18617,86963,3628,1746,1882
54390,112376,25408,54096,18618,86968,3628,1746,1882
54395,112389,25410,54099,18618,86979,3629,1746,1883
54400,112400,25411,54105,18619,86989,3629,1746,1883
54405,112407,25413,54109,18620,86994,3629,1746,1883
54410,112420,25415,54115,18622,87004,3630,1747,1883
54415,112431,25416,54122,18623,87015,3630,1747,1883
54420,112438,25418,54126,18625,87019,3630,1747,1883
54425,112451,25421,54133,18627,87028,3631,1748,1883
54430,112462,25424,54139,18630,87036,3631,1748,1883
54435,112469,25428,54142,18634,87041,3631,1748,1883
54440,112482,25430,54149,18634,87050,3632,1749,1883
54445,112493,25433,54155,18637,87058,3632,1749,1883
54450,112500,25438,54157,18640,87061,3632,1749,1883
54455,112513,25440,54162,18641,87071,3633,1750,1883
54460,112524,25441,54167,18642,87082,3633,1750,1883
54465,112531,25442,54168,18643,87089,3633,1750,1883
54470,112544,25445,54172,18644,87096,3634,1750,1884
54475,112555,25448,54179,18647,87106,3634,1750,1884
54480,112562,25449,54184,18648,87113,3634,1750,1884
54485,112575,25451,54190,18649,87121,3635,1750,1885
54490,112586,25452,54194,18649,87134,3635,1750,1885
54495,112593,25453,54197,18650,87140,3635,1750,1885
54500,112606,25456,54205,18652,87146,3636,1751,1885
54505,112617,25459,54211,18654,87158,3636,1751,1885
54510,112624,25460,54214,18654,87164,3636,1751,1885
54515,112637,25462,54219,18654,87174,3637,1751,1886
54520,112648,25464,54225,18656,87184,3637,1751,1886
54525,112655,25465,54228,18656,87190,3637,1751,1886
54530,112668,25467,54233,18657,87200,3638,1752,1886
54535,112679,25469,54239,18659,87210,3638,1752,1886
54540,112686,25470,54242,18659,87216,3638,1752,1886
54545,112699,25473,54250,18662,87225,3639,1752,1887
54550,112710,25475,54254,18663,87235,3639,1752,1887
54555,112717,25476,54259,18664,87241,3639,1752,1887
54560,112730,25478,54267,18665,87249,3640,1752,1888
54565,112741,25483,54273,18669,87258,3640,1752,1888
54570,112748,25486,54276,18671,87262,3640,1752,1888
54575,112761,25489,54282,18673,87269,3641,1752,1889
54580,112772,25495,54286,18678,87277,3641,1752,1889
54585,112779,25498,54290,18681,87281,3641,1752,1889
54590,112792,25500,54295,18682,87291,3642,1753,1889
54595,112803,25502,54299,18684,87301,3642,1753,1889
54600,112810,25505,54303,18686,87305,3642,1753,1889
54605,112823,25507,54306,18687,87313,3643,1754,1889
54610,112834,25511,54313,18689,87321,3643,1754,1889
54615,112841,25517,54315,18692,87323,3643,1754,1889
54620,112854,25522,54322,18695,87328,3644,1755,1889
54625,112865,25528,54326,18698,87334,3644,1755,1889
54630,112872,25534,54329,18701,87336,3644,1755,1889
54635,112885,25540,54336,18707,87341,3645,1755,1890
54640,112896,25546,54340,18712,87349,3645,1755,1890
54645,112903,25550,54342,18715,87352,3645,1755,1890
54650,112916,25553,54347,18718,87360,3646,1756,1890
54655,112927,25556,54351,18719,87368,3646,1756,1890
54660,112934,25562,54355,18725,87371,3646,1756,1890
54665,112947,25565,54359,18726,87378,3647,1757,1890
54670,112958,25569,54361,18729,87387,3647,1757,1890
54675,112965,25575,54367,18735,87388,3647,1757,1890
54680,112978,25580,54374,18738,87391,3648,1757,1891
54685,112989,25588,54381,18745,87399,3648,1757,1891
54690,112996,25591,54386,18748,87404,3648,1757,1891
54695,113009,25595,54394,18751,87411,3649,1758,1891
54700,113020,25598,54398,18753,87420,3649,1758,1891
54705,113027,25601,54402,18756,87425,3649,1758,1891
54710,113040,25603,54407,18757,87434,3650,1758,1892
54715,113051,25606,54411,18760,87443,3650,1758,1892
54720,113058,25610,54414,18763,87447,3650,1758,1892
54725,113071,25613,54420,18764,87455,3651,1759,1892
54730,113082,25617,54426,18767,87463,3651,1759,1892
54735,113089,25619,54429,18768,87469,3651,1759,1892
54740,113102,25622,54435,18769,87478,3652,1760,1892
54745,113113,25624,54440,18771,87487,3652,1760,1892
54750,113120,25628,54445,18775,87491,3652,1760,1892
54755,113133,25631,54447,18776,87501,3653,1760,1893
54760,113144,25632,54451,18776,87511,3653,1760,1893
54765,113151,25635,54455,18778,87515,3653,1760,1893
54770,113164,25639,54465,18781,87520,3654,1761,1893
54775,113175,25644,54468,18785,87530,3654,1761,1893
54780,113182,25645,54471,18785,87536,3654,1761,1893
54785,113195,25648,54476,18786,87543,3655,1762,1893
54790,113206,25653,54479,18790,87551,3655,1762,1893
54795,113213,25657,54483,18793,87555,3655,1762,1893
54800,113226,25660,54488,18796,87564,3656,1763,1893
54805,113237,25663,54494,18798,87570,3656,1763,1893
54810,113244,25671,54498,18806,87572,3656,1763,1893
54815,113257,25674,54504,18808,87580,3657,1764,1893
54820,113268,25680,54511,18813,87583,3657,1764,1893
54825,113275,25687,54515,18820,87586,3657,1764,1893
54830,113288,25692,54524,18825,87590,3658,1765,1893
54835,113299,25700,54532,18833,87595,3658,1765,1893
54840,113306,25706,54536,18838,87598,3658,1765,1893
54845,113319,25709,54540,18839,87608,3659,1766,1893
54850,113330,25711,54546,18840,87619,3659,1766,1893
54855,113337,25712,54550,18841,87624,3659,1766,1893
54860,113350,25714,54558,18843,87634,3660,1766,1894
54865,113361,25716,54563,18844,87645,3660,1766,1894
54870,113368,25716,54565,18844,87651,3660,1766,1894
54875,113381,25717,54570,18844,87663,3661,1767,1894
54880,113392,25718,54577,18844,87673,3661,1767,1894
54885,113399,25718,54582,18844,87680,3661,1767,1894
54890,113412,25719,54588,18844,87691,3662,1768,1894
54895,113423,25720,54595,18845,87703,3662,1768,1894
54900,113430,25720,54599,18845,87709,3662,1768,1894
54905,113443,25721,54605,18845,87720,3663,1768,1895
54910,113454,25722,54609,18845,87731,3663,1768,1895
54915,113461,25722,54613,18845,87738,3663,1768,1895
54920,113474,25723,54619,18845,87749,3664,1769,1895
54925,113485,25724,54624,18845,87760,3664,1769,1895
54930,113492,25724,54627,18845,87767,3664,1769,1895
54935,113505,25725,54631,18845,87779,3665,1769,1896
54940,113516,25727,54635,18846,87788,3665,1769,1896
54945,113523,25729,54638,18847,87793,3665,1769,1896
54950,113536,25731,54646,18848,87800,3666,1769,1897
54955,113547,25738,54653,18855,87806,3666,1769,1897
54960,113554,25744,54657,18860,87810,3666,1769,1897
54965,113567,25746,54659,18861,87819,3667,1769,1898
54970,113578,25750,54666,18864,87825,3667,1769,1898
54975,113585,25755,54667,18867,87830,3667,1769,1898
54980,113598,25758,54673,18868,87835,3668,1770,1898
54985,113609,25766,54681,18876,87841,3668,1770,1898
54990,113616,25771,54684,18880,87844,3668,1770,1898
54995,113629,25777,54692,18886,87848,3669,1770,1899
55000,113640,25782,54695,18890,87857,3669,1770,1899
55005,113647,25786,54699,18893,87861,3669,1770,1899
55010,113660,25788,54703,18893,87869,3670,1771,1899
55015,113671,25789,54706,18894,87882,3670,1771,1899
55020,113678,25789,54711,18894,87889,3670,1771,1899
55025,113691,25791,54719,18895,87896,3671,1771,1900
55030,113702,25793,54725,18896,87908,3671,1771,1900
55035,113709,25795,54731,18898,87913,3671,1771,1900
55040,113722,25798,54737,18899,87923,3672,1771,1901
55045,113733,25799,54741,18899,87934,3672,1771,1901
55050,113740,25800,54745,18900,87940,3672,1771,1901
55055,113753,25802,54749,18901,87949,3673,1771,1902
55060,113764,25804,54754,18903,87958,3673,1771,1902
55065,113771,25807,54758,18906,87964,3673,1771,1902
55070,113784,25809,54764,18907,87973,3674,1772,1902
55075,113795,25811,54772,18908,87982,3674,1772,1902
55080,113802,25813,54774,18910,87988,3674,1772,1902
55085,113815,25815,54778,18912,87999,3675,1772,1903
55090,113826,25816,54783,18912,88009,3675,1772,1903
55095,113833,25818,54787,18914,88014,3675,1772,1903
55100,113846,25820,54790,18916,88025,3676,1772,1904
55105,113857,25821,54797,18917,88035,3676,1772,1904
55110,113864,25823,54800,18918,88041,3676,1772,1904
55115,113877,25824,54805,18918,88051,3677,1773,1904
55120,113888,25827,54811,18921,88059,3677,1773,1904
55125,113895,25831,54816,18924,88064,3677,1773,1904
55130,113908,25833,54822,18926,88072,3678,1773,1905
55135,113919,25839,54828,18932,88078,3678,1773,1905
55140,113926,25843,54832,18936,88082,3678,1773,1905
55145,113939,25845,54839,18938,88091,3679,1774,1905
55150,113950,25850,54844,18942,88099,3679,1774,1905
55155,113957,25854,54849,18946,88102,3679,1774,1905
55160,113970,25857,54854,18949,88111,3680,1774,1906
55165,113981,25861,54859,18952,88118,3680,1774,1906
55170,113988,25866,54861,18955,88122,3680,1774,1906
55175,114001,25867,54867,18956,88129,3681,1774,1907
55180,114012,25874,54872,18963,88137,3681,1774,1907
55185,114019,25876,54873,18964,88143,3681,1774,1907
55190,114032,25879,54878,18967,88152,3682,1774,1908
55195,114043,25881,54884,18968,88161,3682,1774,1908
55200,114050,25883,54890,18970,88166,3682,1774,1908
55205,114063,25885,54897,18971,88177,3683,1775,1908
55210,114074,25886,54902,18972,88188,3683,1775,1908
55215,114081,25886,54904,18972,88195,3683,1775,1908
55220,114094,25888,54907,18973,88205,3684,1775,1909
55225,114105,25889,54910,18973,88216,3684,1775,1909
55230,114112,25889,54915,18973,88223,3684,1775,1909
55235,114125,25890,54919,18974,88234,3685,1775,1910
55240,114136,25891,54924,18974,88245,3685,1775,1910
55245,114143,25891,54928,18974,88252,3685,1775,1910
55250,114156,25893,54933,18975,88261,3686,1776,1910
55255,114167,25894,54938,18976,88272,3686,1776,1910
55260,114174,25895,54939,18977,88279,3686,1776,1910
55265,114187,25897,54945,18979,88289,3687,1776,1911
55270,114198,25898,54950,18980,88299,3687,1776,1911
55275,114205,25900,54954,18982,88305,3687,1776,1911
55280,114218,25901,54957,18983,88315,3688,1776,1912
55285,114229,25903,54964,18984,88325,3688,1776,1912
55290,114236,25907,54969,18988,88329,3688,1776,1912
55295,114249,25909,54974,18989,88337,3689,1776,1913
55300,114260,25914,54979,18994,88344,3689,1776,1913
55305,114267,25920,54984,19000,88346,3689,1776,1913
55310,114280,25924,54992,19004,88351,3690,1776,1914
55315,114291,25931,54995,19010,88358,3690,1776,1914
55320,114298,25936,54998,19014,88361,3690,1776,1914
55325,114311,25938,55002,19015,88370,3691,1777,1914
55330,114322,25940,55008,19017,88379,3691,1777,1914
55335,114329,25947,55013,19023,88380,3691,1777,1914
55340,114342,25951,55016,19026,88390,3692,1778,1914
55345,114353,25952,55019,19026,88400,3692,1778,1914
55350,114360,25956,55021,19029,88404,3692,1778,1914
55355,114373,25960,55030,19033,88412,3693,1778,1915
55360,114384,25963,55036,19035,88420,3693,1778,1915
55365,114391,25965,55038,19037,88426,3693,1778,1915
55370,114404,25967,55045,19039,88437,3694,1779,1915
55375,114415,25968,55053,19039,88445,3694,1779,1915
55380,114422,25971,55057,19042,88450,3694,1779,1915
55385,114435,25974,55064,19044,88460,3695,1779,1916
55390,114446,25976,55070,19045,88469,3695,1779,1916
55395,114453,25977,55072,19046,88476,3695,1779,1916
55400,114466,25978,55081,19047,88488,3696,1780,1916
55405,114477,25979,55085,19047,88498,3696,1780,1916
55410,114484,25980,55088,19047,88503,3696,1780,1916
55415,114497,25981,55094,19048,88516,3697,1781,1916
55420,114508,25982,55100,19049,88526,3697,1781,1916
55425,114515,25983,55102,19049,88532,3697,1781,1916
55430,114528,25984,55111,19049,88542,3698,1781,1917
55435,114539,25986,55115,19050,88553,3698,1781,1917
55440,114546,25987,55118,19051,88559,3698,1781,1917
55445,114559,25988,55120,19051,88571,3699,1781,1918
55450,114570,25989,55127,19051,88581,3699,1781,1918
55455,114577,25990,55130,19052,88587,3699,1781,1918
55460,114590,25991,55138,19053,88598,3700,1782,1918
55465,114601,25993,55145,19054,88608,3700,1782,1918
55470,114608,25995,55149,19055,88613,3700,1782,1918
55475,114621,25996,55153,19055,88624,3701,1783,1918
55480,114632,25998,55161,19057,88634,3701,1783,1918
55485,114639,26001,55164,19058,88638,3701,1783,1918
55490,114652,26003,55169,19059,88647,3702,1784,1918
55495,114663,26009,55176,19064,88652,3702,1784,1918
55500,114670,26014,55179,19068,88655,3702,1784,1918
55505,114683,26018,55187,19072,88662,3703,1785,1918
55510,114694,26023,55191,19076,88669,3703,1785,1918
55515,114701,26028,55196,19081,88672,3703,1785,1918
55520,114714,26029,55201,19081,88682,3704,1786,1918
55525,114725,26034,55204,19086,88691,3704,1786,1918
55530,114732,26037,55208,19088,88695,3704,1786,1918
55535,114745,26040,55215,19090,88703,3705,1786,1919
55540,114756,26042,55221,19091,88713,3705,1786,1919
55545,114763,26044,55225,19092,88719,3705,1786,1919
55550,114776,26047,55232,19094,88727,3706,1787,1919
55555,114787,26049,55237,19095,88736,3706,1787,1919
55560,114794,26052,55241,19098,88742,3706,1787,1919
55565,114807,26055,55250,19101,88749,3707,1787,1920
55570,114818,26059,55254,19104,88758,3707,1787,1920
55575,114825,26061,55257,19106,88763,3707,1787,1920
55580,114838,26064,55262,19108,88771,3708,1787,1921
55585,114849,26068,55269,19111,88779,3708,1787,1921
55590,114856,26071,55270,19113,88785,3708,1787,1921
55595,114869,26074,55277,19115,88792,3709,1787,1922
55600,114880,26076,55282,19116,88803,3709,1787,1922
55605,114887,26078,55285,19118,88809,3709,1787,1922
55610,114900,26080,55292,19120,88819,3710,1787,1923
55615,114911,26081,55296,19121,88830,3710,1787,1923
55620,114918,26081,55299,19121,88836,3710,1787,1923
55625,114931,26083,55309,19123,88845,3711,1788,1923
55630,114942,26085,55316,19125,88856,3711,1788,1923
55635,114949,26087,55318,19127,88862,3711,1788,1923
55640,114962,26089,55326,19128,88871,3712,1788,1924
55645,114973,26092,55330,19130,88880,3712,1788,1924
55650,114980,26094,55332,19131,88885,3712,1788,1924
55655,114993,26096,55337,19132,88896,3713,1788,1925
55660,115004,26098,55341,19134,88905,3713,1788,1925
55665,115011,26101,55344,19136,88909,3713,1788,1925
55670,115024,26104,55352,19138,88918,3714,1788,1926
55675,115035,26108,55359,19141,88924,3714,1788,1926
55680,115042,26114,55362,19146,88927,3714,1788,1926
55685,115055,26116,55367,19147,88939,3715,1789,1926
55690,115066,26118,55371,19149,88947,3715,1789,1926
55695,115073,26122,55375,19153,88950,3715,1789,1926
55700,115086,26124,55380,19155,88961,3716,1789,1927
55705,115097,26127,55385,19157,88969,3716,1789,1927
55710,115104,26133,55389,19161,88971,3716,1789,1927
55715,115117,26135,55394,19163,88981,3717,1789,1928
55720,115128,26136,55401,19164,88992,3717,1789,1928
55725,115135,26137,55403,19164,88998,3717,1789,1928
55730,115148,26140,55410,19167,89006,3718,1790,1928
55735,115159,26143,55414,19169,89016,3718,1790,1928
55740,115166,26144,55417,19170,89022,3718,1790,1928
55745,115179,26146,55427,19172,89027,3719,1791,1928
55750,115190,26152,55432,19177,89038,3719,1791,1928
55755,115197,26153,55433,19177,89044,3719,1791,1928
55760,115210,26155,55444,19179,89051,3720,1791,1929
55765,115221,26158,55448,19182,89063,3720,1791,1929
55770,115228,26159,55453,19183,89069,3720,1791,1929
55775,115241,26160,55459,19184,89078,3721,1791,1930
55780,115252,26163,55464,19187,89089,3721,1791,1930
55785,115259,26164,55465,19187,89095,3721,1791,1930
55790,115272,26166,55473,19189,89106,3722,1792,1930
55795,115283,26167,55474,19189,89116,3722,1792,1930
55800,115290,26168,55478,19190,89122,3722,1792,1930
55805,115303,26169,55486,19191,89131,3723,1792,1931
55810,115314,26172,55489,19193,89141,3723,1792,1931
55815,115321,26173,55491,19194,89147,3723,1792,1931
55820,115334,26173,55498,19194,89160,3724,1792,1932
55825,115345,26175,55502,19195,89169,3724,1792,1932
55830,115352,26176,55506,19195,89175,3724,1792,1932
55835,115365,26176,55511,19195,89189,3725,1792,1933
55840,115376,26178,55514,19197,89198,3725,1792,1933
55845,115383,26179,55517,19197,89203,3725,1792,1933
55850,115396,26179,55525,19197,89217,3726,1792,1934
55855,115407,26181,55529,19198,89226,3726,1792,1934
55860,115414,26183,55532,19199,89230,3726,1792,1934
55865,115427,26184,55537,19199,89242,3727,1793,1934
55870,115438,26187,55544,19202,89250,3727,1793,1934
55875,115445,26190,55549,19205,89253,3727,1793,1934
55880,115458,26192,55555,19206,89263,3728,1793,1935
55885,115469,26197,55559,19211,89272,3728,1793,1935
55890,115476,26198,55563,19212,89277,3728,1793,1935
55895,115489,26201,55570,19214,89288,3729,1794,1935
55900,115500,26202,55575,19215,89295,3729,1794,1935
55905,115507,26206,55579,19219,89300,3729,1794,1935
55910,115520,26208,55587,19220,89310,3730,1795,1935
55915,115531,26211,55592,19223,89319,3730,1795,1935
55920,115538,26212,55596,19223,89326,3730,1795,1935
55925,115551,26213,55600,19223,89337,3731,1796,1935
55930,115562,26214,55603,19224,89348,3731,1796,1935
55935,115569,26215,55606,19224,89354,3731,1796,1935
55940,115582,26217,55614,19225,89364,3732,1797,1935
55945,115593,26218,55620,19225,89375,3732,1797,1935
55950,115600,26219,55623,19225,89381,3732,1797,1935
55955,115613,26222,55629,19227,89391,3733,1797,1936
55960,115624,26223,55634,19228,89401,3733,1797,1936
55965,115631,26224,55639,19229,89406,3733,1797,1936
55970,115644,26227,55646,19231,89416,3734,1798,1936
55975,115655,26228,55652,19232,89427,3734,1798,1936
55980,115662,26229,55656,19232,89432,3734,1798,1936
55985,115675,26231,55664,19234,89442,3735,1798,1937
55990,115686,26233,55668,19235,89453,3735,1798,1937
55995,115693,26234,55672,19235,89458,3735,1798,1937
56000,115706,26237,55679,19238,89468,3736,1798,1938
56005,115717,26240,55682,19240,89477,3736,1798,1938
56010,115724,26241,55685,19240,89483,3736,1798,1938
56015,115737,26243,55691,19242,89493,3737,1798,1939
56020,115748,26246,55695,19244,89502,3737,1798,1939
56025,115755,26249,55699,19247,89506,3737,1798,1939
56030,115768,26252,55706,19250,89513,3738,1798,1940
56035,115779,26257,55711,19255,89521,3738,1798,1940
56040,115786,26260,55713,19258,89526,3738,1798,1940
56045,115799,26263,55718,19261,89534,3739,1798,1941
56050,115810,26267,55722,19265,89541,3739,1798,1941
56055,115817,26273,55726,19269,89542,3739,1798,1941
56060,115830,26279,55734,19274,89547,3740,1799,1941
56065,115841,26287,55741,19281,89550,3740,1799,1941
56070,115848,26293,55744,19287,89554,3740,1799,1941
56075,115861,26297,55750,19290,89563,3741,1800,1941
56080,115872,26300,55755,19293,89571,3741,1800,1941
56085,115879,26301,55758,19294,89577,3741,1800,1941
56090,115892,26304,55763,19297,89586,3742,1800,1942
56095,115903,26306,55771,19299,89595,3742,1800,1942
56100,115910,26309,55775,19302,89601,3742,1800,1942
56105,115923,26311,55781,19304,89611,3743,1801,1942
56110,115934,26313,55786,19306,89621,3743,1801,1942
56115,115941,26313,55789,19306,89628,3743,1801,1942
56120,115954,26314,55796,19306,89638,3744,1802,1942
56125,115965,26315,55803,19306,89650,3744,1802,1942
56130,115972,26315,55808,19306,89657,3744,1802,1942
56135,115985,26317,55814,19308,89667,3745,1802,1943
56140,115996,26319,55823,19310,89677,3745,1802,1943
56145,116003,26319,55824,19310,89684,3745,1802,1943
56150,116016,26321,55831,19312,89694,3746,1802,1944
56155,116027,26323,55834,19313,89704,3746,1802,1944
56160,116034,26323,55836,19313,89711,3746,1802,1944
56165,116047,26324,55841,19313,89723,3747,1803,1944
56170,116058,26325,55849,19314,89733,3747,1803,1944
56175,116065,26326,55854,19315,89739,3747,1803,1944
56180,116078,26328,55864,19317,89748,3748,1803,1945
56185,116089,26331,55869,19319,89758,3748,1803,1945
56190,116096,26334,55874,19321,89762,3748,1803,1945
56195,116109,26335,55882,19322,89772,3749,1804,1945
56200,116120,26337,55886,19324,89783,3749,1804,1945
56205,116127,26340,55890,19326,89786,3749,1804,1945
56210,116140,26343,55899,19329,89793,3750,1805,1945
56215,116151,26349,55903,19334,89799,3750,1805,1945
56220,116158,26355,55906,19339,89802,3750,1805,1945
56225,116171,26358,55911,19341,89811,3751,1806,1945
56230,116182,26361,55917,19343,89818,3751,1806,1945
56235,116189,26368,55921,19349,89820,3751,1806,1945
56240,116202,26371,55927,19351,89829,3752,1806,1946
56245,116213,26374,55933,19353,89837,3752,1806,1946
56250,116220,26378,55938,19356,89841,3752,1806,1946
56255,116233,26378,55946,19356,89855,3753,1807,1946
56260,116244,26379,55951,19357,89865,3753,1807,1946
56265,116251,26380,55955,19357,89871,3753,1807,1946
56270,116264,26380,55963,19357,89883,3754,1807,1947
56275,116275,26381,55969,19358,89894,3754,1807,1947
56280,116282,26382,55970,19358,89900,3754,1807,1947
56285,116295,26382,55975,19358,89912,3755,1807,1948
56290,116306,26384,55983,19360,89921,3755,1807,1948
56295,116313,26385,55987,19361,89928,3755,1807,1948
56300,116326,26386,55993,19362,89940,3756,1808,1948
56305,116337,26387,55999,19362,89949,3756,1808,1948
56310,116344,26388,56002,19362,89956,3756,1808,1948
56315,116357,26389,56006,19363,89967,3757,1808,1949
56320,116368,26391,56011,19364,89977,3757,1808,1949
56325,116375,26392,56016,19365,89983,3757,1808,1949
56330,116388,26392,56020,19365,89995,3758,1808,1950
56335,116399,26394,56027,19367,90004,3758,1808,1950
56340,116406,26395,56032,19368,90010,3758,1808,1950
56345,116419,26395,56037,19368,90023,3759,1808,1951
56350,116430,26398,56044,19370,90032,3759,1808,1951
56355,116437,26401,56046,19372,90036,3759,1808,1951
56360,116450,26403,56052,19374,90046,3760,1809,1951
56365,116461,26405,56060,19376,90056,3760,1809,1951
56370,116468,26407,56064,19377,90060,3760,1809,1951
56375,116481,26409,56068,19379,90071,3761,1809,1952
56380,116492,26412,56073,19381,90080,3761,1809,1952
56385,116499,26414,56075,19382,90085,3761,1809,1952
56390,116512,26416,56083,19384,90094,3762,1809,1953
56395,116523,26420,56089,19388,90103,3762,1809,1953
56400,116530,26422,56091,19388,90107,3762,1809,1953
56405,116543,26424,56098,19390,90117,3763,1809,1954
56410,116554,26428,56104,19394,90126,3763,1809,1954
56415,116561,26431,56107,19396,90130,3763,1809,1954
56420,116574,26434,56114,19398,90138,3764,1809,1955
56425,116585,26439,56117,19402,90146,3764,1809,1955
56430,116592,26442,56120,19404,90150,3764,1809,1955
56435,116605,26446,56126,19407,90157,3765,1809,1956
56440,116616,26451,56131,19412,90163,3765,1809,1956
56445,116623,26456,56134,19415,90166,3765,1809,1956
56450,116636,26460,56141,19418,90173,3766,1810,1956
56455,116647,26464,56145,19421,90181,3766,1810,1956
56460,116654,26469,56149,19425,90185,3766,1810,1956
56465,116667,26472,56156,19428,90192,3767,1811,1956
56470,116678,26474,56159,19429,90204,3767,1811,1956
56475,116685,26475,56163,19430,90210,3767,1811,1956
56480,116698,26478,56170,19433,90219,3768,1812,1956
56485,116709,26480,56175,19435,90229,3768,1812,1956
56490,116716,26480,56176,19435,90236,3768,1812,1956
56495,116729,26481,56180,19436,90247,3769,1812,1957
56500,116740,26482,56185,19436,90258,3769,1812,1957
56505,116747,26482,56186,19436,90265,3769,1812,1957
56510,116760,26483,56194,19437,90274,3770,1812,1958
56515,116771,26485,56199,19439,90286,3770,1812,1958
56520,116778,26485,56201,19439,90292,3770,1812,1958
56525,116791,26487,56207,19440,90303,3771,1813,1958
56530,116802,26488,56212,19440,90314,3771,1813,1958
56535,116809,26489,56215,19441,90320,3771,1813,1958
56540,116822,26490,56222,19441,90331,3772,1813,1959
56545,116833,26491,56226,19441,90341,3772,1813,1959
56550,116840,26493,56229,19443,90347,3772,1813,1959
56555,116853,26495,56234,19444,90356,3773,1814,1959
56560,116864,26496,56238,19445,90368,3773,1814,1959
56565,116871,26496,56242,19445,90375,3773,1814,1959
56570,116884,26497,56247,19445,90386,3774,1814,1960
56575,116895,26500,56250,19447,90395,3774,1814,1960
56580,116902,26503,56256,19450,90398,3774,1814,1960
56585,116915,26506,56264,19452,90407,3775,1814,1961
56590,116926,26509,56267,19454,90416,3775,1814,1961
56595,116933,26514,56271,19457,90418,3775,1814,1961
56600,116946,26517,56278,19460,90427,3776,1814,1962
56605,116957,26521,56282,19464,90435,3776,1814,1962
56610,116964,26524,56283,19465,90440,3776,1814,1962
56615,116977,26525,56290,19465,90449,3777,1814,1963
56620,116988,26530,56294,19469,90458,3777,1814,1963
56625,116995,26532,56296,19470,90462,3777,1814,1963
56630,117008,26535,56304,19472,90470,3778,1815,1963
56635,117019,26538,56308,19474,90479,3778,1815,1963
56640,117026,26543,56311,19477,90481,3778,1815,1963
56645,117039,26548,56317,19482,90490,3779,1815,1964
56650,117050,26551,56322,19484,90497,3779,1815,1964
56655,117057,26558,56328,19491,90498,3779,1815,1964
56660,117070,26560,56331,19492,90509,3780,1815,1965
56665,117081,26563,56339,19495,90514,3780,1815,1965
56670,117088,26570,56341,19500,90517,3780,1815,1965
56675,117101,26572,56347,19502,90527,3781,1815,1966
56680,117112,26575,56353,19504,90536,3781,1815,1966
56685,117119,26579,56357,19506,90539,3781,1815,1966
56690,117132,26579,56363,19506,90551,3782,1816,1966
56695,117143,26581,56369,19508,90560,3782,1816,1966
56700,117150,26583,56372,19509,90566,3782,1816,1966
56705,117163,26585,56380,19511,90575,3783,1816,1967
56710,117174,26587,56386,19512,90586,3783,1816,1967
56715,117181,26589,56390,19513,90592,3783,1816,1967
56720,117194,26589,56397,19513,90602,3784,1816,1968
56725,117205,26593,56405,19517,90611,3784,1816,1968
56730,117212,26595,56407,19518,90617,3784,1816,1968
56735,117225,26597,56413,19520,90625,3785,1816,1969
56740,117236,26600,56418,19522,90635,3785,1816,1969
56745,117243,26602,56421,19524,90641,3785,1816,1969
56750,117256,26603,56425,19525,90651,3786,1816,1970
56755,117267,26607,56430,19529,90660,3786,1816,1970
56760,117274,26608,56434,19529,90666,3786,1816,1970
56765,117287,26608,56442,19529,90678,3787,1816,1971
56770,117298,26609,56448,19529,90689,3787,1816,1971
56775,117305,26609,56452,19529,90696,3787,1816,1971
56780,117318,26609,56455,19529,90708,3788,1816,1972
56785,117329,26610,56460,19529,90719,3788,1816,1972
56790,117336,26610,56463,19529,90726,3788,1816,1972
56795,117349,26611,56469,19530,90737,3789,1817,1972
56800,117360,26613,56476,19531,90747,3789,1817,1972
56805,117367,26614,56479,19531,90753,3789,1817,1972
56810,117380,26616,56486,19533,90763,3790,1818,1972
56815,117391,26619,56492,19536,90771,3790,1818,1972
56820,117398,26622,56495,19539,90776,3790,1818,1972
56825,117411,26624,56502,19541,90785,3791,1818,1973
56830,117422,26629,56509,19546,90791,3791,1818,1973
56835,117429,26633,56513,19550,90795,3791,1818,1973
56840,117442,26636,56522,19553,90805,3792,1819,1973
56845,117453,26639,56529,19555,90811,3792,1819,1973
56850,117460,26644,56531,19560,90816,3792,1819,1973
56855,117473,26645,56536,19560,90826,3793,1820,1973
56860,117484,26647,56541,19562,90835,3793,1820,1973
56865,117491,26652,56544,19566,90838,3793,1820,1973
56870,117504,26655,56549,19568,90846,3794,1820,1974
56875,117515,26661,56553,19573,90852,3794,1820,1974
56880,117522,26664,56557,19576,90857,3794,1820,1974
56885,117535,26667,56565,19578,90866,3795,1820,1975
56890,117546,26670,56569,19580,90875,3795,1820,1975
56895,117553,26672,56573,19582,90880,3795,1820,1975
56900,117566,26676,56580,19585,90889,3796,1821,1975
56905,117577,26678,56586,19587,90897,3796,1821,1975
56910,117584,26682,56588,19591,90902,3796,1821,1975
56915,117597,26684,56594,19592,90913,3797,1821,1976
56920,117608,26685,56600,19592,90923,3797,1821,1976
56925,117615,26686,56605,19593,90928,3797,1821,1976
56930,117628,26686,56610,19593,90942,3798,1821,1977
56935,117639,26687,56616,19594,90951,3798,1821,1977
56940,117646,26688,56618,19594,90957,3798,1821,1977
56945,117659,26689,56625,19595,90969,3799,1822,1977
56950,117670,26691,56630,19597,90978,3799,1822,1977
56955,117677,26692,56632,19597,90985,3799,1822,1977
56960,117690,26693,56641,19598,90997,3800,1822,1978
56965,117701,26694,56645,19598,91006,3800,1822,1978
56970,117708,26695,56650,19599,91012,3800,1822,1978
56975,117721,26695,56657,19599,91025,3801,1822,1979
56980,117732,26697,56662,19600,91035,3801,1822,1979
56985,117739,26700,56666,19602,91038,3801,1822,1979
56990,117752,26700,56672,19602,91050,3802,1822,1980
56995,117763,26704,56676,19606,91058,3802,1822,1980
57000,117770,26708,56679,19609,91062,3802,1822,1980
57005,117783,26710,56684,19611,91072,3803,1823,1980
57010,117794,26712,56686,19613,91082,3803,1823,1980
57015,117801,26714,56688,19615,91087,3803,1823,1980
57020,117814,26714,56691,19615,91098,3804,1824,1980
57025,117825,26719,56696,19620,91106,3804,1824,1980
57030,117832,26722,56699,19621,91108,3804,1824,1980
57035,117845,26724,56704,19623,91118,3805,1825,1980
57040,117856,26730,56710,19628,91123,3805,1825,1980
57045,117863,26737,56713,19633,91125,3805,1825,1980
57050,117876,26740,56718,19636,91134,3806,1825,1981
57055,117887,26744,56725,19640,91140,3806,1825,1981
57060,117894,26750,56729,19645,91143,3806,1825,1981
57065,117907,26753,56735,19648,91153,3807,1825,1982
57070,117918,26755,56738,19649,91163,3807,1825,1982
57075,117925,26755,56740,19649,91170,3807,1825,1982
57080,117938,26756,56747,19650,91181,3808,1826,1982
57085,117949,26757,56755,19651,91192,3808,1826,1982
57090,117956,26757,56757,19651,91199,3808,1826,1982
57095,117969,26759,56765,19653,91209,3809,1827,1982
57100,117980,26760,56772,19654,91220,3809,1827,1982
57105,117987,26760,56775,19654,91227,3809,1827,1982
57110,118000,26762,56779,19656,91237,3810,1827,1983
57115,118011,26763,56782,19656,91247,3810,1827,1983
57120,118018,26765,56785,19658,91253,3810,1827,1983
57125,118031,26767,56790,19659,91264,3811,1828,1983
57130,118042,26768,56792,19659,91274,3811,1828,1983
57135,118049,26768,56798,19659,91281,3811,1828,1983
57140,118062,26770,56808,19661,91289,3812,1829,1983
57145,118073,26772,56812,19663,91301,3812,1829,1983
57150,118080,26772,56814,19663,91308,3812,1829,1983
57155,118093,26774,56818,19665,91318,3813,1829,1984
57160,118104,26775,56825,19666,91329,3813,1829,1984
57165,118111,26776,56828,19667,91335,3813,1829,1984
57170,118124,26778,56834,19668,91344,3814,1829,1985
57175,118135,26781,56838,19671,91354,3814,1829,1985
57180,118142,26784,56841,19672,91358,3814,1829,1985
57185,118155,26786,56849,19673,91365,3815,1830,1985
57190,118166,26792,56856,19678,91373,3815,1830,1985
57195,118173,26795,56860,19681,91378,3815,1830,1985
57200,118186,26797,56868,19683,91385,3816,1831,1985
57205,118197,26803,56873,19689,91394,3816,1831,1985
57210,118204,26807,56877,19692,91397,3816,1831,1985
57215,118217,26809,56882,19694,91407,3817,1832,1985
57220,118228,26812,56890,19697,91414,3817,1832,1985
57225,118235,26816,56892,19700,91418,3817,1832,1985
57230,118248,26821,56899,19705,91426,3818,1832,1986
57235,118259,26825,56905,19708,91431,3818,1832,1986
57240,118266,26831,56909,19714,91434,3818,1832,1986
57245,118279,26833,56914,19716,91445,3819,1833,1986
57250,118290,26834,56918,19716,91455,3819,1833,1986
57255,118297,26836,56922,19717,91461,3819,1833,1986
57260,118310,26838,56925,19718,91472,3820,1833,1987
57265,118321,26839,56931,19719,91481,3820,1833,1987
57270,118328,26842,56936,19722,91485,3820,1833,1987
57275,118341,26844,56942,19723,91497,3821,1833,1988
57280,118352,26845,56948,19724,91507,3821,1833,1988
57285,118359,26847,56953,19726,91511,3821,1833,1988
57290,118372,26850,56959,19729,91521,3822,1833,1989
57295,118383,26851,56966,19729,91531,3822,1833,1989
57300,118390,26853,56968,19730,91536,3822,1833,1989
57305,118403,26856,56976,19733,91544,3823,1834,1989
57310,118414,26859,56981,19735,91553,3823,1834,1989
57315,118421,26862,56984,19738,91558,3823,1834,1989
57320,118434,26863,56989,19739,91570,3824,1834,1990
57325,118445,26865,56993,19741,91580,3824,1834,1990
57330,118452,26866,56996,19741,91585,3824,1834,1990
57335,118465,26867,57004,19742,91596,3825,1834,1991
57340,118476,26869,57008,19743,91606,3825,1834,1991
57345,118483,26871,57014,19744,91611,3825,1834,1991
57350,118496,26872,57022,19745,91621,3826,1834,1992
57355,118507,26875,57029,19748,91630,3826,1834,1992
57360,118514,26878,57033,19750,91635,3826,1834,1992
57365,118527,26880,57041,19752,91644,3827,1835,1992
57370,118538,26884,57045,19755,91653,3827,1835,1992
57375,118545,26887,57050,19757,91658,3827,1835,1992
57380,118558,26888,57055,19758,91668,3828,1836,1992
57385,118569,26891,57061,19760,91677,3828,1836,1992
57390,118576,26894,57067,19763,91681,3828,1836,1992
57395,118589,26896,57076,19765,91691,3829,1836,1993
57400,118600,26898,57083,19766,91701,3829,1836,1993
57405,118607,26902,57088,19770,91705,3829,1836,1993
57410,118620,26902,57095,19770,91715,3830,1836,1994
57415,118631,26907,57101,19774,91721,3830,1836,1994
57420,118638,26912,57104,19778,91725,3830,1836,1994
57425,118651,26914,57110,19779,91734,3831,1837,1994
57430,118662,26915,57117,19780,91747,3831,1837,1994
57435,118669,26915,57121,19780,91754,3831,1837,1994
57440,118682,26916,57126,19780,91766,3832,1837,1995
57445,118693,26917,57132,19781,91776,3832,1837,1995
57450,118700,26917,57134,19781,91783,3832,1837,1995
57455,118713,26918,57142,19781,91794,3833,1838,1995
57460,118724,26919,57147,19781,91805,3833,1838,1995
57465,118731,26919,57150,19781,91812,3833,1838,1995
57470,118744,26920,57155,19781,91823,3834,1839,1995
57475,118755,26922,57159,19782,91833,3834,1839,1995
57480,118762,26922,57163,19782,91840,3834,1839,1995
57485,118775,26924,57173,19783,91849,3835,1840,1995
57490,118786,26926,57179,19785,91860,3835,1840,1995
57495,118793,26928,57184,19787,91865,3835,1840,1995
57500,118806,26930,57192,19789,91875,3836,1841,1995
57505,118817,26931,57195,19790,91886,3836,1841,1995
57510,118824,26933,57200,19792,91891,3836,1841,1995
57515,118837,26934,57207,19793,91902,3837,1842,1995
57520,118848,26935,57214,19794,91911,3837,1842,1995
57525,118855,26939,57218,19797,91915,3837,1842,1995
57530,118868,26941,57223,19798,91926,3838,1842,1996
57535,118879,26945,57225,19801,91934,3838,1842,1996
57540,118886,26950,57231,19806,91935,3838,1842,1996
57545,118899,26955,57238,19810,91941,3839,1843,1996
57550,118910,26960,57245,19814,91945,3839,1843,1996
57555,118917,26970,57251,19823,91946,3839,1843,1996
57560,118930,26974,57259,19827,91953,3840,1844,1996
57565,118941,26979,57265,19832,91960,3840,1844,1996
57570,118948,26985,57269,19837,91962,3840,1844,1996
57575,118961,26990,57279,19841,91966,3841,1844,1997
57580,118972,26997,57284,19848,91975,3841,1844,1997
57585,118979,26998,57288,19849,91981,3841,1844,1997
57590,118992,27001,57296,19852,91988,3842,1844,1998
57595,119003,27004,57302,19855,91999,3842,1844,1998
57600,119010,27005,57305,19855,92004,3842,1844,1998
57605,119023,27007,57311,19857,92014,3843,1845,1998
57610,119034,27009,57317,19859,92025,3843,1845,1998
57615,119041,27009,57320,19859,92031,3843,1845,1998
57620,119054,27011,57324,19860,92043,3844,1846,1998
57625,119065,27012,57330,19861,92053,3844,1846,1998
57630,119072,27012,57335,19861,92060,3844,1846,1998
57635,119085,27013,57340,19861,92072,3845,1847,1998
57640,119096,27014,57345,19862,92082,3845,1847,1998
57645,119103,27014,57347,19862,92089,3845,1847,1998
57650,119116,27015,57352,19862,92099,3846,1847,1999
57655,119127,27016,57357,19862,92111,3846,1847,1999
57660,119134,27016,57360,19862,92118,3846,1847,1999
57665,119147,27018,57369,19863,92128,3847,1848,1999
57670,119158,27019,57374,19863,92138,3847,1848,1999
57675,119165,27020,57374,19864,92145,3847,1848,1999
57680,119178,27021,57379,19864,92155,3848,1849,1999
57685,119189,27023,57385,19866,92165,3848,1849,1999
57690,119196,27027,57390,19869,92169,3848,1849,1999
57695,119209,27029,57398,19871,92178,3849,1849,2000
57700,119220,27032,57405,19873,92184,3849,1849,2000
57705,119227,27037,57407,19878,92190,3849,1849,2000
57710,119240,27039,57414,19879,92198,3850,1850,2000
57715,119251,27045,57418,19884,92205,3850,1850,2000
57720,119258,27050,57422,19889,92208,3850,1850,2000
57725,119271,27050,57427,19889,92220,3851,1850,2001
57730,119282,27054,57431,19892,92227,3851,1850,2001
57735,119289,27057,57433,19894,92232,3851,1850,2001
57740,119302,27058,57438,19895,92243,3852,1850,2002
57745,119313,27061,57443,19898,92251,3852,1850,2002
57750,119320,27065,57447,19901,92254,3852,1850,2002
57755,119333,27065,57452,19901,92267,3853,1851,2002
57760,119344,27066,57456,19901,92278,3853,1851,2002
57765,119351,27067,57459,19901,92284,3853,1851,2002
57770,119364,27067,57465,19901,92296,3854,1852,2002
57775,119375,27069,57470,19902,92305,3854,1852,2002
57780,119382,27070,57473,19902,92311,3854,1852,2002
57785,119395,27071,57480,19903,92322,3855,1853,2002
57790,119406,27073,57481,19905,92333,3855,1853,2002
57795,119413,27074,57486,19906,92338,3855,1853,2002
57800,119426,27075,57492,19907,92349,3856,1854,2002
57805,119437,27077,57498,19908,92358,3856,1854,2002
57810,119444,27079,57501,19909,92364,3856,1854,2002
57815,119457,27080,57507,19910,92376,3857,1854,2003
57820,119468,27083,57517,19913,92383,3857,1854,2003
57825,119475,27085,57520,19914,92390,3857,1854,2003
57830,119488,27088,57525,19916,92399,3858,1854,2004
57835,119499,27091,57531,19919,92407,3858,1854,2004
57840,119506,27093,57535,19920,92413,3858,1854,2004
57845,119519,27094,57542,19920,92422,3859,1854,2005
57850,119530,27098,57546,19924,92432,3859,1854,2005
57855,119537,27099,57549,19925,92438,3859,1854,2005
57860,119550,27101,57556,19926,92447,3860,1855,2005
57865,119561,27105,57561,19929,92456,3860,1855,2005
57870,119568,27107,57564,19930,92461,3860,1855,2005
57875,119581,27109,57571,19931,92471,3861,1856,2005
57880,119592,27111,57573,19933,92481,3861,1856,2005
57885,119599,27114,57575,19934,92485,3861,1856,2005
57890,119612,27115,57579,19935,92494,3862,1856,2006
57895,119623,27121,57584,19940,92500,3862,1856,2006
57900,119630,27126,57586,19943,92503,3862,1856,2006
57905,119643,27129,57589,19945,92514,3863,1856,2007
57910,119654,27131,57593,19946,92522,3863,1856,2007
57915,119661,27134,57595,19949,92527,3863,1856,2007
57920,119674,27136,57602,19950,92535,3864,1857,2007
57925,119685,27139,57606,19952,92545,3864,1857,2007
57930,119692,27143,57611,19956,92547,3864,1857,2007
57935,119705,27147,57620,19960,92555,3865,1858,2007
57940,119716,27150,57624,19962,92563,3865,1858,2007
57945,119723,27153,57627,19965,92570,3865,1858,2007
57950,119736,27154,57631,19965,92580,3866,1858,2008
57955,119747,27156,57636,19966,92589,3866,1858,2008
57960,119754,27159,57640,19969,92594,3866,1858,2008
57965,119767,27161,57649,19971,92605,3867,1858,2009
57970,119778,27162,57654,19972,92614,3867,1858,2009
57975,119785,27165,57656,19975,92620,3867,1858,2009
57980,119798,27167,57660,19976,92631,3868,1858,2010
57985,119809,27168,57667,19976,92640,3868,1858,2010
57990,119816,27170,57670,19978,92646,3868,1858,2010
57995,119829,27171,57676,19978,92658,3869,1858,2011
58000,119840,27172,57684,19979,92668,3869,1858,2011
58005,119847,27173,57686,19980,92674,3869,1858,2011
58010,119860,27175,57694,19981,92684,3870,1859,2011
58015,119871,27176,57699,19982,92695,3870,1859,2011
58020,119878,27177,57701,19982,92701,3870,1859,2011
58025,119891,27178,57705,19982,92712,3871,1860,2011
58030,119902,27179,57711,19983,92723,3871,1860,2011
58035,119909,27180,57713,19984,92729,3871,1860,2011
58040,119922,27181,57717,19984,92741,3872,1860,2012
58045,119933,27182,57724,19985,92751,3872,1860,2012
58050,119940,27184,57728,19986,92756,3872,1860,2012
58055,119953,27186,57734,19987,92765,3873,1860,2013
58060,119964,27188,57737,19989,92776,3873,1860,2013
58065,119971,27191,57743,19991,92779,3873,1860,2013
58070,119984,27194,57751,19994,92787,3874,1860,2014
58075,119995,27201,57756,20000,92793,3874,1860,2014
58080,120002,27205,57759,20002,92796,3874,1860,2014
58085,120015,27210,57767,20006,92803,3875,1861,2014
58090,120026,27214,57772,20009,92810,3875,1861,2014
58095,120033,27220,57776,20014,92812,3875,1861,2014
58100,120046,27225,57785,20019,92820,3876,1862,2014
58105,120057,27229,57790,20022,92826,3876,1862,2014
58110,120064,27236,57796,20028,92826,3876,1862,2014
58115,120077,27242,57805,20033,92832,3877,1863,2014
58120,120088,27247,57811,20038,92840,3877,1863,2014
58125,120095,27248,57814,20039,92846,3877,1863,2014
58130,120108,27251,57819,20041,92857,3878,1864,2014
58135,120119,27252,57823,20042,92867,3878,1864,2014
58140,120126,27252,57827,20042,92874,3878,1864,2014
58145,120139,27253,57831,20042,92886,3879,1864,2015
58150,120150,27254,57836,20042,92895,3879,1864,2015
58155,120157,27255,57838,20043,92902,3879,1864,2015
58160,120170,27256,57844,20044,92914,3880,1865,2015
58165,120181,27257,57849,20045,92924,3880,1865,2015
58170,120188,27258,57851,20046,92930,3880,1865,2015
58175,120201,27260,57855,20047,92939,3881,1865,2016
58180,120212,27262,57864,20049,92948,3881,1865,2016
58185,120219,27264,57868,20051,92954,3881,1865,2016
58190,120232,27266,57873,20053,92965,3882,1865,2017
58195,120243,27267,57876,20054,92976,3882,1865,2017
58200,120250,27267,57879,20054,92983,3882,1865,2017
58205,120263,27267,57884,20054,92996,3883,1866,2017
58210,120274,27268,57891,20055,93006,3883,1866,2017
58215,120281,27268,57894,20055,93013,3883,1866,2017
58220,120294,27268,57904,20055,93026,3884,1867,2017
58225,120305,27271,57906,20057,93034,3884,1867,2017
58230,120312,27273,57910,20057,93039,3884,1867,2017
58235,120325,27273,57913,20057,93052,3885,1868,2017
58240,120336,27274,57919,20057,93062,3885,1868,2017
58245,120343,27276,57924,20059,93067,3885,1868,2017
58250,120356,27277,57929,20060,93078,3886,1868,2018
58255,120367,27280,57934,20062,93087,3886,1868,2018
58260,120374,27282,57936,20063,93092,3886,1868,2018
58265,120387,27283,57941,20064,93103,3887,1868,2019
58270,120398,27285,57946,20066,93112,3887,1868,2019
58275,120405,27288,57949,20069,93117,3887,1868,2019
58280,120418,27288,57951,20069,93130,3888,1868,2020
58285,120429,27289,57959,20069,93138,3888,1868,2020
58290,120436,27293,57964,20072,93142,3888,1868,2020
58295,120449,27294,57969,20073,93153,3889,1869,2020
58300,120460,27298,57974,20076,93160,3889,1869,2020
58305,120467,27302,57977,20078,93163,3889,1869,2020
58310,120480,27308,57986,20084,93168,3890,1869,2021
58315,120491,27314,57990,20090,93175,3890,1869,2021
58320,120498,27319,57996,20095,93177,3890,1869,2021
58325,120511,27325,58005,20101,93182,3891,1869,2022
58330,120522,27331,58010,20107,93190,3891,1869,2022
58335,120529,27333,58012,20109,93196,3891,1869,2022
58340,120542,27334,58017,20110,93207,3892,1869,2023
58345,120553,27337,58019,20112,93216,3892,1869,2023
58350,120560,27339,58024,20114,93221,3892,1869,2023
58355,120573,27341,58031,20115,93230,3893,1870,2023
58360,120584,27345,58037,20119,93238,3893,1870,2023
58365,120591,27348,58041,20121,93242,3893,1870,2023
58370,120604,27352,58047,20124,93251,3894,1871,2023
58375,120615,27354,58050,20126,93261,3894,1871,2023
58380,120622,27355,58053,20127,93266,3894,1871,2023
58385,120635,27356,58058,20128,93279,3895,1871,2024
58390,120646,27357,58061,20128,93287,3895,1871,2024
58395,120653,27360,58062,20130,93292,3895,1871,2024
58400,120666,27363,58069,20132,93301,3896,1872,2024
58405,120677,27366,58071,20134,93311,3896,1872,2024
58410,120684,27368,58072,20135,93316,3896,1872,2024
58415,120697,27370,58078,20136,93326,3897,1872,2025
58420,120708,27373,58083,20138,93334,3897,1872,2025
58425,120715,27375,58086,20139,93339,3897,1872,2025
58430,120728,27376,58092,20139,93350,3898,1873,2025
58435,120739,27380,58094,20142,93358,3898,1873,2025
58440,120746,27383,58097,20144,93362,3898,1873,2025
58445,120759,27384,58103,20144,93373,3899,1873,2026
58450,120770,27387,58108,20147,93381,3899,1873,2026
58455,120777,27390,58111,20150,93385,3899,1873,2026
58460,120790,27391,58118,20151,93398,3900,1874,2026
58465,120801,27392,58122,20151,93408,3900,1874,2026
58470,120808,27393,58124,20152,93415,3900,1874,2026
58475,120821,27393,58129,20152,93427,3901,1875,2026
58480,120832,27394,58131,20152,93437,3901,1875,2026
58485,120839,27395,58133,20152,93443,3901,1875,2026
58490,120852,27395,58142,20152,93456,3902,1876,2026
58495,120863,27396,58148,20152,93465,3902,1876,2026
58500,120870,27397,58151,20152,93472,3902,1876,2026
58505,120883,27397,58157,20152,93486,3903,1876,2027
58510,120894,27398,58164,20153,93495,3903,1876,2027
58515,120901,27399,58166,20153,93502,3903,1876,2027
58520,120914,27399,58174,20153,93515,3904,1877,2027
58525,120925,27400,58179,20153,93525,3904,1877,2027
58530,120932,27401,58183,20154,93531,3904,1877,2027
58535,120945,27401,58188,20154,93542,3905,1877,2028
58540,120956,27402,58191,20154,93554,3905,1877,2028
58545,120963,27404,58193,20154,93558,3905,1877,2028
58550,120976,27406,58199,20156,93569,3906,1877,2029
58555,120987,27409,58204,20158,93576,3906,1877,2029
58560,120994,27413,58210,20162,93581,3906,1877,2029
58565,121007,27416,58219,20164,93588,3907,1877,2030
58570,121018,27419,58221,20166,93599,3907,1877,2030
58575,121025,27422,58224,20168,93602,3907,1877,2030
58580,121038,27424,58230,20170,93614,3908,1877,2031
58585,121049,27426,58235,20171,93621,3908,1877,2031
58590,121056,27430,58237,20174,93626,3908,1877,2031
58595,121069,27432,58242,20175,93635,3909,1877,2032
58600,121080,27435,58247,20178,93643,3909,1877,2032
58605,121087,27440,58250,20182,93646,3909,1877,2032
58610,121100,27443,58256,20184,93655,3910,1878,2032
58615,121111,27445,58263,20185,93662,3910,1878,2032
58620,121118,27452,58266,20191,93666,3910,1878,2032
58625,121131,27456,58272,20194,93675,3911,1879,2032
58630,121142,27457,58274,20194,93685,3911,1879,2032
58635,121149,27459,58279,20196,93690,3911,1879,2032
58640,121162,27460,58286,20197,93701,3912,1880,2032
58645,121173,27461,58289,20197,93711,3912,1880,2032
58650,121180,27463,58292,20198,93717,3912,1880,2032
58655,121193,27464,58299,20199,93728,3913,1880,2033
58660,121204,27465,58302,20199,93738,3913,1880,2033
58665,121211,27467,58304,20199,93744,3913,1880,2033
58670,121224,27467,58308,20199,93757,3914,1880,2034
58675,121235,27468,58316,20199,93765,3914,1880,2034
58680,121242,27471,58319,20200,93771,3914,1880,2034
58685,121255,27473,58325,20202,93782,3915,1881,2034
58690,121266,27475,58330,20203,93790,3915,1881,2034
58695,121273,27479,58332,20205,93793,3915,1881,2034
58700,121286,27482,58341,20208,93804,3916,1881,2035
58705,121297,27483,58349,20209,93813,3916,1881,2035
58710,121304,27485,58353,20211,93819,3916,1881,2035
58715,121317,27485,58361,20211,93832,3917,1882,2035
58720,121328,27486,58365,20212,93842,3917,1882,2035
58725,121335,27487,58367,20212,93848,3917,1882,2035
58730,121348,27487,58374,20212,93860,3918,1882,2036
58735,121359,27490,58380,20215,93869,3918,1882,2036
58740,121366,27491,58384,20216,93875,3918,1882,2036
58745,121379,27493,58389,20217,93884,3919,1882,2037
58750,121390,27497,58394,20220,93892,3919,1882,2037
58755,121397,27499,58396,20221,93898,3919,1882,2037
58760,121410,27501,58404,20222,93907,3920,1883,2037
58765,121421,27503,58410,20224,93917,3920,1883,2037
58770,121428,27505,58414,20225,93923,3920,1883,2037
58775,121441,27507,58420,20227,93934,3921,1884,2037
58780,121452,27508,58422,20228,93944,3921,1884,2037
58785,121459,27509,58426,20228,93949,3921,1884,2037
58790,121472,27512,58434,20231,93958,3922,1884,2038
58795,121483,27516,58440,20235,93966,3922,1884,2038
58800,121490,27519,58444,20237,93970,3922,1884,2038
58805,121503,27522,58449,20240,93981,3923,1884,2039
58810,121514,27525,58456,20243,93985,3923,1884,2039
58815,121521,27532,58460,20250,93989,3923,1884,2039
58820,121534,27536,58467,20253,93996,3924,1885,2039
58825,121545,27540,58474,20256,94000,3924,1885,2039
58830,121552,27547,58478,20262,94004,3924,1885,2039
58835,121565,27551,58486,20265,94013,3925,1885,2040
58840,121576,27553,58487,20266,94023,3925,1885,2040
58845,121583,27555,58491,20267,94027,3925,1885,2040
58850,121596,27559,58497,20270,94037,3926,1886,2040
58855,121607,27563,58504,20274,94043,3926,1886,2040
58860,121614,27566,58506,20276,94048,3926,1886,2040
58865,121627,27568,58514,20277,94058,3927,1887,2040
58870,121638,27572,58520,20280,94063,3927,1887,2040
58875,121645,27577,58523,20285,94068,3927,1887,2040
58880,121658,27578,58527,20285,94078,3928,1887,2041
58885,121669,27583,58532,20290,94085,3928,1887,2041
58890,121676,27587,58536,20293,94088,3928,1887,2041
58895,121689,27589,58541,20294,94100,3929,1888,2041
58900,121700,27592,58547,20297,94106,3929,1888,2041
58905,121707,27594,58552,20299,94113,3929,1888,2041
58910,121720,27595,58558,20300,94123,3930,1888,2042
58915,121731,27600,58563,20304,94130,3930,1888,2042
58920,121738,27602,58564,20306,94136,3930,1888,2042
58925,121751,27603,58569,20307,94147,3931,1888,2043
58930,121762,27607,58573,20310,94154,3931,1888,2043
58935,121769,27609,58576,20311,94159,3931,1888,2043
58940,121782,27611,58583,20312,94169,3932,1888,2044
58945,121793,27614,58588,20315,94179,3932,1888,2044
58950,121800,27615,58591,20316,94184,3932,1888,2044
58955,121813,27617,58598,20318,94194,3933,1888,2045
58960,121824,27621,58605,20322,94203,3933,1888,2045
58965,121831,27621,58607,20322,94210,3933,1888,2045
58970,121844,27622,58612,20323,94220,3934,1888,2046
58975,121855,27624,58619,20325,94231,3934,1888,2046
58980,121862,27624,58623,20325,94238,3934,1888,2046
58985,121875,27625,58626,20325,94249,3935,1888,2047
58990,121886,27626,58632,20326,94259,3935,1888,2047
58995,121893,27629,58636,20328,94264,3935,1888,2047
59000,121906,27632,58645,20330,94270,3936,1889,2047
59005,121917,27635,58651,20332,94281,3936,1889,2047
59010,121924,27638,58653,20334,94286,3936,1889,2047
59015,121937,27641,58660,20336,94293,3937,1889,2048
59020,121948,27645,58668,20340,94300,3937,1889,2048
59025,121955,27651,58674,20346,94304,3937,1889,2048
59030,121968,27653,58682,20348,94313,3938,1890,2048
59035,121979,27655,58689,20350,94324,3938,1890,2048
59040,121986,27655,58692,20350,94331,3938,1890,2048
59045,121999,27656,58697,20350,94342,3939,1890,2049
59050,122010,27658,58701,20351,94352,3939,1890,2049
59055,122017,27658,58704,20351,94359,3939,1890,2049
59060,122030,27659,58710,20351,94371,3940,1890,2050
59065,122041,27660,58714,20352,94381,3940,1890,2050
59070,122048,27661,58716,20352,94387,3940,1890,2050
59075,122061,27662,58723,20352,94399,3941,1890,2051
59080,122072,27663,58730,20353,94409,3941,1890,2051
59085,122079,27664,58734,20353,94415,3941,1890,2051
59090,122092,27665,58740,20354,94427,3942,1890,2052
59095,122103,27666,58745,20355,94437,3942,1890,2052
59100,122110,27667,58748,20355,94443,3942,1890,2052
59105,122123,27668,58752,20355,94455,3943,1890,2053
59110,122134,27669,58759,20356,94464,3943,1890,2053
59115,122141,27671,58763,20358,94470,3943,1890,2053
59120,122154,27672,58770,20359,94482,3944,1890,2054
59125,122165,27673,58777,20360,94491,3944,1890,2054
59130,122172,27674,58780,20360,94498,3944,1890,2054
59135,122185,27675,58785,20361,94509,3945,1890,2055
59140,122196,27677,58790,20363,94518,3945,1890,2055
59145,122203,27681,58793,20365,94522,3945,1890,2055
59150,122216,27682,58798,20365,94530,3946,1890,2056
59155,122227,27687,58805,20370,94537,3946,1890,2056
59160,122234,27692,58809,20374,94541,3946,1890,2056
59165,122247,27695,58814,20377,94551,3947,1890,2057
59170,122258,27700,58824,20382,94556,3947,1890,2057
59175,122265,27704,58827,20385,94561,3947,1890,2057
59180,122278,27705,58833,20386,94569,3948,1890,2058
59185,122289,27710,58837,20391,94578,3948,1890,2058
59190,122296,27713,58839,20394,94583,3948,1890,2058
59195,122309,27715,58845,20395,94592,3949,1890,2059
59200,122320,27719,58850,20399,94599,3949,1890,2059
59205,122327,27723,58852,20401,94603,3949,1890,2059
59210,122340,27725,58856,20402,94613,3950,1890,2060
59215,122351,27730,58861,20407,94621,3950,1890,2060
59220,122358,27733,58864,20408,94625,3950,1890,2060
59225,122371,27735,58869,20409,94635,3951,1891,2060
59230,122382,27737,58873,20410,94645,3951,1891,2060
59235,122389,27739,58878,20412,94650,3951,1891,2060
59240,122402,27741,58885,20414,94661,3952,1892,2060
59245,122413,27743,58891,20416,94670,3952,1892,2060
59250,122420,27745,58895,20417,94675,3952,1892,2060
59255,122433,27747,58898,20418,94686,3953,1892,2061
59260,122444,27750,58907,20421,94692,3953,1892,2061
59265,122451,27754,58910,20424,94697,3953,1892,2061
59270,122464,27755,58915,20424,94709,3954,1893,2061
59275,122475,27757,58920,20425,94716,3954,1893,2061
59280,122482,27762,58927,20430,94720,3954,1893,2061
59285,122495,27763,58930,20431,94731,3955,1894,2061
59290,122506,27765,58934,20433,94741,3955,1894,2061
59295,122513,27765,58939,20433,94748,3955,1894,2061
59300,122526,27766,58945,20434,94759,3956,1894,2062
59305,122537,27768,58951,20436,94769,3956,1894,2062
59310,122544,27768,58954,20436,94776,3956,1894,2062
59315,122557,27769,58959,20436,94788,3957,1894,2063
59320,122568,27770,58965,20437,94798,3957,1894,2063
59325,122575,27771,58967,20438,94804,3957,1894,2063
59330,122588,27772,58973,20439,94812,3958,1895,2063
59335,122599,27777,58977,20443,94821,3958,1895,2063
59340,122606,27779,58981,20445,94827,3958,1895,2063
59345,122619,27780,58987,20445,94837,3959,1895,2064
59350,122630,27784,58991,20448,94844,3959,1895,2064
59355,122637,27787,58996,20451,94850,3959,1895,2064
59360,122650,27788,58999,20451,94862,3960,1895,2065
59365,122661,27790,59004,20453,94870,3960,1895,2065
59370,122668,27791,59009,20453,94876,3960,1895,2065
59375,122681,27793,59017,20455,94887,3961,1895,2066
59380,122692,27796,59022,20458,94895,3961,1895,2066
59385,122699,27798,59028,20460,94900,3961,1895,2066
59390,122712,27801,59034,20463,94907,3962,1895,2067
59395,122723,27808,59040,20469,94913,3962,1895,2067
59400,122730,27812,59043,20472,94918,3962,1895,2067
59405,122743,27814,59047,20474,94928,3963,1895,2068
59410,122754,27817,59053,20476,94937,3963,1895,2068
59415,122761,27818,59057,20476,94943,3963,1895,2068
59420,122774,27820,59064,20477,94951,3964,1896,2068
59425,122785,27822,59068,20478,94962,3964,1896,2068
59430,122792,27825,59072,20480,94967,3964,1896,2068
59435,122805,27826,59077,20480,94977,3965,1897,2068
59440,122816,27831,59082,20484,94985,3965,1897,2068
59445,122823,27833,59087,20485,94990,3965,1897,2068
59450,122836,27835,59092,20486,95000,3966,1897,2069
59455,122847,27838,59098,20489,95009,3966,1897,2069
59460,122854,27838,59100,20489,95016,3966,1897,2069
59465,122867,27839,59108,20490,95028,3967,1897,2070
59470,122878,27841,59114,20491,95037,3967,1897,2070
59475,122885,27841,59118,20491,95044,3967,1897,2070
59480,122898,27842,59128,20492,95056,3968,1898,2070
59485,122909,27844,59133,20494,95065,3968,1898,2070
59490,122916,27844,59137,20494,95072,3968,1898,2070
59495,122929,27845,59147,20494,95084,3969,1898,2071
59500,122940,27846,59152,20495,95093,3969,1898,2071
59505,122947,27848,59156,20497,95099,3969,1898,2071
59510,122960,27849,59164,20498,95111,3970,1899,2071
59515,122971,27851,59166,20499,95119,3970,1899,2071
59520,122978,27853,59169,20501,95125,3970,1899,2071
59525,122991,27854,59175,20501,95137,3971,1899,2072
59530,123002,27856,59181,20503,95145,3971,1899,2072
59535,123009,27858,59183,20504,95151,3971,1899,2072
59540,123022,27859,59191,20505,95161,3972,1900,2072
59545,123033,27863,59197,20508,95168,3972,1900,2072
59550,123040,27865,59199,20509,95175,3972,1900,2072
59555,123053,27866,59206,20509,95185,3973,1900,2073
59560,123064,27870,59209,20512,95192,3973,1900,2073
59565,123071,27874,59213,20515,95196,3973,1900,2073
59570,123084,27877,59221,20518,95204,3974,1901,2073
59575,123095,27882,59226,20523,95212,3974,1901,2073
59580,123102,27885,59230,20526,95217,3974,1901,2073
59585,123115,27886,59235,20526,95227,3975,1902,2073
59590,123126,27890,59243,20530,95233,3975,1902,2073
59595,123133,27895,59244,20533,95237,3975,1902,2073
59600,123146,27898,59250,20535,95245,3976,1902,2074
59605,123157,27902,59255,20539,95254,3976,1902,2074
59610,123164,27904,59258,20540,95260,3976,1902,2074
59615,123177,27906,59265,20541,95268,3977,1902,2075
59620,123188,27911,59271,20546,95276,3977,1902,2075
59625,123195,27913,59272,20547,95282,3977,1902,2075
59630,123208,27914,59276,20547,95292,3978,1903,2075
59635,123219,27916,59282,20549,95302,3978,1903,2075
59640,123226,27919,59286,20552,95307,3978,1903,2075
59645,123239,27920,59289,20552,95318,3979,1903,2076
59650,123250,27922,59298,20554,95327,3979,1903,2076
59655,123257,27922,59302,20554,95335,3979,1903,2076
59660,123270,27923,59308,20554,95346,3980,1903,2077
59665,123281,27924,59314,20554,95356,3980,1903,2077
59670,123288,27924,59318,20554,95364,3980,1903,2077
59675,123301,27925,59325,20555,95376,3981,1904,2077
59680,123312,27926,59333,20556,95385,3981,1904,2077
59685,123319,27926,59339,20556,95393,3981,1904,2077
59690,123332,27927,59347,20556,95404,3982,1905,2077
59695,123343,27929,59356,20557,95414,3982,1905,2077
59700,123350,27929,59360,20557,95421,3982,1905,2077
59705,123363,27930,59370,20558,95433,3983,1906,2077
59710,123374,27932,59374,20559,95442,3983,1906,2077
59715,123381,27933,59378,20560,95448,3983,1906,2077
59720,123394,27934,59385,20560,95460,3984,1907,2077
59725,123405,27936,59389,20562,95469,3984,1907,2077
59730,123412,27937,59391,20562,95475,3984,1907,2077
59735,123425,27938,59396,20563,95487,3985,1907,2078
59740,123436,27940,59401,20564,95496,3985,1907,2078
59745,123443,27942,59403,20564,95501,3985,1907,2078
59750,123456,27943,59407,20564,95513,3986,1907,2079
59755,123467,27945,59412,20566,95520,3986,1907,2079
59760,123474,27949,59417,20570,95523,3986,1907,2079
59765,123487,27953,59426,20574,95532,3987,1908,2079
59770,123498,27960,59432,20580,95536,3987,1908,2079
59775,123505,27964,59436,20583,95540,3987,1908,2079
59780,123518,27967,59444,20586,95550,3988,1909,2079
59785,123529,27970,59448,20589,95558,3988,1909,2079
59790,123536,27973,59450,20591,95563,3988,1909,2079
59795,123549,27975,59456,20593,95573,3989,1910,2079
59800,123560,27979,59462,20597,95580,3989,1910,2079
59805,123567,27983,59465,20600,95583,3989,1910,2079
59810,123580,27985,59473,20601,95592,3990,1911,2079
59815,123591,27990,59479,20606,95600,3990,1911,2079
59820,123598,27993,59481,20607,95604,3990,1911,2079
59825,123611,27996,59487,20609,95613,3991,1911,2080
59830,123622,28000,59495,20612,95620,3991,1911,2080
59835,123629,28003,59498,20614,95626,3991,1911,2080
59840,123642,28005,59504,20615,95637,3992,1912,2080
59845,123653,28006,59508,20616,95647,3992,1912,2080
59850,123660,28007,59512,20617,95653,3992,1912,2080
59855,123673,28009,59517,20618,95662,3993,1913,2080
59860,123684,28013,59521,20621,95669,3993,1913,2080
59865,123691,28017,59524,20624,95674,3993,1913,2080
59870,123704,28019,59529,20625,95684,3994,1914,2080
59875,123715,28020,59533,20625,95695,3994,1914,2080
59880,123722,28020,59537,20625,95702,3994,1914,2080
59885,123735,28021,59544,20626,95714,3995,1915,2080
59890,123746,28023,59552,20628,95723,3995,1915,2080
59895,123753,28023,59557,20628,95730,3995,1915,2080
59900,123766,28024,59563,20628,95741,3996,1915,2081
59905,123777,28025,59570,20628,95752,3996,1915,2081
59910,123784,28025,59572,20628,95759,3996,1915,2081
59915,123797,28026,59579,20628,95771,3997,1916,2081
59920,123808,28027,59583,20628,95781,3997,1916,2081
59925,123815,28027,59586,20628,95788,3997,1916,2081
59930,123828,28028,59593,20628,95800,3998,1916,2082
59935,123839,28029,59599,20629,95810,3998,1916,2082
59940,123846,28030,59601,20629,95816,3998,1916,2082
59945,123859,28031,59607,20629,95828,3999,1917,2082
59950,123870,28033,59613,20631,95837,3999,1917,2082
59955,123877,28034,59615,20632,95843,3999,1917,2082
59960,123890,28035,59623,20633,95855,4000,1918,2082
59965,123901,28036,59625,20633,95865,4000,1918,2082
59970,123908,28037,59628,20634,95871,4000,1918,2082
59975,123921,28038,59632,20635,95883,4001,1918,2083
59980,123932,28040,59637,20637,95892,4001,1918,2083
59985,123939,28042,59641,20638,95897,4001,1918,2083
59990,123952,28043,59645,20638,95907,4002,1919,2083
59995,123963,28046,59647,20640,95915,4002,1919,2083
60000,123970,28051,59650,20643,95919,4002,1919,2083
60005,123983,28053,59656,20645,95929,4003,1920,2083
60010,123994,28055,59662,20647,95936,4003,1920,2083
60015,124001,28060,59662,20650,95941,4003,1920,2083
60020,124014,28062,59669,20652,95949,4004,1921,2083
60025,124025,28066,59672,20655,95957,4004,1921,2083
60030,124032,28071,59676,20659,95960,4004,1921,2083
60035,124045,28074,59682,20661,95968,4005,1921,2084
60040,124056,28081,59688,20668,95973,4005,1921,2084
60045,124063,28085,59690,20671,95977,4005,1921,2084
60050,124076,28087,59696,20673,95987,4006,1921,2085
60055,124087,28092,59700,20677,95994,4006,1921,2085
60060,124094,28095,59702,20678,95998,4006,1921,2085
60065,124107,28097,59707,20679,96009,4007,1922,2085
60070,124118,28102,59712,20683,96014,4007,1922,2085
60075,124125,28104,59715,20685,96021,4007,1922,2085
60080,124138,28105,59721,20685,96032,4008,1922,2086
60085,124149,28108,59727,20688,96039,4008,1922,2086
60090,124156,28111,59731,20691,96044,4008,1922,2086
60095,124169,28113,59739,20692,96052,4009,1923,2086
60100,124180,28118,59746,20696,96062,4009,1923,2086
60105,124187,28118,59750,20696,96069,4009,1923,2086
60110,124200,28119,59755,20696,96081,4010,1923,2087
60115,124211,28120,59759,20697,96091,4010,1923,2087
60120,124218,28120,59761,20697,96098,4010,1923,2087
60125,124231,28121,59771,20697,96110,4011,1924,2087
60130,124242,28122,59778,20697,96119,4011,1924,2087
60135,124249,28122,59784,20697,96127,4011,1924,2087
60140,124262,28123,59791,20697,96139,4012,1925,2087
60145,124273,28124,59796,20698,96148,4012,1925,2087
60150,124280,28124,59799,20698,96156,4012,1925,2087
60155,124293,28125,59806,20699,96168,4013,1925,2088
60160,124304,28126,59812,20700,96177,4013,1925,2088
60165,124311,28127,59813,20700,96184,4013,1925,2088
60170,124324,28128,59819,20700,96195,4014,1926,2088
60175,124335,28132,59823,20703,96203,4014,1926,2088
60180,124342,28133,59827,20703,96209,4014,1926,2088
60185,124355,28134,59834,20704,96221,4015,1927,2088
60190,124366,28135,59839,20704,96231,4015,1927,2088
60195,124373,28136,59843,20704,96237,4015,1927,2088
60200,124386,28137,59849,20705,96249,4016,1927,2089
60205,124397,28139,59857,20707,96257,4016,1927,2089
60210,124404,28142,59863,20709,96260,4016,1927,2089
60215,124417,28146,59870,20713,96271,4017,1928,2089
60220,124428,28149,59875,20716,96279,4017,1928,2089
60225,124435,28151,59880,20716,96282,4017,1928,2089
60230,124448,28154,59884,20718,96294,4018,1928,2090
60235,124459,28156,59888,20719,96303,4018,1928,2090
60240,124466,28158,59891,20721,96308,4018,1928,2090
60245,124479,28160,59895,20722,96318,4019,1929,2090
60250,124490,28164,59897,20724,96326,4019,1929,2090
60255,124497,28166,59899,20724,96330,4019,1929,2090
60260,124510,28169,59907,20727,96339,4020,1930,2090
60265,124521,28173,59912,20731,96348,4020,1930,2090
60270,124528,28175,59915,20731,96352,4020,1930,2090
60275,124541,28177,59922,20733,96363,4021,1931,2090
60280,124552,28182,59928,20736,96369,4021,1931,2090
60285,124559,28185,59931,20738,96373,4021,1931,2090
60290,124572,28187,59937,20740,96383,4022,1932,2090
60295,124583,28193,59945,20745,96388,4022,1932,2090
60300,124590,28197,59948,20748,96392,4022,1932,2090
60305,124603,28199,59954,20750,96402,4023,1933,2090
60310,124614,28202,59961,20753,96412,4023,1933,2090
60315,124621,28203,59963,20753,96418,4023,1933,2090
60320,124634,28205,59973,20755,96426,4024,1934,2090
60325,124645,28208,59978,20758,96437,4024,1934,2090
60330,124652,28209,59983,20759,96443,4024,1934,2090
60335,124665,28211,59989,20760,96454,4025,1934,2091
60340,124676,28213,59996,20761,96463,4025,1934,2091
60345,124683,28214,60000,20762,96469,4025,1934,2091
60350,124696,28215,60003,20762,96480,4026,1935,2091
60355,124707,28218,60009,20764,96487,4026,1935,2091
60360,124714,28222,60015,20767,96492,4026,1935,2091
60365,124727,28223,60018,20768,96503,4027,1935,2092
60370,124738,28227,60023,20771,96510,4027,1935,2092
60375,124745,28229,60027,20772,96516,4027,1935,2092
60380,124758,28231,60030,20773,96527,4028,1935,2093
60385,124769,28233,60036,20775,96535,4028,1935,2093
60390,124776,28235,60039,20777,96541,4028,1935,2093
60395,124789,28236,60045,20777,96551,4029,1935,2094
60400,124800,28241,60051,20781,96558,4029,1935,2094
60405,124807,28242,60053,20782,96565,4029,1935,2094
60410,124820,28243,60060,20783,96576,4030,1936,2094
60415,124831,28245,60063,20784,96585,4030,1936,2094
60420,124838,28247,60067,20786,96591,4030,1936,2094
60425,124851,28248,60073,20787,96603,4031,1936,2095
60430,124862,28251,60079,20790,96609,4031,1936,2095
60435,124869,28253,60082,20791,96615,4031,1936,2095
60440,124882,28255,60089,20793,96624,4032,1936,2096
60445,124893,28261,60096,20799,96632,4032,1936,2096
60450,124900,28262,60099,20799,96636,4032,1936,2096
60455,124913,28265,60103,20801,96646,4033,1937,2096
60460,124924,28270,60107,20804,96653,4033,1937,2096
60465,124931,28272,60112,20806,96658,4033,1937,2096
60470,124944,28274,60120,20807,96669,4034,1938,2096
60475,124955,28279,60127,20812,96675,4034,1938,2096
60480,124962,28280,60130,20812,96680,4034,1938,2096
60485,124975,28283,60138,20815,96692,4035,1938,2097
60490,124986,28285,60143,20816,96701,4035,1938,2097
60495,124993,28285,60149,20816,96708,4035,1938,2097
60500,125006,28286,60155,20817,96719,4036,1938,2098
60505,125017,28288,60161,20818,96729,4036,1938,2098
60510,125024,28289,60165,20818,96735,4036,1938,2098
60515,125037,28290,60173,20819,96747,4037,1939,2098
60520,125048,28292,60174,20819,96756,4037,1939,2098
60525,125055,28293,60180,20820,96762,4037,1939,2098
60530,125068,28294,60185,20821,96774,4038,1939,2099
60535,125079,28297,60193,20823,96781,4038,1939,2099
60540,125086,28298,60194,20823,96788,4038,1939,2099
60545,125099,28299,60200,20823,96799,4039,1939,2100
60550,125110,28303,60207,20826,96806,4039,1939,2100
60555,125117,28304,60211,20827,96813,4039,1939,2100
60560,125130,28305,60219,20827,96825,4040,1940,2100
60565,125141,28307,60228,20829,96834,4040,1940,2100
60570,125148,28308,60230,20829,96840,4040,1940,2100
60575,125161,28309,60240,20830,96851,4041,1941,2100
60580,125172,28312,60246,20832,96860,4041,1941,2100
60585,125179,28313,60249,20832,96866,4041,1941,2100
60590,125192,28314,60252,20832,96877,4042,1941,2101
60595,125203,28317,60259,20835,96885,4042,1941,2101
60600,125210,28320,60263,20837,96889,4042,1941,2101
60605,125223,28323,60270,20840,96899,4043,1941,2102
60610,125234,28326,60276,20843,96907,4043,1941,2102
60615,125241,28329,60279,20844,96911,4043,1941,2102
60620,125254,28332,60284,20846,96920,4044,1942,2102
60625,125265,28336,60288,20849,96929,4044,1942,2102
60630,125272,28338,60292,20851,96934,4044,1942,2102
60635,125285,28339,60294,20851,96946,4045,1942,2103
60640,125296,28341,60297,20852,96954,4045,1942,2103
60645,125303,28344,60302,20855,96957,4045,1942,2103
60650,125316,28347,60307,20857,96968,4046,1943,2103
60655,125327,28352,60313,20862,96974,4046,1943,2103
60660,125334,28356,60316,20865,96977,4046,1943,2103
60665,125347,28359,60323,20868,96987,4047,1943,2104
60670,125358,28364,60329,20872,96992,4047,1943,2104
60675,125365,28368,60332,20874,96995,4047,1943,2104
60680,125378,28371,60339,20876,97003,4048,1943,2105
60685,125389,28378,60345,20883,97010,4048,1943,2105
60690,125396,28381,60350,20886,97014,4048,1943,2105
60695,125409,28383,60356,20888,97024,4049,1943,2106
60700,125420,28388,60360,20892,97031,4049,1943,2106
60705,125427,28392,60363,20894,97033,4049,1943,2106
60710,125440,28396,60368,20898,97043,4050,1944,2106
60715,125451,28399,60375,20901,97052,4050,1944,2106
60720,125458,28401,60379,20902,97057,4050,1944,2106
60725,125471,28402,60387,20903,97067,4051,1944,2107
60730,125482,28404,60390,20903,97078,4051,1944,2107
60735,125489,28404,60395,20903,97085,4051,1944,2107
60740,125502,28405,60401,20904,97096,4052,1945,2107
60745,125513,28407,60405,20905,97106,4052,1945,2107
60750,125520,28407,60411,20905,97113,4052,1945,2107
60755,125533,28408,60416,20906,97125,4053,1945,2108
60760,125544,28410,60419,20907,97134,4053,1945,2108
60765,125551,28410,60422,20907,97141,4053,1945,2108
60770,125564,28411,60431,20908,97153,4054,1945,2109
60775,125575,28413,60437,20908,97162,4054,1945,2109
60780,125582,28413,60441,20908,97169,4054,1945,2109
60785,125595,28414,60448,20908,97181,4055,1945,2110
60790,125606,28416,60453,20908,97190,4055,1945,2110
60795,125613,28416,60456,20908,97197,4055,1945,2110
60800,125626,28417,60462,20909,97209,4056,1946,2110
60805,125637,28419,60470,20910,97218,4056,1946,2110
60810,125644,28419,60473,20910,97225,4056,1946,2110
60815,125657,28420,60479,20910,97237,4057,1946,2111
60820,125668,28422,60486,20912,97246,4057,1946,2111
60825,125675,28424,60488,20913,97251,4057,1946,2111
60830,125688,28425,60494,20914,97261,4058,1946,2112
60835,125699,28430,60500,20919,97269,4058,1946,2112
60840,125706,28433,60503,20920,97273,4058,1946,2112
60845,125719,28434,60510,20920,97283,4059,1947,2112
60850,125730,28438,60515,20924,97290,4059,1947,2112
60855,125737,28442,60518,20926,97293,4059,1947,2112
60860,125750,28445,60523,20929,97305,4060,1948,2112
60865,125761,28448,60528,20930,97310,4060,1948,2112
60870,125768,28454,60532,20935,97313,4060,1948,2112
60875,125781,28456,60535,20936,97323,4061,1948,2113
60880,125792,28462,60543,20942,97328,4061,1948,2113
60885,125799,28466,60545,20945,97332,4061,1948,2113
60890,125812,28469,60552,20947,97340,4062,1949,2113
60895,125823,28476,60560,20953,97344,4062,1949,2113
60900,125830,28481,60563,20956,97348,4062,1949,2113
60905,125843,28483,60572,20958,97358,4063,1950,2113
60910,125854,28486,60575,20959,97368,4063,1950,2113
60915,125861,28487,60579,20960,97373,4063,1950,2113
60920,125874,28489,60584,20962,97385,4064,1951,2113
60925,125885,28491,60592,20963,97393,4064,1951,2113
60930,125892,28493,60593,20964,97398,4064,1951,2113
60935,125905,28495,60601,20965,97409,4065,1951,2114
60940,125916,28499,60608,20968,97417,4065,1951,2114
60945,125923,28500,60610,20968,97423,4065,1951,2114
60950,125936,28501,60619,20969,97434,4066,1952,2114
60955,125947,28504,60623,20970,97442,4066,1952,2114
60960,125954,28506,60627,20972,97447,4066,1952,2114
60965,125967,28508,60635,20974,97458,4067,1953,2114
60970,125978,28510,60643,20975,97468,4067,1953,2114
60975,125985,28510,60647,20975,97475,4067,1953,2114
60980,125998,28511,60653,20976,97486,4068,1953,2115
60985,126009,28513,60659,20977,97496,4068,1953,2115
60990,126016,28513,60664,20977,97503,4068,1953,2115
60995,126029,28514,60670,20977,97515,4069,1953,2116
61000,126040,28516,60675,20979,97524,4069,1953,2116
61005,126047,28517,60678,20979,97530,4069,1953,2116
61010,126060,28518,60688,20979,97539,4070,1954,2116
61015,126071,28521,60692,20980,97549,4070,1954,2116
61020,126078,28522,60694,20981,97556,4070,1954,2116
61025,126091,28523,60699,20982,97567,4071,1954,2117
61030,126102,28527,60703,20985,97574,4071,1954,2117
61035,126109,28528,60707,20986,97581,4071,1954,2117
61040,126122,28529,60713,20986,97593,4072,1954,2118
61045,126133,28532,60717,20988,97601,4072,1954,2118
61050,126140,28533,60719,20988,97607,4072,1954,2118
61055,126153,28534,60722,20988,97619,4073,1954,2119
61060,126164,28537,60729,20990,97626,4073,1954,2119
61065,126171,28539,60731,20991,97632,4073,1954,2119
61070,126184,28540,60736,20991,97644,4074,1955,2119
61075,126195,28542,60738,20991,97652,4074,1955,2119
61080,126202,28545,60741,20994,97657,4074,1955,2119
61085,126215,28546,60747,20994,97668,4075,1955,2120
61090,126226,28550,60752,20996,97674,4075,1955,2120
61095,126233,28554,60755,20999,97679,4075,1955,2120
61100,126246,28556,60761,21000,97689,4076,1956,2120
61105,126257,28560,60766,21003,97697,4076,1956,2120
61110,126264,28562,60770,21004,97702,4076,1956,2120
61115,126277,28563,60775,21004,97714,4077,1956,2121
61120,126288,28565,60780,21006,97721,4077,1956,2121
61125,126295,28569,60785,21010,97725,4077,1956,2121
61130,126308,28572,60791,21012,97734,4078,1957,2121
61135,126319,28578,60798,21018,97739,4078,1957,2121
61140,126326,28583,60800,21021,97743,4078,1957,2121
61145,126339,28584,60806,21021,97753,4079,1957,2122
61150,126350,28590,60812,21027,97759,4079,1957,2122
61155,126357,28594,60817,21031,97763,4079,1957,2122
61160,126370,28595,60822,21032,97772,4080,1957,2123
61165,126381,28602,60829,21038,97777,4080,1957,2123
61170,126388,28604,60831,21040,97783,4080,1957,2123
61175,126401,28606,60838,21042,97792,4081,1957,2124
61180,126412,28610,60842,21045,97802,4081,1957,2124
61185,126419,28611,60844,21046,97807,4081,1957,2124
61190,126432,28613,60849,21048,97817,4082,1957,2125
61195,126443,28618,60856,21052,97822,4082,1957,2125
61200,126450,28620,60857,21054,97830,4082,1957,2125
61205,126463,28621,60864,21054,97842,4083,1957,2126
61210,126474,28623,60867,21054,97851,4083,1957,2126
61215,126481,28623,60869,21054,97858,4083,1957,2126
61220,126494,28624,60875,21054,97870,4084,1958,2126
61225,126505,28626,60881,21055,97879,4084,1958,2126
61230,126512,28626,60885,21055,97886,4084,1958,2126
61235,126525,28627,60891,21055,97898,4085,1959,2126
61240,126536,28629,60895,21055,97907,4085,1959,2126
61245,126543,28629,60900,21055,97914,4085,1959,2126
61250,126556,28630,60904,21055,97926,4086,1960,2126
61255,126567,28632,60910,21056,97935,4086,1960,2126
61260,126574,28632,60912,21056,97942,4086,1960,2126
61265,126587,28634,60921,21057,97952,4087,1961,2126
61270,126598,28637,60925,21058,97961,4087,1961,2126
61275,126605,28638,60929,21058,97967,4087,1961,2126
61280,126618,28640,60936,21059,97977,4088,1962,2126
61285,126629,28644,60942,21063,97985,4088,1962,2126
61290,126636,28645,60947,21064,97991,4088,1962,2126
61295,126649,28647,60955,21066,98002,4089,1962,2127
61300,126660,28650,60962,21068,98010,4089,1962,2127
61305,126667,28651,60965,21068,98015,4089,1962,2127
61310,126680,28654,60974,21070,98023,4090,1963,2127
61315,126691,28659,60979,21073,98029,4090,1963,2127
61320,126698,28665,60985,21078,98031,4090,1963,2127
61325,126711,28668,60991,21081,98042,4091,1963,2128
61330,126722,28672,60996,21084,98048,4091,1963,2128
61335,126729,28676,60997,21087,98053,4091,1963,2128
61340,126742,28678,61003,21088,98063,4092,1964,2128
61345,126753,28682,61010,21091,98069,4092,1964,2128
61350,126760,28685,61012,21093,98074,4092,1964,2128
61355,126773,28687,61018,21095,98085,4093,1964,2129
61360,126784,28689,61021,21095,98094,4093,1964,2129
61365,126791,28691,61025,21097,98099,4093,1964,2129
61370,126804,28693,61032,21099,98108,4094,1965,2129
61375,126815,28698,61040,21103,98114,4094,1965,2129
61380,126822,28701,61042,21105,98121,4094,1965,2129
61385,126835,28702,61047,21105,98132,4095,1966,2129
61390,126846,28706,61054,21107,98138,4095,1966,2129
61395,126853,28708,61057,21108,98145,4095,1966,2129
61400,126866,28709,61064,21109,98156,4096,1967,2129
61405,126877,28714,61070,21112,98163,4096,1967,2129
61410,126884,28714,61073,21112,98170,4096,1967,2129
61415,126897,28715,61077,21112,98182,4097,1967,2130
61420,126908,28717,61083,21113,98191,4097,1967,2130
61425,126915,28717,61088,21113,98198,4097,1967,2130
61430,126928,28718,61096,21114,98208,4098,1968,2130
61435,126939,28720,61101,21115,98218,4098,1968,2130
61440,126946,28720,61107,21115,98226,4098,1968,2130
61445,126959,28721,61110,21115,98238,4099,1968,2131
61450,126970,28723,61114,21115,98246,4099,1968,2131
61455,126977,28724,61115,21116,98253,4099,1968,2131
61460,126990,28725,61122,21117,98264,4100,1969,2131
61465,127001,28729,61127,21120,98272,4100,1969,2131
61470,127008,28730,61130,21121,98278,4100,1969,2131
61475,127021,28731,61136,21122,98290,4101,1969,2132
61480,127032,28734,61143,21125,98297,4101,1969,2132
61485,127039,28735,61148,21126,98304,4101,1969,2132
61490,127052,28737,61155,21128,98312,4102,1969,2133
61495,127063,28743,61161,21133,98319,4102,1969,2133
61500,127070,28746,61167,21136,98324,4102,1969,2133
61505,127083,28748,61176,21138,98334,4103,1970,2133
61510,127094,28751,61180,21140,98343,4103,1970,2133
61515,127101,28753,61185,21142,98348,4103,1970,2133
61520,127114,28755,61195,21144,98358,4104,1971,2133
61525,127125,28758,61199,21146,98367,4104,1971,2133
61530,127132,28760,61201,21147,98372,4104,1971,2133
61535,127145,28762,61209,21148,98382,4105,1971,2134
61540,127156,28765,61212,21151,98391,4105,1971,2134
61545,127163,28767,61216,21152,98396,4105,1971,2134
61550,127176,28769,61224,21154,98406,4106,1972,2134
61555,127187,28774,61227,21157,98413,4106,1972,2134
61560,127194,28776,61232,21159,98417,4106,1972,2134
61565,127207,28779,61240,21161,98426,4107,1972,2135
61570,127218,28783,61244,21164,98434,4107,1972,2135
61575,127225,28786,61247,21166,98439,4107,1972,2135
61580,127238,28788,61253,21168,98449,4108,1972,2136
61585,127249,28792,61259,21172,98457,4108,1972,2136
61590,127256,28794,61263,21172,98460,4108,1972,2136
61595,127269,28797,61266,21174,98472,4109,1973,2136
61600,127280,28800,61272,21175,98480,4109,1973,2136
61605,127287,28802,61275,21176,98484,4109,1973,2136
61610,127300,28804,61280,21177,98494,4110,1973,2137
61615,127311,28810,61286,21181,98500,4110,1973,2137
61620,127318,28813,61289,21183,98504,4110,1973,2137
61625,127331,28815,61300,21185,98515,4111,1973,2138
61630,127342,28819,61306,21188,98523,4111,1973,2138
61635,127349,28820,61309,21189,98529,4111,1973,2138
61640,127362,28821,61315,21190,98541,4112,1973,2139
61645,127373,28823,61319,21191,98550,4112,1973,2139
61650,127380,28824,61324,21192,98555,4112,1973,2139
61655,127393,28826,61330,21194,98567,4113,1973,2140
61660,127404,28828,61332,21195,98576,4113,1973,2140
61665,127411,28829,61337,21196,98581,4113,1973,2140
61670,127424,28831,61342,21197,98592,4114,1974,2140
61675,127435,28833,61350,21198,98600,4114,1974,2140
61680,127442,28835,61353,21199,98607,4114,1974,2140
61685,127455,28836,61360,21200,98618,4115,1975,2140
61690,127466,28838,61365,21202,98627,4115,1975,2140
61695,127473,28840,61368,21203,98633,4115,1975,2140
61700,127486,28841,61375,21203,98642,4116,1975,2141
61705,127497,28843,61380,21204,98651,4116,1975,2141
61710,127504,28844,61383,21204,98660,4116,1975,2141
61715,127517,28845,61386,21205,98670,4117,1975,2142
61720,127528,28847,61390,21205,98679,4117,1975,2142
61725,127535,28851,61394,21209,98682,4117,1975,2142
61730,127548,28854,61398,21211,98691,4118,1975,2143
61735,127559,28858,61399,21213,98700,4118,1975,2143
61740,127566,28860,61402,21214,98706,4118,1975,2143
61745,127579,28861,61409,21215,98716,4119,1976,2143
61750,127590,28865,61417,21217,98725,4119,1976,2143
61755,127597,28867,61421,21217,98730,4119,1976,2143
61760,127610,28868,61427,21218,98741,4120,1977,2143
61765,127621,28871,61436,21220,98749,4120,1977,2143
61770,127628,28874,61437,21222,98754,4120,1977,2143
61775,127641,28875,61445,21223,98765,4121,1978,2143
61780,127652,28877,61451,21224,98774,4121,1978,2143
61785,127659,28880,61456,21227,98779,4121,1978,2143
61790,127672,28881,61460,21227,98790,4122,1979,2143
61795,127683,28884,61467,21230,98799,4122,1979,2143
61800,127690,28886,61469,21231,98804,4122,1979,2143
61805,127703,28887,61474,21232,98815,4123,1979,2144
61810,127714,28889,61478,21232,98825,4123,1979,2144
61815,127721,28891,61483,21234,98830,4123,1979,2144
61820,127734,28892,61486,21234,98841,4124,1979,2145
61825,127745,28894,61492,21235,98850,4124,1979,2145
61830,127752,28897,61497,21238,98855,4124,1979,2145
61835,127765,28898,61502,21238,98866,4125,1979,2146
61840,127776,28901,61508,21241,98875,4125,1979,2146
61845,127783,28903,61512,21243,98880,4125,1979,2146
61850,127796,28904,61517,21244,98891,4126,1980,2146
61855,127807,28907,61522,21247,98898,4126,1980,2146
61860,127814,28911,61525,21251,98903,4126,1980,2146
61865,127827,28912,61530,21252,98911,4127,1980,2147
61870,127838,28918,61538,21257,98917,4127,1980,2147
61875,127845,28924,61542,21262,98921,4127,1980,2147
61880,127858,28926,61548,21263,98928,4128,1980,2148
61885,127869,28931,61551,21266,98937,4128,1980,2148
61890,127876,28933,61554,21268,98942,4128,1980,2148
61895,127889,28934,61558,21268,98953,4129,1980,2149
61900,127900,28936,61559,21268,98964,4129,1980,2149
61905,127907,28937,61562,21268,98970,4129,1980,2149
61910,127920,28938,61570,21269,98979,4130,1981,2149
61915,127931,28940,61575,21270,98989,4130,1981,2149
61920,127938,28942,61578,21271,98996,4130,1981,2149
61925,127951,28943,61584,21272,99006,4131,1981,2150
61930,127962,28945,61589,21273,99016,4131,1981,2150
61935,127969,28947,61591,21275,99022,4131,1981,2150
61940,127982,28948,61597,21275,99032,4132,1982,2150
61945,127993,28950,61602,21277,99042,4132,1982,2150
61950,128000,28952,61607,21279,99048,4132,1982,2150
61955,128013,28953,61612,21280,99060,4133,1982,2151
61960,128024,28955,61619,21281,99069,4133,1982,2151
61965,128031,28956,61621,21281,99075,4133,1982,2151
61970,128044,28957,61630,21282,99087,4134,1983,2151
61975,128055,28959,61635,21282,99095,4134,1983,2151
61980,128062,28961,61638,21284,99101,4134,1983,2151
61985,128075,28962,61644,21284,99112,4135,1983,2152
61990,128086,28964,61649,21285,99121,4135,1983,2152
61995,128093,28967,61653,21287,99126,4135,1983,2152
62000,128106,28968,61657,21288,99137,4136,1984,2152
62005,128117,28971,61663,21290,99146,4136,1984,2152
62010,128124,28973,61667,21292,99151,4136,1984,2152
62015,128137,28974,61674,21293,99162,4137,1985,2152
62020,128148,28976,61678,21293,99171,4137,1985,2152
62025,128155,28979,61682,21294,99176,4137,1985,2152
62030,128168,28980,61687,21295,99187,4138,1985,2153
62035,128179,28984,61695,21299,99193,4138,1985,2153
62040,128186,28988,61697,21302,99198,4138,1985,2153
62045,128199,28989,61700,21302,99210,4139,1986,2153
62050,128210,28991,61704,21303,99218,4139,1986,2153
62055,128217,28994,61708,21305,99222,4139,1986,2153
62060,128230,28997,61711,21307,99231,4140,1986,2154
62065,128241,29001,61717,21311,99237,4140,1986,2154
62070,128248,29007,61722,21316,99239,4140,1986,2154
62075,128261,29010,61728,21318,99249,4141,1987,2154
62080,128272,29014,61735,21321,99254,4141,1987,2154
62085,128279,29020,61738,21326,99258,4141,1987,2154
62090,128292,29023,61747,21329,99266,4142,1987,2155
62095,128303,29025,61751,21330,99277,4142,1987,2155
62100,128310,29027,61755,21331,99283,4142,1987,2155
62105,128323,29028,61762,21332,99293,4143,1988,2155
62110,128334,29030,61768,21332,99304,4143,1988,2155
62115,128341,29031,61769,21332,99310,4143,1988,2155
62120,128354,29032,61775,21333,99322,4144,1988,2156
62125,128365,29034,61780,21333,99330,4144,1988,2156
62130,128372,29036,61782,21335,99336,4144,1988,2156
62135,128385,29037,61787,21336,99347,4145,1988,2157
62140,128396,29039,61793,21337,99356,4145,1988,2157
62145,128403,29041,61796,21339,99362,4145,1988,2157
62150,128416,29042,61805,21340,99373,4146,1988,2158
62155,128427,29044,61809,21342,99383,4146,1988,2158
62160,128434,29045,61812,21343,99389,4146,1988,2158
62165,128447,29046,61818,21343,99401,4147,1988,2159
62170,128458,29048,61824,21344,99410,4147,1988,2159
62175,128465,29049,61829,21345,99416,4147,1988,2159
62180,128478,29050,61836,21346,99427,4148,1988,2160
62185,128489,29052,61840,21347,99437,4148,1988,2160
62190,128496,29053,61844,21347,99443,4148,1988,2160
62195,128509,29054,61849,21347,99454,4149,1989,2160
62200,128520,29056,61852,21348,99463,4149,1989,2160
62205,128527,29059,61858,21350,99468,4149,1989,2160
62210,128540,29061,61866,21352,99478,4150,1990,2160
62215,128551,29064,61870,21353,99486,4150,1990,2160
62220,128558,29067,61873,21354,99490,4150,1990,2160
62225,128571,29069,61878,21355,99501,4151,1991,2160
62230,128582,29072,61885,21358,99508,4151,1991,2160
62235,128589,29076,61887,21360,99513,4151,1991,2160
62240,128602,29077,61893,21360,99523,4152,1992,2160
62245,128613,29082,61902,21365,99529,4152,1992,2160
62250,128620,29087,61905,21369,99533,4152,1992,2160
62255,128633,29088,61910,21370,99543,4153,1992,2161
62260,128644,29092,61914,21373,99550,4153,1992,2161
62265,128651,29096,61916,21375,99555,4153,1992,2161
62270,128664,29097,61922,21375,99563,4154,1992,2162
62275,128675,29104,61926,21381,99571,4154,1992,2162
62280,128682,29106,61929,21382,99576,4154,1992,2162
62285,128695,29107,61937,21383,99587,4155,1992,2163
62290,128706,29110,61941,21385,99595,4155,1992,2163
62295,128713,29113,61944,21387,99600,4155,1992,2163
62300,128726,29114,61949,21387,99611,4156,1992,2164
62305,128737,29117,61954,21390,99619,4156,1992,2164
62310,128744,29120,61957,21392,99624,4156,1992,2164
62315,128757,29121,61964,21393,99636,4157,1992,2165
62320,128768,29124,61969,21395,99643,4157,1992,2165
62325,128775,29127,61973,21398,99648,4157,1992,2165
62330,128788,29128,61980,21399,99657,4158,1993,2165
62335,128799,29132,61985,21402,99665,4158,1993,2165
62340,128806,29135,61987,21404,99670,4158,1993,2165
62345,128819,29136,61995,21404,99680,4159,1993,2166
62350,128830,29138,62000,21405,99691,4159,1993,2166
62355,128837,29139,62002,21405,99698,4159,1993,2166
62360,128850,29140,62009,21405,99708,4160,1994,2166
62365,128861,29142,62013,21406,99719,4160,1994,2166
62370,128868,29143,62015,21407,99725,4160,1994,2166
62375,128881,29144,62024,21408,99736,4161,1994,2167
62380,128892,29146,62032,21410,99745,4161,1994,2167
62385,128899,29148,62037,21412,99751,4161,1994,2167
62390,128912,29149,62045,21413,99762,4162,1994,2168
62395,128923,29151,62046,21413,99772,4162,1994,2168
62400,128930,29152,62048,21413,99778,4162,1994,2168
62405,128943,29153,62058,21414,99790,4163,1995,2168
62410,128954,29155,62065,21415,99798,4163,1995,2168
62415,128961,29157,62068,21417,99804,4163,1995,2168
62420,128974,29158,62074,21417,99816,4164,1996,2168
62425,128985,29160,62079,21419,99825,4164,1996,2168
62430,128992,29161,62080,21419,99831,4164,1996,2168
62435,129005,29162,62086,21419,99843,4165,1997,2168
62440,129016,29164,62090,21419,99851,4165,1997,2168
62445,129023,29167,62095,21421,99856,4165,1997,2168
62450,129036,29169,62104,21423,99866,4166,1997,2169
62455,129047,29172,62108,21425,99875,4166,1997,2169
62460,129054,29174,62111,21426,99880,4166,1997,2169
62465,129067,29176,62118,21428,99889,4167,1997,2170
62470,129078,29181,62125,21431,99895,4167,1997,2170
62475,129085,29185,62128,21433,99899,4167,1997,2170
62480,129098,29188,62137,21434,99904,4168,1998,2170
62485,129109,29195,62142,21438,99910,4168,1998,2170
62490,129116,29202,62147,21445,99914,4168,1998,2170
62495,129129,29204,62152,21446,99922,4169,1998,2171
62500,129140,29209,62158,21449,99930,4169,1998,2171
62505,129147,29212,62160,21450,99935,4169,1998,2171
62510,129160,29214,62161,21450,99944,4170,1998,2172
62515,129171,29218,62165,21450,99953,4170,1998,2172
62520,129178,29219,62171,21450,99959,4170,1998,2172
62525,129191,29221,62179,21451,99967,4171,1999,2172
62530,129202,29225,62182,21453,99977,4171,1999,2172
62535,129209,29226,62184,21453,99983,4171,1999,2172
62540,129222,29228,62191,21454,99991,4172,1999,2173
62545,129233,29232,62194,21457,100001,4172,1999,2173
62550,129240,29233,62196,21457,100007,4172,1999,2173
62555,129253,29235,62203,21458,100016,4173,2000,2173
62560,129264,29240,62207,21459,100023,4173,2000,2173
62565,129271,29242,62211,21461,100029,4173,2000,2173
62570,129284,29244,62221,21462,100037,4174,2001,2173
62575,129295,29249,62227,21465,100046,4174,2001,2173
62580,129302,29250,62229,21465,100052,4174,2001,2173
62585,129315,29252,62235,21465,100061,4175,2002,2173
62590,129326,29256,62238,21468,100070,4175,2002,2173
62595,129333,29257,62240,21468,100076,4175,2002,2173
62600,129346,29258,62244,21469,100086,4176,2002,2174
62605,129357,29262,62248,21472,100094,4176,2002,2174
62610,129364,29264,62250,21473,100100,4176,2002,2174
62615,129377,29265,62255,21473,100109,4177,2003,2174
62620,129388,29269,62259,21476,100118,4177,2003,2174
62625,129395,29271,62262,21478,100124,4177,2003,2174
62630,129408,29273,62272,21480,100133,4178,2004,2174
62635,129419,29276,62277,21481,100141,4178,2004,2174
62640,129426,29279,62282,21483,100147,4178,2004,2174
62645,129439,29281,62290,21484,100155,4179,2005,2174
62650,129450,29286,62296,21486,100164,4179,2005,2174
62655,129457,29287,62299,21486,100170,4179,2005,2174
62660,129470,29289,62306,21487,100179,4180,2006,2174
62665,129481,29293,62311,21491,100188,4180,2006,2174
62670,129488,29294,62313,21491,100194,4180,2006,2174
62675,129501,29295,62319,21492,100203,4181,2006,2175
62680,129512,29298,62321,21493,100213,4181,2006,2175
62685,129519,29300,62324,21494,100219,4181,2006,2175
62690,129532,29301,62327,21494,100227,4182,2006,2176
62695,129543,29306,62334,21497,100234,4182,2006,2176
62700,129550,29311,62339,21502,100238,4182,2006,2176
62705,129563,29313,62345,21503,100246,4183,2006,2177
62710,129574,29319,62349,21507,100253,4183,2006,2177
62715,129581,29323,62351,21510,100258,4183,2006,2177
62720,129594,29324,62357,21511,100267,4184,2007,2177
62725,129605,29329,62365,21514,100272,4184,2007,2177
62730,129612,29335,62367,21519,100277,4184,2007,2177
62735,129625,29336,62372,21519,100285,4185,2007,2178
62740,129636,29343,62377,21523,100291,4185,2007,2178
62745,129643,29346,62380,21525,100297,4185,2007,2178
62750,129656,29348,62384,21526,100307,4186,2007,2179
62755,129667,29352,62392,21528,100314,4186,2007,2179
62760,129674,29354,62398,21529,100320,4186,2007,2179
62765,129687,29355,62402,21529,100331,4187,2007,2180
62770,129698,29359,62410,21532,100339,4187,2007,2180
62775,129705,29360,62415,21533,100345,4187,2007,2180
62780,129718,29361,62423,21534,100356,4188,2007,2181
62785,129729,29363,62425,21534,100365,4188,2007,2181
62790,129736,29365,62428,21536,100371,4188,2007,2181
62795,129749,29367,62434,21537,100381,4189,2007,2182
62800,129760,29371,62439,21539,100388,4189,2007,2182
62805,129767,29373,62441,21540,100394,4189,2007,2182
62810,129780,29375,62450,21542,100404,4190,2008,2182
62815,129791,29378,62457,21544,100412,4190,2008,2182
62820,129798,29380,62462,21546,100418,4190,2008,2182
62825,129811,29381,62465,21546,100429,4191,2009,2182
62830,129822,29383,62469,21548,100438,4191,2009,2182
62835,129829,29385,62473,21549,100444,4191,2009,2182
62840,129842,29386,62479,21550,100455,4192,2010,2182
62845,129853,29389,62485,21551,100464,4192,2010,2182
62850,129860,29390,62488,21552,100470,4192,2010,2182
62855,129873,29391,62496,21552,100477,4193,2011,2182
62860,129884,29398,62503,21557,100482,4193,2011,2182
62865,129891,29403,62505,21561,100488,4193,2011,2182
62870,129904,29404,62511,21562,100496,4194,2012,2182
62875,129915,29409,62515,21565,100503,4194,2012,2182
62880,129922,29414,62521,21570,100507,4194,2012,2182
62885,129935,29417,62528,21573,100515,4195,2013,2182
62890,129946,29423,62536,21579,100519,4195,2013,2182
62895,129953,29428,62540,21584,100525,4195,2013,2182
62900,129966,29429,62546,21585,100534,4196,2013,2183
62905,129977,29431,62552,21586,100545,4196,2013,2183
62910,129984,29433,62555,21587,100551,4196,2013,2183
62915,129997,29435,62561,21588,100561,4197,2013,2184
62920,130008,29437,62570,21589,100570,4197,2013,2184
62925,130015,29439,62573,21591,100576,4197,2013,2184
62930,130028,29441,62581,21593,100585,4198,2013,2185
62935,130039,29445,62591,21596,100593,4198,2013,2185
62940,130046,29447,62593,21597,100599,4198,2013,2185
62945,130059,29448,62600,21597,100608,4199,2013,2186
62950,130070,29453,62604,21601,100616,4199,2013,2186
62955,130077,29455,62609,21603,100622,4199,2013,2186
62960,130090,29457,62616,21604,100632,4200,2014,2186
62965,130101,29461,62622,21607,100640,4200,2014,2186
62970,130108,29462,62625,21608,100646,4200,2014,2186
62975,130121,29463,62631,21608,100657,4201,2015,2186
62980,130132,29465,62634,21610,100667,4201,2015,2186
62985,130139,29466,62638,21611,100673,4201,2015,2186
62990,130152,29468,62644,21613,100682,4202,2015,2187
62995,130163,29470,62649,21615,100692,4202,2015,2187
63000,130170,29472,62652,21617,100698,4202,2015,2187
63005,130183,29473,62659,21617,100708,4203,2016,2187
63010,130194,29478,62663,21621,100716,4203,2016,2187
63015,130201,29480,62669,21623,100721,4203,2016,2187
63020,130214,29483,62676,21625,100730,4204,2017,2187
63025,130225,29487,62684,21629,100738,4204,2017,2187
63030,130232,29488,62687,21629,100744,4204,2017,2187
63035,130245,29489,62690,21629,100756,4205,2017,2188
63040,130256,29492,62694,21631,100763,4205,2017,2188
63045,130263,29494,62699,21633,100769,4205,2017,2188
63050,130276,29497,62707,21636,100777,4206,2018,2188
63055,130287,29503,62716,21642,100783,4206,2018,2188
63060,130294,29505,62717,21643,100789,4206,2018,2188
63065,130307,29509,62724,21646,100796,4207,2018,2189
63070,130318,29512,62728,21649,100804,4207,2018,2189
63075,130325,29515,62731,21651,100810,4207,2018,2189
63080,130338,29518,62738,21653,100819,4208,2019,2189
63085,130349,29522,62745,21657,100825,4208,2019,2189
63090,130356,29525,62748,21659,100831,4208,2019,2189
63095,130369,29527,62756,21660,100840,4209,2020,2189
63100,130380,29532,62758,21664,100848,4209,2020,2189
63105,130387,29534,62763,21666,100852,4209,2020,2189
63110,130400,29536,62768,21668,100861,4210,2020,2190
63115,130411,29540,62770,21671,100871,4210,2020,2190
63120,130418,29541,62775,21672,100875,4210,2020,2190
63125,130431,29542,62778,21673,100889,4211,2021,2190
63130,130442,29542,62784,21673,100898,4211,2021,2190
63135,130449,29543,62789,21674,100905,4211,2021,2190
63140,130462,29544,62794,21675,100917,4212,2021,2191
63145,130473,29545,62801,21676,100926,4212,2021,2191
63150,130480,29547,62803,21677,100931,4212,2021,2191
63155,130493,29548,62809,21677,100943,4213,2021,2192
63160,130504,29550,62816,21679,100952,4213,2021,2192
63165,130511,29552,62821,21681,100957,4213,2021,2192
63170,130524,29554,62828,21682,100969,4214,2022,2192
63175,130535,29554,62832,21682,100980,4214,2022,2192
63180,130542,29556,62835,21683,100984,4214,2022,2192
63185,130555,29558,62841,21685,100996,4215,2023,2192
63190,130566,29559,62843,21686,101007,4215,2023,2192
63195,130573,29560,62847,21686,101012,4215,2023,2192
63200,130586,29562,62852,21687,101024,4216,2023,2193
63205,130597,29563,62859,21688,101031,4216,2023,2193
63210,130604,29565,62863,21690,101039,4216,2023,2193
63215,130617,29566,62869,21690,101050,4217,2023,2194
63220,130628,29567,62874,21691,101060,4217,2023,2194
63225,130635,29570,62878,21694,101065,4217,2023,2194
63230,130648,29572,62884,21695,101073,4218,2024,2194
63235,130659,29575,62888,21697,101081,4218,2024,2194
63240,130666,29579,62891,21700,101086,4218,2024,2194
63245,130679,29582,62898,21702,101094,4219,2025,2194
63250,130690,29585,62902,21704,101105,4219,2025,2194
63255,130697,29586,62908,21705,101111,4219,2025,2194
63260,130710,29587,62915,21706,101121,4220,2025,2195
63265,130721,29590,62924,21708,101130,4220,2025,2195
63270,130728,29592,62925,21709,101136,4220,2025,2195
63275,130741,29594,62932,21710,101145,4221,2026,2195
63280,130752,29598,62938,21714,101154,4221,2026,2195
63285,130759,29599,62943,21715,101160,4221,2026,2195
63290,130772,29600,62950,21716,101171,4222,2027,2195
63295,130783,29602,62954,21718,101181,4222,2027,2195
63300,130790,29603,62957,21718,101187,4222,2027,2195
63305,130803,29605,62964,21720,101197,4223,2028,2195
63310,130814,29607,62970,21722,101207,4223,2028,2195
63315,130821,29608,62975,21723,101213,4223,2028,2195
63320,130834,29609,62979,21724,101224,4224,2028,2196
63325,130845,29612,62986,21726,101232,4224,2028,2196
63330,130852,29614,62989,21728,101238,4224,2028,2196
63335,130865,29615,62995,21729,101250,4225,2029,2196
63340,130876,29616,63002,21730,101260,4225,2029,2196
63345,130883,29617,63006,21731,101266,4225,2029,2196
63350,130896,29621,63012,21735,101274,4226,2029,2197
63355,130907,29625,63019,21738,101280,4226,2029,2197
63360,130914,29629,63025,21742,101285,4226,2029,2197
63365,130927,29631,63030,21743,101294,4227,2029,2198
63370,130938,29633,63036,21745,101304,4227,2029,2198
63375,130945,29635,63042,21747,101310,4227,2029,2198
63380,130958,29637,63048,21749,101321,4228,2029,2199
63385,130969,29638,63056,21750,101329,4228,2029,2199
63390,130976,29640,63058,21751,101336,4228,2029,2199
63395,130989,29642,63067,21753,101346,4229,2030,2199
63400,131000,29642,63071,21753,101357,4229,2030,2199
63405,131007,29643,63073,21753,101364,4229,2030,2199
63410,131020,29645,63078,21754,101374,4230,2031,2199
63415,131031,29645,63084,21754,101384,4230,2031,2199
63420,131038,29647,63088,21755,101389,4230,2031,2199
63425,131051,29649,63093,21756,101401,4231,2032,2199
63430,131062,29650,63096,21757,101412,4231,2032,2199
63435,131069,29651,63102,21758,101418,4231,2032,2199
63440,131082,29652,63103,21759,101430,4232,2032,2200
63445,131093,29653,63108,21760,101440,4232,2032,2200
63450,131100,29654,63112,21760,101446,4232,2032,2200
63455,131113,29655,63121,21761,101457,4233,2033,2200
63460,131124,29656,63128,21762,101467,4233,2033,2200
63465,131131,29658,63133,21763,101473,4233,2033,2200
63470,131144,29660,63139,21764,101483,4234,2033,2201
63475,131155,29662,63145,21766,101492,4234,2033,2201
63480,131162,29664,63151,21768,101498,4234,2033,2201
63485,131175,29667,63158,21771,101506,4235,2033,2202
63490,131186,29669,63163,21772,101516,4235,2033,2202
63495,131193,29671,63165,21774,101522,4235,2033,2202
63500,131206,29673,63173,21775,101532,4236,2034,2202
63505,131217,29675,63178,21776,101541,4236,2034,2202
63510,131224,29677,63183,21778,101547,4236,2034,2202
63515,131237,29680,63193,21781,101555,4237,2034,2203
63520,131248,29683,63200,21784,101564,4237,2034,2203
63525,131255,29685,63201,21785,101570,4237,2034,2203
63530,131268,29688,63206,21788,101580,4238,2034,2204
63535,131279,29690,63212,21790,101587,4238,2034,2204
63540,131286,29694,63215,21794,101592,4238,2034,2204
63545,131299,29697,63219,21796,101602,4239,2035,2204
63550,131310,29701,63226,21799,101608,4239,2035,2204
63555,131317,29704,63231,21802,101612,4239,2035,2204
63560,131330,29706,63234,21803,101623,4240,2035,2205
63565,131341,29709,63239,21805,101631,4240,2035,2205
63570,131348,29711,63240,21806,101637,4240,2035,2205
63575,131361,29714,63245,21808,101645,4241,2035,2206
63580,131372,29716,63252,21810,101654,4241,2035,2206
63585,131379,29718,63253,21811,101661,4241,2035,2206
63590,131392,29720,63259,21812,101671,4242,2035,2207
63595,131403,29720,63263,21812,101682,4242,2035,2207
63600,131410,29721,63268,21813,101687,4242,2035,2207
63605,131423,29723,63275,21814,101700,4243,2035,2208
63610,131434,29724,63284,21815,101709,4243,2035,2208
63615,131441,29726,63289,21816,101715,4243,2035,2208
63620,131454,29727,63293,21816,101727,4244,2035,2209
63625,131465,29727,63295,21816,101738,4244,2035,2209
63630,131472,29728,63298,21817,101744,4244,2035,2209
63635,131485,29730,63304,21819,101754,4245,2036,2209
63640,131496,29730,63308,21819,101766,4245,2036,2209
63645,131503,29731,63310,21820,101772,4245,2036,2209
63650,131516,29732,63314,21820,101783,4246,2036,2210
63655,131527,29733,63320,21821,101794,4246,2036,2210
63660,131534,29734,63326,21822,101800,4246,2036,2210
63665,131547,29735,63331,21822,101812,4247,2036,2211
63670,131558,29735,63334,21822,101823,4247,2036,2211
63675,131565,29736,63340,21823,101829,4247,2036,2211
63680,131578,29738,63349,21825,101840,4248,2036,2212
63685,131589,29738,63352,21825,101851,4248,2036,2212
63690,131596,29739,63355,21825,101857,4248,2036,2212
63695,131609,29741,63359,21826,101867,4249,2036,2213
63700,131620,29744,63363,21828,101876,4249,2036,2213
63705,131627,29746,63368,21829,101881,4249,2036,2213
63710,131640,29748,63370,21830,101891,4250,2036,2214
63715,131651,29751,63377,21832,101898,4250,2036,2214
63720,131658,29755,63382,21836,101903,4250,2036,2214
63725,131671,29759,63391,21840,101909,4251,2036,2215
63730,131682,29763,63394,21843,101917,4251,2036,2215
63735,131689,29767,63396,21846,101922,4251,2036,2215
63740,131702,29771,63404,21849,101929,4252,2037,2215
63745,131713,29775,63407,21852,101937,4252,2037,2215
63750,131720,29777,63410,21853,101943,4252,2037,2215
63755,131733,29778,63417,21854,101954,4253,2038,2215
63760,131744,29779,63421,21855,101965,4253,2038,2215
63765,131751,29780,63425,21855,101971,4253,2038,2215
63770,131764,29782,63433,21857,101981,4254,2039,2215
63775,131775,29782,63439,21857,101991,4254,2039,2215
63780,131782,29784,63444,21859,101996,4254,2039,2215
63785,131795,29785,63452,21860,102009,4255,2040,2215
63790,131806,29785,63457,21860,102020,4255,2040,2215
63795,131813,29787,63462,21862,102026,4255,2040,2215
63800,131826,29789,63466,21863,102036,4256,2040,2216
63805,131837,29789,63470,21863,102048,4256,2040,2216
63810,131844,29790,63474,21863,102054,4256,2040,2216
63815,131857,29791,63479,21864,102065,4257,2040,2217
63820,131868,29792,63487,21865,102075,4257,2040,2217
63825,131875,29794,63491,21866,102081,4257,2040,2217
63830,131888,29795,63499,21867,102092,4258,2040,2218
63835,131899,29795,63502,21867,102103,4258,2040,2218
63840,131906,29797,63505,21868,102109,4258,2040,2218
63845,131919,29798,63508,21868,102121,4259,2040,2219
63850,131930,29798,63514,21868,102132,4259,2040,2219
63855,131937,29799,63519,21869,102138,4259,2040,2219
63860,131950,29801,63527,21871,102147,4260,2040,2220
63865,131961,29803,63531,21872,102158,4260,2040,2220
63870,131968,29804,63537,21873,102164,4260,2040,2220
63875,131981,29805,63537,21873,102176,4261,2040,2221
63880,131992,29806,63543,21873,102185,4261,2040,2221
63885,131999,29808,63547,21874,102191,4261,2040,2221
63890,132012,29812,63554,21877,102197,4262,2040,2222
63895,132023,29817,63561,21881,102203,4262,2040,2222
63900,132030,29822,63565,21886,102207,4262,2040,2222
63905,132043,29824,63570,21888,102217,4263,2041,2222
63910,132054,29827,63576,21891,102224,4263,2041,2222
63915,132061,29832,63582,21896,102228,4263,2041,2222
63920,132074,29837,63590,21900,102234,4264,2041,2223
63925,132085,29840,63599,21903,102243,4264,2041,2223
63930,132092,29842,63600,21904,102250,4264,2041,2223
63935,132105,29844,63607,21906,102261,4265,2042,2223
63940,132116,29844,63612,21906,102272,4265,2042,2223
63945,132123,29845,63616,21907,102278,4265,2042,2223
63950,132136,29847,63622,21909,102289,4266,2042,2224
63955,132147,29848,63630,21910,102299,4266,2042,2224
63960,132154,29849,63634,21911,102305,4266,2042,2224
63965,132167,29850,63641,21912,102317,4267,2042,2225
63970,132178,29851,63645,21913,102327,4267,2042,2225
63975,132185,29852,63648,21914,102333,4267,2042,2225
63980,132198,29853,63652,21915,102344,4268,2042,2226
63985,132209,29854,63657,21916,102355,4268,2042,2226
63990,132216,29855,63662,21916,102361,4268,2042,2226
63995,132229,29856,63670,21917,102373,4269,2043,2226
64000,132240,29857,63676,21918,102382,4269,2043,2226
64005,132247,29859,63678,21920,102388,4269,2043,2226
64010,132260,29860,63683,21920,102400,4270,2043,2227
64015,132271,29860,63688,21920,102410,4270,2043,2227
64020,132278,29862,63691,21921,102416,4270,2043,2227
64025,132291,29864,63700,21923,102425,4271,2044,2227
64030,132302,29868,63706,21927,102434,4271,2044,2227
64035,132309,29869,63707,21927,102440,4271,2044,2227
64040,132322,29871,63713,21929,102450,4272,2044,2228
64045,132333,29873,63717,21930,102460,4272,2044,2228
64050,132340,29874,63721,21931,102466,4272,2044,2228
64055,132353,29876,63728,21933,102475,4273,2044,2229
64060,132364,29880,63733,21937,102484,4273,2044,2229
64065,132371,29881,63738,21938,102490,4273,2044,2229
64070,132384,29883,63742,21939,102501,4274,2045,2229
64075,132395,29885,63748,21940,102509,4274,2045,2229
64080,132402,29887,63750,21942,102515,4274,2045,2229
64085,132415,29889,63758,21944,102524,4275,2046,2229
64090,132426,29894,63764,21948,102531,4275,2046,2229
64095,132433,29897,63768,21951,102536,4275,2046,2229
64100,132446,29900,63773,21953,102544,4276,2046,2230
64105,132457,29904,63776,21957,102552,4276,2046,2230
64110,132464,29906,63779,21959,102557,4276,2046,2230
64115,132477,29909,63785,21962,102566,4277,2046,2231
64120,132488,29913,63790,21966,102575,4277,2046,2231
64125,132495,29914,63794,21967,102581,4277,2046,2231
64130,132508,29915,63803,21967,102592,4278,2047,2231
64135,132519,29915,63806,21967,102603,4278,2047,2231
64140,132526,29917,63812,21969,102608,4278,2047,2231
64145,132539,29918,63820,21970,102620,4279,2048,2231
64150,132550,29919,63824,21971,102631,4279,2048,2231
64155,132557,29920,63828,21972,102636,4279,2048,2231
64160,132570,29922,63832,21973,102648,4280,2048,2232
64165,132581,29923,63838,21974,102656,4280,2048,2232
64170,132588,29925,63842,21974,102662,4280,2048,2232
64175,132601,29927,63848,21976,102674,4281,2048,2233
64180,132612,29928,63854,21977,102683,4281,2048,2233
64185,132619,29930,63859,21979,102689,4281,2048,2233
64190,132632,29931,63862,21979,102700,4282,2048,2234
64195,132643,29931,63870,21979,102711,4282,2048,2234
64200,132650,29933,63872,21980,102717,4282,2048,2234
64205,132663,29935,63878,21981,102727,4283,2048,2235
64210,132674,29936,63883,21982,102737,4283,2048,2235
64215,132681,29938,63887,21983,102743,4283,2048,2235
64220,132694,29939,63892,21984,102755,4284,2048,2236
64225,132705,29939,63899,21984,102765,4284,2048,2236
64230,132712,29941,63902,21986,102771,4284,2048,2236
64235,132725,29943,63908,21988,102780,4285,2048,2237
64240,132736,29947,63913,21992,102788,4285,2048,2237
64245,132743,29949,63918,21992,102794,4285,2048,2237
64250,132756,29950,63928,21993,102803,4286,2049,2237
64255,132767,29953,63932,21995,102813,4286,2049,2237
64260,132774,29955,63934,21996,102819,4286,2049,2237
64265,132787,29956,63939,21996,102829,4287,2049,2238
64270,132798,29959,63945,21999,102838,4287,2049,2238
64275,132805,29961,63949,22001,102844,4287,2049,2238
64280,132818,29963,63956,22003,102853,4288,2049,2239
64285,132829,29966,63963,22006,102862,4288,2049,2239
64290,132836,29969,63966,22008,102867,4288,2049,2239
64295,132849,29972,63973,22011,102876,4289,2049,2240
64300,132860,29975,63980,22014,102883,4289,2049,2240
64305,132867,29978,63986,22016,102889,4289,2049,2240
64310,132880,29981,63993,22019,102897,4290,2050,2240
64315,132891,29983,63997,22021,102907,4290,2050,2240
64320,132898,29986,64000,22022,102912,4290,2050,2240
64325,132911,29989,64007,22024,102920,4291,2051,2240
64330,132922,29992,64012,22026,102928,4291,2051,2240
64335,132929,29996,64016,22028,102933,4291,2051,2240
64340,132942,29997,64022,22029,102944,4292,2052,2240
64345,132953,30000,64029,22031,102951,4292,2052,2240
64350,132960,30003,64033,22033,102957,4292,2052,2240
64355,132973,30004,64035,22033,102969,4293,2053,2240
64360,132984,30004,64040,22033,102979,4293,2053,2240
64365,132991,30006,64041,22033,102985,4293,2053,2240
64370,133004,30007,64046,22033,102997,4294,2054,2240
64375,133015,30007,64049,22033,103007,4294,2054,2240
64380,133022,30009,64053,22033,103013,4294,2054,2240
64385,133035,30010,64057,22033,103025,4295,2054,2241
64390,133046,30011,64064,22034,103033,4295,2054,2241
64395,133053,30013,64066,22034,103040,4295,2054,2241
64400,133066,30015,64074,22036,103051,4296,2054,2242
64405,133077,30015,64079,22036,103061,4296,2054,2242
64410,133084,30017,64084,22037,103067,4296,2054,2242
64415,133097,30019,64093,22038,103077,4297,2054,2243
64420,133108,30019,64099,22038,103088,4297,2054,2243
64425,133115,30021,64104,22040,103094,4297,2054,2243
64430,133128,30022,64112,22040,103105,4298,2055,2243
64435,133139,30023,64118,22041,103114,4298,2055,2243
64440,133146,30025,64122,22041,103121,4298,2055,2243
64445,133159,30026,64127,22041,103133,4299,2056,2243
64450,133170,30027,64134,22042,103142,4299,2056,2243
64455,133177,30029,64138,22044,103148,4299,2056,2243
64460,133190,30031,64145,22046,103159,4300,2056,2244
64465,133201,30032,64151,22047,103168,4300,2056,2244
64470,133208,30034,64156,22048,103174,4300,2056,2244
64475,133221,30035,64163,22049,103185,4301,2056,2245
64480,133232,30037,64168,22051,103194,4301,2056,2245
64485,133239,30039,64171,22052,103200,4301,2056,2245
64490,133252,30041,64180,22054,103208,4302,2057,2245
64495,133263,30044,64185,22057,103218,4302,2057,2245
64500,133270,30046,64189,22058,103224,4302,2057,2245
64505,133283,30047,64196,22059,103235,4303,2058,2245
64510,133294,30049,64199,22061,103244,4303,2058,2245
64515,133301,30051,64202,22062,103250,4303,2058,2245
64520,133314,30053,64207,22063,103259,4304,2058,2246
64525,133325,30055,64213,22065,103269,4304,2058,2246
64530,133332,30057,64217,22065,103275,4304,2058,2246
64535,133345,30059,64224,22066,103286,4305,2059,2246
64540,133356,30061,64231,22067,103294,4305,2059,2246
64545,133363,30063,64233,22068,103300,4305,2059,2246
64550,133376,30066,64238,22070,103309,4306,2060,2246
64555,133387,30068,64242,22071,103315,4306,2060,2246
64560,133394,30073,64244,22075,103321,4306,2060,2246
64565,133407,30076,64250,22077,103328,4307,2060,2247
64570,133418,30081,64255,22082,103334,4307,2060,2247
64575,133425,30085,64257,22084,103339,4307,2060,2247
64580,133438,30088,64262,22087,103348,4308,2061,2247
64585,133449,30094,64267,22092,103353,4308,2061,2247
64590,133456,30098,64270,22094,103357,4308,2061,2247
64595,133469,30100,64278,22096,103369,4309,2062,2247
64600,133480,30101,64281,22097,103378,4309,2062,2247
64605,133487,30103,64284,22097,103384,4309,2062,2247
64610,133500,30105,64292,22099,103393,4310,2062,2248
64615,133511,30105,64297,22099,103405,4310,2062,2248
64620,133518,30107,64301,22101,103411,4310,2062,2248
64625,133531,30108,64308,22102,103423,4311,2063,2248
64630,133542,30108,64313,22102,103433,4311,2063,2248
64635,133549,30110,64317,22103,103439,4311,2063,2248
64640,133562,30111,64322,22104,103450,4312,2063,2249
64645,133573,30112,64328,22105,103460,4312,2063,2249
64650,133580,30114,64331,22106,103466,4312,2063,2249
64655,133593,30115,64336,22107,103477,4313,2063,2250
64660,133604,30116,64342,22108,103487,4313,2063,2250
64665,133611,30118,64343,22108,103493,4313,2063,2250
64670,133624,30120,64353,22110,103504,4314,2064,2250
64675,133635,30121,64357,22111,103513,4314,2064,2250
64680,133642,30123,64361,22112,103519,4314,2064,2250
64685,133655,30125,64370,22113,103529,4315,2064,2251
64690,133666,30126,64376,22114,103539,4315,2064,2251
64695,133673,30128,64381,22116,103545,4315,2064,2251
64700,133686,30129,64383,22116,103557,4316,2065,2251
64705,133697,30131,64386,22118,103565,4316,2065,2251
64710,133704,30133,64391,22118,103571,4316,2065,2251
64715,133717,30135,64399,22119,103580,4317,2066,2251
64720,133728,30139,64405,22123,103588,4317,2066,2251
64725,133735,30142,64410,22124,103593,4317,2066,2251
64730,133748,30143,64415,22125,103603,4318,2067,2251
64735,133759,30147,64421,22129,103611,4318,2067,2251
64740,133766,30149,64423,22130,103617,4318,2067,2251
64745,133779,30151,64431,22132,103626,4319,2067,2252
64750,133790,30155,64435,22135,103633,4319,2067,2252
64755,133797,30159,64440,22139,103638,4319,2067,2252
64760,133810,30160,64446,22140,103649,4320,2068,2252
64765,133821,30164,64451,22144,103656,4320,2068,2252
64770,133828,30166,64455,22146,103662,4320,2068,2252
64775,133841,30168,64460,22147,103672,4321,2068,2253
64780,133852,30170,64463,22148,103681,4321,2068,2253
64785,133859,30172,64466,22150,103687,4321,2068,2253
64790,133872,30174,64471,22152,103696,4322,2068,2254
64795,133883,30180,64481,22158,103702,4322,2068,2254
64800,133890,30182,64482,22159,103708,4322,2068,2254
64805,133903,30185,64489,22162,103717,4323,2069,2254
64810,133914,30188,64493,22165,103724,4323,2069,2254
64815,133921,30190,64496,22165,103731,4323,2069,2254
64820,133934,30192,64504,22166,103742,4324,2070,2254
64825,133945,30192,64510,22166,103751,4324,2070,2254
64830,133952,30194,64516,22168,103758,4324,2070,2254
64835,133965,30196,64523,22170,103768,4325,2071,2254
64840,133976,30196,64525,22170,103779,4325,2071,2254
64845,133983,30198,64529,22171,103785,4325,2071,2254
64850,133996,30199,64531,22171,103797,4326,2071,2255
64855,134007,30199,64538,22171,103805,4326,2071,2255
64860,134014,30201,64542,22172,103812,4326,2071,2255
64865,134027,30202,64546,22172,103825,4327,2072,2255
64870,134038,30203,64551,22173,103834,4327,2072,2255
64875,134045,30205,64553,22173,103840,4327,2072,2255
64880,134058,30206,64563,22174,103851,4328,2073,2255
64885,134069,30206,64567,22174,103862,4328,2073,2255
64890,134076,30208,64569,22175,103868,4328,2073,2255
64895,134089,30209,64576,22176,103879,4329,2074,2255
64900,134100,30209,64580,22176,103890,4329,2074,2255
64905,134107,30211,64583,22177,103896,4329,2074,2255
64910,134120,30212,64587,22177,103907,4330,2075,2255
64915,134131,30212,64592,22177,103918,4330,2075,2255
64920,134138,30214,64596,22178,103924,4330,2075,2255
64925,134151,30215,64603,22179,103935,4331,2076,2255
64930,134162,30217,64609,22181,103944,4331,2076,2255
64935,134169,30219,64613,22181,103950,4331,2076,2255
64940,134182,30220,64616,22181,103961,4332,2076,2256
64945,134193,30221,64622,22181,103971,4332,2076,2256
64950,134200,30223,64626,22182,103977,4332,2076,2256
64955,134213,30224,64634,22183,103988,4333,2077,2256
64960,134224,30226,64639,22184,103997,4333,2077,2256
64965,134231,30228,64640,22184,104003,4333,2077,2256
64970,134244,30229,64647,22184,104014,4334,2077,2257
64975,134255,30232,64652,22186,104022,4334,2077,2257
64980,134262,30234,64656,22187,104028,4334,2077,2257
64985,134275,30236,64660,22188,104039,4335,2078,2257
64990,134286,30238,64667,22190,104046,4335,2078,2257
64995,134293,30242,64670,22193,104051,4335,2078,2257
65000,134306,30244,64674,22195,104061,4336,2078,2258
65005,134317,30247,64679,22198,104069,4336,2078,2258
65010,134324,30250,64684,22200,104074,4336,2078,2258
65015,134337,30253,64688,22202,104083,4337,2078,2259
65020,134348,30257,64694,22205,104089,4337,2078,2259
65025,134355,30260,64698,22207,104095,4337,2078,2259
65030,134368,30263,64704,22209,104103,4338,2079,2259
65035,134379,30267,64707,22212,104111,4338,2079,2259
65040,134386,30269,64710,22212,104117,4338,2079,2259
65045,134399,30271,64714,22214,104127,4339,2079,2260
65050,134410,30273,64719,22215,104135,4339,2079,2260
65055,134417,30276,64723,22217,104141,4339,2079,2260
65060,134430,30278,64729,22218,104151,4340,2080,2260
65065,134441,30281,64736,22220,104158,4340,2080,2260
65070,134448,30283,64737,22221,104165,4340,2080,2260
65075,134461,30285,64743,22222,104175,4341,2080,2261
65080,134472,30286,64747,22223,104184,4341,2080,2261
65085,134479,30288,64750,22223,104191,4341,2080,2261
65090,134492,30290,64756,22225,104202,4342,2080,2262
65095,134503,30290,64762,22225,104210,4342,2080,2262
65100,134510,30292,64765,22225,104217,4342,2080,2262
65105,134523,30293,64767,22225,104229,4343,2080,2263
65110,134534,30293,64771,22225,104240,4343,2080,2263
65115,134541,30295,64774,22225,104246,4343,2080,2263
65120,134554,30297,64780,22226,104257,4344,2081,2263
65125,134565,30297,64787,22226,104267,4344,2081,2263
65130,134572,30299,64791,22227,104273,4344,2081,2263
65135,134585,30300,64797,22227,104285,4345,2082,2263
65140,134596,30300,64802,22227,104295,4345,2082,2263
65145,134603,30302,64803,22229,104301,4345,2082,2263
65150,134616,30304,64809,22230,104312,4346,2083,2263
65155,134627,30305,64814,22231,104321,4346,2083,2263
65160,134634,30307,64818,22232,104327,4346,2083,2263
65165,134647,30308,64827,22232,104339,4347,2084,2263
65170,134658,30309,64832,22233,104348,4347,2084,2263
65175,134665,30311,64833,22234,104354,4347,2084,2263
65180,134678,30312,64837,22234,104366,4348,2085,2263
65185,134689,30313,64841,22235,104375,4348,2085,2263
65190,134696,30315,64847,22237,104381,4348,2085,2263
65195,134709,30317,64856,22239,104392,4349,2085,2264
65200,134720,30318,64861,22240,104401,4349,2085,2264
65205,134727,30320,64864,22242,104407,4349,2085,2264
65210,134740,30322,64872,22243,104417,4350,2086,2264
65215,134751,30324,64876,22245,104426,4350,2086,2264
65220,134758,30327,64880,22247,104431,4350,2086,2264
65225,134771,30330,64888,22250,104438,4351,2086,2265
65230,134782,30336,64893,22255,104445,4351,2086,2265
65235,134789,30339,64895,22256,104450,4351,2086,2265
65240,134802,30341,64903,22258,104459,4352,2087,2265
65245,134813,30344,64909,22261,104468,4352,2087,2265
65250,134820,30346,64912,22261,104474,4352,2087,2265
65255,134833,30349,64918,22263,104484,4353,2087,2266
65260,134844,30350,64922,22264,104492,4353,2087,2266
65265,134851,30353,64927,22266,104498,4353,2087,2266
65270,134864,30354,64935,22267,104506,4354,2087,2267
65275,134875,30358,64938,22270,104515,4354,2087,2267
65280,134882,30361,64942,22272,104520,4354,2087,2267
65285,134895,30364,64950,22275,104528,4355,2088,2267
65290,134906,30368,64955,22279,104536,4355,2088,2267
65295,134913,30370,64960,22280,104542,4355,2088,2267
65300,134926,30371,64964,22281,104554,4356,2088,2268
65305,134937,30372,64970,22282,104564,4356,2088,2268
65310,134944,30374,64975,22283,104568,4356,2088,2268
65315,134957,30376,64979,22284,104581,4357,2088,2269
65320,134968,30376,64985,22284,104591,4357,2088,2269
65325,134975,30378,64989,22285,104597,4357,2088,2269
65330,134988,30380,64995,22287,104608,4358,2089,2269
65335,134999,30381,65003,22288,104617,4358,2089,2269
65340,135006,30383,65004,22289,104623,4358,2089,2269
65345,135019,30384,65009,22290,104635,4359,2089,2270
65350,135030,30384,65017,22290,104645,4359,2089,2270
65355,135037,30386,65018,22291,104651,4359,2089,2270
65360,135050,30387,65026,22292,104663,4360,2090,2270
65365,135061,30388,65031,22293,104672,4360,2090,2270
65370,135068,30390,65035,22294,104678,4360,2090,2270
65375,135081,30391,65041,22294,104690,4361,2090,2271
65380,135092,30392,65047,22295,104699,4361,2090,2271
65385,135099,30394,65051,22295,104705,4361,2090,2271
65390,135112,30395,65057,22296,104716,4362,2090,2272
65395,135123,30397,65064,22298,104725,4362,2090,2272
65400,135130,30399,65066,22299,104731,4362,2090,2272
65405,135143,30400,65074,22300,104742,4363,2091,2272
65410,135154,30402,65078,22302,104751,4363,2091,2272
65415,135161,30404,65082,22302,104757,4363,2091,2272
65420,135174,30405,65085,22302,104768,4364,2092,2272
65425,135185,30408,65093,22305,104776,4364,2092,2272
65430,135192,30410,65096,22306,104781,4364,2092,2272
65435,135205,30412,65102,22308,104792,4365,2092,2273
65440,135216,30414,65106,22310,104800,4365,2092,2273
65445,135223,30417,65108,22312,104806,4365,2092,2273
65450,135236,30418,65111,22313,104817,4366,2092,2274
65455,135247,30421,65118,22315,104823,4366,2092,2274
65460,135254,30425,65122,22319,104828,4366,2092,2274
65465,135267,30428,65130,22322,104835,4367,2093,2274
65470,135278,30432,65132,22325,104843,4367,2093,2274
65475,135285,30437,65135,22329,104847,4367,2093,2274
65480,135298,30438,65143,22330,104857,4368,2093,2275
65485,135309,30441,65148,22332,104866,4368,2093,2275
65490,135316,30443,65150,22333,104873,4368,2093,2275
65495,135329,30444,65154,22333,104883,4369,2093,2276
65500,135340,30447,65162,22336,104890,4369,2093,2276
65505,135347,30449,65166,22337,104898,4369,2093,2276
65510,135360,30451,65172,22338,104907,4370,2093,2277
65515,135371,30453,65175,22340,104917,4370,2093,2277
65520,135378,30455,65178,22341,104923,4370,2093,2277
65525,135391,30457,65185,22343,104932,4371,2093,2278
65530,135402,30459,65190,22345,104942,4371,2093,2278
65535,135409,30461,65193,22346,104948,4371,2093,2278
65540,135422,30462,65202,22347,104958,4372,2094,2278
65545,135433,30465,65208,22349,104967,4372,2094,2278
65550,135440,30467,65208,22349,104973,4372,2094,2278
65555,135453,30468,65214,22350,104982,4373,2094,2279
65560,135464,30471,65218,22353,104992,4373,2094,2279
65565,135471,30473,65222,22353,104998,4373,2094,2279
65570,135484,30474,65228,22354,105010,4374,2095,2279
65575,135495,30475,65234,22355,105019,4374,2095,2279
65580,135502,30477,65237,22356,105025,4374,2095,2279
65585,135515,30480,65242,22358,105035,4375,2096,2279
65590,135526,30482,65247,22360,105043,4375,2096,2279
65595,135533,30484,65251,22361,105049,4375,2096,2279
65600,135546,30486,65260,22362,105058,4376,2097,2279
65605,135557,30489,65264,22365,105067,4376,2097,2279
65610,135564,30491,65267,22366,105073,4376,2097,2279
65615,135577,30492,65271,22366,105084,4377,2097,2280
65620,135588,30494,65275,22367,105093,4377,2097,2280
65625,135595,30497,65277,22369,105097,4377,2097,2280
65630,135608,30500,65285,22371,105105,4378,2098,2280
65635,135619,30503,65288,22374,105114,4378,2098,2280
65640,135626,30505,65292,22375,105119,4378,2098,2280
65645,135639,30507,65295,22377,105131,4379,2098,2281
65650,135650,30508,65302,22378,105141,4379,2098,2281
65655,135657,30510,65304,22379,105147,4379,2098,2281
65660,135670,30511,65310,22380,105158,4380,2098,2282
65665,135681,30511,65316,22380,105169,4380,2098,2282
65670,135688,30513,65318,22381,105175,4380,2098,2282
65675,135701,30514,65324,22382,105187,4381,2099,2282
65680,135712,30515,65333,22383,105196,4381,2099,2282
65685,135719,30517,65336,22385,105202,4381,2099,2282
65690,135732,30518,65339,22385,105213,4382,2100,2282
65695,135743,30519,65347,22386,105223,4382,2100,2282
65700,135750,30521,65351,22386,105229,4382,2100,2282
65705,135763,30522,65358,22387,105240,4383,2100,2283
65710,135774,30523,65362,22388,105250,4383,2100,2283
65715,135781,30525,65367,22390,105256,4383,2100,2283
65720,135794,30527,65375,22391,105266,4384,2101,2283
65725,135805,30528,65380,22392,105276,4384,2101,2283
65730,135812,30530,65383,22393,105282,4384,2101,2283
65735,135825,30532,65390,22394,105292,4385,2101,2284
65740,135836,30533,65398,22395,105302,4385,2101,2284
65745,135843,30535,65404,22397,105308,4385,2101,2284
65750,135856,30537,65411,22399,105316,4386,2102,2284
65755,135867,30541,65417,22403,105323,4386,2102,2284
65760,135874,30546,65422,22406,105326,4386,2102,2284
65765,135887,30550,65426,22410,105337,4387,2102,2285
65770,135898,30551,65431,22410,105346,4387,2102,2285
65775,135905,30553,65435,22411,105352,4387,2102,2285
65780,135918,30554,65443,22412,105362,4388,2102,2286
65785,135929,30557,65447,22414,105371,4388,2102,2286
65790,135936,30559,65450,22416,105377,4388,2102,2286
65795,135949,30560,65455,22416,105388,4389,2103,2286
65800,135960,30561,65460,22417,105398,4389,2103,2286
65805,135967,30563,65463,22418,105404,4389,2103,2286
65810,135980,30564,65470,22419,105414,4390,2104,2286
65815,135991,30567,65476,22421,105423,4390,2104,2286
65820,135998,30569,65482,22423,105429,4390,2104,2286
65825,136011,30571,65489,22425,105439,4391,2104,2287
65830,136022,30574,65494,22428,105447,4391,2104,2287
65835,136029,30576,65496,22428,105453,4391,2104,2287
65840,136042,30578,65504,22430,105463,4392,2104,2288
65845,136053,30580,65513,22432,105472,4392,2104,2288
65850,136060,30582,65516,22433,105478,4392,2104,2288
65855,136073,30583,65523,22433,105488,4393,2105,2288
65860,136084,30586,65526,22435,105497,4393,2105,2288
65865,136091,30588,65528,22437,105503,4393,2105,2288
65870,136104,30591,65538,22439,105511,4394,2106,2288
65875,136115,30594,65544,22442,105520,4394,2106,2288
65880,136122,30596,65547,22443,105526,4394,2106,2288
65885,136135,30598,65555,22445,105535,4395,2106,2289
65890,136146,30602,65560,22448,105543,4395,2106,2289
65895,136153,30604,65564,22450,105549,4395,2106,2289
65900,136166,30606,65569,22451,105557,4396,2106,2290
65905,136177,30611,65573,22455,105565,4396,2106,2290
65910,136184,30613,65574,22457,105571,4396,2106,2290
65915,136197,30616,65580,22460,105579,4397,2106,2291
65920,136208,30620,65585,22464,105587,4397,2106,2291
65925,136215,30622,65588,22465,105593,4397,2106,2291
65930,136228,30624,65594,22467,105602,4398,2106,2292
65935,136239,30627,65599,22469,105611,4398,2106,2292
65940,136246,30629,65604,22470,105617,4398,2106,2292
65945,136259,30631,65610,22472,105627,4399,2107,2292
65950,136270,30633,65613,22474,105636,4399,2107,2292
65955,136277,30635,65618,22475,105642,4399,2107,2292
65960,136290,30636,65624,22476,105653,4400,2107,2293
65965,136301,30637,65626,22477,105663,4400,2107,2293
65970,136308,30639,65628,22477,105669,4400,2107,2293
65975,136321,30641,65637,22479,105679,4401,2108,2293
65980,136332,30642,65645,22480,105687,4401,2108,2293
65985,136339,30644,65649,22481,105693,4401,2108,2293
65990,136352,30645,65653,22481,105707,4402,2109,2293
65995,136363,30645,65658,22481,105716,4402,2109,2293
66000,136370,30647,65661,22481,105721,4402,2109,2293
66005,136383,30649,65666,22482,105733,4403,2110,2293
66010,136394,30650,65673,22483,105743,4403,2110,2293
66015,136401,30652,65677,22484,105749,4403,2110,2293
66020,136414,30653,65683,22485,105761,4404,2110,2294
66025,136425,30654,65686,22486,105770,4404,2110,2294
66030,136432,30656,65690,22487,105776,4404,2110,2294
66035,136445,30657,65696,22488,105788,4405,2110,2295
66040,136456,30658,65700,22489,105797,4405,2110,2295
66045,136463,30660,65704,22490,105803,4405,2110,2295
66050,136476,30662,65711,22492,105813,4406,2111,2295
66055,136487,30665,65715,22495,105821,4406,2111,2295
66060,136494,30667,65719,22496,105827,4406,2111,2295
66065,136507,30669,65728,22498,105835,4407,2112,2295
66070,136518,30673,65733,22501,105844,4407,2112,2295
66075,136525,30675,65737,22502,105850,4407,2112,2295
66080,136538,30676,65741,22503,105861,4408,2112,2296
66085,136549,30679,65751,22506,105868,4408,2112,2296
66090,136556,30681,65755,22508,105875,4408,2112,2296
66095,136569,30682,65763,22509,105887,4409,2113,2296
66100,136580,30684,65769,22511,105895,4409,2113,2296
66105,136587,30686,65775,22513,105901,4409,2113,2296
66110,136600,30688,65781,22514,105910,4410,2114,2296
66115,136611,30692,65786,22517,105918,4410,2114,2296
66120,136618,30694,65790,22518,105924,4410,2114,2296
66125,136631,30695,65797,22519,105933,4411,2114,2297
66130,136642,30698,65805,22522,105943,4411,2114,2297
66135,136649,30700,65807,22524,105949,4411,2114,2297
66140,136662,30701,65808,22524,105961,4412,2114,2298
66145,136673,30703,65811,22526,105969,4412,2114,2298
66150,136680,30705,65814,22526,105975,4412,2114,2298
66155,136693,30706,65817,22526,105986,4413,2114,2299
66160,136704,30708,65823,22527,105995,4413,2114,2299
66165,136711,30710,65824,22528,106001,4413,2114,2299
66170,136724,30712,65832,22530,106011,4414,2115,2299
66175,136735,30714,65839,22531,106020,4414,2115,2299
66180,136742,30716,65846,22533,106026,4414,2115,2299
66185,136755,30718,65850,22534,106035,4415,2116,2299
66190,136766,30720,65855,22535,106045,4415,2116,2299
66195,136773,30722,65860,22536,106051,4415,2116,2299
66200,136786,30724,65868,22538,106061,4416,2117,2299
66205,136797,30725,65874,22539,106071,4416,2117,2299
66210,136804,30727,65877,22541,106077,4416,2117,2299
66215,136817,30730,65883,22543,106085,4417,2117,2300
66220,136828,30734,65891,22547,106093,4417,2117,2300
66225,136835,30736,65895,22548,106099,4417,2117,2300
66230,136848,30737,65898,22549,106111,4418,2117,2301
66235,136859,30740,65905,22552,106118,4418,2117,2301
66240,136866,30742,65910,22553,106124,4418,2117,2301
66245,136879,30746,65916,22556,106132,4419,2117,2302
66250,136890,30749,65921,22559,106140,4419,2117,2302
66255,136897,30751,65924,22561,106146,4419,2117,2302
66260,136910,30755,65936,22565,106152,4420,2117,2303
66265,136921,30759,65942,22569,106161,4420,2117,2303
66270,136928,30761,65944,22570,106167,4420,2117,2303
66275,136941,30763,65950,22571,106177,4421,2118,2303
66280,136952,30766,65955,22574,106185,4421,2118,2303
66285,136959,30768,65959,22575,106191,4421,2118,2303
66290,136972,30770,65969,22577,106199,4422,2118,2304
66295,136983,30775,65971,22581,106207,4422,2118,2304
66300,136990,30777,65974,22583,106213,4422,2118,2304
66305,137003,30778,65975,22583,106225,4423,2118,2305
66310,137014,30779,65977,22584,106234,4423,2118,2305
66315,137021,30781,65979,22585,106240,4423,2118,2305
66320,137034,30783,65985,22587,106251,4424,2119,2305
66325,137045,30783,65988,22587,106261,4424,2119,2305
66330,137052,30785,65991,22588,106267,4424,2119,2305
66335,137065,30786,65995,22588,106278,4425,2120,2305
66340,137076,30787,66002,22589,106288,4425,2120,2305
66345,137083,30789,66004,22589,106294,4425,2120,2305
66350,137096,30790,66012,22590,106306,4426,2121,2305
66355,137107,30790,66018,22590,106314,4426,2121,2305
66360,137114,30792,66019,22590,106322,4426,2121,2305
66365,137127,30793,66025,22590,106333,4427,2122,2305
66370,137138,30793,66030,22590,106342,4427,2122,2305
66375,137145,30795,66032,22590,106350,4427,2122,2305
66380,137158,30796,66037,22590,106362,4428,2122,2306
66385,137169,30797,66044,22591,106371,4428,2122,2306
66390,137176,30799,66049,22592,106377,4428,2122,2306
66395,137189,30800,66057,22592,106389,4429,2123,2306
66400,137200,30801,66062,22593,106396,4429,2123,2306
66405,137207,30804,66065,22596,106403,4429,2123,2306
66410,137220,30806,66071,22598,106413,4430,2123,2307
66415,137231,30808,66073,22600,106422,4430,2123,2307
66420,137238,30810,66076,22601,106428,4430,2123,2307
66425,137251,30812,66083,22603,106439,4431,2124,2307
66430,137262,30814,66089,22604,106445,4431,2124,2307
66435,137269,30818,66091,22608,106451,4431,2124,2307
66440,137282,30821,66095,22610,106460,4432,2124,2308
66445,137293,30824,66101,22613,106467,4432,2124,2308
66450,137300,30826,66104,22614,106474,4432,2124,2308
66455,137313,30827,66112,22615,106485,4433,2125,2308
66460,137324,30829,66116,22616,106494,4433,2125,2308
66465,137331,30831,66118,22617,106500,4433,2125,2308
66470,137344,30832,66122,22617,106510,4434,2125,2309
66475,137355,30835,66128,22620,106519,4434,2125,2309
66480,137362,30837,66132,22622,106525,4434,2125,2309
66485,137375,30839,66140,22624,106536,4435,2126,2309
66490,137386,30841,66146,22625,106544,4435,2126,2309
66495,137393,30843,66149,22626,106550,4435,2126,2309
66500,137406,30844,66156,22626,106561,4436,2126,2310
66505,137417,30846,66161,22627,106570,4436,2126,2310
66510,137424,30848,66163,22629,106576,4436,2126,2310
66515,137437,30850,66171,22631,106586,4437,2126,2311
66520,137448,30852,66176,22633,106595,4437,2126,2311
66525,137455,30854,66180,22634,106601,4437,2126,2311
66530,137468,30855,66187,22634,106612,4438,2127,2311
66535,137479,30857,66195,22636,106621,4438,2127,2311
66540,137486,30859,66200,22637,106627,4438,2127,2311
66545,137499,30860,66209,22637,106637,4439,2128,2311
66550,137510,30864,66215,22641,106645,4439,2128,2311
66555,137517,30866,66217,22643,106651,4439,2128,2311
66560,137530,30868,66219,22644,106662,4440,2128,2312
66565,137541,30869,66225,22645,106671,4440,2128,2312
66570,137548,30871,66227,22645,106677,4440,2128,2312
66575,137561,30872,66233,22646,106688,4441,2128,2313
66580,137572,30875,66238,22648,106696,4441,2128,2313
66585,137579,30877,66240,22648,106702,4441,2128,2313
66590,137592,30879,66249,22649,106711,4442,2129,2313
66595,137603,30883,66252,22652,106719,4442,2129,2313
66600,137610,30885,66255,22653,106725,4442,2129,2313
66605,137623,30887,66264,22655,106734,4443,2130,2313
66610,137634,30891,66268,22658,106742,4443,2130,2313
66615,137641,30893,66271,22658,106748,4443,2130,2313
66620,137654,30896,66276,22661,106758,4444,2130,2314
66625,137665,30897,66280,22661,106767,4444,2130,2314
66630,137672,30899,66283,22661,106773,4444,2130,2314
66635,137685,30900,66289,22662,106784,4445,2130,2315
66640,137696,30903,66295,22665,106792,4445,2130,2315
66645,137703,30905,66298,22667,106798,4445,2130,2315
66650,137716,30907,66304,22668,106807,4446,2131,2315
66655,137727,30911,66310,22672,106815,4446,2131,2315
66660,137734,30913,66314,22673,106821,4446,2131,2315
66665,137747,30916,66319,22676,106830,4447,2131,2316
66670,137758,30919,66324,22678,106838,4447,2131,2316
66675,137765,30922,66327,22680,106843,4447,2131,2316
66680,137778,30923,66333,22681,106854,4448,2132,2316
66685,137789,30927,66340,22684,106860,4448,2132,2316
66690,137796,30929,66343,22684,106867,4448,2132,2316
66695,137809,30930,66349,22684,106878,4449,2133,2316
66700,137820,30930,66352,22684,106888,4449,2133,2316
66705,137827,30932,66356,22686,106895,4449,2133,2316
66710,137840,30934,66363,22687,106906,4450,2134,2316
66715,137851,30934,66365,22687,106915,4450,2134,2316
66720,137858,30936,66368,22689,106922,4450,2134,2316
66725,137871,30937,66376,22690,106934,4451,2135,2316
66730,137882,30937,66379,22690,106944,4451,2135,2316
66735,137889,30939,66383,22690,106950,4451,2135,2316
66740,137902,30940,66387,22690,106962,4452,2136,2316
66745,137913,30940,66394,22690,106971,4452,2136,2316
66750,137920,30942,66399,22692,106978,4452,2136,2316
66755,137933,30944,66406,22693,106988,4453,2137,2316
66760,137944,30944,66412,22693,106998,4453,2137,2316
66765,137951,30946,66416,22694,107005,4453,2137,2316
66770,137964,30948,66423,22696,107016,4454,2138,2316
66775,137975,30948,66430,22696,107024,4454,2138,2316
66780,137982,30950,66433,22698,107032,4454,2138,2316
66785,137995,30951,66439,22699,107043,4455,2139,2316
66790,138006,30953,66444,22701,107052,4455,2139,2316
66795,138013,30955,66448,22702,107058,4455,2139,2316
66800,138026,30957,66455,22704,107068,4456,2139,2317
66805,138037,30960,66460,22706,107076,4456,2139,2317
66810,138044,30962,66464,22708,107082,4456,2139,2317
66815,138057,30965,66473,22711,107089,4457,2139,2318
66820,138068,30970,66480,22715,107097,4457,2139,2318
66825,138075,30972,66484,22717,107103,4457,2139,2318
66830,138088,30974,66487,22718,107112,4458,2139,2319
66835,138099,30977,66494,22720,107121,4458,2139,2319
66840,138106,30979,66499,22721,107127,4458,2139,2319
66845,138119,30981,66503,22722,107136,4459,2139,2320
66850,138130,30983,66508,22723,107146,4459,2139,2320
66855,138137,30985,66510,22723,107152,4459,2139,2320
66860,138150,30986,66515,22724,107163,4460,2139,2321
66865,138161,30989,66522,22727,107171,4460,2139,2321
66870,138168,30991,66525,22728,107177,4460,2139,2321
66875,138181,30992,66531,22728,107188,4461,2139,2322
66880,138192,30994,66537,22730,107197,4461,2139,2322
66885,138199,30996,66542,22730,107203,4461,2139,2322
66890,138212,30998,66547,22731,107213,4462,2140,2322
66895,138223,30999,66550,22731,107223,4462,2140,2322
66900,138230,31001,66553,22732,107229,4462,2140,2322
66905,138243,31002,66555,22732,107240,4463,2140,2323
66910,138254,31005,66563,22735,107248,4463,2140,2323
66915,138261,31007,66568,22737,107254,4463,2140,2323
66920,138274,31009,66575,22738,107264,4464,2141,2323
66925,138285,31013,66581,22742,107271,4464,2141,2323
66930,138292,31015,66583,22743,107277,4464,2141,2323
66935,138305,31018,66592,22745,107286,4465,2142,2323
66940,138316,31022,66600,22749,107293,4465,2142,2323
66945,138323,31024,66603,22749,107299,4465,2142,2323
66950,138336,31026,66609,22751,107310,4466,2143,2323
66955,138347,31027,66612,22751,107319,4466,2143,2323
66960,138354,31029,66616,22752,107325,4466,2143,2323
66965,138367,31031,66626,22754,107335,4467,2144,2323
66970,138378,31035,66634,22758,107342,4467,2144,2323
66975,138385,31037,66635,22758,107348,4467,2144,2323
66980,138398,31038,66641,22758,107358,4468,2144,2324
66985,138409,31041,66645,22761,107367,4468,2144,2324
66990,138416,31043,66652,22762,107373,4468,2144,2324
66995,138429,31044,66655,22762,107385,4469,2144,2325
67000,138440,31045,66661,22763,107394,4469,2144,2325
67005,138447,31047,66664,22764,107400,4469,2144,2325
67010,138460,31049,66671,22766,107410,4470,2145,2325
67015,138471,31051,66675,22767,107419,4470,2145,2325
67020,138478,31053,66677,22767,107425,4470,2145,2325
67025,138491,31055,66684,22769,107435,4471,2145,2326
67030,138502,31058,66689,22772,107443,4471,2145,2326
67035,138509,31060,66692,22772,107449,4471,2145,2326
67040,138522,31061,66696,22772,107461,4472,2146,2326
67045,138533,31062,66704,22772,107470,4472,2146,2326
67050,138540,31064,66704,22773,107476,4472,2146,2326
67055,138553,31066,66713,22775,107486,4473,2147,2326
67060,138564,31068,66717,22776,107495,4473,2147,2326
67065,138571,31070,66721,22777,107501,4473,2147,2326
67070,138584,31072,66727,22779,107512,4474,2147,2327
67075,138595,31075,66733,22781,107519,4474,2147,2327
67080,138602,31077,66735,22783,107525,4474,2147,2327
67085,138615,31079,66740,22785,107536,4475,2148,2327
67090,138626,31080,66744,22786,107545,4475,2148,2327
67095,138633,31082,66747,22786,107551,4475,2148,2327
67100,138646,31083,66755,22786,107562,4476,2149,2327
67105,138657,31085,66759,22787,107571,4476,2149,2327
67110,138664,31087,66763,22788,107577,4476,2149,2327
67115,138677,31088,66769,22788,107588,4477,2150,2327
67120,138688,31091,66773,22791,107596,4477,2150,2327
67125,138695,31093,66775,22792,107602,4477,2150,2327
67130,138708,31095,66780,22793,107613,4478,2150,2328
67135,138719,31097,66787,22794,107621,4478,2150,2328
67140,138726,31099,66791,22795,107627,4478,2150,2328
67145,138739,31102,66797,22798,107637,4479,2151,2328
67150,138750,31103,66804,22798,107646,4479,2151,2328
67155,138757,31105,66808,22800,107652,4479,2151,2328
67160,138770,31107,66811,22801,107663,4480,2151,2329
67165,138781,31109,66814,22802,107671,4480,2151,2329
67170,138788,31111,66817,22802,107677,4480,2151,2329
67175,138801,31112,66823,22803,107688,4481,2151,2330
67180,138812,31114,66827,22805,107697,4481,2151,2330
67185,138819,31116,66832,22807,107703,4481,2151,2330
67190,138832,31117,66837,22808,107714,4482,2151,2331
67195,138843,31119,66843,22809,107723,4482,2151,2331
67200,138850,31121,66848,22810,107729,4482,2151,2331
67205,138863,31123,66850,22811,107740,4483,2151,2332
67210,138874,31124,66855,22812,107749,4483,2151,2332
67215,138881,31126,66859,22814,107755,4483,2151,2332
67220,138894,31128,66867,22816,107766,4484,2152,2332
67225,138905,31130,66873,22818,107774,4484,2152,2332
67230,138912,31132,66878,22819,107780,4484,2152,2332
67235,138925,31133,66888,22820,107791,4485,2152,2333
67240,138936,31135,66893,22822,107800,4485,2152,2333
67245,138943,31137,66895,22823,107806,4485,2152,2333
67250,138956,31139,66900,22824,107816,4486,2152,2334
67255,138967,31142,66907,22827,107824,4486,2152,2334
67260,138974,31144,66911,22828,107830,4486,2152,2334
67265,138987,31146,66919,22829,107840,4487,2153,2334
67270,138998,31150,66926,22832,107847,4487,2153,2334
67275,139005,31152,66931,22832,107853,4487,2153,2334
67280,139018,31154,66938,22833,107863,4488,2154,2334
67285,139029,31157,66944,22835,107871,4488,2154,2334
67290,139036,31159,66948,22837,107877,4488,2154,2334
67295,139049,31161,66954,22839,107887,4489,2154,2335
67300,139060,31164,66961,22842,107895,4489,2154,2335
67305,139067,31166,66965,22843,107901,4489,2154,2335
67310,139080,31168,66972,22844,107912,4490,2155,2335
67315,139091,31171,66978,22847,107919,4490,2155,2335
67320,139098,31173,66981,22848,107925,4490,2155,2335
67325,139111,31175,66984,22849,107936,4491,2155,2336
67330,139122,31178,66991,22851,107943,4491,2155,2336
67335,139129,31180,66994,22852,107949,4491,2155,2336
67340,139142,31182,66998,22853,107960,4492,2155,2337
67345,139153,31183,67001,22853,107969,4492,2155,2337
67350,139160,31185,67005,22855,107975,4492,2155,2337
67355,139173,31186,67009,22855,107987,4493,2155,2338
67360,139184,31188,67014,22856,107995,4493,2155,2338
67365,139191,31190,67019,22857,108001,4493,2155,2338
67370,139204,31191,67024,22858,108013,4494,2156,2338
67375,139215,31193,67032,22860,108021,4494,2156,2338
67380,139222,31195,67035,22862,108027,4494,2156,2338
67384,139233,31196,67040,22863,108037,4495,2157,2338
