source,gentime, athop, hopcount,priority, reachedTime
2,3,2,2,1, 5
1,6,1,1,0, 7
3,7,3,3,1, 10
8,16,1,1,1, 17
11,14,4,4,0, 18
9,17,2,2,0, 19
16,19,2,2,0, 21
17,19,3,3,1, 22
15,21,2,2,0, 23
22,26,4,4,0, 30
24,29,1,1,0, 30
19,26,5,5,0, 31
23,28,3,3,1, 31
25,35,2,2,1, 37
26,37,3,3,1, 40
2,43,2,2,1, 45
1,46,1,1,1, 47
3,47,3,3,0, 50
8,56,1,1,0, 57
11,54,4,4,1, 58
9,57,2,2,0, 59
16,59,2,2,1, 61
17,59,3,3,0, 62
15,61,2,2,1, 63
18,63,4,4,1, 67
20,63,6,6,1, 69
22,66,4,4,0, 70
24,69,1,1,1, 70
19,66,5,5,1, 71
23,68,3,3,1, 71
25,75,2,2,0, 77
30,73,3,5,0, 78
31,76,2,2,0, 78
26,77,3,3,0, 80
29,78,4,4,1, 82
2,83,2,2,0, 85
1,86,1,1,1, 87
3,87,3,3,0, 90
5,87,3,5,0, 92
6,90,2,4,0, 94
8,96,1,1,1, 97
11,94,4,4,1, 98
9,97,2,2,0, 99
16,99,2,2,0, 101
17,99,3,3,0, 102
15,101,2,2,0, 103
13,99,4,6,1, 105
12,100,5,5,0, 105
18,103,4,4,0, 107
20,103,6,6,1, 109
22,106,4,4,0, 110
24,109,1,1,1, 110
19,106,5,5,0, 111
23,108,3,3,1, 111
30,113,3,3,1, 116
25,115,2,2,0, 117
31,116,2,2,1, 118
26,117,3,3,1, 120
29,118,4,4,0, 122
2,123,2,2,1, 125
1,126,1,1,0, 127
3,127,3,3,0, 130
5,127,3,5,0, 132
6,130,2,4,1, 134
8,136,1,1,0, 137
11,134,4,4,1, 138
9,137,2,2,1, 139
16,139,2,2,1, 141
17,139,3,3,0, 142
15,141,2,2,1, 143
13,139,4,6,0, 145
12,140,5,5,1, 145
18,143,4,4,1, 147
20,143,6,6,1, 149
22,146,4,4,1, 150
24,149,1,1,0, 150
19,146,5,5,1, 151
23,148,3,3,0, 151
30,153,3,3,0, 156
25,155,2,2,1, 157
31,156,2,2,1, 158
28,154,5,5,1, 159
26,157,3,3,0, 160
29,158,4,4,1, 162
2,163,2,2,0, 165
1,166,1,1,1, 167
3,167,3,3,1, 170
5,167,3,5,1, 172
6,170,2,4,0, 174
8,176,1,1,0, 177
11,174,4,4,1, 178
9,177,2,2,1, 179
16,179,2,2,1, 181
17,179,3,3,0, 182
15,181,2,2,0, 183
13,179,4,6,1, 185
12,180,5,5,0, 185
18,183,4,4,1, 187
20,183,6,6,1, 189
22,186,4,4,1, 190
24,189,1,1,0, 190
19,186,5,5,0, 191
23,188,3,3,1, 191
30,193,3,3,0, 196
25,195,2,2,0, 197
31,196,2,2,1, 198
28,194,5,5,1, 199
26,197,3,3,0, 200
29,198,4,4,1, 202
2,203,2,2,1, 205
1,206,1,1,1, 207
3,207,3,3,1, 210
5,207,3,5,0, 212
6,210,2,4,1, 214
8,216,1,1,1, 217
11,214,4,4,0, 218
9,217,2,2,0, 219
16,219,2,2,1, 221
17,219,3,3,1, 222
15,221,2,2,0, 223
13,219,4,6,1, 225
12,220,5,5,0, 225
18,223,4,4,1, 227
20,223,6,6,1, 229
22,226,4,4,1, 230
24,229,1,1,1, 230
19,226,5,5,1, 231
23,228,3,3,0, 231
30,233,3,3,0, 236
25,235,2,2,1, 237
31,236,2,2,1, 238
28,234,5,5,1, 239
26,237,3,3,0, 240
29,238,4,4,0, 242
2,243,2,2,0, 245
1,246,1,1,0, 247
3,247,3,3,0, 250
5,247,3,5,0, 252
6,250,2,4,1, 254
8,256,1,1,0, 257
11,254,4,4,0, 258
9,257,2,2,0, 259
16,259,2,2,1, 261
17,259,3,3,0, 262
15,261,2,2,1, 263
13,259,4,6,1, 265
12,260,5,5,1, 265
18,263,4,4,0, 267
20,263,6,6,1, 269
22,266,4,4,0, 270
24,269,1,1,1, 270
19,266,5,5,1, 271
23,268,3,3,1, 271
30,273,3,3,0, 276
25,275,2,2,0, 277
31,276,2,2,0, 278
28,274,5,5,0, 279
26,277,3,3,1, 280
29,278,4,4,0, 282
2,283,2,2,1, 285
1,286,1,1,0, 287
3,287,3,3,0, 290
5,287,3,5,1, 292
6,290,2,4,0, 294
8,296,1,1,0, 297
11,294,4,4,0, 298
9,297,2,2,1, 299
16,299,2,2,0, 301
17,299,3,3,0, 302
15,301,2,2,0, 303
13,299,4,6,1, 305
12,300,5,5,1, 305
18,303,4,4,1, 307
20,303,6,6,1, 309
22,306,4,4,0, 310
24,309,1,1,0, 310
23,308,3,3,1, 311
30,313,3,3,0, 316
25,315,2,2,1, 317
31,316,2,2,0, 318
28,314,5,5,1, 319
26,317,3,3,1, 320
29,318,4,4,0, 322
2,323,2,2,1, 325
1,326,1,1,0, 327
3,327,3,3,1, 330
5,327,3,5,0, 332
6,330,2,4,1, 334
8,336,1,1,1, 337
16,339,2,2,1, 341
17,339,3,3,1, 342
15,341,2,2,0, 343
13,339,4,6,1, 345
12,340,5,5,1, 345
20,343,6,6,1, 349
22,346,4,4,0, 350
24,349,1,1,0, 350
23,348,3,3,1, 351
30,353,3,3,1, 356
25,355,2,2,1, 357
31,356,2,2,1, 358
28,354,5,5,0, 359
29,358,4,4,0, 362
1,366,1,1,0, 367
5,367,3,5,1, 372
6,370,2,4,1, 374
8,376,1,1,0, 377
11,374,4,4,1, 378
9,377,2,2,1, 379
16,379,2,2,1, 381
17,379,3,3,1, 382
15,381,2,2,0, 383
22,386,4,4,1, 390
24,389,1,1,1, 390
19,386,5,5,1, 391
23,388,3,3,0, 391
30,393,3,3,0, 396
31,396,2,2,0, 398
28,394,5,5,1, 399
26,397,3,3,1, 400
29,398,4,4,1, 402
1,406,1,1,1, 407
3,407,3,3,1, 410
5,407,3,5,1, 412
6,410,2,4,1, 414
8,416,1,1,0, 417
9,417,2,2,1, 419
16,419,2,2,1, 421
17,419,3,3,1, 422
15,421,2,2,0, 423
12,420,5,5,1, 425
18,423,4,4,1, 427
20,423,6,6,1, 429
22,426,4,4,0, 430
24,429,1,1,1, 430
23,428,3,3,0, 431
30,433,3,3,0, 436
25,435,2,2,1, 437
31,436,2,2,1, 438
28,434,5,5,1, 439
26,437,3,3,1, 440
29,438,4,4,1, 442
1,446,1,1,0, 447
3,447,3,3,1, 450
5,447,3,5,0, 452
6,450,2,4,0, 454
8,456,1,1,0, 457
9,457,2,2,1, 459
16,459,2,2,0, 461
15,461,2,2,0, 463
13,459,4,6,1, 465
20,463,6,6,1, 469
22,466,4,4,0, 470
24,469,1,1,1, 470
23,468,3,3,1, 471
30,473,3,3,1, 476
31,476,2,2,0, 478
28,474,5,5,0, 479
26,477,3,3,1, 480
29,478,4,4,1, 482
2,483,2,2,1, 485
1,486,1,1,1, 487
5,487,3,5,0, 492
6,490,2,4,0, 494
8,496,1,1,0, 497
11,494,4,4,1, 498
16,499,2,2,1, 501
17,499,3,3,1, 502
15,501,2,2,0, 503
13,499,4,6,1, 505
18,503,4,4,1, 507
22,506,4,4,1, 510
24,509,1,1,1, 510
23,508,3,3,0, 511
30,513,3,3,0, 516
25,515,2,2,1, 517
31,516,2,2,1, 518
28,514,5,5,1, 519
29,518,4,4,0, 522
1,526,1,1,0, 527
5,527,3,5,0, 532
6,530,2,4,1, 534
8,536,1,1,0, 537
9,537,2,2,1, 539
16,539,2,2,0, 541
15,541,2,2,0, 543
13,539,4,6,1, 545
12,540,5,5,1, 545
20,543,6,6,1, 549
22,546,4,4,0, 550
24,549,1,1,1, 550
23,548,3,3,0, 551
30,553,3,3,0, 556
25,555,2,2,1, 557
31,556,2,2,1, 558
28,554,5,5,0, 559
29,558,4,4,0, 562
2,563,2,2,1, 565
1,566,1,1,0, 567
5,567,3,5,0, 572
6,570,2,4,1, 574
8,576,1,1,0, 577
9,577,2,2,1, 579
16,579,2,2,1, 581
17,579,3,3,1, 582
15,581,2,2,1, 583
13,579,4,6,1, 585
12,580,5,5,1, 585
18,583,4,4,1, 587
20,583,6,6,1, 589
22,586,4,4,0, 590
24,589,1,1,1, 590
23,588,3,3,0, 591
30,593,3,3,0, 596
31,596,2,2,0, 598
28,594,5,5,1, 599
29,598,4,4,0, 602
2,603,2,2,1, 605
1,606,1,1,0, 607
5,607,3,5,1, 612
6,610,2,4,0, 614
8,616,1,1,0, 617
11,614,4,4,1, 618
16,619,2,2,1, 621
15,621,2,2,1, 623
22,626,4,4,0, 630
24,629,1,1,1, 630
23,628,3,3,0, 631
30,633,3,3,0, 636
31,636,2,2,0, 638
28,634,5,5,1, 639
29,638,4,4,0, 642
1,646,1,1,1, 647
5,647,3,5,1, 652
6,650,2,4,1, 654
8,656,1,1,1, 657
9,657,2,2,1, 659
16,659,2,2,0, 661
15,661,2,2,0, 663
13,659,4,6,1, 665
12,660,5,5,1, 665
20,663,6,6,1, 669
22,666,4,4,0, 670
24,669,1,1,0, 670
23,668,3,3,0, 671
30,673,3,3,1, 676
25,675,2,2,1, 677
31,676,2,2,0, 678
28,674,5,5,0, 679
26,677,3,3,1, 680
29,678,4,4,0, 682
1,686,1,1,0, 687
3,687,3,3,1, 690
5,687,3,5,1, 692
6,690,2,4,0, 694
8,696,1,1,1, 697
11,694,4,4,1, 698
16,699,2,2,0, 701
15,701,2,2,1, 703
13,699,4,6,1, 705
12,700,5,5,1, 705
22,706,4,4,0, 710
24,709,1,1,0, 710
23,708,3,3,1, 711
30,713,3,3,1, 716
31,716,2,2,0, 718
28,714,5,5,0, 719
29,718,4,4,1, 722
1,726,1,1,0, 727
3,727,3,3,1, 730
5,727,3,5,0, 732
6,730,2,4,0, 734
8,736,1,1,0, 737
11,734,4,4,1, 738
16,739,2,2,0, 741
17,739,3,3,1, 742
15,741,2,2,0, 743
18,743,4,4,1, 747
20,743,6,6,1, 749
22,746,4,4,1, 750
24,749,1,1,1, 750
19,746,5,5,1, 751
23,748,3,3,0, 751
30,753,3,3,0, 756
31,756,2,2,0, 758
28,754,5,5,1, 759
26,757,3,3,1, 760
29,758,4,4,1, 762
1,766,1,1,1, 767
5,767,3,5,1, 772
6,770,2,4,1, 774
8,776,1,1,1, 777
11,774,4,4,1, 778
16,779,2,2,1, 781
15,781,2,2,0, 783
18,783,4,4,1, 787
22,786,4,4,0, 790
24,789,1,1,0, 790
19,786,5,5,1, 791
23,788,3,3,0, 791
30,793,3,3,1, 796
25,795,2,2,1, 797
31,796,2,2,0, 798
28,794,5,5,1, 799
29,798,4,4,0, 802
2,803,2,2,1, 805
1,806,1,1,1, 807
3,807,3,3,1, 810
5,807,3,5,1, 812
6,810,2,4,1, 814
8,816,1,1,1, 817
16,819,2,2,0, 821
15,821,2,2,1, 823
22,826,4,4,0, 830
24,829,1,1,1, 830
23,828,3,3,1, 831
30,833,3,3,1, 836
31,836,2,2,1, 838
28,834,5,5,0, 839
29,838,4,4,0, 842
5,847,3,5,1, 852
6,850,2,4,1, 854
8,856,1,1,1, 857
16,859,2,2,0, 861
15,861,2,2,1, 863
22,866,4,4,1, 870
24,869,1,1,1, 870
23,868,3,3,1, 871
30,873,3,3,1, 876
31,876,2,2,0, 878
28,874,5,5,0, 879
29,878,4,4,0, 882
5,887,3,5,1, 892
6,890,2,4,1, 894
8,896,1,1,1, 897
16,899,2,2,1, 901
15,901,2,2,0, 903
22,906,4,4,0, 910
24,909,1,1,0, 910
23,908,3,3,1, 911
30,913,3,3,1, 916
31,916,2,2,0, 918
28,914,5,5,1, 919
26,917,3,3,1, 920
29,918,4,4,1, 922
2,923,2,2,1, 925
1,926,1,1,1, 927
5,927,3,5,1, 932
6,930,2,4,1, 934
8,936,1,1,1, 937
11,934,4,4,1, 938
16,939,2,2,0, 941
17,939,3,3,1, 942
15,941,2,2,1, 943
13,939,4,6,1, 945
12,940,5,5,1, 945
18,943,4,4,1, 947
20,943,6,6,1, 949
22,946,4,4,1, 950
24,949,1,1,0, 950
23,948,3,3,1, 951
31,956,2,2,1, 958
2,963,2,2,1, 965
1,966,1,1,1, 967
6,970,2,4,1, 974
8,976,1,1,1, 977
16,979,2,2,0, 981
17,979,3,3,1, 982
15,981,2,2,0, 983
12,980,5,5,1, 985
18,983,4,4,1, 987
20,983,6,6,1, 989
22,986,4,4,0, 990
24,989,1,1,1, 990
19,986,5,5,1, 991
23,988,3,3,1, 991
30,993,3,3,1, 996
31,996,2,2,1, 998
1,1006,1,1,0, 1007
5,1007,3,5,1, 1012
6,1010,2,4,1, 1014
8,1016,1,1,1, 1017
9,1017,2,2,1, 1019
16,1019,2,2,0, 1021
17,1019,3,3,1, 1022
15,1021,2,2,0, 1023
18,1023,4,4,1, 1027
22,1026,4,4,1, 1030
24,1029,1,1,0, 1030
23,1028,3,3,0, 1031
30,1033,3,3,1, 1036
26,1037,3,3,1, 1040
2,1043,2,2,1, 1045
1,1046,1,1,0, 1047
8,1056,1,1,0, 1057
16,1059,2,2,1, 1061
15,1061,2,2,0, 1063
13,1059,4,6,1, 1065
20,1063,6,6,1, 1069
22,1066,4,4,0, 1070
24,1069,1,1,1, 1070
23,1068,3,3,0, 1071
28,1074,5,5,1, 1079
29,1078,4,4,1, 1082
2,1083,2,2,1, 1085
1,1086,1,1,0, 1087
3,1087,3,3,1, 1090
5,1087,3,5,1, 1092
8,1096,1,1,1, 1097
16,1099,2,2,1, 1101
15,1101,2,2,0, 1103
12,1100,5,5,1, 1105
20,1103,6,6,1, 1109
22,1106,4,4,1, 1110
24,1109,1,1,1, 1110
23,1108,3,3,1, 1111
1,1126,1,1,1, 1127
3,1127,3,3,1, 1130
6,1130,2,4,1, 1134
8,1136,1,1,1, 1137
9,1137,2,2,1, 1139
16,1139,2,2,1, 1141
15,1141,2,2,0, 1143
13,1139,4,6,1, 1145
12,1140,5,5,1, 1145
18,1143,4,4,1, 1147
22,1146,4,4,0, 1150
24,1149,1,1,1, 1150
23,1148,3,3,0, 1151
30,1153,3,3,1, 1156
25,1155,2,2,1, 1157
31,1156,2,2,1, 1158
2,1163,2,2,1, 1165
1,1166,1,1,1, 1167
8,1176,1,1,0, 1177
11,1174,4,4,1, 1178
9,1177,2,2,1, 1179
16,1179,2,2,0, 1181
15,1181,2,2,0, 1183
13,1179,4,6,1, 1185
18,1183,4,4,1, 1187
22,1186,4,4,1, 1190
24,1189,1,1,0, 1190
19,1186,5,5,1, 1191
23,1188,3,3,1, 1191
30,1193,3,3,1, 1196
29,1198,4,4,1, 1202
1,1206,1,1,1, 1207
5,1207,3,5,1, 1212
6,1210,2,4,1, 1214
8,1216,1,1,0, 1217
9,1217,2,2,1, 1219
16,1219,2,2,1, 1221
17,1219,3,3,1, 1222
15,1221,2,2,1, 1223
22,1226,4,4,1, 1230
24,1229,1,1,0, 1230
19,1226,5,5,1, 1231
23,1228,3,3,1, 1231
30,1233,3,3,1, 1236
25,1235,2,2,1, 1237
26,1237,3,3,1, 1240
29,1238,4,4,1, 1242
2,1243,2,2,1, 1245
8,1256,1,1,0, 1257
16,1259,2,2,0, 1261
15,1261,2,2,0, 1263
22,1266,4,4,1, 1270
24,1269,1,1,0, 1270
23,1268,3,3,0, 1271
28,1274,5,5,1, 1279
29,1278,4,4,1, 1282
5,1287,3,5,1, 1292
8,1296,1,1,1, 1297
16,1299,2,2,1, 1301
15,1301,2,2,0, 1303
22,1306,4,4,1, 1310
24,1309,1,1,0, 1310
23,1308,3,3,0, 1311
31,1316,2,2,1, 1318
29,1318,4,4,1, 1322
5,1327,3,5,1, 1332
8,1336,1,1,0, 1337
16,1339,2,2,1, 1341
15,1341,2,2,0, 1343
18,1343,4,4,1, 1347
22,1346,4,4,0, 1350
24,1349,1,1,1, 1350
19,1346,5,5,1, 1351
23,1348,3,3,0, 1351
28,1354,5,5,1, 1359
29,1358,4,4,1, 1362
1,1366,1,1,0, 1367
3,1367,3,3,1, 1370
5,1367,3,5,1, 1372
6,1370,2,4,1, 1374
8,1376,1,1,1, 1377
11,1374,4,4,1, 1378
9,1377,2,2,1, 1379
16,1379,2,2,0, 1381
17,1379,3,3,1, 1382
15,1381,2,2,0, 1383
13,1379,4,6,1, 1385
18,1383,4,4,1, 1387
22,1386,4,4,0, 1390
24,1389,1,1,1, 1390
19,1386,5,5,1, 1391
23,1388,3,3,0, 1391
30,1393,3,3,1, 1396
25,1395,2,2,1, 1397
1,1406,1,1,0, 1407
6,1410,2,4,1, 1414
8,1416,1,1,1, 1417
11,1414,4,4,1, 1418
9,1417,2,2,1, 1419
16,1419,2,2,0, 1421
15,1421,2,2,1, 1423
18,1423,4,4,1, 1427
20,1423,6,6,1, 1429
22,1426,4,4,1, 1430
24,1429,1,1,0, 1430
23,1428,3,3,0, 1431
28,1434,5,5,1, 1439
26,1437,3,3,1, 1440
29,1438,4,4,1, 1442
2,1443,2,2,1, 1445
1,1446,1,1,1, 1447
3,1447,3,3,1, 1450
5,1447,3,5,1, 1452
8,1456,1,1,1, 1457
11,1454,4,4,1, 1458
9,1457,2,2,1, 1459
16,1459,2,2,0, 1461
17,1459,3,3,1, 1462
15,1461,2,2,1, 1463
18,1463,4,4,1, 1467
20,1463,6,6,1, 1469
22,1466,4,4,0, 1470
24,1469,1,1,1, 1470
19,1466,5,5,1, 1471
23,1468,3,3,1, 1471
25,1475,2,2,1, 1477
28,1474,5,5,1, 1479
29,1478,4,4,1, 1482
1,1486,1,1,0, 1487
3,1487,3,3,1, 1490
8,1496,1,1,1, 1497
9,1497,2,2,1, 1499
16,1499,2,2,0, 1501
15,1501,2,2,1, 1503
13,1499,4,6,1, 1505
22,1506,4,4,1, 1510
24,1509,1,1,0, 1510
23,1508,3,3,1, 1511
30,1513,3,3,1, 1516
6,1530,2,4,1, 1534
8,1536,1,1,0, 1537
16,1539,2,2,0, 1541
15,1541,2,2,1, 1543
22,1546,4,4,1, 1550
24,1549,1,1,0, 1550
23,1548,3,3,0, 1551
30,1553,3,3,1, 1556
28,1554,5,5,1, 1559
6,1570,2,4,1, 1574
8,1576,1,1,0, 1577
16,1579,2,2,1, 1581
15,1581,2,2,1, 1583
22,1586,4,4,1, 1590
24,1589,1,1,1, 1590
23,1588,3,3,1, 1591
31,1596,2,2,1, 1598
3,1607,3,3,1, 1610
8,1616,1,1,1, 1617
9,1617,2,2,1, 1619
16,1619,2,2,0, 1621
15,1621,2,2,1, 1623
12,1620,5,5,1, 1625
20,1623,6,6,1, 1629
22,1626,4,4,1, 1630
24,1629,1,1,1, 1630
23,1628,3,3,1, 1631
30,1633,3,3,1, 1636
28,1634,5,5,1, 1639
26,1637,3,3,1, 1640
1,1646,1,1,1, 1647
3,1647,3,3,1, 1650
6,1650,2,4,1, 1654
8,1656,1,1,1, 1657
16,1659,2,2,1, 1661
15,1661,2,2,0, 1663
13,1659,4,6,1, 1665
22,1666,4,4,0, 1670
24,1669,1,1,1, 1670
19,1666,5,5,1, 1671
23,1668,3,3,0, 1671
25,1675,2,2,1, 1677
26,1677,3,3,1, 1680
1,1686,1,1,1, 1687
5,1687,3,5,1, 1692
6,1690,2,4,1, 1694
8,1696,1,1,0, 1697
16,1699,2,2,0, 1701
17,1699,3,3,1, 1702
15,1701,2,2,0, 1703
13,1699,4,6,1, 1705
20,1703,6,6,1, 1709
22,1706,4,4,1, 1710
24,1709,1,1,0, 1710
23,1708,3,3,0, 1711
25,1715,2,2,1, 1717
26,1717,3,3,1, 1720
2,1723,2,2,1, 1725
1,1726,1,1,1, 1727
5,1727,3,5,1, 1732
8,1736,1,1,0, 1737
16,1739,2,2,0, 1741
15,1741,2,2,0, 1743
13,1739,4,6,1, 1745
12,1740,5,5,1, 1745
22,1746,4,4,1, 1750
24,1749,1,1,1, 1750
19,1746,5,5,1, 1751
23,1748,3,3,1, 1751
30,1753,3,3,1, 1756
31,1756,2,2,1, 1758
26,1757,3,3,1, 1760
2,1763,2,2,1, 1765
1,1766,1,1,0, 1767
6,1770,2,4,1, 1774
8,1776,1,1,0, 1777
11,1774,4,4,1, 1778
16,1779,2,2,0, 1781
17,1779,3,3,1, 1782
15,1781,2,2,0, 1783
13,1779,4,6,1, 1785
18,1783,4,4,1, 1787
20,1783,6,6,1, 1789
22,1786,4,4,0, 1790
24,1789,1,1,0, 1790
19,1786,5,5,1, 1791
23,1788,3,3,0, 1791
30,1793,3,3,1, 1796
31,1796,2,2,1, 1798
29,1798,4,4,1, 1802
2,1803,2,2,1, 1805
1,1806,1,1,0, 1807
6,1810,2,4,1, 1814
8,1816,1,1,1, 1817
11,1814,4,4,1, 1818
9,1817,2,2,1, 1819
16,1819,2,2,1, 1821
15,1821,2,2,0, 1823
18,1823,4,4,1, 1827
20,1823,6,6,1, 1829
22,1826,4,4,1, 1830
24,1829,1,1,0, 1830
23,1828,3,3,1, 1831
30,1833,3,3,1, 1836
26,1837,3,3,1, 1840
2,1843,2,2,1, 1845
1,1846,1,1,1, 1847
5,1847,3,5,1, 1852
8,1856,1,1,1, 1857
11,1854,4,4,1, 1858
16,1859,2,2,1, 1861
15,1861,2,2,0, 1863
12,1860,5,5,1, 1865
22,1866,4,4,0, 1870
24,1869,1,1,0, 1870
23,1868,3,3,0, 1871
31,1876,2,2,1, 1878
5,1887,3,5,1, 1892
8,1896,1,1,1, 1897
16,1899,2,2,0, 1901
15,1901,2,2,0, 1903
22,1906,4,4,1, 1910
24,1909,1,1,0, 1910
23,1908,3,3,0, 1911
28,1914,5,5,1, 1919
29,1918,4,4,1, 1922
5,1927,3,5,1, 1932
6,1930,2,4,1, 1934
8,1936,1,1,0, 1937
16,1939,2,2,1, 1941
15,1941,2,2,1, 1943
22,1946,4,4,1, 1950
24,1949,1,1,1, 1950
23,1948,3,3,1, 1951
28,1954,5,5,1, 1959
5,1967,3,5,1, 1972
8,1976,1,1,1, 1977
11,1974,4,4,1, 1978
9,1977,2,2,1, 1979
16,1979,2,2,0, 1981
17,1979,3,3,1, 1982
15,1981,2,2,1, 1983
18,1983,4,4,1, 1987
20,1983,6,6,1, 1989
22,1986,4,4,1, 1990
24,1989,1,1,0, 1990
23,1988,3,3,1, 1991
30,1993,3,3,1, 1996
26,1997,3,3,1, 2000
29,1998,4,4,1, 2002
2,2003,2,2,1, 2005
1,2006,1,1,0, 2007
3,2007,3,3,1, 2010
8,2016,1,1,1, 2017
9,2017,2,2,1, 2019
16,2019,2,2,1, 2021
15,2021,2,2,1, 2023
13,2019,4,6,1, 2025
18,2023,4,4,1, 2027
20,2023,6,6,1, 2029
22,2026,4,4,0, 2030
24,2029,1,1,0, 2030
23,2028,3,3,1, 2031
28,2034,5,5,1, 2039
1,2046,1,1,1, 2047
5,2047,3,5,1, 2052
6,2050,2,4,1, 2054
8,2056,1,1,0, 2057
11,2054,4,4,1, 2058
9,2057,2,2,1, 2059
16,2059,2,2,0, 2061
17,2059,3,3,1, 2062
15,2061,2,2,1, 2063
13,2059,4,6,1, 2065
18,2063,4,4,1, 2067
22,2066,4,4,0, 2070
24,2069,1,1,0, 2070
19,2066,5,5,1, 2071
23,2068,3,3,1, 2071
30,2073,3,3,1, 2076
1,2086,1,1,1, 2087
5,2087,3,5,1, 2092
6,2090,2,4,1, 2094
8,2096,1,1,1, 2097
9,2097,2,2,1, 2099
16,2099,2,2,0, 2101
17,2099,3,3,1, 2102
15,2101,2,2,1, 2103
22,2106,4,4,0, 2110
24,2109,1,1,0, 2110
23,2108,3,3,0, 2111
30,2113,3,3,1, 2116
31,2116,2,2,1, 2118
28,2114,5,5,1, 2119
29,2118,4,4,1, 2122
1,2126,1,1,1, 2127
5,2127,3,5,1, 2132
8,2136,1,1,0, 2137
9,2137,2,2,1, 2139
16,2139,2,2,1, 2141
17,2139,3,3,1, 2142
15,2141,2,2,1, 2143
22,2146,4,4,0, 2150
24,2149,1,1,0, 2150
23,2148,3,3,1, 2151
30,2153,3,3,1, 2156
31,2156,2,2,1, 2158
29,2158,4,4,1, 2162
1,2166,1,1,0, 2167
5,2167,3,5,1, 2172
8,2176,1,1,1, 2177
11,2174,4,4,1, 2178
16,2179,2,2,1, 2181
15,2181,2,2,0, 2183
12,2180,5,5,1, 2185
22,2186,4,4,1, 2190
24,2189,1,1,1, 2190
23,2188,3,3,0, 2191
30,2193,3,3,1, 2196
1,2206,1,1,1, 2207
3,2207,3,3,1, 2210
6,2210,2,4,1, 2214
8,2216,1,1,1, 2217
11,2214,4,4,1, 2218
16,2219,2,2,1, 2221
15,2221,2,2,0, 2223
13,2219,4,6,1, 2225
18,2223,4,4,1, 2227
20,2223,6,6,1, 2229
22,2226,4,4,0, 2230
24,2229,1,1,0, 2230
23,2228,3,3,1, 2231
31,2236,2,2,1, 2238
28,2234,5,5,1, 2239
26,2237,3,3,1, 2240
2,2243,2,2,1, 2245
1,2246,1,1,0, 2247
3,2247,3,3,1, 2250
5,2247,3,5,1, 2252
8,2256,1,1,0, 2257
11,2254,4,4,1, 2258
9,2257,2,2,1, 2259
16,2259,2,2,0, 2261
17,2259,3,3,1, 2262
15,2261,2,2,0, 2263
12,2260,5,5,1, 2265
22,2266,4,4,0, 2270
24,2269,1,1,1, 2270
19,2266,5,5,1, 2271
23,2268,3,3,0, 2271
30,2273,3,3,1, 2276
28,2274,5,5,1, 2279
1,2286,1,1,1, 2287
8,2296,1,1,1, 2297
16,2299,2,2,0, 2301
15,2301,2,2,0, 2303
12,2300,5,5,1, 2305
22,2306,4,4,0, 2310
24,2309,1,1,1, 2310
19,2306,5,5,1, 2311
23,2308,3,3,1, 2311
30,2313,3,3,1, 2316
25,2315,2,2,1, 2317
28,2314,5,5,1, 2319
29,2318,4,4,1, 2322
1,2326,1,1,0, 2327
3,2327,3,3,1, 2330
5,2327,3,5,1, 2332
6,2330,2,4,1, 2334
8,2336,1,1,1, 2337
11,2334,4,4,1, 2338
9,2337,2,2,1, 2339
16,2339,2,2,0, 2341
15,2341,2,2,1, 2343
18,2343,4,4,1, 2347
20,2343,6,6,1, 2349
22,2346,4,4,0, 2350
24,2349,1,1,1, 2350
19,2346,5,5,1, 2351
23,2348,3,3,1, 2351
30,2353,3,3,1, 2356
25,2355,2,2,1, 2357
29,2358,4,4,1, 2362
2,2363,2,2,1, 2365
1,2366,1,1,0, 2367
5,2367,3,5,1, 2372
8,2376,1,1,0, 2377
16,2379,2,2,0, 2381
17,2379,3,3,1, 2382
15,2381,2,2,0, 2383
18,2383,4,4,1, 2387
20,2383,6,6,1, 2389
22,2386,4,4,1, 2390
24,2389,1,1,0, 2390
19,2386,5,5,1, 2391
23,2388,3,3,0, 2391
30,2393,3,3,1, 2396
31,2396,2,2,1, 2398
28,2394,5,5,1, 2399
26,2397,3,3,1, 2400
6,2410,2,4,1, 2414
8,2416,1,1,1, 2417
16,2419,2,2,1, 2421
15,2421,2,2,0, 2423
22,2426,4,4,0, 2430
24,2429,1,1,1, 2430
23,2428,3,3,0, 2431
28,2434,5,5,1, 2439
6,2450,2,4,1, 2454
8,2456,1,1,1, 2457
16,2459,2,2,1, 2461
15,2461,2,2,1, 2463
22,2466,4,4,0, 2470
24,2469,1,1,1, 2470
23,2468,3,3,0, 2471
30,2473,3,3,1, 2476
31,2476,2,2,1, 2478
28,2474,5,5,1, 2479
29,2478,4,4,1, 2482
5,2487,3,5,1, 2492
6,2490,2,4,1, 2494
8,2496,1,1,1, 2497
16,2499,2,2,0, 2501
15,2501,2,2,1, 2503
20,2503,6,6,1, 2509
22,2506,4,4,1, 2510
24,2509,1,1,0, 2510
19,2506,5,5,1, 2511
23,2508,3,3,1, 2511
30,2513,3,3,1, 2516
31,2516,2,2,1, 2518
1,2526,1,1,1, 2527
5,2527,3,5,1, 2532
8,2536,1,1,1, 2537
16,2539,2,2,0, 2541
17,2539,3,3,1, 2542
15,2541,2,2,0, 2543
13,2539,4,6,1, 2545
18,2543,4,4,1, 2547
22,2546,4,4,1, 2550
24,2549,1,1,1, 2550
23,2548,3,3,1, 2551
1,2566,1,1,1, 2567
8,2576,1,1,1, 2577
16,2579,2,2,0, 2581
17,2579,3,3,1, 2582
15,2581,2,2,0, 2583
13,2579,4,6,1, 2585
18,2583,4,4,1, 2587
22,2586,4,4,0, 2590
24,2589,1,1,0, 2590
19,2586,5,5,1, 2591
23,2588,3,3,1, 2591
26,2597,3,3,1, 2600
29,2598,4,4,1, 2602
2,2603,2,2,1, 2605
1,2606,1,1,0, 2607
6,2610,2,4,1, 2614
8,2616,1,1,1, 2617
11,2614,4,4,1, 2618
9,2617,2,2,1, 2619
16,2619,2,2,1, 2621
15,2621,2,2,0, 2623
13,2619,4,6,1, 2625
12,2620,5,5,1, 2625
22,2626,4,4,0, 2630
24,2629,1,1,1, 2630
23,2628,3,3,1, 2631
25,2635,2,2,1, 2637
31,2636,2,2,1, 2638
28,2634,5,5,1, 2639
26,2637,3,3,1, 2640
2,2643,2,2,1, 2645
1,2646,1,1,1, 2647
5,2647,3,5,1, 2652
8,2656,1,1,1, 2657
11,2654,4,4,1, 2658
16,2659,2,2,0, 2661
15,2661,2,2,0, 2663
13,2659,4,6,1, 2665
12,2660,5,5,1, 2665
18,2663,4,4,1, 2667
20,2663,6,6,1, 2669
22,2666,4,4,1, 2670
24,2669,1,1,1, 2670
23,2668,3,3,1, 2671
31,2676,2,2,0, 2678
2,2683,2,2,1, 2685
1,2686,1,1,0, 2687
3,2687,3,3,1, 2690
5,2687,3,5,1, 2692
6,2690,2,4,1, 2694
8,2696,1,1,1, 2697
9,2697,2,2,1, 2699
16,2699,2,2,0, 2701
17,2699,3,3,1, 2702
15,2701,2,2,1, 2703
13,2699,4,6,1, 2705
12,2700,5,5,1, 2705
18,2703,4,4,1, 2707
20,2703,6,6,1, 2709
22,2706,4,4,1, 2710
24,2709,1,1,0, 2710
23,2708,3,3,1, 2711
30,2713,3,3,1, 2716
25,2715,2,2,1, 2717
31,2716,2,2,0, 2718
29,2718,4,4,1, 2722
1,2726,1,1,0, 2727
5,2727,3,5,1, 2732
8,2736,1,1,1, 2737
9,2737,2,2,1, 2739
16,2739,2,2,1, 2741
15,2741,2,2,1, 2743
12,2740,5,5,1, 2745
18,2743,4,4,1, 2747
22,2746,4,4,0, 2750
24,2749,1,1,0, 2750
23,2748,3,3,1, 2751
31,2756,2,2,0, 2758
26,2757,3,3,1, 2760
29,2758,4,4,1, 2762
5,2767,3,5,1, 2772
8,2776,1,1,1, 2777
16,2779,2,2,0, 2781
15,2781,2,2,1, 2783
22,2786,4,4,1, 2790
24,2789,1,1,0, 2790
23,2788,3,3,0, 2791
30,2793,3,3,1, 2796
31,2796,2,2,0, 2798
28,2794,5,5,1, 2799
6,2810,2,4,1, 2814
8,2816,1,1,0, 2817
16,2819,2,2,0, 2821
15,2821,2,2,0, 2823
22,2826,4,4,1, 2830
24,2829,1,1,1, 2830
23,2828,3,3,1, 2831
30,2833,3,3,1, 2836
31,2836,2,2,0, 2838
28,2834,5,5,1, 2839
29,2838,4,4,1, 2842
5,2847,3,5,1, 2852
6,2850,2,4,1, 2854
8,2856,1,1,0, 2857
16,2859,2,2,1, 2861
15,2861,2,2,1, 2863
18,2863,4,4,1, 2867
22,2866,4,4,0, 2870
24,2869,1,1,1, 2870
19,2866,5,5,1, 2871
23,2868,3,3,0, 2871
25,2875,2,2,1, 2877
31,2876,2,2,1, 2878
28,2874,5,5,1, 2879
26,2877,3,3,1, 2880
1,2886,1,1,0, 2887
8,2896,1,1,1, 2897
9,2897,2,2,1, 2899
16,2899,2,2,1, 2901
17,2899,3,3,1, 2902
15,2901,2,2,1, 2903
22,2906,4,4,1, 2910
24,2909,1,1,0, 2910
23,2908,3,3,1, 2911
31,2916,2,2,1, 2918
1,2926,1,1,1, 2927
8,2936,1,1,0, 2937
9,2937,2,2,1, 2939
16,2939,2,2,1, 2941
15,2941,2,2,1, 2943
22,2946,4,4,0, 2950
24,2949,1,1,1, 2950
23,2948,3,3,0, 2951
30,2953,3,3,0, 2956
31,2956,2,2,1, 2958
28,2954,5,5,1, 2959
29,2958,4,4,1, 2962
1,2966,1,1,0, 2967
8,2976,1,1,0, 2977
9,2977,2,2,1, 2979
16,2979,2,2,1, 2981
15,2981,2,2,0, 2983
18,2983,4,4,1, 2987
22,2986,4,4,0, 2990
24,2989,1,1,1, 2990
23,2988,3,3,0, 2991
30,2993,3,3,0, 2996
31,2996,2,2,0, 2998
28,2994,5,5,1, 2999
29,2998,4,4,1, 3002
1,3006,1,1,1, 3007
5,3007,3,5,1, 3012
6,3010,2,4,1, 3014
8,3016,1,1,0, 3017
11,3014,4,4,1, 3018
16,3019,2,2,1, 3021
15,3021,2,2,1, 3023
13,3019,4,6,1, 3025
12,3020,5,5,1, 3025
18,3023,4,4,1, 3027
20,3023,6,6,1, 3029
22,3026,4,4,0, 3030
24,3029,1,1,0, 3030
23,3028,3,3,1, 3031
30,3033,3,3,0, 3036
31,3036,2,2,1, 3038
1,3046,1,1,0, 3047
3,3047,3,3,1, 3050
5,3047,3,5,1, 3052
6,3050,2,4,1, 3054
8,3056,1,1,0, 3057
16,3059,2,2,1, 3061
15,3061,2,2,1, 3063
12,3060,5,5,1, 3065
18,3063,4,4,1, 3067
22,3066,4,4,1, 3070
24,3069,1,1,0, 3070
19,3066,5,5,1, 3071
23,3068,3,3,1, 3071
30,3073,3,3,1, 3076
25,3075,2,2,1, 3077
31,3076,2,2,1, 3078
26,3077,3,3,1, 3080
1,3086,1,1,0, 3087
5,3087,3,5,1, 3092
6,3090,2,4,1, 3094
8,3096,1,1,1, 3097
16,3099,2,2,1, 3101
17,3099,3,3,1, 3102
15,3101,2,2,1, 3103
13,3099,4,6,1, 3105
12,3100,5,5,1, 3105
22,3106,4,4,1, 3110
24,3109,1,1,0, 3110
19,3106,5,5,1, 3111
23,3108,3,3,1, 3111
30,3113,3,3,1, 3116
31,3116,2,2,0, 3118
28,3114,5,5,1, 3119
26,3117,3,3,1, 3120
1,3126,1,1,1, 3127
3,3127,3,3,1, 3130
5,3127,3,5,1, 3132
6,3130,2,4,1, 3134
8,3136,1,1,1, 3137
16,3139,2,2,1, 3141
15,3141,2,2,1, 3143
12,3140,5,5,1, 3145
22,3146,4,4,0, 3150
24,3149,1,1,1, 3150
23,3148,3,3,0, 3151
30,3153,3,3,0, 3156
31,3156,2,2,0, 3158
1,3166,1,1,1, 3167
3,3167,3,3,1, 3170
8,3176,1,1,1, 3177
11,3174,4,4,1, 3178
16,3179,2,2,0, 3181
17,3179,3,3,1, 3182
15,3181,2,2,1, 3183
20,3183,6,6,1, 3189
22,3186,4,4,1, 3190
24,3189,1,1,0, 3190
23,3188,3,3,0, 3191
30,3193,3,3,0, 3196
31,3196,2,2,0, 3198
26,3197,3,3,1, 3200
29,3198,4,4,1, 3202
1,3206,1,1,1, 3207
5,3207,3,5,1, 3212
8,3216,1,1,1, 3217
11,3214,4,4,1, 3218
16,3219,2,2,0, 3221
17,3219,3,3,1, 3222
15,3221,2,2,1, 3223
13,3219,4,6,1, 3225
12,3220,5,5,1, 3225
18,3223,4,4,1, 3227
20,3223,6,6,1, 3229
22,3226,4,4,0, 3230
24,3229,1,1,0, 3230
23,3228,3,3,1, 3231
30,3233,3,3,1, 3236
25,3235,2,2,1, 3237
31,3236,2,2,1, 3238
28,3234,5,5,1, 3239
26,3237,3,3,1, 3240
1,3246,1,1,1, 3247
5,3247,3,5,1, 3252
6,3250,2,4,1, 3254
8,3256,1,1,0, 3257
16,3259,2,2,0, 3261
15,3261,2,2,0, 3263
12,3260,5,5,1, 3265
20,3263,6,6,1, 3269
22,3266,4,4,1, 3270
24,3269,1,1,0, 3270
19,3266,5,5,1, 3271
23,3268,3,3,1, 3271
30,3273,3,3,1, 3276
31,3276,2,2,0, 3278
2,3283,2,2,1, 3285
1,3286,1,1,1, 3287
3,3287,3,3,1, 3290
8,3296,1,1,1, 3297
16,3299,2,2,1, 3301
15,3301,2,2,0, 3303
12,3300,5,5,1, 3305
18,3303,4,4,1, 3307
20,3303,6,6,1, 3309
22,3306,4,4,1, 3310
24,3309,1,1,0, 3310
19,3306,5,5,1, 3311
23,3308,3,3,1, 3311
30,3313,3,3,1, 3316
31,3316,2,2,0, 3318
28,3314,5,5,1, 3319
29,3318,4,4,0, 3322
1,3326,1,1,1, 3327
5,3327,3,5,1, 3332
6,3330,2,4,0, 3334
8,3336,1,1,1, 3337
11,3334,4,4,1, 3338
9,3337,2,2,1, 3339
16,3339,2,2,1, 3341
15,3341,2,2,0, 3343
22,3346,4,4,0, 3350
24,3349,1,1,1, 3350
19,3346,5,5,1, 3351
23,3348,3,3,1, 3351
30,3353,3,3,0, 3356
25,3355,2,2,1, 3357
31,3356,2,2,0, 3358
28,3354,5,5,1, 3359
29,3358,4,4,0, 3362
1,3366,1,1,1, 3367
3,3367,3,3,1, 3370
5,3367,3,5,1, 3372
6,3370,2,4,0, 3374
8,3376,1,1,1, 3377
11,3374,4,4,1, 3378
9,3377,2,2,1, 3379
16,3379,2,2,1, 3381
17,3379,3,3,1, 3382
15,3381,2,2,0, 3383
13,3379,4,6,1, 3385
18,3383,4,4,1, 3387
22,3386,4,4,1, 3390
24,3389,1,1,0, 3390
23,3388,3,3,1, 3391
30,3393,3,3,0, 3396
25,3395,2,2,1, 3397
31,3396,2,2,1, 3398
28,3394,5,5,1, 3399
29,3398,4,4,1, 3402
1,3406,1,1,0, 3407
5,3407,3,5,1, 3412
6,3410,2,4,0, 3414
8,3416,1,1,1, 3417
11,3414,4,4,1, 3418
16,3419,2,2,1, 3421
17,3419,3,3,1, 3422
15,3421,2,2,1, 3423
13,3419,4,6,1, 3425
22,3426,4,4,0, 3430
24,3429,1,1,0, 3430
23,3428,3,3,0, 3431
30,3433,3,3,0, 3436
31,3436,2,2,1, 3438
28,3434,5,5,0, 3439
29,3438,4,4,0, 3442
5,3447,3,5,0, 3452
6,3450,2,4,1, 3454
8,3456,1,1,0, 3457
16,3459,2,2,0, 3461
15,3461,2,2,1, 3463
22,3466,4,4,0, 3470
24,3469,1,1,0, 3470
23,3468,3,3,0, 3471
30,3473,3,3,0, 3476
31,3476,2,2,1, 3478
28,3474,5,5,1, 3479
29,3478,4,4,0, 3482
5,3487,3,5,0, 3492
6,3490,2,4,1, 3494
8,3496,1,1,0, 3497
16,3499,2,2,1, 3501
15,3501,2,2,0, 3503
22,3506,4,4,1, 3510
24,3509,1,1,1, 3510
23,3508,3,3,1, 3511
30,3513,3,3,1, 3516
31,3516,2,2,0, 3518
28,3514,5,5,0, 3519
29,3518,4,4,0, 3522
3,3527,3,3,1, 3530
5,3527,3,5,1, 3532
6,3530,2,4,0, 3534
8,3536,1,1,1, 3537
11,3534,4,4,1, 3538
16,3539,2,2,0, 3541
15,3541,2,2,1, 3543
13,3539,4,6,1, 3545
12,3540,5,5,1, 3545
18,3543,4,4,1, 3547
20,3543,6,6,1, 3549
22,3546,4,4,0, 3550
24,3549,1,1,1, 3550
23,3548,3,3,0, 3551
30,3553,3,3,0, 3556
31,3556,2,2,1, 3558
28,3554,5,5,0, 3559
26,3557,3,3,1, 3560
29,3558,4,4,1, 3562
1,3566,1,1,1, 3567
5,3567,3,5,1, 3572
6,3570,2,4,0, 3574
8,3576,1,1,0, 3577
11,3574,4,4,1, 3578
9,3577,2,2,1, 3579
16,3579,2,2,1, 3581
17,3579,3,3,1, 3582
15,3581,2,2,0, 3583
18,3583,4,4,1, 3587
20,3583,6,6,1, 3589
22,3586,4,4,1, 3590
24,3589,1,1,0, 3590
19,3586,5,5,1, 3591
23,3588,3,3,1, 3591
30,3593,3,3,1, 3596
25,3595,2,2,1, 3597
31,3596,2,2,1, 3598
28,3594,5,5,0, 3599
29,3598,4,4,1, 3602
1,3606,1,1,1, 3607
3,3607,3,3,1, 3610
5,3607,3,5,1, 3612
6,3610,2,4,1, 3614
8,3616,1,1,1, 3617
9,3617,2,2,1, 3619
16,3619,2,2,0, 3621
15,3621,2,2,0, 3623
20,3623,6,6,1, 3629
22,3626,4,4,1, 3630
24,3629,1,1,1, 3630
23,3628,3,3,0, 3631
30,3633,3,3,1, 3636
25,3635,2,2,1, 3637
26,3637,3,3,1, 3640
29,3638,4,4,1, 3642
1,3646,1,1,0, 3647
3,3647,3,3,1, 3650
5,3647,3,5,1, 3652
6,3650,2,4,1, 3654
8,3656,1,1,0, 3657
9,3657,2,2,1, 3659
16,3659,2,2,0, 3661
17,3659,3,3,1, 3662
15,3661,2,2,1, 3663
13,3659,4,6,1, 3665
22,3666,4,4,1, 3670
24,3669,1,1,0, 3670
19,3666,5,5,1, 3671
23,3668,3,3,0, 3671
30,3673,3,3,1, 3676
25,3675,2,2,1, 3677
31,3676,2,2,1, 3678
28,3674,5,5,1, 3679
29,3678,4,4,1, 3682
1,3686,1,1,0, 3687
3,3687,3,3,1, 3690
8,3696,1,1,0, 3697
11,3694,4,4,1, 3698
9,3697,2,2,1, 3699
16,3699,2,2,0, 3701
15,3701,2,2,0, 3703
12,3700,5,5,1, 3705
18,3703,4,4,1, 3707
22,3706,4,4,0, 3710
24,3709,1,1,1, 3710
19,3706,5,5,1, 3711
23,3708,3,3,1, 3711
30,3713,3,3,1, 3716
28,3714,5,5,1, 3719
8,3736,1,1,0, 3737
16,3739,2,2,0, 3741
15,3741,2,2,0, 3743
22,3746,4,4,0, 3750
24,3749,1,1,0, 3750
23,3748,3,3,1, 3751
28,3754,5,5,1, 3759
29,3758,4,4,1, 3762
6,3770,2,4,1, 3774
8,3776,1,1,1, 3777
16,3779,2,2,1, 3781
15,3781,2,2,1, 3783
22,3786,4,4,0, 3790
24,3789,1,1,0, 3790
23,3788,3,3,0, 3791
5,3807,3,5,1, 3812
6,3810,2,4,1, 3814
8,3816,1,1,0, 3817
9,3817,2,2,1, 3819
16,3819,2,2,0, 3821
17,3819,3,3,1, 3822
15,3821,2,2,1, 3823
22,3826,4,4,1, 3830
24,3829,1,1,0, 3830
23,3828,3,3,1, 3831
25,3835,2,2,1, 3837
31,3836,2,2,1, 3838
28,3834,5,5,1, 3839
26,3837,3,3,1, 3840
1,3846,1,1,1, 3847
5,3847,3,5,1, 3852
8,3856,1,1,1, 3857
9,3857,2,2,1, 3859
16,3859,2,2,1, 3861
17,3859,3,3,1, 3862
15,3861,2,2,1, 3863
13,3859,4,6,1, 3865
22,3866,4,4,0, 3870
24,3869,1,1,1, 3870
19,3866,5,5,1, 3871
23,3868,3,3,0, 3871
30,3873,3,3,1, 3876
25,3875,2,2,1, 3877
29,3878,4,4,1, 3882
1,3886,1,1,1, 3887
3,3887,3,3,1, 3890
8,3896,1,1,0, 3897
9,3897,2,2,1, 3899
16,3899,2,2,1, 3901
17,3899,3,3,1, 3902
15,3901,2,2,0, 3903
12,3900,5,5,1, 3905
22,3906,4,4,0, 3910
24,3909,1,1,0, 3910
23,3908,3,3,0, 3911
25,3915,2,2,1, 3917
28,3914,5,5,1, 3919
1,3926,1,1,0, 3927
5,3927,3,5,1, 3932
6,3930,2,4,1, 3934
8,3936,1,1,1, 3937
16,3939,2,2,0, 3941
15,3941,2,2,1, 3943
13,3939,4,6,1, 3945
20,3943,6,6,1, 3949
22,3946,4,4,0, 3950
24,3949,1,1,1, 3950
23,3948,3,3,1, 3951
29,3958,4,4,1, 3962
1,3966,1,1,1, 3967
3,3967,3,3,1, 3970
8,3976,1,1,1, 3977
11,3974,4,4,1, 3978
16,3979,2,2,0, 3981
15,3981,2,2,1, 3983
18,3983,4,4,1, 3987
22,3986,4,4,1, 3990
24,3989,1,1,1, 3990
19,3986,5,5,1, 3991
23,3988,3,3,0, 3991
28,3994,5,5,1, 3999
26,3997,3,3,1, 4000
2,4003,2,2,1, 4005
1,4006,1,1,0, 4007
3,4007,3,3,1, 4010
8,4016,1,1,1, 4017
9,4017,2,2,1, 4019
16,4019,2,2,1, 4021
15,4021,2,2,1, 4023
13,4019,4,6,1, 4025
12,4020,5,5,1, 4025
18,4023,4,4,1, 4027
24,4029,1,1,0, 4030
23,4028,3,3,1, 4031
26,4037,3,3,1, 4040
29,4038,4,4,1, 4042
2,4043,2,2,1, 4045
1,4046,1,1,1, 4047
8,4056,1,1,0, 4057
11,4054,4,4,1, 4058
13,4059,4,6,1, 4065
12,4060,5,5,1, 4065
22,4066,4,4,1, 4070
24,4069,1,1,0, 4070
28,4074,5,5,1, 4079
26,4077,3,3,1, 4080
29,4078,4,4,1, 4082
1,4086,1,1,1, 4087
5,4087,3,5,1, 4092
8,4096,1,1,0, 4097
9,4097,2,2,1, 4099
15,4101,2,2,1, 4103
18,4103,4,4,1, 4107
20,4103,6,6,1, 4109
22,4106,4,4,1, 4110
24,4109,1,1,1, 4110
23,4108,3,3,1, 4111
30,4113,3,3,1, 4116
31,4116,2,2,1, 4118
28,4114,5,5,1, 4119
2,4123,2,2,1, 4125
1,4126,1,1,0, 4127
3,4127,3,3,1, 4130
8,4136,1,1,0, 4137
15,4141,2,2,1, 4143
13,4139,4,6,1, 4145
12,4140,5,5,1, 4145
18,4143,4,4,1, 4147
20,4143,6,6,1, 4149
24,4149,1,1,0, 4150
23,4148,3,3,1, 4151
25,4155,2,2,1, 4157
28,4154,5,5,1, 4159
26,4157,3,3,1, 4160
2,4163,2,2,1, 4165
1,4166,1,1,1, 4167
3,4167,3,3,1, 4170
5,4167,3,5,1, 4172
6,4170,2,4,1, 4174
8,4176,1,1,0, 4177
16,4179,2,2,1, 4181
15,4181,2,2,1, 4183
24,4189,1,1,1, 4190
23,4188,3,3,1, 4191
30,4193,3,3,1, 4196
31,4196,2,2,1, 4198
28,4194,5,5,1, 4199
29,4198,4,4,1, 4202
6,4210,2,4,1, 4214
8,4216,1,1,0, 4217
16,4219,2,2,1, 4221
24,4229,1,1,0, 4230
28,4234,5,5,1, 4239
8,4256,1,1,0, 4257
16,4259,2,2,1, 4261
15,4261,2,2,1, 4263
22,4266,4,4,1, 4270
24,4269,1,1,0, 4270
23,4268,3,3,1, 4271
30,4273,3,3,1, 4276
28,4274,5,5,1, 4279
29,4278,4,4,1, 4282
1,4286,1,1,1, 4287
3,4287,3,3,1, 4290
5,4287,3,5,1, 4292
8,4296,1,1,1, 4297
11,4294,4,4,1, 4298
15,4301,2,2,1, 4303
12,4300,5,5,1, 4305
18,4303,4,4,1, 4307
24,4309,1,1,1, 4310
23,4308,3,3,1, 4311
30,4313,3,3,1, 4316
25,4315,2,2,1, 4317
28,4314,5,5,1, 4319
26,4317,3,3,1, 4320
1,4326,1,1,0, 4327
3,4327,3,3,1, 4330
6,4330,2,4,1, 4334
8,4336,1,1,0, 4337
11,4334,4,4,1, 4338
9,4337,2,2,1, 4339
16,4339,2,2,1, 4341
17,4339,3,3,1, 4342
15,4341,2,2,1, 4343
22,4346,4,4,1, 4350
24,4349,1,1,1, 4350
19,4346,5,5,1, 4351
23,4348,3,3,1, 4351
30,4353,3,3,1, 4356
25,4355,2,2,1, 4357
31,4356,2,2,1, 4358
28,4354,5,5,1, 4359
26,4357,3,3,1, 4360
29,4358,4,4,1, 4362
2,4363,2,2,1, 4365
1,4366,1,1,1, 4367
3,4367,3,3,1, 4370
5,4367,3,5,1, 4372
6,4370,2,4,1, 4374
8,4376,1,1,0, 4377
11,4374,4,4,1, 4378
16,4379,2,2,1, 4381
17,4379,3,3,1, 4382
15,4381,2,2,1, 4383
20,4383,6,6,1, 4389
22,4386,4,4,1, 4390
24,4389,1,1,1, 4390
19,4386,5,5,1, 4391
30,4393,3,3,1, 4396
25,4395,2,2,1, 4397
28,4394,5,5,1, 4399
29,4398,4,4,1, 4402
1,4406,1,1,1, 4407
5,4407,3,5,1, 4412
8,4416,1,1,1, 4417
17,4419,3,3,1, 4422
15,4421,2,2,1, 4423
24,4429,1,1,0, 4430
25,4435,2,2,1, 4437
1,4446,1,1,1, 4447
6,4450,2,4,1, 4454
8,4456,1,1,0, 4457
24,4469,1,1,0, 4470
23,4468,3,3,1, 4471
28,4474,5,5,1, 4479
29,4478,4,4,1, 4482
1,4486,1,1,1, 4487
8,4496,1,1,1, 4497
11,4494,4,4,1, 4498
9,4497,2,2,1, 4499
17,4499,3,3,1, 4502
12,4500,5,5,1, 4505
24,4509,1,1,0, 4510
23,4508,3,3,1, 4511
31,4516,2,2,1, 4518
29,4518,4,4,1, 4522
2,4523,2,2,1, 4525
1,4526,1,1,0, 4527
8,4536,1,1,0, 4537
9,4537,2,2,1, 4539
17,4539,3,3,1, 4542
15,4541,2,2,1, 4543
13,4539,4,6,1, 4545
20,4543,6,6,1, 4549
24,4549,1,1,1, 4550
1,4566,1,1,1, 4567
3,4567,3,3,1, 4570
8,4576,1,1,1, 4577
11,4574,4,4,1, 4578
17,4579,3,3,1, 4582
15,4581,2,2,1, 4583
12,4580,5,5,1, 4585
24,4589,1,1,0, 4590
30,4593,3,3,1, 4596
31,4596,2,2,1, 4598
29,4598,4,4,1, 4602
1,4606,1,1,1, 4607
6,4610,2,4,1, 4614
8,4616,1,1,0, 4617
11,4614,4,4,1, 4618
13,4619,4,6,1, 4625
12,4620,5,5,1, 4625
18,4623,4,4,1, 4627
20,4623,6,6,1, 4629
24,4629,1,1,0, 4630
19,4626,5,5,1, 4631
25,4635,2,2,1, 4637
29,4638,4,4,1, 4642
1,4646,1,1,0, 4647
3,4647,3,3,1, 4650
6,4650,2,4,1, 4654
8,4656,1,1,0, 4657
11,4654,4,4,1, 4658
9,4657,2,2,1, 4659
17,4659,3,3,1, 4662
12,4660,5,5,1, 4665
20,4663,6,6,1, 4669
22,4666,4,4,0, 4670
24,4669,1,1,0, 4670
23,4668,3,3,0, 4671
30,4673,3,3,1, 4676
25,4675,2,2,1, 4677
28,4674,5,5,1, 4679
26,4677,3,3,1, 4680
6,4690,2,4,1, 4694
8,4696,1,1,1, 4697
16,4699,2,2,0, 4701
15,4701,2,2,1, 4703
22,4706,4,4,1, 4710
24,4709,1,1,0, 4710
23,4708,3,3,0, 4711
30,4713,3,3,1, 4716
29,4718,4,4,1, 4722
6,4730,2,4,1, 4734
8,4736,1,1,0, 4737
16,4739,2,2,1, 4741
15,4741,2,2,1, 4743
22,4746,4,4,1, 4750
24,4749,1,1,0, 4750
23,4748,3,3,0, 4751
31,4756,2,2,1, 4758
6,4770,2,4,1, 4774
8,4776,1,1,1, 4777
16,4779,2,2,1, 4781
15,4781,2,2,1, 4783
22,4786,4,4,1, 4790
24,4789,1,1,1, 4790
23,4788,3,3,1, 4791
30,4793,3,3,1, 4796
31,4796,2,2,1, 4798
2,4803,2,2,1, 4805
1,4806,1,1,1, 4807
3,4807,3,3,1, 4810
5,4807,3,5,1, 4812
8,4816,1,1,1, 4817
11,4814,4,4,1, 4818
9,4817,2,2,1, 4819
16,4819,2,2,1, 4821
15,4821,2,2,1, 4823
20,4823,6,6,1, 4829
22,4826,4,4,1, 4830
24,4829,1,1,0, 4830
23,4828,3,3,0, 4831
30,4833,3,3,1, 4836
29,4838,4,4,1, 4842
1,4846,1,1,1, 4847
5,4847,3,5,1, 4852
8,4856,1,1,1, 4857
16,4859,2,2,0, 4861
17,4859,3,3,1, 4862
15,4861,2,2,0, 4863
13,4859,4,6,1, 4865
18,4863,4,4,1, 4867
20,4863,6,6,1, 4869
22,4866,4,4,0, 4870
24,4869,1,1,0, 4870
23,4868,3,3,0, 4871
25,4875,2,2,1, 4877
31,4876,2,2,1, 4878
28,4874,5,5,1, 4879
29,4878,4,4,1, 4882
1,4886,1,1,0, 4887
6,4890,2,4,1, 4894
8,4896,1,1,1, 4897
16,4899,2,2,1, 4901
17,4899,3,3,1, 4902
15,4901,2,2,0, 4903
13,4899,4,6,1, 4905
18,4903,4,4,1, 4907
22,4906,4,4,1, 4910
24,4909,1,1,1, 4910
19,4906,5,5,1, 4911
23,4908,3,3,1, 4911
30,4913,3,3,1, 4916
25,4915,2,2,1, 4917
28,4914,5,5,1, 4919
29,4918,4,4,1, 4922
1,4926,1,1,1, 4927
8,4936,1,1,0, 4937
11,4934,4,4,1, 4938
16,4939,2,2,1, 4941
17,4939,3,3,1, 4942
15,4941,2,2,0, 4943
13,4939,4,6,1, 4945
12,4940,5,5,1, 4945
20,4943,6,6,1, 4949
22,4946,4,4,1, 4950
24,4949,1,1,0, 4950
19,4946,5,5,1, 4951
23,4948,3,3,1, 4951
30,4953,3,3,1, 4956
25,4955,2,2,1, 4957
31,4956,2,2,1, 4958
28,4954,5,5,1, 4959
26,4957,3,3,1, 4960
1,4966,1,1,1, 4967
3,4967,3,3,1, 4970
5,4967,3,5,1, 4972
6,4970,2,4,1, 4974
8,4976,1,1,0, 4977
9,4977,2,2,1, 4979
16,4979,2,2,1, 4981
15,4981,2,2,0, 4983
13,4979,4,6,1, 4985
12,4980,5,5,1, 4985
18,4983,4,4,1, 4987
20,4983,6,6,1, 4989
22,4986,4,4,1, 4990
24,4989,1,1,1, 4990
23,4988,3,3,0, 4991
25,4995,2,2,1, 4997
31,4996,2,2,1, 4998
26,4997,3,3,1, 5000
29,4998,4,4,1, 5002
2,5003,2,2,1, 5005
1,5006,1,1,1, 5007
5,5007,3,5,1, 5012
6,5010,2,4,1, 5014
8,5016,1,1,1, 5017
11,5014,4,4,1, 5018
16,5019,2,2,0, 5021
17,5019,3,3,1, 5022
15,5021,2,2,1, 5023
18,5023,4,4,1, 5027
22,5026,4,4,0, 5030
24,5029,1,1,0, 5030
23,5028,3,3,0, 5031
30,5033,3,3,1, 5036
31,5036,2,2,1, 5038
29,5038,4,4,1, 5042
8,5056,1,1,0, 5057
16,5059,2,2,0, 5061
15,5061,2,2,0, 5063
22,5066,4,4,0, 5070
24,5069,1,1,0, 5070
23,5068,3,3,0, 5071
31,5076,2,2,1, 5078
29,5078,4,4,1, 5082
8,5096,1,1,1, 5097
16,5099,2,2,0, 5101
15,5101,2,2,1, 5103
22,5106,4,4,1, 5110
24,5109,1,1,0, 5110
23,5108,3,3,1, 5111
30,5113,3,3,1, 5116
3,5127,3,3,1, 5130
8,5136,1,1,1, 5137
11,5134,4,4,1, 5138
16,5139,2,2,0, 5141
15,5141,2,2,1, 5143
12,5140,5,5,1, 5145
20,5143,6,6,1, 5149
22,5146,4,4,1, 5150
24,5149,1,1,0, 5150
19,5146,5,5,1, 5151
23,5148,3,3,0, 5151
30,5153,3,3,1, 5156
31,5156,2,2,1, 5158
28,5154,5,5,0, 5159
26,5157,3,3,1, 5160
29,5158,4,4,0, 5162
2,5163,2,2,1, 5165
1,5166,1,1,1, 5167
3,5167,3,3,1, 5170
5,5167,3,5,1, 5172
6,5170,2,4,1, 5174
8,5176,1,1,1, 5177
9,5177,2,2,1, 5179
16,5179,2,2,0, 5181
17,5179,3,3,1, 5182
15,5181,2,2,0, 5183
18,5183,4,4,1, 5187
20,5183,6,6,1, 5189
22,5186,4,4,0, 5190
24,5189,1,1,1, 5190
19,5186,5,5,1, 5191
23,5188,3,3,1, 5191
30,5193,3,3,1, 5196
25,5195,2,2,1, 5197
31,5196,2,2,1, 5198
28,5194,5,5,1, 5199
26,5197,3,3,1, 5200
29,5198,4,4,0, 5202
1,5206,1,1,1, 5207
3,5207,3,3,1, 5210
5,5207,3,5,0, 5212
6,5210,2,4,1, 5214
8,5216,1,1,1, 5217
11,5214,4,4,1, 5218
9,5217,2,2,1, 5219
16,5219,2,2,1, 5221
15,5221,2,2,1, 5223
18,5223,4,4,1, 5227
22,5226,4,4,1, 5230
24,5229,1,1,0, 5230
23,5228,3,3,0, 5231
30,5233,3,3,0, 5236
31,5236,2,2,1, 5238
28,5234,5,5,0, 5239
29,5238,4,4,0, 5242
1,5246,1,1,0, 5247
5,5247,3,5,0, 5252
6,5250,2,4,1, 5254
8,5256,1,1,1, 5257
9,5257,2,2,1, 5259
16,5259,2,2,1, 5261
15,5261,2,2,1, 5263
22,5266,4,4,1, 5270
24,5269,1,1,0, 5270
23,5268,3,3,1, 5271
30,5273,3,3,0, 5276
31,5276,2,2,0, 5278
28,5274,5,5,0, 5279
29,5278,4,4,0, 5282
1,5286,1,1,1, 5287
5,5287,3,5,1, 5292
6,5290,2,4,0, 5294
8,5296,1,1,0, 5297
16,5299,2,2,1, 5301
17,5299,3,3,1, 5302
15,5301,2,2,1, 5303
22,5306,4,4,1, 5310
24,5309,1,1,0, 5310
23,5308,3,3,1, 5311
30,5313,3,3,1, 5316
25,5315,2,2,1, 5317
31,5316,2,2,0, 5318
28,5314,5,5,0, 5319
29,5318,4,4,1, 5322
1,5326,1,1,0, 5327
3,5327,3,3,1, 5330
5,5327,3,5,1, 5332
6,5330,2,4,1, 5334
8,5336,1,1,1, 5337
16,5339,2,2,0, 5341
17,5339,3,3,1, 5342
15,5341,2,2,0, 5343
12,5340,5,5,1, 5345
18,5343,4,4,1, 5347
20,5343,6,6,1, 5349
22,5346,4,4,0, 5350
24,5349,1,1,0, 5350
23,5348,3,3,0, 5351
30,5353,3,3,0, 5356
31,5356,2,2,1, 5358
28,5354,5,5,0, 5359
29,5358,4,4,1, 5362
1,5366,1,1,0, 5367
5,5367,3,5,1, 5372
6,5370,2,4,1, 5374
8,5376,1,1,0, 5377
16,5379,2,2,1, 5381
15,5381,2,2,1, 5383
13,5379,4,6,1, 5385
18,5383,4,4,1, 5387
20,5383,6,6,1, 5389
22,5386,4,4,1, 5390
24,5389,1,1,1, 5390
23,5388,3,3,0, 5391
30,5393,3,3,0, 5396
25,5395,2,2,1, 5397
31,5396,2,2,1, 5398
28,5394,5,5,1, 5399
29,5398,4,4,1, 5402
1,5406,1,1,1, 5407
5,5407,3,5,1, 5412
6,5410,2,4,1, 5414
8,5416,1,1,0, 5417
9,5417,2,2,1, 5419
16,5419,2,2,1, 5421
15,5421,2,2,0, 5423
13,5419,4,6,1, 5425
12,5420,5,5,1, 5425
18,5423,4,4,1, 5427
22,5426,4,4,1, 5430
24,5429,1,1,0, 5430
19,5426,5,5,1, 5431
23,5428,3,3,1, 5431
30,5433,3,3,0, 5436
25,5435,2,2,1, 5437
31,5436,2,2,1, 5438
28,5434,5,5,0, 5439
29,5438,4,4,0, 5442
2,5443,2,2,1, 5445
1,5446,1,1,0, 5447
5,5447,3,5,0, 5452
6,5450,2,4,1, 5454
8,5456,1,1,0, 5457
9,5457,2,2,1, 5459
16,5459,2,2,1, 5461
17,5459,3,3,1, 5462
15,5461,2,2,1, 5463
18,5463,4,4,1, 5467
22,5466,4,4,1, 5470
24,5469,1,1,0, 5470
19,5466,5,5,1, 5471
23,5468,3,3,0, 5471
30,5473,3,3,1, 5476
25,5475,2,2,1, 5477
31,5476,2,2,0, 5478
28,5474,5,5,0, 5479
26,5477,3,3,1, 5480
29,5478,4,4,1, 5482
2,5483,2,2,1, 5485
1,5486,1,1,0, 5487
3,5487,3,3,1, 5490
5,5487,3,5,0, 5492
6,5490,2,4,0, 5494
8,5496,1,1,1, 5497
16,5499,2,2,0, 5501
15,5501,2,2,1, 5503
22,5506,4,4,0, 5510
24,5509,1,1,0, 5510
23,5508,3,3,0, 5511
30,5513,3,3,1, 5516
31,5516,2,2,1, 5518
28,5514,5,5,1, 5519
29,5518,4,4,0, 5522
6,5530,2,4,1, 5534
8,5536,1,1,0, 5537
16,5539,2,2,1, 5541
15,5541,2,2,0, 5543
22,5546,4,4,1, 5550
24,5549,1,1,1, 5550
23,5548,3,3,1, 5551
30,5553,3,3,1, 5556
28,5554,5,5,1, 5559
8,5576,1,1,0, 5577
16,5579,2,2,1, 5581
15,5581,2,2,1, 5583
22,5586,4,4,1, 5590
24,5589,1,1,0, 5590
23,5588,3,3,1, 5591
30,5593,3,3,1, 5596
29,5598,4,4,1, 5602
2,5603,2,2,1, 5605
1,5606,1,1,1, 5607
3,5607,3,3,1, 5610
6,5610,2,4,1, 5614
8,5616,1,1,0, 5617
9,5617,2,2,1, 5619
16,5619,2,2,1, 5621
17,5619,3,3,1, 5622
15,5621,2,2,0, 5623
12,5620,5,5,1, 5625
18,5623,4,4,1, 5627
22,5626,4,4,1, 5630
24,5629,1,1,0, 5630
23,5628,3,3,1, 5631
30,5633,3,3,1, 5636
25,5635,2,2,1, 5637
26,5637,3,3,1, 5640
29,5638,4,4,1, 5642
2,5643,2,2,1, 5645
1,5646,1,1,0, 5647
5,5647,3,5,1, 5652
6,5650,2,4,1, 5654
8,5656,1,1,0, 5657
11,5654,4,4,1, 5658
9,5657,2,2,1, 5659
16,5659,2,2,0, 5661
15,5661,2,2,0, 5663
18,5663,4,4,1, 5667
22,5666,4,4,0, 5670
24,5669,1,1,0, 5670
19,5666,5,5,1, 5671
23,5668,3,3,0, 5671
30,5673,3,3,1, 5676
28,5674,5,5,1, 5679
29,5678,4,4,1, 5682
2,5683,2,2,1, 5685
1,5686,1,1,1, 5687
3,5687,3,3,1, 5690
5,5687,3,5,1, 5692
8,5696,1,1,1, 5697
11,5694,4,4,1, 5698
16,5699,2,2,0, 5701
15,5701,2,2,1, 5703
13,5699,4,6,1, 5705
12,5700,5,5,1, 5705
22,5706,4,4,0, 5710
24,5709,1,1,0, 5710
23,5708,3,3,1, 5711
31,5716,2,2,1, 5718
2,5723,2,2,1, 5725
1,5726,1,1,0, 5727
3,5727,3,3,1, 5730
6,5730,2,4,1, 5734
8,5736,1,1,1, 5737
11,5734,4,4,1, 5738
16,5739,2,2,0, 5741
17,5739,3,3,1, 5742
15,5741,2,2,1, 5743
12,5740,5,5,1, 5745
18,5743,4,4,1, 5747
20,5743,6,6,1, 5749
22,5746,4,4,0, 5750
24,5749,1,1,1, 5750
23,5748,3,3,1, 5751
30,5753,3,3,1, 5756
25,5755,2,2,1, 5757
26,5757,3,3,1, 5760
29,5758,4,4,1, 5762
1,5766,1,1,1, 5767
8,5776,1,1,1, 5777
9,5777,2,2,1, 5779
16,5779,2,2,1, 5781
15,5781,2,2,0, 5783
13,5779,4,6,1, 5785
22,5786,4,4,1, 5790
24,5789,1,1,0, 5790
23,5788,3,3,1, 5791
30,5793,3,3,1, 5796
25,5795,2,2,1, 5797
31,5796,2,2,1, 5798
28,5794,5,5,1, 5799
2,5803,2,2,1, 5805
1,5806,1,1,1, 5807
8,5816,1,1,0, 5817
11,5814,4,4,1, 5818
9,5817,2,2,1, 5819
16,5819,2,2,1, 5821
17,5819,3,3,1, 5822
15,5821,2,2,1, 5823
22,5826,4,4,0, 5830
24,5829,1,1,1, 5830
23,5828,3,3,0, 5831
30,5833,3,3,1, 5836
31,5836,2,2,1, 5838
28,5834,5,5,1, 5839
29,5838,4,4,1, 5842
5,5847,3,5,1, 5852
8,5856,1,1,1, 5857
16,5859,2,2,0, 5861
15,5861,2,2,1, 5863
22,5866,4,4,1, 5870
24,5869,1,1,1, 5870
23,5868,3,3,0, 5871
30,5873,3,3,1, 5876
28,5874,5,5,1, 5879
29,5878,4,4,1, 5882
5,5887,3,5,1, 5892
8,5896,1,1,0, 5897
16,5899,2,2,1, 5901
15,5901,2,2,0, 5903
22,5906,4,4,1, 5910
24,5909,1,1,1, 5910
23,5908,3,3,0, 5911
30,5913,3,3,1, 5916
29,5918,4,4,1, 5922
1,5926,1,1,0, 5927
3,5927,3,3,1, 5930
8,5936,1,1,1, 5937
11,5934,4,4,1, 5938
16,5939,2,2,1, 5941
15,5941,2,2,0, 5943
18,5943,4,4,1, 5947
22,5946,4,4,1, 5950
24,5949,1,1,1, 5950
23,5948,3,3,0, 5951
31,5956,2,2,1, 5958
26,5957,3,3,1, 5960
29,5958,4,4,1, 5962
2,5963,2,2,1, 5965
1,5966,1,1,0, 5967
8,5976,1,1,0, 5977
11,5974,4,4,1, 5978
16,5979,2,2,1, 5981
17,5979,3,3,1, 5982
15,5981,2,2,0, 5983
13,5979,4,6,1, 5985
12,5980,5,5,1, 5985
22,5986,4,4,1, 5990
24,5989,1,1,1, 5990
19,5986,5,5,1, 5991
23,5988,3,3,1, 5991
31,5996,2,2,1, 5998
29,5998,4,4,1, 6002
1,6006,1,1,0, 6007
3,6007,3,3,1, 6010
5,6007,3,5,1, 6012
6,6010,2,4,1, 6014
8,6016,1,1,1, 6017
11,6014,4,4,1, 6018
16,6019,2,2,0, 6021
15,6021,2,2,0, 6023
20,6023,6,6,1, 6029
22,6026,4,4,0, 6030
24,6029,1,1,1, 6030
23,6028,3,3,0, 6031
30,6033,3,3,1, 6036
28,6034,5,5,1, 6039
26,6037,3,3,1, 6040
1,6046,1,1,1, 6047
3,6047,3,3,1, 6050
6,6050,2,4,1, 6054
8,6056,1,1,0, 6057
11,6054,4,4,1, 6058
16,6059,2,2,1, 6061
17,6059,3,3,1, 6062
15,6061,2,2,1, 6063
13,6059,4,6,1, 6065
20,6063,6,6,1, 6069
22,6066,4,4,0, 6070
24,6069,1,1,0, 6070
23,6068,3,3,0, 6071
25,6075,2,2,1, 6077
31,6076,2,2,1, 6078
28,6074,5,5,1, 6079
26,6077,3,3,1, 6080
29,6078,4,4,1, 6082
1,6086,1,1,0, 6087
3,6087,3,3,1, 6090
6,6090,2,4,1, 6094
8,6096,1,1,1, 6097
9,6097,2,2,1, 6099
16,6099,2,2,1, 6101
17,6099,3,3,1, 6102
15,6101,2,2,1, 6103
13,6099,4,6,1, 6105
22,6106,4,4,0, 6110
24,6109,1,1,0, 6110
19,6106,5,5,1, 6111
23,6108,3,3,0, 6111
30,6113,3,3,1, 6116
25,6115,2,2,1, 6117
31,6116,2,2,1, 6118
28,6114,5,5,1, 6119
26,6117,3,3,1, 6120
2,6123,2,2,1, 6125
1,6126,1,1,0, 6127
3,6127,3,3,1, 6130
5,6127,3,5,1, 6132
8,6136,1,1,0, 6137
11,6134,4,4,1, 6138
9,6137,2,2,1, 6139
16,6139,2,2,0, 6141
15,6141,2,2,0, 6143
22,6146,4,4,1, 6150
24,6149,1,1,1, 6150
23,6148,3,3,0, 6151
30,6153,3,3,1, 6156
31,6156,2,2,1, 6158
5,6167,3,5,1, 6172
6,6170,2,4,1, 6174
8,6176,1,1,0, 6177
16,6179,2,2,0, 6181
15,6181,2,2,1, 6183
22,6186,4,4,0, 6190
24,6189,1,1,0, 6190
23,6188,3,3,1, 6191
30,6193,3,3,1, 6196
5,6207,3,5,1, 6212
6,6210,2,4,1, 6214
8,6216,1,1,1, 6217
16,6219,2,2,0, 6221
15,6221,2,2,0, 6223
22,6226,4,4,0, 6230
24,6229,1,1,1, 6230
23,6228,3,3,0, 6231
28,6234,5,5,1, 6239
1,6246,1,1,0, 6247
6,6250,2,4,1, 6254
8,6256,1,1,0, 6257
9,6257,2,2,1, 6259
16,6259,2,2,1, 6261
17,6259,3,3,1, 6262
15,6261,2,2,0, 6263
22,6266,4,4,0, 6270
24,6269,1,1,0, 6270
23,6268,3,3,0, 6271
30,6273,3,3,1, 6276
28,6274,5,5,1, 6279
29,6278,4,4,1, 6282
1,6286,1,1,0, 6287
8,6296,1,1,0, 6297
16,6299,2,2,0, 6301
15,6301,2,2,1, 6303
22,6306,4,4,0, 6310
24,6309,1,1,1, 6310
23,6308,3,3,1, 6311
28,6314,5,5,1, 6319
1,6326,1,1,1, 6327
5,6327,3,5,1, 6332
8,6336,1,1,1, 6337
9,6337,2,2,1, 6339
16,6339,2,2,0, 6341
15,6341,2,2,0, 6343
18,6343,4,4,1, 6347
20,6343,6,6,1, 6349
22,6346,4,4,1, 6350
24,6349,1,1,1, 6350
19,6346,5,5,1, 6351
23,6348,3,3,0, 6351
30,6353,3,3,1, 6356
25,6355,2,2,1, 6357
26,6357,3,3,1, 6360
2,6363,2,2,1, 6365
1,6366,1,1,1, 6367
3,6367,3,3,1, 6370
6,6370,2,4,1, 6374
8,6376,1,1,1, 6377
11,6374,4,4,1, 6378
9,6377,2,2,1, 6379
16,6379,2,2,1, 6381
17,6379,3,3,1, 6382
15,6381,2,2,0, 6383
12,6380,5,5,1, 6385
22,6386,4,4,0, 6390
24,6389,1,1,0, 6390
23,6388,3,3,0, 6391
30,6393,3,3,1, 6396
2,6403,2,2,1, 6405
1,6406,1,1,0, 6407
3,6407,3,3,1, 6410
5,6407,3,5,1, 6412
6,6410,2,4,1, 6414
8,6416,1,1,0, 6417
11,6414,4,4,1, 6418
9,6417,2,2,1, 6419
16,6419,2,2,1, 6421
15,6421,2,2,0, 6423
12,6420,5,5,1, 6425
22,6426,4,4,1, 6430
24,6429,1,1,0, 6430
19,6426,5,5,1, 6431
23,6428,3,3,0, 6431
31,6436,2,2,1, 6438
28,6434,5,5,1, 6439
29,6438,4,4,1, 6442
2,6443,2,2,1, 6445
1,6446,1,1,0, 6447
3,6447,3,3,1, 6450
5,6447,3,5,1, 6452
8,6456,1,1,1, 6457
11,6454,4,4,1, 6458
16,6459,2,2,1, 6461
15,6461,2,2,1, 6463
13,6459,4,6,1, 6465
12,6460,5,5,1, 6465
18,6463,4,4,1, 6467
20,6463,6,6,1, 6469
22,6466,4,4,1, 6470
24,6469,1,1,1, 6470
23,6468,3,3,0, 6471
30,6473,3,3,1, 6476
25,6475,2,2,1, 6477
31,6476,2,2,1, 6478
26,6477,3,3,1, 6480
1,6486,1,1,1, 6487
8,6496,1,1,0, 6497
9,6497,2,2,1, 6499
16,6499,2,2,1, 6501
15,6501,2,2,1, 6503
12,6500,5,5,1, 6505
22,6506,4,4,0, 6510
24,6509,1,1,0, 6510
19,6506,5,5,1, 6511
23,6508,3,3,0, 6511
30,6513,3,3,1, 6516
28,6514,5,5,1, 6519
26,6517,3,3,1, 6520
29,6518,4,4,1, 6522
2,6523,2,2,1, 6525
1,6526,1,1,1, 6527
5,6527,3,5,1, 6532
6,6530,2,4,1, 6534
8,6536,1,1,1, 6537
16,6539,2,2,0, 6541
17,6539,3,3,1, 6542
15,6541,2,2,0, 6543
12,6540,5,5,1, 6545
18,6543,4,4,1, 6547
20,6543,6,6,1, 6549
22,6546,4,4,1, 6550
24,6549,1,1,1, 6550
19,6546,5,5,1, 6551
23,6548,3,3,0, 6551
29,6558,4,4,1, 6562
2,6563,2,2,1, 6565
1,6566,1,1,0, 6567
5,6567,3,5,1, 6572
8,6576,1,1,0, 6577
16,6579,2,2,1, 6581
13,6579,4,6,1, 6585
18,6583,4,4,1, 6587
20,6583,6,6,1, 6589
24,6589,1,1,1, 6590
19,6586,5,5,1, 6591
23,6588,3,3,1, 6591
30,6593,3,3,1, 6596
29,6598,4,4,1, 6602
6,6610,2,4,1, 6614
8,6616,1,1,0, 6617
24,6629,1,1,0, 6630
23,6628,3,3,1, 6631
30,6633,3,3,1, 6636
29,6638,4,4,1, 6642
5,6647,3,5,1, 6652
8,6656,1,1,0, 6657
15,6661,2,2,1, 6663
24,6669,1,1,1, 6670
30,6673,3,3,1, 6676
31,6676,2,2,1, 6678
28,6674,5,5,1, 6679
29,6678,4,4,1, 6682
5,6687,3,5,1, 6692
6,6690,2,4,1, 6694
8,6696,1,1,0, 6697
15,6701,2,2,1, 6703
22,6706,4,4,1, 6710
24,6709,1,1,1, 6710
31,6716,2,2,1, 6718
1,6726,1,1,1, 6727
8,6736,1,1,0, 6737
9,6737,2,2,1, 6739
16,6739,2,2,1, 6741
22,6746,4,4,1, 6750
24,6749,1,1,0, 6750
30,6753,3,3,1, 6756
25,6755,2,2,1, 6757
31,6756,2,2,1, 6758
1,6766,1,1,0, 6767
6,6770,2,4,1, 6774
8,6776,1,1,0, 6777
11,6774,4,4,1, 6778
16,6779,2,2,1, 6781
17,6779,3,3,1, 6782
15,6781,2,2,1, 6783
13,6779,4,6,1, 6785
12,6780,5,5,1, 6785
22,6786,4,4,1, 6790
24,6789,1,1,1, 6790
23,6788,3,3,1, 6791
25,6795,2,2,1, 6797
31,6796,2,2,1, 6798
28,6794,5,5,1, 6799
2,6803,2,2,1, 6805
1,6806,1,1,1, 6807
6,6810,2,4,1, 6814
8,6816,1,1,0, 6817
11,6814,4,4,1, 6818
18,6823,4,4,1, 6827
20,6823,6,6,1, 6829
22,6826,4,4,1, 6830
24,6829,1,1,1, 6830
19,6826,5,5,1, 6831
30,6833,3,3,1, 6836
31,6836,2,2,1, 6838
26,6837,3,3,1, 6840
2,6843,2,2,1, 6845
1,6846,1,1,0, 6847
5,6847,3,5,1, 6852
8,6856,1,1,1, 6857
9,6857,2,2,1, 6859
15,6861,2,2,1, 6863
12,6860,5,5,1, 6865
24,6869,1,1,1, 6870
19,6866,5,5,1, 6871
23,6868,3,3,1, 6871
30,6873,3,3,1, 6876
31,6876,2,2,1, 6878
26,6877,3,3,1, 6880
29,6878,4,4,1, 6882
1,6886,1,1,1, 6887
5,6887,3,5,1, 6892
8,6896,1,1,1, 6897
11,6894,4,4,1, 6898
17,6899,3,3,1, 6902
20,6903,6,6,1, 6909
24,6909,1,1,0, 6910
19,6906,5,5,1, 6911
25,6915,2,2,1, 6917
28,6914,5,5,1, 6919
26,6917,3,3,1, 6920
1,6926,1,1,1, 6927
6,6930,2,4,1, 6934
8,6936,1,1,1, 6937
9,6937,2,2,1, 6939
15,6941,2,2,1, 6943
18,6943,4,4,1, 6947
24,6949,1,1,0, 6950
19,6946,5,5,1, 6951
30,6953,3,3,1, 6956
26,6957,3,3,1, 6960
29,6958,4,4,1, 6962
1,6966,1,1,0, 6967
3,6967,3,3,1, 6970
8,6976,1,1,1, 6977
11,6974,4,4,1, 6978
13,6979,4,6,1, 6985
12,6980,5,5,1, 6985
22,6986,4,4,1, 6990
24,6989,1,1,1, 6990
23,6988,3,3,1, 6991
31,6996,2,2,1, 6998
28,6994,5,5,1, 6999
26,6997,3,3,1, 7000
2,7003,2,2,1, 7005
1,7006,1,1,1, 7007
8,7016,1,1,0, 7017
16,7019,2,2,1, 7021
17,7019,3,3,1, 7022
15,7021,2,2,1, 7023
13,7019,4,6,1, 7025
18,7023,4,4,1, 7027
20,7023,6,6,1, 7029
24,7029,1,1,1, 7030
23,7028,3,3,1, 7031
26,7037,3,3,1, 7040
2,7043,2,2,1, 7045
1,7046,1,1,1, 7047
8,7056,1,1,1, 7057
9,7057,2,2,1, 7059
16,7059,2,2,1, 7061
22,7066,4,4,1, 7070
24,7069,1,1,0, 7070
19,7066,5,5,1, 7071
25,7075,2,2,1, 7077
31,7076,2,2,1, 7078
28,7074,5,5,1, 7079
26,7077,3,3,1, 7080
1,7086,1,1,1, 7087
3,7087,3,3,1, 7090
5,7087,3,5,1, 7092
8,7096,1,1,0, 7097
11,7094,4,4,1, 7098
16,7099,2,2,1, 7101
17,7099,3,3,1, 7102
15,7101,2,2,1, 7103
12,7100,5,5,1, 7105
22,7106,4,4,1, 7110
24,7109,1,1,0, 7110
23,7108,3,3,1, 7111
28,7114,5,5,1, 7119
2,7123,2,2,1, 7125
1,7126,1,1,0, 7127
5,7127,3,5,1, 7132
6,7130,2,4,1, 7134
8,7136,1,1,0, 7137
11,7134,4,4,1, 7138
17,7139,3,3,1, 7142
15,7141,2,2,1, 7143
18,7143,4,4,1, 7147
20,7143,6,6,1, 7149
22,7146,4,4,1, 7150
24,7149,1,1,1, 7150
23,7148,3,3,1, 7151
30,7153,3,3,1, 7156
28,7154,5,5,1, 7159
2,7163,2,2,1, 7165
1,7166,1,1,0, 7167
6,7170,2,4,1, 7174
8,7176,1,1,1, 7177
11,7174,4,4,1, 7178
17,7179,3,3,1, 7182
15,7181,2,2,1, 7183
18,7183,4,4,1, 7187
24,7189,1,1,1, 7190
19,7186,5,5,1, 7191
30,7193,3,3,1, 7196
28,7194,5,5,1, 7199
29,7198,4,4,1, 7202
8,7216,1,1,1, 7217
16,7219,2,2,0, 7221
15,7221,2,2,1, 7223
22,7226,4,4,1, 7230
24,7229,1,1,1, 7230
23,7228,3,3,0, 7231
28,7234,5,5,1, 7239
29,7238,4,4,1, 7242
5,7247,3,5,1, 7252
6,7250,2,4,1, 7254
8,7256,1,1,0, 7257
16,7259,2,2,1, 7261
15,7261,2,2,1, 7263
22,7266,4,4,1, 7270
24,7269,1,1,0, 7270
23,7268,3,3,1, 7271
6,7290,2,4,1, 7294
8,7296,1,1,0, 7297
11,7294,4,4,1, 7298
16,7299,2,2,0, 7301
17,7299,3,3,1, 7302
15,7301,2,2,0, 7303
13,7299,4,6,1, 7305
12,7300,5,5,1, 7305
20,7303,6,6,1, 7309
22,7306,4,4,0, 7310
24,7309,1,1,1, 7310
19,7306,5,5,1, 7311
23,7308,3,3,0, 7311
31,7316,2,2,1, 7318
28,7314,5,5,1, 7319
26,7317,3,3,1, 7320
2,7323,2,2,1, 7325
1,7326,1,1,0, 7327
5,7327,3,5,1, 7332
8,7336,1,1,0, 7337
9,7337,2,2,1, 7339
16,7339,2,2,1, 7341
17,7339,3,3,1, 7342
15,7341,2,2,0, 7343
13,7339,4,6,1, 7345
22,7346,4,4,1, 7350
24,7349,1,1,0, 7350
23,7348,3,3,0, 7351
25,7355,2,2,1, 7357
28,7354,5,5,1, 7359
26,7357,3,3,1, 7360
1,7366,1,1,0, 7367
5,7367,3,5,1, 7372
8,7376,1,1,0, 7377
11,7374,4,4,1, 7378
9,7377,2,2,1, 7379
16,7379,2,2,1, 7381
15,7381,2,2,0, 7383
13,7379,4,6,1, 7385
12,7380,5,5,1, 7385
22,7386,4,4,1, 7390
24,7389,1,1,1, 7390
23,7388,3,3,0, 7391
30,7393,3,3,1, 7396
25,7395,2,2,1, 7397
28,7394,5,5,1, 7399
2,7403,2,2,1, 7405
1,7406,1,1,0, 7407
5,7407,3,5,1, 7412
6,7410,2,4,1, 7414
8,7416,1,1,0, 7417
11,7414,4,4,1, 7418
16,7419,2,2,1, 7421
15,7421,2,2,0, 7423
12,7420,5,5,1, 7425
20,7423,6,6,1, 7429
22,7426,4,4,0, 7430
24,7429,1,1,0, 7430
23,7428,3,3,1, 7431
30,7433,3,3,1, 7436
25,7435,2,2,1, 7437
26,7437,3,3,1, 7440
2,7443,2,2,1, 7445
1,7446,1,1,1, 7447
5,7447,3,5,1, 7452
6,7450,2,4,1, 7454
8,7456,1,1,0, 7457
16,7459,2,2,1, 7461
15,7461,2,2,1, 7463
12,7460,5,5,1, 7465
18,7463,4,4,1, 7467
20,7463,6,6,1, 7469
22,7466,4,4,0, 7470
24,7469,1,1,0, 7470
23,7468,3,3,1, 7471
30,7473,3,3,1, 7476
26,7477,3,3,1, 7480
1,7486,1,1,1, 7487
3,7487,3,3,1, 7490
5,7487,3,5,1, 7492
6,7490,2,4,1, 7494
8,7496,1,1,1, 7497
9,7497,2,2,1, 7499
16,7499,2,2,1, 7501
17,7499,3,3,1, 7502
15,7501,2,2,1, 7503
22,7506,4,4,0, 7510
24,7509,1,1,0, 7510
23,7508,3,3,1, 7511
30,7513,3,3,1, 7516
31,7516,2,2,1, 7518
8,7536,1,1,1, 7537
16,7539,2,2,1, 7541
15,7541,2,2,1, 7543
22,7546,4,4,1, 7550
24,7549,1,1,0, 7550
23,7548,3,3,1, 7551
28,7554,5,5,1, 7559
29,7558,4,4,1, 7562
5,7567,3,5,1, 7572
6,7570,2,4,1, 7574
8,7576,1,1,1, 7577
16,7579,2,2,1, 7581
15,7581,2,2,0, 7583
22,7586,4,4,1, 7590
24,7589,1,1,0, 7590
23,7588,3,3,1, 7591
31,7596,2,2,1, 7598
28,7594,5,5,1, 7599
29,7598,4,4,1, 7602
1,7606,1,1,0, 7607
5,7607,3,5,1, 7612
6,7610,2,4,1, 7614
8,7616,1,1,1, 7617
16,7619,2,2,1, 7621
15,7621,2,2,1, 7623
13,7619,4,6,1, 7625
12,7620,5,5,1, 7625
18,7623,4,4,1, 7627
20,7623,6,6,1, 7629
22,7626,4,4,0, 7630
24,7629,1,1,0, 7630
19,7626,5,5,1, 7631
23,7628,3,3,1, 7631
1,7646,1,1,1, 7647
3,7647,3,3,1, 7650
6,7650,2,4,1, 7654
8,7656,1,1,1, 7657
9,7657,2,2,1, 7659
16,7659,2,2,1, 7661
15,7661,2,2,0, 7663
13,7659,4,6,1, 7665
12,7660,5,5,1, 7665
22,7666,4,4,1, 7670
24,7669,1,1,1, 7670
19,7666,5,5,1, 7671
23,7668,3,3,0, 7671
30,7673,3,3,1, 7676
25,7675,2,2,1, 7677
29,7678,4,4,1, 7682
1,7686,1,1,0, 7687
3,7687,3,3,1, 7690
8,7696,1,1,0, 7697
11,7694,4,4,1, 7698
9,7697,2,2,1, 7699
16,7699,2,2,1, 7701
17,7699,3,3,1, 7702
15,7701,2,2,0, 7703
13,7699,4,6,1, 7705
12,7700,5,5,1, 7705
22,7706,4,4,1, 7710
24,7709,1,1,1, 7710
19,7706,5,5,1, 7711
23,7708,3,3,1, 7711
30,7713,3,3,0, 7716
31,7716,2,2,1, 7718
28,7714,5,5,0, 7719
26,7717,3,3,1, 7720
29,7718,4,4,1, 7722
2,7723,2,2,1, 7725
1,7726,1,1,1, 7727
5,7727,3,5,1, 7732
6,7730,2,4,1, 7734
8,7736,1,1,1, 7737
11,7734,4,4,1, 7738
9,7737,2,2,1, 7739
16,7739,2,2,1, 7741
15,7741,2,2,0, 7743
13,7739,4,6,1, 7745
20,7743,6,6,1, 7749
22,7746,4,4,0, 7750
24,7749,1,1,0, 7750
23,7748,3,3,0, 7751
30,7753,3,3,1, 7756
31,7756,2,2,0, 7758
28,7754,5,5,0, 7759
26,7757,3,3,1, 7760
29,7758,4,4,1, 7762
2,7763,2,2,1, 7765
1,7766,1,1,0, 7767
5,7767,3,5,1, 7772
6,7770,2,4,1, 7774
8,7776,1,1,0, 7777
11,7774,4,4,1, 7778
9,7777,2,2,1, 7779
16,7779,2,2,0, 7781
15,7781,2,2,1, 7783
12,7780,5,5,1, 7785
18,7783,4,4,1, 7787
22,7786,4,4,1, 7790
24,7789,1,1,0, 7790
23,7788,3,3,0, 7791
30,7793,3,3,1, 7796
31,7796,2,2,1, 7798
28,7794,5,5,0, 7799
29,7798,4,4,0, 7802
5,7807,3,5,1, 7812
6,7810,2,4,1, 7814
8,7816,1,1,0, 7817
16,7819,2,2,1, 7821
15,7821,2,2,0, 7823
22,7826,4,4,0, 7830
24,7829,1,1,1, 7830
23,7828,3,3,1, 7831
30,7833,3,3,1, 7836
31,7836,2,2,0, 7838
28,7834,5,5,0, 7839
29,7838,4,4,1, 7842
5,7847,3,5,1, 7852
6,7850,2,4,0, 7854
8,7856,1,1,0, 7857
16,7859,2,2,0, 7861
15,7861,2,2,0, 7863
22,7866,4,4,0, 7870
24,7869,1,1,0, 7870
23,7868,3,3,0, 7871
30,7873,3,3,1, 7876
31,7876,2,2,0, 7878
28,7874,5,5,0, 7879
29,7878,4,4,1, 7882
5,7887,3,5,1, 7892
6,7890,2,4,0, 7894
8,7896,1,1,0, 7897
9,7897,2,2,1, 7899
16,7899,2,2,0, 7901
15,7901,2,2,1, 7903
13,7899,4,6,1, 7905
20,7903,6,6,1, 7909
22,7906,4,4,0, 7910
24,7909,1,1,1, 7910
23,7908,3,3,0, 7911
30,7913,3,3,1, 7916
25,7915,2,2,1, 7917
31,7916,2,2,1, 7918
28,7914,5,5,1, 7919
26,7917,3,3,1, 7920
29,7918,4,4,1, 7922
1,7926,1,1,1, 7927
3,7927,3,3,1, 7930
5,7927,3,5,1, 7932
6,7930,2,4,1, 7934
8,7936,1,1,1, 7937
16,7939,2,2,0, 7941
17,7939,3,3,1, 7942
15,7941,2,2,0, 7943
22,7946,4,4,1, 7950
24,7949,1,1,1, 7950
23,7948,3,3,1, 7951
25,7955,2,2,1, 7957
31,7956,2,2,0, 7958
28,7954,5,5,1, 7959
29,7958,4,4,1, 7962
1,7966,1,1,0, 7967
5,7967,3,5,1, 7972
8,7976,1,1,1, 7977
16,7979,2,2,0, 7981
17,7979,3,3,1, 7982
15,7981,2,2,0, 7983
22,7986,4,4,1, 7990
24,7989,1,1,1, 7990
23,7988,3,3,1, 7991
30,7993,3,3,1, 7996
25,7995,2,2,1, 7997
31,7996,2,2,1, 7998
28,7994,5,5,1, 7999
29,7998,4,4,1, 8002
1,8006,1,1,0, 8007
8,8016,1,1,0, 8017
16,8019,2,2,0, 8021
17,8019,3,3,1, 8022
15,8021,2,2,1, 8023
22,8026,4,4,1, 8030
24,8029,1,1,1, 8030
23,8028,3,3,1, 8031
31,8036,2,2,1, 8038
28,8034,5,5,1, 8039
1,8046,1,1,0, 8047
8,8056,1,1,1, 8057
11,8054,4,4,1, 8058
16,8059,2,2,1, 8061
17,8059,3,3,1, 8062
15,8061,2,2,0, 8063
13,8059,4,6,1, 8065
12,8060,5,5,1, 8065
20,8063,6,6,1, 8069
22,8066,4,4,0, 8070
24,8069,1,1,1, 8070
23,8068,3,3,0, 8071
31,8076,2,2,0, 8078
28,8074,5,5,1, 8079
29,8078,4,4,1, 8082
2,8083,2,2,1, 8085
1,8086,1,1,1, 8087
3,8087,3,3,1, 8090
5,8087,3,5,1, 8092
8,8096,1,1,1, 8097
9,8097,2,2,1, 8099
16,8099,2,2,0, 8101
17,8099,3,3,1, 8102
15,8101,2,2,1, 8103
18,8103,4,4,1, 8107
22,8106,4,4,0, 8110
24,8109,1,1,0, 8110
23,8108,3,3,0, 8111
25,8115,2,2,1, 8117
31,8116,2,2,1, 8118
29,8118,4,4,1, 8122
2,8123,2,2,1, 8125
1,8126,1,1,0, 8127
3,8127,3,3,1, 8130
6,8130,2,4,1, 8134
8,8136,1,1,0, 8137
9,8137,2,2,1, 8139
16,8139,2,2,1, 8141
17,8139,3,3,1, 8142
15,8141,2,2,1, 8143
13,8139,4,6,1, 8145
12,8140,5,5,1, 8145
18,8143,4,4,1, 8147
22,8146,4,4,0, 8150
24,8149,1,1,1, 8150
19,8146,5,5,1, 8151
23,8148,3,3,0, 8151
30,8153,3,3,1, 8156
25,8155,2,2,1, 8157
31,8156,2,2,0, 8158
26,8157,3,3,1, 8160
29,8158,4,4,1, 8162
1,8166,1,1,1, 8167
3,8167,3,3,1, 8170
5,8167,3,5,1, 8172
8,8176,1,1,1, 8177
16,8179,2,2,0, 8181
15,8181,2,2,1, 8183
13,8179,4,6,1, 8185
12,8180,5,5,1, 8185
18,8183,4,4,1, 8187
22,8186,4,4,0, 8190
24,8189,1,1,1, 8190
23,8188,3,3,0, 8191
30,8193,3,3,1, 8196
25,8195,2,2,1, 8197
31,8196,2,2,1, 8198
26,8197,3,3,1, 8200
29,8198,4,4,1, 8202
2,8203,2,2,1, 8205
1,8206,1,1,1, 8207
3,8207,3,3,1, 8210
5,8207,3,5,1, 8212
8,8216,1,1,1, 8217
11,8214,4,4,1, 8218
16,8219,2,2,0, 8221
15,8221,2,2,0, 8223
13,8219,4,6,1, 8225
18,8223,4,4,1, 8227
22,8226,4,4,1, 8230
24,8229,1,1,0, 8230
19,8226,5,5,1, 8231
23,8228,3,3,0, 8231
31,8236,2,2,1, 8238
28,8234,5,5,1, 8239
1,8246,1,1,1, 8247
5,8247,3,5,1, 8252
6,8250,2,4,1, 8254
8,8256,1,1,0, 8257
11,8254,4,4,1, 8258
16,8259,2,2,1, 8261
15,8261,2,2,1, 8263
13,8259,4,6,1, 8265
20,8263,6,6,1, 8269
22,8266,4,4,0, 8270
24,8269,1,1,0, 8270
23,8268,3,3,1, 8271
31,8276,2,2,1, 8278
28,8274,5,5,1, 8279
2,8283,2,2,1, 8285
1,8286,1,1,0, 8287
5,8287,3,5,1, 8292
6,8290,2,4,1, 8294
8,8296,1,1,0, 8297
16,8299,2,2,1, 8301
15,8301,2,2,1, 8303
18,8303,4,4,1, 8307
22,8306,4,4,0, 8310
24,8309,1,1,1, 8310
23,8308,3,3,0, 8311
30,8313,3,3,1, 8316
31,8316,2,2,1, 8318
28,8314,5,5,1, 8319
1,8326,1,1,0, 8327
6,8330,2,4,1, 8334
8,8336,1,1,0, 8337
16,8339,2,2,0, 8341
15,8341,2,2,0, 8343
13,8339,4,6,1, 8345
18,8343,4,4,1, 8347
22,8346,4,4,1, 8350
24,8349,1,1,1, 8350
19,8346,5,5,1, 8351
23,8348,3,3,1, 8351
30,8353,3,3,1, 8356
31,8356,2,2,1, 8358
26,8357,3,3,1, 8360
1,8366,1,1,1, 8367
8,8376,1,1,1, 8377
16,8379,2,2,1, 8381
17,8379,3,3,1, 8382
15,8381,2,2,1, 8383
18,8383,4,4,1, 8387
20,8383,6,6,1, 8389
22,8386,4,4,0, 8390
24,8389,1,1,1, 8390
19,8386,5,5,1, 8391
23,8388,3,3,1, 8391
30,8393,3,3,1, 8396
31,8396,2,2,0, 8398
28,8394,5,5,1, 8399
26,8397,3,3,1, 8400
29,8398,4,4,1, 8402
1,8406,1,1,0, 8407
3,8407,3,3,1, 8410
5,8407,3,5,1, 8412
8,8416,1,1,1, 8417
16,8419,2,2,1, 8421
17,8419,3,3,1, 8422
15,8421,2,2,0, 8423
13,8419,4,6,1, 8425
20,8423,6,6,1, 8429
22,8426,4,4,0, 8430
24,8429,1,1,0, 8430
23,8428,3,3,0, 8431
30,8433,3,3,1, 8436
31,8436,2,2,1, 8438
28,8434,5,5,1, 8439
29,8438,4,4,1, 8442
1,8446,1,1,0, 8447
6,8450,2,4,1, 8454
8,8456,1,1,0, 8457
9,8457,2,2,1, 8459
16,8459,2,2,1, 8461
15,8461,2,2,0, 8463
13,8459,4,6,1, 8465
18,8463,4,4,1, 8467
20,8463,6,6,1, 8469
22,8466,4,4,1, 8470
24,8469,1,1,0, 8470
23,8468,3,3,0, 8471
31,8476,2,2,0, 8478
29,8478,4,4,1, 8482
5,8487,3,5,1, 8492
8,8496,1,1,1, 8497
16,8499,2,2,0, 8501
15,8501,2,2,0, 8503
22,8506,4,4,0, 8510
24,8509,1,1,1, 8510
23,8508,3,3,1, 8511
31,8516,2,2,0, 8518
28,8514,5,5,1, 8519
6,8530,2,4,1, 8534
8,8536,1,1,0, 8537
16,8539,2,2,1, 8541
15,8541,2,2,1, 8543
22,8546,4,4,0, 8550
24,8549,1,1,0, 8550
23,8548,3,3,0, 8551
31,8556,2,2,0, 8558
29,8558,4,4,1, 8562
5,8567,3,5,1, 8572
6,8570,2,4,1, 8574
8,8576,1,1,0, 8577
16,8579,2,2,0, 8581
15,8581,2,2,0, 8583
18,8583,4,4,1, 8587
22,8586,4,4,0, 8590
24,8589,1,1,1, 8590
19,8586,5,5,1, 8591
23,8588,3,3,0, 8591
31,8596,2,2,1, 8598
28,8594,5,5,1, 8599
26,8597,3,3,1, 8600
29,8598,4,4,1, 8602
1,8606,1,1,0, 8607
3,8607,3,3,1, 8610
8,8616,1,1,1, 8617
16,8619,2,2,0, 8621
15,8621,2,2,1, 8623
13,8619,4,6,1, 8625
18,8623,4,4,1, 8627
22,8626,4,4,1, 8630
24,8629,1,1,1, 8630
23,8628,3,3,1, 8631
30,8633,3,3,1, 8636
25,8635,2,2,1, 8637
31,8636,2,2,1, 8638
29,8638,4,4,1, 8642
1,8646,1,1,1, 8647
8,8656,1,1,0, 8657
11,8654,4,4,1, 8658
16,8659,2,2,1, 8661
15,8661,2,2,1, 8663
12,8660,5,5,1, 8665
22,8666,4,4,1, 8670
24,8669,1,1,1, 8670
19,8666,5,5,1, 8671
23,8668,3,3,0, 8671
31,8676,2,2,0, 8678
26,8677,3,3,1, 8680
2,8683,2,2,1, 8685
1,8686,1,1,0, 8687
3,8687,3,3,1, 8690
5,8687,3,5,1, 8692
6,8690,2,4,1, 8694
8,8696,1,1,0, 8697
9,8697,2,2,1, 8699
16,8699,2,2,1, 8701
17,8699,3,3,1, 8702
15,8701,2,2,0, 8703
13,8699,4,6,1, 8705
12,8700,5,5,1, 8705
20,8703,6,6,1, 8709
22,8706,4,4,1, 8710
24,8709,1,1,1, 8710
23,8708,3,3,0, 8711
30,8713,3,3,1, 8716
25,8715,2,2,1, 8717
31,8716,2,2,1, 8718
26,8717,3,3,1, 8720
1,8726,1,1,1, 8727
5,8727,3,5,1, 8732
6,8730,2,4,1, 8734
8,8736,1,1,0, 8737
16,8739,2,2,1, 8741
15,8741,2,2,1, 8743
12,8740,5,5,1, 8745
20,8743,6,6,1, 8749
22,8746,4,4,1, 8750
24,8749,1,1,0, 8750
23,8748,3,3,1, 8751
30,8753,3,3,1, 8756
25,8755,2,2,1, 8757
31,8756,2,2,1, 8758
26,8757,3,3,1, 8760
29,8758,4,4,1, 8762
2,8763,2,2,1, 8765
1,8766,1,1,0, 8767
3,8767,3,3,1, 8770
5,8767,3,5,1, 8772
6,8770,2,4,1, 8774
8,8776,1,1,0, 8777
9,8777,2,2,1, 8779
16,8779,2,2,0, 8781
17,8779,3,3,1, 8782
15,8781,2,2,0, 8783
22,8786,4,4,0, 8790
24,8789,1,1,1, 8790
19,8786,5,5,1, 8791
23,8788,3,3,1, 8791
25,8795,2,2,1, 8797
31,8796,2,2,1, 8798
28,8794,5,5,1, 8799
26,8797,3,3,1, 8800
1,8806,1,1,1, 8807
5,8807,3,5,1, 8812
6,8810,2,4,1, 8814
8,8816,1,1,1, 8817
11,8814,4,4,1, 8818
9,8817,2,2,1, 8819
16,8819,2,2,0, 8821
17,8819,3,3,1, 8822
15,8821,2,2,1, 8823
13,8819,4,6,1, 8825
12,8820,5,5,1, 8825
22,8826,4,4,0, 8830
24,8829,1,1,0, 8830
23,8828,3,3,1, 8831
31,8836,2,2,1, 8838
28,8834,5,5,1, 8839
29,8838,4,4,1, 8842
6,8850,2,4,1, 8854
8,8856,1,1,1, 8857
16,8859,2,2,1, 8861
15,8861,2,2,1, 8863
22,8866,4,4,1, 8870
24,8869,1,1,0, 8870
23,8868,3,3,0, 8871
30,8873,3,3,1, 8876
31,8876,2,2,0, 8878
5,8887,3,5,1, 8892
6,8890,2,4,1, 8894
8,8896,1,1,1, 8897
16,8899,2,2,0, 8901
15,8901,2,2,0, 8903
22,8906,4,4,0, 8910
24,8909,1,1,0, 8910
23,8908,3,3,1, 8911
31,8916,2,2,1, 8918
28,8914,5,5,1, 8919
29,8918,4,4,1, 8922
6,8930,2,4,1, 8934
8,8936,1,1,1, 8937
9,8937,2,2,1, 8939
16,8939,2,2,0, 8941
17,8939,3,3,1, 8942
15,8941,2,2,1, 8943
12,8940,5,5,1, 8945
18,8943,4,4,1, 8947
20,8943,6,6,1, 8949
22,8946,4,4,1, 8950
24,8949,1,1,0, 8950
19,8946,5,5,1, 8951
23,8948,3,3,1, 8951
25,8955,2,2,1, 8957
31,8956,2,2,1, 8958
26,8957,3,3,1, 8960
1,8966,1,1,0, 8967
3,8967,3,3,1, 8970
8,8976,1,1,0, 8977
11,8974,4,4,1, 8978
9,8977,2,2,1, 8979
16,8979,2,2,0, 8981
15,8981,2,2,0, 8983
13,8979,4,6,1, 8985
18,8983,4,4,1, 8987
22,8986,4,4,1, 8990
24,8989,1,1,1, 8990
19,8986,5,5,1, 8991
23,8988,3,3,0, 8991
25,8995,2,2,1, 8997
31,8996,2,2,0, 8998
28,8994,5,5,1, 8999
2,9003,2,2,1, 9005
1,9006,1,1,1, 9007
5,9007,3,5,1, 9012
6,9010,2,4,1, 9014
8,9016,1,1,1, 9017
9,9017,2,2,1, 9019
16,9019,2,2,0, 9021
15,9021,2,2,0, 9023
18,9023,4,4,1, 9027
20,9023,6,6,1, 9029
22,9026,4,4,1, 9030
24,9029,1,1,1, 9030
19,9026,5,5,1, 9031
23,9028,3,3,0, 9031
30,9033,3,3,1, 9036
25,9035,2,2,1, 9037
31,9036,2,2,0, 9038
2,9043,2,2,1, 9045
1,9046,1,1,0, 9047
6,9050,2,4,1, 9054
8,9056,1,1,0, 9057
9,9057,2,2,1, 9059
16,9059,2,2,1, 9061
17,9059,3,3,1, 9062
15,9061,2,2,0, 9063
22,9066,4,4,1, 9070
24,9069,1,1,1, 9070
31,9076,2,2,0, 9078
29,9078,4,4,1, 9082
5,9087,3,5,1, 9092
8,9096,1,1,0, 9097
16,9099,2,2,1, 9101
15,9101,2,2,1, 9103
24,9109,1,1,0, 9110
23,9108,3,3,1, 9111
31,9116,2,2,1, 9118
5,9127,3,5,1, 9132
6,9130,2,4,1, 9134
8,9136,1,1,1, 9137
24,9149,1,1,1, 9150
31,9156,2,2,0, 9158
29,9158,4,4,1, 9162
1,9166,1,1,1, 9167
8,9176,1,1,0, 9177
9,9177,2,2,1, 9179
16,9179,2,2,1, 9181
17,9179,3,3,1, 9182
20,9183,6,6,1, 9189
22,9186,4,4,1, 9190
24,9189,1,1,0, 9190
19,9186,5,5,1, 9191
23,9188,3,3,1, 9191
30,9193,3,3,1, 9196
25,9195,2,2,1, 9197
31,9196,2,2,0, 9198
26,9197,3,3,1, 9200
2,9203,2,2,1, 9205
1,9206,1,1,0, 9207
3,9207,3,3,1, 9210
6,9210,2,4,1, 9214
8,9216,1,1,1, 9217
17,9219,3,3,1, 9222
15,9221,2,2,1, 9223
20,9223,6,6,1, 9229
22,9226,4,4,1, 9230
24,9229,1,1,0, 9230
30,9233,3,3,1, 9236
25,9235,2,2,1, 9237
31,9236,2,2,1, 9238
28,9234,5,5,1, 9239
2,9243,2,2,1, 9245
1,9246,1,1,1, 9247
3,9247,3,3,1, 9250
5,9247,3,5,1, 9252
8,9256,1,1,0, 9257
17,9259,3,3,1, 9262
15,9261,2,2,1, 9263
12,9260,5,5,1, 9265
20,9263,6,6,1, 9269
22,9266,4,4,1, 9270
24,9269,1,1,1, 9270
23,9268,3,3,1, 9271
31,9276,2,2,1, 9278
28,9274,5,5,1, 9279
29,9278,4,4,1, 9282
2,9283,2,2,1, 9285
1,9286,1,1,1, 9287
3,9287,3,3,1, 9290
5,9287,3,5,1, 9292
6,9290,2,4,1, 9294
8,9296,1,1,0, 9297
11,9294,4,4,1, 9298
17,9299,3,3,1, 9302
20,9303,6,6,1, 9309
24,9309,1,1,0, 9310
23,9308,3,3,1, 9311
30,9313,3,3,1, 9316
31,9316,2,2,0, 9318
29,9318,4,4,1, 9322
1,9326,1,1,0, 9327
5,9327,3,5,1, 9332
6,9330,2,4,1, 9334
8,9336,1,1,0, 9337
9,9337,2,2,1, 9339
17,9339,3,3,1, 9342
15,9341,2,2,1, 9343
13,9339,4,6,1, 9345
20,9343,6,6,1, 9349
24,9349,1,1,1, 9350
19,9346,5,5,1, 9351
23,9348,3,3,1, 9351
25,9355,2,2,1, 9357
31,9356,2,2,0, 9358
28,9354,5,5,1, 9359
29,9358,4,4,1, 9362
1,9366,1,1,1, 9367
8,9376,1,1,1, 9377
9,9377,2,2,1, 9379
15,9381,2,2,1, 9383
13,9379,4,6,1, 9385
12,9380,5,5,1, 9385
22,9386,4,4,1, 9390
24,9389,1,1,0, 9390
19,9386,5,5,1, 9391
23,9388,3,3,1, 9391
30,9393,3,3,1, 9396
25,9395,2,2,1, 9397
26,9397,3,3,1, 9400
29,9398,4,4,1, 9402
2,9403,2,2,1, 9405
1,9406,1,1,1, 9407
3,9407,3,3,1, 9410
5,9407,3,5,1, 9412
6,9410,2,4,1, 9414
8,9416,1,1,0, 9417
22,9426,4,4,1, 9430
24,9429,1,1,0, 9430
23,9428,3,3,1, 9431
28,9434,5,5,1, 9439
29,9438,4,4,1, 9442
5,9447,3,5,1, 9452
6,9450,2,4,1, 9454
8,9456,1,1,0, 9457
15,9461,2,2,1, 9463
22,9466,4,4,1, 9470
24,9469,1,1,0, 9470
23,9468,3,3,1, 9471
30,9473,3,3,1, 9476
31,9476,2,2,1, 9478
29,9478,4,4,1, 9482
5,9487,3,5,1, 9492
8,9496,1,1,1, 9497
16,9499,2,2,1, 9501
15,9501,2,2,1, 9503
22,9506,4,4,1, 9510
24,9509,1,1,0, 9510
30,9513,3,3,1, 9516
31,9516,2,2,1, 9518
28,9514,5,5,1, 9519
29,9518,4,4,1, 9522
2,9523,2,2,1, 9525
1,9526,1,1,1, 9527
3,9527,3,3,1, 9530
5,9527,3,5,1, 9532
6,9530,2,4,1, 9534
8,9536,1,1,0, 9537
11,9534,4,4,1, 9538
9,9537,2,2,1, 9539
17,9539,3,3,1, 9542
15,9541,2,2,1, 9543
24,9549,1,1,0, 9550
19,9546,5,5,1, 9551
23,9548,3,3,1, 9551
25,9555,2,2,1, 9557
31,9556,2,2,1, 9558
28,9554,5,5,1, 9559
1,9566,1,1,0, 9567
5,9567,3,5,1, 9572
6,9570,2,4,1, 9574
8,9576,1,1,1, 9577
11,9574,4,4,1, 9578
9,9577,2,2,1, 9579
16,9579,2,2,1, 9581
17,9579,3,3,1, 9582
15,9581,2,2,1, 9583
22,9586,4,4,1, 9590
24,9589,1,1,1, 9590
19,9586,5,5,1, 9591
23,9588,3,3,1, 9591
30,9593,3,3,1, 9596
28,9594,5,5,1, 9599
26,9597,3,3,1, 9600
29,9598,4,4,1, 9602
1,9606,1,1,1, 9607
5,9607,3,5,1, 9612
6,9610,2,4,1, 9614
8,9616,1,1,0, 9617
11,9614,4,4,1, 9618
16,9619,2,2,1, 9621
13,9619,4,6,1, 9625
12,9620,5,5,1, 9625
18,9623,4,4,1, 9627
20,9623,6,6,1, 9629
24,9629,1,1,1, 9630
19,9626,5,5,1, 9631
25,9635,2,2,1, 9637
31,9636,2,2,1, 9638
28,9634,5,5,1, 9639
26,9637,3,3,1, 9640
2,9643,2,2,1, 9645
1,9646,1,1,1, 9647
3,9647,3,3,1, 9650
5,9647,3,5,1, 9652
6,9650,2,4,1, 9654
8,9656,1,1,1, 9657
9,9657,2,2,1, 9659
16,9659,2,2,1, 9661
15,9661,2,2,1, 9663
12,9660,5,5,1, 9665
22,9666,4,4,1, 9670
24,9669,1,1,1, 9670
19,9666,5,5,1, 9671
28,9674,5,5,1, 9679
2,9683,2,2,1, 9685
1,9686,1,1,1, 9687
8,9696,1,1,0, 9697
11,9694,4,4,1, 9698
17,9699,3,3,1, 9702
15,9701,2,2,1, 9703
12,9700,5,5,1, 9705
20,9703,6,6,1, 9709
24,9709,1,1,0, 9710
19,9706,5,5,1, 9711
30,9713,3,3,1, 9716
25,9715,2,2,1, 9717
29,9718,4,4,1, 9722
5,9727,3,5,1, 9732
8,9736,1,1,0, 9737
16,9739,2,2,1, 9741
24,9749,1,1,0, 9750
31,9756,2,2,1, 9758
28,9754,5,5,1, 9759
29,9758,4,4,1, 9762
6,9770,2,4,1, 9774
8,9776,1,1,0, 9777
24,9789,1,1,0, 9790
23,9788,3,3,1, 9791
31,9796,2,2,1, 9798
29,9798,4,4,1, 9802
5,9807,3,5,1, 9812
6,9810,2,4,1, 9814
8,9816,1,1,1, 9817
16,9819,2,2,0, 9821
15,9821,2,2,1, 9823
20,9823,6,6,1, 9829
22,9826,4,4,1, 9830
24,9829,1,1,0, 9830
23,9828,3,3,1, 9831
30,9833,3,3,1, 9836
25,9835,2,2,1, 9837
2,9843,2,2,1, 9845
1,9846,1,1,0, 9847
8,9856,1,1,1, 9857
11,9854,4,4,1, 9858
9,9857,2,2,1, 9859
16,9859,2,2,1, 9861
15,9861,2,2,1, 9863
12,9860,5,5,1, 9865
20,9863,6,6,1, 9869
22,9866,4,4,0, 9870
24,9869,1,1,1, 9870
23,9868,3,3,0, 9871
31,9876,2,2,1, 9878
2,9883,2,2,1, 9885
1,9886,1,1,1, 9887
6,9890,2,4,1, 9894
8,9896,1,1,0, 9897
9,9897,2,2,1, 9899
16,9899,2,2,0, 9901
17,9899,3,3,1, 9902
15,9901,2,2,1, 9903
13,9899,4,6,1, 9905
18,9903,4,4,1, 9907
20,9903,6,6,1, 9909
22,9906,4,4,0, 9910
24,9909,1,1,1, 9910
19,9906,5,5,1, 9911
23,9908,3,3,1, 9911
31,9916,2,2,1, 9918
28,9914,5,5,1, 9919
26,9917,3,3,1, 9920
29,9918,4,4,1, 9922
2,9923,2,2,1, 9925
1,9926,1,1,1, 9927
3,9927,3,3,1, 9930
6,9930,2,4,1, 9934
8,9936,1,1,1, 9937
11,9934,4,4,1, 9938
9,9937,2,2,1, 9939
16,9939,2,2,1, 9941
17,9939,3,3,1, 9942
15,9941,2,2,0, 9943
13,9939,4,6,1, 9945
18,9943,4,4,1, 9947
20,9943,6,6,1, 9949
22,9946,4,4,0, 9950
24,9949,1,1,0, 9950
19,9946,5,5,1, 9951
23,9948,3,3,1, 9951
25,9955,2,2,1, 9957
31,9956,2,2,1, 9958
28,9954,5,5,1, 9959
26,9957,3,3,1, 9960
5,9967,3,5,1, 9972
8,9976,1,1,1, 9977
16,9979,2,2,0, 9981
15,9981,2,2,0, 9983
22,9986,4,4,1, 9990
24,9989,1,1,0, 9990
23,9988,3,3,0, 9991
30,9993,3,3,1, 9996
28,9994,5,5,1, 9999
6,10010,2,4,1, 10014
8,10016,1,1,1, 10017
16,10019,2,2,1, 10021
15,10021,2,2,0, 10023
22,10026,4,4,1, 10030
24,10029,1,1,0, 10030
23,10028,3,3,0, 10031
31,10036,2,2,1, 10038
28,10034,5,5,1, 10039
8,10056,1,1,1, 10057
16,10059,2,2,0, 10061
15,10061,2,2,0, 10063
22,10066,4,4,0, 10070
24,10069,1,1,0, 10070
19,10066,5,5,1, 10071
23,10068,3,3,0, 10071
30,10073,3,3,1, 10076
25,10075,2,2,1, 10077
28,10074,5,5,1, 10079
29,10078,4,4,1, 10082
1,10086,1,1,1, 10087
6,10090,2,4,1, 10094
8,10096,1,1,0, 10097
11,10094,4,4,1, 10098
9,10097,2,2,1, 10099
16,10099,2,2,1, 10101
17,10099,3,3,1, 10102
15,10101,2,2,1, 10103
13,10099,4,6,1, 10105
18,10103,4,4,1, 10107
22,10106,4,4,0, 10110
24,10109,1,1,0, 10110
19,10106,5,5,1, 10111
23,10108,3,3,0, 10111
30,10113,3,3,1, 10116
25,10115,2,2,1, 10117
29,10118,4,4,1, 10122
2,10123,2,2,1, 10125
1,10126,1,1,0, 10127
3,10127,3,3,1, 10130
5,10127,3,5,1, 10132
6,10130,2,4,1, 10134
8,10136,1,1,1, 10137
11,10134,4,4,1, 10138
16,10139,2,2,0, 10141
15,10141,2,2,1, 10143
13,10139,4,6,1, 10145
12,10140,5,5,1, 10145
18,10143,4,4,1, 10147
22,10146,4,4,0, 10150
24,10149,1,1,0, 10150
19,10146,5,5,1, 10151
23,10148,3,3,1, 10151
26,10157,3,3,1, 10160
2,10163,2,2,1, 10165
1,10166,1,1,0, 10167
5,10167,3,5,1, 10172
8,10176,1,1,1, 10177
9,10177,2,2,1, 10179
16,10179,2,2,0, 10181
15,10181,2,2,1, 10183
13,10179,4,6,1, 10185
18,10183,4,4,1, 10187
20,10183,6,6,1, 10189
22,10186,4,4,1, 10190
24,10189,1,1,1, 10190
23,10188,3,3,1, 10191
30,10193,3,3,1, 10196
26,10197,3,3,1, 10200
29,10198,4,4,1, 10202
2,10203,2,2,1, 10205
1,10206,1,1,1, 10207
3,10207,3,3,1, 10210
5,10207,3,5,1, 10212
6,10210,2,4,1, 10214
8,10216,1,1,0, 10217
16,10219,2,2,0, 10221
15,10221,2,2,0, 10223
22,10226,4,4,1, 10230
24,10229,1,1,0, 10230
23,10228,3,3,1, 10231
30,10233,3,3,1, 10236
31,10236,2,2,1, 10238
5,10247,3,5,1, 10252
8,10256,1,1,0, 10257
16,10259,2,2,1, 10261
15,10261,2,2,1, 10263
22,10266,4,4,0, 10270
24,10269,1,1,0, 10270
23,10268,3,3,0, 10271
30,10273,3,3,1, 10276
5,10287,3,5,1, 10292
8,10296,1,1,0, 10297
16,10299,2,2,1, 10301
15,10301,2,2,0, 10303
22,10306,4,4,0, 10310
24,10309,1,1,1, 10310
23,10308,3,3,0, 10311
30,10313,3,3,1, 10316
25,10315,2,2,1, 10317
28,10314,5,5,1, 10319
29,10318,4,4,1, 10322
1,10326,1,1,0, 10327
8,10336,1,1,0, 10337
16,10339,2,2,0, 10341
17,10339,3,3,1, 10342
15,10341,2,2,0, 10343
22,10346,4,4,1, 10350
24,10349,1,1,1, 10350
23,10348,3,3,0, 10351
30,10353,3,3,1, 10356
31,10356,2,2,1, 10358
1,10366,1,1,0, 10367
3,10367,3,3,1, 10370
8,10376,1,1,0, 10377
16,10379,2,2,0, 10381
17,10379,3,3,1, 10382
15,10381,2,2,1, 10383
12,10380,5,5,1, 10385
18,10383,4,4,1, 10387
22,10386,4,4,0, 10390
24,10389,1,1,1, 10390
23,10388,3,3,0, 10391
31,10396,2,2,1, 10398
26,10397,3,3,1, 10400
29,10398,4,4,1, 10402
1,10406,1,1,1, 10407
8,10416,1,1,1, 10417
11,10414,4,4,1, 10418
9,10417,2,2,1, 10419
16,10419,2,2,0, 10421
17,10419,3,3,1, 10422
15,10421,2,2,0, 10423
13,10419,4,6,1, 10425
12,10420,5,5,1, 10425
18,10423,4,4,1, 10427
22,10426,4,4,1, 10430
24,10429,1,1,1, 10430
23,10428,3,3,0, 10431
28,10434,5,5,1, 10439
1,10446,1,1,0, 10447
3,10447,3,3,1, 10450
5,10447,3,5,1, 10452
8,10456,1,1,1, 10457
11,10454,4,4,1, 10458
9,10457,2,2,1, 10459
16,10459,2,2,1, 10461
17,10459,3,3,1, 10462
15,10461,2,2,1, 10463
13,10459,4,6,1, 10465
12,10460,5,5,1, 10465
22,10466,4,4,0, 10470
24,10469,1,1,1, 10470
19,10466,5,5,1, 10471
23,10468,3,3,1, 10471
25,10475,2,2,1, 10477
28,10474,5,5,1, 10479
29,10478,4,4,1, 10482
2,10483,2,2,1, 10485
1,10486,1,1,0, 10487
3,10487,3,3,1, 10490
5,10487,3,5,1, 10492
8,10496,1,1,0, 10497
9,10497,2,2,1, 10499
16,10499,2,2,1, 10501
17,10499,3,3,1, 10502
15,10501,2,2,0, 10503
13,10499,4,6,1, 10505
12,10500,5,5,1, 10505
22,10506,4,4,1, 10510
24,10509,1,1,0, 10510
19,10506,5,5,1, 10511
23,10508,3,3,0, 10511
30,10513,3,3,1, 10516
25,10515,2,2,1, 10517
31,10516,2,2,1, 10518
29,10518,4,4,1, 10522
2,10523,2,2,1, 10525
1,10526,1,1,1, 10527
3,10527,3,3,1, 10530
8,10536,1,1,0, 10537
9,10537,2,2,1, 10539
16,10539,2,2,1, 10541
17,10539,3,3,1, 10542
15,10541,2,2,1, 10543
12,10540,5,5,1, 10545
22,10546,4,4,1, 10550
24,10549,1,1,0, 10550
19,10546,5,5,1, 10551
23,10548,3,3,1, 10551
25,10555,2,2,1, 10557
31,10556,2,2,1, 10558
6,10570,2,4,1, 10574
8,10576,1,1,0, 10577
16,10579,2,2,0, 10581
15,10581,2,2,0, 10583
22,10586,4,4,0, 10590
24,10589,1,1,1, 10590
23,10588,3,3,1, 10591
28,10594,5,5,1, 10599
5,10607,3,5,1, 10612
8,10616,1,1,0, 10617
16,10619,2,2,0, 10621
15,10621,2,2,1, 10623
22,10626,4,4,1, 10630
24,10629,1,1,0, 10630
23,10628,3,3,1, 10631
6,10650,2,4,1, 10654
8,10656,1,1,1, 10657
16,10659,2,2,0, 10661
15,10661,2,2,0, 10663
20,10663,6,6,1, 10669
22,10666,4,4,0, 10670
24,10669,1,1,0, 10670
23,10668,3,3,0, 10671
25,10675,2,2,1, 10677
31,10676,2,2,1, 10678
28,10674,5,5,1, 10679
26,10677,3,3,1, 10680
29,10678,4,4,1, 10682
2,10683,2,2,1, 10685
1,10686,1,1,0, 10687
3,10687,3,3,1, 10690
8,10696,1,1,1, 10697
16,10699,2,2,0, 10701
15,10701,2,2,1, 10703
12,10700,5,5,1, 10705
20,10703,6,6,1, 10709
22,10706,4,4,1, 10710
24,10709,1,1,1, 10710
23,10708,3,3,1, 10711
25,10715,2,2,1, 10717
31,10716,2,2,1, 10718
28,10714,5,5,1, 10719
29,10718,4,4,1, 10722
2,10723,2,2,1, 10725
1,10726,1,1,0, 10727
3,10727,3,3,1, 10730
6,10730,2,4,1, 10734
8,10736,1,1,0, 10737
11,10734,4,4,1, 10738
9,10737,2,2,1, 10739
16,10739,2,2,0, 10741
15,10741,2,2,1, 10743
22,10746,4,4,0, 10750
24,10749,1,1,1, 10750
23,10748,3,3,1, 10751
26,10757,3,3,1, 10760
29,10758,4,4,1, 10762
1,10766,1,1,1, 10767
3,10767,3,3,1, 10770
6,10770,2,4,1, 10774
8,10776,1,1,0, 10777
11,10774,4,4,1, 10778
9,10777,2,2,1, 10779
16,10779,2,2,0, 10781
15,10781,2,2,0, 10783
12,10780,5,5,1, 10785
18,10783,4,4,1, 10787
20,10783,6,6,1, 10789
22,10786,4,4,1, 10790
24,10789,1,1,0, 10790
23,10788,3,3,1, 10791
31,10796,2,2,1, 10798
29,10798,4,4,1, 10802
2,10803,2,2,1, 10805
1,10806,1,1,0, 10807
6,10810,2,4,1, 10814
8,10816,1,1,1, 10817
16,10819,2,2,1, 10821
17,10819,3,3,1, 10822
15,10821,2,2,1, 10823
18,10823,4,4,1, 10827
20,10823,6,6,1, 10829
22,10826,4,4,0, 10830
24,10829,1,1,0, 10830
23,10828,3,3,1, 10831
25,10835,2,2,1, 10837
26,10837,3,3,1, 10840
1,10846,1,1,0, 10847
3,10847,3,3,1, 10850
5,10847,3,5,1, 10852
6,10850,2,4,1, 10854
8,10856,1,1,0, 10857
16,10859,2,2,1, 10861
17,10859,3,3,1, 10862
15,10861,2,2,1, 10863
12,10860,5,5,1, 10865
18,10863,4,4,1, 10867
20,10863,6,6,1, 10869
22,10866,4,4,0, 10870
24,10869,1,1,0, 10870
19,10866,5,5,1, 10871
23,10868,3,3,1, 10871
31,10876,2,2,1, 10878
28,10874,5,5,1, 10879
29,10878,4,4,1, 10882
8,10896,1,1,1, 10897
16,10899,2,2,1, 10901
15,10901,2,2,0, 10903
22,10906,4,4,1, 10910
24,10909,1,1,1, 10910
23,10908,3,3,0, 10911
31,10916,2,2,1, 10918
8,10936,1,1,1, 10937
16,10939,2,2,0, 10941
15,10941,2,2,1, 10943
22,10946,4,4,0, 10950
24,10949,1,1,1, 10950
23,10948,3,3,1, 10951
30,10953,3,3,1, 10956
5,10967,3,5,1, 10972
8,10976,1,1,1, 10977
16,10979,2,2,1, 10981
15,10981,2,2,1, 10983
22,10986,4,4,0, 10990
24,10989,1,1,1, 10990
23,10988,3,3,0, 10991
30,10993,3,3,1, 10996
25,10995,2,2,1, 10997
1,11006,1,1,1, 11007
8,11016,1,1,1, 11017
9,11017,2,2,1, 11019
16,11019,2,2,0, 11021
15,11021,2,2,1, 11023
22,11026,4,4,1, 11030
24,11029,1,1,0, 11030
23,11028,3,3,0, 11031
25,11035,2,2,1, 11037
31,11036,2,2,1, 11038
28,11034,5,5,1, 11039
29,11038,4,4,1, 11042
1,11046,1,1,1, 11047
5,11047,3,5,1, 11052
6,11050,2,4,1, 11054
8,11056,1,1,1, 11057
9,11057,2,2,1, 11059
16,11059,2,2,0, 11061
15,11061,2,2,1, 11063
22,11066,4,4,1, 11070
24,11069,1,1,1, 11070
19,11066,5,5,1, 11071
23,11068,3,3,0, 11071
28,11074,5,5,1, 11079
26,11077,3,3,1, 11080
29,11078,4,4,1, 11082
1,11086,1,1,1, 11087
3,11087,3,3,1, 11090
5,11087,3,5,1, 11092
6,11090,2,4,1, 11094
8,11096,1,1,1, 11097
9,11097,2,2,1, 11099
16,11099,2,2,0, 11101
17,11099,3,3,1, 11102
15,11101,2,2,0, 11103
12,11100,5,5,1, 11105
18,11103,4,4,1, 11107
20,11103,6,6,1, 11109
22,11106,4,4,0, 11110
24,11109,1,1,1, 11110
23,11108,3,3,0, 11111
30,11113,3,3,1, 11116
31,11116,2,2,1, 11118
2,11123,2,2,1, 11125
1,11126,1,1,0, 11127
5,11127,3,5,1, 11132
6,11130,2,4,1, 11134
8,11136,1,1,1, 11137
16,11139,2,2,1, 11141
17,11139,3,3,1, 11142
15,11141,2,2,1, 11143
13,11139,4,6,1, 11145
12,11140,5,5,1, 11145
20,11143,6,6,1, 11149
22,11146,4,4,0, 11150
24,11149,1,1,1, 11150
23,11148,3,3,1, 11151
28,11154,5,5,1, 11159
26,11157,3,3,1, 11160
29,11158,4,4,1, 11162
1,11166,1,1,1, 11167
6,11170,2,4,1, 11174
8,11176,1,1,1, 11177
11,11174,4,4,1, 11178
16,11179,2,2,1, 11181
15,11181,2,2,0, 11183
13,11179,4,6,1, 11185
18,11183,4,4,1, 11187
22,11186,4,4,0, 11190
24,11189,1,1,1, 11190
19,11186,5,5,1, 11191
23,11188,3,3,1, 11191
25,11195,2,2,1, 11197
31,11196,2,2,1, 11198
28,11194,5,5,1, 11199
26,11197,3,3,1, 11200
1,11206,1,1,0, 11207
8,11216,1,1,1, 11217
11,11214,4,4,1, 11218
9,11217,2,2,1, 11219
16,11219,2,2,1, 11221
15,11221,2,2,0, 11223
13,11219,4,6,1, 11225
18,11223,4,4,1, 11227
20,11223,6,6,1, 11229
22,11226,4,4,1, 11230
24,11229,1,1,0, 11230
19,11226,5,5,1, 11231
23,11228,3,3,1, 11231
30,11233,3,3,1, 11236
25,11235,2,2,1, 11237
29,11238,4,4,1, 11242
1,11246,1,1,0, 11247
8,11256,1,1,0, 11257
11,11254,4,4,1, 11258
16,11259,2,2,0, 11261
15,11261,2,2,1, 11263
22,11266,4,4,0, 11270
24,11269,1,1,1, 11270
23,11268,3,3,1, 11271
25,11275,2,2,1, 11277
26,11277,3,3,1, 11280
29,11278,4,4,0, 11282
1,11286,1,1,1, 11287
5,11287,3,5,0, 11292
6,11290,2,4,1, 11294
8,11296,1,1,0, 11297
11,11294,4,4,1, 11298
9,11297,2,2,1, 11299
16,11299,2,2,1, 11301
15,11301,2,2,0, 11303
13,11299,4,6,1, 11305
12,11300,5,5,1, 11305
20,11303,6,6,1, 11309
22,11306,4,4,0, 11310
24,11309,1,1,0, 11310
23,11308,3,3,1, 11311
30,11313,3,3,0, 11316
31,11316,2,2,1, 11318
28,11314,5,5,1, 11319
26,11317,3,3,1, 11320
29,11318,4,4,1, 11322
1,11326,1,1,1, 11327
3,11327,3,3,1, 11330
5,11327,3,5,1, 11332
6,11330,2,4,1, 11334
8,11336,1,1,0, 11337
11,11334,4,4,1, 11338
16,11339,2,2,0, 11341
15,11341,2,2,1, 11343
22,11346,4,4,1, 11350
24,11349,1,1,1, 11350
19,11346,5,5,1, 11351
23,11348,3,3,0, 11351
30,11353,3,3,0, 11356
25,11355,2,2,1, 11357
31,11356,2,2,0, 11358
28,11354,5,5,0, 11359
29,11358,4,4,0, 11362
2,11363,2,2,1, 11365
1,11366,1,1,0, 11367
3,11367,3,3,1, 11370
5,11367,3,5,0, 11372
6,11370,2,4,1, 11374
8,11376,1,1,0, 11377
11,11374,4,4,1, 11378
16,11379,2,2,1, 11381
17,11379,3,3,1, 11382
15,11381,2,2,0, 11383
13,11379,4,6,1, 11385
20,11383,6,6,1, 11389
22,11386,4,4,1, 11390
24,11389,1,1,1, 11390
19,11386,5,5,1, 11391
23,11388,3,3,0, 11391
30,11393,3,3,1, 11396
31,11396,2,2,0, 11398
28,11394,5,5,0, 11399
29,11398,4,4,0, 11402
5,11407,3,5,0, 11412
6,11410,2,4,0, 11414
8,11416,1,1,1, 11417
16,11419,2,2,0, 11421
15,11421,2,2,0, 11423
22,11426,4,4,0, 11430
24,11429,1,1,0, 11430
23,11428,3,3,1, 11431
30,11433,3,3,0, 11436
31,11436,2,2,1, 11438
28,11434,5,5,0, 11439
29,11438,4,4,0, 11442
5,11447,3,5,1, 11452
6,11450,2,4,0, 11454
8,11456,1,1,1, 11457
16,11459,2,2,1, 11461
15,11461,2,2,0, 11463
22,11466,4,4,1, 11470
24,11469,1,1,0, 11470
23,11468,3,3,1, 11471
30,11473,3,3,0, 11476
31,11476,2,2,0, 11478
28,11474,5,5,0, 11479
29,11478,4,4,0, 11482
5,11487,3,5,1, 11492
6,11490,2,4,1, 11494
8,11496,1,1,1, 11497
9,11497,2,2,1, 11499
16,11499,2,2,0, 11501
15,11501,2,2,1, 11503
18,11503,4,4,1, 11507
20,11503,6,6,1, 11509
22,11506,4,4,1, 11510
24,11509,1,1,1, 11510
19,11506,5,5,1, 11511
23,11508,3,3,0, 11511
30,11513,3,3,0, 11516
31,11516,2,2,1, 11518
28,11514,5,5,1, 11519
29,11518,4,4,1, 11522
2,11523,2,2,1, 11525
1,11526,1,1,1, 11527
3,11527,3,3,1, 11530
5,11527,3,5,0, 11532
6,11530,2,4,0, 11534
8,11536,1,1,0, 11537
11,11534,4,4,1, 11538
9,11537,2,2,1, 11539
16,11539,2,2,0, 11541
15,11541,2,2,0, 11543
22,11546,4,4,1, 11550
24,11549,1,1,0, 11550
19,11546,5,5,1, 11551
23,11548,3,3,1, 11551
30,11553,3,3,1, 11556
25,11555,2,2,1, 11557
31,11556,2,2,0, 11558
28,11554,5,5,0, 11559
29,11558,4,4,1, 11562
1,11566,1,1,0, 11567
5,11567,3,5,1, 11572
6,11570,2,4,0, 11574
8,11576,1,1,0, 11577
16,11579,2,2,1, 11581
15,11581,2,2,0, 11583
13,11579,4,6,1, 11585
12,11580,5,5,1, 11585
22,11586,4,4,0, 11590
24,11589,1,1,1, 11590
23,11588,3,3,1, 11591
31,11596,2,2,1, 11598
1,11606,1,1,0, 11607
6,11610,2,4,1, 11614
8,11616,1,1,1, 11617
11,11614,4,4,1, 11618
16,11619,2,2,1, 11621
17,11619,3,3,1, 11622
15,11621,2,2,0, 11623
20,11623,6,6,1, 11629
22,11626,4,4,0, 11630
24,11629,1,1,0, 11630
23,11628,3,3,0, 11631
25,11635,2,2,1, 11637
31,11636,2,2,1, 11638
28,11634,5,5,1, 11639
26,11637,3,3,1, 11640
29,11638,4,4,1, 11642
2,11643,2,2,1, 11645
1,11646,1,1,0, 11647
5,11647,3,5,1, 11652
6,11650,2,4,1, 11654
8,11656,1,1,1, 11657
16,11659,2,2,0, 11661
15,11661,2,2,1, 11663
12,11660,5,5,1, 11665
18,11663,4,4,1, 11667
20,11663,6,6,1, 11669
22,11666,4,4,1, 11670
24,11669,1,1,0, 11670
19,11666,5,5,1, 11671
23,11668,3,3,0, 11671
31,11676,2,2,1, 11678
28,11674,5,5,1, 11679
26,11677,3,3,1, 11680
2,11683,2,2,1, 11685
1,11686,1,1,1, 11687
5,11687,3,5,1, 11692
8,11696,1,1,1, 11697
9,11697,2,2,1, 11699
16,11699,2,2,0, 11701
17,11699,3,3,1, 11702
15,11701,2,2,0, 11703
18,11703,4,4,1, 11707
20,11703,6,6,1, 11709
22,11706,4,4,1, 11710
24,11709,1,1,0, 11710
19,11706,5,5,1, 11711
23,11708,3,3,1, 11711
30,11713,3,3,1, 11716
25,11715,2,2,1, 11717
31,11716,2,2,1, 11718
28,11714,5,5,1, 11719
26,11717,3,3,1, 11720
29,11718,4,4,1, 11722
2,11723,2,2,1, 11725
1,11726,1,1,1, 11727
3,11727,3,3,1, 11730
5,11727,3,5,1, 11732
6,11730,2,4,1, 11734
8,11736,1,1,0, 11737
16,11739,2,2,1, 11741
17,11739,3,3,1, 11742
15,11741,2,2,1, 11743
12,11740,5,5,1, 11745
18,11743,4,4,1, 11747
22,11746,4,4,1, 11750
24,11749,1,1,0, 11750
23,11748,3,3,1, 11751
31,11756,2,2,1, 11758
5,11767,3,5,1, 11772
6,11770,2,4,1, 11774
8,11776,1,1,1, 11777
15,11781,2,2,1, 11783
24,11789,1,1,0, 11790
30,11793,3,3,1, 11796
31,11796,2,2,0, 11798
28,11794,5,5,1, 11799
8,11816,1,1,1, 11817
16,11819,2,2,1, 11821
15,11821,2,2,1, 11823
24,11829,1,1,0, 11830
31,11836,2,2,1, 11838
28,11834,5,5,1, 11839
5,11847,3,5,1, 11852
8,11856,1,1,0, 11857
11,11854,4,4,1, 11858
16,11859,2,2,1, 11861
12,11860,5,5,1, 11865
18,11863,4,4,1, 11867
20,11863,6,6,1, 11869
24,11869,1,1,1, 11870
31,11876,2,2,1, 11878
29,11878,4,4,1, 11882
1,11886,1,1,1, 11887
5,11887,3,5,1, 11892
6,11890,2,4,1, 11894
8,11896,1,1,0, 11897
16,11899,2,2,1, 11901
17,11899,3,3,1, 11902
15,11901,2,2,1, 11903
24,11909,1,1,1, 11910
31,11916,2,2,1, 11918
28,11914,5,5,1, 11919
29,11918,4,4,1, 11922
1,11926,1,1,1, 11927
6,11930,2,4,1, 11934
8,11936,1,1,0, 11937
16,11939,2,2,1, 11941
17,11939,3,3,1, 11942
15,11941,2,2,1, 11943
24,11949,1,1,1, 11950
31,11956,2,2,0, 11958
29,11958,4,4,1, 11962
1,11966,1,1,0, 11967
6,11970,2,4,1, 11974
8,11976,1,1,1, 11977
11,11974,4,4,1, 11978
17,11979,3,3,1, 11982
12,11980,5,5,1, 11985
24,11989,1,1,0, 11990
30,11993,3,3,1, 11996
31,11996,2,2,0, 11998
26,11997,3,3,1, 12000
29,11998,4,4,1, 12002
2,12003,2,2,1, 12005
1,12006,1,1,1, 12007
6,12010,2,4,1, 12014
8,12016,1,1,1, 12017
9,12017,2,2,1, 12019
16,12019,2,2,1, 12021
12,12020,5,5,1, 12025
22,12026,4,4,1, 12030
24,12029,1,1,1, 12030
19,12026,5,5,1, 12031
31,12036,2,2,0, 12038
29,12038,4,4,1, 12042
1,12046,1,1,1, 12047
3,12047,3,3,1, 12050
8,12056,1,1,1, 12057
16,12059,2,2,1, 12061
17,12059,3,3,1, 12062
13,12059,4,6,1, 12065
18,12063,4,4,1, 12067
22,12066,4,4,1, 12070
24,12069,1,1,0, 12070
23,12068,3,3,1, 12071
25,12075,2,2,1, 12077
31,12076,2,2,0, 12078
28,12074,5,5,1, 12079
26,12077,3,3,1, 12080
2,12083,2,2,1, 12085
1,12086,1,1,0, 12087
6,12090,2,4,1, 12094
8,12096,1,1,1, 12097
9,12097,2,2,1, 12099
16,12099,2,2,1, 12101
15,12101,2,2,1, 12103
20,12103,6,6,1, 12109
24,12109,1,1,1, 12110
19,12106,5,5,1, 12111
23,12108,3,3,1, 12111
25,12115,2,2,1, 12117
31,12116,2,2,1, 12118
1,12126,1,1,1, 12127
3,12127,3,3,1, 12130
5,12127,3,5,1, 12132
8,12136,1,1,0, 12137
16,12139,2,2,1, 12141
15,12141,2,2,1, 12143
12,12140,5,5,1, 12145
20,12143,6,6,1, 12149
24,12149,1,1,0, 12150
25,12155,2,2,1, 12157
31,12156,2,2,1, 12158
26,12157,3,3,1, 12160
29,12158,4,4,1, 12162
2,12163,2,2,1, 12165
1,12166,1,1,1, 12167
3,12167,3,3,1, 12170
8,12176,1,1,1, 12177
9,12177,2,2,1, 12179
16,12179,2,2,1, 12181
17,12179,3,3,1, 12182
15,12181,2,2,1, 12183
13,12179,4,6,1, 12185
20,12183,6,6,1, 12189
24,12189,1,1,1, 12190
19,12186,5,5,1, 12191
23,12188,3,3,1, 12191
30,12193,3,3,1, 12196
25,12195,2,2,1, 12197
31,12196,2,2,0, 12198
28,12194,5,5,1, 12199
29,12198,4,4,1, 12202
1,12206,1,1,0, 12207
3,12207,3,3,1, 12210
5,12207,3,5,1, 12212
6,12210,2,4,1, 12214
8,12216,1,1,1, 12217
11,12214,4,4,1, 12218
9,12217,2,2,1, 12219
15,12221,2,2,1, 12223
13,12219,4,6,1, 12225
22,12226,4,4,1, 12230
24,12229,1,1,1, 12230
19,12226,5,5,1, 12231
23,12228,3,3,1, 12231
25,12235,2,2,1, 12237
31,12236,2,2,0, 12238
29,12238,4,4,1, 12242
2,12243,2,2,1, 12245
1,12246,1,1,1, 12247
3,12247,3,3,1, 12250
5,12247,3,5,1, 12252
8,12256,1,1,1, 12257
9,12257,2,2,1, 12259
17,12259,3,3,1, 12262
18,12263,4,4,1, 12267
24,12269,1,1,0, 12270
23,12268,3,3,1, 12271
30,12273,3,3,1, 12276
25,12275,2,2,1, 12277
31,12276,2,2,0, 12278
26,12277,3,3,1, 12280
29,12278,4,4,1, 12282
2,12283,2,2,1, 12285
1,12286,1,1,1, 12287
3,12287,3,3,1, 12290
5,12287,3,5,1, 12292
6,12290,2,4,1, 12294
8,12296,1,1,1, 12297
9,12297,2,2,1, 12299
17,12299,3,3,1, 12302
24,12309,1,1,0, 12310
30,12313,3,3,1, 12316
31,12316,2,2,1, 12318
6,12330,2,4,1, 12334
8,12336,1,1,1, 12337
15,12341,2,2,1, 12343
22,12346,4,4,1, 12350
24,12349,1,1,0, 12350
23,12348,3,3,1, 12351
31,12356,2,2,1, 12358
5,12367,3,5,1, 12372
6,12370,2,4,1, 12374
8,12376,1,1,1, 12377
16,12379,2,2,1, 12381
15,12381,2,2,1, 12383
22,12386,4,4,1, 12390
24,12389,1,1,1, 12390
23,12388,3,3,1, 12391
31,12396,2,2,1, 12398
29,12398,4,4,1, 12402
1,12406,1,1,1, 12407
5,12407,3,5,1, 12412
8,12416,1,1,1, 12417
11,12414,4,4,1, 12418
16,12419,2,2,1, 12421
18,12423,4,4,1, 12427
20,12423,6,6,1, 12429
22,12426,4,4,1, 12430
24,12429,1,1,1, 12430
23,12428,3,3,1, 12431
25,12435,2,2,1, 12437
31,12436,2,2,0, 12438
28,12434,5,5,1, 12439
2,12443,2,2,1, 12445
1,12446,1,1,0, 12447
3,12447,3,3,1, 12450
6,12450,2,4,1, 12454
8,12456,1,1,1, 12457
9,12457,2,2,1, 12459
17,12459,3,3,1, 12462
15,12461,2,2,1, 12463
13,12459,4,6,1, 12465
12,12460,5,5,1, 12465
18,12463,4,4,1, 12467
22,12466,4,4,1, 12470
24,12469,1,1,0, 12470
23,12468,3,3,1, 12471
25,12475,2,2,1, 12477
31,12476,2,2,1, 12478
28,12474,5,5,1, 12479
26,12477,3,3,1, 12480
1,12486,1,1,0, 12487
6,12490,2,4,1, 12494
8,12496,1,1,0, 12497
11,12494,4,4,1, 12498
16,12499,2,2,1, 12501
17,12499,3,3,1, 12502
15,12501,2,2,1, 12503
12,12500,5,5,1, 12505
22,12506,4,4,1, 12510
24,12509,1,1,0, 12510
19,12506,5,5,1, 12511
23,12508,3,3,1, 12511
30,12513,3,3,1, 12516
31,12516,2,2,1, 12518
28,12514,5,5,1, 12519
2,12523,2,2,1, 12525
1,12526,1,1,0, 12527
6,12530,2,4,1, 12534
8,12536,1,1,1, 12537
11,12534,4,4,1, 12538
9,12537,2,2,1, 12539
16,12539,2,2,1, 12541
17,12539,3,3,1, 12542
20,12543,6,6,1, 12549
22,12546,4,4,1, 12550
24,12549,1,1,0, 12550
19,12546,5,5,1, 12551
30,12553,3,3,1, 12556
25,12555,2,2,1, 12557
31,12556,2,2,1, 12558
26,12557,3,3,1, 12560
29,12558,4,4,1, 12562
1,12566,1,1,1, 12567
6,12570,2,4,1, 12574
8,12576,1,1,1, 12577
9,12577,2,2,1, 12579
16,12579,2,2,1, 12581
17,12579,3,3,1, 12582
15,12581,2,2,1, 12583
13,12579,4,6,1, 12585
12,12580,5,5,1, 12585
20,12583,6,6,1, 12589
24,12589,1,1,0, 12590
30,12593,3,3,1, 12596
31,12596,2,2,1, 12598
28,12594,5,5,1, 12599
26,12597,3,3,1, 12600
5,12607,3,5,1, 12612
8,12616,1,1,0, 12617
16,12619,2,2,1, 12621
15,12621,2,2,0, 12623
22,12626,4,4,1, 12630
24,12629,1,1,0, 12630
23,12628,3,3,1, 12631
30,12633,3,3,1, 12636
31,12636,2,2,0, 12638
28,12634,5,5,1, 12639
5,12647,3,5,1, 12652
8,12656,1,1,1, 12657
16,12659,2,2,0, 12661
15,12661,2,2,1, 12663
22,12666,4,4,0, 12670
24,12669,1,1,0, 12670
23,12668,3,3,0, 12671
30,12673,3,3,1, 12676
31,12676,2,2,0, 12678
5,12687,3,5,1, 12692
6,12690,2,4,1, 12694
8,12696,1,1,0, 12697
16,12699,2,2,1, 12701
15,12701,2,2,0, 12703
12,12700,5,5,1, 12705
20,12703,6,6,1, 12709
22,12706,4,4,0, 12710
24,12709,1,1,0, 12710
23,12708,3,3,0, 12711
30,12713,3,3,1, 12716
25,12715,2,2,1, 12717
31,12716,2,2,0, 12718
26,12717,3,3,1, 12720
29,12718,4,4,1, 12722
2,12723,2,2,1, 12725
1,12726,1,1,1, 12727
6,12730,2,4,1, 12734
8,12736,1,1,0, 12737
11,12734,4,4,1, 12738
16,12739,2,2,1, 12741
17,12739,3,3,1, 12742
15,12741,2,2,0, 12743
13,12739,4,6,1, 12745
12,12740,5,5,1, 12745
18,12743,4,4,1, 12747
20,12743,6,6,1, 12749
22,12746,4,4,1, 12750
24,12749,1,1,1, 12750
23,12748,3,3,1, 12751
30,12753,3,3,1, 12756
25,12755,2,2,1, 12757
31,12756,2,2,1, 12758
28,12754,5,5,1, 12759
2,12763,2,2,1, 12765
1,12766,1,1,0, 12767
3,12767,3,3,1, 12770
5,12767,3,5,1, 12772
8,12776,1,1,1, 12777
9,12777,2,2,1, 12779
16,12779,2,2,0, 12781
17,12779,3,3,1, 12782
15,12781,2,2,0, 12783
13,12779,4,6,1, 12785
18,12783,4,4,1, 12787
20,12783,6,6,1, 12789
22,12786,4,4,1, 12790
24,12789,1,1,1, 12790
23,12788,3,3,1, 12791
30,12793,3,3,1, 12796
31,12796,2,2,0, 12798
28,12794,5,5,1, 12799
26,12797,3,3,1, 12800
29,12798,4,4,1, 12802
1,12806,1,1,0, 12807
5,12807,3,5,1, 12812
6,12810,2,4,1, 12814
8,12816,1,1,1, 12817
11,12814,4,4,1, 12818
16,12819,2,2,1, 12821
15,12821,2,2,0, 12823
12,12820,5,5,1, 12825
18,12823,4,4,1, 12827
20,12823,6,6,1, 12829
22,12826,4,4,0, 12830
24,12829,1,1,0, 12830
23,12828,3,3,0, 12831
31,12836,2,2,1, 12838
26,12837,3,3,1, 12840
1,12846,1,1,1, 12847
8,12856,1,1,0, 12857
9,12857,2,2,1, 12859
16,12859,2,2,0, 12861
15,12861,2,2,1, 12863
13,12859,4,6,1, 12865
22,12866,4,4,1, 12870
24,12869,1,1,0, 12870
23,12868,3,3,0, 12871
31,12876,2,2,1, 12878
29,12878,4,4,1, 12882
1,12886,1,1,0, 12887
6,12890,2,4,1, 12894
8,12896,1,1,0, 12897
16,12899,2,2,1, 12901
15,12901,2,2,0, 12903
20,12903,6,6,1, 12909
22,12906,4,4,1, 12910
24,12909,1,1,0, 12910
23,12908,3,3,0, 12911
30,12913,3,3,1, 12916
31,12916,2,2,1, 12918
2,12923,2,2,1, 12925
1,12926,1,1,1, 12927
3,12927,3,3,1, 12930
8,12936,1,1,1, 12937
11,12934,4,4,1, 12938
16,12939,2,2,0, 12941
15,12941,2,2,1, 12943
13,12939,4,6,1, 12945
12,12940,5,5,1, 12945
18,12943,4,4,1, 12947
22,12946,4,4,1, 12950
24,12949,1,1,0, 12950
23,12948,3,3,0, 12951
25,12955,2,2,1, 12957
1,12966,1,1,0, 12967
3,12967,3,3,1, 12970
5,12967,3,5,1, 12972
6,12970,2,4,1, 12974
8,12976,1,1,0, 12977
16,12979,2,2,0, 12981
15,12981,2,2,1, 12983
22,12986,4,4,1, 12990
24,12989,1,1,0, 12990
23,12988,3,3,1, 12991
30,12993,3,3,1, 12996
5,13007,3,5,1, 13012
6,13010,2,4,1, 13014
8,13016,1,1,0, 13017
16,13019,2,2,1, 13021
15,13021,2,2,0, 13023
22,13026,4,4,0, 13030
24,13029,1,1,0, 13030
23,13028,3,3,1, 13031
31,13036,2,2,1, 13038
6,13050,2,4,1, 13054
8,13056,1,1,0, 13057
16,13059,2,2,1, 13061
15,13061,2,2,1, 13063
22,13066,4,4,0, 13070
24,13069,1,1,1, 13070
23,13068,3,3,1, 13071
31,13076,2,2,1, 13078
28,13074,5,5,1, 13079
26,13077,3,3,1, 13080
29,13078,4,4,1, 13082
1,13086,1,1,0, 13087
8,13096,1,1,1, 13097
11,13094,4,4,1, 13098
9,13097,2,2,1, 13099
16,13099,2,2,0, 13101
17,13099,3,3,1, 13102
15,13101,2,2,0, 13103
18,13103,4,4,1, 13107
20,13103,6,6,1, 13109
22,13106,4,4,0, 13110
24,13109,1,1,0, 13110
19,13106,5,5,1, 13111
23,13108,3,3,0, 13111
30,13113,3,3,1, 13116
31,13116,2,2,1, 13118
1,13126,1,1,1, 13127
6,13130,2,4,1, 13134
8,13136,1,1,0, 13137
16,13139,2,2,1, 13141
15,13141,2,2,1, 13143
22,13146,4,4,1, 13150
24,13149,1,1,0, 13150
23,13148,3,3,1, 13151
30,13153,3,3,1, 13156
28,13154,5,5,1, 13159
29,13158,4,4,1, 13162
1,13166,1,1,0, 13167
5,13167,3,5,1, 13172
6,13170,2,4,1, 13174
8,13176,1,1,0, 13177
9,13177,2,2,1, 13179
16,13179,2,2,0, 13181
17,13179,3,3,1, 13182
15,13181,2,2,0, 13183
22,13186,4,4,0, 13190
24,13189,1,1,1, 13190
23,13188,3,3,0, 13191
30,13193,3,3,1, 13196
31,13196,2,2,1, 13198
29,13198,4,4,1, 13202
1,13206,1,1,0, 13207
6,13210,2,4,1, 13214
8,13216,1,1,1, 13217
9,13217,2,2,1, 13219
16,13219,2,2,1, 13221
17,13219,3,3,1, 13222
15,13221,2,2,1, 13223
13,13219,4,6,1, 13225
12,13220,5,5,1, 13225
18,13223,4,4,1, 13227
22,13226,4,4,0, 13230
24,13229,1,1,1, 13230
19,13226,5,5,1, 13231
23,13228,3,3,0, 13231
26,13237,3,3,1, 13240
1,13246,1,1,0, 13247
6,13250,2,4,1, 13254
8,13256,1,1,0, 13257
11,13254,4,4,1, 13258
9,13257,2,2,1, 13259
16,13259,2,2,0, 13261
15,13261,2,2,0, 13263
13,13259,4,6,1, 13265
12,13260,5,5,1, 13265
22,13266,4,4,0, 13270
24,13269,1,1,0, 13270
19,13266,5,5,1, 13271
23,13268,3,3,1, 13271
25,13275,2,2,1, 13277
31,13276,2,2,1, 13278
28,13274,5,5,1, 13279
2,13283,2,2,1, 13285
1,13286,1,1,0, 13287
3,13287,3,3,1, 13290
8,13296,1,1,1, 13297
16,13299,2,2,1, 13301
15,13301,2,2,0, 13303
12,13300,5,5,1, 13305
20,13303,6,6,1, 13309
22,13306,4,4,1, 13310
24,13309,1,1,1, 13310
19,13306,5,5,1, 13311
23,13308,3,3,1, 13311
25,13315,2,2,1, 13317
31,13316,2,2,1, 13318
28,13314,5,5,1, 13319
26,13317,3,3,1, 13320
29,13318,4,4,1, 13322
2,13323,2,2,1, 13325
1,13326,1,1,0, 13327
3,13327,3,3,1, 13330
6,13330,2,4,1, 13334
8,13336,1,1,0, 13337
11,13334,4,4,1, 13338
9,13337,2,2,1, 13339
16,13339,2,2,0, 13341
15,13341,2,2,1, 13343
12,13340,5,5,1, 13345
18,13343,4,4,1, 13347
22,13346,4,4,1, 13350
24,13349,1,1,1, 13350
19,13346,5,5,1, 13351
23,13348,3,3,0, 13351
25,13355,2,2,1, 13357
29,13358,4,4,1, 13362
1,13366,1,1,0, 13367
6,13370,2,4,1, 13374
8,13376,1,1,1, 13377
16,13379,2,2,0, 13381
17,13379,3,3,1, 13382
15,13381,2,2,1, 13383
20,13383,6,6,1, 13389
22,13386,4,4,1, 13390
24,13389,1,1,1, 13390
19,13386,5,5,1, 13391
23,13388,3,3,1, 13391
30,13393,3,3,1, 13396
31,13396,2,2,1, 13398
28,13394,5,5,1, 13399
26,13397,3,3,1, 13400
29,13398,4,4,1, 13402
2,13403,2,2,1, 13405
1,13406,1,1,1, 13407
5,13407,3,5,1, 13412
6,13410,2,4,1, 13414
8,13416,1,1,1, 13417
9,13417,2,2,1, 13419
16,13419,2,2,0, 13421
17,13419,3,3,1, 13422
15,13421,2,2,0, 13423
13,13419,4,6,1, 13425
22,13426,4,4,0, 13430
24,13429,1,1,1, 13430
19,13426,5,5,1, 13431
23,13428,3,3,1, 13431
30,13433,3,3,1, 13436
28,13434,5,5,1, 13439
29,13438,4,4,1, 13442
2,13443,2,2,1, 13445
6,13450,2,4,1, 13454
8,13456,1,1,1, 13457
16,13459,2,2,0, 13461
15,13461,2,2,1, 13463
22,13466,4,4,1, 13470
24,13469,1,1,0, 13470
23,13468,3,3,0, 13471
6,13490,2,4,1, 13494
8,13496,1,1,0, 13497
16,13499,2,2,1, 13501
15,13501,2,2,0, 13503
22,13506,4,4,1, 13510
24,13509,1,1,0, 13510
23,13508,3,3,0, 13511
30,13513,3,3,1, 13516
31,13516,2,2,1, 13518
29,13518,4,4,1, 13522
8,13536,1,1,0, 13537
16,13539,2,2,0, 13541
15,13541,2,2,1, 13543
22,13546,4,4,1, 13550
24,13549,1,1,0, 13550
23,13548,3,3,0, 13551
25,13555,2,2,1, 13557
31,13556,2,2,1, 13558
26,13557,3,3,1, 13560
29,13558,4,4,1, 13562
2,13563,2,2,1, 13565
1,13566,1,1,0, 13567
3,13567,3,3,1, 13570
6,13570,2,4,1, 13574
8,13576,1,1,0, 13577
9,13577,2,2,1, 13579
16,13579,2,2,1, 13581
15,13581,2,2,1, 13583
18,13583,4,4,1, 13587
20,13583,6,6,1, 13589
22,13586,4,4,0, 13590
24,13589,1,1,1, 13590
23,13588,3,3,0, 13591
30,13593,3,3,1, 13596
31,13596,2,2,1, 13598
28,13594,5,5,1, 13599
29,13598,4,4,1, 13602
2,13603,2,2,1, 13605
1,13606,1,1,1, 13607
3,13607,3,3,1, 13610
5,13607,3,5,1, 13612
6,13610,2,4,1, 13614
8,13616,1,1,1, 13617
11,13614,4,4,1, 13618
9,13617,2,2,1, 13619
16,13619,2,2,0, 13621
15,13621,2,2,1, 13623
13,13619,4,6,1, 13625
12,13620,5,5,1, 13625
18,13623,4,4,1, 13627
20,13623,6,6,1, 13629
22,13626,4,4,0, 13630
24,13629,1,1,0, 13630
23,13628,3,3,1, 13631
28,13634,5,5,1, 13639
1,13646,1,1,0, 13647
3,13647,3,3,1, 13650
5,13647,3,5,1, 13652
6,13650,2,4,1, 13654
8,13656,1,1,0, 13657
11,13654,4,4,1, 13658
16,13659,2,2,1, 13661
15,13661,2,2,0, 13663
12,13660,5,5,1, 13665
22,13666,4,4,0, 13670
24,13669,1,1,1, 13670
23,13668,3,3,0, 13671
26,13677,3,3,1, 13680
29,13678,4,4,1, 13682
2,13683,2,2,1, 13685
1,13686,1,1,1, 13687
3,13687,3,3,1, 13690
8,13696,1,1,1, 13697
11,13694,4,4,1, 13698
9,13697,2,2,1, 13699
16,13699,2,2,1, 13701
15,13701,2,2,1, 13703
13,13699,4,6,1, 13705
18,13703,4,4,1, 13707
20,13703,6,6,1, 13709
22,13706,4,4,0, 13710
24,13709,1,1,1, 13710
23,13708,3,3,1, 13711
30,13713,3,3,1, 13716
25,13715,2,2,1, 13717
31,13716,2,2,1, 13718
26,13717,3,3,1, 13720
29,13718,4,4,1, 13722
1,13726,1,1,0, 13727
3,13727,3,3,1, 13730
5,13727,3,5,1, 13732
8,13736,1,1,1, 13737
16,13739,2,2,0, 13741
15,13741,2,2,0, 13743
20,13743,6,6,1, 13749
22,13746,4,4,0, 13750
24,13749,1,1,1, 13750
23,13748,3,3,0, 13751
30,13753,3,3,1, 13756
25,13755,2,2,1, 13757
26,13757,3,3,1, 13760
29,13758,4,4,1, 13762
5,13767,3,5,1, 13772
8,13776,1,1,0, 13777
16,13779,2,2,0, 13781
15,13781,2,2,0, 13783
22,13786,4,4,0, 13790
24,13789,1,1,1, 13790
23,13788,3,3,1, 13791
6,13810,2,4,1, 13814
8,13816,1,1,1, 13817
16,13819,2,2,0, 13821
15,13821,2,2,0, 13823
22,13826,4,4,0, 13830
24,13829,1,1,0, 13830
23,13828,3,3,0, 13831
30,13833,3,3,1, 13836
31,13836,2,2,1, 13838
29,13838,4,4,1, 13842
8,13856,1,1,1, 13857
16,13859,2,2,0, 13861
15,13861,2,2,0, 13863
22,13866,4,4,0, 13870
24,13869,1,1,1, 13870
23,13868,3,3,0, 13871
31,13876,2,2,1, 13878
29,13878,4,4,1, 13882
1,13886,1,1,1, 13887
8,13896,1,1,1, 13897
16,13899,2,2,1, 13901
15,13901,2,2,0, 13903
22,13906,4,4,1, 13910
24,13909,1,1,1, 13910
23,13908,3,3,0, 13911
30,13913,3,3,1, 13916
25,13915,2,2,1, 13917
31,13916,2,2,1, 13918
28,13914,5,5,1, 13919
29,13918,4,4,1, 13922
1,13926,1,1,0, 13927
6,13930,2,4,1, 13934
8,13936,1,1,0, 13937
16,13939,2,2,1, 13941
17,13939,3,3,1, 13942
15,13941,2,2,1, 13943
22,13946,4,4,1, 13950
24,13949,1,1,1, 13950
23,13948,3,3,0, 13951
30,13953,3,3,1, 13956
28,13954,5,5,1, 13959
2,13963,2,2,1, 13965
1,13966,1,1,1, 13967
5,13967,3,5,1, 13972
8,13976,1,1,0, 13977
11,13974,4,4,1, 13978
9,13977,2,2,1, 13979
16,13979,2,2,1, 13981
15,13981,2,2,0, 13983
12,13980,5,5,1, 13985
18,13983,4,4,1, 13987
22,13986,4,4,1, 13990
24,13989,1,1,0, 13990
19,13986,5,5,1, 13991
23,13988,3,3,0, 13991
1,14006,1,1,1, 14007
8,14016,1,1,0, 14017
9,14017,2,2,1, 14019
16,14019,2,2,1, 14021
17,14019,3,3,1, 14022
15,14021,2,2,0, 14023
13,14019,4,6,1, 14025
12,14020,5,5,1, 14025
18,14023,4,4,1, 14027
22,14026,4,4,0, 14030
24,14029,1,1,0, 14030
19,14026,5,5,1, 14031
23,14028,3,3,1, 14031
30,14033,3,3,1, 14036
29,14038,4,4,1, 14042
2,14043,2,2,1, 14045
1,14046,1,1,1, 14047
5,14047,3,5,1, 14052
6,14050,2,4,1, 14054
8,14056,1,1,0, 14057
11,14054,4,4,1, 14058
9,14057,2,2,1, 14059
16,14059,2,2,1, 14061
17,14059,3,3,1, 14062
15,14061,2,2,1, 14063
18,14063,4,4,1, 14067
20,14063,6,6,1, 14069
22,14066,4,4,1, 14070
24,14069,1,1,0, 14070
19,14066,5,5,1, 14071
23,14068,3,3,1, 14071
25,14075,2,2,1, 14077
28,14074,5,5,1, 14079
2,14083,2,2,1, 14085
1,14086,1,1,0, 14087
3,14087,3,3,1, 14090
6,14090,2,4,1, 14094
8,14096,1,1,1, 14097
11,14094,4,4,1, 14098
9,14097,2,2,1, 14099
16,14099,2,2,1, 14101
17,14099,3,3,1, 14102
15,14101,2,2,0, 14103
18,14103,4,4,1, 14107
22,14106,4,4,1, 14110
24,14109,1,1,1, 14110
19,14106,5,5,1, 14111
23,14108,3,3,0, 14111
25,14115,2,2,1, 14117
31,14116,2,2,1, 14118
26,14117,3,3,1, 14120
2,14123,2,2,1, 14125
1,14126,1,1,0, 14127
3,14127,3,3,1, 14130
5,14127,3,5,1, 14132
6,14130,2,4,1, 14134
8,14136,1,1,0, 14137
11,14134,4,4,1, 14138
9,14137,2,2,1, 14139
16,14139,2,2,1, 14141
17,14139,3,3,1, 14142
15,14141,2,2,1, 14143
13,14139,4,6,1, 14145
12,14140,5,5,1, 14145
22,14146,4,4,0, 14150
24,14149,1,1,1, 14150
23,14148,3,3,0, 14151
30,14153,3,3,1, 14156
25,14155,2,2,1, 14157
31,14156,2,2,1, 14158
2,14163,2,2,1, 14165
1,14166,1,1,1, 14167
6,14170,2,4,1, 14174
8,14176,1,1,0, 14177
9,14177,2,2,1, 14179
16,14179,2,2,0, 14181
17,14179,3,3,1, 14182
15,14181,2,2,1, 14183
18,14183,4,4,1, 14187
22,14186,4,4,0, 14190
24,14189,1,1,1, 14190
23,14188,3,3,0, 14191
30,14193,3,3,1, 14196
31,14196,2,2,1, 14198
28,14194,5,5,1, 14199
29,14198,4,4,1, 14202
6,14210,2,4,1, 14214
8,14216,1,1,1, 14217
16,14219,2,2,0, 14221
15,14221,2,2,0, 14223
22,14226,4,4,1, 14230
24,14229,1,1,0, 14230
23,14228,3,3,1, 14231
30,14233,3,3,1, 14236
28,14234,5,5,1, 14239
8,14256,1,1,1, 14257
16,14259,2,2,0, 14261
15,14261,2,2,0, 14263
22,14266,4,4,0, 14270
24,14269,1,1,0, 14270
23,14268,3,3,1, 14271
30,14273,3,3,1, 14276
28,14274,5,5,1, 14279
3,14287,3,3,1, 14290
5,14287,3,5,1, 14292
8,14296,1,1,0, 14297
11,14294,4,4,1, 14298
9,14297,2,2,1, 14299
16,14299,2,2,1, 14301
15,14301,2,2,1, 14303
13,14299,4,6,1, 14305
18,14303,4,4,1, 14307
22,14306,4,4,0, 14310
24,14309,1,1,0, 14310
19,14306,5,5,1, 14311
23,14308,3,3,0, 14311
30,14313,3,3,1, 14316
31,14316,2,2,1, 14318
26,14317,3,3,1, 14320
29,14318,4,4,1, 14322
2,14323,2,2,1, 14325
1,14326,1,1,1, 14327
6,14330,2,4,1, 14334
8,14336,1,1,0, 14337
9,14337,2,2,1, 14339
16,14339,2,2,0, 14341
17,14339,3,3,1, 14342
15,14341,2,2,1, 14343
18,14343,4,4,1, 14347
22,14346,4,4,1, 14350
24,14349,1,1,1, 14350
23,14348,3,3,0, 14351
25,14355,2,2,1, 14357
31,14356,2,2,1, 14358
26,14357,3,3,1, 14360
29,14358,4,4,1, 14362
2,14363,2,2,1, 14365
1,14366,1,1,0, 14367
5,14367,3,5,1, 14372
6,14370,2,4,1, 14374
8,14376,1,1,0, 14377
9,14377,2,2,1, 14379
16,14379,2,2,0, 14381
17,14379,3,3,1, 14382
15,14381,2,2,1, 14383
13,14379,4,6,1, 14385
22,14386,4,4,1, 14390
24,14389,1,1,0, 14390
19,14386,5,5,1, 14391
23,14388,3,3,1, 14391
31,14396,2,2,1, 14398
29,14398,4,4,1, 14402
2,14403,2,2,1, 14405
1,14406,1,1,1, 14407
8,14416,1,1,1, 14417
11,14414,4,4,1, 14418
16,14419,2,2,1, 14421
15,14421,2,2,0, 14423
18,14423,4,4,1, 14427
22,14426,4,4,1, 14430
24,14429,1,1,0, 14430
23,14428,3,3,1, 14431
30,14433,3,3,1, 14436
25,14435,2,2,1, 14437
31,14436,2,2,1, 14438
2,14443,2,2,1, 14445
1,14446,1,1,0, 14447
3,14447,3,3,1, 14450
5,14447,3,5,1, 14452
6,14450,2,4,1, 14454
8,14456,1,1,0, 14457
11,14454,4,4,1, 14458
9,14457,2,2,1, 14459
16,14459,2,2,1, 14461
17,14459,3,3,1, 14462
15,14461,2,2,1, 14463
18,14463,4,4,1, 14467
20,14463,6,6,1, 14469
22,14466,4,4,0, 14470
24,14469,1,1,1, 14470
23,14468,3,3,1, 14471
30,14473,3,3,1, 14476
25,14475,2,2,1, 14477
31,14476,2,2,1, 14478
28,14474,5,5,1, 14479
26,14477,3,3,1, 14480
1,14486,1,1,1, 14487
3,14487,3,3,1, 14490
6,14490,2,4,1, 14494
8,14496,1,1,0, 14497
16,14499,2,2,1, 14501
24,14509,1,1,0, 14510
23,14508,3,3,1, 14511
30,14513,3,3,1, 14516
31,14516,2,2,1, 14518
29,14518,4,4,1, 14522
5,14527,3,5,1, 14532
6,14530,2,4,1, 14534
8,14536,1,1,0, 14537
16,14539,2,2,1, 14541
24,14549,1,1,1, 14550
23,14548,3,3,1, 14551
31,14556,2,2,1, 14558
29,14558,4,4,1, 14562
8,14576,1,1,1, 14577
24,14589,1,1,0, 14590
30,14593,3,3,1, 14596
25,14595,2,2,1, 14597
31,14596,2,2,1, 14598
26,14597,3,3,1, 14600
29,14598,4,4,1, 14602
2,14603,2,2,1, 14605
1,14606,1,1,0, 14607
5,14607,3,5,1, 14612
8,14616,1,1,1, 14617
16,14619,2,2,1, 14621
12,14620,5,5,1, 14625
18,14623,4,4,1, 14627
20,14623,6,6,1, 14629
24,14629,1,1,0, 14630
19,14626,5,5,1, 14631
30,14633,3,3,1, 14636
25,14635,2,2,1, 14637
1,14646,1,1,0, 14647
5,14647,3,5,1, 14652
6,14650,2,4,1, 14654
8,14656,1,1,0, 14657
17,14659,3,3,1, 14662
15,14661,2,2,1, 14663
24,14669,1,1,1, 14670
23,14668,3,3,1, 14671
30,14673,3,3,1, 14676
29,14678,4,4,1, 14682
1,14686,1,1,1, 14687
8,14696,1,1,0, 14697
9,14697,2,2,1, 14699
16,14699,2,2,1, 14701
24,14709,1,1,1, 14710
29,14718,4,4,1, 14722
1,14726,1,1,0, 14727
6,14730,2,4,1, 14734
8,14736,1,1,1, 14737
11,14734,4,4,1, 14738
16,14739,2,2,1, 14741
20,14743,6,6,1, 14749
22,14746,4,4,1, 14750
24,14749,1,1,0, 14750
19,14746,5,5,1, 14751
25,14755,2,2,1, 14757
31,14756,2,2,1, 14758
26,14757,3,3,1, 14760
2,14763,2,2,1, 14765
1,14766,1,1,1, 14767
3,14767,3,3,1, 14770
5,14767,3,5,1, 14772
8,14776,1,1,1, 14777
13,14779,4,6,1, 14785
20,14783,6,6,1, 14789
24,14789,1,1,1, 14790
19,14786,5,5,1, 14791
30,14793,3,3,1, 14796
25,14795,2,2,1, 14797
31,14796,2,2,1, 14798
26,14797,3,3,1, 14800
1,14806,1,1,1, 14807
3,14807,3,3,1, 14810
6,14810,2,4,1, 14814
8,14816,1,1,1, 14817
16,14819,2,2,1, 14821
15,14821,2,2,1, 14823
13,14819,4,6,1, 14825
18,14823,4,4,1, 14827
20,14823,6,6,1, 14829
22,14826,4,4,1, 14830
24,14829,1,1,1, 14830
31,14836,2,2,1, 14838
29,14838,4,4,1, 14842
1,14846,1,1,1, 14847
3,14847,3,3,1, 14850
8,14856,1,1,0, 14857
11,14854,4,4,1, 14858
16,14859,2,2,1, 14861
18,14863,4,4,1, 14867
22,14866,4,4,1, 14870
24,14869,1,1,0, 14870
28,14874,5,5,1, 14879
1,14886,1,1,0, 14887
3,14887,3,3,1, 14890
5,14887,3,5,1, 14892
8,14896,1,1,0, 14897
15,14901,2,2,1, 14903
24,14909,1,1,1, 14910
19,14906,5,5,1, 14911
23,14908,3,3,1, 14911
25,14915,2,2,1, 14917
26,14917,3,3,1, 14920
29,14918,4,4,1, 14922
1,14926,1,1,0, 14927
8,14936,1,1,0, 14937
9,14937,2,2,1, 14939
17,14939,3,3,1, 14942
12,14940,5,5,1, 14945
24,14949,1,1,0, 14950
23,14948,3,3,1, 14951
30,14953,3,3,1, 14956
26,14957,3,3,1, 14960
29,14958,4,4,1, 14962
1,14966,1,1,1, 14967
5,14967,3,5,1, 14972
8,14976,1,1,1, 14977
11,14974,4,4,1, 14978
16,14979,2,2,1, 14981
15,14981,2,2,1, 14983
12,14980,5,5,1, 14985
20,14983,6,6,1, 14989
24,14989,1,1,0, 14990
19,14986,5,5,1, 14991
23,14988,3,3,1, 14991
25,14995,2,2,1, 14997
28,14994,5,5,1, 14999
2,15003,2,2,1, 15005
1,15006,1,1,0, 15007
3,15007,3,3,1, 15010
6,15010,2,4,1, 15014
8,15016,1,1,1, 15017
11,15014,4,4,1, 15018
17,15019,3,3,1, 15022
20,15023,6,6,1, 15029
24,15029,1,1,1, 15030
19,15026,5,5,1, 15031
23,15028,3,3,1, 15031
25,15035,2,2,1, 15037
31,15036,2,2,1, 15038
28,15034,5,5,1, 15039
29,15038,4,4,1, 15042
1,15046,1,1,0, 15047
8,15056,1,1,1, 15057
11,15054,4,4,1, 15058
9,15057,2,2,1, 15059
16,15059,2,2,1, 15061
15,15061,2,2,0, 15063
13,15059,4,6,1, 15065
12,15060,5,5,1, 15065
20,15063,6,6,1, 15069
22,15066,4,4,0, 15070
24,15069,1,1,1, 15070
19,15066,5,5,1, 15071
23,15068,3,3,0, 15071
30,15073,3,3,1, 15076
25,15075,2,2,1, 15077
31,15076,2,2,1, 15078
1,15086,1,1,0, 15087
3,15087,3,3,1, 15090
8,15096,1,1,0, 15097
16,15099,2,2,0, 15101
15,15101,2,2,0, 15103
18,15103,4,4,1, 15107
20,15103,6,6,1, 15109
22,15106,4,4,1, 15110
24,15109,1,1,0, 15110
19,15106,5,5,1, 15111
23,15108,3,3,1, 15111
30,15113,3,3,1, 15116
25,15115,2,2,1, 15117
31,15116,2,2,0, 15118
28,15114,5,5,1, 15119
26,15117,3,3,1, 15120
29,15118,4,4,0, 15122
5,15127,3,5,0, 15132
6,15130,2,4,0, 15134
8,15136,1,1,1, 15137
16,15139,2,2,1, 15141
15,15141,2,2,1, 15143
22,15146,4,4,1, 15150
24,15149,1,1,0, 15150
23,15148,3,3,1, 15151
30,15153,3,3,0, 15156
31,15156,2,2,1, 15158
28,15154,5,5,1, 15159
29,15158,4,4,1, 15162
5,15167,3,5,0, 15172
6,15170,2,4,1, 15174
8,15176,1,1,1, 15177
16,15179,2,2,1, 15181
15,15181,2,2,0, 15183
22,15186,4,4,0, 15190
24,15189,1,1,1, 15190
23,15188,3,3,0, 15191
30,15193,3,3,0, 15196
31,15196,2,2,0, 15198
28,15194,5,5,0, 15199
29,15198,4,4,1, 15202
5,15207,3,5,1, 15212
6,15210,2,4,1, 15214
8,15216,1,1,1, 15217
16,15219,2,2,1, 15221
15,15221,2,2,1, 15223
18,15223,4,4,1, 15227
22,15226,4,4,1, 15230
24,15229,1,1,0, 15230
23,15228,3,3,0, 15231
30,15233,3,3,0, 15236
31,15236,2,2,0, 15238
28,15234,5,5,0, 15239
29,15238,4,4,1, 15242
1,15246,1,1,1, 15247
3,15247,3,3,1, 15250
5,15247,3,5,0, 15252
6,15250,2,4,0, 15254
8,15256,1,1,1, 15257
11,15254,4,4,1, 15258
16,15259,2,2,0, 15261
15,15261,2,2,1, 15263
13,15259,4,6,1, 15265
12,15260,5,5,1, 15265
18,15263,4,4,1, 15267
20,15263,6,6,1, 15269
22,15266,4,4,1, 15270
24,15269,1,1,1, 15270
19,15266,5,5,1, 15271
23,15268,3,3,1, 15271
30,15273,3,3,0, 15276
31,15276,2,2,0, 15278
28,15274,5,5,0, 15279
26,15277,3,3,1, 15280
29,15278,4,4,1, 15282
1,15286,1,1,0, 15287
5,15287,3,5,1, 15292
6,15290,2,4,1, 15294
8,15296,1,1,0, 15297
11,15294,4,4,1, 15298
9,15297,2,2,1, 15299
16,15299,2,2,0, 15301
17,15299,3,3,1, 15302
15,15301,2,2,1, 15303
18,15303,4,4,1, 15307
20,15303,6,6,1, 15309
22,15306,4,4,0, 15310
24,15309,1,1,1, 15310
19,15306,5,5,1, 15311
23,15308,3,3,1, 15311
30,15313,3,3,1, 15316
25,15315,2,2,1, 15317
31,15316,2,2,0, 15318
28,15314,5,5,0, 15319
29,15318,4,4,0, 15322
1,15326,1,1,0, 15327
5,15327,3,5,1, 15332
6,15330,2,4,1, 15334
8,15336,1,1,1, 15337
16,15339,2,2,0, 15341
17,15339,3,3,1, 15342
15,15341,2,2,0, 15343
22,15346,4,4,1, 15350
24,15349,1,1,1, 15350
23,15348,3,3,0, 15351
30,15353,3,3,1, 15356
25,15355,2,2,1, 15357
31,15356,2,2,1, 15358
28,15354,5,5,1, 15359
29,15358,4,4,0, 15362
1,15366,1,1,0, 15367
5,15367,3,5,0, 15372
6,15370,2,4,1, 15374
8,15376,1,1,1, 15377
9,15377,2,2,1, 15379
16,15379,2,2,0, 15381
17,15379,3,3,1, 15382
15,15381,2,2,0, 15383
22,15386,4,4,1, 15390
24,15389,1,1,0, 15390
23,15388,3,3,1, 15391
30,15393,3,3,0, 15396
25,15395,2,2,1, 15397
31,15396,2,2,0, 15398
28,15394,5,5,0, 15399
29,15398,4,4,0, 15402
1,15406,1,1,1, 15407
5,15407,3,5,0, 15412
6,15410,2,4,0, 15414
8,15416,1,1,1, 15417
9,15417,2,2,1, 15419
16,15419,2,2,1, 15421
15,15421,2,2,0, 15423
12,15420,5,5,1, 15425
18,15423,4,4,1, 15427
22,15426,4,4,1, 15430
24,15429,1,1,1, 15430
19,15426,5,5,1, 15431
23,15428,3,3,0, 15431
30,15433,3,3,1, 15436
25,15435,2,2,1, 15437
31,15436,2,2,1, 15438
28,15434,5,5,0, 15439
26,15437,3,3,1, 15440
29,15438,4,4,0, 15442
2,15443,2,2,1, 15445
1,15446,1,1,0, 15447
5,15447,3,5,0, 15452
6,15450,2,4,0, 15454
8,15456,1,1,0, 15457
11,15454,4,4,1, 15458
16,15459,2,2,1, 15461
15,15461,2,2,0, 15463
13,15459,4,6,1, 15465
12,15460,5,5,1, 15465
18,15463,4,4,1, 15467
20,15463,6,6,1, 15469
22,15466,4,4,1, 15470
24,15469,1,1,1, 15470
23,15468,3,3,1, 15471
30,15473,3,3,0, 15476
31,15476,2,2,0, 15478
28,15474,5,5,0, 15479
29,15478,4,4,0, 15482
1,15486,1,1,1, 15487
5,15487,3,5,1, 15492
8,15496,1,1,0, 15497
11,15494,4,4,1, 15498
9,15497,2,2,1, 15499
16,15499,2,2,1, 15501
17,15499,3,3,1, 15502
15,15501,2,2,0, 15503
18,15503,4,4,1, 15507
20,15503,6,6,1, 15509
22,15506,4,4,1, 15510
24,15509,1,1,1, 15510
23,15508,3,3,0, 15511
30,15513,3,3,1, 15516
25,15515,2,2,1, 15517
28,15514,5,5,1, 15519
26,15517,3,3,1, 15520
29,15518,4,4,1, 15522
2,15523,2,2,1, 15525
1,15526,1,1,0, 15527
6,15530,2,4,1, 15534
8,15536,1,1,1, 15537
16,15539,2,2,0, 15541
15,15541,2,2,1, 15543
13,15539,4,6,1, 15545
22,15546,4,4,0, 15550
24,15549,1,1,0, 15550
23,15548,3,3,0, 15551
31,15556,2,2,1, 15558
28,15554,5,5,1, 15559
29,15558,4,4,1, 15562
5,15567,3,5,1, 15572
8,15576,1,1,0, 15577
16,15579,2,2,0, 15581
15,15581,2,2,0, 15583
22,15586,4,4,0, 15590
24,15589,1,1,1, 15590
23,15588,3,3,1, 15591
31,15596,2,2,1, 15598
28,15594,5,5,1, 15599
29,15598,4,4,1, 15602
5,15607,3,5,1, 15612
6,15610,2,4,1, 15614
8,15616,1,1,0, 15617
16,15619,2,2,0, 15621
15,15621,2,2,1, 15623
22,15626,4,4,1, 15630
24,15629,1,1,0, 15630
23,15628,3,3,0, 15631
31,15636,2,2,1, 15638
28,15634,5,5,1, 15639
29,15638,4,4,1, 15642
6,15650,2,4,1, 15654
8,15656,1,1,0, 15657
11,15654,4,4,1, 15658
9,15657,2,2,1, 15659
16,15659,2,2,0, 15661
17,15659,3,3,1, 15662
15,15661,2,2,0, 15663
13,15659,4,6,1, 15665
12,15660,5,5,1, 15665
18,15663,4,4,1, 15667
22,15666,4,4,0, 15670
24,15669,1,1,1, 15670
23,15668,3,3,1, 15671
31,15676,2,2,1, 15678
29,15678,4,4,1, 15682
1,15686,1,1,1, 15687
3,15687,3,3,1, 15690
5,15687,3,5,1, 15692
8,15696,1,1,0, 15697
9,15697,2,2,1, 15699
16,15699,2,2,1, 15701
17,15699,3,3,1, 15702
15,15701,2,2,1, 15703
12,15700,5,5,1, 15705
20,15703,6,6,1, 15709
22,15706,4,4,0, 15710
24,15709,1,1,1, 15710
19,15706,5,5,1, 15711
23,15708,3,3,0, 15711
30,15713,3,3,1, 15716
28,15714,5,5,1, 15719
29,15718,4,4,1, 15722
2,15723,2,2,1, 15725
1,15726,1,1,0, 15727
5,15727,3,5,1, 15732
6,15730,2,4,1, 15734
8,15736,1,1,0, 15737
16,15739,2,2,1, 15741
15,15741,2,2,0, 15743
18,15743,4,4,1, 15747
22,15746,4,4,1, 15750
24,15749,1,1,1, 15750
19,15746,5,5,1, 15751
23,15748,3,3,1, 15751
29,15758,4,4,1, 15762
2,15763,2,2,1, 15765
1,15766,1,1,1, 15767
5,15767,3,5,1, 15772
6,15770,2,4,1, 15774
8,15776,1,1,1, 15777
11,15774,4,4,1, 15778
9,15777,2,2,1, 15779
16,15779,2,2,1, 15781
15,15781,2,2,0, 15783
12,15780,5,5,1, 15785
22,15786,4,4,1, 15790
24,15789,1,1,1, 15790
23,15788,3,3,1, 15791
30,15793,3,3,1, 15796
25,15795,2,2,1, 15797
31,15796,2,2,1, 15798
26,15797,3,3,1, 15800
2,15803,2,2,1, 15805
1,15806,1,1,0, 15807
8,15816,1,1,0, 15817
11,15814,4,4,1, 15818
9,15817,2,2,1, 15819
16,15819,2,2,0, 15821
17,15819,3,3,1, 15822
15,15821,2,2,0, 15823
22,15826,4,4,0, 15830
24,15829,1,1,0, 15830
23,15828,3,3,0, 15831
31,15836,2,2,1, 15838
28,15834,5,5,1, 15839
29,15838,4,4,1, 15842
1,15846,1,1,0, 15847
3,15847,3,3,1, 15850
8,15856,1,1,1, 15857
9,15857,2,2,1, 15859
16,15859,2,2,0, 15861
15,15861,2,2,0, 15863
13,15859,4,6,1, 15865
18,15863,4,4,1, 15867
22,15866,4,4,0, 15870
24,15869,1,1,0, 15870
19,15866,5,5,1, 15871
23,15868,3,3,0, 15871
31,15876,2,2,1, 15878
28,15874,5,5,1, 15879
1,15886,1,1,0, 15887
6,15890,2,4,1, 15894
8,15896,1,1,1, 15897
9,15897,2,2,1, 15899
16,15899,2,2,0, 15901
15,15901,2,2,1, 15903
18,15903,4,4,1, 15907
22,15906,4,4,1, 15910
24,15909,1,1,0, 15910
19,15906,5,5,1, 15911
23,15908,3,3,1, 15911
30,15913,3,3,1, 15916
31,15916,2,2,1, 15918
29,15918,4,4,1, 15922
1,15926,1,1,0, 15927
3,15927,3,3,1, 15930
5,15927,3,5,1, 15932
8,15936,1,1,0, 15937
11,15934,4,4,1, 15938
16,15939,2,2,1, 15941
17,15939,3,3,1, 15942
15,15941,2,2,0, 15943
22,15946,4,4,0, 15950
24,15949,1,1,1, 15950
23,15948,3,3,0, 15951
25,15955,2,2,1, 15957
31,15956,2,2,1, 15958
26,15957,3,3,1, 15960
1,15966,1,1,1, 15967
3,15967,3,3,1, 15970
5,15967,3,5,1, 15972
8,15976,1,1,0, 15977
16,15979,2,2,0, 15981
15,15981,2,2,0, 15983
22,15986,4,4,0, 15990
24,15989,1,1,1, 15990
23,15988,3,3,0, 15991
30,15993,3,3,1, 15996
28,15994,5,5,1, 15999
1,16006,1,1,0, 16007
6,16010,2,4,1, 16014
8,16016,1,1,0, 16017
11,16014,4,4,1, 16018
9,16017,2,2,1, 16019
16,16019,2,2,0, 16021
15,16021,2,2,1, 16023
12,16020,5,5,1, 16025
18,16023,4,4,1, 16027
22,16026,4,4,0, 16030
24,16029,1,1,0, 16030
23,16028,3,3,1, 16031
25,16035,2,2,1, 16037
31,16036,2,2,1, 16038
26,16037,3,3,1, 16040
1,16046,1,1,1, 16047
6,16050,2,4,1, 16054
8,16056,1,1,0, 16057
9,16057,2,2,1, 16059
16,16059,2,2,1, 16061
17,16059,3,3,1, 16062
15,16061,2,2,0, 16063
20,16063,6,6,1, 16069
22,16066,4,4,1, 16070
24,16069,1,1,1, 16070
19,16066,5,5,1, 16071
23,16068,3,3,1, 16071
25,16075,2,2,1, 16077
28,16074,5,5,1, 16079
26,16077,3,3,1, 16080
29,16078,4,4,1, 16082
1,16086,1,1,0, 16087
8,16096,1,1,0, 16097
9,16097,2,2,1, 16099
16,16099,2,2,0, 16101
15,16101,2,2,1, 16103
18,16103,4,4,1, 16107
22,16106,4,4,1, 16110
24,16109,1,1,1, 16110
23,16108,3,3,1, 16111
31,16116,2,2,1, 16118
28,16114,5,5,1, 16119
29,16118,4,4,1, 16122
1,16126,1,1,0, 16127
3,16127,3,3,1, 16130
8,16136,1,1,0, 16137
11,16134,4,4,1, 16138
9,16137,2,2,1, 16139
16,16139,2,2,1, 16141
15,16141,2,2,0, 16143
13,16139,4,6,1, 16145
22,16146,4,4,0, 16150
24,16149,1,1,0, 16150
23,16148,3,3,0, 16151
31,16156,2,2,1, 16158
29,16158,4,4,1, 16162
5,16167,3,5,1, 16172
6,16170,2,4,1, 16174
8,16176,1,1,0, 16177
16,16179,2,2,1, 16181
15,16181,2,2,0, 16183
22,16186,4,4,1, 16190
24,16189,1,1,1, 16190
23,16188,3,3,1, 16191
6,16210,2,4,1, 16214
8,16216,1,1,0, 16217
16,16219,2,2,1, 16221
15,16221,2,2,0, 16223
22,16226,4,4,1, 16230
24,16229,1,1,1, 16230
23,16228,3,3,0, 16231
30,16233,3,3,1, 16236
28,16234,5,5,1, 16239
8,16256,1,1,1, 16257
11,16254,4,4,1, 16258
16,16259,2,2,0, 16261
17,16259,3,3,1, 16262
15,16261,2,2,1, 16263
13,16259,4,6,1, 16265
12,16260,5,5,1, 16265
18,16263,4,4,1, 16267
22,16266,4,4,0, 16270
24,16269,1,1,1, 16270
23,16268,3,3,1, 16271
30,16273,3,3,1, 16276
25,16275,2,2,1, 16277
31,16276,2,2,1, 16278
29,16278,4,4,1, 16282
1,16286,1,1,0, 16287
3,16287,3,3,1, 16290
8,16296,1,1,0, 16297
11,16294,4,4,1, 16298
16,16299,2,2,1, 16301
17,16299,3,3,1, 16302
15,16301,2,2,1, 16303
13,16299,4,6,1, 16305
12,16300,5,5,1, 16305
22,16306,4,4,0, 16310
24,16309,1,1,1, 16310
19,16306,5,5,1, 16311
23,16308,3,3,0, 16311
30,16313,3,3,1, 16316
31,16316,2,2,1, 16318
1,16326,1,1,1, 16327
3,16327,3,3,1, 16330
8,16336,1,1,1, 16337
16,16339,2,2,0, 16341
17,16339,3,3,1, 16342
15,16341,2,2,1, 16343
12,16340,5,5,1, 16345
18,16343,4,4,1, 16347
20,16343,6,6,1, 16349
22,16346,4,4,0, 16350
24,16349,1,1,0, 16350
23,16348,3,3,0, 16351
25,16355,2,2,1, 16357
28,16354,5,5,1, 16359
26,16357,3,3,1, 16360
2,16363,2,2,1, 16365
1,16366,1,1,1, 16367
6,16370,2,4,1, 16374
8,16376,1,1,0, 16377
16,16379,2,2,0, 16381
15,16381,2,2,1, 16383
12,16380,5,5,1, 16385
18,16383,4,4,1, 16387
20,16383,6,6,1, 16389
22,16386,4,4,0, 16390
24,16389,1,1,0, 16390
19,16386,5,5,1, 16391
23,16388,3,3,0, 16391
31,16396,2,2,1, 16398
29,16398,4,4,1, 16402
1,16406,1,1,1, 16407
8,16416,1,1,0, 16417
16,16419,2,2,1, 16421
15,16421,2,2,1, 16423
12,16420,5,5,1, 16425
18,16423,4,4,1, 16427
22,16426,4,4,0, 16430
24,16429,1,1,1, 16430
19,16426,5,5,1, 16431
23,16428,3,3,0, 16431
30,16433,3,3,1, 16436
25,16435,2,2,1, 16437
2,16443,2,2,1, 16445
1,16446,1,1,0, 16447
8,16456,1,1,0, 16457
16,16459,2,2,1, 16461
15,16461,2,2,0, 16463
18,16463,4,4,1, 16467
20,16463,6,6,1, 16469
22,16466,4,4,1, 16470
24,16469,1,1,1, 16470
23,16468,3,3,1, 16471
30,16473,3,3,1, 16476
31,16476,2,2,1, 16478
28,16474,5,5,1, 16479
2,16483,2,2,1, 16485
1,16486,1,1,0, 16487
8,16496,1,1,1, 16497
11,16494,4,4,1, 16498
9,16497,2,2,1, 16499
16,16499,2,2,0, 16501
15,16501,2,2,0, 16503
22,16506,4,4,1, 16510
24,16509,1,1,0, 16510
23,16508,3,3,0, 16511
30,16513,3,3,1, 16516
28,16514,5,5,1, 16519
29,16518,4,4,1, 16522
8,16536,1,1,1, 16537
16,16539,2,2,0, 16541
15,16541,2,2,1, 16543
22,16546,4,4,0, 16550
24,16549,1,1,1, 16550
23,16548,3,3,1, 16551
31,16556,2,2,1, 16558
6,16570,2,4,1, 16574
8,16576,1,1,0, 16577
16,16579,2,2,1, 16581
15,16581,2,2,1, 16583
22,16586,4,4,0, 16590
24,16589,1,1,1, 16590
23,16588,3,3,0, 16591
31,16596,2,2,1, 16598
28,16594,5,5,1, 16599
29,16598,4,4,1, 16602
1,16606,1,1,0, 16607
5,16607,3,5,1, 16612
6,16610,2,4,1, 16614
8,16616,1,1,1, 16617
11,16614,4,4,1, 16618
9,16617,2,2,1, 16619
16,16619,2,2,1, 16621
15,16621,2,2,1, 16623
13,16619,4,6,1, 16625
18,16623,4,4,1, 16627
22,16626,4,4,0, 16630
24,16629,1,1,0, 16630
19,16626,5,5,1, 16631
23,16628,3,3,0, 16631
30,16633,3,3,1, 16636
25,16635,2,2,1, 16637
29,16638,4,4,1, 16642
2,16643,2,2,1, 16645
1,16646,1,1,1, 16647
8,16656,1,1,0, 16657
9,16657,2,2,1, 16659
16,16659,2,2,0, 16661
17,16659,3,3,1, 16662
15,16661,2,2,1, 16663
13,16659,4,6,1, 16665
12,16660,5,5,1, 16665
22,16666,4,4,0, 16670
24,16669,1,1,0, 16670
23,16668,3,3,0, 16671
25,16675,2,2,1, 16677
1,16686,1,1,1, 16687
5,16687,3,5,1, 16692
6,16690,2,4,1, 16694
8,16696,1,1,0, 16697
11,16694,4,4,1, 16698
16,16699,2,2,0, 16701
15,16701,2,2,1, 16703
12,16700,5,5,1, 16705
18,16703,4,4,1, 16707
22,16706,4,4,0, 16710
24,16709,1,1,0, 16710
19,16706,5,5,1, 16711
23,16708,3,3,1, 16711
30,16713,3,3,1, 16716
25,16715,2,2,1, 16717
31,16716,2,2,1, 16718
28,16714,5,5,1, 16719
29,16718,4,4,1, 16722
1,16726,1,1,0, 16727
5,16727,3,5,1, 16732
6,16730,2,4,1, 16734
8,16736,1,1,0, 16737
11,16734,4,4,1, 16738
9,16737,2,2,1, 16739
16,16739,2,2,0, 16741
15,16741,2,2,1, 16743
13,16739,4,6,1, 16745
12,16740,5,5,1, 16745
18,16743,4,4,1, 16747
22,16746,4,4,1, 16750
24,16749,1,1,1, 16750
23,16748,3,3,1, 16751
25,16755,2,2,1, 16757
28,16754,5,5,1, 16759
29,16758,4,4,1, 16762
2,16763,2,2,1, 16765
1,16766,1,1,1, 16767
6,16770,2,4,1, 16774
8,16776,1,1,0, 16777
11,16774,4,4,1, 16778
9,16777,2,2,1, 16779
16,16779,2,2,0, 16781
17,16779,3,3,1, 16782
15,16781,2,2,1, 16783
13,16779,4,6,1, 16785
18,16783,4,4,1, 16787
22,16786,4,4,0, 16790
24,16789,1,1,0, 16790
19,16786,5,5,1, 16791
23,16788,3,3,1, 16791
30,16793,3,3,1, 16796
5,16807,3,5,1, 16812
6,16810,2,4,1, 16814
8,16816,1,1,0, 16817
16,16819,2,2,1, 16821
15,16821,2,2,1, 16823
22,16826,4,4,0, 16830
24,16829,1,1,1, 16830
23,16828,3,3,0, 16831
30,16833,3,3,1, 16836
28,16834,5,5,1, 16839
29,16838,4,4,1, 16842
5,16847,3,5,1, 16852
6,16850,2,4,1, 16854
8,16856,1,1,1, 16857
16,16859,2,2,0, 16861
15,16861,2,2,0, 16863
22,16866,4,4,0, 16870
24,16869,1,1,0, 16870
23,16868,3,3,1, 16871
30,16873,3,3,1, 16876
28,16874,5,5,1, 16879
29,16878,4,4,1, 16882
5,16887,3,5,1, 16892
8,16896,1,1,0, 16897
11,16894,4,4,1, 16898
16,16899,2,2,0, 16901
17,16899,3,3,1, 16902
15,16901,2,2,0, 16903
22,16906,4,4,1, 16910
24,16909,1,1,0, 16910
23,16908,3,3,1, 16911
25,16915,2,2,1, 16917
28,16914,5,5,1, 16919
1,16926,1,1,0, 16927
3,16927,3,3,1, 16930
5,16927,3,5,1, 16932
8,16936,1,1,1, 16937
9,16937,2,2,1, 16939
16,16939,2,2,1, 16941
17,16939,3,3,1, 16942
15,16941,2,2,1, 16943
18,16943,4,4,1, 16947
22,16946,4,4,0, 16950
24,16949,1,1,1, 16950
19,16946,5,5,1, 16951
23,16948,3,3,0, 16951
28,16954,5,5,1, 16959
1,16966,1,1,1, 16967
8,16976,1,1,1, 16977
16,16979,2,2,1, 16981
15,16981,2,2,1, 16983
12,16980,5,5,1, 16985
22,16986,4,4,0, 16990
24,16989,1,1,1, 16990
19,16986,5,5,1, 16991
23,16988,3,3,1, 16991
25,16995,2,2,1, 16997
31,16996,2,2,1, 16998
26,16997,3,3,1, 17000
29,16998,4,4,1, 17002
1,17006,1,1,0, 17007
3,17007,3,3,1, 17010
6,17010,2,4,1, 17014
8,17016,1,1,1, 17017
11,17014,4,4,1, 17018
9,17017,2,2,1, 17019
17,17019,3,3,1, 17022
15,17021,2,2,1, 17023
18,17023,4,4,1, 17027
20,17023,6,6,1, 17029
24,17029,1,1,1, 17030
28,17034,5,5,1, 17039
29,17038,4,4,1, 17042
1,17046,1,1,1, 17047
3,17047,3,3,1, 17050
6,17050,2,4,1, 17054
8,17056,1,1,0, 17057
15,17061,2,2,1, 17063
12,17060,5,5,1, 17065
24,17069,1,1,1, 17070
19,17066,5,5,1, 17071
30,17073,3,3,1, 17076
25,17075,2,2,1, 17077
31,17076,2,2,1, 17078
26,17077,3,3,1, 17080
1,17086,1,1,0, 17087
3,17087,3,3,1, 17090
8,17096,1,1,1, 17097
9,17097,2,2,1, 17099
17,17099,3,3,1, 17102
12,17100,5,5,1, 17105
18,17103,4,4,1, 17107
20,17103,6,6,1, 17109
24,17109,1,1,1, 17110
30,17113,3,3,1, 17116
1,17126,1,1,0, 17127
6,17130,2,4,1, 17134
8,17136,1,1,0, 17137
15,17141,2,2,1, 17143
13,17139,4,6,1, 17145
12,17140,5,5,1, 17145
18,17143,4,4,1, 17147
24,17149,1,1,0, 17150
19,17146,5,5,1, 17151
30,17153,3,3,1, 17156
31,17156,2,2,1, 17158
28,17154,5,5,1, 17159
29,17158,4,4,1, 17162
2,17163,2,2,1, 17165
1,17166,1,1,1, 17167
3,17167,3,3,1, 17170
6,17170,2,4,1, 17174
8,17176,1,1,1, 17177
11,17174,4,4,1, 17178
15,17181,2,2,1, 17183
12,17180,5,5,1, 17185
22,17186,4,4,1, 17190
24,17189,1,1,0, 17190
30,17193,3,3,1, 17196
25,17195,2,2,1, 17197
31,17196,2,2,1, 17198
28,17194,5,5,1, 17199
26,17197,3,3,1, 17200
2,17203,2,2,1, 17205
1,17206,1,1,1, 17207
3,17207,3,3,1, 17210
5,17207,3,5,1, 17212
6,17210,2,4,1, 17214
8,17216,1,1,1, 17217
11,17214,4,4,1, 17218
9,17217,2,2,1, 17219
16,17219,2,2,1, 17221
15,17221,2,2,1, 17223
24,17229,1,1,1, 17230
31,17236,2,2,1, 17238
5,17247,3,5,1, 17252
8,17256,1,1,1, 17257
16,17259,2,2,1, 17261
24,17269,1,1,0, 17270
31,17276,2,2,1, 17278
29,17278,4,4,1, 17282
5,17287,3,5,1, 17292
8,17296,1,1,0, 17297
22,17306,4,4,1, 17310
24,17309,1,1,1, 17310
23,17308,3,3,1, 17311
31,17316,2,2,1, 17318
28,17314,5,5,1, 17319
1,17326,1,1,0, 17327
5,17327,3,5,1, 17332
8,17336,1,1,0, 17337
9,17337,2,2,1, 17339
17,17339,3,3,1, 17342
15,17341,2,2,1, 17343
13,17339,4,6,1, 17345
20,17343,6,6,1, 17349
24,17349,1,1,0, 17350
30,17353,3,3,1, 17356
28,17354,5,5,1, 17359
1,17366,1,1,0, 17367
3,17367,3,3,1, 17370
6,17370,2,4,1, 17374
8,17376,1,1,1, 17377
9,17377,2,2,1, 17379
16,17379,2,2,1, 17381
15,17381,2,2,1, 17383
12,17380,5,5,1, 17385
18,17383,4,4,1, 17387
20,17383,6,6,1, 17389
24,17389,1,1,1, 17390
19,17386,5,5,1, 17391
28,17394,5,5,1, 17399
1,17406,1,1,0, 17407
8,17416,1,1,0, 17417
9,17417,2,2,1, 17419
15,17421,2,2,1, 17423
22,17426,4,4,1, 17430
24,17429,1,1,0, 17430
25,17435,2,2,1, 17437
31,17436,2,2,1, 17438
28,17434,5,5,1, 17439
29,17438,4,4,1, 17442
1,17446,1,1,0, 17447
8,17456,1,1,0, 17457
9,17457,2,2,1, 17459
16,17459,2,2,1, 17461
17,17459,3,3,1, 17462
15,17461,2,2,1, 17463
22,17466,4,4,1, 17470
24,17469,1,1,0, 17470
23,17468,3,3,1, 17471
30,17473,3,3,1, 17476
1,17486,1,1,1, 17487
8,17496,1,1,0, 17497
9,17497,2,2,1, 17499
17,17499,3,3,1, 17502
13,17499,4,6,1, 17505
18,17503,4,4,1, 17507
20,17503,6,6,1, 17509
22,17506,4,4,1, 17510
24,17509,1,1,0, 17510
23,17508,3,3,1, 17511
30,17513,3,3,1, 17516
31,17516,2,2,0, 17518
26,17517,3,3,1, 17520
29,17518,4,4,1, 17522
2,17523,2,2,1, 17525
1,17526,1,1,1, 17527
5,17527,3,5,1, 17532
6,17530,2,4,1, 17534
8,17536,1,1,1, 17537
13,17539,4,6,1, 17545
18,17543,4,4,1, 17547
20,17543,6,6,1, 17549
22,17546,4,4,1, 17550
24,17549,1,1,0, 17550
19,17546,5,5,1, 17551
23,17548,3,3,1, 17551
31,17556,2,2,1, 17558
1,17566,1,1,1, 17567
8,17576,1,1,0, 17577
11,17574,4,4,1, 17578
9,17577,2,2,1, 17579
16,17579,2,2,0, 17581
15,17581,2,2,1, 17583
13,17579,4,6,1, 17585
18,17583,4,4,1, 17587
20,17583,6,6,1, 17589
22,17586,4,4,0, 17590
24,17589,1,1,0, 17590
19,17586,5,5,1, 17591
23,17588,3,3,1, 17591
31,17596,2,2,0, 17598
29,17598,4,4,1, 17602
1,17606,1,1,0, 17607
5,17607,3,5,1, 17612
6,17610,2,4,1, 17614
8,17616,1,1,0, 17617
16,17619,2,2,1, 17621
17,17619,3,3,1, 17622
15,17621,2,2,1, 17623
22,17626,4,4,1, 17630
24,17629,1,1,0, 17630
19,17626,5,5,1, 17631
23,17628,3,3,1, 17631
31,17636,2,2,1, 17638
26,17637,3,3,1, 17640
2,17643,2,2,1, 17645
1,17646,1,1,0, 17647
3,17647,3,3,1, 17650
8,17656,1,1,0, 17657
11,17654,4,4,1, 17658
16,17659,2,2,1, 17661
17,17659,3,3,1, 17662
15,17661,2,2,0, 17663
13,17659,4,6,1, 17665
12,17660,5,5,1, 17665
18,17663,4,4,1, 17667
22,17666,4,4,1, 17670
24,17669,1,1,0, 17670
19,17666,5,5,1, 17671
23,17668,3,3,0, 17671
30,17673,3,3,1, 17676
31,17676,2,2,0, 17678
28,17674,5,5,1, 17679
2,17683,2,2,1, 17685
1,17686,1,1,1, 17687
5,17687,3,5,1, 17692
8,17696,1,1,1, 17697
16,17699,2,2,0, 17701
15,17701,2,2,0, 17703
18,17703,4,4,1, 17707
20,17703,6,6,1, 17709
22,17706,4,4,1, 17710
24,17709,1,1,0, 17710
23,17708,3,3,0, 17711
31,17716,2,2,0, 17718
29,17718,4,4,1, 17722
1,17726,1,1,1, 17727
5,17727,3,5,1, 17732
8,17736,1,1,0, 17737
9,17737,2,2,1, 17739
16,17739,2,2,1, 17741
17,17739,3,3,1, 17742
15,17741,2,2,0, 17743
13,17739,4,6,1, 17745
12,17740,5,5,1, 17745
22,17746,4,4,0, 17750
24,17749,1,1,0, 17750
19,17746,5,5,1, 17751
23,17748,3,3,0, 17751
25,17755,2,2,1, 17757
31,17756,2,2,0, 17758
26,17757,3,3,1, 17760
29,17758,4,4,1, 17762
8,17776,1,1,0, 17777
16,17779,2,2,1, 17781
15,17781,2,2,1, 17783
22,17786,4,4,0, 17790
24,17789,1,1,1, 17790
23,17788,3,3,1, 17791
31,17796,2,2,1, 17798
28,17794,5,5,1, 17799
5,17807,3,5,1, 17812
6,17810,2,4,1, 17814
8,17816,1,1,1, 17817
16,17819,2,2,0, 17821
15,17821,2,2,1, 17823
22,17826,4,4,1, 17830
24,17829,1,1,1, 17830
23,17828,3,3,0, 17831
30,17833,3,3,1, 17836
31,17836,2,2,0, 17838
28,17834,5,5,1, 17839
8,17856,1,1,1, 17857
16,17859,2,2,0, 17861
15,17861,2,2,0, 17863
13,17859,4,6,1, 17865
18,17863,4,4,1, 17867
22,17866,4,4,0, 17870
24,17869,1,1,0, 17870
23,17868,3,3,0, 17871
31,17876,2,2,0, 17878
28,17874,5,5,1, 17879
26,17877,3,3,1, 17880
29,17878,4,4,1, 17882
1,17886,1,1,0, 17887
6,17890,2,4,1, 17894
8,17896,1,1,0, 17897
9,17897,2,2,1, 17899
16,17899,2,2,1, 17901
15,17901,2,2,0, 17903
18,17903,4,4,1, 17907
22,17906,4,4,0, 17910
24,17909,1,1,1, 17910
23,17908,3,3,0, 17911
31,17916,2,2,0, 17918
28,17914,5,5,1, 17919
1,17926,1,1,0, 17927
3,17927,3,3,1, 17930
8,17936,1,1,0, 17937
11,17934,4,4,1, 17938
16,17939,2,2,1, 17941
15,17941,2,2,1, 17943
13,17939,4,6,1, 17945
22,17946,4,4,1, 17950
24,17949,1,1,1, 17950
23,17948,3,3,1, 17951
30,17953,3,3,1, 17956
31,17956,2,2,0, 17958
28,17954,5,5,1, 17959
2,17963,2,2,1, 17965
1,17966,1,1,0, 17967
8,17976,1,1,1, 17977
11,17974,4,4,1, 17978
16,17979,2,2,0, 17981
15,17981,2,2,1, 17983
12,17980,5,5,1, 17985
22,17986,4,4,0, 17990
24,17989,1,1,1, 17990
19,17986,5,5,1, 17991
23,17988,3,3,0, 17991
30,17993,3,3,1, 17996
25,17995,2,2,1, 17997
31,17996,2,2,1, 17998
2,18003,2,2,1, 18005
1,18006,1,1,0, 18007
3,18007,3,3,1, 18010
8,18016,1,1,0, 18017
11,18014,4,4,1, 18018
16,18019,2,2,0, 18021
17,18019,3,3,1, 18022
15,18021,2,2,1, 18023
12,18020,5,5,1, 18025
22,18026,4,4,0, 18030
24,18029,1,1,0, 18030
23,18028,3,3,0, 18031
30,18033,3,3,1, 18036
31,18036,2,2,0, 18038
28,18034,5,5,1, 18039
29,18038,4,4,1, 18042
1,18046,1,1,0, 18047
3,18047,3,3,1, 18050
5,18047,3,5,1, 18052
6,18050,2,4,1, 18054
8,18056,1,1,1, 18057
9,18057,2,2,1, 18059
16,18059,2,2,0, 18061
15,18061,2,2,0, 18063
12,18060,5,5,1, 18065
22,18066,4,4,0, 18070
24,18069,1,1,0, 18070
19,18066,5,5,1, 18071
23,18068,3,3,1, 18071
30,18073,3,3,0, 18076
31,18076,2,2,0, 18078
26,18077,3,3,1, 18080
1,18086,1,1,1, 18087
5,18087,3,5,1, 18092
6,18090,2,4,1, 18094
8,18096,1,1,1, 18097
16,18099,2,2,0, 18101
15,18101,2,2,0, 18103
13,18099,4,6,1, 18105
22,18106,4,4,0, 18110
24,18109,1,1,1, 18110
19,18106,5,5,1, 18111
23,18108,3,3,0, 18111
30,18113,3,3,0, 18116
25,18115,2,2,1, 18117
31,18116,2,2,0, 18118
1,18126,1,1,1, 18127
3,18127,3,3,1, 18130
6,18130,2,4,1, 18134
8,18136,1,1,1, 18137
16,18139,2,2,0, 18141
17,18139,3,3,1, 18142
15,18141,2,2,1, 18143
12,18140,5,5,1, 18145
20,18143,6,6,1, 18149
22,18146,4,4,1, 18150
24,18149,1,1,1, 18150
23,18148,3,3,0, 18151
30,18153,3,3,0, 18156
25,18155,2,2,1, 18157
31,18156,2,2,1, 18158
28,18154,5,5,1, 18159
26,18157,3,3,1, 18160
1,18166,1,1,0, 18167
3,18167,3,3,1, 18170
6,18170,2,4,1, 18174
8,18176,1,1,0, 18177
9,18177,2,2,1, 18179
16,18179,2,2,1, 18181
17,18179,3,3,1, 18182
15,18181,2,2,1, 18183
13,18179,4,6,1, 18185
12,18180,5,5,1, 18185
18,18183,4,4,1, 18187
20,18183,6,6,1, 18189
22,18186,4,4,1, 18190
24,18189,1,1,0, 18190
23,18188,3,3,0, 18191
30,18193,3,3,0, 18196
31,18196,2,2,1, 18198
26,18197,3,3,1, 18200
29,18198,4,4,1, 18202
2,18203,2,2,1, 18205
1,18206,1,1,0, 18207
8,18216,1,1,0, 18217
9,18217,2,2,1, 18219
16,18219,2,2,0, 18221
15,18221,2,2,0, 18223
13,18219,4,6,1, 18225
12,18220,5,5,1, 18225
22,18226,4,4,1, 18230
24,18229,1,1,1, 18230
23,18228,3,3,0, 18231
30,18233,3,3,1, 18236
31,18236,2,2,0, 18238
26,18237,3,3,1, 18240
29,18238,4,4,1, 18242
2,18243,2,2,1, 18245
1,18246,1,1,1, 18247
3,18247,3,3,1, 18250
5,18247,3,5,1, 18252
8,18256,1,1,1, 18257
16,18259,2,2,0, 18261
15,18261,2,2,0, 18263
22,18266,4,4,0, 18270
24,18269,1,1,1, 18270
23,18268,3,3,1, 18271
30,18273,3,3,0, 18276
31,18276,2,2,1, 18278
29,18278,4,4,1, 18282
8,18296,1,1,1, 18297
16,18299,2,2,0, 18301
15,18301,2,2,0, 18303
22,18306,4,4,1, 18310
24,18309,1,1,0, 18310
23,18308,3,3,1, 18311
30,18313,3,3,0, 18316
31,18316,2,2,1, 18318
28,18314,5,5,1, 18319
5,18327,3,5,1, 18332
8,18336,1,1,1, 18337
16,18339,2,2,0, 18341
15,18341,2,2,1, 18343
22,18346,4,4,0, 18350
24,18349,1,1,1, 18350
23,18348,3,3,1, 18351
30,18353,3,3,1, 18356
31,18356,2,2,0, 18358
28,18354,5,5,1, 18359
1,18366,1,1,1, 18367
8,18376,1,1,1, 18377
11,18374,4,4,1, 18378
16,18379,2,2,1, 18381
17,18379,3,3,1, 18382
15,18381,2,2,1, 18383
13,18379,4,6,1, 18385
18,18383,4,4,1, 18387
22,18386,4,4,0, 18390
24,18389,1,1,1, 18390
19,18386,5,5,1, 18391
23,18388,3,3,0, 18391
30,18393,3,3,0, 18396
25,18395,2,2,1, 18397
31,18396,2,2,1, 18398
28,18394,5,5,1, 18399
29,18398,4,4,1, 18402
2,18403,2,2,1, 18405
1,18406,1,1,1, 18407
3,18407,3,3,1, 18410
5,18407,3,5,1, 18412
6,18410,2,4,1, 18414
8,18416,1,1,0, 18417
11,18414,4,4,1, 18418
16,18419,2,2,0, 18421
17,18419,3,3,1, 18422
15,18421,2,2,1, 18423
13,18419,4,6,1, 18425
18,18423,4,4,1, 18427
22,18426,4,4,1, 18430
24,18429,1,1,0, 18430
19,18426,5,5,1, 18431
23,18428,3,3,1, 18431
30,18433,3,3,0, 18436
31,18436,2,2,1, 18438
28,18434,5,5,1, 18439
26,18437,3,3,1, 18440
29,18438,4,4,0, 18442
1,18446,1,1,0, 18447
5,18447,3,5,1, 18452
6,18450,2,4,0, 18454
8,18456,1,1,1, 18457
11,18454,4,4,1, 18458
16,18459,2,2,0, 18461
15,18461,2,2,1, 18463
12,18460,5,5,1, 18465
22,18466,4,4,1, 18470
24,18469,1,1,0, 18470
23,18468,3,3,1, 18471
30,18473,3,3,1, 18476
25,18475,2,2,1, 18477
31,18476,2,2,1, 18478
28,18474,5,5,0, 18479
26,18477,3,3,1, 18480
29,18478,4,4,0, 18482
2,18483,2,2,1, 18485
1,18486,1,1,1, 18487
5,18487,3,5,1, 18492
6,18490,2,4,1, 18494
8,18496,1,1,0, 18497
11,18494,4,4,1, 18498
16,18499,2,2,1, 18501
15,18501,2,2,1, 18503
12,18500,5,5,1, 18505
22,18506,4,4,1, 18510
24,18509,1,1,0, 18510
23,18508,3,3,0, 18511
30,18513,3,3,1, 18516
31,18516,2,2,0, 18518
28,18514,5,5,1, 18519
29,18518,4,4,0, 18522
1,18526,1,1,0, 18527
3,18527,3,3,1, 18530
5,18527,3,5,1, 18532
6,18530,2,4,0, 18534
8,18536,1,1,0, 18537
16,18539,2,2,1, 18541
15,18541,2,2,1, 18543
20,18543,6,6,1, 18549
22,18546,4,4,0, 18550
24,18549,1,1,0, 18550
23,18548,3,3,0, 18551
30,18553,3,3,1, 18556
25,18555,2,2,1, 18557
31,18556,2,2,1, 18558
28,18554,5,5,1, 18559
26,18557,3,3,1, 18560
29,18558,4,4,1, 18562
2,18563,2,2,1, 18565
1,18566,1,1,0, 18567
5,18567,3,5,0, 18572
6,18570,2,4,0, 18574
8,18576,1,1,1, 18577
9,18577,2,2,1, 18579
16,18579,2,2,0, 18581
15,18581,2,2,1, 18583
13,18579,4,6,1, 18585
12,18580,5,5,1, 18585
18,18583,4,4,1, 18587
22,18586,4,4,0, 18590
24,18589,1,1,0, 18590
19,18586,5,5,1, 18591
23,18588,3,3,1, 18591
30,18593,3,3,0, 18596
31,18596,2,2,0, 18598
28,18594,5,5,0, 18599
26,18597,3,3,1, 18600
29,18598,4,4,0, 18602
2,18603,2,2,1, 18605
1,18606,1,1,0, 18607
5,18607,3,5,0, 18612
6,18610,2,4,1, 18614
8,18616,1,1,0, 18617
11,18614,4,4,1, 18618
16,18619,2,2,1, 18621
15,18621,2,2,0, 18623
13,18619,4,6,1, 18625
12,18620,5,5,1, 18625
18,18623,4,4,1, 18627
22,18626,4,4,1, 18630
24,18629,1,1,0, 18630
23,18628,3,3,0, 18631
30,18633,3,3,0, 18636
25,18635,2,2,1, 18637
31,18636,2,2,1, 18638
28,18634,5,5,1, 18639
29,18638,4,4,1, 18642
2,18643,2,2,1, 18645
1,18646,1,1,1, 18647
5,18647,3,5,0, 18652
6,18650,2,4,1, 18654
8,18656,1,1,1, 18657
11,18654,4,4,1, 18658
16,18659,2,2,0, 18661
17,18659,3,3,1, 18662
15,18661,2,2,1, 18663
22,18666,4,4,0, 18670
24,18669,1,1,1, 18670
23,18668,3,3,1, 18671
30,18673,3,3,1, 18676
31,18676,2,2,0, 18678
28,18674,5,5,0, 18679
29,18678,4,4,0, 18682
5,18687,3,5,1, 18692
6,18690,2,4,0, 18694
8,18696,1,1,0, 18697
16,18699,2,2,1, 18701
15,18701,2,2,1, 18703
22,18706,4,4,1, 18710
24,18709,1,1,1, 18710
23,18708,3,3,1, 18711
30,18713,3,3,0, 18716
31,18716,2,2,1, 18718
28,18714,5,5,1, 18719
29,18718,4,4,0, 18722
5,18727,3,5,0, 18732
6,18730,2,4,1, 18734
8,18736,1,1,1, 18737
16,18739,2,2,0, 18741
15,18741,2,2,1, 18743
22,18746,4,4,0, 18750
24,18749,1,1,0, 18750
23,18748,3,3,1, 18751
30,18753,3,3,0, 18756
31,18756,2,2,1, 18758
28,18754,5,5,1, 18759
29,18758,4,4,1, 18762
1,18766,1,1,0, 18767
3,18767,3,3,1, 18770
5,18767,3,5,1, 18772
6,18770,2,4,1, 18774
8,18776,1,1,1, 18777
16,18779,2,2,1, 18781
17,18779,3,3,1, 18782
15,18781,2,2,1, 18783
18,18783,4,4,1, 18787
22,18786,4,4,0, 18790
24,18789,1,1,1, 18790
19,18786,5,5,1, 18791
23,18788,3,3,0, 18791
30,18793,3,3,0, 18796
25,18795,2,2,1, 18797
31,18796,2,2,0, 18798
28,18794,5,5,0, 18799
26,18797,3,3,1, 18800
29,18798,4,4,1, 18802
1,18806,1,1,0, 18807
3,18807,3,3,1, 18810
5,18807,3,5,1, 18812
6,18810,2,4,1, 18814
8,18816,1,1,1, 18817
9,18817,2,2,1, 18819
16,18819,2,2,1, 18821
17,18819,3,3,1, 18822
15,18821,2,2,1, 18823
18,18823,4,4,1, 18827
20,18823,6,6,1, 18829
22,18826,4,4,1, 18830
24,18829,1,1,1, 18830
19,18826,5,5,1, 18831
23,18828,3,3,1, 18831
31,18836,2,2,1, 18838
29,18838,4,4,1, 18842
2,18843,2,2,1, 18845
1,18846,1,1,0, 18847
3,18847,3,3,1, 18850
5,18847,3,5,1, 18852
8,18856,1,1,0, 18857
9,18857,2,2,1, 18859
16,18859,2,2,1, 18861
17,18859,3,3,1, 18862
15,18861,2,2,0, 18863
22,18866,4,4,0, 18870
24,18869,1,1,0, 18870
19,18866,5,5,1, 18871
23,18868,3,3,1, 18871
25,18875,2,2,1, 18877
26,18877,3,3,1, 18880
2,18883,2,2,1, 18885
1,18886,1,1,0, 18887
5,18887,3,5,1, 18892
6,18890,2,4,1, 18894
8,18896,1,1,0, 18897
11,18894,4,4,1, 18898
9,18897,2,2,1, 18899
16,18899,2,2,0, 18901
17,18899,3,3,1, 18902
15,18901,2,2,0, 18903
13,18899,4,6,1, 18905
18,18903,4,4,1, 18907
22,18906,4,4,1, 18910
24,18909,1,1,1, 18910
23,18908,3,3,1, 18911
30,18913,3,3,1, 18916
31,18916,2,2,1, 18918
1,18926,1,1,1, 18927
3,18927,3,3,1, 18930
8,18936,1,1,0, 18937
11,18934,4,4,1, 18938
9,18937,2,2,1, 18939
16,18939,2,2,0, 18941
15,18941,2,2,1, 18943
13,18939,4,6,1, 18945
18,18943,4,4,1, 18947
22,18946,4,4,1, 18950
24,18949,1,1,1, 18950
23,18948,3,3,0, 18951
28,18954,5,5,1, 18959
5,18967,3,5,1, 18972
8,18976,1,1,0, 18977
16,18979,2,2,1, 18981
15,18981,2,2,0, 18983
22,18986,4,4,0, 18990
24,18989,1,1,0, 18990
23,18988,3,3,0, 18991
31,18996,2,2,1, 18998
5,19007,3,5,1, 19012
6,19010,2,4,1, 19014
8,19016,1,1,1, 19017
16,19019,2,2,0, 19021
15,19021,2,2,0, 19023
22,19026,4,4,0, 19030
24,19029,1,1,0, 19030
23,19028,3,3,1, 19031
31,19036,2,2,1, 19038
28,19034,5,5,1, 19039
29,19038,4,4,1, 19042
5,19047,3,5,1, 19052
6,19050,2,4,1, 19054
8,19056,1,1,0, 19057
9,19057,2,2,1, 19059
16,19059,2,2,0, 19061
17,19059,3,3,1, 19062
15,19061,2,2,1, 19063
13,19059,4,6,1, 19065
18,19063,4,4,1, 19067
20,19063,6,6,1, 19069
22,19066,4,4,0, 19070
24,19069,1,1,1, 19070
19,19066,5,5,1, 19071
23,19068,3,3,1, 19071
30,19073,3,3,1, 19076
31,19076,2,2,1, 19078
26,19077,3,3,1, 19080
2,19083,2,2,1, 19085
1,19086,1,1,0, 19087
6,19090,2,4,1, 19094
8,19096,1,1,1, 19097
11,19094,4,4,1, 19098
9,19097,2,2,1, 19099
16,19099,2,2,0, 19101
15,19101,2,2,1, 19103
13,19099,4,6,1, 19105
12,19100,5,5,1, 19105
22,19106,4,4,0, 19110
24,19109,1,1,0, 19110
23,19108,3,3,0, 19111
30,19113,3,3,1, 19116
25,19115,2,2,1, 19117
31,19116,2,2,1, 19118
28,19114,5,5,1, 19119
1,19126,1,1,0, 19127
5,19127,3,5,1, 19132
6,19130,2,4,1, 19134
8,19136,1,1,0, 19137
16,19139,2,2,0, 19141
17,19139,3,3,1, 19142
15,19141,2,2,0, 19143
22,19146,4,4,0, 19150
24,19149,1,1,0, 19150
23,19148,3,3,0, 19151
25,19155,2,2,1, 19157
31,19156,2,2,1, 19158
29,19158,4,4,1, 19162
1,19166,1,1,1, 19167
5,19167,3,5,1, 19172
8,19176,1,1,1, 19177
16,19179,2,2,0, 19181
17,19179,3,3,1, 19182
15,19181,2,2,1, 19183
22,19186,4,4,0, 19190
24,19189,1,1,0, 19190
23,19188,3,3,0, 19191
1,19206,1,1,1, 19207
6,19210,2,4,1, 19214
8,19216,1,1,1, 19217
11,19214,4,4,1, 19218
9,19217,2,2,1, 19219
16,19219,2,2,0, 19221
17,19219,3,3,1, 19222
15,19221,2,2,0, 19223
18,19223,4,4,1, 19227
20,19223,6,6,1, 19229
22,19226,4,4,1, 19230
24,19229,1,1,1, 19230
23,19228,3,3,0, 19231
30,19233,3,3,1, 19236
25,19235,2,2,1, 19237
29,19238,4,4,1, 19242
1,19246,1,1,0, 19247
8,19256,1,1,1, 19257
11,19254,4,4,1, 19258
16,19259,2,2,0, 19261
15,19261,2,2,1, 19263
20,19263,6,6,1, 19269
22,19266,4,4,1, 19270
24,19269,1,1,0, 19270
19,19266,5,5,1, 19271
23,19268,3,3,1, 19271
25,19275,2,2,1, 19277
31,19276,2,2,1, 19278
29,19278,4,4,1, 19282
2,19283,2,2,1, 19285
1,19286,1,1,0, 19287
3,19287,3,3,1, 19290
5,19287,3,5,1, 19292
6,19290,2,4,1, 19294
8,19296,1,1,1, 19297
9,19297,2,2,1, 19299
16,19299,2,2,0, 19301
17,19299,3,3,1, 19302
15,19301,2,2,1, 19303
12,19300,5,5,1, 19305
20,19303,6,6,1, 19309
22,19306,4,4,0, 19310
24,19309,1,1,0, 19310
23,19308,3,3,1, 19311
30,19313,3,3,1, 19316
26,19317,3,3,1, 19320
29,19318,4,4,1, 19322
2,19323,2,2,1, 19325
1,19326,1,1,1, 19327
3,19327,3,3,1, 19330
6,19330,2,4,1, 19334
8,19336,1,1,0, 19337
11,19334,4,4,1, 19338
9,19337,2,2,1, 19339
16,19339,2,2,0, 19341
15,19341,2,2,0, 19343
13,19339,4,6,1, 19345
18,19343,4,4,1, 19347
22,19346,4,4,0, 19350
24,19349,1,1,1, 19350
23,19348,3,3,0, 19351
28,19354,5,5,1, 19359
2,19363,2,2,1, 19365
1,19366,1,1,0, 19367
5,19367,3,5,1, 19372
6,19370,2,4,1, 19374
8,19376,1,1,1, 19377
16,19379,2,2,0, 19381
17,19379,3,3,1, 19382
15,19381,2,2,1, 19383
20,19383,6,6,1, 19389
22,19386,4,4,0, 19390
24,19389,1,1,0, 19390
19,19386,5,5,1, 19391
23,19388,3,3,1, 19391
30,19393,3,3,1, 19396
25,19395,2,2,1, 19397
26,19397,3,3,1, 19400
2,19403,2,2,1, 19405
1,19406,1,1,0, 19407
5,19407,3,5,1, 19412
8,19416,1,1,1, 19417
9,19417,2,2,1, 19419
16,19419,2,2,1, 19421
15,19421,2,2,1, 19423
13,19419,4,6,1, 19425
18,19423,4,4,1, 19427
22,19426,4,4,0, 19430
24,19429,1,1,1, 19430
23,19428,3,3,0, 19431
31,19436,2,2,1, 19438
29,19438,4,4,1, 19442
5,19447,3,5,1, 19452
6,19450,2,4,1, 19454
8,19456,1,1,0, 19457
16,19459,2,2,1, 19461
15,19461,2,2,0, 19463
22,19466,4,4,0, 19470
24,19469,1,1,0, 19470
23,19468,3,3,1, 19471
28,19474,5,5,1, 19479
29,19478,4,4,1, 19482
8,19496,1,1,1, 19497
16,19499,2,2,1, 19501
15,19501,2,2,1, 19503
24,19509,1,1,0, 19510
23,19508,3,3,1, 19511
31,19516,2,2,1, 19518
28,19514,5,5,1, 19519
5,19527,3,5,1, 19532
8,19536,1,1,1, 19537
9,19537,2,2,1, 19539
16,19539,2,2,1, 19541
15,19541,2,2,1, 19543
13,19539,4,6,1, 19545
12,19540,5,5,1, 19545
20,19543,6,6,1, 19549
22,19546,4,4,1, 19550
24,19549,1,1,1, 19550
23,19548,3,3,1, 19551
31,19556,2,2,1, 19558
28,19554,5,5,1, 19559
29,19558,4,4,1, 19562
2,19563,2,2,1, 19565
1,19566,1,1,1, 19567
5,19567,3,5,1, 19572
6,19570,2,4,1, 19574
8,19576,1,1,1, 19577
11,19574,4,4,1, 19578
17,19579,3,3,1, 19582
13,19579,4,6,1, 19585
22,19586,4,4,1, 19590
24,19589,1,1,0, 19590
25,19595,2,2,1, 19597
29,19598,4,4,1, 19602
2,19603,2,2,1, 19605
1,19606,1,1,0, 19607
6,19610,2,4,1, 19614
8,19616,1,1,0, 19617
15,19621,2,2,1, 19623
20,19623,6,6,1, 19629
22,19626,4,4,1, 19630
24,19629,1,1,1, 19630
19,19626,5,5,1, 19631
23,19628,3,3,1, 19631
25,19635,2,2,1, 19637
31,19636,2,2,1, 19638
28,19634,5,5,1, 19639
29,19638,4,4,1, 19642
2,19643,2,2,1, 19645
1,19646,1,1,0, 19647
5,19647,3,5,1, 19652
6,19650,2,4,1, 19654
8,19656,1,1,0, 19657
11,19654,4,4,1, 19658
17,19659,3,3,1, 19662
22,19666,4,4,1, 19670
24,19669,1,1,0, 19670
30,19673,3,3,1, 19676
25,19675,2,2,1, 19677
31,19676,2,2,1, 19678
28,19674,5,5,1, 19679
26,19677,3,3,1, 19680
29,19678,4,4,1, 19682
2,19683,2,2,1, 19685
1,19686,1,1,0, 19687
6,19690,2,4,1, 19694
8,19696,1,1,0, 19697
13,19699,4,6,1, 19705
18,19703,4,4,1, 19707
22,19706,4,4,1, 19710
24,19709,1,1,0, 19710
25,19715,2,2,1, 19717
1,19726,1,1,0, 19727
8,19736,1,1,1, 19737
9,19737,2,2,1, 19739
17,19739,3,3,1, 19742
15,19741,2,2,1, 19743
24,19749,1,1,0, 19750
19,19746,5,5,1, 19751
23,19748,3,3,1, 19751
30,19753,3,3,1, 19756
31,19756,2,2,1, 19758
28,19754,5,5,1, 19759
26,19757,3,3,1, 19760
29,19758,4,4,1, 19762
1,19766,1,1,0, 19767
3,19767,3,3,1, 19770
5,19767,3,5,1, 19772
8,19776,1,1,0, 19777
11,19774,4,4,1, 19778
9,19777,2,2,1, 19779
16,19779,2,2,1, 19781
17,19779,3,3,1, 19782
15,19781,2,2,1, 19783
13,19779,4,6,1, 19785
18,19783,4,4,1, 19787
24,19789,1,1,1, 19790
23,19788,3,3,1, 19791
31,19796,2,2,1, 19798
28,19794,5,5,1, 19799
26,19797,3,3,1, 19800
29,19798,4,4,1, 19802
1,19806,1,1,1, 19807
3,19807,3,3,1, 19810
5,19807,3,5,1, 19812
6,19810,2,4,1, 19814
8,19816,1,1,0, 19817
9,19817,2,2,1, 19819
16,19819,2,2,1, 19821
17,19819,3,3,1, 19822
15,19821,2,2,1, 19823
12,19820,5,5,1, 19825
18,19823,4,4,1, 19827
20,19823,6,6,1, 19829
22,19826,4,4,1, 19830
24,19829,1,1,0, 19830
19,19826,5,5,1, 19831
31,19836,2,2,1, 19838
28,19834,5,5,1, 19839
2,19843,2,2,1, 19845
1,19846,1,1,0, 19847
5,19847,3,5,1, 19852
6,19850,2,4,1, 19854
8,19856,1,1,1, 19857
16,19859,2,2,1, 19861
17,19859,3,3,1, 19862
22,19866,4,4,1, 19870
24,19869,1,1,1, 19870
23,19868,3,3,1, 19871
30,19873,3,3,1, 19876
31,19876,2,2,1, 19878
8,19896,1,1,0, 19897
15,19901,2,2,1, 19903
24,19909,1,1,0, 19910
23,19908,3,3,1, 19911
29,19918,4,4,1, 19922
5,19927,3,5,1, 19932
8,19936,1,1,1, 19937
16,19939,2,2,1, 19941
22,19946,4,4,1, 19950
24,19949,1,1,0, 19950
23,19948,3,3,1, 19951
28,19954,5,5,1, 19959
1,19966,1,1,1, 19967
3,19967,3,3,1, 19970
8,19976,1,1,1, 19977
11,19974,4,4,1, 19978
9,19977,2,2,1, 19979
16,19979,2,2,1, 19981
17,19979,3,3,1, 19982
15,19981,2,2,1, 19983
13,19979,4,6,1, 19985
22,19986,4,4,1, 19990
24,19989,1,1,0, 19990
19,19986,5,5,1, 19991
23,19988,3,3,1, 19991
28,19994,5,5,1, 19999
29,19998,4,4,1, 20002
1,20006,1,1,0, 20007
5,20007,3,5,1, 20012
8,20016,1,1,0, 20017
11,20014,4,4,1, 20018
9,20017,2,2,1, 20019
16,20019,2,2,1, 20021
18,20023,4,4,1, 20027
20,20023,6,6,1, 20029
24,20029,1,1,0, 20030
19,20026,5,5,1, 20031
30,20033,3,3,1, 20036
31,20036,2,2,1, 20038
2,20043,2,2,1, 20045
1,20046,1,1,0, 20047
3,20047,3,3,1, 20050
5,20047,3,5,1, 20052
8,20056,1,1,0, 20057
11,20054,4,4,1, 20058
9,20057,2,2,1, 20059
16,20059,2,2,1, 20061
17,20059,3,3,1, 20062
13,20059,4,6,1, 20065
18,20063,4,4,1, 20067
20,20063,6,6,1, 20069
24,20069,1,1,1, 20070
19,20066,5,5,1, 20071
31,20076,2,2,1, 20078
28,20074,5,5,1, 20079
29,20078,4,4,1, 20082
2,20083,2,2,1, 20085
1,20086,1,1,0, 20087
5,20087,3,5,1, 20092
6,20090,2,4,1, 20094
8,20096,1,1,0, 20097
11,20094,4,4,1, 20098
16,20099,2,2,1, 20101
17,20099,3,3,1, 20102
13,20099,4,6,1, 20105
12,20100,5,5,1, 20105
24,20109,1,1,0, 20110
23,20108,3,3,1, 20111
28,20114,5,5,1, 20119
6,20130,2,4,1, 20134
8,20136,1,1,0, 20137
16,20139,2,2,1, 20141
15,20141,2,2,1, 20143
24,20149,1,1,1, 20150
23,20148,3,3,1, 20151
31,20156,2,2,1, 20158
28,20154,5,5,1, 20159
29,20158,4,4,1, 20162
5,20167,3,5,1, 20172
8,20176,1,1,1, 20177
16,20179,2,2,1, 20181
22,20186,4,4,1, 20190
24,20189,1,1,1, 20190
30,20193,3,3,1, 20196
31,20196,2,2,1, 20198
29,20198,4,4,1, 20202
5,20207,3,5,1, 20212
8,20216,1,1,1, 20217
11,20214,4,4,1, 20218
9,20217,2,2,1, 20219
16,20219,2,2,1, 20221
17,20219,3,3,1, 20222
15,20221,2,2,1, 20223
12,20220,5,5,1, 20225
18,20223,4,4,1, 20227
20,20223,6,6,1, 20229
22,20226,4,4,1, 20230
24,20229,1,1,1, 20230
19,20226,5,5,1, 20231
31,20236,2,2,1, 20238
26,20237,3,3,1, 20240
29,20238,4,4,1, 20242
2,20243,2,2,1, 20245
1,20246,1,1,1, 20247
3,20247,3,3,1, 20250
8,20256,1,1,1, 20257
16,20259,2,2,1, 20261
17,20259,3,3,1, 20262
20,20263,6,6,1, 20269
24,20269,1,1,1, 20270
23,20268,3,3,1, 20271
30,20273,3,3,1, 20276
31,20276,2,2,1, 20278
29,20278,4,4,1, 20282
2,20283,2,2,1, 20285
1,20286,1,1,0, 20287
3,20287,3,3,1, 20290
6,20290,2,4,1, 20294
8,20296,1,1,0, 20297
11,20294,4,4,1, 20298
16,20299,2,2,1, 20301
17,20299,3,3,1, 20302
15,20301,2,2,1, 20303
22,20306,4,4,1, 20310
24,20309,1,1,0, 20310
19,20306,5,5,1, 20311
23,20308,3,3,1, 20311
25,20315,2,2,1, 20317
26,20317,3,3,1, 20320
29,20318,4,4,1, 20322
2,20323,2,2,1, 20325
1,20326,1,1,1, 20327
5,20327,3,5,1, 20332
6,20330,2,4,1, 20334
8,20336,1,1,0, 20337
13,20339,4,6,1, 20345
12,20340,5,5,1, 20345
24,20349,1,1,1, 20350
19,20346,5,5,1, 20351
23,20348,3,3,1, 20351
30,20353,3,3,1, 20356
25,20355,2,2,1, 20357
26,20357,3,3,1, 20360
29,20358,4,4,1, 20362
1,20366,1,1,1, 20367
3,20367,3,3,1, 20370
5,20367,3,5,1, 20372
6,20370,2,4,1, 20374
8,20376,1,1,0, 20377
16,20379,2,2,1, 20381
17,20379,3,3,1, 20382
15,20381,2,2,1, 20383
13,20379,4,6,1, 20385
22,20386,4,4,1, 20390
24,20389,1,1,0, 20390
2,20403,2,2,1, 20405
1,20406,1,1,0, 20407
5,20407,3,5,1, 20412
6,20410,2,4,1, 20414
8,20416,1,1,1, 20417
9,20417,2,2,1, 20419
16,20419,2,2,1, 20421
17,20419,3,3,1, 20422
12,20420,5,5,1, 20425
18,20423,4,4,1, 20427
22,20426,4,4,1, 20430
24,20429,1,1,1, 20430
31,20436,2,2,1, 20438
5,20447,3,5,1, 20452
6,20450,2,4,1, 20454
8,20456,1,1,1, 20457
16,20459,2,2,1, 20461
15,20461,2,2,1, 20463
22,20466,4,4,0, 20470
24,20469,1,1,1, 20470
23,20468,3,3,0, 20471
30,20473,3,3,1, 20476
31,20476,2,2,1, 20478
28,20474,5,5,1, 20479
5,20487,3,5,1, 20492
8,20496,1,1,0, 20497
16,20499,2,2,1, 20501
15,20501,2,2,0, 20503
22,20506,4,4,1, 20510
24,20509,1,1,0, 20510
23,20508,3,3,1, 20511
30,20513,3,3,1, 20516
29,20518,4,4,1, 20522
5,20527,3,5,1, 20532
8,20536,1,1,0, 20537
9,20537,2,2,1, 20539
16,20539,2,2,0, 20541
15,20541,2,2,0, 20543
13,20539,4,6,1, 20545
12,20540,5,5,1, 20545
20,20543,6,6,1, 20549
22,20546,4,4,0, 20550
24,20549,1,1,0, 20550
23,20548,3,3,0, 20551
31,20556,2,2,1, 20558
26,20557,3,3,1, 20560
1,20566,1,1,1, 20567
3,20567,3,3,1, 20570
8,20576,1,1,0, 20577
9,20577,2,2,1, 20579
16,20579,2,2,1, 20581
17,20579,3,3,1, 20582
15,20581,2,2,0, 20583
12,20580,5,5,1, 20585
22,20586,4,4,1, 20590
24,20589,1,1,0, 20590
19,20586,5,5,1, 20591
23,20588,3,3,0, 20591
30,20593,3,3,1, 20596
31,20596,2,2,1, 20598
28,20594,5,5,1, 20599
2,20603,2,2,1, 20605
1,20606,1,1,1, 20607
5,20607,3,5,1, 20612
6,20610,2,4,1, 20614
8,20616,1,1,0, 20617
11,20614,4,4,1, 20618
16,20619,2,2,1, 20621
17,20619,3,3,1, 20622
15,20621,2,2,1, 20623
13,20619,4,6,1, 20625
12,20620,5,5,1, 20625
18,20623,4,4,1, 20627
22,20626,4,4,1, 20630
24,20629,1,1,1, 20630
19,20626,5,5,1, 20631
23,20628,3,3,1, 20631
30,20633,3,3,1, 20636
31,20636,2,2,1, 20638
28,20634,5,5,1, 20639
1,20646,1,1,0, 20647
6,20650,2,4,1, 20654
8,20656,1,1,0, 20657
9,20657,2,2,1, 20659
16,20659,2,2,1, 20661
17,20659,3,3,1, 20662
15,20661,2,2,1, 20663
22,20666,4,4,0, 20670
24,20669,1,1,1, 20670
23,20668,3,3,0, 20671
30,20673,3,3,1, 20676
25,20675,2,2,1, 20677
28,20674,5,5,1, 20679
29,20678,4,4,1, 20682
1,20686,1,1,0, 20687
5,20687,3,5,1, 20692
6,20690,2,4,1, 20694
8,20696,1,1,1, 20697
16,20699,2,2,0, 20701
17,20699,3,3,1, 20702
15,20701,2,2,1, 20703
22,20706,4,4,1, 20710
24,20709,1,1,1, 20710
23,20708,3,3,1, 20711
28,20714,5,5,1, 20719
1,20726,1,1,1, 20727
6,20730,2,4,1, 20734
8,20736,1,1,0, 20737
16,20739,2,2,0, 20741
17,20739,3,3,1, 20742
15,20741,2,2,1, 20743
12,20740,5,5,1, 20745
22,20746,4,4,0, 20750
24,20749,1,1,1, 20750
23,20748,3,3,1, 20751
30,20753,3,3,1, 20756
25,20755,2,2,1, 20757
31,20756,2,2,1, 20758
26,20757,3,3,1, 20760
29,20758,4,4,1, 20762
1,20766,1,1,1, 20767
3,20767,3,3,1, 20770
8,20776,1,1,1, 20777
9,20777,2,2,1, 20779
16,20779,2,2,1, 20781
17,20779,3,3,1, 20782
15,20781,2,2,1, 20783
13,20779,4,6,1, 20785
20,20783,6,6,1, 20789
22,20786,4,4,0, 20790
24,20789,1,1,1, 20790
19,20786,5,5,1, 20791
23,20788,3,3,0, 20791
31,20796,2,2,1, 20798
29,20798,4,4,1, 20802
2,20803,2,2,1, 20805
1,20806,1,1,0, 20807
3,20807,3,3,1, 20810
5,20807,3,5,1, 20812
6,20810,2,4,1, 20814
8,20816,1,1,1, 20817
11,20814,4,4,1, 20818
9,20817,2,2,1, 20819
16,20819,2,2,1, 20821
17,20819,3,3,1, 20822
15,20821,2,2,1, 20823
12,20820,5,5,1, 20825
20,20823,6,6,1, 20829
22,20826,4,4,1, 20830
24,20829,1,1,1, 20830
23,20828,3,3,0, 20831
30,20833,3,3,1, 20836
25,20835,2,2,1, 20837
28,20834,5,5,1, 20839
29,20838,4,4,1, 20842
2,20843,2,2,1, 20845
1,20846,1,1,0, 20847
3,20847,3,3,1, 20850
5,20847,3,5,1, 20852
8,20856,1,1,0, 20857
9,20857,2,2,1, 20859
16,20859,2,2,0, 20861
15,20861,2,2,0, 20863
13,20859,4,6,1, 20865
22,20866,4,4,1, 20870
24,20869,1,1,0, 20870
23,20868,3,3,0, 20871
31,20876,2,2,1, 20878
1,20886,1,1,1, 20887
6,20890,2,4,1, 20894
8,20896,1,1,0, 20897
16,20899,2,2,0, 20901
17,20899,3,3,1, 20902
15,20901,2,2,1, 20903
18,20903,4,4,1, 20907
22,20906,4,4,1, 20910
24,20909,1,1,0, 20910
23,20908,3,3,1, 20911
30,20913,3,3,1, 20916
25,20915,2,2,1, 20917
29,20918,4,4,1, 20922
2,20923,2,2,1, 20925
1,20926,1,1,1, 20927
3,20927,3,3,1, 20930
5,20927,3,5,1, 20932
8,20936,1,1,0, 20937
11,20934,4,4,1, 20938
9,20937,2,2,1, 20939
16,20939,2,2,0, 20941
15,20941,2,2,0, 20943
13,20939,4,6,1, 20945
18,20943,4,4,1, 20947
22,20946,4,4,1, 20950
24,20949,1,1,0, 20950
23,20948,3,3,0, 20951
30,20953,3,3,1, 20956
31,20956,2,2,1, 20958
29,20958,4,4,1, 20962
5,20967,3,5,1, 20972
8,20976,1,1,0, 20977
16,20979,2,2,0, 20981
15,20981,2,2,0, 20983
22,20986,4,4,1, 20990
24,20989,1,1,0, 20990
23,20988,3,3,0, 20991
30,20993,3,3,1, 20996
28,20994,5,5,1, 20999
8,21016,1,1,1, 21017
16,21019,2,2,1, 21021
15,21021,2,2,1, 21023
22,21026,4,4,1, 21030
24,21029,1,1,1, 21030
23,21028,3,3,1, 21031
29,21038,4,4,1, 21042
5,21047,3,5,1, 21052
6,21050,2,4,1, 21054
8,21056,1,1,0, 21057
11,21054,4,4,1, 21058
9,21057,2,2,1, 21059
16,21059,2,2,1, 21061
15,21061,2,2,1, 21063
13,21059,4,6,1, 21065
22,21066,4,4,0, 21070
24,21069,1,1,1, 21070
23,21068,3,3,1, 21071
30,21073,3,3,1, 21076
28,21074,5,5,1, 21079
29,21078,4,4,1, 21082
2,21083,2,2,1, 21085
1,21086,1,1,0, 21087
5,21087,3,5,1, 21092
8,21096,1,1,0, 21097
9,21097,2,2,1, 21099
16,21099,2,2,1, 21101
17,21099,3,3,1, 21102
15,21101,2,2,0, 21103
20,21103,6,6,1, 21109
22,21106,4,4,1, 21110
24,21109,1,1,0, 21110
19,21106,5,5,1, 21111
23,21108,3,3,0, 21111
30,21113,3,3,1, 21116
28,21114,5,5,1, 21119
26,21117,3,3,1, 21120
29,21118,4,4,1, 21122
1,21126,1,1,0, 21127
3,21127,3,3,1, 21130
5,21127,3,5,1, 21132
8,21136,1,1,1, 21137
11,21134,4,4,1, 21138
16,21139,2,2,1, 21141
15,21141,2,2,1, 21143
12,21140,5,5,1, 21145
18,21143,4,4,1, 21147
22,21146,4,4,0, 21150
24,21149,1,1,0, 21150
19,21146,5,5,1, 21151
23,21148,3,3,1, 21151
30,21153,3,3,1, 21156
31,21156,2,2,1, 21158
28,21154,5,5,1, 21159
29,21158,4,4,1, 21162
2,21163,2,2,1, 21165
1,21166,1,1,1, 21167
5,21167,3,5,1, 21172
8,21176,1,1,1, 21177
9,21177,2,2,1, 21179
16,21179,2,2,0, 21181
15,21181,2,2,0, 21183
13,21179,4,6,1, 21185
18,21183,4,4,1, 21187
22,21186,4,4,0, 21190
24,21189,1,1,1, 21190
23,21188,3,3,0, 21191
30,21193,3,3,1, 21196
25,21195,2,2,1, 21197
31,21196,2,2,1, 21198
28,21194,5,5,1, 21199
29,21198,4,4,1, 21202
1,21206,1,1,0, 21207
8,21216,1,1,0, 21217
16,21219,2,2,0, 21221
15,21221,2,2,1, 21223
12,21220,5,5,1, 21225
18,21223,4,4,1, 21227
20,21223,6,6,1, 21229
22,21226,4,4,0, 21230
24,21229,1,1,0, 21230
19,21226,5,5,1, 21231
23,21228,3,3,1, 21231
25,21235,2,2,1, 21237
31,21236,2,2,1, 21238
2,21243,2,2,1, 21245
1,21246,1,1,1, 21247
3,21247,3,3,1, 21250
8,21256,1,1,1, 21257
16,21259,2,2,1, 21261
15,21261,2,2,0, 21263
13,21259,4,6,1, 21265
18,21263,4,4,1, 21267
20,21263,6,6,1, 21269
22,21266,4,4,0, 21270
24,21269,1,1,1, 21270
19,21266,5,5,1, 21271
23,21268,3,3,1, 21271
26,21277,3,3,1, 21280
1,21286,1,1,0, 21287
3,21287,3,3,1, 21290
8,21296,1,1,1, 21297
16,21299,2,2,0, 21301
17,21299,3,3,1, 21302
15,21301,2,2,0, 21303
12,21300,5,5,1, 21305
22,21306,4,4,0, 21310
24,21309,1,1,1, 21310
23,21308,3,3,1, 21311
30,21313,3,3,1, 21316
31,21316,2,2,1, 21318
28,21314,5,5,1, 21319
8,21336,1,1,0, 21337
16,21339,2,2,1, 21341
15,21341,2,2,0, 21343
22,21346,4,4,1, 21350
24,21349,1,1,1, 21350
23,21348,3,3,1, 21351
30,21353,3,3,1, 21356
28,21354,5,5,1, 21359
29,21358,4,4,1, 21362
8,21376,1,1,0, 21377
16,21379,2,2,0, 21381
15,21381,2,2,1, 21383
22,21386,4,4,0, 21390
24,21389,1,1,1, 21390
23,21388,3,3,0, 21391
30,21393,3,3,1, 21396
3,21407,3,3,1, 21410
8,21416,1,1,0, 21417
16,21419,2,2,0, 21421
15,21421,2,2,0, 21423
12,21420,5,5,1, 21425
18,21423,4,4,1, 21427
20,21423,6,6,1, 21429
22,21426,4,4,0, 21430
24,21429,1,1,0, 21430
19,21426,5,5,1, 21431
23,21428,3,3,0, 21431
30,21433,3,3,1, 21436
25,21435,2,2,1, 21437
26,21437,3,3,1, 21440
29,21438,4,4,1, 21442
1,21446,1,1,0, 21447
3,21447,3,3,1, 21450
8,21456,1,1,0, 21457
11,21454,4,4,1, 21458
16,21459,2,2,1, 21461
15,21461,2,2,1, 21463
22,21466,4,4,1, 21470
24,21469,1,1,0, 21470
23,21468,3,3,1, 21471
30,21473,3,3,1, 21476
31,21476,2,2,1, 21478
26,21477,3,3,1, 21480
1,21486,1,1,0, 21487
3,21487,3,3,1, 21490
8,21496,1,1,1, 21497
9,21497,2,2,1, 21499
16,21499,2,2,1, 21501
15,21501,2,2,0, 21503
22,21506,4,4,0, 21510
24,21509,1,1,0, 21510
23,21508,3,3,0, 21511
30,21513,3,3,1, 21516
25,21515,2,2,1, 21517
31,21516,2,2,1, 21518
28,21514,5,5,1, 21519
1,21526,1,1,0, 21527
5,21527,3,5,1, 21532
8,21536,1,1,1, 21537
16,21539,2,2,0, 21541
15,21541,2,2,0, 21543
22,21546,4,4,1, 21550
24,21549,1,1,0, 21550
23,21548,3,3,1, 21551
28,21554,5,5,1, 21559
1,21566,1,1,1, 21567
8,21576,1,1,0, 21577
16,21579,2,2,0, 21581
17,21579,3,3,1, 21582
15,21581,2,2,0, 21583
22,21586,4,4,1, 21590
24,21589,1,1,1, 21590
23,21588,3,3,1, 21591
30,21593,3,3,1, 21596
1,21606,1,1,1, 21607
8,21616,1,1,1, 21617
9,21617,2,2,1, 21619
16,21619,2,2,1, 21621
17,21619,3,3,1, 21622
15,21621,2,2,1, 21623
18,21623,4,4,1, 21627
20,21623,6,6,1, 21629
22,21626,4,4,1, 21630
24,21629,1,1,0, 21630
19,21626,5,5,1, 21631
23,21628,3,3,0, 21631
30,21633,3,3,1, 21636
2,21643,2,2,1, 21645
1,21646,1,1,1, 21647
5,21647,3,5,1, 21652
6,21650,2,4,0, 21654
8,21656,1,1,0, 21657
11,21654,4,4,1, 21658
16,21659,2,2,1, 21661
17,21659,3,3,1, 21662
15,21661,2,2,0, 21663
20,21663,6,6,1, 21669
22,21666,4,4,1, 21670
24,21669,1,1,0, 21670
23,21668,3,3,1, 21671
30,21673,3,3,0, 21676
25,21675,2,2,1, 21677
31,21676,2,2,1, 21678
28,21674,5,5,0, 21679
26,21677,3,3,1, 21680
29,21678,4,4,0, 21682
2,21683,2,2,1, 21685
1,21686,1,1,0, 21687
5,21687,3,5,1, 21692
6,21690,2,4,0, 21694
8,21696,1,1,0, 21697
11,21694,4,4,1, 21698
9,21697,2,2,1, 21699
16,21699,2,2,1, 21701
15,21701,2,2,0, 21703
12,21700,5,5,1, 21705
18,21703,4,4,1, 21707
20,21703,6,6,1, 21709
22,21706,4,4,1, 21710
24,21709,1,1,1, 21710
19,21706,5,5,1, 21711
23,21708,3,3,0, 21711
30,21713,3,3,1, 21716
31,21716,2,2,0, 21718
28,21714,5,5,1, 21719
29,21718,4,4,0, 21722
2,21723,2,2,1, 21725
1,21726,1,1,0, 21727
3,21727,3,3,1, 21730
5,21727,3,5,0, 21732
6,21730,2,4,1, 21734
8,21736,1,1,0, 21737
11,21734,4,4,1, 21738
9,21737,2,2,1, 21739
16,21739,2,2,0, 21741
15,21741,2,2,1, 21743
18,21743,4,4,1, 21747
20,21743,6,6,1, 21749
22,21746,4,4,0, 21750
24,21749,1,1,1, 21750
23,21748,3,3,1, 21751
30,21753,3,3,1, 21756
31,21756,2,2,0, 21758
28,21754,5,5,0, 21759
29,21758,4,4,1, 21762
2,21763,2,2,1, 21765
1,21766,1,1,0, 21767
5,21767,3,5,0, 21772
6,21770,2,4,0, 21774
8,21776,1,1,0, 21777
16,21779,2,2,1, 21781
15,21781,2,2,0, 21783
13,21779,4,6,1, 21785
18,21783,4,4,1, 21787
22,21786,4,4,0, 21790
24,21789,1,1,1, 21790
19,21786,5,5,1, 21791
23,21788,3,3,0, 21791
30,21793,3,3,0, 21796
25,21795,2,2,1, 21797
31,21796,2,2,1, 21798
28,21794,5,5,1, 21799
29,21798,4,4,0, 21802
1,21806,1,1,1, 21807
5,21807,3,5,1, 21812
6,21810,2,4,0, 21814
8,21816,1,1,1, 21817
11,21814,4,4,1, 21818
16,21819,2,2,1, 21821
15,21821,2,2,0, 21823
13,21819,4,6,1, 21825
12,21820,5,5,1, 21825
18,21823,4,4,1, 21827
20,21823,6,6,1, 21829
22,21826,4,4,1, 21830
24,21829,1,1,0, 21830
19,21826,5,5,1, 21831
23,21828,3,3,0, 21831
30,21833,3,3,0, 21836
31,21836,2,2,1, 21838
28,21834,5,5,0, 21839
26,21837,3,3,1, 21840
29,21838,4,4,1, 21842
1,21846,1,1,0, 21847
3,21847,3,3,1, 21850
5,21847,3,5,1, 21852
8,21856,1,1,0, 21857
11,21854,4,4,1, 21858
16,21859,2,2,0, 21861
15,21861,2,2,0, 21863
13,21859,4,6,1, 21865
18,21863,4,4,1, 21867
22,21866,4,4,0, 21870
24,21869,1,1,0, 21870
23,21868,3,3,1, 21871
30,21873,3,3,1, 21876
31,21876,2,2,1, 21878
5,21887,3,5,1, 21892
8,21896,1,1,0, 21897
16,21899,2,2,1, 21901
15,21901,2,2,0, 21903
22,21906,4,4,1, 21910
24,21909,1,1,1, 21910
23,21908,3,3,0, 21911
30,21913,3,3,1, 21916
31,21916,2,2,1, 21918
29,21918,4,4,1, 21922
5,21927,3,5,1, 21932
6,21930,2,4,1, 21934
8,21936,1,1,1, 21937
16,21939,2,2,0, 21941
15,21941,2,2,0, 21943
22,21946,4,4,1, 21950
24,21949,1,1,1, 21950
23,21948,3,3,1, 21951
30,21953,3,3,0, 21956
31,21956,2,2,0, 21958
28,21954,5,5,1, 21959
8,21976,1,1,1, 21977
16,21979,2,2,0, 21981
17,21979,3,3,1, 21982
15,21981,2,2,0, 21983
13,21979,4,6,1, 21985
20,21983,6,6,1, 21989
22,21986,4,4,1, 21990
24,21989,1,1,0, 21990
19,21986,5,5,1, 21991
23,21988,3,3,0, 21991
30,21993,3,3,1, 21996
25,21995,2,2,1, 21997
31,21996,2,2,0, 21998
28,21994,5,5,1, 21999
29,21998,4,4,1, 22002
1,22006,1,1,1, 22007
5,22007,3,5,1, 22012
6,22010,2,4,1, 22014
8,22016,1,1,0, 22017
11,22014,4,4,1, 22018
16,22019,2,2,0, 22021
15,22021,2,2,0, 22023
13,22019,4,6,1, 22025
12,22020,5,5,1, 22025
20,22023,6,6,1, 22029
22,22026,4,4,1, 22030
24,22029,1,1,0, 22030
19,22026,5,5,1, 22031
23,22028,3,3,1, 22031
30,22033,3,3,0, 22036
31,22036,2,2,1, 22038
26,22037,3,3,1, 22040
29,22038,4,4,1, 22042
1,22046,1,1,0, 22047
3,22047,3,3,1, 22050
5,22047,3,5,1, 22052
6,22050,2,4,1, 22054
8,22056,1,1,1, 22057
11,22054,4,4,1, 22058
16,22059,2,2,1, 22061
15,22061,2,2,1, 22063
13,22059,4,6,1, 22065
20,22063,6,6,1, 22069
22,22066,4,4,0, 22070
24,22069,1,1,1, 22070
23,22068,3,3,1, 22071
31,22076,2,2,1, 22078
28,22074,5,5,1, 22079
29,22078,4,4,1, 22082
1,22086,1,1,1, 22087
6,22090,2,4,1, 22094
8,22096,1,1,1, 22097
16,22099,2,2,1, 22101
17,22099,3,3,1, 22102
15,22101,2,2,0, 22103
22,22106,4,4,1, 22110
24,22109,1,1,0, 22110
23,22108,3,3,0, 22111
30,22113,3,3,1, 22116
25,22115,2,2,1, 22117
31,22116,2,2,0, 22118
1,22126,1,1,1, 22127
5,22127,3,5,1, 22132
6,22130,2,4,1, 22134
8,22136,1,1,0, 22137
16,22139,2,2,1, 22141
15,22141,2,2,1, 22143
22,22146,4,4,1, 22150
24,22149,1,1,0, 22150
23,22148,3,3,1, 22151
30,22153,3,3,1, 22156
25,22155,2,2,1, 22157
31,22156,2,2,0, 22158
28,22154,5,5,1, 22159
29,22158,4,4,1, 22162
1,22166,1,1,1, 22167
8,22176,1,1,1, 22177
11,22174,4,4,1, 22178
16,22179,2,2,0, 22181
17,22179,3,3,1, 22182
15,22181,2,2,1, 22183
18,22183,4,4,1, 22187
20,22183,6,6,1, 22189
22,22186,4,4,0, 22190
24,22189,1,1,0, 22190
19,22186,5,5,1, 22191
23,22188,3,3,0, 22191
30,22193,3,3,1, 22196
31,22196,2,2,1, 22198
29,22198,4,4,1, 22202
2,22203,2,2,1, 22205
1,22206,1,1,0, 22207
8,22216,1,1,1, 22217
11,22214,4,4,1, 22218
9,22217,2,2,1, 22219
16,22219,2,2,0, 22221
15,22221,2,2,0, 22223
18,22223,4,4,1, 22227
22,22226,4,4,1, 22230
24,22229,1,1,1, 22230
23,22228,3,3,0, 22231
31,22236,2,2,1, 22238
28,22234,5,5,1, 22239
29,22238,4,4,1, 22242
1,22246,1,1,0, 22247
5,22247,3,5,1, 22252
8,22256,1,1,1, 22257
11,22254,4,4,1, 22258
16,22259,2,2,1, 22261
15,22261,2,2,1, 22263
12,22260,5,5,1, 22265
22,22266,4,4,0, 22270
24,22269,1,1,0, 22270
19,22266,5,5,1, 22271
23,22268,3,3,0, 22271
31,22276,2,2,1, 22278
29,22278,4,4,1, 22282
2,22283,2,2,1, 22285
1,22286,1,1,0, 22287
3,22287,3,3,1, 22290
6,22290,2,4,1, 22294
8,22296,1,1,0, 22297
11,22294,4,4,1, 22298
16,22299,2,2,0, 22301
15,22301,2,2,1, 22303
13,22299,4,6,1, 22305
22,22306,4,4,1, 22310
24,22309,1,1,0, 22310
23,22308,3,3,0, 22311
25,22315,2,2,1, 22317
31,22316,2,2,0, 22318
28,22314,5,5,1, 22319
26,22317,3,3,1, 22320
1,22326,1,1,1, 22327
3,22327,3,3,1, 22330
8,22336,1,1,0, 22337
11,22334,4,4,1, 22338
16,22339,2,2,0, 22341
17,22339,3,3,1, 22342
15,22341,2,2,1, 22343
12,22340,5,5,1, 22345
18,22343,4,4,1, 22347
20,22343,6,6,1, 22349
22,22346,4,4,1, 22350
24,22349,1,1,0, 22350
19,22346,5,5,1, 22351
23,22348,3,3,1, 22351
25,22355,2,2,1, 22357
31,22356,2,2,0, 22358
28,22354,5,5,1, 22359
26,22357,3,3,1, 22360
2,22363,2,2,1, 22365
1,22366,1,1,1, 22367
5,22367,3,5,1, 22372
8,22376,1,1,0, 22377
11,22374,4,4,1, 22378
16,22379,2,2,1, 22381
15,22381,2,2,0, 22383
18,22383,4,4,1, 22387
22,22386,4,4,1, 22390
24,22389,1,1,1, 22390
19,22386,5,5,1, 22391
23,22388,3,3,1, 22391
30,22393,3,3,1, 22396
31,22396,2,2,0, 22398
29,22398,4,4,1, 22402
1,22406,1,1,0, 22407
8,22416,1,1,1, 22417
9,22417,2,2,1, 22419
16,22419,2,2,1, 22421
24,22429,1,1,0, 22430
19,22426,5,5,1, 22431
23,22428,3,3,1, 22431
30,22433,3,3,1, 22436
31,22436,2,2,0, 22438
1,22446,1,1,1, 22447
6,22450,2,4,1, 22454
8,22456,1,1,0, 22457
11,22454,4,4,1, 22458
16,22459,2,2,1, 22461
20,22463,6,6,1, 22469
24,22469,1,1,0, 22470
19,22466,5,5,1, 22471
23,22468,3,3,1, 22471
25,22475,2,2,1, 22477
31,22476,2,2,1, 22478
28,22474,5,5,1, 22479
26,22477,3,3,1, 22480
1,22486,1,1,0, 22487
3,22487,3,3,1, 22490
6,22490,2,4,1, 22494
8,22496,1,1,0, 22497
17,22499,3,3,1, 22502
15,22501,2,2,1, 22503
13,22499,4,6,1, 22505
12,22500,5,5,1, 22505
20,22503,6,6,1, 22509
24,22509,1,1,0, 22510
23,22508,3,3,1, 22511
30,22513,3,3,1, 22516
25,22515,2,2,1, 22517
31,22516,2,2,0, 22518
1,22526,1,1,0, 22527
5,22527,3,5,1, 22532
8,22536,1,1,0, 22537
9,22537,2,2,1, 22539
17,22539,3,3,1, 22542
13,22539,4,6,1, 22545
18,22543,4,4,1, 22547
22,22546,4,4,1, 22550
24,22549,1,1,1, 22550
30,22553,3,3,1, 22556
31,22556,2,2,1, 22558
28,22554,5,5,1, 22559
26,22557,3,3,1, 22560
29,22558,4,4,1, 22562
5,22567,3,5,1, 22572
8,22576,1,1,1, 22577
15,22581,2,2,1, 22583
24,22589,1,1,1, 22590
23,22588,3,3,1, 22591
31,22596,2,2,1, 22598
29,22598,4,4,1, 22602
8,22616,1,1,1, 22617
15,22621,2,2,1, 22623
24,22629,1,1,0, 22630
23,22628,3,3,1, 22631
31,22636,2,2,0, 22638
28,22634,5,5,1, 22639
29,22638,4,4,1, 22642
6,22650,2,4,1, 22654
8,22656,1,1,0, 22657
15,22661,2,2,1, 22663
12,22660,5,5,1, 22665
18,22663,4,4,1, 22667
20,22663,6,6,1, 22669
22,22666,4,4,1, 22670
24,22669,1,1,1, 22670
23,22668,3,3,1, 22671
30,22673,3,3,1, 22676
31,22676,2,2,1, 22678
26,22677,3,3,1, 22680
29,22678,4,4,1, 22682
1,22686,1,1,0, 22687
3,22687,3,3,1, 22690
5,22687,3,5,1, 22692
6,22690,2,4,1, 22694
8,22696,1,1,1, 22697
11,22694,4,4,1, 22698
9,22697,2,2,1, 22699
15,22701,2,2,1, 22703
22,22706,4,4,1, 22710
24,22709,1,1,0, 22710
19,22706,5,5,1, 22711
30,22713,3,3,1, 22716
31,22716,2,2,1, 22718
28,22714,5,5,1, 22719
26,22717,3,3,1, 22720
29,22718,4,4,1, 22722
2,22723,2,2,1, 22725
1,22726,1,1,1, 22727
3,22727,3,3,1, 22730
8,22736,1,1,0, 22737
17,22739,3,3,1, 22742
12,22740,5,5,1, 22745
20,22743,6,6,1, 22749
24,22749,1,1,1, 22750
30,22753,3,3,1, 22756
31,22756,2,2,1, 22758
28,22754,5,5,1, 22759
26,22757,3,3,1, 22760
29,22758,4,4,1, 22762
2,22763,2,2,1, 22765
1,22766,1,1,0, 22767
5,22767,3,5,1, 22772
8,22776,1,1,0, 22777
11,22774,4,4,1, 22778
9,22777,2,2,1, 22779
16,22779,2,2,1, 22781
17,22779,3,3,1, 22782
13,22779,4,6,1, 22785
18,22783,4,4,1, 22787
22,22786,4,4,1, 22790
24,22789,1,1,1, 22790
19,22786,5,5,1, 22791
30,22793,3,3,1, 22796
31,22796,2,2,0, 22798
2,22803,2,2,1, 22805
1,22806,1,1,1, 22807
3,22807,3,3,1, 22810
6,22810,2,4,1, 22814
8,22816,1,1,1, 22817
11,22814,4,4,1, 22818
9,22817,2,2,1, 22819
17,22819,3,3,1, 22822
13,22819,4,6,1, 22825
24,22829,1,1,0, 22830
31,22836,2,2,1, 22838
28,22834,5,5,1, 22839
29,22838,4,4,1, 22842
5,22847,3,5,1, 22852
8,22856,1,1,1, 22857
22,22866,4,4,1, 22870
24,22869,1,1,1, 22870
31,22876,2,2,1, 22878
8,22896,1,1,0, 22897
22,22906,4,4,1, 22910
24,22909,1,1,1, 22910
23,22908,3,3,1, 22911
31,22916,2,2,1, 22918
3,22927,3,3,1, 22930
5,22927,3,5,1, 22932
8,22936,1,1,0, 22937
9,22937,2,2,1, 22939
13,22939,4,6,1, 22945
12,22940,5,5,1, 22945
22,22946,4,4,0, 22950
24,22949,1,1,1, 22950
19,22946,5,5,1, 22951
23,22948,3,3,0, 22951
31,22956,2,2,0, 22958
28,22954,5,5,1, 22959
26,22957,3,3,1, 22960
1,22966,1,1,0, 22967
6,22970,2,4,1, 22974
8,22976,1,1,1, 22977
9,22977,2,2,1, 22979
16,22979,2,2,1, 22981
15,22981,2,2,0, 22983
12,22980,5,5,1, 22985
18,22983,4,4,1, 22987
20,22983,6,6,1, 22989
22,22986,4,4,0, 22990
24,22989,1,1,0, 22990
19,22986,5,5,1, 22991
23,22988,3,3,0, 22991
30,22993,3,3,1, 22996
31,22996,2,2,0, 22998
26,22997,3,3,1, 23000
2,23003,2,2,1, 23005
1,23006,1,1,0, 23007
8,23016,1,1,0, 23017
9,23017,2,2,1, 23019
16,23019,2,2,1, 23021
15,23021,2,2,1, 23023
12,23020,5,5,1, 23025
18,23023,4,4,1, 23027
20,23023,6,6,1, 23029
22,23026,4,4,0, 23030
24,23029,1,1,0, 23030
19,23026,5,5,1, 23031
23,23028,3,3,1, 23031
30,23033,3,3,1, 23036
31,23036,2,2,0, 23038
26,23037,3,3,1, 23040
1,23046,1,1,1, 23047
5,23047,3,5,1, 23052
8,23056,1,1,1, 23057
16,23059,2,2,1, 23061
15,23061,2,2,0, 23063
22,23066,4,4,1, 23070
24,23069,1,1,1, 23070
23,23068,3,3,0, 23071
30,23073,3,3,1, 23076
25,23075,2,2,1, 23077
31,23076,2,2,0, 23078
29,23078,4,4,1, 23082
1,23086,1,1,0, 23087
5,23087,3,5,1, 23092
8,23096,1,1,1, 23097
9,23097,2,2,1, 23099
16,23099,2,2,0, 23101
17,23099,3,3,1, 23102
15,23101,2,2,0, 23103
22,23106,4,4,1, 23110
24,23109,1,1,1, 23110
23,23108,3,3,1, 23111
31,23116,2,2,0, 23118
29,23118,4,4,1, 23122
1,23126,1,1,0, 23127
8,23136,1,1,1, 23137
16,23139,2,2,1, 23141
17,23139,3,3,1, 23142
15,23141,2,2,0, 23143
20,23143,6,6,1, 23149
22,23146,4,4,0, 23150
24,23149,1,1,1, 23150
19,23146,5,5,1, 23151
23,23148,3,3,0, 23151
31,23156,2,2,1, 23158
28,23154,5,5,1, 23159
26,23157,3,3,1, 23160
29,23158,4,4,1, 23162
2,23163,2,2,1, 23165
1,23166,1,1,0, 23167
3,23167,3,3,1, 23170
6,23170,2,4,1, 23174
8,23176,1,1,1, 23177
9,23177,2,2,1, 23179
16,23179,2,2,0, 23181
17,23179,3,3,1, 23182
15,23181,2,2,1, 23183
13,23179,4,6,1, 23185
12,23180,5,5,1, 23185
20,23183,6,6,1, 23189
22,23186,4,4,1, 23190
24,23189,1,1,0, 23190
19,23186,5,5,1, 23191
23,23188,3,3,1, 23191
30,23193,3,3,1, 23196
31,23196,2,2,0, 23198
26,23197,3,3,1, 23200
29,23198,4,4,1, 23202
1,23206,1,1,1, 23207
8,23216,1,1,1, 23217
11,23214,4,4,1, 23218
16,23219,2,2,1, 23221
17,23219,3,3,1, 23222
15,23221,2,2,1, 23223
13,23219,4,6,1, 23225
22,23226,4,4,1, 23230
24,23229,1,1,1, 23230
19,23226,5,5,1, 23231
23,23228,3,3,0, 23231
25,23235,2,2,1, 23237
31,23236,2,2,1, 23238
28,23234,5,5,1, 23239
29,23238,4,4,1, 23242
2,23243,2,2,1, 23245
1,23246,1,1,0, 23247
3,23247,3,3,1, 23250
5,23247,3,5,1, 23252
8,23256,1,1,1, 23257
11,23254,4,4,1, 23258
9,23257,2,2,1, 23259
16,23259,2,2,1, 23261
17,23259,3,3,1, 23262
15,23261,2,2,0, 23263
12,23260,5,5,1, 23265
22,23266,4,4,1, 23270
24,23269,1,1,0, 23270
23,23268,3,3,1, 23271
31,23276,2,2,1, 23278
28,23274,5,5,1, 23279
5,23287,3,5,1, 23292
6,23290,2,4,1, 23294
8,23296,1,1,1, 23297
16,23299,2,2,0, 23301
15,23301,2,2,1, 23303
22,23306,4,4,1, 23310
24,23309,1,1,0, 23310
23,23308,3,3,1, 23311
30,23313,3,3,1, 23316
31,23316,2,2,0, 23318
28,23314,5,5,1, 23319
29,23318,4,4,1, 23322
8,23336,1,1,0, 23337
16,23339,2,2,0, 23341
15,23341,2,2,0, 23343
22,23346,4,4,0, 23350
24,23349,1,1,1, 23350
23,23348,3,3,0, 23351
31,23356,2,2,0, 23358
28,23354,5,5,1, 23359
29,23358,4,4,1, 23362
1,23366,1,1,1, 23367
3,23367,3,3,1, 23370
8,23376,1,1,1, 23377
16,23379,2,2,1, 23381
15,23381,2,2,1, 23383
12,23380,5,5,1, 23385
20,23383,6,6,1, 23389
22,23386,4,4,0, 23390
24,23389,1,1,1, 23390
19,23386,5,5,1, 23391
23,23388,3,3,1, 23391
30,23393,3,3,0, 23396
31,23396,2,2,0, 23398
28,23394,5,5,0, 23399
26,23397,3,3,1, 23400
29,23398,4,4,0, 23402
2,23403,2,2,1, 23405
1,23406,1,1,1, 23407
3,23407,3,3,1, 23410
5,23407,3,5,1, 23412
6,23410,2,4,0, 23414
8,23416,1,1,0, 23417
11,23414,4,4,1, 23418
16,23419,2,2,0, 23421
15,23421,2,2,1, 23423
13,23419,4,6,1, 23425
12,23420,5,5,1, 23425
18,23423,4,4,1, 23427
20,23423,6,6,1, 23429
22,23426,4,4,0, 23430
24,23429,1,1,1, 23430
19,23426,5,5,1, 23431
23,23428,3,3,0, 23431
30,23433,3,3,0, 23436
25,23435,2,2,1, 23437
31,23436,2,2,0, 23438
28,23434,5,5,0, 23439
29,23438,4,4,0, 23442
1,23446,1,1,0, 23447
5,23447,3,5,0, 23452
6,23450,2,4,1, 23454
8,23456,1,1,0, 23457
11,23454,4,4,1, 23458
9,23457,2,2,1, 23459
16,23459,2,2,1, 23461
17,23459,3,3,1, 23462
15,23461,2,2,1, 23463
12,23460,5,5,1, 23465
22,23466,4,4,0, 23470
24,23469,1,1,1, 23470
19,23466,5,5,1, 23471
23,23468,3,3,1, 23471
30,23473,3,3,1, 23476
25,23475,2,2,1, 23477
31,23476,2,2,0, 23478
28,23474,5,5,1, 23479
29,23478,4,4,1, 23482
2,23483,2,2,1, 23485
1,23486,1,1,1, 23487
3,23487,3,3,1, 23490
5,23487,3,5,1, 23492
6,23490,2,4,1, 23494
8,23496,1,1,0, 23497
11,23494,4,4,1, 23498
16,23499,2,2,1, 23501
15,23501,2,2,0, 23503
13,23499,4,6,1, 23505
18,23503,4,4,1, 23507
22,23506,4,4,0, 23510
24,23509,1,1,1, 23510
19,23506,5,5,1, 23511
23,23508,3,3,0, 23511
30,23513,3,3,1, 23516
25,23515,2,2,1, 23517
31,23516,2,2,0, 23518
28,23514,5,5,0, 23519
26,23517,3,3,1, 23520
29,23518,4,4,1, 23522
8,23536,1,1,1, 23537
16,23539,2,2,0, 23541
15,23541,2,2,1, 23543
22,23546,4,4,0, 23550
24,23549,1,1,1, 23550
23,23548,3,3,1, 23551
30,23553,3,3,1, 23556
5,23567,3,5,1, 23572
8,23576,1,1,0, 23577
16,23579,2,2,0, 23581
15,23581,2,2,1, 23583
22,23586,4,4,0, 23590
24,23589,1,1,1, 23590
23,23588,3,3,0, 23591
28,23594,5,5,1, 23599
29,23598,4,4,1, 23602
8,23616,1,1,1, 23617
16,23619,2,2,1, 23621
15,23621,2,2,0, 23623
22,23626,4,4,1, 23630
24,23629,1,1,1, 23630
23,23628,3,3,0, 23631
25,23635,2,2,1, 23637
31,23636,2,2,1, 23638
28,23634,5,5,1, 23639
29,23638,4,4,1, 23642
1,23646,1,1,0, 23647
3,23647,3,3,1, 23650
5,23647,3,5,1, 23652
8,23656,1,1,0, 23657
9,23657,2,2,1, 23659
16,23659,2,2,1, 23661
15,23661,2,2,1, 23663
12,23660,5,5,1, 23665
18,23663,4,4,1, 23667
22,23666,4,4,0, 23670
24,23669,1,1,0, 23670
19,23666,5,5,1, 23671
23,23668,3,3,1, 23671
25,23675,2,2,1, 23677
31,23676,2,2,1, 23678
29,23678,4,4,1, 23682
1,23686,1,1,0, 23687
3,23687,3,3,1, 23690
5,23687,3,5,1, 23692
8,23696,1,1,0, 23697
16,23699,2,2,1, 23701
17,23699,3,3,1, 23702
15,23701,2,2,1, 23703
13,23699,4,6,1, 23705
20,23703,6,6,1, 23709
22,23706,4,4,1, 23710
24,23709,1,1,0, 23710
19,23706,5,5,1, 23711
23,23708,3,3,0, 23711
25,23715,2,2,1, 23717
31,23716,2,2,1, 23718
28,23714,5,5,1, 23719
29,23718,4,4,1, 23722
2,23723,2,2,1, 23725
1,23726,1,1,0, 23727
3,23727,3,3,1, 23730
5,23727,3,5,1, 23732
8,23736,1,1,0, 23737
11,23734,4,4,1, 23738
9,23737,2,2,1, 23739
16,23739,2,2,1, 23741
17,23739,3,3,1, 23742
15,23741,2,2,1, 23743
12,23740,5,5,1, 23745
22,23746,4,4,1, 23750
24,23749,1,1,0, 23750
19,23746,5,5,1, 23751
23,23748,3,3,1, 23751
25,23755,2,2,1, 23757
28,23754,5,5,1, 23759
26,23757,3,3,1, 23760
29,23758,4,4,1, 23762
2,23763,2,2,1, 23765
1,23766,1,1,0, 23767
3,23767,3,3,1, 23770
5,23767,3,5,1, 23772
6,23770,2,4,1, 23774
8,23776,1,1,1, 23777
9,23777,2,2,1, 23779
16,23779,2,2,1, 23781
15,23781,2,2,1, 23783
12,23780,5,5,1, 23785
22,23786,4,4,0, 23790
24,23789,1,1,0, 23790
23,23788,3,3,1, 23791
25,23795,2,2,1, 23797
31,23796,2,2,1, 23798
1,23806,1,1,1, 23807
3,23807,3,3,1, 23810
5,23807,3,5,1, 23812
6,23810,2,4,1, 23814
8,23816,1,1,1, 23817
11,23814,4,4,1, 23818
16,23819,2,2,0, 23821
17,23819,3,3,1, 23822
15,23821,2,2,1, 23823
22,23826,4,4,1, 23830
24,23829,1,1,1, 23830
23,23828,3,3,1, 23831
29,23838,4,4,1, 23842
8,23856,1,1,0, 23857
16,23859,2,2,1, 23861
15,23861,2,2,1, 23863
22,23866,4,4,0, 23870
24,23869,1,1,0, 23870
23,23868,3,3,0, 23871
30,23873,3,3,1, 23876
28,23874,5,5,1, 23879
29,23878,4,4,1, 23882
5,23887,3,5,1, 23892
8,23896,1,1,0, 23897
16,23899,2,2,1, 23901
15,23901,2,2,0, 23903
22,23906,4,4,1, 23910
24,23909,1,1,1, 23910
23,23908,3,3,1, 23911
31,23916,2,2,1, 23918
28,23914,5,5,1, 23919
1,23926,1,1,1, 23927
8,23936,1,1,1, 23937
9,23937,2,2,1, 23939
16,23939,2,2,0, 23941
15,23941,2,2,0, 23943
12,23940,5,5,1, 23945
18,23943,4,4,1, 23947
22,23946,4,4,1, 23950
24,23949,1,1,1, 23950
19,23946,5,5,1, 23951
23,23948,3,3,1, 23951
30,23953,3,3,1, 23956
25,23955,2,2,1, 23957
26,23957,3,3,1, 23960
29,23958,4,4,1, 23962
2,23963,2,2,1, 23965
1,23966,1,1,1, 23967
3,23967,3,3,1, 23970
6,23970,2,4,1, 23974
8,23976,1,1,1, 23977
11,23974,4,4,1, 23978
9,23977,2,2,1, 23979
16,23979,2,2,0, 23981
17,23979,3,3,1, 23982
15,23981,2,2,1, 23983
13,23979,4,6,1, 23985
22,23986,4,4,1, 23990
24,23989,1,1,1, 23990
19,23986,5,5,1, 23991
23,23988,3,3,0, 23991
30,23993,3,3,1, 23996
28,23994,5,5,1, 23999
2,24003,2,2,1, 24005
1,24006,1,1,1, 24007
6,24010,2,4,1, 24014
8,24016,1,1,1, 24017
16,24019,2,2,0, 24021
17,24019,3,3,1, 24022
15,24021,2,2,0, 24023
18,24023,4,4,1, 24027
20,24023,6,6,1, 24029
22,24026,4,4,0, 24030
24,24029,1,1,1, 24030
19,24026,5,5,1, 24031
23,24028,3,3,0, 24031
31,24036,2,2,1, 24038
28,24034,5,5,1, 24039
29,24038,4,4,1, 24042
2,24043,2,2,1, 24045
1,24046,1,1,0, 24047
8,24056,1,1,1, 24057
16,24059,2,2,1, 24061
17,24059,3,3,1, 24062
15,24061,2,2,1, 24063
13,24059,4,6,1, 24065
12,24060,5,5,1, 24065
20,24063,6,6,1, 24069
22,24066,4,4,1, 24070
24,24069,1,1,0, 24070
19,24066,5,5,1, 24071
23,24068,3,3,1, 24071
25,24075,2,2,1, 24077
29,24078,4,4,1, 24082
1,24086,1,1,0, 24087
3,24087,3,3,1, 24090
5,24087,3,5,1, 24092
6,24090,2,4,1, 24094
8,24096,1,1,1, 24097
11,24094,4,4,1, 24098
9,24097,2,2,1, 24099
16,24099,2,2,1, 24101
15,24101,2,2,0, 24103
22,24106,4,4,0, 24110
24,24109,1,1,1, 24110
23,24108,3,3,1, 24111
8,24136,1,1,1, 24137
16,24139,2,2,0, 24141
15,24141,2,2,0, 24143
22,24146,4,4,1, 24150
24,24149,1,1,0, 24150
23,24148,3,3,1, 24151
28,24154,5,5,1, 24159
29,24158,4,4,1, 24162
5,24167,3,5,1, 24172
6,24170,2,4,1, 24174
8,24176,1,1,1, 24177
16,24179,2,2,1, 24181
15,24181,2,2,1, 24183
22,24186,4,4,1, 24190
24,24189,1,1,0, 24190
23,24188,3,3,0, 24191
30,24193,3,3,1, 24196
28,24194,5,5,1, 24199
1,24206,1,1,1, 24207
3,24207,3,3,1, 24210
5,24207,3,5,1, 24212
8,24216,1,1,0, 24217
16,24219,2,2,1, 24221
15,24221,2,2,1, 24223
18,24223,4,4,1, 24227
22,24226,4,4,0, 24230
24,24229,1,1,1, 24230
23,24228,3,3,0, 24231
26,24237,3,3,1, 24240
29,24238,4,4,1, 24242
2,24243,2,2,1, 24245
1,24246,1,1,0, 24247
5,24247,3,5,1, 24252
8,24256,1,1,1, 24257
11,24254,4,4,1, 24258
9,24257,2,2,1, 24259
16,24259,2,2,0, 24261
17,24259,3,3,1, 24262
15,24261,2,2,0, 24263
13,24259,4,6,1, 24265
12,24260,5,5,1, 24265
22,24266,4,4,0, 24270
24,24269,1,1,1, 24270
19,24266,5,5,1, 24271
23,24268,3,3,1, 24271
31,24276,2,2,1, 24278
28,24274,5,5,1, 24279
1,24286,1,1,0, 24287
3,24287,3,3,1, 24290
8,24296,1,1,1, 24297
16,24299,2,2,0, 24301
17,24299,3,3,1, 24302
15,24301,2,2,0, 24303
18,24303,4,4,1, 24307
20,24303,6,6,1, 24309
22,24306,4,4,1, 24310
24,24309,1,1,1, 24310
23,24308,3,3,1, 24311
30,24313,3,3,1, 24316
28,24314,5,5,1, 24319
26,24317,3,3,1, 24320
29,24318,4,4,1, 24322
2,24323,2,2,1, 24325
1,24326,1,1,1, 24327
3,24327,3,3,1, 24330
8,24336,1,1,0, 24337
11,24334,4,4,1, 24338
9,24337,2,2,1, 24339
16,24339,2,2,0, 24341
15,24341,2,2,1, 24343
12,24340,5,5,1, 24345
18,24343,4,4,1, 24347
22,24346,4,4,0, 24350
24,24349,1,1,1, 24350
23,24348,3,3,1, 24351
25,24355,2,2,1, 24357
31,24356,2,2,1, 24358
28,24354,5,5,1, 24359
26,24357,3,3,1, 24360
29,24358,4,4,1, 24362
1,24366,1,1,1, 24367
3,24367,3,3,1, 24370
5,24367,3,5,1, 24372
8,24376,1,1,0, 24377
11,24374,4,4,1, 24378
16,24379,2,2,0, 24381
15,24381,2,2,0, 24383
18,24383,4,4,1, 24387
22,24386,4,4,1, 24390
24,24389,1,1,1, 24390
19,24386,5,5,1, 24391
23,24388,3,3,1, 24391
25,24395,2,2,1, 24397
31,24396,2,2,1, 24398
28,24394,5,5,1, 24399
1,24406,1,1,0, 24407
5,24407,3,5,1, 24412
8,24416,1,1,0, 24417
16,24419,2,2,1, 24421
15,24421,2,2,1, 24423
12,24420,5,5,1, 24425
20,24423,6,6,1, 24429
22,24426,4,4,0, 24430
24,24429,1,1,0, 24430
23,24428,3,3,1, 24431
25,24435,2,2,1, 24437
28,24434,5,5,1, 24439
2,24443,2,2,1, 24445
1,24446,1,1,1, 24447
3,24447,3,3,1, 24450
5,24447,3,5,1, 24452
8,24456,1,1,1, 24457
11,24454,4,4,1, 24458
16,24459,2,2,0, 24461
15,24461,2,2,1, 24463
13,24459,4,6,1, 24465
22,24466,4,4,0, 24470
24,24469,1,1,1, 24470
23,24468,3,3,0, 24471
30,24473,3,3,1, 24476
25,24475,2,2,1, 24477
31,24476,2,2,1, 24478
28,24474,5,5,1, 24479
26,24477,3,3,1, 24480
1,24486,1,1,1, 24487
3,24487,3,3,1, 24490
6,24490,2,4,1, 24494
8,24496,1,1,1, 24497
9,24497,2,2,1, 24499
16,24499,2,2,1, 24501
17,24499,3,3,1, 24502
15,24501,2,2,0, 24503
22,24506,4,4,0, 24510
24,24509,1,1,0, 24510
23,24508,3,3,0, 24511
5,24527,3,5,1, 24532
6,24530,2,4,1, 24534
8,24536,1,1,0, 24537
16,24539,2,2,1, 24541
15,24541,2,2,1, 24543
22,24546,4,4,0, 24550
24,24549,1,1,0, 24550
23,24548,3,3,1, 24551
30,24553,3,3,1, 24556
31,24556,2,2,1, 24558
29,24558,4,4,1, 24562
6,24570,2,4,1, 24574
8,24576,1,1,0, 24577
16,24579,2,2,1, 24581
15,24581,2,2,0, 24583
22,24586,4,4,0, 24590
24,24589,1,1,0, 24590
23,24588,3,3,0, 24591
30,24593,3,3,1, 24596
2,24603,2,2,1, 24605
1,24606,1,1,0, 24607
3,24607,3,3,1, 24610
5,24607,3,5,1, 24612
8,24616,1,1,0, 24617
11,24614,4,4,1, 24618
9,24617,2,2,1, 24619
16,24619,2,2,0, 24621
17,24619,3,3,1, 24622
15,24621,2,2,0, 24623
13,24619,4,6,1, 24625
22,24626,4,4,0, 24630
24,24629,1,1,1, 24630
19,24626,5,5,1, 24631
23,24628,3,3,1, 24631
30,24633,3,3,1, 24636
25,24635,2,2,1, 24637
31,24636,2,2,1, 24638
28,24634,5,5,1, 24639
26,24637,3,3,1, 24640
2,24643,2,2,1, 24645
1,24646,1,1,1, 24647
3,24647,3,3,1, 24650
8,24656,1,1,0, 24657
16,24659,2,2,0, 24661
15,24661,2,2,0, 24663
13,24659,4,6,1, 24665
22,24666,4,4,1, 24670
24,24669,1,1,1, 24670
19,24666,5,5,1, 24671
23,24668,3,3,1, 24671
25,24675,2,2,1, 24677
31,24676,2,2,1, 24678
28,24674,5,5,1, 24679
26,24677,3,3,1, 24680
2,24683,2,2,1, 24685
1,24686,1,1,1, 24687
6,24690,2,4,1, 24694
8,24696,1,1,1, 24697
9,24697,2,2,1, 24699
16,24699,2,2,0, 24701
17,24699,3,3,1, 24702
15,24701,2,2,0, 24703
12,24700,5,5,1, 24705
20,24703,6,6,1, 24709
22,24706,4,4,0, 24710
24,24709,1,1,1, 24710
23,24708,3,3,0, 24711
28,24714,5,5,1, 24719
26,24717,3,3,1, 24720
1,24726,1,1,0, 24727
3,24727,3,3,1, 24730
5,24727,3,5,1, 24732
8,24736,1,1,0, 24737
16,24739,2,2,0, 24741
15,24741,2,2,1, 24743
12,24740,5,5,1, 24745
18,24743,4,4,1, 24747
22,24746,4,4,1, 24750
24,24749,1,1,1, 24750
23,24748,3,3,1, 24751
31,24756,2,2,1, 24758
28,24754,5,5,1, 24759
26,24757,3,3,1, 24760
2,24763,2,2,1, 24765
1,24766,1,1,1, 24767
3,24767,3,3,1, 24770
5,24767,3,5,1, 24772
8,24776,1,1,1, 24777
11,24774,4,4,1, 24778
16,24779,2,2,0, 24781
17,24779,3,3,1, 24782
15,24781,2,2,0, 24783
13,24779,4,6,1, 24785
22,24786,4,4,1, 24790
24,24789,1,1,0, 24790
23,24788,3,3,1, 24791
30,24793,3,3,1, 24796
31,24796,2,2,1, 24798
29,24798,4,4,1, 24802
5,24807,3,5,1, 24812
8,24816,1,1,0, 24817
16,24819,2,2,1, 24821
15,24821,2,2,0, 24823
22,24826,4,4,0, 24830
24,24829,1,1,0, 24830
23,24828,3,3,1, 24831
30,24833,3,3,1, 24836
5,24847,3,5,1, 24852
8,24856,1,1,1, 24857
16,24859,2,2,1, 24861
15,24861,2,2,0, 24863
22,24866,4,4,1, 24870
24,24869,1,1,0, 24870
23,24868,3,3,1, 24871
29,24878,4,4,1, 24882
3,24887,3,3,1, 24890
8,24896,1,1,1, 24897
16,24899,2,2,1, 24901
17,24899,3,3,1, 24902
15,24901,2,2,1, 24903
18,24903,4,4,1, 24907
24,24909,1,1,1, 24910
30,24913,3,3,1, 24916
28,24914,5,5,1, 24919
26,24917,3,3,1, 24920
1,24926,1,1,1, 24927
3,24927,3,3,1, 24930
5,24927,3,5,1, 24932
8,24936,1,1,1, 24937
11,24934,4,4,1, 24938
9,24937,2,2,1, 24939
17,24939,3,3,1, 24942
12,24940,5,5,1, 24945
18,24943,4,4,1, 24947
20,24943,6,6,1, 24949
22,24946,4,4,1, 24950
24,24949,1,1,1, 24950
19,24946,5,5,1, 24951
31,24956,2,2,1, 24958
28,24954,5,5,1, 24959
26,24957,3,3,1, 24960
1,24966,1,1,1, 24967
5,24967,3,5,1, 24972
8,24976,1,1,1, 24977
16,24979,2,2,1, 24981
13,24979,4,6,1, 24985
12,24980,5,5,1, 24985
22,24986,4,4,1, 24990
24,24989,1,1,1, 24990
19,24986,5,5,1, 24991
23,24988,3,3,1, 24991
30,24993,3,3,1, 24996
25,24995,2,2,1, 24997
1,25006,1,1,0, 25007
3,25007,3,3,1, 25010
5,25007,3,5,1, 25012
6,25010,2,4,1, 25014
8,25016,1,1,1, 25017
17,25019,3,3,1, 25022
12,25020,5,5,1, 25025
24,25029,1,1,0, 25030
23,25028,3,3,1, 25031
25,25035,2,2,1, 25037
31,25036,2,2,1, 25038
1,25046,1,1,0, 25047
8,25056,1,1,1, 25057
9,25057,2,2,1, 25059
17,25059,3,3,1, 25062
15,25061,2,2,1, 25063
24,25069,1,1,1, 25070
30,25073,3,3,1, 25076
25,25075,2,2,1, 25077
31,25076,2,2,0, 25078
28,25074,5,5,1, 25079
29,25078,4,4,1, 25082
1,25086,1,1,1, 25087
5,25087,3,5,0, 25092
6,25090,2,4,0, 25094
8,25096,1,1,1, 25097
9,25097,2,2,1, 25099
16,25099,2,2,1, 25101
17,25099,3,3,1, 25102
22,25106,4,4,1, 25110
24,25109,1,1,0, 25110
23,25108,3,3,1, 25111
30,25113,3,3,0, 25116
25,25115,2,2,1, 25117
31,25116,2,2,0, 25118
28,25114,5,5,0, 25119
29,25118,4,4,0, 25122
1,25126,1,1,1, 25127
3,25127,3,3,1, 25130
5,25127,3,5,0, 25132
6,25130,2,4,0, 25134
8,25136,1,1,0, 25137
9,25137,2,2,1, 25139
16,25139,2,2,1, 25141
15,25141,2,2,1, 25143
13,25139,4,6,1, 25145
12,25140,5,5,1, 25145
20,25143,6,6,1, 25149
22,25146,4,4,1, 25150
24,25149,1,1,0, 25150
19,25146,5,5,1, 25151
23,25148,3,3,1, 25151
30,25153,3,3,0, 25156
31,25156,2,2,1, 25158
28,25154,5,5,0, 25159
29,25158,4,4,0, 25162
1,25166,1,1,0, 25167
5,25167,3,5,1, 25172
6,25170,2,4,0, 25174
8,25176,1,1,0, 25177
11,25174,4,4,1, 25178
16,25179,2,2,1, 25181
17,25179,3,3,1, 25182
15,25181,2,2,1, 25183
18,25183,4,4,1, 25187
22,25186,4,4,1, 25190
24,25189,1,1,0, 25190
19,25186,5,5,1, 25191
23,25188,3,3,1, 25191
30,25193,3,3,0, 25196
25,25195,2,2,1, 25197
31,25196,2,2,0, 25198
28,25194,5,5,0, 25199
26,25197,3,3,1, 25200
29,25198,4,4,1, 25202
2,25203,2,2,1, 25205
1,25206,1,1,1, 25207
5,25207,3,5,0, 25212
6,25210,2,4,0, 25214
8,25216,1,1,1, 25217
9,25217,2,2,1, 25219
16,25219,2,2,1, 25221
17,25219,3,3,1, 25222
15,25221,2,2,1, 25223
13,25219,4,6,1, 25225
18,25223,4,4,1, 25227
20,25223,6,6,1, 25229
24,25229,1,1,0, 25230
23,25228,3,3,1, 25231
30,25233,3,3,0, 25236
31,25236,2,2,1, 25238
28,25234,5,5,1, 25239
29,25238,4,4,0, 25242
5,25247,3,5,1, 25252
6,25250,2,4,0, 25254
8,25256,1,1,1, 25257
15,25261,2,2,1, 25263
24,25269,1,1,0, 25270
30,25273,3,3,1, 25276
31,25276,2,2,0, 25278
28,25274,5,5,0, 25279
29,25278,4,4,0, 25282
5,25287,3,5,0, 25292
6,25290,2,4,1, 25294
8,25296,1,1,0, 25297
16,25299,2,2,1, 25301
24,25309,1,1,0, 25310
23,25308,3,3,1, 25311
30,25313,3,3,0, 25316
31,25316,2,2,0, 25318
28,25314,5,5,1, 25319
29,25318,4,4,1, 25322
5,25327,3,5,1, 25332
6,25330,2,4,0, 25334
8,25336,1,1,1, 25337
11,25334,4,4,1, 25338
16,25339,2,2,1, 25341
17,25339,3,3,1, 25342
15,25341,2,2,1, 25343
12,25340,5,5,1, 25345
24,25349,1,1,1, 25350
30,25353,3,3,0, 25356
25,25355,2,2,1, 25357
31,25356,2,2,1, 25358
28,25354,5,5,0, 25359
29,25358,4,4,0, 25362
2,25363,2,2,1, 25365
1,25366,1,1,1, 25367
3,25367,3,3,1, 25370
5,25367,3,5,0, 25372
6,25370,2,4,1, 25374
8,25376,1,1,1, 25377
16,25379,2,2,1, 25381
17,25379,3,3,1, 25382
15,25381,2,2,1, 25383
12,25380,5,5,1, 25385
24,25389,1,1,0, 25390
19,25386,5,5,1, 25391
30,25393,3,3,1, 25396
31,25396,2,2,0, 25398
28,25394,5,5,0, 25399
29,25398,4,4,1, 25402
2,25403,2,2,1, 25405
1,25406,1,1,0, 25407
3,25407,3,3,1, 25410
5,25407,3,5,0, 25412
6,25410,2,4,1, 25414
8,25416,1,1,1, 25417
11,25414,4,4,1, 25418
9,25417,2,2,1, 25419
16,25419,2,2,1, 25421
13,25419,4,6,1, 25425
12,25420,5,5,1, 25425
20,25423,6,6,1, 25429
24,25429,1,1,0, 25430
23,25428,3,3,1, 25431
30,25433,3,3,1, 25436
31,25436,2,2,1, 25438
28,25434,5,5,1, 25439
26,25437,3,3,1, 25440
29,25438,4,4,0, 25442
1,25446,1,1,1, 25447
5,25447,3,5,0, 25452
6,25450,2,4,0, 25454
8,25456,1,1,0, 25457
11,25454,4,4,1, 25458
9,25457,2,2,1, 25459
16,25459,2,2,1, 25461
17,25459,3,3,1, 25462
15,25461,2,2,1, 25463
13,25459,4,6,1, 25465
12,25460,5,5,1, 25465
20,25463,6,6,1, 25469
22,25466,4,4,1, 25470
24,25469,1,1,1, 25470
23,25468,3,3,1, 25471
30,25473,3,3,1, 25476
25,25475,2,2,1, 25477
31,25476,2,2,1, 25478
28,25474,5,5,1, 25479
29,25478,4,4,1, 25482
2,25483,2,2,1, 25485
1,25486,1,1,1, 25487
5,25487,3,5,1, 25492
8,25496,1,1,0, 25497
9,25497,2,2,1, 25499
16,25499,2,2,1, 25501
17,25499,3,3,1, 25502
22,25506,4,4,1, 25510
24,25509,1,1,0, 25510
19,25506,5,5,1, 25511
23,25508,3,3,1, 25511
31,25516,2,2,1, 25518
26,25517,3,3,1, 25520
29,25518,4,4,1, 25522
2,25523,2,2,1, 25525
1,25526,1,1,0, 25527
8,25536,1,1,0, 25537
11,25534,4,4,1, 25538
17,25539,3,3,1, 25542
12,25540,5,5,1, 25545
18,25543,4,4,1, 25547
24,25549,1,1,1, 25550
30,25553,3,3,1, 25556
31,25556,2,2,1, 25558
28,25554,5,5,1, 25559
29,25558,4,4,1, 25562
8,25576,1,1,0, 25577
16,25579,2,2,1, 25581
24,25589,1,1,0, 25590
23,25588,3,3,1, 25591
30,25593,3,3,1, 25596
31,25596,2,2,1, 25598
28,25594,5,5,1, 25599
5,25607,3,5,1, 25612
6,25610,2,4,1, 25614
8,25616,1,1,0, 25617
16,25619,2,2,1, 25621
22,25626,4,4,1, 25630
24,25629,1,1,1, 25630
23,25628,3,3,1, 25631
31,25636,2,2,1, 25638
29,25638,4,4,1, 25642
6,25650,2,4,1, 25654
8,25656,1,1,0, 25657
17,25659,3,3,1, 25662
15,25661,2,2,1, 25663
13,25659,4,6,1, 25665
18,25663,4,4,1, 25667
24,25669,1,1,0, 25670
19,25666,5,5,1, 25671
30,25673,3,3,1, 25676
25,25675,2,2,1, 25677
31,25676,2,2,1, 25678
28,25674,5,5,1, 25679
1,25686,1,1,1, 25687
5,25687,3,5,1, 25692
8,25696,1,1,0, 25697
16,25699,2,2,0, 25701
15,25701,2,2,1, 25703
13,25699,4,6,1, 25705
12,25700,5,5,1, 25705
18,25703,4,4,1, 25707
22,25706,4,4,1, 25710
24,25709,1,1,0, 25710
23,25708,3,3,0, 25711
30,25713,3,3,1, 25716
28,25714,5,5,1, 25719
29,25718,4,4,1, 25722
2,25723,2,2,1, 25725
1,25726,1,1,0, 25727
3,25727,3,3,1, 25730
6,25730,2,4,1, 25734
8,25736,1,1,1, 25737
16,25739,2,2,0, 25741
15,25741,2,2,1, 25743
20,25743,6,6,1, 25749
22,25746,4,4,0, 25750
24,25749,1,1,0, 25750
19,25746,5,5,1, 25751
23,25748,3,3,1, 25751
26,25757,3,3,1, 25760
29,25758,4,4,1, 25762
1,25766,1,1,0, 25767
5,25767,3,5,1, 25772
6,25770,2,4,1, 25774
8,25776,1,1,0, 25777
9,25777,2,2,1, 25779
16,25779,2,2,0, 25781
15,25781,2,2,0, 25783
13,25779,4,6,1, 25785
12,25780,5,5,1, 25785
20,25783,6,6,1, 25789
22,25786,4,4,0, 25790
24,25789,1,1,0, 25790
19,25786,5,5,1, 25791
23,25788,3,3,0, 25791
30,25793,3,3,1, 25796
26,25797,3,3,1, 25800
29,25798,4,4,1, 25802
2,25803,2,2,1, 25805
1,25806,1,1,0, 25807
5,25807,3,5,1, 25812
6,25810,2,4,1, 25814
8,25816,1,1,0, 25817
9,25817,2,2,1, 25819
16,25819,2,2,1, 25821
17,25819,3,3,1, 25822
15,25821,2,2,1, 25823
12,25820,5,5,1, 25825
22,25826,4,4,1, 25830
24,25829,1,1,1, 25830
19,25826,5,5,1, 25831
23,25828,3,3,1, 25831
30,25833,3,3,1, 25836
28,25834,5,5,1, 25839
29,25838,4,4,1, 25842
1,25846,1,1,0, 25847
3,25847,3,3,1, 25850
8,25856,1,1,1, 25857
16,25859,2,2,0, 25861
17,25859,3,3,1, 25862
15,25861,2,2,0, 25863
20,25863,6,6,1, 25869
22,25866,4,4,1, 25870
24,25869,1,1,0, 25870
19,25866,5,5,1, 25871
23,25868,3,3,0, 25871
30,25873,3,3,1, 25876
25,25875,2,2,1, 25877
31,25876,2,2,1, 25878
28,25874,5,5,1, 25879
26,25877,3,3,1, 25880
2,25883,2,2,1, 25885
1,25886,1,1,1, 25887
3,25887,3,3,1, 25890
5,25887,3,5,1, 25892
6,25890,2,4,1, 25894
8,25896,1,1,1, 25897
9,25897,2,2,1, 25899
16,25899,2,2,0, 25901
15,25901,2,2,1, 25903
13,25899,4,6,1, 25905
12,25900,5,5,1, 25905
20,25903,6,6,1, 25909
22,25906,4,4,0, 25910
24,25909,1,1,1, 25910
23,25908,3,3,1, 25911
30,25913,3,3,1, 25916
31,25916,2,2,1, 25918
26,25917,3,3,1, 25920
1,25926,1,1,0, 25927
3,25927,3,3,1, 25930
5,25927,3,5,1, 25932
8,25936,1,1,1, 25937
16,25939,2,2,1, 25941
15,25941,2,2,1, 25943
22,25946,4,4,0, 25950
24,25949,1,1,0, 25950
23,25948,3,3,1, 25951
29,25958,4,4,1, 25962
8,25976,1,1,0, 25977
16,25979,2,2,1, 25981
15,25981,2,2,1, 25983
22,25986,4,4,0, 25990
24,25989,1,1,1, 25990
23,25988,3,3,0, 25991
28,25994,5,5,1, 25999
29,25998,4,4,1, 26002
8,26016,1,1,1, 26017
16,26019,2,2,0, 26021
15,26021,2,2,0, 26023
22,26026,4,4,0, 26030
24,26029,1,1,0, 26030
23,26028,3,3,0, 26031
30,26033,3,3,1, 26036
25,26035,2,2,1, 26037
31,26036,2,2,1, 26038
29,26038,4,4,1, 26042
2,26043,2,2,1, 26045
1,26046,1,1,1, 26047
8,26056,1,1,0, 26057
16,26059,2,2,1, 26061
17,26059,3,3,1, 26062
15,26061,2,2,1, 26063
12,26060,5,5,1, 26065
20,26063,6,6,1, 26069
22,26066,4,4,0, 26070
24,26069,1,1,0, 26070
23,26068,3,3,1, 26071
25,26075,2,2,1, 26077
31,26076,2,2,1, 26078
28,26074,5,5,1, 26079
29,26078,4,4,1, 26082
2,26083,2,2,1, 26085
1,26086,1,1,0, 26087
5,26087,3,5,1, 26092
6,26090,2,4,1, 26094
8,26096,1,1,1, 26097
16,26099,2,2,1, 26101
15,26101,2,2,0, 26103
18,26103,4,4,1, 26107
22,26106,4,4,0, 26110
24,26109,1,1,1, 26110
19,26106,5,5,1, 26111
23,26108,3,3,1, 26111
28,26114,5,5,1, 26119
2,26123,2,2,1, 26125
1,26126,1,1,0, 26127
8,26136,1,1,0, 26137
11,26134,4,4,1, 26138
9,26137,2,2,1, 26139
16,26139,2,2,0, 26141
17,26139,3,3,1, 26142
15,26141,2,2,0, 26143
22,26146,4,4,1, 26150
24,26149,1,1,1, 26150
23,26148,3,3,0, 26151
25,26155,2,2,1, 26157
28,26154,5,5,1, 26159
29,26158,4,4,1, 26162
2,26163,2,2,1, 26165
1,26166,1,1,0, 26167
3,26167,3,3,1, 26170
6,26170,2,4,1, 26174
8,26176,1,1,0, 26177
16,26179,2,2,0, 26181
15,26181,2,2,0, 26183
22,26186,4,4,1, 26190
24,26189,1,1,0, 26190
23,26188,3,3,0, 26191
25,26195,2,2,1, 26197
28,26194,5,5,1, 26199
26,26197,3,3,1, 26200
29,26198,4,4,1, 26202
2,26203,2,2,1, 26205
1,26206,1,1,1, 26207
3,26207,3,3,1, 26210
8,26216,1,1,0, 26217
11,26214,4,4,1, 26218
16,26219,2,2,1, 26221
15,26221,2,2,1, 26223
20,26223,6,6,1, 26229
22,26226,4,4,1, 26230
24,26229,1,1,0, 26230
19,26226,5,5,1, 26231
23,26228,3,3,1, 26231
25,26235,2,2,1, 26237
31,26236,2,2,1, 26238
28,26234,5,5,1, 26239
2,26243,2,2,1, 26245
1,26246,1,1,1, 26247
6,26250,2,4,1, 26254
8,26256,1,1,0, 26257
16,26259,2,2,0, 26261
17,26259,3,3,1, 26262
15,26261,2,2,0, 26263
18,26263,4,4,1, 26267
22,26266,4,4,1, 26270
24,26269,1,1,0, 26270
23,26268,3,3,0, 26271
25,26275,2,2,1, 26277
28,26274,5,5,1, 26279
26,26277,3,3,1, 26280
29,26278,4,4,1, 26282
2,26283,2,2,1, 26285
1,26286,1,1,1, 26287
8,26296,1,1,1, 26297
9,26297,2,2,1, 26299
16,26299,2,2,1, 26301
17,26299,3,3,1, 26302
15,26301,2,2,1, 26303
18,26303,4,4,1, 26307
22,26306,4,4,0, 26310
24,26309,1,1,1, 26310
23,26308,3,3,0, 26311
25,26315,2,2,1, 26317
31,26316,2,2,1, 26318
28,26314,5,5,1, 26319
26,26317,3,3,1, 26320
1,26326,1,1,1, 26327
8,26336,1,1,1, 26337
9,26337,2,2,1, 26339
16,26339,2,2,1, 26341
17,26339,3,3,1, 26342
15,26341,2,2,1, 26343
22,26346,4,4,0, 26350
24,26349,1,1,0, 26350
23,26348,3,3,1, 26351
30,26353,3,3,1, 26356
25,26355,2,2,1, 26357
31,26356,2,2,1, 26358
1,26366,1,1,1, 26367
3,26367,3,3,1, 26370
8,26376,1,1,1, 26377
9,26377,2,2,1, 26379
16,26379,2,2,0, 26381
17,26379,3,3,1, 26382
15,26381,2,2,0, 26383
13,26379,4,6,1, 26385
18,26383,4,4,1, 26387
20,26383,6,6,1, 26389
22,26386,4,4,0, 26390
24,26389,1,1,1, 26390
23,26388,3,3,0, 26391
2,26403,2,2,1, 26405
1,26406,1,1,1, 26407
3,26407,3,3,1, 26410
5,26407,3,5,1, 26412
6,26410,2,4,1, 26414
8,26416,1,1,0, 26417
16,26419,2,2,1, 26421
15,26421,2,2,0, 26423
22,26426,4,4,1, 26430
24,26429,1,1,1, 26430
23,26428,3,3,1, 26431
30,26433,3,3,1, 26436
31,26436,2,2,1, 26438
29,26438,4,4,1, 26442
8,26456,1,1,0, 26457
16,26459,2,2,0, 26461
15,26461,2,2,0, 26463
22,26466,4,4,1, 26470
24,26469,1,1,1, 26470
23,26468,3,3,1, 26471
30,26473,3,3,1, 26476
29,26478,4,4,1, 26482
5,26487,3,5,1, 26492
8,26496,1,1,0, 26497
16,26499,2,2,0, 26501
15,26501,2,2,1, 26503
22,26506,4,4,0, 26510
24,26509,1,1,0, 26510
23,26508,3,3,1, 26511
30,26513,3,3,1, 26516
25,26515,2,2,1, 26517
31,26516,2,2,1, 26518
26,26517,3,3,1, 26520
1,26526,1,1,1, 26527
6,26530,2,4,1, 26534
8,26536,1,1,1, 26537
9,26537,2,2,1, 26539
16,26539,2,2,1, 26541
15,26541,2,2,1, 26543
22,26546,4,4,0, 26550
24,26549,1,1,0, 26550
19,26546,5,5,1, 26551
23,26548,3,3,1, 26551
25,26555,2,2,1, 26557
28,26554,5,5,1, 26559
2,26563,2,2,1, 26565
1,26566,1,1,0, 26567
6,26570,2,4,1, 26574
8,26576,1,1,0, 26577
11,26574,4,4,1, 26578
16,26579,2,2,1, 26581
15,26581,2,2,1, 26583
12,26580,5,5,1, 26585
18,26583,4,4,1, 26587
22,26586,4,4,1, 26590
24,26589,1,1,1, 26590
19,26586,5,5,1, 26591
23,26588,3,3,1, 26591
30,26593,3,3,1, 26596
25,26595,2,2,1, 26597
31,26596,2,2,1, 26598
28,26594,5,5,1, 26599
26,26597,3,3,1, 26600
29,26598,4,4,1, 26602
1,26606,1,1,1, 26607
3,26607,3,3,1, 26610
6,26610,2,4,1, 26614
8,26616,1,1,1, 26617
16,26619,2,2,1, 26621
15,26621,2,2,0, 26623
13,26619,4,6,1, 26625
18,26623,4,4,1, 26627
22,26626,4,4,1, 26630
24,26629,1,1,0, 26630
19,26626,5,5,1, 26631
23,26628,3,3,0, 26631
30,26633,3,3,1, 26636
28,26634,5,5,1, 26639
29,26638,4,4,1, 26642
1,26646,1,1,1, 26647
6,26650,2,4,1, 26654
8,26656,1,1,1, 26657
11,26654,4,4,1, 26658
16,26659,2,2,0, 26661
17,26659,3,3,1, 26662
15,26661,2,2,0, 26663
12,26660,5,5,1, 26665
20,26663,6,6,1, 26669
22,26666,4,4,0, 26670
24,26669,1,1,1, 26670
19,26666,5,5,1, 26671
23,26668,3,3,0, 26671
30,26673,3,3,1, 26676
25,26675,2,2,1, 26677
2,26683,2,2,1, 26685
1,26686,1,1,0, 26687
3,26687,3,3,1, 26690
8,26696,1,1,1, 26697
16,26699,2,2,0, 26701
17,26699,3,3,1, 26702
15,26701,2,2,0, 26703
18,26703,4,4,1, 26707
22,26706,4,4,1, 26710
24,26709,1,1,1, 26710
23,26708,3,3,0, 26711
30,26713,3,3,1, 26716
28,26714,5,5,1, 26719
1,26726,1,1,0, 26727
5,26727,3,5,1, 26732
6,26730,2,4,1, 26734
8,26736,1,1,1, 26737
16,26739,2,2,0, 26741
15,26741,2,2,0, 26743
12,26740,5,5,1, 26745
20,26743,6,6,1, 26749
22,26746,4,4,1, 26750
24,26749,1,1,1, 26750
23,26748,3,3,0, 26751
30,26753,3,3,1, 26756
25,26755,2,2,1, 26757
31,26756,2,2,1, 26758
29,26758,4,4,1, 26762
2,26763,2,2,1, 26765
1,26766,1,1,1, 26767
5,26767,3,5,1, 26772
6,26770,2,4,1, 26774
8,26776,1,1,0, 26777
16,26779,2,2,1, 26781
17,26779,3,3,1, 26782
15,26781,2,2,1, 26783
20,26783,6,6,1, 26789
22,26786,4,4,1, 26790
24,26789,1,1,1, 26790
23,26788,3,3,1, 26791
30,26793,3,3,1, 26796
26,26797,3,3,1, 26800
1,26806,1,1,1, 26807
8,26816,1,1,0, 26817
11,26814,4,4,1, 26818
9,26817,2,2,1, 26819
16,26819,2,2,0, 26821
15,26821,2,2,1, 26823
12,26820,5,5,1, 26825
22,26826,4,4,0, 26830
24,26829,1,1,1, 26830
19,26826,5,5,1, 26831
23,26828,3,3,1, 26831
25,26835,2,2,1, 26837
31,26836,2,2,1, 26838
26,26837,3,3,1, 26840
29,26838,4,4,1, 26842
1,26846,1,1,0, 26847
5,26847,3,5,1, 26852
6,26850,2,4,1, 26854
8,26856,1,1,0, 26857
11,26854,4,4,1, 26858
9,26857,2,2,1, 26859
16,26859,2,2,1, 26861
15,26861,2,2,0, 26863
13,26859,4,6,1, 26865
12,26860,5,5,1, 26865
20,26863,6,6,1, 26869
22,26866,4,4,0, 26870
24,26869,1,1,1, 26870
19,26866,5,5,1, 26871
23,26868,3,3,0, 26871
31,26876,2,2,1, 26878
28,26874,5,5,1, 26879
29,26878,4,4,1, 26882
6,26890,2,4,1, 26894
8,26896,1,1,0, 26897
16,26899,2,2,1, 26901
15,26901,2,2,1, 26903
22,26906,4,4,0, 26910
24,26909,1,1,1, 26910
23,26908,3,3,1, 26911
31,26916,2,2,1, 26918
29,26918,4,4,1, 26922
5,26927,3,5,1, 26932
6,26930,2,4,1, 26934
8,26936,1,1,0, 26937
16,26939,2,2,0, 26941
15,26941,2,2,1, 26943
22,26946,4,4,1, 26950
24,26949,1,1,0, 26950
23,26948,3,3,1, 26951
28,26954,5,5,1, 26959
5,26967,3,5,1, 26972
6,26970,2,4,1, 26974
8,26976,1,1,1, 26977
11,26974,4,4,1, 26978
9,26977,2,2,1, 26979
16,26979,2,2,0, 26981
15,26981,2,2,1, 26983
13,26979,4,6,1, 26985
20,26983,6,6,1, 26989
22,26986,4,4,0, 26990
24,26989,1,1,0, 26990
19,26986,5,5,1, 26991
23,26988,3,3,0, 26991
25,26995,2,2,1, 26997
31,26996,2,2,1, 26998
28,26994,5,5,1, 26999
2,27003,2,2,1, 27005
1,27006,1,1,0, 27007
5,27007,3,5,1, 27012
6,27010,2,4,1, 27014
8,27016,1,1,1, 27017
11,27014,4,4,1, 27018
16,27019,2,2,0, 27021
17,27019,3,3,1, 27022
15,27021,2,2,0, 27023
12,27020,5,5,1, 27025
22,27026,4,4,0, 27030
24,27029,1,1,0, 27030
23,27028,3,3,1, 27031
25,27035,2,2,1, 27037
31,27036,2,2,1, 27038
26,27037,3,3,1, 27040
1,27046,1,1,0, 27047
8,27056,1,1,1, 27057
9,27057,2,2,1, 27059
16,27059,2,2,1, 27061
15,27061,2,2,0, 27063
13,27059,4,6,1, 27065
12,27060,5,5,1, 27065
18,27063,4,4,1, 27067
22,27066,4,4,0, 27070
24,27069,1,1,0, 27070
19,27066,5,5,1, 27071
23,27068,3,3,0, 27071
30,27073,3,3,1, 27076
25,27075,2,2,1, 27077
2,27083,2,2,1, 27085
1,27086,1,1,0, 27087
3,27087,3,3,1, 27090
6,27090,2,4,1, 27094
8,27096,1,1,1, 27097
11,27094,4,4,1, 27098
9,27097,2,2,1, 27099
16,27099,2,2,0, 27101
15,27101,2,2,1, 27103
18,27103,4,4,1, 27107
20,27103,6,6,1, 27109
22,27106,4,4,0, 27110
24,27109,1,1,0, 27110
23,27108,3,3,1, 27111
1,27126,1,1,1, 27127
3,27127,3,3,1, 27130
5,27127,3,5,1, 27132
8,27136,1,1,0, 27137
11,27134,4,4,1, 27138
16,27139,2,2,1, 27141
15,27141,2,2,1, 27143
13,27139,4,6,1, 27145
22,27146,4,4,1, 27150
24,27149,1,1,0, 27150
23,27148,3,3,1, 27151
31,27156,2,2,1, 27158
28,27154,5,5,1, 27159
26,27157,3,3,1, 27160
29,27158,4,4,1, 27162
1,27166,1,1,1, 27167
5,27167,3,5,1, 27172
6,27170,2,4,1, 27174
8,27176,1,1,0, 27177
16,27179,2,2,1, 27181
15,27181,2,2,0, 27183
13,27179,4,6,1, 27185
12,27180,5,5,1, 27185
22,27186,4,4,1, 27190
24,27189,1,1,1, 27190
23,27188,3,3,0, 27191
30,27193,3,3,1, 27196
28,27194,5,5,1, 27199
26,27197,3,3,1, 27200
1,27206,1,1,1, 27207
3,27207,3,3,1, 27210
5,27207,3,5,1, 27212
6,27210,2,4,1, 27214
8,27216,1,1,1, 27217
9,27217,2,2,1, 27219
16,27219,2,2,0, 27221
15,27221,2,2,0, 27223
22,27226,4,4,0, 27230
24,27229,1,1,1, 27230
19,27226,5,5,1, 27231
23,27228,3,3,1, 27231
26,27237,3,3,1, 27240
29,27238,4,4,1, 27242
2,27243,2,2,1, 27245
1,27246,1,1,1, 27247
8,27256,1,1,1, 27257
9,27257,2,2,1, 27259
16,27259,2,2,1, 27261
17,27259,3,3,1, 27262
15,27261,2,2,1, 27263
18,27263,4,4,1, 27267
20,27263,6,6,1, 27269
22,27266,4,4,1, 27270
24,27269,1,1,0, 27270
23,27268,3,3,1, 27271
30,27273,3,3,1, 27276
6,27290,2,4,1, 27294
8,27296,1,1,1, 27297
16,27299,2,2,0, 27301
15,27301,2,2,1, 27303
22,27306,4,4,0, 27310
24,27309,1,1,0, 27310
23,27308,3,3,1, 27311
28,27314,5,5,1, 27319
5,27327,3,5,1, 27332
6,27330,2,4,1, 27334
8,27336,1,1,0, 27337
16,27339,2,2,0, 27341
15,27341,2,2,0, 27343
22,27346,4,4,0, 27350
24,27349,1,1,0, 27350
23,27348,3,3,1, 27351
30,27353,3,3,1, 27356
28,27354,5,5,1, 27359
29,27358,4,4,1, 27362
5,27367,3,5,1, 27372
8,27376,1,1,1, 27377
11,27374,4,4,1, 27378
16,27379,2,2,0, 27381
17,27379,3,3,1, 27382
15,27381,2,2,1, 27383
13,27379,4,6,1, 27385
20,27383,6,6,1, 27389
22,27386,4,4,1, 27390
24,27389,1,1,1, 27390
19,27386,5,5,1, 27391
23,27388,3,3,1, 27391
30,27393,3,3,1, 27396
31,27396,2,2,1, 27398
26,27397,3,3,1, 27400
29,27398,4,4,1, 27402
2,27403,2,2,1, 27405
1,27406,1,1,0, 27407
6,27410,2,4,1, 27414
8,27416,1,1,0, 27417
9,27417,2,2,1, 27419
16,27419,2,2,1, 27421
17,27419,3,3,1, 27422
15,27421,2,2,1, 27423
13,27419,4,6,1, 27425
20,27423,6,6,1, 27429
22,27426,4,4,1, 27430
24,27429,1,1,1, 27430
23,27428,3,3,1, 27431
31,27436,2,2,1, 27438
26,27437,3,3,1, 27440
1,27446,1,1,1, 27447
3,27447,3,3,1, 27450
8,27456,1,1,0, 27457
16,27459,2,2,0, 27461
15,27461,2,2,0, 27463
18,27463,4,4,1, 27467
20,27463,6,6,1, 27469
22,27466,4,4,0, 27470
24,27469,1,1,1, 27470
19,27466,5,5,1, 27471
23,27468,3,3,1, 27471
30,27473,3,3,1, 27476
31,27476,2,2,1, 27478
26,27477,3,3,1, 27480
1,27486,1,1,0, 27487
6,27490,2,4,1, 27494
8,27496,1,1,1, 27497
9,27497,2,2,1, 27499
16,27499,2,2,0, 27501
15,27501,2,2,0, 27503
22,27506,4,4,0, 27510
24,27509,1,1,0, 27510
23,27508,3,3,0, 27511
30,27513,3,3,1, 27516
29,27518,4,4,1, 27522
1,27526,1,1,0, 27527
3,27527,3,3,1, 27530
5,27527,3,5,1, 27532
8,27536,1,1,1, 27537
11,27534,4,4,1, 27538
9,27537,2,2,1, 27539
16,27539,2,2,1, 27541
17,27539,3,3,1, 27542
15,27541,2,2,0, 27543
12,27540,5,5,1, 27545
18,27543,4,4,1, 27547
20,27543,6,6,1, 27549
22,27546,4,4,1, 27550
24,27549,1,1,1, 27550
31,27556,2,2,1, 27558
29,27558,4,4,1, 27562
2,27563,2,2,1, 27565
1,27566,1,1,1, 27567
8,27576,1,1,0, 27577
9,27577,2,2,1, 27579
16,27579,2,2,1, 27581
12,27580,5,5,1, 27585
18,27583,4,4,1, 27587
22,27586,4,4,1, 27590
24,27589,1,1,1, 27590
19,27586,5,5,1, 27591
25,27595,2,2,1, 27597
28,27594,5,5,1, 27599
29,27598,4,4,1, 27602
2,27603,2,2,1, 27605
1,27606,1,1,0, 27607
3,27607,3,3,1, 27610
8,27616,1,1,1, 27617
11,27614,4,4,1, 27618
17,27619,3,3,1, 27622
13,27619,4,6,1, 27625
22,27626,4,4,1, 27630
24,27629,1,1,0, 27630
23,27628,3,3,1, 27631
6,27650,2,4,0, 27654
8,27656,1,1,1, 27657
16,27659,2,2,1, 27661
22,27666,4,4,1, 27670
24,27669,1,1,0, 27670
23,27668,3,3,1, 27671
30,27673,3,3,1, 27676
31,27676,2,2,1, 27678
28,27674,5,5,0, 27679
29,27678,4,4,1, 27682
5,27687,3,5,0, 27692
6,27690,2,4,0, 27694
8,27696,1,1,1, 27697
16,27699,2,2,1, 27701
22,27706,4,4,1, 27710
24,27709,1,1,1, 27710
23,27708,3,3,1, 27711
30,27713,3,3,0, 27716
31,27716,2,2,1, 27718
28,27714,5,5,0, 27719
29,27718,4,4,1, 27722
1,27726,1,1,0, 27727
8,27736,1,1,1, 27737
18,27743,4,4,1, 27747
20,27743,6,6,1, 27749
24,27749,1,1,0, 27750
19,27746,5,5,1, 27751
30,27753,3,3,0, 27756
25,27755,2,2,1, 27757
31,27756,2,2,0, 27758
28,27754,5,5,1, 27759
1,27766,1,1,0, 27767
3,27767,3,3,1, 27770
6,27770,2,4,1, 27774
8,27776,1,1,0, 27777
11,27774,4,4,1, 27778
9,27777,2,2,1, 27779
16,27779,2,2,1, 27781
12,27780,5,5,1, 27785
18,27783,4,4,1, 27787
24,27789,1,1,0, 27790
19,27786,5,5,1, 27791
30,27793,3,3,1, 27796
25,27795,2,2,1, 27797
31,27796,2,2,0, 27798
28,27794,5,5,1, 27799
29,27798,4,4,1, 27802
1,27806,1,1,0, 27807
3,27807,3,3,1, 27810
5,27807,3,5,1, 27812
8,27816,1,1,0, 27817
11,27814,4,4,1, 27818
16,27819,2,2,1, 27821
20,27823,6,6,1, 27829
22,27826,4,4,1, 27830
24,27829,1,1,1, 27830
19,27826,5,5,1, 27831
23,27828,3,3,1, 27831
30,27833,3,3,0, 27836
25,27835,2,2,1, 27837
31,27836,2,2,1, 27838
28,27834,5,5,1, 27839
29,27838,4,4,1, 27842
1,27846,1,1,0, 27847
3,27847,3,3,1, 27850
6,27850,2,4,1, 27854
8,27856,1,1,1, 27857
11,27854,4,4,1, 27858
16,27859,2,2,1, 27861
13,27859,4,6,1, 27865
12,27860,5,5,1, 27865
24,27869,1,1,1, 27870
19,27866,5,5,1, 27871
30,27873,3,3,1, 27876
31,27876,2,2,1, 27878
28,27874,5,5,1, 27879
26,27877,3,3,1, 27880
29,27878,4,4,1, 27882
2,27883,2,2,1, 27885
1,27886,1,1,1, 27887
3,27887,3,3,1, 27890
5,27887,3,5,1, 27892
6,27890,2,4,1, 27894
8,27896,1,1,1, 27897
11,27894,4,4,1, 27898
16,27899,2,2,1, 27901
13,27899,4,6,1, 27905
22,27906,4,4,1, 27910
24,27909,1,1,0, 27910
19,27906,5,5,1, 27911
23,27908,3,3,1, 27911
30,27913,3,3,0, 27916
31,27916,2,2,0, 27918
29,27918,4,4,1, 27922
2,27923,2,2,1, 27925
1,27926,1,1,1, 27927
3,27927,3,3,1, 27930
5,27927,3,5,1, 27932
6,27930,2,4,1, 27934
8,27936,1,1,1, 27937
17,27939,3,3,1, 27942
15,27941,2,2,1, 27943
12,27940,5,5,1, 27945
22,27946,4,4,1, 27950
24,27949,1,1,1, 27950
19,27946,5,5,1, 27951
23,27948,3,3,1, 27951
30,27953,3,3,0, 27956
25,27955,2,2,1, 27957
31,27956,2,2,1, 27958
28,27954,5,5,1, 27959
29,27958,4,4,1, 27962
2,27963,2,2,1, 27965
8,27976,1,1,0, 27977
15,27981,2,2,1, 27983
24,27989,1,1,1, 27990
30,27993,3,3,0, 27996
31,27996,2,2,1, 27998
29,27998,4,4,1, 28002
6,28010,2,4,1, 28014
8,28016,1,1,0, 28017
15,28021,2,2,1, 28023
24,28029,1,1,0, 28030
30,28033,3,3,0, 28036
31,28036,2,2,1, 28038
8,28056,1,1,1, 28057
22,28066,4,4,1, 28070
24,28069,1,1,1, 28070
30,28073,3,3,0, 28076
25,28075,2,2,1, 28077
31,28076,2,2,1, 28078
28,28074,5,5,1, 28079
29,28078,4,4,1, 28082
2,28083,2,2,1, 28085
1,28086,1,1,0, 28087
3,28087,3,3,1, 28090
6,28090,2,4,1, 28094
8,28096,1,1,1, 28097
16,28099,2,2,1, 28101
17,28099,3,3,1, 28102
18,28103,4,4,1, 28107
22,28106,4,4,1, 28110
24,28109,1,1,0, 28110
30,28113,3,3,1, 28116
31,28116,2,2,0, 28118
29,28118,4,4,1, 28122
1,28126,1,1,0, 28127
8,28136,1,1,1, 28137
9,28137,2,2,1, 28139
16,28139,2,2,0, 28141
17,28139,3,3,1, 28142
15,28141,2,2,0, 28143
22,28146,4,4,1, 28150
24,28149,1,1,1, 28150
23,28148,3,3,1, 28151
30,28153,3,3,1, 28156
25,28155,2,2,1, 28157
31,28156,2,2,0, 28158
29,28158,4,4,1, 28162
1,28166,1,1,1, 28167
3,28167,3,3,1, 28170
5,28167,3,5,1, 28172
6,28170,2,4,1, 28174
8,28176,1,1,1, 28177
11,28174,4,4,1, 28178
9,28177,2,2,1, 28179
16,28179,2,2,1, 28181
17,28179,3,3,1, 28182
15,28181,2,2,1, 28183
13,28179,4,6,1, 28185
18,28183,4,4,1, 28187
20,28183,6,6,1, 28189
22,28186,4,4,1, 28190
24,28189,1,1,1, 28190
19,28186,5,5,1, 28191
23,28188,3,3,1, 28191
30,28193,3,3,1, 28196
31,28196,2,2,1, 28198
26,28197,3,3,1, 28200
1,28206,1,1,0, 28207
3,28207,3,3,1, 28210
5,28207,3,5,1, 28212
8,28216,1,1,1, 28217
11,28214,4,4,1, 28218
9,28217,2,2,1, 28219
16,28219,2,2,1, 28221
15,28221,2,2,0, 28223
12,28220,5,5,1, 28225
22,28226,4,4,0, 28230
24,28229,1,1,1, 28230
23,28228,3,3,1, 28231
30,28233,3,3,1, 28236
25,28235,2,2,1, 28237
31,28236,2,2,0, 28238
28,28234,5,5,1, 28239
26,28237,3,3,1, 28240
1,28246,1,1,1, 28247
3,28247,3,3,1, 28250
5,28247,3,5,1, 28252
6,28250,2,4,1, 28254
8,28256,1,1,1, 28257
16,28259,2,2,1, 28261
15,28261,2,2,0, 28263
13,28259,4,6,1, 28265
12,28260,5,5,1, 28265
22,28266,4,4,0, 28270
24,28269,1,1,0, 28270
23,28268,3,3,0, 28271
30,28273,3,3,0, 28276
25,28275,2,2,1, 28277
31,28276,2,2,1, 28278
28,28274,5,5,1, 28279
26,28277,3,3,1, 28280
29,28278,4,4,1, 28282
2,28283,2,2,1, 28285
1,28286,1,1,0, 28287
3,28287,3,3,1, 28290
6,28290,2,4,1, 28294
8,28296,1,1,1, 28297
9,28297,2,2,1, 28299
16,28299,2,2,1, 28301
15,28301,2,2,1, 28303
13,28299,4,6,1, 28305
12,28300,5,5,1, 28305
18,28303,4,4,1, 28307
20,28303,6,6,1, 28309
22,28306,4,4,0, 28310
24,28309,1,1,1, 28310
23,28308,3,3,0, 28311
30,28313,3,3,0, 28316
25,28315,2,2,1, 28317
31,28316,2,2,0, 28318
28,28314,5,5,1, 28319
29,28318,4,4,1, 28322
5,28327,3,5,1, 28332
8,28336,1,1,1, 28337
16,28339,2,2,0, 28341
15,28341,2,2,1, 28343
22,28346,4,4,1, 28350
24,28349,1,1,0, 28350
23,28348,3,3,1, 28351
30,28353,3,3,1, 28356
31,28356,2,2,1, 28358
29,28358,4,4,1, 28362
5,28367,3,5,1, 28372
6,28370,2,4,1, 28374
8,28376,1,1,0, 28377
16,28379,2,2,0, 28381
15,28381,2,2,0, 28383
22,28386,4,4,0, 28390
24,28389,1,1,1, 28390
23,28388,3,3,0, 28391
30,28393,3,3,1, 28396
31,28396,2,2,1, 28398
28,28394,5,5,1, 28399
5,28407,3,5,1, 28412
8,28416,1,1,0, 28417
16,28419,2,2,0, 28421
15,28421,2,2,1, 28423
13,28419,4,6,1, 28425
18,28423,4,4,1, 28427
22,28426,4,4,0, 28430
24,28429,1,1,1, 28430
23,28428,3,3,1, 28431
30,28433,3,3,0, 28436
25,28435,2,2,1, 28437
31,28436,2,2,0, 28438
26,28437,3,3,1, 28440
1,28446,1,1,0, 28447
5,28447,3,5,1, 28452
8,28456,1,1,0, 28457
11,28454,4,4,1, 28458
9,28457,2,2,1, 28459
16,28459,2,2,1, 28461
17,28459,3,3,1, 28462
15,28461,2,2,1, 28463
13,28459,4,6,1, 28465
18,28463,4,4,1, 28467
22,28466,4,4,0, 28470
24,28469,1,1,1, 28470
23,28468,3,3,0, 28471
30,28473,3,3,0, 28476
25,28475,2,2,1, 28477
31,28476,2,2,0, 28478
26,28477,3,3,1, 28480
1,28486,1,1,0, 28487
8,28496,1,1,1, 28497
9,28497,2,2,1, 28499
16,28499,2,2,0, 28501
15,28501,2,2,1, 28503
13,28499,4,6,1, 28505
12,28500,5,5,1, 28505
20,28503,6,6,1, 28509
22,28506,4,4,1, 28510
24,28509,1,1,0, 28510
19,28506,5,5,1, 28511
23,28508,3,3,0, 28511
30,28513,3,3,0, 28516
25,28515,2,2,1, 28517
31,28516,2,2,0, 28518
29,28518,4,4,1, 28522
2,28523,2,2,1, 28525
1,28526,1,1,0, 28527
8,28536,1,1,0, 28537
11,28534,4,4,1, 28538
16,28539,2,2,1, 28541
17,28539,3,3,1, 28542
15,28541,2,2,1, 28543
12,28540,5,5,1, 28545
22,28546,4,4,0, 28550
24,28549,1,1,0, 28550
19,28546,5,5,1, 28551
23,28548,3,3,0, 28551
30,28553,3,3,0, 28556
31,28556,2,2,1, 28558
28,28554,5,5,1, 28559
2,28563,2,2,1, 28565
1,28566,1,1,0, 28567
5,28567,3,5,1, 28572
8,28576,1,1,1, 28577
16,28579,2,2,0, 28581
15,28581,2,2,1, 28583
13,28579,4,6,1, 28585
22,28586,4,4,0, 28590
24,28589,1,1,1, 28590
23,28588,3,3,1, 28591
30,28593,3,3,0, 28596
31,28596,2,2,0, 28598
26,28597,3,3,1, 28600
1,28606,1,1,1, 28607
8,28616,1,1,0, 28617
11,28614,4,4,1, 28618
9,28617,2,2,1, 28619
16,28619,2,2,1, 28621
17,28619,3,3,1, 28622
15,28621,2,2,1, 28623
13,28619,4,6,1, 28625
20,28623,6,6,1, 28629
22,28626,4,4,0, 28630
24,28629,1,1,1, 28630
23,28628,3,3,0, 28631
30,28633,3,3,1, 28636
25,28635,2,2,1, 28637
31,28636,2,2,0, 28638
28,28634,5,5,0, 28639
29,28638,4,4,0, 28642
1,28646,1,1,0, 28647
3,28647,3,3,1, 28650
5,28647,3,5,0, 28652
6,28650,2,4,0, 28654
8,28656,1,1,1, 28657
11,28654,4,4,1, 28658
9,28657,2,2,1, 28659
16,28659,2,2,0, 28661
15,28661,2,2,0, 28663
13,28659,4,6,1, 28665
22,28666,4,4,1, 28670
24,28669,1,1,0, 28670
23,28668,3,3,1, 28671
30,28673,3,3,0, 28676
31,28676,2,2,0, 28678
28,28674,5,5,1, 28679
29,28678,4,4,1, 28682
5,28687,3,5,1, 28692
6,28690,2,4,0, 28694
8,28696,1,1,0, 28697
16,28699,2,2,0, 28701
15,28701,2,2,1, 28703
22,28706,4,4,0, 28710
24,28709,1,1,1, 28710
23,28708,3,3,0, 28711
30,28713,3,3,0, 28716
31,28716,2,2,1, 28718
28,28714,5,5,0, 28719
29,28718,4,4,0, 28722
6,28730,2,4,1, 28734
8,28736,1,1,0, 28737
16,28739,2,2,0, 28741
15,28741,2,2,0, 28743
22,28746,4,4,1, 28750
24,28749,1,1,1, 28750
23,28748,3,3,0, 28751
31,28756,2,2,1, 28758
28,28754,5,5,1, 28759
6,28770,2,4,1, 28774
8,28776,1,1,1, 28777
16,28779,2,2,1, 28781
17,28779,3,3,1, 28782
15,28781,2,2,1, 28783
18,28783,4,4,1, 28787
22,28786,4,4,0, 28790
24,28789,1,1,0, 28790
23,28788,3,3,0, 28791
30,28793,3,3,1, 28796
28,28794,5,5,1, 28799
26,28797,3,3,1, 28800
29,28798,4,4,1, 28802
2,28803,2,2,1, 28805
1,28806,1,1,1, 28807
5,28807,3,5,1, 28812
8,28816,1,1,1, 28817
11,28814,4,4,1, 28818
9,28817,2,2,1, 28819
16,28819,2,2,0, 28821
15,28821,2,2,0, 28823
22,28826,4,4,0, 28830
24,28829,1,1,0, 28830
19,28826,5,5,1, 28831
23,28828,3,3,1, 28831
30,28833,3,3,1, 28836
29,28838,4,4,1, 28842
1,28846,1,1,0, 28847
5,28847,3,5,1, 28852
6,28850,2,4,1, 28854
8,28856,1,1,0, 28857
9,28857,2,2,1, 28859
16,28859,2,2,0, 28861
15,28861,2,2,0, 28863
12,28860,5,5,1, 28865
18,28863,4,4,1, 28867
20,28863,6,6,1, 28869
22,28866,4,4,0, 28870
24,28869,1,1,1, 28870
23,28868,3,3,1, 28871
25,28875,2,2,1, 28877
31,28876,2,2,1, 28878
26,28877,3,3,1, 28880
1,28886,1,1,1, 28887
3,28887,3,3,1, 28890
6,28890,2,4,1, 28894
8,28896,1,1,0, 28897
11,28894,4,4,1, 28898
9,28897,2,2,1, 28899
16,28899,2,2,1, 28901
17,28899,3,3,1, 28902
15,28901,2,2,1, 28903
12,28900,5,5,1, 28905
20,28903,6,6,1, 28909
22,28906,4,4,0, 28910
24,28909,1,1,0, 28910
23,28908,3,3,0, 28911
30,28913,3,3,1, 28916
28,28914,5,5,1, 28919
26,28917,3,3,1, 28920
2,28923,2,2,1, 28925
1,28926,1,1,0, 28927
6,28930,2,4,1, 28934
8,28936,1,1,1, 28937
16,28939,2,2,1, 28941
17,28939,3,3,1, 28942
15,28941,2,2,0, 28943
20,28943,6,6,1, 28949
22,28946,4,4,0, 28950
24,28949,1,1,1, 28950
23,28948,3,3,1, 28951
26,28957,3,3,1, 28960
29,28958,4,4,1, 28962
2,28963,2,2,1, 28965
1,28966,1,1,1, 28967
3,28967,3,3,1, 28970
8,28976,1,1,1, 28977
16,28979,2,2,1, 28981
17,28979,3,3,1, 28982
15,28981,2,2,0, 28983
18,28983,4,4,1, 28987
22,28986,4,4,1, 28990
24,28989,1,1,1, 28990
23,28988,3,3,1, 28991
26,28997,3,3,1, 29000
2,29003,2,2,1, 29005
1,29006,1,1,0, 29007
8,29016,1,1,0, 29017
9,29017,2,2,1, 29019
16,29019,2,2,0, 29021
17,29019,3,3,1, 29022
15,29021,2,2,0, 29023
13,29019,4,6,1, 29025
12,29020,5,5,1, 29025
18,29023,4,4,1, 29027
22,29026,4,4,0, 29030
24,29029,1,1,1, 29030
23,29028,3,3,1, 29031
30,29033,3,3,1, 29036
2,29043,2,2,1, 29045
1,29046,1,1,1, 29047
3,29047,3,3,1, 29050
8,29056,1,1,0, 29057
11,29054,4,4,1, 29058
9,29057,2,2,1, 29059
16,29059,2,2,1, 29061
17,29059,3,3,1, 29062
15,29061,2,2,0, 29063
22,29066,4,4,1, 29070
24,29069,1,1,0, 29070
23,29068,3,3,0, 29071
30,29073,3,3,1, 29076
28,29074,5,5,1, 29079
26,29077,3,3,1, 29080
29,29078,4,4,1, 29082
2,29083,2,2,1, 29085
1,29086,1,1,1, 29087
5,29087,3,5,1, 29092
6,29090,2,4,1, 29094
8,29096,1,1,1, 29097
11,29094,4,4,1, 29098
9,29097,2,2,1, 29099
16,29099,2,2,0, 29101
15,29101,2,2,0, 29103
22,29106,4,4,0, 29110
24,29109,1,1,1, 29110
23,29108,3,3,0, 29111
30,29113,3,3,1, 29116
31,29116,2,2,1, 29118
5,29127,3,5,1, 29132
6,29130,2,4,1, 29134
8,29136,1,1,0, 29137
16,29139,2,2,1, 29141
15,29141,2,2,1, 29143
22,29146,4,4,1, 29150
24,29149,1,1,0, 29150
23,29148,3,3,0, 29151
29,29158,4,4,1, 29162
5,29167,3,5,1, 29172
8,29176,1,1,0, 29177
16,29179,2,2,0, 29181
15,29181,2,2,1, 29183
22,29186,4,4,0, 29190
24,29189,1,1,1, 29190
23,29188,3,3,1, 29191
30,29193,3,3,1, 29196
28,29194,5,5,1, 29199
29,29198,4,4,1, 29202
1,29206,1,1,0, 29207
3,29207,3,3,1, 29210
5,29207,3,5,1, 29212
8,29216,1,1,0, 29217
11,29214,4,4,1, 29218
9,29217,2,2,1, 29219
16,29219,2,2,1, 29221
17,29219,3,3,1, 29222
15,29221,2,2,1, 29223
20,29223,6,6,1, 29229
22,29226,4,4,0, 29230
24,29229,1,1,1, 29230
23,29228,3,3,0, 29231
29,29238,4,4,1, 29242
1,29246,1,1,1, 29247
3,29247,3,3,1, 29250
5,29247,3,5,1, 29252
6,29250,2,4,1, 29254
8,29256,1,1,1, 29257
16,29259,2,2,1, 29261
17,29259,3,3,1, 29262
15,29261,2,2,0, 29263
13,29259,4,6,1, 29265
22,29266,4,4,1, 29270
24,29269,1,1,1, 29270
19,29266,5,5,1, 29271
23,29268,3,3,1, 29271
26,29277,3,3,1, 29280
1,29286,1,1,0, 29287
5,29287,3,5,1, 29292
6,29290,2,4,1, 29294
8,29296,1,1,1, 29297
11,29294,4,4,1, 29298
16,29299,2,2,0, 29301
17,29299,3,3,1, 29302
15,29301,2,2,0, 29303
13,29299,4,6,1, 29305
12,29300,5,5,1, 29305
18,29303,4,4,1, 29307
22,29306,4,4,1, 29310
24,29309,1,1,1, 29310
19,29306,5,5,1, 29311
23,29308,3,3,0, 29311
30,29313,3,3,1, 29316
25,29315,2,2,1, 29317
29,29318,4,4,1, 29322
1,29326,1,1,0, 29327
3,29327,3,3,1, 29330
8,29336,1,1,0, 29337
11,29334,4,4,1, 29338
9,29337,2,2,1, 29339
16,29339,2,2,0, 29341
15,29341,2,2,1, 29343
13,29339,4,6,1, 29345
22,29346,4,4,0, 29350
24,29349,1,1,1, 29350
23,29348,3,3,0, 29351
30,29353,3,3,1, 29356
31,29356,2,2,1, 29358
29,29358,4,4,1, 29362
1,29366,1,1,1, 29367
5,29367,3,5,1, 29372
8,29376,1,1,0, 29377
9,29377,2,2,1, 29379
16,29379,2,2,1, 29381
17,29379,3,3,1, 29382
15,29381,2,2,0, 29383
22,29386,4,4,1, 29390
24,29389,1,1,1, 29390
23,29388,3,3,1, 29391
31,29396,2,2,1, 29398
29,29398,4,4,1, 29402
1,29406,1,1,1, 29407
6,29410,2,4,1, 29414
8,29416,1,1,1, 29417
9,29417,2,2,1, 29419
16,29419,2,2,1, 29421
15,29421,2,2,1, 29423
22,29426,4,4,0, 29430
24,29429,1,1,0, 29430
23,29428,3,3,0, 29431
30,29433,3,3,1, 29436
25,29435,2,2,1, 29437
28,29434,5,5,1, 29439
1,29446,1,1,1, 29447
5,29447,3,5,1, 29452
8,29456,1,1,0, 29457
11,29454,4,4,1, 29458
9,29457,2,2,1, 29459
16,29459,2,2,1, 29461
17,29459,3,3,1, 29462
15,29461,2,2,1, 29463
13,29459,4,6,1, 29465
12,29460,5,5,1, 29465
18,29463,4,4,1, 29467
20,29463,6,6,1, 29469
22,29466,4,4,1, 29470
24,29469,1,1,0, 29470
23,29468,3,3,0, 29471
28,29474,5,5,1, 29479
2,29483,2,2,1, 29485
1,29486,1,1,1, 29487
3,29487,3,3,1, 29490
5,29487,3,5,1, 29492
6,29490,2,4,1, 29494
8,29496,1,1,1, 29497
11,29494,4,4,1, 29498
9,29497,2,2,1, 29499
16,29499,2,2,0, 29501
15,29501,2,2,0, 29503
13,29499,4,6,1, 29505
18,29503,4,4,1, 29507
22,29506,4,4,1, 29510
24,29509,1,1,0, 29510
19,29506,5,5,1, 29511
23,29508,3,3,1, 29511
30,29513,3,3,1, 29516
31,29516,2,2,1, 29518
28,29514,5,5,1, 29519
29,29518,4,4,1, 29522
2,29523,2,2,1, 29525
1,29526,1,1,0, 29527
3,29527,3,3,1, 29530
5,29527,3,5,1, 29532
6,29530,2,4,1, 29534
8,29536,1,1,0, 29537
11,29534,4,4,1, 29538
16,29539,2,2,0, 29541
17,29539,3,3,1, 29542
15,29541,2,2,1, 29543
22,29546,4,4,1, 29550
24,29549,1,1,0, 29550
23,29548,3,3,1, 29551
31,29556,2,2,1, 29558
28,29554,5,5,1, 29559
6,29570,2,4,1, 29574
8,29576,1,1,1, 29577
16,29579,2,2,1, 29581
15,29581,2,2,1, 29583
22,29586,4,4,1, 29590
24,29589,1,1,0, 29590
23,29588,3,3,0, 29591
30,29593,3,3,1, 29596
31,29596,2,2,1, 29598
28,29594,5,5,1, 29599
29,29598,4,4,1, 29602
5,29607,3,5,1, 29612
8,29616,1,1,0, 29617
16,29619,2,2,1, 29621
15,29621,2,2,1, 29623
22,29626,4,4,0, 29630
24,29629,1,1,0, 29630
23,29628,3,3,0, 29631
31,29636,2,2,1, 29638
29,29638,4,4,1, 29642
1,29646,1,1,1, 29647
5,29647,3,5,1, 29652
6,29650,2,4,1, 29654
8,29656,1,1,0, 29657
9,29657,2,2,1, 29659
16,29659,2,2,0, 29661
17,29659,3,3,1, 29662
15,29661,2,2,1, 29663
12,29660,5,5,1, 29665
18,29663,4,4,1, 29667
22,29666,4,4,1, 29670
24,29669,1,1,1, 29670
23,29668,3,3,1, 29671
29,29678,4,4,1, 29682
1,29686,1,1,0, 29687
3,29687,3,3,1, 29690
6,29690,2,4,1, 29694
8,29696,1,1,1, 29697
11,29694,4,4,1, 29698
9,29697,2,2,1, 29699
16,29699,2,2,0, 29701
17,29699,3,3,1, 29702
15,29701,2,2,1, 29703
13,29699,4,6,1, 29705
12,29700,5,5,1, 29705
18,29703,4,4,1, 29707
22,29706,4,4,1, 29710
24,29709,1,1,1, 29710
19,29706,5,5,1, 29711
23,29708,3,3,1, 29711
30,29713,3,3,1, 29716
29,29718,4,4,1, 29722
1,29726,1,1,0, 29727
5,29727,3,5,1, 29732
6,29730,2,4,1, 29734
8,29736,1,1,0, 29737
16,29739,2,2,0, 29741
15,29741,2,2,1, 29743
13,29739,4,6,1, 29745
20,29743,6,6,1, 29749
22,29746,4,4,1, 29750
24,29749,1,1,1, 29750
23,29748,3,3,1, 29751
25,29755,2,2,1, 29757
28,29754,5,5,1, 29759
1,29766,1,1,1, 29767
5,29767,3,5,1, 29772
6,29770,2,4,1, 29774
8,29776,1,1,1, 29777
9,29777,2,2,1, 29779
16,29779,2,2,0, 29781
15,29781,2,2,0, 29783
12,29780,5,5,1, 29785
22,29786,4,4,0, 29790
24,29789,1,1,1, 29790
23,29788,3,3,0, 29791
30,29793,3,3,1, 29796
28,29794,5,5,1, 29799
26,29797,3,3,1, 29800
2,29803,2,2,1, 29805
1,29806,1,1,0, 29807
5,29807,3,5,1, 29812
8,29816,1,1,1, 29817
11,29814,4,4,1, 29818
9,29817,2,2,1, 29819
16,29819,2,2,1, 29821
15,29821,2,2,0, 29823
13,29819,4,6,1, 29825
12,29820,5,5,1, 29825
20,29823,6,6,1, 29829
22,29826,4,4,0, 29830
24,29829,1,1,0, 29830
23,29828,3,3,0, 29831
30,29833,3,3,1, 29836
25,29835,2,2,1, 29837
26,29837,3,3,1, 29840
1,29846,1,1,1, 29847
6,29850,2,4,1, 29854
8,29856,1,1,0, 29857
11,29854,4,4,1, 29858
16,29859,2,2,0, 29861
17,29859,3,3,1, 29862
15,29861,2,2,0, 29863
18,29863,4,4,1, 29867
22,29866,4,4,1, 29870
24,29869,1,1,0, 29870
19,29866,5,5,1, 29871
23,29868,3,3,0, 29871
28,29874,5,5,1, 29879
26,29877,3,3,1, 29880
2,29883,2,2,1, 29885
1,29886,1,1,1, 29887
3,29887,3,3,1, 29890
6,29890,2,4,1, 29894
8,29896,1,1,1, 29897
16,29899,2,2,0, 29901
17,29899,3,3,1, 29902
15,29901,2,2,0, 29903
18,29903,4,4,1, 29907
22,29906,4,4,1, 29910
24,29909,1,1,1, 29910
23,29908,3,3,0, 29911
29,29918,4,4,1, 29922
1,29926,1,1,0, 29927
3,29927,3,3,1, 29930
6,29930,2,4,1, 29934
8,29936,1,1,0, 29937
15,29941,2,2,1, 29943
12,29940,5,5,1, 29945
20,29943,6,6,1, 29949
22,29946,4,4,1, 29950
24,29949,1,1,1, 29950
23,29948,3,3,1, 29951
30,29953,3,3,1, 29956
25,29955,2,2,1, 29957
31,29956,2,2,1, 29958
2,29963,2,2,1, 29965
1,29966,1,1,1, 29967
3,29967,3,3,1, 29970
5,29967,3,5,1, 29972
6,29970,2,4,1, 29974
8,29976,1,1,1, 29977
12,29980,5,5,1, 29985
24,29989,1,1,0, 29990
25,29995,2,2,1, 29997
28,29994,5,5,1, 29999
29,29998,4,4,1, 30002
2,30003,2,2,1, 30005
1,30006,1,1,1, 30007
5,30007,3,5,1, 30012
8,30016,1,1,1, 30017
9,30017,2,2,1, 30019
16,30019,2,2,1, 30021
17,30019,3,3,1, 30022
13,30019,4,6,1, 30025
18,30023,4,4,1, 30027
22,30026,4,4,1, 30030
24,30029,1,1,1, 30030
31,30036,2,2,1, 30038
28,30034,5,5,1, 30039
6,30050,2,4,1, 30054
8,30056,1,1,1, 30057
15,30061,2,2,1, 30063
24,30069,1,1,1, 30070
6,30090,2,4,1, 30094
8,30096,1,1,1, 30097
15,30101,2,2,1, 30103
22,30106,4,4,1, 30110
24,30109,1,1,1, 30110
23,30108,3,3,1, 30111
8,30136,1,1,1, 30137
9,30137,2,2,1, 30139
18,30143,4,4,1, 30147
22,30146,4,4,1, 30150
24,30149,1,1,0, 30150
19,30146,5,5,1, 30151
28,30154,5,5,1, 30159
26,30157,3,3,1, 30160
1,30166,1,1,0, 30167
8,30176,1,1,0, 30177
16,30179,2,2,1, 30181
13,30179,4,6,1, 30185
12,30180,5,5,1, 30185
20,30183,6,6,1, 30189
24,30189,1,1,0, 30190
23,30188,3,3,1, 30191
25,30195,2,2,1, 30197
31,30196,2,2,1, 30198
29,30198,4,4,1, 30202
2,30203,2,2,1, 30205
1,30206,1,1,1, 30207
8,30216,1,1,1, 30217
11,30214,4,4,1, 30218
17,30219,3,3,1, 30222
13,30219,4,6,1, 30225
12,30220,5,5,1, 30225
18,30223,4,4,1, 30227
22,30226,4,4,1, 30230
24,30229,1,1,1, 30230
23,30228,3,3,1, 30231
30,30233,3,3,1, 30236
31,30236,2,2,1, 30238
26,30237,3,3,1, 30240
2,30243,2,2,1, 30245
1,30246,1,1,1, 30247
3,30247,3,3,1, 30250
8,30256,1,1,1, 30257
16,30259,2,2,1, 30261
17,30259,3,3,1, 30262
13,30259,4,6,1, 30265
20,30263,6,6,1, 30269
24,30269,1,1,0, 30270
28,30274,5,5,1, 30279
26,30277,3,3,1, 30280
29,30278,4,4,1, 30282
1,30286,1,1,1, 30287
3,30287,3,3,1, 30290
6,30290,2,4,1, 30294
8,30296,1,1,0, 30297
9,30297,2,2,1, 30299
16,30299,2,2,1, 30301
13,30299,4,6,1, 30305
18,30303,4,4,1, 30307
24,30309,1,1,1, 30310
19,30306,5,5,1, 30311
23,30308,3,3,1, 30311
30,30313,3,3,1, 30316
25,30315,2,2,1, 30317
28,30314,5,5,1, 30319
26,30317,3,3,1, 30320
29,30318,4,4,1, 30322
1,30326,1,1,1, 30327
6,30330,2,4,1, 30334
8,30336,1,1,1, 30337
17,30339,3,3,1, 30342
15,30341,2,2,1, 30343
13,30339,4,6,1, 30345
12,30340,5,5,1, 30345
18,30343,4,4,1, 30347
20,30343,6,6,1, 30349
24,30349,1,1,1, 30350
30,30353,3,3,1, 30356
25,30355,2,2,1, 30357
28,30354,5,5,1, 30359
1,30366,1,1,1, 30367
6,30370,2,4,1, 30374
8,30376,1,1,0, 30377
9,30377,2,2,1, 30379
16,30379,2,2,1, 30381
17,30379,3,3,1, 30382
15,30381,2,2,1, 30383
24,30389,1,1,1, 30390
30,30393,3,3,1, 30396
25,30395,2,2,1, 30397
31,30396,2,2,1, 30398
28,30394,5,5,1, 30399
1,30406,1,1,0, 30407
5,30407,3,5,1, 30412
8,30416,1,1,0, 30417
16,30419,2,2,1, 30421
24,30429,1,1,1, 30430
31,30436,2,2,1, 30438
28,30434,5,5,1, 30439
29,30438,4,4,1, 30442
1,30446,1,1,1, 30447
5,30447,3,5,1, 30452
6,30450,2,4,1, 30454
8,30456,1,1,0, 30457
9,30457,2,2,1, 30459
16,30459,2,2,1, 30461
20,30463,6,6,1, 30469
24,30469,1,1,0, 30470
19,30466,5,5,1, 30471
23,30468,3,3,1, 30471
25,30475,2,2,1, 30477
28,30474,5,5,1, 30479
26,30477,3,3,1, 30480
2,30483,2,2,1, 30485
1,30486,1,1,1, 30487
8,30496,1,1,0, 30497
11,30494,4,4,1, 30498
9,30497,2,2,1, 30499
16,30499,2,2,0, 30501
15,30501,2,2,1, 30503
13,30499,4,6,1, 30505
12,30500,5,5,1, 30505
18,30503,4,4,1, 30507
20,30503,6,6,1, 30509
22,30506,4,4,1, 30510
24,30509,1,1,0, 30510
23,30508,3,3,0, 30511
29,30518,4,4,1, 30522
6,30530,2,4,0, 30534
8,30536,1,1,0, 30537
16,30539,2,2,1, 30541
15,30541,2,2,1, 30543
22,30546,4,4,0, 30550
24,30549,1,1,1, 30550
23,30548,3,3,0, 30551
30,30553,3,3,0, 30556
31,30556,2,2,0, 30558
28,30554,5,5,0, 30559
29,30558,4,4,1, 30562
5,30567,3,5,0, 30572
6,30570,2,4,1, 30574
8,30576,1,1,0, 30577
16,30579,2,2,1, 30581
15,30581,2,2,0, 30583
22,30586,4,4,1, 30590
24,30589,1,1,1, 30590
23,30588,3,3,0, 30591
30,30593,3,3,1, 30596
31,30596,2,2,0, 30598
28,30594,5,5,0, 30599
29,30598,4,4,0, 30602
5,30607,3,5,1, 30612
6,30610,2,4,1, 30614
8,30616,1,1,0, 30617
11,30614,4,4,1, 30618
16,30619,2,2,1, 30621
15,30621,2,2,0, 30623
13,30619,4,6,1, 30625
22,30626,4,4,1, 30630
24,30629,1,1,1, 30630
23,30628,3,3,1, 30631
30,30633,3,3,0, 30636
31,30636,2,2,0, 30638
28,30634,5,5,1, 30639
29,30638,4,4,0, 30642
1,30646,1,1,1, 30647
3,30647,3,3,1, 30650
5,30647,3,5,0, 30652
6,30650,2,4,1, 30654
8,30656,1,1,0, 30657
16,30659,2,2,1, 30661
15,30661,2,2,0, 30663
13,30659,4,6,1, 30665
12,30660,5,5,1, 30665
20,30663,6,6,1, 30669
22,30666,4,4,0, 30670
24,30669,1,1,0, 30670
23,30668,3,3,0, 30671
30,30673,3,3,0, 30676
31,30676,2,2,0, 30678
28,30674,5,5,0, 30679
29,30678,4,4,0, 30682
1,30686,1,1,1, 30687
5,30687,3,5,1, 30692
6,30690,2,4,1, 30694
8,30696,1,1,1, 30697
16,30699,2,2,0, 30701
15,30701,2,2,1, 30703
12,30700,5,5,1, 30705
18,30703,4,4,1, 30707
22,30706,4,4,0, 30710
24,30709,1,1,0, 30710
19,30706,5,5,1, 30711
23,30708,3,3,1, 30711
30,30713,3,3,1, 30716
25,30715,2,2,1, 30717
31,30716,2,2,0, 30718
28,30714,5,5,0, 30719
29,30718,4,4,1, 30722
2,30723,2,2,1, 30725
1,30726,1,1,0, 30727
3,30727,3,3,1, 30730
5,30727,3,5,1, 30732
6,30730,2,4,1, 30734
8,30736,1,1,0, 30737
11,30734,4,4,1, 30738
9,30737,2,2,1, 30739
16,30739,2,2,1, 30741
15,30741,2,2,1, 30743
13,30739,4,6,1, 30745
12,30740,5,5,1, 30745
22,30746,4,4,0, 30750
24,30749,1,1,1, 30750
23,30748,3,3,0, 30751
30,30753,3,3,1, 30756
25,30755,2,2,1, 30757
31,30756,2,2,1, 30758
28,30754,5,5,1, 30759
26,30757,3,3,1, 30760
29,30758,4,4,1, 30762
1,30766,1,1,0, 30767
3,30767,3,3,1, 30770
5,30767,3,5,0, 30772
6,30770,2,4,1, 30774
8,30776,1,1,1, 30777
16,30779,2,2,1, 30781
17,30779,3,3,1, 30782
15,30781,2,2,0, 30783
12,30780,5,5,1, 30785
18,30783,4,4,1, 30787
22,30786,4,4,1, 30790
24,30789,1,1,1, 30790
19,30786,5,5,1, 30791
23,30788,3,3,1, 30791
30,30793,3,3,0, 30796
25,30795,2,2,1, 30797
31,30796,2,2,1, 30798
28,30794,5,5,1, 30799
29,30798,4,4,1, 30802
1,30806,1,1,1, 30807
3,30807,3,3,1, 30810
5,30807,3,5,1, 30812
6,30810,2,4,0, 30814
8,30816,1,1,0, 30817
11,30814,4,4,1, 30818
9,30817,2,2,1, 30819
16,30819,2,2,1, 30821
17,30819,3,3,1, 30822
15,30821,2,2,0, 30823
22,30826,4,4,1, 30830
24,30829,1,1,0, 30830
23,30828,3,3,0, 30831
30,30833,3,3,1, 30836
31,30836,2,2,0, 30838
28,30834,5,5,0, 30839
26,30837,3,3,1, 30840
29,30838,4,4,1, 30842
2,30843,2,2,1, 30845
1,30846,1,1,1, 30847
3,30847,3,3,1, 30850
5,30847,3,5,0, 30852
6,30850,2,4,1, 30854
8,30856,1,1,1, 30857
11,30854,4,4,1, 30858
16,30859,2,2,1, 30861
15,30861,2,2,1, 30863
20,30863,6,6,1, 30869
22,30866,4,4,0, 30870
24,30869,1,1,1, 30870
19,30866,5,5,1, 30871
23,30868,3,3,1, 30871
30,30873,3,3,1, 30876
31,30876,2,2,1, 30878
28,30874,5,5,0, 30879
29,30878,4,4,1, 30882
1,30886,1,1,1, 30887
3,30887,3,3,1, 30890
5,30887,3,5,1, 30892
6,30890,2,4,1, 30894
8,30896,1,1,0, 30897
9,30897,2,2,1, 30899
16,30899,2,2,0, 30901
17,30899,3,3,1, 30902
15,30901,2,2,0, 30903
20,30903,6,6,1, 30909
22,30906,4,4,0, 30910
24,30909,1,1,1, 30910
23,30908,3,3,0, 30911
30,30913,3,3,1, 30916
31,30916,2,2,0, 30918
28,30914,5,5,1, 30919
29,30918,4,4,0, 30922
2,30923,2,2,1, 30925
1,30926,1,1,0, 30927
5,30927,3,5,1, 30932
6,30930,2,4,1, 30934
8,30936,1,1,0, 30937
16,30939,2,2,1, 30941
15,30941,2,2,0, 30943
13,30939,4,6,1, 30945
18,30943,4,4,1, 30947
20,30943,6,6,1, 30949
22,30946,4,4,1, 30950
24,30949,1,1,1, 30950
19,30946,5,5,1, 30951
23,30948,3,3,1, 30951
25,30955,2,2,1, 30957
28,30954,5,5,1, 30959
26,30957,3,3,1, 30960
29,30958,4,4,1, 30962
5,30967,3,5,1, 30972
6,30970,2,4,1, 30974
8,30976,1,1,1, 30977
16,30979,2,2,0, 30981
15,30981,2,2,0, 30983
22,30986,4,4,0, 30990
24,30989,1,1,0, 30990
23,30988,3,3,1, 30991
31,30996,2,2,1, 30998
28,30994,5,5,1, 30999
5,31007,3,5,1, 31012
8,31016,1,1,1, 31017
16,31019,2,2,1, 31021
15,31021,2,2,1, 31023
22,31026,4,4,0, 31030
24,31029,1,1,0, 31030
23,31028,3,3,0, 31031
30,31033,3,3,1, 31036
29,31038,4,4,1, 31042
8,31056,1,1,1, 31057
16,31059,2,2,0, 31061
15,31061,2,2,0, 31063
13,31059,4,6,1, 31065
18,31063,4,4,1, 31067
22,31066,4,4,0, 31070
24,31069,1,1,1, 31070
23,31068,3,3,0, 31071
25,31075,2,2,1, 31077
28,31074,5,5,1, 31079
26,31077,3,3,1, 31080
1,31086,1,1,0, 31087
3,31087,3,3,1, 31090
6,31090,2,4,1, 31094
8,31096,1,1,1, 31097
11,31094,4,4,1, 31098
9,31097,2,2,1, 31099
16,31099,2,2,1, 31101
15,31101,2,2,0, 31103
18,31103,4,4,1, 31107
22,31106,4,4,0, 31110
24,31109,1,1,1, 31110
19,31106,5,5,1, 31111
23,31108,3,3,0, 31111
30,31113,3,3,1, 31116
31,31116,2,2,1, 31118
26,31117,3,3,1, 31120
1,31126,1,1,0, 31127
8,31136,1,1,1, 31137
9,31137,2,2,1, 31139
16,31139,2,2,0, 31141
15,31141,2,2,0, 31143
12,31140,5,5,1, 31145
22,31146,4,4,1, 31150
24,31149,1,1,0, 31150
19,31146,5,5,1, 31151
23,31148,3,3,1, 31151
28,31154,5,5,1, 31159
26,31157,3,3,1, 31160
29,31158,4,4,1, 31162
1,31166,1,1,0, 31167
3,31167,3,3,1, 31170
8,31176,1,1,0, 31177
16,31179,2,2,0, 31181
17,31179,3,3,1, 31182
15,31181,2,2,0, 31183
13,31179,4,6,1, 31185
22,31186,4,4,1, 31190
24,31189,1,1,1, 31190
23,31188,3,3,0, 31191
25,31195,2,2,1, 31197
31,31196,2,2,1, 31198
28,31194,5,5,1, 31199
26,31197,3,3,1, 31200
1,31206,1,1,0, 31207
6,31210,2,4,1, 31214
8,31216,1,1,0, 31217
11,31214,4,4,1, 31218
9,31217,2,2,1, 31219
16,31219,2,2,1, 31221
17,31219,3,3,1, 31222
15,31221,2,2,0, 31223
13,31219,4,6,1, 31225
18,31223,4,4,1, 31227
22,31226,4,4,0, 31230
24,31229,1,1,0, 31230
23,31228,3,3,0, 31231
30,31233,3,3,1, 31236
31,31236,2,2,1, 31238
26,31237,3,3,1, 31240
29,31238,4,4,1, 31242
1,31246,1,1,0, 31247
3,31247,3,3,1, 31250
6,31250,2,4,1, 31254
8,31256,1,1,0, 31257
11,31254,4,4,1, 31258
16,31259,2,2,0, 31261
15,31261,2,2,0, 31263
13,31259,4,6,1, 31265
12,31260,5,5,1, 31265
18,31263,4,4,1, 31267
22,31266,4,4,0, 31270
24,31269,1,1,0, 31270
23,31268,3,3,0, 31271
30,31273,3,3,1, 31276
25,31275,2,2,1, 31277
28,31274,5,5,1, 31279
2,31283,2,2,1, 31285
1,31286,1,1,1, 31287
3,31287,3,3,1, 31290
6,31290,2,4,1, 31294
8,31296,1,1,1, 31297
16,31299,2,2,0, 31301
15,31301,2,2,0, 31303
13,31299,4,6,1, 31305
12,31300,5,5,1, 31305
20,31303,6,6,1, 31309
22,31306,4,4,0, 31310
24,31309,1,1,1, 31310
23,31308,3,3,0, 31311
30,31313,3,3,1, 31316
25,31315,2,2,1, 31317
28,31314,5,5,1, 31319
5,31327,3,5,1, 31332
6,31330,2,4,1, 31334
8,31336,1,1,0, 31337
16,31339,2,2,0, 31341
15,31341,2,2,0, 31343
22,31346,4,4,1, 31350
24,31349,1,1,1, 31350
23,31348,3,3,0, 31351
30,31353,3,3,1, 31356
31,31356,2,2,1, 31358
28,31354,5,5,1, 31359
5,31367,3,5,1, 31372
8,31376,1,1,0, 31377
16,31379,2,2,1, 31381
15,31381,2,2,1, 31383
22,31386,4,4,0, 31390
24,31389,1,1,0, 31390
23,31388,3,3,1, 31391
30,31393,3,3,1, 31396
31,31396,2,2,1, 31398
28,31394,5,5,1, 31399
29,31398,4,4,1, 31402
5,31407,3,5,1, 31412
6,31410,2,4,1, 31414
8,31416,1,1,0, 31417
16,31419,2,2,1, 31421
15,31421,2,2,0, 31423
13,31419,4,6,1, 31425
12,31420,5,5,1, 31425
22,31426,4,4,1, 31430
24,31429,1,1,0, 31430
23,31428,3,3,1, 31431
30,31433,3,3,1, 31436
31,31436,2,2,1, 31438
29,31438,4,4,1, 31442
2,31443,2,2,1, 31445
1,31446,1,1,1, 31447
3,31447,3,3,1, 31450
6,31450,2,4,1, 31454
8,31456,1,1,1, 31457
9,31457,2,2,1, 31459
16,31459,2,2,0, 31461
17,31459,3,3,1, 31462
15,31461,2,2,1, 31463
13,31459,4,6,1, 31465
12,31460,5,5,1, 31465
20,31463,6,6,1, 31469
22,31466,4,4,0, 31470
24,31469,1,1,1, 31470
23,31468,3,3,0, 31471
30,31473,3,3,1, 31476
31,31476,2,2,1, 31478
28,31474,5,5,1, 31479
26,31477,3,3,1, 31480
29,31478,4,4,1, 31482
2,31483,2,2,1, 31485
1,31486,1,1,0, 31487
3,31487,3,3,1, 31490
6,31490,2,4,1, 31494
8,31496,1,1,0, 31497
9,31497,2,2,1, 31499
16,31499,2,2,0, 31501
15,31501,2,2,1, 31503
20,31503,6,6,1, 31509
22,31506,4,4,0, 31510
24,31509,1,1,0, 31510
23,31508,3,3,0, 31511
30,31513,3,3,1, 31516
28,31514,5,5,1, 31519
1,31526,1,1,1, 31527
6,31530,2,4,1, 31534
8,31536,1,1,1, 31537
9,31537,2,2,1, 31539
16,31539,2,2,0, 31541
15,31541,2,2,0, 31543
22,31546,4,4,0, 31550
24,31549,1,1,0, 31550
23,31548,3,3,0, 31551
25,31555,2,2,1, 31557
29,31558,4,4,1, 31562
1,31566,1,1,0, 31567
5,31567,3,5,1, 31572
6,31570,2,4,1, 31574
8,31576,1,1,1, 31577
9,31577,2,2,1, 31579
16,31579,2,2,0, 31581
17,31579,3,3,1, 31582
15,31581,2,2,0, 31583
22,31586,4,4,0, 31590
24,31589,1,1,0, 31590
23,31588,3,3,0, 31591
25,31595,2,2,1, 31597
31,31596,2,2,1, 31598
29,31598,4,4,1, 31602
1,31606,1,1,1, 31607
5,31607,3,5,1, 31612
8,31616,1,1,1, 31617
11,31614,4,4,1, 31618
9,31617,2,2,1, 31619
16,31619,2,2,1, 31621
17,31619,3,3,1, 31622
15,31621,2,2,0, 31623
13,31619,4,6,1, 31625
12,31620,5,5,1, 31625
18,31623,4,4,1, 31627
22,31626,4,4,1, 31630
24,31629,1,1,0, 31630
23,31628,3,3,0, 31631
30,31633,3,3,1, 31636
25,31635,2,2,1, 31637
28,31634,5,5,1, 31639
1,31646,1,1,1, 31647
3,31647,3,3,1, 31650
5,31647,3,5,1, 31652
8,31656,1,1,0, 31657
16,31659,2,2,1, 31661
17,31659,3,3,1, 31662
15,31661,2,2,1, 31663
12,31660,5,5,1, 31665
18,31663,4,4,1, 31667
22,31666,4,4,1, 31670
24,31669,1,1,1, 31670
23,31668,3,3,0, 31671
25,31675,2,2,1, 31677
28,31674,5,5,1, 31679
1,31686,1,1,1, 31687
5,31687,3,5,1, 31692
6,31690,2,4,1, 31694
8,31696,1,1,1, 31697
11,31694,4,4,1, 31698
16,31699,2,2,0, 31701
15,31701,2,2,1, 31703
20,31703,6,6,1, 31709
22,31706,4,4,0, 31710
24,31709,1,1,1, 31710
19,31706,5,5,1, 31711
23,31708,3,3,0, 31711
25,31715,2,2,1, 31717
31,31716,2,2,1, 31718
2,31723,2,2,1, 31725
1,31726,1,1,1, 31727
6,31730,2,4,1, 31734
8,31736,1,1,0, 31737
11,31734,4,4,1, 31738
16,31739,2,2,0, 31741
17,31739,3,3,1, 31742
15,31741,2,2,1, 31743
12,31740,5,5,1, 31745
20,31743,6,6,1, 31749
22,31746,4,4,0, 31750
24,31749,1,1,0, 31750
23,31748,3,3,0, 31751
25,31755,2,2,1, 31757
31,31756,2,2,1, 31758
28,31754,5,5,1, 31759
29,31758,4,4,1, 31762
1,31766,1,1,0, 31767
3,31767,3,3,1, 31770
8,31776,1,1,1, 31777
9,31777,2,2,1, 31779
16,31779,2,2,0, 31781
17,31779,3,3,1, 31782
15,31781,2,2,0, 31783
22,31786,4,4,0, 31790
24,31789,1,1,1, 31790
23,31788,3,3,0, 31791
30,31793,3,3,1, 31796
26,31797,3,3,1, 31800
29,31798,4,4,1, 31802
1,31806,1,1,1, 31807
3,31807,3,3,1, 31810
5,31807,3,5,1, 31812
8,31816,1,1,1, 31817
9,31817,2,2,1, 31819
16,31819,2,2,0, 31821
15,31821,2,2,0, 31823
22,31826,4,4,0, 31830
24,31829,1,1,1, 31830
23,31828,3,3,0, 31831
30,31833,3,3,1, 31836
28,31834,5,5,1, 31839
1,31846,1,1,0, 31847
3,31847,3,3,1, 31850
5,31847,3,5,1, 31852
8,31856,1,1,0, 31857
11,31854,4,4,1, 31858
9,31857,2,2,1, 31859
16,31859,2,2,1, 31861
15,31861,2,2,1, 31863
20,31863,6,6,1, 31869
22,31866,4,4,1, 31870
24,31869,1,1,1, 31870
19,31866,5,5,1, 31871
23,31868,3,3,1, 31871
30,31873,3,3,1, 31876
25,31875,2,2,1, 31877
29,31878,4,4,1, 31882
2,31883,2,2,1, 31885
1,31886,1,1,0, 31887
5,31887,3,5,1, 31892
6,31890,2,4,1, 31894
8,31896,1,1,1, 31897
11,31894,4,4,1, 31898
9,31897,2,2,1, 31899
16,31899,2,2,1, 31901
17,31899,3,3,1, 31902
15,31901,2,2,0, 31903
22,31906,4,4,0, 31910
24,31909,1,1,1, 31910
23,31908,3,3,1, 31911
31,31916,2,2,1, 31918
28,31914,5,5,1, 31919
29,31918,4,4,1, 31922
8,31936,1,1,1, 31937
16,31939,2,2,0, 31941
15,31941,2,2,1, 31943
22,31946,4,4,1, 31950
24,31949,1,1,0, 31950
23,31948,3,3,0, 31951
30,31953,3,3,1, 31956
5,31967,3,5,1, 31972
8,31976,1,1,1, 31977
16,31979,2,2,0, 31981
15,31981,2,2,1, 31983
22,31986,4,4,1, 31990
24,31989,1,1,0, 31990
23,31988,3,3,1, 31991
29,31998,4,4,1, 32002
1,32006,1,1,0, 32007
5,32007,3,5,1, 32012
6,32010,2,4,1, 32014
8,32016,1,1,1, 32017
9,32017,2,2,1, 32019
16,32019,2,2,1, 32021
17,32019,3,3,1, 32022
15,32021,2,2,0, 32023
13,32019,4,6,1, 32025
18,32023,4,4,1, 32027
20,32023,6,6,1, 32029
22,32026,4,4,0, 32030
24,32029,1,1,0, 32030
19,32026,5,5,1, 32031
23,32028,3,3,1, 32031
30,32033,3,3,1, 32036
31,32036,2,2,1, 32038
26,32037,3,3,1, 32040
29,32038,4,4,1, 32042
1,32046,1,1,0, 32047
3,32047,3,3,1, 32050
5,32047,3,5,1, 32052
8,32056,1,1,0, 32057
9,32057,2,2,1, 32059
16,32059,2,2,0, 32061
17,32059,3,3,1, 32062
15,32061,2,2,1, 32063
13,32059,4,6,1, 32065
18,32063,4,4,1, 32067
20,32063,6,6,1, 32069
22,32066,4,4,0, 32070
24,32069,1,1,0, 32070
19,32066,5,5,1, 32071
23,32068,3,3,0, 32071
31,32076,2,2,1, 32078
26,32077,3,3,1, 32080
2,32083,2,2,1, 32085
1,32086,1,1,0, 32087
3,32087,3,3,1, 32090
5,32087,3,5,1, 32092
6,32090,2,4,1, 32094
8,32096,1,1,0, 32097
16,32099,2,2,1, 32101
15,32101,2,2,0, 32103
22,32106,4,4,0, 32110
24,32109,1,1,0, 32110
23,32108,3,3,0, 32111
30,32113,3,3,1, 32116
25,32115,2,2,1, 32117
31,32116,2,2,1, 32118
28,32114,5,5,1, 32119
1,32126,1,1,0, 32127
6,32130,2,4,1, 32134
8,32136,1,1,1, 32137
11,32134,4,4,1, 32138
16,32139,2,2,1, 32141
17,32139,3,3,1, 32142
15,32141,2,2,0, 32143
13,32139,4,6,1, 32145
12,32140,5,5,1, 32145
20,32143,6,6,1, 32149
22,32146,4,4,1, 32150
24,32149,1,1,0, 32150
19,32146,5,5,1, 32151
23,32148,3,3,0, 32151
28,32154,5,5,1, 32159
29,32158,4,4,1, 32162
1,32166,1,1,0, 32167
6,32170,2,4,1, 32174
8,32176,1,1,1, 32177
9,32177,2,2,1, 32179
16,32179,2,2,0, 32181
17,32179,3,3,1, 32182
15,32181,2,2,0, 32183
20,32183,6,6,1, 32189
22,32186,4,4,1, 32190
24,32189,1,1,0, 32190
23,32188,3,3,0, 32191
30,32193,3,3,1, 32196
25,32195,2,2,1, 32197
31,32196,2,2,1, 32198
26,32197,3,3,1, 32200
29,32198,4,4,1, 32202
1,32206,1,1,1, 32207
5,32207,3,5,1, 32212
6,32210,2,4,1, 32214
8,32216,1,1,0, 32217
16,32219,2,2,1, 32221
17,32219,3,3,1, 32222
15,32221,2,2,0, 32223
18,32223,4,4,1, 32227
22,32226,4,4,0, 32230
24,32229,1,1,1, 32230
23,32228,3,3,0, 32231
28,32234,5,5,1, 32239
29,32238,4,4,1, 32242
2,32243,2,2,1, 32245
1,32246,1,1,0, 32247
8,32256,1,1,0, 32257
16,32259,2,2,1, 32261
15,32261,2,2,1, 32263
12,32260,5,5,1, 32265
22,32266,4,4,0, 32270
24,32269,1,1,0, 32270
23,32268,3,3,0, 32271
28,32274,5,5,1, 32279
29,32278,4,4,1, 32282
1,32286,1,1,1, 32287
6,32290,2,4,1, 32294
8,32296,1,1,0, 32297
9,32297,2,2,1, 32299
16,32299,2,2,0, 32301
15,32301,2,2,1, 32303
13,32299,4,6,1, 32305
12,32300,5,5,1, 32305
22,32306,4,4,0, 32310
24,32309,1,1,0, 32310
19,32306,5,5,1, 32311
23,32308,3,3,1, 32311
25,32315,2,2,1, 32317
31,32316,2,2,1, 32318
26,32317,3,3,1, 32320
29,32318,4,4,1, 32322
1,32326,1,1,0, 32327
3,32327,3,3,1, 32330
6,32330,2,4,1, 32334
8,32336,1,1,0, 32337
11,32334,4,4,1, 32338
16,32339,2,2,0, 32341
15,32341,2,2,0, 32343
13,32339,4,6,1, 32345
12,32340,5,5,1, 32345
22,32346,4,4,0, 32350
24,32349,1,1,1, 32350
23,32348,3,3,1, 32351
31,32356,2,2,1, 32358
28,32354,5,5,1, 32359
29,32358,4,4,1, 32362
8,32376,1,1,1, 32377
16,32379,2,2,1, 32381
24,32389,1,1,1, 32390
30,32393,3,3,1, 32396
31,32396,2,2,1, 32398
28,32394,5,5,1, 32399
29,32398,4,4,1, 32402
6,32410,2,4,1, 32414
8,32416,1,1,1, 32417
16,32419,2,2,1, 32421
22,32426,4,4,1, 32430
24,32429,1,1,0, 32430
1,32446,1,1,1, 32447
3,32447,3,3,1, 32450
8,32456,1,1,0, 32457
9,32457,2,2,1, 32459
16,32459,2,2,1, 32461
17,32459,3,3,1, 32462
15,32461,2,2,1, 32463
18,32463,4,4,1, 32467
24,32469,1,1,1, 32470
19,32466,5,5,1, 32471
23,32468,3,3,1, 32471
31,32476,2,2,1, 32478
28,32474,5,5,1, 32479
2,32483,2,2,1, 32485
1,32486,1,1,1, 32487
3,32487,3,3,1, 32490
6,32490,2,4,1, 32494
8,32496,1,1,0, 32497
16,32499,2,2,1, 32501
13,32499,4,6,1, 32505
12,32500,5,5,1, 32505
20,32503,6,6,1, 32509
22,32506,4,4,1, 32510
24,32509,1,1,0, 32510
25,32515,2,2,1, 32517
31,32516,2,2,1, 32518
28,32514,5,5,1, 32519
29,32518,4,4,1, 32522
2,32523,2,2,1, 32525
1,32526,1,1,0, 32527
5,32527,3,5,1, 32532
6,32530,2,4,1, 32534
8,32536,1,1,1, 32537
9,32537,2,2,1, 32539
17,32539,3,3,1, 32542
15,32541,2,2,1, 32543
18,32543,4,4,1, 32547
22,32546,4,4,1, 32550
24,32549,1,1,0, 32550
19,32546,5,5,1, 32551
23,32548,3,3,1, 32551
30,32553,3,3,1, 32556
31,32556,2,2,1, 32558
1,32566,1,1,0, 32567
3,32567,3,3,1, 32570
6,32570,2,4,1, 32574
8,32576,1,1,1, 32577
11,32574,4,4,1, 32578
17,32579,3,3,1, 32582
13,32579,4,6,1, 32585
12,32580,5,5,1, 32585
18,32583,4,4,1, 32587
22,32586,4,4,1, 32590
24,32589,1,1,0, 32590
31,32596,2,2,1, 32598
28,32594,5,5,1, 32599
26,32597,3,3,1, 32600
1,32606,1,1,1, 32607
5,32607,3,5,1, 32612
8,32616,1,1,1, 32617
16,32619,2,2,1, 32621
13,32619,4,6,1, 32625
24,32629,1,1,0, 32630
28,32634,5,5,1, 32639
26,32637,3,3,1, 32640
2,32643,2,2,1, 32645
1,32646,1,1,0, 32647
6,32650,2,4,1, 32654
8,32656,1,1,0, 32657
9,32657,2,2,1, 32659
15,32661,2,2,1, 32663
18,32663,4,4,1, 32667
20,32663,6,6,1, 32669
22,32666,4,4,1, 32670
24,32669,1,1,0, 32670
19,32666,5,5,1, 32671
25,32675,2,2,1, 32677
26,32677,3,3,1, 32680
29,32678,4,4,1, 32682
1,32686,1,1,0, 32687
8,32696,1,1,1, 32697
11,32694,4,4,1, 32698
16,32699,2,2,1, 32701
17,32699,3,3,1, 32702
13,32699,4,6,1, 32705
22,32706,4,4,1, 32710
24,32709,1,1,0, 32710
23,32708,3,3,1, 32711
31,32716,2,2,1, 32718
8,32736,1,1,1, 32737
22,32746,4,4,1, 32750
24,32749,1,1,1, 32750
28,32754,5,5,1, 32759
29,32758,4,4,1, 32762
8,32776,1,1,0, 32777
16,32779,2,2,1, 32781
15,32781,2,2,1, 32783
24,32789,1,1,0, 32790
23,32788,3,3,1, 32791
1,32806,1,1,1, 32807
8,32816,1,1,1, 32817
11,32814,4,4,1, 32818
17,32819,3,3,1, 32822
22,32826,4,4,1, 32830
24,32829,1,1,0, 32830
19,32826,5,5,1, 32831
25,32835,2,2,1, 32837
26,32837,3,3,1, 32840
29,32838,4,4,1, 32842
1,32846,1,1,1, 32847
5,32847,3,5,1, 32852
8,32856,1,1,0, 32857
15,32861,2,2,1, 32863
18,32863,4,4,1, 32867
20,32863,6,6,1, 32869
22,32866,4,4,1, 32870
24,32869,1,1,0, 32870
23,32868,3,3,1, 32871
30,32873,3,3,1, 32876
25,32875,2,2,1, 32877
28,32874,5,5,1, 32879
1,32886,1,1,0, 32887
6,32890,2,4,1, 32894
8,32896,1,1,1, 32897
16,32899,2,2,1, 32901
15,32901,2,2,1, 32903
12,32900,5,5,1, 32905
24,32909,1,1,1, 32910
23,32908,3,3,1, 32911
30,32913,3,3,1, 32916
28,32914,5,5,1, 32919
26,32917,3,3,1, 32920
2,32923,2,2,1, 32925
1,32926,1,1,0, 32927
5,32927,3,5,1, 32932
8,32936,1,1,0, 32937
11,32934,4,4,1, 32938
9,32937,2,2,1, 32939
16,32939,2,2,1, 32941
15,32941,2,2,1, 32943
13,32939,4,6,1, 32945
20,32943,6,6,1, 32949
22,32946,4,4,1, 32950
24,32949,1,1,0, 32950
19,32946,5,5,1, 32951
30,32953,3,3,1, 32956
25,32955,2,2,1, 32957
28,32954,5,5,1, 32959
2,32963,2,2,1, 32965
1,32966,1,1,1, 32967
8,32976,1,1,1, 32977
11,32974,4,4,1, 32978
9,32977,2,2,1, 32979
16,32979,2,2,1, 32981
17,32979,3,3,1, 32982
18,32983,4,4,1, 32987
24,32989,1,1,1, 32990
23,32988,3,3,1, 32991
25,32995,2,2,1, 32997
31,32996,2,2,1, 32998
2,33003,2,2,1, 33005
1,33006,1,1,0, 33007
6,33010,2,4,1, 33014
8,33016,1,1,1, 33017
11,33014,4,4,1, 33018
9,33017,2,2,1, 33019
17,33019,3,3,1, 33022
15,33021,2,2,1, 33023
13,33019,4,6,1, 33025
18,33023,4,4,1, 33027
22,33026,4,4,1, 33030
24,33029,1,1,0, 33030
23,33028,3,3,1, 33031
28,33034,5,5,1, 33039
26,33037,3,3,1, 33040
29,33038,4,4,1, 33042
2,33043,2,2,1, 33045
1,33046,1,1,1, 33047
3,33047,3,3,1, 33050
6,33050,2,4,1, 33054
8,33056,1,1,1, 33057
18,33063,4,4,1, 33067
22,33066,4,4,1, 33070
24,33069,1,1,1, 33070
19,33066,5,5,1, 33071
23,33068,3,3,1, 33071
30,33073,3,3,1, 33076
31,33076,2,2,1, 33078
29,33078,4,4,1, 33082
2,33083,2,2,1, 33085
1,33086,1,1,0, 33087
3,33087,3,3,1, 33090
8,33096,1,1,0, 33097
9,33097,2,2,1, 33099
16,33099,2,2,1, 33101
17,33099,3,3,1, 33102
15,33101,2,2,0, 33103
18,33103,4,4,1, 33107
20,33103,6,6,1, 33109
22,33106,4,4,0, 33110
24,33109,1,1,1, 33110
19,33106,5,5,1, 33111
23,33108,3,3,0, 33111
30,33113,3,3,0, 33116
31,33116,2,2,0, 33118
28,33114,5,5,1, 33119
29,33118,4,4,1, 33122
5,33127,3,5,1, 33132
6,33130,2,4,1, 33134
8,33136,1,1,0, 33137
16,33139,2,2,1, 33141
15,33141,2,2,0, 33143
22,33146,4,4,0, 33150
24,33149,1,1,1, 33150
23,33148,3,3,0, 33151
30,33153,3,3,1, 33156
31,33156,2,2,0, 33158
28,33154,5,5,1, 33159
29,33158,4,4,1, 33162
5,33167,3,5,0, 33172
6,33170,2,4,1, 33174
8,33176,1,1,1, 33177
16,33179,2,2,1, 33181
15,33181,2,2,0, 33183
22,33186,4,4,0, 33190
24,33189,1,1,0, 33190
23,33188,3,3,1, 33191
30,33193,3,3,1, 33196
31,33196,2,2,0, 33198
28,33194,5,5,1, 33199
29,33198,4,4,1, 33202
5,33207,3,5,1, 33212
6,33210,2,4,0, 33214
8,33216,1,1,0, 33217
16,33219,2,2,0, 33221
15,33221,2,2,0, 33223
12,33220,5,5,1, 33225
20,33223,6,6,1, 33229
22,33226,4,4,0, 33230
24,33229,1,1,1, 33230
23,33228,3,3,0, 33231
30,33233,3,3,0, 33236
31,33236,2,2,0, 33238
28,33234,5,5,1, 33239
29,33238,4,4,1, 33242
2,33243,2,2,1, 33245
1,33246,1,1,1, 33247
5,33247,3,5,0, 33252
6,33250,2,4,1, 33254
8,33256,1,1,1, 33257
16,33259,2,2,1, 33261
15,33261,2,2,0, 33263
12,33260,5,5,1, 33265
18,33263,4,4,1, 33267
20,33263,6,6,1, 33269
22,33266,4,4,0, 33270
24,33269,1,1,1, 33270
19,33266,5,5,1, 33271
23,33268,3,3,1, 33271
30,33273,3,3,1, 33276
25,33275,2,2,1, 33277
31,33276,2,2,1, 33278
28,33274,5,5,0, 33279
26,33277,3,3,1, 33280
29,33278,4,4,0, 33282
1,33286,1,1,0, 33287
3,33287,3,3,1, 33290
5,33287,3,5,1, 33292
6,33290,2,4,1, 33294
8,33296,1,1,1, 33297
9,33297,2,2,1, 33299
16,33299,2,2,1, 33301
17,33299,3,3,1, 33302
15,33301,2,2,0, 33303
13,33299,4,6,1, 33305
18,33303,4,4,1, 33307
20,33303,6,6,1, 33309
22,33306,4,4,0, 33310
24,33309,1,1,1, 33310
19,33306,5,5,1, 33311
23,33308,3,3,0, 33311
30,33313,3,3,0, 33316
31,33316,2,2,0, 33318
28,33314,5,5,1, 33319
26,33317,3,3,1, 33320
29,33318,4,4,0, 33322
1,33326,1,1,0, 33327
3,33327,3,3,1, 33330
5,33327,3,5,1, 33332
6,33330,2,4,0, 33334
8,33336,1,1,1, 33337
11,33334,4,4,1, 33338
16,33339,2,2,1, 33341
17,33339,3,3,1, 33342
15,33341,2,2,0, 33343
13,33339,4,6,1, 33345
12,33340,5,5,1, 33345
22,33346,4,4,0, 33350
24,33349,1,1,1, 33350
19,33346,5,5,1, 33351
23,33348,3,3,1, 33351
30,33353,3,3,0, 33356
31,33356,2,2,0, 33358
28,33354,5,5,1, 33359
26,33357,3,3,1, 33360
29,33358,4,4,0, 33362
2,33363,2,2,1, 33365
1,33366,1,1,0, 33367
3,33367,3,3,1, 33370
5,33367,3,5,1, 33372
6,33370,2,4,1, 33374
8,33376,1,1,1, 33377
16,33379,2,2,1, 33381
15,33381,2,2,1, 33383
22,33386,4,4,0, 33390
24,33389,1,1,1, 33390
23,33388,3,3,1, 33391
31,33396,2,2,0, 33398
5,33407,3,5,1, 33412
8,33416,1,1,0, 33417
16,33419,2,2,0, 33421
15,33421,2,2,1, 33423
22,33426,4,4,0, 33430
24,33429,1,1,1, 33430
23,33428,3,3,0, 33431
31,33436,2,2,0, 33438
5,33447,3,5,1, 33452
8,33456,1,1,0, 33457
16,33459,2,2,1, 33461
15,33461,2,2,0, 33463
22,33466,4,4,0, 33470
24,33469,1,1,0, 33470
23,33468,3,3,0, 33471
30,33473,3,3,1, 33476
31,33476,2,2,0, 33478
28,33474,5,5,1, 33479
29,33478,4,4,1, 33482
2,33483,2,2,1, 33485
1,33486,1,1,1, 33487
6,33490,2,4,1, 33494
8,33496,1,1,0, 33497
11,33494,4,4,1, 33498
16,33499,2,2,0, 33501
17,33499,3,3,1, 33502
15,33501,2,2,1, 33503
13,33499,4,6,1, 33505
12,33500,5,5,1, 33505
22,33506,4,4,1, 33510
24,33509,1,1,0, 33510
19,33506,5,5,1, 33511
23,33508,3,3,0, 33511
31,33516,2,2,1, 33518
28,33514,5,5,1, 33519
29,33518,4,4,1, 33522
2,33523,2,2,1, 33525
1,33526,1,1,0, 33527
3,33527,3,3,1, 33530
8,33536,1,1,1, 33537
16,33539,2,2,1, 33541
17,33539,3,3,1, 33542
15,33541,2,2,1, 33543
13,33539,4,6,1, 33545
18,33543,4,4,1, 33547
22,33546,4,4,0, 33550
24,33549,1,1,0, 33550
23,33548,3,3,0, 33551
31,33556,2,2,1, 33558
29,33558,4,4,1, 33562
1,33566,1,1,1, 33567
5,33567,3,5,1, 33572
8,33576,1,1,1, 33577
9,33577,2,2,1, 33579
16,33579,2,2,0, 33581
17,33579,3,3,1, 33582
15,33581,2,2,0, 33583
22,33586,4,4,1, 33590
24,33589,1,1,1, 33590
23,33588,3,3,1, 33591
31,33596,2,2,0, 33598
28,33594,5,5,1, 33599
29,33598,4,4,1, 33602
1,33606,1,1,0, 33607
5,33607,3,5,1, 33612
6,33610,2,4,1, 33614
8,33616,1,1,0, 33617
9,33617,2,2,1, 33619
16,33619,2,2,1, 33621
17,33619,3,3,1, 33622
15,33621,2,2,0, 33623
22,33626,4,4,0, 33630
24,33629,1,1,0, 33630
23,33628,3,3,0, 33631
30,33633,3,3,1, 33636
31,33636,2,2,0, 33638
29,33638,4,4,1, 33642
1,33646,1,1,1, 33647
8,33656,1,1,1, 33657
16,33659,2,2,0, 33661
17,33659,3,3,1, 33662
15,33661,2,2,1, 33663
18,33663,4,4,1, 33667
22,33666,4,4,0, 33670
24,33669,1,1,1, 33670
19,33666,5,5,1, 33671
23,33668,3,3,1, 33671
25,33675,2,2,1, 33677
31,33676,2,2,0, 33678
29,33678,4,4,1, 33682
1,33686,1,1,0, 33687
5,33687,3,5,1, 33692
6,33690,2,4,1, 33694
8,33696,1,1,0, 33697
16,33699,2,2,0, 33701
15,33701,2,2,0, 33703
13,33699,4,6,1, 33705
18,33703,4,4,1, 33707
22,33706,4,4,0, 33710
24,33709,1,1,1, 33710
23,33708,3,3,0, 33711
25,33715,2,2,1, 33717
31,33716,2,2,0, 33718
28,33714,5,5,1, 33719
1,33726,1,1,0, 33727
5,33727,3,5,1, 33732
8,33736,1,1,1, 33737
11,33734,4,4,1, 33738
9,33737,2,2,1, 33739
16,33739,2,2,1, 33741
15,33741,2,2,1, 33743
13,33739,4,6,1, 33745
22,33746,4,4,0, 33750
24,33749,1,1,1, 33750
19,33746,5,5,1, 33751
23,33748,3,3,1, 33751
31,33756,2,2,1, 33758
1,33766,1,1,0, 33767
3,33767,3,3,1, 33770
8,33776,1,1,0, 33777
9,33777,2,2,1, 33779
16,33779,2,2,1, 33781
17,33779,3,3,1, 33782
15,33781,2,2,0, 33783
13,33779,4,6,1, 33785
12,33780,5,5,1, 33785
20,33783,6,6,1, 33789
22,33786,4,4,0, 33790
24,33789,1,1,1, 33790
19,33786,5,5,1, 33791
23,33788,3,3,1, 33791
30,33793,3,3,1, 33796
25,33795,2,2,1, 33797
31,33796,2,2,0, 33798
26,33797,3,3,1, 33800
29,33798,4,4,1, 33802
2,33803,2,2,1, 33805
1,33806,1,1,0, 33807
3,33807,3,3,1, 33810
5,33807,3,5,1, 33812
6,33810,2,4,1, 33814
8,33816,1,1,0, 33817
11,33814,4,4,1, 33818
9,33817,2,2,1, 33819
16,33819,2,2,1, 33821
15,33821,2,2,1, 33823
13,33819,4,6,1, 33825
12,33820,5,5,1, 33825
18,33823,4,4,1, 33827
20,33823,6,6,1, 33829
22,33826,4,4,1, 33830
24,33829,1,1,1, 33830
19,33826,5,5,1, 33831
23,33828,3,3,0, 33831
30,33833,3,3,1, 33836
31,33836,2,2,0, 33838
26,33837,3,3,1, 33840
2,33843,2,2,1, 33845
1,33846,1,1,0, 33847
5,33847,3,5,1, 33852
8,33856,1,1,0, 33857
11,33854,4,4,1, 33858
9,33857,2,2,1, 33859
16,33859,2,2,0, 33861
15,33861,2,2,0, 33863
22,33866,4,4,1, 33870
24,33869,1,1,0, 33870
23,33868,3,3,0, 33871
31,33876,2,2,1, 33878
29,33878,4,4,1, 33882
5,33887,3,5,1, 33892
6,33890,2,4,1, 33894
8,33896,1,1,1, 33897
16,33899,2,2,0, 33901
15,33901,2,2,1, 33903
22,33906,4,4,0, 33910
24,33909,1,1,1, 33910
23,33908,3,3,1, 33911
30,33913,3,3,1, 33916
31,33916,2,2,0, 33918
6,33930,2,4,1, 33934
8,33936,1,1,1, 33937
16,33939,2,2,1, 33941
15,33941,2,2,0, 33943
22,33946,4,4,1, 33950
24,33949,1,1,1, 33950
23,33948,3,3,1, 33951
30,33953,3,3,1, 33956
31,33956,2,2,0, 33958
29,33958,4,4,1, 33962
2,33963,2,2,1, 33965
1,33966,1,1,0, 33967
6,33970,2,4,1, 33974
8,33976,1,1,1, 33977
9,33977,2,2,1, 33979
16,33979,2,2,0, 33981
15,33981,2,2,0, 33983
12,33980,5,5,1, 33985
18,33983,4,4,1, 33987
20,33983,6,6,1, 33989
22,33986,4,4,0, 33990
24,33989,1,1,1, 33990
23,33988,3,3,1, 33991
31,33996,2,2,0, 33998
26,33997,3,3,1, 34000
29,33998,4,4,1, 34002
2,34003,2,2,1, 34005
1,34006,1,1,1, 34007
3,34007,3,3,1, 34010
8,34016,1,1,1, 34017
9,34017,2,2,1, 34019
16,34019,2,2,0, 34021
17,34019,3,3,1, 34022
15,34021,2,2,1, 34023
20,34023,6,6,1, 34029
22,34026,4,4,1, 34030
24,34029,1,1,0, 34030
23,34028,3,3,0, 34031
30,34033,3,3,1, 34036
25,34035,2,2,1, 34037
31,34036,2,2,0, 34038
26,34037,3,3,1, 34040
29,34038,4,4,1, 34042
1,34046,1,1,1, 34047
6,34050,2,4,1, 34054
8,34056,1,1,0, 34057
9,34057,2,2,1, 34059
16,34059,2,2,1, 34061
15,34061,2,2,1, 34063
13,34059,4,6,1, 34065
12,34060,5,5,1, 34065
18,34063,4,4,1, 34067
20,34063,6,6,1, 34069
22,34066,4,4,1, 34070
24,34069,1,1,0, 34070
23,34068,3,3,1, 34071
30,34073,3,3,1, 34076
25,34075,2,2,1, 34077
31,34076,2,2,0, 34078
28,34074,5,5,1, 34079
2,34083,2,2,1, 34085
1,34086,1,1,0, 34087
5,34087,3,5,1, 34092
8,34096,1,1,1, 34097
11,34094,4,4,1, 34098
9,34097,2,2,1, 34099
16,34099,2,2,0, 34101
17,34099,3,3,1, 34102
15,34101,2,2,1, 34103
20,34103,6,6,1, 34109
22,34106,4,4,1, 34110
24,34109,1,1,0, 34110
19,34106,5,5,1, 34111
23,34108,3,3,0, 34111
31,34116,2,2,0, 34118
2,34123,2,2,1, 34125
1,34126,1,1,0, 34127
3,34127,3,3,1, 34130
5,34127,3,5,1, 34132
8,34136,1,1,1, 34137
16,34139,2,2,1, 34141
17,34139,3,3,1, 34142
15,34141,2,2,0, 34143
13,34139,4,6,1, 34145
22,34146,4,4,0, 34150
24,34149,1,1,1, 34150
23,34148,3,3,0, 34151
31,34156,2,2,1, 34158
5,34167,3,5,1, 34172
6,34170,2,4,1, 34174
8,34176,1,1,0, 34177
16,34179,2,2,0, 34181
15,34181,2,2,1, 34183
22,34186,4,4,1, 34190
24,34189,1,1,1, 34190
23,34188,3,3,1, 34191
30,34193,3,3,1, 34196
31,34196,2,2,0, 34198
29,34198,4,4,1, 34202
5,34207,3,5,1, 34212
8,34216,1,1,1, 34217
16,34219,2,2,1, 34221
15,34221,2,2,1, 34223
22,34226,4,4,1, 34230
24,34229,1,1,1, 34230
23,34228,3,3,1, 34231
30,34233,3,3,1, 34236
31,34236,2,2,1, 34238
1,34246,1,1,1, 34247
6,34250,2,4,1, 34254
8,34256,1,1,1, 34257
11,34254,4,4,1, 34258
9,34257,2,2,1, 34259
16,34259,2,2,1, 34261
15,34261,2,2,0, 34263
13,34259,4,6,1, 34265
22,34266,4,4,0, 34270
24,34269,1,1,0, 34270
19,34266,5,5,1, 34271
23,34268,3,3,1, 34271
25,34275,2,2,1, 34277
31,34276,2,2,0, 34278
26,34277,3,3,1, 34280
29,34278,4,4,1, 34282
2,34283,2,2,1, 34285
1,34286,1,1,0, 34287
6,34290,2,4,1, 34294
8,34296,1,1,0, 34297
16,34299,2,2,1, 34301
15,34301,2,2,1, 34303
12,34300,5,5,1, 34305
18,34303,4,4,1, 34307
22,34306,4,4,1, 34310
24,34309,1,1,1, 34310
23,34308,3,3,1, 34311
30,34313,3,3,1, 34316
31,34316,2,2,0, 34318
26,34317,3,3,1, 34320
1,34326,1,1,1, 34327
3,34327,3,3,1, 34330
6,34330,2,4,1, 34334
8,34336,1,1,1, 34337
9,34337,2,2,1, 34339
16,34339,2,2,0, 34341
17,34339,3,3,1, 34342
15,34341,2,2,1, 34343
20,34343,6,6,1, 34349
22,34346,4,4,0, 34350
24,34349,1,1,1, 34350
19,34346,5,5,1, 34351
23,34348,3,3,1, 34351
30,34353,3,3,1, 34356
25,34355,2,2,1, 34357
31,34356,2,2,0, 34358
26,34357,3,3,1, 34360
29,34358,4,4,1, 34362
1,34366,1,1,0, 34367
6,34370,2,4,1, 34374
8,34376,1,1,1, 34377
9,34377,2,2,1, 34379
16,34379,2,2,0, 34381
17,34379,3,3,1, 34382
15,34381,2,2,0, 34383
12,34380,5,5,1, 34385
18,34383,4,4,1, 34387
22,34386,4,4,0, 34390
24,34389,1,1,1, 34390
19,34386,5,5,1, 34391
23,34388,3,3,1, 34391
31,34396,2,2,1, 34398
2,34403,2,2,1, 34405
1,34406,1,1,1, 34407
5,34407,3,5,1, 34412
8,34416,1,1,1, 34417
11,34414,4,4,1, 34418
16,34419,2,2,1, 34421
17,34419,3,3,1, 34422
15,34421,2,2,1, 34423
12,34420,5,5,1, 34425
20,34423,6,6,1, 34429
22,34426,4,4,1, 34430
24,34429,1,1,0, 34430
19,34426,5,5,1, 34431
23,34428,3,3,0, 34431
31,34436,2,2,0, 34438
28,34434,5,5,1, 34439
26,34437,3,3,1, 34440
2,34443,2,2,1, 34445
6,34450,2,4,1, 34454
8,34456,1,1,1, 34457
16,34459,2,2,1, 34461
15,34461,2,2,0, 34463
22,34466,4,4,1, 34470
24,34469,1,1,0, 34470
23,34468,3,3,1, 34471
30,34473,3,3,1, 34476
31,34476,2,2,1, 34478
5,34487,3,5,1, 34492
6,34490,2,4,1, 34494
8,34496,1,1,1, 34497
16,34499,2,2,1, 34501
15,34501,2,2,1, 34503
22,34506,4,4,0, 34510
24,34509,1,1,0, 34510
23,34508,3,3,1, 34511
30,34513,3,3,1, 34516
31,34516,2,2,0, 34518
5,34527,3,5,1, 34532
6,34530,2,4,1, 34534
8,34536,1,1,1, 34537
16,34539,2,2,1, 34541
15,34541,2,2,1, 34543
18,34543,4,4,1, 34547
22,34546,4,4,0, 34550
24,34549,1,1,0, 34550
19,34546,5,5,1, 34551
23,34548,3,3,0, 34551
30,34553,3,3,1, 34556
25,34555,2,2,1, 34557
31,34556,2,2,0, 34558
28,34554,5,5,1, 34559
29,34558,4,4,1, 34562
1,34566,1,1,0, 34567
8,34576,1,1,1, 34577
9,34577,2,2,1, 34579
16,34579,2,2,1, 34581
17,34579,3,3,1, 34582
15,34581,2,2,1, 34583
22,34586,4,4,1, 34590
24,34589,1,1,0, 34590
23,34588,3,3,1, 34591
30,34593,3,3,1, 34596
31,34596,2,2,1, 34598
1,34606,1,1,0, 34607
6,34610,2,4,1, 34614
8,34616,1,1,0, 34617
9,34617,2,2,1, 34619
16,34619,2,2,1, 34621
17,34619,3,3,1, 34622
15,34621,2,2,1, 34623
22,34626,4,4,0, 34630
24,34629,1,1,1, 34630
23,34628,3,3,1, 34631
30,34633,3,3,1, 34636
25,34635,2,2,1, 34637
31,34636,2,2,1, 34638
28,34634,5,5,1, 34639
29,34638,4,4,1, 34642
1,34646,1,1,1, 34647
5,34647,3,5,1, 34652
6,34650,2,4,1, 34654
8,34656,1,1,0, 34657
11,34654,4,4,1, 34658
9,34657,2,2,1, 34659
16,34659,2,2,0, 34661
17,34659,3,3,1, 34662
15,34661,2,2,0, 34663
12,34660,5,5,1, 34665
20,34663,6,6,1, 34669
22,34666,4,4,1, 34670
24,34669,1,1,1, 34670
19,34666,5,5,1, 34671
23,34668,3,3,0, 34671
31,34676,2,2,1, 34678
1,34686,1,1,0, 34687
3,34687,3,3,1, 34690
8,34696,1,1,1, 34697
9,34697,2,2,1, 34699
16,34699,2,2,1, 34701
15,34701,2,2,0, 34703
22,34706,4,4,0, 34710
24,34709,1,1,1, 34710
19,34706,5,5,1, 34711
23,34708,3,3,1, 34711
31,34716,2,2,0, 34718
28,34714,5,5,1, 34719
26,34717,3,3,1, 34720
29,34718,4,4,1, 34722
1,34726,1,1,0, 34727
3,34727,3,3,1, 34730
5,34727,3,5,1, 34732
8,34736,1,1,1, 34737
16,34739,2,2,1, 34741
15,34741,2,2,0, 34743
13,34739,4,6,1, 34745
12,34740,5,5,1, 34745
18,34743,4,4,1, 34747
22,34746,4,4,0, 34750
24,34749,1,1,1, 34750
23,34748,3,3,1, 34751
25,34755,2,2,1, 34757
31,34756,2,2,1, 34758
29,34758,4,4,1, 34762
1,34766,1,1,0, 34767
3,34767,3,3,1, 34770
8,34776,1,1,1, 34777
11,34774,4,4,1, 34778
9,34777,2,2,1, 34779
16,34779,2,2,0, 34781
17,34779,3,3,1, 34782
15,34781,2,2,1, 34783
13,34779,4,6,1, 34785
12,34780,5,5,1, 34785
20,34783,6,6,1, 34789
22,34786,4,4,0, 34790
24,34789,1,1,0, 34790
23,34788,3,3,1, 34791
30,34793,3,3,0, 34796
25,34795,2,2,1, 34797
31,34796,2,2,1, 34798
28,34794,5,5,0, 34799
26,34797,3,3,1, 34800
29,34798,4,4,0, 34802
1,34806,1,1,1, 34807
3,34807,3,3,1, 34810
5,34807,3,5,0, 34812
6,34810,2,4,1, 34814
8,34816,1,1,1, 34817
11,34814,4,4,1, 34818
16,34819,2,2,1, 34821
15,34821,2,2,1, 34823
13,34819,4,6,1, 34825
20,34823,6,6,1, 34829
22,34826,4,4,0, 34830
24,34829,1,1,0, 34830
23,34828,3,3,0, 34831
30,34833,3,3,0, 34836
31,34836,2,2,1, 34838
28,34834,5,5,1, 34839
26,34837,3,3,1, 34840
29,34838,4,4,1, 34842
2,34843,2,2,1, 34845
1,34846,1,1,0, 34847
5,34847,3,5,1, 34852
6,34850,2,4,0, 34854
8,34856,1,1,1, 34857
11,34854,4,4,1, 34858
16,34859,2,2,1, 34861
15,34861,2,2,1, 34863
12,34860,5,5,1, 34865
20,34863,6,6,1, 34869
22,34866,4,4,1, 34870
24,34869,1,1,0, 34870
19,34866,5,5,1, 34871
23,34868,3,3,0, 34871
30,34873,3,3,1, 34876
31,34876,2,2,0, 34878
28,34874,5,5,0, 34879
26,34877,3,3,1, 34880
29,34878,4,4,1, 34882
2,34883,2,2,1, 34885
1,34886,1,1,1, 34887
3,34887,3,3,1, 34890
6,34890,2,4,1, 34894
8,34896,1,1,1, 34897
15,34901,2,2,1, 34903
22,34906,4,4,1, 34910
24,34909,1,1,1, 34910
23,34908,3,3,1, 34911
30,34913,3,3,1, 34916
28,34914,5,5,1, 34919
8,34936,1,1,1, 34937
16,34939,2,2,1, 34941
24,34949,1,1,0, 34950
23,34948,3,3,1, 34951
28,34954,5,5,1, 34959
29,34958,4,4,1, 34962
5,34967,3,5,1, 34972
8,34976,1,1,0, 34977
15,34981,2,2,1, 34983
22,34986,4,4,1, 34990
24,34989,1,1,0, 34990
25,34995,2,2,1, 34997
28,34994,5,5,1, 34999
26,34997,3,3,1, 35000
29,34998,4,4,1, 35002
1,35006,1,1,1, 35007
6,35010,2,4,1, 35014
8,35016,1,1,0, 35017
9,35017,2,2,1, 35019
17,35019,3,3,1, 35022
12,35020,5,5,1, 35025
24,35029,1,1,1, 35030
19,35026,5,5,1, 35031
30,35033,3,3,1, 35036
25,35035,2,2,1, 35037
31,35036,2,2,1, 35038
28,35034,5,5,1, 35039
2,35043,2,2,1, 35045
1,35046,1,1,0, 35047
5,35047,3,5,1, 35052
6,35050,2,4,1, 35054
8,35056,1,1,1, 35057
11,35054,4,4,1, 35058
16,35059,2,2,1, 35061
17,35059,3,3,1, 35062
15,35061,2,2,1, 35063
12,35060,5,5,1, 35065
18,35063,4,4,1, 35067
20,35063,6,6,1, 35069
24,35069,1,1,0, 35070
29,35078,4,4,1, 35082
1,35086,1,1,0, 35087
3,35087,3,3,1, 35090
6,35090,2,4,1, 35094
8,35096,1,1,0, 35097
11,35094,4,4,1, 35098
15,35101,2,2,1, 35103
18,35103,4,4,1, 35107
20,35103,6,6,1, 35109
22,35106,4,4,1, 35110
24,35109,1,1,1, 35110
19,35106,5,5,1, 35111
30,35113,3,3,1, 35116
25,35115,2,2,1, 35117
1,35126,1,1,0, 35127
6,35130,2,4,1, 35134
8,35136,1,1,0, 35137
9,35137,2,2,1, 35139
16,35139,2,2,1, 35141
17,35139,3,3,1, 35142
22,35146,4,4,1, 35150
24,35149,1,1,1, 35150
28,35154,5,5,1, 35159
1,35166,1,1,1, 35167
6,35170,2,4,1, 35174
8,35176,1,1,1, 35177
17,35179,3,3,1, 35182
15,35181,2,2,1, 35183
22,35186,4,4,1, 35190
24,35189,1,1,0, 35190
30,35193,3,3,1, 35196
25,35195,2,2,1, 35197
28,35194,5,5,1, 35199
29,35198,4,4,1, 35202
1,35206,1,1,1, 35207
6,35210,2,4,1, 35214
8,35216,1,1,0, 35217
17,35219,3,3,1, 35222
15,35221,2,2,1, 35223
18,35223,4,4,1, 35227
24,35229,1,1,1, 35230
19,35226,5,5,1, 35231
23,35228,3,3,1, 35231
31,35236,2,2,1, 35238
28,35234,5,5,1, 35239
26,35237,3,3,1, 35240
2,35243,2,2,1, 35245
1,35246,1,1,0, 35247
5,35247,3,5,1, 35252
6,35250,2,4,1, 35254
8,35256,1,1,1, 35257
11,35254,4,4,1, 35258
15,35261,2,2,1, 35263
24,35269,1,1,0, 35270
19,35266,5,5,1, 35271
30,35273,3,3,1, 35276
25,35275,2,2,1, 35277
31,35276,2,2,1, 35278
29,35278,4,4,1, 35282
1,35286,1,1,0, 35287
3,35287,3,3,1, 35290
8,35296,1,1,1, 35297
16,35299,2,2,1, 35301
12,35300,5,5,1, 35305
18,35303,4,4,1, 35307
20,35303,6,6,1, 35309
22,35306,4,4,1, 35310
24,35309,1,1,0, 35310
23,35308,3,3,1, 35311
25,35315,2,2,1, 35317
29,35318,4,4,1, 35322
1,35326,1,1,1, 35327
3,35327,3,3,1, 35330
5,35327,3,5,1, 35332
6,35330,2,4,1, 35334
8,35336,1,1,1, 35337
11,35334,4,4,1, 35338
15,35341,2,2,1, 35343
13,35339,4,6,1, 35345
22,35346,4,4,1, 35350
24,35349,1,1,1, 35350
31,35356,2,2,1, 35358
29,35358,4,4,1, 35362
1,35366,1,1,0, 35367
3,35367,3,3,1, 35370
5,35367,3,5,1, 35372
6,35370,2,4,1, 35374
8,35376,1,1,1, 35377
15,35381,2,2,1, 35383
22,35386,4,4,1, 35390
24,35389,1,1,0, 35390
23,35388,3,3,1, 35391
30,35393,3,3,1, 35396
28,35394,5,5,1, 35399
2,35403,2,2,1, 35405
1,35406,1,1,1, 35407
3,35407,3,3,1, 35410
5,35407,3,5,1, 35412
8,35416,1,1,0, 35417
11,35414,4,4,1, 35418
9,35417,2,2,1, 35419
17,35419,3,3,1, 35422
20,35423,6,6,1, 35429
24,35429,1,1,1, 35430
23,35428,3,3,1, 35431
29,35438,4,4,1, 35442
2,35443,2,2,1, 35445
1,35446,1,1,0, 35447
5,35447,3,5,1, 35452
8,35456,1,1,0, 35457
11,35454,4,4,1, 35458
16,35459,2,2,1, 35461
15,35461,2,2,1, 35463
12,35460,5,5,1, 35465
22,35466,4,4,1, 35470
24,35469,1,1,0, 35470
23,35468,3,3,1, 35471
30,35473,3,3,1, 35476
28,35474,5,5,1, 35479
26,35477,3,3,1, 35480
2,35483,2,2,1, 35485
1,35486,1,1,1, 35487
3,35487,3,3,1, 35490
8,35496,1,1,0, 35497
9,35497,2,2,1, 35499
17,35499,3,3,1, 35502
12,35500,5,5,1, 35505
18,35503,4,4,1, 35507
20,35503,6,6,1, 35509
22,35506,4,4,1, 35510
24,35509,1,1,0, 35510
19,35506,5,5,1, 35511
28,35514,5,5,1, 35519
2,35523,2,2,1, 35525
1,35526,1,1,0, 35527
8,35536,1,1,0, 35537
9,35537,2,2,1, 35539
16,35539,2,2,1, 35541
17,35539,3,3,1, 35542
15,35541,2,2,1, 35543
24,35549,1,1,1, 35550
19,35546,5,5,1, 35551
30,35553,3,3,1, 35556
26,35557,3,3,1, 35560
1,35566,1,1,1, 35567
3,35567,3,3,1, 35570
6,35570,2,4,1, 35574
8,35576,1,1,0, 35577
16,35579,2,2,0, 35581
15,35581,2,2,0, 35583
12,35580,5,5,1, 35585
22,35586,4,4,0, 35590
24,35589,1,1,0, 35590
19,35586,5,5,1, 35591
23,35588,3,3,0, 35591
30,35593,3,3,1, 35596
25,35595,2,2,1, 35597
28,35594,5,5,1, 35599
2,35603,2,2,1, 35605
1,35606,1,1,0, 35607
5,35607,3,5,1, 35612
6,35610,2,4,1, 35614
8,35616,1,1,1, 35617
16,35619,2,2,0, 35621
15,35621,2,2,0, 35623
22,35626,4,4,1, 35630
24,35629,1,1,0, 35630
23,35628,3,3,0, 35631
30,35633,3,3,1, 35636
31,35636,2,2,1, 35638
28,35634,5,5,1, 35639
29,35638,4,4,1, 35642
2,35643,2,2,1, 35645
1,35646,1,1,0, 35647
6,35650,2,4,1, 35654
8,35656,1,1,1, 35657
16,35659,2,2,0, 35661
15,35661,2,2,0, 35663
18,35663,4,4,1, 35667
22,35666,4,4,1, 35670
24,35669,1,1,0, 35670
23,35668,3,3,1, 35671
30,35673,3,3,1, 35676
31,35676,2,2,1, 35678
28,35674,5,5,1, 35679
29,35678,4,4,1, 35682
1,35686,1,1,0, 35687
3,35687,3,3,1, 35690
8,35696,1,1,1, 35697
9,35697,2,2,1, 35699
16,35699,2,2,1, 35701
15,35701,2,2,1, 35703
13,35699,4,6,1, 35705
18,35703,4,4,1, 35707
20,35703,6,6,1, 35709
22,35706,4,4,0, 35710
24,35709,1,1,1, 35710
19,35706,5,5,1, 35711
23,35708,3,3,0, 35711
31,35716,2,2,1, 35718
28,35714,5,5,1, 35719
26,35717,3,3,1, 35720
29,35718,4,4,1, 35722
2,35723,2,2,1, 35725
1,35726,1,1,1, 35727
3,35727,3,3,1, 35730
5,35727,3,5,1, 35732
8,35736,1,1,0, 35737
9,35737,2,2,1, 35739
16,35739,2,2,0, 35741
15,35741,2,2,0, 35743
12,35740,5,5,1, 35745
18,35743,4,4,1, 35747
22,35746,4,4,1, 35750
24,35749,1,1,0, 35750
23,35748,3,3,0, 35751
8,35776,1,1,0, 35777
16,35779,2,2,1, 35781
15,35781,2,2,1, 35783
22,35786,4,4,0, 35790
24,35789,1,1,0, 35790
23,35788,3,3,0, 35791
31,35796,2,2,1, 35798
28,35794,5,5,1, 35799
5,35807,3,5,1, 35812
8,35816,1,1,0, 35817
16,35819,2,2,0, 35821
15,35821,2,2,0, 35823
22,35826,4,4,1, 35830
24,35829,1,1,1, 35830
23,35828,3,3,1, 35831
30,35833,3,3,1, 35836
28,35834,5,5,1, 35839
29,35838,4,4,1, 35842
5,35847,3,5,1, 35852
8,35856,1,1,1, 35857
16,35859,2,2,0, 35861
15,35861,2,2,0, 35863
18,35863,4,4,1, 35867
20,35863,6,6,1, 35869
22,35866,4,4,0, 35870
24,35869,1,1,0, 35870
19,35866,5,5,1, 35871
23,35868,3,3,0, 35871
26,35877,3,3,1, 35880
29,35878,4,4,1, 35882
1,35886,1,1,0, 35887
3,35887,3,3,1, 35890
5,35887,3,5,1, 35892
8,35896,1,1,0, 35897
11,35894,4,4,1, 35898
16,35899,2,2,1, 35901
17,35899,3,3,1, 35902
15,35901,2,2,0, 35903
12,35900,5,5,1, 35905
20,35903,6,6,1, 35909
22,35906,4,4,0, 35910
24,35909,1,1,0, 35910
23,35908,3,3,1, 35911
30,35913,3,3,1, 35916
25,35915,2,2,1, 35917
31,35916,2,2,1, 35918
28,35914,5,5,1, 35919
26,35917,3,3,1, 35920
2,35923,2,2,1, 35925
1,35926,1,1,1, 35927
6,35930,2,4,1, 35934
8,35936,1,1,1, 35937
16,35939,2,2,1, 35941
17,35939,3,3,1, 35942
15,35941,2,2,0, 35943
20,35943,6,6,1, 35949
22,35946,4,4,0, 35950
24,35949,1,1,0, 35950
19,35946,5,5,1, 35951
23,35948,3,3,1, 35951
30,35953,3,3,1, 35956
25,35955,2,2,1, 35957
31,35956,2,2,1, 35958
29,35958,4,4,1, 35962
1,35966,1,1,0, 35967
3,35967,3,3,1, 35970
8,35976,1,1,1, 35977
11,35974,4,4,1, 35978
9,35977,2,2,1, 35979
16,35979,2,2,0, 35981
17,35979,3,3,1, 35982
15,35981,2,2,0, 35983
13,35979,4,6,1, 35985
12,35980,5,5,1, 35985
18,35983,4,4,1, 35987
20,35983,6,6,1, 35989
22,35986,4,4,1, 35990
24,35989,1,1,1, 35990
23,35988,3,3,1, 35991
30,35993,3,3,1, 35996
25,35995,2,2,1, 35997
28,35994,5,5,1, 35999
26,35997,3,3,1, 36000
2,36003,2,2,1, 36005
5,36007,3,5,1, 36012
8,36016,1,1,1, 36017
16,36019,2,2,1, 36021
15,36021,2,2,0, 36023
22,36026,4,4,0, 36030
24,36029,1,1,0, 36030
23,36028,3,3,0, 36031
30,36033,3,3,1, 36036
28,36034,5,5,1, 36039
6,36050,2,4,1, 36054
8,36056,1,1,0, 36057
16,36059,2,2,1, 36061
15,36061,2,2,1, 36063
22,36066,4,4,1, 36070
24,36069,1,1,1, 36070
23,36068,3,3,1, 36071
31,36076,2,2,1, 36078
29,36078,4,4,1, 36082
6,36090,2,4,1, 36094
8,36096,1,1,0, 36097
16,36099,2,2,0, 36101
15,36101,2,2,0, 36103
18,36103,4,4,1, 36107
22,36106,4,4,1, 36110
24,36109,1,1,0, 36110
23,36108,3,3,0, 36111
30,36113,3,3,1, 36116
28,36114,5,5,1, 36119
26,36117,3,3,1, 36120
1,36126,1,1,0, 36127
8,36136,1,1,1, 36137
16,36139,2,2,1, 36141
15,36141,2,2,1, 36143
22,36146,4,4,1, 36150
24,36149,1,1,1, 36150
23,36148,3,3,1, 36151
28,36154,5,5,1, 36159
26,36157,3,3,1, 36160
2,36163,2,2,1, 36165
1,36166,1,1,0, 36167
3,36167,3,3,1, 36170
6,36170,2,4,1, 36174
8,36176,1,1,0, 36177
16,36179,2,2,1, 36181
17,36179,3,3,1, 36182
15,36181,2,2,1, 36183
12,36180,5,5,1, 36185
18,36183,4,4,1, 36187
20,36183,6,6,1, 36189
22,36186,4,4,0, 36190
24,36189,1,1,1, 36190
19,36186,5,5,1, 36191
23,36188,3,3,1, 36191
30,36193,3,3,1, 36196
25,36195,2,2,1, 36197
31,36196,2,2,1, 36198
29,36198,4,4,1, 36202
1,36206,1,1,1, 36207
6,36210,2,4,1, 36214
8,36216,1,1,0, 36217
9,36217,2,2,1, 36219
16,36219,2,2,0, 36221
15,36221,2,2,0, 36223
18,36223,4,4,1, 36227
22,36226,4,4,1, 36230
24,36229,1,1,0, 36230
23,36228,3,3,0, 36231
31,36236,2,2,1, 36238
2,36243,2,2,1, 36245
1,36246,1,1,1, 36247
5,36247,3,5,1, 36252
6,36250,2,4,1, 36254
8,36256,1,1,0, 36257
9,36257,2,2,1, 36259
16,36259,2,2,0, 36261
17,36259,3,3,1, 36262
15,36261,2,2,1, 36263
20,36263,6,6,1, 36269
22,36266,4,4,0, 36270
24,36269,1,1,0, 36270
23,36268,3,3,1, 36271
28,36274,5,5,1, 36279
2,36283,2,2,1, 36285
1,36286,1,1,0, 36287
6,36290,2,4,1, 36294
8,36296,1,1,0, 36297
9,36297,2,2,1, 36299
16,36299,2,2,0, 36301
17,36299,3,3,1, 36302
15,36301,2,2,1, 36303
18,36303,4,4,1, 36307
22,36306,4,4,0, 36310
24,36309,1,1,1, 36310
23,36308,3,3,0, 36311
25,36315,2,2,1, 36317
31,36316,2,2,1, 36318
26,36317,3,3,1, 36320
2,36323,2,2,1, 36325
1,36326,1,1,0, 36327
5,36327,3,5,1, 36332
8,36336,1,1,0, 36337
9,36337,2,2,1, 36339
16,36339,2,2,1, 36341
15,36341,2,2,0, 36343
13,36339,4,6,1, 36345
12,36340,5,5,1, 36345
22,36346,4,4,0, 36350
24,36349,1,1,1, 36350
19,36346,5,5,1, 36351
23,36348,3,3,1, 36351
25,36355,2,2,1, 36357
31,36356,2,2,1, 36358
1,36366,1,1,0, 36367
3,36367,3,3,1, 36370
5,36367,3,5,1, 36372
6,36370,2,4,1, 36374
8,36376,1,1,1, 36377
11,36374,4,4,1, 36378
9,36377,2,2,1, 36379
16,36379,2,2,1, 36381
17,36379,3,3,1, 36382
15,36381,2,2,1, 36383
13,36379,4,6,1, 36385
12,36380,5,5,1, 36385
18,36383,4,4,1, 36387
22,36386,4,4,0, 36390
24,36389,1,1,1, 36390
23,36388,3,3,1, 36391
30,36393,3,3,1, 36396
28,36394,5,5,1, 36399
26,36397,3,3,1, 36400
1,36406,1,1,0, 36407
3,36407,3,3,1, 36410
6,36410,2,4,1, 36414
8,36416,1,1,0, 36417
16,36419,2,2,0, 36421
17,36419,3,3,1, 36422
15,36421,2,2,0, 36423
18,36423,4,4,1, 36427
22,36426,4,4,1, 36430
24,36429,1,1,1, 36430
19,36426,5,5,1, 36431
23,36428,3,3,1, 36431
25,36435,2,2,1, 36437
31,36436,2,2,1, 36438
29,36438,4,4,1, 36442
2,36443,2,2,1, 36445
1,36446,1,1,0, 36447
3,36447,3,3,1, 36450
5,36447,3,5,1, 36452
6,36450,2,4,1, 36454
8,36456,1,1,0, 36457
16,36459,2,2,1, 36461
15,36461,2,2,0, 36463
22,36466,4,4,1, 36470
24,36469,1,1,1, 36470
23,36468,3,3,0, 36471
5,36487,3,5,1, 36492
6,36490,2,4,1, 36494
8,36496,1,1,1, 36497
16,36499,2,2,1, 36501
15,36501,2,2,0, 36503
22,36506,4,4,1, 36510
24,36509,1,1,1, 36510
23,36508,3,3,1, 36511
30,36513,3,3,1, 36516
31,36516,2,2,1, 36518
28,36514,5,5,1, 36519
29,36518,4,4,1, 36522
5,36527,3,5,1, 36532
8,36536,1,1,1, 36537
16,36539,2,2,0, 36541
15,36541,2,2,1, 36543
22,36546,4,4,0, 36550
24,36549,1,1,1, 36550
23,36548,3,3,0, 36551
31,36556,2,2,1, 36558
26,36557,3,3,1, 36560
1,36566,1,1,0, 36567
8,36576,1,1,1, 36577
9,36577,2,2,1, 36579
16,36579,2,2,1, 36581
15,36581,2,2,0, 36583
12,36580,5,5,1, 36585
18,36583,4,4,1, 36587
22,36586,4,4,1, 36590
24,36589,1,1,0, 36590
23,36588,3,3,1, 36591
30,36593,3,3,1, 36596
1,36606,1,1,1, 36607
3,36607,3,3,1, 36610
8,36616,1,1,1, 36617
11,36614,4,4,1, 36618
9,36617,2,2,1, 36619
16,36619,2,2,1, 36621
15,36621,2,2,0, 36623
12,36620,5,5,1, 36625
20,36623,6,6,1, 36629
22,36626,4,4,1, 36630
24,36629,1,1,0, 36630
23,36628,3,3,1, 36631
29,36638,4,4,0, 36642
1,36646,1,1,1, 36647
3,36647,3,3,1, 36650
5,36647,3,5,1, 36652
6,36650,2,4,0, 36654
8,36656,1,1,0, 36657
11,36654,4,4,1, 36658
9,36657,2,2,1, 36659
16,36659,2,2,0, 36661
17,36659,3,3,1, 36662
15,36661,2,2,0, 36663
13,36659,4,6,1, 36665
18,36663,4,4,1, 36667
20,36663,6,6,1, 36669
22,36666,4,4,1, 36670
24,36669,1,1,0, 36670
23,36668,3,3,0, 36671
30,36673,3,3,1, 36676
31,36676,2,2,1, 36678
28,36674,5,5,0, 36679
26,36677,3,3,1, 36680
29,36678,4,4,1, 36682
1,36686,1,1,1, 36687
5,36687,3,5,0, 36692
6,36690,2,4,0, 36694
8,36696,1,1,0, 36697
11,36694,4,4,1, 36698
16,36699,2,2,0, 36701
17,36699,3,3,1, 36702
15,36701,2,2,0, 36703
13,36699,4,6,1, 36705
18,36703,4,4,1, 36707
20,36703,6,6,1, 36709
22,36706,4,4,1, 36710
24,36709,1,1,0, 36710
23,36708,3,3,0, 36711
30,36713,3,3,1, 36716
31,36716,2,2,1, 36718
28,36714,5,5,1, 36719
26,36717,3,3,1, 36720
29,36718,4,4,0, 36722
2,36723,2,2,1, 36725
1,36726,1,1,1, 36727
3,36727,3,3,1, 36730
5,36727,3,5,0, 36732
6,36730,2,4,0, 36734
8,36736,1,1,1, 36737
9,36737,2,2,1, 36739
16,36739,2,2,0, 36741
15,36741,2,2,0, 36743
13,36739,4,6,1, 36745
12,36740,5,5,1, 36745
20,36743,6,6,1, 36749
22,36746,4,4,0, 36750
24,36749,1,1,0, 36750
19,36746,5,5,1, 36751
23,36748,3,3,0, 36751
30,36753,3,3,0, 36756
31,36756,2,2,1, 36758
28,36754,5,5,0, 36759
29,36758,4,4,0, 36762
2,36763,2,2,1, 36765
1,36766,1,1,1, 36767
5,36767,3,5,1, 36772
6,36770,2,4,1, 36774
8,36776,1,1,0, 36777
11,36774,4,4,1, 36778
16,36779,2,2,1, 36781
15,36781,2,2,1, 36783
12,36780,5,5,1, 36785
22,36786,4,4,1, 36790
24,36789,1,1,1, 36790
23,36788,3,3,1, 36791
30,36793,3,3,0, 36796
31,36796,2,2,1, 36798
28,36794,5,5,1, 36799
29,36798,4,4,1, 36802
5,36807,3,5,0, 36812
6,36810,2,4,1, 36814
8,36816,1,1,1, 36817
16,36819,2,2,1, 36821
15,36821,2,2,1, 36823
22,36826,4,4,1, 36830
24,36829,1,1,1, 36830
23,36828,3,3,0, 36831
30,36833,3,3,1, 36836
31,36836,2,2,0, 36838
28,36834,5,5,0, 36839
29,36838,4,4,1, 36842
5,36847,3,5,1, 36852
6,36850,2,4,0, 36854
8,36856,1,1,0, 36857
16,36859,2,2,1, 36861
15,36861,2,2,0, 36863
22,36866,4,4,0, 36870
24,36869,1,1,0, 36870
23,36868,3,3,0, 36871
30,36873,3,3,0, 36876
31,36876,2,2,1, 36878
28,36874,5,5,0, 36879
29,36878,4,4,1, 36882
3,36887,3,3,1, 36890
5,36887,3,5,0, 36892
6,36890,2,4,1, 36894
8,36896,1,1,1, 36897
11,36894,4,4,1, 36898
16,36899,2,2,0, 36901
15,36901,2,2,0, 36903
22,36906,4,4,0, 36910
24,36909,1,1,1, 36910
23,36908,3,3,1, 36911
30,36913,3,3,1, 36916
31,36916,2,2,0, 36918
28,36914,5,5,1, 36919
29,36918,4,4,1, 36922
1,36926,1,1,0, 36927
5,36927,3,5,1, 36932
6,36930,2,4,1, 36934
8,36936,1,1,1, 36937
16,36939,2,2,0, 36941
17,36939,3,3,1, 36942
15,36941,2,2,0, 36943
22,36946,4,4,1, 36950
24,36949,1,1,1, 36950
23,36948,3,3,0, 36951
30,36953,3,3,1, 36956
31,36956,2,2,0, 36958
28,36954,5,5,0, 36959
29,36958,4,4,0, 36962
1,36966,1,1,1, 36967
5,36967,3,5,1, 36972
6,36970,2,4,0, 36974
8,36976,1,1,1, 36977
16,36979,2,2,0, 36981
15,36981,2,2,1, 36983
22,36986,4,4,1, 36990
24,36989,1,1,0, 36990
23,36988,3,3,0, 36991
30,36993,3,3,0, 36996
25,36995,2,2,1, 36997
31,36996,2,2,0, 36998
28,36994,5,5,0, 36999
29,36998,4,4,0, 37002
1,37006,1,1,1, 37007
3,37007,3,3,1, 37010
5,37007,3,5,1, 37012
6,37010,2,4,1, 37014
8,37016,1,1,1, 37017
9,37017,2,2,1, 37019
16,37019,2,2,0, 37021
15,37021,2,2,1, 37023
13,37019,4,6,1, 37025
22,37026,4,4,1, 37030
24,37029,1,1,1, 37030
19,37026,5,5,1, 37031
23,37028,3,3,0, 37031
30,37033,3,3,0, 37036
31,37036,2,2,1, 37038
28,37034,5,5,1, 37039
2,37043,2,2,1, 37045
1,37046,1,1,1, 37047
3,37047,3,3,1, 37050
6,37050,2,4,1, 37054
8,37056,1,1,0, 37057
9,37057,2,2,1, 37059
16,37059,2,2,1, 37061
15,37061,2,2,1, 37063
13,37059,4,6,1, 37065
12,37060,5,5,1, 37065
18,37063,4,4,1, 37067
20,37063,6,6,1, 37069
22,37066,4,4,1, 37070
24,37069,1,1,0, 37070
19,37066,5,5,1, 37071
23,37068,3,3,1, 37071
30,37073,3,3,1, 37076
31,37076,2,2,1, 37078
26,37077,3,3,1, 37080
29,37078,4,4,1, 37082
1,37086,1,1,1, 37087
8,37096,1,1,1, 37097
9,37097,2,2,1, 37099
16,37099,2,2,0, 37101
15,37101,2,2,1, 37103
18,37103,4,4,1, 37107
20,37103,6,6,1, 37109
22,37106,4,4,0, 37110
24,37109,1,1,1, 37110
23,37108,3,3,0, 37111
30,37113,3,3,1, 37116
26,37117,3,3,1, 37120
29,37118,4,4,1, 37122
1,37126,1,1,1, 37127
3,37127,3,3,1, 37130
8,37136,1,1,0, 37137
11,37134,4,4,1, 37138
16,37139,2,2,0, 37141
15,37141,2,2,1, 37143
12,37140,5,5,1, 37145
18,37143,4,4,1, 37147
22,37146,4,4,1, 37150
24,37149,1,1,1, 37150
19,37146,5,5,1, 37151
23,37148,3,3,0, 37151
30,37153,3,3,1, 37156
31,37156,2,2,1, 37158
28,37154,5,5,1, 37159
29,37158,4,4,1, 37162
2,37163,2,2,1, 37165
1,37166,1,1,0, 37167
8,37176,1,1,0, 37177
9,37177,2,2,1, 37179
16,37179,2,2,1, 37181
17,37179,3,3,1, 37182
15,37181,2,2,1, 37183
12,37180,5,5,1, 37185
22,37186,4,4,1, 37190
24,37189,1,1,1, 37190
23,37188,3,3,0, 37191
30,37193,3,3,1, 37196
25,37195,2,2,1, 37197
28,37194,5,5,1, 37199
26,37197,3,3,1, 37200
2,37203,2,2,1, 37205
1,37206,1,1,1, 37207
8,37216,1,1,0, 37217
16,37219,2,2,0, 37221
15,37221,2,2,0, 37223
13,37219,4,6,1, 37225
12,37220,5,5,1, 37225
18,37223,4,4,1, 37227
20,37223,6,6,1, 37229
22,37226,4,4,1, 37230
24,37229,1,1,0, 37230
23,37228,3,3,0, 37231
31,37236,2,2,1, 37238
29,37238,4,4,1, 37242
2,37243,2,2,1, 37245
1,37246,1,1,1, 37247
3,37247,3,3,1, 37250
8,37256,1,1,1, 37257
16,37259,2,2,1, 37261
17,37259,3,3,1, 37262
15,37261,2,2,0, 37263
13,37259,4,6,1, 37265
22,37266,4,4,0, 37270
24,37269,1,1,1, 37270
23,37268,3,3,0, 37271
25,37275,2,2,1, 37277
26,37277,3,3,1, 37280
1,37286,1,1,0, 37287
5,37287,3,5,1, 37292
8,37296,1,1,0, 37297
16,37299,2,2,0, 37301
17,37299,3,3,1, 37302
15,37301,2,2,0, 37303
13,37299,4,6,1, 37305
12,37300,5,5,1, 37305
18,37303,4,4,1, 37307
20,37303,6,6,1, 37309
22,37306,4,4,0, 37310
24,37309,1,1,0, 37310
23,37308,3,3,0, 37311
30,37313,3,3,1, 37316
31,37316,2,2,1, 37318
2,37323,2,2,1, 37325
1,37326,1,1,0, 37327
3,37327,3,3,1, 37330
8,37336,1,1,1, 37337
9,37337,2,2,1, 37339
16,37339,2,2,1, 37341
15,37341,2,2,0, 37343
12,37340,5,5,1, 37345
20,37343,6,6,1, 37349
22,37346,4,4,1, 37350
24,37349,1,1,0, 37350
23,37348,3,3,0, 37351
30,37353,3,3,1, 37356
25,37355,2,2,1, 37357
31,37356,2,2,1, 37358
26,37357,3,3,1, 37360
29,37358,4,4,1, 37362
1,37366,1,1,0, 37367
5,37367,3,5,1, 37372
6,37370,2,4,1, 37374
8,37376,1,1,1, 37377
9,37377,2,2,1, 37379
16,37379,2,2,1, 37381
15,37381,2,2,0, 37383
18,37383,4,4,1, 37387
22,37386,4,4,0, 37390
24,37389,1,1,0, 37390
23,37388,3,3,0, 37391
25,37395,2,2,1, 37397
28,37394,5,5,1, 37399
2,37403,2,2,1, 37405
1,37406,1,1,0, 37407
3,37407,3,3,1, 37410
5,37407,3,5,1, 37412
6,37410,2,4,1, 37414
8,37416,1,1,0, 37417
16,37419,2,2,0, 37421
15,37421,2,2,0, 37423
22,37426,4,4,0, 37430
24,37429,1,1,0, 37430
23,37428,3,3,1, 37431
5,37447,3,5,1, 37452
8,37456,1,1,0, 37457
16,37459,2,2,0, 37461
15,37461,2,2,0, 37463
22,37466,4,4,0, 37470
24,37469,1,1,0, 37470
23,37468,3,3,0, 37471
28,37474,5,5,1, 37479
5,37487,3,5,1, 37492
6,37490,2,4,1, 37494
8,37496,1,1,1, 37497
16,37499,2,2,1, 37501
15,37501,2,2,1, 37503
22,37506,4,4,1, 37510
24,37509,1,1,0, 37510
23,37508,3,3,1, 37511
30,37513,3,3,1, 37516
25,37515,2,2,1, 37517
26,37517,3,3,1, 37520
1,37526,1,1,1, 37527
3,37527,3,3,1, 37530
6,37530,2,4,1, 37534
8,37536,1,1,0, 37537
11,37534,4,4,1, 37538
17,37539,3,3,1, 37542
12,37540,5,5,1, 37545
22,37546,4,4,1, 37550
24,37549,1,1,0, 37550
23,37548,3,3,1, 37551
30,37553,3,3,1, 37556
28,37554,5,5,1, 37559
26,37557,3,3,1, 37560
29,37558,4,4,1, 37562
2,37563,2,2,1, 37565
1,37566,1,1,0, 37567
3,37567,3,3,1, 37570
5,37567,3,5,1, 37572
6,37570,2,4,1, 37574
8,37576,1,1,1, 37577
17,37579,3,3,1, 37582
15,37581,2,2,1, 37583
13,37579,4,6,1, 37585
20,37583,6,6,1, 37589
22,37586,4,4,1, 37590
24,37589,1,1,1, 37590
19,37586,5,5,1, 37591
29,37598,4,4,1, 37602
1,37606,1,1,0, 37607
3,37607,3,3,1, 37610
5,37607,3,5,1, 37612
8,37616,1,1,1, 37617
9,37617,2,2,1, 37619
15,37621,2,2,1, 37623
18,37623,4,4,1, 37627
20,37623,6,6,1, 37629
22,37626,4,4,1, 37630
24,37629,1,1,0, 37630
23,37628,3,3,1, 37631
30,37633,3,3,1, 37636
29,37638,4,4,1, 37642
2,37643,2,2,1, 37645
1,37646,1,1,1, 37647
5,37647,3,5,1, 37652
8,37656,1,1,0, 37657
11,37654,4,4,1, 37658
13,37659,4,6,1, 37665
22,37666,4,4,1, 37670
24,37669,1,1,1, 37670
19,37666,5,5,1, 37671
30,37673,3,3,1, 37676
25,37675,2,2,1, 37677
31,37676,2,2,1, 37678
26,37677,3,3,1, 37680
1,37686,1,1,0, 37687
5,37687,3,5,1, 37692
6,37690,2,4,1, 37694
8,37696,1,1,1, 37697
11,37694,4,4,1, 37698
9,37697,2,2,1, 37699
16,37699,2,2,1, 37701
17,37699,3,3,1, 37702
15,37701,2,2,1, 37703
13,37699,4,6,1, 37705
22,37706,4,4,1, 37710
24,37709,1,1,0, 37710
19,37706,5,5,1, 37711
23,37708,3,3,1, 37711
30,37713,3,3,1, 37716
28,37714,5,5,1, 37719
26,37717,3,3,1, 37720
2,37723,2,2,1, 37725
1,37726,1,1,1, 37727
8,37736,1,1,1, 37737
11,37734,4,4,1, 37738
9,37737,2,2,1, 37739
16,37739,2,2,1, 37741
15,37741,2,2,1, 37743
18,37743,4,4,1, 37747
20,37743,6,6,1, 37749
24,37749,1,1,0, 37750
23,37748,3,3,1, 37751
30,37753,3,3,1, 37756
25,37755,2,2,1, 37757
29,37758,4,4,1, 37762
2,37763,2,2,1, 37765
1,37766,1,1,0, 37767
3,37767,3,3,1, 37770
6,37770,2,4,1, 37774
8,37776,1,1,1, 37777
16,37779,2,2,1, 37781
22,37786,4,4,1, 37790
24,37789,1,1,1, 37790
29,37798,4,4,1, 37802
5,37807,3,5,1, 37812
6,37810,2,4,1, 37814
8,37816,1,1,0, 37817
16,37819,2,2,1, 37821
15,37821,2,2,1, 37823
24,37829,1,1,0, 37830
23,37828,3,3,1, 37831
31,37836,2,2,1, 37838
29,37838,4,4,1, 37842
5,37847,3,5,1, 37852
8,37856,1,1,0, 37857
16,37859,2,2,1, 37861
15,37861,2,2,1, 37863
22,37866,4,4,1, 37870
24,37869,1,1,0, 37870
26,37877,3,3,1, 37880
2,37883,2,2,1, 37885
1,37886,1,1,0, 37887
6,37890,2,4,1, 37894
8,37896,1,1,0, 37897
11,37894,4,4,1, 37898
9,37897,2,2,1, 37899
16,37899,2,2,1, 37901
17,37899,3,3,1, 37902
12,37900,5,5,1, 37905
24,37909,1,1,0, 37910
30,37913,3,3,1, 37916
31,37916,2,2,1, 37918
2,37923,2,2,1, 37925
1,37926,1,1,0, 37927
3,37927,3,3,1, 37930
8,37936,1,1,1, 37937
9,37937,2,2,1, 37939
17,37939,3,3,1, 37942
12,37940,5,5,1, 37945
24,37949,1,1,0, 37950
19,37946,5,5,1, 37951
23,37948,3,3,1, 37951
30,37953,3,3,1, 37956
31,37956,2,2,1, 37958
26,37957,3,3,1, 37960
2,37963,2,2,1, 37965
1,37966,1,1,0, 37967
5,37967,3,5,1, 37972
8,37976,1,1,1, 37977
16,37979,2,2,1, 37981
17,37979,3,3,1, 37982
13,37979,4,6,1, 37985
12,37980,5,5,1, 37985
18,37983,4,4,1, 37987
20,37983,6,6,1, 37989
22,37986,4,4,1, 37990
24,37989,1,1,0, 37990
19,37986,5,5,1, 37991
23,37988,3,3,1, 37991
31,37996,2,2,1, 37998
26,37997,3,3,1, 38000
29,37998,4,4,1, 38002
1,38006,1,1,1, 38007
3,38007,3,3,1, 38010
8,38016,1,1,1, 38017
11,38014,4,4,1, 38018
16,38019,2,2,1, 38021
12,38020,5,5,1, 38025
20,38023,6,6,1, 38029
24,38029,1,1,1, 38030
30,38033,3,3,1, 38036
28,38034,5,5,1, 38039
26,38037,3,3,1, 38040
29,38038,4,4,1, 38042
1,38046,1,1,0, 38047
5,38047,3,5,1, 38052
8,38056,1,1,0, 38057
16,38059,2,2,1, 38061
17,38059,3,3,1, 38062
15,38061,2,2,1, 38063
22,38066,4,4,1, 38070
24,38069,1,1,0, 38070
23,38068,3,3,1, 38071
30,38073,3,3,1, 38076
25,38075,2,2,1, 38077
31,38076,2,2,1, 38078
28,38074,5,5,1, 38079
1,38086,1,1,0, 38087
6,38090,2,4,1, 38094
8,38096,1,1,1, 38097
9,38097,2,2,1, 38099
16,38099,2,2,1, 38101
15,38101,2,2,1, 38103
24,38109,1,1,1, 38110
23,38108,3,3,1, 38111
31,38116,2,2,1, 38118
28,38114,5,5,1, 38119
1,38126,1,1,0, 38127
6,38130,2,4,1, 38134
8,38136,1,1,0, 38137
9,38137,2,2,1, 38139
20,38143,6,6,1, 38149
24,38149,1,1,1, 38150
23,38148,3,3,1, 38151
31,38156,2,2,1, 38158
26,38157,3,3,1, 38160
2,38163,2,2,1, 38165
1,38166,1,1,1, 38167
6,38170,2,4,1, 38174
8,38176,1,1,0, 38177
9,38177,2,2,1, 38179
16,38179,2,2,1, 38181
20,38183,6,6,1, 38189
22,38186,4,4,1, 38190
24,38189,1,1,0, 38190
19,38186,5,5,1, 38191
25,38195,2,2,1, 38197
26,38197,3,3,1, 38200
2,38203,2,2,1, 38205
1,38206,1,1,1, 38207
5,38207,3,5,1, 38212
8,38216,1,1,0, 38217
9,38217,2,2,1, 38219
16,38219,2,2,1, 38221
17,38219,3,3,1, 38222
15,38221,2,2,1, 38223
24,38229,1,1,1, 38230
23,38228,3,3,1, 38231
25,38235,2,2,1, 38237
28,38234,5,5,1, 38239
29,38238,4,4,1, 38242
2,38243,2,2,1, 38245
1,38246,1,1,0, 38247
3,38247,3,3,1, 38250
5,38247,3,5,1, 38252
8,38256,1,1,1, 38257
11,38254,4,4,1, 38258
9,38257,2,2,1, 38259
16,38259,2,2,1, 38261
17,38259,3,3,1, 38262
15,38261,2,2,1, 38263
18,38263,4,4,1, 38267
20,38263,6,6,1, 38269
24,38269,1,1,0, 38270
19,38266,5,5,1, 38271
23,38268,3,3,1, 38271
25,38275,2,2,1, 38277
31,38276,2,2,1, 38278
28,38274,5,5,1, 38279
29,38278,4,4,1, 38282
5,38287,3,5,1, 38292
8,38296,1,1,0, 38297
22,38306,4,4,1, 38310
24,38309,1,1,0, 38310
30,38313,3,3,1, 38316
31,38316,2,2,1, 38318
29,38318,4,4,1, 38322
8,38336,1,1,1, 38337
15,38341,2,2,1, 38343
24,38349,1,1,0, 38350
30,38353,3,3,1, 38356
31,38356,2,2,1, 38358
28,38354,5,5,1, 38359
6,38370,2,4,1, 38374
8,38376,1,1,1, 38377
16,38379,2,2,1, 38381
17,38379,3,3,1, 38382
15,38381,2,2,0, 38383
13,38379,4,6,1, 38385
22,38386,4,4,1, 38390
24,38389,1,1,1, 38390
23,38388,3,3,0, 38391
30,38393,3,3,1, 38396
25,38395,2,2,1, 38397
31,38396,2,2,1, 38398
28,38394,5,5,1, 38399
26,38397,3,3,1, 38400
2,38403,2,2,1, 38405
1,38406,1,1,0, 38407
3,38407,3,3,1, 38410
5,38407,3,5,1, 38412
8,38416,1,1,0, 38417
11,38414,4,4,1, 38418
16,38419,2,2,1, 38421
17,38419,3,3,1, 38422
15,38421,2,2,1, 38423
13,38419,4,6,1, 38425
18,38423,4,4,1, 38427
20,38423,6,6,1, 38429
22,38426,4,4,1, 38430
24,38429,1,1,0, 38430
19,38426,5,5,1, 38431
23,38428,3,3,0, 38431
30,38433,3,3,1, 38436
31,38436,2,2,1, 38438
28,38434,5,5,1, 38439
29,38438,4,4,1, 38442
1,38446,1,1,0, 38447
3,38447,3,3,1, 38450
5,38447,3,5,1, 38452
6,38450,2,4,1, 38454
8,38456,1,1,1, 38457
16,38459,2,2,1, 38461
17,38459,3,3,1, 38462
15,38461,2,2,0, 38463
13,38459,4,6,1, 38465
22,38466,4,4,0, 38470
24,38469,1,1,1, 38470
23,38468,3,3,1, 38471
30,38473,3,3,1, 38476
31,38476,2,2,1, 38478
28,38474,5,5,1, 38479
1,38486,1,1,1, 38487
5,38487,3,5,1, 38492
6,38490,2,4,1, 38494
8,38496,1,1,1, 38497
16,38499,2,2,0, 38501
15,38501,2,2,1, 38503
13,38499,4,6,1, 38505
12,38500,5,5,1, 38505
18,38503,4,4,1, 38507
20,38503,6,6,1, 38509
22,38506,4,4,0, 38510
24,38509,1,1,0, 38510
19,38506,5,5,1, 38511
23,38508,3,3,1, 38511
28,38514,5,5,1, 38519
2,38523,2,2,1, 38525
1,38526,1,1,1, 38527
8,38536,1,1,0, 38537
11,38534,4,4,1, 38538
16,38539,2,2,1, 38541
17,38539,3,3,1, 38542
15,38541,2,2,1, 38543
12,38540,5,5,1, 38545
20,38543,6,6,1, 38549
22,38546,4,4,0, 38550
24,38549,1,1,0, 38550
23,38548,3,3,0, 38551
30,38553,3,3,1, 38556
1,38566,1,1,1, 38567
3,38567,3,3,1, 38570
5,38567,3,5,1, 38572
8,38576,1,1,1, 38577
9,38577,2,2,1, 38579
16,38579,2,2,1, 38581
15,38581,2,2,0, 38583
13,38579,4,6,1, 38585
18,38583,4,4,1, 38587
22,38586,4,4,1, 38590
24,38589,1,1,1, 38590
23,38588,3,3,1, 38591
30,38593,3,3,1, 38596
31,38596,2,2,1, 38598
28,38594,5,5,1, 38599
29,38598,4,4,1, 38602
1,38606,1,1,1, 38607
5,38607,3,5,1, 38612
8,38616,1,1,0, 38617
11,38614,4,4,1, 38618
9,38617,2,2,1, 38619
16,38619,2,2,1, 38621
17,38619,3,3,1, 38622
15,38621,2,2,1, 38623
22,38626,4,4,0, 38630
24,38629,1,1,0, 38630
23,38628,3,3,1, 38631
25,38635,2,2,1, 38637
31,38636,2,2,1, 38638
2,38643,2,2,1, 38645
1,38646,1,1,0, 38647
3,38647,3,3,1, 38650
5,38647,3,5,1, 38652
6,38650,2,4,1, 38654
8,38656,1,1,1, 38657
16,38659,2,2,1, 38661
15,38661,2,2,1, 38663
13,38659,4,6,1, 38665
12,38660,5,5,1, 38665
18,38663,4,4,1, 38667
22,38666,4,4,0, 38670
24,38669,1,1,0, 38670
23,38668,3,3,1, 38671
30,38673,3,3,1, 38676
31,38676,2,2,1, 38678
26,38677,3,3,1, 38680
29,38678,4,4,1, 38682
2,38683,2,2,1, 38685
1,38686,1,1,1, 38687
3,38687,3,3,1, 38690
6,38690,2,4,1, 38694
8,38696,1,1,1, 38697
16,38699,2,2,1, 38701
15,38701,2,2,1, 38703
22,38706,4,4,0, 38710
24,38709,1,1,1, 38710
23,38708,3,3,0, 38711
28,38714,5,5,1, 38719
5,38727,3,5,1, 38732
8,38736,1,1,0, 38737
16,38739,2,2,1, 38741
15,38741,2,2,1, 38743
22,38746,4,4,1, 38750
24,38749,1,1,1, 38750
23,38748,3,3,1, 38751
30,38753,3,3,1, 38756
28,38754,5,5,1, 38759
8,38776,1,1,0, 38777
16,38779,2,2,0, 38781
15,38781,2,2,1, 38783
22,38786,4,4,1, 38790
24,38789,1,1,0, 38790
23,38788,3,3,1, 38791
30,38793,3,3,1, 38796
26,38797,3,3,1, 38800
29,38798,4,4,1, 38802
1,38806,1,1,0, 38807
3,38807,3,3,1, 38810
8,38816,1,1,0, 38817
16,38819,2,2,1, 38821
17,38819,3,3,1, 38822
15,38821,2,2,0, 38823
13,38819,4,6,1, 38825
12,38820,5,5,1, 38825
22,38826,4,4,1, 38830
24,38829,1,1,1, 38830
19,38826,5,5,1, 38831
23,38828,3,3,1, 38831
30,38833,3,3,1, 38836
31,38836,2,2,1, 38838
26,38837,3,3,1, 38840
29,38838,4,4,1, 38842
2,38843,2,2,1, 38845
1,38846,1,1,1, 38847
8,38856,1,1,1, 38857
11,38854,4,4,1, 38858
9,38857,2,2,1, 38859
16,38859,2,2,1, 38861
15,38861,2,2,0, 38863
13,38859,4,6,1, 38865
12,38860,5,5,1, 38865
22,38866,4,4,0, 38870
24,38869,1,1,0, 38870
23,38868,3,3,0, 38871
25,38875,2,2,1, 38877
28,38874,5,5,1, 38879
29,38878,4,4,1, 38882
2,38883,2,2,1, 38885
1,38886,1,1,0, 38887
5,38887,3,5,1, 38892
8,38896,1,1,1, 38897
11,38894,4,4,1, 38898
9,38897,2,2,1, 38899
16,38899,2,2,0, 38901
15,38901,2,2,0, 38903
13,38899,4,6,1, 38905
12,38900,5,5,1, 38905
18,38903,4,4,1, 38907
22,38906,4,4,0, 38910
24,38909,1,1,0, 38910
19,38906,5,5,1, 38911
23,38908,3,3,0, 38911
25,38915,2,2,1, 38917
1,38926,1,1,0, 38927
5,38927,3,5,1, 38932
6,38930,2,4,0, 38934
8,38936,1,1,1, 38937
9,38937,2,2,1, 38939
16,38939,2,2,0, 38941
15,38941,2,2,1, 38943
18,38943,4,4,1, 38947
20,38943,6,6,1, 38949
22,38946,4,4,1, 38950
24,38949,1,1,0, 38950
23,38948,3,3,1, 38951
30,38953,3,3,1, 38956
25,38955,2,2,1, 38957
31,38956,2,2,0, 38958
28,38954,5,5,0, 38959
29,38958,4,4,1, 38962
1,38966,1,1,1, 38967
3,38967,3,3,1, 38970
5,38967,3,5,1, 38972
6,38970,2,4,0, 38974
8,38976,1,1,1, 38977
11,38974,4,4,1, 38978
9,38977,2,2,1, 38979
16,38979,2,2,0, 38981
15,38981,2,2,0, 38983
18,38983,4,4,1, 38987
22,38986,4,4,0, 38990
24,38989,1,1,1, 38990
23,38988,3,3,0, 38991
30,38993,3,3,0, 38996
31,38996,2,2,0, 38998
28,38994,5,5,1, 38999
26,38997,3,3,1, 39000
29,38998,4,4,0, 39002
1,39006,1,1,0, 39007
3,39007,3,3,1, 39010
5,39007,3,5,0, 39012
6,39010,2,4,1, 39014
8,39016,1,1,0, 39017
9,39017,2,2,1, 39019
16,39019,2,2,1, 39021
17,39019,3,3,1, 39022
15,39021,2,2,0, 39023
13,39019,4,6,1, 39025
20,39023,6,6,1, 39029
22,39026,4,4,0, 39030
24,39029,1,1,0, 39030
23,39028,3,3,1, 39031
30,39033,3,3,1, 39036
31,39036,2,2,1, 39038
28,39034,5,5,0, 39039
29,39038,4,4,0, 39042
5,39047,3,5,1, 39052
6,39050,2,4,1, 39054
8,39056,1,1,0, 39057
16,39059,2,2,0, 39061
15,39061,2,2,1, 39063
22,39066,4,4,0, 39070
24,39069,1,1,0, 39070
23,39068,3,3,0, 39071
30,39073,3,3,0, 39076
31,39076,2,2,1, 39078
28,39074,5,5,1, 39079
29,39078,4,4,0, 39082
5,39087,3,5,1, 39092
6,39090,2,4,1, 39094
8,39096,1,1,0, 39097
16,39099,2,2,1, 39101
15,39101,2,2,0, 39103
22,39106,4,4,0, 39110
24,39109,1,1,1, 39110
23,39108,3,3,1, 39111
30,39113,3,3,0, 39116
31,39116,2,2,1, 39118
28,39114,5,5,0, 39119
29,39118,4,4,0, 39122
5,39127,3,5,0, 39132
6,39130,2,4,1, 39134
8,39136,1,1,1, 39137
11,39134,4,4,1, 39138
16,39139,2,2,1, 39141
17,39139,3,3,1, 39142
15,39141,2,2,1, 39143
12,39140,5,5,1, 39145
20,39143,6,6,1, 39149
22,39146,4,4,0, 39150
24,39149,1,1,0, 39150
19,39146,5,5,1, 39151
23,39148,3,3,0, 39151
30,39153,3,3,1, 39156
31,39156,2,2,0, 39158
28,39154,5,5,0, 39159
29,39158,4,4,0, 39162
2,39163,2,2,1, 39165
1,39166,1,1,0, 39167
3,39167,3,3,1, 39170
5,39167,3,5,0, 39172
6,39170,2,4,1, 39174
8,39176,1,1,0, 39177
9,39177,2,2,1, 39179
16,39179,2,2,1, 39181
17,39179,3,3,1, 39182
15,39181,2,2,0, 39183
12,39180,5,5,1, 39185
22,39186,4,4,1, 39190
24,39189,1,1,0, 39190
23,39188,3,3,1, 39191
30,39193,3,3,1, 39196
31,39196,2,2,1, 39198
28,39194,5,5,1, 39199
29,39198,4,4,0, 39202
1,39206,1,1,1, 39207
3,39207,3,3,1, 39210
5,39207,3,5,1, 39212
6,39210,2,4,0, 39214
8,39216,1,1,0, 39217
9,39217,2,2,1, 39219
16,39219,2,2,1, 39221
17,39219,3,3,1, 39222
15,39221,2,2,0, 39223
12,39220,5,5,1, 39225
22,39226,4,4,0, 39230
24,39229,1,1,0, 39230
19,39226,5,5,1, 39231
23,39228,3,3,1, 39231
30,39233,3,3,1, 39236
25,39235,2,2,1, 39237
31,39236,2,2,0, 39238
28,39234,5,5,1, 39239
26,39237,3,3,1, 39240
29,39238,4,4,1, 39242
1,39246,1,1,0, 39247
3,39247,3,3,1, 39250
5,39247,3,5,1, 39252
6,39250,2,4,1, 39254
8,39256,1,1,0, 39257
11,39254,4,4,1, 39258
9,39257,2,2,1, 39259
16,39259,2,2,0, 39261
17,39259,3,3,1, 39262
15,39261,2,2,1, 39263
12,39260,5,5,1, 39265
20,39263,6,6,1, 39269
22,39266,4,4,0, 39270
24,39269,1,1,1, 39270
23,39268,3,3,1, 39271
31,39276,2,2,1, 39278
28,39274,5,5,1, 39279
1,39286,1,1,0, 39287
3,39287,3,3,1, 39290
5,39287,3,5,1, 39292
8,39296,1,1,0, 39297
16,39299,2,2,1, 39301
15,39301,2,2,0, 39303
13,39299,4,6,1, 39305
12,39300,5,5,1, 39305
22,39306,4,4,0, 39310
24,39309,1,1,0, 39310
23,39308,3,3,0, 39311
30,39313,3,3,1, 39316
31,39316,2,2,1, 39318
26,39317,3,3,1, 39320
1,39326,1,1,1, 39327
3,39327,3,3,1, 39330
5,39327,3,5,1, 39332
6,39330,2,4,1, 39334
8,39336,1,1,1, 39337
16,39339,2,2,1, 39341
17,39339,3,3,1, 39342
15,39341,2,2,0, 39343
13,39339,4,6,1, 39345
18,39343,4,4,1, 39347
20,39343,6,6,1, 39349
22,39346,4,4,0, 39350
24,39349,1,1,1, 39350
23,39348,3,3,0, 39351
30,39353,3,3,1, 39356
25,39355,2,2,1, 39357
31,39356,2,2,0, 39358
28,39354,5,5,1, 39359
29,39358,4,4,1, 39362
1,39366,1,1,0, 39367
5,39367,3,5,1, 39372
8,39376,1,1,0, 39377
16,39379,2,2,0, 39381
17,39379,3,3,1, 39382
15,39381,2,2,1, 39383
13,39379,4,6,1, 39385
12,39380,5,5,1, 39385
18,39383,4,4,1, 39387
22,39386,4,4,1, 39390
24,39389,1,1,1, 39390
19,39386,5,5,1, 39391
23,39388,3,3,1, 39391
30,39393,3,3,1, 39396
31,39396,2,2,1, 39398
29,39398,4,4,1, 39402
2,39403,2,2,1, 39405
1,39406,1,1,0, 39407
8,39416,1,1,1, 39417
11,39414,4,4,1, 39418
16,39419,2,2,0, 39421
15,39421,2,2,0, 39423
22,39426,4,4,1, 39430
24,39429,1,1,0, 39430
23,39428,3,3,0, 39431
30,39433,3,3,1, 39436
31,39436,2,2,1, 39438
29,39438,4,4,1, 39442
5,39447,3,5,1, 39452
6,39450,2,4,1, 39454
8,39456,1,1,0, 39457
16,39459,2,2,1, 39461
15,39461,2,2,1, 39463
22,39466,4,4,1, 39470
24,39469,1,1,1, 39470
23,39468,3,3,0, 39471
30,39473,3,3,1, 39476
31,39476,2,2,1, 39478
5,39487,3,5,1, 39492
6,39490,2,4,1, 39494
8,39496,1,1,1, 39497
16,39499,2,2,1, 39501
15,39501,2,2,0, 39503
22,39506,4,4,0, 39510
24,39509,1,1,0, 39510
23,39508,3,3,1, 39511
28,39514,5,5,1, 39519
1,39526,1,1,1, 39527
5,39527,3,5,1, 39532
6,39530,2,4,1, 39534
8,39536,1,1,0, 39537
16,39539,2,2,1, 39541
17,39539,3,3,1, 39542
15,39541,2,2,0, 39543
22,39546,4,4,0, 39550
24,39549,1,1,1, 39550
23,39548,3,3,0, 39551
30,39553,3,3,1, 39556
25,39555,2,2,1, 39557
28,39554,5,5,1, 39559
1,39566,1,1,0, 39567
5,39567,3,5,1, 39572
6,39570,2,4,1, 39574
8,39576,1,1,1, 39577
9,39577,2,2,1, 39579
16,39579,2,2,0, 39581
15,39581,2,2,1, 39583
13,39579,4,6,1, 39585
12,39580,5,5,1, 39585
20,39583,6,6,1, 39589
22,39586,4,4,0, 39590
24,39589,1,1,0, 39590
19,39586,5,5,1, 39591
23,39588,3,3,1, 39591
25,39595,2,2,1, 39597
28,39594,5,5,1, 39599
29,39598,4,4,1, 39602
1,39606,1,1,1, 39607
3,39607,3,3,1, 39610
8,39616,1,1,0, 39617
9,39617,2,2,1, 39619
16,39619,2,2,0, 39621
15,39621,2,2,0, 39623
13,39619,4,6,1, 39625
18,39623,4,4,1, 39627
20,39623,6,6,1, 39629
22,39626,4,4,0, 39630
24,39629,1,1,1, 39630
23,39628,3,3,0, 39631
29,39638,4,4,1, 39642
1,39646,1,1,1, 39647
6,39650,2,4,1, 39654
8,39656,1,1,0, 39657
9,39657,2,2,1, 39659
16,39659,2,2,0, 39661
17,39659,3,3,1, 39662
15,39661,2,2,0, 39663
13,39659,4,6,1, 39665
22,39666,4,4,0, 39670
24,39669,1,1,0, 39670
19,39666,5,5,1, 39671
23,39668,3,3,0, 39671
25,39675,2,2,1, 39677
31,39676,2,2,1, 39678
29,39678,4,4,1, 39682
1,39686,1,1,0, 39687
3,39687,3,3,1, 39690
6,39690,2,4,1, 39694
8,39696,1,1,0, 39697
11,39694,4,4,1, 39698
9,39697,2,2,1, 39699
16,39699,2,2,1, 39701
17,39699,3,3,1, 39702
15,39701,2,2,1, 39703
13,39699,4,6,1, 39705
12,39700,5,5,1, 39705
20,39703,6,6,1, 39709
22,39706,4,4,0, 39710
24,39709,1,1,0, 39710
23,39708,3,3,0, 39711
31,39716,2,2,1, 39718
29,39718,4,4,1, 39722
2,39723,2,2,1, 39725
1,39726,1,1,1, 39727
5,39727,3,5,1, 39732
8,39736,1,1,1, 39737
11,39734,4,4,1, 39738
16,39739,2,2,1, 39741
15,39741,2,2,0, 39743
18,39743,4,4,1, 39747
20,39743,6,6,1, 39749
22,39746,4,4,0, 39750
24,39749,1,1,1, 39750
23,39748,3,3,1, 39751
25,39755,2,2,1, 39757
31,39756,2,2,1, 39758
2,39763,2,2,1, 39765
1,39766,1,1,1, 39767
3,39767,3,3,1, 39770
8,39776,1,1,1, 39777
11,39774,4,4,1, 39778
16,39779,2,2,1, 39781
15,39781,2,2,0, 39783
13,39779,4,6,1, 39785
22,39786,4,4,1, 39790
24,39789,1,1,0, 39790
19,39786,5,5,1, 39791
23,39788,3,3,1, 39791
25,39795,2,2,1, 39797
26,39797,3,3,1, 39800
29,39798,4,4,1, 39802
8,39816,1,1,1, 39817
16,39819,2,2,0, 39821
15,39821,2,2,1, 39823
22,39826,4,4,0, 39830
24,39829,1,1,1, 39830
23,39828,3,3,0, 39831
31,39836,2,2,1, 39838
28,39834,5,5,1, 39839
5,39847,3,5,1, 39852
6,39850,2,4,1, 39854
8,39856,1,1,1, 39857
16,39859,2,2,0, 39861
15,39861,2,2,1, 39863
22,39866,4,4,0, 39870
24,39869,1,1,1, 39870
23,39868,3,3,0, 39871
31,39876,2,2,1, 39878
28,39874,5,5,1, 39879
29,39878,4,4,1, 39882
6,39890,2,4,1, 39894
8,39896,1,1,1, 39897
16,39899,2,2,0, 39901
15,39901,2,2,0, 39903
13,39899,4,6,1, 39905
22,39906,4,4,1, 39910
24,39909,1,1,0, 39910
19,39906,5,5,1, 39911
23,39908,3,3,1, 39911
30,39913,3,3,1, 39916
25,39915,2,2,1, 39917
26,39917,3,3,1, 39920
29,39918,4,4,1, 39922
1,39926,1,1,0, 39927
5,39927,3,5,1, 39932
6,39930,2,4,1, 39934
8,39936,1,1,0, 39937
16,39939,2,2,0, 39941
17,39939,3,3,1, 39942
15,39941,2,2,0, 39943
18,39943,4,4,1, 39947
20,39943,6,6,1, 39949
22,39946,4,4,0, 39950
24,39949,1,1,0, 39950
19,39946,5,5,1, 39951
23,39948,3,3,1, 39951
25,39955,2,2,1, 39957
2,39963,2,2,1, 39965
1,39966,1,1,1, 39967
3,39967,3,3,1, 39970
5,39967,3,5,1, 39972
8,39976,1,1,1, 39977
11,39974,4,4,1, 39978
9,39977,2,2,1, 39979
16,39979,2,2,0, 39981
15,39981,2,2,1, 39983
18,39983,4,4,1, 39987
20,39983,6,6,1, 39989
22,39986,4,4,1, 39990
24,39989,1,1,1, 39990
19,39986,5,5,1, 39991
23,39988,3,3,0, 39991
30,39993,3,3,1, 39996
25,39995,2,2,1, 39997
26,39997,3,3,1, 40000
29,39998,4,4,1, 40002
2,40003,2,2,1, 40005
1,40006,1,1,0, 40007
5,40007,3,5,1, 40012
6,40010,2,4,1, 40014
8,40016,1,1,1, 40017
11,40014,4,4,1, 40018
16,40019,2,2,1, 40021
17,40019,3,3,1, 40022
15,40021,2,2,1, 40023
12,40020,5,5,1, 40025
18,40023,4,4,1, 40027
20,40023,6,6,1, 40029
22,40026,4,4,0, 40030
24,40029,1,1,1, 40030
23,40028,3,3,0, 40031
30,40033,3,3,1, 40036
25,40035,2,2,1, 40037
29,40038,4,4,1, 40042
1,40046,1,1,0, 40047
5,40047,3,5,1, 40052
6,40050,2,4,1, 40054
8,40056,1,1,0, 40057
9,40057,2,2,1, 40059
16,40059,2,2,1, 40061
17,40059,3,3,1, 40062
15,40061,2,2,0, 40063
22,40066,4,4,1, 40070
24,40069,1,1,0, 40070
19,40066,5,5,1, 40071
23,40068,3,3,1, 40071
30,40073,3,3,1, 40076
31,40076,2,2,1, 40078
28,40074,5,5,1, 40079
2,40083,2,2,1, 40085
1,40086,1,1,1, 40087
3,40087,3,3,1, 40090
5,40087,3,5,1, 40092
6,40090,2,4,1, 40094
8,40096,1,1,0, 40097
16,40099,2,2,0, 40101
15,40101,2,2,1, 40103
22,40106,4,4,0, 40110
24,40109,1,1,0, 40110
23,40108,3,3,0, 40111
31,40116,2,2,1, 40118
29,40118,4,4,1, 40122
8,40136,1,1,0, 40137
16,40139,2,2,1, 40141
15,40141,2,2,1, 40143
22,40146,4,4,0, 40150
24,40149,1,1,0, 40150
23,40148,3,3,1, 40151
30,40153,3,3,1, 40156
28,40154,5,5,1, 40159
29,40158,4,4,1, 40162
6,40170,2,4,1, 40174
8,40176,1,1,0, 40177
16,40179,2,2,0, 40181
15,40181,2,2,0, 40183
22,40186,4,4,0, 40190
24,40189,1,1,0, 40190
23,40188,3,3,1, 40191
25,40195,2,2,1, 40197
31,40196,2,2,1, 40198
29,40198,4,4,1, 40202
2,40203,2,2,1, 40205
1,40206,1,1,0, 40207
3,40207,3,3,1, 40210
8,40216,1,1,0, 40217
16,40219,2,2,0, 40221
17,40219,3,3,1, 40222
15,40221,2,2,0, 40223
22,40226,4,4,0, 40230
24,40229,1,1,0, 40230
23,40228,3,3,1, 40231
28,40234,5,5,1, 40239
1,40246,1,1,0, 40247
3,40247,3,3,1, 40250
6,40250,2,4,1, 40254
8,40256,1,1,1, 40257
11,40254,4,4,1, 40258
17,40259,3,3,1, 40262
12,40260,5,5,1, 40265
24,40269,1,1,0, 40270
19,40266,5,5,1, 40271
23,40268,3,3,1, 40271
2,40283,2,2,1, 40285
1,40286,1,1,0, 40287
8,40296,1,1,0, 40297
9,40297,2,2,1, 40299
17,40299,3,3,1, 40302
12,40300,5,5,1, 40305
22,40306,4,4,1, 40310
24,40309,1,1,1, 40310
19,40306,5,5,1, 40311
23,40308,3,3,1, 40311
25,40315,2,2,1, 40317
28,40314,5,5,1, 40319
26,40317,3,3,1, 40320
29,40318,4,4,1, 40322
2,40323,2,2,1, 40325
1,40326,1,1,0, 40327
5,40327,3,5,1, 40332
6,40330,2,4,1, 40334
8,40336,1,1,0, 40337
9,40337,2,2,1, 40339
16,40339,2,2,1, 40341
17,40339,3,3,1, 40342
13,40339,4,6,1, 40345
12,40340,5,5,1, 40345
18,40343,4,4,1, 40347
20,40343,6,6,1, 40349
24,40349,1,1,0, 40350
30,40353,3,3,1, 40356
25,40355,2,2,1, 40357
31,40356,2,2,1, 40358
26,40357,3,3,1, 40360
2,40363,2,2,1, 40365
1,40366,1,1,0, 40367
3,40367,3,3,1, 40370
5,40367,3,5,1, 40372
6,40370,2,4,1, 40374
8,40376,1,1,0, 40377
11,40374,4,4,1, 40378
9,40377,2,2,1, 40379
15,40381,2,2,1, 40383
24,40389,1,1,1, 40390
31,40396,2,2,1, 40398
28,40394,5,5,1, 40399
29,40398,4,4,1, 40402
5,40407,3,5,1, 40412
6,40410,2,4,1, 40414
8,40416,1,1,0, 40417
16,40419,2,2,1, 40421
15,40421,2,2,1, 40423
24,40429,1,1,1, 40430
23,40428,3,3,1, 40431
31,40436,2,2,1, 40438
28,40434,5,5,1, 40439
8,40456,1,1,1, 40457
16,40459,2,2,1, 40461
15,40461,2,2,1, 40463
24,40469,1,1,0, 40470
23,40468,3,3,1, 40471
30,40473,3,3,1, 40476
1,40486,1,1,1, 40487
5,40487,3,5,1, 40492
8,40496,1,1,0, 40497
17,40499,3,3,1, 40502
20,40503,6,6,1, 40509
22,40506,4,4,1, 40510
24,40509,1,1,1, 40510
19,40506,5,5,1, 40511
23,40508,3,3,1, 40511
30,40513,3,3,1, 40516
25,40515,2,2,1, 40517
31,40516,2,2,1, 40518
29,40518,4,4,1, 40522
1,40526,1,1,1, 40527
5,40527,3,5,1, 40532
8,40536,1,1,0, 40537
12,40540,5,5,1, 40545
24,40549,1,1,0, 40550
23,40548,3,3,1, 40551
30,40553,3,3,1, 40556
26,40557,3,3,1, 40560
29,40558,4,4,1, 40562
1,40566,1,1,1, 40567
6,40570,2,4,1, 40574
8,40576,1,1,0, 40577
11,40574,4,4,1, 40578
16,40579,2,2,1, 40581
12,40580,5,5,1, 40585
20,40583,6,6,1, 40589
24,40589,1,1,0, 40590
30,40593,3,3,1, 40596
25,40595,2,2,1, 40597
31,40596,2,2,1, 40598
28,40594,5,5,1, 40599
26,40597,3,3,1, 40600
29,40598,4,4,1, 40602
2,40603,2,2,1, 40605
1,40606,1,1,1, 40607
3,40607,3,3,1, 40610
5,40607,3,5,1, 40612
6,40610,2,4,1, 40614
8,40616,1,1,0, 40617
11,40614,4,4,1, 40618
9,40617,2,2,1, 40619
16,40619,2,2,1, 40621
17,40619,3,3,1, 40622
24,40629,1,1,0, 40630
30,40633,3,3,1, 40636
26,40637,3,3,1, 40640
1,40646,1,1,1, 40647
3,40647,3,3,1, 40650
5,40647,3,5,1, 40652
6,40650,2,4,1, 40654
8,40656,1,1,0, 40657
17,40659,3,3,1, 40662
15,40661,2,2,1, 40663
12,40660,5,5,1, 40665
18,40663,4,4,1, 40667
24,40669,1,1,1, 40670
30,40673,3,3,1, 40676
25,40675,2,2,1, 40677
31,40676,2,2,1, 40678
2,40683,2,2,1, 40685
1,40686,1,1,0, 40687
5,40687,3,5,1, 40692
6,40690,2,4,1, 40694
8,40696,1,1,0, 40697
16,40699,2,2,1, 40701
12,40700,5,5,1, 40705
22,40706,4,4,1, 40710
24,40709,1,1,0, 40710
19,40706,5,5,1, 40711
25,40715,2,2,1, 40717
28,40714,5,5,1, 40719
1,40726,1,1,0, 40727
3,40727,3,3,1, 40730
5,40727,3,5,1, 40732
8,40736,1,1,1, 40737
11,40734,4,4,1, 40738
16,40739,2,2,1, 40741
15,40741,2,2,1, 40743
13,40739,4,6,1, 40745
22,40746,4,4,1, 40750
24,40749,1,1,1, 40750
23,40748,3,3,1, 40751
31,40756,2,2,1, 40758
26,40757,3,3,1, 40760
1,40766,1,1,1, 40767
3,40767,3,3,1, 40770
5,40767,3,5,1, 40772
6,40770,2,4,1, 40774
8,40776,1,1,1, 40777
11,40774,4,4,1, 40778
9,40777,2,2,1, 40779
16,40779,2,2,1, 40781
17,40779,3,3,1, 40782
13,40779,4,6,1, 40785
18,40783,4,4,1, 40787
20,40783,6,6,1, 40789
24,40789,1,1,1, 40790
19,40786,5,5,1, 40791
25,40795,2,2,1, 40797
31,40796,2,2,1, 40798
28,40794,5,5,1, 40799
1,40806,1,1,0, 40807
3,40807,3,3,1, 40810
5,40807,3,5,1, 40812
8,40816,1,1,1, 40817
17,40819,3,3,1, 40822
22,40826,4,4,1, 40830
24,40829,1,1,1, 40830
19,40826,5,5,1, 40831
23,40828,3,3,0, 40831
25,40835,2,2,1, 40837
31,40836,2,2,1, 40838
1,40846,1,1,0, 40847
3,40847,3,3,1, 40850
8,40856,1,1,1, 40857
11,40854,4,4,1, 40858
16,40859,2,2,1, 40861
17,40859,3,3,1, 40862
15,40861,2,2,1, 40863
22,40866,4,4,1, 40870
24,40869,1,1,1, 40870
23,40868,3,3,0, 40871
31,40876,2,2,1, 40878
28,40874,5,5,1, 40879
29,40878,4,4,1, 40882
8,40896,1,1,1, 40897
16,40899,2,2,0, 40901
15,40901,2,2,1, 40903
22,40906,4,4,0, 40910
24,40909,1,1,0, 40910
23,40908,3,3,1, 40911
30,40913,3,3,1, 40916
31,40916,2,2,1, 40918
28,40914,5,5,1, 40919
29,40918,4,4,1, 40922
6,40930,2,4,1, 40934
8,40936,1,1,1, 40937
16,40939,2,2,1, 40941
15,40941,2,2,1, 40943
22,40946,4,4,0, 40950
24,40949,1,1,1, 40950
23,40948,3,3,0, 40951
31,40956,2,2,1, 40958
29,40958,4,4,1, 40962
1,40966,1,1,0, 40967
3,40967,3,3,1, 40970
6,40970,2,4,1, 40974
8,40976,1,1,1, 40977
16,40979,2,2,1, 40981
15,40981,2,2,0, 40983
12,40980,5,5,1, 40985
18,40983,4,4,1, 40987
22,40986,4,4,1, 40990
24,40989,1,1,1, 40990
23,40988,3,3,1, 40991
30,40993,3,3,1, 40996
29,40998,4,4,1, 41002
1,41006,1,1,1, 41007
6,41010,2,4,1, 41014
8,41016,1,1,1, 41017
16,41019,2,2,0, 41021
15,41021,2,2,1, 41023
22,41026,4,4,0, 41030
24,41029,1,1,0, 41030
23,41028,3,3,0, 41031
30,41033,3,3,1, 41036
29,41038,4,4,1, 41042
1,41046,1,1,0, 41047
5,41047,3,5,1, 41052
8,41056,1,1,0, 41057
9,41057,2,2,1, 41059
16,41059,2,2,0, 41061
17,41059,3,3,1, 41062
15,41061,2,2,0, 41063
22,41066,4,4,1, 41070
24,41069,1,1,1, 41070
23,41068,3,3,1, 41071
30,41073,3,3,1, 41076
31,41076,2,2,1, 41078
29,41078,4,4,1, 41082
1,41086,1,1,1, 41087
5,41087,3,5,1, 41092
8,41096,1,1,1, 41097
16,41099,2,2,0, 41101
15,41101,2,2,0, 41103
13,41099,4,6,1, 41105
12,41100,5,5,1, 41105
22,41106,4,4,0, 41110
24,41109,1,1,0, 41110
23,41108,3,3,1, 41111
30,41113,3,3,1, 41116
29,41118,4,4,1, 41122
1,41126,1,1,1, 41127
3,41127,3,3,1, 41130
5,41127,3,5,1, 41132
8,41136,1,1,0, 41137
11,41134,4,4,1, 41138
16,41139,2,2,1, 41141
17,41139,3,3,1, 41142
15,41141,2,2,0, 41143
20,41143,6,6,1, 41149
22,41146,4,4,1, 41150
24,41149,1,1,0, 41150
19,41146,5,5,1, 41151
23,41148,3,3,0, 41151
30,41153,3,3,1, 41156
25,41155,2,2,1, 41157
26,41157,3,3,1, 41160
2,41163,2,2,1, 41165
1,41166,1,1,0, 41167
3,41167,3,3,1, 41170
6,41170,2,4,1, 41174
8,41176,1,1,1, 41177
11,41174,4,4,1, 41178
9,41177,2,2,1, 41179
16,41179,2,2,0, 41181
15,41181,2,2,0, 41183
12,41180,5,5,1, 41185
20,41183,6,6,1, 41189
22,41186,4,4,0, 41190
24,41189,1,1,0, 41190
19,41186,5,5,1, 41191
23,41188,3,3,1, 41191
30,41193,3,3,1, 41196
25,41195,2,2,1, 41197
31,41196,2,2,1, 41198
28,41194,5,5,1, 41199
1,41206,1,1,1, 41207
3,41207,3,3,1, 41210
8,41216,1,1,1, 41217
11,41214,4,4,1, 41218
16,41219,2,2,0, 41221
17,41219,3,3,1, 41222
15,41221,2,2,1, 41223
12,41220,5,5,1, 41225
18,41223,4,4,1, 41227
20,41223,6,6,1, 41229
22,41226,4,4,0, 41230
24,41229,1,1,0, 41230
19,41226,5,5,1, 41231
23,41228,3,3,0, 41231
31,41236,2,2,1, 41238
28,41234,5,5,1, 41239
26,41237,3,3,1, 41240
1,41246,1,1,0, 41247
5,41247,3,5,1, 41252
8,41256,1,1,1, 41257
11,41254,4,4,1, 41258
9,41257,2,2,1, 41259
16,41259,2,2,0, 41261
15,41261,2,2,1, 41263
13,41259,4,6,1, 41265
12,41260,5,5,1, 41265
18,41263,4,4,1, 41267
22,41266,4,4,0, 41270
24,41269,1,1,1, 41270
23,41268,3,3,0, 41271
25,41275,2,2,1, 41277
28,41274,5,5,1, 41279
26,41277,3,3,1, 41280
2,41283,2,2,1, 41285
1,41286,1,1,1, 41287
3,41287,3,3,1, 41290
8,41296,1,1,1, 41297
11,41294,4,4,1, 41298
9,41297,2,2,1, 41299
16,41299,2,2,0, 41301
15,41301,2,2,0, 41303
12,41300,5,5,1, 41305
18,41303,4,4,1, 41307
22,41306,4,4,0, 41310
24,41309,1,1,0, 41310
23,41308,3,3,0, 41311
30,41313,3,3,1, 41316
25,41315,2,2,1, 41317
28,41314,5,5,1, 41319
29,41318,4,4,1, 41322
1,41326,1,1,0, 41327
3,41327,3,3,1, 41330
5,41327,3,5,1, 41332
8,41336,1,1,1, 41337
11,41334,4,4,1, 41338
16,41339,2,2,1, 41341
17,41339,3,3,1, 41342
15,41341,2,2,1, 41343
22,41346,4,4,1, 41350
24,41349,1,1,0, 41350
23,41348,3,3,1, 41351
29,41358,4,4,1, 41362
8,41376,1,1,0, 41377
16,41379,2,2,1, 41381
15,41381,2,2,0, 41383
22,41386,4,4,1, 41390
24,41389,1,1,0, 41390
23,41388,3,3,1, 41391
29,41398,4,4,1, 41402
5,41407,3,5,1, 41412
8,41416,1,1,0, 41417
16,41419,2,2,0, 41421
15,41421,2,2,0, 41423
22,41426,4,4,0, 41430
24,41429,1,1,1, 41430
23,41428,3,3,1, 41431
30,41433,3,3,1, 41436
1,41446,1,1,0, 41447
5,41447,3,5,1, 41452
8,41456,1,1,1, 41457
9,41457,2,2,1, 41459
16,41459,2,2,0, 41461
15,41461,2,2,1, 41463
22,41466,4,4,1, 41470
24,41469,1,1,0, 41470
23,41468,3,3,1, 41471
30,41473,3,3,1, 41476
25,41475,2,2,1, 41477
31,41476,2,2,1, 41478
28,41474,5,5,1, 41479
29,41478,4,4,1, 41482
1,41486,1,1,1, 41487
5,41487,3,5,1, 41492
8,41496,1,1,0, 41497
16,41499,2,2,1, 41501
17,41499,3,3,1, 41502
15,41501,2,2,0, 41503
13,41499,4,6,1, 41505
12,41500,5,5,1, 41505
22,41506,4,4,0, 41510
24,41509,1,1,0, 41510
23,41508,3,3,1, 41511
30,41513,3,3,1, 41516
28,41514,5,5,1, 41519
2,41523,2,2,1, 41525
1,41526,1,1,1, 41527
8,41536,1,1,0, 41537
16,41539,2,2,0, 41541
17,41539,3,3,1, 41542
15,41541,2,2,0, 41543
12,41540,5,5,1, 41545
18,41543,4,4,1, 41547
20,41543,6,6,1, 41549
22,41546,4,4,0, 41550
24,41549,1,1,1, 41550
23,41548,3,3,0, 41551
28,41554,5,5,1, 41559
26,41557,3,3,1, 41560
29,41558,4,4,1, 41562
1,41566,1,1,1, 41567
3,41567,3,3,1, 41570
6,41570,2,4,1, 41574
8,41576,1,1,1, 41577
9,41577,2,2,1, 41579
16,41579,2,2,1, 41581
15,41581,2,2,0, 41583
13,41579,4,6,1, 41585
22,41586,4,4,1, 41590
24,41589,1,1,0, 41590
23,41588,3,3,1, 41591
25,41595,2,2,1, 41597
26,41597,3,3,1, 41600
2,41603,2,2,1, 41605
1,41606,1,1,1, 41607
3,41607,3,3,1, 41610
5,41607,3,5,1, 41612
8,41616,1,1,1, 41617
11,41614,4,4,1, 41618
16,41619,2,2,1, 41621
15,41621,2,2,0, 41623
18,41623,4,4,1, 41627
20,41623,6,6,1, 41629
22,41626,4,4,1, 41630
24,41629,1,1,1, 41630
19,41626,5,5,1, 41631
23,41628,3,3,1, 41631
30,41633,3,3,1, 41636
25,41635,2,2,1, 41637
31,41636,2,2,0, 41638
28,41634,5,5,1, 41639
26,41637,3,3,1, 41640
29,41638,4,4,0, 41642
1,41646,1,1,0, 41647
5,41647,3,5,1, 41652
6,41650,2,4,1, 41654
8,41656,1,1,1, 41657
11,41654,4,4,1, 41658
9,41657,2,2,1, 41659
16,41659,2,2,1, 41661
15,41661,2,2,0, 41663
13,41659,4,6,1, 41665
12,41660,5,5,1, 41665
22,41666,4,4,0, 41670
24,41669,1,1,0, 41670
19,41666,5,5,1, 41671
23,41668,3,3,1, 41671
30,41673,3,3,0, 41676
31,41676,2,2,1, 41678
28,41674,5,5,1, 41679
26,41677,3,3,1, 41680
29,41678,4,4,1, 41682
1,41686,1,1,1, 41687
5,41687,3,5,0, 41692
6,41690,2,4,1, 41694
8,41696,1,1,0, 41697
9,41697,2,2,1, 41699
16,41699,2,2,1, 41701
15,41701,2,2,0, 41703
13,41699,4,6,1, 41705
12,41700,5,5,1, 41705
22,41706,4,4,0, 41710
24,41709,1,1,1, 41710
23,41708,3,3,1, 41711
30,41713,3,3,0, 41716
31,41716,2,2,0, 41718
28,41714,5,5,1, 41719
29,41718,4,4,1, 41722
1,41726,1,1,0, 41727
5,41727,3,5,1, 41732
6,41730,2,4,1, 41734
8,41736,1,1,1, 41737
11,41734,4,4,1, 41738
9,41737,2,2,1, 41739
16,41739,2,2,0, 41741
17,41739,3,3,1, 41742
15,41741,2,2,0, 41743
18,41743,4,4,1, 41747
20,41743,6,6,1, 41749
22,41746,4,4,0, 41750
24,41749,1,1,0, 41750
19,41746,5,5,1, 41751
23,41748,3,3,0, 41751
30,41753,3,3,0, 41756
31,41756,2,2,0, 41758
28,41754,5,5,1, 41759
26,41757,3,3,1, 41760
29,41758,4,4,0, 41762
1,41766,1,1,0, 41767
3,41767,3,3,1, 41770
6,41770,2,4,1, 41774
8,41776,1,1,0, 41777
11,41774,4,4,1, 41778
16,41779,2,2,1, 41781
15,41781,2,2,0, 41783
13,41779,4,6,1, 41785
20,41783,6,6,1, 41789
22,41786,4,4,0, 41790
24,41789,1,1,1, 41790
23,41788,3,3,1, 41791
25,41795,2,2,1, 41797
31,41796,2,2,1, 41798
28,41794,5,5,1, 41799
26,41797,3,3,1, 41800
5,41807,3,5,1, 41812
6,41810,2,4,1, 41814
8,41816,1,1,1, 41817
16,41819,2,2,0, 41821
15,41821,2,2,0, 41823
22,41826,4,4,1, 41830
24,41829,1,1,1, 41830
23,41828,3,3,0, 41831
30,41833,3,3,1, 41836
31,41836,2,2,1, 41838
28,41834,5,5,1, 41839
8,41856,1,1,1, 41857
16,41859,2,2,1, 41861
15,41861,2,2,1, 41863
22,41866,4,4,0, 41870
24,41869,1,1,1, 41870
23,41868,3,3,1, 41871
30,41873,3,3,1, 41876
31,41876,2,2,1, 41878
5,41887,3,5,1, 41892
8,41896,1,1,1, 41897
16,41899,2,2,0, 41901
15,41901,2,2,0, 41903
22,41906,4,4,1, 41910
24,41909,1,1,1, 41910
23,41908,3,3,0, 41911
31,41916,2,2,0, 41918
29,41918,4,4,1, 41922
1,41926,1,1,1, 41927
6,41930,2,4,1, 41934
8,41936,1,1,1, 41937
16,41939,2,2,0, 41941
15,41941,2,2,1, 41943
22,41946,4,4,1, 41950
24,41949,1,1,1, 41950
23,41948,3,3,1, 41951
30,41953,3,3,1, 41956
25,41955,2,2,1, 41957
31,41956,2,2,0, 41958
28,41954,5,5,1, 41959
29,41958,4,4,1, 41962
1,41966,1,1,0, 41967
6,41970,2,4,1, 41974
8,41976,1,1,1, 41977
9,41977,2,2,1, 41979
16,41979,2,2,1, 41981
15,41981,2,2,0, 41983
22,41986,4,4,0, 41990
24,41989,1,1,1, 41990
23,41988,3,3,1, 41991
25,41995,2,2,1, 41997
31,41996,2,2,1, 41998
28,41994,5,5,1, 41999
26,41997,3,3,1, 42000
29,41998,4,4,1, 42002
1,42006,1,1,1, 42007
3,42007,3,3,1, 42010
5,42007,3,5,1, 42012
8,42016,1,1,0, 42017
11,42014,4,4,1, 42018
16,42019,2,2,1, 42021
17,42019,3,3,1, 42022
15,42021,2,2,0, 42023
20,42023,6,6,1, 42029
22,42026,4,4,0, 42030
24,42029,1,1,0, 42030
23,42028,3,3,1, 42031
31,42036,2,2,0, 42038
1,42046,1,1,0, 42047
8,42056,1,1,1, 42057
16,42059,2,2,1, 42061
17,42059,3,3,1, 42062
15,42061,2,2,1, 42063
18,42063,4,4,1, 42067
22,42066,4,4,0, 42070
24,42069,1,1,1, 42070
23,42068,3,3,1, 42071
31,42076,2,2,0, 42078
28,42074,5,5,1, 42079
29,42078,4,4,1, 42082
1,42086,1,1,0, 42087
3,42087,3,3,1, 42090
5,42087,3,5,1, 42092
8,42096,1,1,1, 42097
16,42099,2,2,1, 42101
15,42101,2,2,1, 42103
13,42099,4,6,1, 42105
18,42103,4,4,1, 42107
22,42106,4,4,1, 42110
24,42109,1,1,0, 42110
23,42108,3,3,0, 42111
30,42113,3,3,1, 42116
31,42116,2,2,0, 42118
28,42114,5,5,1, 42119
26,42117,3,3,1, 42120
2,42123,2,2,1, 42125
1,42126,1,1,1, 42127
6,42130,2,4,1, 42134
8,42136,1,1,0, 42137
16,42139,2,2,0, 42141
15,42141,2,2,0, 42143
12,42140,5,5,1, 42145
18,42143,4,4,1, 42147
20,42143,6,6,1, 42149
22,42146,4,4,1, 42150
24,42149,1,1,1, 42150
23,42148,3,3,0, 42151
31,42156,2,2,1, 42158
29,42158,4,4,1, 42162
2,42163,2,2,1, 42165
1,42166,1,1,0, 42167
3,42167,3,3,1, 42170
6,42170,2,4,1, 42174
8,42176,1,1,0, 42177
9,42177,2,2,1, 42179
16,42179,2,2,0, 42181
15,42181,2,2,1, 42183
13,42179,4,6,1, 42185
22,42186,4,4,1, 42190
24,42189,1,1,0, 42190
23,42188,3,3,0, 42191
31,42196,2,2,0, 42198
26,42197,3,3,1, 42200
2,42203,2,2,1, 42205
1,42206,1,1,0, 42207
6,42210,2,4,1, 42214
8,42216,1,1,1, 42217
16,42219,2,2,0, 42221
17,42219,3,3,1, 42222
15,42221,2,2,1, 42223
13,42219,4,6,1, 42225
20,42223,6,6,1, 42229
22,42226,4,4,1, 42230
24,42229,1,1,1, 42230
19,42226,5,5,1, 42231
23,42228,3,3,1, 42231
30,42233,3,3,1, 42236
31,42236,2,2,0, 42238
28,42234,5,5,1, 42239
2,42243,2,2,1, 42245
1,42246,1,1,0, 42247
8,42256,1,1,1, 42257
16,42259,2,2,0, 42261
17,42259,3,3,1, 42262
15,42261,2,2,0, 42263
13,42259,4,6,1, 42265
20,42263,6,6,1, 42269
22,42266,4,4,1, 42270
24,42269,1,1,0, 42270
23,42268,3,3,1, 42271
30,42273,3,3,1, 42276
25,42275,2,2,1, 42277
31,42276,2,2,0, 42278
28,42274,5,5,1, 42279
2,42283,2,2,1, 42285
1,42286,1,1,1, 42287
3,42287,3,3,1, 42290
8,42296,1,1,0, 42297
11,42294,4,4,1, 42298
9,42297,2,2,1, 42299
16,42299,2,2,1, 42301
15,42301,2,2,1, 42303
13,42299,4,6,1, 42305
18,42303,4,4,1, 42307
22,42306,4,4,0, 42310
24,42309,1,1,0, 42310
19,42306,5,5,1, 42311
23,42308,3,3,1, 42311
30,42313,3,3,1, 42316
25,42315,2,2,1, 42317
31,42316,2,2,0, 42318
28,42314,5,5,1, 42319
29,42318,4,4,1, 42322
2,42323,2,2,1, 42325
1,42326,1,1,0, 42327
3,42327,3,3,1, 42330
5,42327,3,5,1, 42332
6,42330,2,4,1, 42334
8,42336,1,1,1, 42337
9,42337,2,2,1, 42339
16,42339,2,2,0, 42341
17,42339,3,3,1, 42342
15,42341,2,2,1, 42343
18,42343,4,4,1, 42347
22,42346,4,4,0, 42350
24,42349,1,1,0, 42350
23,42348,3,3,0, 42351
30,42353,3,3,1, 42356
25,42355,2,2,1, 42357
31,42356,2,2,1, 42358
29,42358,4,4,1, 42362
2,42363,2,2,1, 42365
1,42366,1,1,1, 42367
3,42367,3,3,1, 42370
6,42370,2,4,1, 42374
8,42376,1,1,1, 42377
9,42377,2,2,1, 42379
16,42379,2,2,0, 42381
15,42381,2,2,0, 42383
20,42383,6,6,1, 42389
22,42386,4,4,1, 42390
24,42389,1,1,0, 42390
19,42386,5,5,1, 42391
23,42388,3,3,0, 42391
25,42395,2,2,1, 42397
31,42396,2,2,0, 42398
29,42398,4,4,1, 42402
2,42403,2,2,1, 42405
1,42406,1,1,0, 42407
3,42407,3,3,1, 42410
8,42416,1,1,0, 42417
9,42417,2,2,1, 42419
16,42419,2,2,1, 42421
15,42421,2,2,0, 42423
13,42419,4,6,1, 42425
12,42420,5,5,1, 42425
18,42423,4,4,1, 42427
22,42426,4,4,1, 42430
24,42429,1,1,0, 42430
23,42428,3,3,1, 42431
30,42433,3,3,1, 42436
31,42436,2,2,1, 42438
29,42438,4,4,1, 42442
8,42456,1,1,1, 42457
16,42459,2,2,0, 42461
15,42461,2,2,0, 42463
22,42466,4,4,0, 42470
24,42469,1,1,0, 42470
23,42468,3,3,0, 42471
30,42473,3,3,1, 42476
31,42476,2,2,1, 42478
28,42474,5,5,1, 42479
5,42487,3,5,1, 42492
8,42496,1,1,1, 42497
16,42499,2,2,0, 42501
15,42501,2,2,0, 42503
22,42506,4,4,1, 42510
24,42509,1,1,0, 42510
23,42508,3,3,1, 42511
30,42513,3,3,1, 42516
31,42516,2,2,1, 42518
28,42514,5,5,1, 42519
5,42527,3,5,1, 42532
6,42530,2,4,1, 42534
8,42536,1,1,1, 42537
16,42539,2,2,0, 42541
15,42541,2,2,1, 42543
12,42540,5,5,1, 42545
18,42543,4,4,1, 42547
20,42543,6,6,1, 42549
22,42546,4,4,1, 42550
24,42549,1,1,0, 42550
19,42546,5,5,1, 42551
23,42548,3,3,1, 42551
30,42553,3,3,1, 42556
25,42555,2,2,1, 42557
31,42556,2,2,1, 42558
28,42554,5,5,1, 42559
26,42557,3,3,1, 42560
1,42566,1,1,0, 42567
6,42570,2,4,1, 42574
8,42576,1,1,0, 42577
11,42574,4,4,1, 42578
16,42579,2,2,0, 42581
15,42581,2,2,1, 42583
13,42579,4,6,1, 42585
12,42580,5,5,1, 42585
20,42583,6,6,1, 42589
22,42586,4,4,1, 42590
24,42589,1,1,1, 42590
23,42588,3,3,0, 42591
31,42596,2,2,0, 42598
2,42603,2,2,1, 42605
1,42606,1,1,0, 42607
6,42610,2,4,1, 42614
8,42616,1,1,0, 42617
16,42619,2,2,1, 42621
15,42621,2,2,1, 42623
12,42620,5,5,1, 42625
20,42623,6,6,1, 42629
22,42626,4,4,0, 42630
24,42629,1,1,0, 42630
19,42626,5,5,1, 42631
23,42628,3,3,0, 42631
25,42635,2,2,1, 42637
31,42636,2,2,1, 42638
26,42637,3,3,1, 42640
29,42638,4,4,1, 42642
1,42646,1,1,1, 42647
5,42647,3,5,1, 42652
6,42650,2,4,1, 42654
8,42656,1,1,1, 42657
11,42654,4,4,1, 42658
16,42659,2,2,1, 42661
15,42661,2,2,0, 42663
12,42660,5,5,1, 42665
18,42663,4,4,1, 42667
22,42666,4,4,1, 42670
24,42669,1,1,1, 42670
23,42668,3,3,1, 42671
30,42673,3,3,1, 42676
31,42676,2,2,1, 42678
28,42674,5,5,1, 42679
1,42686,1,1,0, 42687
3,42687,3,3,1, 42690
5,42687,3,5,1, 42692
6,42690,2,4,1, 42694
8,42696,1,1,0, 42697
9,42697,2,2,1, 42699
16,42699,2,2,0, 42701
17,42699,3,3,1, 42702
15,42701,2,2,1, 42703
13,42699,4,6,1, 42705
18,42703,4,4,1, 42707
22,42706,4,4,0, 42710
24,42709,1,1,1, 42710
19,42706,5,5,1, 42711
23,42708,3,3,0, 42711
30,42713,3,3,1, 42716
25,42715,2,2,1, 42717
31,42716,2,2,0, 42718
28,42714,5,5,1, 42719
29,42718,4,4,1, 42722
2,42723,2,2,1, 42725
1,42726,1,1,1, 42727
3,42727,3,3,1, 42730
8,42736,1,1,0, 42737
9,42737,2,2,1, 42739
16,42739,2,2,0, 42741
15,42741,2,2,0, 42743
12,42740,5,5,1, 42745
18,42743,4,4,1, 42747
22,42746,4,4,1, 42750
24,42749,1,1,0, 42750
19,42746,5,5,1, 42751
23,42748,3,3,0, 42751
31,42756,2,2,0, 42758
28,42754,5,5,1, 42759
26,42757,3,3,1, 42760
29,42758,4,4,1, 42762
2,42763,2,2,1, 42765
1,42766,1,1,1, 42767
3,42767,3,3,1, 42770
5,42767,3,5,1, 42772
8,42776,1,1,1, 42777
22,42786,4,4,1, 42790
24,42789,1,1,0, 42790
31,42796,2,2,1, 42798
6,42810,2,4,1, 42814
8,42816,1,1,0, 42817
16,42819,2,2,1, 42821
22,42826,4,4,1, 42830
24,42829,1,1,1, 42830
23,42828,3,3,1, 42831
31,42836,2,2,1, 42838
28,42834,5,5,1, 42839
29,42838,4,4,1, 42842
8,42856,1,1,0, 42857
15,42861,2,2,1, 42863
24,42869,1,1,1, 42870
23,42868,3,3,1, 42871
30,42873,3,3,1, 42876
31,42876,2,2,1, 42878
29,42878,4,4,1, 42882
2,42883,2,2,1, 42885
1,42886,1,1,1, 42887
5,42887,3,5,1, 42892
8,42896,1,1,1, 42897
9,42897,2,2,1, 42899
16,42899,2,2,1, 42901
13,42899,4,6,1, 42905
18,42903,4,4,1, 42907
24,42909,1,1,1, 42910
31,42916,2,2,0, 42918
26,42917,3,3,1, 42920
2,42923,2,2,1, 42925
1,42926,1,1,1, 42927
8,42936,1,1,1, 42937
9,42937,2,2,1, 42939
16,42939,2,2,1, 42941
17,42939,3,3,1, 42942
13,42939,4,6,1, 42945
12,42940,5,5,1, 42945
18,42943,4,4,1, 42947
20,42943,6,6,1, 42949
22,42946,4,4,1, 42950
24,42949,1,1,0, 42950
19,42946,5,5,1, 42951
23,42948,3,3,1, 42951
25,42955,2,2,1, 42957
31,42956,2,2,0, 42958
29,42958,4,4,1, 42962
1,42966,1,1,1, 42967
3,42967,3,3,1, 42970
5,42967,3,5,1, 42972
8,42976,1,1,1, 42977
16,42979,2,2,1, 42981
17,42979,3,3,1, 42982
12,42980,5,5,1, 42985
20,42983,6,6,1, 42989
24,42989,1,1,1, 42990
19,42986,5,5,1, 42991
25,42995,2,2,1, 42997
31,42996,2,2,1, 42998
28,42994,5,5,1, 42999
1,43006,1,1,1, 43007
5,43007,3,5,1, 43012
8,43016,1,1,1, 43017
15,43021,2,2,1, 43023
18,43023,4,4,1, 43027
22,43026,4,4,1, 43030
24,43029,1,1,1, 43030
19,43026,5,5,1, 43031
23,43028,3,3,1, 43031
30,43033,3,3,1, 43036
31,43036,2,2,1, 43038
29,43038,4,4,1, 43042
1,43046,1,1,0, 43047
3,43047,3,3,1, 43050
8,43056,1,1,1, 43057
11,43054,4,4,1, 43058
13,43059,4,6,1, 43065
20,43063,6,6,1, 43069
24,43069,1,1,1, 43070
19,43066,5,5,1, 43071
30,43073,3,3,1, 43076
25,43075,2,2,1, 43077
31,43076,2,2,0, 43078
28,43074,5,5,1, 43079
29,43078,4,4,1, 43082
2,43083,2,2,1, 43085
1,43086,1,1,0, 43087
3,43087,3,3,1, 43090
8,43096,1,1,0, 43097
11,43094,4,4,1, 43098
17,43099,3,3,1, 43102
15,43101,2,2,1, 43103
22,43106,4,4,1, 43110
24,43109,1,1,1, 43110
23,43108,3,3,1, 43111
31,43116,2,2,0, 43118
28,43114,5,5,1, 43119
29,43118,4,4,1, 43122
8,43136,1,1,1, 43137
24,43149,1,1,0, 43150
23,43148,3,3,1, 43151
30,43153,3,3,1, 43156
31,43156,2,2,1, 43158
28,43154,5,5,1, 43159
29,43158,4,4,1, 43162
6,43170,2,4,1, 43174
8,43176,1,1,0, 43177
16,43179,2,2,1, 43181
15,43181,2,2,1, 43183
22,43186,4,4,1, 43190
24,43189,1,1,1, 43190
30,43193,3,3,1, 43196
31,43196,2,2,1, 43198
1,43206,1,1,1, 43207
5,43207,3,5,1, 43212
6,43210,2,4,1, 43214
8,43216,1,1,1, 43217
16,43219,2,2,1, 43221
12,43220,5,5,1, 43225
24,43229,1,1,0, 43230
19,43226,5,5,1, 43231
23,43228,3,3,1, 43231
30,43233,3,3,1, 43236
25,43235,2,2,1, 43237
31,43236,2,2,0, 43238
26,43237,3,3,1, 43240
2,43243,2,2,1, 43245
1,43246,1,1,1, 43247
6,43250,2,4,1, 43254
8,43256,1,1,1, 43257
11,43254,4,4,1, 43258
9,43257,2,2,1, 43259
17,43259,3,3,1, 43262
12,43260,5,5,1, 43265
18,43263,4,4,1, 43267
20,43263,6,6,1, 43269
24,43269,1,1,1, 43270
19,43266,5,5,1, 43271
23,43268,3,3,1, 43271
31,43276,2,2,1, 43278
26,43277,3,3,1, 43280
29,43278,4,4,1, 43282
1,43286,1,1,0, 43287
3,43287,3,3,1, 43290
6,43290,2,4,1, 43294
8,43296,1,1,0, 43297
9,43297,2,2,1, 43299
24,43309,1,1,1, 43310
19,43306,5,5,1, 43311
23,43308,3,3,1, 43311
30,43313,3,3,1, 43316
31,43316,2,2,1, 43318
28,43314,5,5,0, 43319
26,43317,3,3,1, 43320
29,43318,4,4,1, 43322
2,43323,2,2,1, 43325
1,43326,1,1,0, 43327
5,43327,3,5,1, 43332
6,43330,2,4,0, 43334
8,43336,1,1,0, 43337
11,43334,4,4,1, 43338
9,43337,2,2,1, 43339
16,43339,2,2,1, 43341
13,43339,4,6,1, 43345
12,43340,5,5,1, 43345
22,43346,4,4,1, 43350
24,43349,1,1,1, 43350
19,43346,5,5,1, 43351
23,43348,3,3,1, 43351
30,43353,3,3,1, 43356
25,43355,2,2,1, 43357
31,43356,2,2,0, 43358
28,43354,5,5,1, 43359
26,43357,3,3,1, 43360
29,43358,4,4,0, 43362
1,43366,1,1,1, 43367
5,43367,3,5,1, 43372
6,43370,2,4,1, 43374
8,43376,1,1,1, 43377
16,43379,2,2,0, 43381
15,43381,2,2,0, 43383
13,43379,4,6,1, 43385
18,43383,4,4,1, 43387
22,43386,4,4,0, 43390
24,43389,1,1,1, 43390
19,43386,5,5,1, 43391
23,43388,3,3,1, 43391
30,43393,3,3,0, 43396
31,43396,2,2,0, 43398
28,43394,5,5,0, 43399
26,43397,3,3,1, 43400
29,43398,4,4,1, 43402
1,43406,1,1,1, 43407
3,43407,3,3,1, 43410
5,43407,3,5,0, 43412
6,43410,2,4,0, 43414
8,43416,1,1,1, 43417
9,43417,2,2,1, 43419
16,43419,2,2,1, 43421
15,43421,2,2,1, 43423
13,43419,4,6,1, 43425
18,43423,4,4,1, 43427
22,43426,4,4,0, 43430
24,43429,1,1,1, 43430
19,43426,5,5,1, 43431
23,43428,3,3,1, 43431
30,43433,3,3,0, 43436
31,43436,2,2,0, 43438
28,43434,5,5,1, 43439
26,43437,3,3,1, 43440
29,43438,4,4,1, 43442
5,43447,3,5,1, 43452
6,43450,2,4,1, 43454
8,43456,1,1,0, 43457
16,43459,2,2,1, 43461
15,43461,2,2,0, 43463
22,43466,4,4,1, 43470
24,43469,1,1,1, 43470
23,43468,3,3,0, 43471
30,43473,3,3,0, 43476
31,43476,2,2,1, 43478
28,43474,5,5,1, 43479
29,43478,4,4,1, 43482
5,43487,3,5,0, 43492
6,43490,2,4,0, 43494
8,43496,1,1,0, 43497
16,43499,2,2,1, 43501
15,43501,2,2,1, 43503
22,43506,4,4,1, 43510
24,43509,1,1,1, 43510
23,43508,3,3,0, 43511
30,43513,3,3,0, 43516
31,43516,2,2,0, 43518
29,43518,4,4,1, 43522
6,43530,2,4,1, 43534
8,43536,1,1,0, 43537
16,43539,2,2,1, 43541
15,43541,2,2,1, 43543
20,43543,6,6,1, 43549
22,43546,4,4,0, 43550
24,43549,1,1,0, 43550
23,43548,3,3,1, 43551
31,43556,2,2,1, 43558
26,43557,3,3,1, 43560
29,43558,4,4,1, 43562
1,43566,1,1,0, 43567
6,43570,2,4,1, 43574
8,43576,1,1,0, 43577
9,43577,2,2,1, 43579
16,43579,2,2,1, 43581
17,43579,3,3,1, 43582
15,43581,2,2,0, 43583
13,43579,4,6,1, 43585
12,43580,5,5,1, 43585
20,43583,6,6,1, 43589
22,43586,4,4,0, 43590
24,43589,1,1,0, 43590
23,43588,3,3,0, 43591
30,43593,3,3,1, 43596
26,43597,3,3,1, 43600
1,43606,1,1,0, 43607
3,43607,3,3,1, 43610
5,43607,3,5,1, 43612
8,43616,1,1,1, 43617
11,43614,4,4,1, 43618
9,43617,2,2,1, 43619
16,43619,2,2,1, 43621
17,43619,3,3,1, 43622
15,43621,2,2,1, 43623
13,43619,4,6,1, 43625
20,43623,6,6,1, 43629
22,43626,4,4,0, 43630
24,43629,1,1,0, 43630
23,43628,3,3,1, 43631
30,43633,3,3,1, 43636
31,43636,2,2,1, 43638
28,43634,5,5,1, 43639
26,43637,3,3,1, 43640
29,43638,4,4,1, 43642
1,43646,1,1,0, 43647
8,43656,1,1,1, 43657
9,43657,2,2,1, 43659
16,43659,2,2,1, 43661
17,43659,3,3,1, 43662
15,43661,2,2,1, 43663
20,43663,6,6,1, 43669
22,43666,4,4,1, 43670
24,43669,1,1,0, 43670
19,43666,5,5,1, 43671
23,43668,3,3,1, 43671
30,43673,3,3,1, 43676
31,43676,2,2,1, 43678
26,43677,3,3,1, 43680
29,43678,4,4,1, 43682
1,43686,1,1,1, 43687
3,43687,3,3,1, 43690
8,43696,1,1,1, 43697
11,43694,4,4,1, 43698
16,43699,2,2,1, 43701
17,43699,3,3,1, 43702
15,43701,2,2,0, 43703
13,43699,4,6,1, 43705
18,43703,4,4,1, 43707
22,43706,4,4,0, 43710
24,43709,1,1,1, 43710
19,43706,5,5,1, 43711
23,43708,3,3,1, 43711
25,43715,2,2,1, 43717
29,43718,4,4,1, 43722
1,43726,1,1,0, 43727
8,43736,1,1,1, 43737
9,43737,2,2,1, 43739
16,43739,2,2,1, 43741
17,43739,3,3,1, 43742
15,43741,2,2,1, 43743
22,43746,4,4,0, 43750
24,43749,1,1,0, 43750
23,43748,3,3,0, 43751
30,43753,3,3,1, 43756
25,43755,2,2,1, 43757
31,43756,2,2,1, 43758
28,43754,5,5,1, 43759
1,43766,1,1,1, 43767
5,43767,3,5,1, 43772
8,43776,1,1,0, 43777
9,43777,2,2,1, 43779
16,43779,2,2,1, 43781
17,43779,3,3,1, 43782
15,43781,2,2,1, 43783
22,43786,4,4,1, 43790
24,43789,1,1,0, 43790
23,43788,3,3,1, 43791
31,43796,2,2,1, 43798
28,43794,5,5,1, 43799
1,43806,1,1,1, 43807
6,43810,2,4,1, 43814
8,43816,1,1,0, 43817
11,43814,4,4,1, 43818
9,43817,2,2,1, 43819
16,43819,2,2,1, 43821
17,43819,3,3,1, 43822
15,43821,2,2,0, 43823
13,43819,4,6,1, 43825
12,43820,5,5,1, 43825
20,43823,6,6,1, 43829
22,43826,4,4,1, 43830
24,43829,1,1,1, 43830
19,43826,5,5,1, 43831
23,43828,3,3,0, 43831
28,43834,5,5,1, 43839
2,43843,2,2,1, 43845
1,43846,1,1,0, 43847
6,43850,2,4,1, 43854
8,43856,1,1,0, 43857
16,43859,2,2,0, 43861
17,43859,3,3,1, 43862
15,43861,2,2,0, 43863
13,43859,4,6,1, 43865
12,43860,5,5,1, 43865
22,43866,4,4,0, 43870
24,43869,1,1,1, 43870
23,43868,3,3,1, 43871
31,43876,2,2,1, 43878
28,43874,5,5,1, 43879
29,43878,4,4,1, 43882
5,43887,3,5,1, 43892
6,43890,2,4,1, 43894
8,43896,1,1,1, 43897
16,43899,2,2,0, 43901
15,43901,2,2,0, 43903
22,43906,4,4,0, 43910
24,43909,1,1,0, 43910
23,43908,3,3,1, 43911
28,43914,5,5,1, 43919
8,43936,1,1,0, 43937
16,43939,2,2,0, 43941
15,43941,2,2,1, 43943
22,43946,4,4,1, 43950
24,43949,1,1,0, 43950
23,43948,3,3,0, 43951
30,43953,3,3,1, 43956
28,43954,5,5,1, 43959
29,43958,4,4,1, 43962
1,43966,1,1,1, 43967
8,43976,1,1,0, 43977
16,43979,2,2,1, 43981
17,43979,3,3,1, 43982
15,43981,2,2,0, 43983
18,43983,4,4,1, 43987
20,43983,6,6,1, 43989
22,43986,4,4,0, 43990
24,43989,1,1,0, 43990
23,43988,3,3,0, 43991
30,43993,3,3,1, 43996
25,43995,2,2,1, 43997
31,43996,2,2,1, 43998
28,43994,5,5,1, 43999
26,43997,3,3,1, 44000
29,43998,4,4,1, 44002
2,44003,2,2,1, 44005
1,44006,1,1,1, 44007
3,44007,3,3,1, 44010
8,44016,1,1,1, 44017
11,44014,4,4,1, 44018
16,44019,2,2,0, 44021
17,44019,3,3,1, 44022
15,44021,2,2,1, 44023
20,44023,6,6,1, 44029
22,44026,4,4,0, 44030
24,44029,1,1,1, 44030
23,44028,3,3,0, 44031
31,44036,2,2,1, 44038
26,44037,3,3,1, 44040
29,44038,4,4,1, 44042
2,44043,2,2,1, 44045
1,44046,1,1,1, 44047
3,44047,3,3,1, 44050
5,44047,3,5,1, 44052
6,44050,2,4,1, 44054
8,44056,1,1,0, 44057
11,44054,4,4,1, 44058
9,44057,2,2,1, 44059
16,44059,2,2,1, 44061
15,44061,2,2,0, 44063
12,44060,5,5,1, 44065
18,44063,4,4,1, 44067
20,44063,6,6,1, 44069
22,44066,4,4,0, 44070
24,44069,1,1,1, 44070
19,44066,5,5,1, 44071
23,44068,3,3,1, 44071
31,44076,2,2,1, 44078
29,44078,4,4,1, 44082
1,44086,1,1,0, 44087
3,44087,3,3,1, 44090
5,44087,3,5,1, 44092
8,44096,1,1,1, 44097
11,44094,4,4,1, 44098
16,44099,2,2,1, 44101
17,44099,3,3,1, 44102
15,44101,2,2,1, 44103
13,44099,4,6,1, 44105
18,44103,4,4,1, 44107
22,44106,4,4,1, 44110
24,44109,1,1,0, 44110
19,44106,5,5,1, 44111
23,44108,3,3,0, 44111
30,44113,3,3,1, 44116
28,44114,5,5,1, 44119
29,44118,4,4,1, 44122
5,44127,3,5,1, 44132
6,44130,2,4,1, 44134
8,44136,1,1,0, 44137
16,44139,2,2,1, 44141
15,44141,2,2,0, 44143
22,44146,4,4,1, 44150
24,44149,1,1,1, 44150
23,44148,3,3,1, 44151
30,44153,3,3,1, 44156
31,44156,2,2,1, 44158
28,44154,5,5,1, 44159
5,44167,3,5,1, 44172
6,44170,2,4,1, 44174
8,44176,1,1,1, 44177
16,44179,2,2,0, 44181
15,44181,2,2,1, 44183
22,44186,4,4,0, 44190
24,44189,1,1,0, 44190
23,44188,3,3,1, 44191
30,44193,3,3,1, 44196
28,44194,5,5,1, 44199
29,44198,4,4,1, 44202
6,44210,2,4,1, 44214
8,44216,1,1,1, 44217
11,44214,4,4,1, 44218
9,44217,2,2,1, 44219
16,44219,2,2,1, 44221
15,44221,2,2,0, 44223
12,44220,5,5,1, 44225
20,44223,6,6,1, 44229
22,44226,4,4,1, 44230
24,44229,1,1,0, 44230
23,44228,3,3,1, 44231
25,44235,2,2,1, 44237
28,44234,5,5,1, 44239
26,44237,3,3,1, 44240
2,44243,2,2,1, 44245
1,44246,1,1,0, 44247
6,44250,2,4,1, 44254
8,44256,1,1,0, 44257
16,44259,2,2,1, 44261
17,44259,3,3,1, 44262
15,44261,2,2,1, 44263
13,44259,4,6,1, 44265
18,44263,4,4,1, 44267
20,44263,6,6,1, 44269
22,44266,4,4,0, 44270
24,44269,1,1,0, 44270
19,44266,5,5,1, 44271
23,44268,3,3,0, 44271
25,44275,2,2,1, 44277
1,44286,1,1,0, 44287
8,44296,1,1,0, 44297
9,44297,2,2,1, 44299
16,44299,2,2,1, 44301
17,44299,3,3,1, 44302
15,44301,2,2,0, 44303
22,44306,4,4,0, 44310
24,44309,1,1,1, 44310
23,44308,3,3,1, 44311
30,44313,3,3,1, 44316
25,44315,2,2,1, 44317
31,44316,2,2,1, 44318
28,44314,5,5,1, 44319
1,44326,1,1,1, 44327
5,44327,3,5,1, 44332
6,44330,2,4,1, 44334
8,44336,1,1,0, 44337
16,44339,2,2,1, 44341
17,44339,3,3,1, 44342
15,44341,2,2,1, 44343
22,44346,4,4,0, 44350
24,44349,1,1,0, 44350
23,44348,3,3,0, 44351
30,44353,3,3,1, 44356
25,44355,2,2,1, 44357
29,44358,4,4,1, 44362
1,44366,1,1,1, 44367
6,44370,2,4,1, 44374
8,44376,1,1,0, 44377
11,44374,4,4,1, 44378
16,44379,2,2,0, 44381
17,44379,3,3,1, 44382
15,44381,2,2,1, 44383
13,44379,4,6,1, 44385
18,44383,4,4,1, 44387
20,44383,6,6,1, 44389
22,44386,4,4,0, 44390
24,44389,1,1,0, 44390
23,44388,3,3,0, 44391
31,44396,2,2,1, 44398
26,44397,3,3,1, 44400
2,44403,2,2,1, 44405
1,44406,1,1,1, 44407
3,44407,3,3,1, 44410
6,44410,2,4,1, 44414
8,44416,1,1,1, 44417
11,44414,4,4,1, 44418
9,44417,2,2,1, 44419
16,44419,2,2,1, 44421
17,44419,3,3,1, 44422
15,44421,2,2,1, 44423
18,44423,4,4,1, 44427
22,44426,4,4,0, 44430
24,44429,1,1,1, 44430
19,44426,5,5,1, 44431
23,44428,3,3,1, 44431
30,44433,3,3,1, 44436
31,44436,2,2,1, 44438
28,44434,5,5,1, 44439
26,44437,3,3,1, 44440
2,44443,2,2,1, 44445
1,44446,1,1,0, 44447
8,44456,1,1,1, 44457
9,44457,2,2,1, 44459
16,44459,2,2,0, 44461
15,44461,2,2,0, 44463
13,44459,4,6,1, 44465
18,44463,4,4,1, 44467
22,44466,4,4,1, 44470
24,44469,1,1,0, 44470
23,44468,3,3,1, 44471
30,44473,3,3,1, 44476
5,44487,3,5,1, 44492
6,44490,2,4,1, 44494
8,44496,1,1,0, 44497
16,44499,2,2,0, 44501
15,44501,2,2,1, 44503
22,44506,4,4,1, 44510
24,44509,1,1,0, 44510
23,44508,3,3,1, 44511
28,44514,5,5,1, 44519
5,44527,3,5,1, 44532
6,44530,2,4,1, 44534
8,44536,1,1,0, 44537
16,44539,2,2,1, 44541
15,44541,2,2,0, 44543
22,44546,4,4,0, 44550
24,44549,1,1,1, 44550
23,44548,3,3,0, 44551
31,44556,2,2,1, 44558
29,44558,4,4,1, 44562
5,44567,3,5,1, 44572
6,44570,2,4,1, 44574
8,44576,1,1,0, 44577
9,44577,2,2,1, 44579
16,44579,2,2,1, 44581
15,44581,2,2,0, 44583
13,44579,4,6,1, 44585
12,44580,5,5,1, 44585
18,44583,4,4,1, 44587
22,44586,4,4,0, 44590
24,44589,1,1,0, 44590
23,44588,3,3,1, 44591
28,44594,5,5,1, 44599
26,44597,3,3,1, 44600
29,44598,4,4,1, 44602
1,44606,1,1,0, 44607
5,44607,3,5,1, 44612
8,44616,1,1,0, 44617
11,44614,4,4,1, 44618
9,44617,2,2,1, 44619
16,44619,2,2,1, 44621
15,44621,2,2,1, 44623
12,44620,5,5,1, 44625
22,44626,4,4,1, 44630
24,44629,1,1,0, 44630
19,44626,5,5,1, 44631
23,44628,3,3,1, 44631
30,44633,3,3,1, 44636
31,44636,2,2,1, 44638
1,44646,1,1,0, 44647
5,44647,3,5,1, 44652
8,44656,1,1,1, 44657
16,44659,2,2,0, 44661
15,44661,2,2,0, 44663
12,44660,5,5,1, 44665
20,44663,6,6,1, 44669
22,44666,4,4,0, 44670
24,44669,1,1,0, 44670
19,44666,5,5,1, 44671
23,44668,3,3,1, 44671
30,44673,3,3,1, 44676
31,44676,2,2,1, 44678
26,44677,3,3,1, 44680
1,44686,1,1,0, 44687
3,44687,3,3,1, 44690
5,44687,3,5,1, 44692
8,44696,1,1,0, 44697
16,44699,2,2,1, 44701
17,44699,3,3,1, 44702
15,44701,2,2,1, 44703
12,44700,5,5,1, 44705
20,44703,6,6,1, 44709
22,44706,4,4,1, 44710
24,44709,1,1,1, 44710
19,44706,5,5,1, 44711
23,44708,3,3,0, 44711
25,44715,2,2,1, 44717
31,44716,2,2,1, 44718
28,44714,5,5,1, 44719
26,44717,3,3,1, 44720
2,44723,2,2,1, 44725
1,44726,1,1,1, 44727
5,44727,3,5,1, 44732
8,44736,1,1,1, 44737
11,44734,4,4,1, 44738
9,44737,2,2,1, 44739
16,44739,2,2,0, 44741
17,44739,3,3,1, 44742
15,44741,2,2,0, 44743
13,44739,4,6,1, 44745
22,44746,4,4,0, 44750
24,44749,1,1,0, 44750
19,44746,5,5,1, 44751
23,44748,3,3,0, 44751
25,44755,2,2,1, 44757
28,44754,5,5,1, 44759
26,44757,3,3,1, 44760
29,44758,4,4,1, 44762
1,44766,1,1,0, 44767
5,44767,3,5,1, 44772
8,44776,1,1,0, 44777
9,44777,2,2,1, 44779
16,44779,2,2,0, 44781
17,44779,3,3,1, 44782
15,44781,2,2,0, 44783
22,44786,4,4,1, 44790
24,44789,1,1,0, 44790
23,44788,3,3,0, 44791
28,44794,5,5,1, 44799
1,44806,1,1,1, 44807
5,44807,3,5,1, 44812
8,44816,1,1,1, 44817
9,44817,2,2,1, 44819
16,44819,2,2,1, 44821
15,44821,2,2,0, 44823
22,44826,4,4,1, 44830
24,44829,1,1,0, 44830
23,44828,3,3,0, 44831
30,44833,3,3,1, 44836
25,44835,2,2,1, 44837
28,44834,5,5,1, 44839
29,44838,4,4,1, 44842
1,44846,1,1,1, 44847
8,44856,1,1,0, 44857
9,44857,2,2,1, 44859
16,44859,2,2,0, 44861
17,44859,3,3,1, 44862
15,44861,2,2,0, 44863
22,44866,4,4,1, 44870
24,44869,1,1,1, 44870
19,44866,5,5,1, 44871
23,44868,3,3,1, 44871
28,44874,5,5,1, 44879
1,44886,1,1,1, 44887
6,44890,2,4,1, 44894
8,44896,1,1,1, 44897
16,44899,2,2,1, 44901
17,44899,3,3,1, 44902
15,44901,2,2,0, 44903
18,44903,4,4,1, 44907
20,44903,6,6,1, 44909
22,44906,4,4,0, 44910
24,44909,1,1,0, 44910
19,44906,5,5,1, 44911
23,44908,3,3,0, 44911
31,44916,2,2,1, 44918
28,44914,5,5,1, 44919
26,44917,3,3,1, 44920
29,44918,4,4,1, 44922
2,44923,2,2,1, 44925
1,44926,1,1,1, 44927
5,44927,3,5,1, 44932
6,44930,2,4,1, 44934
8,44936,1,1,0, 44937
11,44934,4,4,1, 44938
16,44939,2,2,0, 44941
15,44941,2,2,1, 44943
12,44940,5,5,1, 44945
18,44943,4,4,1, 44947
20,44943,6,6,1, 44949
22,44946,4,4,0, 44950
24,44949,1,1,1, 44950
19,44946,5,5,1, 44951
23,44948,3,3,1, 44951
30,44953,3,3,1, 44956
25,44955,2,2,1, 44957
31,44956,2,2,1, 44958
28,44954,5,5,1, 44959
29,44958,4,4,1, 44962
2,44963,2,2,1, 44965
1,44966,1,1,0, 44967
8,44976,1,1,1, 44977
11,44974,4,4,1, 44978
16,44979,2,2,1, 44981
15,44981,2,2,1, 44983
13,44979,4,6,1, 44985
12,44980,5,5,1, 44985
22,44986,4,4,0, 44990
24,44989,1,1,0, 44990
23,44988,3,3,1, 44991
31,44996,2,2,1, 44998
8,45016,1,1,1, 45017
16,45019,2,2,0, 45021
15,45021,2,2,0, 45023
22,45026,4,4,1, 45030
24,45029,1,1,1, 45030
23,45028,3,3,0, 45031
30,45033,3,3,1, 45036
28,45034,5,5,1, 45039
29,45038,4,4,1, 45042
6,45050,2,4,1, 45054
8,45056,1,1,1, 45057
16,45059,2,2,0, 45061
15,45061,2,2,0, 45063
22,45066,4,4,1, 45070
24,45069,1,1,1, 45070
23,45068,3,3,0, 45071
30,45073,3,3,1, 45076
1,45086,1,1,1, 45087
3,45087,3,3,1, 45090
6,45090,2,4,1, 45094
8,45096,1,1,0, 45097
9,45097,2,2,1, 45099
16,45099,2,2,0, 45101
17,45099,3,3,1, 45102
15,45101,2,2,1, 45103
13,45099,4,6,1, 45105
18,45103,4,4,1, 45107
22,45106,4,4,1, 45110
24,45109,1,1,0, 45110
19,45106,5,5,1, 45111
23,45108,3,3,0, 45111
30,45113,3,3,1, 45116
31,45116,2,2,1, 45118
2,45123,2,2,1, 45125
1,45126,1,1,0, 45127
8,45136,1,1,0, 45137
16,45139,2,2,1, 45141
15,45141,2,2,0, 45143
13,45139,4,6,1, 45145
18,45143,4,4,1, 45147
20,45143,6,6,1, 45149
22,45146,4,4,1, 45150
24,45149,1,1,1, 45150
23,45148,3,3,1, 45151
25,45155,2,2,1, 45157
31,45156,2,2,1, 45158
1,45166,1,1,1, 45167
3,45167,3,3,1, 45170
8,45176,1,1,0, 45177
11,45174,4,4,1, 45178
17,45179,3,3,1, 45182
13,45179,4,6,1, 45185
12,45180,5,5,1, 45185
22,45186,4,4,1, 45190
24,45189,1,1,1, 45190
19,45186,5,5,1, 45191
30,45193,3,3,1, 45196
26,45197,3,3,1, 45200
1,45206,1,1,0, 45207
3,45207,3,3,1, 45210
5,45207,3,5,1, 45212
6,45210,2,4,1, 45214
8,45216,1,1,1, 45217
20,45223,6,6,1, 45229
22,45226,4,4,1, 45230
24,45229,1,1,0, 45230
25,45235,2,2,1, 45237
31,45236,2,2,1, 45238
28,45234,5,5,1, 45239
29,45238,4,4,1, 45242
1,45246,1,1,0, 45247
5,45247,3,5,1, 45252
6,45250,2,4,1, 45254
8,45256,1,1,1, 45257
11,45254,4,4,1, 45258
9,45257,2,2,1, 45259
16,45259,2,2,1, 45261
17,45259,3,3,1, 45262
13,45259,4,6,1, 45265
12,45260,5,5,1, 45265
18,45263,4,4,1, 45267
20,45263,6,6,1, 45269
24,45269,1,1,0, 45270
19,45266,5,5,1, 45271
23,45268,3,3,1, 45271
2,45283,2,2,1, 45285
1,45286,1,1,1, 45287
5,45287,3,5,1, 45292
6,45290,2,4,1, 45294
8,45296,1,1,1, 45297
9,45297,2,2,1, 45299
24,45309,1,1,0, 45310
19,45306,5,5,1, 45311
23,45308,3,3,1, 45311
31,45316,2,2,1, 45318
2,45323,2,2,1, 45325
1,45326,1,1,0, 45327
3,45327,3,3,1, 45330
5,45327,3,5,1, 45332
8,45336,1,1,0, 45337
9,45337,2,2,1, 45339
16,45339,2,2,1, 45341
15,45341,2,2,1, 45343
12,45340,5,5,1, 45345
18,45343,4,4,1, 45347
22,45346,4,4,1, 45350
24,45349,1,1,0, 45350
30,45353,3,3,1, 45356
31,45356,2,2,1, 45358
5,45367,3,5,1, 45372
6,45370,2,4,1, 45374
8,45376,1,1,0, 45377
16,45379,2,2,1, 45381
15,45381,2,2,1, 45383
22,45386,4,4,1, 45390
24,45389,1,1,0, 45390
28,45394,5,5,1, 45399
29,45398,4,4,1, 45402
5,45407,3,5,1, 45412
8,45416,1,1,1, 45417
16,45419,2,2,1, 45421
15,45421,2,2,1, 45423
24,45429,1,1,0, 45430
23,45428,3,3,1, 45431
30,45433,3,3,1, 45436
6,45450,2,4,1, 45454
8,45456,1,1,0, 45457
9,45457,2,2,1, 45459
13,45459,4,6,1, 45465
18,45463,4,4,1, 45467
22,45466,4,4,1, 45470
24,45469,1,1,1, 45470
19,45466,5,5,1, 45471
25,45475,2,2,1, 45477
28,45474,5,5,1, 45479
26,45477,3,3,1, 45480
29,45478,4,4,1, 45482
2,45483,2,2,1, 45485
1,45486,1,1,0, 45487
3,45487,3,3,1, 45490
5,45487,3,5,1, 45492
6,45490,2,4,1, 45494
8,45496,1,1,1, 45497
13,45499,4,6,1, 45505
18,45503,4,4,1, 45507
20,45503,6,6,1, 45509
24,45509,1,1,1, 45510
19,45506,5,5,1, 45511
23,45508,3,3,1, 45511
31,45516,2,2,1, 45518
1,45526,1,1,0, 45527
8,45536,1,1,1, 45537
11,45534,4,4,1, 45538
13,45539,4,6,1, 45545
12,45540,5,5,1, 45545
24,45549,1,1,0, 45550
23,45548,3,3,1, 45551
28,45554,5,5,1, 45559
29,45558,4,4,1, 45562
1,45566,1,1,1, 45567
5,45567,3,5,1, 45572
8,45576,1,1,1, 45577
17,45579,3,3,1, 45582
22,45586,4,4,1, 45590
24,45589,1,1,1, 45590
30,45593,3,3,1, 45596
31,45596,2,2,1, 45598
29,45598,4,4,1, 45602
1,45606,1,1,0, 45607
8,45616,1,1,0, 45617
17,45619,3,3,1, 45622
22,45626,4,4,1, 45630
24,45629,1,1,1, 45630
23,45628,3,3,1, 45631
30,45633,3,3,1, 45636
25,45635,2,2,1, 45637
28,45634,5,5,1, 45639
29,45638,4,4,1, 45642
1,45646,1,1,0, 45647
5,45647,3,5,1, 45652
6,45650,2,4,1, 45654
8,45656,1,1,0, 45657
11,45654,4,4,1, 45658
9,45657,2,2,1, 45659
15,45661,2,2,1, 45663
13,45659,4,6,1, 45665
22,45666,4,4,1, 45670
24,45669,1,1,0, 45670
19,45666,5,5,1, 45671
23,45668,3,3,1, 45671
30,45673,3,3,1, 45676
31,45676,2,2,1, 45678
29,45678,4,4,1, 45682
2,45683,2,2,1, 45685
1,45686,1,1,1, 45687
3,45687,3,3,1, 45690
6,45690,2,4,1, 45694
8,45696,1,1,0, 45697
9,45697,2,2,1, 45699
17,45699,3,3,1, 45702
15,45701,2,2,1, 45703
18,45703,4,4,1, 45707
20,45703,6,6,1, 45709
22,45706,4,4,1, 45710
24,45709,1,1,0, 45710
31,45716,2,2,1, 45718
28,45714,5,5,1, 45719
1,45726,1,1,1, 45727
3,45727,3,3,1, 45730
5,45727,3,5,1, 45732
8,45736,1,1,0, 45737
17,45739,3,3,1, 45742
12,45740,5,5,1, 45745
22,45746,4,4,1, 45750
24,45749,1,1,1, 45750
23,45748,3,3,1, 45751
25,45755,2,2,1, 45757
29,45758,4,4,1, 45762
1,45766,1,1,1, 45767
5,45767,3,5,1, 45772
6,45770,2,4,1, 45774
8,45776,1,1,1, 45777
11,45774,4,4,1, 45778
16,45779,2,2,1, 45781
15,45781,2,2,1, 45783
13,45779,4,6,1, 45785
22,45786,4,4,0, 45790
24,45789,1,1,1, 45790
19,45786,5,5,1, 45791
23,45788,3,3,0, 45791
26,45797,3,3,1, 45800
2,45803,2,2,1, 45805
1,45806,1,1,1, 45807
3,45807,3,3,1, 45810
5,45807,3,5,1, 45812
6,45810,2,4,1, 45814
8,45816,1,1,0, 45817
11,45814,4,4,1, 45818
16,45819,2,2,1, 45821
15,45821,2,2,0, 45823
13,45819,4,6,1, 45825
12,45820,5,5,1, 45825
18,45823,4,4,1, 45827
22,45826,4,4,0, 45830
24,45829,1,1,0, 45830
19,45826,5,5,1, 45831
23,45828,3,3,0, 45831
25,45835,2,2,1, 45837
1,45846,1,1,1, 45847
5,45847,3,5,1, 45852
6,45850,2,4,1, 45854
8,45856,1,1,1, 45857
9,45857,2,2,1, 45859
16,45859,2,2,0, 45861
15,45861,2,2,0, 45863
20,45863,6,6,1, 45869
22,45866,4,4,0, 45870
24,45869,1,1,0, 45870
19,45866,5,5,1, 45871
23,45868,3,3,1, 45871
31,45876,2,2,1, 45878
28,45874,5,5,1, 45879
1,45886,1,1,1, 45887
5,45887,3,5,1, 45892
6,45890,2,4,1, 45894
8,45896,1,1,0, 45897
9,45897,2,2,1, 45899
16,45899,2,2,0, 45901
17,45899,3,3,1, 45902
15,45901,2,2,0, 45903
13,45899,4,6,1, 45905
12,45900,5,5,1, 45905
22,45906,4,4,1, 45910
24,45909,1,1,1, 45910
23,45908,3,3,0, 45911
30,45913,3,3,1, 45916
28,45914,5,5,1, 45919
26,45917,3,3,1, 45920
1,45926,1,1,1, 45927
3,45927,3,3,1, 45930
5,45927,3,5,1, 45932
8,45936,1,1,1, 45937
11,45934,4,4,1, 45938
9,45937,2,2,1, 45939
16,45939,2,2,0, 45941
17,45939,3,3,1, 45942
15,45941,2,2,0, 45943
18,45943,4,4,1, 45947
20,45943,6,6,1, 45949
22,45946,4,4,1, 45950
24,45949,1,1,0, 45950
23,45948,3,3,0, 45951
30,45953,3,3,1, 45956
25,45955,2,2,1, 45957
31,45956,2,2,1, 45958
28,45954,5,5,1, 45959
26,45957,3,3,1, 45960
5,45967,3,5,1, 45972
8,45976,1,1,0, 45977
16,45979,2,2,0, 45981
15,45981,2,2,0, 45983
22,45986,4,4,0, 45990
24,45989,1,1,1, 45990
23,45988,3,3,0, 45991
28,45994,5,5,1, 45999
8,46016,1,1,1, 46017
16,46019,2,2,1, 46021
15,46021,2,2,0, 46023
22,46026,4,4,1, 46030
24,46029,1,1,0, 46030
23,46028,3,3,0, 46031
31,46036,2,2,0, 46038
28,46034,5,5,1, 46039
6,46050,2,4,1, 46054
8,46056,1,1,0, 46057
16,46059,2,2,1, 46061
15,46061,2,2,0, 46063
22,46066,4,4,0, 46070
24,46069,1,1,0, 46070
23,46068,3,3,1, 46071
30,46073,3,3,1, 46076
25,46075,2,2,1, 46077
31,46076,2,2,0, 46078
2,46083,2,2,1, 46085
1,46086,1,1,1, 46087
6,46090,2,4,1, 46094
8,46096,1,1,1, 46097
16,46099,2,2,0, 46101
17,46099,3,3,1, 46102
15,46101,2,2,1, 46103
12,46100,5,5,1, 46105
22,46106,4,4,0, 46110
24,46109,1,1,1, 46110
19,46106,5,5,1, 46111
23,46108,3,3,1, 46111
30,46113,3,3,1, 46116
31,46116,2,2,1, 46118
26,46117,3,3,1, 46120
29,46118,4,4,1, 46122
2,46123,2,2,1, 46125
1,46126,1,1,0, 46127
3,46127,3,3,1, 46130
5,46127,3,5,1, 46132
6,46130,2,4,1, 46134
8,46136,1,1,1, 46137
9,46137,2,2,1, 46139
16,46139,2,2,0, 46141
15,46141,2,2,0, 46143
12,46140,5,5,1, 46145
20,46143,6,6,1, 46149
22,46146,4,4,0, 46150
24,46149,1,1,1, 46150
23,46148,3,3,0, 46151
30,46153,3,3,1, 46156
31,46156,2,2,1, 46158
2,46163,2,2,1, 46165
1,46166,1,1,1, 46167
3,46167,3,3,1, 46170
5,46167,3,5,1, 46172
6,46170,2,4,1, 46174
8,46176,1,1,0, 46177
9,46177,2,2,1, 46179
16,46179,2,2,1, 46181
15,46181,2,2,0, 46183
12,46180,5,5,1, 46185
18,46183,4,4,1, 46187
20,46183,6,6,1, 46189
22,46186,4,4,1, 46190
24,46189,1,1,1, 46190
19,46186,5,5,1, 46191
23,46188,3,3,0, 46191
30,46193,3,3,1, 46196
31,46196,2,2,0, 46198
28,46194,5,5,1, 46199
1,46206,1,1,0, 46207
8,46216,1,1,0, 46217
16,46219,2,2,0, 46221
17,46219,3,3,1, 46222
15,46221,2,2,1, 46223
13,46219,4,6,1, 46225
12,46220,5,5,1, 46225
22,46226,4,4,1, 46230
24,46229,1,1,1, 46230
23,46228,3,3,1, 46231
30,46233,3,3,1, 46236
31,46236,2,2,1, 46238
26,46237,3,3,1, 46240
29,46238,4,4,1, 46242
1,46246,1,1,0, 46247
3,46247,3,3,1, 46250
8,46256,1,1,0, 46257
16,46259,2,2,1, 46261
17,46259,3,3,1, 46262
15,46261,2,2,0, 46263
12,46260,5,5,1, 46265
18,46263,4,4,1, 46267
22,46266,4,4,1, 46270
24,46269,1,1,1, 46270
23,46268,3,3,0, 46271
31,46276,2,2,1, 46278
28,46274,5,5,1, 46279
29,46278,4,4,1, 46282
2,46283,2,2,1, 46285
1,46286,1,1,1, 46287
3,46287,3,3,1, 46290
8,46296,1,1,0, 46297
11,46294,4,4,1, 46298
9,46297,2,2,1, 46299
16,46299,2,2,1, 46301
17,46299,3,3,1, 46302
15,46301,2,2,0, 46303
18,46303,4,4,1, 46307
20,46303,6,6,1, 46309
22,46306,4,4,1, 46310
24,46309,1,1,1, 46310
19,46306,5,5,1, 46311
23,46308,3,3,1, 46311
25,46315,2,2,1, 46317
31,46316,2,2,1, 46318
26,46317,3,3,1, 46320
5,46327,3,5,1, 46332
8,46336,1,1,0, 46337
16,46339,2,2,1, 46341
15,46341,2,2,1, 46343
22,46346,4,4,0, 46350
24,46349,1,1,0, 46350
23,46348,3,3,0, 46351
30,46353,3,3,1, 46356
31,46356,2,2,1, 46358
8,46376,1,1,0, 46377
16,46379,2,2,0, 46381
15,46381,2,2,0, 46383
22,46386,4,4,1, 46390
24,46389,1,1,1, 46390
23,46388,3,3,1, 46391
31,46396,2,2,1, 46398
29,46398,4,4,1, 46402
6,46410,2,4,1, 46414
8,46416,1,1,1, 46417
16,46419,2,2,1, 46421
15,46421,2,2,1, 46423
12,46420,5,5,1, 46425
18,46423,4,4,1, 46427
20,46423,6,6,1, 46429
22,46426,4,4,0, 46430
24,46429,1,1,0, 46430
23,46428,3,3,1, 46431
25,46435,2,2,1, 46437
31,46436,2,2,0, 46438
28,46434,5,5,1, 46439
26,46437,3,3,1, 46440
2,46443,2,2,1, 46445
1,46446,1,1,0, 46447
3,46447,3,3,1, 46450
5,46447,3,5,1, 46452
6,46450,2,4,1, 46454
8,46456,1,1,1, 46457
11,46454,4,4,1, 46458
9,46457,2,2,1, 46459
16,46459,2,2,1, 46461
15,46461,2,2,0, 46463
18,46463,4,4,1, 46467
20,46463,6,6,1, 46469
22,46466,4,4,0, 46470
24,46469,1,1,0, 46470
19,46466,5,5,1, 46471
23,46468,3,3,0, 46471
31,46476,2,2,1, 46478
1,46486,1,1,1, 46487
3,46487,3,3,1, 46490
6,46490,2,4,1, 46494
8,46496,1,1,0, 46497
9,46497,2,2,1, 46499
16,46499,2,2,0, 46501
17,46499,3,3,1, 46502
15,46501,2,2,1, 46503
12,46500,5,5,1, 46505
20,46503,6,6,1, 46509
22,46506,4,4,1, 46510
24,46509,1,1,0, 46510
23,46508,3,3,1, 46511
30,46513,3,3,1, 46516
25,46515,2,2,1, 46517
31,46516,2,2,0, 46518
26,46517,3,3,1, 46520
29,46518,4,4,1, 46522
1,46526,1,1,1, 46527
3,46527,3,3,1, 46530
6,46530,2,4,1, 46534
8,46536,1,1,1, 46537
9,46537,2,2,1, 46539
16,46539,2,2,1, 46541
15,46541,2,2,1, 46543
13,46539,4,6,1, 46545
18,46543,4,4,1, 46547
20,46543,6,6,1, 46549
22,46546,4,4,0, 46550
24,46549,1,1,1, 46550
19,46546,5,5,1, 46551
23,46548,3,3,0, 46551
30,46553,3,3,1, 46556
31,46556,2,2,1, 46558
26,46557,3,3,1, 46560
29,46558,4,4,1, 46562
8,46576,1,1,1, 46577
16,46579,2,2,1, 46581
15,46581,2,2,0, 46583
22,46586,4,4,1, 46590
24,46589,1,1,1, 46590
23,46588,3,3,1, 46591
30,46593,3,3,1, 46596
31,46596,2,2,1, 46598
28,46594,5,5,1, 46599
5,46607,3,5,1, 46612
8,46616,1,1,0, 46617
16,46619,2,2,1, 46621
15,46621,2,2,1, 46623
22,46626,4,4,0, 46630
24,46629,1,1,1, 46630
23,46628,3,3,0, 46631
31,46636,2,2,0, 46638
28,46634,5,5,1, 46639
29,46638,4,4,1, 46642
6,46650,2,4,1, 46654
8,46656,1,1,0, 46657
16,46659,2,2,1, 46661
15,46661,2,2,1, 46663
22,46666,4,4,0, 46670
24,46669,1,1,1, 46670
23,46668,3,3,0, 46671
30,46673,3,3,1, 46676
31,46676,2,2,0, 46678
1,46686,1,1,0, 46687
6,46690,2,4,1, 46694
8,46696,1,1,0, 46697
11,46694,4,4,1, 46698
16,46699,2,2,0, 46701
17,46699,3,3,1, 46702
15,46701,2,2,1, 46703
12,46700,5,5,1, 46705
18,46703,4,4,1, 46707
20,46703,6,6,1, 46709
22,46706,4,4,0, 46710
24,46709,1,1,0, 46710
23,46708,3,3,0, 46711
30,46713,3,3,1, 46716
25,46715,2,2,1, 46717
31,46716,2,2,0, 46718
26,46717,3,3,1, 46720
29,46718,4,4,1, 46722
2,46723,2,2,1, 46725
1,46726,1,1,1, 46727
6,46730,2,4,1, 46734
8,46736,1,1,0, 46737
11,46734,4,4,1, 46738
9,46737,2,2,1, 46739
16,46739,2,2,1, 46741
15,46741,2,2,0, 46743
13,46739,4,6,1, 46745
12,46740,5,5,1, 46745
20,46743,6,6,1, 46749
22,46746,4,4,0, 46750
24,46749,1,1,1, 46750
19,46746,5,5,1, 46751
23,46748,3,3,1, 46751
30,46753,3,3,1, 46756
31,46756,2,2,0, 46758
28,46754,5,5,1, 46759
29,46758,4,4,1, 46762
2,46763,2,2,1, 46765
1,46766,1,1,1, 46767
3,46767,3,3,1, 46770
8,46776,1,1,0, 46777
11,46774,4,4,1, 46778
9,46777,2,2,1, 46779
16,46779,2,2,1, 46781
15,46781,2,2,1, 46783
12,46780,5,5,1, 46785
22,46786,4,4,1, 46790
24,46789,1,1,0, 46790
23,46788,3,3,1, 46791
30,46793,3,3,1, 46796
25,46795,2,2,1, 46797
31,46796,2,2,1, 46798
28,46794,5,5,1, 46799
2,46803,2,2,1, 46805
1,46806,1,1,0, 46807
5,46807,3,5,1, 46812
6,46810,2,4,1, 46814
8,46816,1,1,1, 46817
11,46814,4,4,1, 46818
9,46817,2,2,1, 46819
16,46819,2,2,1, 46821
15,46821,2,2,0, 46823
13,46819,4,6,1, 46825
12,46820,5,5,1, 46825
18,46823,4,4,1, 46827
20,46823,6,6,1, 46829
22,46826,4,4,0, 46830
24,46829,1,1,0, 46830
19,46826,5,5,1, 46831
23,46828,3,3,0, 46831
25,46835,2,2,1, 46837
31,46836,2,2,0, 46838
5,46847,3,5,1, 46852
6,46850,2,4,1, 46854
8,46856,1,1,0, 46857
16,46859,2,2,0, 46861
15,46861,2,2,0, 46863
22,46866,4,4,0, 46870
24,46869,1,1,1, 46870
23,46868,3,3,0, 46871
30,46873,3,3,1, 46876
31,46876,2,2,0, 46878
5,46887,3,5,1, 46892
8,46896,1,1,0, 46897
16,46899,2,2,0, 46901
15,46901,2,2,1, 46903
22,46906,4,4,0, 46910
24,46909,1,1,1, 46910
23,46908,3,3,0, 46911
30,46913,3,3,1, 46916
31,46916,2,2,0, 46918
28,46914,5,5,1, 46919
5,46927,3,5,1, 46932
6,46930,2,4,1, 46934
8,46936,1,1,0, 46937
16,46939,2,2,0, 46941
15,46941,2,2,1, 46943
13,46939,4,6,1, 46945
12,46940,5,5,1, 46945
18,46943,4,4,1, 46947
22,46946,4,4,1, 46950
24,46949,1,1,0, 46950
19,46946,5,5,1, 46951
23,46948,3,3,1, 46951
30,46953,3,3,1, 46956
25,46955,2,2,1, 46957
31,46956,2,2,0, 46958
28,46954,5,5,1, 46959
26,46957,3,3,1, 46960
1,46966,1,1,0, 46967
5,46967,3,5,1, 46972
8,46976,1,1,1, 46977
16,46979,2,2,1, 46981
15,46981,2,2,1, 46983
13,46979,4,6,1, 46985
12,46980,5,5,1, 46985
22,46986,4,4,1, 46990
24,46989,1,1,1, 46990
19,46986,5,5,1, 46991
23,46988,3,3,0, 46991
25,46995,2,2,1, 46997
31,46996,2,2,0, 46998
28,46994,5,5,1, 46999
26,46997,3,3,1, 47000
2,47003,2,2,1, 47005
1,47006,1,1,1, 47007
5,47007,3,5,1, 47012
8,47016,1,1,0, 47017
11,47014,4,4,1, 47018
9,47017,2,2,1, 47019
16,47019,2,2,0, 47021
15,47021,2,2,0, 47023
12,47020,5,5,1, 47025
20,47023,6,6,1, 47029
22,47026,4,4,0, 47030
24,47029,1,1,0, 47030
23,47028,3,3,0, 47031
25,47035,2,2,1, 47037
31,47036,2,2,1, 47038
1,47046,1,1,0, 47047
3,47047,3,3,1, 47050
6,47050,2,4,1, 47054
8,47056,1,1,1, 47057
11,47054,4,4,1, 47058
16,47059,2,2,0, 47061
15,47061,2,2,0, 47063
13,47059,4,6,1, 47065
18,47063,4,4,1, 47067
20,47063,6,6,1, 47069
22,47066,4,4,0, 47070
24,47069,1,1,0, 47070
23,47068,3,3,1, 47071
25,47075,2,2,1, 47077
31,47076,2,2,1, 47078
28,47074,5,5,1, 47079
1,47086,1,1,1, 47087
6,47090,2,4,1, 47094
8,47096,1,1,0, 47097
9,47097,2,2,1, 47099
16,47099,2,2,1, 47101
15,47101,2,2,1, 47103
22,47106,4,4,1, 47110
24,47109,1,1,0, 47110
23,47108,3,3,0, 47111
30,47113,3,3,1, 47116
25,47115,2,2,1, 47117
31,47116,2,2,1, 47118
29,47118,4,4,1, 47122
1,47126,1,1,0, 47127
5,47127,3,5,1, 47132
8,47136,1,1,1, 47137
9,47137,2,2,1, 47139
16,47139,2,2,0, 47141
15,47141,2,2,1, 47143
22,47146,4,4,1, 47150
24,47149,1,1,1, 47150
23,47148,3,3,0, 47151
25,47155,2,2,1, 47157
31,47156,2,2,0, 47158
29,47158,4,4,1, 47162
1,47166,1,1,1, 47167
5,47167,3,5,1, 47172
8,47176,1,1,0, 47177
16,47179,2,2,0, 47181
17,47179,3,3,1, 47182
15,47181,2,2,0, 47183
12,47180,5,5,1, 47185
22,47186,4,4,1, 47190
24,47189,1,1,1, 47190
23,47188,3,3,1, 47191
31,47196,2,2,1, 47198
26,47197,3,3,1, 47200
2,47203,2,2,1, 47205
1,47206,1,1,0, 47207
6,47210,2,4,1, 47214
8,47216,1,1,0, 47217
11,47214,4,4,1, 47218
16,47219,2,2,1, 47221
15,47221,2,2,1, 47223
13,47219,4,6,1, 47225
12,47220,5,5,1, 47225
18,47223,4,4,1, 47227
22,47226,4,4,1, 47230
24,47229,1,1,1, 47230
19,47226,5,5,1, 47231
23,47228,3,3,0, 47231
31,47236,2,2,1, 47238
28,47234,5,5,1, 47239
29,47238,4,4,1, 47242
2,47243,2,2,1, 47245
1,47246,1,1,0, 47247
5,47247,3,5,1, 47252
8,47256,1,1,1, 47257
16,47259,2,2,0, 47261
17,47259,3,3,1, 47262
15,47261,2,2,1, 47263
13,47259,4,6,1, 47265
22,47266,4,4,1, 47270
24,47269,1,1,0, 47270
23,47268,3,3,0, 47271
30,47273,3,3,1, 47276
31,47276,2,2,0, 47278
28,47274,5,5,0, 47279
29,47278,4,4,1, 47282
2,47283,2,2,1, 47285
1,47286,1,1,0, 47287
3,47287,3,3,1, 47290
5,47287,3,5,1, 47292
6,47290,2,4,1, 47294
8,47296,1,1,1, 47297
11,47294,4,4,1, 47298
16,47299,2,2,1, 47301
17,47299,3,3,1, 47302
15,47301,2,2,0, 47303
18,47303,4,4,1, 47307
22,47306,4,4,1, 47310
24,47309,1,1,1, 47310
19,47306,5,5,1, 47311
23,47308,3,3,1, 47311
30,47313,3,3,0, 47316
31,47316,2,2,0, 47318
28,47314,5,5,0, 47319
29,47318,4,4,1, 47322
2,47323,2,2,1, 47325
1,47326,1,1,1, 47327
5,47327,3,5,0, 47332
6,47330,2,4,0, 47334
8,47336,1,1,0, 47337
11,47334,4,4,1, 47338
16,47339,2,2,0, 47341
17,47339,3,3,1, 47342
15,47341,2,2,0, 47343
13,47339,4,6,1, 47345
12,47340,5,5,1, 47345
22,47346,4,4,1, 47350
24,47349,1,1,1, 47350
23,47348,3,3,1, 47351
30,47353,3,3,1, 47356
31,47356,2,2,0, 47358
28,47354,5,5,0, 47359
29,47358,4,4,1, 47362
5,47367,3,5,1, 47372
6,47370,2,4,0, 47374
8,47376,1,1,1, 47377
16,47379,2,2,1, 47381
15,47381,2,2,0, 47383
22,47386,4,4,0, 47390
24,47389,1,1,0, 47390
23,47388,3,3,1, 47391
30,47393,3,3,1, 47396
31,47396,2,2,1, 47398
28,47394,5,5,0, 47399
29,47398,4,4,1, 47402
5,47407,3,5,0, 47412
6,47410,2,4,1, 47414
8,47416,1,1,0, 47417
16,47419,2,2,1, 47421
15,47421,2,2,0, 47423
22,47426,4,4,0, 47430
24,47429,1,1,0, 47430
23,47428,3,3,1, 47431
30,47433,3,3,0, 47436
31,47436,2,2,0, 47438
28,47434,5,5,0, 47439
29,47438,4,4,1, 47442
3,47447,3,3,1, 47450
5,47447,3,5,1, 47452
6,47450,2,4,0, 47454
8,47456,1,1,1, 47457
11,47454,4,4,1, 47458
9,47457,2,2,1, 47459
16,47459,2,2,1, 47461
15,47461,2,2,1, 47463
18,47463,4,4,1, 47467
20,47463,6,6,1, 47469
22,47466,4,4,1, 47470
24,47469,1,1,0, 47470
19,47466,5,5,1, 47471
23,47468,3,3,1, 47471
30,47473,3,3,1, 47476
31,47476,2,2,1, 47478
28,47474,5,5,1, 47479
29,47478,4,4,0, 47482
1,47486,1,1,1, 47487
3,47487,3,3,1, 47490
5,47487,3,5,1, 47492
6,47490,2,4,0, 47494
8,47496,1,1,1, 47497
9,47497,2,2,1, 47499
16,47499,2,2,1, 47501
15,47501,2,2,1, 47503
20,47503,6,6,1, 47509
22,47506,4,4,1, 47510
24,47509,1,1,0, 47510
19,47506,5,5,1, 47511
23,47508,3,3,0, 47511
30,47513,3,3,1, 47516
31,47516,2,2,1, 47518
28,47514,5,5,0, 47519
29,47518,4,4,0, 47522
1,47526,1,1,0, 47527
3,47527,3,3,1, 47530
5,47527,3,5,1, 47532
6,47530,2,4,0, 47534
8,47536,1,1,0, 47537
16,47539,2,2,1, 47541
17,47539,3,3,1, 47542
15,47541,2,2,0, 47543
20,47543,6,6,1, 47549
22,47546,4,4,1, 47550
24,47549,1,1,0, 47550
19,47546,5,5,1, 47551
23,47548,3,3,0, 47551
30,47553,3,3,1, 47556
25,47555,2,2,1, 47557
31,47556,2,2,1, 47558
28,47554,5,5,0, 47559
26,47557,3,3,1, 47560
29,47558,4,4,1, 47562
1,47566,1,1,1, 47567
5,47567,3,5,0, 47572
6,47570,2,4,0, 47574
8,47576,1,1,0, 47577
9,47577,2,2,1, 47579
16,47579,2,2,1, 47581
15,47581,2,2,0, 47583
13,47579,4,6,1, 47585
18,47583,4,4,1, 47587
22,47586,4,4,1, 47590
24,47589,1,1,1, 47590
23,47588,3,3,1, 47591
30,47593,3,3,0, 47596
25,47595,2,2,1, 47597
31,47596,2,2,0, 47598
28,47594,5,5,0, 47599
29,47598,4,4,0, 47602
2,47603,2,2,1, 47605
1,47606,1,1,0, 47607
3,47607,3,3,1, 47610
5,47607,3,5,1, 47612
6,47610,2,4,0, 47614
8,47616,1,1,1, 47617
16,47619,2,2,1, 47621
17,47619,3,3,1, 47622
15,47621,2,2,0, 47623
12,47620,5,5,1, 47625
22,47626,4,4,1, 47630
24,47629,1,1,1, 47630
19,47626,5,5,1, 47631
23,47628,3,3,0, 47631
30,47633,3,3,1, 47636
31,47636,2,2,1, 47638
28,47634,5,5,0, 47639
26,47637,3,3,1, 47640
29,47638,4,4,0, 47642
1,47646,1,1,0, 47647
3,47647,3,3,1, 47650
5,47647,3,5,1, 47652
8,47656,1,1,0, 47657
16,47659,2,2,0, 47661
17,47659,3,3,1, 47662
15,47661,2,2,0, 47663
12,47660,5,5,1, 47665
22,47666,4,4,1, 47670
24,47669,1,1,1, 47670
23,47668,3,3,1, 47671
31,47676,2,2,1, 47678
29,47678,4,4,1, 47682
2,47683,2,2,1, 47685
1,47686,1,1,0, 47687
5,47687,3,5,1, 47692
6,47690,2,4,1, 47694
8,47696,1,1,1, 47697
11,47694,4,4,1, 47698
9,47697,2,2,1, 47699
16,47699,2,2,0, 47701
15,47701,2,2,1, 47703
20,47703,6,6,1, 47709
22,47706,4,4,1, 47710
24,47709,1,1,0, 47710
31,47716,2,2,1, 47718
2,47723,2,2,1, 47725
1,47726,1,1,0, 47727
3,47727,3,3,1, 47730
6,47730,2,4,1, 47734
8,47736,1,1,1, 47737
11,47734,4,4,1, 47738
15,47741,2,2,1, 47743
12,47740,5,5,1, 47745
22,47746,4,4,1, 47750
24,47749,1,1,1, 47750
23,47748,3,3,1, 47751
30,47753,3,3,1, 47756
26,47757,3,3,1, 47760
1,47766,1,1,1, 47767
6,47770,2,4,1, 47774
8,47776,1,1,1, 47777
9,47777,2,2,1, 47779
16,47779,2,2,1, 47781
17,47779,3,3,1, 47782
15,47781,2,2,1, 47783
12,47780,5,5,1, 47785
18,47783,4,4,1, 47787
20,47783,6,6,1, 47789
22,47786,4,4,1, 47790
24,47789,1,1,0, 47790
19,47786,5,5,1, 47791
28,47794,5,5,1, 47799
5,47807,3,5,1, 47812
8,47816,1,1,1, 47817
15,47821,2,2,1, 47823
22,47826,4,4,1, 47830
24,47829,1,1,0, 47830
31,47836,2,2,1, 47838
28,47834,5,5,1, 47839
29,47838,4,4,1, 47842
8,47856,1,1,0, 47857
24,47869,1,1,1, 47870
23,47868,3,3,1, 47871
30,47873,3,3,1, 47876
31,47876,2,2,1, 47878
6,47890,2,4,1, 47894
8,47896,1,1,1, 47897
9,47897,2,2,1, 47899
17,47899,3,3,1, 47902
24,47909,1,1,1, 47910
31,47916,2,2,1, 47918
26,47917,3,3,1, 47920
29,47918,4,4,1, 47922
1,47926,1,1,1, 47927
8,47936,1,1,1, 47937
11,47934,4,4,1, 47938
9,47937,2,2,1, 47939
17,47939,3,3,1, 47942
12,47940,5,5,1, 47945
20,47943,6,6,1, 47949
22,47946,4,4,1, 47950
24,47949,1,1,1, 47950
25,47955,2,2,1, 47957
29,47958,4,4,1, 47962
1,47966,1,1,0, 47967
3,47967,3,3,1, 47970
6,47970,2,4,1, 47974
8,47976,1,1,0, 47977
9,47977,2,2,1, 47979
17,47979,3,3,1, 47982
15,47981,2,2,1, 47983
18,47983,4,4,1, 47987
22,47986,4,4,1, 47990
24,47989,1,1,0, 47990
31,47996,2,2,1, 47998
29,47998,4,4,1, 48002
1,48006,1,1,0, 48007
3,48007,3,3,1, 48010
8,48016,1,1,0, 48017
17,48019,3,3,1, 48022
13,48019,4,6,1, 48025
12,48020,5,5,1, 48025
22,48026,4,4,1, 48030
24,48029,1,1,1, 48030
31,48036,2,2,1, 48038
28,48034,5,5,1, 48039
29,48038,4,4,1, 48042
2,48043,2,2,1, 48045
1,48046,1,1,0, 48047
3,48047,3,3,1, 48050
6,48050,2,4,1, 48054
8,48056,1,1,1, 48057
16,48059,2,2,1, 48061
17,48059,3,3,1, 48062
13,48059,4,6,1, 48065
12,48060,5,5,1, 48065
20,48063,6,6,1, 48069
24,48069,1,1,0, 48070
30,48073,3,3,1, 48076
25,48075,2,2,1, 48077
28,48074,5,5,1, 48079
2,48083,2,2,1, 48085
1,48086,1,1,1, 48087
5,48087,3,5,1, 48092
8,48096,1,1,0, 48097
11,48094,4,4,1, 48098
9,48097,2,2,1, 48099
16,48099,2,2,1, 48101
17,48099,3,3,1, 48102
15,48101,2,2,1, 48103
20,48103,6,6,1, 48109
22,48106,4,4,1, 48110
24,48109,1,1,1, 48110
19,48106,5,5,1, 48111
31,48116,2,2,1, 48118
29,48118,4,4,1, 48122
2,48123,2,2,1, 48125
1,48126,1,1,1, 48127
5,48127,3,5,1, 48132
6,48130,2,4,1, 48134
8,48136,1,1,0, 48137
11,48134,4,4,1, 48138
9,48137,2,2,1, 48139
16,48139,2,2,1, 48141
13,48139,4,6,1, 48145
12,48140,5,5,1, 48145
20,48143,6,6,1, 48149
24,48149,1,1,1, 48150
19,48146,5,5,1, 48151
23,48148,3,3,1, 48151
31,48156,2,2,1, 48158
28,48154,5,5,1, 48159
26,48157,3,3,1, 48160
29,48158,4,4,1, 48162
1,48166,1,1,0, 48167
8,48176,1,1,0, 48177
9,48177,2,2,1, 48179
16,48179,2,2,1, 48181
17,48179,3,3,1, 48182
15,48181,2,2,1, 48183
22,48186,4,4,1, 48190
24,48189,1,1,0, 48190
30,48193,3,3,1, 48196
31,48196,2,2,1, 48198
28,48194,5,5,1, 48199
29,48198,4,4,1, 48202
5,48207,3,5,1, 48212
6,48210,2,4,1, 48214
8,48216,1,1,1, 48217
15,48221,2,2,1, 48223
22,48226,4,4,1, 48230
24,48229,1,1,0, 48230
30,48233,3,3,1, 48236
31,48236,2,2,1, 48238
6,48250,2,4,1, 48254
8,48256,1,1,0, 48257
16,48259,2,2,1, 48261
15,48261,2,2,1, 48263
22,48266,4,4,1, 48270
24,48269,1,1,0, 48270
30,48273,3,3,1, 48276
1,48286,1,1,0, 48287
3,48287,3,3,1, 48290
6,48290,2,4,1, 48294
8,48296,1,1,0, 48297
11,48294,4,4,1, 48298
9,48297,2,2,1, 48299
16,48299,2,2,1, 48301
17,48299,3,3,1, 48302
13,48299,4,6,1, 48305
18,48303,4,4,1, 48307
22,48306,4,4,1, 48310
24,48309,1,1,1, 48310
28,48314,5,5,1, 48319
29,48318,4,4,1, 48322
1,48326,1,1,1, 48327
5,48327,3,5,1, 48332
6,48330,2,4,1, 48334
8,48336,1,1,0, 48337
9,48337,2,2,1, 48339
16,48339,2,2,0, 48341
15,48341,2,2,0, 48343
22,48346,4,4,0, 48350
24,48349,1,1,1, 48350
23,48348,3,3,0, 48351
1,48366,1,1,0, 48367
5,48367,3,5,1, 48372
8,48376,1,1,1, 48377
16,48379,2,2,0, 48381
15,48381,2,2,0, 48383
22,48386,4,4,1, 48390
24,48389,1,1,0, 48390
23,48388,3,3,0, 48391
31,48396,2,2,1, 48398
1,48406,1,1,1, 48407
8,48416,1,1,0, 48417
11,48414,4,4,1, 48418
9,48417,2,2,1, 48419
16,48419,2,2,1, 48421
15,48421,2,2,0, 48423
12,48420,5,5,1, 48425
22,48426,4,4,0, 48430
24,48429,1,1,1, 48430
19,48426,5,5,1, 48431
23,48428,3,3,1, 48431
30,48433,3,3,1, 48436
28,48434,5,5,1, 48439
26,48437,3,3,1, 48440
29,48438,4,4,1, 48442
1,48446,1,1,1, 48447
3,48447,3,3,1, 48450
5,48447,3,5,1, 48452
6,48450,2,4,1, 48454
8,48456,1,1,1, 48457
9,48457,2,2,1, 48459
16,48459,2,2,0, 48461
15,48461,2,2,1, 48463
13,48459,4,6,1, 48465
18,48463,4,4,1, 48467
20,48463,6,6,1, 48469
22,48466,4,4,0, 48470
24,48469,1,1,0, 48470
19,48466,5,5,1, 48471
23,48468,3,3,0, 48471
31,48476,2,2,1, 48478
26,48477,3,3,1, 48480
2,48483,2,2,1, 48485
1,48486,1,1,0, 48487
5,48487,3,5,1, 48492
6,48490,2,4,1, 48494
8,48496,1,1,1, 48497
11,48494,4,4,1, 48498
16,48499,2,2,1, 48501
15,48501,2,2,1, 48503
13,48499,4,6,1, 48505
18,48503,4,4,1, 48507
20,48503,6,6,1, 48509
22,48506,4,4,0, 48510
24,48509,1,1,1, 48510
19,48506,5,5,1, 48511
23,48508,3,3,1, 48511
28,48514,5,5,1, 48519
26,48517,3,3,1, 48520
2,48523,2,2,1, 48525
1,48526,1,1,0, 48527
3,48527,3,3,1, 48530
5,48527,3,5,1, 48532
6,48530,2,4,1, 48534
8,48536,1,1,0, 48537
16,48539,2,2,1, 48541
15,48541,2,2,1, 48543
13,48539,4,6,1, 48545
18,48543,4,4,1, 48547
22,48546,4,4,0, 48550
24,48549,1,1,0, 48550
23,48548,3,3,1, 48551
30,48553,3,3,1, 48556
28,48554,5,5,1, 48559
29,48558,4,4,1, 48562
2,48563,2,2,1, 48565
1,48566,1,1,0, 48567
5,48567,3,5,1, 48572
6,48570,2,4,1, 48574
8,48576,1,1,0, 48577
16,48579,2,2,0, 48581
15,48581,2,2,0, 48583
12,48580,5,5,1, 48585
18,48583,4,4,1, 48587
20,48583,6,6,1, 48589
22,48586,4,4,1, 48590
24,48589,1,1,0, 48590
19,48586,5,5,1, 48591
23,48588,3,3,1, 48591
25,48595,2,2,1, 48597
31,48596,2,2,1, 48598
28,48594,5,5,1, 48599
26,48597,3,3,1, 48600
29,48598,4,4,1, 48602
1,48606,1,1,0, 48607
6,48610,2,4,1, 48614
8,48616,1,1,1, 48617
11,48614,4,4,1, 48618
9,48617,2,2,1, 48619
16,48619,2,2,1, 48621
17,48619,3,3,1, 48622
15,48621,2,2,0, 48623
22,48626,4,4,1, 48630
24,48629,1,1,1, 48630
19,48626,5,5,1, 48631
23,48628,3,3,1, 48631
30,48633,3,3,1, 48636
2,48643,2,2,1, 48645
1,48646,1,1,0, 48647
3,48647,3,3,1, 48650
5,48647,3,5,1, 48652
8,48656,1,1,0, 48657
9,48657,2,2,1, 48659
16,48659,2,2,0, 48661
15,48661,2,2,1, 48663
12,48660,5,5,1, 48665
22,48666,4,4,0, 48670
24,48669,1,1,1, 48670
23,48668,3,3,0, 48671
30,48673,3,3,1, 48676
25,48675,2,2,1, 48677
31,48676,2,2,1, 48678
26,48677,3,3,1, 48680
2,48683,2,2,1, 48685
1,48686,1,1,0, 48687
5,48687,3,5,1, 48692
8,48696,1,1,1, 48697
11,48694,4,4,1, 48698
9,48697,2,2,1, 48699
16,48699,2,2,1, 48701
15,48701,2,2,1, 48703
22,48706,4,4,1, 48710
24,48709,1,1,1, 48710
23,48708,3,3,0, 48711
6,48730,2,4,1, 48734
8,48736,1,1,1, 48737
16,48739,2,2,0, 48741
15,48741,2,2,1, 48743
22,48746,4,4,0, 48750
24,48749,1,1,0, 48750
23,48748,3,3,1, 48751
30,48753,3,3,1, 48756
8,48776,1,1,0, 48777
16,48779,2,2,1, 48781
15,48781,2,2,1, 48783
22,48786,4,4,0, 48790
24,48789,1,1,1, 48790
23,48788,3,3,1, 48791
2,48803,2,2,1, 48805
1,48806,1,1,0, 48807
5,48807,3,5,1, 48812
6,48810,2,4,1, 48814
8,48816,1,1,1, 48817
9,48817,2,2,1, 48819
16,48819,2,2,0, 48821
15,48821,2,2,1, 48823
13,48819,4,6,1, 48825
12,48820,5,5,1, 48825
22,48826,4,4,1, 48830
24,48829,1,1,1, 48830
23,48828,3,3,0, 48831
30,48833,3,3,1, 48836
31,48836,2,2,1, 48838
26,48837,3,3,1, 48840
1,48846,1,1,0, 48847
3,48847,3,3,1, 48850
5,48847,3,5,1, 48852
8,48856,1,1,0, 48857
11,48854,4,4,1, 48858
16,48859,2,2,0, 48861
15,48861,2,2,1, 48863
12,48860,5,5,1, 48865
20,48863,6,6,1, 48869
22,48866,4,4,1, 48870
24,48869,1,1,1, 48870
23,48868,3,3,0, 48871
31,48876,2,2,1, 48878
26,48877,3,3,1, 48880
29,48878,4,4,1, 48882
1,48886,1,1,0, 48887
3,48887,3,3,1, 48890
8,48896,1,1,1, 48897
16,48899,2,2,0, 48901
17,48899,3,3,1, 48902
15,48901,2,2,0, 48903
12,48900,5,5,1, 48905
18,48903,4,4,1, 48907
20,48903,6,6,1, 48909
22,48906,4,4,0, 48910
24,48909,1,1,0, 48910
23,48908,3,3,1, 48911
30,48913,3,3,1, 48916
25,48915,2,2,1, 48917
26,48917,3,3,1, 48920
29,48918,4,4,1, 48922
2,48923,2,2,1, 48925
1,48926,1,1,1, 48927
3,48927,3,3,1, 48930
8,48936,1,1,1, 48937
9,48937,2,2,1, 48939
16,48939,2,2,1, 48941
17,48939,3,3,1, 48942
15,48941,2,2,0, 48943
12,48940,5,5,1, 48945
22,48946,4,4,0, 48950
24,48949,1,1,1, 48950
19,48946,5,5,1, 48951
23,48948,3,3,0, 48951
25,48955,2,2,1, 48957
31,48956,2,2,1, 48958
28,48954,5,5,1, 48959
2,48963,2,2,1, 48965
1,48966,1,1,0, 48967
8,48976,1,1,0, 48977
16,48979,2,2,1, 48981
15,48981,2,2,1, 48983
12,48980,5,5,1, 48985
20,48983,6,6,1, 48989
22,48986,4,4,0, 48990
24,48989,1,1,1, 48990
23,48988,3,3,1, 48991
31,48996,2,2,1, 48998
28,48994,5,5,1, 48999
2,49003,2,2,1, 49005
1,49006,1,1,0, 49007
5,49007,3,5,1, 49012
8,49016,1,1,1, 49017
9,49017,2,2,1, 49019
16,49019,2,2,0, 49021
17,49019,3,3,1, 49022
15,49021,2,2,0, 49023
13,49019,4,6,1, 49025
12,49020,5,5,1, 49025
22,49026,4,4,0, 49030
24,49029,1,1,1, 49030
23,49028,3,3,1, 49031
30,49033,3,3,1, 49036
31,49036,2,2,1, 49038
28,49034,5,5,1, 49039
2,49043,2,2,1, 49045
1,49046,1,1,0, 49047
6,49050,2,4,1, 49054
8,49056,1,1,1, 49057
16,49059,2,2,1, 49061
15,49061,2,2,1, 49063
12,49060,5,5,1, 49065
18,49063,4,4,1, 49067
20,49063,6,6,1, 49069
22,49066,4,4,1, 49070
24,49069,1,1,1, 49070
19,49066,5,5,1, 49071
23,49068,3,3,1, 49071
30,49073,3,3,1, 49076
31,49076,2,2,1, 49078
26,49077,3,3,1, 49080
29,49078,4,4,1, 49082
5,49087,3,5,1, 49092
6,49090,2,4,1, 49094
8,49096,1,1,0, 49097
16,49099,2,2,1, 49101
15,49101,2,2,1, 49103
22,49106,4,4,0, 49110
24,49109,1,1,1, 49110
23,49108,3,3,0, 49111
30,49113,3,3,1, 49116
5,49127,3,5,1, 49132
6,49130,2,4,1, 49134
8,49136,1,1,1, 49137
16,49139,2,2,1, 49141
15,49141,2,2,1, 49143
22,49146,4,4,0, 49150
24,49149,1,1,1, 49150
23,49148,3,3,0, 49151
30,49153,3,3,1, 49156
6,49170,2,4,1, 49174
8,49176,1,1,1, 49177
16,49179,2,2,0, 49181
15,49181,2,2,1, 49183
22,49186,4,4,0, 49190
24,49189,1,1,1, 49190
23,49188,3,3,1, 49191
30,49193,3,3,1, 49196
31,49196,2,2,1, 49198
1,49206,1,1,0, 49207
8,49216,1,1,1, 49217
16,49219,2,2,1, 49221
15,49221,2,2,0, 49223
22,49226,4,4,0, 49230
24,49229,1,1,0, 49230
23,49228,3,3,0, 49231
30,49233,3,3,1, 49236
31,49236,2,2,1, 49238
28,49234,5,5,1, 49239
29,49238,4,4,1, 49242
1,49246,1,1,1, 49247
3,49247,3,3,1, 49250
5,49247,3,5,1, 49252
8,49256,1,1,1, 49257
16,49259,2,2,1, 49261
15,49261,2,2,0, 49263
13,49259,4,6,1, 49265
22,49266,4,4,1, 49270
24,49269,1,1,1, 49270
23,49268,3,3,1, 49271
31,49276,2,2,1, 49278
2,49283,2,2,1, 49285
1,49286,1,1,0, 49287
3,49287,3,3,1, 49290
8,49296,1,1,1, 49297
11,49294,4,4,1, 49298
9,49297,2,2,1, 49299
16,49299,2,2,0, 49301
15,49301,2,2,0, 49303
20,49303,6,6,1, 49309
22,49306,4,4,1, 49310
24,49309,1,1,0, 49310
23,49308,3,3,1, 49311
25,49315,2,2,1, 49317
31,49316,2,2,1, 49318
29,49318,4,4,1, 49322
1,49326,1,1,1, 49327
6,49330,2,4,1, 49334
8,49336,1,1,1, 49337
9,49337,2,2,1, 49339
16,49339,2,2,1, 49341
15,49341,2,2,1, 49343
13,49339,4,6,1, 49345
20,49343,6,6,1, 49349
22,49346,4,4,0, 49350
24,49349,1,1,0, 49350
19,49346,5,5,1, 49351
23,49348,3,3,1, 49351
30,49353,3,3,1, 49356
31,49356,2,2,1, 49358
26,49357,3,3,1, 49360
29,49358,4,4,1, 49362
2,49363,2,2,1, 49365
1,49366,1,1,1, 49367
6,49370,2,4,1, 49374
8,49376,1,1,0, 49377
9,49377,2,2,1, 49379
16,49379,2,2,0, 49381
15,49381,2,2,0, 49383
18,49383,4,4,1, 49387
22,49386,4,4,1, 49390
24,49389,1,1,1, 49390
19,49386,5,5,1, 49391
23,49388,3,3,1, 49391
30,49393,3,3,1, 49396
25,49395,2,2,1, 49397
2,49403,2,2,1, 49405
1,49406,1,1,1, 49407
8,49416,1,1,0, 49417
16,49419,2,2,1, 49421
17,49419,3,3,1, 49422
15,49421,2,2,0, 49423
13,49419,4,6,1, 49425
12,49420,5,5,1, 49425
22,49426,4,4,0, 49430
24,49429,1,1,1, 49430
23,49428,3,3,1, 49431
30,49433,3,3,1, 49436
25,49435,2,2,1, 49437
31,49436,2,2,0, 49438
28,49434,5,5,1, 49439
29,49438,4,4,0, 49442
1,49446,1,1,0, 49447
3,49447,3,3,1, 49450
5,49447,3,5,1, 49452
6,49450,2,4,1, 49454
8,49456,1,1,0, 49457
16,49459,2,2,1, 49461
15,49461,2,2,1, 49463
13,49459,4,6,1, 49465
12,49460,5,5,1, 49465
22,49466,4,4,0, 49470
24,49469,1,1,1, 49470
23,49468,3,3,1, 49471
30,49473,3,3,1, 49476
31,49476,2,2,1, 49478
28,49474,5,5,0, 49479
29,49478,4,4,1, 49482
1,49486,1,1,1, 49487
5,49487,3,5,1, 49492
6,49490,2,4,0, 49494
8,49496,1,1,0, 49497
11,49494,4,4,1, 49498
9,49497,2,2,1, 49499
16,49499,2,2,1, 49501
15,49501,2,2,1, 49503
20,49503,6,6,1, 49509
22,49506,4,4,0, 49510
24,49509,1,1,0, 49510
23,49508,3,3,1, 49511
31,49516,2,2,1, 49518
28,49514,5,5,1, 49519
29,49518,4,4,1, 49522
2,49523,2,2,1, 49525
1,49526,1,1,1, 49527
5,49527,3,5,1, 49532
8,49536,1,1,0, 49537
11,49534,4,4,1, 49538
9,49537,2,2,1, 49539
16,49539,2,2,0, 49541
15,49541,2,2,0, 49543
12,49540,5,5,1, 49545
20,49543,6,6,1, 49549
22,49546,4,4,1, 49550
24,49549,1,1,1, 49550
23,49548,3,3,0, 49551
31,49556,2,2,1, 49558
26,49557,3,3,1, 49560
29,49558,4,4,1, 49562
1,49566,1,1,1, 49567
6,49570,2,4,1, 49574
8,49576,1,1,0, 49577
11,49574,4,4,1, 49578
16,49579,2,2,1, 49581
17,49579,3,3,1, 49582
15,49581,2,2,1, 49583
12,49580,5,5,1, 49585
22,49586,4,4,0, 49590
24,49589,1,1,1, 49590
23,49588,3,3,0, 49591
31,49596,2,2,1, 49598
26,49597,3,3,1, 49600
2,49603,2,2,1, 49605
1,49606,1,1,1, 49607
5,49607,3,5,1, 49612
6,49610,2,4,1, 49614
8,49616,1,1,1, 49617
11,49614,4,4,1, 49618
9,49617,2,2,1, 49619
16,49619,2,2,1, 49621
15,49621,2,2,0, 49623
22,49626,4,4,0, 49630
24,49629,1,1,1, 49630
23,49628,3,3,0, 49631
30,49633,3,3,1, 49636
31,49636,2,2,0, 49638
26,49637,3,3,1, 49640
29,49638,4,4,1, 49642
1,49646,1,1,0, 49647
8,49656,1,1,0, 49657
16,49659,2,2,0, 49661
17,49659,3,3,1, 49662
15,49661,2,2,0, 49663
22,49666,4,4,0, 49670
24,49669,1,1,1, 49670
23,49668,3,3,0, 49671
30,49673,3,3,1, 49676
25,49675,2,2,1, 49677
31,49676,2,2,1, 49678
28,49674,5,5,1, 49679
1,49686,1,1,1, 49687
8,49696,1,1,0, 49697
11,49694,4,4,1, 49698
16,49699,2,2,1, 49701
17,49699,3,3,1, 49702
15,49701,2,2,1, 49703
13,49699,4,6,1, 49705
18,49703,4,4,1, 49707
22,49706,4,4,1, 49710
24,49709,1,1,0, 49710
23,49708,3,3,1, 49711
31,49716,2,2,0, 49718
26,49717,3,3,1, 49720
29,49718,4,4,1, 49722
1,49726,1,1,0, 49727
3,49727,3,3,1, 49730
6,49730,2,4,1, 49734
8,49736,1,1,0, 49737
9,49737,2,2,1, 49739
16,49739,2,2,1, 49741
17,49739,3,3,1, 49742
15,49741,2,2,0, 49743
18,49743,4,4,1, 49747
20,49743,6,6,1, 49749
22,49746,4,4,0, 49750
24,49749,1,1,1, 49750
19,49746,5,5,1, 49751
23,49748,3,3,0, 49751
31,49756,2,2,1, 49758
28,49754,5,5,1, 49759
26,49757,3,3,1, 49760
2,49763,2,2,1, 49765
1,49766,1,1,1, 49767
5,49767,3,5,1, 49772
6,49770,2,4,1, 49774
8,49776,1,1,0, 49777
11,49774,4,4,1, 49778
9,49777,2,2,1, 49779
16,49779,2,2,0, 49781
17,49779,3,3,1, 49782
15,49781,2,2,0, 49783
18,49783,4,4,1, 49787
22,49786,4,4,1, 49790
24,49789,1,1,1, 49790
23,49788,3,3,1, 49791
25,49795,2,2,1, 49797
31,49796,2,2,1, 49798
29,49798,4,4,1, 49802
2,49803,2,2,1, 49805
1,49806,1,1,0, 49807
3,49807,3,3,1, 49810
5,49807,3,5,1, 49812
6,49810,2,4,1, 49814
8,49816,1,1,0, 49817
16,49819,2,2,0, 49821
15,49821,2,2,1, 49823
12,49820,5,5,1, 49825
20,49823,6,6,1, 49829
22,49826,4,4,0, 49830
24,49829,1,1,1, 49830
23,49828,3,3,0, 49831
30,49833,3,3,1, 49836
25,49835,2,2,1, 49837
31,49836,2,2,1, 49838
28,49834,5,5,1, 49839
1,49846,1,1,1, 49847
5,49847,3,5,1, 49852
8,49856,1,1,0, 49857
11,49854,4,4,1, 49858
16,49859,2,2,1, 49861
15,49861,2,2,0, 49863
12,49860,5,5,1, 49865
22,49866,4,4,0, 49870
24,49869,1,1,1, 49870
23,49868,3,3,1, 49871
30,49873,3,3,1, 49876
25,49875,2,2,1, 49877
31,49876,2,2,0, 49878
28,49874,5,5,1, 49879
26,49877,3,3,1, 49880
29,49878,4,4,1, 49882
2,49883,2,2,1, 49885
1,49886,1,1,1, 49887
8,49896,1,1,0, 49897
16,49899,2,2,1, 49901
17,49899,3,3,1, 49902
15,49901,2,2,1, 49903
12,49900,5,5,1, 49905
18,49903,4,4,1, 49907
22,49906,4,4,1, 49910
24,49909,1,1,0, 49910
19,49906,5,5,1, 49911
23,49908,3,3,0, 49911
31,49916,2,2,0, 49918
28,49914,5,5,1, 49919
1,49926,1,1,0, 49927
3,49927,3,3,1, 49930
5,49927,3,5,1, 49932
6,49930,2,4,1, 49934
8,49936,1,1,1, 49937
16,49939,2,2,0, 49941
15,49941,2,2,0, 49943
18,49943,4,4,1, 49947
22,49946,4,4,0, 49950
24,49949,1,1,1, 49950
23,49948,3,3,0, 49951
25,49955,2,2,1, 49957
31,49956,2,2,1, 49958
29,49958,4,4,1, 49962
2,49963,2,2,1, 49965
1,49966,1,1,1, 49967
3,49967,3,3,1, 49970
6,49970,2,4,1, 49974
8,49976,1,1,1, 49977
9,49977,2,2,1, 49979
16,49979,2,2,1, 49981
17,49979,3,3,1, 49982
15,49981,2,2,0, 49983
22,49986,4,4,1, 49990
24,49989,1,1,1, 49990
23,49988,3,3,1, 49991
30,49993,3,3,1, 49996
31,49996,2,2,0, 49998
5,50007,3,5,1, 50012
6,50010,2,4,1, 50014
8,50016,1,1,1, 50017
16,50019,2,2,1, 50021
15,50021,2,2,0, 50023
22,50026,4,4,0, 50030
24,50029,1,1,0, 50030
23,50028,3,3,1, 50031
31,50036,2,2,0, 50038
28,50034,5,5,1, 50039
5,50047,3,5,1, 50052
6,50050,2,4,1, 50054
8,50056,1,1,0, 50057
16,50059,2,2,0, 50061
15,50061,2,2,0, 50063
22,50066,4,4,0, 50070
24,50069,1,1,1, 50070
23,50068,3,3,0, 50071
31,50076,2,2,1, 50078
28,50074,5,5,1, 50079
29,50078,4,4,1, 50082
1,50086,1,1,1, 50087
3,50087,3,3,1, 50090
8,50096,1,1,0, 50097
16,50099,2,2,0, 50101
15,50101,2,2,1, 50103
13,50099,4,6,1, 50105
18,50103,4,4,1, 50107
20,50103,6,6,1, 50109
22,50106,4,4,1, 50110
24,50109,1,1,0, 50110
23,50108,3,3,0, 50111
30,50113,3,3,1, 50116
25,50115,2,2,1, 50117
31,50116,2,2,0, 50118
28,50114,5,5,1, 50119
1,50126,1,1,0, 50127
3,50127,3,3,1, 50130
5,50127,3,5,1, 50132
6,50130,2,4,1, 50134
8,50136,1,1,1, 50137
9,50137,2,2,1, 50139
16,50139,2,2,0, 50141
17,50139,3,3,1, 50142
15,50141,2,2,1, 50143
13,50139,4,6,1, 50145
22,50146,4,4,1, 50150
24,50149,1,1,1, 50150
19,50146,5,5,1, 50151
23,50148,3,3,1, 50151
30,50153,3,3,1, 50156
25,50155,2,2,1, 50157
31,50156,2,2,0, 50158
26,50157,3,3,1, 50160
2,50163,2,2,1, 50165
1,50166,1,1,0, 50167
3,50167,3,3,1, 50170
6,50170,2,4,1, 50174
8,50176,1,1,0, 50177
11,50174,4,4,1, 50178
9,50177,2,2,1, 50179
16,50179,2,2,1, 50181
17,50179,3,3,1, 50182
15,50181,2,2,0, 50183
18,50183,4,4,1, 50187
20,50183,6,6,1, 50189
22,50186,4,4,0, 50190
24,50189,1,1,1, 50190
19,50186,5,5,1, 50191
23,50188,3,3,1, 50191
25,50195,2,2,1, 50197
31,50196,2,2,0, 50198
26,50197,3,3,1, 50200
1,50206,1,1,0, 50207
8,50216,1,1,1, 50217
9,50217,2,2,1, 50219
17,50219,3,3,1, 50222
15,50221,2,2,1, 50223
13,50219,4,6,1, 50225
24,50229,1,1,1, 50230
23,50228,3,3,1, 50231
30,50233,3,3,1, 50236
31,50236,2,2,0, 50238
28,50234,5,5,1, 50239
29,50238,4,4,1, 50242
5,50247,3,5,1, 50252
8,50256,1,1,1, 50257
16,50259,2,2,1, 50261
24,50269,1,1,1, 50270
23,50268,3,3,1, 50271
31,50276,2,2,0, 50278
29,50278,4,4,1, 50282
5,50287,3,5,1, 50292
6,50290,2,4,1, 50294
8,50296,1,1,0, 50297
15,50301,2,2,1, 50303
24,50309,1,1,1, 50310
23,50308,3,3,1, 50311
31,50316,2,2,1, 50318
28,50314,5,5,1, 50319
6,50330,2,4,1, 50334
8,50336,1,1,0, 50337
15,50341,2,2,1, 50343
12,50340,5,5,1, 50345
18,50343,4,4,1, 50347
20,50343,6,6,1, 50349
22,50346,4,4,1, 50350
24,50349,1,1,1, 50350
30,50353,3,3,1, 50356
25,50355,2,2,1, 50357
31,50356,2,2,0, 50358
26,50357,3,3,1, 50360
29,50358,4,4,1, 50362
2,50363,2,2,1, 50365
1,50366,1,1,0, 50367
3,50367,3,3,1, 50370
5,50367,3,5,1, 50372
6,50370,2,4,1, 50374
8,50376,1,1,1, 50377
11,50374,4,4,1, 50378
9,50377,2,2,1, 50379
16,50379,2,2,1, 50381
17,50379,3,3,1, 50382
15,50381,2,2,1, 50383
12,50380,5,5,1, 50385
24,50389,1,1,0, 50390
30,50393,3,3,1, 50396
25,50395,2,2,1, 50397
31,50396,2,2,1, 50398
28,50394,5,5,1, 50399
29,50398,4,4,1, 50402
1,50406,1,1,1, 50407
6,50410,2,4,1, 50414
8,50416,1,1,0, 50417
15,50421,2,2,1, 50423
13,50419,4,6,1, 50425
12,50420,5,5,1, 50425
20,50423,6,6,1, 50429
24,50429,1,1,1, 50430
19,50426,5,5,1, 50431
31,50436,2,2,0, 50438
28,50434,5,5,1, 50439
26,50437,3,3,1, 50440
2,50443,2,2,1, 50445
1,50446,1,1,1, 50447
3,50447,3,3,1, 50450
6,50450,2,4,1, 50454
8,50456,1,1,0, 50457
12,50460,5,5,1, 50465
20,50463,6,6,1, 50469
24,50469,1,1,0, 50470
23,50468,3,3,1, 50471
30,50473,3,3,1, 50476
25,50475,2,2,1, 50477
31,50476,2,2,0, 50478
2,50483,2,2,1, 50485
1,50486,1,1,0, 50487
6,50490,2,4,1, 50494
8,50496,1,1,0, 50497
11,50494,4,4,1, 50498
16,50499,2,2,1, 50501
15,50501,2,2,1, 50503
13,50499,4,6,1, 50505
12,50500,5,5,1, 50505
24,50509,1,1,1, 50510
19,50506,5,5,1, 50511
23,50508,3,3,1, 50511
31,50516,2,2,0, 50518
29,50518,4,4,1, 50522
2,50523,2,2,1, 50525
1,50526,1,1,1, 50527
5,50527,3,5,1, 50532
8,50536,1,1,1, 50537
9,50537,2,2,1, 50539
17,50539,3,3,1, 50542
15,50541,2,2,1, 50543
12,50540,5,5,1, 50545
24,50549,1,1,0, 50550
19,50546,5,5,1, 50551
23,50548,3,3,1, 50551
30,50553,3,3,1, 50556
31,50556,2,2,0, 50558
28,50554,5,5,1, 50559
26,50557,3,3,1, 50560
2,50563,2,2,1, 50565
1,50566,1,1,0, 50567
5,50567,3,5,1, 50572
6,50570,2,4,1, 50574
8,50576,1,1,0, 50577
11,50574,4,4,1, 50578
9,50577,2,2,1, 50579
16,50579,2,2,1, 50581
15,50581,2,2,1, 50583
22,50586,4,4,1, 50590
24,50589,1,1,0, 50590
23,50588,3,3,1, 50591
30,50593,3,3,1, 50596
31,50596,2,2,1, 50598
29,50598,4,4,1, 50602
5,50607,3,5,1, 50612
8,50616,1,1,0, 50617
16,50619,2,2,1, 50621
24,50629,1,1,0, 50630
23,50628,3,3,1, 50631
31,50636,2,2,0, 50638
29,50638,4,4,1, 50642
5,50647,3,5,1, 50652
8,50656,1,1,0, 50657
22,50666,4,4,1, 50670
24,50669,1,1,1, 50670
23,50668,3,3,1, 50671
31,50676,2,2,0, 50678
28,50674,5,5,1, 50679
1,50686,1,1,0, 50687
3,50687,3,3,1, 50690
8,50696,1,1,1, 50697
9,50697,2,2,1, 50699
16,50699,2,2,1, 50701
15,50701,2,2,1, 50703
12,50700,5,5,1, 50705
18,50703,4,4,1, 50707
20,50703,6,6,1, 50709
22,50706,4,4,1, 50710
24,50709,1,1,0, 50710
23,50708,3,3,1, 50711
30,50713,3,3,1, 50716
31,50716,2,2,0, 50718
26,50717,3,3,1, 50720
29,50718,4,4,1, 50722
1,50726,1,1,1, 50727
3,50727,3,3,1, 50730
6,50730,2,4,1, 50734
8,50736,1,1,0, 50737
11,50734,4,4,1, 50738
9,50737,2,2,1, 50739
16,50739,2,2,1, 50741
15,50741,2,2,1, 50743
13,50739,4,6,1, 50745
20,50743,6,6,1, 50749
22,50746,4,4,1, 50750
24,50749,1,1,0, 50750
19,50746,5,5,1, 50751
23,50748,3,3,1, 50751
25,50755,2,2,1, 50757
31,50756,2,2,1, 50758
28,50754,5,5,1, 50759
26,50757,3,3,1, 50760
29,50758,4,4,1, 50762
1,50766,1,1,1, 50767
3,50767,3,3,1, 50770
6,50770,2,4,1, 50774
8,50776,1,1,0, 50777
11,50774,4,4,1, 50778
17,50779,3,3,1, 50782
15,50781,2,2,1, 50783
13,50779,4,6,1, 50785
12,50780,5,5,1, 50785
18,50783,4,4,1, 50787
20,50783,6,6,1, 50789
22,50786,4,4,1, 50790
24,50789,1,1,1, 50790
19,50786,5,5,1, 50791
23,50788,3,3,1, 50791
30,50793,3,3,1, 50796
25,50795,2,2,1, 50797
31,50796,2,2,0, 50798
29,50798,4,4,1, 50802
5,50807,3,5,1, 50812
8,50816,1,1,1, 50817
16,50819,2,2,1, 50821
24,50829,1,1,1, 50830
23,50828,3,3,1, 50831
31,50836,2,2,0, 50838
5,50847,3,5,1, 50852
8,50856,1,1,1, 50857
15,50861,2,2,1, 50863
24,50869,1,1,0, 50870
30,50873,3,3,1, 50876
31,50876,2,2,0, 50878
6,50890,2,4,1, 50894
8,50896,1,1,1, 50897
16,50899,2,2,1, 50901
15,50901,2,2,1, 50903
18,50903,4,4,1, 50907
24,50909,1,1,1, 50910
30,50913,3,3,1, 50916
31,50916,2,2,1, 50918
26,50917,3,3,1, 50920
29,50918,4,4,1, 50922
2,50923,2,2,1, 50925
1,50926,1,1,1, 50927
3,50927,3,3,1, 50930
5,50927,3,5,1, 50932
6,50930,2,4,1, 50934
8,50936,1,1,0, 50937
11,50934,4,4,1, 50938
9,50937,2,2,1, 50939
16,50939,2,2,1, 50941
20,50943,6,6,1, 50949
24,50949,1,1,1, 50950
23,50948,3,3,1, 50951
31,50956,2,2,1, 50958
26,50957,3,3,1, 50960
29,50958,4,4,1, 50962
2,50963,2,2,1, 50965
1,50966,1,1,1, 50967
5,50967,3,5,1, 50972
6,50970,2,4,1, 50974
8,50976,1,1,1, 50977
11,50974,4,4,1, 50978
16,50979,2,2,1, 50981
17,50979,3,3,1, 50982
12,50980,5,5,1, 50985
20,50983,6,6,1, 50989
22,50986,4,4,1, 50990
24,50989,1,1,0, 50990
23,50988,3,3,1, 50991
25,50995,2,2,1, 50997
31,50996,2,2,0, 50998
28,50994,5,5,1, 50999
29,50998,4,4,1, 51002
1,51006,1,1,1, 51007
3,51007,3,3,1, 51010
5,51007,3,5,1, 51012
6,51010,2,4,1, 51014
8,51016,1,1,1, 51017
16,51019,2,2,1, 51021
12,51020,5,5,1, 51025
20,51023,6,6,1, 51029
22,51026,4,4,1, 51030
24,51029,1,1,0, 51030
19,51026,5,5,1, 51031
23,51028,3,3,1, 51031
30,51033,3,3,1, 51036
31,51036,2,2,1, 51038
28,51034,5,5,1, 51039
29,51038,4,4,1, 51042
2,51043,2,2,1, 51045
1,51046,1,1,1, 51047
5,51047,3,5,1, 51052
6,51050,2,4,1, 51054
8,51056,1,1,0, 51057
9,51057,2,2,1, 51059
16,51059,2,2,1, 51061
15,51061,2,2,1, 51063
24,51069,1,1,0, 51070
19,51066,5,5,1, 51071
23,51068,3,3,1, 51071
31,51076,2,2,1, 51078
29,51078,4,4,1, 51082
1,51086,1,1,1, 51087
6,51090,2,4,1, 51094
8,51096,1,1,0, 51097
11,51094,4,4,1, 51098
9,51097,2,2,1, 51099
15,51101,2,2,1, 51103
13,51099,4,6,1, 51105
18,51103,4,4,1, 51107
24,51109,1,1,1, 51110
23,51108,3,3,1, 51111
30,51113,3,3,1, 51116
25,51115,2,2,1, 51117
31,51116,2,2,1, 51118
26,51117,3,3,1, 51120
29,51118,4,4,1, 51122
2,51123,2,2,1, 51125
1,51126,1,1,1, 51127
3,51127,3,3,1, 51130
6,51130,2,4,1, 51134
8,51136,1,1,0, 51137
15,51141,2,2,1, 51143
13,51139,4,6,1, 51145
12,51140,5,5,1, 51145
18,51143,4,4,1, 51147
22,51146,4,4,1, 51150
24,51149,1,1,1, 51150
23,51148,3,3,1, 51151
30,51153,3,3,1, 51156
25,51155,2,2,1, 51157
31,51156,2,2,0, 51158
29,51158,4,4,1, 51162
1,51166,1,1,0, 51167
3,51167,3,3,1, 51170
8,51176,1,1,1, 51177
11,51174,4,4,1, 51178
16,51179,2,2,1, 51181
17,51179,3,3,1, 51182
15,51181,2,2,1, 51183
13,51179,4,6,1, 51185
12,51180,5,5,1, 51185
22,51186,4,4,1, 51190
24,51189,1,1,0, 51190
19,51186,5,5,1, 51191
23,51188,3,3,0, 51191
25,51195,2,2,1, 51197
31,51196,2,2,0, 51198
5,51207,3,5,1, 51212
8,51216,1,1,1, 51217
16,51219,2,2,0, 51221
15,51221,2,2,1, 51223
22,51226,4,4,1, 51230
24,51229,1,1,0, 51230
23,51228,3,3,0, 51231
30,51233,3,3,1, 51236
31,51236,2,2,1, 51238
28,51234,5,5,1, 51239
29,51238,4,4,1, 51242
5,51247,3,5,1, 51252
8,51256,1,1,0, 51257
16,51259,2,2,1, 51261
15,51261,2,2,0, 51263
22,51266,4,4,0, 51270
24,51269,1,1,0, 51270
23,51268,3,3,1, 51271
30,51273,3,3,1, 51276
31,51276,2,2,1, 51278
28,51274,5,5,1, 51279
5,51287,3,5,1, 51292
8,51296,1,1,0, 51297
16,51299,2,2,0, 51301
17,51299,3,3,1, 51302
15,51301,2,2,0, 51303
22,51306,4,4,0, 51310
24,51309,1,1,0, 51310
23,51308,3,3,0, 51311
25,51315,2,2,1, 51317
31,51316,2,2,1, 51318
29,51318,4,4,1, 51322
1,51326,1,1,0, 51327
6,51330,2,4,1, 51334
8,51336,1,1,0, 51337
16,51339,2,2,1, 51341
15,51341,2,2,0, 51343
22,51346,4,4,0, 51350
24,51349,1,1,1, 51350
23,51348,3,3,1, 51351
30,51353,3,3,1, 51356
25,51355,2,2,1, 51357
31,51356,2,2,1, 51358
1,51366,1,1,1, 51367
6,51370,2,4,1, 51374
8,51376,1,1,1, 51377
9,51377,2,2,1, 51379
16,51379,2,2,1, 51381
17,51379,3,3,1, 51382
15,51381,2,2,0, 51383
13,51379,4,6,1, 51385
12,51380,5,5,1, 51385
22,51386,4,4,1, 51390
24,51389,1,1,1, 51390
19,51386,5,5,1, 51391
23,51388,3,3,1, 51391
30,51393,3,3,1, 51396
25,51395,2,2,1, 51397
31,51396,2,2,0, 51398
28,51394,5,5,1, 51399
26,51397,3,3,1, 51400
2,51403,2,2,1, 51405
1,51406,1,1,1, 51407
8,51416,1,1,0, 51417
16,51419,2,2,1, 51421
15,51421,2,2,1, 51423
20,51423,6,6,1, 51429
22,51426,4,4,0, 51430
24,51429,1,1,1, 51430
23,51428,3,3,0, 51431
30,51433,3,3,1, 51436
25,51435,2,2,1, 51437
31,51436,2,2,1, 51438
1,51446,1,1,0, 51447
6,51450,2,4,1, 51454
8,51456,1,1,1, 51457
16,51459,2,2,0, 51461
17,51459,3,3,1, 51462
15,51461,2,2,1, 51463
20,51463,6,6,1, 51469
22,51466,4,4,0, 51470
24,51469,1,1,0, 51470
19,51466,5,5,1, 51471
23,51468,3,3,1, 51471
30,51473,3,3,1, 51476
31,51476,2,2,1, 51478
28,51474,5,5,1, 51479
26,51477,3,3,1, 51480
29,51478,4,4,1, 51482
2,51483,2,2,1, 51485
1,51486,1,1,1, 51487
5,51487,3,5,1, 51492
8,51496,1,1,0, 51497
16,51499,2,2,0, 51501
15,51501,2,2,1, 51503
20,51503,6,6,1, 51509
22,51506,4,4,0, 51510
24,51509,1,1,0, 51510
23,51508,3,3,0, 51511
30,51513,3,3,1, 51516
25,51515,2,2,1, 51517
31,51516,2,2,1, 51518
29,51518,4,4,1, 51522
1,51526,1,1,0, 51527
3,51527,3,3,1, 51530
5,51527,3,5,1, 51532
8,51536,1,1,1, 51537
16,51539,2,2,1, 51541
15,51541,2,2,1, 51543
18,51543,4,4,1, 51547
22,51546,4,4,0, 51550
24,51549,1,1,1, 51550
23,51548,3,3,0, 51551
31,51556,2,2,1, 51558
1,51566,1,1,1, 51567
3,51567,3,3,1, 51570
8,51576,1,1,1, 51577
9,51577,2,2,1, 51579
16,51579,2,2,0, 51581
17,51579,3,3,1, 51582
15,51581,2,2,1, 51583
13,51579,4,6,1, 51585
22,51586,4,4,1, 51590
24,51589,1,1,0, 51590
19,51586,5,5,1, 51591
23,51588,3,3,0, 51591
31,51596,2,2,0, 51598
29,51598,4,4,1, 51602
1,51606,1,1,0, 51607
5,51607,3,5,1, 51612
8,51616,1,1,1, 51617
16,51619,2,2,1, 51621
17,51619,3,3,1, 51622
15,51621,2,2,1, 51623
12,51620,5,5,1, 51625
20,51623,6,6,1, 51629
22,51626,4,4,0, 51630
24,51629,1,1,0, 51630
23,51628,3,3,1, 51631
30,51633,3,3,1, 51636
25,51635,2,2,1, 51637
31,51636,2,2,0, 51638
1,51646,1,1,0, 51647
5,51647,3,5,1, 51652
6,51650,2,4,1, 51654
8,51656,1,1,0, 51657
11,51654,4,4,1, 51658
16,51659,2,2,0, 51661
15,51661,2,2,1, 51663
13,51659,4,6,1, 51665
12,51660,5,5,1, 51665
18,51663,4,4,1, 51667
20,51663,6,6,1, 51669
22,51666,4,4,1, 51670
24,51669,1,1,0, 51670
23,51668,3,3,0, 51671
30,51673,3,3,1, 51676
25,51675,2,2,1, 51677
31,51676,2,2,1, 51678
28,51674,5,5,1, 51679
26,51677,3,3,1, 51680
29,51678,4,4,1, 51682
2,51683,2,2,1, 51685
1,51686,1,1,1, 51687
3,51687,3,3,1, 51690
5,51687,3,5,1, 51692
6,51690,2,4,1, 51694
8,51696,1,1,1, 51697
11,51694,4,4,1, 51698
16,51699,2,2,0, 51701
17,51699,3,3,1, 51702
15,51701,2,2,0, 51703
13,51699,4,6,1, 51705
12,51700,5,5,1, 51705
18,51703,4,4,1, 51707
20,51703,6,6,1, 51709
22,51706,4,4,0, 51710
24,51709,1,1,0, 51710
19,51706,5,5,1, 51711
23,51708,3,3,0, 51711
30,51713,3,3,1, 51716
31,51716,2,2,1, 51718
28,51714,5,5,0, 51719
26,51717,3,3,1, 51720
29,51718,4,4,0, 51722
1,51726,1,1,0, 51727
5,51727,3,5,0, 51732
6,51730,2,4,0, 51734
8,51736,1,1,0, 51737
16,51739,2,2,0, 51741
15,51741,2,2,0, 51743
13,51739,4,6,1, 51745
12,51740,5,5,1, 51745
20,51743,6,6,1, 51749
22,51746,4,4,0, 51750
24,51749,1,1,0, 51750
19,51746,5,5,1, 51751
23,51748,3,3,1, 51751
25,51755,2,2,1, 51757
26,51757,3,3,1, 51760
2,51763,2,2,1, 51765
5,51767,3,5,1, 51772
8,51776,1,1,0, 51777
16,51779,2,2,0, 51781
15,51781,2,2,1, 51783
22,51786,4,4,1, 51790
24,51789,1,1,1, 51790
23,51788,3,3,1, 51791
5,51807,3,5,1, 51812
6,51810,2,4,1, 51814
8,51816,1,1,1, 51817
16,51819,2,2,1, 51821
15,51821,2,2,0, 51823
22,51826,4,4,0, 51830
24,51829,1,1,1, 51830
23,51828,3,3,1, 51831
30,51833,3,3,1, 51836
5,51847,3,5,1, 51852
6,51850,2,4,1, 51854
8,51856,1,1,0, 51857
16,51859,2,2,1, 51861
15,51861,2,2,0, 51863
22,51866,4,4,1, 51870
24,51869,1,1,0, 51870
23,51868,3,3,0, 51871
25,51875,2,2,1, 51877
31,51876,2,2,1, 51878
29,51878,4,4,1, 51882
1,51886,1,1,0, 51887
3,51887,3,3,1, 51890
5,51887,3,5,1, 51892
8,51896,1,1,0, 51897
16,51899,2,2,1, 51901
15,51901,2,2,1, 51903
13,51899,4,6,1, 51905
18,51903,4,4,1, 51907
20,51903,6,6,1, 51909
22,51906,4,4,0, 51910
24,51909,1,1,0, 51910
23,51908,3,3,1, 51911
25,51915,2,2,1, 51917
28,51914,5,5,1, 51919
2,51923,2,2,1, 51925
1,51926,1,1,1, 51927
5,51927,3,5,1, 51932
6,51930,2,4,1, 51934
8,51936,1,1,1, 51937
9,51937,2,2,1, 51939
16,51939,2,2,0, 51941
15,51941,2,2,0, 51943
13,51939,4,6,1, 51945
18,51943,4,4,1, 51947
22,51946,4,4,0, 51950
24,51949,1,1,1, 51950
23,51948,3,3,0, 51951
30,51953,3,3,1, 51956
25,51955,2,2,1, 51957
28,51954,5,5,1, 51959
1,51966,1,1,0, 51967
3,51967,3,3,1, 51970
5,51967,3,5,1, 51972
8,51976,1,1,1, 51977
9,51977,2,2,1, 51979
16,51979,2,2,0, 51981
15,51981,2,2,0, 51983
18,51983,4,4,1, 51987
22,51986,4,4,0, 51990
24,51989,1,1,0, 51990
19,51986,5,5,1, 51991
23,51988,3,3,0, 51991
25,51995,2,2,1, 51997
31,51996,2,2,1, 51998
26,51997,3,3,1, 52000
29,51998,4,4,1, 52002
2,52003,2,2,1, 52005
1,52006,1,1,1, 52007
3,52007,3,3,1, 52010
6,52010,2,4,1, 52014
8,52016,1,1,0, 52017
9,52017,2,2,1, 52019
16,52019,2,2,1, 52021
17,52019,3,3,1, 52022
15,52021,2,2,0, 52023
13,52019,4,6,1, 52025
18,52023,4,4,1, 52027
22,52026,4,4,1, 52030
24,52029,1,1,0, 52030
23,52028,3,3,1, 52031
30,52033,3,3,1, 52036
28,52034,5,5,1, 52039
26,52037,3,3,1, 52040
1,52046,1,1,0, 52047
3,52047,3,3,1, 52050
5,52047,3,5,1, 52052
8,52056,1,1,0, 52057
11,52054,4,4,1, 52058
9,52057,2,2,1, 52059
16,52059,2,2,1, 52061
15,52061,2,2,1, 52063
18,52063,4,4,1, 52067
20,52063,6,6,1, 52069
22,52066,4,4,1, 52070
24,52069,1,1,1, 52070
19,52066,5,5,1, 52071
23,52068,3,3,0, 52071
30,52073,3,3,1, 52076
31,52076,2,2,1, 52078
28,52074,5,5,1, 52079
26,52077,3,3,1, 52080
1,52086,1,1,0, 52087
3,52087,3,3,1, 52090
5,52087,3,5,1, 52092
8,52096,1,1,0, 52097
16,52099,2,2,0, 52101
15,52101,2,2,0, 52103
22,52106,4,4,1, 52110
24,52109,1,1,1, 52110
23,52108,3,3,0, 52111
30,52113,3,3,1, 52116
25,52115,2,2,1, 52117
31,52116,2,2,1, 52118
29,52118,4,4,1, 52122
2,52123,2,2,1, 52125
1,52126,1,1,0, 52127
3,52127,3,3,1, 52130
8,52136,1,1,1, 52137
11,52134,4,4,1, 52138
16,52139,2,2,1, 52141
15,52141,2,2,0, 52143
12,52140,5,5,1, 52145
20,52143,6,6,1, 52149
22,52146,4,4,0, 52150
24,52149,1,1,1, 52150
23,52148,3,3,0, 52151
31,52156,2,2,1, 52158
29,52158,4,4,1, 52162
8,52176,1,1,0, 52177
16,52179,2,2,1, 52181
15,52181,2,2,1, 52183
22,52186,4,4,1, 52190
24,52189,1,1,0, 52190
23,52188,3,3,1, 52191
31,52196,2,2,1, 52198
28,52194,5,5,1, 52199
6,52210,2,4,1, 52214
8,52216,1,1,0, 52217
16,52219,2,2,1, 52221
15,52221,2,2,1, 52223
22,52226,4,4,1, 52230
24,52229,1,1,0, 52230
23,52228,3,3,1, 52231
29,52238,4,4,1, 52242
5,52247,3,5,1, 52252
8,52256,1,1,0, 52257
11,52254,4,4,1, 52258
16,52259,2,2,1, 52261
17,52259,3,3,1, 52262
15,52261,2,2,0, 52263
13,52259,4,6,1, 52265
22,52266,4,4,1, 52270
24,52269,1,1,0, 52270
23,52268,3,3,1, 52271
30,52273,3,3,1, 52276
31,52276,2,2,1, 52278
29,52278,4,4,1, 52282
1,52286,1,1,0, 52287
3,52287,3,3,1, 52290
8,52296,1,1,0, 52297
16,52299,2,2,0, 52301
17,52299,3,3,1, 52302
15,52301,2,2,0, 52303
13,52299,4,6,1, 52305
20,52303,6,6,1, 52309
22,52306,4,4,0, 52310
24,52309,1,1,0, 52310
23,52308,3,3,0, 52311
29,52318,4,4,1, 52322
2,52323,2,2,1, 52325
1,52326,1,1,0, 52327
3,52327,3,3,1, 52330
5,52327,3,5,1, 52332
8,52336,1,1,0, 52337
16,52339,2,2,1, 52341
17,52339,3,3,1, 52342
15,52341,2,2,1, 52343
13,52339,4,6,1, 52345
18,52343,4,4,1, 52347
22,52346,4,4,1, 52350
24,52349,1,1,1, 52350
23,52348,3,3,1, 52351
30,52353,3,3,1, 52356
31,52356,2,2,1, 52358
26,52357,3,3,1, 52360
2,52363,2,2,1, 52365
1,52366,1,1,1, 52367
3,52367,3,3,1, 52370
6,52370,2,4,1, 52374
8,52376,1,1,0, 52377
9,52377,2,2,1, 52379
16,52379,2,2,0, 52381
17,52379,3,3,1, 52382
15,52381,2,2,0, 52383
13,52379,4,6,1, 52385
18,52383,4,4,1, 52387
20,52383,6,6,1, 52389
22,52386,4,4,0, 52390
24,52389,1,1,1, 52390
23,52388,3,3,0, 52391
30,52393,3,3,1, 52396
25,52395,2,2,1, 52397
31,52396,2,2,1, 52398
1,52406,1,1,1, 52407
5,52407,3,5,1, 52412
8,52416,1,1,1, 52417
11,52414,4,4,1, 52418
9,52417,2,2,1, 52419
16,52419,2,2,1, 52421
15,52421,2,2,1, 52423
18,52423,4,4,1, 52427
20,52423,6,6,1, 52429
22,52426,4,4,0, 52430
24,52429,1,1,0, 52430
23,52428,3,3,1, 52431
26,52437,3,3,1, 52440
2,52443,2,2,1, 52445
1,52446,1,1,0, 52447
6,52450,2,4,1, 52454
8,52456,1,1,0, 52457
16,52459,2,2,1, 52461
17,52459,3,3,1, 52462
15,52461,2,2,0, 52463
13,52459,4,6,1, 52465
22,52466,4,4,0, 52470
24,52469,1,1,0, 52470
23,52468,3,3,0, 52471
30,52473,3,3,1, 52476
28,52474,5,5,1, 52479
1,52486,1,1,1, 52487
8,52496,1,1,0, 52497
11,52494,4,4,1, 52498
16,52499,2,2,0, 52501
15,52501,2,2,0, 52503
13,52499,4,6,1, 52505
18,52503,4,4,1, 52507
20,52503,6,6,1, 52509
22,52506,4,4,0, 52510
24,52509,1,1,1, 52510
19,52506,5,5,1, 52511
23,52508,3,3,0, 52511
30,52513,3,3,1, 52516
26,52517,3,3,1, 52520
29,52518,4,4,1, 52522
1,52526,1,1,0, 52527
8,52536,1,1,0, 52537
16,52539,2,2,0, 52541
15,52541,2,2,1, 52543
12,52540,5,5,1, 52545
18,52543,4,4,1, 52547
20,52543,6,6,1, 52549
22,52546,4,4,0, 52550
24,52549,1,1,1, 52550
23,52548,3,3,0, 52551
30,52553,3,3,1, 52556
28,52554,5,5,1, 52559
1,52566,1,1,0, 52567
5,52567,3,5,1, 52572
6,52570,2,4,1, 52574
8,52576,1,1,0, 52577
11,52574,4,4,1, 52578
16,52579,2,2,1, 52581
15,52581,2,2,0, 52583
12,52580,5,5,1, 52585
22,52586,4,4,1, 52590
24,52589,1,1,0, 52590
19,52586,5,5,1, 52591
23,52588,3,3,1, 52591
30,52593,3,3,1, 52596
31,52596,2,2,1, 52598
1,52606,1,1,0, 52607
3,52607,3,3,1, 52610
5,52607,3,5,1, 52612
6,52610,2,4,1, 52614
8,52616,1,1,1, 52617
11,52614,4,4,1, 52618
9,52617,2,2,1, 52619
16,52619,2,2,0, 52621
17,52619,3,3,1, 52622
15,52621,2,2,1, 52623
20,52623,6,6,1, 52629
22,52626,4,4,1, 52630
24,52629,1,1,1, 52630
23,52628,3,3,1, 52631
30,52633,3,3,1, 52636
28,52634,5,5,1, 52639
8,52656,1,1,0, 52657
16,52659,2,2,0, 52661
15,52661,2,2,0, 52663
22,52666,4,4,0, 52670
24,52669,1,1,0, 52670
23,52668,3,3,0, 52671
31,52676,2,2,1, 52678
6,52690,2,4,1, 52694
8,52696,1,1,0, 52697
16,52699,2,2,0, 52701
15,52701,2,2,1, 52703
22,52706,4,4,0, 52710
24,52709,1,1,1, 52710
23,52708,3,3,0, 52711
30,52713,3,3,1, 52716
29,52718,4,4,1, 52722
5,52727,3,5,1, 52732
8,52736,1,1,0, 52737
9,52737,2,2,1, 52739
16,52739,2,2,0, 52741
15,52741,2,2,1, 52743
22,52746,4,4,1, 52750
24,52749,1,1,0, 52750
23,52748,3,3,1, 52751
25,52755,2,2,1, 52757
28,52754,5,5,1, 52759
1,52766,1,1,1, 52767
5,52767,3,5,1, 52772
8,52776,1,1,0, 52777
9,52777,2,2,1, 52779
16,52779,2,2,0, 52781
17,52779,3,3,1, 52782
15,52781,2,2,0, 52783
22,52786,4,4,1, 52790
24,52789,1,1,0, 52790
23,52788,3,3,1, 52791
30,52793,3,3,1, 52796
25,52795,2,2,1, 52797
31,52796,2,2,1, 52798
1,52806,1,1,0, 52807
5,52807,3,5,1, 52812
8,52816,1,1,1, 52817
16,52819,2,2,0, 52821
17,52819,3,3,1, 52822
15,52821,2,2,1, 52823
12,52820,5,5,1, 52825
18,52823,4,4,1, 52827
20,52823,6,6,1, 52829
22,52826,4,4,1, 52830
24,52829,1,1,1, 52830
19,52826,5,5,1, 52831
23,52828,3,3,1, 52831
28,52834,5,5,1, 52839
26,52837,3,3,1, 52840
1,52846,1,1,1, 52847
3,52847,3,3,1, 52850
8,52856,1,1,0, 52857
16,52859,2,2,1, 52861
15,52861,2,2,0, 52863
12,52860,5,5,1, 52865
18,52863,4,4,1, 52867
22,52866,4,4,1, 52870
24,52869,1,1,1, 52870
23,52868,3,3,1, 52871
28,52874,5,5,1, 52879
2,52883,2,2,1, 52885
1,52886,1,1,0, 52887
3,52887,3,3,1, 52890
5,52887,3,5,1, 52892
6,52890,2,4,1, 52894
8,52896,1,1,0, 52897
11,52894,4,4,1, 52898
16,52899,2,2,1, 52901
15,52901,2,2,0, 52903
13,52899,4,6,1, 52905
12,52900,5,5,1, 52905
18,52903,4,4,1, 52907
22,52906,4,4,1, 52910
24,52909,1,1,1, 52910
19,52906,5,5,1, 52911
23,52908,3,3,1, 52911
28,52914,5,5,1, 52919
2,52923,2,2,1, 52925
1,52926,1,1,0, 52927
5,52927,3,5,1, 52932
8,52936,1,1,1, 52937
11,52934,4,4,1, 52938
9,52937,2,2,1, 52939
16,52939,2,2,1, 52941
17,52939,3,3,1, 52942
15,52941,2,2,1, 52943
12,52940,5,5,1, 52945
18,52943,4,4,1, 52947
22,52946,4,4,1, 52950
24,52949,1,1,1, 52950
19,52946,5,5,1, 52951
23,52948,3,3,1, 52951
30,52953,3,3,0, 52956
31,52956,2,2,1, 52958
28,52954,5,5,0, 52959
26,52957,3,3,1, 52960
29,52958,4,4,0, 52962
2,52963,2,2,1, 52965
1,52966,1,1,1, 52967
5,52967,3,5,1, 52972
6,52970,2,4,1, 52974
8,52976,1,1,1, 52977
11,52974,4,4,1, 52978
16,52979,2,2,1, 52981
15,52981,2,2,1, 52983
13,52979,4,6,1, 52985
12,52980,5,5,1, 52985
18,52983,4,4,1, 52987
20,52983,6,6,1, 52989
22,52986,4,4,0, 52990
24,52989,1,1,0, 52990
19,52986,5,5,1, 52991
25,52995,2,2,1, 52997
31,52996,2,2,1, 52998
29,52998,4,4,1, 53002
5,53007,3,5,1, 53012
6,53010,2,4,1, 53014
8,53016,1,1,0, 53017
16,53019,2,2,1, 53021
15,53021,2,2,1, 53023
24,53029,1,1,0, 53030
23,53028,3,3,1, 53031
30,53033,3,3,1, 53036
31,53036,2,2,1, 53038
6,53050,2,4,1, 53054
8,53056,1,1,1, 53057
16,53059,2,2,1, 53061
15,53061,2,2,1, 53063
24,53069,1,1,1, 53070
31,53076,2,2,1, 53078
6,53090,2,4,1, 53094
8,53096,1,1,0, 53097
16,53099,2,2,1, 53101
17,53099,3,3,1, 53102
22,53106,4,4,1, 53110
24,53109,1,1,1, 53110
23,53108,3,3,1, 53111
30,53113,3,3,1, 53116
31,53116,2,2,0, 53118
29,53118,4,4,1, 53122
1,53126,1,1,1, 53127
5,53127,3,5,1, 53132
6,53130,2,4,1, 53134
8,53136,1,1,1, 53137
9,53137,2,2,1, 53139
16,53139,2,2,1, 53141
17,53139,3,3,1, 53142
15,53141,2,2,1, 53143
22,53146,4,4,1, 53150
24,53149,1,1,1, 53150
23,53148,3,3,1, 53151
30,53153,3,3,1, 53156
31,53156,2,2,1, 53158
28,53154,5,5,1, 53159
1,53166,1,1,1, 53167
6,53170,2,4,1, 53174
8,53176,1,1,0, 53177
15,53181,2,2,1, 53183
13,53179,4,6,1, 53185
18,53183,4,4,1, 53187
24,53189,1,1,1, 53190
19,53186,5,5,1, 53191
23,53188,3,3,1, 53191
31,53196,2,2,1, 53198
26,53197,3,3,1, 53200
29,53198,4,4,1, 53202
2,53203,2,2,1, 53205
1,53206,1,1,1, 53207
3,53207,3,3,1, 53210
6,53210,2,4,1, 53214
8,53216,1,1,1, 53217
15,53221,2,2,1, 53223
12,53220,5,5,1, 53225
22,53226,4,4,1, 53230
24,53229,1,1,0, 53230
23,53228,3,3,1, 53231
30,53233,3,3,1, 53236
31,53236,2,2,1, 53238
26,53237,3,3,1, 53240
29,53238,4,4,1, 53242
2,53243,2,2,1, 53245
1,53246,1,1,0, 53247
5,53247,3,5,1, 53252
8,53256,1,1,1, 53257
9,53257,2,2,1, 53259
17,53259,3,3,1, 53262
12,53260,5,5,1, 53265
18,53263,4,4,1, 53267
24,53269,1,1,1, 53270
30,53273,3,3,1, 53276
25,53275,2,2,1, 53277
31,53276,2,2,1, 53278
26,53277,3,3,1, 53280
29,53278,4,4,1, 53282
1,53286,1,1,1, 53287
8,53296,1,1,0, 53297
11,53294,4,4,1, 53298
9,53297,2,2,1, 53299
13,53299,4,6,1, 53305
18,53303,4,4,1, 53307
22,53306,4,4,1, 53310
24,53309,1,1,0, 53310
19,53306,5,5,1, 53311
25,53315,2,2,1, 53317
31,53316,2,2,0, 53318
1,53326,1,1,1, 53327
5,53327,3,5,1, 53332
6,53330,2,4,1, 53334
8,53336,1,1,1, 53337
11,53334,4,4,1, 53338
9,53337,2,2,1, 53339
16,53339,2,2,1, 53341
17,53339,3,3,1, 53342
13,53339,4,6,1, 53345
12,53340,5,5,1, 53345
20,53343,6,6,1, 53349
22,53346,4,4,1, 53350
24,53349,1,1,0, 53350
19,53346,5,5,1, 53351
23,53348,3,3,1, 53351
31,53356,2,2,0, 53358
28,53354,5,5,1, 53359
29,53358,4,4,1, 53362
2,53363,2,2,1, 53365
1,53366,1,1,1, 53367
6,53370,2,4,1, 53374
8,53376,1,1,1, 53377
17,53379,3,3,1, 53382
13,53379,4,6,1, 53385
12,53380,5,5,1, 53385
20,53383,6,6,1, 53389
24,53389,1,1,1, 53390
19,53386,5,5,1, 53391
30,53393,3,3,1, 53396
25,53395,2,2,1, 53397
31,53396,2,2,0, 53398
28,53394,5,5,1, 53399
26,53397,3,3,1, 53400
1,53406,1,1,0, 53407
6,53410,2,4,1, 53414
8,53416,1,1,0, 53417
11,53414,4,4,1, 53418
18,53423,4,4,1, 53427
22,53426,4,4,1, 53430
24,53429,1,1,0, 53430
31,53436,2,2,0, 53438
28,53434,5,5,1, 53439
29,53438,4,4,1, 53442
1,53446,1,1,1, 53447
3,53447,3,3,1, 53450
5,53447,3,5,1, 53452
8,53456,1,1,0, 53457
16,53459,2,2,1, 53461
15,53461,2,2,1, 53463
20,53463,6,6,1, 53469
24,53469,1,1,0, 53470
23,53468,3,3,1, 53471
25,53475,2,2,1, 53477
31,53476,2,2,0, 53478
29,53478,4,4,1, 53482
2,53483,2,2,1, 53485
1,53486,1,1,1, 53487
3,53487,3,3,1, 53490
8,53496,1,1,1, 53497
24,53509,1,1,1, 53510
23,53508,3,3,1, 53511
25,53515,2,2,1, 53517
31,53516,2,2,0, 53518
2,53523,2,2,1, 53525
1,53526,1,1,1, 53527
5,53527,3,5,1, 53532
6,53530,2,4,1, 53534
8,53536,1,1,0, 53537
16,53539,2,2,1, 53541
17,53539,3,3,1, 53542
15,53541,2,2,1, 53543
18,53543,4,4,1, 53547
24,53549,1,1,1, 53550
19,53546,5,5,1, 53551
30,53553,3,3,1, 53556
25,53555,2,2,1, 53557
31,53556,2,2,0, 53558
28,53554,5,5,1, 53559
26,53557,3,3,1, 53560
1,53566,1,1,1, 53567
8,53576,1,1,0, 53577
11,53574,4,4,1, 53578
16,53579,2,2,1, 53581
17,53579,3,3,1, 53582
15,53581,2,2,1, 53583
13,53579,4,6,1, 53585
24,53589,1,1,1, 53590
23,53588,3,3,1, 53591
30,53593,3,3,1, 53596
31,53596,2,2,0, 53598
29,53598,4,4,1, 53602
5,53607,3,5,1, 53612
6,53610,2,4,1, 53614
8,53616,1,1,0, 53617
22,53626,4,4,1, 53630
24,53629,1,1,1, 53630
31,53636,2,2,1, 53638
29,53638,4,4,1, 53642
6,53650,2,4,1, 53654
8,53656,1,1,1, 53657
16,53659,2,2,1, 53661
15,53661,2,2,1, 53663
24,53669,1,1,0, 53670
23,53668,3,3,1, 53671
31,53676,2,2,1, 53678
28,53674,5,5,1, 53679
29,53678,4,4,1, 53682
3,53687,3,3,1, 53690
6,53690,2,4,1, 53694
8,53696,1,1,0, 53697
9,53697,2,2,1, 53699
16,53699,2,2,0, 53701
17,53699,3,3,1, 53702
15,53701,2,2,0, 53703
12,53700,5,5,1, 53705
18,53703,4,4,1, 53707
20,53703,6,6,1, 53709
22,53706,4,4,1, 53710
24,53709,1,1,0, 53710
23,53708,3,3,1, 53711
30,53713,3,3,1, 53716
31,53716,2,2,1, 53718
1,53726,1,1,0, 53727
3,53727,3,3,1, 53730
6,53730,2,4,1, 53734
8,53736,1,1,1, 53737
11,53734,4,4,1, 53738
16,53739,2,2,0, 53741
15,53741,2,2,1, 53743
12,53740,5,5,1, 53745
18,53743,4,4,1, 53747
22,53746,4,4,0, 53750
24,53749,1,1,1, 53750
23,53748,3,3,0, 53751
25,53755,2,2,1, 53757
31,53756,2,2,1, 53758
28,53754,5,5,1, 53759
26,53757,3,3,1, 53760
1,53766,1,1,0, 53767
3,53767,3,3,1, 53770
8,53776,1,1,1, 53777
9,53777,2,2,1, 53779
16,53779,2,2,0, 53781
17,53779,3,3,1, 53782
15,53781,2,2,0, 53783
13,53779,4,6,1, 53785
12,53780,5,5,1, 53785
18,53783,4,4,1, 53787
22,53786,4,4,1, 53790
24,53789,1,1,1, 53790
19,53786,5,5,1, 53791
23,53788,3,3,0, 53791
31,53796,2,2,0, 53798
28,53794,5,5,1, 53799
29,53798,4,4,1, 53802
1,53806,1,1,0, 53807
3,53807,3,3,1, 53810
6,53810,2,4,1, 53814
8,53816,1,1,1, 53817
9,53817,2,2,1, 53819
16,53819,2,2,1, 53821
17,53819,3,3,1, 53822
15,53821,2,2,1, 53823
13,53819,4,6,1, 53825
12,53820,5,5,1, 53825
18,53823,4,4,1, 53827
22,53826,4,4,0, 53830
24,53829,1,1,1, 53830
23,53828,3,3,0, 53831
30,53833,3,3,1, 53836
31,53836,2,2,0, 53838
28,53834,5,5,1, 53839
26,53837,3,3,1, 53840
29,53838,4,4,1, 53842
2,53843,2,2,1, 53845
1,53846,1,1,1, 53847
6,53850,2,4,1, 53854
8,53856,1,1,1, 53857
11,53854,4,4,1, 53858
9,53857,2,2,1, 53859
16,53859,2,2,1, 53861
15,53861,2,2,1, 53863
12,53860,5,5,1, 53865
22,53866,4,4,1, 53870
24,53869,1,1,1, 53870
19,53866,5,5,1, 53871
23,53868,3,3,0, 53871
31,53876,2,2,1, 53878
28,53874,5,5,1, 53879
8,53896,1,1,0, 53897
16,53899,2,2,0, 53901
15,53901,2,2,0, 53903
22,53906,4,4,1, 53910
24,53909,1,1,1, 53910
23,53908,3,3,0, 53911
30,53913,3,3,1, 53916
31,53916,2,2,1, 53918
29,53918,4,4,1, 53922
5,53927,3,5,1, 53932
8,53936,1,1,0, 53937
16,53939,2,2,0, 53941
15,53941,2,2,1, 53943
22,53946,4,4,1, 53950
24,53949,1,1,0, 53950
23,53948,3,3,1, 53951
30,53953,3,3,1, 53956
31,53956,2,2,0, 53958
5,53967,3,5,1, 53972
8,53976,1,1,1, 53977
16,53979,2,2,0, 53981
15,53981,2,2,1, 53983
12,53980,5,5,1, 53985
20,53983,6,6,1, 53989
22,53986,4,4,0, 53990
24,53989,1,1,0, 53990
19,53986,5,5,1, 53991
23,53988,3,3,1, 53991
31,53996,2,2,0, 53998
28,53994,5,5,1, 53999
29,53998,4,4,1, 54002
1,54006,1,1,0, 54007
6,54010,2,4,1, 54014
8,54016,1,1,0, 54017
9,54017,2,2,1, 54019
16,54019,2,2,1, 54021
15,54021,2,2,0, 54023
22,54026,4,4,1, 54030
24,54029,1,1,0, 54030
23,54028,3,3,1, 54031
31,54036,2,2,0, 54038
28,54034,5,5,1, 54039
1,54046,1,1,0, 54047
5,54047,3,5,1, 54052
6,54050,2,4,1, 54054
8,54056,1,1,1, 54057
16,54059,2,2,1, 54061
17,54059,3,3,1, 54062
15,54061,2,2,0, 54063
22,54066,4,4,0, 54070
24,54069,1,1,0, 54070
23,54068,3,3,1, 54071
25,54075,2,2,1, 54077
31,54076,2,2,1, 54078
29,54078,4,4,1, 54082
1,54086,1,1,0, 54087
5,54087,3,5,1, 54092
6,54090,2,4,1, 54094
8,54096,1,1,0, 54097
16,54099,2,2,1, 54101
17,54099,3,3,1, 54102
15,54101,2,2,0, 54103
12,54100,5,5,1, 54105
20,54103,6,6,1, 54109
22,54106,4,4,0, 54110
24,54109,1,1,0, 54110
23,54108,3,3,0, 54111
30,54113,3,3,1, 54116
25,54115,2,2,1, 54117
31,54116,2,2,0, 54118
28,54114,5,5,1, 54119
26,54117,3,3,1, 54120
2,54123,2,2,1, 54125
1,54126,1,1,0, 54127
5,54127,3,5,1, 54132
6,54130,2,4,1, 54134
8,54136,1,1,1, 54137
16,54139,2,2,1, 54141
15,54141,2,2,0, 54143
13,54139,4,6,1, 54145
22,54146,4,4,0, 54150
24,54149,1,1,0, 54150
19,54146,5,5,1, 54151
23,54148,3,3,0, 54151
31,54156,2,2,1, 54158
28,54154,5,5,1, 54159
26,54157,3,3,1, 54160
29,54158,4,4,1, 54162
1,54166,1,1,0, 54167
3,54167,3,3,1, 54170
6,54170,2,4,1, 54174
8,54176,1,1,0, 54177
11,54174,4,4,1, 54178
16,54179,2,2,1, 54181
17,54179,3,3,1, 54182
15,54181,2,2,1, 54183
13,54179,4,6,1, 54185
12,54180,5,5,1, 54185
22,54186,4,4,1, 54190
24,54189,1,1,1, 54190
23,54188,3,3,1, 54191
31,54196,2,2,0, 54198
26,54197,3,3,1, 54200
29,54198,4,4,1, 54202
2,54203,2,2,1, 54205
1,54206,1,1,0, 54207
5,54207,3,5,1, 54212
8,54216,1,1,0, 54217
11,54214,4,4,1, 54218
16,54219,2,2,0, 54221
15,54221,2,2,1, 54223
18,54223,4,4,1, 54227
22,54226,4,4,0, 54230
24,54229,1,1,0, 54230
23,54228,3,3,0, 54231
25,54235,2,2,1, 54237
31,54236,2,2,1, 54238
1,54246,1,1,0, 54247
3,54247,3,3,1, 54250
6,54250,2,4,1, 54254
8,54256,1,1,0, 54257
16,54259,2,2,0, 54261
17,54259,3,3,1, 54262
15,54261,2,2,0, 54263
12,54260,5,5,1, 54265
18,54263,4,4,1, 54267
22,54266,4,4,1, 54270
24,54269,1,1,0, 54270
23,54268,3,3,0, 54271
25,54275,2,2,1, 54277
31,54276,2,2,1, 54278
28,54274,5,5,1, 54279
26,54277,3,3,1, 54280
29,54278,4,4,1, 54282
2,54283,2,2,1, 54285
1,54286,1,1,0, 54287
3,54287,3,3,1, 54290
6,54290,2,4,1, 54294
8,54296,1,1,1, 54297
11,54294,4,4,1, 54298
9,54297,2,2,1, 54299
16,54299,2,2,0, 54301
15,54301,2,2,0, 54303
18,54303,4,4,1, 54307
22,54306,4,4,1, 54310
24,54309,1,1,0, 54310
23,54308,3,3,1, 54311
31,54316,2,2,1, 54318
28,54314,5,5,1, 54319
1,54326,1,1,0, 54327
3,54327,3,3,1, 54330
5,54327,3,5,1, 54332
6,54330,2,4,1, 54334
8,54336,1,1,1, 54337
11,54334,4,4,1, 54338
16,54339,2,2,1, 54341
15,54341,2,2,1, 54343
13,54339,4,6,1, 54345
12,54340,5,5,1, 54345
22,54346,4,4,1, 54350
24,54349,1,1,0, 54350
19,54346,5,5,1, 54351
23,54348,3,3,0, 54351
25,54355,2,2,1, 54357
31,54356,2,2,0, 54358
29,54358,4,4,1, 54362
1,54366,1,1,1, 54367
3,54367,3,3,1, 54370
6,54370,2,4,1, 54374
8,54376,1,1,0, 54377
9,54377,2,2,1, 54379
16,54379,2,2,0, 54381
17,54379,3,3,1, 54382
15,54381,2,2,0, 54383
13,54379,4,6,1, 54385
22,54386,4,4,0, 54390
24,54389,1,1,0, 54390
19,54386,5,5,1, 54391
23,54388,3,3,1, 54391
30,54393,3,3,1, 54396
25,54395,2,2,1, 54397
31,54396,2,2,0, 54398
26,54397,3,3,1, 54400
29,54398,4,4,1, 54402
1,54406,1,1,0, 54407
3,54407,3,3,1, 54410
8,54416,1,1,0, 54417
16,54419,2,2,1, 54421
17,54419,3,3,1, 54422
15,54421,2,2,1, 54423
13,54419,4,6,1, 54425
12,54420,5,5,1, 54425
22,54426,4,4,1, 54430
24,54429,1,1,1, 54430
23,54428,3,3,0, 54431
31,54436,2,2,1, 54438
28,54434,5,5,1, 54439
29,54438,4,4,1, 54442
6,54450,2,4,1, 54454
8,54456,1,1,0, 54457
16,54459,2,2,0, 54461
15,54461,2,2,1, 54463
22,54466,4,4,0, 54470
24,54469,1,1,1, 54470
23,54468,3,3,1, 54471
31,54476,2,2,1, 54478
28,54474,5,5,1, 54479
29,54478,4,4,1, 54482
6,54490,2,4,1, 54494
8,54496,1,1,1, 54497
16,54499,2,2,0, 54501
15,54501,2,2,0, 54503
22,54506,4,4,0, 54510
24,54509,1,1,1, 54510
23,54508,3,3,0, 54511
31,54516,2,2,0, 54518
28,54514,5,5,1, 54519
1,54526,1,1,0, 54527
5,54527,3,5,1, 54532
8,54536,1,1,0, 54537
16,54539,2,2,1, 54541
15,54541,2,2,1, 54543
13,54539,4,6,1, 54545
18,54543,4,4,1, 54547
22,54546,4,4,1, 54550
24,54549,1,1,1, 54550
23,54548,3,3,0, 54551
25,54555,2,2,1, 54557
31,54556,2,2,0, 54558
28,54554,5,5,1, 54559
1,54566,1,1,0, 54567
5,54567,3,5,1, 54572
6,54570,2,4,1, 54574
8,54576,1,1,0, 54577
16,54579,2,2,1, 54581
15,54581,2,2,0, 54583
22,54586,4,4,0, 54590
24,54589,1,1,0, 54590
23,54588,3,3,0, 54591
30,54593,3,3,1, 54596
31,54596,2,2,0, 54598
28,54594,5,5,1, 54599
1,54606,1,1,0, 54607
8,54616,1,1,1, 54617
16,54619,2,2,1, 54621
17,54619,3,3,1, 54622
15,54621,2,2,1, 54623
22,54626,4,4,1, 54630
24,54629,1,1,0, 54630
23,54628,3,3,1, 54631
30,54633,3,3,1, 54636
25,54635,2,2,1, 54637
31,54636,2,2,0, 54638
1,54646,1,1,1, 54647
6,54650,2,4,1, 54654
8,54656,1,1,1, 54657
11,54654,4,4,1, 54658
9,54657,2,2,1, 54659
16,54659,2,2,0, 54661
15,54661,2,2,0, 54663
18,54663,4,4,1, 54667
22,54666,4,4,1, 54670
24,54669,1,1,0, 54670
19,54666,5,5,1, 54671
23,54668,3,3,0, 54671
25,54675,2,2,1, 54677
31,54676,2,2,1, 54678
2,54683,2,2,1, 54685
1,54686,1,1,0, 54687
3,54687,3,3,1, 54690
5,54687,3,5,1, 54692
8,54696,1,1,1, 54697
16,54699,2,2,0, 54701
17,54699,3,3,1, 54702
15,54701,2,2,0, 54703
13,54699,4,6,1, 54705
22,54706,4,4,1, 54710
24,54709,1,1,0, 54710
19,54706,5,5,1, 54711
23,54708,3,3,0, 54711
30,54713,3,3,1, 54716
31,54716,2,2,1, 54718
26,54717,3,3,1, 54720
2,54723,2,2,1, 54725
1,54726,1,1,1, 54727
5,54727,3,5,1, 54732
8,54736,1,1,1, 54737
11,54734,4,4,1, 54738
16,54739,2,2,0, 54741
17,54739,3,3,1, 54742
15,54741,2,2,0, 54743
13,54739,4,6,1, 54745
22,54746,4,4,1, 54750
24,54749,1,1,1, 54750
23,54748,3,3,1, 54751
30,54753,3,3,0, 54756
31,54756,2,2,0, 54758
26,54757,3,3,1, 54760
1,54766,1,1,0, 54767
3,54767,3,3,1, 54770
5,54767,3,5,1, 54772
8,54776,1,1,1, 54777
11,54774,4,4,1, 54778
9,54777,2,2,1, 54779
16,54779,2,2,1, 54781
17,54779,3,3,1, 54782
15,54781,2,2,0, 54783
13,54779,4,6,1, 54785
20,54783,6,6,1, 54789
22,54786,4,4,0, 54790
24,54789,1,1,0, 54790
23,54788,3,3,0, 54791
30,54793,3,3,0, 54796
25,54795,2,2,1, 54797
31,54796,2,2,1, 54798
28,54794,5,5,1, 54799
26,54797,3,3,1, 54800
29,54798,4,4,1, 54802
1,54806,1,1,0, 54807
3,54807,3,3,1, 54810
5,54807,3,5,0, 54812
6,54810,2,4,1, 54814
8,54816,1,1,0, 54817
9,54817,2,2,1, 54819
16,54819,2,2,0, 54821
15,54821,2,2,0, 54823
13,54819,4,6,1, 54825
18,54823,4,4,1, 54827
22,54826,4,4,0, 54830
24,54829,1,1,0, 54830
23,54828,3,3,1, 54831
30,54833,3,3,1, 54836
25,54835,2,2,1, 54837
31,54836,2,2,0, 54838
28,54834,5,5,0, 54839
26,54837,3,3,1, 54840
29,54838,4,4,1, 54842
2,54843,2,2,1, 54845
1,54846,1,1,0, 54847
3,54847,3,3,1, 54850
5,54847,3,5,0, 54852
6,54850,2,4,1, 54854
8,54856,1,1,1, 54857
9,54857,2,2,1, 54859
16,54859,2,2,0, 54861
17,54859,3,3,1, 54862
15,54861,2,2,1, 54863
18,54863,4,4,1, 54867
22,54866,4,4,1, 54870
24,54869,1,1,0, 54870
23,54868,3,3,0, 54871
30,54873,3,3,0, 54876
25,54875,2,2,1, 54877
31,54876,2,2,1, 54878
28,54874,5,5,1, 54879
26,54877,3,3,1, 54880
29,54878,4,4,1, 54882
1,54886,1,1,1, 54887
3,54887,3,3,1, 54890
5,54887,3,5,1, 54892
6,54890,2,4,1, 54894
8,54896,1,1,1, 54897
16,54899,2,2,0, 54901
17,54899,3,3,1, 54902
15,54901,2,2,0, 54903
12,54900,5,5,1, 54905
20,54903,6,6,1, 54909
22,54906,4,4,1, 54910
24,54909,1,1,1, 54910
19,54906,5,5,1, 54911
23,54908,3,3,0, 54911
30,54913,3,3,0, 54916
31,54916,2,2,0, 54918
28,54914,5,5,0, 54919
29,54918,4,4,1, 54922
1,54926,1,1,1, 54927
5,54927,3,5,1, 54932
6,54930,2,4,0, 54934
8,54936,1,1,0, 54937
11,54934,4,4,1, 54938
9,54937,2,2,1, 54939
16,54939,2,2,1, 54941
17,54939,3,3,1, 54942
15,54941,2,2,1, 54943
13,54939,4,6,1, 54945
22,54946,4,4,1, 54950
24,54949,1,1,0, 54950
23,54948,3,3,0, 54951
30,54953,3,3,1, 54956
31,54956,2,2,1, 54958
28,54954,5,5,0, 54959
29,54958,4,4,1, 54962
5,54967,3,5,1, 54972
6,54970,2,4,1, 54974
8,54976,1,1,0, 54977
16,54979,2,2,0, 54981
15,54981,2,2,0, 54983
22,54986,4,4,0, 54990
24,54989,1,1,0, 54990
23,54988,3,3,0, 54991
30,54993,3,3,0, 54996
31,54996,2,2,0, 54998
28,54994,5,5,1, 54999
29,54998,4,4,0, 55002
5,55007,3,5,1, 55012
6,55010,2,4,0, 55014
8,55016,1,1,1, 55017
16,55019,2,2,0, 55021
15,55021,2,2,1, 55023
22,55026,4,4,0, 55030
24,55029,1,1,0, 55030
23,55028,3,3,0, 55031
30,55033,3,3,0, 55036
31,55036,2,2,1, 55038
28,55034,5,5,1, 55039
29,55038,4,4,0, 55042
1,55046,1,1,0, 55047
3,55047,3,3,1, 55050
5,55047,3,5,1, 55052
6,55050,2,4,1, 55054
8,55056,1,1,0, 55057
9,55057,2,2,1, 55059
16,55059,2,2,0, 55061
17,55059,3,3,1, 55062
15,55061,2,2,0, 55063
13,55059,4,6,1, 55065
18,55063,4,4,1, 55067
20,55063,6,6,1, 55069
22,55066,4,4,0, 55070
24,55069,1,1,0, 55070
23,55068,3,3,0, 55071
30,55073,3,3,0, 55076
25,55075,2,2,1, 55077
31,55076,2,2,0, 55078
28,55074,5,5,1, 55079
2,55083,2,2,1, 55085
1,55086,1,1,0, 55087
3,55087,3,3,1, 55090
8,55096,1,1,0, 55097
9,55097,2,2,1, 55099
16,55099,2,2,0, 55101
15,55101,2,2,0, 55103
12,55100,5,5,1, 55105
18,55103,4,4,1, 55107
20,55103,6,6,1, 55109
22,55106,4,4,1, 55110
24,55109,1,1,1, 55110
19,55106,5,5,1, 55111
23,55108,3,3,0, 55111
30,55113,3,3,1, 55116
28,55114,5,5,1, 55119
26,55117,3,3,1, 55120
1,55126,1,1,0, 55127
8,55136,1,1,1, 55137
11,55134,4,4,1, 55138
9,55137,2,2,1, 55139
16,55139,2,2,1, 55141
15,55141,2,2,1, 55143
12,55140,5,5,1, 55145
18,55143,4,4,1, 55147
22,55146,4,4,1, 55150
24,55149,1,1,1, 55150
19,55146,5,5,1, 55151
23,55148,3,3,0, 55151
25,55155,2,2,1, 55157
28,55154,5,5,1, 55159
29,55158,4,4,1, 55162
1,55166,1,1,0, 55167
8,55176,1,1,0, 55177
9,55177,2,2,1, 55179
16,55179,2,2,0, 55181
17,55179,3,3,1, 55182
15,55181,2,2,1, 55183
22,55186,4,4,0, 55190
24,55189,1,1,0, 55190
23,55188,3,3,0, 55191
30,55193,3,3,1, 55196
25,55195,2,2,1, 55197
31,55196,2,2,1, 55198
28,55194,5,5,1, 55199
29,55198,4,4,1, 55202
1,55206,1,1,0, 55207
5,55207,3,5,1, 55212
6,55210,2,4,1, 55214
8,55216,1,1,1, 55217
9,55217,2,2,1, 55219
16,55219,2,2,0, 55221
15,55221,2,2,0, 55223
22,55226,4,4,0, 55230
24,55229,1,1,0, 55230
23,55228,3,3,1, 55231
25,55235,2,2,1, 55237
28,55234,5,5,1, 55239
29,55238,4,4,1, 55242
1,55246,1,1,1, 55247
5,55247,3,5,1, 55252
6,55250,2,4,1, 55254
8,55256,1,1,1, 55257
9,55257,2,2,1, 55259
16,55259,2,2,0, 55261
17,55259,3,3,1, 55262
15,55261,2,2,0, 55263
12,55260,5,5,1, 55265
18,55263,4,4,1, 55267
22,55266,4,4,0, 55270
24,55269,1,1,1, 55270
19,55266,5,5,1, 55271
23,55268,3,3,0, 55271
25,55275,2,2,1, 55277
28,55274,5,5,1, 55279
29,55278,4,4,1, 55282
2,55283,2,2,1, 55285
1,55286,1,1,0, 55287
5,55287,3,5,1, 55292
6,55290,2,4,1, 55294
8,55296,1,1,1, 55297
11,55294,4,4,1, 55298
16,55299,2,2,1, 55301
17,55299,3,3,1, 55302
15,55301,2,2,1, 55303
12,55300,5,5,1, 55305
22,55306,4,4,1, 55310
24,55309,1,1,1, 55310
23,55308,3,3,0, 55311
30,55313,3,3,1, 55316
31,55316,2,2,1, 55318
28,55314,5,5,1, 55319
26,55317,3,3,1, 55320
29,55318,4,4,1, 55322
6,55330,2,4,1, 55334
8,55336,1,1,0, 55337
16,55339,2,2,1, 55341
15,55341,2,2,0, 55343
22,55346,4,4,0, 55350
24,55349,1,1,1, 55350
23,55348,3,3,0, 55351
30,55353,3,3,1, 55356
29,55358,4,4,1, 55362
8,55376,1,1,0, 55377
16,55379,2,2,0, 55381
15,55381,2,2,0, 55383
22,55386,4,4,1, 55390
24,55389,1,1,1, 55390
23,55388,3,3,1, 55391
30,55393,3,3,1, 55396
28,55394,5,5,1, 55399
6,55410,2,4,1, 55414
8,55416,1,1,1, 55417
16,55419,2,2,1, 55421
15,55421,2,2,1, 55423
13,55419,4,6,1, 55425
20,55423,6,6,1, 55429
22,55426,4,4,1, 55430
24,55429,1,1,1, 55430
23,55428,3,3,1, 55431
25,55435,2,2,1, 55437
28,55434,5,5,1, 55439
29,55438,4,4,1, 55442
1,55446,1,1,0, 55447
8,55456,1,1,0, 55457
16,55459,2,2,1, 55461
17,55459,3,3,1, 55462
15,55461,2,2,0, 55463
22,55466,4,4,0, 55470
24,55469,1,1,0, 55470
23,55468,3,3,0, 55471
31,55476,2,2,1, 55478
28,55474,5,5,1, 55479
2,55483,2,2,1, 55485
1,55486,1,1,1, 55487
5,55487,3,5,1, 55492
8,55496,1,1,0, 55497
9,55497,2,2,1, 55499
16,55499,2,2,1, 55501
17,55499,3,3,1, 55502
15,55501,2,2,1, 55503
20,55503,6,6,1, 55509
22,55506,4,4,0, 55510
24,55509,1,1,1, 55510
23,55508,3,3,1, 55511
30,55513,3,3,1, 55516
25,55515,2,2,1, 55517
31,55516,2,2,1, 55518
28,55514,5,5,1, 55519
26,55517,3,3,1, 55520
2,55523,2,2,1, 55525
1,55526,1,1,0, 55527
3,55527,3,3,1, 55530
8,55536,1,1,1, 55537
9,55537,2,2,1, 55539
16,55539,2,2,1, 55541
17,55539,3,3,1, 55542
12,55540,5,5,1, 55545
18,55543,4,4,1, 55547
24,55549,1,1,0, 55550
30,55553,3,3,1, 55556
28,55554,5,5,1, 55559
1,55566,1,1,1, 55567
6,55570,2,4,1, 55574
8,55576,1,1,0, 55577
13,55579,4,6,1, 55585
12,55580,5,5,1, 55585
18,55583,4,4,1, 55587
20,55583,6,6,1, 55589
22,55586,4,4,1, 55590
24,55589,1,1,1, 55590
19,55586,5,5,1, 55591
31,55596,2,2,1, 55598
28,55594,5,5,1, 55599
26,55597,3,3,1, 55600
29,55598,4,4,1, 55602
2,55603,2,2,1, 55605
1,55606,1,1,1, 55607
8,55616,1,1,0, 55617
17,55619,3,3,1, 55622
15,55621,2,2,1, 55623
13,55619,4,6,1, 55625
18,55623,4,4,1, 55627
20,55623,6,6,1, 55629
24,55629,1,1,0, 55630
23,55628,3,3,1, 55631
1,55646,1,1,0, 55647
8,55656,1,1,1, 55657
11,55654,4,4,1, 55658
12,55660,5,5,1, 55665
18,55663,4,4,1, 55667
24,55669,1,1,0, 55670
19,55666,5,5,1, 55671
23,55668,3,3,1, 55671
25,55675,2,2,1, 55677
28,55674,5,5,1, 55679
26,55677,3,3,1, 55680
1,55686,1,1,1, 55687
5,55687,3,5,1, 55692
6,55690,2,4,1, 55694
8,55696,1,1,0, 55697
9,55697,2,2,1, 55699
15,55701,2,2,1, 55703
20,55703,6,6,1, 55709
22,55706,4,4,1, 55710
24,55709,1,1,1, 55710
19,55706,5,5,1, 55711
30,55713,3,3,1, 55716
31,55716,2,2,1, 55718
28,55714,5,5,1, 55719
26,55717,3,3,1, 55720
1,55726,1,1,1, 55727
6,55730,2,4,1, 55734
8,55736,1,1,1, 55737
11,55734,4,4,1, 55738
13,55739,4,6,1, 55745
12,55740,5,5,1, 55745
18,55743,4,4,1, 55747
20,55743,6,6,1, 55749
24,55749,1,1,1, 55750
23,55748,3,3,1, 55751
30,55753,3,3,1, 55756
28,55754,5,5,1, 55759
5,55767,3,5,1, 55772
6,55770,2,4,1, 55774
8,55776,1,1,0, 55777
24,55789,1,1,0, 55790
28,55794,5,5,1, 55799
29,55798,4,4,1, 55802
8,55816,1,1,1, 55817
16,55819,2,2,1, 55821
15,55821,2,2,1, 55823
22,55826,4,4,1, 55830
24,55829,1,1,0, 55830
30,55833,3,3,1, 55836
31,55836,2,2,1, 55838
28,55834,5,5,1, 55839
29,55838,4,4,1, 55842
5,55847,3,5,1, 55852
8,55856,1,1,1, 55857
11,55854,4,4,1, 55858
15,55861,2,2,1, 55863
12,55860,5,5,1, 55865
20,55863,6,6,1, 55869
22,55866,4,4,1, 55870
24,55869,1,1,1, 55870
23,55868,3,3,1, 55871
30,55873,3,3,1, 55876
25,55875,2,2,1, 55877
28,55874,5,5,1, 55879
26,55877,3,3,1, 55880
1,55886,1,1,1, 55887
8,55896,1,1,0, 55897
11,55894,4,4,1, 55898
9,55897,2,2,1, 55899
16,55899,2,2,1, 55901
15,55901,2,2,1, 55903
13,55899,4,6,1, 55905
22,55906,4,4,1, 55910
24,55909,1,1,0, 55910
23,55908,3,3,1, 55911
25,55915,2,2,1, 55917
31,55916,2,2,1, 55918
26,55917,3,3,1, 55920
29,55918,4,4,1, 55922
2,55923,2,2,1, 55925
1,55926,1,1,0, 55927
3,55927,3,3,1, 55930
8,55936,1,1,0, 55937
11,55934,4,4,1, 55938
9,55937,2,2,1, 55939
13,55939,4,6,1, 55945
12,55940,5,5,1, 55945
20,55943,6,6,1, 55949
24,55949,1,1,0, 55950
23,55948,3,3,1, 55951
1,55966,1,1,1, 55967
8,55976,1,1,1, 55977
9,55977,2,2,1, 55979
17,55979,3,3,1, 55982
12,55980,5,5,1, 55985
22,55986,4,4,1, 55990
24,55989,1,1,0, 55990
26,55997,3,3,1, 56000
1,56006,1,1,0, 56007
5,56007,3,5,1, 56012
8,56016,1,1,0, 56017
11,56014,4,4,1, 56018
9,56017,2,2,1, 56019
16,56019,2,2,1, 56021
15,56021,2,2,1, 56023
12,56020,5,5,1, 56025
22,56026,4,4,1, 56030
24,56029,1,1,0, 56030
23,56028,3,3,1, 56031
30,56033,3,3,1, 56036
25,56035,2,2,1, 56037
26,56037,3,3,1, 56040
29,56038,4,4,1, 56042
2,56043,2,2,1, 56045
1,56046,1,1,1, 56047
3,56047,3,3,1, 56050
5,56047,3,5,1, 56052
8,56056,1,1,0, 56057
9,56057,2,2,1, 56059
17,56059,3,3,1, 56062
20,56063,6,6,1, 56069
24,56069,1,1,1, 56070
19,56066,5,5,1, 56071
23,56068,3,3,1, 56071
26,56077,3,3,1, 56080
2,56083,2,2,1, 56085
1,56086,1,1,1, 56087
6,56090,2,4,1, 56094
8,56096,1,1,1, 56097
16,56099,2,2,0, 56101
15,56101,2,2,0, 56103
18,56103,4,4,1, 56107
22,56106,4,4,1, 56110
24,56109,1,1,0, 56110
23,56108,3,3,0, 56111
30,56113,3,3,1, 56116
26,56117,3,3,1, 56120
29,56118,4,4,1, 56122
1,56126,1,1,0, 56127
6,56130,2,4,1, 56134
8,56136,1,1,1, 56137
9,56137,2,2,1, 56139
16,56139,2,2,0, 56141
17,56139,3,3,1, 56142
15,56141,2,2,0, 56143
12,56140,5,7,1, 56147
18,56143,4,4,1, 56147
20,56143,6,6,1, 56149
22,56146,4,4,0, 56150
24,56149,1,1,1, 56150
23,56148,3,3,1, 56151
25,56155,2,2,1, 56157
31,56156,2,2,1, 56158
26,56157,3,3,1, 56160
29,56158,4,4,1, 56162
5,56167,3,5,1, 56172
8,56176,1,1,1, 56177
16,56179,2,2,0, 56181
15,56181,2,2,0, 56183
22,56186,4,4,1, 56190
24,56189,1,1,0, 56190
23,56188,3,3,0, 56191
31,56196,2,2,1, 56198
28,56194,5,5,1, 56199
5,56207,3,5,1, 56212
8,56216,1,1,1, 56217
16,56219,2,2,1, 56221
15,56221,2,2,1, 56223
22,56226,4,4,1, 56230
24,56229,1,1,0, 56230
23,56228,3,3,0, 56231
30,56233,3,3,1, 56236
31,56236,2,2,1, 56238
28,56234,5,5,1, 56239
29,56238,4,4,1, 56242
6,56250,2,4,1, 56254
8,56256,1,1,0, 56257
16,56259,2,2,0, 56261
15,56261,2,2,1, 56263
18,56263,4,4,1, 56267
20,56263,6,6,1, 56269
22,56266,4,4,1, 56270
24,56269,1,1,0, 56270
23,56268,3,3,1, 56271
30,56273,3,3,1, 56276
25,56275,2,2,1, 56277
26,56277,3,3,1, 56280
29,56278,4,4,1, 56282
2,56283,2,2,1, 56285
1,56286,1,1,1, 56287
8,56296,1,1,1, 56297
16,56299,2,2,1, 56301
17,56299,3,3,1, 56302
15,56301,2,2,1, 56303
13,56299,4,6,1, 56305
18,56303,4,4,1, 56307
22,56306,4,4,1, 56310
24,56309,1,1,1, 56310
23,56308,3,3,1, 56311
30,56313,3,3,1, 56316
31,56316,2,2,1, 56318
2,56323,2,2,1, 56325
1,56326,1,1,1, 56327
3,56327,3,3,1, 56330
5,56327,3,5,1, 56332
6,56330,2,4,1, 56334
8,56336,1,1,1, 56337
16,56339,2,2,1, 56341
17,56339,3,3,1, 56342
15,56341,2,2,0, 56343
12,56340,5,7,1, 56347
18,56343,4,4,1, 56347
20,56343,6,6,1, 56349
22,56346,4,4,0, 56350
24,56349,1,1,0, 56350
23,56348,3,3,1, 56351
30,56353,3,3,1, 56356
31,56356,2,2,1, 56358
26,56357,3,3,1, 56360
1,56366,1,1,0, 56367
5,56367,3,5,1, 56372
6,56370,2,4,1, 56374
8,56376,1,1,1, 56377
9,56377,2,2,1, 56379
16,56379,2,2,1, 56381
15,56381,2,2,0, 56383
13,56379,4,6,1, 56385
20,56383,6,6,1, 56389
22,56386,4,4,0, 56390
24,56389,1,1,1, 56390
23,56388,3,3,1, 56391
25,56395,2,2,1, 56397
26,56397,3,3,1, 56400
1,56406,1,1,0, 56407
8,56416,1,1,0, 56417
16,56419,2,2,0, 56421
17,56419,3,3,1, 56422
15,56421,2,2,0, 56423
13,56419,4,6,1, 56425
12,56420,5,7,1, 56427
18,56423,4,4,1, 56427
22,56426,4,4,0, 56430
24,56429,1,1,1, 56430
23,56428,3,3,1, 56431
25,56435,2,2,1, 56437
31,56436,2,2,1, 56438
29,56438,4,4,1, 56442
2,56443,2,2,1, 56445
1,56446,1,1,1, 56447
5,56447,3,5,1, 56452
8,56456,1,1,1, 56457
9,56457,2,2,1, 56459
16,56459,2,2,0, 56461
15,56461,2,2,1, 56463
12,56460,5,7,1, 56467
20,56463,6,6,1, 56469
22,56466,4,4,1, 56470
24,56469,1,1,1, 56470
19,56466,5,5,1, 56471
23,56468,3,3,1, 56471
29,56478,4,4,1, 56482
2,56483,2,2,1, 56485
1,56486,1,1,0, 56487
5,56487,3,5,1, 56492
8,56496,1,1,1, 56497
9,56497,2,2,1, 56499
16,56499,2,2,0, 56501
17,56499,3,3,1, 56502
15,56501,2,2,1, 56503
12,56500,5,7,1, 56507
20,56503,6,6,1, 56509
22,56506,4,4,1, 56510
24,56509,1,1,0, 56510
19,56506,5,5,1, 56511
23,56508,3,3,1, 56511
30,56513,3,3,1, 56516
25,56515,2,2,1, 56517
28,56514,5,5,1, 56519
2,56523,2,2,1, 56525
1,56526,1,1,0, 56527
3,56527,3,3,1, 56530
6,56530,2,4,1, 56534
8,56536,1,1,0, 56537
16,56539,2,2,1, 56541
15,56541,2,2,1, 56543
13,56539,4,6,1, 56545
22,56546,4,4,0, 56550
24,56549,1,1,0, 56550
23,56548,3,3,1, 56551
29,56558,4,4,1, 56562
8,56576,1,1,0, 56577
16,56579,2,2,1, 56581
15,56581,2,2,1, 56583
22,56586,4,4,0, 56590
24,56589,1,1,1, 56590
23,56588,3,3,1, 56591
28,56594,5,5,1, 56599
8,56616,1,1,1, 56617
16,56619,2,2,1, 56621
15,56621,2,2,0, 56623
13,56619,4,6,1, 56625
22,56626,4,4,0, 56630
24,56629,1,1,1, 56630
23,56628,3,3,0, 56631
30,56633,3,3,1, 56636
25,56635,2,2,1, 56637
31,56636,2,2,1, 56638
28,56634,5,5,1, 56639
1,56646,1,1,1, 56647
3,56647,3,3,1, 56650
8,56656,1,1,0, 56657
16,56659,2,2,0, 56661
17,56659,3,3,1, 56662
15,56661,2,2,0, 56663
22,56666,4,4,0, 56670
24,56669,1,1,0, 56670
19,56666,5,5,1, 56671
23,56668,3,3,1, 56671
25,56675,2,2,1, 56677
26,56677,3,3,1, 56680
29,56678,4,4,0, 56682
1,56686,1,1,0, 56687
3,56687,3,3,1, 56690
5,56687,3,5,0, 56692
6,56690,2,4,1, 56694
8,56696,1,1,0, 56697
16,56699,2,2,0, 56701
15,56701,2,2,0, 56703
13,56699,4,6,0, 56705
18,56703,4,4,1, 56707
22,56706,4,4,1, 56710
24,56709,1,1,0, 56710
23,56708,3,3,0, 56711
30,56713,3,3,0, 56716
25,56715,2,2,1, 56717
31,56716,2,2,1, 56718
28,56714,5,5,1, 56719
29,56718,4,4,1, 56722
1,56726,1,1,0, 56727
3,56727,3,3,1, 56730
5,56727,3,5,0, 56732
6,56730,2,4,1, 56734
8,56736,1,1,0, 56737
9,56737,2,2,1, 56739
16,56739,2,2,0, 56741
17,56739,3,3,1, 56742
15,56741,2,2,0, 56743
13,56739,4,6,1, 56745
12,56740,5,7,1, 56747
18,56743,4,4,1, 56747
22,56746,4,4,1, 56750
24,56749,1,1,0, 56750
23,56748,3,3,1, 56751
30,56753,3,3,1, 56756
25,56755,2,2,1, 56757
31,56756,2,2,0, 56758
28,56754,5,5,1, 56759
26,56757,3,3,1, 56760
29,56758,4,4,0, 56762
2,56763,2,2,1, 56765
1,56766,1,1,0, 56767
3,56767,3,3,1, 56770
5,56767,3,5,1, 56772
6,56770,2,4,1, 56774
8,56776,1,1,0, 56777
9,56777,2,2,1, 56779
16,56779,2,2,1, 56781
15,56781,2,2,0, 56783
13,56779,4,6,1, 56785
22,56786,4,4,0, 56790
24,56789,1,1,0, 56790
19,56786,5,5,1, 56791
23,56788,3,3,1, 56791
30,56793,3,3,1, 56796
25,56795,2,2,1, 56797
31,56796,2,2,0, 56798
28,56794,5,5,0, 56799
26,56797,3,3,1, 56800
29,56798,4,4,1, 56802
1,56806,1,1,1, 56807
5,56807,3,5,0, 56812
6,56810,2,4,1, 56814
8,56816,1,1,1, 56817
16,56819,2,2,1, 56821
15,56821,2,2,1, 56823
13,56819,4,6,0, 56825
22,56826,4,4,0, 56830
24,56829,1,1,1, 56830
19,56826,5,5,1, 56831
23,56828,3,3,1, 56831
30,56833,3,3,0, 56836
25,56835,2,2,1, 56837
31,56836,2,2,0, 56838
28,56834,5,5,0, 56839
26,56837,3,3,1, 56840
29,56838,4,4,1, 56842
2,56843,2,2,1, 56845
1,56846,1,1,0, 56847
3,56847,3,3,1, 56850
5,56847,3,5,0, 56852
6,56850,2,4,0, 56854
8,56856,1,1,0, 56857
9,56857,2,2,1, 56859
16,56859,2,2,1, 56861
15,56861,2,2,0, 56863
13,56859,4,6,0, 56865
12,56860,5,7,1, 56867
18,56863,4,4,1, 56867
20,56863,6,6,1, 56869
22,56866,4,4,1, 56870
24,56869,1,1,1, 56870
19,56866,5,5,1, 56871
23,56868,3,3,1, 56871
30,56873,3,3,0, 56876
31,56876,2,2,0, 56878
28,56874,5,5,1, 56879
29,56878,4,4,1, 56882
2,56883,2,2,1, 56885
1,56886,1,1,0, 56887
5,56887,3,5,0, 56892
6,56890,2,4,1, 56894
8,56896,1,1,1, 56897
16,56899,2,2,1, 56901
15,56901,2,2,1, 56903
13,56899,4,6,1, 56905
18,56903,4,4,1, 56907
20,56903,6,6,1, 56909
22,56906,4,4,1, 56910
24,56909,1,1,0, 56910
19,56906,5,5,1, 56911
23,56908,3,3,0, 56911
30,56913,3,3,1, 56916
25,56915,2,2,1, 56917
31,56916,2,2,1, 56918
28,56914,5,5,0, 56919
29,56918,4,4,1, 56922
1,56926,1,1,1, 56927
5,56927,3,5,1, 56932
6,56930,2,4,0, 56934
8,56936,1,1,0, 56937
16,56939,2,2,1, 56941
15,56941,2,2,0, 56943
13,56939,4,6,0, 56945
20,56943,6,6,1, 56949
22,56946,4,4,1, 56950
24,56949,1,1,1, 56950
19,56946,5,5,1, 56951
23,56948,3,3,0, 56951
30,56953,3,3,0, 56956
25,56955,2,2,1, 56957
31,56956,2,2,0, 56958
28,56954,5,5,1, 56959
26,56957,3,3,1, 56960
29,56958,4,4,1, 56962
2,56963,2,2,1, 56965
1,56966,1,1,1, 56967
5,56967,3,5,0, 56972
6,56970,2,4,0, 56974
8,56976,1,1,0, 56977
9,56977,2,2,1, 56979
16,56979,2,2,0, 56981
17,56979,3,3,1, 56982
15,56981,2,2,1, 56983
13,56979,4,6,1, 56985
22,56986,4,4,1, 56990
24,56989,1,1,0, 56990
23,56988,3,3,1, 56991
30,56993,3,3,1, 56996
31,56996,2,2,0, 56998
28,56994,5,5,1, 56999
29,56998,4,4,1, 57002
6,57010,2,4,1, 57014
8,57016,1,1,1, 57017
16,57019,2,2,0, 57021
15,57021,2,2,0, 57023
13,57019,4,6,1, 57025
22,57026,4,4,1, 57030
24,57029,1,1,1, 57030
23,57028,3,3,1, 57031
31,57036,2,2,1, 57038
28,57034,5,5,1, 57039
29,57038,4,4,1, 57042
5,57047,3,5,1, 57052
6,57050,2,4,1, 57054
8,57056,1,1,1, 57057
16,57059,2,2,0, 57061
15,57061,2,2,1, 57063
22,57066,4,4,0, 57070
24,57069,1,1,0, 57070
23,57068,3,3,1, 57071
1,57086,1,1,1, 57087
8,57096,1,1,0, 57097
9,57097,2,2,1, 57099
16,57099,2,2,1, 57101
15,57101,2,2,1, 57103
12,57100,5,7,1, 57107
18,57103,4,4,1, 57107
20,57103,6,6,1, 57109
22,57106,4,4,1, 57110
24,57109,1,1,0, 57110
19,57106,5,5,1, 57111
23,57108,3,3,1, 57111
30,57113,3,3,1, 57116
28,57114,5,5,1, 57119
26,57117,3,3,1, 57120
2,57123,2,2,1, 57125
1,57126,1,1,0, 57127
8,57136,1,1,1, 57137
16,57139,2,2,1, 57141
17,57139,3,3,1, 57142
15,57141,2,2,1, 57143
12,57140,5,7,1, 57147
18,57143,4,4,1, 57147
20,57143,6,6,1, 57149
22,57146,4,4,0, 57150
24,57149,1,1,0, 57150
19,57146,5,5,1, 57151
23,57148,3,3,1, 57151
29,57158,4,4,1, 57162
2,57163,2,2,1, 57165
1,57166,1,1,0, 57167
5,57167,3,5,1, 57172
8,57176,1,1,0, 57177
16,57179,2,2,1, 57181
17,57179,3,3,1, 57182
15,57181,2,2,0, 57183
18,57183,4,4,1, 57187
20,57183,6,6,1, 57189
22,57186,4,4,0, 57190
24,57189,1,1,1, 57190
19,57186,5,5,1, 57191
23,57188,3,3,0, 57191
31,57196,2,2,1, 57198
26,57197,3,3,1, 57200
29,57198,4,4,1, 57202
1,57206,1,1,0, 57207
5,57207,3,5,1, 57212
8,57216,1,1,0, 57217
9,57217,2,2,1, 57219
16,57219,2,2,1, 57221
15,57221,2,2,0, 57223
13,57219,4,6,1, 57225
12,57220,5,7,1, 57227
18,57223,4,4,1, 57227
20,57223,6,6,1, 57229
22,57226,4,4,1, 57230
24,57229,1,1,1, 57230
19,57226,5,5,1, 57231
23,57228,3,3,0, 57231
30,57233,3,3,1, 57236
28,57234,5,5,1, 57239
1,57246,1,1,1, 57247
5,57247,3,5,1, 57252
6,57250,2,4,1, 57254
8,57256,1,1,0, 57257
9,57257,2,2,1, 57259
16,57259,2,2,0, 57261
17,57259,3,3,1, 57262
15,57261,2,2,1, 57263
13,57259,4,6,1, 57265
12,57260,5,7,1, 57267
20,57263,6,6,1, 57269
22,57266,4,4,1, 57270
24,57269,1,1,0, 57270
19,57266,5,5,1, 57271
23,57268,3,3,1, 57271
30,57273,3,3,1, 57276
25,57275,2,2,1, 57277
28,57274,5,5,1, 57279
26,57277,3,3,1, 57280
29,57278,4,4,1, 57282
2,57283,2,2,1, 57285
1,57286,1,1,0, 57287
5,57287,3,5,1, 57292
6,57290,2,4,1, 57294
8,57296,1,1,1, 57297
16,57299,2,2,0, 57301
17,57299,3,3,1, 57302
15,57301,2,2,0, 57303
22,57306,4,4,1, 57310
24,57309,1,1,1, 57310
23,57308,3,3,0, 57311
29,57318,4,4,1, 57322
6,57330,2,4,1, 57334
8,57336,1,1,0, 57337
16,57339,2,2,1, 57341
15,57341,2,2,1, 57343
13,57339,4,6,1, 57345
22,57346,4,4,0, 57350
24,57349,1,1,1, 57350
23,57348,3,3,1, 57351
31,57356,2,2,1, 57358
29,57358,4,4,1, 57362
5,57367,3,5,1, 57372
6,57370,2,4,1, 57374
8,57376,1,1,1, 57377
16,57379,2,2,0, 57381
15,57381,2,2,0, 57383
22,57386,4,4,0, 57390
24,57389,1,1,1, 57390
23,57388,3,3,1, 57391
31,57396,2,2,1, 57398
29,57398,4,4,1, 57402
1,57406,1,1,0, 57407
6,57410,2,4,1, 57414
8,57416,1,1,0, 57417
16,57419,2,2,0, 57421
17,57419,3,3,1, 57422
15,57421,2,2,1, 57423
13,57419,4,6,1, 57425
18,57423,4,4,1, 57427
22,57426,4,4,1, 57430
24,57429,1,1,0, 57430
19,57426,5,5,1, 57431
23,57428,3,3,1, 57431
30,57433,3,3,1, 57436
28,57434,5,5,1, 57439
29,57438,4,4,1, 57442
1,57446,1,1,1, 57447
5,57447,3,5,1, 57452
6,57450,2,4,1, 57454
8,57456,1,1,1, 57457
9,57457,2,2,1, 57459
16,57459,2,2,0, 57461
15,57461,2,2,0, 57463
12,57460,5,7,1, 57467
20,57463,6,6,1, 57469
22,57466,4,4,1, 57470
24,57469,1,1,0, 57470
23,57468,3,3,0, 57471
31,57476,2,2,1, 57478
26,57477,3,3,1, 57480
2,57483,2,2,1, 57485
1,57486,1,1,0, 57487
8,57496,1,1,1, 57497
9,57497,2,2,1, 57499
16,57499,2,2,0, 57501
15,57501,2,2,1, 57503
13,57499,4,6,1, 57505
22,57506,4,4,0, 57510
24,57509,1,1,0, 57510
23,57508,3,3,0, 57511
30,57513,3,3,1, 57516
25,57515,2,2,1, 57517
28,57514,5,5,1, 57519
29,57518,4,4,1, 57522
2,57523,2,2,1, 57525
1,57526,1,1,0, 57527
8,57536,1,1,1, 57537
16,57539,2,2,0, 57541
17,57539,3,3,1, 57542
15,57541,2,2,1, 57543
12,57540,5,7,1, 57547
18,57543,4,4,1, 57547
20,57543,6,6,1, 57549
22,57546,4,4,1, 57550
24,57549,1,1,1, 57550
23,57548,3,3,0, 57551
30,57553,3,3,1, 57556
28,57554,5,5,1, 57559
26,57557,3,3,1, 57560
2,57563,2,2,1, 57565
1,57566,1,1,1, 57567
8,57576,1,1,0, 57577
16,57579,2,2,0, 57581
15,57581,2,2,1, 57583
18,57583,4,4,1, 57587
20,57583,6,6,1, 57589
22,57586,4,4,1, 57590
24,57589,1,1,1, 57590
23,57588,3,3,1, 57591
30,57593,3,3,1, 57596
25,57595,2,2,1, 57597
29,57598,4,4,1, 57602
1,57606,1,1,1, 57607
8,57616,1,1,0, 57617
16,57619,2,2,0, 57621
17,57619,3,3,1, 57622
15,57621,2,2,1, 57623
22,57626,4,4,0, 57630
24,57629,1,1,1, 57630
19,57626,5,5,1, 57631
23,57628,3,3,0, 57631
25,57635,2,2,1, 57637
29,57638,4,4,1, 57642
1,57646,1,1,0, 57647
6,57650,2,4,1, 57654
8,57656,1,1,0, 57657
16,57659,2,2,1, 57661
15,57661,2,2,1, 57663
18,57663,4,4,1, 57667
22,57666,4,4,1, 57670
24,57669,1,1,0, 57670
19,57666,5,5,1, 57671
23,57668,3,3,0, 57671
31,57676,2,2,1, 57678
29,57678,4,8,1, 57686
1,57686,1,1,1, 57687
8,57696,1,1,0, 57697
16,57699,2,2,1, 57701
15,57701,2,2,1, 57703
12,57700,5,7,1, 57707
22,57706,4,4,0, 57710
24,57709,1,1,1, 57710
23,57708,3,3,1, 57711
26,57717,3,3,1, 57720
28,57714,5,7,1, 57721
1,57726,1,1,1, 57727
5,57727,3,9,1, 57736
8,57736,1,1,0, 57737
9,57737,2,2,1, 57739
16,57739,2,2,0, 57741
15,57741,2,2,0, 57743
18,57743,4,4,1, 57747
22,57746,4,4,0, 57750
24,57749,1,1,0, 57750
19,57746,5,5,1, 57751
23,57748,3,3,0, 57751
2,57763,2,2,1, 57765
29,57758,4,8,1, 57766
1,57766,1,1,0, 57767
5,57767,3,9,1, 57776
8,57776,1,1,0, 57777
16,57779,2,2,1, 57781
15,57781,2,2,0, 57783
13,57779,4,8,1, 57787
12,57780,5,7,1, 57787
18,57783,4,4,1, 57787
22,57786,4,4,1, 57790
24,57789,1,1,0, 57790
19,57786,5,5,1, 57791
23,57788,3,3,0, 57791
25,57795,2,2,1, 57797
1,57806,1,1,0, 57807
8,57816,1,1,0, 57817
9,57817,2,2,1, 57819
16,57819,2,2,1, 57821
15,57821,2,2,1, 57823
13,57819,4,8,1, 57827
12,57820,5,7,1, 57827
22,57826,4,4,1, 57830
24,57829,1,1,0, 57830
23,57828,3,3,0, 57831
25,57835,2,2,1, 57837
29,57838,4,8,1, 57846
1,57846,1,1,1, 57847
8,57856,1,1,1, 57857
9,57857,2,2,1, 57859
16,57859,2,2,0, 57861
15,57861,2,2,1, 57863
13,57859,4,8,1, 57867
20,57863,6,6,1, 57869
22,57866,4,4,1, 57870
24,57869,1,1,0, 57870
23,57868,3,3,1, 57871
29,57878,4,8,1, 57886
1,57886,1,1,0, 57887
8,57896,1,1,0, 57897
9,57897,2,2,1, 57899
16,57899,2,2,1, 57901
17,57899,3,3,1, 57902
15,57901,2,2,1, 57903
20,57903,6,6,1, 57909
22,57906,4,4,1, 57910
24,57909,1,1,0, 57910
23,57908,3,3,1, 57911
25,57915,2,2,1, 57917
2,57923,2,2,1, 57925
29,57918,4,8,1, 57926
1,57926,1,1,0, 57927
8,57936,1,1,1, 57937
15,57941,2,2,1, 57943
12,57940,5,7,1, 57947
22,57946,4,4,1, 57950
24,57949,1,1,1, 57950
26,57957,3,3,1, 57960
2,57963,2,2,1, 57965
29,57958,4,8,1, 57966
1,57966,1,1,0, 57967
5,57967,3,9,1, 57976
8,57976,1,1,0, 57977
9,57977,2,2,1, 57979
16,57979,2,2,1, 57981
15,57981,2,2,1, 57983
13,57979,4,8,1, 57987
18,57983,4,4,1, 57987
20,57983,6,6,1, 57989
24,57989,1,1,1, 57990
19,57986,5,5,1, 57991
23,57988,3,3,1, 57991
8,58016,1,1,0, 58017
16,58019,2,2,1, 58021
22,58026,4,4,1, 58030
24,58029,1,1,0, 58030
23,58028,3,3,1, 58031
8,58056,1,1,1, 58057
16,58059,2,2,1, 58061
22,58066,4,4,1, 58070
24,58069,1,1,1, 58070
23,58068,3,3,1, 58071
8,58096,1,1,1, 58097
16,58099,2,2,1, 58101
18,58103,4,4,1, 58107
24,58109,1,1,1, 58110
25,58115,2,2,1, 58117
26,58117,3,3,1, 58120
28,58114,5,7,1, 58121
2,58123,2,2,1, 58125
1,58126,1,1,0, 58127
5,58127,3,9,1, 58136
8,58136,1,1,1, 58137
12,58140,5,7,1, 58147
18,58143,4,4,1, 58147
24,58149,1,1,0, 58150
26,58157,3,3,1, 58160
28,58154,5,7,1, 58161
2,58163,2,2,1, 58165
1,58166,1,1,1, 58167
8,58176,1,1,0, 58177
6,58170,2,10,1, 58180
16,58179,2,2,1, 58181
18,58183,4,4,1, 58187
24,58189,1,1,0, 58190
19,58186,5,5,1, 58191
23,58188,3,3,1, 58191
26,58197,3,3,1, 58200
28,58194,5,7,1, 58201
1,58206,1,1,1, 58207
8,58216,1,1,0, 58217
9,58217,2,2,1, 58219
6,58210,2,10,1, 58220
16,58219,2,2,1, 58221
17,58219,3,3,1, 58222
15,58221,2,2,1, 58223
24,58229,1,1,1, 58230
19,58226,5,5,1, 58231
23,58228,3,3,1, 58231
25,58235,2,2,1, 58237
29,58238,4,8,1, 58246
1,58246,1,1,0, 58247
8,58256,1,1,1, 58257
9,58257,2,2,1, 58259
16,58259,2,2,1, 58261
17,58259,3,3,1, 58262
13,58259,4,8,1, 58267
22,58266,4,4,1, 58270
24,58269,1,1,1, 58270
28,58274,5,7,1, 58281
29,58278,4,8,1, 58286
1,58286,1,1,0, 58287
5,58287,3,9,1, 58296
8,58296,1,1,1, 58297
9,58297,2,2,1, 58299
6,58290,2,10,1, 58300
16,58299,2,2,1, 58301
12,58300,5,7,1, 58307
18,58303,4,4,1, 58307
20,58303,6,6,1, 58309
24,58309,1,1,0, 58310
19,58306,5,5,1, 58311
2,58323,2,2,1, 58325
8,58336,1,1,0, 58337
15,58341,2,2,1, 58343
24,58349,1,1,0, 58350
23,58348,3,3,1, 58351
8,58376,1,1,0, 58377
16,58379,2,2,1, 58381
22,58386,4,4,1, 58390
24,58389,1,1,0, 58390
8,58416,1,1,1, 58417
16,58419,2,2,1, 58421
15,58421,2,2,1, 58423
24,58429,1,1,0, 58430
25,58435,2,2,1, 58437
28,58434,5,7,1, 58441
2,58443,2,2,1, 58445
1,58446,1,1,0, 58447
13,58459,4,8,1, 58467
22,58466,4,4,0, 58470
24,58469,1,1,0, 58470
19,58466,5,5,1, 58471
23,58468,3,3,0, 58471
28,58474,5,7,1, 58481
2,58483,2,2,1, 58485
1,58486,1,1,0, 58487
5,58487,3,9,1, 58496
6,58490,2,10,1, 58500
16,58499,2,2,1, 58501
15,58501,2,4,1, 58505
13,58499,4,8,1, 58507
12,58500,5,7,1, 58507
18,58503,4,4,1, 58507
22,58506,4,4,1, 58510
24,58509,1,1,1, 58510
23,58508,3,3,1, 58511
25,58515,2,2,1, 58517
26,58517,3,3,1, 58520
28,58514,5,7,1, 58521
29,58518,4,8,1, 58526
1,58526,1,1,1, 58527
5,58527,3,9,1, 58536
9,58537,2,2,1, 58539
6,58530,2,10,1, 58540
16,58539,2,2,0, 58541
15,58541,2,4,1, 58545
20,58543,6,6,1, 58549
22,58546,4,4,1, 58550
24,58549,1,1,1, 58550
23,58548,3,3,1, 58551
25,58555,2,2,1, 58557
2,58563,2,2,1, 58565
29,58558,4,8,1, 58566
1,58566,1,1,0, 58567
6,58570,2,10,1, 58580
16,58579,2,2,0, 58581
17,58579,3,3,1, 58582
15,58581,2,4,1, 58585
13,58579,4,8,1, 58587
18,58583,4,4,1, 58587
22,58586,4,4,1, 58590
24,58589,1,1,1, 58590
23,58588,3,3,1, 58591
26,58597,3,3,1, 58600
28,58594,5,7,1, 58601
1,58606,1,1,0, 58607
5,58607,3,9,1, 58616
9,58617,2,2,1, 58619
16,58619,2,2,0, 58621
15,58621,2,4,0, 58625
22,58626,4,4,1, 58630
24,58629,1,1,0, 58630
23,58628,3,3,0, 58631
16,58659,2,2,1, 58661
15,58661,2,4,1, 58665
22,58666,4,4,0, 58670
24,58669,1,1,0, 58670
23,58668,3,3,1, 58671
16,58699,2,2,1, 58701
15,58701,2,4,0, 58705
22,58706,4,4,1, 58710
24,58709,1,1,0, 58710
23,58708,3,3,1, 58711
28,58714,5,7,1, 58721
1,58726,1,1,0, 58727
16,58739,2,2,1, 58741
17,58739,3,3,1, 58742
15,58741,2,4,0, 58745
13,58739,4,8,1, 58747
18,58743,4,4,1, 58747
22,58746,4,4,0, 58750
24,58749,1,1,1, 58750
23,58748,3,3,0, 58751
26,58757,3,3,1, 58760
28,58754,5,7,1, 58761
2,58763,2,2,1, 58765
29,58758,4,8,1, 58766
1,58766,1,1,1, 58767
5,58767,3,9,1, 58776
9,58777,2,2,1, 58779
6,58770,2,10,1, 58780
16,58779,2,2,0, 58781
15,58781,2,4,1, 58785
12,58780,5,7,1, 58787
18,58783,4,4,1, 58787
20,58783,6,6,1, 58789
22,58786,4,4,0, 58790
24,58789,1,1,0, 58790
23,58788,3,3,0, 58791
25,58795,2,2,1, 58797
28,58794,5,7,1, 58801
29,58798,4,8,1, 58806
1,58806,1,1,1, 58807
5,58807,3,9,1, 58816
9,58817,2,2,1, 58819
16,58819,2,2,1, 58821
17,58819,3,3,1, 58822
15,58821,2,4,0, 58825
12,58820,5,7,1, 58827
20,58823,6,6,1, 58829
22,58826,4,4,0, 58830
24,58829,1,1,1, 58830
19,58826,5,5,1, 58831
23,58828,3,3,0, 58831
25,58835,2,2,1, 58837
28,58834,5,7,1, 58841
2,58843,2,2,1, 58845
16,58859,2,2,0, 58861
15,58861,2,4,1, 58865
22,58866,4,4,1, 58870
24,58869,1,1,1, 58870
23,58868,3,3,1, 58871
16,58899,2,2,0, 58901
15,58901,2,4,0, 58905
22,58906,4,4,1, 58910
24,58909,1,1,1, 58910
23,58908,3,3,0, 58911
16,58939,2,2,0, 58941
15,58941,2,4,0, 58945
22,58946,4,4,1, 58950
24,58949,1,1,0, 58950
23,58948,3,3,1, 58951
28,58954,5,7,1, 58961
2,58963,2,2,1, 58965
1,58966,1,1,1, 58967
9,58977,2,2,1, 58979
12,58980,5,7,1, 58987
18,58983,4,4,1, 58987
20,58983,6,6,1, 58989
19,58986,5,5,1, 58991
23,58988,3,5,1, 58993
25,58995,2,2,1, 58997
2,59003,2,2,1, 59005
29,58998,4,8,1, 59006
1,59006,1,1,0, 59007
5,59007,3,9,1, 59016
17,59019,3,3,1, 59022
16,59019,2,4,1, 59023
15,59021,2,6,1, 59027
20,59023,6,6,1, 59029
19,59026,5,5,1, 59031
29,59038,4,8,1, 59046
1,59046,1,1,1, 59047
9,59057,2,2,1, 59059
17,59059,3,3,1, 59062
16,59059,2,4,1, 59063
13,59059,4,8,1, 59067
12,59060,5,7,1, 59067
15,59061,2,6,1, 59067
5,59167,3,9,1, 59176
9,59177,2,2,1, 59179
6,59170,2,10,1, 59180
17,59179,3,3,1, 59182
16,59179,2,4,1, 59183
13,59179,4,8,1, 59187
12,59180,5,7,1, 59187
15,59181,2,6,1, 59187
18,59183,4,4,1, 59187
22,59186,4,6,1, 59192
23,59188,3,5,1, 59193
28,59194,5,7,1, 59201
29,59198,4,8,1, 59206
1,59206,1,1,1, 59207
16,59219,2,4,1, 59223
13,59219,4,8,1, 59227
12,59220,5,7,1, 59227
20,59223,6,6,1, 59229
19,59226,5,5,1, 59231
22,59226,4,6,1, 59232
26,59237,3,3,1, 59240
28,59234,5,7,1, 59241
29,59238,4,8,1, 59246
1,59246,1,1,0, 59247
9,59257,2,2,1, 59259
6,59250,2,10,1, 59260
1,59366,1,1,0, 59367
6,59370,2,10,1, 59380
17,59379,3,3,1, 59382
13,59379,4,8,1, 59387
18,59383,4,4,1, 59387
20,59383,6,6,1, 59389
19,59386,5,5,1, 59391
23,59388,3,5,1, 59393
28,59394,5,7,1, 59401
1,59406,1,1,0, 59407
17,59419,3,3,1, 59422
12,59420,5,7,1, 59427
15,59421,2,6,1, 59427
23,59428,3,5,1, 59433
26,59437,3,3,1, 59440
1,59446,1,1,1, 59447
5,59447,3,9,1, 59456
17,59459,3,3,1, 59462
20,59463,6,6,1, 59469
19,59466,5,5,1, 59471
22,59466,4,6,1, 59472
26,59477,3,3,1, 59480
1,59486,1,1,1, 59487
9,59497,2,2,1, 59499
6,59490,2,10,1, 59500
17,59499,3,3,1, 59502
16,59499,2,4,1, 59503
13,59499,4,8,1, 59507
12,59500,5,7,1, 59507
18,59503,4,4,1, 59507
20,59503,6,6,1, 59509
19,59506,5,5,1, 59511
9,59617,2,2,1, 59619
16,59619,2,4,1, 59623
22,59626,4,6,1, 59632
25,59635,2,2,1, 59637
1,59646,1,1,1, 59647
9,59657,2,2,1, 59659
16,59659,2,4,1, 59663
15,59661,2,6,1, 59667
22,59666,4,6,1, 59672
23,59668,3,5,1, 59673
25,59675,2,2,1, 59677
2,59683,2,2,1, 59685
1,59686,1,1,1, 59687
9,59697,2,2,1, 59699
13,59699,4,8,1, 59707
12,59700,5,7,1, 59707
15,59701,2,6,1, 59707
20,59703,6,6,1, 59709
26,59717,3,3,1, 59720
29,59718,4,8,1, 59726
1,59726,1,1,1, 59727
9,59737,2,2,1, 59739
6,59730,2,10,1, 59740
13,59739,4,8,1, 59747
12,59740,5,7,1, 59747
20,59743,6,6,1, 59749
19,59746,5,5,1, 59751
22,59746,4,6,1, 59752
23,59748,3,5,1, 59753
25,59755,2,2,1, 59757
18,59863,4,4,1, 59867
20,59863,6,6,1, 59869
19,59866,5,5,1, 59871
23,59868,3,5,1, 59873
28,59874,5,7,1, 59881
2,59883,2,2,1, 59885
29,59878,4,8,1, 59886
1,59886,1,1,0, 59887
9,59897,2,2,1, 59899
16,59899,2,4,1, 59903
12,59900,5,7,1, 59907
18,59903,4,4,1, 59907
19,59906,5,5,1, 59911
22,59906,4,6,1, 59912
23,59908,3,5,1, 59913
26,59917,3,3,1, 59920
2,59923,2,2,1, 59925
1,59926,1,1,1, 59927
5,59927,3,9,1, 59936
6,59930,2,10,1, 59940
17,59939,3,3,1, 59942
1,60046,1,1,0, 60047
5,60047,3,9,1, 60056
9,60057,2,2,1, 60059
20,60063,6,6,1, 60069
25,60075,2,2,1, 60077
26,60077,3,3,1, 60080
28,60074,5,7,1, 60081
1,60086,1,1,0, 60087
5,60087,3,9,1, 60096
6,60090,2,10,1, 60100
12,60100,5,7,1, 60107
20,60103,6,6,1, 60109
19,60106,5,5,1, 60111
25,60115,2,2,1, 60117
26,60117,3,3,1, 60120
28,60114,5,7,1, 60121
2,60123,2,2,1, 60125
1,60126,1,1,0, 60127
5,60127,3,9,1, 60136
6,60130,2,10,1, 60140
17,60139,3,3,1, 60142
15,60141,2,6,1, 60147
20,60143,6,6,1, 60149
19,60146,5,5,1, 60151
23,60148,3,5,1, 60153
29,60158,4,8,1, 60166
1,60166,1,1,1, 60167
5,60167,3,9,1, 60176
9,60177,2,2,1, 60179
1,60286,1,1,1, 60287
17,60299,3,3,1, 60302
16,60299,2,4,1, 60303
15,60301,2,6,1, 60307
18,60303,4,4,1, 60307
20,60303,6,6,1, 60309
26,60317,3,3,1, 60320
1,60326,1,1,1, 60327
9,60337,2,2,1, 60339
16,60339,2,4,1, 60343
15,60341,2,6,1, 60347
19,60346,5,5,1, 60351
22,60346,4,6,1, 60352
23,60348,3,5,1, 60353
25,60355,2,2,1, 60357
28,60354,5,7,1, 60361
1,60366,1,1,0, 60367
17,60379,3,3,1, 60382
16,60379,2,4,1, 60383
12,60380,5,7,1, 60387
18,60383,4,4,1, 60387
23,60388,3,5,1, 60393
1,60406,1,1,0, 60407
17,60419,3,3,1, 60422
13,60419,4,8,1, 60427
12,60420,5,7,1, 60427
18,60423,4,4,1, 60427
19,60426,5,5,1, 60431
23,60428,3,5,1, 60433
25,60435,2,2,1, 60437
26,60437,3,3,1, 60440
12,60540,5,7,1, 60547
15,60541,2,6,1, 60547
20,60543,6,6,1, 60549
19,60546,5,5,1, 60551
23,60548,3,5,1, 60553
25,60555,2,2,1, 60557
26,60557,3,3,1, 60560
29,60558,4,8,1, 60566
1,60566,1,1,1, 60567
6,60570,2,10,1, 60580
17,60579,3,3,1, 60582
13,60579,4,8,1, 60587
15,60581,2,6,1, 60587
18,60583,4,4,1, 60587
20,60583,6,6,1, 60589
19,60586,5,5,1, 60591
23,60588,3,5,1, 60593
26,60597,3,3,1, 60600
28,60594,5,7,1, 60601
29,60598,4,8,1, 60606
1,60606,1,1,0, 60607
16,60619,2,4,1, 60623
15,60621,2,6,1, 60627
25,60635,2,2,1, 60637
1,60646,1,1,1, 60647
16,60659,2,4,1, 60663
23,60668,3,5,1, 60673
26,60677,3,3,1, 60680
1,60686,1,1,0, 60687
17,60699,3,3,1, 60702
19,60706,5,5,1, 60711
22,60706,4,6,1, 60712
23,60708,3,5,1, 60713
26,60717,3,3,1, 60720
1,60726,1,1,1, 60727
5,60727,3,9,1, 60736
16,60739,2,4,1, 60743
12,60740,5,7,1, 60747
15,60741,2,6,1, 60747
1,60886,1,1,0, 60887
25,60915,2,2,1, 60917
1,60926,1,1,1, 60927
15,60941,2,6,1, 60947
18,60943,4,4,1, 60947
22,60946,4,6,1, 60952
25,60955,2,2,1, 60957
26,60957,3,3,1, 60960
28,60954,5,7,1, 60961
1,60966,1,1,1, 60967
9,60977,2,2,1, 60979
17,60979,3,3,1, 60982
16,60979,2,4,1, 60983
13,60979,4,8,1, 60987
22,60986,4,6,1, 60992
25,60995,2,2,1, 60997
26,60997,3,3,1, 61000
1,61006,1,1,0, 61007
5,61007,3,9,1, 61016
9,61017,2,2,1, 61019
17,61019,3,3,1, 61022
12,61020,5,7,1, 61027
20,61023,6,6,1, 61029
23,61028,3,5,1, 61033
28,61034,5,7,1, 61041
1,61046,1,1,0, 61047
5,61047,3,9,1, 61056
13,61059,4,8,1, 61067
18,61063,4,4,1, 61067
20,61063,6,6,1, 61069
26,61077,3,3,1, 61080
28,61074,5,7,1, 61081
29,61078,4,8,1, 61086
1,61086,1,1,0, 61087
5,61087,3,9,1, 61096
9,61097,2,2,1, 61099
16,61099,2,4,1, 61103
13,61099,4,8,1, 61107
12,61100,5,7,1, 61107
15,61101,2,6,1, 61107
19,61106,5,5,1, 61111
25,61115,2,2,1, 61117
28,61114,5,7,1, 61121
1,61126,1,1,0, 61127
9,61137,2,2,1, 61139
6,61130,2,10,1, 61140
12,61140,5,7,1, 61147
25,61155,2,2,1, 61157
26,61157,3,3,1, 61160
1,61166,1,1,0, 61167
25,61195,2,2,1, 61197
1,61206,1,1,0, 61207
25,61235,2,2,1, 61237
26,61237,3,3,1, 61240
1,61246,1,1,0, 61247
5,61247,3,9,1, 61256
9,61257,2,2,1, 61259
6,61250,2,10,1, 61260
12,61260,5,7,1, 61267
26,61277,3,3,1, 61280
1,61286,1,1,0, 61287
9,61297,2,2,1, 61299
1,61326,1,1,0, 61327
25,61355,2,2,1, 61357
1,61366,1,1,0, 61367
6,61370,2,10,1, 61380
12,61380,5,7,1, 61387
15,61381,2,6,1, 61387
18,61383,4,4,1, 61387
22,61386,4,6,1, 61392
23,61388,3,5,1, 61393
26,61397,3,3,1, 61400
28,61394,5,7,1, 61401
1,61406,1,1,0, 61407
5,61407,3,9,1, 61416
9,61417,2,2,1, 61419
6,61410,2,10,1, 61420
17,61419,3,3,1, 61422
13,61419,4,8,1, 61427
15,61421,2,6,1, 61427
18,61423,4,4,1, 61427
20,61423,6,6,1, 61429
23,61428,3,5,1, 61433
26,61437,3,3,1, 61440
25,61555,2,2,1, 61557
26,61557,3,3,1, 61560
1,61566,1,1,1, 61567
1,61606,1,1,0, 61607
5,61607,3,9,1, 61616
6,61610,2,10,1, 61620
17,61619,3,3,1, 61622
13,61619,4,8,1, 61627
12,61620,5,7,1, 61627
18,61623,4,4,1, 61627
20,61623,6,6,1, 61629
22,61626,4,6,1, 61632
23,61628,3,5,1, 61633
26,61637,3,3,1, 61640
29,61638,4,8,1, 61646
1,61646,1,1,1, 61647
9,61657,2,2,1, 61659
6,61650,2,10,1, 61660
17,61659,3,3,1, 61662
13,61659,4,8,1, 61667
15,61661,2,6,1, 61667
19,61666,5,5,1, 61671
22,61666,4,6,1, 61672
25,61675,2,2,1, 61677
29,61678,4,8,1, 61686
1,61686,1,1,1, 61687
9,61697,2,2,1, 61699
6,61690,2,10,1, 61700
13,61699,4,8,1, 61707
18,61703,4,4,1, 61707
20,61703,6,6,1, 61709
22,61706,4,6,1, 61712
25,61715,2,2,1, 61717
26,61717,3,3,1, 61720
28,61714,5,7,1, 61721
29,61718,4,8,1, 61726
25,61835,2,2,1, 61837
1,61846,1,1,1, 61847
9,61857,2,2,1, 61859
6,61850,2,10,1, 61860
16,61859,2,4,1, 61863
13,61859,4,8,1, 61867
12,61860,5,7,1, 61867
20,61863,6,6,1, 61869
19,61866,5,5,1, 61871
26,61877,3,3,1, 61880
28,61874,5,7,1, 61881
1,61886,1,1,0, 61887
5,61887,3,9,1, 61896
16,61899,2,4,1, 61903
15,61901,2,6,1, 61907
19,61906,5,5,1, 61911
22,61906,4,6,1, 61912
25,61915,2,2,1, 61917
26,61917,3,3,1, 61920
1,61926,1,1,1, 61927
9,61937,2,2,1, 61939
6,61930,2,10,1, 61940
17,61939,3,3,1, 61942
15,61941,2,6,1, 61947
19,61946,5,5,1, 61951
22,61946,4,6,1, 61952
23,61948,3,5,1, 61953
25,61955,2,2,1, 61957
29,61958,4,8,1, 61966
1,61966,1,1,1, 61967
16,61979,2,4,1, 61983
13,61979,4,8,1, 61987
6,62090,2,10,1, 62100
17,62099,3,3,1, 62102
15,62101,2,6,1, 62107
18,62103,4,4,1, 62107
20,62103,6,6,1, 62109
23,62108,3,5,1, 62113
25,62115,2,2,1, 62117
29,62118,4,8,1, 62126
1,62126,1,1,1, 62127
5,62127,3,9,1, 62136
6,62130,2,10,1, 62140
17,62139,3,3,1, 62142
13,62139,4,8,1, 62147
12,62140,5,7,1, 62147
19,62146,5,5,1, 62151
22,62146,4,6,1, 62152
23,62148,3,5,1, 62153
25,62155,2,2,1, 62157
26,62157,3,3,1, 62160
28,62154,5,7,1, 62161
1,62166,1,1,0, 62167
9,62177,2,2,1, 62179
6,62170,2,10,1, 62180
18,62183,4,4,1, 62187
25,62315,2,2,1, 62317
1,62326,1,1,0, 62327
9,62337,2,2,1, 62339
1,62366,1,1,0, 62367
9,62377,2,2,1, 62379
19,62386,5,5,1, 62391
22,62386,4,6,1, 62392
1,62406,1,1,0, 62407
6,62410,2,10,1, 62420
18,62423,4,4,1, 62427
22,62426,4,6,1, 62432
26,62437,3,3,1, 62440
1,62446,1,1,0, 62447
9,62457,2,2,1, 62459
6,62450,2,10,1, 62460
16,62459,2,4,1, 62463
12,62460,5,7,1, 62467
25,62475,2,2,1, 62477
26,62477,3,3,1, 62480
28,62474,5,7,1, 62481
1,62486,1,1,0, 62487
5,62487,3,9,1, 62496
9,62497,2,2,1, 62499
16,62499,2,4,1, 62503
12,62500,5,7,1, 62507
15,62501,2,6,1, 62507
22,62506,4,6,1, 62512
23,62508,3,5,1, 62513
25,62515,2,2,1, 62517
1,62526,1,1,1, 62527
5,62527,3,9,1, 62536
16,62539,2,4,1, 62543
13,62539,4,8,1, 62547
15,62541,2,6,1, 62547
20,62543,6,6,1, 62549
23,62548,3,5,1, 62553
28,62554,5,7,1, 62561
29,62558,4,8,1, 62566
1,62566,1,1,1, 62567
9,62577,2,2,1, 62579
6,62570,2,10,1, 62580
13,62579,4,8,1, 62587
12,62580,5,7,1, 62587
15,62581,2,6,1, 62587
19,62586,5,5,1, 62591
22,62586,4,6,1, 62592
25,62595,2,2,1, 62597
29,62598,4,8,1, 62606
1,62606,1,1,1, 62607
9,62617,2,2,1, 62619
6,62610,2,10,1, 62620
13,62619,4,8,1, 62627
12,62620,5,7,1, 62627
25,62635,2,2,1, 62637
1,62646,1,1,1, 62647
9,62657,2,2,1, 62659
26,62677,3,3,1, 62680
1,62686,1,1,0, 62687
9,62697,2,2,1, 62699
1,62726,1,1,1, 62727
17,62739,3,3,1, 62742
16,62739,2,4,1, 62743
22,62746,4,6,1, 62752
25,62755,2,2,1, 62757
26,62757,3,3,1, 62760
28,62754,5,7,1, 62761
1,62766,1,1,0, 62767
5,62767,3,9,1, 62776
9,62777,2,2,1, 62779
6,62770,2,10,1, 62780
16,62779,2,4,1, 62783
18,62783,4,4,1, 62787
20,62783,6,6,1, 62789
9,62897,2,2,1, 62899
6,62890,2,10,1, 62900
17,62899,3,3,1, 62902
18,62903,4,4,1, 62907
13,62899,4,10,1, 62909
19,62906,5,5,1, 62911
25,62915,2,2,1, 62917
26,62917,3,3,1, 62920
1,62926,1,1,1, 62927
5,62927,3,9,1, 62936
6,62930,2,10,1, 62940
20,62943,6,6,1, 62949
19,62946,5,5,1, 62951
25,62955,2,2,1, 62957
1,62966,1,1,0, 62967
17,62979,3,3,1, 62982
18,62983,4,4,1, 62987
19,62986,5,5,1, 62991
26,62997,3,3,1, 63000
29,62998,4,8,1, 63006
1,63006,1,1,0, 63007
5,63007,3,9,1, 63016
6,63010,2,10,1, 63020
17,63019,3,3,1, 63022
18,63023,4,4,1, 63027
20,63023,6,6,1, 63029
28,63034,5,7,1, 63041
1,63046,1,1,0, 63047
18,63063,4,4,1, 63067
25,63075,2,2,1, 63077
28,63074,5,7,1, 63081
1,63086,1,1,0, 63087
5,63087,3,9,1, 63096
17,63099,3,3,1, 63102
25,63115,2,2,1, 63117
28,63114,5,7,1, 63121
29,63118,4,8,1, 63126
1,63126,1,1,0, 63127
5,63127,3,9,1, 63136
9,63137,2,2,1, 63139
6,63130,2,10,1, 63140
17,63139,3,3,1, 63142
5,63247,3,9,1, 63256
6,63250,2,10,1, 63260
17,63259,3,3,1, 63262
18,63263,4,4,1, 63267
20,63263,6,6,1, 63269
28,63274,5,7,1, 63281
29,63278,4,8,1, 63286
1,63286,1,1,1, 63287
5,63287,3,9,1, 63296
6,63290,2,10,1, 63300
17,63299,3,3,1, 63302
18,63303,4,4,1, 63307
13,63299,4,10,1, 63309
20,63303,6,6,1, 63309
26,63317,3,3,1, 63320
1,63326,1,1,0, 63327
9,63337,2,2,1, 63339
1,63366,1,1,1, 63367
1,63406,1,1,0, 63407
9,63417,2,2,1, 63419
17,63419,3,3,1, 63422
13,63419,4,10,1, 63429
19,63426,5,5,1, 63431
25,63435,2,2,1, 63437
26,63437,3,3,1, 63440
28,63434,5,7,1, 63441
29,63438,4,8,1, 63446
1,63446,1,1,0, 63447
5,63447,3,9,1, 63456
17,63459,3,3,1, 63462
20,63463,6,6,1, 63469
19,63466,5,5,1, 63471
1,63486,1,1,0, 63487
5,63487,3,9,1, 63496
6,63490,2,10,1, 63500
20,63503,6,6,1, 63509
19,63506,5,5,1, 63511
25,63515,2,2,1, 63517
26,63517,3,3,1, 63520
29,63518,4,8,1, 63526
1,63526,1,1,1, 63527
6,63530,2,10,1, 63540
17,63539,3,3,1, 63542
19,63546,5,5,1, 63551
26,63557,3,3,1, 63560
28,63554,5,7,1, 63561
29,63558,4,8,1, 63566
1,63566,1,1,1, 63567
5,63567,3,9,1, 63576
9,63577,2,2,1, 63579
6,63570,2,10,1, 63580
18,63583,4,4,1, 63587
13,63579,4,10,1, 63589
19,63586,5,5,1, 63591
25,63715,2,2,1, 63717
26,63717,3,3,1, 63720
1,63726,1,1,1, 63727
9,63737,2,2,1, 63739
25,63755,2,2,1, 63757
1,63766,1,1,1, 63767
18,63783,4,4,1, 63787
20,63783,6,6,1, 63789
26,63797,3,3,1, 63800
28,63794,5,7,1, 63801
1,63806,1,1,0, 63807
5,63807,3,9,1, 63816
17,63819,3,3,1, 63822
18,63823,4,4,1, 63827
13,63819,4,10,1, 63829
26,63837,3,3,1, 63840
1,63846,1,1,1, 63847
5,63847,3,9,1, 63856
9,63857,2,2,1, 63859
18,63863,4,4,1, 63867
13,63859,4,10,1, 63869
29,63878,4,8,1, 63886
1,63886,1,1,0, 63887
6,63890,2,10,1, 63900
18,63903,4,4,1, 63907
13,63899,4,10,1, 63909
20,63903,6,6,1, 63909
28,63914,5,7,1, 63921
29,63918,4,8,1, 63926
1,63926,1,1,1, 63927
5,63927,3,9,1, 63936
9,63937,2,2,1, 63939
17,63939,3,3,1, 63942
18,63943,4,4,1, 63947
20,63943,6,6,1, 63949
28,63954,5,7,1, 63961
29,63958,4,8,1, 63966
1,63966,1,1,0, 63967
5,63967,3,9,1, 63976
6,63970,2,10,1, 63980
20,63983,6,6,1, 63989
19,63986,5,5,1, 63991
25,63995,2,2,1, 63997
26,63997,3,3,1, 64000
28,63994,5,7,1, 64001
29,63998,4,8,1, 64006
1,64006,1,1,0, 64007
9,64017,2,2,1, 64019
6,64010,2,10,1, 64020
13,64019,4,10,1, 64029
20,64023,6,6,1, 64029
19,64026,5,5,1, 64031
26,64037,3,3,1, 64040
29,64038,4,8,1, 64046
1,64046,1,1,1, 64047
9,64057,2,2,1, 64059
20,64063,6,6,1, 64069
19,64066,5,5,1, 64071
9,64177,2,2,1, 64179
17,64179,3,3,1, 64182
18,64183,4,4,1, 64187
25,64195,2,2,1, 64197
28,64194,5,7,1, 64201
1,64206,1,1,0, 64207
5,64207,3,9,1, 64216
18,64223,4,4,1, 64227
20,64223,6,6,1, 64229
25,64235,2,2,1, 64237
28,64234,5,7,1, 64241
29,64238,4,8,1, 64246
1,64246,1,1,1, 64247
9,64257,2,2,1, 64259
6,64250,2,10,1, 64260
17,64259,3,3,1, 64262
18,64263,4,4,1, 64267
20,64263,6,6,1, 64269
26,64277,3,3,1, 64280
29,64278,4,8,1, 64286
1,64286,1,1,0, 64287
5,64287,3,9,1, 64296
6,64290,2,10,1, 64300
17,64299,3,3,1, 64302
18,64303,4,4,1, 64307
20,64303,6,6,1, 64309
19,64306,5,5,1, 64311
26,64317,3,3,1, 64320
28,64314,5,7,1, 64321
13,64419,4,10,1, 64429
20,64423,6,6,1, 64429
25,64435,2,2,1, 64437
29,64438,4,8,1, 64446
1,64446,1,1,1, 64447
9,64457,2,2,1, 64459
6,64450,2,10,1, 64460
17,64459,3,3,1, 64462
18,64463,4,4,1, 64467
20,64463,6,6,1, 64469
19,64466,5,5,1, 64471
26,64477,3,3,1, 64480
28,64474,5,7,1, 64481
1,64486,1,1,1, 64487
9,64497,2,2,1, 64499
17,64499,3,3,1, 64502
20,64503,6,6,1, 64509
26,64517,3,3,1, 64520
29,64518,4,8,1, 64526
1,64526,1,1,1, 64527
5,64527,3,9,1, 64536
9,64537,2,2,1, 64539
13,64539,4,10,1, 64549
20,64543,6,6,1, 64549
25,64555,2,2,1, 64557
1,64566,1,1,0, 64567
20,64583,6,6,1, 64589
25,64595,2,2,1, 64597
28,64594,5,7,1, 64601
1,64606,1,1,0, 64607
18,64623,4,4,1, 64627
20,64623,6,6,1, 64629
25,64635,2,2,1, 64637
29,64638,4,8,1, 64646
1,64646,1,1,0, 64647
6,64650,2,10,1, 64660
17,64659,3,3,1, 64662
18,64663,4,4,1, 64667
25,64675,2,2,1, 64677
28,64674,5,7,1, 64681
29,64678,4,8,1, 64686
1,64686,1,1,0, 64687
5,64687,3,9,1, 64696
9,64697,2,2,1, 64699
6,64690,2,10,1, 64700
29,64798,4,8,1, 64806
1,64806,1,1,1, 64807
5,64807,3,9,1, 64816
6,64810,2,10,1, 64820
17,64819,3,3,1, 64822
13,64819,4,10,1, 64829
20,64823,6,6,1, 64829
19,64826,5,5,1, 64831
26,64837,3,3,1, 64840
28,64834,5,7,1, 64841
29,64838,4,8,1, 64846
1,64846,1,1,1, 64847
9,64857,2,2,1, 64859
6,64850,2,10,1, 64860
13,64859,4,10,1, 64869
26,64877,3,3,1, 64880
1,64886,1,1,1, 64887
17,64899,3,3,1, 64902
25,64915,2,2,1, 64917
1,64926,1,1,0, 64927
1,64966,1,1,0, 64967
9,64977,2,2,1, 64979
6,64970,2,10,1, 64980
26,64997,3,3,1, 65000
1,65006,1,1,1, 65007
17,65019,3,3,1, 65022
1,65046,1,1,1, 65047
9,65057,2,2,1, 65059
26,65077,3,3,1, 65080
1,65086,1,1,1, 65087
9,65097,2,2,1, 65099
17,65099,3,3,1, 65102
26,65117,3,3,1, 65120
1,65126,1,1,0, 65127
9,65137,2,2,1, 65139
25,65155,2,2,1, 65157
1,65166,1,1,1, 65167
17,65179,3,3,1, 65182
26,65197,3,3,1, 65200
1,65206,1,1,0, 65207
25,65235,2,2,1, 65237
26,65237,3,3,1, 65240
1,65246,1,1,1, 65247
17,65259,3,3,1, 65262
25,65275,2,2,1, 65277
1,65286,1,1,1, 65287
9,65297,2,2,1, 65299
1,65326,1,1,0, 65327
9,65337,2,2,1, 65339
25,65355,2,2,1, 65357
1,65366,1,1,0, 65367
9,65377,2,2,1, 65379
25,65395,2,2,1, 65397
1,65406,1,1,0, 65407
17,65419,3,3,1, 65422
25,65435,2,2,1, 65437
1,65446,1,1,1, 65447
9,65457,2,2,1, 65459
25,65475,2,2,1, 65477
26,65477,3,3,1, 65480
1,65486,1,1,0, 65487
25,65515,2,2,1, 65517
26,65517,3,3,1, 65520
1,65526,1,1,0, 65527
9,65537,2,2,1, 65539
17,65539,3,3,1, 65542
26,65557,3,3,1, 65560
1,65566,1,1,1, 65567
9,65577,2,2,1, 65579
1,65606,1,1,1, 65607
9,65617,2,2,1, 65619
1,65646,1,1,0, 65647
9,65657,2,2,1, 65659
17,65659,3,3,1, 65662
25,65675,2,2,1, 65677
1,65686,1,1,0, 65687
25,65715,2,2,1, 65717
1,65726,1,1,0, 65727
9,65737,2,2,1, 65739
26,65757,3,3,1, 65760
1,65766,1,1,1, 65767
9,65777,2,2,1, 65779
17,65779,3,3,1, 65782
25,65795,2,2,1, 65797
1,65806,1,1,1, 65807
9,65817,2,2,1, 65819
26,65837,3,3,1, 65840
1,65846,1,1,0, 65847
9,65857,2,2,1, 65859
17,65859,3,3,1, 65862
26,65877,3,3,1, 65880
1,65886,1,1,1, 65887
25,65915,2,2,1, 65917
26,65917,3,3,1, 65920
1,65926,1,1,0, 65927
17,65939,3,3,1, 65942
25,65955,2,2,1, 65957
1,65966,1,1,0, 65967
17,65979,3,3,1, 65982
26,65997,3,3,1, 66000
1,66006,1,1,1, 66007
17,66019,3,3,1, 66022
1,66046,1,1,0, 66047
9,66057,2,2,0, 66059
17,66059,3,3,1, 66062
25,66075,2,2,1, 66077
26,66077,3,3,0, 66080
1,66086,1,1,0, 66087
9,66097,2,2,0, 66099
17,66099,3,3,1, 66102
25,66115,2,2,1, 66117
26,66117,3,3,0, 66120
1,66126,1,1,1, 66127
9,66137,2,2,1, 66139
17,66139,3,3,1, 66142
25,66155,2,2,0, 66157
26,66157,3,3,0, 66160
1,66166,1,1,0, 66167
9,66177,2,2,1, 66179
17,66179,3,3,0, 66182
25,66195,2,2,0, 66197
26,66197,3,3,1, 66200
1,66206,1,1,0, 66207
9,66217,2,2,0, 66219
17,66219,3,3,1, 66222
25,66235,2,2,0, 66237
26,66237,3,3,1, 66240
1,66246,1,1,1, 66247
9,66257,2,2,0, 66259
17,66259,3,3,0, 66262
25,66275,2,2,1, 66277
26,66277,3,3,1, 66280
1,66286,1,1,1, 66287
9,66297,2,2,1, 66299
17,66299,3,3,0, 66302
25,66315,2,2,1, 66317
26,66317,3,3,0, 66320
1,66326,1,1,0, 66327
9,66337,2,2,0, 66339
17,66339,3,3,0, 66342
25,66355,2,2,1, 66357
26,66357,3,3,1, 66360
1,66366,1,1,1, 66367
9,66377,2,2,1, 66379
17,66379,3,3,0, 66382
25,66395,2,2,0, 66397
26,66397,3,3,0, 66400
1,66406,1,1,0, 66407
9,66417,2,2,0, 66419
17,66419,3,3,0, 66422
25,66435,2,2,1, 66437
26,66437,3,3,1, 66440
1,66446,1,1,0, 66447
9,66457,2,2,0, 66459
17,66459,3,3,0, 66462
25,66475,2,2,0, 66477
26,66477,3,3,0, 66480
1,66486,1,1,0, 66487
9,66497,2,2,0, 66499
17,66499,3,3,0, 66502
25,66515,2,2,0, 66517
26,66517,3,3,0, 66520
1,66526,1,1,1, 66527
9,66537,2,2,0, 66539
17,66539,3,3,0, 66542
25,66555,2,2,1, 66557
26,66557,3,3,0, 66560
1,66566,1,1,0, 66567
9,66577,2,2,0, 66579
17,66579,3,3,0, 66582
25,66595,2,2,1, 66597
26,66597,3,3,0, 66600
1,66606,1,1,0, 66607
9,66617,2,2,0, 66619
17,66619,3,3,1, 66622
25,66635,2,2,0, 66637
26,66637,3,3,1, 66640
1,66646,1,1,1, 66647
9,66657,2,2,0, 66659
17,66659,3,3,1, 66662
25,66675,2,2,1, 66677
26,66677,3,3,0, 66680
1,66686,1,1,0, 66687
9,66697,2,2,1, 66699
17,66699,3,3,0, 66702
25,66715,2,2,1, 66717
26,66717,3,3,0, 66720
1,66726,1,1,0, 66727
9,66737,2,2,1, 66739
17,66739,3,3,0, 66742
25,66755,2,2,1, 66757
26,66757,3,3,0, 66760
1,66766,1,1,0, 66767
9,66777,2,2,1, 66779
17,66779,3,3,0, 66782
25,66795,2,2,1, 66797
26,66797,3,3,1, 66800
1,66806,1,1,0, 66807
9,66817,2,2,0, 66819
17,66819,3,3,0, 66822
25,66835,2,2,0, 66837
26,66837,3,3,1, 66840
1,66846,1,1,0, 66847
9,66857,2,2,0, 66859
17,66859,3,3,1, 66862
25,66875,2,2,1, 66877
1,66886,1,1,1, 66887
9,66897,2,2,1, 66899
17,66899,3,3,0, 66902
25,66915,2,2,0, 66917
1,66926,1,1,0, 66927
9,66937,2,2,0, 66939
17,66939,3,3,0, 66942
25,66955,2,2,1, 66957
1,66966,1,1,1, 66967
9,66977,2,2,0, 66979
17,66979,3,3,0, 66982
25,66995,2,2,0, 66997
1,67006,1,1,1, 67007
9,67017,2,2,0, 67019
17,67019,3,3,0, 67022
25,67035,2,2,0, 67037
1,67046,1,1,0, 67047
9,67057,2,2,1, 67059
17,67059,3,3,1, 67062
25,67075,2,2,0, 67077
1,67086,1,1,0, 67087
9,67097,2,2,1, 67099
17,67099,3,3,0, 67102
25,67115,2,2,1, 67117
1,67126,1,1,1, 67127
9,67137,2,2,0, 67139
17,67139,3,3,1, 67142
25,67155,2,2,0, 67157
1,67166,1,1,1, 67167
9,67177,2,2,1, 67179
17,67179,3,3,0, 67182
25,67195,2,2,1, 67197
1,67206,1,1,0, 67207
9,67217,2,2,1, 67219
17,67219,3,3,0, 67222
25,67235,2,2,1, 67237
1,67246,1,1,0, 67247
9,67257,2,2,0, 67259
17,67259,3,3,0, 67262
25,67275,2,2,0, 67277
1,67286,1,1,0, 67287
9,67297,2,2,0, 67299
17,67299,3,3,1, 67302
25,67315,2,2,1, 67317
1,67326,1,1,0, 67327
9,67337,2,2,1, 67339
17,67339,3,3,0, 67342
25,67355,2,2,0, 67357
1,67366,1,1,1, 67367
9,67377,2,2,0, 67379
17,67379,3,3,0, 67382
25,67395,2,2,1, 67397
1,67406,1,1,1, 67407
9,67417,2,2,1, 67419
17,67419,3,3,0, 67422
25,67435,2,2,1, 67437
1,67446,1,1,0, 67447
9,67457,2,2,1, 67459
17,67459,3,3,0, 67462
25,67475,2,2,1, 67477
1,67486,1,1,1, 67487
9,67497,2,2,1, 67499
17,67499,3,3,0, 67502
25,67515,2,2,1, 67517
1,67526,1,1,0, 67527
9,67537,2,2,0, 67539
17,67539,3,3,0, 67542
25,67555,2,2,1, 67557
1,67566,1,1,1, 67567
9,67577,2,2,1, 67579
17,67579,3,3,0, 67582
25,67595,2,2,1, 67597
1,67606,1,1,1, 67607
25,67635,2,2,0, 67637
1,67646,1,1,1, 67647
25,67675,2,2,1, 67677
1,67686,1,1,1, 67687
25,67715,2,2,1, 67717
1,67726,1,1,0, 67727
17,67739,3,3,1, 67742
25,67755,2,2,0, 67757
1,67766,1,1,0, 67767
17,67779,3,3,1, 67782
25,67795,2,2,0, 67797
1,67806,1,1,0, 67807
17,67819,3,3,0, 67822
25,67835,2,2,1, 67837
1,67846,1,1,0, 67847
17,67859,3,3,0, 67862
25,67875,2,2,1, 67877
1,67886,1,1,0, 67887
17,67899,3,3,0, 67902
25,67915,2,2,0, 67917
1,67926,1,1,0, 67927
17,67939,3,3,0, 67942
25,67955,2,2,1, 67957
1,67966,1,1,0, 67967
17,67979,3,3,1, 67982
25,67995,2,2,0, 67997
1,68006,1,1,0, 68007
17,68019,3,3,0, 68022
25,68035,2,2,0, 68037
1,68046,1,1,0, 68047
17,68059,3,3,1, 68062
25,68075,2,2,1, 68077
1,68086,1,1,0, 68087
17,68099,3,3,0, 68102
25,68115,2,2,1, 68117
1,68126,1,1,1, 68127
