source,gentime, athop, hopcount,priority, reachedTime
2,3,2,2,1, 5
1,6,1,1,0, 7
4,6,4,4,1, 10
3,7,3,3,1, 10
5,7,3,3,1, 10
6,10,2,2,1, 12
7,12,1,1,1, 13
8,16,1,1,1, 17
11,14,4,4,0, 18
9,17,2,2,0, 19
16,19,2,2,0, 21
14,19,3,3,0, 22
17,19,3,3,1, 22
13,19,4,4,0, 23
15,21,2,2,0, 23
12,20,5,5,1, 25
20,23,6,6,0, 29
22,26,4,4,0, 30
24,29,1,1,0, 30
19,26,5,5,0, 31
23,28,3,3,1, 31
21,27,5,5,1, 32
2,33,2,2,0, 35
27,32,4,4,0, 36
30,33,3,3,1, 36
25,35,2,2,0, 37
1,36,1,1,1, 37
31,36,2,2,1, 38
28,34,5,5,1, 39
4,36,4,4,0, 40
3,37,3,3,1, 40
5,37,3,3,0, 40
26,37,3,3,0, 40
29,38,4,4,1, 42
6,40,2,2,0, 42
7,42,1,1,1, 43
8,46,1,1,0, 47
11,44,4,4,1, 48
9,47,2,2,0, 49
16,49,2,2,1, 51
14,49,3,3,0, 52
17,49,3,3,0, 52
13,49,4,4,0, 53
15,51,2,2,1, 53
12,50,5,5,1, 55
20,53,6,6,1, 59
22,56,4,4,0, 60
24,59,1,1,1, 60
19,56,5,5,1, 61
23,58,3,3,1, 61
21,57,5,5,0, 62
2,63,2,2,0, 65
27,62,4,4,0, 66
30,63,3,3,1, 66
25,65,2,2,0, 67
1,66,1,1,0, 67
31,66,2,2,0, 68
28,64,5,5,0, 69
4,66,4,4,1, 70
3,67,3,3,1, 70
5,67,3,3,0, 70
26,67,3,3,0, 70
29,68,4,4,0, 72
6,70,2,2,0, 72
7,72,1,1,1, 73
8,76,1,1,1, 77
11,74,4,4,1, 78
9,77,2,2,0, 79
16,79,2,2,0, 81
14,79,3,3,0, 82
17,79,3,3,0, 82
13,79,4,4,1, 83
15,81,2,2,0, 83
12,80,5,5,0, 85
18,83,4,4,0, 87
20,83,6,6,1, 89
22,86,4,4,0, 90
24,89,1,1,1, 90
19,86,5,5,0, 91
23,88,3,3,1, 91
21,87,5,5,0, 92
2,93,2,2,1, 95
27,92,4,4,1, 96
30,93,3,3,0, 96
25,95,2,2,1, 97
1,96,1,1,1, 97
31,96,2,2,1, 98
28,94,5,5,0, 99
4,96,4,4,0, 100
3,97,3,3,0, 100
5,97,3,3,0, 100
26,97,3,3,0, 100
29,98,4,4,0, 102
6,100,2,2,1, 102
7,102,1,1,0, 103
8,106,1,1,0, 107
11,104,4,4,1, 108
9,107,2,2,1, 109
16,109,2,2,1, 111
14,109,3,3,0, 112
17,109,3,3,0, 112
13,109,4,4,0, 113
15,111,2,2,1, 113
12,110,5,5,1, 115
18,113,4,4,1, 117
20,113,6,6,1, 119
22,116,4,4,1, 120
24,119,1,1,0, 120
19,116,5,5,1, 121
23,118,3,3,0, 121
21,117,5,5,1, 122
30,123,3,3,1, 126
25,125,2,2,1, 127
1,126,1,1,0, 127
31,126,2,2,0, 128
28,124,5,5,1, 129
4,126,4,4,1, 130
3,127,3,3,1, 130
5,127,3,3,0, 130
26,127,3,3,1, 130
29,128,4,4,1, 132
6,130,2,2,0, 132
7,132,1,1,0, 133
8,136,1,1,0, 137
11,134,4,4,1, 138
9,137,2,2,1, 139
16,139,2,2,1, 141
14,139,3,3,0, 142
13,139,4,4,1, 143
15,141,2,2,0, 143
18,143,4,4,1, 147
20,143,6,6,1, 149
22,146,4,4,1, 150
24,149,1,1,0, 150
23,148,3,3,1, 151
21,147,5,5,0, 152
27,152,4,4,1, 156
30,153,3,3,1, 156
25,155,2,2,1, 157
1,156,1,1,0, 157
31,156,2,2,1, 158
4,156,4,4,1, 160
3,157,3,3,1, 160
5,157,3,3,0, 160
26,157,3,3,1, 160
29,158,4,4,0, 162
6,160,2,2,1, 162
7,162,1,1,0, 163
8,166,1,1,1, 167
16,169,2,2,1, 171
14,169,3,3,0, 172
17,169,3,3,1, 172
13,169,4,4,1, 173
15,171,2,2,0, 173
18,173,4,4,1, 177
20,173,6,6,1, 179
22,176,4,4,1, 180
24,179,1,1,1, 180
19,176,5,5,1, 181
23,178,3,3,0, 181
21,177,5,5,1, 182
30,183,3,3,1, 186
25,185,2,2,1, 187
28,184,5,5,1, 189
5,187,3,3,1, 190
26,187,3,3,0, 190
6,190,2,2,1, 192
7,192,1,1,0, 193
8,196,1,1,0, 197
16,199,2,2,1, 201
14,199,3,3,1, 202
13,199,4,4,1, 203
15,201,2,2,1, 203
12,200,5,5,1, 205
20,203,6,6,1, 209
24,209,1,1,1, 210
19,206,5,5,1, 211
23,208,3,3,1, 211
25,215,2,2,0, 217
31,216,2,2,1, 218
5,217,3,3,1, 220
26,217,3,3,0, 220
29,218,4,4,1, 222
7,222,1,1,0, 223
8,226,1,1,0, 227
9,227,2,2,1, 229
13,229,4,4,1, 233
12,230,5,5,1, 235
18,233,4,4,1, 237
20,233,6,6,1, 239
24,239,1,1,0, 240
23,238,3,3,1, 241
21,237,5,5,1, 242
30,243,3,3,1, 246
25,245,2,2,0, 247
31,246,2,2,1, 248
28,244,5,5,1, 249
26,247,3,3,1, 250
5,247,3,5,1, 252
7,252,1,1,0, 253
24,269,1,1,0, 270
27,272,4,4,1, 276
25,275,2,2,1, 277
28,274,5,5,1, 279
26,277,3,3,0, 280
29,278,4,4,1, 282
7,282,1,1,0, 283
11,284,4,6,1, 290
24,299,1,1,1, 300
27,302,4,4,1, 306
30,303,3,3,1, 306
1,306,1,1,1, 307
26,307,3,3,1, 310
9,317,2,2,1, 319
16,319,2,2,1, 321
20,323,6,6,1, 329
24,329,1,1,1, 330
21,327,5,5,1, 332
30,333,3,3,1, 336
25,335,2,2,1, 337
1,336,1,1,1, 337
27,332,4,8,1, 340
26,337,3,3,1, 340
28,334,5,7,1, 341
9,347,2,2,1, 349
20,353,6,6,1, 359
24,359,1,1,1, 360
23,358,3,3,1, 361
21,357,5,5,1, 362
24,389,1,1,1, 390
25,395,2,2,1, 397
8,406,1,1,0, 407
9,407,2,2,1, 409
13,409,4,6,1, 415
12,410,5,5,1, 415
24,419,1,1,1, 420
25,425,2,2,1, 427
1,426,1,1,0, 427
28,424,5,5,1, 429
6,430,2,2,1, 432
7,432,1,1,0, 433
8,436,1,1,0, 437
9,437,2,2,1, 439
24,449,1,1,1, 450
1,456,1,1,0, 457
7,462,1,1,0, 463
8,466,1,1,0, 467
16,469,2,2,1, 471
24,479,1,1,1, 480
6,490,2,2,1, 492
7,492,1,1,1, 493
8,496,1,1,1, 497
9,497,2,2,1, 499
7,522,1,1,1, 523
8,526,1,1,1, 527
15,531,2,2,1, 533
23,538,3,3,1, 541
7,552,1,1,1, 553
30,573,3,3,1, 576
6,580,2,2,1, 582
7,582,1,1,1, 583
14,589,3,3,1, 592
11,584,4,12,1, 596
18,593,4,8,1, 601
19,596,5,7,1, 603
1,606,1,1,0, 607
31,606,2,2,1, 608
7,612,1,1,0, 613
17,619,3,3,1, 622
24,629,1,1,1, 630
25,635,2,2,1, 637
1,636,1,1,1, 637
31,636,2,2,1, 638
7,642,1,1,1, 643
8,646,1,1,1, 647
9,647,2,2,1, 649
15,651,2,2,1, 653
24,659,1,1,1, 660
8,676,1,1,1, 677
23,688,3,3,1, 691
8,706,1,1,1, 707
15,711,2,2,1, 713
22,716,4,4,1, 720
23,718,3,3,1, 721
8,736,1,1,1, 737
8,766,1,1,1, 767
22,776,4,4,1, 780
24,779,1,1,0, 780
31,786,2,2,1, 788
7,792,1,1,0, 793
8,796,1,1,0, 797
16,799,2,4,1, 803
24,809,1,1,1, 810
31,816,2,2,1, 818
7,822,1,1,1, 823
8,826,1,1,1, 827
16,829,2,2,1, 831
14,829,3,3,1, 832
12,830,5,7,1, 837
24,839,1,1,1, 840
23,838,3,3,1, 841
1,846,1,1,0, 847
7,852,1,1,0, 853
24,869,1,1,1, 870
1,876,1,1,0, 877
7,882,1,1,1, 883
24,899,1,1,0, 900
1,906,1,1,0, 907
7,912,1,1,1, 913
24,929,1,1,0, 930
1,936,1,1,1, 937
7,942,1,1,1, 943
8,946,1,1,0, 947
12,950,5,5,1, 955
22,956,4,4,1, 960
24,959,1,1,0, 960
21,957,5,5,1, 962
19,956,5,7,1, 963
1,966,1,1,0, 967
7,972,1,1,1, 973
8,976,1,1,1, 977
24,989,1,1,0, 990
1,996,1,1,0, 997
7,1002,1,1,1, 1003
8,1006,1,1,0, 1007
24,1019,1,1,1, 1020
1,1026,1,1,0, 1027
7,1032,1,1,1, 1033
8,1036,1,1,1, 1037
17,1039,3,3,1, 1042
24,1049,1,1,1, 1050
2,1053,2,2,1, 1055
1,1056,1,1,0, 1057
7,1062,1,1,0, 1063
8,1066,1,1,1, 1067
9,1067,2,2,1, 1069
15,1071,2,2,1, 1073
18,1073,4,4,1, 1077
20,1073,6,6,1, 1079
22,1076,4,4,1, 1080
24,1079,1,1,0, 1080
31,1086,2,2,1, 1088
7,1092,1,1,1, 1093
24,1109,1,1,1, 1110
7,1122,1,1,0, 1123
24,1139,1,1,0, 1140
31,1146,2,2,1, 1148
7,1152,1,1,0, 1153
24,1169,1,1,0, 1170
7,1182,1,1,0, 1183
8,1186,1,1,0, 1187
16,1189,2,2,1, 1191
13,1189,4,4,1, 1193
15,1191,2,2,1, 1193
18,1193,4,4,1, 1197
22,1196,4,4,1, 1200
24,1199,1,1,1, 1200
23,1198,3,3,1, 1201
21,1197,5,5,1, 1202
8,1216,1,1,1, 1217
24,1229,1,1,1, 1230
8,1246,1,1,1, 1247
24,1259,1,1,1, 1260
8,1276,1,1,0, 1277
24,1289,1,1,0, 1290
8,1306,1,1,0, 1307
22,1316,4,4,1, 1320
24,1319,1,1,1, 1320
19,1316,5,5,1, 1321
23,1318,3,3,1, 1321
1,1326,1,1,1, 1327
1,1356,1,1,0, 1357
1,1386,1,1,1, 1387
1,1416,1,1,1, 1417
8,1426,1,1,1, 1427
9,1427,2,2,1, 1429
24,1439,1,1,0, 1440
22,1436,4,6,1, 1442
1,1446,1,1,1, 1447
7,1452,1,1,1, 1453
24,1469,1,1,1, 1470
1,1476,1,1,0, 1477
7,1482,1,1,1, 1483
24,1499,1,1,0, 1500
1,1506,1,1,1, 1507
7,1512,1,1,0, 1513
24,1529,1,1,0, 1530
1,1536,1,1,0, 1537
7,1542,1,1,0, 1543
8,1546,1,1,0, 1547
9,1547,2,2,1, 1549
17,1549,3,3,1, 1552
15,1551,2,2,1, 1553
18,1553,4,4,1, 1557
24,1559,1,1,0, 1560
19,1556,5,5,1, 1561
23,1558,3,3,1, 1561
21,1557,5,5,1, 1562
24,1589,1,1,0, 1590
24,1619,1,1,0, 1620
24,1649,1,1,1, 1650
8,1666,1,1,1, 1667
11,1664,4,4,1, 1668
16,1669,2,2,1, 1671
13,1669,4,6,1, 1675
18,1673,4,4,1, 1677
20,1673,6,6,1, 1679
24,1679,1,1,0, 1680
23,1678,3,3,1, 1681
21,1677,5,5,1, 1682
7,1692,1,1,0, 1693
24,1709,1,1,1, 1710
7,1722,1,1,0, 1723
24,1739,1,1,1, 1740
6,1750,2,2,1, 1752
7,1752,1,1,0, 1753
24,1769,1,1,1, 1770
7,1782,1,1,1, 1783
8,1786,1,1,0, 1787
17,1789,3,3,1, 1792
18,1793,4,4,1, 1797
20,1793,6,6,1, 1799
22,1796,4,4,1, 1800
24,1799,1,1,0, 1800
19,1796,5,5,1, 1801
21,1797,5,5,1, 1802
1,1806,1,1,1, 1807
7,1812,1,1,1, 1813
1,1836,1,1,1, 1837
7,1842,1,1,0, 1843
1,1866,1,1,1, 1867
31,1866,2,2,1, 1868
7,1872,1,1,0, 1873
24,1889,1,1,0, 1890
1,1896,1,1,0, 1897
7,1902,1,1,1, 1903
8,1906,1,1,1, 1907
14,1909,3,3,1, 1912
17,1909,3,3,1, 1912
13,1909,4,4,1, 1913
18,1913,4,4,1, 1917
22,1916,4,4,1, 1920
24,1919,1,1,1, 1920
23,1918,3,3,1, 1921
21,1917,5,5,1, 1922
25,1985,2,2,1, 1987
24,2009,1,1,1, 2010
8,2026,1,1,1, 2027
9,2027,2,2,1, 2029
17,2029,3,3,1, 2032
15,2031,2,2,1, 2033
14,2029,3,5,1, 2034
18,2033,4,4,1, 2037
22,2036,4,4,1, 2040
24,2039,1,1,0, 2040
21,2037,5,5,1, 2042
1,2046,1,1,0, 2047
7,2052,1,1,0, 2053
24,2069,1,1,0, 2070
1,2076,1,1,1, 2077
7,2082,1,1,1, 2083
24,2099,1,1,0, 2100
1,2106,1,1,1, 2107
31,2106,2,2,1, 2108
7,2112,1,1,1, 2113
24,2129,1,1,1, 2130
1,2136,1,1,1, 2137
7,2142,1,1,0, 2143
8,2146,1,1,0, 2147
16,2149,2,2,1, 2151
13,2149,4,4,1, 2153
15,2151,2,2,1, 2153
18,2153,4,4,1, 2157
24,2159,1,1,1, 2160
19,2156,5,5,1, 2161
1,2166,1,1,1, 2167
1,2196,1,1,0, 2197
1,2226,1,1,1, 2227
1,2256,1,1,0, 2257
8,2266,1,1,0, 2267
16,2269,2,2,1, 2271
14,2269,3,3,1, 2272
15,2271,2,2,1, 2273
18,2273,4,4,1, 2277
24,2279,1,1,0, 2280
20,2273,6,8,1, 2281
23,2278,3,3,1, 2281
21,2277,5,5,1, 2282
6,2290,2,2,1, 2292
7,2292,1,1,1, 2293
24,2309,1,1,0, 2310
6,2320,2,2,1, 2322
7,2322,1,1,1, 2323
24,2339,1,1,0, 2340
6,2350,2,2,1, 2352
7,2352,1,1,0, 2353
24,2369,1,1,1, 2370
7,2382,1,1,0, 2383
8,2386,1,1,1, 2387
11,2384,4,8,1, 2392
14,2389,3,3,1, 2392
17,2389,3,3,1, 2392
15,2391,2,2,1, 2393
22,2396,4,4,1, 2400
24,2399,1,1,0, 2400
24,2429,1,1,0, 2430
24,2459,1,1,0, 2460
16,2479,2,2,1, 2481
24,2489,1,1,0, 2490
8,2506,1,1,1, 2507
9,2507,2,2,1, 2509
16,2509,2,2,1, 2511
14,2509,3,5,1, 2514
24,2519,1,1,1, 2520
19,2516,5,5,1, 2521
23,2518,3,3,1, 2521
1,2526,1,1,0, 2527
7,2532,1,1,0, 2533
8,2536,1,1,1, 2537
24,2549,1,1,0, 2550
23,2548,3,3,1, 2551
1,2556,1,1,0, 2557
7,2562,1,1,1, 2563
8,2566,1,1,1, 2567
24,2579,1,1,0, 2580
1,2586,1,1,1, 2587
7,2592,1,1,1, 2593
8,2596,1,1,0, 2597
24,2609,1,1,0, 2610
1,2616,1,1,0, 2617
7,2622,1,1,1, 2623
8,2626,1,1,0, 2627
16,2629,2,2,1, 2631
18,2633,4,4,1, 2637
22,2636,4,4,1, 2640
24,2639,1,1,1, 2640
21,2637,5,5,1, 2642
7,2652,1,1,1, 2653
15,2661,2,2,1, 2663
7,2682,1,1,0, 2683
2,2703,2,2,1, 2705
1,2706,1,1,0, 2707
7,2712,1,1,1, 2713
8,2716,1,1,1, 2717
9,2717,2,2,1, 2719
2,2733,2,2,1, 2735
1,2736,1,1,1, 2737
7,2742,1,1,1, 2743
8,2746,1,1,0, 2747
9,2747,2,2,1, 2749
17,2749,3,3,1, 2752
13,2749,4,4,1, 2753
15,2751,2,2,1, 2753
22,2756,4,4,1, 2760
24,2759,1,1,0, 2760
19,2756,5,5,1, 2761
21,2757,5,5,1, 2762
25,2765,2,2,1, 2767
24,2789,1,1,1, 2790
24,2819,1,1,0, 2820
7,2832,1,1,0, 2833
24,2849,1,1,0, 2850
31,2856,2,2,1, 2858
7,2862,1,1,0, 2863
9,2867,2,2,1, 2869
15,2871,2,2,1, 2873
12,2870,5,5,1, 2875
18,2873,4,4,1, 2877
22,2876,4,4,1, 2880
24,2879,1,1,0, 2880
19,2876,5,5,1, 2881
23,2878,3,3,1, 2881
1,2886,1,1,1, 2887
8,2896,1,1,1, 2897
24,2909,1,1,1, 2910
1,2916,1,1,0, 2917
8,2926,1,1,0, 2927
24,2939,1,1,0, 2940
1,2946,1,1,0, 2947
8,2956,1,1,1, 2957
24,2969,1,1,1, 2970
1,2976,1,1,0, 2977
8,2986,1,1,1, 2987
11,2984,4,6,1, 2990
15,2991,2,2,1, 2993
18,2993,4,4,1, 2997
22,2996,4,4,1, 3000
24,2999,1,1,1, 3000
19,2996,5,5,1, 3001
21,2997,5,5,1, 3002
7,3012,1,1,0, 3013
24,3029,1,1,0, 3030
7,3042,1,1,1, 3043
24,3059,1,1,0, 3060
7,3072,1,1,0, 3073
24,3089,1,1,1, 3090
7,3102,1,1,0, 3103
8,3106,1,1,0, 3107
13,3109,4,4,1, 3113
15,3111,2,2,1, 3113
18,3113,4,4,1, 3117
24,3119,1,1,0, 3120
23,3118,3,3,1, 3121
21,3117,5,5,1, 3122
31,3126,2,2,1, 3128
8,3136,1,1,0, 3137
24,3149,1,1,1, 3150
23,3148,3,3,1, 3151
31,3156,2,2,1, 3158
8,3166,1,1,0, 3167
24,3179,1,1,0, 3180
8,3196,1,1,0, 3197
24,3209,1,1,0, 3210
23,3208,3,3,1, 3211
8,3226,1,1,1, 3227
11,3224,4,6,1, 3230
15,3231,2,2,1, 3233
14,3229,3,5,1, 3234
12,3230,5,7,1, 3237
18,3233,4,4,1, 3237
24,3239,1,1,1, 3240
23,3238,3,3,1, 3241
2,3243,2,2,1, 3245
1,3246,1,1,1, 3247
7,3252,1,1,1, 3253
1,3276,1,1,1, 3277
7,3282,1,1,0, 3283
1,3306,1,1,0, 3307
7,3312,1,1,1, 3313
1,3336,1,1,0, 3337
7,3342,1,1,0, 3343
8,3346,1,1,0, 3347
18,3353,4,4,1, 3357
24,3359,1,1,0, 3360
12,3350,5,11,1, 3361
23,3358,3,3,1, 3361
7,3372,1,1,1, 3373
24,3389,1,1,0, 3390
7,3402,1,1,1, 3403
15,3411,2,2,1, 3413
24,3419,1,1,1, 3420
7,3432,1,1,1, 3433
15,3441,2,2,1, 3443
24,3449,1,1,0, 3450
6,3460,2,2,1, 3462
7,3462,1,1,0, 3463
8,3466,1,1,0, 3467
18,3473,4,4,1, 3477
24,3479,1,1,0, 3480
19,3476,5,5,1, 3481
1,3486,1,1,0, 3487
26,3487,3,3,1, 3490
7,3492,1,1,0, 3493
8,3496,1,1,0, 3497
2,3513,2,2,1, 3515
1,3516,1,1,1, 3517
7,3522,1,1,1, 3523
8,3526,1,1,1, 3527
2,3543,2,2,1, 3545
1,3546,1,1,1, 3547
26,3547,3,3,1, 3550
7,3552,1,1,0, 3553
8,3556,1,1,0, 3557
16,3559,2,2,1, 3561
1,3576,1,1,0, 3577
7,3582,1,1,1, 3583
8,3586,1,1,1, 3587
16,3589,2,2,1, 3591
17,3589,3,3,1, 3592
15,3591,2,2,1, 3593
22,3596,4,4,1, 3600
24,3599,1,1,1, 3600
23,3598,3,3,1, 3601
25,3605,2,2,1, 3607
7,3612,1,1,0, 3613
24,3629,1,1,0, 3630
7,3642,1,1,0, 3643
24,3659,1,1,0, 3660
25,3665,2,2,1, 3667
7,3672,1,1,1, 3673
24,3689,1,1,1, 3690
7,3702,1,1,0, 3703
8,3706,1,1,0, 3707
11,3704,4,6,1, 3710
16,3709,2,2,1, 3711
17,3709,3,3,1, 3712
22,3716,4,4,1, 3720
24,3719,1,1,0, 3720
20,3713,6,8,1, 3721
19,3716,5,5,1, 3721
23,3718,3,3,1, 3721
1,3726,1,1,1, 3727
7,3732,1,1,0, 3733
8,3736,1,1,0, 3737
16,3739,2,2,1, 3741
18,3743,4,4,1, 3747
1,3756,1,1,1, 3757
7,3762,1,1,1, 3763
8,3766,1,1,1, 3767
17,3769,3,3,1, 3772
1,3786,1,1,0, 3787
7,3792,1,1,1, 3793
8,3796,1,1,0, 3797
1,3816,1,1,0, 3817
7,3822,1,1,0, 3823
8,3826,1,1,1, 3827
9,3827,2,2,1, 3829
14,3829,3,3,1, 3832
17,3829,3,3,1, 3832
15,3831,2,2,1, 3833
12,3830,5,5,1, 3835
22,3836,4,4,1, 3840
24,3839,1,1,0, 3840
23,3838,3,3,1, 3841
1,3846,1,1,0, 3847
24,3869,1,1,0, 3870
1,3876,1,1,1, 3877
24,3899,1,1,1, 3900
1,3906,1,1,1, 3907
24,3929,1,1,0, 3930
1,3936,1,1,0, 3937
8,3946,1,1,1, 3947
9,3947,2,2,1, 3949
15,3951,2,2,1, 3953
22,3956,4,4,1, 3960
24,3959,1,1,0, 3960
23,3958,3,3,1, 3961
7,3972,1,1,0, 3973
24,3989,1,1,0, 3990
7,4002,1,1,1, 4003
24,4019,1,1,0, 4020
7,4032,1,1,0, 4033
24,4049,1,1,1, 4050
7,4062,1,1,1, 4063
8,4066,1,1,0, 4067
9,4067,2,2,1, 4069
16,4069,2,2,1, 4071
13,4069,4,4,1, 4073
12,4070,5,5,1, 4075
18,4073,4,4,1, 4077
22,4076,4,4,1, 4080
24,4079,1,1,0, 4080
23,4078,3,3,1, 4081
19,4076,5,7,1, 4083
1,4086,1,1,0, 4087
31,4086,2,2,1, 4088
24,4109,1,1,0, 4110
1,4116,1,1,1, 4117
31,4116,2,2,1, 4118
24,4139,1,1,0, 4140
25,4145,2,2,1, 4147
1,4146,1,1,0, 4147
24,4169,1,1,1, 4170
23,4168,3,3,1, 4171
1,4176,1,1,1, 4177
31,4176,2,2,1, 4178
8,4186,1,1,0, 4187
9,4187,2,2,1, 4189
16,4189,2,2,1, 4191
11,4184,4,8,1, 4192
14,4189,3,3,1, 4192
13,4189,4,4,1, 4193
15,4191,2,2,1, 4193
18,4193,4,4,1, 4197
20,4193,6,6,1, 4199
22,4196,4,4,1, 4200
24,4199,1,1,0, 4200
19,4196,5,5,1, 4201
23,4198,3,3,1, 4201
21,4197,5,5,1, 4202
7,4212,1,1,0, 4213
7,4242,1,1,1, 4243
7,4272,1,1,0, 4273
8,4276,1,1,1, 4277
15,4281,2,2,1, 4283
7,4302,1,1,0, 4303
8,4306,1,1,1, 4307
17,4309,3,3,1, 4312
15,4311,2,2,1, 4313
18,4313,4,4,1, 4317
20,4313,6,6,1, 4319
24,4319,1,1,1, 4320
21,4317,5,5,1, 4322
1,4326,1,1,1, 4327
7,4332,1,1,0, 4333
24,4349,1,1,0, 4350
1,4356,1,1,0, 4357
31,4356,2,2,1, 4358
7,4362,1,1,0, 4363
24,4379,1,1,1, 4380
30,4383,3,3,1, 4386
1,4386,1,1,0, 4387
7,4392,1,1,1, 4393
8,4396,1,1,1, 4397
9,4397,2,2,1, 4399
15,4401,2,2,1, 4403
1,4416,1,1,1, 4417
31,4416,2,2,1, 4418
7,4422,1,1,0, 4423
8,4426,1,1,0, 4427
9,4427,2,2,1, 4429
14,4429,3,3,1, 4432
2,4443,2,2,1, 4445
1,4446,1,1,0, 4447
31,4446,2,2,1, 4448
8,4456,1,1,1, 4457
24,4469,1,1,1, 4470
25,4475,2,2,1, 4477
1,4476,1,1,1, 4477
31,4476,2,2,1, 4478
8,4486,1,1,0, 4487
16,4489,2,2,1, 4491
24,4499,1,1,1, 4500
23,4498,3,3,1, 4501
25,4505,2,2,1, 4507
7,4512,1,1,0, 4513
14,4519,3,3,1, 4522
21,4527,5,5,1, 4532
7,4542,1,1,1, 4543
13,4549,4,4,1, 4553
16,4549,2,4,1, 4553
15,4551,2,2,1, 4553
17,4549,3,5,1, 4554
30,4563,3,3,1, 4566
28,4564,5,5,1, 4569
6,4570,2,2,1, 4572
7,4572,1,1,1, 4573
30,4593,3,3,1, 4596
28,4594,5,5,1, 4599
29,4598,4,4,1, 4602
7,4602,1,1,1, 4603
8,4606,1,1,0, 4607
9,4607,2,2,1, 4609
24,4619,1,1,1, 4620
1,4626,1,1,1, 4627
6,4630,2,4,1, 4634
8,4636,1,1,0, 4637
9,4637,2,2,1, 4639
15,4641,2,2,1, 4643
24,4649,1,1,0, 4650
23,4648,3,3,1, 4651
1,4656,1,1,0, 4657
6,4660,2,4,1, 4664
8,4666,1,1,1, 4667
24,4679,1,1,1, 4680
19,4676,5,5,1, 4681
1,4686,1,1,1, 4687
31,4686,2,2,1, 4688
7,4692,1,1,0, 4693
8,4696,1,1,0, 4697
9,4697,2,2,1, 4699
24,4709,1,1,0, 4710
1,4716,1,1,0, 4717
7,4722,1,1,0, 4723
8,4726,1,1,0, 4727
18,4733,4,6,1, 4739
24,4739,1,1,1, 4740
23,4738,3,3,1, 4741
30,4743,3,3,1, 4746
1,4746,1,1,1, 4747
31,4746,2,2,1, 4748
24,4769,1,1,1, 4770
1,4776,1,1,1, 4777
31,4776,2,2,1, 4778
16,4789,2,2,1, 4791
24,4799,1,1,0, 4800
2,4803,2,2,1, 4805
1,4806,1,1,0, 4807
31,4806,2,2,1, 4808
16,4819,2,2,1, 4821
24,4829,1,1,0, 4830
30,4833,3,3,1, 4836
1,4836,1,1,0, 4837
31,4836,2,2,1, 4838
8,4846,1,1,1, 4847
16,4849,2,2,1, 4851
15,4851,2,2,1, 4853
18,4853,4,4,1, 4857
20,4853,6,6,1, 4859
22,4856,4,4,1, 4860
24,4859,1,1,1, 4860
21,4857,5,5,1, 4862
25,4865,2,2,1, 4867
1,4866,1,1,1, 4867
7,4872,1,1,1, 4873
8,4876,1,1,0, 4877
1,4896,1,1,1, 4897
6,4900,2,2,1, 4902
7,4902,1,1,0, 4903
8,4906,1,1,1, 4907
17,4909,3,3,1, 4912
18,4913,4,4,1, 4917
1,4926,1,1,0, 4927
7,4932,1,1,0, 4933
8,4936,1,1,0, 4937
1,4956,1,1,0, 4957
6,4960,2,2,1, 4962
7,4962,1,1,1, 4963
8,4966,1,1,0, 4967
9,4967,2,2,1, 4969
13,4969,4,6,1, 4975
12,4970,5,7,1, 4977
20,4973,6,6,1, 4979
24,4979,1,1,0, 4980
23,4978,3,3,1, 4981
21,4977,5,5,1, 4982
8,4996,1,1,0, 4997
24,5009,1,1,1, 5010
25,5015,2,2,1, 5017
8,5026,1,1,0, 5027
24,5039,1,1,1, 5040
1,5046,1,1,0, 5047
3,5047,3,3,1, 5050
8,5056,1,1,0, 5057
9,5057,2,2,1, 5059
24,5069,1,1,0, 5070
2,5073,2,2,1, 5075
27,5072,4,4,1, 5076
1,5076,1,1,0, 5077
8,5086,1,1,0, 5087
16,5089,2,2,1, 5091
15,5091,2,2,1, 5093
22,5096,4,4,1, 5100
24,5099,1,1,1, 5100
23,5098,3,3,1, 5101
30,5103,3,3,1, 5106
5,5107,3,3,1, 5110
6,5110,2,2,1, 5112
7,5112,1,1,1, 5113
8,5116,1,1,0, 5117
24,5129,1,1,1, 5130
7,5142,1,1,1, 5143
8,5146,1,1,1, 5147
24,5159,1,1,1, 5160
25,5165,2,2,1, 5167
1,5166,1,1,1, 5167
7,5172,1,1,0, 5173
8,5176,1,1,1, 5177
17,5179,3,3,1, 5182
24,5189,1,1,0, 5190
1,5196,1,1,1, 5197
7,5202,1,1,0, 5203
8,5206,1,1,1, 5207
15,5211,2,2,1, 5213
18,5213,4,4,1, 5217
24,5219,1,1,0, 5220
2,5223,2,2,1, 5225
27,5222,4,4,1, 5226
1,5226,1,1,1, 5227
26,5227,3,3,1, 5230
8,5236,1,1,1, 5237
13,5239,4,4,1, 5243
25,5255,2,2,1, 5257
1,5256,1,1,1, 5257
3,5257,3,3,1, 5260
8,5266,1,1,0, 5267
15,5271,2,2,1, 5273
18,5273,4,4,1, 5277
16,5329,2,2,1, 5331
17,5329,3,3,1, 5332
15,5331,2,2,1, 5333
12,5330,5,7,1, 5337
24,5339,1,1,0, 5340
23,5338,3,3,1, 5341
22,5336,4,6,1, 5342
7,5352,1,1,0, 5353
8,5356,1,1,0, 5357
7,5382,1,1,1, 5383
8,5386,1,1,1, 5387
2,5403,2,2,1, 5405
1,5406,1,1,1, 5407
7,5412,1,1,0, 5413
8,5416,1,1,1, 5417
1,5436,1,1,0, 5437
7,5442,1,1,1, 5443
8,5446,1,1,0, 5447
9,5447,2,2,1, 5449
15,5451,2,2,1, 5453
12,5450,5,7,1, 5457
22,5456,4,6,1, 5462
1,5466,1,1,0, 5467
6,5470,2,2,1, 5472
7,5472,1,1,0, 5473
8,5476,1,1,0, 5477
1,5496,1,1,1, 5497
7,5502,1,1,0, 5503
8,5506,1,1,0, 5507
24,5519,1,1,0, 5520
1,5526,1,1,1, 5527
7,5532,1,1,1, 5533
8,5536,1,1,0, 5537
16,5539,2,2,1, 5541
22,5546,4,4,1, 5550
24,5549,1,1,1, 5550
1,5556,1,1,0, 5557
6,5560,2,2,1, 5562
7,5562,1,1,0, 5563
8,5566,1,1,0, 5567
16,5569,2,2,1, 5571
14,5569,3,5,1, 5574
12,5570,5,7,1, 5577
20,5573,6,6,1, 5579
24,5579,1,1,0, 5580
23,5578,3,3,1, 5581
1,5586,1,1,1, 5587
8,5596,1,1,0, 5597
15,5601,2,2,1, 5603
24,5609,1,1,0, 5610
1,5616,1,1,1, 5617
8,5626,1,1,1, 5627
15,5631,2,2,1, 5633
24,5639,1,1,0, 5640
1,5646,1,1,1, 5647
8,5656,1,1,1, 5657
15,5661,2,2,1, 5663
24,5669,1,1,0, 5670
1,5676,1,1,0, 5677
8,5686,1,1,1, 5687
9,5687,2,2,1, 5689
16,5689,2,2,1, 5691
17,5689,3,3,1, 5692
14,5689,3,5,1, 5694
13,5689,4,6,1, 5695
20,5693,6,6,1, 5699
22,5696,4,4,1, 5700
24,5699,1,1,0, 5700
23,5698,3,3,1, 5701
27,5702,4,4,1, 5706
1,5706,1,1,0, 5707
4,5706,4,4,1, 5710
6,5710,2,2,1, 5712
7,5712,1,1,0, 5713
24,5729,1,1,0, 5730
5,5737,3,3,1, 5740
6,5740,2,2,1, 5742
7,5742,1,1,0, 5743
24,5759,1,1,1, 5760
7,5772,1,1,1, 5773
24,5789,1,1,1, 5790
23,5788,3,3,1, 5791
6,5800,2,2,1, 5802
7,5802,1,1,0, 5803
8,5806,1,1,1, 5807
9,5807,2,2,1, 5809
16,5809,2,2,1, 5811
14,5809,3,3,1, 5812
13,5809,4,8,1, 5817
20,5813,6,6,1, 5819
24,5819,1,1,0, 5820
21,5817,5,5,1, 5822
1,5826,1,1,1, 5827
8,5836,1,1,0, 5837
1,5856,1,1,0, 5857
8,5866,1,1,0, 5867
16,5869,2,2,1, 5871
1,5886,1,1,1, 5887
8,5896,1,1,0, 5897
1,5916,1,1,1, 5917
5,5917,3,7,1, 5924
8,5926,1,1,0, 5927
9,5927,2,2,1, 5929
15,5931,2,2,1, 5933
13,5929,4,8,1, 5937
24,5939,1,1,1, 5940
1,5946,1,1,1, 5947
7,5952,1,1,1, 5953
24,5969,1,1,1, 5970
1,5976,1,1,1, 5977
7,5982,1,1,1, 5983
24,5999,1,1,1, 6000
1,6006,1,1,1, 6007
7,6012,1,1,1, 6013
8,6016,1,1,0, 6017
15,6021,2,2,1, 6023
24,6029,1,1,1, 6030
1,6036,1,1,0, 6037
7,6042,1,1,1, 6043
8,6046,1,1,1, 6047
16,6049,2,2,1, 6051
17,6049,3,3,1, 6052
13,6049,4,6,1, 6055
12,6050,5,7,1, 6057
20,6053,6,6,1, 6059
24,6059,1,1,1, 6060
1,6066,1,1,0, 6067
24,6089,1,1,0, 6090
1,6096,1,1,0, 6097
16,6109,2,2,1, 6111
15,6111,2,4,1, 6115
24,6119,1,1,1, 6120
1,6126,1,1,1, 6127
15,6141,2,4,1, 6145
24,6149,1,1,1, 6150
1,6156,1,1,1, 6157
8,6166,1,1,1, 6167
18,6173,4,4,1, 6177
24,6179,1,1,0, 6180
7,6192,1,1,1, 6193
8,6196,1,1,0, 6197
24,6209,1,1,0, 6210
7,6222,1,1,1, 6223
8,6226,1,1,0, 6227
24,6239,1,1,1, 6240
30,6243,3,3,1, 6246
5,6247,3,5,1, 6252
7,6252,1,1,0, 6253
6,6250,2,4,1, 6254
8,6256,1,1,0, 6257
24,6269,1,1,1, 6270
23,6268,3,3,1, 6271
5,6277,3,5,1, 6282
7,6282,1,1,0, 6283
8,6286,1,1,1, 6287
17,6289,3,3,1, 6292
14,6289,3,5,1, 6294
15,6291,2,4,1, 6295
18,6293,4,4,1, 6297
24,6299,1,1,1, 6300
23,6298,3,3,1, 6301
21,6297,5,5,1, 6302
2,6303,2,2,1, 6305
1,6306,1,1,1, 6307
7,6312,1,1,1, 6313
8,6316,1,1,1, 6317
16,6319,2,2,1, 6321
24,6329,1,1,0, 6330
2,6333,2,2,1, 6335
25,6335,2,2,1, 6337
1,6336,1,1,0, 6337
7,6342,1,1,0, 6343
8,6346,1,1,0, 6347
16,6349,2,2,1, 6351
24,6359,1,1,0, 6360
1,6366,1,1,0, 6367
7,6372,1,1,1, 6373
8,6376,1,1,1, 6377
24,6389,1,1,1, 6390
1,6396,1,1,1, 6397
7,6402,1,1,0, 6403
8,6406,1,1,0, 6407
9,6407,2,2,1, 6409
16,6409,2,2,1, 6411
14,6409,3,3,1, 6412
15,6411,2,2,1, 6413
18,6413,4,4,1, 6417
24,6419,1,1,0, 6420
7,6432,1,1,1, 6433
7,6462,1,1,0, 6463
7,6492,1,1,1, 6493
7,6522,1,1,0, 6523
8,6526,1,1,0, 6527
9,6527,2,2,1, 6529
16,6529,2,2,1, 6531
17,6529,3,3,1, 6532
13,6529,4,6,1, 6535
22,6536,4,4,1, 6540
24,6539,1,1,1, 6540
21,6537,5,5,1, 6542
25,6545,2,2,1, 6547
1,6546,1,1,1, 6547
6,6550,2,2,1, 6552
7,6552,1,1,0, 6553
8,6556,1,1,0, 6557
24,6569,1,1,0, 6570
25,6575,2,2,1, 6577
1,6576,1,1,1, 6577
6,6580,2,2,1, 6582
7,6582,1,1,1, 6583
8,6586,1,1,0, 6587
17,6589,3,3,1, 6592
24,6599,1,1,1, 6600
1,6606,1,1,1, 6607
6,6610,2,2,1, 6612
7,6612,1,1,1, 6613
8,6616,1,1,1, 6617
24,6629,1,1,0, 6630
1,6636,1,1,1, 6637
6,6640,2,2,1, 6642
7,6642,1,1,0, 6643
8,6646,1,1,1, 6647
9,6647,2,2,1, 6649
16,6649,2,2,1, 6651
13,6649,4,4,1, 6653
15,6651,2,2,1, 6653
22,6656,4,4,1, 6660
24,6659,1,1,0, 6660
2,6663,2,2,1, 6665
1,6666,1,1,0, 6667
24,6689,1,1,0, 6690
1,6696,1,1,0, 6697
24,6719,1,1,0, 6720
25,6725,2,2,1, 6727
1,6726,1,1,1, 6727
24,6749,1,1,1, 6750
1,6756,1,1,0, 6757
31,6756,2,2,1, 6758
7,6762,1,1,0, 6763
8,6766,1,1,1, 6767
9,6767,2,2,1, 6769
14,6769,3,5,1, 6774
22,6776,4,4,1, 6780
24,6779,1,1,1, 6780
21,6777,5,5,1, 6782
2,6783,2,2,1, 6785
7,6792,1,1,0, 6793
8,6796,1,1,0, 6797
7,6822,1,1,0, 6823
8,6826,1,1,0, 6827
7,6852,1,1,0, 6853
8,6856,1,1,1, 6857
7,6882,1,1,0, 6883
8,6886,1,1,0, 6887
9,6887,2,2,1, 6889
22,6896,4,4,1, 6900
24,6899,1,1,0, 6900
23,6898,3,3,1, 6901
1,6906,1,1,1, 6907
6,6910,2,2,1, 6912
7,6912,1,1,1, 6913
24,6929,1,1,0, 6930
1,6936,1,1,0, 6937
7,6942,1,1,0, 6943
24,6959,1,1,1, 6960
1,6966,1,1,0, 6967
6,6970,2,2,1, 6972
7,6972,1,1,1, 6973
24,6989,1,1,0, 6990
1,6996,1,1,0, 6997
6,7000,2,2,1, 7002
7,7002,1,1,1, 7003
8,7006,1,1,0, 7007
9,7007,2,2,1, 7009
17,7009,3,3,1, 7012
13,7009,4,4,1, 7013
15,7011,2,2,1, 7013
24,7019,1,1,1, 7020
23,7018,3,3,1, 7021
21,7017,5,5,1, 7022
1,7026,1,1,0, 7027
7,7032,1,1,0, 7033
24,7049,1,1,0, 7050
1,7056,1,1,1, 7057
7,7062,1,1,1, 7063
24,7079,1,1,0, 7080
1,7086,1,1,0, 7087
7,7092,1,1,0, 7093
24,7109,1,1,0, 7110
1,7116,1,1,1, 7117
7,7122,1,1,1, 7123
8,7126,1,1,1, 7127
16,7129,2,2,1, 7131
14,7129,3,3,1, 7132
15,7131,2,2,1, 7133
18,7133,4,4,1, 7137
22,7136,4,4,1, 7140
24,7139,1,1,0, 7140
21,7137,5,5,1, 7142
5,7147,3,3,1, 7150
6,7150,2,2,1, 7152
7,7152,1,1,1, 7153
24,7169,1,1,0, 7170
7,7182,1,1,0, 7183
24,7199,1,1,1, 7200
6,7210,2,2,1, 7212
7,7212,1,1,0, 7213
24,7229,1,1,1, 7230
5,7237,3,3,1, 7240
6,7240,2,2,1, 7242
7,7242,1,1,1, 7243
8,7246,1,1,1, 7247
9,7247,2,2,1, 7249
16,7249,2,2,1, 7251
15,7251,2,2,1, 7253
22,7256,4,4,1, 7260
24,7259,1,1,1, 7260
30,7263,3,3,1, 7266
1,7266,1,1,0, 7267
31,7266,2,2,1, 7268
24,7289,1,1,0, 7290
1,7296,1,1,0, 7297
24,7319,1,1,0, 7320
30,7323,3,3,1, 7326
1,7326,1,1,1, 7327
31,7326,2,2,1, 7328
24,7349,1,1,0, 7350
1,7356,1,1,0, 7357
31,7356,2,2,1, 7358
8,7366,1,1,1, 7367
9,7367,2,2,1, 7369
22,7376,4,4,1, 7380
24,7379,1,1,0, 7380
23,7378,3,3,1, 7381
1,7386,1,1,0, 7387
7,7392,1,1,1, 7393
1,7416,1,1,0, 7417
6,7420,2,2,1, 7422
7,7422,1,1,0, 7423
1,7446,1,1,1, 7447
6,7450,2,2,1, 7452
7,7452,1,1,1, 7453
1,7476,1,1,1, 7477
7,7482,1,1,1, 7483
8,7486,1,1,1, 7487
9,7487,2,2,1, 7489
14,7489,3,3,1, 7492
12,7490,5,5,1, 7495
22,7496,4,4,1, 7500
24,7499,1,1,0, 7500
7,7512,1,1,0, 7513
7,7542,1,1,0, 7543
7,7572,1,1,1, 7573
7,7602,1,1,1, 7603
8,7606,1,1,1, 7607
15,7611,2,2,1, 7613
12,7610,5,7,1, 7617
24,7619,1,1,0, 7620
23,7618,3,3,1, 7621
1,7626,1,1,1, 7627
9,7637,2,2,1, 7639
24,7649,1,1,1, 7650
2,7653,2,2,1, 7655
1,7656,1,1,1, 7657
9,7667,2,2,1, 7669
24,7679,1,1,0, 7680
25,7685,2,2,1, 7687
24,7709,1,1,0, 7710
8,7726,1,1,0, 7727
16,7729,2,2,1, 7731
14,7729,3,3,1, 7732
13,7729,4,4,1, 7733
24,7739,1,1,1, 7740
21,7737,5,5,1, 7742
7,7752,1,1,0, 7753
8,7756,1,1,0, 7757
7,7782,1,1,1, 7783
8,7786,1,1,0, 7787
25,7805,2,2,1, 7807
1,7806,1,1,1, 7807
7,7812,1,1,0, 7813
8,7816,1,1,1, 7817
9,7817,2,2,1, 7819
1,7836,1,1,0, 7837
7,7842,1,1,0, 7843
8,7846,1,1,1, 7847
9,7847,2,2,1, 7849
16,7849,2,2,1, 7851
14,7849,3,3,1, 7852
17,7849,3,3,1, 7852
15,7851,2,2,1, 7853
12,7850,5,5,1, 7855
24,7859,1,1,1, 7860
23,7858,3,3,1, 7861
21,7857,5,5,1, 7862
1,7866,1,1,0, 7867
24,7889,1,1,0, 7890
1,7896,1,1,0, 7897
24,7919,1,1,0, 7920
1,7926,1,1,0, 7927
24,7949,1,1,1, 7950
1,7956,1,1,0, 7957
8,7966,1,1,0, 7967
17,7969,3,3,1, 7972
15,7971,2,2,1, 7973
22,7976,4,4,1, 7980
24,7979,1,1,0, 7980
23,7978,3,3,1, 7981
1,7986,1,1,1, 7987
24,8009,1,1,0, 8010
1,8016,1,1,1, 8017
24,8039,1,1,1, 8040
1,8046,1,1,0, 8047
8,8056,1,1,0, 8057
9,8057,2,2,1, 8059
24,8069,1,1,1, 8070
1,8076,1,1,1, 8077
7,8082,1,1,0, 8083
8,8086,1,1,0, 8087
9,8087,2,2,1, 8089
24,8099,1,1,0, 8100
23,8098,3,3,1, 8101
25,8105,2,2,1, 8107
1,8106,1,1,0, 8107
5,8107,3,3,1, 8110
6,8110,2,2,1, 8112
7,8112,1,1,1, 8113
14,8119,3,3,1, 8122
15,8121,2,2,1, 8123
24,8129,1,1,0, 8130
23,8128,3,3,1, 8131
1,8136,1,1,1, 8137
6,8140,2,2,1, 8142
7,8142,1,1,1, 8143
15,8151,2,2,1, 8153
24,8159,1,1,0, 8160
23,8158,3,3,1, 8161
25,8165,2,2,1, 8167
1,8166,1,1,1, 8167
24,8189,1,1,1, 8190
25,8195,2,2,1, 8197
1,8196,1,1,0, 8197
8,8206,1,1,1, 8207
24,8219,1,1,1, 8220
23,8218,3,3,1, 8221
2,8223,2,2,1, 8225
1,8226,1,1,1, 8227
31,8226,2,2,1, 8228
5,8227,3,3,1, 8230
29,8228,4,4,1, 8232
7,8232,1,1,1, 8233
8,8236,1,1,1, 8237
15,8241,2,2,1, 8243
24,8249,1,1,1, 8250
2,8253,2,2,1, 8255
1,8256,1,1,1, 8257
31,8256,2,2,1, 8258
8,8266,1,1,1, 8267
14,8269,3,3,1, 8272
13,8269,4,4,1, 8273
15,8271,2,2,1, 8273
24,8279,1,1,0, 8280
30,8283,3,3,1, 8286
1,8286,1,1,1, 8287
31,8286,2,2,1, 8288
8,8296,1,1,1, 8297
15,8301,2,2,1, 8303
24,8309,1,1,1, 8310
30,8313,3,3,1, 8316
1,8316,1,1,1, 8317
8,8326,1,1,1, 8327
9,8327,2,2,1, 8329
17,8329,3,3,1, 8332
24,8339,1,1,1, 8340
21,8337,5,5,1, 8342
25,8345,2,2,1, 8347
7,8352,1,1,1, 8353
14,8359,3,3,1, 8362
15,8361,2,2,1, 8363
7,8382,1,1,0, 8383
14,8389,3,3,1, 8392
21,8397,5,5,1, 8402
5,8407,3,3,1, 8410
7,8412,1,1,1, 8413
23,8428,3,3,1, 8431
7,8442,1,1,0, 8443
8,8446,1,1,0, 8447
24,8459,1,1,1, 8460
23,8458,3,3,1, 8461
1,8466,1,1,1, 8467
6,8470,2,2,1, 8472
7,8472,1,1,0, 8473
8,8476,1,1,0, 8477
1,8496,1,1,1, 8497
5,8497,3,3,1, 8500
6,8500,2,2,1, 8502
7,8502,1,1,1, 8503
8,8506,1,1,0, 8507
14,8509,3,3,1, 8512
15,8511,2,2,1, 8513
22,8516,4,4,1, 8520
1,8526,1,1,0, 8527
8,8536,1,1,0, 8537
2,8553,2,2,1, 8555
1,8556,1,1,1, 8557
8,8566,1,1,1, 8567
17,8569,3,3,1, 8572
24,8579,1,1,0, 8580
23,8578,3,3,1, 8581
25,8585,2,2,1, 8587
1,8586,1,1,0, 8587
8,8596,1,1,1, 8597
24,8609,1,1,0, 8610
23,8608,3,3,1, 8611
1,8616,1,1,1, 8617
7,8622,1,1,0, 8623
8,8626,1,1,1, 8627
14,8629,3,3,1, 8632
15,8631,2,2,1, 8633
24,8639,1,1,1, 8640
25,8645,2,2,1, 8647
1,8646,1,1,0, 8647
5,8647,3,5,1, 8652
7,8652,1,1,0, 8653
8,8656,1,1,0, 8657
24,8669,1,1,0, 8670
1,8676,1,1,0, 8677
7,8682,1,1,1, 8683
8,8686,1,1,0, 8687
16,8689,2,2,1, 8691
24,8699,1,1,1, 8700
23,8698,3,3,1, 8701
7,8712,1,1,0, 8713
8,8716,1,1,1, 8717
7,8742,1,1,0, 8743
8,8746,1,1,1, 8747
15,8751,2,2,1, 8753
7,8772,1,1,1, 8773
8,8776,1,1,1, 8777
7,8802,1,1,0, 8803
8,8806,1,1,0, 8807
16,8809,2,2,1, 8811
17,8809,3,3,1, 8812
15,8811,2,2,1, 8813
24,8819,1,1,0, 8820
1,8826,1,1,1, 8827
5,8827,3,3,1, 8830
6,8830,2,2,1, 8832
7,8832,1,1,1, 8833
17,8839,3,3,1, 8842
24,8849,1,1,0, 8850
1,8856,1,1,1, 8857
7,8862,1,1,1, 8863
16,8869,2,2,1, 8871
17,8869,3,3,1, 8872
24,8879,1,1,0, 8880
1,8886,1,1,1, 8887
5,8887,3,3,1, 8890
7,8892,1,1,0, 8893
24,8909,1,1,1, 8910
1,8916,1,1,1, 8917
5,8917,3,3,1, 8920
6,8920,2,2,1, 8922
7,8922,1,1,0, 8923
8,8926,1,1,0, 8927
17,8929,3,3,1, 8932
15,8931,2,2,1, 8933
24,8939,1,1,1, 8940
30,8943,3,3,1, 8946
25,8945,2,2,1, 8947
8,8956,1,1,0, 8957
16,8959,2,2,1, 8961
8,8986,1,1,1, 8987
8,9016,1,1,1, 9017
16,9019,2,2,1, 9021
8,9046,1,1,1, 9047
16,9049,2,2,1, 9051
17,9049,3,3,1, 9052
22,9056,4,4,1, 9060
24,9059,1,1,0, 9060
23,9058,3,3,1, 9061
1,9066,1,1,1, 9067
6,9070,2,2,1, 9072
7,9072,1,1,0, 9073
24,9089,1,1,1, 9090
1,9096,1,1,0, 9097
7,9102,1,1,0, 9103
24,9119,1,1,0, 9120
1,9126,1,1,1, 9127
7,9132,1,1,0, 9133
24,9149,1,1,1, 9150
2,9153,2,2,1, 9155
1,9156,1,1,0, 9157
6,9160,2,2,1, 9162
7,9162,1,1,1, 9163
8,9166,1,1,1, 9167
9,9167,2,2,1, 9169
15,9171,2,2,1, 9173
22,9176,4,4,1, 9180
24,9179,1,1,1, 9180
23,9178,3,3,1, 9181
1,9186,1,1,0, 9187
7,9192,1,1,1, 9193
1,9216,1,1,1, 9217
7,9222,1,1,1, 9223
1,9246,1,1,0, 9247
7,9252,1,1,0, 9253
1,9276,1,1,1, 9277
7,9282,1,1,1, 9283
8,9286,1,1,1, 9287
16,9289,2,2,1, 9291
14,9289,3,3,1, 9292
17,9289,3,3,1, 9292
13,9289,4,4,1, 9293
15,9291,2,2,1, 9293
22,9296,4,4,1, 9300
24,9299,1,1,1, 9300
23,9298,3,3,1, 9301
25,9305,2,2,1, 9307
1,9306,1,1,1, 9307
24,9329,1,1,1, 9330
1,9336,1,1,0, 9337
17,9349,3,3,1, 9352
24,9359,1,1,0, 9360
25,9365,2,2,1, 9367
1,9366,1,1,1, 9367
17,9379,3,3,1, 9382
24,9389,1,1,0, 9390
2,9393,2,2,1, 9395
25,9395,2,2,1, 9397
1,9396,1,1,0, 9397
8,9406,1,1,1, 9407
9,9407,2,2,1, 9409
16,9409,2,2,1, 9411
17,9409,3,3,1, 9412
14,9409,3,5,1, 9414
22,9416,4,4,1, 9420
24,9419,1,1,0, 9420
7,9432,1,1,0, 9433
8,9436,1,1,1, 9437
9,9437,2,2,1, 9439
16,9439,2,2,1, 9441
24,9449,1,1,0, 9450
31,9456,2,2,1, 9458
7,9462,1,1,0, 9463
8,9466,1,1,0, 9467
16,9469,2,2,1, 9471
24,9479,1,1,0, 9480
23,9478,3,3,1, 9481
31,9486,2,2,1, 9488
7,9492,1,1,0, 9493
8,9496,1,1,1, 9497
31,9516,2,2,1, 9518
7,9522,1,1,1, 9523
8,9526,1,1,0, 9527
16,9529,2,2,1, 9531
14,9529,3,3,1, 9532
17,9529,3,5,1, 9534
2,9543,2,2,1, 9545
7,9552,1,1,1, 9553
24,9569,1,1,1, 9570
25,9575,2,2,1, 9577
7,9582,1,1,1, 9583
24,9599,1,1,1, 9600
7,9612,1,1,0, 9613
24,9629,1,1,0, 9630
25,9635,2,2,1, 9637
7,9642,1,1,1, 9643
8,9646,1,1,0, 9647
9,9647,2,2,1, 9649
15,9651,2,2,1, 9653
22,9656,4,4,1, 9660
24,9659,1,1,0, 9660
1,9666,1,1,0, 9667
7,9672,1,1,0, 9673
8,9676,1,1,0, 9677
1,9696,1,1,0, 9697
31,9696,2,2,1, 9698
7,9702,1,1,1, 9703
8,9706,1,1,1, 9707
1,9726,1,1,0, 9727
7,9732,1,1,1, 9733
8,9736,1,1,0, 9737
23,9748,3,3,1, 9751
1,9756,1,1,0, 9757
31,9756,2,2,1, 9758
7,9762,1,1,1, 9763
8,9766,1,1,0, 9767
9,9767,2,2,1, 9769
16,9769,2,2,1, 9771
24,9779,1,1,0, 9780
23,9778,3,3,1, 9781
1,9786,1,1,0, 9787
24,9809,1,1,1, 9810
1,9816,1,1,1, 9817
24,9839,1,1,0, 9840
1,9846,1,1,1, 9847
24,9869,1,1,0, 9870
1,9876,1,1,0, 9877
8,9886,1,1,0, 9887
9,9887,2,2,1, 9889
17,9889,3,3,1, 9892
18,9893,4,4,1, 9897
24,9899,1,1,1, 9900
2,9903,2,2,1, 9905
1,9906,1,1,0, 9907
7,9912,1,1,1, 9913
8,9916,1,1,1, 9917
24,9929,1,1,1, 9930
1,9936,1,1,1, 9937
7,9942,1,1,1, 9943
8,9946,1,1,0, 9947
24,9959,1,1,0, 9960
1,9966,1,1,0, 9967
7,9972,1,1,1, 9973
8,9976,1,1,1, 9977
24,9989,1,1,1, 9990
1,9996,1,1,1, 9997
7,10002,1,1,1, 10003
8,10006,1,1,0, 10007
9,10007,2,2,1, 10009
15,10011,2,2,1, 10013
18,10013,4,4,1, 10017
24,10019,1,1,1, 10020
1,10026,1,1,0, 10027
8,10036,1,1,1, 10037
24,10049,1,1,1, 10050
2,10053,2,2,1, 10055
1,10056,1,1,1, 10057
8,10066,1,1,1, 10067
24,10079,1,1,1, 10080
2,10083,2,2,1, 10085
1,10086,1,1,0, 10087
8,10096,1,1,1, 10097
24,10109,1,1,0, 10110
1,10116,1,1,1, 10117
8,10126,1,1,0, 10127
16,10129,2,2,1, 10131
17,10129,3,3,1, 10132
18,10133,4,4,1, 10137
24,10139,1,1,0, 10140
31,10146,2,2,1, 10148
7,10152,1,1,1, 10153
15,10161,2,2,1, 10163
22,10166,4,4,1, 10170
24,10169,1,1,0, 10170
31,10176,2,2,1, 10178
6,10180,2,2,1, 10182
7,10182,1,1,0, 10183
14,10189,3,3,1, 10192
15,10191,2,2,1, 10193
24,10199,1,1,1, 10200
24,10229,1,1,0, 10230
8,10246,1,1,0, 10247
16,10249,2,2,1, 10251
24,10259,1,1,1, 10260
1,10266,1,1,1, 10267
8,10276,1,1,1, 10277
15,10281,2,2,1, 10283
24,10289,1,1,1, 10290
23,10288,3,3,1, 10291
2,10293,2,2,1, 10295
1,10296,1,1,1, 10297
8,10306,1,1,1, 10307
14,10309,3,5,1, 10314
24,10319,1,1,1, 10320
2,10323,2,2,1, 10325
1,10326,1,1,1, 10327
7,10332,1,1,1, 10333
8,10336,1,1,0, 10337
24,10349,1,1,1, 10350
1,10356,1,1,1, 10357
31,10356,2,2,1, 10358
7,10362,1,1,1, 10363
8,10366,1,1,1, 10367
24,10379,1,1,0, 10380
25,10385,2,2,1, 10387
1,10386,1,1,1, 10387
31,10386,2,2,1, 10388
7,10392,1,1,0, 10393
8,10396,1,1,1, 10397
25,10415,2,2,1, 10417
1,10416,1,1,0, 10417
7,10422,1,1,0, 10423
8,10426,1,1,1, 10427
16,10429,2,2,1, 10431
22,10436,4,4,1, 10440
25,10445,2,2,1, 10447
1,10446,1,1,0, 10447
7,10452,1,1,1, 10453
8,10456,1,1,0, 10457
16,10459,2,2,1, 10461
1,10476,1,1,1, 10477
7,10482,1,1,0, 10483
8,10486,1,1,0, 10487
9,10487,2,2,1, 10489
16,10489,2,2,1, 10491
18,10493,4,4,1, 10497
24,10499,1,1,0, 10500
7,10512,1,1,1, 10513
24,10529,1,1,0, 10530
7,10542,1,1,0, 10543
24,10559,1,1,0, 10560
31,10566,2,2,1, 10568
7,10572,1,1,0, 10573
8,10576,1,1,1, 10577
24,10589,1,1,1, 10590
31,10596,2,2,1, 10598
7,10602,1,1,1, 10603
8,10606,1,1,0, 10607
9,10607,2,2,1, 10609
17,10609,3,3,1, 10612
24,10619,1,1,1, 10620
1,10626,1,1,0, 10627
31,10626,2,2,1, 10628
7,10632,1,1,1, 10633
24,10649,1,1,1, 10650
1,10656,1,1,1, 10657
7,10662,1,1,1, 10663
24,10679,1,1,0, 10680
23,10678,3,3,1, 10681
1,10686,1,1,0, 10687
8,10696,1,1,1, 10697
17,10699,3,3,1, 10702
18,10703,4,4,1, 10707
24,10709,1,1,0, 10710
1,10716,1,1,1, 10717
8,10726,1,1,0, 10727
9,10727,2,2,1, 10729
16,10729,2,2,1, 10731
15,10731,2,2,1, 10733
18,10733,4,4,1, 10737
24,10739,1,1,0, 10740
2,10743,2,2,1, 10745
1,10746,1,1,1, 10747
31,10746,2,2,1, 10748
9,10757,2,2,1, 10759
15,10761,2,4,1, 10765
24,10769,1,1,1, 10770
1,10776,1,1,1, 10777
31,10776,2,2,1, 10778
9,10787,2,2,1, 10789
14,10789,3,3,1, 10792
13,10789,4,4,1, 10793
15,10791,2,4,1, 10795
24,10799,1,1,0, 10800
23,10798,3,3,1, 10801
1,10806,1,1,0, 10807
7,10812,1,1,0, 10813
16,10819,2,2,1, 10821
24,10829,1,1,0, 10830
1,10836,1,1,0, 10837
7,10842,1,1,0, 10843
8,10846,1,1,0, 10847
16,10849,2,2,1, 10851
17,10849,3,3,1, 10852
18,10853,4,4,1, 10857
24,10859,1,1,1, 10860
25,10865,2,2,1, 10867
1,10866,1,1,1, 10867
7,10872,1,1,0, 10873
8,10876,1,1,0, 10877
9,10877,2,2,1, 10879
16,10879,2,2,1, 10881
25,10895,2,2,1, 10897
1,10896,1,1,1, 10897
7,10902,1,1,0, 10903
8,10906,1,1,0, 10907
16,10909,2,2,1, 10911
14,10909,3,3,1, 10912
13,10909,4,4,1, 10913
23,10918,3,3,1, 10921
7,10932,1,1,1, 10933
8,10936,1,1,1, 10937
7,10962,1,1,0, 10963
8,10966,1,1,1, 10967
7,10992,1,1,0, 10993
8,10996,1,1,0, 10997
17,10999,3,3,1, 11002
24,11009,1,1,1, 11010
7,11022,1,1,0, 11023
8,11026,1,1,0, 11027
16,11029,2,2,1, 11031
18,11033,4,4,1, 11037
24,11039,1,1,1, 11040
1,11046,1,1,1, 11047
31,11046,2,2,1, 11048
7,11052,1,1,0, 11053
8,11056,1,1,1, 11057
1,11076,1,1,1, 11077
31,11076,2,2,1, 11078
7,11082,1,1,1, 11083
8,11086,1,1,1, 11087
1,11106,1,1,1, 11107
7,11112,1,1,1, 11113
8,11116,1,1,1, 11117
1,11136,1,1,0, 11137
7,11142,1,1,1, 11143
8,11146,1,1,0, 11147
16,11149,2,2,1, 11151
18,11153,4,4,1, 11157
22,11156,4,4,1, 11160
24,11159,1,1,0, 11160
1,11166,1,1,0, 11167
8,11176,1,1,0, 11177
15,11181,2,2,1, 11183
24,11189,1,1,1, 11190
1,11196,1,1,1, 11197
8,11206,1,1,0, 11207
24,11219,1,1,0, 11220
1,11226,1,1,1, 11227
8,11236,1,1,1, 11237
15,11241,2,2,1, 11243
24,11249,1,1,0, 11250
1,11256,1,1,0, 11257
7,11262,1,1,0, 11263
8,11266,1,1,1, 11267
14,11269,3,3,1, 11272
17,11269,3,3,1, 11272
24,11279,1,1,1, 11280
23,11278,3,3,1, 11281
1,11286,1,1,0, 11287
24,11309,1,1,1, 11310
1,11316,1,1,0, 11317
24,11339,1,1,0, 11340
1,11346,1,1,1, 11347
24,11369,1,1,0, 11370
1,11376,1,1,0, 11377
7,11382,1,1,1, 11383
8,11386,1,1,1, 11387
9,11387,2,2,1, 11389
16,11389,2,2,1, 11391
24,11399,1,1,1, 11400
1,11406,1,1,0, 11407
5,11407,3,3,1, 11410
6,11410,2,2,1, 11412
7,11412,1,1,0, 11413
8,11416,1,1,1, 11417
24,11429,1,1,0, 11430
1,11436,1,1,0, 11437
7,11442,1,1,1, 11443
8,11446,1,1,1, 11447
14,11449,3,3,1, 11452
24,11459,1,1,1, 11460
23,11458,3,3,1, 11461
1,11466,1,1,1, 11467
8,11476,1,1,0, 11477
24,11489,1,1,1, 11490
23,11488,3,3,1, 11491
1,11496,1,1,0, 11497
8,11506,1,1,1, 11507
17,11509,3,3,1, 11512
18,11513,4,4,1, 11517
22,11516,4,4,1, 11520
24,11519,1,1,1, 11520
25,11525,2,2,1, 11527
1,11526,1,1,1, 11527
5,11527,3,3,1, 11530
6,11530,2,2,1, 11532
7,11532,1,1,0, 11533
8,11536,1,1,1, 11537
24,11549,1,1,0, 11550
1,11556,1,1,1, 11557
7,11562,1,1,0, 11563
8,11566,1,1,1, 11567
24,11579,1,1,1, 11580
2,11583,2,2,1, 11585
1,11586,1,1,1, 11587
7,11592,1,1,0, 11593
8,11596,1,1,0, 11597
24,11609,1,1,1, 11610
1,11616,1,1,0, 11617
7,11622,1,1,1, 11623
8,11626,1,1,0, 11627
9,11627,2,2,1, 11629
16,11629,2,2,1, 11631
17,11629,3,3,1, 11632
18,11633,4,4,1, 11637
22,11636,4,4,1, 11640
24,11639,1,1,1, 11640
2,11643,2,2,1, 11645
1,11646,1,1,1, 11647
1,11676,1,1,1, 11677
1,11706,1,1,1, 11707
1,11736,1,1,1, 11737
8,11746,1,1,0, 11747
9,11747,2,2,1, 11749
14,11749,3,3,1, 11752
24,11759,1,1,1, 11760
23,11758,3,3,1, 11761
25,11765,2,2,1, 11767
26,11767,3,3,1, 11770
8,11776,1,1,0, 11777
8,11806,1,1,0, 11807
8,11836,1,1,1, 11837
7,11862,1,1,1, 11863
8,11866,1,1,0, 11867
9,11867,2,2,1, 11869
17,11869,3,3,1, 11872
24,11879,1,1,0, 11880
1,11886,1,1,0, 11887
7,11892,1,1,0, 11893
8,11896,1,1,1, 11897
24,11909,1,1,0, 11910
1,11916,1,1,0, 11917
7,11922,1,1,0, 11923
8,11926,1,1,1, 11927
15,11931,2,2,1, 11933
24,11939,1,1,0, 11940
1,11946,1,1,0, 11947
7,11952,1,1,1, 11953
8,11956,1,1,0, 11957
17,11959,3,3,1, 11962
24,11969,1,1,1, 11970
1,11976,1,1,1, 11977
7,11982,1,1,0, 11983
8,11986,1,1,0, 11987
24,11999,1,1,1, 12000
2,12003,2,2,1, 12005
1,12006,1,1,0, 12007
7,12012,1,1,1, 12013
8,12016,1,1,0, 12017
24,12029,1,1,0, 12030
1,12036,1,1,1, 12037
7,12042,1,1,1, 12043
8,12046,1,1,0, 12047
24,12059,1,1,1, 12060
1,12066,1,1,1, 12067
7,12072,1,1,0, 12073
8,12076,1,1,0, 12077
24,12089,1,1,1, 12090
1,12096,1,1,0, 12097
7,12102,1,1,1, 12103
8,12106,1,1,0, 12107
9,12107,2,2,1, 12109
16,12109,2,2,1, 12111
13,12109,4,4,1, 12113
24,12119,1,1,0, 12120
25,12125,2,2,1, 12127
24,12149,1,1,1, 12150
24,12179,1,1,1, 12180
24,12209,1,1,1, 12210
8,12226,1,1,0, 12227
16,12229,2,2,1, 12231
17,12229,3,3,1, 12232
15,12231,2,2,1, 12233
24,12239,1,1,1, 12240
7,12252,1,1,0, 12253
8,12256,1,1,1, 12257
7,12282,1,1,1, 12283
8,12286,1,1,0, 12287
1,12306,1,1,0, 12307
7,12312,1,1,0, 12313
8,12316,1,1,0, 12317
16,12319,2,2,1, 12321
24,12329,1,1,1, 12330
2,12333,2,2,1, 12335
1,12336,1,1,0, 12337
7,12342,1,1,0, 12343
8,12346,1,1,0, 12347
16,12349,2,2,1, 12351
24,12359,1,1,1, 12360
23,12358,3,3,1, 12361
2,12363,2,2,1, 12365
1,12366,1,1,0, 12367
31,12366,2,2,1, 12368
5,12367,3,3,1, 12370
7,12372,1,1,0, 12373
22,12386,4,4,1, 12390
24,12389,1,1,0, 12390
2,12393,2,2,1, 12395
1,12396,1,1,0, 12397
7,12402,1,1,0, 12403
17,12409,3,3,1, 12412
24,12419,1,1,1, 12420
25,12425,2,2,1, 12427
1,12426,1,1,1, 12427
7,12432,1,1,1, 12433
8,12436,1,1,0, 12437
16,12439,2,2,1, 12441
17,12439,3,3,1, 12442
25,12455,2,2,1, 12457
1,12456,1,1,1, 12457
7,12462,1,1,0, 12463
8,12466,1,1,1, 12467
16,12469,2,2,1, 12471
15,12471,2,2,1, 12473
1,12486,1,1,0, 12487
31,12486,2,4,1, 12490
5,12487,3,5,1, 12492
8,12496,1,1,0, 12497
13,12499,4,4,1, 12503
15,12501,2,2,1, 12503
1,12516,1,1,0, 12517
8,12526,1,1,0, 12527
14,12529,3,3,1, 12532
15,12531,2,2,1, 12533
24,12539,1,1,0, 12540
23,12538,3,3,1, 12541
24,12569,1,1,1, 12570
24,12599,1,1,0, 12600
6,12610,2,2,1, 12612
7,12612,1,1,1, 12613
15,12621,2,2,1, 12623
24,12629,1,1,1, 12630
6,12640,2,2,1, 12642
7,12642,1,1,1, 12643
9,12647,2,2,1, 12649
17,12649,3,3,1, 12652
24,12659,1,1,0, 12660
23,12658,3,3,1, 12661
7,12672,1,1,0, 12673
8,12676,1,1,0, 12677
24,12689,1,1,0, 12690
5,12697,3,3,1, 12700
7,12702,1,1,1, 12703
8,12706,1,1,1, 12707
24,12719,1,1,1, 12720
5,12727,3,3,1, 12730
7,12732,1,1,1, 12733
8,12736,1,1,1, 12737
24,12749,1,1,1, 12750
5,12757,3,3,1, 12760
6,12760,2,2,1, 12762
7,12762,1,1,1, 12763
8,12766,1,1,1, 12767
9,12767,2,2,1, 12769
17,12769,3,3,1, 12772
24,12779,1,1,1, 12780
7,12792,1,1,1, 12793
8,12796,1,1,0, 12797
24,12809,1,1,1, 12810
7,12822,1,1,1, 12823
8,12826,1,1,1, 12827
24,12839,1,1,1, 12840
7,12852,1,1,0, 12853
8,12856,1,1,0, 12857
24,12869,1,1,0, 12870
7,12882,1,1,0, 12883
8,12886,1,1,1, 12887
15,12891,2,2,1, 12893
22,12896,4,4,1, 12900
24,12899,1,1,0, 12900
8,12916,1,1,1, 12917
15,12921,2,2,1, 12923
24,12929,1,1,1, 12930
8,12946,1,1,1, 12947
24,12959,1,1,0, 12960
8,12976,1,1,0, 12977
24,12989,1,1,1, 12990
23,12988,3,3,1, 12991
8,13006,1,1,0, 13007
9,13007,2,2,1, 13009
14,13009,3,3,1, 13012
17,13009,3,3,1, 13012
13,13009,4,4,1, 13013
15,13011,2,2,1, 13013
24,13019,1,1,0, 13020
30,13023,3,3,1, 13026
5,13027,3,3,1, 13030
6,13030,2,2,1, 13032
7,13032,1,1,1, 13033
7,13062,1,1,1, 13063
7,13092,1,1,1, 13093
7,13122,1,1,1, 13123
8,13126,1,1,0, 13127
9,13127,2,2,1, 13129
17,13129,3,3,1, 13132
13,13129,4,4,1, 13133
22,13136,4,4,1, 13140
24,13139,1,1,0, 13140
23,13138,3,3,1, 13141
7,13152,1,1,1, 13153
24,13169,1,1,0, 13170
7,13182,1,1,1, 13183
24,13199,1,1,0, 13200
7,13212,1,1,1, 13213
24,13229,1,1,0, 13230
7,13242,1,1,0, 13243
8,13246,1,1,0, 13247
16,13249,2,2,1, 13251
17,13249,3,3,1, 13252
22,13256,4,4,1, 13260
24,13259,1,1,0, 13260
30,13263,3,3,1, 13266
1,13266,1,1,0, 13267
31,13266,2,2,1, 13268
7,13272,1,1,0, 13273
24,13289,1,1,0, 13290
1,13296,1,1,0, 13297
7,13302,1,1,0, 13303
24,13319,1,1,0, 13320
1,13326,1,1,1, 13327
7,13332,1,1,0, 13333
24,13349,1,1,1, 13350
1,13356,1,1,0, 13357
7,13362,1,1,1, 13363
8,13366,1,1,1, 13367
9,13367,2,2,1, 13369
15,13371,2,2,1, 13373
22,13376,4,4,1, 13380
24,13379,1,1,1, 13380
8,13486,1,1,1, 13487
14,13489,3,3,1, 13492
15,13491,2,2,1, 13493
24,13499,1,1,1, 13500
7,13512,1,1,0, 13513
8,13516,1,1,0, 13517
24,13529,1,1,0, 13530
7,13542,1,1,1, 13543
8,13546,1,1,1, 13547
24,13559,1,1,0, 13560
7,13572,1,1,1, 13573
8,13576,1,1,1, 13577
24,13589,1,1,1, 13590
7,13602,1,1,1, 13603
8,13606,1,1,1, 13607
14,13609,3,3,1, 13612
17,13609,3,3,1, 13612
15,13611,2,2,1, 13613
22,13616,4,4,1, 13620
24,13619,1,1,1, 13620
30,13623,3,3,1, 13626
7,13632,1,1,1, 13633
7,13662,1,1,0, 13663
7,13692,1,1,0, 13693
7,13722,1,1,0, 13723
8,13726,1,1,1, 13727
9,13727,2,2,1, 13729
17,13729,3,3,1, 13732
22,13736,4,4,1, 13740
24,13739,1,1,0, 13740
23,13738,3,3,1, 13741
24,13769,1,1,1, 13770
24,13799,1,1,1, 13800
24,13829,1,1,0, 13830
8,13846,1,1,1, 13847
15,13851,2,2,1, 13853
14,13849,3,5,1, 13854
22,13856,4,4,1, 13860
24,13859,1,1,0, 13860
23,13858,3,3,1, 13861
7,13872,1,1,1, 13873
24,13889,1,1,0, 13890
7,13902,1,1,0, 13903
24,13919,1,1,0, 13920
7,13932,1,1,0, 13933
24,13949,1,1,0, 13950
7,13962,1,1,0, 13963
8,13966,1,1,0, 13967
16,13969,2,2,1, 13971
14,13969,3,3,1, 13972
22,13976,4,4,1, 13980
24,13979,1,1,0, 13980
7,13992,1,1,1, 13993
7,14022,1,1,0, 14023
7,14052,1,1,0, 14053
7,14082,1,1,1, 14083
8,14086,1,1,1, 14087
16,14089,2,2,1, 14091
17,14089,3,3,1, 14092
15,14091,2,2,1, 14093
24,14099,1,1,1, 14100
24,14129,1,1,1, 14130
31,14136,2,2,1, 14138
24,14159,1,1,0, 14160
31,14166,2,2,1, 14168
24,14189,1,1,1, 14190
8,14206,1,1,0, 14207
9,14207,2,2,1, 14209
24,14219,1,1,1, 14220
30,14223,3,3,1, 14226
1,14226,1,1,0, 14227
31,14226,2,2,1, 14228
7,14232,1,1,1, 14233
8,14236,1,1,0, 14237
25,14255,2,2,1, 14257
1,14256,1,1,1, 14257
6,14260,2,2,1, 14262
7,14262,1,1,1, 14263
8,14266,1,1,1, 14267
30,14283,3,3,1, 14286
25,14285,2,2,1, 14287
1,14286,1,1,1, 14287
7,14292,1,1,1, 14293
8,14296,1,1,0, 14297
9,14297,2,2,1, 14299
15,14301,2,2,1, 14303
25,14315,2,2,1, 14317
1,14316,1,1,1, 14317
7,14322,1,1,1, 14323
8,14326,1,1,1, 14327
9,14327,2,2,1, 14329
13,14329,4,4,1, 14333
15,14331,2,2,1, 14333
24,14339,1,1,0, 14340
2,14343,2,2,1, 14345
24,14369,1,1,0, 14370
15,14391,2,4,1, 14395
24,14399,1,1,0, 14400
24,14429,1,1,1, 14430
8,14446,1,1,1, 14447
15,14451,2,4,1, 14455
24,14459,1,1,0, 14460
23,14458,3,3,1, 14461
22,14456,4,6,1, 14462
25,14465,2,2,1, 14467
1,14466,1,1,0, 14467
6,14470,2,2,1, 14472
7,14472,1,1,0, 14473
8,14476,1,1,1, 14477
24,14489,1,1,0, 14490
6,14500,2,2,1, 14502
7,14502,1,1,1, 14503
8,14506,1,1,0, 14507
24,14519,1,1,1, 14520
7,14532,1,1,1, 14533
8,14536,1,1,1, 14537
15,14541,2,4,1, 14545
24,14549,1,1,0, 14550
23,14548,3,3,1, 14551
7,14562,1,1,0, 14563
8,14566,1,1,1, 14567
9,14567,2,2,1, 14569
16,14569,2,2,1, 14571
15,14571,2,2,1, 14573
24,14579,1,1,1, 14580
25,14585,2,2,1, 14587
1,14586,1,1,1, 14587
31,14586,2,2,1, 14588
7,14592,1,1,1, 14593
8,14596,1,1,0, 14597
24,14609,1,1,0, 14610
1,14616,1,1,0, 14617
7,14622,1,1,1, 14623
8,14626,1,1,1, 14627
24,14639,1,1,0, 14640
1,14646,1,1,1, 14647
8,14656,1,1,1, 14657
24,14669,1,1,1, 14670
1,14676,1,1,0, 14677
8,14686,1,1,1, 14687
17,14689,3,3,1, 14692
24,14699,1,1,0, 14700
8,14716,1,1,0, 14717
24,14729,1,1,1, 14730
8,14746,1,1,0, 14747
22,14756,4,4,1, 14760
24,14759,1,1,0, 14760
7,14772,1,1,0, 14773
8,14776,1,1,0, 14777
7,14802,1,1,0, 14803
8,14806,1,1,1, 14807
9,14807,2,2,1, 14809
17,14809,3,5,1, 14814
7,14832,1,1,1, 14833
8,14836,1,1,0, 14837
16,14839,2,2,1, 14841
7,14862,1,1,0, 14863
8,14866,1,1,0, 14867
16,14869,2,2,1, 14871
15,14871,2,2,1, 14873
22,14876,4,4,1, 14880
24,14939,1,1,0, 14940
1,14946,1,1,1, 14947
8,14956,1,1,1, 14957
24,14969,1,1,0, 14970
1,14976,1,1,0, 14977
31,14976,2,2,1, 14978
7,14982,1,1,1, 14983
8,14986,1,1,1, 14987
15,14991,2,2,1, 14993
22,14996,4,4,1, 15000
24,14999,1,1,0, 15000
1,15006,1,1,0, 15007
7,15012,1,1,1, 15013
8,15016,1,1,0, 15017
24,15029,1,1,0, 15030
1,15036,1,1,0, 15037
7,15042,1,1,0, 15043
8,15046,1,1,0, 15047
9,15047,2,2,1, 15049
17,15049,3,3,1, 15052
24,15059,1,1,1, 15060
1,15066,1,1,0, 15067
6,15070,2,2,1, 15072
7,15072,1,1,0, 15073
24,15089,1,1,0, 15090
1,15096,1,1,0, 15097
6,15100,2,2,1, 15102
7,15102,1,1,1, 15103
9,15107,2,2,1, 15109
15,15111,2,2,1, 15113
24,15119,1,1,1, 15120
23,15118,3,3,1, 15121
7,15132,1,1,1, 15133
8,15136,1,1,1, 15137
16,15139,2,2,1, 15141
24,15149,1,1,1, 15150
7,15162,1,1,1, 15163
8,15166,1,1,1, 15167
16,15169,2,2,1, 15171
24,15179,1,1,1, 15180
25,15185,2,2,1, 15187
1,15186,1,1,1, 15187
7,15192,1,1,0, 15193
8,15196,1,1,1, 15197
25,15215,2,2,1, 15217
1,15216,1,1,0, 15217
7,15222,1,1,1, 15223
8,15226,1,1,0, 15227
15,15231,2,2,1, 15233
1,15246,1,1,1, 15247
6,15250,2,2,1, 15252
7,15252,1,1,0, 15253
8,15256,1,1,0, 15257
14,15259,3,3,1, 15262
13,15259,4,4,1, 15263
2,15273,2,2,1, 15275
1,15276,1,1,1, 15277
26,15277,3,3,1, 15280
6,15280,2,2,1, 15282
7,15282,1,1,0, 15283
8,15286,1,1,0, 15287
16,15289,2,2,1, 15291
14,15289,3,3,1, 15292
17,15289,3,3,1, 15292
13,15289,4,4,1, 15293
15,15291,2,2,1, 15293
24,15299,1,1,0, 15300
31,15306,2,2,1, 15308
6,15310,2,2,1, 15312
7,15312,1,1,1, 15313
24,15329,1,1,1, 15330
6,15340,2,2,1, 15342
7,15342,1,1,1, 15343
24,15359,1,1,1, 15360
7,15372,1,1,0, 15373
24,15389,1,1,0, 15390
7,15402,1,1,1, 15403
8,15406,1,1,0, 15407
9,15407,2,2,1, 15409
24,15419,1,1,0, 15420
7,15432,1,1,0, 15433
8,15436,1,1,0, 15437
24,15449,1,1,0, 15450
7,15462,1,1,1, 15463
8,15466,1,1,0, 15467
24,15479,1,1,1, 15480
7,15492,1,1,1, 15493
8,15496,1,1,0, 15497
24,15509,1,1,1, 15510
7,15522,1,1,0, 15523
8,15526,1,1,1, 15527
17,15529,3,3,1, 15532
13,15529,4,4,1, 15533
15,15531,2,2,1, 15533
18,15533,4,4,1, 15537
22,15536,4,4,1, 15540
24,15539,1,1,1, 15540
23,15538,3,3,1, 15541
1,15546,1,1,1, 15547
31,15546,2,2,1, 15548
6,15550,2,2,1, 15552
7,15552,1,1,1, 15553
24,15569,1,1,1, 15570
2,15573,2,2,1, 15575
1,15576,1,1,1, 15577
7,15582,1,1,0, 15583
24,15599,1,1,1, 15600
1,15606,1,1,0, 15607
31,15606,2,2,1, 15608
6,15610,2,2,1, 15612
7,15612,1,1,1, 15613
24,15629,1,1,1, 15630
2,15633,2,2,1, 15635
1,15636,1,1,0, 15637
31,15636,2,2,1, 15638
7,15642,1,1,1, 15643
8,15646,1,1,0, 15647
9,15647,2,2,1, 15649
22,15656,4,4,1, 15660
24,15659,1,1,0, 15660
24,15689,1,1,0, 15690
24,15719,1,1,0, 15720
24,15749,1,1,0, 15750
8,15766,1,1,1, 15767
16,15769,2,2,1, 15771
14,15769,3,3,1, 15772
15,15771,2,2,1, 15773
18,15773,4,4,1, 15777
22,15776,4,4,1, 15780
24,15779,1,1,1, 15780
23,15778,3,3,1, 15781
8,15796,1,1,0, 15797
24,15809,1,1,1, 15810
8,15826,1,1,0, 15827
24,15839,1,1,0, 15840
8,15856,1,1,1, 15857
24,15869,1,1,0, 15870
8,15886,1,1,1, 15887
9,15887,2,2,1, 15889
18,15893,4,4,1, 15897
24,15899,1,1,1, 15900
2,15903,2,2,1, 15905
1,15906,1,1,0, 15907
7,15912,1,1,1, 15913
8,15916,1,1,0, 15917
14,15919,3,3,1, 15922
15,15921,2,2,1, 15923
24,15929,1,1,0, 15930
1,15936,1,1,0, 15937
31,15936,2,2,1, 15938
7,15942,1,1,1, 15943
8,15946,1,1,1, 15947
14,15949,3,3,1, 15952
13,15949,4,4,1, 15953
24,15959,1,1,1, 15960
1,15966,1,1,1, 15967
7,15972,1,1,0, 15973
8,15976,1,1,1, 15977
24,15989,1,1,1, 15990
1,15996,1,1,1, 15997
7,16002,1,1,0, 16003
8,16006,1,1,0, 16007
16,16009,2,2,1, 16011
14,16009,3,5,1, 16014
13,16009,4,6,1, 16015
22,16016,4,4,1, 16020
24,16019,1,1,1, 16020
23,16018,3,3,1, 16021
1,16026,1,1,0, 16027
7,16032,1,1,1, 16033
8,16036,1,1,0, 16037
24,16049,1,1,1, 16050
1,16056,1,1,0, 16057
31,16056,2,2,1, 16058
7,16062,1,1,0, 16063
8,16066,1,1,0, 16067
24,16079,1,1,0, 16080
7,16092,1,1,1, 16093
8,16096,1,1,0, 16097
24,16109,1,1,0, 16110
7,16122,1,1,0, 16123
8,16126,1,1,1, 16127
24,16139,1,1,0, 16140
31,16146,2,2,1, 16148
7,16152,1,1,1, 16153
8,16156,1,1,1, 16157
24,16169,1,1,0, 16170
31,16176,2,2,1, 16178
7,16182,1,1,0, 16183
8,16186,1,1,0, 16187
24,16199,1,1,1, 16200
1,16206,1,1,0, 16207
8,16216,1,1,1, 16217
1,16236,1,1,0, 16237
8,16246,1,1,0, 16247
1,16266,1,1,1, 16267
8,16276,1,1,0, 16277
1,16296,1,1,0, 16297
8,16306,1,1,0, 16307
9,16307,2,2,1, 16309
15,16311,2,2,1, 16313
18,16313,4,4,1, 16317
24,16319,1,1,1, 16320
23,16318,3,3,1, 16321
31,16326,2,2,1, 16328
7,16332,1,1,1, 16333
14,16339,3,3,1, 16342
13,16339,4,4,1, 16343
24,16349,1,1,1, 16350
30,16353,3,5,1, 16358
7,16362,1,1,1, 16363
14,16369,3,3,1, 16372
13,16369,4,4,1, 16373
22,16376,4,4,1, 16380
24,16379,1,1,0, 16380
7,16392,1,1,0, 16393
24,16409,1,1,0, 16410
31,16416,2,2,1, 16418
7,16422,1,1,0, 16423
8,16426,1,1,0, 16427
9,16427,2,2,1, 16429
16,16429,2,2,1, 16431
18,16433,4,4,1, 16437
24,16439,1,1,1, 16440
1,16446,1,1,0, 16447
31,16446,2,2,1, 16448
7,16452,1,1,0, 16453
8,16456,1,1,1, 16457
14,16459,3,3,1, 16462
22,16466,4,4,1, 16470
24,16469,1,1,1, 16470
23,16468,3,3,1, 16471
1,16476,1,1,0, 16477
30,16473,3,5,1, 16478
7,16482,1,1,1, 16483
8,16486,1,1,1, 16487
14,16489,3,3,1, 16492
22,16496,4,4,1, 16500
24,16499,1,1,0, 16500
21,16497,5,5,1, 16502
1,16506,1,1,0, 16507
6,16510,2,2,1, 16512
7,16512,1,1,1, 16513
8,16516,1,1,0, 16517
24,16529,1,1,0, 16530
1,16536,1,1,1, 16537
6,16540,2,2,1, 16542
7,16542,1,1,1, 16543
8,16546,1,1,1, 16547
16,16549,2,2,1, 16551
24,16559,1,1,1, 16560
23,16558,3,3,1, 16561
6,16570,2,2,1, 16572
7,16572,1,1,0, 16573
8,16576,1,1,1, 16577
6,16600,2,2,1, 16602
7,16602,1,1,0, 16603
8,16606,1,1,0, 16607
15,16611,2,2,1, 16613
22,16616,4,4,1, 16620
23,16618,3,3,1, 16621
21,16617,5,5,1, 16622
8,16636,1,1,1, 16637
8,16666,1,1,1, 16667
9,16667,2,2,1, 16669
18,16673,4,4,1, 16677
24,16679,1,1,1, 16680
1,16686,1,1,0, 16687
16,16699,2,2,1, 16701
24,16709,1,1,0, 16710
1,16716,1,1,0, 16717
31,16716,2,2,1, 16718
24,16739,1,1,0, 16740
1,16746,1,1,1, 16747
7,16752,1,1,0, 16753
15,16761,2,2,1, 16763
24,16769,1,1,0, 16770
1,16776,1,1,1, 16777
31,16776,2,2,1, 16778
7,16782,1,1,1, 16783
8,16786,1,1,0, 16787
16,16789,2,2,1, 16791
18,16793,4,4,1, 16797
24,16799,1,1,1, 16800
23,16798,3,3,1, 16801
2,16803,2,2,1, 16805
1,16806,1,1,0, 16807
7,16812,1,1,0, 16813
8,16816,1,1,1, 16817
24,16829,1,1,0, 16830
2,16833,2,2,1, 16835
1,16836,1,1,0, 16837
6,16840,2,2,1, 16842
7,16842,1,1,1, 16843
8,16846,1,1,0, 16847
24,16859,1,1,0, 16860
1,16866,1,1,1, 16867
8,16876,1,1,0, 16877
24,16889,1,1,0, 16890
1,16896,1,1,0, 16897
8,16906,1,1,0, 16907
9,16907,2,2,1, 16909
17,16909,3,3,1, 16912
18,16913,4,4,1, 16917
24,16919,1,1,1, 16920
2,16923,2,2,1, 16925
25,16925,2,2,1, 16927
1,16926,1,1,1, 16927
8,16936,1,1,1, 16937
1,16956,1,1,1, 16957
8,16966,1,1,1, 16967
15,16971,2,2,1, 16973
23,16978,3,3,1, 16981
1,16986,1,1,1, 16987
31,16986,2,2,1, 16988
7,16992,1,1,0, 16993
8,16996,1,1,0, 16997
1,17016,1,1,1, 17017
7,17022,1,1,0, 17023
8,17026,1,1,1, 17027
9,17027,2,2,1, 17029
24,17039,1,1,0, 17040
31,17046,2,2,1, 17048
7,17052,1,1,1, 17053
8,17056,1,1,0, 17057
24,17069,1,1,1, 17070
31,17076,2,2,1, 17078
7,17082,1,1,1, 17083
8,17086,1,1,0, 17087
24,17099,1,1,1, 17100
8,17116,1,1,1, 17117
24,17129,1,1,0, 17130
8,17146,1,1,1, 17147
17,17149,3,3,1, 17152
24,17159,1,1,1, 17160
1,17166,1,1,0, 17167
8,17176,1,1,0, 17177
24,17189,1,1,1, 17190
1,17196,1,1,0, 17197
8,17206,1,1,0, 17207
24,17219,1,1,1, 17220
1,17226,1,1,1, 17227
6,17230,2,2,1, 17232
7,17232,1,1,0, 17233
8,17236,1,1,1, 17237
24,17249,1,1,0, 17250
1,17256,1,1,1, 17257
31,17256,2,2,1, 17258
7,17262,1,1,1, 17263
8,17266,1,1,0, 17267
9,17267,2,2,1, 17269
18,17273,4,4,1, 17277
24,17279,1,1,0, 17280
31,17286,2,2,1, 17288
7,17292,1,1,0, 17293
24,17309,1,1,1, 17310
31,17316,2,2,1, 17318
7,17322,1,1,0, 17323
24,17339,1,1,1, 17340
7,17352,1,1,1, 17353
24,17369,1,1,1, 17370
31,17376,2,2,1, 17378
6,17380,2,2,1, 17382
7,17382,1,1,0, 17383
8,17386,1,1,1, 17387
9,17387,2,2,1, 17389
17,17389,3,3,1, 17392
24,17399,1,1,0, 17400
23,17398,3,3,1, 17401
8,17416,1,1,1, 17417
24,17429,1,1,1, 17430
31,17436,2,2,1, 17438
8,17446,1,1,1, 17447
24,17459,1,1,0, 17460
8,17476,1,1,1, 17477
24,17489,1,1,0, 17490
31,17496,2,2,1, 17498
8,17506,1,1,0, 17507
17,17509,3,3,1, 17512
24,17519,1,1,1, 17520
1,17526,1,1,0, 17527
31,17526,2,2,1, 17528
7,17532,1,1,1, 17533
24,17549,1,1,1, 17550
1,17556,1,1,1, 17557
31,17556,2,2,1, 17558
7,17562,1,1,1, 17563
24,17579,1,1,1, 17580
1,17586,1,1,0, 17587
6,17590,2,2,1, 17592
7,17592,1,1,0, 17593
24,17609,1,1,1, 17610
1,17616,1,1,0, 17617
31,17616,2,2,1, 17618
6,17620,2,2,1, 17622
7,17622,1,1,0, 17623
8,17626,1,1,0, 17627
16,17629,2,2,1, 17631
18,17633,4,4,1, 17637
24,17639,1,1,1, 17640
21,17637,5,5,1, 17642
8,17656,1,1,1, 17657
8,17686,1,1,0, 17687
8,17716,1,1,1, 17717
8,17746,1,1,0, 17747
9,17747,2,2,1, 17749
16,17749,2,2,1, 17751
15,17751,2,2,1, 17753
18,17753,4,4,1, 17757
24,17759,1,1,0, 17760
23,17758,3,3,1, 17761
1,17766,1,1,0, 17767
7,17772,1,1,1, 17773
24,17789,1,1,0, 17790
1,17796,1,1,0, 17797
31,17796,2,2,1, 17798
7,17802,1,1,1, 17803
24,17819,1,1,0, 17820
1,17826,1,1,1, 17827
31,17826,2,2,1, 17828
6,17830,2,2,1, 17832
7,17832,1,1,0, 17833
24,17849,1,1,0, 17850
25,17855,2,2,1, 17857
1,17856,1,1,0, 17857
6,17860,2,2,1, 17862
7,17862,1,1,0, 17863
8,17866,1,1,1, 17867
17,17869,3,3,1, 17872
15,17871,2,2,1, 17873
24,17879,1,1,1, 17880
23,17878,3,3,1, 17881
8,17896,1,1,0, 17897
8,17926,1,1,0, 17927
8,17956,1,1,1, 17957
8,17986,1,1,1, 17987
9,17987,2,2,1, 17989
17,17989,3,3,1, 17992
15,17991,2,2,1, 17993
24,17999,1,1,1, 18000
31,18006,2,2,1, 18008
6,18010,2,2,1, 18012
7,18012,1,1,0, 18013
8,18016,1,1,1, 18017
24,18029,1,1,1, 18030
31,18036,2,2,1, 18038
7,18042,1,1,0, 18043
8,18046,1,1,1, 18047
24,18059,1,1,0, 18060
6,18070,2,2,1, 18072
7,18072,1,1,0, 18073
8,18076,1,1,1, 18077
24,18089,1,1,1, 18090
7,18102,1,1,0, 18103
8,18106,1,1,1, 18107
24,18119,1,1,0, 18120
23,18118,3,3,1, 18121
8,18136,1,1,1, 18137
8,18166,1,1,0, 18167
8,18196,1,1,1, 18197
8,18226,1,1,1, 18227
17,18229,3,3,1, 18232
18,18233,4,4,1, 18237
24,18239,1,1,1, 18240
23,18238,3,3,1, 18241
2,18243,2,2,1, 18245
1,18246,1,1,1, 18247
31,18246,2,2,1, 18248
7,18252,1,1,1, 18253
8,18256,1,1,0, 18257
24,18269,1,1,1, 18270
1,18276,1,1,1, 18277
7,18282,1,1,1, 18283
8,18286,1,1,0, 18287
24,18299,1,1,1, 18300
1,18306,1,1,0, 18307
7,18312,1,1,1, 18313
8,18316,1,1,0, 18317
24,18329,1,1,0, 18330
1,18336,1,1,0, 18337
31,18336,2,2,1, 18338
7,18342,1,1,0, 18343
8,18346,1,1,1, 18347
15,18351,2,2,1, 18353
24,18359,1,1,1, 18360
6,18370,2,2,1, 18372
7,18372,1,1,1, 18373
8,18376,1,1,1, 18377
24,18389,1,1,0, 18390
6,18400,2,2,1, 18402
7,18402,1,1,0, 18403
8,18406,1,1,0, 18407
15,18411,2,2,1, 18413
24,18419,1,1,0, 18420
23,18418,3,3,1, 18421
31,18426,2,2,1, 18428
8,18436,1,1,0, 18437
24,18449,1,1,0, 18450
31,18456,2,2,1, 18458
8,18466,1,1,0, 18467
9,18467,2,2,1, 18469
17,18469,3,3,1, 18472
24,18479,1,1,1, 18480
23,18478,3,3,1, 18481
25,18485,2,2,1, 18487
1,18486,1,1,1, 18487
8,18496,1,1,0, 18497
1,18516,1,1,1, 18517
8,18526,1,1,1, 18527
1,18546,1,1,1, 18547
7,18552,1,1,1, 18553
8,18556,1,1,0, 18557
15,18561,2,2,1, 18563
1,18576,1,1,1, 18577
31,18576,2,2,1, 18578
7,18582,1,1,1, 18583
8,18586,1,1,1, 18587
17,18589,3,3,1, 18592
18,18593,4,4,1, 18597
24,18599,1,1,0, 18600
2,18603,2,2,1, 18605
25,18605,2,2,1, 18607
1,18606,1,1,1, 18607
7,18612,1,1,0, 18613
2,18633,2,2,1, 18635
1,18636,1,1,0, 18637
31,18636,2,2,1, 18638
7,18642,1,1,1, 18643
9,18647,2,2,1, 18649
7,18672,1,1,0, 18673
7,18702,1,1,0, 18703
8,18706,1,1,1, 18707
24,18719,1,1,1, 18720
7,18732,1,1,1, 18733
8,18736,1,1,1, 18737
16,18739,2,2,1, 18741
24,18749,1,1,1, 18750
7,18762,1,1,1, 18763
8,18766,1,1,1, 18767
24,18779,1,1,0, 18780
1,18786,1,1,0, 18787
31,18786,2,2,1, 18788
7,18792,1,1,1, 18793
8,18796,1,1,1, 18797
9,18797,2,2,1, 18799
24,18809,1,1,1, 18810
2,18813,2,2,1, 18815
1,18816,1,1,0, 18817
7,18822,1,1,1, 18823
8,18826,1,1,1, 18827
9,18827,2,2,1, 18829
16,18829,2,2,1, 18831
17,18829,3,3,1, 18832
18,18833,4,4,1, 18837
24,18839,1,1,0, 18840
1,18846,1,1,1, 18847
31,18846,2,2,1, 18848
24,18869,1,1,0, 18870
1,18876,1,1,0, 18877
24,18899,1,1,0, 18900
1,18906,1,1,1, 18907
31,18906,2,2,1, 18908
24,18929,1,1,0, 18930
1,18936,1,1,0, 18937
31,18936,2,2,1, 18938
8,18946,1,1,1, 18947
9,18947,2,2,1, 18949
17,18949,3,3,1, 18952
24,18959,1,1,0, 18960
2,18963,2,2,1, 18965
1,18966,1,1,0, 18967
31,18966,2,2,1, 18968
6,18970,2,2,1, 18972
7,18972,1,1,1, 18973
8,18976,1,1,0, 18977
23,18988,3,3,1, 18991
1,18996,1,1,0, 18997
31,18996,2,2,1, 18998
7,19002,1,1,0, 19003
8,19006,1,1,1, 19007
14,19009,3,3,1, 19012
15,19011,2,2,1, 19013
1,19026,1,1,0, 19027
31,19026,2,2,1, 19028
6,19030,2,2,1, 19032
7,19032,1,1,0, 19033
8,19036,1,1,1, 19037
2,19053,2,2,1, 19055
1,19056,1,1,0, 19057
31,19056,2,2,1, 19058
6,19060,2,2,1, 19062
7,19062,1,1,0, 19063
8,19066,1,1,1, 19067
9,19067,2,2,1, 19069
16,19069,2,2,1, 19071
24,19079,1,1,0, 19080
23,19078,3,3,1, 19081
25,19085,2,2,1, 19087
7,19092,1,1,0, 19093
8,19096,1,1,0, 19097
24,19109,1,1,1, 19110
25,19115,2,2,1, 19117
31,19116,2,2,1, 19118
7,19122,1,1,1, 19123
8,19126,1,1,0, 19127
24,19139,1,1,0, 19140
23,19138,3,3,1, 19141
25,19145,2,2,1, 19147
31,19146,2,2,1, 19148
8,19156,1,1,0, 19157
24,19169,1,1,1, 19170
25,19175,2,2,1, 19177
8,19186,1,1,0, 19187
16,19189,2,2,1, 19191
24,19199,1,1,0, 19200
23,19198,3,3,1, 19201
2,19203,2,2,1, 19205
1,19206,1,1,0, 19207
8,19216,1,1,0, 19217
16,19219,2,2,1, 19221
23,19228,3,3,1, 19231
1,19236,1,1,0, 19237
8,19246,1,1,0, 19247
15,19251,2,2,1, 19253
2,19263,2,2,1, 19265
1,19266,1,1,0, 19267
7,19272,1,1,1, 19273
15,19281,2,2,1, 19283
1,19296,1,1,0, 19297
31,19296,2,2,1, 19298
6,19300,2,2,1, 19302
7,19302,1,1,1, 19303
15,19311,2,2,1, 19313
24,19319,1,1,0, 19320
1,19326,1,1,1, 19327
24,19349,1,1,0, 19350
2,19353,2,2,1, 19355
1,19356,1,1,1, 19357
31,19356,2,2,1, 19358
24,19379,1,1,1, 19380
2,19383,2,2,1, 19385
1,19386,1,1,0, 19387
24,19409,1,1,0, 19410
2,19413,2,2,1, 19415
1,19416,1,1,1, 19417
31,19416,2,2,1, 19418
8,19426,1,1,1, 19427
9,19427,2,2,1, 19429
15,19431,2,2,1, 19433
24,19439,1,1,1, 19440
23,19438,3,3,1, 19441
25,19445,2,2,1, 19447
7,19452,1,1,1, 19453
8,19456,1,1,1, 19457
24,19469,1,1,0, 19470
31,19476,2,2,1, 19478
7,19482,1,1,0, 19483
8,19486,1,1,0, 19487
24,19499,1,1,1, 19500
7,19512,1,1,1, 19513
8,19516,1,1,1, 19517
24,19529,1,1,0, 19530
31,19536,2,2,1, 19538
7,19542,1,1,1, 19543
8,19546,1,1,0, 19547
16,19549,2,2,1, 19551
17,19549,3,3,1, 19552
24,19559,1,1,0, 19560
23,19558,3,3,1, 19561
31,19566,2,2,1, 19568
7,19572,1,1,1, 19573
8,19576,1,1,1, 19577
24,19589,1,1,1, 19590
31,19596,2,2,1, 19598
7,19602,1,1,1, 19603
8,19606,1,1,0, 19607
24,19619,1,1,1, 19620
31,19626,2,2,1, 19628
6,19630,2,2,1, 19632
7,19632,1,1,0, 19633
8,19636,1,1,0, 19637
14,19639,3,3,1, 19642
24,19649,1,1,0, 19650
31,19656,2,2,1, 19658
7,19662,1,1,0, 19663
8,19666,1,1,0, 19667
16,19669,2,2,1, 19671
15,19671,2,2,1, 19673
24,19679,1,1,0, 19680
23,19678,3,3,1, 19681
25,19685,2,2,1, 19687
1,19686,1,1,0, 19687
1,19716,1,1,1, 19717
1,19746,1,1,1, 19747
1,19776,1,1,0, 19777
8,19786,1,1,1, 19787
9,19787,2,2,1, 19789
17,19789,3,3,1, 19792
18,19793,4,4,1, 19797
24,19799,1,1,1, 19800
1,19806,1,1,0, 19807
31,19806,2,2,1, 19808
7,19812,1,1,1, 19813
8,19816,1,1,0, 19817
24,19829,1,1,1, 19830
2,19833,2,2,1, 19835
25,19835,2,2,1, 19837
1,19836,1,1,0, 19837
31,19836,2,2,1, 19838
7,19842,1,1,1, 19843
8,19846,1,1,0, 19847
24,19859,1,1,1, 19860
2,19863,2,2,1, 19865
1,19866,1,1,0, 19867
31,19866,2,2,1, 19868
7,19872,1,1,0, 19873
8,19876,1,1,0, 19877
15,19881,2,2,1, 19883
24,19889,1,1,0, 19890
2,19893,2,2,1, 19895
25,19895,2,2,1, 19897
1,19896,1,1,1, 19897
7,19902,1,1,0, 19903
8,19906,1,1,1, 19907
9,19907,2,2,1, 19909
16,19909,2,2,1, 19911
14,19909,3,3,1, 19912
15,19911,2,2,1, 19913
24,19919,1,1,0, 19920
23,19918,3,3,1, 19921
31,19926,2,2,1, 19928
6,19930,2,2,1, 19932
7,19932,1,1,1, 19933
6,19960,2,2,1, 19962
7,19962,1,1,1, 19963
7,19992,1,1,0, 19993
31,20016,2,2,1, 20018
7,20022,1,1,1, 20023
8,20026,1,1,1, 20027
17,20029,3,3,1, 20032
24,20039,1,1,1, 20040
2,20043,2,2,1, 20045
1,20046,1,1,0, 20047
6,20050,2,2,1, 20052
7,20052,1,1,0, 20053
8,20056,1,1,1, 20057
14,20059,3,3,1, 20062
24,20069,1,1,1, 20070
2,20073,2,2,1, 20075
25,20075,2,2,1, 20077
1,20076,1,1,0, 20077
31,20076,2,2,1, 20078
6,20080,2,2,1, 20082
7,20082,1,1,0, 20083
8,20086,1,1,0, 20087
17,20089,3,3,1, 20092
15,20091,2,2,1, 20093
24,20099,1,1,1, 20100
2,20103,2,2,1, 20105
1,20106,1,1,1, 20107
8,20116,1,1,0, 20117
15,20121,2,2,1, 20123
24,20129,1,1,1, 20130
1,20136,1,1,1, 20137
8,20146,1,1,0, 20147
9,20147,2,2,1, 20149
16,20149,2,2,1, 20151
24,20159,1,1,1, 20160
8,20176,1,1,0, 20177
24,20189,1,1,1, 20190
31,20196,2,2,1, 20198
8,20206,1,1,0, 20207
24,20219,1,1,0, 20220
1,20226,1,1,0, 20227
31,20226,2,2,1, 20228
26,20227,3,3,1, 20230
7,20232,1,1,1, 20233
8,20236,1,1,1, 20237
9,20237,2,2,1, 20239
24,20249,1,1,0, 20250
25,20255,2,2,1, 20257
1,20256,1,1,0, 20257
31,20256,2,2,1, 20258
7,20262,1,1,1, 20263
8,20266,1,1,1, 20267
24,20279,1,1,0, 20280
7,20292,1,1,0, 20293
8,20296,1,1,1, 20297
16,20299,2,2,1, 20301
24,20309,1,1,0, 20310
31,20316,2,2,1, 20318
7,20322,1,1,0, 20323
8,20326,1,1,1, 20327
15,20331,2,2,1, 20333
24,20339,1,1,0, 20340
23,20338,3,3,1, 20341
7,20352,1,1,0, 20353
8,20356,1,1,0, 20357
6,20380,2,2,1, 20382
7,20382,1,1,0, 20383
8,20386,1,1,0, 20387
6,20410,2,2,1, 20412
7,20412,1,1,1, 20413
8,20416,1,1,1, 20417
24,20429,1,1,1, 20430
7,20442,1,1,0, 20443
8,20446,1,1,1, 20447
15,20451,2,2,1, 20453
24,20459,1,1,0, 20460
23,20458,3,3,1, 20461
7,20472,1,1,0, 20473
8,20476,1,1,1, 20477
24,20489,1,1,0, 20490
7,20502,1,1,1, 20503
8,20506,1,1,0, 20507
24,20519,1,1,0, 20520
7,20532,1,1,1, 20533
8,20536,1,1,1, 20537
31,20556,2,2,1, 20558
7,20562,1,1,1, 20563
8,20566,1,1,0, 20567
15,20571,2,2,1, 20573
23,20578,3,3,1, 20581
8,20596,1,1,0, 20597
8,20626,1,1,1, 20627
9,20627,2,2,1, 20629
24,20639,1,1,0, 20640
2,20643,2,2,1, 20645
1,20646,1,1,0, 20647
26,20647,3,3,1, 20650
8,20656,1,1,1, 20657
24,20669,1,1,1, 20670
25,20675,2,2,1, 20677
1,20676,1,1,0, 20677
8,20686,1,1,0, 20687
24,20699,1,1,1, 20700
31,20706,2,2,1, 20708
7,20712,1,1,1, 20713
8,20716,1,1,1, 20717
24,20729,1,1,0, 20730
7,20742,1,1,1, 20743
8,20746,1,1,1, 20747
16,20749,2,2,1, 20751
17,20749,3,3,1, 20752
24,20759,1,1,0, 20760
2,20763,2,2,1, 20765
1,20766,1,1,1, 20767
31,20766,2,2,1, 20768
7,20772,1,1,1, 20773
8,20776,1,1,1, 20777
16,20779,2,2,1, 20781
1,20796,1,1,0, 20797
31,20796,2,2,1, 20798
7,20802,1,1,1, 20803
8,20806,1,1,1, 20807
1,20826,1,1,0, 20827
6,20830,2,2,1, 20832
7,20832,1,1,0, 20833
8,20836,1,1,0, 20837
16,20839,2,2,1, 20841
2,20853,2,2,1, 20855
1,20856,1,1,0, 20857
7,20862,1,1,1, 20863
8,20866,1,1,0, 20867
16,20869,2,2,1, 20871
24,20879,1,1,1, 20880
1,20886,1,1,0, 20887
6,20890,2,2,1, 20892
7,20892,1,1,1, 20893
16,20899,2,2,1, 20901
24,20909,1,1,1, 20910
1,20916,1,1,1, 20917
6,20920,2,2,1, 20922
7,20922,1,1,1, 20923
16,20929,2,2,1, 20931
24,20939,1,1,0, 20940
23,20938,3,3,1, 20941
1,20946,1,1,0, 20947
31,20946,2,2,1, 20948
7,20952,1,1,1, 20953
24,20969,1,1,1, 20970
1,20976,1,1,0, 20977
31,20976,2,2,1, 20978
7,20982,1,1,0, 20983
8,20986,1,1,0, 20987
17,20989,3,3,1, 20992
24,20999,1,1,1, 21000
31,21006,2,2,1, 21008
6,21010,2,4,1, 21014
8,21016,1,1,0, 21017
14,21019,3,3,1, 21022
15,21021,2,2,1, 21023
24,21029,1,1,0, 21030
8,21046,1,1,1, 21047
14,21049,3,3,1, 21052
24,21059,1,1,1, 21060
31,21066,2,2,1, 21068
8,21076,1,1,1, 21077
24,21089,1,1,0, 21090
8,21106,1,1,1, 21107
9,21107,2,2,1, 21109
17,21109,3,3,1, 21112
24,21119,1,1,1, 21120
7,21132,1,1,0, 21133
8,21136,1,1,1, 21137
24,21149,1,1,1, 21150
7,21162,1,1,0, 21163
8,21166,1,1,1, 21167
24,21179,1,1,1, 21180
7,21192,1,1,1, 21193
8,21196,1,1,1, 21197
24,21209,1,1,0, 21210
31,21216,2,2,1, 21218
7,21222,1,1,0, 21223
8,21226,1,1,1, 21227
9,21227,2,2,1, 21229
16,21229,2,2,1, 21231
15,21231,2,2,1, 21233
18,21233,4,4,1, 21237
24,21239,1,1,1, 21240
7,21252,1,1,0, 21253
8,21256,1,1,1, 21257
31,21276,2,2,1, 21278
6,21280,2,2,1, 21282
7,21282,1,1,0, 21283
8,21286,1,1,0, 21287
7,21312,1,1,1, 21313
8,21316,1,1,0, 21317
7,21342,1,1,1, 21343
8,21346,1,1,0, 21347
9,21347,2,2,1, 21349
16,21349,2,2,1, 21351
17,21349,3,3,1, 21352
15,21351,2,2,1, 21353
18,21353,4,4,1, 21357
24,21359,1,1,1, 21360
1,21366,1,1,1, 21367
7,21372,1,1,1, 21373
24,21389,1,1,0, 21390
1,21396,1,1,0, 21397
31,21396,2,2,1, 21398
7,21402,1,1,1, 21403
24,21419,1,1,0, 21420
1,21426,1,1,0, 21427
31,21426,2,2,1, 21428
7,21432,1,1,0, 21433
24,21449,1,1,1, 21450
1,21456,1,1,1, 21457
7,21462,1,1,0, 21463
8,21466,1,1,0, 21467
9,21467,2,2,1, 21469
16,21469,2,2,1, 21471
17,21469,3,3,1, 21472
15,21471,2,2,1, 21473
24,21479,1,1,1, 21480
1,21486,1,1,0, 21487
1,21516,1,1,0, 21517
1,21546,1,1,0, 21547
1,21576,1,1,1, 21577
8,21586,1,1,1, 21587
16,21589,2,2,1, 21591
17,21589,3,3,1, 21592
15,21591,2,2,1, 21593
18,21593,4,4,1, 21597
24,21599,1,1,0, 21600
31,21606,2,2,1, 21608
7,21612,1,1,0, 21613
24,21629,1,1,0, 21630
6,21640,2,2,1, 21642
7,21642,1,1,0, 21643
24,21659,1,1,1, 21660
6,21670,2,2,1, 21672
7,21672,1,1,1, 21673
24,21689,1,1,0, 21690
31,21696,2,2,1, 21698
6,21700,2,2,1, 21702
7,21702,1,1,1, 21703
8,21706,1,1,1, 21707
16,21709,2,2,1, 21711
17,21709,3,3,1, 21712
24,21719,1,1,1, 21720
23,21718,3,3,1, 21721
31,21726,2,2,1, 21728
8,21736,1,1,1, 21737
24,21749,1,1,1, 21750
31,21756,2,2,1, 21758
8,21766,1,1,0, 21767
24,21779,1,1,1, 21780
31,21786,2,2,1, 21788
8,21796,1,1,0, 21797
24,21809,1,1,0, 21810
31,21816,2,2,1, 21818
8,21826,1,1,1, 21827
9,21827,2,2,1, 21829
24,21839,1,1,1, 21840
1,21846,1,1,0, 21847
6,21850,2,2,1, 21852
7,21852,1,1,0, 21853
1,21876,1,1,0, 21877
7,21882,1,1,0, 21883
1,21906,1,1,1, 21907
7,21912,1,1,1, 21913
1,21936,1,1,0, 21937
7,21942,1,1,0, 21943
8,21946,1,1,1, 21947
16,21949,2,2,1, 21951
17,21949,3,3,1, 21952
24,21959,1,1,1, 21960
23,21958,3,3,1, 21961
1,21966,1,1,1, 21967
7,21972,1,1,0, 21973
8,21976,1,1,1, 21977
24,21989,1,1,1, 21990
2,21993,2,2,1, 21995
1,21996,1,1,0, 21997
7,22002,1,1,1, 22003
8,22006,1,1,0, 22007
24,22019,1,1,1, 22020
2,22023,2,2,1, 22025
1,22026,1,1,1, 22027
7,22032,1,1,0, 22033
8,22036,1,1,0, 22037
24,22049,1,1,1, 22050
1,22056,1,1,0, 22057
6,22060,2,2,1, 22062
7,22062,1,1,0, 22063
8,22066,1,1,1, 22067
9,22067,2,2,1, 22069
16,22069,2,2,1, 22071
15,22071,2,2,1, 22073
24,22079,1,1,0, 22080
7,22092,1,1,0, 22093
16,22099,2,2,1, 22101
15,22101,2,2,1, 22103
24,22109,1,1,0, 22110
6,22120,2,2,1, 22122
7,22122,1,1,0, 22123
24,22139,1,1,0, 22140
23,22138,3,3,1, 22141
31,22146,2,2,1, 22148
24,22169,1,1,0, 22170
31,22176,2,2,1, 22178
8,22186,1,1,1, 22187
9,22187,2,2,1, 22189
17,22189,3,3,1, 22192
24,22199,1,1,0, 22200
2,22203,2,2,1, 22205
1,22206,1,1,1, 22207
31,22206,2,2,1, 22208
7,22212,1,1,1, 22213
8,22216,1,1,0, 22217
15,22221,2,2,1, 22223
24,22229,1,1,0, 22230
1,22236,1,1,1, 22237
7,22242,1,1,1, 22243
8,22246,1,1,0, 22247
15,22251,2,2,1, 22253
24,22259,1,1,1, 22260
23,22258,3,3,1, 22261
1,22266,1,1,0, 22267
6,22270,2,2,1, 22272
7,22272,1,1,1, 22273
8,22276,1,1,1, 22277
24,22289,1,1,1, 22290
1,22296,1,1,0, 22297
6,22300,2,2,1, 22302
7,22302,1,1,1, 22303
8,22306,1,1,0, 22307
24,22319,1,1,1, 22320
6,22330,2,2,1, 22332
7,22332,1,1,1, 22333
8,22336,1,1,1, 22337
31,22356,2,2,1, 22358
7,22362,1,1,1, 22363
8,22366,1,1,1, 22367
16,22369,2,2,1, 22371
8,22396,1,1,0, 22397
8,22426,1,1,1, 22427
17,22429,3,3,1, 22432
18,22433,4,4,1, 22437
24,22439,1,1,1, 22440
8,22456,1,1,0, 22457
24,22469,1,1,1, 22470
31,22476,2,2,1, 22478
8,22486,1,1,1, 22487
24,22499,1,1,0, 22500
7,22512,1,1,1, 22513
8,22516,1,1,1, 22517
24,22529,1,1,1, 22530
6,22540,2,2,1, 22542
7,22542,1,1,0, 22543
8,22546,1,1,1, 22547
9,22547,2,2,1, 22549
17,22549,3,3,1, 22552
18,22553,4,4,1, 22557
24,22559,1,1,1, 22560
1,22566,1,1,0, 22567
6,22570,2,2,1, 22572
7,22572,1,1,0, 22573
8,22576,1,1,1, 22577
9,22577,2,2,1, 22579
24,22589,1,1,1, 22590
1,22596,1,1,1, 22597
7,22602,1,1,0, 22603
8,22606,1,1,1, 22607
9,22607,2,2,1, 22609
24,22619,1,1,0, 22620
1,22626,1,1,1, 22627
7,22632,1,1,1, 22633
8,22636,1,1,0, 22637
16,22639,2,2,1, 22641
24,22649,1,1,0, 22650
1,22656,1,1,0, 22657
31,22656,2,2,1, 22658
7,22662,1,1,0, 22663
8,22666,1,1,1, 22667
24,22679,1,1,1, 22680
2,22683,2,2,1, 22685
1,22686,1,1,1, 22687
31,22686,2,2,1, 22688
7,22692,1,1,1, 22693
8,22696,1,1,1, 22697
16,22699,2,2,1, 22701
24,22709,1,1,0, 22710
1,22716,1,1,1, 22717
7,22722,1,1,0, 22723
8,22726,1,1,0, 22727
16,22729,2,2,1, 22731
24,22739,1,1,1, 22740
23,22738,3,3,1, 22741
6,22750,2,2,1, 22752
7,22752,1,1,0, 22753
31,22776,2,2,1, 22778
6,22780,2,2,1, 22782
7,22782,1,1,0, 22783
7,22812,1,1,0, 22813
31,22836,2,2,1, 22838
6,22840,2,2,1, 22842
7,22842,1,1,0, 22843
8,22846,1,1,0, 22847
9,22847,2,2,1, 22849
24,22859,1,1,0, 22860
23,22858,3,3,1, 22861
1,22866,1,1,1, 22867
31,22866,2,2,1, 22868
8,22876,1,1,0, 22877
24,22889,1,1,0, 22890
1,22896,1,1,1, 22897
8,22906,1,1,0, 22907
16,22909,2,2,1, 22911
17,22909,3,3,1, 22912
24,22919,1,1,1, 22920
1,22926,1,1,0, 22927
31,22926,2,2,1, 22928
8,22936,1,1,0, 22937
24,22949,1,1,1, 22950
2,22953,2,2,1, 22955
1,22956,1,1,1, 22957
31,22956,2,2,1, 22958
8,22966,1,1,0, 22967
24,22979,1,1,1, 22980
23,22978,3,3,1, 22981
1,22986,1,1,0, 22987
6,22990,2,2,1, 22992
7,22992,1,1,0, 22993
24,23009,1,1,0, 23010
1,23016,1,1,0, 23017
6,23020,2,2,1, 23022
7,23022,1,1,0, 23023
24,23039,1,1,0, 23040
1,23046,1,1,0, 23047
31,23046,2,2,1, 23048
6,23050,2,2,1, 23052
7,23052,1,1,1, 23053
24,23069,1,1,1, 23070
25,23075,2,2,1, 23077
1,23076,1,1,1, 23077
6,23080,2,2,1, 23082
7,23082,1,1,0, 23083
8,23086,1,1,1, 23087
16,23089,2,2,1, 23091
24,23099,1,1,1, 23100
23,23098,3,3,1, 23101
8,23116,1,1,0, 23117
8,23146,1,1,1, 23147
8,23176,1,1,0, 23177
8,23206,1,1,0, 23207
16,23209,2,2,1, 23211
24,23219,1,1,1, 23220
23,23218,3,3,1, 23221
1,23226,1,1,1, 23227
6,23230,2,2,1, 23232
7,23232,1,1,0, 23233
24,23249,1,1,0, 23250
1,23256,1,1,0, 23257
31,23256,2,2,1, 23258
7,23262,1,1,1, 23263
15,23271,2,2,1, 23273
24,23279,1,1,0, 23280
2,23283,2,2,1, 23285
1,23286,1,1,0, 23287
7,23292,1,1,1, 23293
24,23309,1,1,1, 23310
1,23316,1,1,1, 23317
6,23320,2,2,1, 23322
7,23322,1,1,1, 23323
8,23326,1,1,1, 23327
9,23327,2,2,1, 23329
16,23329,2,2,1, 23331
24,23339,1,1,1, 23340
8,23356,1,1,1, 23357
8,23386,1,1,0, 23387
8,23416,1,1,0, 23417
8,23446,1,1,0, 23447
24,23459,1,1,0, 23460
31,23466,2,2,1, 23468
6,23470,2,2,1, 23472
7,23472,1,1,1, 23473
8,23476,1,1,1, 23477
24,23489,1,1,1, 23490
6,23500,2,2,1, 23502
7,23502,1,1,0, 23503
8,23506,1,1,0, 23507
24,23519,1,1,1, 23520
31,23526,2,2,1, 23528
7,23532,1,1,0, 23533
8,23536,1,1,0, 23537
24,23549,1,1,0, 23550
6,23560,2,2,1, 23562
7,23562,1,1,0, 23563
8,23566,1,1,0, 23567
16,23569,2,2,1, 23571
24,23579,1,1,0, 23580
23,23578,3,3,1, 23581
8,23596,1,1,1, 23597
8,23626,1,1,0, 23627
8,23656,1,1,1, 23657
8,23686,1,1,1, 23687
9,23687,2,2,1, 23689
17,23689,3,3,1, 23692
24,23699,1,1,0, 23700
25,23705,2,2,1, 23707
1,23706,1,1,1, 23707
31,23706,2,2,1, 23708
7,23712,1,1,0, 23713
16,23719,2,2,1, 23721
24,23729,1,1,0, 23730
2,23733,2,2,1, 23735
1,23736,1,1,0, 23737
7,23742,1,1,1, 23743
16,23749,2,2,1, 23751
24,23759,1,1,1, 23760
1,23766,1,1,0, 23767
7,23772,1,1,0, 23773
25,23795,2,2,1, 23797
1,23796,1,1,0, 23797
31,23796,2,2,1, 23798
7,23802,1,1,0, 23803
8,23806,1,1,0, 23807
17,23809,3,3,1, 23812
15,23811,2,2,1, 23813
8,23836,1,1,1, 23837
9,23837,2,2,1, 23839
8,23866,1,1,1, 23867
9,23867,2,2,1, 23869
24,23879,1,1,1, 23880
8,23896,1,1,0, 23897
9,23897,2,2,1, 23899
16,23899,2,2,1, 23901
24,23909,1,1,1, 23910
31,23916,2,2,1, 23918
8,23926,1,1,1, 23927
9,23927,2,2,1, 23929
16,23929,2,2,1, 23931
17,23929,3,3,1, 23932
24,23939,1,1,1, 23940
23,23938,3,3,1, 23941
25,23945,2,2,1, 23947
1,23946,1,1,0, 23947
7,23952,1,1,1, 23953
9,23957,2,2,1, 23959
14,23959,3,3,1, 23962
15,23961,2,2,1, 23963
24,23969,1,1,0, 23970
2,23973,2,2,1, 23975
1,23976,1,1,0, 23977
7,23982,1,1,1, 23983
9,23987,2,2,1, 23989
14,23989,3,3,1, 23992
15,23991,2,2,1, 23993
24,23999,1,1,0, 24000
23,23998,3,3,1, 24001
1,24006,1,1,0, 24007
24,24029,1,1,0, 24030
1,24036,1,1,1, 24037
17,24049,3,3,1, 24052
24,24059,1,1,0, 24060
25,24065,2,2,1, 24067
1,24066,1,1,1, 24067
8,24076,1,1,0, 24077
16,24079,2,2,1, 24081
24,24089,1,1,0, 24090
25,24095,2,2,1, 24097
1,24096,1,1,0, 24097
8,24106,1,1,1, 24107
16,24109,2,2,1, 24111
24,24119,1,1,0, 24120
1,24126,1,1,0, 24127
7,24132,1,1,0, 24133
8,24136,1,1,1, 24137
24,24149,1,1,0, 24150
1,24156,1,1,1, 24157
7,24162,1,1,0, 24163
8,24166,1,1,0, 24167
24,24179,1,1,1, 24180
31,24186,2,2,1, 24188
7,24192,1,1,0, 24193
8,24196,1,1,0, 24197
6,24220,2,2,1, 24222
7,24222,1,1,1, 24223
8,24226,1,1,0, 24227
15,24231,2,2,1, 24233
23,24238,3,3,1, 24241
6,24250,2,2,1, 24252
7,24252,1,1,1, 24253
8,24256,1,1,0, 24257
24,24269,1,1,1, 24270
23,24268,3,3,1, 24271
7,24282,1,1,0, 24283
8,24286,1,1,1, 24287
9,24287,2,2,1, 24289
16,24289,2,2,1, 24291
24,24299,1,1,1, 24300
25,24305,2,2,1, 24307
1,24306,1,1,1, 24307
31,24306,2,2,1, 24308
6,24310,2,2,1, 24312
7,24312,1,1,1, 24313
8,24316,1,1,1, 24317
24,24329,1,1,0, 24330
1,24336,1,1,1, 24337
7,24342,1,1,1, 24343
8,24346,1,1,0, 24347
15,24351,2,2,1, 24353
24,24359,1,1,1, 24360
23,24358,3,3,1, 24361
1,24366,1,1,0, 24367
31,24366,2,2,1, 24368
8,24376,1,1,0, 24377
24,24389,1,1,0, 24390
1,24396,1,1,0, 24397
31,24396,2,2,1, 24398
8,24406,1,1,1, 24407
9,24407,2,2,1, 24409
17,24409,3,3,1, 24412
24,24419,1,1,0, 24420
23,24418,3,3,1, 24421
25,24425,2,2,1, 24427
6,24430,2,2,1, 24432
7,24432,1,1,0, 24433
8,24436,1,1,1, 24437
24,24449,1,1,0, 24450
7,24462,1,1,1, 24463
8,24466,1,1,1, 24467
24,24479,1,1,0, 24480
31,24486,2,2,1, 24488
8,24496,1,1,0, 24497
24,24509,1,1,0, 24510
8,24526,1,1,1, 24527
16,24529,2,2,1, 24531
17,24529,3,3,1, 24532
24,24539,1,1,0, 24540
23,24538,3,3,1, 24541
1,24546,1,1,1, 24547
8,24556,1,1,1, 24557
1,24576,1,1,1, 24577
8,24586,1,1,0, 24587
14,24589,3,3,1, 24592
15,24591,2,2,1, 24593
1,24606,1,1,0, 24607
7,24612,1,1,1, 24613
8,24616,1,1,1, 24617
1,24636,1,1,1, 24637
7,24642,1,1,1, 24643
8,24646,1,1,0, 24647
24,24659,1,1,0, 24660
7,24672,1,1,0, 24673
8,24676,1,1,1, 24677
16,24679,2,2,1, 24681
24,24689,1,1,1, 24690
31,24696,2,2,1, 24698
7,24702,1,1,0, 24703
8,24706,1,1,0, 24707
16,24709,2,2,1, 24711
15,24711,2,2,1, 24713
24,24719,1,1,0, 24720
31,24726,2,2,1, 24728
7,24732,1,1,0, 24733
24,24749,1,1,1, 24750
31,24756,2,2,1, 24758
6,24760,2,2,1, 24762
7,24762,1,1,1, 24763
24,24779,1,1,0, 24780
1,24786,1,1,1, 24787
31,24786,2,2,1, 24788
6,24790,2,2,1, 24792
7,24792,1,1,1, 24793
8,24796,1,1,1, 24797
2,24813,2,2,1, 24815
1,24816,1,1,0, 24817
31,24816,2,2,1, 24818
7,24822,1,1,1, 24823
8,24826,1,1,0, 24827
1,24846,1,1,1, 24847
8,24856,1,1,0, 24857
2,24873,2,2,1, 24875
1,24876,1,1,0, 24877
8,24886,1,1,1, 24887
16,24889,2,2,1, 24891
24,24899,1,1,0, 24900
23,24898,3,3,1, 24901
24,24929,1,1,1, 24930
31,24936,2,2,1, 24938
16,24949,2,2,1, 24951
24,24959,1,1,1, 24960
6,24970,2,2,1, 24972
7,24972,1,1,0, 24973
24,24989,1,1,1, 24990
7,25002,1,1,1, 25003
8,25006,1,1,1, 25007
17,25009,3,3,1, 25012
24,25019,1,1,1, 25020
1,25026,1,1,1, 25027
6,25030,2,2,1, 25032
7,25032,1,1,0, 25033
8,25036,1,1,1, 25037
15,25041,2,2,1, 25043
24,25049,1,1,1, 25050
23,25048,3,3,1, 25051
1,25056,1,1,0, 25057
7,25062,1,1,1, 25063
8,25066,1,1,0, 25067
14,25069,3,3,1, 25072
15,25071,2,2,1, 25073
24,25079,1,1,1, 25080
1,25086,1,1,1, 25087
31,25086,2,2,1, 25088
7,25092,1,1,1, 25093
8,25096,1,1,0, 25097
24,25109,1,1,0, 25110
2,25113,2,2,1, 25115
1,25116,1,1,0, 25117
31,25116,2,2,1, 25118
6,25120,2,2,1, 25122
7,25122,1,1,1, 25123
8,25126,1,1,0, 25127
17,25129,3,3,1, 25132
24,25139,1,1,0, 25140
25,25145,2,2,1, 25147
1,25146,1,1,0, 25147
31,25146,2,2,1, 25148
7,25152,1,1,0, 25153
8,25156,1,1,1, 25157
16,25159,2,2,1, 25161
24,25169,1,1,0, 25170
25,25175,2,2,1, 25177
1,25176,1,1,0, 25177
31,25176,2,2,1, 25178
7,25182,1,1,1, 25183
8,25186,1,1,1, 25187
9,25187,2,2,1, 25189
14,25189,3,3,1, 25192
24,25199,1,1,1, 25200
23,25198,3,3,1, 25201
31,25206,2,2,1, 25208
6,25210,2,2,1, 25212
7,25212,1,1,1, 25213
8,25216,1,1,0, 25217
9,25217,2,2,1, 25219
31,25236,2,2,1, 25238
7,25242,1,1,1, 25243
8,25246,1,1,1, 25247
17,25249,3,3,1, 25252
7,25272,1,1,1, 25273
24,25289,1,1,1, 25290
7,25302,1,1,0, 25303
16,25309,2,2,1, 25311
24,25319,1,1,1, 25320
23,25318,3,3,1, 25321
1,25326,1,1,0, 25327
24,25349,1,1,1, 25350
2,25353,2,2,1, 25355
1,25356,1,1,1, 25357
31,25356,2,2,1, 25358
24,25379,1,1,1, 25380
2,25383,2,2,1, 25385
1,25386,1,1,1, 25387
31,25386,2,2,1, 25388
24,25409,1,1,0, 25410
25,25415,2,2,1, 25417
1,25416,1,1,0, 25417
8,25426,1,1,1, 25427
15,25431,2,2,1, 25433
24,25439,1,1,1, 25440
23,25438,3,3,1, 25441
1,25446,1,1,0, 25447
7,25452,1,1,1, 25453
8,25456,1,1,1, 25457
16,25459,2,2,1, 25461
23,25468,3,3,1, 25471
1,25476,1,1,0, 25477
7,25482,1,1,1, 25483
8,25486,1,1,1, 25487
23,25498,3,3,1, 25501
1,25506,1,1,1, 25507
7,25512,1,1,1, 25513
8,25516,1,1,1, 25517
1,25536,1,1,1, 25537
7,25542,1,1,0, 25543
8,25546,1,1,0, 25547
9,25547,2,2,1, 25549
16,25549,2,2,1, 25551
15,25551,2,2,1, 25553
24,25559,1,1,0, 25560
23,25558,3,3,1, 25561
31,25566,2,2,1, 25568
7,25572,1,1,1, 25573
17,25579,3,3,1, 25582
24,25589,1,1,0, 25590
31,25596,2,2,1, 25598
7,25602,1,1,1, 25603
24,25619,1,1,1, 25620
25,25625,2,2,1, 25627
31,25626,2,2,1, 25628
6,25630,2,2,1, 25632
7,25632,1,1,0, 25633
24,25649,1,1,1, 25650
31,25656,2,2,1, 25658
7,25662,1,1,1, 25663
8,25666,1,1,1, 25667
15,25671,2,2,1, 25673
24,25679,1,1,1, 25680
23,25678,3,3,1, 25681
2,25683,2,2,1, 25685
1,25686,1,1,0, 25687
8,25696,1,1,1, 25697
24,25709,1,1,0, 25710
1,25716,1,1,1, 25717
31,25716,2,2,1, 25718
8,25726,1,1,0, 25727
24,25739,1,1,1, 25740
2,25743,2,2,1, 25745
1,25746,1,1,1, 25747
8,25756,1,1,1, 25757
24,25769,1,1,1, 25770
1,25776,1,1,1, 25777
8,25786,1,1,1, 25787
9,25787,2,2,1, 25789
17,25789,3,3,1, 25792
24,25799,1,1,1, 25800
23,25798,3,3,1, 25801
1,25806,1,1,0, 25807
31,25806,2,2,1, 25808
7,25812,1,1,0, 25813
8,25816,1,1,1, 25817
24,25829,1,1,0, 25830
1,25836,1,1,1, 25837
31,25836,2,2,1, 25838
6,25840,2,2,1, 25842
7,25842,1,1,1, 25843
8,25846,1,1,1, 25847
24,25859,1,1,0, 25860
2,25863,2,2,1, 25865
1,25866,1,1,1, 25867
6,25870,2,2,1, 25872
7,25872,1,1,0, 25873
8,25876,1,1,1, 25877
24,25889,1,1,0, 25890
2,25893,2,2,1, 25895
1,25896,1,1,1, 25897
6,25900,2,2,1, 25902
7,25902,1,1,1, 25903
8,25906,1,1,1, 25907
16,25909,2,2,1, 25911
15,25911,2,2,1, 25913
24,25919,1,1,0, 25920
8,25936,1,1,1, 25937
16,25939,2,2,1, 25941
8,25966,1,1,0, 25967
16,25969,2,2,1, 25971
8,25996,1,1,0, 25997
8,26026,1,1,1, 26027
9,26027,2,2,1, 26029
16,26029,2,2,1, 26031
24,26039,1,1,1, 26040
23,26038,3,3,1, 26041
7,26052,1,1,0, 26053
8,26056,1,1,1, 26057
24,26069,1,1,1, 26070
7,26082,1,1,1, 26083
8,26086,1,1,1, 26087
24,26099,1,1,0, 26100
6,26110,2,2,1, 26112
7,26112,1,1,0, 26113
8,26116,1,1,1, 26117
24,26129,1,1,0, 26130
31,26136,2,2,1, 26138
7,26142,1,1,0, 26143
8,26146,1,1,1, 26147
16,26149,2,2,1, 26151
15,26151,2,2,1, 26153
24,26159,1,1,0, 26160
31,26166,2,2,1, 26168
8,26176,1,1,1, 26177
24,26189,1,1,1, 26190
31,26196,2,2,1, 26198
8,26206,1,1,1, 26207
24,26219,1,1,0, 26220
31,26226,2,2,1, 26228
8,26236,1,1,0, 26237
24,26249,1,1,0, 26250
8,26266,1,1,0, 26267
9,26267,2,2,1, 26269
17,26269,3,3,1, 26272
24,26279,1,1,1, 26280
31,26286,2,2,1, 26288
6,26290,2,2,1, 26292
7,26292,1,1,1, 26293
8,26296,1,1,1, 26297
6,26320,2,2,1, 26322
7,26322,1,1,0, 26323
8,26326,1,1,0, 26327
6,26350,2,2,1, 26352
7,26352,1,1,1, 26353
8,26356,1,1,0, 26357
6,26380,2,2,1, 26382
7,26382,1,1,1, 26383
8,26386,1,1,1, 26387
14,26389,3,3,1, 26392
17,26389,3,3,1, 26392
15,26391,2,2,1, 26393
24,26399,1,1,0, 26400
2,26403,2,2,1, 26405
1,26406,1,1,1, 26407
8,26416,1,1,0, 26417
24,26429,1,1,1, 26430
1,26436,1,1,1, 26437
8,26446,1,1,1, 26447
24,26459,1,1,0, 26460
2,26463,2,2,1, 26465
1,26466,1,1,0, 26467
8,26476,1,1,1, 26477
24,26489,1,1,0, 26490
1,26496,1,1,0, 26497
8,26506,1,1,1, 26507
15,26511,2,2,1, 26513
24,26519,1,1,1, 26520
6,26530,2,2,1, 26532
7,26532,1,1,0, 26533
24,26549,1,1,0, 26550
31,26556,2,2,1, 26558
7,26562,1,1,0, 26563
24,26579,1,1,1, 26580
31,26586,2,2,1, 26588
7,26592,1,1,0, 26593
24,26609,1,1,0, 26610
31,26616,2,2,1, 26618
7,26622,1,1,1, 26623
8,26626,1,1,0, 26627
9,26627,2,2,1, 26629
17,26629,3,3,1, 26632
24,26639,1,1,0, 26640
31,26646,2,2,1, 26648
8,26656,1,1,0, 26657
24,26669,1,1,1, 26670
8,26686,1,1,0, 26687
24,26699,1,1,0, 26700
31,26706,2,2,1, 26708
8,26716,1,1,1, 26717
24,26729,1,1,0, 26730
31,26736,2,2,1, 26738
8,26746,1,1,1, 26747
24,26759,1,1,0, 26760
23,26758,3,3,1, 26761
7,26772,1,1,1, 26773
8,26776,1,1,1, 26777
7,26802,1,1,0, 26803
8,26806,1,1,0, 26807
7,26832,1,1,0, 26833
8,26836,1,1,0, 26837
7,26862,1,1,0, 26863
8,26866,1,1,0, 26867
24,26879,1,1,1, 26880
23,26878,3,3,1, 26881
1,26886,1,1,1, 26887
31,26886,2,2,1, 26888
7,26892,1,1,1, 26893
24,26909,1,1,0, 26910
1,26916,1,1,1, 26917
7,26922,1,1,1, 26923
24,26939,1,1,0, 26940
1,26946,1,1,1, 26947
31,26946,2,2,1, 26948
7,26952,1,1,0, 26953
24,26969,1,1,0, 26970
1,26976,1,1,0, 26977
7,26982,1,1,1, 26983
8,26986,1,1,1, 26987
9,26987,2,2,1, 26989
17,26989,3,3,1, 26992
24,26999,1,1,1, 27000
23,26998,3,3,1, 27001
31,27006,2,2,1, 27008
7,27012,1,1,1, 27013
8,27016,1,1,1, 27017
24,27029,1,1,0, 27030
31,27036,2,2,1, 27038
6,27040,2,2,1, 27042
7,27042,1,1,0, 27043
8,27046,1,1,0, 27047
24,27059,1,1,1, 27060
31,27066,2,2,1, 27068
6,27070,2,2,1, 27072
7,27072,1,1,0, 27073
8,27076,1,1,0, 27077
24,27089,1,1,0, 27090
7,27102,1,1,1, 27103
8,27106,1,1,1, 27107
16,27109,2,2,1, 27111
15,27111,2,2,1, 27113
24,27119,1,1,1, 27120
23,27118,3,3,1, 27121
1,27126,1,1,1, 27127
26,27127,3,3,1, 27130
25,27155,2,2,1, 27157
1,27156,1,1,0, 27157
25,27185,2,2,1, 27187
1,27186,1,1,0, 27187
1,27216,1,1,0, 27217
8,27226,1,1,0, 27227
9,27227,2,2,1, 27229
17,27229,3,3,1, 27232
15,27231,2,2,1, 27233
24,27239,1,1,1, 27240
31,27246,2,2,1, 27248
7,27252,1,1,1, 27253
8,27256,1,1,0, 27257
24,27269,1,1,1, 27270
6,27280,2,2,1, 27282
7,27282,1,1,1, 27283
8,27286,1,1,1, 27287
24,27299,1,1,1, 27300
6,27310,2,2,1, 27312
7,27312,1,1,0, 27313
8,27316,1,1,0, 27317
24,27329,1,1,1, 27330
31,27336,2,2,1, 27338
6,27340,2,2,1, 27342
7,27342,1,1,0, 27343
8,27346,1,1,0, 27347
16,27349,2,2,1, 27351
24,27359,1,1,1, 27360
1,27366,1,1,1, 27367
31,27366,2,2,1, 27368
24,27389,1,1,1, 27390
1,27396,1,1,0, 27397
24,27419,1,1,1, 27420
1,27426,1,1,1, 27427
24,27449,1,1,0, 27450
1,27456,1,1,0, 27457
8,27466,1,1,1, 27467
9,27467,2,2,1, 27469
16,27469,2,2,1, 27471
24,27479,1,1,0, 27480
23,27478,3,3,1, 27481
7,27492,1,1,1, 27493
24,27509,1,1,0, 27510
7,27522,1,1,1, 27523
24,27539,1,1,0, 27540
31,27546,2,2,1, 27548
7,27552,1,1,1, 27553
24,27569,1,1,0, 27570
31,27576,2,2,1, 27578
6,27580,2,2,1, 27582
7,27582,1,1,1, 27583
8,27586,1,1,0, 27587
16,27589,2,2,1, 27591
15,27591,2,2,1, 27593
24,27599,1,1,1, 27600
23,27598,3,3,1, 27601
7,27672,1,1,0, 27673
14,27679,3,3,1, 27682
23,27688,3,3,1, 27691
31,27696,2,2,1, 27698
7,27702,1,1,1, 27703
8,27706,1,1,1, 27707
17,27709,3,3,1, 27712
24,27719,1,1,1, 27720
7,27732,1,1,0, 27733
8,27736,1,1,1, 27737
24,27749,1,1,0, 27750
7,27762,1,1,0, 27763
8,27766,1,1,1, 27767
24,27779,1,1,1, 27780
8,27796,1,1,0, 27797
24,27809,1,1,0, 27810
8,27826,1,1,1, 27827
9,27827,2,2,1, 27829
24,27839,1,1,1, 27840
1,27846,1,1,1, 27847
8,27856,1,1,0, 27857
24,27869,1,1,1, 27870
1,27876,1,1,0, 27877
8,27886,1,1,0, 27887
15,27891,2,2,1, 27893
24,27899,1,1,1, 27900
1,27906,1,1,1, 27907
31,27906,2,2,1, 27908
7,27912,1,1,0, 27913
8,27916,1,1,0, 27917
24,27929,1,1,0, 27930
1,27936,1,1,0, 27937
31,27936,2,2,1, 27938
7,27942,1,1,1, 27943
8,27946,1,1,1, 27947
17,27949,3,3,1, 27952
24,27959,1,1,1, 27960
7,27972,1,1,1, 27973
8,27976,1,1,0, 27977
31,27996,2,2,1, 27998
7,28002,1,1,1, 28003
8,28006,1,1,1, 28007
6,28030,2,2,1, 28032
7,28032,1,1,0, 28033
8,28036,1,1,1, 28037
31,28056,2,2,1, 28058
6,28060,2,2,1, 28062
7,28062,1,1,0, 28063
8,28066,1,1,0, 28067
24,28079,1,1,0, 28080
23,28078,3,3,1, 28081
7,28092,1,1,1, 28093
8,28096,1,1,0, 28097
24,28109,1,1,0, 28110
31,28116,2,2,1, 28118
6,28120,2,2,1, 28122
7,28122,1,1,0, 28123
8,28126,1,1,1, 28127
15,28131,2,2,1, 28133
24,28139,1,1,0, 28140
8,28156,1,1,0, 28157
24,28169,1,1,0, 28170
31,28176,2,2,1, 28178
8,28186,1,1,1, 28187
17,28189,3,3,1, 28192
24,28199,1,1,1, 28200
1,28206,1,1,0, 28207
8,28216,1,1,1, 28217
2,28233,2,2,1, 28235
1,28236,1,1,0, 28237
8,28246,1,1,0, 28247
14,28249,3,3,1, 28252
2,28263,2,2,1, 28265
1,28266,1,1,1, 28267
6,28270,2,2,1, 28272
7,28272,1,1,1, 28273
8,28276,1,1,1, 28277
9,28277,2,2,1, 28279
24,28289,1,1,0, 28290
1,28296,1,1,1, 28297
31,28296,2,2,1, 28298
7,28302,1,1,1, 28303
8,28306,1,1,1, 28307
9,28307,2,2,1, 28309
24,28319,1,1,0, 28320
31,28326,2,2,1, 28328
6,28330,2,2,1, 28332
7,28332,1,1,1, 28333
8,28336,1,1,1, 28337
24,28349,1,1,1, 28350
31,28356,2,2,1, 28358
6,28360,2,2,1, 28362
7,28362,1,1,0, 28363
8,28366,1,1,0, 28367
16,28369,2,2,1, 28371
15,28371,2,2,1, 28373
24,28379,1,1,0, 28380
23,28378,3,3,1, 28381
8,28396,1,1,0, 28397
8,28426,1,1,0, 28427
8,28456,1,1,1, 28457
8,28486,1,1,1, 28487
16,28489,2,2,1, 28491
17,28489,3,3,1, 28492
24,28499,1,1,0, 28500
23,28498,3,3,1, 28501
7,28512,1,1,1, 28513
8,28516,1,1,1, 28517
24,28529,1,1,1, 28530
7,28542,1,1,1, 28543
8,28546,1,1,0, 28547
24,28559,1,1,0, 28560
6,28570,2,2,1, 28572
7,28572,1,1,1, 28573
8,28576,1,1,1, 28577
24,28589,1,1,1, 28590
6,28600,2,2,1, 28602
7,28602,1,1,1, 28603
8,28606,1,1,0, 28607
9,28607,2,2,1, 28609
24,28619,1,1,1, 28620
23,28618,3,3,1, 28621
25,28625,2,2,1, 28627
31,28626,2,2,1, 28628
7,28632,1,1,1, 28633
8,28636,1,1,0, 28637
24,28649,1,1,0, 28650
31,28656,2,2,1, 28658
7,28662,1,1,0, 28663
8,28666,1,1,0, 28667
24,28679,1,1,1, 28680
31,28686,2,2,1, 28688
7,28692,1,1,1, 28693
8,28696,1,1,1, 28697
24,28709,1,1,0, 28710
31,28716,2,2,1, 28718
7,28722,1,1,1, 28723
8,28726,1,1,0, 28727
9,28727,2,2,1, 28729
14,28729,3,3,1, 28732
24,28739,1,1,0, 28740
25,28745,2,2,1, 28747
1,28746,1,1,1, 28747
26,28747,3,3,1, 28750
8,28756,1,1,1, 28757
1,28776,1,1,0, 28777
8,28786,1,1,1, 28787
1,28806,1,1,1, 28807
8,28816,1,1,0, 28817
1,28836,1,1,0, 28837
8,28846,1,1,1, 28847
16,28849,2,2,1, 28851
17,28849,3,3,1, 28852
24,28859,1,1,1, 28860
23,28858,3,3,1, 28861
7,28872,1,1,1, 28873
8,28876,1,1,1, 28877
24,28889,1,1,0, 28890
31,28896,2,2,1, 28898
7,28902,1,1,1, 28903
8,28906,1,1,0, 28907
24,28919,1,1,0, 28920
7,28932,1,1,1, 28933
8,28936,1,1,1, 28937
24,28949,1,1,1, 28950
7,28962,1,1,1, 28963
8,28966,1,1,0, 28967
9,28967,2,2,1, 28969
16,28969,2,2,1, 28971
17,28969,3,3,1, 28972
24,28979,1,1,0, 28980
23,28978,3,3,1, 28981
31,28986,2,2,1, 28988
6,28990,2,2,1, 28992
7,28992,1,1,1, 28993
8,28996,1,1,1, 28997
24,29009,1,1,0, 29010
31,29016,2,2,1, 29018
6,29020,2,2,1, 29022
7,29022,1,1,0, 29023
8,29026,1,1,1, 29027
24,29039,1,1,1, 29040
31,29046,2,2,1, 29048
7,29052,1,1,0, 29053
8,29056,1,1,0, 29057
24,29069,1,1,1, 29070
31,29076,2,2,1, 29078
7,29082,1,1,1, 29083
8,29086,1,1,0, 29087
17,29089,3,3,1, 29092
15,29091,2,2,1, 29093
24,29099,1,1,0, 29100
23,29098,3,3,1, 29101
1,29106,1,1,1, 29107
25,29135,2,2,1, 29137
1,29136,1,1,1, 29137
1,29166,1,1,0, 29167
1,29196,1,1,0, 29197
8,29206,1,1,1, 29207
9,29207,2,2,1, 29209
15,29211,2,2,1, 29213
24,29219,1,1,0, 29220
23,29218,3,3,1, 29221
7,29232,1,1,0, 29233
8,29236,1,1,1, 29237
24,29249,1,1,1, 29250
6,29260,2,2,1, 29262
7,29262,1,1,1, 29263
8,29266,1,1,0, 29267
24,29279,1,1,0, 29280
31,29286,2,2,1, 29288
6,29290,2,2,1, 29292
7,29292,1,1,1, 29293
8,29296,1,1,0, 29297
24,29309,1,1,0, 29310
31,29316,2,2,1, 29318
6,29320,2,2,1, 29322
7,29322,1,1,0, 29323
8,29326,1,1,0, 29327
16,29329,2,2,1, 29331
24,29339,1,1,1, 29340
23,29338,3,3,1, 29341
1,29346,1,1,0, 29347
31,29346,2,2,1, 29348
8,29356,1,1,1, 29357
24,29369,1,1,0, 29370
1,29376,1,1,0, 29377
31,29376,2,2,1, 29378
8,29386,1,1,0, 29387
24,29399,1,1,0, 29400
1,29406,1,1,0, 29407
8,29416,1,1,0, 29417
24,29429,1,1,0, 29430
1,29436,1,1,1, 29437
8,29446,1,1,0, 29447
9,29447,2,2,1, 29449
15,29451,2,2,1, 29453
24,29459,1,1,1, 29460
23,29458,3,3,1, 29461
7,29472,1,1,1, 29473
8,29476,1,1,0, 29477
24,29489,1,1,0, 29490
6,29500,2,2,1, 29502
7,29502,1,1,0, 29503
8,29506,1,1,1, 29507
24,29519,1,1,1, 29520
7,29532,1,1,0, 29533
8,29536,1,1,0, 29537
24,29549,1,1,1, 29550
31,29556,2,2,1, 29558
7,29562,1,1,1, 29563
8,29566,1,1,1, 29567
24,29579,1,1,0, 29580
8,29596,1,1,0, 29597
8,29626,1,1,1, 29627
8,29656,1,1,0, 29657
8,29686,1,1,1, 29687
9,29687,2,2,1, 29689
15,29691,2,2,1, 29693
24,29699,1,1,0, 29700
23,29698,3,3,1, 29701
1,29706,1,1,0, 29707
7,29712,1,1,1, 29713
24,29729,1,1,1, 29730
1,29736,1,1,0, 29737
6,29740,2,2,1, 29742
7,29742,1,1,1, 29743
24,29759,1,1,0, 29760
1,29766,1,1,0, 29767
6,29770,2,2,1, 29772
7,29772,1,1,1, 29773
24,29789,1,1,0, 29790
1,29796,1,1,0, 29797
31,29796,2,2,1, 29798
7,29802,1,1,1, 29803
8,29806,1,1,1, 29807
16,29809,2,2,1, 29811
24,29819,1,1,1, 29820
23,29818,3,3,1, 29821
25,29825,2,2,1, 29827
1,29826,1,1,0, 29827
24,29849,1,1,0, 29850
1,29856,1,1,1, 29857
24,29879,1,1,1, 29880
25,29885,2,2,1, 29887
1,29886,1,1,0, 29887
24,29909,1,1,1, 29910
25,29915,2,2,1, 29917
1,29916,1,1,0, 29917
8,29926,1,1,1, 29927
9,29927,2,2,1, 29929
14,29929,3,3,1, 29932
24,29939,1,1,0, 29940
23,29938,3,3,1, 29941
6,29950,2,2,1, 29952
7,29952,1,1,0, 29953
8,29956,1,1,0, 29957
24,29969,1,1,0, 29970
31,29976,2,2,1, 29978
7,29982,1,1,1, 29983
8,29986,1,1,1, 29987
24,29999,1,1,1, 30000
31,30006,2,2,1, 30008
6,30010,2,2,1, 30012
7,30012,1,1,1, 30013
8,30016,1,1,1, 30017
24,30029,1,1,1, 30030
6,30040,2,2,1, 30042
7,30042,1,1,0, 30043
8,30046,1,1,0, 30047
9,30047,2,2,1, 30049
16,30049,2,2,1, 30051
17,30049,3,3,1, 30052
24,30059,1,1,0, 30060
23,30058,3,3,1, 30061
25,30065,2,2,1, 30067
1,30066,1,1,0, 30067
1,30096,1,1,0, 30097
1,30126,1,1,0, 30127
1,30156,1,1,0, 30157
8,30166,1,1,0, 30167
17,30169,3,3,1, 30172
24,30179,1,1,0, 30180
23,30178,3,3,1, 30181
6,30190,2,2,1, 30192
7,30192,1,1,1, 30193
8,30196,1,1,1, 30197
24,30209,1,1,0, 30210
31,30216,2,2,1, 30218
7,30222,1,1,1, 30223
8,30226,1,1,0, 30227
24,30239,1,1,1, 30240
31,30246,2,2,1, 30248
6,30250,2,2,1, 30252
7,30252,1,1,0, 30253
8,30256,1,1,0, 30257
24,30269,1,1,0, 30270
31,30276,2,2,1, 30278
6,30280,2,2,1, 30282
7,30282,1,1,1, 30283
8,30286,1,1,0, 30287
9,30287,2,2,1, 30289
15,30291,2,2,1, 30293
24,30299,1,1,1, 30300
1,30306,1,1,1, 30307
8,30316,1,1,0, 30317
1,30336,1,1,1, 30337
8,30346,1,1,1, 30347
1,30366,1,1,1, 30367
8,30376,1,1,0, 30377
1,30396,1,1,0, 30397
8,30406,1,1,0, 30407
24,30419,1,1,0, 30420
23,30418,3,3,1, 30421
2,30423,2,2,1, 30425
1,30426,1,1,1, 30427
6,30430,2,2,1, 30432
7,30432,1,1,1, 30433
8,30436,1,1,0, 30437
24,30449,1,1,0, 30450
25,30455,2,2,1, 30457
1,30456,1,1,1, 30457
31,30456,2,2,1, 30458
6,30460,2,2,1, 30462
7,30462,1,1,1, 30463
8,30466,1,1,0, 30467
24,30479,1,1,0, 30480
2,30483,2,2,1, 30485
6,30490,2,2,1, 30492
7,30492,1,1,1, 30493
8,30496,1,1,0, 30497
24,30509,1,1,1, 30510
25,30515,2,2,1, 30517
31,30516,2,2,1, 30518
6,30520,2,2,1, 30522
7,30522,1,1,1, 30523
8,30526,1,1,0, 30527
16,30529,2,2,1, 30531
24,30539,1,1,0, 30540
8,30646,1,1,1, 30647
16,30649,2,2,1, 30651
24,30659,1,1,1, 30660
25,30665,2,2,1, 30667
1,30666,1,1,0, 30667
7,30672,1,1,0, 30673
8,30676,1,1,1, 30677
14,30679,3,3,1, 30682
15,30681,2,2,1, 30683
24,30689,1,1,0, 30690
23,30688,3,3,1, 30691
2,30693,2,2,1, 30695
25,30695,2,2,1, 30697
1,30696,1,1,1, 30697
7,30702,1,1,1, 30703
6,30700,2,4,1, 30704
8,30706,1,1,1, 30707
14,30709,3,3,1, 30712
15,30711,2,2,1, 30713
24,30719,1,1,1, 30720
1,30726,1,1,1, 30727
31,30726,2,2,1, 30728
6,30730,2,2,1, 30732
7,30732,1,1,0, 30733
8,30736,1,1,1, 30737
24,30749,1,1,1, 30750
2,30753,2,2,1, 30755
1,30756,1,1,1, 30757
31,30756,2,2,1, 30758
6,30760,2,2,1, 30762
7,30762,1,1,0, 30763
8,30766,1,1,1, 30767
24,30779,1,1,0, 30780
7,30792,1,1,1, 30793
8,30796,1,1,0, 30797
23,30808,3,3,1, 30811
7,30822,1,1,1, 30823
8,30826,1,1,1, 30827
23,30838,3,3,1, 30841
7,30852,1,1,1, 30853
31,30876,2,2,1, 30878
7,30882,1,1,1, 30883
24,30899,1,1,0, 30900
2,30903,2,2,1, 30905
7,30912,1,1,0, 30913
8,30916,1,1,1, 30917
24,30929,1,1,0, 30930
7,30942,1,1,1, 30943
8,30946,1,1,1, 30947
14,30949,3,3,1, 30952
13,30949,4,4,1, 30953
15,30951,2,2,1, 30953
24,30959,1,1,1, 30960
24,30989,1,1,0, 30990
17,31009,3,3,1, 31012
24,31019,1,1,0, 31020
1,31026,1,1,1, 31027
9,31037,2,2,1, 31039
17,31039,3,3,1, 31042
24,31049,1,1,0, 31050
1,31056,1,1,0, 31057
9,31067,2,2,1, 31069
17,31069,3,3,1, 31072
24,31079,1,1,1, 31080
2,31083,2,2,1, 31085
1,31086,1,1,0, 31087
7,31092,1,1,0, 31093
8,31096,1,1,1, 31097
24,31109,1,1,0, 31110
2,31113,2,2,1, 31115
1,31116,1,1,1, 31117
31,31116,2,2,1, 31118
7,31122,1,1,0, 31123
8,31126,1,1,0, 31127
16,31129,2,2,1, 31131
24,31139,1,1,0, 31140
31,31146,2,2,1, 31148
7,31152,1,1,1, 31153
8,31156,1,1,0, 31157
24,31169,1,1,1, 31170
26,31177,3,3,1, 31180
7,31182,1,1,0, 31183
8,31186,1,1,1, 31187
24,31199,1,1,0, 31200
31,31206,2,2,1, 31208
7,31212,1,1,1, 31213
8,31216,1,1,1, 31217
24,31229,1,1,1, 31230
6,31240,2,2,1, 31242
7,31242,1,1,1, 31243
8,31246,1,1,1, 31247
24,31259,1,1,0, 31260
8,31276,1,1,0, 31277
24,31289,1,1,1, 31290
8,31306,1,1,1, 31307
9,31307,2,2,1, 31309
17,31309,3,3,1, 31312
24,31319,1,1,0, 31320
1,31326,1,1,1, 31327
8,31336,1,1,0, 31337
1,31356,1,1,1, 31357
8,31366,1,1,1, 31367
1,31386,1,1,0, 31387
31,31386,2,2,1, 31388
7,31392,1,1,0, 31393
8,31396,1,1,1, 31397
1,31416,1,1,1, 31417
7,31422,1,1,0, 31423
8,31426,1,1,1, 31427
17,31429,3,3,1, 31432
24,31439,1,1,1, 31440
1,31446,1,1,1, 31447
6,31450,2,2,1, 31452
7,31452,1,1,1, 31453
24,31469,1,1,1, 31470
2,31473,2,2,1, 31475
1,31476,1,1,1, 31477
6,31480,2,2,1, 31482
7,31482,1,1,1, 31483
24,31499,1,1,1, 31500
1,31506,1,1,1, 31507
7,31512,1,1,0, 31513
24,31529,1,1,0, 31530
1,31536,1,1,0, 31537
7,31542,1,1,0, 31543
8,31546,1,1,1, 31547
16,31549,2,2,1, 31551
17,31549,3,3,1, 31552
15,31551,2,2,1, 31553
24,31559,1,1,1, 31560
23,31558,3,3,1, 31561
24,31589,1,1,0, 31590
24,31619,1,1,1, 31620
24,31649,1,1,0, 31650
8,31666,1,1,1, 31667
14,31669,3,3,1, 31672
17,31669,3,3,1, 31672
15,31671,2,2,1, 31673
22,31676,4,4,1, 31680
24,31679,1,1,1, 31680
23,31678,3,3,1, 31681
31,31686,2,2,1, 31688
7,31692,1,1,1, 31693
24,31709,1,1,0, 31710
31,31716,2,2,1, 31718
7,31722,1,1,1, 31723
24,31739,1,1,0, 31740
31,31746,2,2,1, 31748
6,31750,2,2,1, 31752
7,31752,1,1,0, 31753
24,31769,1,1,0, 31770
31,31776,2,2,1, 31778
6,31780,2,2,1, 31782
7,31782,1,1,1, 31783
8,31786,1,1,1, 31787
9,31787,2,2,1, 31789
22,31796,4,4,1, 31800
24,31799,1,1,0, 31800
1,31806,1,1,0, 31807
31,31806,2,2,1, 31808
8,31816,1,1,0, 31817
24,31829,1,1,0, 31830
1,31836,1,1,1, 31837
31,31836,2,2,1, 31838
8,31846,1,1,1, 31847
24,31859,1,1,0, 31860
1,31866,1,1,0, 31867
8,31876,1,1,1, 31877
24,31889,1,1,0, 31890
1,31896,1,1,1, 31897
31,31896,2,2,1, 31898
8,31906,1,1,1, 31907
15,31911,2,2,1, 31913
22,31916,4,4,1, 31920
24,31919,1,1,0, 31920
23,31918,3,3,1, 31921
7,31932,1,1,1, 31933
8,31936,1,1,0, 31937
7,31962,1,1,0, 31963
8,31966,1,1,0, 31967
7,31992,1,1,1, 31993
8,31996,1,1,1, 31997
7,32022,1,1,0, 32023
8,32026,1,1,0, 32027
9,32027,2,2,1, 32029
17,32029,3,3,1, 32032
13,32029,4,4,1, 32033
15,32031,2,2,1, 32033
24,32039,1,1,1, 32040
1,32046,1,1,0, 32047
31,32046,2,2,1, 32048
7,32052,1,1,1, 32053
24,32069,1,1,0, 32070
1,32076,1,1,1, 32077
31,32076,2,2,1, 32078
7,32082,1,1,0, 32083
24,32099,1,1,0, 32100
1,32106,1,1,1, 32107
31,32106,2,2,1, 32108
6,32110,2,2,1, 32112
7,32112,1,1,0, 32113
24,32129,1,1,1, 32130
1,32136,1,1,0, 32137
31,32136,2,2,1, 32138
7,32142,1,1,0, 32143
8,32146,1,1,0, 32147
9,32147,2,2,1, 32149
17,32149,3,3,1, 32152
15,32151,2,2,1, 32153
24,32159,1,1,1, 32160
23,32158,3,3,1, 32161
2,32163,2,2,1, 32165
1,32166,1,1,0, 32167
31,32166,2,2,1, 32168
7,32172,1,1,1, 32173
8,32176,1,1,1, 32177
1,32196,1,1,1, 32197
31,32196,2,2,1, 32198
7,32202,1,1,1, 32203
8,32206,1,1,1, 32207
1,32226,1,1,0, 32227
7,32232,1,1,0, 32233
8,32236,1,1,1, 32237
1,32256,1,1,0, 32257
7,32262,1,1,1, 32263
8,32266,1,1,1, 32267
15,32271,2,2,1, 32273
22,32276,4,4,1, 32280
24,32279,1,1,1, 32280
23,32278,3,3,1, 32281
25,32285,2,2,1, 32287
26,32287,3,3,1, 32290
7,32292,1,1,1, 32293
24,32309,1,1,1, 32310
7,32322,1,1,1, 32323
24,32339,1,1,1, 32340
7,32352,1,1,1, 32353
24,32369,1,1,0, 32370
6,32380,2,2,1, 32382
7,32382,1,1,0, 32383
8,32386,1,1,0, 32387
9,32387,2,2,1, 32389
16,32389,2,2,1, 32391
17,32389,3,3,1, 32392
15,32391,2,2,1, 32393
22,32396,4,4,1, 32400
24,32399,1,1,1, 32400
7,32412,1,1,1, 32413
24,32429,1,1,0, 32430
23,32428,3,3,1, 32431
31,32436,2,2,1, 32438
7,32442,1,1,1, 32443
24,32459,1,1,1, 32460
23,32458,3,3,1, 32461
24,32489,1,1,1, 32490
31,32496,2,2,1, 32498
8,32506,1,1,0, 32507
9,32507,2,2,1, 32509
16,32509,2,2,1, 32511
24,32519,1,1,1, 32520
23,32518,3,3,1, 32521
8,32536,1,1,1, 32537
8,32566,1,1,1, 32567
8,32596,1,1,0, 32597
8,32626,1,1,0, 32627
9,32627,2,2,1, 32629
16,32629,2,2,1, 32631
17,32629,3,3,1, 32632
24,32639,1,1,1, 32640
1,32646,1,1,0, 32647
31,32646,2,2,1, 32648
7,32652,1,1,1, 32653
24,32669,1,1,0, 32670
1,32676,1,1,1, 32677
7,32682,1,1,1, 32683
24,32699,1,1,0, 32700
1,32706,1,1,1, 32707
7,32712,1,1,0, 32713
24,32729,1,1,0, 32730
1,32736,1,1,1, 32737
7,32742,1,1,0, 32743
8,32746,1,1,1, 32747
9,32747,2,2,1, 32749
16,32749,2,2,1, 32751
14,32749,3,3,1, 32752
17,32749,3,3,1, 32752
15,32751,2,2,1, 32753
22,32756,4,4,1, 32760
24,32759,1,1,0, 32760
23,32758,3,3,1, 32761
2,32763,2,2,1, 32765
1,32766,1,1,1, 32767
8,32776,1,1,1, 32777
24,32789,1,1,1, 32790
1,32796,1,1,0, 32797
31,32796,2,2,1, 32798
8,32806,1,1,1, 32807
24,32819,1,1,0, 32820
2,32823,2,2,1, 32825
1,32826,1,1,0, 32827
31,32826,2,2,1, 32828
8,32836,1,1,0, 32837
24,32849,1,1,0, 32850
1,32856,1,1,1, 32857
8,32866,1,1,0, 32867
9,32867,2,2,1, 32869
16,32869,2,2,1, 32871
14,32869,3,3,1, 32872
17,32869,3,3,1, 32872
22,32876,4,4,1, 32880
24,32879,1,1,1, 32880
7,32892,1,1,1, 32893
23,32908,3,3,1, 32911
7,32922,1,1,0, 32923
23,32938,3,3,1, 32941
7,32952,1,1,0, 32953
7,32982,1,1,0, 32983
8,32986,1,1,0, 32987
16,32989,2,2,1, 32991
17,32989,3,3,1, 32992
24,32999,1,1,0, 33000
25,33005,2,2,1, 33007
31,33006,2,2,1, 33008
26,33007,3,3,1, 33010
8,33016,1,1,1, 33017
8,33046,1,1,0, 33047
16,33049,2,2,1, 33051
8,33076,1,1,1, 33077
16,33079,2,2,1, 33081
8,33106,1,1,0, 33107
16,33109,2,2,1, 33111
17,33109,3,3,1, 33112
24,33119,1,1,1, 33120
23,33118,3,3,1, 33121
7,33132,1,1,0, 33133
8,33136,1,1,1, 33137
24,33149,1,1,0, 33150
7,33162,1,1,0, 33163
8,33166,1,1,1, 33167
24,33179,1,1,0, 33180
31,33186,2,2,1, 33188
7,33192,1,1,0, 33193
8,33196,1,1,0, 33197
24,33209,1,1,0, 33210
31,33216,2,2,1, 33218
7,33222,1,1,0, 33223
8,33226,1,1,0, 33227
9,33227,2,2,1, 33229
16,33229,2,2,1, 33231
24,33239,1,1,1, 33240
23,33238,3,3,1, 33241
2,33243,2,2,1, 33245
1,33246,1,1,1, 33247
6,33250,2,2,1, 33252
7,33252,1,1,0, 33253
24,33269,1,1,0, 33270
1,33276,1,1,0, 33277
6,33280,2,2,1, 33282
7,33282,1,1,1, 33283
24,33299,1,1,0, 33300
1,33306,1,1,1, 33307
31,33306,2,2,1, 33308
6,33310,2,2,1, 33312
7,33312,1,1,0, 33313
24,33329,1,1,1, 33330
2,33333,2,2,1, 33335
1,33336,1,1,1, 33337
31,33336,2,2,1, 33338
7,33342,1,1,1, 33343
8,33346,1,1,1, 33347
9,33347,2,2,1, 33349
13,33349,4,4,1, 33353
22,33356,4,4,1, 33360
24,33359,1,1,0, 33360
23,33358,3,3,1, 33361
8,33376,1,1,0, 33377
8,33406,1,1,0, 33407
8,33436,1,1,0, 33437
7,33462,1,1,0, 33463
8,33466,1,1,0, 33467
9,33467,2,2,1, 33469
16,33469,2,2,1, 33471
15,33471,2,2,1, 33473
22,33476,4,4,1, 33480
24,33479,1,1,0, 33480
23,33478,3,3,1, 33481
2,33483,2,2,1, 33485
1,33486,1,1,0, 33487
7,33492,1,1,1, 33493
24,33509,1,1,0, 33510
2,33513,2,2,1, 33515
1,33516,1,1,1, 33517
7,33522,1,1,1, 33523
24,33539,1,1,1, 33540
1,33546,1,1,1, 33547
31,33546,2,2,1, 33548
7,33552,1,1,0, 33553
24,33569,1,1,0, 33570
1,33576,1,1,1, 33577
7,33582,1,1,0, 33583
8,33586,1,1,0, 33587
9,33587,2,2,1, 33589
22,33596,4,4,1, 33600
24,33599,1,1,0, 33600
8,33616,1,1,1, 33617
24,33629,1,1,0, 33630
8,33646,1,1,0, 33647
24,33659,1,1,1, 33660
8,33676,1,1,1, 33677
24,33689,1,1,0, 33690
25,33695,2,2,1, 33697
31,33696,2,2,1, 33698
8,33706,1,1,0, 33707
14,33709,3,3,1, 33712
15,33711,2,2,1, 33713
24,33719,1,1,1, 33720
23,33718,3,3,1, 33721
2,33723,2,2,1, 33725
1,33726,1,1,0, 33727
7,33732,1,1,0, 33733
8,33736,1,1,1, 33737
24,33749,1,1,0, 33750
1,33756,1,1,0, 33757
7,33762,1,1,0, 33763
8,33766,1,1,1, 33767
24,33779,1,1,1, 33780
2,33783,2,2,1, 33785
1,33786,1,1,0, 33787
6,33790,2,2,1, 33792
7,33792,1,1,0, 33793
8,33796,1,1,1, 33797
24,33809,1,1,1, 33810
2,33813,2,2,1, 33815
1,33816,1,1,1, 33817
6,33820,2,2,1, 33822
7,33822,1,1,0, 33823
8,33826,1,1,0, 33827
9,33827,2,2,1, 33829
17,33829,3,3,1, 33832
15,33831,2,2,1, 33833
24,33839,1,1,0, 33840
25,33845,2,2,1, 33847
31,33846,2,2,1, 33848
8,33856,1,1,0, 33857
24,33869,1,1,1, 33870
25,33875,2,2,1, 33877
8,33886,1,1,0, 33887
24,33899,1,1,1, 33900
8,33916,1,1,1, 33917
24,33929,1,1,0, 33930
25,33935,2,2,1, 33937
8,33946,1,1,1, 33947
9,33947,2,2,1, 33949
16,33949,2,2,1, 33951
14,33949,3,3,1, 33952
17,33949,3,3,1, 33952
24,33959,1,1,0, 33960
23,33958,3,3,1, 33961
1,33966,1,1,0, 33967
31,33966,2,2,1, 33968
6,33970,2,2,1, 33972
7,33972,1,1,1, 33973
1,33996,1,1,0, 33997
31,33996,2,2,1, 33998
7,34002,1,1,0, 34003
2,34023,2,2,1, 34025
1,34026,1,1,0, 34027
6,34030,2,2,1, 34032
7,34032,1,1,1, 34033
1,34056,1,1,0, 34057
31,34056,2,2,1, 34058
7,34062,1,1,1, 34063
8,34066,1,1,1, 34067
9,34067,2,2,1, 34069
16,34069,2,2,1, 34071
17,34069,3,3,1, 34072
15,34071,2,2,1, 34073
24,34079,1,1,0, 34080
23,34078,3,3,1, 34081
31,34086,2,2,1, 34088
24,34109,1,1,1, 34110
24,34139,1,1,1, 34140
24,34169,1,1,0, 34170
8,34186,1,1,1, 34187
17,34189,3,3,1, 34192
24,34199,1,1,1, 34200
2,34203,2,2,1, 34205
1,34206,1,1,0, 34207
31,34206,2,2,1, 34208
7,34212,1,1,0, 34213
8,34216,1,1,0, 34217
22,34226,4,4,1, 34230
24,34229,1,1,1, 34230
23,34228,3,3,1, 34231
2,34233,2,2,1, 34235
1,34236,1,1,1, 34237
31,34236,2,2,1, 34238
6,34240,2,2,1, 34242
7,34242,1,1,0, 34243
8,34246,1,1,0, 34247
14,34249,3,3,1, 34252
15,34251,2,2,1, 34253
24,34259,1,1,0, 34260
23,34258,3,3,1, 34261
2,34263,2,2,1, 34265
1,34266,1,1,0, 34267
31,34266,2,2,1, 34268
6,34270,2,2,1, 34272
7,34272,1,1,1, 34273
8,34276,1,1,0, 34277
24,34289,1,1,0, 34290
1,34296,1,1,0, 34297
7,34302,1,1,1, 34303
8,34306,1,1,0, 34307
17,34309,3,3,1, 34312
24,34319,1,1,1, 34320
23,34318,3,3,1, 34321
6,34330,2,2,1, 34332
7,34332,1,1,1, 34333
31,34356,2,2,1, 34358
6,34360,2,2,1, 34362
7,34362,1,1,1, 34363
7,34392,1,1,1, 34393
8,34396,1,1,1, 34397
7,34422,1,1,1, 34423
8,34426,1,1,0, 34427
9,34427,2,2,1, 34429
17,34429,3,3,1, 34432
24,34439,1,1,1, 34440
7,34452,1,1,1, 34453
8,34456,1,1,1, 34457
24,34469,1,1,0, 34470
31,34476,2,2,1, 34478
7,34482,1,1,0, 34483
8,34486,1,1,0, 34487
14,34489,3,3,1, 34492
24,34499,1,1,1, 34500
8,34516,1,1,1, 34517
24,34529,1,1,0, 34530
8,34546,1,1,0, 34547
9,34547,2,2,1, 34549
17,34549,3,3,1, 34552
24,34559,1,1,0, 34560
31,34566,2,2,1, 34568
24,34589,1,1,1, 34590
31,34596,2,2,1, 34598
24,34619,1,1,1, 34620
31,34626,2,2,1, 34628
7,34632,1,1,1, 34633
24,34649,1,1,1, 34650
7,34662,1,1,1, 34663
8,34666,1,1,0, 34667
17,34669,3,3,1, 34672
24,34679,1,1,1, 34680
7,34692,1,1,0, 34693
8,34696,1,1,0, 34697
31,34716,2,2,1, 34718
7,34722,1,1,1, 34723
8,34726,1,1,0, 34727
31,34746,2,2,1, 34748
7,34752,1,1,0, 34753
8,34756,1,1,0, 34757
31,34776,2,2,1, 34778
7,34782,1,1,1, 34783
8,34786,1,1,0, 34787
9,34787,2,2,1, 34789
17,34789,3,3,1, 34792
24,34799,1,1,1, 34800
23,34798,3,3,1, 34801
31,34806,2,2,1, 34808
6,34810,2,2,1, 34812
7,34812,1,1,1, 34813
8,34816,1,1,1, 34817
15,34821,2,2,1, 34823
24,34829,1,1,0, 34830
31,34836,2,2,1, 34838
6,34840,2,2,1, 34842
7,34842,1,1,0, 34843
8,34846,1,1,1, 34847
24,34859,1,1,0, 34860
7,34872,1,1,0, 34873
8,34876,1,1,0, 34877
15,34881,2,2,1, 34883
24,34889,1,1,0, 34890
7,34902,1,1,0, 34903
8,34906,1,1,1, 34907
9,34907,2,2,1, 34909
16,34909,2,2,1, 34911
15,34911,2,2,1, 34913
24,34919,1,1,1, 34920
31,34926,2,2,1, 34928
7,34932,1,1,1, 34933
24,34949,1,1,1, 34950
7,34962,1,1,1, 34963
24,34979,1,1,1, 34980
24,35009,1,1,1, 35010
8,35026,1,1,0, 35027
17,35029,3,3,1, 35032
15,35031,2,2,1, 35033
24,35039,1,1,0, 35040
1,35046,1,1,1, 35047
8,35056,1,1,0, 35057
24,35069,1,1,1, 35070
1,35076,1,1,0, 35077
8,35086,1,1,0, 35087
24,35099,1,1,0, 35100
1,35106,1,1,0, 35107
31,35106,2,2,1, 35108
6,35110,2,2,1, 35112
7,35112,1,1,1, 35113
8,35116,1,1,1, 35117
24,35129,1,1,0, 35130
1,35136,1,1,1, 35137
31,35136,2,2,1, 35138
6,35140,2,2,1, 35142
7,35142,1,1,0, 35143
8,35146,1,1,0, 35147
24,35159,1,1,1, 35160
31,35166,2,2,1, 35168
7,35172,1,1,0, 35173
8,35176,1,1,0, 35177
15,35181,2,2,1, 35183
24,35189,1,1,1, 35190
6,35200,2,2,1, 35202
7,35202,1,1,0, 35203
8,35206,1,1,0, 35207
15,35211,2,2,1, 35213
24,35219,1,1,0, 35220
8,35236,1,1,1, 35237
15,35241,2,2,1, 35243
24,35249,1,1,1, 35250
8,35266,1,1,0, 35267
9,35267,2,2,1, 35269
24,35279,1,1,0, 35280
1,35286,1,1,0, 35287
24,35309,1,1,0, 35310
1,35316,1,1,0, 35317
24,35339,1,1,0, 35340
1,35346,1,1,1, 35347
31,35346,2,2,1, 35348
7,35352,1,1,0, 35353
8,35356,1,1,1, 35357
24,35369,1,1,1, 35370
1,35376,1,1,0, 35377
7,35382,1,1,1, 35383
8,35386,1,1,0, 35387
17,35389,3,3,1, 35392
24,35399,1,1,1, 35400
23,35398,3,3,1, 35401
31,35406,2,2,1, 35408
6,35410,2,2,1, 35412
7,35412,1,1,0, 35413
15,35421,2,2,1, 35423
24,35429,1,1,1, 35430
31,35436,2,2,1, 35438
7,35442,1,1,0, 35443
15,35451,2,2,1, 35453
24,35459,1,1,0, 35460
31,35466,2,2,1, 35468
24,35489,1,1,1, 35490
31,35496,2,2,1, 35498
8,35506,1,1,0, 35507
17,35509,3,3,1, 35512
24,35519,1,1,1, 35520
23,35518,3,3,1, 35521
7,35532,1,1,0, 35533
8,35536,1,1,1, 35537
7,35562,1,1,1, 35563
8,35566,1,1,0, 35567
7,35592,1,1,0, 35593
8,35596,1,1,1, 35597
7,35622,1,1,0, 35623
8,35626,1,1,1, 35627
9,35627,2,2,1, 35629
16,35629,2,2,1, 35631
24,35639,1,1,0, 35640
7,35652,1,1,0, 35653
8,35656,1,1,0, 35657
24,35669,1,1,0, 35670
7,35682,1,1,1, 35683
8,35686,1,1,0, 35687
24,35699,1,1,1, 35700
7,35712,1,1,1, 35713
8,35716,1,1,1, 35717
24,35729,1,1,1, 35730
7,35742,1,1,0, 35743
8,35746,1,1,0, 35747
17,35749,3,3,1, 35752
24,35759,1,1,1, 35760
31,35766,2,2,1, 35768
7,35772,1,1,1, 35773
8,35776,1,1,1, 35777
24,35789,1,1,0, 35790
31,35796,2,2,1, 35798
7,35802,1,1,0, 35803
8,35806,1,1,1, 35807
24,35819,1,1,1, 35820
6,35830,2,2,1, 35832
7,35832,1,1,0, 35833
8,35836,1,1,1, 35837
24,35849,1,1,0, 35850
7,35862,1,1,1, 35863
8,35866,1,1,1, 35867
9,35867,2,2,1, 35869
15,35871,2,2,1, 35873
24,35879,1,1,0, 35880
8,35896,1,1,0, 35897
24,35909,1,1,1, 35910
8,35926,1,1,1, 35927
24,35939,1,1,1, 35940
8,35956,1,1,1, 35957
24,35969,1,1,1, 35970
8,35986,1,1,0, 35987
9,35987,2,2,1, 35989
17,35989,3,3,1, 35992
15,35991,2,2,1, 35993
24,35999,1,1,0, 36000
8,36016,1,1,0, 36017
24,36029,1,1,1, 36030
8,36046,1,1,1, 36047
24,36059,1,1,0, 36060
31,36066,2,2,1, 36068
7,36072,1,1,1, 36073
8,36076,1,1,0, 36077
24,36089,1,1,1, 36090
31,36096,2,2,1, 36098
6,36100,2,2,1, 36102
7,36102,1,1,0, 36103
8,36106,1,1,0, 36107
9,36107,2,2,1, 36109
16,36109,2,2,1, 36111
24,36119,1,1,1, 36120
23,36118,3,3,1, 36121
7,36132,1,1,1, 36133
15,36141,2,2,1, 36143
24,36149,1,1,0, 36150
6,36160,2,2,1, 36162
7,36162,1,1,1, 36163
15,36171,2,2,1, 36173
24,36179,1,1,0, 36180
24,36209,1,1,0, 36210
8,36226,1,1,0, 36227
9,36227,2,2,1, 36229
16,36229,2,2,1, 36231
17,36229,3,3,1, 36232
24,36239,1,1,1, 36240
8,36256,1,1,0, 36257
24,36269,1,1,1, 36270
8,36286,1,1,1, 36287
24,36299,1,1,0, 36300
7,36312,1,1,0, 36313
8,36316,1,1,0, 36317
16,36319,2,2,1, 36321
24,36329,1,1,1, 36330
23,36328,3,3,1, 36331
6,36340,2,2,1, 36342
7,36342,1,1,1, 36343
8,36346,1,1,1, 36347
9,36347,2,2,1, 36349
15,36351,2,2,1, 36353
24,36359,1,1,0, 36360
31,36366,2,2,1, 36368
7,36372,1,1,1, 36373
15,36381,2,2,1, 36383
24,36389,1,1,1, 36390
31,36396,2,2,1, 36398
7,36402,1,1,0, 36403
15,36411,2,2,1, 36413
24,36419,1,1,0, 36420
31,36426,2,2,1, 36428
7,36432,1,1,0, 36433
24,36449,1,1,0, 36450
7,36462,1,1,0, 36463
8,36466,1,1,1, 36467
9,36467,2,2,1, 36469
17,36469,3,3,1, 36472
24,36479,1,1,1, 36480
23,36478,3,3,1, 36481
1,36486,1,1,0, 36487
8,36496,1,1,0, 36497
24,36509,1,1,1, 36510
1,36516,1,1,1, 36517
8,36526,1,1,1, 36527
24,36539,1,1,1, 36540
1,36546,1,1,1, 36547
8,36556,1,1,1, 36557
24,36569,1,1,0, 36570
1,36576,1,1,0, 36577
8,36586,1,1,0, 36587
16,36589,2,2,1, 36591
17,36589,3,3,1, 36592
15,36591,2,2,1, 36593
24,36599,1,1,1, 36600
23,36598,3,3,1, 36601
31,36606,2,2,1, 36608
7,36612,1,1,1, 36613
15,36621,2,2,1, 36623
24,36629,1,1,1, 36630
7,36642,1,1,0, 36643
15,36651,2,2,1, 36653
24,36659,1,1,1, 36660
7,36672,1,1,0, 36673
24,36689,1,1,0, 36690
31,36696,2,2,1, 36698
7,36702,1,1,0, 36703
8,36706,1,1,1, 36707
9,36707,2,2,1, 36709
16,36709,2,2,1, 36711
17,36709,3,3,1, 36712
24,36719,1,1,1, 36720
8,36736,1,1,0, 36737
8,36766,1,1,1, 36767
8,36796,1,1,1, 36797
8,36826,1,1,0, 36827
16,36829,2,2,1, 36831
15,36831,2,2,1, 36833
24,36839,1,1,1, 36840
2,36843,2,2,1, 36845
1,36846,1,1,0, 36847
6,36850,2,2,1, 36852
7,36852,1,1,1, 36853
8,36856,1,1,1, 36857
15,36861,2,2,1, 36863
24,36869,1,1,1, 36870
1,36876,1,1,1, 36877
6,36880,2,2,1, 36882
7,36882,1,1,0, 36883
8,36886,1,1,1, 36887
15,36891,2,2,1, 36893
24,36899,1,1,1, 36900
1,36906,1,1,0, 36907
8,36916,1,1,1, 36917
24,36929,1,1,0, 36930
1,36936,1,1,0, 36937
31,36936,2,2,1, 36938
8,36946,1,1,1, 36947
16,36949,2,2,1, 36951
24,36959,1,1,1, 36960
23,36958,3,3,1, 36961
1,36966,1,1,0, 36967
31,36966,2,2,1, 36968
8,36976,1,1,1, 36977
24,36989,1,1,0, 36990
1,36996,1,1,0, 36997
8,37006,1,1,1, 37007
15,37011,2,2,1, 37013
24,37019,1,1,0, 37020
2,37023,2,2,1, 37025
1,37026,1,1,1, 37027
31,37026,2,2,1, 37028
7,37032,1,1,1, 37033
8,37036,1,1,0, 37037
24,37049,1,1,1, 37050
2,37053,2,2,1, 37055
1,37056,1,1,0, 37057
31,37056,2,2,1, 37058
7,37062,1,1,0, 37063
8,37066,1,1,0, 37067
16,37069,2,2,1, 37071
17,37069,3,3,1, 37072
24,37079,1,1,1, 37080
23,37078,3,3,1, 37081
7,37092,1,1,1, 37093
7,37122,1,1,0, 37123
25,37145,2,2,1, 37147
31,37146,2,2,1, 37148
7,37152,1,1,0, 37153
8,37156,1,1,0, 37157
6,37180,2,2,1, 37182
7,37182,1,1,0, 37183
8,37186,1,1,0, 37187
17,37189,3,3,1, 37192
15,37191,2,2,1, 37193
1,37206,1,1,1, 37207
31,37206,2,2,1, 37208
6,37210,2,2,1, 37212
7,37212,1,1,1, 37213
2,37233,2,2,1, 37235
1,37236,1,1,1, 37237
7,37242,1,1,1, 37243
2,37263,2,2,1, 37265
1,37266,1,1,0, 37267
7,37272,1,1,1, 37273
1,37296,1,1,1, 37297
6,37300,2,2,1, 37302
7,37302,1,1,0, 37303
8,37306,1,1,0, 37307
9,37307,2,2,1, 37309
16,37309,2,2,1, 37311
17,37309,3,3,1, 37312
24,37319,1,1,1, 37320
25,37325,2,2,1, 37327
7,37332,1,1,0, 37333
24,37349,1,1,1, 37350
25,37355,2,2,1, 37357
26,37357,3,3,1, 37360
7,37362,1,1,1, 37363
15,37371,2,2,1, 37373
24,37379,1,1,1, 37380
25,37385,2,2,1, 37387
7,37392,1,1,0, 37393
24,37409,1,1,1, 37410
7,37422,1,1,0, 37423
8,37426,1,1,0, 37427
16,37429,2,2,1, 37431
17,37429,3,3,1, 37432
15,37431,2,2,1, 37433
24,37439,1,1,0, 37440
1,37446,1,1,0, 37447
6,37450,2,2,1, 37452
7,37452,1,1,1, 37453
8,37456,1,1,1, 37457
1,37476,1,1,0, 37477
31,37476,2,2,1, 37478
6,37480,2,2,1, 37482
7,37482,1,1,1, 37483
8,37486,1,1,1, 37487
2,37503,2,2,1, 37505
1,37506,1,1,0, 37507
6,37510,2,2,1, 37512
7,37512,1,1,1, 37513
8,37516,1,1,1, 37517
1,37536,1,1,1, 37537
6,37540,2,2,1, 37542
7,37542,1,1,0, 37543
8,37546,1,1,0, 37547
24,37559,1,1,1, 37560
25,37565,2,2,1, 37567
7,37572,1,1,1, 37573
8,37576,1,1,0, 37577
15,37581,2,2,1, 37583
24,37589,1,1,0, 37590
6,37600,2,2,1, 37602
7,37602,1,1,1, 37603
8,37606,1,1,1, 37607
15,37611,2,2,1, 37613
24,37619,1,1,1, 37620
31,37626,2,2,1, 37628
8,37636,1,1,0, 37637
24,37649,1,1,1, 37650
8,37666,1,1,1, 37667
9,37667,2,2,1, 37669
17,37669,3,3,1, 37672
24,37679,1,1,1, 37680
23,37678,3,3,1, 37681
1,37686,1,1,0, 37687
8,37696,1,1,1, 37697
24,37709,1,1,1, 37710
1,37716,1,1,1, 37717
31,37716,2,2,1, 37718
8,37726,1,1,0, 37727
15,37731,2,2,1, 37733
24,37739,1,1,1, 37740
1,37746,1,1,0, 37747
6,37750,2,2,1, 37752
7,37752,1,1,0, 37753
8,37756,1,1,0, 37757
15,37761,2,2,1, 37763
24,37769,1,1,1, 37770
1,37776,1,1,1, 37777
31,37776,2,2,1, 37778
6,37780,2,2,1, 37782
7,37782,1,1,0, 37783
8,37786,1,1,1, 37787
9,37787,2,2,1, 37789
16,37789,2,2,1, 37791
17,37789,3,3,1, 37792
15,37791,2,2,1, 37793
24,37799,1,1,0, 37800
8,37906,1,1,1, 37907
9,37907,2,2,1, 37909
17,37909,3,3,1, 37912
15,37911,2,2,1, 37913
24,37919,1,1,0, 37920
23,37918,3,3,1, 37921
1,37926,1,1,1, 37927
7,37932,1,1,0, 37933
15,37941,2,2,1, 37943
24,37949,1,1,0, 37950
1,37956,1,1,1, 37957
7,37962,1,1,1, 37963
24,37979,1,1,0, 37980
1,37986,1,1,1, 37987
7,37992,1,1,0, 37993
24,38009,1,1,1, 38010
1,38016,1,1,1, 38017
7,38022,1,1,1, 38023
8,38026,1,1,1, 38027
9,38027,2,2,1, 38029
16,38029,2,2,1, 38031
15,38031,2,2,1, 38033
24,38039,1,1,0, 38040
23,38038,3,3,1, 38041
6,38050,2,2,1, 38052
7,38052,1,1,1, 38053
8,38056,1,1,0, 38057
24,38069,1,1,0, 38070
6,38080,2,2,1, 38082
7,38082,1,1,1, 38083
8,38086,1,1,0, 38087
24,38099,1,1,1, 38100
7,38112,1,1,0, 38113
8,38116,1,1,1, 38117
24,38129,1,1,1, 38130
31,38136,2,2,1, 38138
7,38142,1,1,1, 38143
8,38146,1,1,1, 38147
15,38151,2,2,1, 38153
24,38159,1,1,0, 38160
8,38176,1,1,1, 38177
15,38181,2,2,1, 38183
24,38189,1,1,1, 38190
8,38206,1,1,0, 38207
24,38219,1,1,1, 38220
8,38236,1,1,1, 38237
24,38249,1,1,0, 38250
8,38266,1,1,1, 38267
16,38269,2,2,1, 38271
24,38279,1,1,0, 38280
23,38278,3,3,1, 38281
31,38286,2,2,1, 38288
6,38290,2,2,1, 38292
7,38292,1,1,0, 38293
8,38296,1,1,0, 38297
24,38309,1,1,0, 38310
6,38320,2,2,1, 38322
7,38322,1,1,0, 38323
8,38326,1,1,0, 38327
24,38339,1,1,1, 38340
31,38346,2,2,1, 38348
6,38350,2,2,1, 38352
7,38352,1,1,0, 38353
8,38356,1,1,0, 38357
24,38369,1,1,1, 38370
7,38382,1,1,0, 38383
8,38386,1,1,1, 38387
16,38389,2,2,1, 38391
17,38389,3,3,1, 38392
15,38391,2,2,1, 38393
24,38399,1,1,0, 38400
31,38406,2,2,1, 38408
7,38412,1,1,1, 38413
15,38421,2,2,1, 38423
24,38429,1,1,0, 38430
7,38442,1,1,1, 38443
24,38459,1,1,0, 38460
31,38466,2,2,1, 38468
7,38472,1,1,0, 38473
24,38489,1,1,0, 38490
7,38502,1,1,0, 38503
8,38506,1,1,0, 38507
16,38509,2,2,1, 38511
24,38519,1,1,1, 38520
23,38518,3,3,1, 38521
8,38536,1,1,1, 38537
8,38566,1,1,0, 38567
8,38596,1,1,1, 38597
8,38626,1,1,0, 38627
15,38631,2,2,1, 38633
24,38639,1,1,0, 38640
2,38643,2,2,1, 38645
1,38646,1,1,0, 38647
7,38652,1,1,0, 38653
8,38656,1,1,1, 38657
15,38661,2,2,1, 38663
24,38669,1,1,1, 38670
1,38676,1,1,0, 38677
7,38682,1,1,0, 38683
8,38686,1,1,1, 38687
15,38691,2,2,1, 38693
24,38699,1,1,0, 38700
1,38706,1,1,0, 38707
7,38712,1,1,0, 38713
8,38716,1,1,1, 38717
24,38729,1,1,0, 38730
2,38733,2,2,1, 38735
1,38736,1,1,0, 38737
6,38740,2,2,1, 38742
7,38742,1,1,0, 38743
8,38746,1,1,0, 38747
24,38759,1,1,0, 38760
25,38765,2,2,1, 38767
31,38766,2,2,1, 38768
26,38767,3,3,1, 38770
6,38770,2,2,1, 38772
7,38772,1,1,1, 38773
8,38776,1,1,1, 38777
24,38789,1,1,0, 38790
25,38795,2,2,1, 38797
7,38802,1,1,0, 38803
8,38806,1,1,0, 38807
24,38819,1,1,0, 38820
31,38826,2,2,1, 38828
7,38832,1,1,1, 38833
8,38836,1,1,0, 38837
15,38841,2,2,1, 38843
7,38862,1,1,0, 38863
8,38866,1,1,1, 38867
16,38869,2,2,1, 38871
23,38878,3,3,1, 38881
1,38886,1,1,1, 38887
7,38892,1,1,0, 38893
9,38897,2,2,1, 38899
17,38899,3,3,1, 38902
24,38909,1,1,0, 38910
1,38916,1,1,0, 38917
7,38922,1,1,0, 38923
24,38939,1,1,0, 38940
1,38946,1,1,0, 38947
6,38950,2,2,1, 38952
7,38952,1,1,1, 38953
24,38969,1,1,1, 38970
2,38973,2,2,1, 38975
1,38976,1,1,0, 38977
7,38982,1,1,0, 38983
8,38986,1,1,1, 38987
24,38999,1,1,0, 39000
25,39005,2,2,1, 39007
1,39006,1,1,1, 39007
6,39010,2,2,1, 39012
7,39012,1,1,1, 39013
8,39016,1,1,0, 39017
9,39017,2,2,1, 39019
24,39029,1,1,0, 39030
2,39033,2,2,1, 39035
1,39036,1,1,1, 39037
7,39042,1,1,0, 39043
8,39046,1,1,0, 39047
9,39047,2,2,1, 39049
15,39051,2,2,1, 39053
24,39059,1,1,1, 39060
25,39065,2,2,1, 39067
7,39072,1,1,0, 39073
8,39076,1,1,0, 39077
24,39089,1,1,1, 39090
25,39095,2,2,1, 39097
31,39096,2,2,1, 39098
7,39102,1,1,1, 39103
8,39106,1,1,1, 39107
16,39109,2,2,1, 39111
24,39119,1,1,1, 39120
31,39126,2,2,1, 39128
7,39132,1,1,0, 39133
8,39136,1,1,0, 39137
31,39156,2,2,1, 39158
7,39162,1,1,0, 39163
8,39166,1,1,0, 39167
1,39186,1,1,0, 39187
8,39196,1,1,0, 39197
25,39215,2,2,1, 39217
1,39216,1,1,0, 39217
8,39226,1,1,0, 39227
24,39239,1,1,0, 39240
1,39246,1,1,0, 39247
31,39246,2,2,1, 39248
8,39256,1,1,0, 39257
16,39259,2,2,1, 39261
17,39259,3,3,1, 39262
24,39269,1,1,1, 39270
23,39268,3,3,1, 39271
2,39273,2,2,1, 39275
1,39276,1,1,1, 39277
31,39276,2,2,1, 39278
8,39286,1,1,0, 39287
9,39287,2,2,1, 39289
17,39289,3,3,1, 39292
24,39299,1,1,1, 39300
2,39303,2,2,1, 39305
1,39306,1,1,0, 39307
7,39312,1,1,1, 39313
8,39316,1,1,1, 39317
15,39321,2,2,1, 39323
24,39329,1,1,0, 39330
1,39336,1,1,1, 39337
7,39342,1,1,1, 39343
8,39346,1,1,0, 39347
24,39359,1,1,0, 39360
2,39363,2,2,1, 39365
1,39366,1,1,0, 39367
7,39372,1,1,0, 39373
8,39376,1,1,0, 39377
24,39389,1,1,1, 39390
2,39393,2,2,1, 39395
1,39396,1,1,1, 39397
7,39402,1,1,0, 39403
8,39406,1,1,0, 39407
15,39411,2,2,1, 39413
24,39419,1,1,1, 39420
1,39426,1,1,0, 39427
6,39430,2,2,1, 39432
7,39432,1,1,1, 39433
24,39449,1,1,0, 39450
1,39456,1,1,0, 39457
6,39460,2,2,1, 39462
7,39462,1,1,1, 39463
24,39479,1,1,1, 39480
1,39486,1,1,1, 39487
31,39486,2,2,1, 39488
7,39492,1,1,1, 39493
24,39509,1,1,0, 39510
1,39516,1,1,1, 39517
31,39516,2,2,1, 39518
6,39520,2,2,1, 39522
7,39522,1,1,0, 39523
8,39526,1,1,0, 39527
17,39529,3,3,1, 39532
24,39539,1,1,1, 39540
2,39543,2,2,1, 39545
31,39546,2,2,1, 39548
7,39552,1,1,0, 39553
8,39556,1,1,0, 39557
15,39561,2,2,1, 39563
24,39569,1,1,0, 39570
31,39576,2,2,1, 39578
7,39582,1,1,1, 39583
8,39586,1,1,0, 39587
24,39599,1,1,0, 39600
31,39606,2,2,1, 39608
7,39612,1,1,1, 39613
8,39616,1,1,1, 39617
15,39621,2,2,1, 39623
24,39629,1,1,1, 39630
7,39642,1,1,0, 39643
8,39646,1,1,0, 39647
16,39649,2,2,1, 39651
24,39659,1,1,1, 39660
23,39658,3,3,1, 39661
6,39670,2,2,1, 39672
7,39672,1,1,1, 39673
24,39689,1,1,1, 39690
7,39702,1,1,1, 39703
24,39719,1,1,1, 39720
6,39730,2,2,1, 39732
7,39732,1,1,0, 39733
24,39749,1,1,0, 39750
6,39760,2,2,1, 39762
7,39762,1,1,0, 39763
8,39766,1,1,0, 39767
16,39769,2,2,1, 39771
17,39769,3,3,1, 39772
24,39779,1,1,0, 39780
23,39778,3,3,1, 39781
31,39786,2,2,1, 39788
8,39796,1,1,1, 39797
15,39801,2,2,1, 39803
24,39809,1,1,1, 39810
8,39826,1,1,0, 39827
24,39839,1,1,1, 39840
8,39856,1,1,1, 39857
15,39861,2,2,1, 39863
24,39869,1,1,1, 39870
8,39886,1,1,0, 39887
15,39891,2,2,1, 39893
24,39899,1,1,1, 39900
23,39898,3,3,1, 39901
1,39906,1,1,1, 39907
31,39906,2,2,1, 39908
6,39910,2,2,1, 39912
7,39912,1,1,0, 39913
24,39929,1,1,0, 39930
1,39936,1,1,1, 39937
31,39936,2,2,1, 39938
7,39942,1,1,1, 39943
24,39959,1,1,1, 39960
1,39966,1,1,1, 39967
7,39972,1,1,0, 39973
24,39989,1,1,0, 39990
1,39996,1,1,0, 39997
6,40000,2,2,1, 40002
7,40002,1,1,1, 40003
8,40006,1,1,1, 40007
9,40007,2,2,1, 40009
16,40009,2,2,1, 40011
17,40009,3,3,1, 40012
24,40019,1,1,0, 40020
23,40018,3,3,1, 40021
31,40026,2,2,1, 40028
6,40030,2,2,1, 40032
7,40032,1,1,1, 40033
6,40060,2,2,1, 40062
7,40062,1,1,0, 40063
8,40126,1,1,1, 40127
24,40139,1,1,1, 40140
23,40138,3,3,1, 40141
31,40146,2,2,1, 40148
8,40156,1,1,0, 40157
24,40169,1,1,1, 40170
8,40186,1,1,0, 40187
24,40199,1,1,1, 40200
6,40210,2,2,1, 40212
7,40212,1,1,0, 40213
8,40216,1,1,0, 40217
24,40229,1,1,1, 40230
6,40240,2,2,1, 40242
7,40242,1,1,0, 40243
8,40246,1,1,1, 40247
16,40249,2,2,1, 40251
17,40249,3,3,1, 40252
15,40251,2,2,1, 40253
24,40259,1,1,0, 40260
23,40258,3,3,1, 40261
1,40266,1,1,1, 40267
6,40270,2,2,1, 40272
7,40272,1,1,1, 40273
8,40276,1,1,0, 40277
24,40289,1,1,0, 40290
2,40293,2,2,1, 40295
1,40296,1,1,0, 40297
6,40300,2,2,1, 40302
7,40302,1,1,1, 40303
8,40306,1,1,1, 40307
15,40311,2,2,1, 40313
24,40319,1,1,1, 40320
1,40326,1,1,1, 40327
8,40336,1,1,1, 40337
24,40349,1,1,1, 40350
1,40356,1,1,0, 40357
8,40366,1,1,1, 40367
9,40367,2,2,1, 40369
16,40369,2,2,1, 40371
17,40369,3,3,1, 40372
24,40379,1,1,1, 40380
8,40396,1,1,1, 40397
24,40409,1,1,1, 40410
8,40426,1,1,0, 40427
24,40439,1,1,1, 40440
31,40446,2,2,1, 40448
7,40452,1,1,0, 40453
8,40456,1,1,0, 40457
15,40461,2,2,1, 40463
24,40469,1,1,0, 40470
7,40482,1,1,1, 40483
8,40486,1,1,1, 40487
9,40487,2,2,1, 40489
17,40489,3,3,1, 40492
15,40491,2,2,1, 40493
24,40499,1,1,0, 40500
23,40498,3,3,1, 40501
1,40506,1,1,0, 40507
31,40506,2,2,1, 40508
6,40510,2,2,1, 40512
7,40512,1,1,0, 40513
24,40529,1,1,0, 40530
1,40536,1,1,0, 40537
31,40536,2,2,1, 40538
6,40540,2,2,1, 40542
7,40542,1,1,0, 40543
24,40559,1,1,0, 40560
1,40566,1,1,1, 40567
6,40570,2,2,1, 40572
7,40572,1,1,1, 40573
24,40589,1,1,0, 40590
2,40593,2,2,1, 40595
1,40596,1,1,1, 40597
31,40596,2,2,1, 40598
6,40600,2,2,1, 40602
7,40602,1,1,0, 40603
8,40606,1,1,1, 40607
16,40609,2,2,1, 40611
24,40619,1,1,0, 40620
1,40626,1,1,1, 40627
7,40632,1,1,0, 40633
8,40636,1,1,0, 40637
16,40639,2,2,1, 40641
15,40641,2,2,1, 40643
24,40649,1,1,1, 40650
23,40648,3,3,1, 40651
1,40656,1,1,1, 40657
31,40656,2,2,1, 40658
7,40662,1,1,0, 40663
8,40666,1,1,0, 40667
15,40671,2,2,1, 40673
24,40679,1,1,0, 40680
25,40685,2,2,1, 40687
1,40686,1,1,0, 40687
26,40687,3,3,1, 40690
8,40696,1,1,0, 40697
25,40715,2,2,1, 40717
1,40716,1,1,1, 40717
26,40717,3,3,1, 40720
8,40726,1,1,1, 40727
25,40745,2,2,1, 40747
8,40756,1,1,1, 40757
8,40786,1,1,0, 40787
24,40799,1,1,0, 40800
23,40798,3,3,1, 40801
1,40806,1,1,1, 40807
7,40812,1,1,1, 40813
8,40816,1,1,0, 40817
24,40829,1,1,1, 40830
25,40835,2,2,1, 40837
1,40836,1,1,1, 40837
7,40842,1,1,0, 40843
8,40846,1,1,0, 40847
24,40859,1,1,1, 40860
1,40866,1,1,0, 40867
7,40872,1,1,1, 40873
8,40876,1,1,1, 40877
24,40889,1,1,1, 40890
1,40896,1,1,1, 40897
7,40902,1,1,0, 40903
8,40906,1,1,0, 40907
16,40909,2,2,1, 40911
15,40911,2,2,1, 40913
24,40919,1,1,1, 40920
31,40926,2,2,1, 40928
6,40930,2,2,1, 40932
7,40932,1,1,1, 40933
24,40949,1,1,0, 40950
31,40956,2,2,1, 40958
7,40962,1,1,1, 40963
15,40971,2,2,1, 40973
24,40979,1,1,0, 40980
6,40990,2,2,1, 40992
7,40992,1,1,0, 40993
24,41009,1,1,0, 41010
31,41016,2,2,1, 41018
7,41022,1,1,1, 41023
8,41026,1,1,1, 41027
17,41029,3,3,1, 41032
24,41039,1,1,0, 41040
31,41046,2,2,1, 41048
7,41052,1,1,0, 41053
8,41056,1,1,1, 41057
24,41069,1,1,1, 41070
7,41082,1,1,1, 41083
8,41086,1,1,1, 41087
24,41099,1,1,0, 41100
7,41112,1,1,1, 41113
8,41116,1,1,0, 41117
24,41129,1,1,0, 41130
31,41136,2,2,1, 41138
7,41142,1,1,0, 41143
8,41146,1,1,1, 41147
9,41147,2,2,1, 41149
24,41159,1,1,0, 41160
8,41176,1,1,1, 41177
8,41206,1,1,0, 41207
8,41236,1,1,0, 41237
8,41266,1,1,1, 41267
9,41267,2,2,1, 41269
17,41269,3,3,1, 41272
15,41271,2,2,1, 41273
24,41279,1,1,0, 41280
1,41286,1,1,1, 41287
31,41286,2,2,1, 41288
6,41290,2,2,1, 41292
7,41292,1,1,1, 41293
8,41296,1,1,0, 41297
24,41309,1,1,0, 41310
1,41316,1,1,0, 41317
31,41316,2,2,1, 41318
7,41322,1,1,1, 41323
8,41326,1,1,0, 41327
24,41339,1,1,1, 41340
1,41346,1,1,1, 41347
7,41352,1,1,1, 41353
8,41356,1,1,1, 41357
15,41361,2,2,1, 41363
24,41369,1,1,1, 41370
1,41376,1,1,1, 41377
31,41376,2,2,1, 41378
7,41382,1,1,0, 41383
8,41386,1,1,0, 41387
9,41387,2,2,1, 41389
17,41389,3,3,1, 41392
15,41391,2,2,1, 41393
24,41399,1,1,0, 41400
8,41506,1,1,0, 41507
16,41509,2,2,1, 41511
17,41509,3,3,1, 41512
24,41519,1,1,1, 41520
1,41526,1,1,0, 41527
31,41526,2,2,1, 41528
7,41532,1,1,1, 41533
8,41536,1,1,0, 41537
24,41549,1,1,1, 41550
1,41556,1,1,0, 41557
31,41556,2,2,1, 41558
6,41560,2,2,1, 41562
7,41562,1,1,0, 41563
8,41566,1,1,1, 41567
15,41571,2,2,1, 41573
24,41579,1,1,1, 41580
1,41586,1,1,0, 41587
8,41596,1,1,0, 41597
24,41609,1,1,0, 41610
1,41616,1,1,0, 41617
8,41626,1,1,0, 41627
9,41627,2,2,1, 41629
16,41629,2,2,1, 41631
17,41629,3,3,1, 41632
15,41631,2,2,1, 41633
24,41639,1,1,1, 41640
23,41638,3,3,1, 41641
2,41643,2,2,1, 41645
25,41645,2,2,1, 41647
1,41646,1,1,1, 41647
26,41647,3,3,1, 41650
9,41657,2,2,1, 41659
16,41659,2,2,1, 41661
24,41669,1,1,0, 41670
2,41673,2,2,1, 41675
1,41676,1,1,0, 41677
24,41699,1,1,1, 41700
25,41705,2,2,1, 41707
7,41712,1,1,0, 41713
7,41742,1,1,0, 41743
8,41746,1,1,1, 41747
23,41758,3,3,1, 41761
6,41770,2,2,1, 41772
7,41772,1,1,0, 41773
8,41776,1,1,0, 41777
15,41781,2,2,1, 41783
6,41800,2,2,1, 41802
7,41802,1,1,0, 41803
8,41806,1,1,1, 41807
24,41819,1,1,1, 41820
1,41826,1,1,1, 41827
31,41826,2,2,1, 41828
6,41830,2,2,1, 41832
7,41832,1,1,0, 41833
8,41836,1,1,0, 41837
24,41849,1,1,0, 41850
1,41856,1,1,0, 41857
7,41862,1,1,0, 41863
8,41866,1,1,1, 41867
16,41869,2,2,1, 41871
15,41871,2,2,1, 41873
24,41879,1,1,0, 41880
2,41883,2,2,1, 41885
1,41886,1,1,0, 41887
8,41896,1,1,1, 41897
24,41909,1,1,1, 41910
2,41913,2,2,1, 41915
1,41916,1,1,1, 41917
8,41926,1,1,0, 41927
16,41929,2,2,1, 41931
24,41939,1,1,0, 41940
25,41945,2,2,1, 41947
1,41946,1,1,1, 41947
31,41946,2,2,1, 41948
8,41956,1,1,0, 41957
24,41969,1,1,0, 41970
1,41976,1,1,0, 41977
8,41986,1,1,1, 41987
9,41987,2,2,1, 41989
17,41989,3,3,1, 41992
24,41999,1,1,0, 42000
7,42012,1,1,0, 42013
8,42016,1,1,0, 42017
15,42021,2,2,1, 42023
24,42029,1,1,0, 42030
31,42036,2,2,1, 42038
7,42042,1,1,0, 42043
8,42046,1,1,0, 42047
24,42059,1,1,1, 42060
6,42070,2,2,1, 42072
7,42072,1,1,1, 42073
8,42076,1,1,1, 42077
24,42089,1,1,0, 42090
6,42100,2,2,1, 42102
7,42102,1,1,0, 42103
8,42106,1,1,1, 42107
24,42119,1,1,1, 42120
1,42126,1,1,1, 42127
31,42126,2,2,1, 42128
7,42132,1,1,0, 42133
8,42136,1,1,1, 42137
9,42137,2,2,1, 42139
24,42149,1,1,0, 42150
1,42156,1,1,0, 42157
7,42162,1,1,1, 42163
8,42166,1,1,1, 42167
16,42169,2,2,1, 42171
15,42171,2,2,1, 42173
24,42179,1,1,0, 42180
2,42183,2,2,1, 42185
1,42186,1,1,1, 42187
7,42192,1,1,1, 42193
8,42196,1,1,0, 42197
15,42201,2,2,1, 42203
24,42209,1,1,0, 42210
2,42213,2,2,1, 42215
1,42216,1,1,1, 42217
31,42216,2,2,1, 42218
7,42222,1,1,1, 42223
8,42226,1,1,1, 42227
16,42229,2,2,1, 42231
17,42229,3,3,1, 42232
15,42231,2,2,1, 42233
24,42239,1,1,1, 42240
8,42346,1,1,1, 42347
9,42347,2,2,1, 42349
15,42351,2,2,1, 42353
24,42359,1,1,1, 42360
31,42366,2,2,1, 42368
7,42372,1,1,0, 42373
8,42376,1,1,1, 42377
15,42381,2,2,1, 42383
24,42389,1,1,0, 42390
31,42396,2,2,1, 42398
26,42397,3,3,1, 42400
6,42400,2,2,1, 42402
7,42402,1,1,1, 42403
8,42406,1,1,0, 42407
15,42411,2,2,1, 42413
24,42419,1,1,0, 42420
31,42426,2,2,1, 42428
7,42432,1,1,1, 42433
8,42436,1,1,0, 42437
24,42449,1,1,1, 42450
7,42462,1,1,0, 42463
8,42466,1,1,1, 42467
16,42469,2,2,1, 42471
17,42469,3,3,1, 42472
24,42479,1,1,1, 42480
1,42486,1,1,0, 42487
7,42492,1,1,0, 42493
8,42496,1,1,0, 42497
17,42499,3,3,1, 42502
1,42516,1,1,1, 42517
7,42522,1,1,0, 42523
8,42526,1,1,0, 42527
1,42546,1,1,0, 42547
6,42550,2,2,1, 42552
7,42552,1,1,0, 42553
8,42556,1,1,0, 42557
1,42576,1,1,1, 42577
31,42576,2,2,1, 42578
6,42580,2,2,1, 42582
7,42582,1,1,0, 42583
8,42586,1,1,0, 42587
9,42587,2,2,1, 42589
24,42599,1,1,0, 42600
2,42603,2,2,1, 42605
1,42606,1,1,1, 42607
24,42629,1,1,1, 42630
1,42636,1,1,1, 42637
31,42636,2,2,1, 42638
24,42659,1,1,1, 42660
1,42666,1,1,0, 42667
31,42666,2,2,1, 42668
24,42689,1,1,0, 42690
2,42693,2,2,1, 42695
1,42696,1,1,0, 42697
8,42706,1,1,0, 42707
24,42719,1,1,1, 42720
7,42732,1,1,1, 42733
8,42736,1,1,0, 42737
9,42737,2,2,1, 42739
15,42741,2,2,1, 42743
24,42749,1,1,0, 42750
6,42760,2,2,1, 42762
7,42762,1,1,1, 42763
8,42766,1,1,1, 42767
24,42779,1,1,1, 42780
25,42785,2,2,1, 42787
6,42790,2,2,1, 42792
7,42792,1,1,0, 42793
8,42796,1,1,1, 42797
9,42797,2,2,1, 42799
24,42809,1,1,0, 42810
26,42817,3,3,1, 42820
7,42822,1,1,0, 42823
8,42826,1,1,0, 42827
9,42827,2,2,1, 42829
16,42829,2,2,1, 42831
24,42839,1,1,0, 42840
23,42838,3,3,1, 42841
1,42846,1,1,1, 42847
7,42852,1,1,1, 42853
16,42859,2,2,1, 42861
17,42859,3,3,1, 42862
24,42869,1,1,0, 42870
23,42868,3,3,1, 42871
1,42876,1,1,0, 42877
7,42882,1,1,1, 42883
16,42889,2,2,1, 42891
17,42889,3,3,1, 42892
24,42899,1,1,1, 42900
1,42906,1,1,1, 42907
7,42912,1,1,1, 42913
8,42916,1,1,0, 42917
1,42936,1,1,0, 42937
7,42942,1,1,1, 42943
8,42946,1,1,0, 42947
9,42947,2,2,1, 42949
15,42951,2,2,1, 42953
2,42963,2,2,1, 42965
1,42966,1,1,1, 42967
31,42966,2,2,1, 42968
7,42972,1,1,1, 42973
8,42976,1,1,1, 42977
24,42989,1,1,1, 42990
1,42996,1,1,1, 42997
31,42996,2,2,1, 42998
7,43002,1,1,0, 43003
8,43006,1,1,0, 43007
17,43009,3,3,1, 43012
24,43019,1,1,1, 43020
6,43030,2,2,1, 43032
7,43032,1,1,0, 43033
8,43036,1,1,1, 43037
31,43056,2,2,1, 43058
6,43060,2,2,1, 43062
7,43062,1,1,0, 43063
8,43066,1,1,0, 43067
15,43071,2,2,1, 43073
6,43090,2,2,1, 43092
7,43092,1,1,0, 43093
8,43096,1,1,1, 43097
31,43116,2,2,1, 43118
7,43122,1,1,1, 43123
8,43126,1,1,1, 43127
9,43127,2,2,1, 43129
24,43139,1,1,0, 43140
1,43146,1,1,0, 43147
31,43146,2,2,1, 43148
7,43152,1,1,0, 43153
8,43156,1,1,1, 43157
24,43169,1,1,1, 43170
1,43176,1,1,1, 43177
31,43176,2,2,1, 43178
7,43182,1,1,0, 43183
8,43186,1,1,0, 43187
15,43191,2,2,1, 43193
24,43199,1,1,1, 43200
1,43206,1,1,0, 43207
7,43212,1,1,1, 43213
15,43221,2,2,1, 43223
24,43229,1,1,1, 43230
1,43236,1,1,0, 43237
6,43240,2,2,1, 43242
7,43242,1,1,0, 43243
16,43249,2,2,1, 43251
15,43251,2,2,1, 43253
24,43259,1,1,0, 43260
2,43263,2,2,1, 43265
25,43265,2,2,1, 43267
1,43266,1,1,0, 43267
8,43276,1,1,0, 43277
15,43281,2,2,1, 43283
1,43296,1,1,1, 43297
8,43306,1,1,0, 43307
2,43323,2,2,1, 43325
1,43326,1,1,0, 43327
8,43336,1,1,0, 43337
1,43356,1,1,0, 43357
8,43366,1,1,0, 43367
9,43367,2,2,1, 43369
16,43369,2,2,1, 43371
24,43379,1,1,0, 43380
7,43392,1,1,0, 43393
8,43396,1,1,1, 43397
9,43397,2,2,1, 43399
24,43409,1,1,0, 43410
23,43408,3,3,1, 43411
7,43422,1,1,0, 43423
8,43426,1,1,0, 43427
9,43427,2,2,1, 43429
16,43429,2,2,1, 43431
15,43431,2,2,1, 43433
24,43439,1,1,0, 43440
23,43438,3,3,1, 43441
7,43452,1,1,0, 43453
15,43461,2,2,1, 43463
24,43469,1,1,1, 43470
7,43482,1,1,1, 43483
15,43491,2,2,1, 43493
24,43499,1,1,1, 43500
25,43505,2,2,1, 43507
1,43506,1,1,0, 43507
7,43512,1,1,1, 43513
8,43516,1,1,0, 43517
24,43529,1,1,0, 43530
2,43533,2,2,1, 43535
25,43535,2,2,1, 43537
1,43536,1,1,1, 43537
7,43542,1,1,1, 43543
8,43546,1,1,1, 43547
17,43549,3,3,1, 43552
24,43559,1,1,1, 43560
2,43563,2,2,1, 43565
31,43566,2,2,1, 43568
7,43572,1,1,0, 43573
8,43576,1,1,1, 43577
24,43589,1,1,1, 43590
31,43596,2,2,1, 43598
7,43602,1,1,0, 43603
8,43606,1,1,1, 43607
24,43619,1,1,0, 43620
31,43626,2,2,1, 43628
6,43630,2,2,1, 43632
7,43632,1,1,1, 43633
8,43636,1,1,0, 43637
6,43660,2,2,1, 43662
7,43662,1,1,0, 43663
8,43666,1,1,0, 43667
9,43667,2,2,1, 43669
15,43671,2,2,1, 43673
7,43692,1,1,0, 43693
8,43696,1,1,1, 43697
9,43697,2,2,1, 43699
6,43720,2,2,1, 43722
7,43722,1,1,1, 43723
8,43726,1,1,1, 43727
9,43727,2,2,1, 43729
16,43729,2,2,1, 43731
24,43739,1,1,0, 43740
1,43746,1,1,0, 43747
31,43746,2,2,1, 43748
8,43756,1,1,0, 43757
24,43769,1,1,0, 43770
1,43776,1,1,0, 43777
31,43776,2,2,1, 43778
8,43786,1,1,0, 43787
24,43799,1,1,0, 43800
1,43806,1,1,0, 43807
31,43806,2,2,1, 43808
8,43816,1,1,1, 43817
24,43829,1,1,0, 43830
1,43836,1,1,0, 43837
31,43836,2,2,1, 43838
8,43846,1,1,1, 43847
24,43859,1,1,0, 43860
1,43866,1,1,0, 43867
31,43866,2,2,1, 43868
6,43870,2,2,1, 43872
7,43872,1,1,0, 43873
8,43876,1,1,1, 43877
15,43881,2,2,1, 43883
24,43889,1,1,1, 43890
1,43896,1,1,1, 43897
6,43900,2,2,1, 43902
7,43902,1,1,1, 43903
8,43906,1,1,0, 43907
9,43907,2,2,1, 43909
15,43911,2,2,1, 43913
24,43919,1,1,1, 43920
1,43926,1,1,0, 43927
24,43949,1,1,1, 43950
25,43955,2,2,1, 43957
1,43956,1,1,1, 43957
17,43969,3,3,1, 43972
24,43979,1,1,0, 43980
1,43986,1,1,0, 43987
8,43996,1,1,1, 43997
16,43999,2,2,1, 44001
15,44001,2,2,1, 44003
24,44009,1,1,0, 44010
23,44008,3,3,1, 44011
2,44013,2,2,1, 44015
1,44016,1,1,0, 44017
8,44026,1,1,0, 44027
16,44029,2,2,1, 44031
24,44039,1,1,0, 44040
23,44038,3,3,1, 44041
1,44046,1,1,0, 44047
7,44052,1,1,1, 44053
24,44069,1,1,1, 44070
1,44076,1,1,1, 44077
31,44076,2,2,1, 44078
7,44082,1,1,0, 44083
9,44087,2,2,1, 44089
24,44099,1,1,0, 44100
7,44112,1,1,0, 44113
31,44136,2,2,1, 44138
7,44142,1,1,0, 44143
15,44151,2,2,1, 44153
23,44158,3,3,1, 44161
1,44166,1,1,0, 44167
31,44166,2,2,1, 44168
7,44172,1,1,0, 44173
8,44176,1,1,1, 44177
17,44179,3,3,1, 44182
1,44196,1,1,0, 44197
31,44196,2,2,1, 44198
7,44202,1,1,0, 44203
8,44206,1,1,0, 44207
24,44219,1,1,0, 44220
1,44226,1,1,0, 44227
31,44226,2,2,1, 44228
7,44232,1,1,0, 44233
8,44236,1,1,0, 44237
24,44249,1,1,1, 44250
31,44256,2,2,1, 44258
7,44262,1,1,0, 44263
8,44266,1,1,0, 44267
24,44279,1,1,0, 44280
7,44292,1,1,1, 44293
8,44296,1,1,1, 44297
16,44299,2,2,1, 44301
17,44299,3,3,1, 44302
15,44301,2,2,1, 44303
23,44308,3,3,1, 44311
31,44316,2,2,1, 44318
6,44320,2,2,1, 44322
7,44322,1,1,0, 44323
8,44326,1,1,0, 44327
16,44329,2,2,1, 44331
17,44329,3,3,1, 44332
15,44331,2,2,1, 44333
1,44346,1,1,1, 44347
8,44356,1,1,1, 44357
15,44361,2,2,1, 44363
24,44369,1,1,0, 44370
2,44373,2,2,1, 44375
1,44376,1,1,1, 44377
8,44386,1,1,0, 44387
15,44391,2,2,1, 44393
24,44399,1,1,1, 44400
2,44403,2,2,1, 44405
1,44406,1,1,0, 44407
8,44416,1,1,1, 44417
24,44429,1,1,0, 44430
2,44433,2,2,1, 44435
1,44436,1,1,1, 44437
8,44446,1,1,0, 44447
9,44447,2,2,1, 44449
16,44449,2,2,1, 44451
15,44451,2,2,1, 44453
24,44459,1,1,1, 44460
31,44466,2,2,1, 44468
7,44472,1,1,0, 44473
24,44489,1,1,0, 44490
31,44496,2,2,1, 44498
7,44502,1,1,1, 44503
24,44519,1,1,1, 44520
7,44532,1,1,0, 44533
24,44549,1,1,1, 44550
7,44562,1,1,1, 44563
8,44566,1,1,1, 44567
17,44569,3,3,1, 44572
15,44571,2,2,1, 44573
24,44579,1,1,1, 44580
23,44578,3,3,1, 44581
7,44592,1,1,0, 44593
8,44596,1,1,0, 44597
24,44609,1,1,0, 44610
6,44620,2,2,1, 44622
7,44622,1,1,1, 44623
8,44626,1,1,0, 44627
24,44639,1,1,0, 44640
7,44652,1,1,0, 44653
8,44656,1,1,0, 44657
24,44669,1,1,0, 44670
7,44682,1,1,1, 44683
8,44686,1,1,0, 44687
9,44687,2,2,1, 44689
24,44699,1,1,0, 44700
23,44698,3,3,1, 44701
25,44705,2,2,1, 44707
31,44706,2,2,1, 44708
7,44712,1,1,1, 44713
8,44716,1,1,1, 44717
24,44729,1,1,1, 44730
7,44742,1,1,1, 44743
8,44746,1,1,0, 44747
15,44751,2,2,1, 44753
24,44759,1,1,0, 44760
25,44765,2,2,1, 44767
8,44776,1,1,0, 44777
15,44781,2,2,1, 44783
24,44789,1,1,1, 44790
25,44795,2,2,1, 44797
8,44806,1,1,1, 44807
9,44807,2,2,1, 44809
24,44819,1,1,0, 44820
23,44818,3,3,1, 44821
1,44826,1,1,0, 44827
8,44836,1,1,1, 44837
24,44849,1,1,1, 44850
2,44853,2,2,1, 44855
1,44856,1,1,0, 44857
8,44866,1,1,1, 44867
24,44879,1,1,0, 44880
1,44886,1,1,0, 44887
31,44886,2,2,1, 44888
6,44890,2,2,1, 44892
7,44892,1,1,0, 44893
8,44896,1,1,1, 44897
24,44909,1,1,1, 44910
1,44916,1,1,0, 44917
31,44916,2,2,1, 44918
7,44922,1,1,0, 44923
8,44926,1,1,1, 44927
9,44927,2,2,1, 44929
16,44929,2,2,1, 44931
24,44939,1,1,1, 44940
23,44938,3,3,1, 44941
31,44946,2,2,1, 44948
7,44952,1,1,1, 44953
7,44982,1,1,0, 44983
7,45012,1,1,1, 45013
31,45036,2,2,1, 45038
7,45042,1,1,0, 45043
8,45046,1,1,1, 45047
9,45047,2,2,1, 45049
24,45059,1,1,1, 45060
2,45063,2,2,1, 45065
25,45065,2,2,1, 45067
1,45066,1,1,1, 45067
6,45070,2,2,1, 45072
7,45072,1,1,0, 45073
8,45076,1,1,1, 45077
24,45089,1,1,1, 45090
1,45096,1,1,1, 45097
31,45096,2,2,1, 45098
6,45100,2,2,1, 45102
7,45102,1,1,0, 45103
8,45106,1,1,1, 45107
15,45111,2,2,1, 45113
24,45119,1,1,0, 45120
8,45136,1,1,0, 45137
24,45149,1,1,1, 45150
8,45166,1,1,1, 45167
9,45167,2,2,1, 45169
16,45169,2,2,1, 45171
17,45169,3,3,1, 45172
24,45179,1,1,0, 45180
1,45186,1,1,1, 45187
8,45196,1,1,1, 45197
1,45216,1,1,1, 45217
8,45226,1,1,1, 45227
2,45243,2,2,1, 45245
1,45246,1,1,1, 45247
7,45252,1,1,1, 45253
8,45256,1,1,0, 45257
15,45261,2,2,1, 45263
2,45273,2,2,1, 45275
1,45276,1,1,0, 45277
7,45282,1,1,1, 45283
8,45286,1,1,1, 45287
16,45289,2,2,1, 45291
17,45289,3,3,1, 45292
24,45299,1,1,1, 45300
23,45298,3,3,1, 45301
25,45305,2,2,1, 45307
7,45312,1,1,0, 45313
24,45329,1,1,0, 45330
25,45335,2,2,1, 45337
6,45340,2,2,1, 45342
7,45342,1,1,0, 45343
24,45359,1,1,1, 45360
7,45372,1,1,1, 45373
24,45389,1,1,1, 45390
25,45395,2,2,1, 45397
31,45396,2,2,1, 45398
6,45400,2,2,1, 45402
7,45402,1,1,0, 45403
8,45406,1,1,1, 45407
15,45411,2,2,1, 45413
24,45419,1,1,0, 45420
23,45418,3,3,1, 45421
2,45423,2,2,1, 45425
1,45426,1,1,1, 45427
7,45432,1,1,0, 45433
8,45436,1,1,1, 45437
15,45441,2,2,1, 45443
1,45456,1,1,1, 45457
7,45462,1,1,1, 45463
8,45466,1,1,0, 45467
15,45471,2,2,1, 45473
1,45486,1,1,0, 45487
7,45492,1,1,0, 45493
8,45496,1,1,1, 45497
2,45513,2,2,1, 45515
1,45516,1,1,1, 45517
7,45522,1,1,0, 45523
8,45526,1,1,0, 45527
17,45529,3,3,1, 45532
24,45539,1,1,0, 45540
23,45538,3,3,1, 45541
25,45545,2,2,1, 45547
31,45546,2,2,1, 45548
7,45552,1,1,0, 45553
8,45556,1,1,1, 45557
24,45569,1,1,0, 45570
31,45576,2,2,1, 45578
26,45577,3,3,1, 45580
7,45582,1,1,1, 45583
8,45586,1,1,1, 45587
15,45591,2,2,1, 45593
24,45599,1,1,0, 45600
25,45605,2,2,1, 45607
26,45607,3,3,1, 45610
8,45616,1,1,0, 45617
8,45646,1,1,0, 45647
16,45649,2,2,1, 45651
15,45651,2,2,1, 45653
23,45658,3,3,1, 45661
1,45666,1,1,0, 45667
24,45689,1,1,1, 45690
1,45696,1,1,0, 45697
24,45719,1,1,1, 45720
2,45723,2,2,1, 45725
1,45726,1,1,1, 45727
7,45732,1,1,0, 45733
24,45749,1,1,0, 45750
1,45756,1,1,1, 45757
7,45762,1,1,1, 45763
8,45766,1,1,0, 45767
17,45769,3,3,1, 45772
24,45779,1,1,1, 45780
23,45778,3,3,1, 45781
1,45786,1,1,0, 45787
7,45792,1,1,1, 45793
8,45796,1,1,0, 45797
24,45809,1,1,0, 45810
2,45813,2,2,1, 45815
1,45816,1,1,1, 45817
31,45816,2,2,1, 45818
7,45822,1,1,1, 45823
8,45826,1,1,0, 45827
15,45831,2,2,1, 45833
24,45839,1,1,1, 45840
1,45846,1,1,0, 45847
6,45850,2,2,1, 45852
7,45852,1,1,0, 45853
8,45856,1,1,0, 45857
15,45861,2,2,1, 45863
24,45869,1,1,1, 45870
1,45876,1,1,1, 45877
7,45882,1,1,1, 45883
8,45886,1,1,0, 45887
9,45887,2,2,1, 45889
24,45899,1,1,1, 45900
2,45903,2,2,1, 45905
7,45912,1,1,1, 45913
8,45916,1,1,1, 45917
24,45929,1,1,0, 45930
31,45936,2,2,1, 45938
6,45940,2,2,1, 45942
7,45942,1,1,0, 45943
8,45946,1,1,0, 45947
24,45959,1,1,1, 45960
31,45966,2,2,1, 45968
7,45972,1,1,1, 45973
8,45976,1,1,0, 45977
24,45989,1,1,0, 45990
31,45996,2,2,1, 45998
7,46002,1,1,0, 46003
8,46006,1,1,1, 46007
24,46019,1,1,0, 46020
1,46026,1,1,0, 46027
8,46036,1,1,1, 46037
15,46041,2,2,1, 46043
1,46056,1,1,1, 46057
8,46066,1,1,1, 46067
9,46067,2,2,1, 46069
15,46071,2,2,1, 46073
1,46086,1,1,1, 46087
8,46096,1,1,1, 46097
15,46101,2,2,1, 46103
1,46116,1,1,0, 46117
8,46126,1,1,0, 46127
15,46131,2,2,1, 46133
24,46139,1,1,0, 46140
23,46138,3,3,1, 46141
2,46143,2,2,1, 46145
25,46145,2,2,1, 46147
1,46146,1,1,1, 46147
31,46146,2,2,1, 46148
7,46152,1,1,0, 46153
8,46156,1,1,1, 46157
24,46169,1,1,0, 46170
1,46176,1,1,1, 46177
31,46176,2,2,1, 46178
7,46182,1,1,0, 46183
8,46186,1,1,1, 46187
24,46199,1,1,0, 46200
2,46203,2,2,1, 46205
1,46206,1,1,0, 46207
31,46206,2,2,1, 46208
6,46210,2,2,1, 46212
7,46212,1,1,1, 46213
8,46216,1,1,0, 46217
24,46229,1,1,0, 46230
1,46236,1,1,1, 46237
6,46240,2,2,1, 46242
7,46242,1,1,1, 46243
8,46246,1,1,0, 46247
9,46247,2,2,1, 46249
17,46249,3,3,1, 46252
15,46251,2,2,1, 46253
24,46259,1,1,1, 46260
31,46266,2,2,1, 46268
6,46270,2,2,1, 46272
7,46272,1,1,1, 46273
8,46276,1,1,1, 46277
31,46296,2,2,1, 46298
6,46300,2,2,1, 46302
7,46302,1,1,1, 46303
8,46306,1,1,1, 46307
15,46311,2,2,1, 46313
8,46336,1,1,0, 46337
8,46366,1,1,0, 46367
24,46379,1,1,1, 46380
1,46386,1,1,0, 46387
8,46396,1,1,1, 46397
24,46409,1,1,1, 46410
25,46415,2,2,1, 46417
1,46416,1,1,1, 46417
8,46426,1,1,0, 46427
15,46431,2,2,1, 46433
24,46439,1,1,0, 46440
25,46445,2,2,1, 46447
1,46446,1,1,1, 46447
31,46446,2,2,1, 46448
7,46452,1,1,0, 46453
8,46456,1,1,0, 46457
24,46469,1,1,0, 46470
1,46476,1,1,0, 46477
31,46476,2,2,1, 46478
7,46482,1,1,0, 46483
8,46486,1,1,0, 46487
16,46489,2,2,1, 46491
24,46499,1,1,1, 46500
6,46510,2,2,1, 46512
7,46512,1,1,1, 46513
8,46516,1,1,0, 46517
31,46536,2,2,1, 46538
7,46542,1,1,0, 46543
8,46546,1,1,1, 46547
6,46570,2,2,1, 46572
7,46572,1,1,1, 46573
8,46576,1,1,1, 46577
15,46581,2,2,1, 46583
31,46596,2,2,1, 46598
6,46600,2,2,1, 46602
7,46602,1,1,0, 46603
8,46606,1,1,1, 46607
17,46609,3,3,1, 46612
24,46619,1,1,1, 46620
23,46618,3,3,1, 46621
6,46630,2,2,1, 46632
7,46632,1,1,1, 46633
8,46636,1,1,0, 46637
24,46649,1,1,1, 46650
7,46662,1,1,1, 46663
8,46666,1,1,1, 46667
24,46679,1,1,1, 46680
6,46690,2,2,1, 46692
7,46692,1,1,1, 46693
8,46696,1,1,0, 46697
24,46709,1,1,1, 46710
7,46722,1,1,0, 46723
8,46726,1,1,1, 46727
16,46729,2,2,1, 46731
17,46729,3,3,1, 46732
24,46739,1,1,1, 46740
1,46746,1,1,0, 46747
31,46746,2,2,1, 46748
7,46752,1,1,1, 46753
8,46756,1,1,0, 46757
24,46769,1,1,1, 46770
1,46776,1,1,0, 46777
31,46776,2,2,1, 46778
7,46782,1,1,0, 46783
8,46786,1,1,1, 46787
24,46799,1,1,1, 46800
2,46803,2,2,1, 46805
1,46806,1,1,0, 46807
31,46806,2,2,1, 46808
8,46816,1,1,0, 46817
24,46829,1,1,1, 46830
2,46833,2,2,1, 46835
1,46836,1,1,1, 46837
8,46846,1,1,0, 46847
9,46847,2,2,1, 46849
16,46849,2,2,1, 46851
24,46859,1,1,0, 46860
25,46865,2,2,1, 46867
31,46866,2,2,1, 46868
24,46889,1,1,1, 46890
31,46896,2,2,1, 46898
24,46919,1,1,1, 46920
7,46932,1,1,1, 46933
8,46936,1,1,0, 46937
24,46949,1,1,0, 46950
7,46962,1,1,1, 46963
8,46966,1,1,1, 46967
9,46967,2,2,1, 46969
15,46971,2,2,1, 46973
24,46979,1,1,0, 46980
23,46978,3,3,1, 46981
1,46986,1,1,0, 46987
6,46990,2,2,1, 46992
7,46992,1,1,1, 46993
15,47001,2,2,1, 47003
24,47009,1,1,1, 47010
1,47016,1,1,1, 47017
31,47016,2,2,1, 47018
7,47022,1,1,0, 47023
24,47039,1,1,0, 47040
1,47046,1,1,0, 47047
6,47050,2,2,1, 47052
7,47052,1,1,1, 47053
24,47069,1,1,0, 47070
2,47073,2,2,1, 47075
1,47076,1,1,1, 47077
6,47080,2,2,1, 47082
7,47082,1,1,0, 47083
8,47086,1,1,0, 47087
9,47087,2,2,1, 47089
16,47089,2,2,1, 47091
24,47099,1,1,0, 47100
23,47098,3,3,1, 47101
25,47105,2,2,1, 47107
8,47116,1,1,1, 47117
24,47129,1,1,0, 47130
8,47146,1,1,1, 47147
24,47159,1,1,1, 47160
31,47166,2,2,1, 47168
8,47176,1,1,1, 47177
24,47189,1,1,1, 47190
8,47206,1,1,1, 47207
16,47209,2,2,1, 47211
15,47211,2,2,1, 47213
24,47219,1,1,0, 47220
1,47226,1,1,0, 47227
7,47232,1,1,0, 47233
15,47241,2,2,1, 47243
2,47253,2,2,1, 47255
1,47256,1,1,1, 47257
6,47260,2,2,1, 47262
7,47262,1,1,0, 47263
2,47283,2,2,1, 47285
1,47286,1,1,0, 47287
7,47292,1,1,0, 47293
1,47316,1,1,0, 47317
7,47322,1,1,0, 47323
8,47326,1,1,1, 47327
16,47329,2,2,1, 47331
17,47329,3,3,1, 47332
24,47339,1,1,0, 47340
6,47350,2,2,1, 47352
7,47352,1,1,1, 47353
8,47356,1,1,1, 47357
24,47369,1,1,0, 47370
31,47376,2,2,1, 47378
6,47380,2,2,1, 47382
7,47382,1,1,1, 47383
8,47386,1,1,0, 47387
15,47391,2,2,1, 47393
24,47399,1,1,1, 47400
8,47416,1,1,0, 47417
24,47429,1,1,1, 47430
31,47436,2,2,1, 47438
8,47446,1,1,0, 47447
24,47459,1,1,0, 47460
8,47476,1,1,0, 47477
8,47506,1,1,0, 47507
7,47532,1,1,1, 47533
8,47536,1,1,1, 47537
7,47562,1,1,0, 47563
8,47566,1,1,0, 47567
9,47567,2,2,1, 47569
16,47569,2,2,1, 47571
17,47569,3,3,1, 47572
15,47571,2,2,1, 47573
24,47579,1,1,1, 47580
1,47586,1,1,1, 47587
31,47586,2,2,1, 47588
7,47592,1,1,0, 47593
8,47596,1,1,1, 47597
15,47601,2,2,1, 47603
24,47609,1,1,0, 47610
1,47616,1,1,0, 47617
6,47620,2,2,1, 47622
7,47622,1,1,1, 47623
8,47626,1,1,1, 47627
24,47639,1,1,1, 47640
1,47646,1,1,1, 47647
7,47652,1,1,1, 47653
8,47656,1,1,1, 47657
24,47669,1,1,0, 47670
1,47676,1,1,1, 47677
7,47682,1,1,0, 47683
8,47686,1,1,1, 47687
9,47687,2,2,1, 47689
16,47689,2,2,1, 47691
24,47699,1,1,0, 47700
7,47712,1,1,0, 47713
8,47716,1,1,1, 47717
24,47729,1,1,0, 47730
7,47742,1,1,0, 47743
8,47746,1,1,0, 47747
24,47759,1,1,0, 47760
23,47758,3,3,1, 47761
7,47772,1,1,1, 47773
8,47776,1,1,1, 47777
24,47789,1,1,0, 47790
6,47800,2,2,1, 47802
7,47802,1,1,0, 47803
8,47806,1,1,1, 47807
9,47807,2,2,1, 47809
24,47819,1,1,1, 47820
1,47826,1,1,0, 47827
31,47826,2,2,1, 47828
24,47849,1,1,1, 47850
1,47856,1,1,1, 47857
31,47856,2,2,1, 47858
24,47879,1,1,0, 47880
1,47886,1,1,1, 47887
24,47909,1,1,1, 47910
1,47916,1,1,0, 47917
31,47916,2,2,1, 47918
8,47926,1,1,1, 47927
16,47929,2,2,1, 47931
24,47939,1,1,0, 47940
7,47952,1,1,1, 47953
8,47956,1,1,0, 47957
24,47969,1,1,0, 47970
6,47980,2,2,1, 47982
7,47982,1,1,0, 47983
8,47986,1,1,1, 47987
24,47999,1,1,1, 48000
7,48012,1,1,0, 48013
8,48016,1,1,0, 48017
24,48029,1,1,1, 48030
7,48042,1,1,0, 48043
8,48046,1,1,0, 48047
9,48047,2,2,1, 48049
16,48049,2,2,1, 48051
24,48059,1,1,1, 48060
23,48058,3,3,1, 48061
25,48065,2,2,1, 48067
1,48066,1,1,0, 48067
26,48067,3,3,1, 48070
7,48072,1,1,1, 48073
8,48076,1,1,1, 48077
16,48079,2,2,1, 48081
24,48089,1,1,0, 48090
23,48088,3,3,1, 48091
25,48095,2,2,1, 48097
1,48096,1,1,0, 48097
26,48097,3,3,1, 48100
7,48102,1,1,1, 48103
8,48106,1,1,0, 48107
9,48107,2,2,1, 48109
15,48111,2,2,1, 48113
24,48119,1,1,0, 48120
23,48118,3,3,1, 48121
1,48126,1,1,1, 48127
26,48127,3,3,1, 48130
7,48132,1,1,0, 48133
9,48137,2,2,1, 48139
1,48156,1,1,0, 48157
26,48157,3,3,1, 48160
7,48162,1,1,1, 48163
15,48171,2,2,1, 48173
31,48186,2,2,1, 48188
6,48190,2,2,1, 48192
7,48192,1,1,1, 48193
6,48220,2,2,1, 48222
7,48222,1,1,1, 48223
17,48229,3,3,1, 48232
24,48239,1,1,0, 48240
8,48256,1,1,0, 48257
24,48269,1,1,1, 48270
8,48286,1,1,0, 48287
24,48299,1,1,0, 48300
1,48306,1,1,0, 48307
8,48316,1,1,1, 48317
24,48329,1,1,0, 48330
25,48335,2,2,1, 48337
1,48336,1,1,0, 48337
8,48346,1,1,0, 48347
9,48347,2,2,1, 48349
16,48349,2,2,1, 48351
17,48349,3,3,1, 48352
15,48351,2,2,1, 48353
24,48359,1,1,1, 48360
23,48358,3,3,1, 48361
1,48366,1,1,1, 48367
7,48372,1,1,1, 48373
8,48376,1,1,1, 48377
24,48389,1,1,0, 48390
1,48396,1,1,1, 48397
31,48396,2,2,1, 48398
7,48402,1,1,0, 48403
8,48406,1,1,0, 48407
24,48419,1,1,0, 48420
2,48423,2,2,1, 48425
1,48426,1,1,0, 48427
31,48426,2,2,1, 48428
7,48432,1,1,0, 48433
8,48436,1,1,1, 48437
24,48449,1,1,1, 48450
1,48456,1,1,0, 48457
31,48456,2,2,1, 48458
7,48462,1,1,1, 48463
8,48466,1,1,1, 48467
24,48479,1,1,0, 48480
7,48492,1,1,0, 48493
8,48496,1,1,1, 48497
24,48509,1,1,0, 48510
7,48522,1,1,1, 48523
8,48526,1,1,0, 48527
15,48531,2,2,1, 48533
24,48539,1,1,0, 48540
7,48552,1,1,1, 48553
8,48556,1,1,0, 48557
24,48569,1,1,0, 48570
7,48582,1,1,1, 48583
8,48586,1,1,0, 48587
9,48587,2,2,1, 48589
24,48599,1,1,0, 48600
25,48605,2,2,1, 48607
1,48606,1,1,0, 48607
31,48606,2,2,1, 48608
6,48610,2,2,1, 48612
7,48612,1,1,1, 48613
8,48616,1,1,0, 48617
15,48621,2,2,1, 48623
25,48635,2,2,1, 48637
1,48636,1,1,1, 48637
6,48640,2,2,1, 48642
7,48642,1,1,1, 48643
8,48646,1,1,0, 48647
15,48651,2,2,1, 48653
1,48666,1,1,1, 48667
8,48676,1,1,1, 48677
25,48695,2,2,1, 48697
1,48696,1,1,0, 48697
8,48706,1,1,1, 48707
24,48719,1,1,0, 48720
23,48718,3,3,1, 48721
8,48736,1,1,1, 48737
24,48749,1,1,0, 48750
8,48766,1,1,0, 48767
15,48771,2,2,1, 48773
24,48779,1,1,0, 48780
6,48790,2,2,1, 48792
7,48792,1,1,1, 48793
8,48796,1,1,1, 48797
24,48809,1,1,1, 48810
31,48816,2,2,1, 48818
7,48822,1,1,0, 48823
8,48826,1,1,0, 48827
9,48827,2,2,1, 48829
17,48829,3,3,1, 48832
24,48839,1,1,0, 48840
23,48838,3,3,1, 48841
31,48846,2,2,1, 48848
7,48852,1,1,1, 48853
24,48869,1,1,0, 48870
6,48880,2,2,1, 48882
7,48882,1,1,0, 48883
24,48899,1,1,1, 48900
7,48912,1,1,1, 48913
24,48929,1,1,1, 48930
7,48942,1,1,1, 48943
8,48946,1,1,0, 48947
17,48949,3,3,1, 48952
24,48959,1,1,1, 48960
7,48972,1,1,0, 48973
8,48976,1,1,0, 48977
15,48981,2,2,1, 48983
24,48989,1,1,1, 48990
7,49002,1,1,0, 49003
8,49006,1,1,1, 49007
24,49019,1,1,0, 49020
6,49030,2,2,1, 49032
7,49032,1,1,1, 49033
8,49036,1,1,0, 49037
24,49049,1,1,0, 49050
31,49056,2,2,1, 49058
7,49062,1,1,0, 49063
8,49066,1,1,1, 49067
17,49069,3,3,1, 49072
24,49079,1,1,1, 49080
7,49092,1,1,0, 49093
8,49096,1,1,1, 49097
24,49109,1,1,0, 49110
6,49120,2,2,1, 49122
7,49122,1,1,0, 49123
8,49126,1,1,0, 49127
24,49139,1,1,1, 49140
8,49156,1,1,0, 49157
15,49161,2,2,1, 49163
24,49169,1,1,1, 49170
31,49176,2,2,1, 49178
8,49186,1,1,1, 49187
9,49187,2,2,1, 49189
24,49199,1,1,1, 49200
31,49206,2,2,1, 49208
8,49216,1,1,1, 49217
15,49221,2,2,1, 49223
24,49229,1,1,0, 49230
31,49236,2,2,1, 49238
8,49246,1,1,1, 49247
15,49251,2,2,1, 49253
24,49259,1,1,1, 49260
7,49272,1,1,0, 49273
8,49276,1,1,0, 49277
24,49289,1,1,1, 49290
7,49302,1,1,1, 49303
8,49306,1,1,0, 49307
9,49307,2,2,1, 49309
16,49309,2,2,1, 49311
24,49319,1,1,0, 49320
6,49330,2,2,1, 49332
7,49332,1,1,0, 49333
8,49336,1,1,0, 49337
31,49356,2,2,1, 49358
6,49360,2,2,1, 49362
7,49362,1,1,0, 49363
8,49366,1,1,0, 49367
7,49392,1,1,1, 49393
8,49396,1,1,0, 49397
15,49401,2,2,1, 49403
6,49420,2,2,1, 49422
7,49422,1,1,1, 49423
8,49426,1,1,0, 49427
16,49429,2,2,1, 49431
15,49431,2,2,1, 49433
24,49439,1,1,0, 49440
23,49438,3,3,1, 49441
7,49452,1,1,0, 49453
8,49456,1,1,1, 49457
24,49469,1,1,1, 49470
7,49482,1,1,0, 49483
8,49486,1,1,0, 49487
24,49499,1,1,0, 49500
7,49512,1,1,1, 49513
8,49516,1,1,0, 49517
24,49529,1,1,1, 49530
7,49542,1,1,1, 49543
8,49546,1,1,0, 49547
16,49549,2,2,1, 49551
17,49549,3,3,1, 49552
24,49559,1,1,1, 49560
1,49566,1,1,0, 49567
31,49566,2,2,1, 49568
6,49570,2,2,1, 49572
7,49572,1,1,0, 49573
8,49576,1,1,1, 49577
24,49589,1,1,1, 49590
1,49596,1,1,0, 49597
7,49602,1,1,0, 49603
8,49606,1,1,0, 49607
15,49611,2,2,1, 49613
24,49619,1,1,1, 49620
1,49626,1,1,0, 49627
31,49626,2,2,1, 49628
8,49636,1,1,1, 49637
24,49649,1,1,0, 49650
1,49656,1,1,1, 49657
31,49656,2,2,1, 49658
8,49666,1,1,0, 49667
16,49669,2,2,1, 49671
17,49669,3,3,1, 49672
24,49679,1,1,1, 49680
8,49696,1,1,0, 49697
8,49726,1,1,0, 49727
7,49752,1,1,0, 49753
8,49756,1,1,1, 49757
15,49761,2,2,1, 49763
31,49776,2,2,1, 49778
7,49782,1,1,1, 49783
8,49786,1,1,1, 49787
9,49787,2,2,1, 49789
24,49799,1,1,0, 49800
6,49810,2,2,1, 49812
7,49812,1,1,0, 49813
16,49819,2,2,1, 49821
24,49829,1,1,0, 49830
7,49842,1,1,1, 49843
16,49849,2,2,1, 49851
24,49859,1,1,1, 49860
6,49870,2,2,1, 49872
7,49872,1,1,1, 49873
24,49889,1,1,0, 49890
6,49900,2,2,1, 49902
7,49902,1,1,0, 49903
8,49906,1,1,1, 49907
16,49909,2,2,1, 49911
24,49919,1,1,1, 49920
23,49918,3,3,1, 49921
1,49926,1,1,0, 49927
31,49926,2,2,1, 49928
7,49932,1,1,0, 49933
8,49936,1,1,0, 49937
15,49941,2,2,1, 49943
24,49949,1,1,0, 49950
2,49953,2,2,1, 49955
1,49956,1,1,0, 49957
7,49962,1,1,0, 49963
8,49966,1,1,0, 49967
15,49971,2,2,1, 49973
24,49979,1,1,0, 49980
2,49983,2,2,1, 49985
1,49986,1,1,1, 49987
31,49986,2,2,1, 49988
7,49992,1,1,0, 49993
8,49996,1,1,1, 49997
15,50001,2,2,1, 50003
24,50009,1,1,0, 50010
1,50016,1,1,0, 50017
7,50022,1,1,1, 50023
8,50026,1,1,1, 50027
9,50027,2,2,1, 50029
16,50029,2,2,1, 50031
15,50031,2,2,1, 50033
24,50039,1,1,1, 50040
8,50146,1,1,1, 50147
24,50159,1,1,0, 50160
23,50158,3,3,1, 50161
31,50166,2,2,1, 50168
7,50172,1,1,1, 50173
8,50176,1,1,1, 50177
24,50189,1,1,0, 50190
7,50202,1,1,1, 50203
8,50206,1,1,0, 50207
15,50211,2,2,1, 50213
24,50219,1,1,0, 50220
31,50226,2,2,1, 50228
7,50232,1,1,0, 50233
8,50236,1,1,0, 50237
24,50249,1,1,0, 50250
31,50256,2,2,1, 50258
7,50262,1,1,0, 50263
8,50266,1,1,0, 50267
16,50269,2,2,1, 50271
24,50279,1,1,0, 50280
6,50290,2,2,1, 50292
7,50292,1,1,1, 50293
8,50296,1,1,0, 50297
6,50320,2,2,1, 50322
7,50322,1,1,1, 50323
8,50326,1,1,0, 50327
7,50352,1,1,0, 50353
8,50356,1,1,1, 50357
31,50376,2,2,1, 50378
6,50380,2,2,1, 50382
7,50382,1,1,0, 50383
8,50386,1,1,0, 50387
9,50387,2,2,1, 50389
15,50391,2,2,1, 50393
24,50399,1,1,0, 50400
23,50398,3,3,1, 50401
1,50406,1,1,1, 50407
8,50416,1,1,0, 50417
9,50417,2,2,1, 50419
24,50429,1,1,0, 50430
1,50436,1,1,0, 50437
8,50446,1,1,0, 50447
24,50459,1,1,1, 50460
1,50466,1,1,1, 50467
8,50476,1,1,1, 50477
24,50489,1,1,1, 50490
1,50496,1,1,1, 50497
8,50506,1,1,0, 50507
24,50519,1,1,0, 50520
2,50523,2,2,1, 50525
1,50526,1,1,0, 50527
6,50530,2,2,1, 50532
7,50532,1,1,1, 50533
8,50536,1,1,0, 50537
15,50541,2,2,1, 50543
24,50549,1,1,0, 50550
2,50553,2,2,1, 50555
25,50555,2,2,1, 50557
1,50556,1,1,1, 50557
31,50556,2,2,1, 50558
6,50560,2,2,1, 50562
7,50562,1,1,0, 50563
8,50566,1,1,1, 50567
15,50571,2,2,1, 50573
24,50579,1,1,1, 50580
2,50583,2,2,1, 50585
1,50586,1,1,1, 50587
31,50586,2,2,1, 50588
8,50596,1,1,1, 50597
15,50601,2,2,1, 50603
24,50609,1,1,1, 50610
1,50616,1,1,1, 50617
31,50616,2,2,1, 50618
8,50626,1,1,1, 50627
9,50627,2,2,1, 50629
24,50639,1,1,1, 50640
23,50638,3,3,1, 50641
8,50656,1,1,0, 50657
24,50669,1,1,1, 50670
8,50686,1,1,0, 50687
24,50699,1,1,0, 50700
31,50706,2,2,1, 50708
7,50712,1,1,1, 50713
8,50716,1,1,0, 50717
24,50729,1,1,1, 50730
6,50740,2,2,1, 50742
7,50742,1,1,1, 50743
8,50746,1,1,0, 50747
9,50747,2,2,1, 50749
17,50749,3,3,1, 50752
24,50759,1,1,0, 50760
1,50766,1,1,1, 50767
6,50770,2,2,1, 50772
7,50772,1,1,1, 50773
15,50781,2,2,1, 50783
24,50789,1,1,1, 50790
1,50796,1,1,0, 50797
6,50800,2,2,1, 50802
7,50802,1,1,1, 50803
15,50811,2,2,1, 50813
24,50819,1,1,1, 50820
1,50826,1,1,0, 50827
7,50832,1,1,1, 50833
15,50841,2,2,1, 50843
24,50849,1,1,0, 50850
1,50856,1,1,0, 50857
7,50862,1,1,1, 50863
8,50866,1,1,0, 50867
9,50867,2,2,1, 50869
24,50879,1,1,1, 50880
23,50878,3,3,1, 50881
7,50892,1,1,1, 50893
8,50896,1,1,0, 50897
24,50909,1,1,1, 50910
7,50922,1,1,1, 50923
8,50926,1,1,0, 50927
24,50939,1,1,0, 50940
7,50952,1,1,0, 50953
8,50956,1,1,0, 50957
24,50969,1,1,1, 50970
31,50976,2,2,1, 50978
7,50982,1,1,1, 50983
8,50986,1,1,0, 50987
16,50989,2,2,1, 50991
17,50989,3,3,1, 50992
24,50999,1,1,1, 51000
31,51006,2,2,1, 51008
8,51016,1,1,0, 51017
24,51029,1,1,1, 51030
8,51046,1,1,1, 51047
15,51051,2,2,1, 51053
24,51059,1,1,1, 51060
8,51076,1,1,0, 51077
24,51089,1,1,0, 51090
31,51096,2,2,1, 51098
8,51106,1,1,0, 51107
16,51109,2,2,1, 51111
17,51109,3,3,1, 51112
24,51119,1,1,0, 51120
23,51118,3,3,1, 51121
2,51123,2,2,1, 51125
6,51130,2,2,1, 51132
7,51132,1,1,1, 51133
8,51136,1,1,1, 51137
31,51156,2,2,1, 51158
6,51160,2,2,1, 51162
7,51162,1,1,0, 51163
8,51166,1,1,0, 51167
15,51171,2,2,1, 51173
7,51192,1,1,1, 51193
8,51196,1,1,0, 51197
15,51201,2,2,1, 51203
31,51216,2,2,1, 51218
7,51222,1,1,0, 51223
8,51226,1,1,0, 51227
15,51231,2,2,1, 51233
24,51239,1,1,1, 51240
23,51238,3,3,1, 51241
2,51243,2,2,1, 51245
24,51269,1,1,1, 51270
24,51299,1,1,1, 51300
24,51329,1,1,1, 51330
8,51346,1,1,0, 51347
16,51349,2,2,1, 51351
15,51351,2,2,1, 51353
24,51359,1,1,0, 51360
2,51363,2,2,1, 51365
1,51366,1,1,1, 51367
6,51370,2,2,1, 51372
7,51372,1,1,0, 51373
8,51376,1,1,0, 51377
24,51389,1,1,1, 51390
1,51396,1,1,0, 51397
31,51396,2,2,1, 51398
6,51400,2,2,1, 51402
7,51402,1,1,0, 51403
8,51406,1,1,0, 51407
24,51419,1,1,0, 51420
1,51426,1,1,1, 51427
7,51432,1,1,0, 51433
8,51436,1,1,0, 51437
24,51449,1,1,0, 51450
2,51453,2,2,1, 51455
1,51456,1,1,0, 51457
31,51456,2,2,1, 51458
6,51460,2,2,1, 51462
7,51462,1,1,0, 51463
8,51466,1,1,0, 51467
16,51469,2,2,1, 51471
17,51469,3,3,1, 51472
15,51471,2,2,1, 51473
24,51479,1,1,0, 51480
31,51486,2,2,1, 51488
24,51509,1,1,1, 51510
31,51516,2,2,1, 51518
24,51539,1,1,0, 51540
24,51569,1,1,0, 51570
25,51575,2,2,1, 51577
31,51576,2,2,1, 51578
8,51586,1,1,1, 51587
15,51591,2,2,1, 51593
24,51599,1,1,0, 51600
23,51598,3,3,1, 51601
1,51606,1,1,0, 51607
6,51610,2,2,1, 51612
7,51612,1,1,1, 51613
8,51616,1,1,0, 51617
24,51629,1,1,1, 51630
1,51636,1,1,0, 51637
7,51642,1,1,0, 51643
8,51646,1,1,0, 51647
24,51659,1,1,1, 51660
1,51666,1,1,1, 51667
7,51672,1,1,1, 51673
8,51676,1,1,0, 51677
15,51681,2,2,1, 51683
24,51689,1,1,1, 51690
1,51696,1,1,0, 51697
7,51702,1,1,0, 51703
8,51706,1,1,1, 51707
24,51719,1,1,1, 51720
23,51718,3,3,1, 51721
2,51723,2,2,1, 51725
25,51725,2,2,1, 51727
1,51726,1,1,0, 51727
31,51726,2,2,1, 51728
7,51732,1,1,0, 51733
8,51736,1,1,1, 51737
24,51749,1,1,1, 51750
1,51756,1,1,0, 51757
31,51756,2,2,1, 51758
7,51762,1,1,1, 51763
8,51766,1,1,1, 51767
24,51779,1,1,1, 51780
1,51786,1,1,0, 51787
7,51792,1,1,0, 51793
8,51796,1,1,0, 51797
24,51809,1,1,0, 51810
1,51816,1,1,1, 51817
31,51816,2,2,1, 51818
7,51822,1,1,0, 51823
8,51826,1,1,0, 51827
9,51827,2,2,1, 51829
16,51829,2,2,1, 51831
24,51839,1,1,1, 51840
23,51838,3,3,1, 51841
1,51846,1,1,1, 51847
7,51852,1,1,1, 51853
1,51876,1,1,0, 51877
31,51876,2,2,1, 51878
6,51880,2,2,1, 51882
7,51882,1,1,1, 51883
15,51891,2,2,1, 51893
1,51906,1,1,0, 51907
6,51910,2,2,1, 51912
7,51912,1,1,1, 51913
1,51936,1,1,0, 51937
7,51942,1,1,1, 51943
8,51946,1,1,1, 51947
9,51947,2,2,1, 51949
16,51949,2,2,1, 51951
24,51959,1,1,0, 51960
31,51966,2,2,1, 51968
7,51972,1,1,0, 51973
8,51976,1,1,0, 51977
15,51981,2,2,1, 51983
24,51989,1,1,1, 51990
31,51996,2,2,1, 51998
7,52002,1,1,0, 52003
8,52006,1,1,1, 52007
24,52019,1,1,0, 52020
31,52026,2,2,1, 52028
7,52032,1,1,1, 52033
8,52036,1,1,1, 52037
15,52041,2,2,1, 52043
24,52049,1,1,1, 52050
31,52056,2,2,1, 52058
7,52062,1,1,0, 52063
8,52066,1,1,1, 52067
16,52069,2,2,1, 52071
17,52069,3,3,1, 52072
15,52071,2,2,1, 52073
24,52079,1,1,0, 52080
23,52078,3,3,1, 52081
2,52083,2,2,1, 52085
7,52092,1,1,0, 52093
8,52096,1,1,1, 52097
7,52122,1,1,1, 52123
8,52126,1,1,1, 52127
6,52150,2,2,1, 52152
7,52152,1,1,1, 52153
8,52156,1,1,0, 52157
7,52182,1,1,0, 52183
8,52186,1,1,0, 52187
9,52187,2,2,1, 52189
17,52189,3,3,1, 52192
24,52199,1,1,1, 52200
23,52198,3,3,1, 52201
25,52205,2,2,1, 52207
1,52206,1,1,0, 52207
7,52212,1,1,0, 52213
8,52216,1,1,1, 52217
15,52221,2,2,1, 52223
24,52229,1,1,1, 52230
25,52235,2,2,1, 52237
1,52236,1,1,0, 52237
6,52240,2,2,1, 52242
7,52242,1,1,0, 52243
8,52246,1,1,1, 52247
24,52259,1,1,1, 52260
1,52266,1,1,0, 52267
31,52266,2,2,1, 52268
8,52276,1,1,1, 52277
24,52289,1,1,0, 52290
1,52296,1,1,0, 52297
8,52306,1,1,1, 52307
17,52309,3,3,1, 52312
15,52311,2,2,1, 52313
24,52319,1,1,0, 52320
23,52318,3,3,1, 52321
2,52323,2,2,1, 52325
1,52326,1,1,1, 52327
24,52349,1,1,1, 52350
1,52356,1,1,0, 52357
24,52379,1,1,1, 52380
2,52383,2,2,1, 52385
1,52386,1,1,0, 52387
6,52390,2,2,1, 52392
7,52392,1,1,1, 52393
8,52396,1,1,0, 52397
24,52409,1,1,0, 52410
2,52413,2,2,1, 52415
1,52416,1,1,1, 52417
6,52420,2,2,1, 52422
7,52422,1,1,0, 52423
8,52426,1,1,1, 52427
16,52429,2,2,1, 52431
17,52429,3,3,1, 52432
24,52439,1,1,0, 52440
6,52450,2,2,1, 52452
7,52452,1,1,1, 52453
15,52461,2,2,1, 52463
7,52482,1,1,1, 52483
6,52510,2,2,1, 52512
7,52512,1,1,0, 52513
7,52542,1,1,0, 52543
8,52546,1,1,0, 52547
15,52551,2,2,1, 52553
24,52559,1,1,1, 52560
23,52558,3,3,1, 52561
2,52563,2,2,1, 52565
1,52566,1,1,0, 52567
31,52566,2,2,1, 52568
7,52572,1,1,0, 52573
8,52576,1,1,0, 52577
24,52589,1,1,1, 52590
2,52593,2,2,1, 52595
1,52596,1,1,1, 52597
6,52600,2,2,1, 52602
7,52602,1,1,1, 52603
8,52606,1,1,0, 52607
24,52619,1,1,0, 52620
1,52626,1,1,1, 52627
31,52626,2,2,1, 52628
7,52632,1,1,1, 52633
8,52636,1,1,0, 52637
24,52649,1,1,0, 52650
1,52656,1,1,0, 52657
31,52656,2,2,1, 52658
7,52662,1,1,0, 52663
8,52666,1,1,0, 52667
17,52669,3,3,1, 52672
15,52671,2,2,1, 52673
24,52679,1,1,0, 52680
25,52685,2,2,1, 52687
7,52692,1,1,1, 52693
8,52696,1,1,1, 52697
9,52697,2,2,1, 52699
15,52701,2,2,1, 52703
24,52709,1,1,0, 52710
25,52715,2,2,1, 52717
31,52716,2,2,1, 52718
7,52722,1,1,0, 52723
8,52726,1,1,1, 52727
9,52727,2,2,1, 52729
24,52739,1,1,0, 52740
8,52756,1,1,0, 52757
9,52757,2,2,1, 52759
24,52769,1,1,1, 52770
25,52775,2,2,1, 52777
8,52786,1,1,0, 52787
24,52799,1,1,0, 52800
1,52806,1,1,0, 52807
8,52816,1,1,0, 52817
17,52819,3,3,1, 52822
2,52833,2,2,1, 52835
25,52835,2,2,1, 52837
1,52836,1,1,0, 52837
8,52846,1,1,0, 52847
16,52849,2,2,1, 52851
17,52849,3,3,1, 52852
2,52863,2,2,1, 52865
6,52870,2,2,1, 52872
7,52872,1,1,1, 52873
8,52876,1,1,0, 52877
15,52881,2,2,1, 52883
6,52900,2,2,1, 52902
7,52902,1,1,1, 52903
8,52906,1,1,0, 52907
24,52919,1,1,1, 52920
7,52932,1,1,0, 52933
24,52949,1,1,1, 52950
7,52962,1,1,1, 52963
24,52979,1,1,0, 52980
7,52992,1,1,1, 52993
24,53009,1,1,1, 53010
7,53022,1,1,1, 53023
8,53026,1,1,0, 53027
16,53029,2,2,1, 53031
24,53039,1,1,1, 53040
1,53046,1,1,1, 53047
31,53046,2,2,1, 53048
6,53050,2,2,1, 53052
7,53052,1,1,0, 53053
8,53056,1,1,1, 53057
24,53069,1,1,0, 53070
2,53073,2,2,1, 53075
1,53076,1,1,1, 53077
7,53082,1,1,1, 53083
8,53086,1,1,1, 53087
24,53099,1,1,0, 53100
2,53103,2,2,1, 53105
1,53106,1,1,0, 53107
6,53110,2,2,1, 53112
7,53112,1,1,1, 53113
8,53116,1,1,0, 53117
15,53121,2,2,1, 53123
24,53129,1,1,1, 53130
1,53136,1,1,1, 53137
7,53142,1,1,1, 53143
8,53146,1,1,0, 53147
9,53147,2,2,1, 53149
17,53149,3,3,1, 53152
24,53159,1,1,0, 53160
26,53167,3,3,1, 53170
8,53176,1,1,0, 53177
24,53189,1,1,1, 53190
25,53195,2,2,1, 53197
31,53196,2,2,1, 53198
26,53197,3,3,1, 53200
8,53206,1,1,1, 53207
9,53207,2,2,1, 53209
16,53209,2,2,1, 53211
24,53219,1,1,1, 53220
25,53225,2,2,1, 53227
31,53226,2,2,1, 53228
26,53227,3,3,1, 53230
8,53236,1,1,1, 53237
24,53249,1,1,1, 53250
25,53255,2,2,1, 53257
26,53257,3,3,1, 53260
8,53266,1,1,1, 53267
9,53267,2,2,1, 53269
16,53269,2,2,1, 53271
17,53269,3,3,1, 53272
24,53279,1,1,0, 53280
1,53286,1,1,1, 53287
6,53290,2,2,1, 53292
7,53292,1,1,0, 53293
2,53313,2,2,1, 53315
1,53316,1,1,1, 53317
7,53322,1,1,0, 53323
2,53343,2,2,1, 53345
1,53346,1,1,0, 53347
7,53352,1,1,1, 53353
2,53373,2,2,1, 53375
1,53376,1,1,1, 53377
7,53382,1,1,0, 53383
15,53391,2,2,1, 53393
24,53399,1,1,0, 53400
1,53406,1,1,1, 53407
7,53412,1,1,0, 53413
8,53416,1,1,1, 53417
9,53417,2,2,1, 53419
24,53429,1,1,0, 53430
25,53435,2,2,1, 53437
1,53436,1,1,0, 53437
31,53436,2,2,1, 53438
26,53437,3,3,1, 53440
7,53442,1,1,1, 53443
8,53446,1,1,1, 53447
9,53447,2,2,1, 53449
24,53459,1,1,1, 53460
25,53465,2,2,1, 53467
1,53466,1,1,0, 53467
7,53472,1,1,1, 53473
8,53476,1,1,0, 53477
24,53489,1,1,0, 53490
25,53495,2,2,1, 53497
1,53496,1,1,1, 53497
6,53500,2,2,1, 53502
7,53502,1,1,1, 53503
8,53506,1,1,1, 53507
17,53509,3,3,1, 53512
24,53519,1,1,1, 53520
23,53518,3,3,1, 53521
1,53526,1,1,0, 53527
7,53532,1,1,0, 53533
8,53536,1,1,0, 53537
15,53541,2,2,1, 53543
1,53556,1,1,0, 53557
7,53562,1,1,1, 53563
8,53566,1,1,0, 53567
17,53569,3,3,1, 53572
15,53571,2,2,1, 53573
1,53586,1,1,0, 53587
7,53592,1,1,1, 53593
8,53596,1,1,1, 53597
2,53613,2,2,1, 53615
1,53616,1,1,1, 53617
31,53616,2,2,1, 53618
7,53622,1,1,1, 53623
8,53626,1,1,0, 53627
9,53627,2,2,1, 53629
24,53639,1,1,1, 53640
31,53646,2,2,1, 53648
7,53652,1,1,0, 53653
8,53656,1,1,0, 53657
24,53669,1,1,1, 53670
31,53676,2,2,1, 53678
6,53680,2,2,1, 53682
7,53682,1,1,0, 53683
8,53686,1,1,0, 53687
15,53691,2,2,1, 53693
24,53699,1,1,0, 53700
6,53710,2,2,1, 53712
7,53712,1,1,1, 53713
8,53716,1,1,1, 53717
15,53721,2,2,1, 53723
24,53729,1,1,0, 53730
7,53742,1,1,1, 53743
8,53746,1,1,0, 53747
16,53749,2,2,1, 53751
15,53751,2,2,1, 53753
24,53759,1,1,0, 53760
7,53772,1,1,1, 53773
24,53789,1,1,0, 53790
7,53802,1,1,0, 53803
24,53819,1,1,1, 53820
6,53830,2,2,1, 53832
7,53832,1,1,1, 53833
24,53849,1,1,0, 53850
6,53860,2,2,1, 53862
7,53862,1,1,0, 53863
8,53866,1,1,1, 53867
24,53879,1,1,1, 53880
25,53885,2,2,1, 53887
1,53886,1,1,1, 53887
7,53892,1,1,1, 53893
8,53896,1,1,0, 53897
15,53901,2,2,1, 53903
24,53909,1,1,0, 53910
1,53916,1,1,1, 53917
7,53922,1,1,1, 53923
8,53926,1,1,0, 53927
9,53927,2,2,1, 53929
24,53939,1,1,0, 53940
1,53946,1,1,1, 53947
31,53946,2,2,1, 53948
7,53952,1,1,1, 53953
8,53956,1,1,0, 53957
15,53961,2,2,1, 53963
24,53969,1,1,1, 53970
1,53976,1,1,0, 53977
31,53976,2,2,1, 53978
7,53982,1,1,1, 53983
8,53986,1,1,0, 53987
16,53989,2,2,1, 53991
24,53999,1,1,1, 54000
23,53998,3,3,1, 54001
1,54006,1,1,0, 54007
31,54006,2,2,1, 54008
8,54016,1,1,1, 54017
9,54017,2,2,1, 54019
24,54029,1,1,1, 54030
1,54036,1,1,1, 54037
8,54046,1,1,0, 54047
24,54059,1,1,0, 54060
2,54063,2,2,1, 54065
1,54066,1,1,1, 54067
8,54076,1,1,1, 54077
24,54089,1,1,1, 54090
2,54093,2,2,1, 54095
1,54096,1,1,0, 54097
31,54096,2,2,1, 54098
8,54106,1,1,1, 54107
16,54109,2,2,1, 54111
17,54109,3,3,1, 54112
24,54119,1,1,1, 54120
23,54118,3,3,1, 54121
1,54126,1,1,0, 54127
7,54132,1,1,0, 54133
8,54136,1,1,0, 54137
1,54156,1,1,1, 54157
7,54162,1,1,0, 54163
8,54166,1,1,1, 54167
15,54171,2,2,1, 54173
1,54186,1,1,1, 54187
31,54186,2,2,1, 54188
7,54192,1,1,0, 54193
8,54196,1,1,0, 54197
1,54216,1,1,0, 54217
31,54216,2,2,1, 54218
7,54222,1,1,0, 54223
8,54226,1,1,0, 54227
17,54229,3,3,1, 54232
24,54239,1,1,0, 54240
2,54243,2,2,1, 54245
1,54246,1,1,1, 54247
6,54250,2,2,1, 54252
7,54252,1,1,0, 54253
8,54256,1,1,1, 54257
24,54269,1,1,1, 54270
1,54276,1,1,0, 54277
31,54276,2,2,1, 54278
7,54282,1,1,1, 54283
8,54286,1,1,0, 54287
15,54291,2,2,1, 54293
24,54299,1,1,1, 54300
2,54303,2,2,1, 54305
1,54306,1,1,1, 54307
7,54312,1,1,1, 54313
8,54316,1,1,0, 54317
15,54321,2,2,1, 54323
24,54329,1,1,0, 54330
1,54336,1,1,0, 54337
7,54342,1,1,0, 54343
8,54346,1,1,1, 54347
16,54349,2,2,1, 54351
15,54351,2,2,1, 54353
24,54359,1,1,1, 54360
23,54358,3,3,1, 54361
24,54389,1,1,1, 54390
24,54419,1,1,0, 54420
24,54449,1,1,1, 54450
8,54466,1,1,1, 54467
24,54479,1,1,1, 54480
2,54483,2,2,1, 54485
1,54486,1,1,0, 54487
7,54492,1,1,0, 54493
8,54496,1,1,0, 54497
15,54501,2,2,1, 54503
24,54509,1,1,0, 54510
7,54522,1,1,1, 54523
8,54526,1,1,0, 54527
17,54529,3,3,1, 54532
24,54539,1,1,1, 54540
7,54552,1,1,0, 54553
8,54556,1,1,0, 54557
24,54569,1,1,0, 54570
31,54576,2,2,1, 54578
6,54580,2,2,1, 54582
7,54582,1,1,0, 54583
8,54586,1,1,0, 54587
15,54591,2,2,1, 54593
24,54599,1,1,1, 54600
2,54603,2,2,1, 54605
1,54606,1,1,0, 54607
8,54616,1,1,1, 54617
2,54633,2,2,1, 54635
1,54636,1,1,1, 54637
8,54646,1,1,1, 54647
1,54666,1,1,1, 54667
8,54676,1,1,0, 54677
1,54696,1,1,1, 54697
8,54706,1,1,1, 54707
24,54719,1,1,1, 54720
23,54718,3,3,1, 54721
31,54726,2,2,1, 54728
7,54732,1,1,0, 54733
24,54749,1,1,0, 54750
6,54760,2,2,1, 54762
7,54762,1,1,0, 54763
15,54771,2,2,1, 54773
24,54779,1,1,0, 54780
31,54786,2,2,1, 54788
7,54792,1,1,0, 54793
24,54809,1,1,0, 54810
31,54816,2,2,1, 54818
7,54822,1,1,0, 54823
8,54826,1,1,0, 54827
24,54839,1,1,0, 54840
2,54843,2,2,1, 54845
25,54845,2,2,1, 54847
1,54846,1,1,1, 54847
31,54846,2,2,1, 54848
6,54850,2,2,1, 54852
7,54852,1,1,1, 54853
8,54856,1,1,0, 54857
9,54857,2,2,1, 54859
24,54869,1,1,1, 54870
2,54873,2,2,1, 54875
25,54875,2,2,1, 54877
1,54876,1,1,1, 54877
6,54880,2,2,1, 54882
7,54882,1,1,1, 54883
8,54886,1,1,0, 54887
24,54899,1,1,0, 54900
2,54903,2,2,1, 54905
1,54906,1,1,0, 54907
8,54916,1,1,1, 54917
15,54921,2,2,1, 54923
24,54929,1,1,1, 54930
25,54935,2,2,1, 54937
1,54936,1,1,0, 54937
31,54936,2,2,1, 54938
8,54946,1,1,1, 54947
24,54959,1,1,0, 54960
23,54958,3,3,1, 54961
8,54976,1,1,0, 54977
9,54977,2,2,1, 54979
17,54979,3,3,1, 54982
15,54981,2,2,1, 54983
8,55006,1,1,1, 55007
9,55007,2,2,1, 55009
6,55030,2,2,1, 55032
7,55032,1,1,0, 55033
8,55036,1,1,1, 55037
31,55056,2,2,1, 55058
7,55062,1,1,0, 55063
8,55066,1,1,1, 55067
24,55079,1,1,0, 55080
2,55083,2,2,1, 55085
1,55086,1,1,1, 55087
7,55092,1,1,1, 55093
8,55096,1,1,0, 55097
24,55109,1,1,0, 55110
1,55116,1,1,1, 55117
31,55116,2,2,1, 55118
6,55120,2,2,1, 55122
7,55122,1,1,1, 55123
8,55126,1,1,0, 55127
9,55127,2,2,1, 55129
24,55139,1,1,1, 55140
2,55143,2,2,1, 55145
1,55146,1,1,0, 55147
8,55156,1,1,0, 55157
15,55161,2,2,1, 55163
24,55169,1,1,1, 55170
1,55176,1,1,0, 55177
8,55186,1,1,0, 55187
17,55189,3,3,1, 55192
15,55191,2,2,1, 55193
24,55199,1,1,0, 55200
8,55216,1,1,1, 55217
15,55221,2,2,1, 55223
24,55229,1,1,1, 55230
8,55246,1,1,0, 55247
15,55251,2,2,1, 55253
24,55259,1,1,0, 55260
1,55266,1,1,1, 55267
7,55272,1,1,0, 55273
8,55276,1,1,1, 55277
24,55289,1,1,1, 55290
2,55293,2,2,1, 55295
1,55296,1,1,1, 55297
7,55302,1,1,1, 55303
8,55306,1,1,0, 55307
24,55319,1,1,0, 55320
2,55323,2,2,1, 55325
1,55326,1,1,1, 55327
7,55332,1,1,0, 55333
24,55349,1,1,0, 55350
1,55356,1,1,0, 55357
7,55362,1,1,1, 55363
16,55369,2,2,1, 55371
15,55371,2,2,1, 55373
24,55379,1,1,0, 55380
2,55383,2,2,1, 55385
1,55386,1,1,0, 55387
31,55386,2,2,1, 55388
6,55390,2,2,1, 55392
7,55392,1,1,0, 55393
16,55399,2,2,1, 55401
17,55399,3,3,1, 55402
24,55409,1,1,1, 55410
25,55415,2,2,1, 55417
1,55416,1,1,0, 55417
6,55420,2,2,1, 55422
7,55422,1,1,0, 55423
8,55426,1,1,0, 55427
24,55439,1,1,1, 55440
25,55445,2,2,1, 55447
1,55446,1,1,0, 55447
31,55446,2,2,1, 55448
8,55456,1,1,1, 55457
9,55457,2,2,1, 55459
8,55486,1,1,0, 55487
15,55491,2,2,1, 55493
2,55503,2,2,1, 55505
1,55506,1,1,1, 55507
26,55507,3,3,1, 55510
8,55516,1,1,0, 55517
15,55521,2,2,1, 55523
2,55533,2,2,1, 55535
1,55536,1,1,0, 55537
26,55537,3,3,1, 55540
8,55546,1,1,1, 55547
24,55559,1,1,0, 55560
23,55558,3,3,1, 55561
2,55563,2,2,1, 55565
1,55566,1,1,0, 55567
6,55570,2,2,1, 55572
7,55572,1,1,0, 55573
8,55576,1,1,0, 55577
24,55589,1,1,1, 55590
1,55596,1,1,1, 55597
6,55600,2,2,1, 55602
7,55602,1,1,1, 55603
8,55606,1,1,1, 55607
9,55607,2,2,1, 55609
15,55611,2,2,1, 55613
24,55619,1,1,0, 55620
1,55626,1,1,0, 55627
7,55632,1,1,1, 55633
8,55636,1,1,1, 55637
24,55649,1,1,0, 55650
7,55662,1,1,0, 55663
8,55666,1,1,0, 55667
15,55671,2,2,1, 55673
24,55679,1,1,1, 55680
1,55686,1,1,0, 55687
8,55696,1,1,0, 55697
24,55709,1,1,1, 55710
25,55715,2,2,1, 55717
1,55716,1,1,1, 55717
8,55726,1,1,1, 55727
24,55739,1,1,1, 55740
8,55756,1,1,1, 55757
9,55757,2,2,1, 55759
24,55769,1,1,0, 55770
31,55776,2,2,1, 55778
8,55786,1,1,0, 55787
24,55799,1,1,1, 55800
23,55798,3,3,1, 55801
6,55810,2,2,1, 55812
7,55812,1,1,0, 55813
8,55816,1,1,0, 55817
24,55829,1,1,1, 55830
7,55842,1,1,0, 55843
8,55846,1,1,0, 55847
15,55851,2,2,1, 55853
24,55859,1,1,0, 55860
1,55866,1,1,1, 55867
6,55870,2,2,1, 55872
7,55872,1,1,1, 55873
8,55876,1,1,0, 55877
24,55889,1,1,1, 55890
1,55896,1,1,0, 55897
7,55902,1,1,0, 55903
8,55906,1,1,1, 55907
17,55909,3,3,1, 55912
15,55911,2,2,1, 55913
24,55919,1,1,0, 55920
23,55918,3,3,1, 55921
2,55923,2,2,1, 55925
1,55926,1,1,1, 55927
6,55930,2,2,1, 55932
7,55932,1,1,1, 55933
8,55936,1,1,1, 55937
24,55949,1,1,0, 55950
1,55956,1,1,1, 55957
7,55962,1,1,0, 55963
8,55966,1,1,1, 55967
15,55971,2,2,1, 55973
24,55979,1,1,0, 55980
1,55986,1,1,0, 55987
8,55996,1,1,0, 55997
24,56009,1,1,1, 56010
1,56016,1,1,1, 56017
31,56016,2,2,1, 56018
8,56026,1,1,0, 56027
9,56027,2,2,1, 56029
15,56031,2,2,1, 56033
24,56039,1,1,0, 56040
1,56046,1,1,0, 56047
9,56057,2,2,1, 56059
24,56069,1,1,0, 56070
1,56076,1,1,0, 56077
31,56076,2,2,1, 56078
24,56099,1,1,1, 56100
23,56098,3,3,1, 56101
7,56112,1,1,1, 56113
31,56136,2,2,1, 56138
6,56140,2,2,1, 56142
7,56142,1,1,1, 56143
8,56146,1,1,1, 56147
31,56166,2,2,1, 56168
7,56172,1,1,1, 56173
8,56176,1,1,0, 56177
24,56189,1,1,0, 56190
31,56196,2,2,1, 56198
7,56202,1,1,1, 56203
8,56206,1,1,1, 56207
16,56209,2,2,1, 56211
24,56219,1,1,0, 56220
23,56218,3,3,1, 56221
2,56223,2,2,1, 56225
1,56226,1,1,0, 56227
8,56236,1,1,1, 56237
15,56241,2,2,1, 56243
1,56256,1,1,1, 56257
8,56266,1,1,0, 56267
1,56286,1,1,1, 56287
8,56296,1,1,1, 56297
1,56316,1,1,1, 56317
8,56326,1,1,0, 56327
9,56327,2,2,1, 56329
17,56329,3,3,1, 56332
15,56331,2,2,1, 56333
24,56339,1,1,0, 56340
7,56352,1,1,0, 56353
8,56356,1,1,1, 56357
9,56357,2,2,1, 56359
24,56369,1,1,1, 56370
6,56380,2,2,1, 56382
7,56382,1,1,1, 56383
8,56386,1,1,0, 56387
9,56387,2,2,1, 56389
24,56399,1,1,0, 56400
6,56410,2,2,1, 56412
7,56412,1,1,1, 56413
8,56416,1,1,1, 56417
24,56429,1,1,0, 56430
7,56442,1,1,0, 56443
8,56446,1,1,1, 56447
17,56449,3,3,1, 56452
15,56451,2,2,1, 56453
24,56459,1,1,1, 56460
1,56466,1,1,1, 56467
31,56466,2,2,1, 56468
6,56470,2,2,1, 56472
7,56472,1,1,1, 56473
8,56476,1,1,1, 56477
24,56489,1,1,1, 56490
1,56496,1,1,0, 56497
31,56496,2,2,1, 56498
6,56500,2,2,1, 56502
7,56502,1,1,0, 56503
8,56506,1,1,1, 56507
24,56519,1,1,0, 56520
2,56523,2,2,1, 56525
1,56526,1,1,0, 56527
31,56526,2,2,1, 56528
8,56536,1,1,0, 56537
24,56549,1,1,1, 56550
2,56553,2,2,1, 56555
1,56556,1,1,1, 56557
8,56566,1,1,1, 56567
16,56569,2,2,1, 56571
17,56569,3,3,1, 56572
24,56579,1,1,0, 56580
23,56578,3,3,1, 56581
1,56586,1,1,0, 56587
31,56586,2,2,1, 56588
8,56596,1,1,0, 56597
24,56609,1,1,0, 56610
2,56613,2,2,1, 56615
1,56616,1,1,1, 56617
8,56626,1,1,0, 56627
24,56639,1,1,1, 56640
2,56643,2,2,1, 56645
31,56646,2,2,1, 56648
6,56650,2,2,1, 56652
7,56652,1,1,1, 56653
8,56656,1,1,1, 56657
24,56669,1,1,0, 56670
31,56676,2,2,1, 56678
7,56682,1,1,1, 56683
8,56686,1,1,0, 56687
16,56689,2,2,1, 56691
24,56699,1,1,1, 56700
7,56712,1,1,1, 56713
8,56716,1,1,0, 56717
16,56719,2,2,1, 56721
31,56736,2,2,1, 56738
7,56742,1,1,1, 56743
8,56746,1,1,0, 56747
16,56749,2,2,1, 56751
31,56766,2,2,1, 56768
7,56772,1,1,1, 56773
8,56776,1,1,0, 56777
15,56781,2,2,1, 56783
6,56800,2,2,1, 56802
7,56802,1,1,0, 56803
8,56806,1,1,1, 56807
16,56809,2,2,1, 56811
24,56819,1,1,1, 56820
1,56826,1,1,0, 56827
31,56826,2,2,1, 56828
9,56837,2,2,1, 56839
24,56849,1,1,0, 56850
1,56856,1,1,0, 56857
31,56856,2,2,1, 56858
9,56867,2,2,1, 56869
24,56879,1,1,1, 56880
1,56886,1,1,0, 56887
16,56899,2,2,1, 56901
17,56899,3,3,1, 56902
24,56909,1,1,0, 56910
2,56913,2,2,1, 56915
1,56916,1,1,0, 56917
8,56926,1,1,0, 56927
16,56929,2,2,1, 56931
17,56929,3,3,1, 56932
15,56931,2,2,1, 56933
24,56939,1,1,0, 56940
23,56938,3,3,1, 56941
1,56946,1,1,1, 56947
6,56950,2,2,1, 56952
7,56952,1,1,0, 56953
8,56956,1,1,0, 56957
9,56957,2,2,1, 56959
17,56959,3,3,1, 56962
24,56969,1,1,1, 56970
2,56973,2,2,1, 56975
1,56976,1,1,0, 56977
6,56980,2,2,1, 56982
7,56982,1,1,1, 56983
8,56986,1,1,0, 56987
15,56991,2,2,1, 56993
24,56999,1,1,0, 57000
7,57012,1,1,0, 57013
8,57016,1,1,1, 57017
9,57017,2,2,1, 57019
24,57029,1,1,0, 57030
6,57040,2,2,1, 57042
7,57042,1,1,0, 57043
8,57046,1,1,0, 57047
16,57049,2,2,1, 57051
17,57049,3,3,1, 57052
24,57059,1,1,1, 57060
31,57066,2,2,1, 57068
7,57072,1,1,0, 57073
8,57076,1,1,1, 57077
24,57089,1,1,0, 57090
6,57100,2,2,1, 57102
7,57102,1,1,0, 57103
8,57106,1,1,0, 57107
24,57119,1,1,0, 57120
2,57123,2,2,1, 57125
25,57125,2,2,1, 57127
1,57126,1,1,0, 57127
31,57126,2,2,1, 57128
6,57130,2,2,1, 57132
7,57132,1,1,0, 57133
8,57136,1,1,0, 57137
15,57141,2,2,1, 57143
25,57155,2,2,1, 57157
1,57156,1,1,0, 57157
26,57157,3,3,1, 57160
7,57162,1,1,0, 57163
8,57166,1,1,0, 57167
17,57169,3,3,1, 57172
15,57171,2,2,1, 57173
31,57186,2,2,1, 57188
8,57196,1,1,1, 57197
9,57197,2,2,1, 57199
8,57226,1,1,0, 57227
9,57227,2,2,1, 57229
24,57239,1,1,0, 57240
8,57256,1,1,0, 57257
15,57261,2,2,1, 57263
24,57269,1,1,0, 57270
8,57286,1,1,1, 57287
16,57289,2,2,1, 57291
17,57289,3,3,1, 57292
15,57291,2,2,1, 57293
24,57299,1,1,0, 57300
1,57306,1,1,0, 57307
31,57306,2,2,1, 57308
6,57310,2,2,1, 57312
7,57312,1,1,0, 57313
24,57329,1,1,0, 57330
2,57333,2,2,1, 57335
1,57336,1,1,0, 57337
6,57340,2,2,1, 57342
7,57342,1,1,1, 57343
24,57359,1,1,1, 57360
1,57366,1,1,1, 57367
7,57372,1,1,0, 57373
24,57389,1,1,1, 57390
2,57393,2,2,1, 57395
25,57395,2,2,1, 57397
1,57396,1,1,0, 57397
31,57396,2,2,1, 57398
6,57400,2,2,1, 57402
7,57402,1,1,0, 57403
8,57406,1,1,1, 57407
15,57411,2,2,1, 57413
24,57419,1,1,1, 57420
8,57436,1,1,0, 57437
24,57449,1,1,1, 57450
8,57466,1,1,0, 57467
9,57467,2,2,1, 57469
24,57479,1,1,0, 57480
8,57496,1,1,0, 57497
24,57509,1,1,1, 57510
8,57526,1,1,0, 57527
9,57527,2,2,1, 57529
16,57529,2,2,1, 57531
15,57531,2,2,1, 57533
24,57539,1,1,0, 57540
23,57538,3,3,1, 57541
2,57543,2,2,1, 57545
1,57546,1,1,0, 57547
31,57546,2,2,1, 57548
6,57550,2,2,1, 57552
7,57552,1,1,1, 57553
15,57561,2,2,1, 57563
24,57569,1,1,0, 57570
2,57573,2,2,1, 57575
1,57576,1,1,0, 57577
7,57582,1,1,0, 57583
24,57599,1,1,1, 57600
1,57606,1,1,1, 57607
31,57606,2,2,1, 57608
7,57612,1,1,1, 57613
15,57621,2,2,1, 57623
24,57629,1,1,1, 57630
1,57636,1,1,0, 57637
6,57640,2,2,1, 57642
7,57642,1,1,1, 57643
9,57647,2,2,1, 57649
15,57651,2,2,1, 57653
24,57659,1,1,0, 57660
8,57676,1,1,1, 57677
8,57706,1,1,1, 57707
9,57707,2,2,1, 57709
8,57736,1,1,0, 57737
9,57737,2,2,1, 57739
8,57766,1,1,1, 57767
16,57769,2,2,1, 57771
24,57779,1,1,0, 57780
23,57778,3,3,1, 57781
2,57783,2,2,1, 57785
1,57786,1,1,0, 57787
31,57786,2,2,1, 57788
6,57790,2,2,1, 57792
7,57792,1,1,0, 57793
8,57796,1,1,1, 57797
15,57801,2,2,1, 57803
24,57809,1,1,1, 57810
2,57813,2,2,1, 57815
1,57816,1,1,0, 57817
31,57816,2,2,1, 57818
7,57822,1,1,0, 57823
8,57826,1,1,0, 57827
24,57839,1,1,1, 57840
1,57846,1,1,0, 57847
31,57846,2,2,1, 57848
8,57856,1,1,0, 57857
24,57869,1,1,1, 57870
1,57876,1,1,1, 57877
8,57886,1,1,1, 57887
24,57899,1,1,0, 57900
23,57898,3,3,1, 57901
8,57916,1,1,1, 57917
9,57917,2,2,1, 57919
24,57929,1,1,1, 57930
8,57946,1,1,1, 57947
9,57947,2,2,1, 57949
15,57951,2,2,1, 57953
24,57959,1,1,0, 57960
31,57966,2,2,1, 57968
7,57972,1,1,0, 57973
8,57976,1,1,1, 57977
9,57977,2,2,1, 57979
24,57989,1,1,1, 57990
31,57996,2,2,1, 57998
6,58000,2,2,1, 58002
7,58002,1,1,0, 58003
8,58006,1,1,1, 58007
24,58019,1,1,0, 58020
23,58018,3,3,1, 58021
1,58026,1,1,0, 58027
6,58030,2,2,1, 58032
7,58032,1,1,1, 58033
15,58041,2,2,1, 58043
2,58053,2,2,1, 58055
1,58056,1,1,1, 58057
7,58062,1,1,0, 58063
15,58071,2,2,1, 58073
2,58083,2,2,1, 58085
1,58086,1,1,0, 58087
2,58113,2,2,1, 58115
1,58116,1,1,0, 58117
8,58126,1,1,1, 58127
15,58131,2,2,1, 58133
24,58139,1,1,0, 58140
8,58156,1,1,1, 58157
9,58157,2,2,1, 58159
24,58169,1,1,1, 58170
8,58186,1,1,0, 58187
24,58199,1,1,1, 58200
7,58212,1,1,1, 58213
8,58216,1,1,1, 58217
24,58229,1,1,1, 58230
7,58242,1,1,1, 58243
8,58246,1,1,1, 58247
24,58259,1,1,0, 58260
2,58263,2,2,1, 58265
1,58266,1,1,1, 58267
6,58270,2,2,1, 58272
7,58272,1,1,1, 58273
8,58276,1,1,1, 58277
24,58289,1,1,0, 58290
2,58293,2,2,1, 58295
1,58296,1,1,0, 58297
6,58300,2,2,1, 58302
7,58302,1,1,0, 58303
8,58306,1,1,0, 58307
9,58307,2,2,1, 58309
16,58309,2,2,1, 58311
24,58319,1,1,0, 58320
1,58326,1,1,0, 58327
6,58330,2,2,1, 58332
7,58332,1,1,0, 58333
9,58337,2,2,1, 58339
24,58349,1,1,0, 58350
2,58353,2,2,1, 58355
1,58356,1,1,1, 58357
6,58360,2,2,1, 58362
7,58362,1,1,0, 58363
24,58379,1,1,1, 58380
6,58390,2,2,1, 58392
7,58392,1,1,1, 58393
24,58409,1,1,1, 58410
23,58408,3,3,1, 58411
25,58415,2,2,1, 58417
6,58420,2,2,1, 58422
7,58422,1,1,0, 58423
8,58426,1,1,0, 58427
24,58439,1,1,1, 58440
8,58456,1,1,0, 58457
15,58461,2,2,1, 58463
24,58469,1,1,0, 58470
8,58486,1,1,1, 58487
17,58489,3,3,1, 58492
15,58491,2,2,1, 58493
24,58499,1,1,0, 58500
2,58503,2,2,1, 58505
1,58506,1,1,0, 58507
8,58516,1,1,1, 58517
9,58517,2,2,1, 58519
15,58521,2,2,1, 58523
24,58529,1,1,0, 58530
2,58533,2,2,1, 58535
1,58536,1,1,1, 58537
8,58546,1,1,1, 58547
24,58559,1,1,0, 58560
1,58566,1,1,0, 58567
31,58566,2,2,1, 58568
7,58572,1,1,0, 58573
8,58576,1,1,1, 58577
24,58589,1,1,0, 58590
1,58596,1,1,0, 58597
6,58600,2,2,1, 58602
7,58602,1,1,1, 58603
8,58606,1,1,1, 58607
17,58609,3,3,1, 58612
24,58619,1,1,0, 58620
23,58618,3,3,1, 58621
31,58626,2,2,1, 58628
6,58630,2,2,1, 58632
7,58632,1,1,0, 58633
8,58636,1,1,0, 58637
7,58662,1,1,1, 58663
8,58666,1,1,0, 58667
15,58671,2,2,1, 58673
31,58686,2,2,1, 58688
7,58692,1,1,1, 58693
8,58696,1,1,1, 58697
9,58697,2,2,1, 58699
15,58701,2,2,1, 58703
31,58716,2,2,1, 58718
6,58720,2,2,1, 58722
7,58722,1,1,0, 58723
8,58726,1,1,1, 58727
17,58729,3,3,1, 58732
15,58731,2,2,1, 58733
24,58739,1,1,1, 58740
31,58746,2,2,1, 58748
8,58756,1,1,1, 58757
15,58761,2,2,1, 58763
24,58769,1,1,1, 58770
25,58775,2,2,1, 58777
31,58776,2,2,1, 58778
26,58777,3,3,1, 58780
8,58786,1,1,0, 58787
15,58791,2,2,1, 58793
24,58799,1,1,1, 58800
1,58806,1,1,1, 58807
31,58806,2,2,1, 58808
8,58816,1,1,1, 58817
24,58829,1,1,1, 58830
2,58833,2,2,1, 58835
1,58836,1,1,0, 58837
8,58846,1,1,1, 58847
16,58849,2,2,1, 58851
24,58859,1,1,1, 58860
23,58858,3,3,1, 58861
1,58866,1,1,0, 58867
31,58866,2,2,1, 58868
7,58872,1,1,1, 58873
24,58889,1,1,1, 58890
1,58896,1,1,1, 58897
31,58896,2,2,1, 58898
6,58900,2,2,1, 58902
7,58902,1,1,0, 58903
24,58919,1,1,0, 58920
25,58925,2,2,1, 58927
1,58926,1,1,0, 58927
6,58930,2,2,1, 58932
7,58932,1,1,0, 58933
24,58949,1,1,1, 58950
2,58953,2,2,1, 58955
1,58956,1,1,0, 58957
6,58960,2,2,1, 58962
7,58962,1,1,1, 58963
8,58966,1,1,1, 58967
24,58979,1,1,0, 58980
6,58990,2,2,1, 58992
7,58992,1,1,0, 58993
8,58996,1,1,1, 58997
16,58999,2,2,1, 59001
17,58999,3,3,1, 59002
15,59001,2,2,1, 59003
7,59022,1,1,0, 59023
8,59026,1,1,0, 59027
16,59029,2,2,1, 59031
17,59029,3,3,1, 59032
8,59056,1,1,1, 59057
8,59086,1,1,0, 59087
17,59089,3,3,1, 59092
24,59099,1,1,1, 59100
8,59116,1,1,0, 59117
9,59117,2,2,1, 59119
24,59129,1,1,1, 59130
8,59146,1,1,1, 59147
9,59147,2,2,1, 59149
24,59159,1,1,0, 59160
23,59158,3,3,1, 59161
7,59172,1,1,0, 59173
15,59181,2,2,1, 59183
24,59189,1,1,0, 59190
7,59202,1,1,1, 59203
24,59219,1,1,1, 59220
1,59226,1,1,1, 59227
6,59230,2,2,1, 59232
7,59232,1,1,0, 59233
16,59239,2,2,1, 59241
24,59249,1,1,0, 59250
2,59253,2,2,1, 59255
25,59255,2,2,1, 59257
1,59256,1,1,1, 59257
31,59256,2,2,1, 59258
7,59262,1,1,1, 59263
8,59266,1,1,1, 59267
17,59269,3,3,1, 59272
24,59279,1,1,0, 59280
1,59286,1,1,0, 59287
8,59296,1,1,1, 59297
9,59297,2,2,1, 59299
24,59309,1,1,1, 59310
1,59316,1,1,0, 59317
8,59326,1,1,0, 59327
9,59327,2,2,1, 59329
24,59339,1,1,1, 59340
1,59346,1,1,1, 59347
8,59356,1,1,1, 59357
9,59357,2,2,1, 59359
24,59369,1,1,1, 59370
1,59376,1,1,1, 59377
8,59386,1,1,1, 59387
9,59387,2,2,1, 59389
24,59399,1,1,0, 59400
23,59398,3,3,1, 59401
31,59406,2,2,1, 59408
7,59412,1,1,1, 59413
8,59416,1,1,0, 59417
24,59429,1,1,1, 59430
31,59436,2,2,1, 59438
6,59440,2,2,1, 59442
7,59442,1,1,1, 59443
8,59446,1,1,1, 59447
24,59459,1,1,0, 59460
31,59466,2,2,1, 59468
8,59476,1,1,1, 59477
15,59481,2,2,1, 59483
24,59489,1,1,1, 59490
31,59496,2,2,1, 59498
8,59506,1,1,1, 59507
24,59519,1,1,1, 59520
23,59518,3,3,1, 59521
8,59536,1,1,0, 59537
8,59566,1,1,0, 59567
6,59590,2,2,1, 59592
7,59592,1,1,1, 59593
8,59596,1,1,1, 59597
6,59620,2,2,1, 59622
7,59622,1,1,1, 59623
8,59626,1,1,1, 59627
24,59639,1,1,0, 59640
25,59645,2,2,1, 59647
1,59646,1,1,0, 59647
6,59650,2,2,1, 59652
7,59652,1,1,1, 59653
8,59656,1,1,1, 59657
16,59659,2,2,1, 59661
24,59669,1,1,1, 59670
23,59668,3,3,1, 59671
25,59675,2,2,1, 59677
1,59676,1,1,1, 59677
7,59682,1,1,0, 59683
8,59686,1,1,0, 59687
9,59687,2,2,1, 59689
24,59699,1,1,1, 59700
23,59698,3,3,1, 59701
6,59710,2,2,1, 59712
7,59712,1,1,1, 59713
8,59716,1,1,0, 59717
6,59740,2,2,1, 59742
7,59742,1,1,1, 59743
8,59746,1,1,0, 59747
15,59751,2,2,1, 59753
7,59772,1,1,0, 59773
8,59776,1,1,1, 59777
15,59781,2,2,1, 59783
6,59800,2,2,1, 59802
7,59802,1,1,0, 59803
8,59806,1,1,1, 59807
16,59809,2,2,1, 59811
24,59819,1,1,1, 59820
1,59826,1,1,0, 59827
31,59826,2,2,1, 59828
8,59836,1,1,1, 59837
24,59849,1,1,0, 59850
1,59856,1,1,0, 59857
8,59866,1,1,1, 59867
24,59879,1,1,1, 59880
1,59886,1,1,0, 59887
8,59896,1,1,0, 59897
24,59909,1,1,1, 59910
1,59916,1,1,1, 59917
8,59926,1,1,1, 59927
9,59927,2,2,1, 59929
24,59939,1,1,1, 59940
23,59938,3,3,1, 59941
2,59943,2,2,1, 59945
25,59945,2,2,1, 59947
1,59946,1,1,0, 59947
7,59952,1,1,0, 59953
8,59956,1,1,1, 59957
15,59961,2,2,1, 59963
24,59969,1,1,1, 59970
2,59973,2,2,1, 59975
1,59976,1,1,0, 59977
31,59976,2,2,1, 59978
6,59980,2,2,1, 59982
7,59982,1,1,0, 59983
8,59986,1,1,1, 59987
15,59991,2,2,1, 59993
24,59999,1,1,0, 60000
1,60006,1,1,0, 60007
8,60016,1,1,0, 60017
24,60029,1,1,0, 60030
1,60036,1,1,1, 60037
31,60036,2,2,1, 60038
8,60046,1,1,0, 60047
9,60047,2,2,1, 60049
16,60049,2,2,1, 60051
24,60059,1,1,0, 60060
23,60058,3,3,1, 60061
2,60063,2,2,1, 60065
1,60066,1,1,1, 60067
8,60076,1,1,1, 60077
24,60089,1,1,1, 60090
1,60096,1,1,0, 60097
8,60106,1,1,0, 60107
9,60107,2,2,1, 60109
15,60111,2,2,1, 60113
24,60119,1,1,1, 60120
6,60130,2,2,1, 60132
7,60132,1,1,0, 60133
8,60136,1,1,1, 60137
15,60141,2,2,1, 60143
6,60160,2,2,1, 60162
7,60162,1,1,1, 60163
8,60166,1,1,0, 60167
6,60190,2,2,1, 60192
7,60192,1,1,1, 60193
8,60196,1,1,0, 60197
7,60222,1,1,0, 60223
8,60226,1,1,1, 60227
15,60231,2,2,1, 60233
24,60239,1,1,0, 60240
1,60246,1,1,1, 60247
7,60252,1,1,0, 60253
8,60256,1,1,0, 60257
9,60257,2,2,1, 60259
24,60269,1,1,0, 60270
1,60276,1,1,0, 60277
31,60276,2,2,1, 60278
7,60282,1,1,0, 60283
8,60286,1,1,0, 60287
9,60287,2,2,1, 60289
24,60299,1,1,1, 60300
1,60306,1,1,1, 60307
6,60310,2,2,1, 60312
7,60312,1,1,1, 60313
8,60316,1,1,0, 60317
24,60329,1,1,1, 60330
25,60335,2,2,1, 60337
1,60336,1,1,0, 60337
7,60342,1,1,1, 60343
8,60346,1,1,0, 60347
16,60349,2,2,1, 60351
17,60349,3,3,1, 60352
15,60351,2,2,1, 60353
24,60359,1,1,0, 60360
23,60358,3,3,1, 60361
24,60389,1,1,1, 60390
24,60419,1,1,0, 60420
24,60449,1,1,1, 60450
8,60466,1,1,0, 60467
16,60469,2,2,1, 60471
15,60471,2,2,1, 60473
24,60479,1,1,1, 60480
2,60483,2,2,1, 60485
25,60485,2,2,1, 60487
1,60486,1,1,1, 60487
7,60492,1,1,0, 60493
8,60496,1,1,1, 60497
24,60509,1,1,1, 60510
1,60516,1,1,1, 60517
7,60522,1,1,0, 60523
8,60526,1,1,1, 60527
9,60527,2,2,1, 60529
16,60529,2,2,1, 60531
24,60539,1,1,1, 60540
25,60545,2,2,1, 60547
6,60550,2,2,1, 60552
7,60552,1,1,0, 60553
8,60556,1,1,0, 60557
24,60569,1,1,0, 60570
6,60580,2,2,1, 60582
7,60582,1,1,0, 60583
8,60586,1,1,1, 60587
9,60587,2,2,1, 60589
24,60599,1,1,1, 60600
7,60612,1,1,0, 60613
31,60636,2,2,1, 60638
6,60640,2,2,1, 60642
7,60642,1,1,1, 60643
15,60651,2,2,1, 60653
1,60666,1,1,0, 60667
31,60666,2,2,1, 60668
6,60670,2,2,1, 60672
7,60672,1,1,0, 60673
9,60677,2,2,1, 60679
1,60696,1,1,1, 60697
31,60696,2,2,1, 60698
7,60702,1,1,0, 60703
8,60706,1,1,0, 60707
9,60707,2,2,1, 60709
1,60726,1,1,1, 60727
6,60730,2,2,1, 60732
7,60732,1,1,1, 60733
8,60736,1,1,0, 60737
9,60737,2,2,1, 60739
1,60756,1,1,1, 60757
6,60760,2,2,1, 60762
7,60762,1,1,0, 60763
8,60766,1,1,1, 60767
15,60771,2,2,1, 60773
2,60783,2,2,1, 60785
1,60786,1,1,0, 60787
8,60796,1,1,0, 60797
15,60801,2,2,1, 60803
2,60813,2,2,1, 60815
25,60815,2,2,1, 60817
1,60816,1,1,0, 60817
8,60826,1,1,1, 60827
15,60831,2,2,1, 60833
1,60846,1,1,0, 60847
8,60856,1,1,1, 60857
17,60859,3,3,1, 60862
25,60875,2,2,1, 60877
1,60876,1,1,0, 60877
8,60886,1,1,0, 60887
16,60889,2,2,1, 60891
17,60889,3,3,1, 60892
15,60891,2,2,1, 60893
6,60910,2,2,1, 60912
7,60912,1,1,0, 60913
8,60916,1,1,0, 60917
15,60921,2,2,1, 60923
6,60940,2,2,1, 60942
7,60942,1,1,1, 60943
8,60946,1,1,0, 60947
9,60947,2,2,1, 60949
15,60951,2,2,1, 60953
25,61025,2,2,1, 61027
1,61026,1,1,0, 61027
9,61037,2,2,1, 61039
1,61056,1,1,1, 61057
8,61066,1,1,1, 61067
16,61069,2,2,1, 61071
25,61085,2,2,1, 61087
1,61086,1,1,1, 61087
31,61086,2,2,1, 61088
6,61090,2,2,1, 61092
7,61092,1,1,0, 61093
8,61096,1,1,1, 61097
1,61116,1,1,0, 61117
31,61116,2,2,1, 61118
6,61120,2,2,1, 61122
7,61122,1,1,1, 61123
8,61126,1,1,1, 61127
15,61131,2,2,1, 61133
2,61143,2,2,1, 61145
1,61146,1,1,0, 61147
8,61156,1,1,0, 61157
17,61159,3,3,1, 61162
1,61176,1,1,1, 61177
8,61186,1,1,0, 61187
1,61206,1,1,0, 61207
8,61216,1,1,1, 61217
9,61217,2,2,1, 61219
1,61236,1,1,0, 61237
8,61246,1,1,1, 61247
9,61247,2,2,1, 61249
2,61263,2,2,1, 61265
7,61272,1,1,1, 61273
7,61302,1,1,0, 61303
7,61332,1,1,0, 61333
7,61362,1,1,1, 61363
8,61366,1,1,0, 61367
16,61369,2,2,1, 61371
2,61383,2,2,1, 61385
25,61385,2,2,1, 61387
1,61386,1,1,1, 61387
7,61392,1,1,0, 61393
8,61396,1,1,0, 61397
16,61399,2,2,1, 61401
15,61401,2,2,1, 61403
25,61415,2,2,1, 61417
1,61416,1,1,1, 61417
7,61422,1,1,1, 61423
8,61426,1,1,0, 61427
16,61429,2,2,1, 61431
6,61450,2,2,1, 61452
7,61452,1,1,1, 61453
15,61461,2,2,1, 61463
7,61482,1,1,0, 61483
15,61491,2,2,1, 61493
6,61510,2,2,1, 61512
7,61512,1,1,0, 61513
7,61542,1,1,1, 61543
8,61546,1,1,0, 61547
15,61551,2,2,1, 61553
2,61563,2,2,1, 61565
25,61565,2,2,1, 61567
1,61566,1,1,1, 61567
7,61572,1,1,0, 61573
8,61576,1,1,0, 61577
9,61577,2,2,1, 61579
15,61581,2,2,1, 61583
2,61593,2,2,1, 61595
1,61596,1,1,1, 61597
7,61602,1,1,1, 61603
8,61606,1,1,0, 61607
16,61609,2,2,1, 61611
6,61630,2,2,1, 61632
7,61632,1,1,0, 61633
8,61636,1,1,1, 61637
16,61639,2,2,1, 61641
15,61641,2,2,1, 61643
7,61662,1,1,1, 61663
8,61666,1,1,0, 61667
6,61690,2,2,1, 61692
7,61692,1,1,1, 61693
8,61696,1,1,1, 61697
6,61720,2,2,1, 61722
7,61722,1,1,1, 61723
8,61726,1,1,1, 61727
9,61727,2,2,1, 61729
1,61746,1,1,1, 61747
7,61752,1,1,0, 61753
8,61756,1,1,1, 61757
9,61757,2,2,1, 61759
1,61776,1,1,1, 61777
6,61780,2,2,1, 61782
7,61782,1,1,0, 61783
8,61786,1,1,1, 61787
16,61789,2,2,1, 61791
15,61791,2,2,1, 61793
7,61812,1,1,0, 61813
7,61842,1,1,0, 61843
15,61851,2,2,1, 61853
7,61872,1,1,0, 61873
15,61881,2,2,1, 61883
6,61900,2,2,1, 61902
7,61902,1,1,0, 61903
8,61906,1,1,0, 61907
9,61907,2,2,1, 61909
15,61911,2,2,1, 61913
1,61926,1,1,0, 61927
7,61932,1,1,0, 61933
8,61936,1,1,1, 61937
15,61941,2,2,1, 61943
2,61953,2,2,1, 61955
25,61955,2,2,1, 61957
1,61956,1,1,1, 61957
6,61960,2,2,1, 61962
7,61962,1,1,0, 61963
8,61966,1,1,1, 61967
16,61969,2,2,1, 61971
15,61971,2,2,1, 61973
1,61986,1,1,1, 61987
7,61992,1,1,0, 61993
8,61996,1,1,0, 61997
16,61999,2,2,1, 62001
15,62001,2,2,1, 62003
2,62013,2,2,1, 62015
25,62015,2,2,1, 62017
1,62016,1,1,1, 62017
6,62020,2,2,1, 62022
7,62022,1,1,0, 62023
8,62026,1,1,1, 62027
9,62027,2,2,1, 62029
6,62050,2,2,1, 62052
7,62052,1,1,0, 62053
15,62061,2,2,1, 62063
7,62082,1,1,1, 62083
15,62091,2,2,1, 62093
8,62146,1,1,0, 62147
9,62147,2,2,1, 62149
15,62151,2,2,1, 62153
25,62165,2,2,1, 62167
1,62166,1,1,1, 62167
8,62176,1,1,0, 62177
9,62177,2,2,1, 62179
16,62179,2,2,1, 62181
15,62181,2,2,1, 62183
25,62195,2,2,1, 62197
1,62196,1,1,1, 62197
8,62206,1,1,0, 62207
16,62209,2,2,1, 62211
8,62326,1,1,0, 62327
16,62329,2,2,1, 62331
1,62346,1,1,0, 62347
8,62356,1,1,0, 62357
9,62357,2,2,1, 62359
25,62375,2,2,1, 62377
1,62376,1,1,1, 62377
8,62386,1,1,1, 62387
9,62387,2,2,1, 62389
15,62391,2,2,1, 62393
2,62403,2,2,1, 62405
1,62406,1,1,0, 62407
8,62416,1,1,0, 62417
9,62417,2,2,1, 62419
15,62421,2,2,1, 62423
2,62433,2,2,1, 62435
25,62435,2,2,1, 62437
1,62436,1,1,1, 62437
8,62446,1,1,0, 62447
15,62451,2,2,1, 62453
2,62463,2,2,1, 62465
1,62466,1,1,1, 62467
8,62476,1,1,0, 62477
9,62477,2,2,1, 62479
1,62496,1,1,1, 62497
8,62506,1,1,1, 62507
16,62509,2,2,1, 62511
8,62626,1,1,0, 62627
9,62627,2,2,1, 62629
25,62645,2,2,1, 62647
1,62646,1,1,0, 62647
8,62656,1,1,1, 62657
16,62659,2,2,1, 62661
25,62675,2,2,1, 62677
1,62676,1,1,1, 62677
8,62686,1,1,0, 62687
16,62689,2,2,1, 62691
1,62706,1,1,0, 62707
8,62716,1,1,1, 62717
15,62721,2,2,1, 62723
2,62733,2,2,1, 62735
25,62735,2,2,1, 62737
1,62736,1,1,1, 62737
8,62746,1,1,1, 62747
16,62749,2,2,1, 62751
15,62751,2,2,1, 62753
25,62765,2,2,1, 62767
1,62766,1,1,1, 62767
25,62795,2,2,1, 62797
1,62796,1,1,1, 62797
9,62807,2,2,1, 62809
8,62866,1,1,0, 62867
16,62869,2,2,1, 62871
8,62896,1,1,1, 62897
9,62897,2,2,1, 62899
8,62926,1,1,0, 62927
9,62927,2,2,1, 62929
25,62945,2,2,1, 62947
1,62946,1,1,1, 62947
8,62956,1,1,0, 62957
15,62961,2,2,1, 62963
1,62976,1,1,1, 62977
8,62986,1,1,0, 62987
25,63005,2,2,1, 63007
1,63006,1,1,1, 63007
8,63016,1,1,1, 63017
15,63021,2,2,1, 63023
25,63035,2,2,1, 63037
1,63036,1,1,1, 63037
8,63046,1,1,0, 63047
2,63063,2,2,1, 63065
25,63065,2,2,1, 63067
1,63066,1,1,1, 63067
8,63076,1,1,1, 63077
9,63077,2,2,1, 63079
2,63093,2,2,1, 63095
1,63096,1,1,1, 63097
8,63106,1,1,0, 63107
15,63111,2,2,1, 63113
8,63136,1,1,0, 63137
15,63141,2,2,1, 63143
8,63166,1,1,0, 63167
8,63196,1,1,0, 63197
16,63199,2,2,1, 63201
15,63201,2,2,1, 63203
8,63226,1,1,1, 63227
9,63227,2,2,1, 63229
2,63243,2,2,1, 63245
1,63246,1,1,0, 63247
1,63276,1,1,1, 63277
9,63287,2,2,1, 63289
8,63316,1,1,1, 63317
16,63319,2,2,1, 63321
8,63346,1,1,0, 63347
8,63376,1,1,0, 63377
15,63381,2,2,1, 63383
8,63406,1,1,0, 63407
9,63407,2,2,1, 63409
15,63411,2,2,1, 63413
2,63423,2,2,1, 63425
1,63426,1,1,1, 63427
8,63436,1,1,1, 63437
9,63437,2,2,1, 63439
15,63441,2,2,1, 63443
2,63453,2,2,1, 63455
1,63456,1,1,1, 63457
8,63466,1,1,0, 63467
9,63467,2,2,1, 63469
15,63471,2,2,1, 63473
8,63556,1,1,0, 63557
9,63557,2,2,1, 63559
16,63559,2,2,1, 63561
8,63586,1,1,1, 63587
15,63591,2,2,1, 63593
2,63603,2,2,1, 63605
25,63605,2,2,1, 63607
1,63606,1,1,0, 63607
2,63633,2,2,1, 63635
25,63635,2,2,1, 63637
1,63636,1,1,0, 63637
9,63647,2,2,1, 63649
2,63783,2,2,1, 63785
1,63786,1,1,1, 63787
1,63816,1,1,0, 63817
9,63827,2,2,1, 63829
1,63846,1,1,0, 63847
1,63876,1,1,0, 63877
9,63887,2,2,1, 63889
25,63905,2,2,1, 63907
1,63906,1,1,1, 63907
25,63935,2,2,1, 63937
1,63936,1,1,0, 63937
9,63947,2,2,1, 63949
9,64067,2,2,1, 64069
1,64086,1,1,0, 64087
9,64097,2,2,1, 64099
2,64113,2,2,1, 64115
25,64115,2,2,1, 64117
1,64116,1,1,0, 64117
9,64127,2,2,1, 64129
2,64143,2,2,1, 64145
25,64145,2,2,1, 64147
1,64146,1,1,1, 64147
9,64157,2,2,1, 64159
25,64175,2,2,1, 64177
1,64176,1,1,1, 64177
1,64326,1,1,0, 64327
25,64355,2,2,1, 64357
1,64356,1,1,0, 64357
9,64367,2,2,1, 64369
1,64386,1,1,0, 64387
9,64397,2,2,1, 64399
1,64416,1,1,0, 64417
9,64427,2,2,1, 64429
25,64445,2,2,1, 64447
1,64446,1,1,0, 64447
25,64475,2,2,1, 64477
1,64476,1,1,1, 64477
9,64487,2,2,1, 64489
25,64505,2,2,1, 64507
1,64506,1,1,0, 64507
1,64536,1,1,1, 64537
9,64547,2,2,1, 64549
1,64566,1,1,1, 64567
9,64577,2,2,1, 64579
1,64596,1,1,1, 64597
25,64625,2,2,1, 64627
1,64626,1,1,0, 64627
25,64655,2,2,1, 64657
1,64656,1,1,0, 64657
9,64667,2,2,1, 64669
25,64685,2,2,1, 64687
1,64686,1,1,0, 64687
9,64697,2,2,1, 64699
1,64716,1,1,0, 64717
25,64745,2,2,1, 64747
1,64746,1,1,0, 64747
25,64775,2,2,1, 64777
1,64776,1,1,0, 64777
1,64806,1,1,0, 64807
9,64817,2,2,1, 64819
1,64836,1,1,0, 64837
9,64847,2,2,1, 64849
1,64866,1,1,1, 64867
1,64896,1,1,0, 64897
9,64907,2,2,1, 64909
1,64926,1,1,0, 64927
9,64937,2,2,1, 64939
1,64956,1,1,0, 64957
25,64985,2,2,1, 64987
1,64986,1,1,0, 64987
9,64997,2,2,1, 64999
1,65016,1,1,1, 65017
9,65027,2,2,1, 65029
1,65046,1,1,0, 65047
9,65057,2,2,1, 65059
1,65076,1,1,1, 65077
25,65105,2,2,1, 65107
1,65106,1,1,0, 65107
1,65136,1,1,1, 65137
25,65165,2,2,1, 65167
1,65166,1,1,1, 65167
9,65177,2,2,1, 65179
1,65196,1,1,0, 65197
9,65207,2,2,1, 65209
1,65226,1,1,0, 65227
9,65237,2,2,1, 65239
25,65255,2,2,1, 65257
1,65256,1,1,0, 65257
9,65267,2,2,1, 65269
25,65285,2,2,1, 65287
1,65286,1,1,0, 65287
25,65315,2,2,1, 65317
1,65316,1,1,0, 65317
9,65327,2,2,1, 65329
25,65345,2,2,1, 65347
1,65346,1,1,0, 65347
9,65357,2,2,1, 65359
1,65376,1,1,0, 65377
25,65405,2,2,1, 65407
1,65406,1,1,0, 65407
9,65417,2,2,1, 65419
25,65435,2,2,1, 65437
1,65436,1,1,0, 65437
1,65466,1,1,0, 65467
9,65477,2,2,1, 65479
1,65496,1,1,1, 65497
1,65526,1,1,0, 65527
25,65555,2,2,1, 65557
1,65556,1,1,0, 65557
25,65585,2,2,1, 65587
1,65586,1,1,0, 65587
25,65615,2,2,1, 65617
1,65616,1,1,1, 65617
1,65646,1,1,0, 65647
9,65657,2,2,1, 65659
1,65676,1,1,0, 65677
1,65706,1,1,1, 65707
9,65717,2,2,1, 65719
25,65735,2,2,1, 65737
1,65736,1,1,0, 65737
9,65747,2,2,1, 65749
1,65766,1,1,1, 65767
1,65796,1,1,1, 65797
1,65826,1,1,0, 65827
1,65856,1,1,0, 65857
9,65867,2,2,1, 65869
25,65885,2,2,1, 65887
1,65886,1,1,0, 65887
1,65916,1,1,0, 65917
9,65927,2,2,1, 65929
25,65945,2,2,1, 65947
1,65946,1,1,0, 65947
1,65976,1,1,1, 65977
9,65987,2,2,1, 65989
25,66005,2,2,1, 66007
1,66006,1,1,0, 66007
9,66017,2,2,1, 66019
25,66035,2,2,1, 66037
1,66036,1,1,0, 66037
25,66065,2,2,1, 66067
1,66066,1,1,1, 66067
9,66077,2,2,1, 66079
1,66096,1,1,0, 66097
9,66107,2,2,1, 66109
25,66125,2,2,1, 66127
1,66126,1,1,1, 66127
25,66155,2,2,1, 66157
1,66156,1,1,0, 66157
25,66185,2,2,1, 66187
1,66186,1,1,1, 66187
1,66216,1,1,0, 66217
9,66227,2,2,1, 66229
25,66245,2,2,1, 66247
1,66246,1,1,1, 66247
9,66257,2,2,1, 66259
1,66276,1,1,1, 66277
25,66305,2,2,1, 66307
1,66306,1,1,0, 66307
1,66336,1,1,0, 66337
1,66366,1,1,1, 66367
9,66377,2,2,1, 66379
1,66396,1,1,0, 66397
9,66407,2,2,1, 66409
25,66425,2,2,1, 66427
1,66426,1,1,1, 66427
9,66437,2,2,1, 66439
1,66456,1,1,0, 66457
25,66485,2,2,1, 66487
1,66486,1,1,1, 66487
9,66497,2,2,1, 66499
25,66515,2,2,1, 66517
1,66516,1,1,0, 66517
25,66545,2,2,1, 66547
1,66546,1,1,0, 66547
1,66576,1,1,0, 66577
9,66587,2,2,1, 66589
