Time,  Packets Generated,  Packets Reached,High Priority Packets Generated, High Priority Packets reached, Packet Dropped, Packet Dropped due to Faulty Node, High Prio Packet Dropped due to Faulty Node, Low Prio Packet Dropped due to Faulty Node 
5,1,1,1,1,0,0,0,0
10,7,6,6,5,0,0,0,0
15,15,13,9,8,0,0,0,0
20,31,24,16,14,1,1,0,1
25,50,40,26,22,3,3,0,3
30,74,61,36,32,6,6,1,5
35,102,84,46,40,9,9,3,6
40,133,111,64,54,12,12,4,8
45,164,139,81,67,15,15,6,9
50,195,164,96,86,23,18,7,11
55,226,187,110,102,31,21,7,14
60,257,204,125,113,44,24,7,17
65,288,223,140,126,54,26,8,18
70,319,242,157,140,68,28,10,18
75,350,260,173,154,80,30,11,19
80,381,275,188,167,96,32,11,21
85,412,292,202,179,109,35,13,22
90,443,309,213,188,125,38,14,24
95,474,326,226,198,140,41,15,26
100,505,338,237,206,161,44,16,28
105,536,349,250,217,180,46,16,30
110,567,356,259,223,204,48,16,32
115,598,368,278,235,222,50,18,32
120,629,370,292,237,259,51,18,33
125,660,371,310,237,289,53,18,35
130,691,372,329,238,319,54,19,35
135,722,373,347,238,349,55,19,36
140,753,374,363,238,379,56,20,36
145,784,375,377,238,409,57,20,37
150,815,376,385,239,439,58,21,37
155,846,377,398,239,469,58,21,37
160,877,378,412,239,499,58,21,37
165,908,379,427,240,529,58,21,37
170,939,380,442,241,559,58,21,37
175,970,381,460,242,589,58,21,37
180,1001,382,473,242,619,58,21,37
185,1032,382,488,242,650,59,22,37
190,1063,384,505,243,679,59,22,37
195,1094,385,518,244,709,59,22,37
200,1125,387,536,245,738,59,22,37
205,1156,389,552,246,767,59,22,37
210,1187,390,569,247,797,59,22,37
215,1218,393,583,249,825,59,22,37
220,1249,395,596,250,854,59,22,37
225,1280,399,612,252,880,59,22,37
230,1311,405,624,257,905,59,22,37
235,1342,412,635,264,928,59,22,37
240,1373,421,653,271,950,59,22,37
245,1404,424,668,273,979,60,23,37
250,1435,426,684,275,1008,61,23,38
255,1466,428,699,277,1037,62,24,38
260,1497,430,713,279,1067,62,24,38
265,1528,431,730,280,1096,62,24,38
270,1559,433,744,281,1125,62,24,38
275,1590,435,756,283,1155,62,24,38
280,1621,436,772,284,1184,62,24,38
285,1652,437,786,285,1215,62,24,38
290,1683,439,806,287,1239,64,24,40
295,1714,448,819,295,1262,66,26,40
300,1745,454,833,300,1288,68,26,42
305,1776,454,845,300,1322,69,27,42
310,1807,454,859,300,1353,70,28,42
315,1838,454,875,300,1384,71,29,42
320,1869,454,891,300,1415,72,30,42
325,1900,454,905,300,1446,73,30,43
330,1931,454,927,300,1477,74,31,43
335,1962,454,942,300,1508,75,31,44
340,1993,454,954,300,1539,76,31,45
345,2024,454,967,300,1570,77,31,46
350,2055,459,986,304,1594,78,32,46
355,2086,465,1001,310,1620,79,32,47
360,2117,472,1017,317,1645,80,32,48
365,2148,474,1033,319,1674,81,32,49
370,2179,476,1049,319,1703,82,33,49
375,2210,479,1065,321,1731,83,34,49
380,2241,480,1080,321,1761,84,34,50
385,2272,481,1097,321,1791,84,34,50
390,2303,482,1111,321,1821,84,34,50
395,2334,483,1123,322,1851,84,34,50
400,2365,484,1139,323,1881,84,34,50
405,2396,485,1157,324,1911,84,34,50
410,2427,486,1175,325,1941,84,34,50
415,2458,487,1186,325,1970,84,34,50
420,2489,488,1197,326,1999,85,35,50
425,2520,489,1215,327,2031,85,35,50
430,2551,490,1226,327,2061,85,35,50
435,2582,491,1245,328,2091,85,35,50
440,2613,492,1258,329,2121,85,35,50
445,2644,493,1276,330,2151,85,35,50
450,2675,494,1289,330,2181,85,35,50
455,2706,495,1302,330,2211,85,35,50
460,2737,496,1316,331,2241,85,35,50
465,2768,497,1329,332,2271,85,35,50
470,2799,500,1350,334,2299,85,35,50
475,2830,503,1363,336,2324,85,35,50
480,2861,514,1380,345,2345,85,35,50
485,2892,520,1395,350,2371,85,35,50
490,2923,522,1409,352,2401,85,35,50
495,2954,523,1421,352,2431,85,35,50
500,2985,524,1438,352,2461,85,35,50
505,3016,525,1454,352,2491,85,35,50
510,3047,526,1464,352,2521,85,35,50
515,3078,527,1477,353,2551,85,35,50
520,3109,528,1491,353,2581,85,35,50
525,3140,529,1507,353,2611,85,35,50
530,3171,530,1517,353,2641,85,35,50
535,3202,531,1530,354,2671,85,35,50
540,3233,532,1547,355,2701,85,35,50
545,3264,532,1565,355,2732,85,35,50
550,3295,532,1581,355,2763,85,35,50
555,3326,532,1602,355,2794,85,35,50
560,3357,532,1618,355,2825,85,35,50
565,3388,532,1642,355,2856,85,35,50
570,3419,532,1660,355,2887,86,35,51
575,3450,532,1673,355,2918,87,36,51
580,3481,532,1686,355,2949,88,36,52
585,3512,533,1696,355,2979,89,37,52
590,3543,537,1711,358,3005,90,37,53
595,3574,543,1720,361,3031,91,37,54
600,3605,549,1733,365,3056,92,37,55
605,3636,554,1748,369,3081,92,37,55
610,3667,558,1763,372,3109,92,37,55
615,3698,562,1779,375,3135,92,37,55
620,3729,565,1794,377,3164,92,37,55
625,3760,568,1806,380,3192,92,37,55
630,3791,570,1820,380,3221,92,37,55
635,3822,574,1836,382,3248,92,37,55
640,3853,579,1856,386,3274,92,37,55
645,3884,580,1878,387,3304,92,37,55
650,3915,581,1890,387,3333,92,37,55
655,3946,583,1901,389,3359,92,37,55
660,3977,588,1919,394,3386,92,37,55
665,4008,588,1936,394,3420,92,37,55
670,4039,588,1954,394,3451,92,37,55
675,4070,588,1967,394,3482,92,37,55
680,4101,588,1980,394,3513,92,37,55
685,4132,588,1997,394,3544,92,37,55
690,4163,588,2009,394,3575,92,37,55
695,4194,588,2026,394,3606,92,37,55
700,4225,588,2040,394,3637,92,37,55
705,4256,588,2057,394,3668,92,37,55
710,4287,589,2071,395,3698,92,37,55
715,4318,590,2087,395,3728,92,37,55
720,4349,591,2105,396,3758,92,37,55
725,4380,594,2123,398,3786,93,37,56
730,4411,598,2138,401,3813,94,37,57
735,4442,600,2150,402,3842,95,37,58
740,4473,605,2167,405,3868,96,37,59
745,4504,609,2182,409,3895,97,38,59
750,4535,612,2200,412,3923,97,38,59
755,4566,614,2217,413,3952,97,38,59
760,4597,616,2232,414,3981,97,38,59
765,4628,619,2244,415,4007,97,38,59
770,4659,627,2262,422,4025,99,40,59
775,4690,634,2274,427,4051,101,40,61
780,4721,639,2290,431,4075,102,40,62
785,4752,644,2307,435,4108,103,40,63
790,4783,647,2321,438,4136,104,41,63
795,4814,649,2337,439,4165,105,41,64
800,4845,650,2350,439,4195,106,41,65
805,4876,651,2362,439,4225,107,41,66
810,4907,652,2378,440,4255,108,41,67
815,4938,653,2398,441,4285,109,42,67
820,4969,654,2409,441,4315,110,42,68
825,5000,655,2426,441,4345,111,43,68
830,5031,656,2443,442,4375,112,44,68
835,5062,657,2460,442,4405,113,44,69
840,5093,658,2473,443,4435,114,45,69
845,5124,658,2489,443,4466,114,45,69
850,5155,658,2506,443,4497,114,45,69
855,5186,658,2525,443,4528,114,45,69
860,5217,658,2540,443,4559,114,45,69
865,5248,658,2553,443,4590,114,45,69
870,5279,658,2572,443,4621,114,45,69
875,5310,658,2586,443,4652,114,45,69
880,5341,658,2604,443,4683,114,45,69
885,5372,659,2615,443,4713,115,45,70
890,5403,661,2627,443,4742,116,46,70
895,5434,664,2640,445,4770,117,47,70
900,5465,667,2655,447,4797,118,47,71
905,5496,672,2668,450,4824,118,47,71
910,5527,676,2681,452,4851,118,47,71
915,5558,680,2696,454,4877,118,47,71
920,5589,684,2710,455,4905,118,47,71
925,5620,687,2723,457,4932,118,47,71
930,5651,692,2737,460,4959,118,47,71
935,5682,694,2751,462,4988,118,47,71
940,5713,695,2764,463,5018,118,47,71
945,5744,696,2778,464,5048,118,47,71
950,5775,697,2792,465,5078,118,47,71
955,5806,698,2809,466,5108,118,47,71
960,5837,698,2825,466,5139,118,47,71
965,5868,698,2843,466,5170,118,47,71
970,5899,698,2861,466,5201,118,47,71
975,5930,698,2875,466,5232,118,47,71
980,5961,698,2890,466,5263,118,47,71
985,5992,698,2911,466,5294,118,47,71
990,6023,698,2926,466,5325,118,47,71
995,6054,698,2939,466,5356,118,47,71
1000,6085,698,2953,466,5387,118,47,71
1005,6116,698,2965,466,5418,119,47,72
1010,6147,698,2986,466,5443,120,48,72
1015,6178,706,3002,473,5468,122,49,73
1020,6209,714,3017,480,5495,124,50,74
1025,6240,716,3032,482,5524,125,50,75
1030,6271,717,3047,483,5554,125,50,75
1035,6302,719,3060,483,5583,125,50,75
1040,6333,722,3081,485,5611,125,50,75
1045,6364,725,3100,487,5639,125,50,75
1050,6395,727,3114,488,5668,125,50,75
1055,6426,729,3128,490,5697,125,50,75
1060,6457,731,3139,490,5726,125,50,75
1065,6488,733,3152,491,5755,125,50,75
1070,6519,735,3171,492,5784,125,50,75
1075,6550,737,3182,494,5813,125,50,75
1080,6581,739,3199,496,5842,125,50,75
1085,6612,743,3211,499,5869,126,50,76
1090,6643,746,3226,501,5897,127,50,77
1095,6674,748,3237,501,5926,127,50,77
1100,6705,750,3254,502,5955,127,50,77
1105,6736,752,3265,502,5984,127,50,77
1110,6767,754,3282,504,6013,127,50,77
1115,6798,756,3301,505,6042,127,50,77
1120,6829,758,3318,505,6071,127,50,77
1125,6860,760,3333,506,6099,127,50,77
1130,6891,767,3347,512,6119,128,51,77
1135,6922,776,3359,519,6141,129,51,78
1140,6953,786,3375,528,6164,130,51,79
1145,6984,789,3390,530,6193,131,51,80
1150,7015,792,3403,532,6223,132,51,81
1155,7046,794,3419,534,6252,132,51,81
1160,7077,795,3431,535,6282,132,51,81
1165,7108,796,3444,535,6312,132,51,81
1170,7139,797,3462,535,6342,132,51,81
1175,7170,798,3477,536,6372,132,51,81
1180,7201,800,3497,538,6401,132,51,81
1185,7232,801,3508,539,6431,132,51,81
1190,7263,802,3523,539,6461,132,51,81
1195,7294,803,3543,540,6491,132,51,81
1200,7325,803,3558,540,6522,132,51,81
1205,7356,805,3578,542,6550,133,52,81
1210,7387,807,3602,543,6579,133,52,81
1215,7418,809,3616,544,6609,133,52,81
1220,7449,811,3636,545,6638,133,52,81
1225,7480,813,3656,547,6667,133,52,81
1230,7511,814,3668,547,6697,133,52,81
1235,7542,815,3679,548,6727,133,52,81
1240,7573,816,3690,548,6757,133,52,81
1245,7604,817,3705,549,6787,133,52,81
1250,7635,819,3719,550,6816,133,52,81
1255,7666,824,3732,554,6841,134,53,81
1260,7697,830,3754,560,6861,135,53,82
1265,7728,831,3775,561,6897,135,53,82
1270,7759,831,3789,561,6928,135,53,82
1275,7790,831,3800,561,6959,135,53,82
1280,7821,831,3813,561,6990,135,53,82
1285,7852,831,3833,561,7021,135,53,82
1290,7883,831,3845,561,7052,135,53,82
1295,7914,831,3864,561,7083,135,53,82
1300,7945,831,3879,561,7114,135,53,82
1305,7976,831,3891,561,7145,135,53,82
1310,8007,831,3902,561,7176,135,53,82
1315,8038,831,3914,561,7207,135,53,82
1320,8069,831,3926,561,7238,135,53,82
1325,8100,831,3939,561,7269,135,53,82
1330,8131,831,3958,561,7300,135,53,82
1335,8162,831,3976,561,7331,135,53,82
1340,8193,831,3991,561,7362,135,53,82
1345,8224,831,4007,561,7393,135,53,82
1350,8255,831,4018,561,7424,135,53,82
1355,8286,831,4033,561,7455,135,53,82
1360,8317,831,4051,561,7486,135,53,82
1365,8348,831,4062,561,7516,135,53,82
1370,8379,837,4076,565,7536,135,53,82
1375,8410,852,4091,578,7552,135,53,82
1380,8441,868,4108,591,7568,136,53,83
1385,8472,873,4121,594,7599,138,54,84
1390,8503,876,4140,597,7627,139,55,84
1395,8534,879,4155,599,7655,140,55,85
1400,8565,882,4172,601,7683,141,55,86
1405,8596,884,4189,602,7712,142,56,86
1410,8627,887,4206,605,7740,143,57,86
1415,8658,890,4223,607,7768,144,57,87
1420,8689,892,4239,607,7797,145,57,88
1425,8720,894,4251,608,7826,146,57,89
1430,8751,896,4261,608,7855,147,57,90
1435,8782,899,4280,611,7883,148,57,91
1440,8813,901,4294,611,7912,149,58,91
1445,8844,905,4307,613,7939,149,58,91
1450,8875,908,4318,615,7967,149,58,91
1455,8906,911,4332,617,7995,149,58,91
1460,8937,914,4351,619,8023,149,58,91
1465,8968,915,4362,620,8053,149,58,91
1470,8999,916,4373,621,8083,149,58,91
1475,9030,916,4389,621,8114,149,58,91
1480,9061,916,4407,621,8145,149,58,91
1485,9092,916,4427,621,8176,149,58,91
1490,9123,919,4446,623,8200,150,59,91
1495,9154,923,4459,626,8231,151,59,92
1500,9185,928,4474,630,8254,152,59,93
1505,9216,932,4489,632,8284,153,59,94
1510,9247,933,4506,632,8314,153,59,94
1515,9278,934,4523,632,8343,153,59,94
1520,9309,936,4533,633,8372,153,59,94
1525,9340,938,4546,635,8402,153,59,94
1530,9371,939,4560,635,8432,153,59,94
1535,9402,940,4574,636,8462,153,59,94
1540,9433,941,4589,636,8492,153,59,94
1545,9464,942,4612,637,8522,153,59,94
1550,9495,944,4630,638,8551,153,59,94
1555,9526,946,4648,639,8580,153,59,94
1560,9557,948,4662,640,8609,153,59,94
1565,9588,949,4679,640,8638,153,59,94
1570,9619,951,4699,641,8668,153,59,94
1575,9650,952,4715,642,8698,153,59,94
1580,9681,953,4733,642,8728,153,59,94
1585,9712,954,4747,642,8758,153,59,94
1590,9743,955,4763,643,8788,153,59,94
1595,9774,956,4780,644,8818,153,59,94
1600,9805,957,4794,645,8848,153,59,94
1605,9836,959,4805,646,8877,153,59,94
1610,9867,962,4821,648,8903,153,59,94
1615,9898,964,4839,650,8930,154,59,95
1620,9929,971,4856,657,8953,155,59,96
1625,9960,978,4868,662,8982,157,60,97
1630,9991,982,4878,664,9009,159,62,97
1635,10022,986,4892,666,9035,161,64,97
1640,10053,990,4906,668,9063,163,65,98
1645,10084,993,4922,671,9091,164,65,99
1650,10115,995,4934,672,9120,165,66,99
1655,10146,999,4954,676,9147,166,67,99
1660,10177,1001,4970,678,9176,167,68,99
1665,10208,1003,4981,679,9205,168,68,100
1670,10239,1008,4996,683,9231,169,68,101
1675,10270,1014,5010,688,9255,170,69,101
1680,10301,1018,5023,692,9281,171,70,101
1685,10332,1021,5043,694,9311,172,71,101
1690,10363,1022,5058,694,9341,173,72,101
1695,10394,1023,5080,694,9371,174,73,101
1700,10425,1024,5099,695,9401,175,73,102
1705,10456,1025,5109,696,9431,176,74,102
1710,10487,1026,5123,697,9461,177,75,102
1715,10518,1027,5137,698,9491,178,76,102
1720,10549,1028,5157,698,9521,179,76,103
1725,10580,1029,5173,699,9551,180,76,104
1730,10611,1030,5185,699,9581,181,76,105
1735,10642,1031,5203,700,9611,182,76,106
1740,10673,1032,5215,700,9641,183,76,107
1745,10704,1034,5231,701,9669,183,76,107
1750,10735,1038,5247,703,9696,183,76,107
1755,10766,1041,5261,704,9724,183,76,107
1760,10797,1044,5278,705,9752,183,76,107
1765,10828,1048,5295,708,9780,183,76,107
1770,10859,1049,5305,708,9810,183,76,107
1775,10890,1050,5323,709,9840,183,76,107
1780,10921,1051,5342,709,9870,183,76,107
1785,10952,1053,5361,710,9899,183,76,107
1790,10983,1055,5378,710,9928,183,76,107
1795,11014,1057,5398,711,9957,183,76,107
1800,11045,1059,5412,711,9986,183,76,107
1805,11076,1061,5426,711,10015,183,76,107
1810,11107,1063,5440,712,10043,183,76,107
1815,11138,1066,5456,713,10072,183,76,107
1820,11169,1068,5473,714,10100,183,76,107
1825,11200,1071,5486,715,10129,183,76,107
1830,11231,1073,5503,716,10157,183,76,107
1835,11262,1076,5524,719,10186,183,76,107
1840,11293,1078,5540,721,10214,183,76,107
1845,11324,1081,5554,722,10243,183,76,107
1850,11355,1083,5566,723,10272,183,76,107
1855,11386,1085,5577,724,10300,183,76,107
1860,11417,1088,5592,726,10329,183,76,107
1865,11448,1090,5606,727,10358,183,76,107
1870,11479,1092,5621,729,10387,183,76,107
1875,11510,1094,5635,731,10416,183,76,107
1880,11541,1096,5644,731,10445,183,76,107
1885,11572,1098,5653,731,10474,183,76,107
1890,11603,1100,5666,731,10503,183,76,107
1895,11634,1103,5680,733,10531,184,76,108
1900,11665,1106,5693,735,10559,185,76,109
1905,11696,1109,5705,738,10587,186,77,109
1910,11727,1113,5721,741,10610,188,79,109
1915,11758,1123,5741,749,10630,190,80,110
1920,11789,1136,5754,762,10650,192,81,111
1925,11820,1137,5765,763,10683,194,82,112
1930,11851,1137,5780,763,10714,195,82,113
1935,11882,1137,5799,763,10745,196,83,113
1940,11913,1137,5817,763,10776,197,83,114
1945,11944,1137,5833,763,10807,198,84,114
1950,11975,1137,5847,763,10838,199,84,115
1955,12006,1137,5862,763,10869,200,85,115
1960,12037,1137,5880,763,10900,201,85,116
1965,12068,1137,5895,763,10931,202,86,116
1970,12099,1137,5914,763,10962,203,86,117
1975,12130,1137,5930,763,10993,204,86,118
1980,12161,1137,5944,763,11024,205,86,119
1985,12192,1140,5959,766,11052,205,86,119
1990,12223,1143,5974,768,11079,205,86,119
1995,12254,1144,5989,769,11110,205,86,119
2000,12285,1144,5997,769,11141,205,86,119
2005,12316,1144,6007,769,11172,205,86,119
2010,12347,1145,6022,769,11202,205,86,119
2015,12378,1146,6031,769,11232,205,86,119
2020,12409,1148,6040,770,11261,205,86,119
2025,12440,1151,6051,771,11286,205,86,119
2030,12471,1159,6065,777,11307,206,87,119
2035,12502,1168,6080,783,11325,207,88,119
2040,12533,1176,6092,790,11350,208,88,120
2045,12564,1180,6106,793,11384,210,89,121
2050,12595,1182,6121,794,11413,212,90,122
2055,12626,1184,6138,795,11442,214,90,124
2060,12657,1186,6153,796,11471,216,90,126
2065,12688,1188,6168,797,11500,218,91,127
2070,12719,1190,6179,798,11529,220,91,129
2075,12750,1192,6189,799,11558,222,91,131
2080,12781,1193,6202,799,11588,224,92,132
2085,12812,1195,6218,800,11617,226,93,133
2090,12843,1195,6234,800,11648,228,94,134
2095,12874,1195,6253,800,11679,230,94,136
2100,12905,1197,6267,802,11708,232,94,138
2105,12936,1199,6280,804,11737,233,94,139
2110,12967,1201,6296,805,11765,234,94,140
2115,12998,1204,6317,808,11794,235,95,140
2120,13029,1206,6334,810,11823,236,95,141
2125,13060,1209,6354,813,11850,237,95,142
2130,13091,1213,6367,817,11878,238,95,143
2135,13122,1213,6378,817,11909,239,96,143
2140,13153,1213,6391,817,11940,240,96,144
2145,13184,1216,6408,819,11966,241,96,145
2150,13215,1220,6421,822,11990,242,96,146
2155,13246,1228,6435,828,12014,242,96,146
2160,13277,1238,6446,837,12038,242,96,146
2165,13308,1240,6464,838,12068,243,96,147
2170,13339,1242,6481,839,12097,244,97,147
2175,13370,1244,6497,841,12126,245,97,148
2180,13401,1246,6513,842,12155,246,98,148
2185,13432,1248,6531,844,12184,247,99,148
2190,13463,1250,6546,845,12213,248,100,148
2195,13494,1252,6560,845,12242,249,100,149
2200,13525,1254,6577,846,12271,250,100,150
2205,13556,1256,6594,846,12300,251,100,151
2210,13587,1258,6614,848,12329,252,101,151
2215,13618,1260,6626,849,12358,253,102,151
2220,13649,1262,6639,851,12387,254,102,152
2225,13680,1266,6653,852,12413,255,102,153
2230,13711,1270,6668,855,12441,256,103,153
2235,13742,1272,6677,856,12470,257,103,154
2240,13773,1275,6688,858,12498,258,103,155
2245,13804,1278,6708,860,12525,259,104,155
2250,13835,1282,6723,863,12553,260,105,155
2255,13866,1284,6734,863,12582,261,105,156
2260,13897,1287,6744,865,12609,262,106,156
2265,13928,1292,6756,867,12635,263,106,157
2270,13959,1297,6770,869,12656,265,107,158
2275,13990,1306,6784,877,12675,266,107,159
2280,14021,1318,6797,888,12699,267,107,160
2285,14052,1320,6807,890,12732,267,107,160
2290,14083,1321,6823,890,12762,267,107,160
2295,14114,1322,6838,891,12792,267,107,160
2300,14145,1323,6854,892,12822,267,107,160
2305,14176,1324,6865,893,12852,267,107,160
2310,14207,1325,6877,893,12882,267,107,160
2315,14238,1326,6890,893,12912,267,107,160
2320,14269,1327,6911,894,12942,267,107,160
2325,14300,1328,6928,895,12972,267,107,160
2330,14331,1329,6944,895,13002,267,107,160
2335,14362,1330,6955,895,13032,267,107,160
2340,14393,1331,6968,895,13062,267,107,160
2345,14424,1333,6980,897,13091,267,107,160
2350,14455,1334,6999,897,13121,267,107,160
2355,14486,1335,7013,897,13151,267,107,160
2360,14517,1336,7025,897,13181,267,107,160
2365,14548,1337,7040,898,13211,267,107,160
2370,14579,1338,7058,898,13241,267,107,160
2375,14610,1339,7076,899,13271,267,107,160
2380,14641,1340,7087,900,13301,268,107,161
2385,14672,1342,7101,902,13330,269,107,162
2390,14703,1345,7113,904,13354,271,109,162
2395,14734,1348,7130,907,13377,273,109,164
2400,14765,1350,7146,908,13414,275,110,165
2405,14796,1355,7167,912,13439,276,111,165
2410,14827,1360,7182,917,13465,276,111,165
2415,14858,1364,7195,921,13492,276,111,165
2420,14889,1368,7206,924,13521,276,111,165
2425,14920,1371,7220,926,13549,276,111,165
2430,14951,1373,7234,928,13577,276,111,165
2435,14982,1375,7250,930,13607,276,111,165
2440,15013,1376,7261,930,13637,276,111,165
2445,15044,1377,7275,931,13667,276,111,165
2450,15075,1380,7295,934,13694,276,111,165
2455,15106,1386,7308,938,13720,276,111,165
2460,15137,1392,7325,943,13744,276,111,165
2465,15168,1396,7347,947,13771,276,111,165
2470,15199,1398,7356,948,13801,276,111,165
2475,15230,1401,7372,950,13829,276,111,165
2480,15261,1401,7384,950,13860,276,111,165
2485,15292,1401,7393,950,13891,276,111,165
2490,15323,1401,7409,950,13922,276,111,165
2495,15354,1401,7425,950,13953,276,111,165
2500,15385,1401,7444,950,13984,276,111,165
2505,15416,1401,7457,950,14015,276,111,165
2510,15447,1401,7471,950,14044,276,111,165
2515,15478,1401,7484,950,14072,276,111,165
2520,15509,1401,7500,950,14108,276,111,165
2525,15540,1403,7515,952,14136,276,111,165
2530,15571,1407,7532,956,14164,276,111,165
2535,15602,1413,7550,960,14189,276,111,165
2540,15633,1417,7570,963,14216,276,111,165
2545,15664,1419,7589,965,14245,276,111,165
2550,15695,1422,7608,967,14273,276,111,165
2555,15726,1424,7623,968,14302,276,111,165
2560,15757,1426,7639,969,14331,276,111,165
2565,15788,1429,7654,971,14359,276,111,165
2570,15819,1431,7667,972,14387,276,111,165
2575,15850,1436,7686,976,14413,276,111,165
2580,15881,1440,7703,980,14441,276,111,165
2585,15912,1445,7715,983,14466,277,112,165
2590,15943,1449,7725,987,14494,277,112,165
2595,15974,1451,7742,988,14523,277,112,165
2600,16005,1455,7762,991,14550,277,112,165
2605,16036,1460,7781,995,14575,277,112,165
2610,16067,1464,7798,998,14603,277,112,165
2615,16098,1468,7813,1000,14630,277,112,165
2620,16129,1469,7833,1001,14660,277,112,165
2625,16160,1472,7853,1003,14688,277,112,165
2630,16191,1475,7864,1006,14716,277,112,165
2635,16222,1476,7881,1006,14746,277,112,165
2640,16253,1476,7894,1006,14777,277,112,165
2645,16284,1476,7909,1006,14808,277,112,165
2650,16315,1476,7926,1006,14839,277,112,165
2655,16346,1476,7941,1006,14870,277,112,165
2660,16377,1476,7957,1006,14901,277,112,165
2665,16408,1476,7973,1006,14932,277,112,165
2670,16439,1476,7987,1006,14963,277,112,165
2675,16470,1476,8003,1006,14994,277,112,165
2680,16501,1476,8016,1006,15025,277,112,165
2685,16532,1476,8028,1006,15056,277,112,165
2690,16563,1477,8046,1006,15081,277,112,165
2695,16594,1484,8058,1013,15109,278,112,166
2700,16625,1489,8072,1017,15134,280,113,167
2705,16656,1493,8086,1019,15162,280,113,167
2710,16687,1497,8103,1022,15189,280,113,167
2715,16718,1500,8112,1023,15217,280,113,167
2720,16749,1504,8121,1024,15245,280,113,167
2725,16780,1508,8136,1027,15272,280,113,167
2730,16811,1511,8150,1028,15300,280,113,167
2735,16842,1515,8167,1031,15327,280,113,167
2740,16873,1517,8179,1032,15356,280,113,167
2745,16904,1520,8196,1034,15384,280,113,167
2750,16935,1524,8212,1037,15411,280,113,167
2755,16966,1526,8226,1038,15440,280,113,167
2760,16997,1529,8241,1041,15468,280,113,167
2765,17028,1533,8255,1043,15495,280,113,167
2770,17059,1537,8272,1046,15522,280,113,167
2775,17090,1542,8291,1050,15547,280,113,167
2780,17121,1547,8308,1053,15574,280,113,167
2785,17152,1550,8319,1054,15601,280,113,167
2790,17183,1556,8340,1058,15626,280,113,167
2795,17214,1560,8355,1060,15653,280,113,167
2800,17245,1563,8366,1062,15681,280,113,167
2805,17276,1567,8379,1063,15706,282,113,169
2810,17307,1570,8390,1064,15737,284,115,169
2815,17338,1575,8409,1069,15762,285,116,169
2820,17369,1576,8419,1070,15793,285,116,169
2825,17400,1577,8429,1070,15823,285,116,169
2830,17431,1579,8444,1071,15852,285,116,169
2835,17462,1582,8458,1074,15880,285,116,169
2840,17493,1583,8475,1075,15910,285,116,169
2845,17524,1585,8489,1076,15939,285,116,169
2850,17555,1587,8503,1077,15968,285,116,169
2855,17586,1589,8522,1078,15997,285,116,169
2860,17617,1590,8537,1078,16027,285,116,169
2865,17648,1591,8550,1078,16057,285,116,169
2870,17679,1592,8568,1079,16087,285,116,169
2875,17710,1595,8580,1082,16115,285,116,169
2880,17741,1598,8594,1085,16143,285,116,169
2885,17772,1598,8607,1085,16174,286,116,170
2890,17803,1598,8620,1085,16205,287,117,170
2895,17834,1598,8634,1085,16236,288,118,170
2900,17865,1598,8652,1085,16267,289,119,170
2905,17896,1598,8669,1085,16298,290,120,170
2910,17927,1598,8683,1085,16329,291,121,170
2915,17958,1599,8700,1085,16358,292,121,171
2920,17989,1602,8719,1088,16383,294,123,171
2925,18020,1609,8737,1094,16405,296,124,172
2930,18051,1620,8756,1104,16425,298,125,173
2935,18082,1629,8772,1111,16448,299,126,173
2940,18113,1636,8784,1116,16472,300,126,174
2945,18144,1642,8799,1121,16502,300,126,174
2950,18175,1645,8811,1123,16530,300,126,174
2955,18206,1648,8830,1125,16558,300,126,174
2960,18237,1650,8846,1126,16587,300,126,174
2965,18268,1653,8861,1129,16615,300,126,174
2970,18299,1656,8874,1131,16643,300,126,174
2975,18330,1658,8889,1133,16672,300,126,174
2980,18361,1661,8905,1135,16700,300,126,174
2985,18392,1663,8925,1137,16729,300,126,174
2990,18423,1665,8945,1138,16758,300,126,174
2995,18454,1667,8963,1139,16787,300,126,174
3000,18485,1669,8976,1139,16816,300,126,174
3005,18516,1670,8990,1140,16846,301,127,174
3010,18547,1671,9002,1141,16876,301,127,174
3015,18578,1673,9022,1142,16905,301,127,174
3020,18609,1674,9036,1142,16935,301,127,174
3025,18640,1675,9047,1143,16965,301,127,174
3030,18671,1677,9067,1145,16994,301,127,174
3035,18702,1678,9079,1146,17024,301,127,174
3040,18733,1678,9097,1146,17055,301,127,174
3045,18764,1679,9113,1146,17085,301,127,174
3050,18795,1680,9126,1146,17113,302,127,175
3055,18826,1682,9140,1148,17142,303,127,176
3060,18857,1684,9158,1149,17171,304,128,176
3065,18888,1686,9178,1151,17202,304,128,176
3070,18919,1688,9192,1152,17231,304,128,176
3075,18950,1690,9208,1153,17260,304,128,176
3080,18981,1692,9223,1153,17289,304,128,176
3085,19012,1694,9232,1155,17318,304,128,176
3090,19043,1696,9248,1156,17347,304,128,176
3095,19074,1698,9261,1158,17376,304,128,176
3100,19105,1700,9280,1159,17405,304,128,176
3105,19136,1702,9298,1159,17434,304,128,176
3110,19167,1704,9310,1161,17463,304,128,176
3115,19198,1706,9329,1162,17492,304,128,176
3120,19229,1708,9342,1163,17521,304,128,176
3125,19260,1710,9356,1164,17550,305,128,177
3130,19291,1712,9369,1165,17579,305,128,177
3135,19322,1714,9382,1166,17608,305,128,177
3140,19353,1716,9399,1168,17637,305,128,177
3145,19384,1718,9415,1169,17666,305,128,177
3150,19415,1720,9429,1169,17695,305,128,177
3155,19446,1722,9445,1170,17724,305,128,177
3160,19477,1724,9460,1171,17753,305,128,177
3165,19508,1727,9475,1174,17781,305,128,177
3170,19539,1731,9491,1175,17807,305,128,177
3175,19570,1734,9507,1178,17834,305,128,177
3180,19601,1742,9523,1185,17858,305,128,177
3185,19632,1745,9535,1188,17887,306,128,178
3190,19663,1747,9550,1189,17916,307,128,179
3195,19694,1749,9566,1190,17945,307,128,179
3200,19725,1751,9579,1192,17974,307,128,179
3205,19756,1753,9600,1194,18003,307,128,179
3210,19787,1754,9614,1194,18033,307,128,179
3215,19818,1756,9631,1196,18062,307,128,179
3220,19849,1757,9646,1197,18092,307,128,179
3225,19880,1759,9663,1198,18121,307,128,179
3230,19911,1760,9677,1198,18151,307,128,179
3235,19942,1762,9692,1199,18180,307,128,179
3240,19973,1763,9703,1200,18210,307,128,179
3245,20004,1766,9716,1203,18238,308,128,180
3250,20035,1768,9732,1204,18267,309,129,180
3255,20066,1770,9750,1205,18296,310,129,181
3260,20097,1771,9768,1206,18326,311,130,181
3265,20128,1772,9777,1207,18356,312,130,182
3270,20159,1774,9792,1209,18385,313,130,183
3275,20190,1774,9803,1209,18416,314,131,183
3280,20221,1776,9821,1210,18445,314,131,183
3285,20252,1778,9833,1210,18474,314,131,183
3290,20283,1780,9845,1211,18503,314,131,183
3295,20314,1782,9856,1211,18532,315,132,183
3300,20345,1784,9870,1211,18561,316,133,183
3305,20376,1791,9885,1214,18583,316,133,183
3310,20407,1800,9901,1220,18607,316,133,183
3315,20438,1805,9916,1223,18632,316,133,183
3320,20469,1810,9932,1228,18658,316,133,183
3325,20500,1815,9947,1231,18685,316,133,183
3330,20531,1818,9963,1233,18713,316,133,183
3335,20562,1821,9975,1234,18741,316,133,183
3340,20593,1824,9988,1235,18769,316,133,183
3345,20624,1827,10012,1235,18797,317,134,183
3350,20655,1830,10026,1235,18825,318,134,184
3355,20686,1833,10041,1236,18853,318,134,184
3360,20717,1836,10052,1238,18881,318,134,184
3365,20748,1841,10068,1241,18907,318,134,184
3370,20779,1844,10080,1241,18935,318,134,184
3375,20810,1847,10096,1243,18963,318,134,184
3380,20841,1850,10113,1245,18991,318,134,184
3385,20872,1853,10130,1248,19019,318,134,184
3390,20903,1856,10145,1250,19047,318,134,184
3395,20934,1859,10161,1253,19075,318,134,184
3400,20965,1862,10170,1253,19103,318,134,184
3405,20996,1865,10187,1255,19131,318,134,184
3410,21027,1868,10197,1257,19159,318,134,184
3415,21058,1871,10212,1259,19187,318,134,184
3420,21089,1875,10228,1262,19213,318,134,184
3425,21120,1880,10240,1265,19240,318,134,184
3430,21151,1883,10256,1267,19268,318,134,184
3435,21182,1884,10268,1267,19297,318,134,184
3440,21213,1887,10282,1269,19325,318,134,184
3445,21244,1889,10301,1271,19354,318,134,184
3450,21275,1891,10316,1273,19384,318,134,184
3455,21306,1892,10330,1274,19413,318,134,184
3460,21337,1893,10342,1275,19444,319,134,185
3465,21368,1893,10356,1275,19475,319,134,185
3470,21399,1893,10374,1275,19506,319,134,185
3475,21430,1893,10386,1275,19537,319,134,185
3480,21461,1893,10404,1275,19568,319,134,185
3485,21492,1895,10423,1276,19597,319,134,185
3490,21523,1898,10433,1278,19625,319,134,185
3495,21554,1901,10449,1280,19653,319,134,185
3500,21585,1903,10469,1281,19682,319,134,185
3505,21616,1904,10488,1282,19712,319,134,185
3510,21647,1904,10502,1282,19743,319,134,185
3515,21678,1904,10517,1282,19774,319,134,185
3520,21709,1904,10535,1282,19805,319,134,185
3525,21740,1905,10547,1282,19835,319,134,185
3530,21771,1909,10562,1284,19862,319,134,185
3535,21802,1912,10573,1285,19889,319,134,185
3540,21833,1916,10588,1289,19916,319,134,185
3545,21864,1922,10608,1295,19942,319,134,185
3550,21895,1925,10626,1297,19970,319,134,185
3555,21926,1928,10641,1298,19998,319,134,185
3560,21957,1931,10659,1301,20026,319,134,185
3565,21988,1935,10673,1304,20053,319,134,185
3570,22019,1939,10686,1305,20079,319,134,185
3575,22050,1944,10699,1309,20105,319,134,185
3580,22081,1949,10712,1312,20131,319,134,185
3585,22112,1954,10726,1316,20157,319,134,185
3590,22143,1961,10739,1320,20182,319,134,185
3595,22174,1966,10750,1322,20208,319,134,185
3600,22205,1969,10764,1324,20235,319,134,185
3605,22236,1973,10777,1328,20263,319,134,185
3610,22267,1975,10789,1328,20292,319,134,185
3615,22298,1977,10803,1328,20321,319,134,185
3620,22329,1979,10818,1329,20350,319,134,185
3625,22360,1981,10829,1331,20379,319,134,185
3630,22391,1984,10847,1333,20407,319,134,185
3635,22422,1986,10864,1335,20436,319,134,185
3640,22453,1987,10879,1335,20466,320,135,185
3645,22484,1989,10890,1336,20495,321,136,185
3650,22515,1989,10904,1336,20526,322,137,185
3655,22546,1989,10920,1336,20557,323,137,186
3660,22577,1989,10935,1336,20588,323,137,186
3665,22608,1989,10951,1336,20619,323,137,186
3670,22639,1989,10968,1336,20650,323,137,186
3675,22670,1989,10983,1336,20681,323,137,186
3680,22701,1989,10998,1336,20712,323,137,186
3685,22732,1989,11011,1336,20743,323,137,186
3690,22763,1989,11026,1336,20774,323,137,186
3695,22794,1989,11042,1336,20804,323,137,186
3700,22825,1992,11057,1339,20833,323,137,186
3705,22856,1993,11074,1340,20862,323,137,186
3710,22887,1997,11093,1343,20888,323,137,186
3715,22918,2002,11108,1347,20915,323,137,186
3720,22949,2007,11126,1351,20940,323,137,186
3725,22980,2011,11140,1355,20969,323,137,186
3730,23011,2013,11157,1355,20998,323,137,186
3735,23042,2015,11173,1357,21027,323,137,186
3740,23073,2017,11187,1359,21056,323,137,186
3745,23104,2019,11202,1360,21085,323,137,186
3750,23135,2021,11217,1361,21114,323,137,186
3755,23166,2024,11233,1361,21142,323,137,186
3760,23197,2027,11241,1361,21167,323,137,186
3765,23228,2034,11258,1366,21191,323,137,186
3770,23259,2040,11267,1370,21218,323,137,186
3775,23290,2046,11288,1375,21242,323,137,186
3780,23321,2053,11300,1380,21267,323,137,186
3785,23352,2056,11316,1382,21296,324,138,186
3790,23383,2058,11326,1382,21325,325,139,186
3795,23414,2060,11340,1383,21353,326,139,187
3800,23445,2064,11359,1386,21380,326,139,187
3805,23476,2068,11371,1389,21408,326,139,187
3810,23507,2070,11388,1390,21436,326,139,187
3815,23538,2073,11404,1392,21465,326,139,187
3820,23569,2076,11421,1394,21493,326,139,187
3825,23600,2077,11436,1394,21523,326,139,187
3830,23631,2079,11450,1395,21552,326,139,187
3835,23662,2081,11464,1397,21581,326,139,187
3840,23693,2084,11477,1398,21609,326,139,187
3845,23724,2086,11493,1400,21637,326,139,187
3850,23755,2087,11503,1401,21668,326,139,187
3855,23786,2087,11512,1401,21699,326,139,187
3860,23817,2087,11529,1401,21730,326,139,187
3865,23848,2087,11547,1401,21761,326,139,187
3870,23879,2087,11566,1401,21792,326,139,187
3875,23910,2087,11584,1401,21823,326,139,187
3880,23941,2087,11600,1401,21854,326,139,187
3885,23972,2087,11612,1401,21885,326,139,187
3890,24003,2087,11632,1401,21916,327,140,187
3895,24034,2087,11648,1401,21945,328,141,187
3900,24065,2088,11662,1402,21975,329,141,188
3905,24096,2090,11675,1403,22005,329,141,188
3910,24127,2092,11687,1405,22034,329,141,188
3915,24158,2094,11698,1407,22064,329,141,188
3920,24189,2095,11710,1407,22094,329,141,188
3925,24220,2096,11725,1408,22124,329,141,188
3930,24251,2097,11738,1408,22153,329,141,188
3935,24282,2099,11751,1409,22183,329,141,188
3940,24313,2100,11767,1409,22213,329,141,188
3945,24344,2102,11785,1410,22242,329,141,188
3950,24375,2106,11801,1412,22268,329,141,188
3955,24406,2113,11818,1418,22293,330,141,189
3960,24437,2117,11828,1420,22319,331,141,190
3965,24468,2121,11842,1424,22347,331,141,190
3970,24499,2125,11857,1427,22374,331,141,190
3975,24530,2129,11874,1431,22401,331,141,190
3980,24561,2133,11892,1433,22428,331,141,190
3985,24592,2136,11903,1433,22456,331,141,190
3990,24623,2140,11916,1434,22483,331,141,190
3995,24654,2143,11929,1436,22511,331,141,190
4000,24685,2146,11938,1438,22539,331,141,190
4005,24716,2151,11957,1442,22565,331,141,190
4010,24747,2156,11972,1445,22591,331,141,190
4015,24778,2159,11987,1448,22618,332,141,191
4020,24809,2163,12005,1451,22646,333,142,191
4025,24840,2164,12022,1452,22676,333,142,191
4030,24871,2165,12039,1453,22706,333,142,191
4035,24902,2166,12049,1453,22736,333,142,191
4040,24933,2167,12063,1454,22766,333,142,191
4045,24964,2168,12077,1454,22796,333,142,191
4050,24995,2169,12087,1454,22826,333,142,191
4055,25026,2170,12095,1454,22856,333,142,191
4060,25057,2171,12111,1455,22886,333,142,191
4065,25088,2172,12124,1456,22916,333,142,191
4070,25119,2176,12142,1459,22941,333,142,191
4075,25150,2183,12155,1464,22966,333,142,191
4080,25181,2188,12173,1467,22992,333,142,191
4085,25212,2189,12186,1468,23023,333,142,191
4090,25243,2189,12201,1468,23054,333,142,191
4095,25274,2189,12215,1468,23085,333,142,191
4100,25305,2189,12225,1468,23116,333,142,191
4105,25336,2189,12238,1468,23147,333,142,191
4110,25367,2189,12253,1468,23178,333,142,191
4115,25398,2189,12263,1468,23209,333,142,191
4120,25429,2189,12278,1468,23240,333,142,191
4125,25460,2189,12288,1468,23271,333,142,191
4130,25491,2191,12302,1469,23299,333,142,191
4135,25522,2194,12315,1471,23327,334,143,191
4140,25553,2197,12330,1474,23355,335,143,192
4145,25584,2200,12343,1476,23383,335,143,192
4150,25615,2203,12360,1479,23411,335,143,192
4155,25646,2205,12376,1480,23441,335,143,192
4160,25677,2206,12394,1480,23471,335,143,192
4165,25708,2207,12414,1481,23501,335,143,192
4170,25739,2208,12427,1482,23531,336,143,193
4175,25770,2209,12439,1482,23561,337,143,194
4180,25801,2210,12456,1482,23591,338,143,195
4185,25832,2212,12473,1484,23620,339,143,196
4190,25863,2215,12488,1486,23648,340,143,197
4195,25894,2219,12498,1488,23674,341,143,198
4200,25925,2226,12514,1493,23696,342,143,199
4205,25956,2231,12529,1497,23725,342,143,199
4210,25987,2234,12543,1498,23753,342,143,199
4215,26018,2236,12561,1500,23782,342,143,199
4220,26049,2238,12578,1502,23811,342,143,199
4225,26080,2240,12592,1502,23840,342,143,199
4230,26111,2242,12606,1503,23869,342,143,199
4235,26142,2244,12616,1504,23898,342,143,199
4240,26173,2246,12627,1504,23927,342,143,199
4245,26204,2249,12648,1507,23955,342,143,199
4250,26235,2251,12666,1509,23984,342,143,199
4255,26266,2254,12684,1511,24012,342,143,199
4260,26297,2258,12700,1514,24039,342,143,199
4265,26328,2258,12714,1514,24070,342,143,199
4270,26359,2258,12731,1514,24101,342,143,199
4275,26390,2258,12742,1514,24132,342,143,199
4280,26421,2258,12761,1514,24163,342,143,199
4285,26452,2258,12776,1514,24194,342,143,199
4290,26483,2258,12791,1514,24225,342,143,199
4295,26514,2258,12808,1514,24256,342,143,199
4300,26545,2258,12824,1514,24287,342,143,199
4305,26576,2258,12836,1514,24318,343,143,200
4310,26607,2258,12852,1514,24349,344,144,200
4315,26638,2258,12867,1514,24380,345,144,201
4320,26669,2258,12881,1514,24410,346,144,202
4325,26700,2259,12898,1515,24441,346,144,202
4330,26731,2260,12912,1516,24471,346,144,202
4335,26762,2261,12929,1517,24501,346,144,202
4340,26793,2262,12946,1517,24531,346,144,202
4345,26824,2263,12962,1517,24561,346,144,202
4350,26855,2264,12987,1518,24591,346,144,202
4355,26886,2265,13000,1519,24621,346,144,202
4360,26917,2266,13013,1519,24651,346,144,202
4365,26948,2268,13029,1520,24680,347,145,202
4370,26979,2274,13046,1525,24705,348,146,202
4375,27010,2281,13062,1531,24728,349,147,202
4380,27041,2290,13079,1537,24749,350,147,203
4385,27072,2293,13099,1539,24778,350,147,203
4390,27103,2295,13115,1541,24808,350,147,203
4395,27134,2296,13133,1542,24838,350,147,203
4400,27165,2297,13150,1542,24868,350,147,203
4405,27196,2298,13162,1542,24898,350,147,203
4410,27227,2299,13175,1542,24928,350,147,203
4415,27258,2300,13195,1543,24958,350,147,203
4420,27289,2301,13213,1543,24988,350,147,203
4425,27320,2302,13229,1543,25017,350,147,203
4430,27351,2303,13239,1543,25048,350,147,203
4435,27382,2304,13257,1543,25077,350,147,203
4440,27413,2305,13269,1544,25108,350,147,203
4445,27444,2307,13280,1544,25137,350,147,203
4450,27475,2309,13291,1545,25166,350,147,203
4455,27506,2312,13305,1546,25194,350,147,203
4460,27537,2315,13318,1548,25222,350,147,203
4465,27568,2317,13333,1548,25251,350,147,203
4470,27599,2320,13345,1549,25279,350,147,203
4475,27630,2322,13355,1549,25308,350,147,203
4480,27661,2324,13367,1549,25337,350,147,203
4485,27692,2328,13384,1553,25364,350,147,203
4490,27723,2334,13395,1556,25389,350,147,203
4495,27754,2341,13406,1561,25412,351,148,203
4500,27785,2351,13427,1569,25432,352,149,203
4505,27816,2354,13436,1572,25462,352,149,203
4510,27847,2355,13451,1572,25492,352,149,203
4515,27878,2356,13465,1572,25522,352,149,203
4520,27909,2357,13484,1573,25552,352,149,203
4525,27940,2358,13500,1573,25582,352,149,203
4530,27971,2359,13515,1573,25612,352,149,203
4535,28002,2360,13528,1573,25642,352,149,203
4540,28033,2361,13542,1573,25672,352,149,203
4545,28064,2362,13559,1573,25702,352,149,203
4550,28095,2363,13570,1574,25732,352,149,203
4555,28126,2364,13580,1574,25762,352,149,203
4560,28157,2365,13595,1575,25792,352,149,203
4565,28188,2367,13610,1576,25820,352,149,203
4570,28219,2371,13626,1578,25848,352,149,203
4575,28250,2373,13643,1579,25877,352,149,203
4580,28281,2375,13655,1580,25906,352,149,203
4585,28312,2377,13673,1581,25935,352,149,203
4590,28343,2379,13680,1581,25964,352,149,203
4595,28374,2381,13693,1581,25993,352,149,203
4600,28405,2383,13705,1583,26022,352,149,203
4605,28436,2386,13719,1585,26049,352,149,203
4610,28467,2390,13736,1587,26075,352,149,203
4615,28498,2396,13751,1593,26100,352,149,203
4620,28529,2403,13770,1598,26121,352,149,203
4625,28560,2408,13784,1602,26152,353,149,204
4630,28591,2409,13796,1603,26182,354,150,204
4635,28622,2411,13815,1604,26211,355,150,205
4640,28653,2412,13824,1604,26241,356,150,206
4645,28684,2413,13837,1604,26271,357,151,206
4650,28715,2415,13853,1606,26300,357,151,206
4655,28746,2416,13872,1607,26330,357,151,206
4660,28777,2418,13887,1608,26359,357,151,206
4665,28808,2420,13902,1609,26388,357,151,206
4670,28839,2421,13915,1609,26418,357,151,206
4675,28870,2423,13930,1611,26447,357,151,206
4680,28901,2424,13941,1612,26477,357,151,206
4685,28932,2427,13956,1614,26504,357,151,206
4690,28963,2429,13973,1616,26534,357,151,206
4695,28994,2430,13985,1616,26564,357,151,206
4700,29025,2431,13993,1616,26594,357,151,206
4705,29056,2432,14006,1616,26624,357,151,206
4710,29087,2433,14022,1616,26654,357,151,206
4715,29118,2434,14038,1616,26684,357,151,206
4720,29149,2435,14053,1617,26714,357,151,206
4725,29180,2437,14069,1619,26743,357,151,206
4730,29211,2440,14085,1621,26768,357,151,206
4735,29242,2446,14106,1625,26793,357,151,206
4740,29273,2452,14122,1630,26817,357,151,206
4745,29304,2459,14136,1636,26845,358,151,207
4750,29335,2461,14148,1636,26874,359,152,207
4755,29366,2464,14161,1638,26902,360,152,208
4760,29397,2466,14175,1638,26931,360,152,208
4765,29428,2469,14189,1639,26959,360,152,208
4770,29459,2472,14209,1642,26987,360,152,208
4775,29490,2474,14223,1643,27016,360,152,208
4780,29521,2476,14242,1644,27045,360,152,208
4785,29552,2478,14260,1645,27073,360,152,208
4790,29583,2483,14275,1650,27100,360,152,208
4795,29614,2485,14288,1651,27129,360,152,208
4800,29645,2487,14306,1652,27158,360,152,208
4805,29676,2490,14326,1655,27186,360,152,208
4810,29707,2493,14341,1657,27214,360,152,208
4815,29738,2495,14355,1657,27243,360,152,208
4820,29769,2497,14371,1659,27272,360,152,208
4825,29800,2499,14392,1660,27301,360,152,208
4830,29831,2501,14407,1661,27330,360,152,208
4835,29862,2504,14423,1662,27358,360,152,208
4840,29893,2507,14436,1664,27386,360,152,208
4845,29924,2509,14453,1666,27415,360,152,208
4850,29955,2511,14467,1668,27444,360,152,208
4855,29986,2514,14485,1669,27470,360,152,208
4860,30017,2517,14500,1671,27500,360,152,208
4865,30048,2520,14517,1674,27528,361,152,209
4870,30079,2521,14529,1674,27558,361,152,209
4875,30110,2523,14548,1676,27587,361,152,209
4880,30141,2524,14560,1677,27617,361,152,209
4885,30172,2526,14571,1679,27646,361,152,209
4890,30203,2527,14588,1679,27676,361,152,209
4895,30234,2530,14599,1680,27704,361,152,209
4900,30265,2534,14616,1684,27731,361,152,209
4905,30296,2537,14629,1686,27759,361,152,209
4910,30327,2539,14643,1688,27788,361,152,209
4915,30358,2541,14657,1690,27816,361,152,209
4920,30389,2545,14671,1693,27842,361,152,209
4925,30420,2548,14688,1695,27872,361,152,209
4930,30451,2549,14703,1696,27902,361,152,209
4935,30482,2550,14716,1696,27932,361,152,209
4940,30513,2551,14730,1697,27962,361,152,209
4945,30544,2552,14747,1697,27992,361,152,209
4950,30575,2553,14763,1698,28022,361,152,209
4955,30606,2554,14786,1699,28052,361,152,209
4960,30637,2555,14801,1700,28082,361,152,209
4965,30668,2556,14819,1701,28112,361,152,209
4970,30699,2560,14836,1704,28139,361,152,209
4975,30730,2564,14847,1707,28166,361,152,209
4980,30761,2568,14859,1709,28193,361,152,209
4985,30792,2572,14879,1713,28220,361,152,209
4990,30823,2573,14895,1713,28250,361,152,209
4995,30854,2574,14909,1713,28280,361,152,209
5000,30885,2575,14923,1714,28310,361,152,209
5005,30916,2576,14938,1714,28340,361,152,209
5010,30947,2577,14954,1715,28370,361,152,209
5015,30978,2578,14969,1716,28400,361,152,209
5020,31009,2579,14989,1717,28430,361,152,209
5025,31040,2581,15003,1719,28459,361,152,209
5030,31071,2582,15019,1720,28489,361,152,209
5035,31102,2583,15030,1720,28519,361,152,209
5040,31133,2585,15046,1721,28548,361,152,209
5045,31164,2588,15058,1723,28576,361,152,209
5050,31195,2590,15069,1724,28605,361,152,209
5055,31226,2592,15075,1725,28634,361,152,209
5060,31257,2594,15092,1726,28663,361,152,209
5065,31288,2595,15112,1727,28693,361,152,209
5070,31319,2595,15126,1727,28724,361,152,209
5075,31350,2595,15141,1727,28755,362,152,210
5080,31381,2595,15155,1727,28786,363,152,211
5085,31412,2595,15170,1727,28817,364,152,212
5090,31443,2597,15183,1728,28845,365,152,213
5095,31474,2604,15202,1733,28868,366,152,214
5100,31505,2610,15216,1738,28893,367,153,214
5105,31536,2615,15229,1741,28921,367,153,214
5110,31567,2616,15242,1741,28951,367,153,214
5115,31598,2617,15257,1741,28981,367,153,214
5120,31629,2618,15273,1742,29011,367,153,214
5125,31660,2619,15284,1742,29041,367,153,214
5130,31691,2620,15298,1743,29071,367,153,214
5135,31722,2621,15316,1743,29101,367,153,214
5140,31753,2622,15334,1743,29131,367,153,214
5145,31784,2623,15351,1743,29161,367,153,214
5150,31815,2624,15359,1743,29190,368,153,215
5155,31846,2627,15376,1745,29219,369,154,215
5160,31877,2627,15389,1745,29250,369,154,215
5165,31908,2627,15406,1745,29281,369,154,215
5170,31939,2627,15420,1745,29312,369,154,215
5175,31970,2627,15437,1745,29343,369,154,215
5180,32001,2627,15454,1745,29374,369,154,215
5185,32032,2627,15467,1745,29405,369,154,215
5190,32063,2627,15483,1745,29436,369,154,215
5195,32094,2627,15500,1745,29467,369,154,215
5200,32125,2627,15513,1745,29498,369,154,215
5205,32156,2628,15529,1746,29528,369,154,215
5210,32187,2633,15542,1749,29554,370,155,215
5215,32218,2639,15557,1752,29577,371,156,215
5220,32249,2645,15573,1758,29602,372,157,215
5225,32280,2651,15592,1763,29629,372,157,215
5230,32311,2655,15605,1765,29656,372,157,215
5235,32342,2659,15618,1768,29683,372,157,215
5240,32373,2662,15630,1769,29711,372,157,215
5245,32404,2665,15647,1772,29739,372,157,215
5250,32435,2669,15666,1775,29766,372,157,215
5255,32466,2671,15682,1777,29795,372,157,215
5260,32497,2674,15702,1779,29823,372,157,215
5265,32528,2677,15722,1780,29851,372,157,215
5270,32559,2680,15741,1782,29879,372,157,215
5275,32590,2681,15748,1782,29909,372,157,215
5280,32621,2682,15761,1782,29939,372,157,215
5285,32652,2683,15774,1783,29969,372,157,215
5290,32683,2685,15787,1784,29998,372,157,215
5295,32714,2686,15798,1785,30028,372,157,215
5300,32745,2687,15814,1786,30058,372,157,215
5305,32776,2688,15829,1787,30088,372,157,215
5310,32807,2689,15846,1788,30118,372,157,215
5315,32838,2690,15865,1788,30148,372,157,215
5320,32869,2691,15877,1788,30178,372,157,215
5325,32900,2692,15893,1789,30208,372,157,215
5330,32931,2694,15905,1790,30235,373,158,215
5335,32962,2701,15923,1796,30257,374,158,216
5340,32993,2709,15942,1803,30281,376,160,216
5345,33024,2711,15951,1804,30313,378,161,217
5350,33055,2712,15969,1805,30343,380,161,219
5355,33086,2714,15983,1806,30372,382,162,220
5360,33117,2717,16000,1807,30400,384,162,222
5365,33148,2718,16016,1807,30430,386,163,223
5370,33179,2719,16026,1808,30460,388,165,223
5375,33210,2720,16041,1809,30490,389,166,223
5380,33241,2721,16058,1810,30520,390,166,224
5385,33272,2722,16068,1810,30550,391,166,225
5390,33303,2723,16086,1811,30580,392,167,225
5395,33334,2724,16102,1812,30609,393,167,226
5400,33365,2726,16118,1813,30638,394,168,226
5405,33396,2728,16133,1815,30668,394,168,226
5410,33427,2729,16152,1816,30698,394,168,226
5415,33458,2730,16168,1817,30728,394,168,226
5420,33489,2731,16192,1818,30758,394,168,226
5425,33520,2732,16208,1818,30788,394,168,226
5430,33551,2733,16223,1819,30818,394,168,226
5435,33582,2734,16236,1819,30848,394,168,226
5440,33613,2735,16255,1819,30878,394,168,226
5445,33644,2736,16268,1819,30908,394,168,226
5450,33675,2738,16283,1820,30936,394,168,226
5455,33706,2742,16299,1824,30962,394,168,226
5460,33737,2749,16314,1829,30986,394,168,226
5465,33768,2753,16329,1831,31015,394,168,226
5470,33799,2756,16343,1834,31043,394,168,226
5475,33830,2759,16359,1836,31071,395,168,227
5480,33861,2762,16379,1838,31099,396,169,227
5485,33892,2765,16392,1838,31127,397,169,228
5490,33923,2768,16407,1840,31155,398,169,229
5495,33954,2771,16423,1841,31183,399,170,229
5500,33985,2774,16438,1843,31211,400,171,229
5505,34016,2777,16456,1845,31239,401,171,230
5510,34047,2781,16464,1846,31264,402,171,231
5515,34078,2788,16479,1851,31288,403,172,231
5520,34109,2793,16497,1854,31314,404,172,232
5525,34140,2796,16513,1855,31344,405,172,233
5530,34171,2800,16531,1858,31371,405,172,233
5535,34202,2803,16548,1860,31399,405,172,233
5540,34233,2806,16565,1862,31427,405,172,233
5545,34264,2810,16583,1865,31454,405,172,233
5550,34295,2814,16596,1867,31481,405,172,233
5555,34326,2817,16609,1868,31509,405,172,233
5560,34357,2820,16626,1870,31537,405,172,233
5565,34388,2825,16642,1872,31563,405,172,233
5570,34419,2830,16657,1875,31588,405,172,233
5575,34450,2836,16673,1879,31613,405,172,233
5580,34481,2841,16691,1884,31640,405,172,233
5585,34512,2842,16705,1884,31670,406,172,234
5590,34543,2844,16722,1886,31699,407,172,235
5595,34574,2844,16734,1886,31730,407,172,235
5600,34605,2844,16748,1886,31761,407,172,235
5605,34636,2844,16761,1886,31792,407,172,235
5610,34667,2844,16780,1886,31823,407,172,235
5615,34698,2844,16792,1886,31854,407,172,235
5620,34729,2844,16807,1886,31885,407,172,235
5625,34760,2845,16819,1887,31915,407,172,235
5630,34791,2846,16834,1887,31944,407,172,235
5635,34822,2848,16851,1889,31973,408,172,236
5640,34853,2851,16868,1892,32002,409,172,237
5645,34884,2853,16880,1894,32031,409,172,237
5650,34915,2854,16894,1895,32061,409,172,237
5655,34946,2856,16908,1896,32090,409,172,237
5660,34977,2857,16920,1896,32120,409,172,237
5665,35008,2858,16936,1897,32150,409,172,237
5670,35039,2860,16952,1898,32179,409,172,237
5675,35070,2861,16965,1899,32209,409,172,237
5680,35101,2863,16985,1901,32238,409,172,237
5685,35132,2865,16994,1902,32267,409,172,237
5690,35163,2871,17013,1908,32290,409,172,237
5695,35194,2878,17029,1913,32315,409,172,237
5700,35225,2884,17043,1918,32341,409,172,237
5705,35256,2887,17061,1921,32368,409,172,237
5710,35287,2890,17073,1923,32397,409,172,237
5715,35318,2892,17088,1925,32426,409,172,237
5720,35349,2894,17098,1926,32455,409,172,237
5725,35380,2896,17114,1927,32484,409,172,237
5730,35411,2898,17131,1928,32513,409,172,237
5735,35442,2900,17145,1929,32542,409,172,237
5740,35473,2902,17160,1930,32571,409,172,237
5745,35504,2904,17177,1932,32600,410,172,238
5750,35535,2906,17193,1934,32629,411,172,239
5755,35566,2908,17207,1935,32658,412,172,240
5760,35597,2910,17224,1937,32687,413,173,240
5765,35628,2912,17238,1938,32716,414,174,240
5770,35659,2914,17251,1938,32745,414,174,240
5775,35690,2917,17264,1940,32773,414,174,240
5780,35721,2920,17279,1942,32801,414,174,240
5785,35752,2923,17297,1944,32829,414,174,240
5790,35783,2925,17312,1945,32858,414,174,240
5795,35814,2926,17327,1945,32888,414,174,240
5800,35845,2928,17341,1946,32917,414,174,240
5805,35876,2931,17360,1947,32945,414,174,240
5810,35907,2936,17376,1951,32970,414,174,240
5815,35938,2941,17390,1954,32995,414,174,240
5820,35969,2948,17410,1960,33020,414,174,240
5825,36000,2952,17427,1963,33048,414,174,240
5830,36031,2953,17440,1964,33078,414,174,240
5835,36062,2955,17457,1966,33107,414,174,240
5840,36093,2956,17476,1967,33137,414,174,240
5845,36124,2958,17493,1968,33166,414,174,240
5850,36155,2959,17511,1969,33196,414,174,240
5855,36186,2960,17520,1969,33226,414,174,240
5860,36217,2962,17536,1971,33255,414,174,240
5865,36248,2964,17553,1973,33282,414,174,240
5870,36279,2968,17573,1976,33311,414,174,240
5875,36310,2970,17589,1978,33340,415,174,241
5880,36341,2971,17600,1979,33370,416,174,242
5885,36372,2976,17614,1982,33396,417,174,243
5890,36403,2979,17630,1984,33423,417,174,243
5895,36434,2984,17647,1987,33450,417,174,243
5900,36465,2985,17658,1988,33479,417,174,243
5905,36496,2987,17671,1989,33509,417,174,243
5910,36527,2988,17687,1990,33538,417,174,243
5915,36558,2990,17700,1992,33568,417,174,243
5920,36589,2990,17713,1992,33599,417,174,243
5925,36620,2990,17728,1992,33630,417,174,243
5930,36651,2992,17740,1994,33659,417,174,243
5935,36682,2994,17753,1994,33688,417,174,243
5940,36713,2997,17769,1997,33716,417,174,243
5945,36744,3002,17782,1998,33742,418,175,243
5950,36775,3007,17797,2003,33768,419,176,243
5955,36806,3012,17815,2007,33794,420,177,243
5960,36837,3016,17826,2010,33821,421,177,244
5965,36868,3021,17840,2012,33847,422,178,244
5970,36899,3027,17855,2017,33872,423,178,245
5975,36930,3034,17869,2021,33896,424,178,246
5980,36961,3039,17883,2023,33921,425,179,246
5985,36992,3045,17895,2027,33947,426,179,247
5990,37023,3051,17909,2030,33970,427,180,247
5995,37054,3059,17926,2037,33995,428,180,248
6000,37085,3061,17944,2038,34024,430,182,248
6005,37116,3062,17959,2038,34053,430,182,248
6010,37147,3064,17971,2039,34082,430,182,248
6015,37178,3066,17983,2040,34112,430,182,248
6020,37209,3067,17993,2040,34142,430,182,248
6025,37240,3068,18007,2040,34171,430,182,248
6030,37271,3070,18022,2042,34201,430,182,248
6035,37302,3071,18039,2043,34231,430,182,248
6040,37333,3072,18056,2043,34261,430,182,248
6045,37364,3073,18078,2044,34290,430,182,248
6050,37395,3074,18093,2045,34321,430,182,248
6055,37426,3074,18109,2045,34352,430,182,248
6060,37457,3074,18126,2045,34383,430,182,248
6065,37488,3074,18136,2045,34414,430,182,248
6070,37519,3074,18143,2045,34445,430,182,248
6075,37550,3074,18161,2045,34476,430,182,248
6080,37581,3074,18179,2045,34507,430,182,248
6085,37612,3074,18194,2045,34538,430,182,248
6090,37643,3074,18207,2045,34569,430,182,248
6095,37674,3075,18223,2046,34599,430,182,248
6100,37705,3076,18236,2046,34629,430,182,248
6105,37736,3077,18253,2046,34657,430,182,248
6110,37767,3081,18268,2048,34684,431,183,248
6115,37798,3088,18284,2055,34706,433,184,249
6120,37829,3098,18299,2062,34726,435,184,251
6125,37860,3102,18314,2066,34758,437,185,252
6130,37891,3105,18328,2067,34786,438,186,252
6135,37922,3107,18343,2068,34815,439,187,252
6140,37953,3109,18357,2070,34844,440,188,252
6145,37984,3110,18372,2070,34874,441,189,252
6150,38015,3111,18389,2071,34904,442,189,253
6155,38046,3113,18409,2072,34933,443,189,254
6160,38077,3115,18424,2073,34962,444,189,255
6165,38108,3115,18441,2073,34993,444,189,255
6170,38139,3115,18457,2073,35024,444,189,255
6175,38170,3115,18474,2073,35055,444,189,255
6180,38201,3115,18486,2073,35086,444,189,255
6185,38232,3115,18499,2073,35117,444,189,255
6190,38263,3115,18516,2073,35148,444,189,255
6195,38294,3115,18528,2073,35179,444,189,255
6200,38325,3115,18544,2073,35210,444,189,255
6205,38356,3115,18558,2073,35241,444,189,255
6210,38387,3115,18573,2073,35272,444,189,255
6215,38418,3115,18587,2073,35303,444,189,255
6220,38449,3115,18605,2073,35334,444,189,255
6225,38480,3115,18613,2073,35365,444,189,255
6230,38511,3117,18625,2074,35393,445,189,256
6235,38542,3121,18639,2077,35420,446,190,256
6240,38573,3126,18655,2081,35446,447,190,257
6245,38604,3132,18670,2085,35471,449,191,258
6250,38635,3141,18683,2092,35493,451,192,259
6255,38666,3148,18697,2096,35518,453,192,261
6260,38697,3149,18710,2096,35548,453,192,261
6265,38728,3150,18725,2096,35578,453,192,261
6270,38759,3151,18745,2096,35608,453,192,261
6275,38790,3152,18759,2096,35638,453,192,261
6280,38821,3153,18771,2097,35668,453,192,261
6285,38852,3154,18789,2098,35698,453,192,261
6290,38883,3155,18809,2099,35728,453,192,261
6295,38914,3156,18823,2099,35758,453,192,261
6300,38945,3157,18840,2100,35788,453,192,261
6305,38976,3158,18856,2101,35818,453,192,261
6310,39007,3159,18871,2101,35848,453,192,261
6315,39038,3160,18889,2101,35878,453,192,261
6320,39069,3161,18904,2101,35908,453,192,261
6325,39100,3162,18920,2102,35938,453,192,261
6330,39131,3163,18933,2102,35968,453,192,261
6335,39162,3164,18949,2103,35998,453,192,261
6340,39193,3165,18966,2103,36028,453,192,261
6345,39224,3166,18984,2104,36058,453,192,261
6350,39255,3168,18996,2106,36087,453,192,261
6355,39286,3169,19011,2107,36115,453,192,261
6360,39317,3174,19029,2110,36142,454,193,261
6365,39348,3179,19049,2114,36169,454,193,261
6370,39379,3185,19067,2119,36194,454,193,261
6375,39410,3190,19081,2124,36220,454,193,261
6380,39441,3192,19095,2124,36249,454,193,261
6385,39472,3193,19110,2125,36279,454,193,261
6390,39503,3194,19128,2126,36309,454,193,261
6395,39534,3195,19147,2127,36339,454,193,261
6400,39565,3196,19163,2128,36369,454,193,261
6405,39596,3197,19174,2128,36399,454,193,261
6410,39627,3198,19192,2128,36429,454,193,261
6415,39658,3199,19208,2128,36459,454,193,261
6420,39689,3200,19224,2129,36489,454,193,261
6425,39720,3201,19239,2130,36519,454,193,261
6430,39751,3202,19255,2131,36549,454,193,261
6435,39782,3203,19266,2131,36579,454,193,261
6440,39813,3204,19279,2131,36609,454,193,261
6445,39844,3205,19298,2131,36639,454,193,261
6450,39875,3206,19309,2131,36669,454,193,261
6455,39906,3207,19325,2132,36699,454,193,261
6460,39937,3208,19336,2133,36729,454,193,261
6465,39968,3209,19347,2133,36758,455,193,262
6470,39999,3214,19358,2138,36785,457,194,263
6475,40030,3215,19371,2138,36813,459,195,264
6480,40061,3220,19395,2143,36838,461,196,265
6485,40092,3228,19407,2150,36864,461,196,265
6490,40123,3232,19420,2153,36891,461,196,265
6495,40154,3238,19437,2159,36915,461,196,265
6500,40185,3243,19451,2163,36942,461,196,265
6505,40216,3245,19462,2164,36971,461,196,265
6510,40247,3248,19477,2166,36998,461,196,265
6515,40278,3252,19491,2169,37025,461,196,265
6520,40309,3256,19506,2172,37053,461,196,265
6525,40340,3259,19520,2174,37081,461,196,265
6530,40371,3260,19537,2175,37111,461,196,265
6535,40402,3261,19550,2175,37140,461,196,265
6540,40433,3263,19561,2176,37170,461,196,265
6545,40464,3264,19575,2176,37200,461,196,265
6550,40495,3265,19593,2177,37230,461,196,265
6555,40526,3266,19606,2177,37260,461,196,265
6560,40557,3267,19615,2177,37290,461,196,265
6565,40588,3268,19632,2177,37320,461,196,265
6570,40619,3269,19647,2178,37350,461,196,265
6575,40650,3270,19659,2179,37380,461,196,265
6580,40681,3271,19670,2179,37410,461,196,265
6585,40712,3272,19681,2179,37440,461,196,265
6590,40743,3273,19696,2179,37469,462,196,266
6595,40774,3277,19712,2182,37497,463,197,266
6600,40805,3280,19729,2183,37525,464,198,266
6605,40836,3282,19739,2184,37554,464,198,266
6610,40867,3284,19757,2186,37583,464,198,266
6615,40898,3286,19773,2188,37612,464,198,266
6620,40929,3288,19790,2189,37641,464,198,266
6625,40960,3290,19804,2189,37670,464,198,266
6630,40991,3292,19818,2190,37699,464,198,266
6635,41022,3295,19834,2192,37727,464,198,266
6640,41053,3298,19855,2193,37755,464,198,266
6645,41084,3301,19872,2196,37783,464,198,266
6650,41115,3306,19890,2200,37809,464,198,266
6655,41146,3311,19908,2202,37835,464,198,266
6660,41177,3315,19926,2204,37862,464,198,266
6665,41208,3316,19946,2205,37892,464,198,266
6670,41239,3317,19962,2205,37922,464,198,266
6675,41270,3318,19975,2205,37952,464,198,266
6680,41301,3319,19990,2205,37982,464,198,266
6685,41332,3320,20004,2205,38012,464,198,266
6690,41363,3321,20021,2206,38042,464,198,266
6695,41394,3322,20035,2207,38072,464,198,266
6700,41425,3323,20046,2207,38100,464,198,266
6705,41456,3326,20057,2210,38129,464,198,266
6710,41487,3328,20065,2211,38159,465,198,267
6715,41518,3333,20080,2214,38183,465,198,267
6720,41549,3337,20095,2217,38211,465,198,267
6725,41580,3339,20111,2219,38241,465,198,267
6730,41611,3340,20133,2219,38271,466,199,267
6735,41642,3341,20150,2220,38301,467,199,268
6740,41673,3342,20162,2220,38331,468,199,269
6745,41704,3343,20179,2221,38361,469,200,269
6750,41735,3344,20198,2222,38391,470,200,270
6755,41766,3345,20215,2223,38421,471,201,270
6760,41797,3346,20226,2224,38451,472,201,271
6765,41828,3348,20240,2225,38480,472,201,271
6770,41859,3352,20255,2227,38507,472,201,271
6775,41890,3356,20270,2231,38534,472,201,271
6780,41921,3363,20285,2236,38558,472,201,271
6785,41952,3367,20299,2238,38585,472,201,271
6790,41983,3370,20311,2239,38613,472,201,271
6795,42014,3373,20328,2240,38641,472,201,271
6800,42045,3377,20340,2241,38668,472,201,271
6805,42076,3380,20357,2241,38696,472,201,271
6810,42107,3383,20369,2242,38724,472,201,271
6815,42138,3385,20383,2243,38753,472,201,271
6820,42169,3387,20397,2245,38782,472,201,271
6825,42200,3390,20417,2247,38810,472,201,271
6830,42231,3393,20436,2248,38838,472,201,271
6835,42262,3397,20450,2251,38865,472,201,271
6840,42293,3399,20466,2252,38894,472,201,271
6845,42324,3400,20480,2253,38924,473,202,271
6850,42355,3401,20497,2253,38954,474,203,271
6855,42386,3402,20510,2253,38984,475,203,272
6860,42417,3403,20524,2254,39014,476,204,272
6865,42448,3404,20537,2255,39044,477,204,273
6870,42479,3405,20554,2256,39074,478,205,273
6875,42510,3406,20567,2257,39104,479,205,274
6880,42541,3407,20585,2257,39134,480,206,274
6885,42572,3410,20599,2259,39162,481,206,275
6890,42603,3412,20620,2261,39190,482,207,275
6895,42634,3415,20626,2263,39218,483,207,276
6900,42665,3419,20645,2267,39245,484,208,276
6905,42696,3422,20657,2269,39274,485,208,277
6910,42727,3425,20672,2271,39301,486,208,278
6915,42758,3428,20687,2273,39330,486,208,278
6920,42789,3430,20703,2274,39358,486,208,278
6925,42820,3434,20719,2278,39385,486,208,278
6930,42851,3440,20737,2283,39409,486,208,278
6935,42882,3446,20754,2287,39436,486,208,278
6940,42913,3450,20763,2289,39462,486,208,278
6945,42944,3453,20779,2291,39490,486,208,278
6950,42975,3455,20792,2293,39520,487,209,278
6955,43006,3456,20800,2293,39550,488,209,279
6960,43037,3457,20818,2294,39580,488,209,279
6965,43068,3459,20831,2295,39609,488,209,279
6970,43099,3459,20845,2295,39640,488,209,279
6975,43130,3459,20856,2295,39671,488,209,279
6980,43161,3459,20868,2295,39702,488,209,279
6985,43192,3459,20884,2295,39733,488,209,279
6990,43223,3459,20899,2295,39764,488,209,279
6995,43254,3459,20906,2295,39795,488,209,279
7000,43285,3459,20926,2295,39826,488,209,279
7005,43316,3459,20941,2295,39857,488,209,279
7010,43347,3461,20956,2297,39885,488,209,279
7015,43378,3464,20968,2300,39914,489,210,279
7020,43409,3466,20977,2301,39943,490,211,279
7025,43440,3469,20995,2303,39971,491,211,280
7030,43471,3470,21013,2303,40001,491,211,280
7035,43502,3471,21023,2303,40031,491,211,280
7040,43533,3472,21042,2304,40061,491,211,280
7045,43564,3473,21058,2305,40091,491,211,280
7050,43595,3474,21073,2305,40121,491,211,280
7055,43626,3476,21089,2305,40150,491,211,280
7060,43657,3478,21109,2306,40179,491,211,280
7065,43688,3480,21124,2307,40208,491,211,280
7070,43719,3482,21136,2308,40237,491,211,280
7075,43750,3484,21151,2309,40266,491,211,280
7080,43781,3486,21166,2311,40295,491,211,280
7085,43812,3488,21183,2312,40324,491,211,280
7090,43843,3490,21199,2313,40353,491,211,280
7095,43874,3492,21211,2314,40382,491,211,280
7100,43905,3494,21225,2315,40411,491,211,280
7105,43936,3496,21234,2315,40440,491,211,280
7110,43967,3498,21245,2315,40469,491,211,280
7115,43998,3500,21262,2317,40498,491,211,280
7120,44029,3502,21277,2318,40527,491,211,280
7125,44060,3504,21290,2318,40556,491,211,280
7130,44091,3508,21305,2321,40582,491,211,280
7135,44122,3514,21322,2326,40604,492,211,281
7140,44153,3526,21339,2335,40625,493,212,281
7145,44184,3529,21358,2338,40655,494,213,281
7150,44215,3532,21376,2341,40683,494,213,281
7155,44246,3533,21386,2341,40713,494,213,281
7160,44277,3535,21405,2342,40742,494,213,281
7165,44308,3536,21419,2342,40772,494,213,281
7170,44339,3537,21432,2342,40802,494,213,281
7175,44370,3539,21450,2344,40831,494,213,281
7180,44401,3540,21473,2345,40861,494,213,281
7185,44432,3541,21487,2345,40891,494,213,281
7190,44463,3541,21505,2345,40922,494,213,281
7195,44494,3541,21519,2345,40953,494,213,281
7200,44525,3541,21536,2345,40984,494,213,281
7205,44556,3541,21550,2345,41015,494,213,281
7210,44587,3541,21562,2345,41046,494,213,281
7215,44618,3541,21577,2345,41077,494,213,281
7220,44649,3541,21591,2345,41108,494,213,281
7225,44680,3541,21604,2345,41139,494,213,281
7230,44711,3541,21617,2345,41170,494,213,281
7235,44742,3541,21629,2345,41201,494,213,281
7240,44773,3541,21641,2345,41232,494,213,281
7245,44804,3542,21651,2345,41261,494,213,281
7250,44835,3547,21666,2348,41287,495,214,281
7255,44866,3551,21675,2351,41315,497,215,282
7260,44897,3555,21693,2354,41340,499,217,282
7265,44928,3563,21707,2359,41365,499,217,282
7270,44959,3566,21728,2361,41393,499,217,282
7275,44990,3569,21745,2363,41421,499,217,282
7280,45021,3572,21764,2365,41449,499,217,282
7285,45052,3574,21775,2366,41478,499,217,282
7290,45083,3576,21786,2366,41507,499,217,282
7295,45114,3578,21800,2366,41536,499,217,282
7300,45145,3580,21813,2366,41565,499,217,282
7305,45176,3582,21828,2368,41594,499,217,282
7310,45207,3584,21841,2368,41623,499,217,282
7315,45238,3586,21860,2369,41652,499,217,282
7320,45269,3588,21872,2370,41681,499,217,282
7325,45300,3590,21886,2371,41710,499,217,282
7330,45331,3592,21898,2373,41739,499,217,282
7335,45362,3594,21920,2375,41768,499,217,282
7340,45393,3596,21934,2375,41797,499,217,282
7345,45424,3598,21951,2377,41826,499,217,282
7350,45455,3600,21965,2379,41855,499,217,282
7355,45486,3602,21976,2379,41884,499,217,282
7360,45517,3604,21992,2379,41913,499,217,282
7365,45548,3607,22008,2382,41940,500,217,283
7370,45579,3610,22025,2384,41967,501,217,284
7375,45610,3616,22044,2388,41990,502,217,285
7380,45641,3624,22062,2396,42013,503,218,285
7385,45672,3629,22074,2400,42043,505,219,286
7390,45703,3631,22085,2401,42072,507,221,286
7395,45734,3633,22100,2403,42101,509,221,288
7400,45765,3634,22112,2404,42131,509,221,288
7405,45796,3636,22132,2406,42160,509,221,288
7410,45827,3638,22147,2408,42189,509,221,288
7415,45858,3639,22164,2409,42219,509,221,288
7420,45889,3641,22183,2410,42248,509,221,288
7425,45920,3643,22201,2412,42277,509,221,288
7430,45951,3643,22220,2412,42308,509,221,288
7435,45982,3643,22234,2412,42339,509,221,288
7440,46013,3643,22249,2412,42370,509,221,288
7445,46044,3645,22263,2413,42398,509,221,288
7450,46075,3647,22274,2414,42428,509,221,288
7455,46106,3649,22288,2415,42457,509,221,288
7460,46137,3651,22305,2417,42486,509,221,288
7465,46168,3652,22320,2418,42516,509,221,288
7470,46199,3654,22338,2420,42544,509,221,288
7475,46230,3656,22353,2422,42574,509,221,288
7480,46261,3658,22370,2424,42603,509,221,288
7485,46292,3658,22388,2424,42633,509,221,288
7490,46323,3658,22403,2424,42663,509,221,288
7495,46354,3659,22421,2424,42695,509,221,288
7500,46385,3660,22435,2424,42725,510,221,289
7505,46416,3663,22448,2425,42753,511,221,290
7510,46447,3666,22467,2426,42781,512,222,290
7515,46478,3670,22479,2427,42808,513,223,290
7520,46509,3673,22492,2429,42836,514,224,290
7525,46540,3676,22507,2430,42864,514,224,290
7530,46571,3680,22521,2433,42891,514,224,290
7535,46602,3684,22539,2436,42918,514,224,290
7540,46633,3687,22551,2438,42946,514,224,290
7545,46664,3690,22566,2439,42974,514,224,290
7550,46695,3694,22583,2441,43001,514,224,290
7555,46726,3698,22599,2443,43028,514,224,290
7560,46757,3702,22614,2445,43055,514,224,290
7565,46788,3705,22632,2446,43082,515,225,290
7570,46819,3709,22641,2448,43110,515,225,290
7575,46850,3713,22655,2451,43137,515,225,290
7580,46881,3714,22669,2451,43167,515,225,290
7585,46912,3714,22686,2451,43198,515,225,290
7590,46943,3715,22704,2451,43228,515,225,290
7595,46974,3716,22722,2451,43258,515,225,290
7600,47005,3717,22739,2451,43288,515,225,290
7605,47036,3718,22749,2451,43318,515,225,290
7610,47067,3720,22764,2452,43347,516,225,291
7615,47098,3722,22779,2453,43376,517,225,292
7620,47129,3723,22794,2454,43406,518,225,293
7625,47160,3724,22805,2454,43436,518,225,293
7630,47191,3725,22816,2454,43466,518,225,293
7635,47222,3727,22835,2455,43495,518,225,293
7640,47253,3728,22851,2455,43525,518,225,293
7645,47284,3729,22862,2455,43555,518,225,293
7650,47315,3731,22876,2457,43584,518,225,293
7655,47346,3732,22890,2458,43614,518,225,293
7660,47377,3733,22904,2459,43644,518,225,293
7665,47408,3733,22917,2459,43675,518,225,293
7670,47439,3733,22927,2459,43706,518,225,293
7675,47470,3733,22940,2459,43737,518,225,293
7680,47501,3733,22956,2459,43768,518,225,293
7685,47532,3734,22965,2459,43798,518,225,293
7690,47563,3735,22975,2460,43828,518,225,293
7695,47594,3736,22990,2460,43858,518,225,293
7700,47625,3737,23008,2461,43888,518,225,293
7705,47656,3738,23023,2462,43918,518,225,293
7710,47687,3739,23041,2463,43948,518,225,293
7715,47718,3740,23059,2463,43978,518,225,293
7720,47749,3741,23077,2464,44008,518,225,293
7725,47780,3742,23093,2465,44036,518,225,293
7730,47811,3752,23110,2473,44055,519,226,293
7735,47842,3763,23127,2483,44075,520,227,293
7740,47873,3773,23140,2492,44099,521,228,293
7745,47904,3775,23149,2494,44129,521,228,293
7750,47935,3776,23161,2494,44159,521,228,293
7755,47966,3777,23178,2495,44189,521,228,293
7760,47997,3778,23192,2495,44219,521,228,293
7765,48028,3779,23206,2495,44249,521,228,293
7770,48059,3780,23224,2496,44279,521,228,293
7775,48090,3781,23236,2496,44309,521,228,293
7780,48121,3782,23254,2496,44339,521,228,293
7785,48152,3783,23273,2497,44369,521,228,293
7790,48183,3784,23290,2497,44399,521,228,293
7795,48214,3785,23300,2497,44429,521,228,293
7800,48245,3786,23314,2498,44459,521,228,293
7805,48276,3787,23331,2499,44489,521,228,293
7810,48307,3788,23343,2500,44519,521,228,293
7815,48338,3789,23359,2500,44549,521,228,293
7820,48369,3790,23374,2500,44579,521,228,293
7825,48400,3791,23385,2500,44609,521,228,293
7830,48431,3792,23400,2501,44639,521,228,293
7835,48462,3793,23417,2502,44669,521,228,293
7840,48493,3794,23432,2502,44699,521,228,293
7845,48524,3796,23448,2503,44727,521,228,293
7850,48555,3804,23464,2510,44749,521,228,293
7855,48586,3810,23475,2515,44774,522,228,294
7860,48617,3818,23490,2522,44797,524,229,295
7865,48648,3822,23505,2526,44826,524,229,295
7870,48679,3824,23523,2527,44855,524,229,295
7875,48710,3826,23538,2528,44884,524,229,295
7880,48741,3829,23556,2529,44912,524,229,295
7885,48772,3831,23571,2530,44941,524,229,295
7890,48803,3834,23582,2532,44969,524,229,295
7895,48834,3836,23599,2532,44998,524,229,295
7900,48865,3839,23608,2534,45026,524,229,295
7905,48896,3842,23620,2535,45054,524,229,295
7910,48927,3845,23632,2536,45082,524,229,295
7915,48958,3848,23649,2539,45110,524,229,295
7920,48989,3850,23657,2539,45139,524,229,295
7925,49020,3854,23679,2542,45166,524,229,295
7930,49051,3857,23694,2543,45194,524,229,295
7935,49082,3860,23710,2545,45222,524,229,295
7940,49113,3863,23730,2547,45249,524,229,295
7945,49144,3867,23743,2548,45277,524,229,295
7950,49175,3870,23763,2550,45304,524,229,295
7955,49206,3874,23775,2552,45331,524,229,295
7960,49237,3878,23793,2554,45358,524,229,295
7965,49268,3883,23807,2556,45382,524,229,295
7970,49299,3891,23821,2563,45406,525,230,295
7975,49330,3897,23833,2569,45433,526,231,295
7980,49361,3900,23848,2572,45461,526,231,295
7985,49392,3902,23865,2574,45490,527,232,295
7990,49423,3903,23883,2575,45520,528,232,296
7995,49454,3904,23895,2576,45550,529,232,297
8000,49485,3905,23909,2577,45580,530,232,298
8005,49516,3906,23924,2577,45610,531,233,298
8010,49547,3907,23939,2578,45640,532,233,299
8015,49578,3908,23951,2579,45670,532,233,299
8020,49609,3909,23969,2579,45700,532,233,299
8025,49640,3910,23982,2579,45730,532,233,299
8030,49671,3911,24000,2579,45760,532,233,299
8035,49702,3912,24017,2579,45790,532,233,299
8040,49733,3913,24031,2579,45820,532,233,299
8045,49764,3914,24044,2580,45850,532,233,299
8050,49795,3915,24060,2580,45880,532,233,299
8055,49826,3916,24074,2581,45910,532,233,299
8060,49857,3917,24086,2582,45940,532,233,299
8065,49888,3918,24097,2583,45970,532,233,299
8070,49919,3919,24113,2583,46000,532,233,299
8075,49950,3921,24129,2584,46029,532,233,299
8080,49981,3923,24148,2585,46057,532,233,299
8085,50012,3927,24159,2589,46082,533,233,300
8090,50043,3935,24170,2596,46106,534,234,300
8095,50074,3940,24184,2600,46130,535,235,300
8100,50105,3949,24195,2607,46154,536,235,301
8105,50136,3953,24208,2609,46182,538,235,303
8110,50167,3956,24225,2612,46211,539,235,304
8115,50198,3957,24236,2612,46241,540,235,305
8120,50229,3958,24250,2613,46271,541,235,306
8125,50260,3959,24270,2614,46301,542,236,306
8130,50291,3960,24288,2615,46331,543,237,306
8135,50322,3961,24303,2615,46361,544,238,306
8140,50353,3962,24317,2615,46391,545,238,307
8145,50384,3963,24333,2616,46421,546,239,307
8150,50415,3964,24350,2617,46451,547,240,307
8155,50446,3965,24364,2617,46481,548,240,308
8160,50477,3966,24381,2618,46511,549,240,309
8165,50508,3968,24396,2619,46539,550,240,310
8170,50539,3972,24405,2621,46567,551,240,311
8175,50570,3976,24418,2623,46594,552,240,312
8180,50601,3978,24430,2623,46623,553,241,312
8185,50632,3979,24448,2624,46653,554,241,313
8190,50663,3980,24462,2624,46683,555,242,313
8195,50694,3982,24478,2626,46712,556,243,313
8200,50725,3984,24496,2627,46741,557,244,313
8205,50756,3987,24512,2629,46768,558,245,313
8210,50787,3994,24522,2634,46790,560,245,315
8215,50818,4002,24543,2640,46810,562,246,316
8220,50849,4009,24559,2647,46839,564,247,317
8225,50880,4013,24576,2650,46866,565,248,317
8230,50911,4017,24588,2652,46894,566,249,317
8235,50942,4020,24600,2652,46922,566,249,317
8240,50973,4024,24615,2656,46949,566,249,317
8245,51004,4027,24631,2658,46977,566,249,317
8250,51035,4031,24642,2660,47004,566,249,317
8255,51066,4035,24661,2662,47031,566,249,317
8260,51097,4039,24677,2664,47057,566,249,317
8265,51128,4044,24689,2667,47084,566,249,317
8270,51159,4047,24703,2667,47112,566,249,317
8275,51190,4051,24722,2669,47139,566,249,317
8280,51221,4054,24738,2671,47166,566,249,317
8285,51252,4056,24749,2672,47196,566,249,317
8290,51283,4057,24767,2673,47226,566,249,317
8295,51314,4058,24782,2673,47256,566,249,317
8300,51345,4059,24799,2674,47286,566,249,317
8305,51376,4060,24811,2675,47316,566,249,317
8310,51407,4061,24824,2676,47346,566,249,317
8315,51438,4062,24843,2676,47376,566,249,317
8320,51469,4063,24855,2676,47406,566,249,317
8325,51500,4065,24870,2677,47434,566,249,317
8330,51531,4068,24880,2678,47462,566,249,317
8335,51562,4071,24894,2681,47489,566,249,317
8340,51593,4076,24909,2684,47517,568,249,319
8345,51624,4080,24922,2687,47544,568,249,319
8350,51655,4082,24936,2687,47572,568,249,319
8355,51686,4085,24951,2689,47600,568,249,319
8360,51717,4088,24963,2691,47628,568,249,319
8365,51748,4091,24979,2694,47657,568,249,319
8370,51779,4093,24996,2695,47685,568,249,319
8375,51810,4095,25011,2697,47715,568,249,319
8380,51841,4096,25031,2698,47745,568,249,319
8385,51872,4097,25046,2699,47775,568,249,319
8390,51903,4098,25057,2700,47805,568,249,319
8395,51934,4099,25072,2701,47835,568,249,319
8400,51965,4100,25088,2702,47865,568,249,319
8405,51996,4102,25103,2703,47894,568,249,319
8410,52027,4103,25118,2703,47924,568,249,319
8415,52058,4104,25134,2703,47954,568,249,319
8420,52089,4105,25152,2704,47984,568,249,319
8425,52120,4106,25160,2704,48014,568,249,319
8430,52151,4107,25173,2705,48044,568,249,319
8435,52182,4108,25188,2706,48074,568,249,319
8440,52213,4109,25200,2706,48104,568,249,319
8445,52244,4110,25220,2706,48132,568,249,319
8450,52275,4116,25235,2710,48156,568,249,319
8455,52306,4125,25258,2718,48177,568,249,319
8460,52337,4132,25269,2725,48204,568,249,319
8465,52368,4134,25283,2726,48234,568,249,319
8470,52399,4135,25298,2726,48264,568,249,319
8475,52430,4136,25311,2726,48294,568,249,319
8480,52461,4137,25324,2726,48324,568,249,319
8485,52492,4138,25340,2726,48354,568,249,319
8490,52523,4139,25351,2726,48384,568,249,319
8495,52554,4140,25362,2726,48414,568,249,319
8500,52585,4141,25375,2726,48444,568,249,319
8505,52616,4142,25392,2727,48474,568,249,319
8510,52647,4144,25403,2729,48503,568,249,319
8515,52678,4146,25418,2729,48532,568,249,319
8520,52709,4149,25428,2730,48560,568,249,319
8525,52740,4152,25439,2732,48587,569,250,319
8530,52771,4158,25458,2736,48613,569,250,319
8535,52802,4160,25473,2738,48642,569,250,319
8540,52833,4163,25488,2740,48669,569,250,319
8545,52864,4168,25504,2745,48696,569,250,319
8550,52895,4170,25522,2746,48725,569,250,319
8555,52926,4171,25536,2747,48755,569,250,319
8560,52957,4174,25549,2748,48783,569,250,319
8565,52988,4178,25562,2749,48809,569,250,319
8570,53019,4184,25579,2754,48834,569,250,319
8575,53050,4190,25599,2760,48860,569,250,319
8580,53081,4193,25613,2762,48888,569,250,319
8585,53112,4195,25629,2763,48917,569,250,319
8590,53143,4197,25640,2763,48946,569,250,319
8595,53174,4200,25654,2765,48974,569,250,319
8600,53205,4202,25666,2765,49003,569,250,319
8605,53236,4205,25687,2767,49031,569,250,319
8610,53267,4208,25701,2768,49059,569,250,319
8615,53298,4210,25715,2770,49088,569,250,319
8620,53329,4211,25732,2770,49118,569,250,319
8625,53360,4212,25749,2771,49148,569,250,319
8630,53391,4213,25762,2772,49178,570,251,319
8635,53422,4214,25773,2772,49208,572,251,321
8640,53453,4215,25786,2772,49238,574,252,322
8645,53484,4216,25802,2773,49268,574,252,322
8650,53515,4217,25821,2774,49298,574,252,322
8655,53546,4218,25835,2774,49328,574,252,322
8660,53577,4219,25853,2775,49358,574,252,322
8665,53608,4220,25864,2776,49388,574,252,322
8670,53639,4221,25876,2777,49418,574,252,322
8675,53670,4222,25895,2778,49448,574,252,322
8680,53701,4224,25913,2780,49477,574,252,322
8685,53732,4226,25931,2781,49506,574,252,322
8690,53763,4232,25951,2786,49530,574,252,322
8695,53794,4237,25966,2791,49557,574,252,322
8700,53825,4240,25982,2793,49585,574,252,322
8705,53856,4243,25994,2793,49612,575,252,323
8710,53887,4247,26011,2795,49640,575,252,323
8715,53918,4250,26021,2795,49668,575,252,323
8720,53949,4254,26034,2797,49695,575,252,323
8725,53980,4256,26045,2798,49724,575,252,323
8730,54011,4258,26058,2799,49753,575,252,323
8735,54042,4260,26072,2801,49782,575,252,323
8740,54073,4262,26087,2801,49811,575,252,323
8745,54104,4264,26105,2802,49840,575,252,323
8750,54135,4266,26119,2803,49869,575,252,323
8755,54166,4268,26135,2804,49898,575,252,323
8760,54197,4270,26149,2804,49927,575,252,323
8765,54228,4272,26165,2805,49956,575,252,323
8770,54259,4274,26177,2806,49985,575,252,323
8775,54290,4276,26191,2807,50014,575,252,323
8780,54321,4278,26203,2807,50043,575,252,323
8785,54352,4280,26220,2807,50072,575,252,323
8790,54383,4282,26231,2808,50101,575,252,323
8795,54414,4284,26243,2809,50130,575,252,323
8800,54445,4287,26257,2810,50158,575,252,323
8805,54476,4291,26273,2812,50185,575,252,323
8810,54507,4299,26287,2819,50207,577,252,325
8815,54538,4309,26303,2829,50228,579,253,326
8820,54569,4315,26314,2834,50252,580,253,327
8825,54600,4317,26328,2835,50283,580,253,327
8830,54631,4320,26341,2837,50311,580,253,327
8835,54662,4323,26355,2840,50339,580,253,327
8840,54693,4326,26373,2843,50366,580,253,327
8845,54724,4329,26385,2844,50395,580,253,327
8850,54755,4331,26399,2844,50424,580,253,327
8855,54786,4333,26412,2845,50453,580,253,327
8860,54817,4335,26422,2845,50481,580,253,327
8865,54848,4337,26438,2847,50511,580,253,327
8870,54879,4338,26457,2848,50541,580,253,327
8875,54910,4339,26474,2848,50571,580,253,327
8880,54941,4340,26483,2848,50601,580,253,327
8885,54972,4341,26506,2848,50631,580,253,327
8890,55003,4342,26523,2848,50661,580,253,327
8895,55034,4343,26539,2848,50691,580,253,327
8900,55065,4344,26554,2848,50721,580,253,327
8905,55096,4345,26571,2849,50751,580,253,327
8910,55127,4346,26586,2849,50781,580,253,327
8915,55158,4347,26601,2849,50811,580,253,327
8920,55189,4349,26610,2849,50840,581,254,327
8925,55220,4354,26626,2854,50865,582,254,328
8930,55251,4360,26636,2858,50890,584,254,330
8935,55282,4366,26651,2862,50913,586,256,330
8940,55313,4375,26670,2871,50936,588,258,330
8945,55344,4381,26684,2877,50963,589,259,330
8950,55375,4384,26695,2879,50990,590,260,330
8955,55406,4389,26709,2883,51017,591,260,331
8960,55437,4393,26725,2887,51044,592,261,331
8965,55468,4395,26742,2889,51073,592,261,331
8970,55499,4397,26758,2890,51101,592,261,331
8975,55530,4401,26771,2894,51129,592,261,331
8980,55561,4403,26787,2895,51158,592,261,331
8985,55592,4403,26798,2895,51189,592,261,331
8990,55623,4403,26817,2895,51220,592,261,331
8995,55654,4403,26829,2895,51251,592,261,331
9000,55685,4403,26840,2895,51282,592,261,331
9005,55716,4403,26851,2895,51313,592,261,331
9010,55747,4403,26863,2895,51344,592,261,331
9015,55778,4403,26881,2895,51375,592,261,331
9020,55809,4403,26895,2895,51406,592,261,331
9025,55840,4403,26911,2895,51437,592,261,331
9030,55871,4403,26924,2895,51468,592,261,331
9035,55902,4403,26943,2895,51499,592,261,331
9040,55933,4404,26951,2896,51529,592,261,331
9045,55964,4406,26967,2898,51558,592,261,331
9050,55995,4410,26980,2901,51582,592,261,331
9055,56026,4417,26992,2907,51605,593,261,332
9060,56057,4425,27002,2914,51632,594,261,333
9065,56088,4429,27015,2916,51659,594,261,333
9070,56119,4437,27031,2921,51682,595,261,334
9075,56150,4441,27040,2923,51708,596,261,335
9080,56181,4448,27054,2928,51733,597,261,336
9085,56212,4454,27074,2934,51757,598,261,337
9090,56243,4461,27087,2939,51782,599,261,338
9095,56274,4466,27106,2942,51807,600,261,339
9100,56305,4472,27116,2945,51833,601,261,340
9105,56336,4474,27131,2946,51862,602,261,341
9110,56367,4478,27145,2950,51889,603,262,341
9115,56398,4481,27162,2952,51917,604,262,342
9120,56429,4484,27179,2954,51945,605,262,343
9125,56460,4487,27198,2956,51973,605,262,343
9130,56491,4489,27213,2957,52002,605,262,343
9135,56522,4490,27230,2958,52032,605,262,343
9140,56553,4491,27245,2959,52062,605,262,343
9145,56584,4492,27260,2959,52092,605,262,343
9150,56615,4493,27277,2959,52122,605,262,343
9155,56646,4494,27293,2960,52152,605,262,343
9160,56677,4495,27312,2961,52182,605,262,343
9165,56708,4496,27328,2961,52212,605,262,343
9170,56739,4498,27339,2963,52241,606,263,343
9175,56770,4498,27356,2963,52272,607,263,344
9180,56801,4498,27372,2963,52303,608,264,344
9185,56832,4498,27385,2963,52334,608,264,344
9190,56863,4498,27401,2963,52365,608,264,344
9195,56894,4498,27414,2963,52396,608,264,344
9200,56925,4498,27428,2963,52427,608,264,344
9205,56956,4498,27439,2963,52458,608,264,344
9210,56987,4498,27452,2963,52489,608,264,344
9215,57018,4498,27463,2963,52520,608,264,344
9220,57049,4498,27476,2963,52551,608,264,344
9225,57080,4498,27490,2963,52582,608,264,344
9230,57111,4501,27505,2965,52609,608,264,344
9235,57142,4506,27520,2969,52636,608,264,344
9240,57173,4510,27532,2970,52662,609,265,344
9245,57204,4514,27542,2972,52690,609,265,344
9250,57235,4519,27557,2974,52716,609,265,344
9255,57266,4523,27574,2977,52743,609,265,344
9260,57297,4527,27591,2981,52770,609,265,344
9265,57328,4530,27604,2983,52798,609,265,344
9270,57359,4533,27618,2986,52826,609,265,344
9275,57390,4537,27635,2988,52853,609,265,344
9280,57421,4541,27649,2992,52880,609,265,344
9285,57452,4545,27661,2995,52906,610,265,345
9290,57483,4551,27683,2998,52932,611,266,345
9295,57514,4553,27694,3000,52961,612,267,345
9300,57545,4554,27702,3000,52991,613,267,346
9305,57576,4556,27718,3002,53020,613,267,346
9310,57607,4557,27733,3003,53050,613,267,346
9315,57638,4557,27743,3003,53081,613,267,346
9320,57669,4557,27753,3003,53112,613,267,346
9325,57700,4557,27772,3003,53143,613,267,346
9330,57731,4557,27787,3003,53174,613,267,346
9335,57762,4557,27801,3003,53205,613,267,346
9340,57793,4557,27815,3003,53236,613,267,346
9345,57824,4557,27831,3003,53267,613,267,346
9350,57855,4558,27844,3003,53296,613,267,346
9355,57886,4562,27861,3007,53323,613,267,346
9360,57917,4565,27876,3010,53350,613,267,346
9365,57948,4569,27889,3013,53379,614,268,346
9370,57979,4571,27900,3015,53408,615,268,347
9375,58010,4572,27918,3016,53438,616,268,348
9380,58041,4573,27938,3017,53468,617,268,349
9385,58072,4575,27956,3018,53497,618,268,350
9390,58103,4577,27969,3019,53526,618,268,350
9395,58134,4578,27982,3019,53556,618,268,350
9400,58165,4581,27996,3020,53584,618,268,350
9405,58196,4583,28011,3020,53613,618,268,350
9410,58227,4586,28028,3022,53640,619,268,351
9415,58258,4591,28045,3026,53665,620,268,352
9420,58289,4596,28065,3030,53693,621,269,352
9425,58320,4600,28080,3033,53720,621,269,352
9430,58351,4604,28099,3036,53747,621,269,352
9435,58382,4608,28116,3038,53774,621,269,352
9440,58413,4612,28128,3039,53801,621,269,352
9445,58444,4616,28146,3042,53828,621,269,352
9450,58475,4620,28158,3044,53855,621,269,352
9455,58506,4623,28178,3047,53883,621,269,352
9460,58537,4628,28194,3050,53909,621,269,352
9465,58568,4631,28211,3053,53937,621,269,352
9470,58599,4633,28222,3053,53966,621,269,352
9475,58630,4635,28235,3053,53995,621,269,352
9480,58661,4637,28251,3053,54024,621,269,352
9485,58692,4638,28261,3053,54054,621,269,352
9490,58723,4639,28276,3054,54084,622,269,353
9495,58754,4640,28290,3054,54114,622,269,353
9500,58785,4641,28301,3055,54144,622,269,353
9505,58816,4642,28317,3055,54174,622,269,353
9510,58847,4643,28331,3056,54204,622,269,353
9515,58878,4644,28347,3056,54234,622,269,353
9520,58909,4645,28364,3057,54264,622,269,353
9525,58940,4646,28379,3058,54294,622,269,353
9530,58971,4647,28392,3059,54324,623,269,354
9535,59002,4650,28409,3062,54351,624,269,355
9540,59033,4654,28422,3065,54379,625,270,355
9545,59064,4658,28434,3068,54406,625,270,355
9550,59095,4664,28454,3072,54431,625,270,355
9555,59126,4669,28466,3075,54457,625,270,355
9560,59157,4673,28483,3078,54484,625,270,355
9565,59188,4677,28494,3079,54511,625,270,355
9570,59219,4680,28506,3080,54539,625,270,355
9575,59250,4683,28519,3082,54567,625,270,355
9580,59281,4687,28532,3086,54594,625,270,355
9585,59312,4690,28549,3088,54622,625,270,355
9590,59343,4694,28564,3090,54649,625,270,355
9595,59374,4697,28577,3092,54677,625,270,355
9600,59405,4700,28590,3093,54705,625,270,355
9605,59436,4703,28604,3094,54733,626,271,355
9610,59467,4703,28619,3094,54764,626,271,355
9615,59498,4703,28635,3094,54795,626,271,355
9620,59529,4703,28652,3094,54826,626,271,355
9625,59560,4703,28669,3094,54857,626,271,355
9630,59591,4704,28689,3094,54887,626,271,355
9635,59622,4705,28707,3095,54917,626,271,355
9640,59653,4706,28722,3095,54947,626,271,355
9645,59684,4707,28740,3096,54977,627,272,355
9650,59715,4709,28754,3097,55006,628,273,355
9655,59746,4711,28771,3099,55035,629,273,356
9660,59777,4712,28785,3100,55065,629,273,356
9665,59808,4715,28802,3101,55093,629,273,356
9670,59839,4718,28816,3102,55121,629,273,356
9675,59870,4721,28830,3105,55149,629,273,356
9680,59901,4724,28837,3106,55177,629,273,356
9685,59932,4727,28854,3108,55205,629,273,356
9690,59963,4730,28863,3108,55233,629,273,356
9695,59994,4733,28879,3110,55261,629,273,356
9700,60025,4736,28893,3112,55289,629,273,356
9705,60056,4740,28913,3116,55316,629,273,356
9710,60087,4744,28927,3117,55343,629,273,356
9715,60118,4748,28944,3119,55370,629,273,356
9720,60149,4753,28957,3120,55396,629,273,356
9725,60180,4756,28971,3122,55424,629,273,356
9730,60211,4758,28987,3123,55453,629,273,356
9735,60242,4760,29003,3124,55482,629,273,356
9740,60273,4762,29014,3125,55511,629,273,356
9745,60304,4764,29031,3125,55540,629,273,356
9750,60335,4766,29047,3126,55569,629,273,356
9755,60366,4768,29064,3126,55598,629,273,356
9760,60397,4770,29078,3127,55627,629,273,356
9765,60428,4772,29095,3128,55656,629,273,356
9770,60459,4775,29112,3130,55684,629,273,356
9775,60490,4776,29124,3130,55712,630,273,357
9780,60521,4781,29142,3135,55739,631,273,358
9785,60552,4783,29159,3137,55768,631,273,358
9790,60583,4787,29172,3139,55796,631,273,358
9795,60614,4789,29184,3139,55825,631,273,358
9800,60645,4791,29199,3139,55853,631,273,358
9805,60676,4795,29218,3142,55880,631,273,358
9810,60707,4797,29234,3144,55909,631,273,358
9815,60738,4800,29253,3146,55938,631,273,358
9820,60769,4801,29270,3146,55967,631,273,358
9825,60800,4803,29286,3147,55996,631,273,358
9830,60831,4806,29305,3150,56024,631,273,358
9835,60862,4807,29319,3151,56055,631,273,358
9840,60893,4807,29331,3151,56086,631,273,358
9845,60924,4807,29346,3151,56117,631,273,358
9850,60955,4807,29357,3151,56148,631,273,358
9855,60986,4807,29372,3151,56179,632,273,359
9860,61017,4807,29387,3151,56210,633,273,360
9865,61048,4807,29401,3151,56241,634,273,361
9870,61079,4807,29412,3151,56272,635,274,361
9875,61110,4807,29427,3151,56303,636,275,361
9880,61141,4808,29437,3152,56333,637,276,361
9885,61172,4809,29452,3152,56362,638,277,361
9890,61203,4815,29466,3158,56387,640,277,363
9895,61234,4821,29480,3163,56411,642,278,364
9900,61265,4826,29494,3167,56438,644,278,366
9905,61296,4830,29509,3170,56466,644,278,366
9910,61327,4833,29527,3172,56494,644,278,366
9915,61358,4836,29544,3175,56522,644,278,366
9920,61389,4838,29555,3177,56551,644,278,366
9925,61420,4842,29573,3181,56578,644,278,366
9930,61451,4844,29586,3182,56607,644,278,366
9935,61482,4847,29602,3183,56635,644,278,366
9940,61513,4848,29618,3184,56665,644,278,366
9945,61544,4849,29632,3185,56695,644,278,366
9950,61575,4850,29651,3185,56725,644,278,366
9955,61606,4851,29667,3186,56755,644,278,366
9960,61637,4852,29681,3187,56785,644,278,366
9965,61668,4853,29694,3187,56815,644,278,366
9970,61699,4854,29709,3187,56845,644,278,366
9975,61730,4855,29724,3187,56875,644,278,366
9980,61761,4856,29737,3188,56905,644,278,366
9985,61792,4857,29754,3188,56935,644,278,366
9990,61823,4858,29769,3189,56965,644,278,366
9995,61854,4859,29780,3189,56995,644,278,366
10000,61885,4860,29792,3189,57025,644,278,366
10005,61916,4862,29806,3189,57053,645,278,367
10010,61947,4868,29821,3193,57075,647,279,368
10015,61978,4879,29842,3203,57094,649,281,368
10020,62009,4890,29854,3213,57118,651,283,368
10025,62040,4892,29867,3215,57148,651,283,368
10030,62071,4893,29887,3216,57178,651,283,368
10035,62102,4895,29903,3217,57207,651,283,368
10040,62133,4897,29920,3219,57236,651,283,368
10045,62164,4898,29935,3220,57266,651,283,368
10050,62195,4900,29948,3221,57295,651,283,368
10055,62226,4901,29964,3222,57325,651,283,368
10060,62257,4902,29974,3222,57355,651,283,368
10065,62288,4903,29988,3223,57385,651,283,368
10070,62319,4905,30003,3225,57414,651,283,368
10075,62350,4906,30014,3225,57444,651,283,368
10080,62381,4906,30029,3225,57475,651,283,368
10085,62412,4906,30044,3225,57506,651,283,368
10090,62443,4906,30057,3225,57537,651,283,368
10095,62474,4906,30069,3225,57568,651,283,368
10100,62505,4906,30087,3225,57599,651,283,368
10105,62536,4906,30102,3225,57630,651,283,368
10110,62567,4906,30121,3225,57661,651,283,368
10115,62598,4906,30134,3225,57692,651,283,368
10120,62629,4906,30144,3225,57723,651,283,368
10125,62660,4908,30160,3227,57752,651,283,368
10130,62691,4911,30172,3229,57779,651,283,368
10135,62722,4917,30191,3234,57801,651,283,368
10140,62753,4928,30208,3243,57821,651,283,368
10145,62784,4935,30219,3248,57848,651,283,368
10150,62815,4938,30232,3249,57877,651,283,368
10155,62846,4939,30246,3249,57907,651,283,368
10160,62877,4940,30261,3250,57937,651,283,368
10165,62908,4941,30271,3250,57967,651,283,368
10170,62939,4942,30284,3251,57997,651,283,368
10175,62970,4943,30296,3252,58027,651,283,368
10180,63001,4944,30315,3253,58057,651,283,368
10185,63032,4945,30326,3254,58087,651,283,368
10190,63063,4946,30342,3255,58117,651,283,368
10195,63094,4948,30357,3257,58146,651,283,368
10200,63125,4950,30374,3258,58175,651,283,368
10205,63156,4952,30391,3258,58203,651,283,368
10210,63187,4955,30409,3261,58232,651,283,368
10215,63218,4957,30420,3261,58261,651,283,368
10220,63249,4959,30432,3261,58289,651,283,368
10225,63280,4962,30446,3264,58317,651,283,368
10230,63311,4965,30458,3265,58345,651,283,368
10235,63342,4967,30473,3267,58375,651,283,368
10240,63373,4968,30485,3268,58405,651,283,368
10245,63404,4969,30503,3268,58435,651,283,368
10250,63435,4970,30518,3268,58465,651,283,368
10255,63466,4972,30535,3270,58494,651,283,368
10260,63497,4975,30550,3271,58522,651,283,368
10265,63528,4979,30566,3272,58549,651,283,368
10270,63559,4982,30580,3273,58577,651,283,368
10275,63590,4985,30594,3274,58605,652,283,369
10280,63621,4989,30610,3276,58632,653,284,369
10285,63652,4993,30622,3279,58659,654,284,370
10290,63683,4996,30636,3280,58687,655,284,371
10295,63714,4999,30648,3281,58715,656,284,372
10300,63745,5002,30665,3282,58743,657,285,372
10305,63776,5005,30683,3285,58771,657,285,372
10310,63807,5008,30696,3288,58799,657,285,372
10315,63838,5011,30714,3291,58827,657,285,372
10320,63869,5014,30727,3293,58855,657,285,372
10325,63900,5015,30743,3293,58885,657,285,372
10330,63931,5016,30758,3293,58915,657,285,372
10335,63962,5017,30775,3294,58945,657,285,372
10340,63993,5018,30790,3295,58975,657,285,372
10345,64024,5019,30807,3296,59005,657,285,372
10350,64055,5020,30822,3297,59035,657,285,372
10355,64086,5021,30840,3297,59065,657,285,372
10360,64117,5022,30854,3298,59095,658,285,373
10365,64148,5024,30874,3300,59124,659,285,374
10370,64179,5025,30889,3300,59154,659,285,374
10375,64210,5029,30905,3304,59180,659,285,374
10380,64241,5032,30919,3307,59209,659,285,374
10385,64272,5033,30930,3308,59239,659,285,374
10390,64303,5035,30948,3310,59268,659,285,374
10395,64334,5037,30961,3312,59297,659,285,374
10400,64365,5038,30977,3313,59327,659,285,374
10405,64396,5040,30991,3315,59356,659,285,374
10410,64427,5042,31009,3316,59385,659,285,374
10415,64458,5044,31027,3318,59414,659,285,374
10420,64489,5045,31042,3318,59444,659,285,374
10425,64520,5047,31056,3320,59473,659,285,374
10430,64551,5050,31075,3323,59501,659,285,374
10435,64582,5053,31093,3326,59529,659,285,374
10440,64613,5054,31105,3327,59559,659,285,374
10445,64644,5057,31117,3329,59586,659,285,374
10450,64675,5059,31135,3331,59616,659,285,374
10455,64706,5060,31153,3331,59646,659,285,374
10460,64737,5061,31174,3331,59676,659,285,374
10465,64768,5062,31189,3332,59706,659,285,374
10470,64799,5063,31201,3332,59736,659,285,374
10475,64830,5064,31221,3333,59766,659,285,374
10480,64861,5065,31236,3334,59796,659,285,374
10485,64892,5068,31249,3336,59824,660,285,375
10490,64923,5073,31270,3340,59849,660,285,375
10495,64954,5078,31283,3343,59876,660,285,375
10500,64985,5083,31298,3346,59901,660,285,375
10505,65016,5087,31313,3350,59929,660,285,375
10510,65047,5090,31326,3352,59957,660,285,375
10515,65078,5094,31338,3355,59984,660,285,375
10520,65109,5097,31350,3356,60012,660,285,375
10525,65140,5099,31364,3357,60041,660,285,375
10530,65171,5101,31379,3358,60070,660,285,375
10535,65202,5103,31393,3359,60099,660,285,375
10540,65233,5105,31410,3361,60128,660,285,375
10545,65264,5107,31423,3362,60157,660,285,375
10550,65295,5109,31442,3362,60186,660,285,375
10555,65326,5111,31460,3364,60214,660,285,375
10560,65357,5114,31469,3365,60243,660,285,375
10565,65388,5119,31486,3367,60268,661,286,375
10570,65419,5125,31504,3373,60294,661,286,375
10575,65450,5129,31523,3376,60321,661,286,375
10580,65481,5130,31537,3376,60351,661,286,375
10585,65512,5132,31548,3378,60380,661,286,375
10590,65543,5134,31563,3379,60409,661,286,375
10595,65574,5136,31581,3380,60438,661,286,375
10600,65605,5139,31597,3382,60466,661,286,375
10605,65636,5141,31614,3384,60495,661,286,375
10610,65667,5143,31629,3386,60524,661,286,375
10615,65698,5144,31648,3387,60554,661,286,375
10620,65729,5145,31662,3387,60584,661,286,375
10625,65760,5147,31674,3387,60613,661,286,375
10630,65791,5149,31688,3388,60642,661,286,375
10635,65822,5152,31706,3390,60670,661,286,375
10640,65853,5154,31718,3391,60699,661,286,375
10645,65884,5157,31740,3394,60727,661,286,375
10650,65915,5160,31753,3397,60755,661,286,375
10655,65946,5162,31761,3397,60784,661,286,375
10660,65977,5165,31781,3400,60812,661,286,375
10665,66008,5168,31795,3402,60840,661,286,375
10670,66039,5171,31811,3405,60868,662,287,375
10675,66070,5172,31825,3405,60898,663,288,375
10680,66101,5174,31840,3407,60927,663,288,375
10685,66132,5179,31855,3411,60952,663,288,375
10690,66163,5183,31870,3413,60980,663,288,375
10695,66194,5185,31879,3414,61009,663,288,375
10700,66225,5188,31892,3416,61036,663,288,375
10705,66256,5193,31908,3420,61062,663,288,375
10710,66287,5198,31926,3425,61089,663,288,375
10715,66318,5202,31942,3429,61115,663,288,375
10720,66349,5206,31955,3432,61142,663,288,375
10725,66380,5209,31967,3435,61171,663,288,375
10730,66411,5211,31980,3435,61198,663,288,375
10735,66442,5216,31995,3439,61224,663,288,375
10740,66473,5219,32010,3441,61253,663,288,375
10745,66504,5221,32025,3443,61283,663,288,375
10750,66535,5221,32040,3443,61314,663,288,375
10755,66566,5221,32050,3443,61345,663,288,375
10760,66597,5221,32066,3443,61376,663,288,375
10765,66628,5221,32081,3443,61407,663,288,375
10770,66659,5221,32098,3443,61438,663,288,375
10775,66690,5221,32114,3443,61469,663,288,375
10780,66721,5222,32131,3443,61499,664,289,375
10785,66752,5223,32146,3443,61529,665,290,375
10790,66783,5224,32158,3443,61559,666,290,376
10795,66814,5226,32173,3443,61587,667,291,376
10800,66845,5229,32191,3445,61615,669,293,376
10805,66876,5234,32207,3449,61642,671,295,376
10810,66907,5237,32221,3451,61670,672,296,376
10815,66938,5240,32236,3452,61698,673,296,377
10820,66969,5243,32248,3454,61726,674,296,378
10825,67000,5246,32267,3457,61754,675,296,379
10830,67031,5249,32283,3458,61782,676,296,380
10835,67062,5252,32302,3460,61810,677,297,380
10840,67093,5257,32318,3463,61836,678,298,380
10845,67124,5261,32330,3466,61862,679,299,380
10850,67155,5266,32347,3467,61888,680,300,380
10855,67186,5273,32367,3473,61913,681,300,381
10860,67217,5279,32379,3478,61938,682,300,382
10865,67248,5281,32394,3480,61967,682,300,382
10870,67279,5281,32407,3480,61998,682,300,382
10875,67310,5281,32424,3480,62029,682,300,382
10880,67341,5281,32440,3480,62060,682,300,382
10885,67372,5281,32454,3480,62091,682,300,382
10890,67403,5281,32467,3480,62122,682,300,382
10895,67434,5281,32482,3480,62153,682,300,382
10900,67465,5281,32495,3480,62184,682,300,382
10905,67496,5281,32512,3480,62215,682,300,382
10910,67527,5281,32525,3480,62246,682,300,382
10915,67558,5281,32539,3480,62277,682,300,382
10920,67589,5281,32559,3480,62308,682,300,382
10925,67620,5281,32579,3480,62339,683,301,382
10930,67651,5281,32593,3480,62370,683,301,382
10935,67682,5281,32608,3480,62401,683,301,382
10940,67713,5281,32617,3480,62432,683,301,382
10945,67744,5281,32634,3480,62463,683,301,382
10950,67775,5281,32646,3480,62494,683,301,382
10955,67806,5281,32661,3480,62525,683,301,382
10960,67837,5281,32672,3480,62556,683,301,382
10965,67868,5284,32686,3483,62584,683,301,382
10970,67899,5290,32702,3487,62608,684,301,383
10975,67930,5298,32720,3493,62632,685,301,384
10980,67961,5304,32731,3499,62656,686,301,385
10985,67992,5308,32747,3502,62684,686,301,385
10990,68023,5311,32766,3504,62712,686,301,385
10995,68054,5313,32778,3504,62741,686,301,385
11000,68085,5316,32793,3505,62769,686,301,385
11005,68116,5319,32805,3507,62797,686,301,385
11010,68147,5321,32818,3508,62826,686,301,385
11015,68178,5324,32836,3510,62854,686,301,385
11020,68209,5326,32846,3510,62883,686,301,385
11025,68240,5329,32862,3513,62911,686,301,385
11030,68271,5330,32879,3514,62941,686,301,385
11035,68302,5331,32889,3515,62971,686,301,385
11040,68333,5332,32905,3515,63001,686,301,385
11045,68364,5333,32917,3515,63031,686,301,385
11050,68395,5334,32930,3515,63061,686,301,385
11055,68426,5335,32942,3516,63091,686,301,385
11060,68457,5336,32963,3517,63121,686,301,385
11065,68488,5337,32981,3518,63151,686,301,385
11070,68519,5338,32995,3519,63181,686,301,385
11075,68550,5339,33007,3520,63211,686,301,385
11080,68581,5340,33021,3520,63241,686,301,385
11085,68612,5341,33032,3520,63271,686,301,385
11090,68643,5347,33048,3524,63296,686,301,385
11095,68674,5350,33064,3526,63324,686,301,385
11100,68705,5354,33079,3528,63350,686,301,385
11105,68736,5355,33099,3529,63381,687,301,386
11110,68767,5355,33113,3529,63412,687,301,386
11115,68798,5355,33124,3529,63443,687,301,386
11120,68829,5355,33140,3529,63474,687,301,386
11125,68860,5355,33155,3529,63505,687,301,386
11130,68891,5356,33167,3529,63535,687,301,386
11135,68922,5357,33182,3529,63565,687,301,386
11140,68953,5358,33195,3530,63595,687,301,386
11145,68984,5359,33204,3530,63625,687,301,386
11150,69015,5360,33219,3530,63655,687,301,386
11155,69046,5361,33229,3530,63685,687,301,386
11160,69077,5362,33242,3531,63715,687,301,386
11165,69108,5364,33253,3533,63744,687,301,386
11170,69139,5366,33267,3535,63773,687,301,386
11175,69170,5370,33287,3538,63800,687,301,386
11180,69201,5373,33299,3540,63828,687,301,386
11185,69232,5377,33317,3542,63855,687,301,386
11190,69263,5381,33330,3545,63882,687,301,386
11195,69294,5384,33342,3547,63910,687,301,386
11200,69325,5387,33355,3549,63938,687,301,386
11205,69356,5390,33373,3551,63966,687,301,386
11210,69387,5394,33385,3553,63992,687,301,386
11215,69418,5400,33401,3559,64017,688,302,386
11220,69449,5405,33414,3561,64041,689,303,386
11225,69480,5411,33424,3565,64069,690,303,387
11230,69511,5412,33443,3566,64099,691,304,387
11235,69542,5413,33456,3566,64129,691,304,387
11240,69573,5414,33471,3567,64159,691,304,387
11245,69604,5415,33483,3567,64189,691,304,387
11250,69635,5416,33494,3567,64219,691,304,387
11255,69666,5417,33509,3568,64249,691,304,387
11260,69697,5418,33525,3569,64279,691,304,387
11265,69728,5419,33541,3570,64309,691,304,387
11270,69759,5420,33556,3570,64339,691,304,387
11275,69790,5422,33571,3572,64368,691,304,387
11280,69821,5424,33585,3574,64397,691,304,387
11285,69852,5426,33599,3575,64426,692,304,388
11290,69883,5428,33613,3576,64455,693,304,389
11295,69914,5430,33632,3578,64484,694,305,389
11300,69945,5432,33646,3579,64513,694,305,389
11305,69976,5434,33664,3579,64542,694,305,389
11310,70007,5436,33683,3581,64571,694,305,389
11315,70038,5438,33694,3581,64600,694,305,389
11320,70069,5440,33713,3582,64629,694,305,389
11325,70100,5444,33728,3584,64656,694,305,389
11330,70131,5449,33742,3587,64681,694,305,389
11335,70162,5456,33757,3592,64705,695,306,389
11340,70193,5464,33773,3598,64729,696,306,390
11345,70224,5464,33785,3598,64760,696,306,390
11350,70255,5464,33802,3598,64791,696,306,390
11355,70286,5464,33811,3598,64822,696,306,390
11360,70317,5464,33823,3598,64853,696,306,390
11365,70348,5464,33836,3598,64884,696,306,390
11370,70379,5464,33853,3598,64915,696,306,390
11375,70410,5464,33866,3598,64946,696,306,390
11380,70441,5464,33881,3598,64977,696,306,390
11385,70472,5464,33894,3598,65008,696,306,390
11390,70503,5464,33910,3598,65039,696,306,390
11395,70534,5464,33922,3598,65070,696,306,390
11400,70565,5464,33942,3598,65101,696,306,390
11405,70596,5464,33957,3598,65132,696,306,390
11410,70627,5464,33973,3598,65163,696,306,390
11415,70658,5464,33983,3598,65194,696,306,390
11420,70689,5464,33996,3598,65225,696,306,390
11425,70720,5464,34008,3598,65256,696,306,390
11430,70751,5464,34021,3598,65287,696,306,390
11435,70782,5465,34036,3599,65317,696,306,390
11440,70813,5466,34051,3599,65347,696,306,390
11445,70844,5468,34068,3601,65376,697,307,390
11450,70875,5474,34087,3605,65400,699,307,392
11455,70906,5479,34104,3608,65425,701,308,393
11460,70937,5485,34117,3611,65450,703,309,394
11465,70968,5491,34133,3615,65476,703,309,394
11470,70999,5496,34149,3619,65503,703,309,394
11475,71030,5500,34162,3620,65529,703,309,394
11480,71061,5506,34178,3624,65555,703,309,394
11485,71092,5511,34190,3626,65581,703,309,394
11490,71123,5515,34204,3627,65608,703,309,394
11495,71154,5520,34224,3632,65634,703,309,394
11500,71185,5524,34239,3634,65661,703,309,394
11505,71216,5528,34258,3637,65688,703,309,394
11510,71247,5532,34267,3640,65715,703,309,394
11515,71278,5537,34288,3645,65741,703,309,394
11520,71309,5541,34304,3647,65768,703,309,394
11525,71340,5544,34319,3649,65796,703,309,394
11530,71371,5546,34335,3650,65825,703,309,394
11535,71402,5549,34349,3652,65853,703,309,394
11540,71433,5551,34358,3653,65882,703,309,394
11545,71464,5553,34374,3653,65911,703,309,394
11550,71495,5555,34387,3654,65940,703,309,394
11555,71526,5557,34404,3654,65969,703,309,394
11560,71557,5559,34418,3656,65998,703,309,394
11565,71588,5561,34433,3657,66027,703,309,394
11570,71619,5563,34452,3658,66054,704,310,394
11575,71650,5568,34463,3663,66080,705,310,395
11580,71681,5570,34479,3665,66111,706,310,396
11585,71712,5570,34491,3665,66142,706,310,396
11590,71743,5570,34504,3665,66173,706,310,396
11595,71774,5570,34516,3665,66204,706,310,396
11600,71805,5570,34530,3665,66235,706,310,396
11605,71836,5570,34542,3665,66266,706,310,396
11610,71867,5570,34559,3665,66297,706,310,396
11615,71898,5570,34575,3665,66328,706,310,396
11620,71929,5570,34591,3665,66359,706,310,396
11625,71960,5570,34604,3665,66390,706,310,396
11630,71991,5573,34621,3667,66418,706,310,396
11635,72022,5575,34632,3668,66447,706,310,396
11640,72053,5578,34644,3669,66475,706,310,396
11645,72084,5583,34659,3673,66500,706,310,396
11650,72115,5588,34672,3677,66527,706,310,396
11655,72146,5591,34687,3679,66555,706,310,396
11660,72177,5594,34702,3682,66583,706,310,396
11665,72208,5597,34720,3684,66611,706,310,396
11670,72239,5600,34733,3685,66639,706,310,396
11675,72270,5603,34749,3686,66667,706,310,396
11680,72301,5607,34766,3688,66694,706,310,396
11685,72332,5612,34785,3691,66720,706,310,396
11690,72363,5616,34796,3692,66747,706,310,396
11695,72394,5620,34815,3695,66774,706,310,396
11700,72425,5624,34832,3698,66801,706,310,396
11705,72456,5628,34843,3701,66828,706,310,396
11710,72487,5632,34865,3705,66855,706,310,396
11715,72518,5637,34880,3709,66879,706,310,396
11720,72549,5644,34898,3715,66904,706,310,396
11725,72580,5649,34911,3718,66931,706,310,396
11730,72611,5653,34926,3719,66957,706,310,396
11735,72642,5659,34939,3723,66982,706,310,396
11740,72673,5665,34955,3727,67007,706,310,396
11745,72704,5670,34971,3729,67034,706,310,396
11750,72735,5676,34992,3733,67058,706,310,396
11755,72766,5685,35008,3741,67081,706,310,396
11760,72797,5690,35029,3745,67106,706,310,396
11765,72828,5692,35044,3747,67136,707,310,397
11770,72859,5694,35061,3748,67165,707,310,397
11775,72890,5696,35073,3748,67193,707,310,397
11780,72921,5699,35092,3749,67222,707,310,397
11785,72952,5701,35103,3751,67251,707,310,397
11790,72983,5703,35118,3752,67280,707,310,397
11795,73014,5705,35130,3752,67309,707,310,397
11800,73045,5707,35146,3753,67338,707,310,397
11805,73076,5708,35164,3754,67368,707,310,397
11810,73107,5709,35176,3755,67398,707,310,397
11815,73138,5710,35191,3756,67428,707,310,397
11820,73169,5711,35207,3757,67458,707,310,397
11825,73200,5712,35221,3758,67487,707,310,397
11830,73231,5714,35235,3759,67517,707,310,397
11835,73262,5715,35249,3760,67547,707,310,397
11840,73293,5716,35265,3761,67577,707,310,397
11845,73324,5717,35280,3761,67607,707,310,397
11850,73355,5718,35296,3761,67637,707,310,397
11855,73386,5719,35312,3762,67667,707,310,397
11860,73417,5721,35324,3763,67696,707,310,397
11865,73448,5725,35340,3765,67723,707,310,397
11870,73479,5730,35354,3769,67749,707,310,397
11875,73510,5732,35373,3771,67778,707,310,397
11880,73541,5736,35390,3774,67805,707,310,397
11885,73572,5740,35407,3777,67832,707,310,397
11890,73603,5743,35425,3778,67859,707,310,397
11895,73634,5747,35441,3781,67887,707,310,397
11900,73665,5751,35460,3783,67914,707,310,397
11905,73696,5754,35473,3785,67942,707,310,397
11910,73727,5757,35484,3785,67970,707,310,397
11915,73758,5760,35499,3787,67998,707,310,397
11920,73789,5763,35511,3789,68026,707,310,397
11925,73820,5766,35528,3790,68054,707,310,397
11930,73851,5769,35543,3792,68082,707,310,397
11935,73882,5772,35557,3793,68110,707,310,397
11940,73913,5775,35571,3795,68138,707,310,397
11945,73944,5779,35586,3798,68165,708,311,397
11950,73975,5782,35598,3798,68193,708,311,397
11955,74006,5785,35615,3800,68221,708,311,397
11960,74037,5788,35632,3803,68249,708,311,397
11965,74068,5791,35647,3804,68277,708,311,397
11970,74099,5794,35664,3804,68305,708,311,397
11975,74130,5797,35675,3805,68333,708,311,397
11980,74161,5800,35687,3805,68361,708,311,397
11985,74192,5804,35705,3808,68388,708,311,397
11990,74223,5810,35716,3812,68412,708,311,397
11995,74254,5814,35729,3814,68440,708,311,397
12000,74285,5815,35742,3814,68470,708,311,397
12005,74316,5817,35753,3815,68499,708,311,397
12010,74347,5818,35767,3815,68529,708,311,397
12015,74378,5820,35786,3817,68558,708,311,397
12020,74409,5822,35803,3819,68587,708,311,397
12025,74440,5823,35818,3819,68617,708,311,397
12030,74471,5824,35836,3820,68647,708,311,397
12035,74502,5825,35854,3820,68677,708,311,397
12040,74533,5826,35870,3820,68707,708,311,397
12045,74564,5827,35885,3820,68737,708,311,397
12050,74595,5828,35896,3820,68767,709,312,397
12055,74626,5829,35911,3820,68797,710,313,397
12060,74657,5830,35924,3820,68827,711,313,398
12065,74688,5831,35941,3821,68857,712,313,399
12070,74719,5832,35960,3821,68887,713,314,399
12075,74750,5833,35975,3822,68917,714,314,400
12080,74781,5834,35991,3822,68947,714,314,400
12085,74812,5835,36005,3822,68977,714,314,400
12090,74843,5836,36020,3822,69007,714,314,400
12095,74874,5837,36034,3822,69037,714,314,400
12100,74905,5839,36043,3823,69066,714,314,400
12105,74936,5842,36062,3826,69093,714,314,400
12110,74967,5848,36077,3830,69119,714,314,400
12115,74998,5853,36091,3834,69144,714,314,400
12120,75029,5858,36109,3837,69170,714,314,400
12125,75060,5863,36126,3840,69197,714,314,400
12130,75091,5866,36139,3842,69225,714,314,400
12135,75122,5870,36154,3845,69252,714,314,400
12140,75153,5873,36169,3847,69280,714,314,400
12145,75184,5876,36184,3849,69308,714,314,400
12150,75215,5878,36201,3849,69337,714,314,400
12155,75246,5879,36214,3849,69367,714,314,400
12160,75277,5880,36229,3850,69397,714,314,400
12165,75308,5881,36250,3851,69427,714,314,400
12170,75339,5882,36268,3852,69457,714,314,400
12175,75370,5883,36285,3853,69487,714,314,400
12180,75401,5884,36301,3853,69517,715,314,401
12185,75432,5887,36313,3856,69545,717,315,402
12190,75463,5891,36328,3858,69572,718,315,403
12195,75494,5894,36341,3859,69600,719,316,403
12200,75525,5898,36354,3862,69626,720,317,403
12205,75556,5904,36371,3865,69651,721,317,404
12210,75587,5909,36389,3869,69678,722,318,404
12215,75618,5913,36400,3871,69705,723,318,405
12220,75649,5916,36416,3872,69733,724,318,406
12225,75680,5918,36431,3874,69761,725,319,406
12230,75711,5922,36442,3876,69788,726,320,406
12235,75742,5925,36459,3879,69816,727,320,407
12240,75773,5928,36473,3880,69845,728,320,408
12245,75804,5930,36491,3882,69874,729,321,408
12250,75835,5932,36507,3884,69903,729,321,408
12255,75866,5934,36519,3884,69932,729,321,408
12260,75897,5935,36531,3885,69962,729,321,408
12265,75928,5937,36544,3887,69991,729,321,408
12270,75959,5939,36556,3888,70020,729,321,408
12275,75990,5942,36571,3890,70048,729,321,408
12280,76021,5943,36585,3890,70078,729,321,408
12285,76052,5944,36593,3890,70108,729,321,408
12290,76083,5946,36606,3891,70137,729,321,408
12295,76114,5949,36619,3894,70165,729,321,408
12300,76145,5951,36635,3896,70194,729,321,408
12305,76176,5954,36651,3899,70222,729,321,408
12310,76207,5957,36668,3901,70250,729,321,408
12315,76238,5960,36682,3903,70278,729,321,408
12320,76269,5963,36700,3906,70306,729,321,408
12325,76300,5965,36712,3908,70335,729,321,408
12330,76331,5966,36723,3908,70365,729,321,408
12335,76362,5966,36739,3908,70396,729,321,408
12340,76393,5966,36757,3908,70427,729,321,408
12345,76424,5967,36765,3908,70457,729,321,408
12350,76455,5968,36779,3908,70487,730,322,408
12355,76486,5969,36795,3908,70517,731,323,408
12360,76517,5970,36812,3908,70547,732,324,408
12365,76548,5973,36828,3910,70575,733,325,408
12370,76579,5976,36844,3912,70603,734,325,409
12375,76610,5979,36856,3914,70631,735,325,410
12380,76641,5982,36864,3915,70658,736,325,411
12385,76672,5986,36882,3918,70685,737,326,411
12390,76703,5990,36897,3921,70713,738,327,411
12395,76734,5993,36912,3922,70741,739,328,411
12400,76765,5996,36929,3923,70768,740,328,412
12405,76796,6000,36947,3926,70795,741,328,413
12410,76827,6004,36963,3929,70823,742,329,413
12415,76858,6007,36982,3932,70850,743,330,413
12420,76889,6011,36998,3933,70878,743,330,413
12425,76920,6014,37011,3934,70906,743,330,413
12430,76951,6017,37027,3936,70934,743,330,413
12435,76982,6020,37039,3937,70961,743,330,413
12440,77013,6023,37054,3939,70990,743,330,413
12445,77044,6025,37071,3939,71019,743,330,413
12450,77075,6027,37079,3939,71048,743,330,413
12455,77106,6029,37095,3941,71077,743,330,413
12460,77137,6031,37111,3943,71106,743,330,413
12465,77168,6035,37125,3946,71133,744,330,414
12470,77199,6037,37139,3948,71162,745,331,414
12475,77230,6041,37148,3950,71189,746,331,415
12480,77261,6043,37159,3950,71218,746,331,415
12485,77292,6044,37170,3951,71248,746,331,415
12490,77323,6046,37186,3952,71277,746,331,415
12495,77354,6047,37199,3953,71307,746,331,415
12500,77385,6048,37213,3953,71337,746,331,415
12505,77416,6050,37230,3954,71366,746,331,415
12510,77447,6051,37245,3955,71396,746,331,415
12515,77478,6052,37258,3955,71426,746,331,415
12520,77509,6053,37271,3956,71456,747,331,416
12525,77540,6055,37288,3957,71485,748,332,416
12530,77571,6056,37305,3958,71515,749,333,416
12535,77602,6058,37320,3960,71544,750,334,416
12540,77633,6060,37345,3962,71573,751,335,416
12545,77664,6063,37363,3964,71601,752,335,417
12550,77695,6065,37377,3964,71630,752,335,417
12555,77726,6068,37392,3966,71658,752,335,417
12560,77757,6071,37413,3968,71686,752,335,417
12565,77788,6074,37430,3969,71713,752,335,417
12570,77819,6076,37447,3971,71743,752,335,417
12575,77850,6077,37463,3972,71772,752,335,417
12580,77881,6079,37472,3973,71802,753,336,417
12585,77912,6082,37481,3975,71830,754,336,418
12590,77943,6087,37491,3977,71856,755,336,419
12595,77974,6090,37504,3977,71884,756,337,419
12600,78005,6095,37517,3979,71908,757,338,419
12605,78036,6101,37530,3982,71935,757,338,419
12610,78067,6104,37542,3984,71962,757,338,419
12615,78098,6107,37556,3987,71990,757,338,419
12620,78129,6110,37568,3989,72019,757,338,419
12625,78160,6112,37584,3990,72047,757,338,419
12630,78191,6116,37603,3993,72074,757,338,419
12635,78222,6120,37616,3995,72101,757,338,419
12640,78253,6123,37636,3997,72130,757,338,419
12645,78284,6125,37647,3998,72159,757,338,419
12650,78315,6127,37663,4000,72188,757,338,419
12655,78346,6127,37683,4000,72219,757,338,419
12660,78377,6127,37704,4000,72250,757,338,419
12665,78408,6128,37717,4000,72280,757,338,419
12670,78439,6129,37728,4000,72310,757,338,419
12675,78470,6130,37740,4000,72339,757,338,419
12680,78501,6132,37755,4002,72369,757,338,419
12685,78532,6133,37769,4003,72399,757,338,419
12690,78563,6134,37779,4003,72428,757,338,419
12695,78594,6136,37793,4004,72458,757,338,419
12700,78625,6137,37808,4004,72488,757,338,419
12705,78656,6138,37824,4005,72517,757,338,419
12710,78687,6142,37838,4008,72545,759,340,419
12715,78718,6145,37848,4009,72573,761,340,421
12720,78749,6148,37862,4012,72600,763,341,422
12725,78780,6150,37881,4013,72630,763,341,422
12730,78811,6151,37899,4014,72660,763,341,422
12735,78842,6152,37912,4015,72690,763,341,422
12740,78873,6153,37924,4016,72720,763,341,422
12745,78904,6154,37940,4016,72750,763,341,422
12750,78935,6156,37950,4017,72779,763,341,422
12755,78966,6158,37967,4018,72808,763,341,422
12760,78997,6160,37984,4020,72837,763,341,422
12765,79028,6162,38002,4022,72866,763,341,422
12770,79059,6164,38019,4024,72895,763,341,422
12775,79090,6166,38034,4024,72924,763,341,422
12780,79121,6168,38050,4024,72953,763,341,422
12785,79152,6170,38064,4024,72982,763,341,422
12790,79183,6172,38079,4024,73011,763,341,422
12795,79214,6174,38095,4025,73040,763,341,422
12800,79245,6176,38109,4025,73069,763,341,422
12805,79276,6178,38123,4025,73098,763,341,422
12810,79307,6180,38135,4026,73127,763,341,422
12815,79338,6182,38149,4028,73156,763,341,422
12820,79369,6184,38166,4030,73185,763,341,422
12825,79400,6188,38184,4032,73212,763,341,422
12830,79431,6193,38199,4035,73238,764,341,423
12835,79462,6198,38214,4039,73264,765,342,423
12840,79493,6203,38227,4042,73290,765,342,423
12845,79524,6208,38242,4046,73314,765,342,423
12850,79555,6213,38255,4049,73340,765,342,423
12855,79586,6217,38268,4052,73368,765,342,423
12860,79617,6221,38277,4055,73396,765,342,423
12865,79648,6224,38292,4057,73423,765,342,423
12870,79679,6228,38312,4061,73451,765,342,423
12875,79710,6231,38322,4063,73479,765,342,423
12880,79741,6233,38338,4064,73508,765,342,423
12885,79772,6236,38358,4065,73536,765,342,423
12890,79803,6237,38377,4065,73566,765,342,423
12895,79834,6238,38391,4066,73596,765,342,423
12900,79865,6239,38402,4066,73626,765,342,423
12905,79896,6240,38417,4067,73656,765,342,423
12910,79927,6241,38431,4067,73686,765,342,423
12915,79958,6242,38445,4068,73716,765,342,423
12920,79989,6243,38459,4068,73746,765,342,423
12925,80020,6244,38472,4068,73776,765,342,423
12930,80051,6245,38484,4068,73806,765,342,423
12935,80082,6246,38499,4069,73836,765,342,423
12940,80113,6247,38512,4069,73866,766,343,423
12945,80144,6248,38527,4069,73896,767,343,424
12950,80175,6250,38540,4069,73925,768,344,424
12955,80206,6255,38558,4073,73951,769,345,424
12960,80237,6259,38575,4075,73978,770,345,425
12965,80268,6262,38592,4078,74006,770,345,425
12970,80299,6264,38604,4079,74035,770,345,425
12975,80330,6267,38623,4081,74063,770,345,425
12980,80361,6269,38638,4083,74092,770,345,425
12985,80392,6271,38653,4084,74121,770,345,425
12990,80423,6275,38669,4087,74148,770,345,425
12995,80454,6277,38684,4088,74177,770,345,425
13000,80485,6279,38698,4090,74206,770,345,425
13005,80516,6281,38714,4090,74235,770,345,425
13010,80547,6283,38726,4092,74264,770,345,425
13015,80578,6285,38742,4094,74293,770,345,425
13020,80609,6289,38756,4096,74320,770,345,425
13025,80640,6291,38767,4096,74348,770,345,425
13030,80671,6294,38784,4098,74377,770,345,425
13035,80702,6296,38800,4100,74406,770,345,425
13040,80733,6298,38816,4100,74434,770,345,425
13045,80764,6301,38831,4103,74463,770,345,425
13050,80795,6303,38849,4104,74492,770,345,425
13055,80826,6305,38863,4105,74520,770,345,425
13060,80857,6308,38882,4107,74549,770,345,425
13065,80888,6310,38894,4108,74578,770,345,425
13070,80919,6312,38914,4109,74606,770,345,425
13075,80950,6316,38930,4112,74633,770,345,425
13080,80981,6321,38946,4115,74660,770,345,425
13085,81012,6325,38960,4117,74686,770,345,425
13090,81043,6330,38974,4120,74713,770,345,425
13095,81074,6330,38990,4120,74744,770,345,425
13100,81105,6330,39001,4120,74775,770,345,425
13105,81136,6330,39016,4120,74806,770,345,425
13110,81167,6330,39030,4120,74837,770,345,425
13115,81198,6330,39046,4120,74868,770,345,425
13120,81229,6330,39064,4120,74899,770,345,425
13125,81260,6330,39077,4120,74930,770,345,425
13130,81291,6330,39091,4120,74961,770,345,425
13135,81322,6330,39101,4120,74992,770,345,425
13140,81353,6330,39116,4120,75023,770,345,425
13145,81384,6332,39132,4121,75052,770,345,425
13150,81415,6334,39150,4122,75081,770,345,425
13155,81446,6336,39164,4123,75110,770,345,425
13160,81477,6337,39179,4124,75140,770,345,425
13165,81508,6339,39190,4125,75169,770,345,425
13170,81539,6341,39205,4127,75198,770,345,425
13175,81570,6341,39225,4127,75229,770,345,425
13180,81601,6341,39242,4127,75260,770,345,425
13185,81632,6341,39256,4127,75291,770,345,425
13190,81663,6341,39273,4127,75322,770,345,425
13195,81694,6342,39287,4128,75352,770,345,425
13200,81725,6346,39307,4130,75379,770,345,425
13205,81756,6349,39328,4132,75407,770,345,425
13210,81787,6352,39342,4133,75435,770,345,425
13215,81818,6354,39353,4133,75464,770,345,425
13220,81849,6357,39370,4136,75492,770,345,425
13225,81880,6359,39385,4138,75521,770,345,425
13230,81911,6361,39399,4138,75550,770,345,425
13235,81942,6363,39415,4140,75579,770,345,425
13240,81973,6366,39432,4142,75607,770,345,425
13245,82004,6369,39445,4143,75635,770,345,425
13250,82035,6372,39461,4146,75663,770,345,425
13255,82066,6373,39480,4146,75693,770,345,425
13260,82097,6374,39498,4147,75723,770,345,425
13265,82128,6375,39513,4148,75753,770,345,425
13270,82159,6377,39531,4149,75781,770,345,425
13275,82190,6380,39544,4151,75810,770,345,425
13280,82221,6383,39559,4154,75838,770,345,425
13285,82252,6385,39572,4156,75867,770,345,425
13290,82283,6385,39590,4156,75898,770,345,425
13295,82314,6385,39611,4156,75929,770,345,425
13300,82345,6385,39628,4156,75960,770,345,425
13305,82376,6385,39642,4156,75991,770,345,425
13310,82407,6388,39655,4157,76019,770,345,425
13315,82438,6390,39668,4158,76047,770,345,425
13320,82469,6393,39687,4160,76076,770,345,425
13325,82500,6397,39702,4162,76102,770,345,425
13330,82531,6400,39718,4164,76130,770,345,425
13335,82562,6404,39733,4168,76157,770,345,425
13340,82593,6409,39749,4172,76184,770,345,425
13345,82624,6412,39760,4174,76212,770,345,425
13350,82655,6414,39776,4176,76240,770,345,425
13355,82686,6416,39793,4177,76269,770,345,425
13360,82717,6418,39806,4179,76299,770,345,425
13365,82748,6419,39820,4180,76329,770,345,425
13370,82779,6421,39834,4180,76358,770,345,425
13375,82810,6423,39851,4182,76387,770,345,425
13380,82841,6425,39870,4183,76416,770,345,425
13385,82872,6427,39883,4184,76445,770,345,425
13390,82903,6429,39902,4186,76474,770,345,425
13395,82934,6432,39915,4186,76502,770,345,425
13400,82965,6435,39932,4188,76530,770,345,425
13405,82996,6439,39947,4189,76557,770,345,425
13410,83027,6443,39960,4192,76584,770,345,425
13415,83058,6447,39977,4196,76610,770,345,425
13420,83089,6453,39995,4199,76635,770,345,425
13425,83120,6457,40012,4202,76663,770,345,425
13430,83151,6460,40019,4203,76691,770,345,425
13435,83182,6463,40034,4206,76719,770,345,425
13440,83213,6466,40053,4208,76746,770,345,425
13445,83244,6470,40068,4210,76774,770,345,425
13450,83275,6472,40085,4210,76803,770,345,425
13455,83306,6475,40100,4213,76831,770,345,425
13460,83337,6478,40113,4216,76859,770,345,425
13465,83368,6482,40130,4218,76886,770,345,425
13470,83399,6485,40145,4219,76914,770,345,425
13475,83430,6486,40158,4219,76944,770,345,425
13480,83461,6487,40173,4220,76974,770,345,425
13485,83492,6488,40185,4220,77004,770,345,425
13490,83523,6489,40197,4220,77034,770,345,425
13495,83554,6490,40217,4221,77064,770,345,425
13500,83585,6491,40231,4222,77094,770,345,425
13505,83616,6492,40246,4222,77124,770,345,425
13510,83647,6493,40262,4222,77154,770,345,425
13515,83678,6494,40277,4222,77184,770,345,425
13520,83709,6495,40294,4223,77214,770,345,425
13525,83740,6496,40310,4224,77244,770,345,425
13530,83771,6498,40320,4224,77273,770,345,425
13535,83802,6500,40330,4224,77302,770,345,425
13540,83833,6502,40345,4225,77330,770,345,425
13545,83864,6505,40355,4227,77359,770,345,425
13550,83895,6510,40374,4230,77385,770,345,425
13555,83926,6513,40386,4230,77413,770,345,425
13560,83957,6517,40403,4232,77440,770,345,425
13565,83988,6519,40419,4233,77468,770,345,425
13570,84019,6522,40436,4235,77496,770,345,425
13575,84050,6526,40450,4239,77524,770,345,425
13580,84081,6529,40466,4239,77551,770,345,425
13585,84112,6535,40478,4243,77577,770,345,425
13590,84143,6540,40493,4248,77603,770,345,425
13595,84174,6543,40511,4250,77631,770,345,425
13600,84205,6546,40529,4253,77659,770,345,425
13605,84236,6550,40542,4257,77686,770,345,425
13610,84267,6553,40560,4260,77714,770,345,425
13615,84298,6558,40577,4264,77740,770,345,425
13620,84329,6561,40592,4266,77768,770,345,425
13625,84360,6563,40605,4267,77797,770,345,425
13630,84391,6566,40617,4268,77825,770,345,425
13635,84422,6569,40634,4270,77853,770,345,425
13640,84453,6571,40647,4272,77882,770,345,425
13645,84484,6573,40667,4274,77911,770,345,425
13650,84515,6575,40681,4275,77940,770,345,425
13655,84546,6578,40693,4277,77968,770,345,425
13660,84577,6582,40708,4280,77995,770,345,425
13665,84608,6584,40724,4281,78024,770,345,425
13670,84639,6587,40740,4283,78052,770,345,425
13675,84670,6588,40751,4283,78082,770,345,425
13680,84701,6588,40770,4283,78113,770,345,425
13685,84732,6588,40787,4283,78144,770,345,425
13690,84763,6588,40805,4283,78175,770,345,425
13695,84794,6588,40823,4283,78206,770,345,425
13700,84825,6589,40839,4283,78235,770,345,425
13705,84856,6591,40852,4284,78264,770,345,425
13710,84887,6593,40862,4286,78293,770,345,425
13715,84918,6595,40874,4287,78323,770,345,425
13720,84949,6596,40886,4287,78352,770,345,425
13725,84980,6599,40897,4289,78381,770,345,425
13730,85011,6602,40911,4291,78409,770,345,425
13735,85042,6605,40928,4293,78436,770,345,425
13740,85073,6608,40945,4295,78464,770,345,425
13745,85104,6615,40960,4299,78489,770,345,425
13750,85135,6620,40973,4303,78515,770,345,425
13755,85166,6626,40987,4308,78540,770,345,425
13760,85197,6631,41005,4312,78566,770,345,425
13765,85228,6635,41022,4313,78593,770,345,425
13770,85259,6640,41039,4314,78619,770,345,425
13775,85290,6644,41052,4316,78646,770,345,425
13780,85321,6651,41069,4321,78670,770,345,425
13785,85352,6657,41089,4325,78695,770,345,425
13790,85383,6664,41108,4332,78719,770,345,425
13795,85414,6668,41120,4335,78746,770,345,425
13800,85445,6673,41132,4338,78772,770,345,425
13805,85476,6676,41147,4340,78800,770,345,425
13810,85507,6679,41160,4341,78828,770,345,425
13815,85538,6682,41171,4342,78856,770,345,425
13820,85569,6684,41181,4343,78885,770,345,425
13825,85600,6686,41194,4344,78914,770,345,425
13830,85631,6688,41205,4344,78943,770,345,425
13835,85662,6690,41217,4345,78972,770,345,425
13840,85693,6691,41238,4346,79002,770,345,425
13845,85724,6692,41249,4346,79032,770,345,425
13850,85755,6694,41265,4347,79061,770,345,425
13855,85786,6695,41281,4348,79091,770,345,425
13860,85817,6697,41295,4349,79120,770,345,425
13865,85848,6699,41307,4350,79149,770,345,425
13870,85879,6701,41318,4351,79178,770,345,425
13875,85910,6702,41332,4351,79208,770,345,425
13880,85941,6703,41345,4351,79238,770,345,425
13885,85972,6704,41357,4352,79268,770,345,425
13890,86003,6705,41373,4353,79298,770,345,425
13895,86034,6706,41390,4354,79328,770,345,425
13900,86065,6707,41407,4355,79358,770,345,425
13905,86096,6708,41425,4356,79388,770,345,425
13910,86127,6709,41441,4357,79418,770,345,425
13915,86158,6710,41450,4357,79448,770,345,425
13920,86189,6712,41462,4357,79477,770,345,425
13925,86220,6713,41479,4358,79507,770,345,425
13930,86251,6714,41497,4359,79537,770,345,425
13935,86282,6715,41512,4359,79567,770,345,425
13940,86313,6716,41528,4360,79597,770,345,425
13945,86344,6717,41545,4361,79627,770,345,425
13950,86375,6718,41560,4361,79657,770,345,425
13955,86406,6719,41573,4361,79687,770,345,425
13960,86437,6720,41590,4362,79717,770,345,425
13965,86468,6721,41601,4362,79747,770,345,425
13970,86499,6723,41611,4364,79776,770,345,425
13975,86530,6728,41624,4366,79802,770,345,425
13980,86561,6731,41639,4368,79829,770,345,425
13985,86592,6738,41654,4373,79854,770,345,425
13990,86623,6742,41670,4376,79881,770,345,425
13995,86654,6747,41688,4379,79907,770,345,425
14000,86685,6750,41699,4381,79935,770,345,425
14005,86716,6754,41716,4384,79962,770,345,425
14010,86747,6757,41729,4386,79990,770,345,425
14015,86778,6761,41747,4388,80017,770,345,425
14020,86809,6765,41761,4391,80044,770,345,425
14025,86840,6767,41776,4391,80072,770,345,425
14030,86871,6771,41790,4394,80100,770,345,425
14035,86902,6776,41804,4398,80126,770,345,425
14040,86933,6777,41818,4399,80156,770,345,425
14045,86964,6779,41836,4401,80185,770,345,425
14050,86995,6781,41847,4402,80214,770,345,425
14055,87026,6781,41865,4402,80245,770,345,425
14060,87057,6781,41881,4402,80276,770,345,425
14065,87088,6781,41895,4402,80307,770,345,425
14070,87119,6781,41910,4402,80338,770,345,425
14075,87150,6781,41929,4402,80369,770,345,425
14080,87181,6781,41942,4402,80400,770,345,425
14085,87212,6781,41958,4402,80431,770,345,425
14090,87243,6781,41973,4402,80461,770,345,425
14095,87274,6783,41988,4404,80491,770,345,425
14100,87305,6786,42007,4407,80518,770,345,425
14105,87336,6789,42023,4409,80547,770,345,425
14110,87367,6790,42038,4409,80577,770,345,425
14115,87398,6791,42054,4409,80607,770,345,425
14120,87429,6792,42071,4409,80637,770,345,425
14125,87460,6793,42086,4409,80667,770,345,425
14130,87491,6794,42101,4410,80697,770,345,425
14135,87522,6795,42116,4411,80727,770,345,425
14140,87553,6796,42138,4411,80757,770,345,425
14145,87584,6798,42154,4412,80786,770,345,425
14150,87615,6800,42168,4412,80815,770,345,425
14155,87646,6802,42182,4413,80844,770,345,425
14160,87677,6804,42197,4413,80873,770,345,425
14165,87708,6807,42211,4413,80901,770,345,425
14170,87739,6810,42226,4416,80929,770,345,425
14175,87770,6814,42245,4418,80955,770,345,425
14180,87801,6819,42262,4421,80981,770,345,425
14185,87832,6823,42282,4423,81009,770,345,425
14190,87863,6826,42299,4424,81037,770,345,425
14195,87894,6830,42315,4427,81064,770,345,425
14200,87925,6834,42325,4428,81091,770,345,425
14205,87956,6837,42338,4429,81119,770,345,425
14210,87987,6840,42356,4431,81147,770,345,425
14215,88018,6845,42370,4433,81173,770,345,425
14220,88049,6849,42383,4435,81200,770,345,425
14225,88080,6852,42398,4437,81228,770,345,425
14230,88111,6855,42411,4438,81256,770,345,425
14235,88142,6858,42425,4440,81284,770,345,425
14240,88173,6859,42438,4441,81314,770,345,425
14245,88204,6860,42454,4442,81344,770,345,425
14250,88235,6861,42464,4443,81374,770,345,425
14255,88266,6862,42480,4443,81404,770,345,425
14260,88297,6863,42493,4444,81434,770,345,425
14265,88328,6864,42510,4444,81464,770,345,425
14270,88359,6865,42526,4444,81494,770,345,425
14275,88390,6866,42546,4445,81524,770,345,425
14280,88421,6867,42557,4445,81554,770,345,425
14285,88452,6869,42569,4446,81582,770,345,425
14290,88483,6871,42585,4447,81612,770,345,425
14295,88514,6871,42600,4447,81643,770,345,425
14300,88545,6871,42618,4447,81674,770,345,425
14305,88576,6871,42632,4447,81705,770,345,425
14310,88607,6871,42645,4447,81736,770,345,425
14315,88638,6872,42661,4448,81766,770,345,425
14320,88669,6873,42674,4449,81796,770,345,425
14325,88700,6874,42685,4450,81826,770,345,425
14330,88731,6875,42705,4451,81856,770,345,425
14335,88762,6877,42722,4453,81885,770,345,425
14340,88793,6878,42733,4454,81915,770,345,425
14345,88824,6882,42748,4456,81942,770,345,425
14350,88855,6886,42761,4459,81969,770,345,425
14355,88886,6891,42777,4461,81995,770,345,425
14360,88917,6895,42791,4463,82022,770,345,425
14365,88948,6899,42804,4466,82049,770,345,425
14370,88979,6903,42818,4468,82076,770,345,425
14375,89010,6908,42831,4470,82102,770,345,425
14380,89041,6913,42846,4473,82128,770,345,425
14385,89072,6917,42864,4477,82155,770,345,425
14390,89103,6920,42875,4479,82183,770,345,425
14395,89134,6928,42889,4483,82206,770,345,425
14400,89165,6933,42904,4485,82232,770,345,425
14405,89196,6937,42922,4488,82258,770,345,425
14410,89227,6943,42939,4492,82284,770,345,425
14415,89258,6946,42957,4493,82311,770,345,425
14420,89289,6950,42971,4497,82338,770,345,425
14425,89320,6954,42981,4499,82365,770,345,425
14430,89351,6957,42993,4502,82394,770,345,425
14435,89382,6959,43007,4503,82423,770,345,425
14440,89413,6961,43018,4504,82452,770,345,425
14445,89444,6963,43032,4505,82481,770,345,425
14450,89475,6965,43047,4506,82509,770,345,425
14455,89506,6967,43064,4508,82539,770,345,425
14460,89537,6968,43085,4509,82569,770,345,425
14465,89568,6970,43104,4510,82598,770,345,425
14470,89599,6971,43122,4510,82628,770,345,425
14475,89630,6972,43140,4511,82658,770,345,425
14480,89661,6973,43152,4512,82688,770,345,425
14485,89692,6974,43169,4513,82718,770,345,425
14490,89723,6975,43183,4513,82748,770,345,425
14495,89754,6976,43196,4513,82778,770,345,425
14500,89785,6977,43214,4514,82808,770,345,425
14505,89816,6979,43235,4516,82837,770,345,425
14510,89847,6980,43245,4516,82867,770,345,425
14515,89878,6981,43261,4517,82897,770,345,425
14520,89909,6982,43276,4518,82927,770,345,425
14525,89940,6986,43294,4522,82954,770,345,425
14530,89971,6989,43309,4525,82982,770,345,425
14535,90002,6992,43320,4527,83009,770,345,425
14540,90033,6998,43338,4533,83034,770,345,425
14545,90064,7002,43350,4536,83061,770,345,425
14550,90095,7007,43366,4541,83088,770,345,425
14555,90126,7012,43384,4543,83113,770,345,425
14560,90157,7015,43404,4546,83141,770,345,425
14565,90188,7018,43414,4548,83170,770,345,425
14570,90219,7021,43426,4550,83197,770,345,425
14575,90250,7024,43433,4552,83226,770,345,425
14580,90281,7027,43447,4554,83253,770,345,425
14585,90312,7029,43460,4555,83283,770,345,425
14590,90343,7030,43477,4556,83313,770,345,425
14595,90374,7031,43488,4556,83343,770,345,425
14600,90405,7032,43499,4556,83372,770,345,425
14605,90436,7034,43519,4558,83401,770,345,425
14610,90467,7036,43534,4560,83430,770,345,425
14615,90498,7038,43553,4562,83460,770,345,425
14620,90529,7039,43568,4562,83490,770,345,425
14625,90560,7040,43584,4563,83520,770,345,425
14630,90591,7041,43599,4564,83550,770,345,425
14635,90622,7043,43609,4565,83579,770,345,425
14640,90653,7045,43623,4567,83608,770,345,425
14645,90684,7050,43641,4571,83633,770,345,425
14650,90715,7054,43655,4573,83660,770,345,425
14655,90746,7058,43672,4576,83687,770,345,425
14660,90777,7062,43684,4578,83714,770,345,425
14665,90808,7066,43696,4581,83742,770,345,425
14670,90839,7071,43713,4585,83768,770,345,425
14675,90870,7075,43722,4587,83795,770,345,425
14680,90901,7079,43735,4590,83822,770,345,425
14685,90932,7082,43749,4591,83850,770,345,425
14690,90963,7085,43767,4593,83878,770,345,425
14695,90994,7089,43780,4595,83904,770,345,425
14700,91025,7095,43792,4599,83929,770,345,425
14705,91056,7097,43808,4600,83959,770,345,425
14710,91087,7099,43827,4602,83988,770,345,425
14715,91118,7100,43839,4602,84018,770,345,425
14720,91149,7102,43858,4604,84047,770,345,425
14725,91180,7103,43870,4604,84077,770,345,425
14730,91211,7105,43887,4606,84106,770,345,425
14735,91242,7107,43904,4608,84135,770,345,425
14740,91273,7109,43927,4610,84164,770,345,425
14745,91304,7110,43944,4610,84194,770,345,425
14750,91335,7112,43961,4611,84222,771,345,426
14755,91366,7115,43975,4614,84250,771,345,426
14760,91397,7120,43992,4617,84277,771,345,426
14765,91428,7123,44004,4618,84304,771,345,426
14770,91459,7127,44016,4621,84331,771,345,426
14775,91490,7131,44038,4624,84357,771,345,426
14780,91521,7135,44051,4627,84386,771,345,426
14785,91552,7138,44069,4629,84413,771,345,426
14790,91583,7141,44081,4632,84441,771,345,426
14795,91614,7144,44096,4634,84470,771,345,426
14800,91645,7146,44111,4635,84499,771,345,426
14805,91676,7147,44127,4635,84528,771,345,426
14810,91707,7149,44140,4636,84558,771,345,426
14815,91738,7151,44150,4637,84586,771,345,426
14820,91769,7154,44168,4639,84615,771,345,426
14825,91800,7157,44185,4642,84643,771,345,426
14830,91831,7160,44202,4644,84671,771,345,426
14835,91862,7162,44213,4644,84700,771,345,426
14840,91893,7165,44226,4645,84728,771,345,426
14845,91924,7168,44245,4648,84756,771,345,426
14850,91955,7171,44258,4650,84784,771,345,426
14855,91986,7175,44272,4654,84811,771,345,426
14860,92017,7178,44286,4655,84839,771,345,426
14865,92048,7183,44303,4659,84865,771,345,426
14870,92079,7185,44312,4660,84894,771,345,426
14875,92110,7187,44323,4661,84923,771,345,426
14880,92141,7190,44338,4663,84951,771,345,426
14885,92172,7190,44348,4663,84982,771,345,426
14890,92203,7190,44365,4663,85013,771,345,426
14895,92234,7191,44377,4664,85043,771,345,426
14900,92265,7192,44386,4664,85073,771,345,426
14905,92296,7193,44401,4665,85103,771,345,426
14910,92327,7194,44420,4666,85133,771,345,426
14915,92358,7195,44435,4666,85163,771,345,426
14920,92389,7196,44449,4666,85193,771,345,426
14925,92420,7197,44463,4666,85222,771,345,426
14930,92451,7200,44474,4667,85251,771,345,426
14935,92482,7203,44485,4668,85278,771,345,426
14940,92513,7207,44503,4670,85305,771,345,426
14945,92544,7213,44517,4673,85331,771,345,426
14950,92575,7216,44534,4675,85359,771,345,426
14955,92606,7219,44547,4676,85387,771,345,426
14960,92637,7222,44559,4676,85415,771,345,426
14965,92668,7225,44568,4676,85443,771,345,426
14970,92699,7229,44583,4679,85470,771,345,426
14975,92730,7233,44594,4680,85497,771,345,426
14980,92761,7237,44609,4683,85524,771,345,426
14985,92792,7240,44622,4684,85552,771,345,426
14990,92823,7244,44634,4685,85579,771,345,426
14995,92854,7248,44646,4688,85606,771,345,426
15000,92885,7251,44662,4689,85634,771,345,426
15005,92916,7251,44674,4689,85665,771,345,426
15010,92947,7251,44687,4689,85696,771,345,426
15015,92978,7251,44703,4689,85727,771,345,426
15020,93009,7251,44712,4689,85758,771,345,426
15025,93040,7251,44724,4689,85789,771,345,426
15030,93071,7251,44741,4689,85820,771,345,426
15035,93102,7251,44760,4689,85851,771,345,426
15040,93133,7251,44773,4689,85882,771,345,426
15045,93164,7251,44786,4689,85913,771,345,426
15050,93195,7251,44800,4689,85943,772,345,427
15055,93226,7255,44814,4693,85971,773,346,427
15060,93257,7256,44831,4694,86001,774,347,427
15065,93288,7261,44846,4696,86027,774,347,427
15070,93319,7265,44863,4698,86054,774,347,427
15075,93350,7269,44878,4700,86081,774,347,427
15080,93381,7274,44894,4704,86107,774,347,427
15085,93412,7277,44914,4707,86135,774,347,427
15090,93443,7280,44926,4710,86163,774,347,427
15095,93474,7284,44946,4714,86190,774,347,427
15100,93505,7288,44962,4717,86217,774,347,427
15105,93536,7292,44980,4720,86244,774,347,427
15110,93567,7296,44998,4723,86271,774,347,427
15115,93598,7301,45017,4727,86297,774,347,427
15120,93629,7305,45031,4728,86324,774,347,427
15125,93660,7308,45041,4730,86352,774,347,427
15130,93691,7310,45060,4731,86381,774,347,427
15135,93722,7313,45074,4734,86408,774,347,427
15140,93753,7317,45091,4737,86436,774,347,427
15145,93784,7319,45103,4739,86465,774,347,427
15150,93815,7322,45122,4741,86493,774,347,427
15155,93846,7324,45134,4742,86522,774,347,427
15160,93877,7327,45150,4743,86549,774,347,427
15165,93908,7331,45172,4746,86577,774,347,427
15170,93939,7332,45185,4746,86607,775,348,427
15175,93970,7333,45201,4747,86636,776,348,428
15180,94001,7336,45217,4749,86665,776,348,428
15185,94032,7338,45233,4750,86694,776,348,428
15190,94063,7339,45245,4751,86724,776,348,428
15195,94094,7340,45261,4751,86754,776,348,428
15200,94125,7341,45279,4751,86784,776,348,428
15205,94156,7343,45295,4753,86813,776,348,428
15210,94187,7344,45309,4754,86843,776,348,428
15215,94218,7345,45323,4754,86873,776,348,428
15220,94249,7346,45337,4754,86903,776,348,428
15225,94280,7347,45355,4754,86933,776,348,428
15230,94311,7348,45372,4754,86963,776,348,428
15235,94342,7350,45390,4755,86992,776,348,428
15240,94373,7352,45404,4755,87021,776,348,428
15245,94404,7356,45419,4757,87048,776,348,428
15250,94435,7360,45433,4760,87075,776,348,428
15255,94466,7364,45454,4763,87102,776,348,428
15260,94497,7368,45468,4764,87129,776,348,428
15265,94528,7372,45479,4765,87156,776,348,428
15270,94559,7377,45495,4769,87181,776,348,428
15275,94590,7383,45510,4772,87207,776,348,428
15280,94621,7389,45527,4777,87232,776,348,428
15285,94652,7393,45541,4778,87258,776,348,428
15290,94683,7400,45556,4784,87282,776,348,428
15295,94714,7407,45569,4788,87306,776,348,428
15300,94745,7413,45585,4793,87331,776,348,428
15305,94776,7415,45601,4794,87361,776,348,428
15310,94807,7416,45618,4795,87391,776,348,428
15315,94838,7417,45636,4796,87421,776,348,428
15320,94869,7418,45650,4797,87451,776,348,428
15325,94900,7419,45666,4797,87481,776,348,428
15330,94931,7420,45684,4797,87511,776,348,428
15335,94962,7421,45703,4797,87541,776,348,428
15340,94993,7422,45722,4798,87571,776,348,428
15345,95024,7423,45736,4799,87601,776,348,428
15350,95055,7424,45753,4799,87631,776,348,428
15355,95086,7425,45770,4800,87661,776,348,428
15360,95117,7426,45785,4800,87691,776,348,428
15365,95148,7431,45801,4802,87717,776,348,428
15370,95179,7434,45813,4804,87745,776,348,428
15375,95210,7436,45821,4804,87774,776,348,428
15380,95241,7438,45834,4806,87803,776,348,428
15385,95272,7440,45852,4807,87832,776,348,428
15390,95303,7442,45869,4807,87861,776,348,428
15395,95334,7444,45885,4809,87890,776,348,428
15400,95365,7446,45896,4811,87919,776,348,428
15405,95396,7448,45909,4813,87948,776,348,428
15410,95427,7450,45926,4815,87977,777,348,429
15415,95458,7452,45941,4816,88006,777,348,429
15420,95489,7455,45966,4819,88033,777,348,429
15425,95520,7459,45978,4821,88061,777,348,429
15430,95551,7461,45992,4822,88090,777,348,429
15435,95582,7464,46007,4824,88118,777,348,429
15440,95613,7467,46024,4826,88146,777,348,429
15445,95644,7470,46039,4829,88174,777,348,429
15450,95675,7473,46057,4831,88202,777,348,429
15455,95706,7474,46075,4831,88232,777,348,429
15460,95737,7475,46090,4831,88262,777,348,429
15465,95768,7476,46107,4832,88292,777,348,429
15470,95799,7477,46124,4833,88321,777,348,429
15475,95830,7480,46142,4835,88350,777,348,429
15480,95861,7484,46158,4838,88376,777,348,429
15485,95892,7487,46174,4841,88405,777,348,429
15490,95923,7489,46190,4842,88434,777,348,429
15495,95954,7490,46205,4843,88464,777,348,429
15500,95985,7491,46217,4843,88494,777,348,429
15505,96016,7493,46229,4844,88523,777,348,429
15510,96047,7495,46240,4846,88552,777,348,429
15515,96078,7496,46255,4846,88582,777,348,429
15520,96109,7497,46273,4847,88612,777,348,429
15525,96140,7498,46288,4847,88642,777,348,429
15530,96171,7502,46301,4850,88669,777,348,429
15535,96202,7505,46317,4851,88697,777,348,429
15540,96233,7508,46330,4852,88725,777,348,429
15545,96264,7511,46343,4853,88753,777,348,429
15550,96295,7515,46354,4856,88779,777,348,429
15555,96326,7519,46372,4859,88807,777,348,429
15560,96357,7521,46384,4859,88836,777,348,429
15565,96388,7523,46398,4860,88865,777,348,429
15570,96419,7525,46414,4860,88894,777,348,429
15575,96450,7527,46430,4861,88923,777,348,429
15580,96481,7529,46445,4863,88952,777,348,429
15585,96512,7531,46459,4864,88981,777,348,429
15590,96543,7533,46478,4866,89010,777,348,429
15595,96574,7535,46496,4866,89039,777,348,429
15600,96605,7537,46510,4868,89068,777,348,429
15605,96636,7542,46528,4873,89093,778,348,430
15610,96667,7546,46546,4874,89121,778,348,430
15615,96698,7548,46568,4875,89150,778,348,430
15620,96729,7550,46582,4876,89179,778,348,430
15625,96760,7552,46594,4877,89208,778,348,430
15630,96791,7554,46602,4877,89237,778,348,430
15635,96822,7556,46616,4878,89266,778,348,430
15640,96853,7558,46631,4879,89295,778,348,430
15645,96884,7560,46647,4879,89324,778,348,430
15650,96915,7563,46664,4881,89352,778,348,430
15655,96946,7566,46684,4884,89380,778,348,430
15660,96977,7570,46703,4885,89407,778,348,430
15665,97008,7572,46715,4887,89436,778,348,430
15670,97039,7574,46731,4888,89464,778,348,430
15675,97070,7578,46746,4890,89491,778,348,430
15680,97101,7582,46761,4894,89519,778,348,430
15685,97132,7583,46778,4895,89549,778,348,430
15690,97163,7585,46793,4897,89577,778,348,430
15695,97194,7587,46806,4899,89607,778,348,430
15700,97225,7588,46823,4900,89637,778,348,430
15705,97256,7589,46838,4901,89667,778,348,430
15710,97287,7591,46852,4902,89696,778,348,430
15715,97318,7592,46865,4903,89725,778,348,430
15720,97349,7595,46881,4904,89753,779,349,430
15725,97380,7598,46902,4906,89782,779,349,430
15730,97411,7600,46923,4908,89811,779,349,430
15735,97442,7602,46939,4910,89840,779,349,430
15740,97473,7604,46954,4910,89869,779,349,430
15745,97504,7606,46971,4911,89898,779,349,430
15750,97535,7608,46983,4911,89927,779,349,430
15755,97566,7610,46996,4911,89956,779,349,430
15760,97597,7612,47011,4912,89985,779,349,430
15765,97628,7614,47024,4913,90014,779,349,430
15770,97659,7616,47041,4914,90043,779,349,430
15775,97690,7618,47057,4915,90072,779,349,430
15780,97721,7620,47071,4917,90101,779,349,430
15785,97752,7622,47082,4918,90129,779,349,430
15790,97783,7625,47093,4919,90158,779,349,430
15795,97814,7627,47106,4920,90187,779,349,430
15800,97845,7629,47123,4920,90216,779,349,430
15805,97876,7631,47141,4921,90245,779,349,430
15810,97907,7633,47161,4921,90274,779,349,430
15815,97938,7635,47177,4921,90303,779,349,430
15820,97969,7637,47191,4921,90332,779,349,430
15825,98000,7639,47209,4923,90361,780,350,430
15830,98031,7641,47220,4924,90390,781,351,430
15835,98062,7643,47232,4925,90419,782,351,431
15840,98093,7645,47252,4927,90448,783,351,432
15845,98124,7647,47268,4929,90477,783,351,432
15850,98155,7649,47284,4930,90506,783,351,432
15855,98186,7651,47304,4932,90535,783,351,432
15860,98217,7654,47321,4933,90563,783,351,432
15865,98248,7656,47332,4935,90592,783,351,432
15870,98279,7658,47345,4936,90621,783,351,432
15875,98310,7660,47363,4938,90650,783,351,432
15880,98341,7663,47373,4939,90678,783,351,432
15885,98372,7667,47391,4941,90705,783,351,432
15890,98403,7673,47411,4946,90730,783,351,432
15895,98434,7677,47424,4947,90757,783,351,432
15900,98465,7681,47440,4950,90784,783,351,432
15905,98496,7684,47456,4952,90811,783,351,432
15910,98527,7688,47472,4956,90838,783,351,432
15915,98558,7691,47487,4959,90866,783,351,432
15920,98589,7694,47504,4962,90894,783,351,432
15925,98620,7697,47515,4963,90923,783,351,432
15930,98651,7698,47526,4963,90953,783,351,432
15935,98682,7699,47541,4963,90983,783,351,432
15940,98713,7700,47561,4964,91013,783,351,432
15945,98744,7701,47575,4965,91043,783,351,432
15950,98775,7702,47589,4965,91073,783,351,432
15955,98806,7703,47600,4965,91103,783,351,432
15960,98837,7704,47612,4966,91133,783,351,432
15965,98868,7705,47627,4967,91163,783,351,432
15970,98899,7706,47641,4968,91193,783,351,432
15975,98930,7707,47656,4968,91223,783,351,432
15980,98961,7708,47671,4968,91253,783,351,432
15985,98992,7709,47684,4968,91283,783,351,432
15990,99023,7710,47696,4968,91313,783,351,432
15995,99054,7711,47714,4969,91343,783,351,432
16000,99085,7712,47724,4969,91373,783,351,432
16005,99116,7714,47736,4970,91402,783,351,432
16010,99147,7717,47751,4971,91429,783,351,432
16015,99178,7720,47769,4974,91458,783,351,432
16020,99209,7722,47788,4976,91486,783,351,432
16025,99240,7727,47805,4978,91513,783,351,432
16030,99271,7731,47821,4980,91540,783,351,432
16035,99302,7735,47837,4981,91567,783,351,432
16040,99333,7740,47857,4984,91593,783,351,432
16045,99364,7743,47872,4986,91621,783,351,432
16050,99395,7748,47884,4989,91647,783,351,432
16055,99426,7753,47898,4992,91672,783,351,432
16060,99457,7758,47913,4996,91699,783,351,432
16065,99488,7763,47930,5000,91725,783,351,432
16070,99519,7768,47944,5004,91750,783,351,432
16075,99550,7773,47958,5009,91776,783,351,432
16080,99581,7778,47970,5012,91803,783,351,432
16085,99612,7779,47983,5013,91833,783,351,432
16090,99643,7779,47997,5013,91864,783,351,432
16095,99674,7779,48012,5013,91895,783,351,432
16100,99705,7779,48030,5013,91926,783,351,432
16105,99736,7779,48047,5013,91957,783,351,432
16110,99767,7779,48059,5013,91988,783,351,432
16115,99798,7779,48076,5013,92019,783,351,432
16120,99829,7780,48091,5014,92049,783,351,432
16125,99860,7781,48106,5014,92079,783,351,432
16130,99891,7782,48122,5014,92109,783,351,432
16135,99922,7783,48133,5014,92139,783,351,432
16140,99953,7784,48140,5014,92169,783,351,432
16145,99984,7790,48153,5018,92194,783,351,432
16150,100015,7793,48168,5021,92221,783,351,432
16155,100046,7797,48183,5023,92249,783,351,432
16160,100077,7801,48196,5025,92275,783,351,432
16165,100108,7806,48210,5029,92302,783,351,432
16170,100139,7809,48230,5031,92330,783,351,432
16175,100170,7811,48246,5032,92359,783,351,432
16180,100201,7813,48265,5033,92388,783,351,432
16185,100232,7815,48276,5034,92417,783,351,432
16190,100263,7818,48286,5035,92445,783,351,432
16195,100294,7821,48302,5037,92473,783,351,432
16200,100325,7824,48317,5039,92501,783,351,432
16205,100356,7827,48330,5040,92529,783,351,432
16210,100387,7830,48342,5040,92557,783,351,432
16215,100418,7833,48359,5041,92585,783,351,432
16220,100449,7836,48376,5042,92613,783,351,432
16225,100480,7839,48391,5044,92641,783,351,432
16230,100511,7842,48405,5045,92669,783,351,432
16235,100542,7845,48420,5046,92697,783,351,432
16240,100573,7848,48442,5049,92725,783,351,432
16245,100604,7851,48457,5049,92753,783,351,432
16250,100635,7854,48466,5049,92781,783,351,432
16255,100666,7857,48481,5050,92809,783,351,432
16260,100697,7860,48497,5052,92837,783,351,432
16265,100728,7863,48507,5052,92865,783,351,432
16270,100759,7867,48519,5054,92892,783,351,432
16275,100790,7870,48533,5055,92920,783,351,432
16280,100821,7872,48546,5056,92949,783,351,432
16285,100852,7874,48556,5057,92978,783,351,432
16290,100883,7876,48569,5057,93006,783,351,432
16295,100914,7879,48580,5058,93034,783,351,432
16300,100945,7882,48598,5060,93062,783,351,432
16305,100976,7887,48615,5065,93088,783,351,432
16310,101007,7893,48628,5070,93114,783,351,432
16315,101038,7897,48647,5074,93141,783,351,432
16320,101069,7899,48661,5076,93170,783,351,432
16325,101100,7902,48672,5077,93198,783,351,432
16330,101131,7904,48684,5078,93227,783,351,432
16335,101162,7907,48697,5081,93255,783,351,432
16340,101193,7910,48710,5082,93283,783,351,432
16345,101224,7912,48730,5083,93311,783,351,432
16350,101255,7914,48749,5085,93340,783,351,432
16355,101286,7916,48760,5086,93370,783,351,432
16360,101317,7917,48780,5086,93399,783,351,432
16365,101348,7919,48794,5087,93429,783,351,432
16370,101379,7920,48809,5087,93459,783,351,432
16375,101410,7921,48820,5087,93489,783,351,432
16380,101441,7924,48836,5088,93517,783,351,432
16385,101472,7927,48849,5089,93545,783,351,432
16390,101503,7930,48867,5091,93573,783,351,432
16395,101534,7933,48883,5092,93601,783,351,432
16400,101565,7936,48899,5094,93629,783,351,432
16405,101596,7939,48917,5096,93657,783,351,432
16410,101627,7942,48926,5097,93685,783,351,432
16415,101658,7945,48942,5098,93713,783,351,432
16420,101689,7949,48956,5099,93740,783,351,432
16425,101720,7953,48972,5102,93767,783,351,432
16430,101751,7957,48991,5103,93794,783,351,432
16435,101782,7962,49001,5104,93820,783,351,432
16440,101813,7967,49022,5107,93846,783,351,432
16445,101844,7969,49036,5108,93875,783,351,432
16450,101875,7971,49057,5109,93904,783,351,432
16455,101906,7974,49071,5112,93932,783,351,432
16460,101937,7977,49086,5114,93960,783,351,432
16465,101968,7979,49099,5115,93989,783,351,432
16470,101999,7981,49120,5116,94018,783,351,432
16475,102030,7983,49140,5118,94047,783,351,432
16480,102061,7986,49150,5120,94075,783,351,432
16485,102092,7989,49165,5122,94103,783,351,432
16490,102123,7992,49170,5123,94130,783,351,432
16495,102154,7996,49186,5127,94158,783,351,432
16500,102185,7999,49201,5128,94185,783,351,432
16505,102216,8001,49216,5129,94215,783,351,432
16510,102247,8002,49227,5129,94245,783,351,432
16515,102278,8003,49239,5129,94275,783,351,432
16520,102309,8004,49248,5130,94305,783,351,432
16525,102340,8005,49263,5130,94335,783,351,432
16530,102371,8006,49279,5131,94365,783,351,432
16535,102402,8007,49293,5131,94395,783,351,432
16540,102433,8008,49311,5132,94425,783,351,432
16545,102464,8009,49328,5133,94455,783,351,432
16550,102495,8011,49342,5135,94484,783,351,432
16555,102526,8015,49354,5137,94510,783,351,432
16560,102557,8020,49372,5141,94536,783,351,432
16565,102588,8023,49388,5144,94565,783,351,432
16570,102619,8024,49400,5144,94595,783,351,432
16575,102650,8025,49414,5144,94625,783,351,432
16580,102681,8027,49430,5146,94654,783,351,432
16585,102712,8028,49446,5147,94684,783,351,432
16590,102743,8029,49459,5147,94714,783,351,432
16595,102774,8031,49476,5149,94743,783,351,432
16600,102805,8032,49495,5150,94773,783,351,432
16605,102836,8033,49509,5150,94803,783,351,432
16610,102867,8037,49531,5153,94829,783,351,432
16615,102898,8042,49547,5157,94856,783,351,432
16620,102929,8047,49561,5161,94882,783,351,432
16625,102960,8049,49576,5162,94911,783,351,432
16630,102991,8052,49590,5163,94939,783,351,432
16635,103022,8055,49601,5166,94967,783,351,432
16640,103053,8058,49617,5168,94995,783,351,432
16645,103084,8059,49633,5168,95025,783,351,432
16650,103115,8060,49647,5168,95055,783,351,432
16655,103146,8061,49661,5169,95085,783,351,432
16660,103177,8062,49676,5170,95115,783,351,432
16665,103208,8065,49692,5171,95143,783,351,432
16670,103239,8068,49704,5173,95171,783,351,432
16675,103270,8072,49722,5177,95198,783,351,432
16680,103301,8077,49736,5179,95223,783,351,432
16685,103332,8084,49755,5185,95247,783,351,432
16690,103363,8089,49770,5189,95274,783,351,432
16695,103394,8092,49787,5192,95302,783,351,432
16700,103425,8096,49800,5193,95329,783,351,432
16705,103456,8099,49812,5194,95357,783,351,432
16710,103487,8103,49829,5196,95384,783,351,432
16715,103518,8106,49843,5197,95412,783,351,432
16720,103549,8110,49857,5199,95438,783,351,432
16725,103580,8115,49874,5203,95465,783,351,432
16730,103611,8120,49892,5206,95490,783,351,432
16735,103642,8124,49904,5208,95517,783,351,432
16740,103673,8126,49919,5209,95547,783,351,432
16745,103704,8127,49932,5209,95577,783,351,432
16750,103735,8128,49945,5209,95607,783,351,432
16755,103766,8129,49961,5209,95637,783,351,432
16760,103797,8130,49977,5210,95667,783,351,432
16765,103828,8131,49989,5210,95697,783,351,432
16770,103859,8132,50006,5211,95727,783,351,432
16775,103890,8133,50020,5211,95757,783,351,432
16780,103921,8134,50031,5211,95787,783,351,432
16785,103952,8135,50047,5211,95817,783,351,432
16790,103983,8136,50062,5212,95847,783,351,432
16795,104014,8137,50080,5213,95877,783,351,432
16800,104045,8139,50097,5214,95906,783,351,432
16805,104076,8143,50110,5217,95933,783,351,432
16810,104107,8145,50126,5218,95962,783,351,432
16815,104138,8147,50138,5218,95991,783,351,432
16820,104169,8149,50153,5219,96019,783,351,432
16825,104200,8152,50171,5221,96047,783,351,432
16830,104231,8155,50181,5223,96076,783,351,432
16835,104262,8157,50192,5223,96105,783,351,432
16840,104293,8160,50205,5225,96132,783,351,432
16845,104324,8165,50218,5228,96159,783,351,432
16850,104355,8169,50235,5231,96186,783,351,432
16855,104386,8172,50253,5233,96213,783,351,432
16860,104417,8176,50266,5235,96241,783,351,432
16865,104448,8178,50275,5236,96270,783,351,432
16870,104479,8180,50284,5236,96299,783,351,432
16875,104510,8182,50302,5237,96328,783,351,432
16880,104541,8184,50321,5238,96355,783,351,432
16885,104572,8188,50336,5240,96384,783,351,432
16890,104603,8189,50350,5240,96414,783,351,432
16895,104634,8190,50359,5241,96444,783,351,432
16900,104665,8191,50376,5241,96473,783,351,432
16905,104696,8193,50393,5242,96502,783,351,432
16910,104727,8195,50407,5243,96532,783,351,432
16915,104758,8197,50424,5245,96561,783,351,432
16920,104789,8199,50440,5245,96589,783,351,432
16925,104820,8204,50451,5249,96616,783,351,432
16930,104851,8209,50470,5252,96642,783,351,432
16935,104882,8213,50482,5255,96669,783,351,432
16940,104913,8216,50496,5256,96697,783,351,432
16945,104944,8218,50505,5257,96726,783,351,432
16950,104975,8221,50515,5259,96754,783,351,432
16955,105006,8224,50531,5261,96782,783,351,432
16960,105037,8227,50544,5262,96810,783,351,432
16965,105068,8230,50557,5265,96838,783,351,432
16970,105099,8232,50572,5266,96867,783,351,432
16975,105130,8234,50586,5268,96896,783,351,432
16980,105161,8236,50601,5270,96925,783,351,432
16985,105192,8239,50611,5271,96953,783,351,432
16990,105223,8242,50623,5272,96981,783,351,432
16995,105254,8244,50638,5273,97010,783,351,432
17000,105285,8246,50655,5274,97039,783,351,432
17005,105316,8248,50664,5274,97068,783,351,432
17010,105347,8250,50678,5275,97097,783,351,432
17015,105378,8253,50697,5277,97125,783,351,432
17020,105409,8255,50714,5278,97154,783,351,432
17025,105440,8255,50731,5278,97185,783,351,432
17030,105471,8255,50752,5278,97216,783,351,432
17035,105502,8255,50767,5278,97247,783,351,432
17040,105533,8256,50784,5279,97277,783,351,432
17045,105564,8260,50795,5280,97304,783,351,432
17050,105595,8264,50809,5282,97331,783,351,432
17055,105626,8269,50824,5284,97357,783,351,432
17060,105657,8273,50839,5286,97384,783,351,432
17065,105688,8279,50857,5290,97409,783,351,432
17070,105719,8283,50872,5293,97436,783,351,432
17075,105750,8288,50889,5298,97462,783,351,432
17080,105781,8292,50901,5299,97489,783,351,432
17085,105812,8297,50917,5304,97515,783,351,432
17090,105843,8302,50935,5308,97540,783,351,432
17095,105874,8307,50946,5311,97567,783,351,432
17100,105905,8310,50963,5313,97595,783,351,432
17105,105936,8313,50979,5315,97622,783,351,432
17110,105967,8315,50998,5317,97652,783,351,432
17115,105998,8315,51012,5317,97683,783,351,432
17120,106029,8315,51024,5317,97714,783,351,432
17125,106060,8315,51039,5317,97745,783,351,432
17130,106091,8315,51052,5317,97776,783,351,432
17135,106122,8315,51073,5317,97807,783,351,432
17140,106153,8315,51087,5317,97838,783,351,432
17145,106184,8315,51100,5317,97869,783,351,432
17150,106215,8315,51114,5317,97900,783,351,432
17155,106246,8315,51130,5317,97931,783,351,432
17160,106277,8315,51150,5317,97962,783,351,432
17165,106308,8315,51166,5317,97993,783,351,432
17170,106339,8315,51178,5317,98024,783,351,432
17175,106370,8315,51192,5317,98055,783,351,432
17180,106401,8315,51203,5317,98086,783,351,432
17185,106432,8315,51216,5317,98117,783,351,432
17190,106463,8315,51226,5317,98148,783,351,432
17195,106494,8315,51239,5317,98179,783,351,432
17200,106525,8315,51252,5317,98210,783,351,432
17205,106556,8318,51265,5319,98238,783,351,432
17210,106587,8322,51282,5322,98265,783,351,432
17215,106618,8325,51295,5324,98291,783,351,432
17220,106649,8333,51313,5329,98314,783,351,432
17225,106680,8339,51324,5332,98340,783,351,432
17230,106711,8343,51340,5333,98368,783,351,432
17235,106742,8346,51354,5333,98396,783,351,432
17240,106773,8349,51362,5334,98424,783,351,432
17245,106804,8352,51378,5335,98451,783,351,432
17250,106835,8356,51391,5338,98478,783,351,432
17255,106866,8360,51407,5340,98506,783,351,432
17260,106897,8362,51420,5341,98535,783,351,432
17265,106928,8364,51440,5342,98564,783,351,432
17270,106959,8366,51456,5343,98593,783,351,432
17275,106990,8368,51469,5343,98622,783,351,432
17280,107021,8370,51487,5344,98651,783,351,432
17285,107052,8372,51504,5345,98680,783,351,432
17290,107083,8374,51521,5345,98709,783,351,432
17295,107114,8376,51536,5345,98738,783,351,432
17300,107145,8378,51552,5345,98767,783,351,432
17305,107176,8380,51568,5347,98796,783,351,432
17310,107207,8382,51587,5349,98825,783,351,432
17315,107238,8384,51601,5349,98854,783,351,432
17320,107269,8386,51616,5350,98883,783,351,432
17325,107300,8388,51631,5351,98912,783,351,432
17330,107331,8391,51642,5353,98940,783,351,432
17335,107362,8395,51657,5355,98967,783,351,432
17340,107393,8400,51677,5359,98993,783,351,432
17345,107424,8404,51693,5361,99020,783,351,432
17350,107455,8407,51708,5364,99048,783,351,432
17355,107486,8411,51719,5367,99075,783,351,432
17360,107517,8414,51729,5369,99102,783,351,432
17365,107548,8419,51745,5372,99128,783,351,432
17370,107579,8424,51762,5375,99154,783,351,432
17375,107610,8428,51780,5377,99181,783,351,432
17380,107641,8433,51794,5380,99208,783,351,432
17385,107672,8436,51807,5382,99236,783,351,432
17390,107703,8438,51820,5384,99265,783,351,432
17395,107734,8440,51836,5385,99294,783,351,432
17400,107765,8442,51850,5386,99323,783,351,432
17405,107796,8444,51864,5386,99352,783,351,432
17410,107827,8446,51879,5387,99381,783,351,432
17415,107858,8448,51892,5388,99410,783,351,432
17420,107889,8450,51904,5389,99439,783,351,432
17425,107920,8452,51920,5391,99468,783,351,432
17430,107951,8454,51935,5391,99497,783,351,432
17435,107982,8456,51952,5392,99526,783,351,432
17440,108013,8458,51966,5393,99555,783,351,432
17445,108044,8460,51976,5394,99584,783,351,432
17450,108075,8464,51990,5396,99610,783,351,432
17455,108106,8467,51999,5398,99638,783,351,432
17460,108137,8472,52015,5402,99664,783,351,432
17465,108168,8476,52030,5405,99692,783,351,432
17470,108199,8477,52045,5405,99722,783,351,432
17475,108230,8479,52068,5407,99751,783,351,432
17480,108261,8480,52084,5407,99781,783,351,432
17485,108292,8481,52098,5408,99811,783,351,432
17490,108323,8482,52113,5408,99841,783,351,432
17495,108354,8483,52126,5409,99871,783,351,432
17500,108385,8484,52137,5409,99901,783,351,432
17505,108416,8485,52152,5409,99931,783,351,432
17510,108447,8486,52162,5410,99961,783,351,432
17515,108478,8488,52183,5412,99990,783,351,432
17520,108509,8489,52200,5412,100020,783,351,432
17525,108540,8493,52211,5414,100047,783,351,432
17530,108571,8496,52224,5415,100075,783,351,432
17535,108602,8499,52240,5415,100103,783,351,432
17540,108633,8503,52255,5418,100130,783,351,432
17545,108664,8507,52272,5421,100157,783,351,432
17550,108695,8510,52288,5424,100185,783,351,432
17555,108726,8513,52302,5424,100213,783,351,432
17560,108757,8517,52320,5426,100240,783,351,432
17565,108788,8523,52340,5431,100265,783,351,432
17570,108819,8528,52355,5434,100290,783,351,432
17575,108850,8536,52375,5440,100313,783,351,432
17580,108881,8541,52391,5444,100339,783,351,432
17585,108912,8544,52405,5446,100368,783,351,432
17590,108943,8545,52418,5446,100398,783,351,432
17595,108974,8547,52431,5448,100427,783,351,432
17600,109005,8549,52444,5450,100456,783,351,432
17605,109036,8550,52457,5450,100486,783,351,432
17610,109067,8551,52469,5450,100516,783,351,432
17615,109098,8552,52485,5451,100546,783,351,432
17620,109129,8554,52499,5453,100575,783,351,432
17625,109160,8556,52517,5454,100604,783,351,432
17630,109191,8557,52535,5455,100634,783,351,432
17635,109222,8559,52550,5457,100663,783,351,432
17640,109253,8560,52565,5458,100693,783,351,432
17645,109284,8563,52578,5460,100721,783,351,432
17650,109315,8565,52591,5460,100750,783,351,432
17655,109346,8567,52598,5460,100779,783,351,432
17660,109377,8570,52613,5462,100807,783,351,432
17665,109408,8572,52627,5464,100836,783,351,432
17670,109439,8574,52643,5466,100865,783,351,432
17675,109470,8576,52655,5467,100894,783,351,432
17680,109501,8578,52667,5468,100923,783,351,432
17685,109532,8583,52685,5472,100949,783,351,432
17690,109563,8589,52698,5476,100974,783,351,432
17695,109594,8596,52721,5483,100998,783,351,432
17700,109625,8601,52734,5487,101024,783,351,432
17705,109656,8606,52751,5489,101050,783,351,432
17710,109687,8608,52766,5490,101079,783,351,432
17715,109718,8610,52779,5490,101108,783,351,432
17720,109749,8612,52796,5492,101137,783,351,432
17725,109780,8613,52816,5492,101167,783,351,432
17730,109811,8614,52838,5493,101197,783,351,432
17735,109842,8615,52854,5493,101227,783,351,432
17740,109873,8616,52873,5494,101257,783,351,432
17745,109904,8617,52885,5494,101287,783,351,432
17750,109935,8618,52898,5494,101317,783,351,432
17755,109966,8619,52911,5495,101347,783,351,432
17760,109997,8620,52933,5495,101377,783,351,432
17765,110028,8621,52953,5496,101407,783,351,432
17770,110059,8622,52964,5497,101437,783,351,432
17775,110090,8623,52977,5498,101467,783,351,432
17780,110121,8624,52998,5498,101497,783,351,432
17785,110152,8625,53014,5499,101527,783,351,432
17790,110183,8627,53031,5500,101556,783,351,432
17795,110214,8629,53044,5501,101585,783,351,432
17800,110245,8632,53063,5504,101613,783,351,432
17805,110276,8634,53077,5506,101642,783,351,432
17810,110307,8637,53097,5508,101670,783,351,432
17815,110338,8640,53115,5510,101698,783,351,432
17820,110369,8644,53134,5513,101724,783,351,432
17825,110400,8650,53152,5517,101750,783,351,432
17830,110431,8656,53169,5521,101774,783,351,432
17835,110462,8662,53186,5525,101799,783,351,432
17840,110493,8668,53202,5529,101825,783,351,432
17845,110524,8672,53216,5532,101852,783,351,432
17850,110555,8675,53224,5533,101879,783,351,432
17855,110586,8678,53237,5535,101908,783,351,432
17860,110617,8680,53251,5535,101937,783,351,432
17865,110648,8682,53261,5536,101966,783,351,432
17870,110679,8684,53278,5538,101994,783,351,432
17875,110710,8687,53295,5540,102022,783,351,432
17880,110741,8690,53309,5542,102051,783,351,432
17885,110772,8692,53323,5543,102080,783,351,432
17890,110803,8694,53338,5544,102109,783,351,432
17895,110834,8696,53357,5545,102138,783,351,432
17900,110865,8698,53373,5547,102167,783,351,432
17905,110896,8700,53389,5548,102196,783,351,432
17910,110927,8702,53403,5549,102225,783,351,432
17915,110958,8704,53418,5549,102254,783,351,432
17920,110989,8707,53438,5552,102282,783,351,432
17925,111020,8710,53452,5554,102309,783,351,432
17930,111051,8714,53465,5557,102337,783,351,432
17935,111082,8716,53476,5559,102366,783,351,432
17940,111113,8718,53491,5560,102395,783,351,432
17945,111144,8720,53499,5561,102424,783,351,432
17950,111175,8724,53519,5563,102451,783,351,432
17955,111206,8727,53538,5566,102479,783,351,432
17960,111237,8730,53556,5568,102507,783,351,432
17965,111268,8733,53568,5569,102535,783,351,432
17970,111299,8737,53582,5571,102562,783,351,432
17975,111330,8741,53595,5573,102589,783,351,432
17980,111361,8745,53610,5576,102616,783,351,432
17985,111392,8749,53627,5579,102643,783,351,432
17990,111423,8753,53639,5582,102670,783,351,432
17995,111454,8754,53652,5582,102700,783,351,432
18000,111485,8755,53665,5583,102730,783,351,432
18005,111516,8755,53680,5583,102761,783,351,432
18010,111547,8755,53691,5583,102792,783,351,432
18015,111578,8755,53705,5583,102823,783,351,432
18020,111609,8755,53723,5583,102854,783,351,432
18025,111640,8755,53737,5583,102885,783,351,432
18030,111671,8755,53754,5583,102916,783,351,432
18035,111702,8755,53775,5583,102947,783,351,432
18040,111733,8755,53789,5583,102978,783,351,432
18045,111764,8755,53805,5583,103009,783,351,432
18050,111795,8757,53823,5584,103038,783,351,432
18055,111826,8760,53837,5585,103065,783,351,432
18060,111857,8763,53853,5587,103092,783,351,432
18065,111888,8769,53870,5591,103118,783,351,432
18070,111919,8773,53881,5594,103145,783,351,432
18075,111950,8777,53895,5596,103173,783,351,432
18080,111981,8780,53905,5597,103201,783,351,432
18085,112012,8782,53927,5599,103229,783,351,432
18090,112043,8785,53938,5601,103258,783,351,432
18095,112074,8787,53954,5602,103286,783,351,432
18100,112105,8790,53968,5604,103315,783,351,432
18105,112136,8792,53983,5605,103344,783,351,432
18110,112167,8795,53993,5607,103372,783,351,432
18115,112198,8798,54010,5608,103400,783,351,432
18120,112229,8802,54026,5610,103427,783,351,432
18125,112260,8804,54043,5612,103456,783,351,432
18130,112291,8804,54056,5612,103487,783,351,432
18135,112322,8804,54072,5612,103518,783,351,432
18140,112353,8804,54088,5612,103549,783,351,432
18145,112384,8804,54099,5612,103580,783,351,432
18150,112415,8804,54113,5612,103611,783,351,432
18155,112446,8804,54130,5612,103642,783,351,432
18160,112477,8804,54147,5612,103673,783,351,432
18165,112508,8804,54160,5612,103704,783,351,432
18170,112539,8804,54169,5612,103735,783,351,432
18175,112570,8806,54187,5614,103764,783,351,432
18180,112601,8810,54201,5616,103791,783,351,432
18185,112632,8814,54217,5619,103818,783,351,432
18190,112663,8818,54231,5620,103844,783,351,432
18195,112694,8824,54247,5625,103870,783,351,432
18200,112725,8828,54263,5628,103896,783,351,432
18205,112756,8834,54277,5631,103922,783,351,432
18210,112787,8838,54294,5633,103947,783,351,432
18215,112818,8844,54305,5636,103974,783,351,432
18220,112849,8849,54319,5638,103999,783,351,432
18225,112880,8855,54334,5642,104025,783,351,432
18230,112911,8860,54345,5644,104051,783,351,432
18235,112942,8864,54357,5647,104078,783,351,432
18240,112973,8868,54371,5649,104104,783,351,432
18245,113004,8874,54393,5653,104129,783,351,432
18250,113035,8878,54406,5656,104157,783,351,432
18255,113066,8879,54417,5656,104187,783,351,432
18260,113097,8881,54432,5658,104216,783,351,432
18265,113128,8883,54446,5659,104245,783,351,432
18270,113159,8884,54461,5659,104275,783,351,432
18275,113190,8884,54474,5659,104306,783,351,432
18280,113221,8884,54487,5659,104337,783,351,432
18285,113252,8884,54501,5659,104368,783,351,432
18290,113283,8884,54521,5659,104399,783,351,432
18295,113314,8884,54539,5659,104430,783,351,432
18300,113345,8884,54555,5659,104461,783,351,432
18305,113376,8884,54569,5659,104492,783,351,432
18310,113407,8884,54586,5659,104523,783,351,432
18315,113438,8884,54603,5659,104554,783,351,432
18320,113469,8884,54616,5659,104585,783,351,432
18325,113500,8884,54628,5659,104616,783,351,432
18330,113531,8884,54641,5659,104647,783,351,432
18335,113562,8884,54659,5659,104678,783,351,432
18340,113593,8884,54670,5659,104709,783,351,432
18345,113624,8884,54689,5659,104740,783,351,432
18350,113655,8886,54701,5660,104769,783,351,432
18355,113686,8889,54714,5661,104797,783,351,432
18360,113717,8892,54735,5662,104824,783,351,432
18365,113748,8899,54748,5666,104848,783,351,432
18370,113779,8906,54762,5670,104873,783,351,432
18375,113810,8912,54777,5672,104897,783,351,432
18380,113841,8918,54790,5675,104923,783,351,432
18385,113872,8924,54805,5679,104947,783,351,432
18390,113903,8929,54819,5682,104974,783,351,432
18395,113934,8934,54837,5685,104999,783,351,432
18400,113965,8941,54853,5688,105024,783,351,432
18405,113996,8944,54864,5688,105052,783,351,432
18410,114027,8947,54875,5690,105080,783,351,432
18415,114058,8951,54894,5693,105107,783,351,432
18420,114089,8955,54905,5695,105134,783,351,432
18425,114120,8958,54917,5695,105162,783,351,432
18430,114151,8962,54931,5698,105189,783,351,432
18435,114182,8966,54944,5701,105216,783,351,432
18440,114213,8969,54955,5702,105244,783,351,432
18445,114244,8973,54971,5704,105271,783,351,432
18450,114275,8976,54987,5705,105299,783,351,432
18455,114306,8979,55000,5707,105327,783,351,432
18460,114337,8982,55015,5709,105355,783,351,432
18465,114368,8985,55027,5710,105383,783,351,432
18470,114399,8988,55043,5712,105411,783,351,432
18475,114430,8991,55062,5714,105439,783,351,432
18480,114461,8994,55079,5716,105467,783,351,432
18485,114492,8996,55093,5717,105496,783,351,432
18490,114523,8997,55107,5717,105525,783,351,432
18495,114554,8999,55119,5718,105555,783,351,432
18500,114585,9000,55136,5718,105584,783,351,432
18505,114616,9001,55152,5719,105615,783,351,432
18510,114647,9001,55166,5719,105646,783,351,432
18515,114678,9001,55185,5719,105677,783,351,432
18520,114709,9001,55199,5719,105708,783,351,432
18525,114740,9001,55213,5719,105739,783,351,432
18530,114771,9001,55229,5719,105770,783,351,432
18535,114802,9001,55247,5719,105801,783,351,432
18540,114833,9001,55259,5719,105832,783,351,432
18545,114864,9001,55275,5719,105863,783,351,432
18550,114895,9001,55290,5719,105894,783,351,432
18555,114926,9001,55305,5719,105925,783,351,432
18560,114957,9001,55323,5719,105956,783,351,432
18565,114988,9001,55334,5719,105987,783,351,432
18570,115019,9001,55347,5719,106018,783,351,432
18575,115050,9001,55364,5719,106049,783,351,432
18580,115081,9001,55378,5719,106080,783,351,432
18585,115112,9002,55392,5720,106110,783,351,432
18590,115143,9006,55408,5722,106137,783,351,432
18595,115174,9010,55423,5725,106164,783,351,432
18600,115205,9015,55440,5729,106189,783,351,432
18605,115236,9020,55455,5732,106216,783,351,432
18610,115267,9025,55471,5735,106242,783,351,432
18615,115298,9030,55483,5739,106268,783,351,432
18620,115329,9034,55495,5742,106295,783,351,432
18625,115360,9038,55510,5745,106321,783,351,432
18630,115391,9044,55523,5750,106346,783,351,432
18635,115422,9048,55536,5752,106373,783,351,432
18640,115453,9053,55552,5755,106399,783,351,432
18645,115484,9056,55567,5756,106428,783,351,432
18650,115515,9059,55584,5759,106456,783,351,432
18655,115546,9062,55600,5761,106484,783,351,432
18660,115577,9065,55611,5762,106512,783,351,432
18665,115608,9068,55626,5765,106539,783,351,432
18670,115639,9072,55642,5768,106567,783,351,432
18675,115670,9074,55660,5770,106595,783,351,432
18680,115701,9078,55676,5774,106623,783,351,432
18685,115732,9079,55689,5775,106653,783,351,432
18690,115763,9080,55702,5775,106683,783,351,432
18695,115794,9081,55716,5776,106713,783,351,432
18700,115825,9082,55731,5777,106743,783,351,432
18705,115856,9083,55748,5778,106773,783,351,432
18710,115887,9084,55760,5779,106803,783,351,432
18715,115918,9086,55780,5780,106832,783,351,432
18720,115949,9088,55793,5780,106861,783,351,432
18725,115980,9094,55813,5784,106885,783,351,432
18730,116011,9098,55829,5787,106912,783,351,432
18735,116042,9101,55840,5789,106940,783,351,432
18740,116073,9105,55860,5793,106967,783,351,432
18745,116104,9109,55879,5796,106995,783,351,432
18750,116135,9113,55896,5797,107022,783,351,432
18755,116166,9117,55908,5798,107049,783,351,432
18760,116197,9121,55924,5801,107076,783,351,432
18765,116228,9127,55944,5805,107101,783,351,432
18770,116259,9133,55960,5809,107125,783,351,432
18775,116290,9137,55974,5812,107153,783,351,432
18780,116321,9139,55991,5813,107182,783,351,432
18785,116352,9140,56004,5814,107212,783,351,432
18790,116383,9141,56018,5815,107241,783,351,432
18795,116414,9143,56034,5816,107271,783,351,432
18800,116445,9144,56050,5816,107300,783,351,432
18805,116476,9146,56066,5817,107330,783,351,432
18810,116507,9147,56081,5818,107359,783,351,432
18815,116538,9149,56096,5820,107389,783,351,432
18820,116569,9150,56110,5820,107418,783,351,432
18825,116600,9152,56123,5821,107447,783,351,432
18830,116631,9155,56137,5824,107476,783,351,432
18835,116662,9157,56155,5825,107505,783,351,432
18840,116693,9159,56168,5825,107534,783,351,432
18845,116724,9162,56178,5826,107562,783,351,432
18850,116755,9164,56191,5828,107591,783,351,432
18855,116786,9167,56205,5829,107619,783,351,432
18860,116817,9170,56220,5830,107647,783,351,432
18865,116848,9173,56232,5831,107675,783,351,432
18870,116879,9175,56245,5833,107704,783,351,432
18875,116910,9178,56260,5836,107732,783,351,432
18880,116941,9181,56276,5837,107760,783,351,432
18885,116972,9183,56286,5837,107788,783,351,432
18890,117003,9189,56300,5841,107814,783,351,432
18895,117034,9195,56315,5845,107839,783,351,432
18900,117065,9198,56329,5847,107867,783,351,432
18905,117096,9202,56344,5850,107894,783,351,432
18910,117127,9206,56361,5853,107921,783,351,432
18915,117158,9209,56377,5853,107949,783,351,432
18920,117189,9213,56393,5855,107976,783,351,432
18925,117220,9216,56408,5856,108004,783,351,432
18930,117251,9218,56423,5858,108033,783,351,432
18935,117282,9220,56438,5859,108062,783,351,432
18940,117313,9222,56453,5860,108091,783,351,432
18945,117344,9224,56467,5860,108120,783,351,432
18950,117375,9226,56484,5860,108149,783,351,432
18955,117406,9228,56499,5860,108178,783,351,432
18960,117437,9230,56520,5860,108207,783,351,432
18965,117468,9235,56532,5863,108233,783,351,432
18970,117499,9240,56547,5866,108258,783,351,432
18975,117530,9246,56561,5871,108284,783,351,432
18980,117561,9249,56578,5873,108311,783,351,432
18985,117592,9252,56592,5875,108339,783,351,432
18990,117623,9255,56609,5876,108367,783,351,432
18995,117654,9258,56623,5877,108396,783,351,432
19000,117685,9260,56638,5878,108425,783,351,432
19005,117716,9264,56655,5881,108452,783,351,432
19010,117747,9267,56670,5883,108480,783,351,432
19015,117778,9270,56681,5885,108508,783,351,432
19020,117809,9272,56690,5886,108537,783,351,432
19025,117840,9274,56703,5887,108566,783,351,432
19030,117871,9276,56716,5888,108595,783,351,432
19035,117902,9278,56734,5888,108624,783,351,432
19040,117933,9280,56745,5888,108653,783,351,432
19045,117964,9282,56763,5888,108682,783,351,432
19050,117995,9284,56778,5890,108711,783,351,432
19055,118026,9286,56789,5890,108740,783,351,432
19060,118057,9288,56803,5890,108769,783,351,432
19065,118088,9290,56816,5891,108798,783,351,432
19070,118119,9292,56831,5891,108827,783,351,432
19075,118150,9294,56846,5892,108855,783,351,432
19080,118181,9297,56863,5895,108884,783,351,432
19085,118212,9300,56880,5897,108912,783,351,432
19090,118243,9303,56898,5900,108940,783,351,432
19095,118274,9304,56911,5900,108970,783,351,432
19100,118305,9305,56923,5900,109000,783,351,432
19105,118336,9307,56941,5902,109029,783,351,432
19110,118367,9308,56956,5903,109059,783,351,432
19115,118398,9311,56972,5905,109087,783,351,432
19120,118429,9313,56987,5907,109116,783,351,432
19125,118460,9315,56999,5909,109145,783,351,432
19130,118491,9317,57019,5911,109174,783,351,432
19135,118522,9321,57038,5914,109200,783,351,432
19140,118553,9323,57054,5916,109230,783,351,432
19145,118584,9325,57072,5917,109259,783,351,432
19150,118615,9326,57091,5918,109289,783,351,432
19155,118646,9328,57106,5919,109318,783,351,432
19160,118677,9330,57123,5921,109347,783,351,432
19165,118708,9331,57140,5922,109377,783,351,432
19170,118739,9333,57154,5923,109406,783,351,432
19175,118770,9335,57168,5924,109435,783,351,432
19180,118801,9336,57189,5925,109465,783,351,432
19185,118832,9337,57204,5926,109495,783,351,432
19190,118863,9340,57222,5927,109523,783,351,432
19195,118894,9342,57235,5927,109552,783,351,432
19200,118925,9345,57256,5929,109580,783,351,432
19205,118956,9348,57275,5932,109608,783,351,432
19210,118987,9351,57293,5933,109636,783,351,432
19215,119018,9354,57309,5934,109664,783,351,432
19220,119049,9357,57323,5934,109692,783,351,432
19225,119080,9360,57339,5934,109720,783,351,432
19230,119111,9363,57348,5934,109748,783,351,432
19235,119142,9366,57366,5936,109776,783,351,432
19240,119173,9369,57376,5939,109804,783,351,432
19245,119204,9373,57395,5939,109831,783,351,432
19250,119235,9378,57413,5942,109856,783,351,432
19255,119266,9382,57424,5945,109883,783,351,432
19260,119297,9387,57437,5950,109909,783,351,432
19265,119328,9390,57452,5953,109938,783,351,432
19270,119359,9394,57462,5955,109965,783,351,432
19275,119390,9396,57477,5956,109994,783,351,432
19280,119421,9398,57490,5957,110023,783,351,432
19285,119452,9401,57506,5959,110051,783,351,432
19290,119483,9405,57523,5962,110078,783,351,432
19295,119514,9409,57539,5966,110104,783,351,432
19300,119545,9413,57553,5969,110131,783,351,432
19305,119576,9416,57569,5971,110160,783,351,432
19310,119607,9418,57578,5972,110189,783,351,432
19315,119638,9418,57588,5972,110220,783,351,432
19320,119669,9418,57599,5972,110251,783,351,432
19325,119700,9419,57618,5973,110280,783,351,432
19330,119731,9421,57628,5974,110310,783,351,432
19335,119762,9422,57645,5975,110339,783,351,432
19340,119793,9424,57658,5976,110369,783,351,432
19345,119824,9425,57673,5976,110398,783,351,432
19350,119855,9428,57690,5978,110426,783,351,432
19355,119886,9430,57703,5979,110455,783,351,432
19360,119917,9431,57716,5980,110486,783,351,432
19365,119948,9431,57730,5980,110517,783,351,432
19370,119979,9433,57749,5982,110545,783,351,432
19375,120010,9435,57763,5983,110575,783,351,432
19380,120041,9436,57782,5984,110605,783,351,432
19385,120072,9438,57802,5986,110634,783,351,432
19390,120103,9440,57819,5987,110663,783,351,432
19395,120134,9441,57829,5987,110693,783,351,432
19400,120165,9443,57842,5989,110722,783,351,432
19405,120196,9444,57852,5990,110752,783,351,432
19410,120227,9446,57870,5992,110781,783,351,432
19415,120258,9449,57882,5994,110809,783,351,432
19420,120289,9454,57899,5996,110834,783,351,432
19425,120320,9459,57912,6000,110861,783,351,432
19430,120351,9463,57927,6002,110888,783,351,432
19435,120382,9466,57938,6005,110916,783,351,432
19440,120413,9471,57950,6009,110942,783,351,432
19445,120444,9477,57968,6014,110967,783,351,432
19450,120475,9483,57982,6018,110992,783,351,432
19455,120506,9489,58001,6023,111016,783,351,432
19460,120537,9494,58016,6027,111042,783,351,432
19465,120568,9500,58028,6030,111067,783,351,432
19470,120599,9504,58046,6034,111095,783,351,432
19475,120630,9508,58058,6036,111122,783,351,432
19480,120661,9513,58067,6040,111148,783,351,432
19485,120692,9515,58074,6041,111177,783,351,432
19490,120723,9519,58091,6044,111203,783,351,432
19495,120754,9522,58100,6045,111232,783,351,432
19500,120785,9523,58115,6046,111262,783,351,432
19505,120816,9523,58126,6046,111293,783,351,432
19510,120847,9523,58138,6046,111324,783,351,432
19515,120878,9523,58154,6046,111355,783,351,432
19520,120909,9523,58171,6046,111386,783,351,432
19525,120940,9523,58186,6046,111417,783,351,432
19530,120971,9523,58196,6046,111448,783,351,432
19535,121002,9523,58215,6046,111479,783,351,432
19540,121033,9523,58228,6046,111510,783,351,432
19545,121064,9523,58239,6046,111541,783,351,432
19550,121095,9523,58254,6046,111572,783,351,432
19555,121126,9523,58271,6046,111603,783,351,432
19560,121157,9523,58284,6046,111634,783,351,432
19565,121188,9526,58297,6048,111662,783,351,432
19570,121219,9528,58307,6049,111691,783,351,432
19575,121250,9532,58322,6052,111718,783,351,432
19580,121281,9536,58338,6055,111745,783,351,432
19585,121312,9538,58358,6056,111774,783,351,432
19590,121343,9540,58371,6057,111803,783,351,432
19595,121374,9543,58388,6060,111831,783,351,432
19600,121405,9545,58400,6061,111860,783,351,432
19605,121436,9550,58419,6066,111886,783,351,432
19610,121467,9554,58432,6068,111913,783,351,432
19615,121498,9559,58447,6072,111939,783,351,432
19620,121529,9563,58466,6075,111964,783,351,432
19625,121560,9570,58484,6082,111989,783,351,432
19630,121591,9573,58494,6084,112017,783,351,432
19635,121622,9577,58510,6088,112045,783,351,432
19640,121653,9580,58524,6090,112073,783,351,432
19645,121684,9582,58540,6090,112102,783,351,432
19650,121715,9584,58557,6092,112131,783,351,432
19655,121746,9585,58567,6093,112161,783,351,432
19660,121777,9586,58580,6094,112191,783,351,432
19665,121808,9587,58598,6094,112221,783,351,432
19670,121839,9588,58612,6094,112251,783,351,432
19675,121870,9589,58625,6094,112281,783,351,432
19680,121901,9590,58641,6095,112311,783,351,432
19685,121932,9593,58657,6097,112339,783,351,432
19690,121963,9596,58678,6099,112367,783,351,432
19695,121994,9599,58695,6102,112395,783,351,432
19700,122025,9602,58708,6103,112423,783,351,432
19705,122056,9606,58720,6105,112450,783,351,432
19710,122087,9610,58737,6108,112477,783,351,432
19715,122118,9613,58750,6109,112505,783,351,432
19720,122149,9616,58767,6110,112533,783,351,432
19725,122180,9619,58783,6111,112560,783,351,432
19730,122211,9624,58797,6114,112587,783,351,432
19735,122242,9626,58812,6115,112616,783,351,432
19740,122273,9628,58830,6117,112645,783,351,432
19745,122304,9630,58842,6119,112673,783,351,432
19750,122335,9633,58853,6122,112702,783,351,432
19755,122366,9636,58867,6124,112729,783,351,432
19760,122397,9641,58883,6127,112756,783,351,432
19765,122428,9645,58897,6131,112783,783,351,432
19770,122459,9649,58914,6133,112810,783,351,432
19775,122490,9652,58930,6134,112838,783,351,432
19780,122521,9656,58943,6136,112865,783,351,432
19785,122552,9660,58957,6138,112892,783,351,432
19790,122583,9664,58972,6142,112919,783,351,432
19795,122614,9667,58983,6144,112947,783,351,432
19800,122645,9670,58997,6146,112975,783,351,432
19805,122676,9673,59014,6147,113002,783,351,432
19810,122707,9676,59030,6150,113031,783,351,432
19815,122738,9678,59046,6151,113060,783,351,432
19820,122769,9679,59060,6152,113090,783,351,432
19825,122800,9682,59075,6155,113118,783,351,432
19830,122831,9683,59091,6156,113148,783,351,432
19835,122862,9684,59104,6157,113178,783,351,432
19840,122893,9686,59126,6158,113207,783,351,432
19845,122924,9687,59142,6158,113237,783,351,432
19850,122955,9688,59162,6159,113267,783,351,432
19855,122986,9689,59172,6160,113297,783,351,432
19860,123017,9690,59189,6161,113327,783,351,432
19865,123048,9697,59202,6165,113351,783,351,432
19870,123079,9701,59216,6168,113377,783,351,432
19875,123110,9706,59232,6171,113404,783,351,432
19880,123141,9711,59247,6175,113429,783,351,432
19885,123172,9717,59261,6180,113454,783,351,432
19890,123203,9723,59276,6184,113480,783,351,432
19895,123234,9726,59288,6184,113508,783,351,432
19900,123265,9730,59305,6185,113535,783,351,432
19905,123296,9734,59322,6188,113562,783,351,432
19910,123327,9737,59344,6190,113589,783,351,432
19915,123358,9740,59365,6193,113618,783,351,432
19920,123389,9742,59383,6194,113647,783,351,432
19925,123420,9744,59394,6194,113676,783,351,432
19930,123451,9746,59405,6194,113704,783,351,432
19935,123482,9749,59423,6196,113733,783,351,432
19940,123513,9750,59440,6197,113763,783,351,432
19945,123544,9751,59454,6198,113793,783,351,432
19950,123575,9752,59469,6198,113823,783,351,432
19955,123606,9753,59486,6199,113853,783,351,432
19960,123637,9754,59502,6199,113883,783,351,432
19965,123668,9755,59514,6200,113913,783,351,432
19970,123699,9756,59528,6200,113943,783,351,432
19975,123730,9757,59541,6200,113973,783,351,432
19980,123761,9758,59561,6200,114003,783,351,432
19985,123792,9760,59578,6201,114032,783,351,432
19990,123823,9763,59588,6203,114060,783,351,432
19995,123854,9765,59605,6204,114089,783,351,432
20000,123885,9767,59619,6204,114118,783,351,432
20005,123916,9769,59631,6204,114147,783,351,432
20010,123947,9771,59644,6204,114176,783,351,432
20015,123978,9773,59653,6205,114205,783,351,432
20020,124009,9776,59665,6207,114233,783,351,432
20025,124040,9779,59681,6210,114261,783,351,432
20030,124071,9783,59695,6214,114288,783,351,432
20035,124102,9785,59703,6214,114317,783,351,432
20040,124133,9789,59718,6217,114343,783,351,432
20045,124164,9794,59737,6222,114370,783,351,432
20050,124195,9797,59753,6224,114398,783,351,432
20055,124226,9801,59766,6226,114424,783,351,432
20060,124257,9804,59789,6229,114453,783,351,432
20065,124288,9806,59803,6231,114482,783,351,432
20070,124319,9808,59815,6232,114511,783,351,432
20075,124350,9809,59833,6233,114540,783,351,432
20080,124381,9812,59847,6235,114569,783,351,432
20085,124412,9813,59867,6236,114598,783,351,432
20090,124443,9816,59882,6239,114627,783,351,432
20095,124474,9819,59893,6241,114655,783,351,432
20100,124505,9821,59904,6242,114684,783,351,432
20105,124536,9823,59921,6243,114713,783,351,432
20110,124567,9826,59935,6244,114741,783,351,432
20115,124598,9828,59953,6246,114770,783,351,432
20120,124629,9831,59970,6247,114798,783,351,432
20125,124660,9832,59987,6248,114828,783,351,432
20130,124691,9833,60003,6248,114858,783,351,432
20135,124722,9834,60017,6248,114888,783,351,432
20140,124753,9835,60029,6248,114918,783,351,432
20145,124784,9836,60042,6248,114948,783,351,432
20150,124815,9837,60058,6249,114978,783,351,432
20155,124846,9839,60071,6250,115007,783,351,432
20160,124877,9842,60086,6250,115035,783,351,432
20165,124908,9848,60102,6254,115060,783,351,432
20170,124939,9853,60116,6257,115084,783,351,432
20175,124970,9860,60135,6261,115109,783,351,432
20180,125001,9866,60153,6266,115135,783,351,432
20185,125032,9871,60170,6268,115160,783,351,432
20190,125063,9875,60183,6271,115188,783,351,432
20195,125094,9879,60196,6275,115215,783,351,432
20200,125125,9883,60216,6278,115242,783,351,432
20205,125156,9888,60236,6283,115268,783,351,432
20210,125187,9892,60251,6285,115295,783,351,432
20215,125218,9895,60267,6286,115323,783,351,432
20220,125249,9898,60282,6287,115351,783,351,432
20225,125280,9900,60292,6288,115380,783,351,432
20230,125311,9903,60305,6290,115408,783,351,432
20235,125342,9906,60320,6291,115436,783,351,432
20240,125373,9909,60336,6293,115464,783,351,432
20245,125404,9911,60354,6293,115493,783,351,432
20250,125435,9913,60367,6293,115522,783,351,432
20255,125466,9915,60384,6294,115551,783,351,432
20260,125497,9917,60399,6295,115580,783,351,432
20265,125528,9920,60414,6296,115608,783,351,432
20270,125559,9922,60427,6297,115637,783,351,432
20275,125590,9925,60445,6300,115665,783,351,432
20280,125621,9926,60460,6301,115695,783,351,432
20285,125652,9928,60475,6303,115724,783,351,432
20290,125683,9930,60491,6304,115752,783,351,432
20295,125714,9934,60507,6306,115780,783,351,432
20300,125745,9937,60523,6306,115807,783,351,432
20305,125776,9941,60533,6308,115834,783,351,432
20310,125807,9945,60548,6310,115862,783,351,432
20315,125838,9948,60568,6313,115890,783,351,432
20320,125869,9951,60583,6315,115918,783,351,432
20325,125900,9955,60598,6318,115944,783,351,432
20330,125931,9958,60615,6320,115972,783,351,432
20335,125962,9961,60632,6322,116000,783,351,432
20340,125993,9964,60650,6325,116029,783,351,432
20345,126024,9966,60667,6327,116058,783,351,432
20350,126055,9967,60684,6328,116088,783,351,432
20355,126086,9969,60696,6329,116117,783,351,432
20360,126117,9970,60709,6329,116147,783,351,432
20365,126148,9971,60721,6329,116177,783,351,432
20370,126179,9972,60735,6330,116207,783,351,432
20375,126210,9973,60745,6330,116237,783,351,432
20380,126241,9975,60759,6331,116266,783,351,432
20385,126272,9978,60773,6333,116294,783,351,432
20390,126303,9982,60789,6337,116321,783,351,432
20395,126334,9986,60805,6340,116348,783,351,432
20400,126365,9990,60821,6343,116375,783,351,432
20405,126396,9994,60836,6345,116402,783,351,432
20410,126427,9998,60848,6348,116429,783,351,432
20415,126458,10002,60862,6350,116456,783,351,432
20420,126489,10004,60873,6350,116485,783,351,432
20425,126520,10007,60888,6351,116513,783,351,432
20430,126551,10010,60902,6353,116541,783,351,432
20435,126582,10014,60918,6355,116568,783,351,432
20440,126613,10017,60933,6358,116596,783,351,432
20445,126644,10021,60953,6362,116622,783,351,432
20450,126675,10023,60970,6364,116652,783,351,432
20455,126706,10024,60989,6365,116682,783,351,432
20460,126737,10025,60999,6365,116711,783,351,432
20465,126768,10028,61014,6368,116740,783,351,432
20470,126799,10030,61030,6369,116769,783,351,432
20475,126830,10032,61044,6370,116798,783,351,432
20480,126861,10034,61061,6371,116826,783,351,432
20485,126892,10037,61075,6373,116854,783,351,432
20490,126923,10038,61094,6374,116885,783,351,432
20495,126954,10038,61109,6374,116916,783,351,432
20500,126985,10038,61120,6374,116947,783,351,432
20505,127016,10038,61135,6374,116978,783,351,432
20510,127047,10038,61151,6374,117009,783,351,432
20515,127078,10038,61172,6374,117040,783,351,432
20520,127109,10038,61191,6374,117071,783,351,432
20525,127140,10039,61205,6375,117101,783,351,432
20530,127171,10041,61221,6376,117130,783,351,432
20535,127202,10042,61236,6376,117160,783,351,432
20540,127233,10043,61250,6377,117190,783,351,432
20545,127264,10044,61264,6377,117220,783,351,432
20550,127295,10045,61277,6377,117250,783,351,432
20555,127326,10047,61295,6378,117279,783,351,432
20560,127357,10049,61312,6379,117308,783,351,432
20565,127388,10051,61326,6380,117337,783,351,432
20570,127419,10054,61341,6381,117365,783,351,432
20575,127450,10057,61359,6382,117393,783,351,432
20580,127481,10060,61372,6383,117420,783,351,432
20585,127512,10066,61386,6386,117445,783,351,432
20590,127543,10071,61396,6387,117472,783,351,432
20595,127574,10077,61407,6390,117496,783,351,432
20600,127605,10084,61426,6394,117521,783,351,432
20605,127636,10089,61443,6398,117547,783,351,432
20610,127667,10095,61460,6402,117571,783,351,432
20615,127698,10103,61473,6407,117595,783,351,432
20620,127729,10108,61485,6410,117621,783,351,432
20625,127760,10113,61500,6412,117646,783,351,432
20630,127791,10119,61517,6416,117671,783,351,432
20635,127822,10122,61529,6417,117700,783,351,432
20640,127853,10123,61545,6417,117730,783,351,432
20645,127884,10126,61555,6419,117758,783,351,432
20650,127915,10129,61567,6421,117786,783,351,432
20655,127946,10131,61583,6422,117815,783,351,432
20660,127977,10134,61597,6423,117843,783,351,432
20665,128008,10136,61611,6423,117872,783,351,432
20670,128039,10139,61627,6424,117900,783,351,432
20675,128070,10141,61640,6425,117929,783,351,432
20680,128101,10143,61656,6427,117958,783,351,432
20685,128132,10146,61674,6429,117986,783,351,432
20690,128163,10149,61685,6431,118014,783,351,432
20695,128194,10152,61700,6434,118042,783,351,432
20700,128225,10154,61709,6434,118071,783,351,432
20705,128256,10158,61726,6436,118098,783,351,432
20710,128287,10161,61742,6437,118126,783,351,432
20715,128318,10164,61760,6440,118154,783,351,432
20720,128349,10168,61773,6443,118181,783,351,432
20725,128380,10172,61785,6445,118208,783,351,432
20730,128411,10176,61803,6447,118235,783,351,432
20735,128442,10180,61816,6447,118261,783,351,432
20740,128473,10187,61833,6451,118286,783,351,432
20745,128504,10190,61848,6451,118314,783,351,432
20750,128535,10193,61863,6452,118342,783,351,432
20755,128566,10197,61877,6454,118369,783,351,432
20760,128597,10200,61890,6455,118397,783,351,432
20765,128628,10202,61909,6456,118426,783,351,432
20770,128659,10203,61919,6457,118456,783,351,432
20775,128690,10204,61932,6457,118486,783,351,432
20780,128721,10205,61948,6457,118516,783,351,432
20785,128752,10206,61962,6457,118546,783,351,432
20790,128783,10207,61978,6458,118576,783,351,432
20795,128814,10208,61991,6459,118606,783,351,432
20800,128845,10209,62008,6460,118635,783,351,432
20805,128876,10211,62021,6461,118664,783,351,432
20810,128907,10213,62042,6463,118693,783,351,432
20815,128938,10215,62054,6464,118722,783,351,432
20820,128969,10217,62072,6466,118751,783,351,432
20825,129000,10219,62083,6467,118781,783,351,432
20830,129031,10219,62099,6467,118812,783,351,432
20835,129062,10219,62114,6467,118843,783,351,432
20840,129093,10219,62134,6467,118874,783,351,432
20845,129124,10219,62150,6467,118905,783,351,432
20850,129155,10220,62161,6468,118935,783,351,432
20855,129186,10221,62177,6469,118965,783,351,432
20860,129217,10222,62188,6470,118995,783,351,432
20865,129248,10223,62202,6470,119025,783,351,432
20870,129279,10225,62218,6471,119054,783,351,432
20875,129310,10231,62233,6476,119079,783,351,432
20880,129341,10234,62242,6477,119107,783,351,432
20885,129372,10238,62254,6478,119133,783,351,432
20890,129403,10243,62268,6480,119160,783,351,432
20895,129434,10247,62287,6484,119187,783,351,432
20900,129465,10250,62303,6487,119215,783,351,432
20905,129496,10253,62318,6489,119243,783,351,432
20910,129527,10256,62327,6490,119271,783,351,432
20915,129558,10260,62342,6492,119298,783,351,432
20920,129589,10263,62356,6494,119326,783,351,432
20925,129620,10266,62370,6495,119354,783,351,432
20930,129651,10267,62382,6495,119384,783,351,432
20935,129682,10269,62400,6497,119413,783,351,432
20940,129713,10271,62420,6498,119442,783,351,432
20945,129744,10272,62431,6498,119472,783,351,432
20950,129775,10273,62447,6499,119502,783,351,432
20955,129806,10274,62463,6500,119532,783,351,432
20960,129837,10275,62477,6500,119562,783,351,432
20965,129868,10277,62495,6501,119591,783,351,432
20970,129899,10278,62510,6501,119621,783,351,432
20975,129930,10280,62526,6502,119650,783,351,432
20980,129961,10281,62544,6503,119680,783,351,432
20985,129992,10284,62558,6504,119708,783,351,432
20990,130023,10286,62578,6506,119737,783,351,432
20995,130054,10287,62597,6507,119766,783,351,432
21000,130085,10290,62612,6508,119794,783,351,432
21005,130116,10295,62629,6512,119820,783,351,432
21010,130147,10301,62642,6515,119845,783,351,432
21015,130178,10306,62657,6518,119871,783,351,432
21020,130209,10312,62675,6523,119895,783,351,432
21025,130240,10317,62689,6526,119923,783,351,432
21030,130271,10320,62704,6526,119950,783,351,432
21035,130302,10325,62720,6531,119976,783,351,432
21040,130333,10329,62735,6534,120003,783,351,432
21045,130364,10333,62753,6537,120031,783,351,432
21050,130395,10335,62766,6538,120060,783,351,432
21055,130426,10337,62778,6539,120089,783,351,432
21060,130457,10339,62791,6539,120118,783,351,432
21065,130488,10340,62806,6540,120148,783,351,432
21070,130519,10342,62826,6542,120177,783,351,432
21075,130550,10343,62837,6542,120207,783,351,432
21080,130581,10344,62849,6543,120237,783,351,432
21085,130612,10346,62866,6544,120266,783,351,432
21090,130643,10347,62881,6545,120296,783,351,432
21095,130674,10348,62895,6546,120326,783,351,432
21100,130705,10349,62913,6546,120356,783,351,432
21105,130736,10351,62928,6548,120385,783,351,432
21110,130767,10355,62948,6552,120412,783,351,432
21115,130798,10359,62962,6555,120439,783,351,432
21120,130829,10362,62977,6557,120467,783,351,432
21125,130860,10363,62994,6558,120497,783,351,432
21130,130891,10365,63010,6560,120526,783,351,432
21135,130922,10366,63028,6561,120556,783,351,432
21140,130953,10367,63045,6562,120586,783,351,432
21145,130984,10368,63064,6562,120616,783,351,432
21150,131015,10369,63074,6563,120646,783,351,432
21155,131046,10371,63090,6564,120675,783,351,432
21160,131077,10372,63103,6564,120705,783,351,432
21165,131108,10374,63119,6565,120734,783,351,432
21170,131139,10375,63137,6565,120764,783,351,432
21175,131170,10378,63155,6568,120792,783,351,432
21180,131201,10380,63170,6568,120820,783,351,432
21185,131232,10384,63190,6571,120846,783,351,432
21190,131263,10388,63205,6574,120874,783,351,432
21195,131294,10391,63217,6576,120903,783,351,432
21200,131325,10394,63233,6578,120930,783,351,432
21205,131356,10397,63241,6579,120959,783,351,432
21210,131387,10398,63257,6579,120989,783,351,432
21215,131418,10400,63271,6581,121018,783,351,432
21220,131449,10402,63292,6582,121047,783,351,432
21225,131480,10403,63302,6582,121077,783,351,432
21230,131511,10406,63313,6584,121105,783,351,432
21235,131542,10409,63329,6586,121133,783,351,432
21240,131573,10411,63344,6587,121162,783,351,432
21245,131604,10417,63358,6593,121187,783,351,432
21250,131635,10420,63369,6594,121215,783,351,432
21255,131666,10422,63386,6594,121244,783,351,432
21260,131697,10424,63400,6596,121273,783,351,432
21265,131728,10426,63415,6597,121302,783,351,432
21270,131759,10428,63429,6598,121331,783,351,432
21275,131790,10430,63449,6600,121360,783,351,432
21280,131821,10432,63465,6600,121389,783,351,432
21285,131852,10434,63478,6601,121418,783,351,432
21290,131883,10436,63496,6601,121447,783,351,432
21295,131914,10438,63506,6601,121476,783,351,432
21300,131945,10440,63523,6602,121505,783,351,432
21305,131976,10442,63537,6604,121534,783,351,432
21310,132007,10444,63550,6604,121563,783,351,432
21315,132038,10446,63569,6606,121592,783,351,432
21320,132069,10448,63585,6607,121621,783,351,432
21325,132100,10450,63604,6609,121650,783,351,432
21330,132131,10452,63618,6611,121679,783,351,432
21335,132162,10454,63637,6613,121708,783,351,432
21340,132193,10456,63652,6614,121737,783,351,432
21345,132224,10458,63668,6614,121766,783,351,432
21350,132255,10462,63682,6616,121792,783,351,432
21355,132286,10469,63696,6620,121815,783,351,432
21360,132317,10478,63711,6629,121839,783,351,432
21365,132348,10480,63725,6629,121867,783,351,432
21370,132379,10483,63741,6630,121896,783,351,432
21375,132410,10485,63755,6630,121925,783,351,432
21380,132441,10487,63770,6631,121954,783,351,432
21385,132472,10489,63784,6632,121983,783,351,432
21390,132503,10491,63799,6633,122012,783,351,432
21395,132534,10493,63817,6635,122041,783,351,432
21400,132565,10495,63830,6635,122070,783,351,432
21405,132596,10497,63845,6636,122099,783,351,432
21410,132627,10499,63861,6638,122128,783,351,432
21415,132658,10501,63875,6639,122157,783,351,432
21420,132689,10503,63889,6640,122186,783,351,432
21425,132720,10505,63905,6642,122215,783,351,432
21430,132751,10507,63925,6642,122244,783,351,432
21435,132782,10509,63937,6643,122273,783,351,432
21440,132813,10511,63953,6644,122302,783,351,432
21445,132844,10513,63973,6645,122331,783,351,432
21450,132875,10515,63992,6646,122360,783,351,432
21455,132906,10517,64002,6646,122389,783,351,432
21460,132937,10519,64020,6647,122418,783,351,432
21465,132968,10522,64035,6649,122446,783,351,432
21470,132999,10527,64043,6651,122472,783,351,432
21475,133030,10532,64054,6653,122498,783,351,432
21480,133061,10535,64071,6655,122525,783,351,432
21485,133092,10539,64089,6659,122553,783,351,432
21490,133123,10541,64108,6660,122582,783,351,432
21495,133154,10543,64126,6661,122611,783,351,432
21500,133185,10545,64143,6662,122640,783,351,432
21505,133216,10547,64162,6663,122669,783,351,432
21510,133247,10549,64176,6663,122698,783,351,432
21515,133278,10551,64193,6664,122727,783,351,432
21520,133309,10553,64204,6664,122756,783,351,432
21525,133340,10555,64222,6666,122785,783,351,432
21530,133371,10557,64237,6667,122814,783,351,432
21535,133402,10559,64248,6668,122843,783,351,432
21540,133433,10561,64259,6668,122872,783,351,432
21545,133464,10562,64276,6669,122902,783,351,432
21550,133495,10563,64289,6670,122932,783,351,432
21555,133526,10564,64306,6671,122962,783,351,432
21560,133557,10565,64321,6671,122992,783,351,432
21565,133588,10566,64335,6671,123022,783,351,432
21570,133619,10567,64350,6671,123052,783,351,432
21575,133650,10569,64365,6673,123081,783,351,432
21580,133681,10572,64383,6676,123109,783,351,432
21585,133712,10576,64395,6677,123135,783,351,432
21590,133743,10582,64413,6682,123161,783,351,432
21595,133774,10587,64427,6686,123186,783,351,432
21600,133805,10593,64444,6690,123212,783,351,432
21605,133836,10596,64458,6692,123239,783,351,432
21610,133867,10601,64467,6695,123266,783,351,432
21615,133898,10604,64488,6698,123293,783,351,432
21620,133929,10609,64502,6702,123319,783,351,432
21625,133960,10612,64521,6703,123347,783,351,432
21630,133991,10615,64530,6705,123376,783,351,432
21635,134022,10617,64545,6705,123404,783,351,432
21640,134053,10620,64560,6707,123433,783,351,432
21645,134084,10621,64573,6708,123463,783,351,432
21650,134115,10622,64587,6709,123493,783,351,432
21655,134146,10624,64600,6710,123522,783,351,432
21660,134177,10625,64615,6711,123552,783,351,432
21665,134208,10627,64632,6712,123581,783,351,432
21670,134239,10627,64644,6712,123612,783,351,432
21675,134270,10627,64659,6712,123643,783,351,432
21680,134301,10627,64672,6712,123674,783,351,432
21685,134332,10627,64686,6712,123705,783,351,432
21690,134363,10627,64702,6712,123736,783,351,432
21695,134394,10627,64712,6712,123767,783,351,432
21700,134425,10627,64727,6712,123798,783,351,432
21705,134456,10628,64741,6713,123828,783,351,432
21710,134487,10631,64753,6715,123856,783,351,432
21715,134518,10634,64766,6717,123884,783,351,432
21720,134549,10637,64778,6718,123911,783,351,432
21725,134580,10643,64795,6723,123937,783,351,432
21730,134611,10645,64807,6724,123966,783,351,432
21735,134642,10647,64824,6726,123995,783,351,432
21740,134673,10648,64837,6726,124025,783,351,432
21745,134704,10649,64853,6726,124055,783,351,432
21750,134735,10650,64870,6727,124085,783,351,432
21755,134766,10651,64884,6728,124115,783,351,432
21760,134797,10653,64900,6730,124144,783,351,432
21765,134828,10655,64917,6731,124173,783,351,432
21770,134859,10660,64931,6734,124198,783,351,432
21775,134890,10667,64946,6739,124223,783,351,432
21780,134921,10671,64962,6742,124249,783,351,432
21785,134952,10676,64976,6745,124276,783,351,432
21790,134983,10680,64993,6749,124302,783,351,432
21795,135014,10684,65007,6752,124329,783,351,432
21800,135045,10689,65024,6756,124355,783,351,432
21805,135076,10692,65037,6758,124384,783,351,432
21810,135107,10695,65055,6760,124412,783,351,432
21815,135138,10698,65071,6761,124440,783,351,432
21820,135169,10700,65084,6762,124469,783,351,432
21825,135200,10704,65100,6764,124495,783,351,432
21830,135231,10706,65109,6766,124525,783,351,432
21835,135262,10708,65127,6766,124553,783,351,432
21840,135293,10712,65140,6769,124580,783,351,432
21845,135324,10716,65152,6771,124608,783,351,432
21850,135355,10719,65169,6772,124636,783,351,432
21855,135386,10722,65181,6772,124664,783,351,432
21860,135417,10725,65200,6775,124692,783,351,432
21865,135448,10728,65212,6777,124720,783,351,432
21870,135479,10731,65228,6779,124748,783,351,432
21875,135510,10734,65241,6781,124776,783,351,432
21880,135541,10737,65257,6781,124804,783,351,432
21885,135572,10740,65269,6781,124832,783,351,432
21890,135603,10745,65282,6784,124858,783,351,432
21895,135634,10749,65293,6786,124885,783,351,432
21900,135665,10752,65307,6788,124913,783,351,432
21905,135696,10755,65323,6790,124941,783,351,432
21910,135727,10757,65338,6791,124970,783,351,432
21915,135758,10757,65355,6791,125001,783,351,432
21920,135789,10757,65371,6791,125032,783,351,432
21925,135820,10757,65387,6791,125063,783,351,432
21930,135851,10757,65408,6791,125094,783,351,432
21935,135882,10759,65425,6793,125123,783,351,432
21940,135913,10761,65440,6795,125152,783,351,432
21945,135944,10762,65454,6795,125182,783,351,432
21950,135975,10763,65468,6795,125212,783,351,432
21955,136006,10764,65485,6795,125242,783,351,432
21960,136037,10766,65501,6797,125271,783,351,432
21965,136068,10768,65519,6799,125300,783,351,432
21970,136099,10771,65535,6801,125328,783,351,432
21975,136130,10774,65551,6803,125356,783,351,432
21980,136161,10776,65567,6804,125385,783,351,432
21985,136192,10778,65578,6805,125414,783,351,432
21990,136223,10780,65592,6806,125443,783,351,432
21995,136254,10783,65608,6807,125471,783,351,432
22000,136285,10784,65621,6807,125501,783,351,432
22005,136316,10786,65634,6808,125530,783,351,432
22010,136347,10789,65653,6810,125558,783,351,432
22015,136378,10791,65663,6810,125587,783,351,432
22020,136409,10795,65681,6814,125614,783,351,432
22025,136440,10799,65695,6815,125640,783,351,432
22030,136471,10804,65709,6817,125667,783,351,432
22035,136502,10807,65723,6819,125695,783,351,432
22040,136533,10812,65739,6823,125721,783,351,432
22045,136564,10817,65762,6825,125747,783,351,432
22050,136595,10820,65777,6826,125775,783,351,432
22055,136626,10824,65794,6830,125802,783,351,432
22060,136657,10829,65808,6832,125828,783,351,432
22065,136688,10832,65816,6832,125856,783,351,432
22070,136719,10837,65830,6836,125882,783,351,432
22075,136750,10842,65849,6840,125908,783,351,432
22080,136781,10846,65867,6842,125935,783,351,432
22085,136812,10851,65881,6846,125961,783,351,432
22090,136843,10856,65897,6849,125987,783,351,432
22095,136874,10860,65914,6852,126014,783,351,432
22100,136905,10865,65931,6857,126040,783,351,432
22105,136936,10869,65949,6861,126067,783,351,432
22110,136967,10872,65964,6862,126095,783,351,432
22115,136998,10874,65975,6863,126124,783,351,432
22120,137029,10876,65983,6863,126153,783,351,432
22125,137060,10878,65993,6863,126182,783,351,432
22130,137091,10880,66011,6865,126211,783,351,432
22135,137122,10882,66022,6865,126240,783,351,432
22140,137153,10885,66034,6867,126268,783,351,432
22145,137184,10887,66054,6868,126297,783,351,432
22150,137215,10889,66068,6868,126326,783,351,432
22155,137246,10891,66082,6869,126355,783,351,432
22160,137277,10893,66093,6869,126384,783,351,432
22165,137308,10895,66110,6870,126413,783,351,432
22170,137339,10897,66120,6871,126442,783,351,432
22175,137370,10899,66138,6872,126471,783,351,432
22180,137401,10901,66153,6874,126500,783,351,432
22185,137432,10903,66167,6876,126528,783,351,432
22190,137463,10906,66186,6879,126556,783,351,432
22195,137494,10907,66206,6880,126586,783,351,432
22200,137525,10909,66219,6881,126616,783,351,432
22205,137556,10910,66230,6881,126646,783,351,432
22210,137587,10912,66244,6881,126675,783,351,432
22215,137618,10914,66262,6883,126704,783,351,432
22220,137649,10917,66275,6884,126732,783,351,432
22225,137680,10919,66288,6885,126761,783,351,432
22230,137711,10921,66300,6886,126790,783,351,432
22235,137742,10924,66316,6888,126818,783,351,432
22240,137773,10927,66332,6891,126846,783,351,432
22245,137804,10930,66348,6893,126874,783,351,432
22250,137835,10933,66361,6894,126902,783,351,432
22255,137866,10936,66375,6896,126930,783,351,432
22260,137897,10940,66386,6898,126957,783,351,432
22265,137928,10942,66402,6899,126986,783,351,432
22270,137959,10945,66420,6902,127014,783,351,432
22275,137990,10948,66438,6905,127042,783,351,432
22280,138021,10952,66453,6907,127069,783,351,432
22285,138052,10954,66470,6908,127098,783,351,432
22290,138083,10957,66484,6909,127126,783,351,432
22295,138114,10960,66499,6911,127154,783,351,432
22300,138145,10965,66514,6916,127180,783,351,432
22305,138176,10969,66529,6918,127207,783,351,432
22310,138207,10970,66545,6919,127237,783,351,432
22315,138238,10971,66554,6920,127267,783,351,432
22320,138269,10972,66572,6920,127297,783,351,432
22325,138300,10974,66590,6921,127326,783,351,432
22330,138331,10975,66609,6922,127356,783,351,432
22335,138362,10977,66623,6923,127385,783,351,432
22340,138393,10979,66638,6925,127414,783,351,432
22345,138424,10980,66654,6926,127444,783,351,432
22350,138455,10982,66668,6927,127473,783,351,432
22355,138486,10984,66680,6928,127502,783,351,432
22360,138517,10986,66695,6930,127531,783,351,432
22365,138548,10989,66710,6932,127558,783,351,432
22370,138579,10993,66725,6934,127585,783,351,432
22375,138610,10996,66739,6936,127613,783,351,432
22380,138641,11000,66751,6938,127640,783,351,432
22385,138672,11004,66766,6940,127668,783,351,432
22390,138703,11006,66779,6940,127697,783,351,432
22395,138734,11008,66794,6942,127726,783,351,432
22400,138765,11011,66809,6944,127754,783,351,432
22405,138796,11014,66820,6946,127782,783,351,432
22410,138827,11016,66835,6947,127811,783,351,432
22415,138858,11018,66849,6947,127840,783,351,432
22420,138889,11021,66864,6949,127868,783,351,432
22425,138920,11025,66884,6953,127895,783,351,432
22430,138951,11027,66897,6954,127924,783,351,432
22435,138982,11029,66915,6956,127953,783,351,432
22440,139013,11030,66936,6957,127983,783,351,432
22445,139044,11032,66952,6958,128012,783,351,432
22450,139075,11032,66970,6958,128043,783,351,432
22455,139106,11032,66983,6958,128074,783,351,432
22460,139137,11032,66996,6958,128105,783,351,432
22465,139168,11032,67009,6958,128136,783,351,432
22470,139199,11032,67022,6958,128167,783,351,432
22475,139230,11032,67039,6958,128198,783,351,432
22480,139261,11032,67056,6958,128229,783,351,432
22485,139292,11032,67069,6958,128259,783,351,432
22490,139323,11034,67086,6960,128288,783,351,432
22495,139354,11038,67103,6963,128316,783,351,432
22500,139385,11040,67118,6964,128345,783,351,432
22505,139416,11044,67137,6967,128372,783,351,432
22510,139447,11046,67153,6968,128401,783,351,432
22515,139478,11049,67171,6970,128429,783,351,432
22520,139509,11052,67186,6971,128457,783,351,432
22525,139540,11054,67202,6971,128486,783,351,432
22530,139571,11056,67215,6972,128515,783,351,432
22535,139602,11058,67226,6973,128544,783,351,432
22540,139633,11060,67242,6973,128573,783,351,432
22545,139664,11063,67259,6975,128601,783,351,432
22550,139695,11066,67274,6977,128629,783,351,432
22555,139726,11070,67291,6980,128656,783,351,432
22560,139757,11073,67306,6982,128684,783,351,432
22565,139788,11075,67318,6982,128713,783,351,432
22570,139819,11077,67334,6983,128742,783,351,432
22575,139850,11080,67349,6985,128770,783,351,432
22580,139881,11082,67362,6985,128799,783,351,432
22585,139912,11085,67374,6986,128827,783,351,432
22590,139943,11088,67388,6988,128855,783,351,432
22595,139974,11090,67406,6990,128884,783,351,432
22600,140005,11092,67419,6991,128913,783,351,432
22605,140036,11095,67435,6993,128941,783,351,432
22610,140067,11099,67454,6995,128966,783,351,432
22615,140098,11108,67469,7003,128990,783,351,432
22620,140129,11112,67480,7005,129016,783,351,432
22625,140160,11116,67493,7007,129043,783,351,432
22630,140191,11120,67503,7009,129071,783,351,432
22635,140222,11124,67522,7012,129098,783,351,432
22640,140253,11126,67534,7013,129127,783,351,432
22645,140284,11128,67545,7014,129156,783,351,432
22650,140315,11130,67558,7015,129185,783,351,432
22655,140346,11132,67568,7017,129213,783,351,432
22660,140377,11135,67584,7018,129242,783,351,432
22665,140408,11137,67600,7020,129270,783,351,432
22670,140439,11141,67620,7023,129297,783,351,432
22675,140470,11144,67636,7025,129326,783,351,432
22680,140501,11146,67648,7027,129354,783,351,432
22685,140532,11150,67655,7029,129382,783,351,432
22690,140563,11152,67667,7029,129411,783,351,432
22695,140594,11155,67684,7032,129439,783,351,432
22700,140625,11158,67694,7034,129467,783,351,432
22705,140656,11160,67709,7034,129496,783,351,432
22710,140687,11162,67727,7036,129525,783,351,432
22715,140718,11164,67744,7038,129554,783,351,432
22720,140749,11166,67759,7039,129583,783,351,432
22725,140780,11169,67771,7042,129611,783,351,432
22730,140811,11171,67783,7042,129640,783,351,432
22735,140842,11173,67797,7044,129669,783,351,432
22740,140873,11175,67816,7045,129698,783,351,432
22745,140904,11178,67832,7047,129726,783,351,432
22750,140935,11179,67843,7047,129756,783,351,432
22755,140966,11181,67857,7048,129785,783,351,432
22760,140997,11182,67871,7049,129815,783,351,432
22765,141028,11183,67889,7050,129845,783,351,432
22770,141059,11184,67900,7050,129875,783,351,432
22775,141090,11185,67914,7051,129905,783,351,432
22780,141121,11187,67931,7053,129934,783,351,432
22785,141152,11188,67941,7053,129964,783,351,432
22790,141183,11191,67956,7055,129992,783,351,432
22795,141214,11193,67965,7055,130021,783,351,432
22800,141245,11196,67984,7058,130049,783,351,432
22805,141276,11200,68002,7061,130076,783,351,432
22810,141307,11203,68014,7063,130104,783,351,432
22815,141338,11206,68025,7064,130132,783,351,432
22820,141369,11209,68038,7065,130160,783,351,432
22825,141400,11213,68056,7068,130187,783,351,432
22830,141431,11216,68072,7069,130215,783,351,432
22835,141462,11221,68088,7071,130241,783,351,432
22840,141493,11226,68106,7073,130267,783,351,432
22845,141524,11228,68118,7074,130296,783,351,432
22850,141555,11231,68129,7075,130324,783,351,432
22855,141586,11235,68138,7077,130351,783,351,432
22860,141617,11240,68155,7080,130377,783,351,432
22865,141648,11245,68169,7083,130402,783,351,432
22870,141679,11250,68184,7085,130428,783,351,432
22875,141710,11255,68196,7089,130455,783,351,432
22880,141741,11259,68219,7093,130482,783,351,432
22885,141772,11262,68232,7094,130509,783,351,432
22890,141803,11267,68245,7097,130536,783,351,432
22895,141834,11269,68261,7099,130565,783,351,432
22900,141865,11271,68271,7101,130593,783,351,432
22905,141896,11274,68286,7103,130622,783,351,432
22910,141927,11276,68300,7103,130650,783,351,432
22915,141958,11279,68314,7105,130679,783,351,432
22920,141989,11280,68329,7105,130709,783,351,432
22925,142020,11281,68347,7105,130739,783,351,432
22930,142051,11282,68365,7105,130769,783,351,432
22935,142082,11283,68379,7106,130799,783,351,432
22940,142113,11284,68397,7107,130829,783,351,432
22945,142144,11285,68416,7108,130859,783,351,432
22950,142175,11287,68429,7109,130888,783,351,432
22955,142206,11289,68441,7110,130917,783,351,432
22960,142237,11291,68455,7111,130946,783,351,432
22965,142268,11293,68466,7112,130975,783,351,432
22970,142299,11295,68476,7112,131004,783,351,432
22975,142330,11297,68490,7113,131033,783,351,432
22980,142361,11299,68505,7114,131062,783,351,432
22985,142392,11302,68516,7115,131090,783,351,432
22990,142423,11305,68531,7117,131118,783,351,432
22995,142454,11307,68542,7118,131147,783,351,432
23000,142485,11310,68556,7121,131175,783,351,432
23005,142516,11312,68570,7121,131204,783,351,432
23010,142547,11315,68587,7123,131232,783,351,432
23015,142578,11317,68601,7125,131261,783,351,432
23020,142609,11320,68615,7128,131289,783,351,432
23025,142640,11323,68633,7131,131317,783,351,432
23030,142671,11328,68649,7134,131343,783,351,432
23035,142702,11335,68667,7140,131367,783,351,432
23040,142733,11340,68688,7144,131393,783,351,432
23045,142764,11343,68702,7146,131420,783,351,432
23050,142795,11348,68712,7149,131447,783,351,432
23055,142826,11351,68729,7150,131474,783,351,432
23060,142857,11355,68743,7152,131501,783,351,432
23065,142888,11360,68755,7155,131528,783,351,432
23070,142919,11364,68770,7157,131555,783,351,432
23075,142950,11366,68782,7158,131584,783,351,432
23080,142981,11369,68799,7160,131612,783,351,432
23085,143012,11372,68815,7161,131639,783,351,432
23090,143043,11375,68831,7162,131668,783,351,432
23095,143074,11376,68841,7163,131698,783,351,432
23100,143105,11377,68856,7163,131728,783,351,432
23105,143136,11378,68870,7164,131758,783,351,432
23110,143167,11379,68887,7165,131788,783,351,432
23115,143198,11380,68905,7165,131818,783,351,432
23120,143229,11381,68920,7166,131848,783,351,432
23125,143260,11382,68932,7167,131878,783,351,432
23130,143291,11383,68943,7168,131908,783,351,432
23135,143322,11384,68957,7169,131938,783,351,432
23140,143353,11385,68972,7169,131968,783,351,432
23145,143384,11388,68984,7171,131996,783,351,432
23150,143415,11390,68996,7173,132025,783,351,432
23155,143446,11391,69012,7173,132054,783,351,432
23160,143477,11393,69026,7174,132083,783,351,432
23165,143508,11397,69041,7178,132111,783,351,432
23170,143539,11400,69054,7179,132138,783,351,432
23175,143570,11405,69070,7184,132165,783,351,432
23180,143601,11408,69077,7185,132193,783,351,432
23185,143632,11411,69093,7186,132221,783,351,432
23190,143663,11415,69108,7187,132248,783,351,432
23195,143694,11419,69117,7188,132275,783,351,432
23200,143725,11423,69129,7190,132302,783,351,432
23205,143756,11426,69139,7191,132330,783,351,432
23210,143787,11429,69153,7192,132358,783,351,432
23215,143818,11433,69170,7194,132385,783,351,432
23220,143849,11437,69184,7198,132412,783,351,432
23225,143880,11438,69198,7198,132442,783,351,432
23230,143911,11439,69210,7198,132472,783,351,432
23235,143942,11441,69226,7199,132501,783,351,432
23240,143973,11441,69243,7199,132532,783,351,432
23245,144004,11441,69258,7199,132563,783,351,432
23250,144035,11441,69272,7199,132594,783,351,432
23255,144066,11441,69288,7199,132625,783,351,432
23260,144097,11442,69302,7199,132655,783,351,432
23265,144128,11443,69311,7199,132684,783,351,432
23270,144159,11445,69328,7201,132714,783,351,432
23275,144190,11446,69342,7201,132744,783,351,432
23280,144221,11447,69355,7201,132774,783,351,432
23285,144252,11449,69367,7201,132803,783,351,432
23290,144283,11452,69382,7202,132831,783,351,432
23295,144314,11457,69402,7206,132857,783,351,432
23300,144345,11459,69413,7208,132886,783,351,432
23305,144376,11460,69425,7209,132916,783,351,432
23310,144407,11461,69439,7209,132946,783,351,432
23315,144438,11463,69451,7210,132975,783,351,432
23320,144469,11465,69461,7211,133004,783,351,432
23325,144500,11468,69472,7213,133032,783,351,432
23330,144531,11474,69487,7218,133057,783,351,432
23335,144562,11478,69501,7220,133084,783,351,432
23340,144593,11482,69517,7223,133111,783,351,432
23345,144624,11484,69534,7224,133140,783,351,432
23350,144655,11486,69552,7226,133168,783,351,432
23355,144686,11489,69571,7228,133197,783,351,432
23360,144717,11491,69583,7229,133225,783,351,432
23365,144748,11494,69598,7231,133254,783,351,432
23370,144779,11496,69611,7231,133283,783,351,432
23375,144810,11498,69623,7232,133312,783,351,432
23380,144841,11500,69641,7233,133341,783,351,432
23385,144872,11502,69656,7234,133370,783,351,432
23390,144903,11504,69671,7235,133398,783,351,432
23395,144934,11508,69687,7239,133425,783,351,432
23400,144965,11512,69701,7241,133452,783,351,432
23405,144996,11517,69716,7244,133479,783,351,432
23410,145027,11520,69729,7244,133507,783,351,432
23415,145058,11524,69749,7247,133534,783,351,432
23420,145089,11528,69767,7250,133561,783,351,432
23425,145120,11532,69780,7254,133588,783,351,432
23430,145151,11535,69791,7255,133616,783,351,432
23435,145182,11539,69804,7258,133643,783,351,432
23440,145213,11543,69820,7262,133670,783,351,432
23445,145244,11546,69835,7263,133698,783,351,432
23450,145275,11548,69850,7264,133727,783,351,432
23455,145306,11550,69859,7265,133756,783,351,432
23460,145337,11553,69882,7268,133784,783,351,432
23465,145368,11557,69895,7271,133811,783,351,432
23470,145399,11560,69909,7273,133839,783,351,432
23475,145430,11564,69926,7275,133866,783,351,432
23480,145461,11567,69940,7276,133894,783,351,432
23485,145492,11570,69950,7276,133922,783,351,432
23490,145523,11573,69964,7276,133950,783,351,432
23495,145554,11576,69985,7279,133978,783,351,432
23500,145585,11579,70002,7282,134006,783,351,432
23505,145616,11582,70020,7282,134034,783,351,432
23510,145647,11586,70040,7286,134061,783,351,432
23515,145678,11589,70057,7287,134089,783,351,432
23520,145709,11592,70071,7289,134117,783,351,432
23525,145740,11593,70082,7289,134147,783,351,432
23530,145771,11594,70098,7289,134177,783,351,432
23535,145802,11595,70117,7289,134207,783,351,432
23540,145833,11597,70132,7290,134235,783,351,432
23545,145864,11602,70149,7293,134262,783,351,432
23550,145895,11604,70161,7295,134291,783,351,432
23555,145926,11606,70172,7295,134320,783,351,432
23560,145957,11609,70189,7296,134348,783,351,432
23565,145988,11613,70205,7298,134375,783,351,432
23570,146019,11617,70217,7300,134402,783,351,432
23575,146050,11620,70226,7302,134430,783,351,432
23580,146081,11622,70246,7303,134459,783,351,432
23585,146112,11623,70259,7303,134489,783,351,432
23590,146143,11625,70275,7305,134518,783,351,432
23595,146174,11626,70285,7306,134548,783,351,432
23600,146205,11627,70300,7306,134578,783,351,432
23605,146236,11629,70314,7308,134607,783,351,432
23610,146267,11631,70326,7309,134636,783,351,432
23615,146298,11633,70341,7310,134665,783,351,432
23620,146329,11634,70361,7311,134695,783,351,432
23625,146360,11636,70373,7313,134724,783,351,432
23630,146391,11639,70389,7316,134752,783,351,432
23635,146422,11643,70404,7318,134779,783,351,432
23640,146453,11648,70420,7322,134805,783,351,432
23645,146484,11653,70431,7326,134830,783,351,432
23650,146515,11658,70453,7331,134857,783,351,432
23655,146546,11661,70468,7334,134885,783,351,432
23660,146577,11664,70486,7335,134913,783,351,432
23665,146608,11668,70502,7338,134940,783,351,432
23670,146639,11673,70517,7343,134966,783,351,432
23675,146670,11676,70535,7346,134994,783,351,432
23680,146701,11681,70551,7350,135020,783,351,432
23685,146732,11685,70568,7354,135047,783,351,432
23690,146763,11688,70586,7355,135075,783,351,432
23695,146794,11690,70596,7355,135104,783,351,432
23700,146825,11692,70605,7356,135133,783,351,432
23705,146856,11695,70620,7358,135161,783,351,432
23710,146887,11698,70636,7359,135188,783,351,432
23715,146918,11702,70653,7363,135215,783,351,432
23720,146949,11706,70670,7365,135243,783,351,432
23725,146980,11709,70688,7368,135271,783,351,432
23730,147011,11710,70701,7369,135301,783,351,432
23735,147042,11711,70720,7369,135331,783,351,432
23740,147073,11713,70732,7371,135360,783,351,432
23745,147104,11715,70749,7373,135389,783,351,432
23750,147135,11717,70771,7375,135418,783,351,432
23755,147166,11719,70787,7377,135447,783,351,432
23760,147197,11721,70800,7378,135476,783,351,432
23765,147228,11721,70813,7378,135507,783,351,432
23770,147259,11721,70824,7378,135538,783,351,432
23775,147290,11721,70838,7378,135569,783,351,432
23780,147321,11721,70854,7378,135600,783,351,432
23785,147352,11721,70870,7378,135631,783,351,432
23790,147383,11722,70885,7379,135661,783,351,432
23795,147414,11723,70901,7379,135691,783,351,432
23800,147445,11724,70919,7380,135721,783,351,432
23805,147476,11726,70930,7380,135750,783,351,432
23810,147507,11729,70944,7382,135778,783,351,432
23815,147538,11732,70961,7384,135806,783,351,432
23820,147569,11735,70977,7386,135834,783,351,432
23825,147600,11740,70991,7390,135860,783,351,432
23830,147631,11743,71006,7393,135888,783,351,432
23835,147662,11746,71017,7393,135916,783,351,432
23840,147693,11750,71035,7396,135943,783,351,432
23845,147724,11754,71053,7399,135969,783,351,432
23850,147755,11758,71063,7400,135997,783,351,432
23855,147786,11761,71079,7403,136024,783,351,432
23860,147817,11766,71092,7406,136050,783,351,432
23865,147848,11772,71110,7410,136075,783,351,432
23870,147879,11778,71125,7415,136099,783,351,432
23875,147910,11782,71138,7417,136128,783,351,432
23880,147941,11785,71147,7419,136155,783,351,432
23885,147972,11788,71161,7422,136184,783,351,432
23890,148003,11788,71178,7422,136215,783,351,432
23895,148034,11788,71194,7422,136246,783,351,432
23900,148065,11788,71205,7422,136277,783,351,432
23905,148096,11788,71221,7422,136308,783,351,432
23910,148127,11788,71233,7422,136339,783,351,432
23915,148158,11788,71246,7422,136370,783,351,432
23920,148189,11788,71265,7422,136401,783,351,432
23925,148220,11788,71282,7422,136432,783,351,432
23930,148251,11788,71295,7422,136463,783,351,432
23935,148282,11789,71314,7422,136493,783,351,432
23940,148313,11791,71323,7423,136522,784,351,433
23945,148344,11795,71343,7427,136549,785,352,433
23950,148375,11798,71360,7429,136577,785,352,433
23955,148406,11802,71378,7433,136604,785,352,433
23960,148437,11806,71392,7436,136631,785,352,433
23965,148468,11809,71403,7437,136659,785,352,433
23970,148499,11813,71420,7439,136686,785,352,433
23975,148530,11817,71435,7442,136713,785,352,433
23980,148561,11819,71449,7443,136742,785,352,433
23985,148592,11822,71469,7446,136770,785,352,433
23990,148623,11825,71485,7447,136798,785,352,433
23995,148654,11828,71504,7449,136825,785,352,433
24000,148685,11833,71521,7452,136851,785,352,433
24005,148716,11836,71534,7454,136880,785,352,433
24010,148747,11839,71547,7455,136907,785,352,433
24015,148778,11843,71560,7458,136934,785,352,433
24020,148809,11846,71572,7459,136963,785,352,433
24025,148840,11849,71589,7461,136990,785,352,433
24030,148871,11852,71604,7463,137019,785,352,433
24035,148902,11855,71619,7465,137047,785,352,433
24040,148933,11857,71634,7465,137075,785,352,433
24045,148964,11859,71653,7466,137104,785,352,433
24050,148995,11861,71665,7468,137133,785,352,433
24055,149026,11863,71680,7469,137163,785,352,433
24060,149057,11864,71690,7469,137193,785,352,433
24065,149088,11868,71706,7473,137219,785,352,433
24070,149119,11873,71721,7476,137245,785,352,433
24075,149150,11878,71739,7480,137271,785,352,433
24080,149181,11883,71755,7483,137297,785,352,433
24085,149212,11888,71770,7487,137323,785,352,433
24090,149243,11893,71787,7491,137350,785,352,433
24095,149274,11896,71799,7493,137378,785,352,433
24100,149305,11899,71808,7495,137406,785,352,433
24105,149336,11903,71818,7497,137433,785,352,433
24110,149367,11906,71832,7498,137461,785,352,433
24115,149398,11907,71849,7498,137491,785,352,433
24120,149429,11908,71864,7498,137521,785,352,433
24125,149460,11913,71877,7501,137547,785,352,433
24130,149491,11918,71891,7505,137573,785,352,433
24135,149522,11921,71906,7507,137601,785,352,433
24140,149553,11922,71917,7507,137631,785,352,433
24145,149584,11924,71933,7508,137660,785,352,433
24150,149615,11925,71945,7508,137690,785,352,433
24155,149646,11926,71960,7508,137720,785,352,433
24160,149677,11927,71971,7509,137750,785,352,433
24165,149708,11928,71980,7510,137780,785,352,433
24170,149739,11929,71992,7511,137810,785,352,433
24175,149770,11932,72007,7513,137838,785,352,433
24180,149801,11934,72023,7515,137867,785,352,433
24185,149832,11935,72040,7516,137897,785,352,433
24190,149863,11936,72054,7516,137927,785,352,433
24195,149894,11938,72069,7517,137956,785,352,433
24200,149925,11940,72083,7518,137985,785,352,433
24205,149956,11941,72101,7518,138015,785,352,433
24210,149987,11941,72115,7518,138046,785,352,433
24215,150018,11941,72127,7518,138077,785,352,433
24220,150049,11941,72143,7518,138108,785,352,433
24225,150080,11941,72156,7518,138139,785,352,433
24230,150111,11942,72172,7519,138169,785,352,433
24235,150142,11943,72193,7520,138199,785,352,433
24240,150173,11945,72208,7522,138228,785,352,433
24245,150204,11948,72226,7524,138255,785,352,433
24250,150235,11952,72236,7526,138281,785,352,433
24255,150266,11957,72248,7529,138309,785,352,433
24260,150297,11959,72260,7530,138336,785,352,433
24265,150328,11965,72280,7534,138361,785,352,433
24270,150359,11970,72292,7538,138389,785,352,433
24275,150390,11972,72312,7540,138418,785,352,433
24280,150421,11974,72327,7541,138446,785,352,433
24285,150452,11977,72345,7544,138475,785,352,433
24290,150483,11980,72358,7547,138503,785,352,433
24295,150514,11983,72374,7550,138531,785,352,433
24300,150545,11987,72390,7553,138558,785,352,433
24305,150576,11989,72403,7554,138587,785,352,433
24310,150607,11990,72412,7554,138617,785,352,433
24315,150638,11993,72428,7556,138645,785,352,433
24320,150669,11996,72439,7557,138673,785,352,433
24325,150700,11999,72449,7558,138701,785,352,433
24330,150731,12002,72459,7559,138729,785,352,433
24335,150762,12004,72469,7559,138758,785,352,433
24340,150793,12006,72483,7559,138787,785,352,433
24345,150824,12008,72499,7561,138816,785,352,433
24350,150855,12010,72511,7562,138845,785,352,433
24355,150886,12012,72528,7564,138874,785,352,433
24360,150917,12014,72542,7564,138903,785,352,433
24365,150948,12016,72559,7565,138932,785,352,433
24370,150979,12018,72575,7565,138961,785,352,433
24375,151010,12020,72595,7567,138990,785,352,433
24380,151041,12023,72606,7568,139018,785,352,433
24385,151072,12026,72621,7569,139046,785,352,433
24390,151103,12030,72631,7572,139073,785,352,433
24395,151134,12034,72643,7576,139100,785,352,433
24400,151165,12039,72661,7580,139125,785,352,433
24405,151196,12045,72680,7585,139150,785,352,433
24410,151227,12050,72694,7588,139176,785,352,433
24415,151258,12056,72712,7593,139200,785,352,433
24420,151289,12062,72724,7596,139226,785,352,433
24425,151320,12064,72742,7598,139256,785,352,433
24430,151351,12064,72756,7598,139287,785,352,433
24435,151382,12064,72772,7598,139318,785,352,433
24440,151413,12064,72787,7598,139349,785,352,433
24445,151444,12064,72802,7598,139380,785,352,433
24450,151475,12064,72815,7598,139411,785,352,433
24455,151506,12064,72831,7598,139442,785,352,433
24460,151537,12064,72843,7598,139473,785,352,433
24465,151568,12064,72855,7598,139504,785,352,433
24470,151599,12064,72867,7598,139535,785,352,433
24475,151630,12064,72882,7598,139566,785,352,433
24480,151661,12064,72898,7598,139597,785,352,433
24485,151692,12064,72913,7598,139628,785,352,433
24490,151723,12064,72931,7598,139659,785,352,433
24495,151754,12064,72952,7598,139690,785,352,433
24500,151785,12064,72971,7598,139721,785,352,433
24505,151816,12064,72983,7598,139752,785,352,433
24510,151847,12064,73000,7598,139783,785,352,433
24515,151878,12064,73018,7598,139814,785,352,433
24520,151909,12064,73030,7598,139845,785,352,433
24525,151940,12065,73049,7599,139875,785,352,433
24530,151971,12070,73064,7603,139901,785,352,433
24535,152002,12077,73085,7608,139924,785,352,433
24540,152033,12084,73102,7613,139948,785,352,433
24545,152064,12089,73120,7617,139975,785,352,433
24550,152095,12093,73134,7619,140002,785,352,433
24555,152126,12097,73146,7620,140029,785,352,433
24560,152157,12101,73161,7621,140055,785,352,433
24565,152188,12106,73171,7623,140081,785,352,433
24570,152219,12111,73188,7627,140108,785,352,433
24575,152250,12116,73202,7630,140133,785,352,433
24580,152281,12122,73218,7635,140158,785,352,433
24585,152312,12127,73227,7636,140185,785,352,433
24590,152343,12131,73248,7640,140212,785,352,433
24595,152374,12135,73262,7640,140239,785,352,433
24600,152405,12140,73274,7644,140265,785,352,433
24605,152436,12142,73289,7645,140294,785,352,433
24610,152467,12144,73301,7645,140323,785,352,433
24615,152498,12147,73316,7647,140351,785,352,433
24620,152529,12150,73332,7649,140379,785,352,433
24625,152560,12153,73350,7651,140407,785,352,433
24630,152591,12156,73368,7653,140435,785,352,433
24635,152622,12159,73384,7656,140463,785,352,433
24640,152653,12160,73401,7657,140493,785,352,433
24645,152684,12162,73416,7658,140522,785,352,433
24650,152715,12164,73432,7659,140551,785,352,433
24655,152746,12165,73448,7659,140580,785,352,433
24660,152777,12168,73462,7662,140608,785,352,433
24665,152808,12171,73473,7663,140637,785,352,433
24670,152839,12173,73490,7663,140666,785,352,433
24675,152870,12175,73506,7664,140695,785,352,433
24680,152901,12177,73521,7664,140724,785,352,433
24685,152932,12179,73537,7666,140753,785,352,433
24690,152963,12181,73552,7666,140782,785,352,433
24695,152994,12183,73561,7666,140811,785,352,433
24700,153025,12185,73573,7667,140840,785,352,433
24705,153056,12187,73588,7668,140869,785,352,433
24710,153087,12189,73604,7670,140898,785,352,433
24715,153118,12191,73621,7672,140927,785,352,433
24720,153149,12193,73631,7673,140956,785,352,433
24725,153180,12197,73650,7677,140981,785,352,433
24730,153211,12203,73663,7682,141007,785,352,433
24735,153242,12207,73679,7683,141034,785,352,433
24740,153273,12212,73693,7687,141061,785,352,433
24745,153304,12214,73705,7688,141090,785,352,433
24750,153335,12217,73717,7689,141117,785,352,433
24755,153366,12220,73730,7691,141146,785,352,433
24760,153397,12222,73742,7692,141174,785,352,433
24765,153428,12226,73758,7694,141202,785,352,433
24770,153459,12227,73770,7694,141232,785,352,433
24775,153490,12229,73784,7695,141261,785,352,433
24780,153521,12230,73796,7695,141291,785,352,433
24785,153552,12233,73812,7698,141319,785,352,433
24790,153583,12236,73826,7699,141347,785,352,433
24795,153614,12239,73844,7701,141375,785,352,433
24800,153645,12242,73858,7704,141403,785,352,433
24805,153676,12245,73872,7706,141431,785,352,433
24810,153707,12248,73883,7707,141459,785,352,433
24815,153738,12251,73902,7710,141487,785,352,433
24820,153769,12254,73919,7711,141515,785,352,433
24825,153800,12257,73928,7712,141543,785,352,433
24830,153831,12260,73945,7714,141571,785,352,433
24835,153862,12263,73958,7716,141599,785,352,433
24840,153893,12266,73972,7718,141627,785,352,433
24845,153924,12266,73989,7718,141658,785,352,433
24850,153955,12266,73997,7718,141689,785,352,433
24855,153986,12266,74010,7718,141720,785,352,433
24860,154017,12266,74024,7718,141751,785,352,433
24865,154048,12266,74039,7718,141782,785,352,433
24870,154079,12267,74056,7719,141812,785,352,433
24875,154110,12270,74066,7721,141840,785,352,433
24880,154141,12273,74079,7723,141868,785,352,433
24885,154172,12276,74097,7725,141895,785,352,433
24890,154203,12278,74107,7726,141924,785,352,433
24895,154234,12281,74120,7728,141953,785,352,433
24900,154265,12282,74136,7728,141982,785,352,433
24905,154296,12283,74153,7729,142013,785,352,433
24910,154327,12283,74171,7729,142044,785,352,433
24915,154358,12283,74188,7729,142075,785,352,433
24920,154389,12283,74202,7729,142106,785,352,433
24925,154420,12283,74213,7729,142137,785,352,433
24930,154451,12283,74229,7729,142168,785,352,433
24935,154482,12283,74241,7729,142199,785,352,433
24940,154513,12283,74260,7729,142230,785,352,433
24945,154544,12284,74270,7729,142260,785,352,433
24950,154575,12286,74282,7730,142289,785,352,433
24955,154606,12290,74299,7734,142316,785,352,433
24960,154637,12295,74315,7737,142342,785,352,433
24965,154668,12300,74330,7740,142368,785,352,433
24970,154699,12304,74348,7742,142395,785,352,433
24975,154730,12309,74364,7745,142421,785,352,433
24980,154761,12313,74372,7747,142448,785,352,433
24985,154792,12317,74385,7749,142474,785,352,433
24990,154823,12322,74398,7753,142501,785,352,433
24995,154854,12327,74414,7756,142527,785,352,433
25000,154885,12330,74429,7757,142555,785,352,433
25005,154916,12334,74444,7758,142582,785,352,433
25010,154947,12338,74455,7760,142609,785,352,433
25015,154978,12341,74473,7762,142637,785,352,433
25020,155009,12345,74482,7764,142664,785,352,433
25025,155040,12347,74495,7765,142693,785,352,433
25030,155071,12349,74510,7766,142722,785,352,433
25035,155102,12351,74522,7767,142751,785,352,433
25040,155133,12353,74538,7768,142780,785,352,433
25045,155164,12355,74553,7768,142809,785,352,433
25050,155195,12357,74566,7769,142838,785,352,433
25055,155226,12359,74585,7769,142867,785,352,433
25060,155257,12361,74597,7770,142896,785,352,433
25065,155288,12364,74610,7772,142924,785,352,433
25070,155319,12367,74628,7774,142952,785,352,433
25075,155350,12370,74640,7777,142980,785,352,433
25080,155381,12373,74659,7780,143008,785,352,433
25085,155412,12378,74673,7782,143034,785,352,433
25090,155443,12381,74691,7785,143062,785,352,433
25095,155474,12383,74713,7785,143091,785,352,433
25100,155505,12385,74724,7786,143120,785,352,433
25105,155536,12388,74737,7788,143148,785,352,433
25110,155567,12391,74755,7790,143176,785,352,433
25115,155598,12393,74773,7791,143205,785,352,433
25120,155629,12395,74787,7793,143234,785,352,433
25125,155660,12397,74801,7795,143263,785,352,433
25130,155691,12400,74814,7797,143291,785,352,433
25135,155722,12402,74828,7798,143319,785,352,433
25140,155753,12406,74840,7801,143346,785,352,433
25145,155784,12408,74854,7803,143376,785,352,433
25150,155815,12410,74869,7805,143405,785,352,433
25155,155846,12411,74885,7805,143435,785,352,433
25160,155877,12413,74905,7807,143464,785,352,433
25165,155908,12414,74918,7808,143494,785,352,433
25170,155939,12415,74934,7808,143524,785,352,433
25175,155970,12416,74953,7808,143554,785,352,433
25180,156001,12418,74969,7810,143583,785,352,433
25185,156032,12419,74988,7811,143613,785,352,433
25190,156063,12420,75003,7811,143643,785,352,433
25195,156094,12423,75021,7814,143671,785,352,433
25200,156125,12425,75037,7815,143700,785,352,433
25205,156156,12429,75049,7818,143726,785,352,433
25210,156187,12434,75063,7819,143753,785,352,433
25215,156218,12439,75080,7821,143778,785,352,433
25220,156249,12444,75093,7824,143805,785,352,433
25225,156280,12448,75106,7826,143831,785,352,433
25230,156311,12453,75121,7829,143858,785,352,433
25235,156342,12457,75138,7830,143884,785,352,433
25240,156373,12462,75150,7832,143910,785,352,433
25245,156404,12466,75165,7835,143938,785,352,433
25250,156435,12470,75178,7838,143965,785,352,433
25255,156466,12472,75192,7839,143993,785,352,433
25260,156497,12476,75207,7842,144021,785,352,433
25265,156528,12477,75218,7842,144051,785,352,433
25270,156559,12478,75235,7842,144081,785,352,433
25275,156590,12479,75251,7843,144111,785,352,433
25280,156621,12480,75269,7844,144141,785,352,433
25285,156652,12481,75279,7844,144171,785,352,433
25290,156683,12482,75298,7844,144201,785,352,433
25295,156714,12483,75315,7845,144231,785,352,433
25300,156745,12484,75333,7846,144261,785,352,433
25305,156776,12485,75352,7847,144291,785,352,433
25310,156807,12486,75368,7847,144321,785,352,433
25315,156838,12487,75390,7848,144351,785,352,433
25320,156869,12488,75410,7849,144381,785,352,433
25325,156900,12489,75428,7849,144411,785,352,433
25330,156931,12492,75437,7852,144439,785,352,433
25335,156962,12494,75448,7854,144468,785,352,433
25340,156993,12496,75462,7855,144497,785,352,433
25345,157024,12498,75476,7856,144526,785,352,433
25350,157055,12499,75494,7857,144556,785,352,433
25355,157086,12500,75509,7858,144586,785,352,433
25360,157117,12501,75526,7858,144616,785,352,433
25365,157148,12502,75538,7858,144646,785,352,433
25370,157179,12508,75554,7863,144671,785,352,433
25375,157210,12512,75568,7865,144698,785,352,433
25380,157241,12519,75589,7872,144722,785,352,433
25385,157272,12523,75606,7875,144749,785,352,433
25390,157303,12527,75621,7878,144776,785,352,433
25395,157334,12531,75632,7879,144803,785,352,433
25400,157365,12535,75643,7880,144830,785,352,433
25405,157396,12539,75658,7881,144857,785,352,433
25410,157427,12544,75676,7885,144883,785,352,433
25415,157458,12548,75695,7887,144910,785,352,433
25420,157489,12552,75712,7889,144937,785,352,433
25425,157520,12556,75729,7891,144964,785,352,433
25430,157551,12559,75745,7893,144992,785,352,433
25435,157582,12563,75759,7894,145019,785,352,433
25440,157613,12567,75770,7896,145046,785,352,433
25445,157644,12570,75782,7899,145074,785,352,433
25450,157675,12572,75796,7900,145103,785,352,433
25455,157706,12574,75810,7901,145132,785,352,433
25460,157737,12576,75825,7902,145161,785,352,433
25465,157768,12578,75845,7904,145190,785,352,433
25470,157799,12580,75861,7905,145219,785,352,433
25475,157830,12582,75874,7907,145248,785,352,433
25480,157861,12584,75884,7907,145277,785,352,433
25485,157892,12586,75898,7908,145306,785,352,433
25490,157923,12589,75910,7910,145334,785,352,433
25495,157954,12592,75929,7912,145362,785,352,433
25500,157985,12594,75938,7912,145391,785,352,433
25505,158016,12596,75954,7913,145420,785,352,433
25510,158047,12599,75965,7914,145447,785,352,433
25515,158078,12603,75979,7917,145474,785,352,433
25520,158109,12606,75995,7919,145503,785,352,433
25525,158140,12608,76016,7921,145531,785,352,433
25530,158171,12612,76030,7924,145558,785,352,433
25535,158202,12614,76043,7925,145588,785,352,433
25540,158233,12615,76054,7926,145618,785,352,433
25545,158264,12616,76070,7927,145647,785,352,433
25550,158295,12618,76082,7929,145676,785,352,433
25555,158326,12620,76094,7931,145706,785,352,433
25560,158357,12621,76106,7932,145736,785,352,433
25565,158388,12623,76121,7934,145765,785,352,433
25570,158419,12625,76137,7936,145794,785,352,433
25575,158450,12627,76155,7937,145823,785,352,433
25580,158481,12628,76170,7938,145853,785,352,433
25585,158512,12629,76183,7938,145883,785,352,433
25590,158543,12631,76199,7940,145912,785,352,433
25595,158574,12632,76214,7940,145942,785,352,433
25600,158605,12633,76226,7941,145972,785,352,433
25605,158636,12635,76238,7943,146001,785,352,433
25610,158667,12637,76251,7944,146030,785,352,433
25615,158698,12640,76266,7946,146058,785,352,433
25620,158729,12643,76281,7948,146086,785,352,433
25625,158760,12645,76293,7948,146115,785,352,433
25630,158791,12648,76308,7949,146143,785,352,433
25635,158822,12651,76321,7951,146171,785,352,433
25640,158853,12654,76337,7953,146199,785,352,433
25645,158884,12656,76353,7954,146228,785,352,433
25650,158915,12659,76368,7956,146256,785,352,433
25655,158946,12663,76381,7959,146283,785,352,433
25660,158977,12665,76398,7960,146312,785,352,433
25665,159008,12667,76411,7960,146340,785,352,433
25670,159039,12672,76430,7962,146366,785,352,433
25675,159070,12677,76453,7966,146392,785,352,433
25680,159101,12682,76465,7968,146418,785,352,433
25685,159132,12686,76478,7969,146445,785,352,433
25690,159163,12689,76497,7972,146474,785,352,433
25695,159194,12691,76513,7972,146503,785,352,433
25700,159225,12693,76525,7973,146532,785,352,433
25705,159256,12695,76544,7974,146561,785,352,433
25710,159287,12697,76561,7976,146590,785,352,433
25715,159318,12699,76579,7976,146619,785,352,433
25720,159349,12701,76594,7976,146648,785,352,433
25725,159380,12703,76607,7978,146677,785,352,433
25730,159411,12705,76622,7980,146706,785,352,433
25735,159442,12707,76639,7982,146735,785,352,433
25740,159473,12710,76653,7984,146763,785,352,433
25745,159504,12714,76669,7987,146790,785,352,433
25750,159535,12717,76685,7990,146818,785,352,433
25755,159566,12720,76696,7991,146846,785,352,433
25760,159597,12723,76713,7992,146874,785,352,433
25765,159628,12726,76727,7993,146902,785,352,433
25770,159659,12730,76740,7997,146929,785,352,433
25775,159690,12733,76754,7999,146957,785,352,433
25780,159721,12736,76768,8002,146985,785,352,433
25785,159752,12739,76781,8004,147013,785,352,433
25790,159783,12744,76794,8006,147039,785,352,433
25795,159814,12749,76810,8010,147065,785,352,433
25800,159845,12754,76828,8012,147091,785,352,433
25805,159876,12754,76838,8012,147122,785,352,433
25810,159907,12754,76851,8012,147153,785,352,433
25815,159938,12754,76865,8012,147184,785,352,433
25820,159969,12754,76881,8012,147215,785,352,433
25825,160000,12754,76893,8012,147246,785,352,433
25830,160031,12754,76911,8012,147277,785,352,433
25835,160062,12754,76925,8012,147308,785,352,433
25840,160093,12754,76942,8012,147339,785,352,433
25845,160124,12754,76959,8012,147370,785,352,433
25850,160155,12755,76975,8013,147400,785,352,433
25855,160186,12757,76990,8014,147429,785,352,433
25860,160217,12759,77005,8016,147458,785,352,433
25865,160248,12763,77016,8019,147485,785,352,433
25870,160279,12766,77031,8021,147513,785,352,433
25875,160310,12768,77048,8022,147542,785,352,433
25880,160341,12770,77058,8023,147571,785,352,433
25885,160372,12772,77074,8023,147600,785,352,433
25890,160403,12774,77088,8024,147629,785,352,433
25895,160434,12777,77100,8026,147657,785,352,433
25900,160465,12779,77115,8026,147686,785,352,433
25905,160496,12782,77134,8028,147713,785,352,433
25910,160527,12788,77153,8032,147739,785,352,433
25915,160558,12793,77170,8036,147765,785,352,433
25920,160589,12797,77179,8037,147792,785,352,433
25925,160620,12801,77193,8040,147819,785,352,433
25930,160651,12806,77213,8044,147845,785,352,433
25935,160682,12809,77226,8047,147873,785,352,433
25940,160713,12814,77244,8051,147899,785,352,433
25945,160744,12818,77259,8052,147926,785,352,433
25950,160775,12821,77273,8053,147954,785,352,433
25955,160806,12825,77289,8057,147981,785,352,433
25960,160837,12829,77305,8060,148008,785,352,433
25965,160868,12833,77318,8061,148035,785,352,433
25970,160899,12837,77333,8063,148062,785,352,433
25975,160930,12840,77345,8063,148090,785,352,433
25980,160961,12844,77360,8065,148117,785,352,433
25985,160992,12847,77374,8067,148145,785,352,433
25990,161023,12850,77388,8070,148172,785,352,433
25995,161054,12854,77405,8074,148200,785,352,433
26000,161085,12858,77420,8075,148227,785,352,433
26005,161116,12861,77430,8076,148255,785,352,433
26010,161147,12864,77443,8077,148283,785,352,433
26015,161178,12867,77456,8079,148311,785,352,433
26020,161209,12871,77476,8082,148338,785,352,433
26025,161240,12874,77489,8084,148366,785,352,433
26030,161271,12878,77506,8087,148393,785,352,433
26035,161302,12882,77521,8090,148420,785,352,433
26040,161333,12886,77539,8093,148447,785,352,433
26045,161364,12886,77559,8093,148478,785,352,433
26050,161395,12886,77568,8093,148509,785,352,433
26055,161426,12886,77582,8093,148540,785,352,433
26060,161457,12886,77598,8093,148571,785,352,433
26065,161488,12886,77612,8093,148602,785,352,433
26070,161519,12886,77628,8093,148633,785,352,433
26075,161550,12886,77641,8093,148664,785,352,433
26080,161581,12886,77654,8093,148695,785,352,433
26085,161612,12886,77665,8093,148726,785,352,433
26090,161643,12887,77677,8094,148756,785,352,433
26095,161674,12888,77692,8094,148786,785,352,433
26100,161705,12889,77705,8095,148816,785,352,433
26105,161736,12892,77722,8098,148843,785,352,433
26110,161767,12895,77735,8099,148872,785,352,433
26115,161798,12898,77752,8102,148899,785,352,433
26120,161829,12901,77764,8103,148928,785,352,433
26125,161860,12903,77779,8104,148956,785,352,433
26130,161891,12905,77793,8105,148985,785,352,433
26135,161922,12909,77808,8109,149013,785,352,433
26140,161953,12911,77823,8110,149042,785,352,433
26145,161984,12914,77840,8113,149069,785,352,433
26150,162015,12915,77858,8114,149100,785,352,433
26155,162046,12916,77871,8114,149130,785,352,433
26160,162077,12918,77890,8115,149159,785,352,433
26165,162108,12921,77910,8117,149187,785,352,433
26170,162139,12924,77929,8119,149215,785,352,433
26175,162170,12927,77945,8120,149243,785,352,433
26180,162201,12930,77958,8123,149271,785,352,433
26185,162232,12933,77976,8125,149299,785,352,433
26190,162263,12937,77994,8127,149326,785,352,433
26195,162294,12940,78010,8129,149354,785,352,433
26200,162325,12944,78028,8132,149381,785,352,433
26205,162356,12947,78039,8134,149409,785,352,433
26210,162387,12950,78053,8134,149436,785,352,433
26215,162418,12954,78067,8137,149463,785,352,433
26220,162449,12958,78079,8140,149490,785,352,433
26225,162480,12961,78097,8143,149519,785,352,433
26230,162511,12963,78114,8144,149548,785,352,433
26235,162542,12964,78126,8144,149578,785,352,433
26240,162573,12966,78140,8145,149607,785,352,433
26245,162604,12968,78155,8147,149636,785,352,433
26250,162635,12969,78177,8148,149666,785,352,433
26255,162666,12973,78197,8151,149692,785,352,433
26260,162697,12976,78209,8153,149721,785,352,433
26265,162728,12979,78223,8155,149748,785,352,433
26270,162759,12985,78244,8160,149773,785,352,433
26275,162790,12988,78258,8161,149801,785,352,433
26280,162821,12990,78275,8162,149831,785,352,433
26285,162852,12990,78289,8162,149862,785,352,433
26290,162883,12990,78300,8162,149893,785,352,433
26295,162914,12990,78320,8162,149924,785,352,433
26300,162945,12990,78333,8162,149955,785,352,433
26305,162976,12990,78345,8162,149986,785,352,433
26310,163007,12990,78361,8162,150017,785,352,433
26315,163038,12990,78378,8162,150048,785,352,433
26320,163069,12990,78393,8162,150079,785,352,433
26325,163100,12991,78406,8163,150109,785,352,433
26330,163131,12993,78427,8164,150137,785,352,433
26335,163162,12996,78442,8166,150166,785,352,433
26340,163193,12998,78453,8167,150195,785,352,433
26345,163224,13000,78469,8169,150224,785,352,433
26350,163255,13002,78483,8170,150253,785,352,433
26355,163286,13004,78501,8172,150282,785,352,433
26360,163317,13007,78514,8174,150310,785,352,433
26365,163348,13009,78531,8176,150339,785,352,433
26370,163379,13011,78540,8177,150368,785,352,433
26375,163410,13014,78557,8180,150396,785,352,433
26380,163441,13016,78571,8181,150425,785,352,433
26385,163472,13018,78590,8183,150454,785,352,433
26390,163503,13022,78602,8185,150481,785,352,433
26395,163534,13029,78618,8191,150505,785,352,433
26400,163565,13033,78632,8194,150532,785,352,433
26405,163596,13038,78649,8197,150557,785,352,433
26410,163627,13043,78671,8202,150583,785,352,433
26415,163658,13048,78690,8206,150610,785,352,433
26420,163689,13052,78707,8208,150637,785,352,433
26425,163720,13056,78722,8210,150664,785,352,433
26430,163751,13061,78743,8214,150690,785,352,433
26435,163782,13065,78760,8217,150717,785,352,433
26440,163813,13070,78779,8220,150743,785,352,433
26445,163844,13075,78791,8222,150769,785,352,433
26450,163875,13080,78807,8226,150795,785,352,433
26455,163906,13084,78823,8229,150822,785,352,433
26460,163937,13087,78829,8229,150850,785,352,433
26465,163968,13089,78845,8230,150879,785,352,433
26470,163999,13092,78858,8231,150907,785,352,433
26475,164030,13095,78873,8234,150935,785,352,433
26480,164061,13097,78888,8234,150964,785,352,433
26485,164092,13099,78899,8235,150993,785,352,433
26490,164123,13101,78914,8236,151022,785,352,433
26495,164154,13103,78932,8236,151051,785,352,433
26500,164185,13105,78948,8236,151080,785,352,433
26505,164216,13106,78964,8236,151110,785,352,433
26510,164247,13107,78981,8236,151140,785,352,433
26515,164278,13108,78995,8237,151170,785,352,433
26520,164309,13109,79012,8237,151200,785,352,433
26525,164340,13110,79024,8237,151230,785,352,433
26530,164371,13111,79039,8237,151260,785,352,433
26535,164402,13112,79052,8237,151290,785,352,433
26540,164433,13113,79069,8237,151320,785,352,433
26545,164464,13114,79086,8237,151350,785,352,433
26550,164495,13115,79100,8237,151380,785,352,433
26555,164526,13116,79118,8238,151410,785,352,433
26560,164557,13117,79138,8238,151440,785,352,433
26565,164588,13118,79153,8238,151470,785,352,433
26570,164619,13120,79168,8239,151499,785,352,433
26575,164650,13124,79181,8242,151526,785,352,433
26580,164681,13127,79191,8243,151554,785,352,433
26585,164712,13130,79207,8245,151581,785,352,433
26590,164743,13135,79225,8248,151608,785,352,433
26595,164774,13138,79239,8248,151636,785,352,433
26600,164805,13141,79250,8249,151664,785,352,433
26605,164836,13145,79261,8251,151691,785,352,433
26610,164867,13149,79275,8254,151717,785,352,433
26615,164898,13154,79290,8257,151744,785,352,433
26620,164929,13157,79305,8258,151771,785,352,433
26625,164960,13162,79318,8260,151798,785,352,433
26630,164991,13164,79337,8261,151826,785,352,433
26635,165022,13167,79348,8262,151855,785,352,433
26640,165053,13169,79360,8263,151884,785,352,433
26645,165084,13170,79375,8263,151914,785,352,433
26650,165115,13171,79391,8264,151944,785,352,433
26655,165146,13172,79411,8265,151974,785,352,433
26660,165177,13173,79424,8265,152004,785,352,433
26665,165208,13174,79437,8265,152034,785,352,433
26670,165239,13176,79452,8266,152063,785,352,433
26675,165270,13177,79470,8266,152093,785,352,433
26680,165301,13179,79483,8268,152122,785,352,433
26685,165332,13182,79500,8270,152150,785,352,433
26690,165363,13185,79515,8272,152177,785,352,433
26695,165394,13189,79533,8276,152205,785,352,433
26700,165425,13191,79543,8277,152234,785,352,433
26705,165456,13194,79553,8278,152262,785,352,433
26710,165487,13197,79568,8279,152290,785,352,433
26715,165518,13200,79581,8279,152318,785,352,433
26720,165549,13203,79591,8281,152346,785,352,433
26725,165580,13206,79605,8281,152374,785,352,433
26730,165611,13209,79620,8282,152402,785,352,433
26735,165642,13212,79632,8282,152430,785,352,433
26740,165673,13215,79642,8283,152458,785,352,433
26745,165704,13218,79658,8284,152486,785,352,433
26750,165735,13221,79677,8286,152514,785,352,433
26755,165766,13224,79694,8288,152542,785,352,433
26760,165797,13227,79706,8289,152570,785,352,433
26765,165828,13230,79719,8290,152598,785,352,433
26770,165859,13233,79736,8292,152626,785,352,433
26775,165890,13236,79753,8294,152654,785,352,433
26780,165921,13239,79771,8295,152682,785,352,433
26785,165952,13242,79787,8296,152710,785,352,433
26790,165983,13245,79805,8298,152738,785,352,433
26795,166014,13248,79820,8300,152766,785,352,433
26800,166045,13252,79840,8304,152793,785,352,433
26805,166076,13255,79855,8305,152820,785,352,433
26810,166107,13259,79866,8308,152848,785,352,433
26815,166138,13263,79878,8311,152874,785,352,433
26820,166169,13269,79895,8316,152900,785,352,433
26825,166200,13272,79911,8318,152928,785,352,433
26830,166231,13276,79928,8322,152955,785,352,433
26835,166262,13278,79943,8324,152984,785,352,433
26840,166293,13281,79963,8327,153012,785,352,433
26845,166324,13284,79981,8329,153040,785,352,433
26850,166355,13287,79995,8332,153068,785,352,433
26855,166386,13289,80010,8334,153097,785,352,433
26860,166417,13292,80023,8337,153125,785,352,433
26865,166448,13294,80038,8338,153154,785,352,433
26870,166479,13297,80056,8339,153182,785,352,433
26875,166510,13299,80069,8339,153211,785,352,433
26880,166541,13302,80087,8341,153239,785,352,433
26885,166572,13303,80101,8342,153269,785,352,433
26890,166603,13303,80113,8342,153300,785,352,433
26895,166634,13303,80129,8342,153331,785,352,433
26900,166665,13303,80143,8342,153362,785,352,433
26905,166696,13303,80157,8342,153393,785,352,433
26910,166727,13303,80170,8342,153424,785,352,433
26915,166758,13303,80189,8342,153455,785,352,433
26920,166789,13304,80206,8342,153485,785,352,433
26925,166820,13306,80222,8343,153514,785,352,433
26930,166851,13308,80238,8344,153543,785,352,433
26935,166882,13310,80250,8344,153572,785,352,433
26940,166913,13313,80261,8346,153600,785,352,433
26945,166944,13318,80276,8349,153625,785,352,433
26950,166975,13322,80294,8352,153652,785,352,433
26955,167006,13326,80309,8355,153680,785,352,433
26960,167037,13329,80324,8356,153707,785,352,433
26965,167068,13333,80341,8357,153734,785,352,433
26970,167099,13338,80360,8360,153760,785,352,433
26975,167130,13343,80373,8363,153787,785,352,433
26980,167161,13346,80391,8366,153815,785,352,433
26985,167192,13348,80404,8366,153844,785,352,433
26990,167223,13351,80417,8369,153872,785,352,433
26995,167254,13354,80437,8371,153900,785,352,433
27000,167285,13357,80454,8373,153928,785,352,433
27005,167316,13357,80466,8373,153959,785,352,433
27010,167347,13357,80476,8373,153990,785,352,433
27015,167378,13357,80485,8373,154021,785,352,433
27020,167409,13357,80504,8373,154052,785,352,433
27025,167440,13357,80519,8373,154083,785,352,433
27030,167471,13357,80532,8373,154114,785,352,433
27035,167502,13357,80546,8373,154145,785,352,433
27040,167533,13357,80558,8373,154176,785,352,433
27045,167564,13357,80572,8373,154207,785,352,433
27050,167595,13359,80590,8375,154236,785,352,433
27055,167626,13361,80604,8376,154265,785,352,433
27060,167657,13363,80623,8377,154294,785,352,433
27065,167688,13368,80634,8381,154320,785,352,433
27070,167719,13374,80646,8383,154345,785,352,433
27075,167750,13381,80661,8387,154368,785,352,433
27080,167781,13388,80674,8391,154392,785,352,433
27085,167812,13394,80691,8395,154417,785,352,433
27090,167843,13398,80704,8396,154445,785,352,433
27095,167874,13401,80723,8399,154473,785,352,433
27100,167905,13405,80732,8400,154500,785,352,433
27105,167936,13408,80749,8402,154528,785,352,433
27110,167967,13411,80765,8405,154556,785,352,433
27115,167998,13414,80777,8406,154583,785,352,433
27120,168029,13418,80794,8409,154611,785,352,433
27125,168060,13420,80808,8410,154640,785,352,433
27130,168091,13422,80819,8411,154669,785,352,433
27135,168122,13424,80833,8412,154698,785,352,433
27140,168153,13426,80844,8412,154727,785,352,433
27145,168184,13428,80858,8412,154756,785,352,433
27150,168215,13430,80870,8413,154785,785,352,433
27155,168246,13432,80888,8415,154814,785,352,433
27160,168277,13434,80903,8416,154843,785,352,433
27165,168308,13436,80919,8417,154872,785,352,433
27170,168339,13438,80933,8419,154901,785,352,433
27175,168370,13441,80947,8421,154929,785,352,433
27180,168401,13443,80960,8423,154958,785,352,433
27185,168432,13443,80976,8423,154989,785,352,433
27190,168463,13443,80991,8423,155020,785,352,433
27195,168494,13444,81012,8423,155050,785,352,433
27200,168525,13445,81025,8423,155080,785,352,433
27205,168556,13446,81041,8423,155109,785,352,433
27210,168587,13448,81053,8425,155139,785,352,433
27215,168618,13449,81069,8426,155169,785,352,433
27220,168649,13450,81087,8427,155199,785,352,433
27225,168680,13451,81106,8427,155228,785,352,433
27230,168711,13453,81121,8428,155258,785,352,433
27235,168742,13455,81126,8428,155287,785,352,433
27240,168773,13457,81138,8429,155316,785,352,433
27245,168804,13461,81153,8431,155343,785,352,433
27250,168835,13464,81174,8433,155371,785,352,433
27255,168866,13467,81186,8435,155399,785,352,433
27260,168897,13470,81203,8437,155427,785,352,433
27265,168928,13473,81224,8438,155455,785,352,433
27270,168959,13476,81239,8440,155483,785,352,433
27275,168990,13479,81252,8441,155511,785,352,433
27280,169021,13482,81266,8443,155539,785,352,433
27285,169052,13485,81281,8445,155567,785,352,433
27290,169083,13489,81297,8448,155594,785,352,433
27295,169114,13493,81313,8449,155621,785,352,433
27300,169145,13498,81327,8452,155647,785,352,433
27305,169176,13500,81341,8453,155676,785,352,433
27310,169207,13502,81355,8455,155705,785,352,433
27315,169238,13504,81372,8455,155734,785,352,433
27320,169269,13506,81385,8456,155763,785,352,433
27325,169300,13508,81401,8457,155792,785,352,433
27330,169331,13510,81415,8458,155821,785,352,433
27335,169362,13512,81427,8460,155850,785,352,433
27340,169393,13514,81440,8462,155879,785,352,433
27345,169424,13516,81454,8464,155908,785,352,433
27350,169455,13520,81472,8467,155934,785,352,433
27355,169486,13524,81490,8470,155962,785,352,433
27360,169517,13527,81506,8472,155989,785,352,433
27365,169548,13529,81520,8474,156019,785,352,433
27370,169579,13531,81532,8476,156048,785,352,433
27375,169610,13532,81547,8477,156078,785,352,433
27380,169641,13534,81565,8479,156107,785,352,433
27385,169672,13536,81575,8480,156136,785,352,433
27390,169703,13538,81591,8481,156165,785,352,433
27395,169734,13540,81607,8482,156194,785,352,433
27400,169765,13540,81620,8482,156225,785,352,433
27405,169796,13540,81636,8482,156256,785,352,433
27410,169827,13543,81651,8483,156284,785,352,433
27415,169858,13546,81666,8485,156311,785,352,433
27420,169889,13550,81684,8488,156339,785,352,433
27425,169920,13553,81695,8490,156367,785,352,433
27430,169951,13556,81706,8491,156395,785,352,433
27435,169982,13560,81724,8495,156422,785,352,433
27440,170013,13562,81739,8495,156451,785,352,433
27445,170044,13564,81754,8496,156480,785,352,433
27450,170075,13566,81771,8497,156509,785,352,433
27455,170106,13568,81789,8497,156538,785,352,433
27460,170137,13570,81805,8499,156567,785,352,433
27465,170168,13572,81820,8501,156596,785,352,433
27470,170199,13574,81830,8503,156625,785,352,433
27475,170230,13576,81848,8504,156654,785,352,433
27480,170261,13580,81866,8507,156681,785,352,433
27485,170292,13583,81883,8510,156709,785,352,433
27490,170323,13586,81898,8512,156737,785,352,433
27495,170354,13589,81915,8515,156764,785,352,433
27500,170385,13592,81930,8517,156792,785,352,433
27505,170416,13595,81945,8519,156821,785,352,433
27510,170447,13596,81960,8519,156851,785,352,433
27515,170478,13597,81975,8519,156881,785,352,433
27520,170509,13598,81992,8520,156911,785,352,433
27525,170540,13599,82010,8520,156941,785,352,433
27530,170571,13600,82024,8521,156971,785,352,433
27535,170602,13601,82034,8522,157001,785,352,433
27540,170633,13603,82049,8524,157030,785,352,433
27545,170664,13607,82062,8525,157056,785,352,433
27550,170695,13612,82077,8527,157083,785,352,433
27555,170726,13617,82097,8530,157109,785,352,433
27560,170757,13622,82111,8531,157135,785,352,433
27565,170788,13627,82125,8534,157161,785,352,433
27570,170819,13632,82141,8535,157186,785,352,433
27575,170850,13637,82165,8539,157212,785,352,433
27580,170881,13643,82179,8543,157238,785,352,433
27585,170912,13648,82193,8546,157264,785,352,433
27590,170943,13652,82209,8550,157291,785,352,433
27595,170974,13656,82221,8552,157318,785,352,433
27600,171005,13659,82235,8555,157346,785,352,433
27605,171036,13660,82251,8556,157376,785,352,433
27610,171067,13661,82264,8556,157406,785,352,433
27615,171098,13662,82279,8556,157436,785,352,433
27620,171129,13663,82292,8557,157466,785,352,433
27625,171160,13664,82308,8557,157496,785,352,433
27630,171191,13665,82326,8557,157526,785,352,433
27635,171222,13666,82337,8557,157556,785,352,433
27640,171253,13667,82354,8557,157586,785,352,433
27645,171284,13669,82374,8559,157614,785,352,433
27650,171315,13672,82388,8561,157643,785,352,433
27655,171346,13674,82403,8563,157672,785,352,433
27660,171377,13675,82417,8563,157701,785,352,433
27665,171408,13679,82430,8567,157728,785,352,433
27670,171439,13682,82442,8569,157757,785,352,433
27675,171470,13682,82455,8569,157788,785,352,433
27680,171501,13682,82468,8569,157819,785,352,433
27685,171532,13682,82484,8569,157850,785,352,433
27690,171563,13682,82500,8569,157881,785,352,433
27695,171594,13682,82518,8569,157912,785,352,433
27700,171625,13682,82534,8569,157943,785,352,433
27705,171656,13683,82551,8570,157973,785,352,433
27710,171687,13685,82563,8571,158002,785,352,433
27715,171718,13687,82575,8572,158031,785,352,433
27720,171749,13689,82591,8573,158059,785,352,433
27725,171780,13693,82604,8575,158086,785,352,433
27730,171811,13697,82615,8576,158114,785,352,433
27735,171842,13700,82630,8578,158141,785,352,433
27740,171873,13704,82645,8579,158168,785,352,433
27745,171904,13708,82661,8582,158195,785,352,433
27750,171935,13712,82679,8585,158223,785,352,433
27755,171966,13715,82692,8585,158250,785,352,433
27760,171997,13718,82708,8586,158279,785,352,433
27765,172028,13721,82722,8589,158307,785,352,433
27770,172059,13723,82738,8590,158336,785,352,433
27775,172090,13726,82753,8593,158364,785,352,433
27780,172121,13729,82764,8594,158392,785,352,433
27785,172152,13732,82779,8594,158420,785,352,433
27790,172183,13736,82794,8596,158447,785,352,433
27795,172214,13740,82812,8598,158474,785,352,433
27800,172245,13743,82833,8600,158502,785,352,433
27805,172276,13746,82848,8603,158530,785,352,433
27810,172307,13749,82859,8605,158558,785,352,433
27815,172338,13753,82874,8609,158585,785,352,433
27820,172369,13756,82892,8611,158613,785,352,433
27825,172400,13760,82907,8614,158640,785,352,433
27830,172431,13765,82923,8617,158666,785,352,433
27835,172462,13768,82940,8619,158694,785,352,433
27840,172493,13771,82958,8621,158722,785,352,433
27845,172524,13775,82974,8623,158749,785,352,433
27850,172555,13778,82983,8624,158777,785,352,433
27855,172586,13783,82994,8626,158803,785,352,433
27860,172617,13786,83009,8628,158831,785,352,433
27865,172648,13790,83024,8630,158858,785,352,433
27870,172679,13794,83038,8633,158885,785,352,433
27875,172710,13797,83051,8635,158913,785,352,433
27880,172741,13797,83064,8635,158944,785,352,433
27885,172772,13797,83080,8635,158975,785,352,433
27890,172803,13797,83096,8635,159006,785,352,433
27895,172834,13797,83111,8635,159037,785,352,433
27900,172865,13797,83129,8635,159068,785,352,433
27905,172896,13797,83142,8635,159099,785,352,433
27910,172927,13797,83158,8635,159130,785,352,433
27915,172958,13797,83175,8635,159161,785,352,433
27920,172989,13797,83190,8635,159192,785,352,433
27925,173020,13797,83207,8635,159223,785,352,433
27930,173051,13797,83222,8635,159254,785,352,433
27935,173082,13797,83242,8635,159285,785,352,433
27940,173113,13797,83255,8635,159316,785,352,433
27945,173144,13797,83270,8635,159347,785,352,433
27950,173175,13798,83280,8636,159377,785,352,433
27955,173206,13799,83295,8636,159407,785,352,433
27960,173237,13800,83311,8637,159437,785,352,433
27965,173268,13803,83324,8639,159465,785,352,433
27970,173299,13806,83341,8641,159492,785,352,433
27975,173330,13811,83353,8644,159518,785,352,433
27980,173361,13817,83367,8648,159543,785,352,433
27985,173392,13822,83379,8650,159570,785,352,433
27990,173423,13826,83388,8653,159597,785,352,433
27995,173454,13831,83398,8656,159623,785,352,433
28000,173485,13837,83412,8659,159647,785,352,433
28005,173516,13842,83430,8662,159673,785,352,433
28010,173547,13847,83444,8664,159699,785,352,433
28015,173578,13853,83457,8667,159725,785,352,433
28020,173609,13858,83473,8671,159749,785,352,433
28025,173640,13863,83484,8674,159777,785,352,433
28030,173671,13867,83503,8676,159804,785,352,433
28035,173702,13871,83516,8680,159830,785,352,433
28040,173733,13875,83527,8682,159857,785,352,433
28045,173764,13878,83539,8683,159885,785,352,433
28050,173795,13881,83550,8685,159914,785,352,433
28055,173826,13884,83567,8686,159942,785,352,433
28060,173857,13886,83583,8686,159971,785,352,433
28065,173888,13889,83596,8687,159999,785,352,433
28070,173919,13891,83607,8688,160027,785,352,433
28075,173950,13893,83618,8689,160057,785,352,433
28080,173981,13894,83630,8689,160087,785,352,433
28085,174012,13895,83644,8690,160117,785,352,433
28090,174043,13896,83659,8690,160147,785,352,433
28095,174074,13897,83672,8690,160177,785,352,433
28100,174105,13898,83689,8690,160207,785,352,433
28105,174136,13899,83701,8691,160237,785,352,433
28110,174167,13900,83719,8692,160267,785,352,433
28115,174198,13901,83732,8693,160297,785,352,433
28120,174229,13903,83746,8694,160326,785,352,433
28125,174260,13906,83766,8697,160354,785,352,433
28130,174291,13907,83774,8697,160384,785,352,433
28135,174322,13908,83786,8697,160414,785,352,433
28140,174353,13909,83800,8697,160444,785,352,433
28145,174384,13911,83815,8697,160473,785,352,433
28150,174415,13913,83831,8698,160502,785,352,433
28155,174446,13915,83846,8699,160531,785,352,433
28160,174477,13917,83865,8701,160560,785,352,433
28165,174508,13919,83878,8703,160589,785,352,433
28170,174539,13921,83891,8704,160618,785,352,433
28175,174570,13923,83909,8706,160647,785,352,433
28180,174601,13926,83926,8706,160675,785,352,433
28185,174632,13929,83943,8708,160703,785,352,433
28190,174663,13933,83954,8710,160729,785,352,433
28195,174694,13938,83968,8714,160756,785,352,433
28200,174725,13941,83981,8715,160783,785,352,433
28205,174756,13944,83993,8717,160812,785,352,433
28210,174787,13946,84008,8717,160841,785,352,433
28215,174818,13949,84021,8719,160869,785,352,433
28220,174849,13951,84039,8719,160898,785,352,433
28225,174880,13953,84053,8720,160927,785,352,433
28230,174911,13955,84070,8722,160956,785,352,433
28235,174942,13958,84086,8723,160984,785,352,433
28240,174973,13961,84102,8725,161012,785,352,433
28245,175004,13964,84115,8728,161040,785,352,433
28250,175035,13967,84126,8729,161067,785,352,433
28255,175066,13972,84140,8732,161094,785,352,433
28260,175097,13976,84159,8736,161121,785,352,433
28265,175128,13980,84173,8738,161148,785,352,433
28270,175159,13983,84189,8740,161176,785,352,433
28275,175190,13986,84200,8741,161204,785,352,433
28280,175221,13990,84212,8743,161231,785,352,433
28285,175252,13991,84221,8743,161261,785,352,433
28290,175283,13993,84235,8744,161290,785,352,433
28295,175314,13995,84257,8746,161319,785,352,433
28300,175345,13996,84264,8746,161349,785,352,433
28305,175376,13997,84283,8746,161379,785,352,433
28310,175407,13999,84298,8747,161408,785,352,433
28315,175438,14002,84311,8749,161436,785,352,433
28320,175469,14006,84328,8752,161463,785,352,433
28325,175500,14011,84339,8755,161489,785,352,433
28330,175531,14014,84352,8755,161517,785,352,433
28335,175562,14017,84367,8755,161544,785,352,433
28340,175593,14021,84381,8757,161572,785,352,433
28345,175624,14024,84393,8757,161600,785,352,433
28350,175655,14027,84408,8758,161627,785,352,433
28355,175686,14031,84421,8762,161655,785,352,433
28360,175717,14034,84438,8763,161683,785,352,433
28365,175748,14037,84454,8764,161710,785,352,433
28370,175779,14042,84465,8766,161736,785,352,433
28375,175810,14046,84483,8769,161764,785,352,433
28380,175841,14048,84498,8770,161793,785,352,433
28385,175872,14051,84511,8771,161821,785,352,433
28390,175903,14052,84527,8771,161851,785,352,433
28395,175934,14053,84538,8771,161881,785,352,433
28400,175965,14054,84553,8772,161911,785,352,433
28405,175996,14055,84574,8773,161941,785,352,433
28410,176027,14056,84588,8774,161971,785,352,433
28415,176058,14057,84603,8775,162001,785,352,433
28420,176089,14058,84620,8776,162031,785,352,433
28425,176120,14059,84634,8776,162061,785,352,433
28430,176151,14060,84652,8777,162091,785,352,433
28435,176182,14062,84672,8779,162120,785,352,433
28440,176213,14064,84683,8779,162149,785,352,433
28445,176244,14067,84700,8781,162177,785,352,433
28450,176275,14071,84716,8783,162204,785,352,433
28455,176306,14073,84726,8784,162233,785,352,433
28460,176337,14075,84740,8784,162262,785,352,433
28465,176368,14077,84749,8786,162291,785,352,433
28470,176399,14079,84763,8787,162320,785,352,433
28475,176430,14082,84781,8789,162348,785,352,433
28480,176461,14085,84797,8791,162376,785,352,433
28485,176492,14088,84806,8793,162404,785,352,433
28490,176523,14090,84818,8794,162431,785,352,433
28495,176554,14095,84830,8796,162458,785,352,433
28500,176585,14099,84846,8798,162485,785,352,433
28505,176616,14103,84865,8801,162513,785,352,433
28510,176647,14106,84877,8802,162541,785,352,433
28515,176678,14109,84887,8804,162569,785,352,433
28520,176709,14113,84901,8808,162596,785,352,433
28525,176740,14117,84918,8811,162623,785,352,433
28530,176771,14120,84931,8813,162651,785,352,433
28535,176802,14122,84951,8815,162680,785,352,433
28540,176833,14123,84964,8816,162710,785,352,433
28545,176864,14125,84983,8817,162739,785,352,433
28550,176895,14127,85000,8819,162768,785,352,433
28555,176926,14130,85015,8820,162796,785,352,433
28560,176957,14133,85027,8822,162824,785,352,433
28565,176988,14136,85039,8824,162852,785,352,433
28570,177019,14140,85055,8828,162879,785,352,433
28575,177050,14143,85070,8830,162907,785,352,433
28580,177081,14147,85086,8833,162934,785,352,433
28585,177112,14150,85098,8835,162962,785,352,433
28590,177143,14154,85115,8839,162989,785,352,433
28595,177174,14157,85131,8841,163017,785,352,433
28600,177205,14160,85147,8844,163045,785,352,433
28605,177236,14162,85166,8846,163074,785,352,433
28610,177267,14164,85181,8848,163103,785,352,433
28615,177298,14166,85192,8849,163132,785,352,433
28620,177329,14167,85206,8850,163162,785,352,433
28625,177360,14169,85222,8851,163191,785,352,433
28630,177391,14169,85238,8851,163222,785,352,433
28635,177422,14170,85255,8852,163252,785,352,433
28640,177453,14171,85270,8852,163282,785,352,433
28645,177484,14172,85284,8852,163312,785,352,433
28650,177515,14173,85299,8852,163342,785,352,433
28655,177546,14174,85317,8852,163372,785,352,433
28660,177577,14175,85330,8852,163402,785,352,433
28665,177608,14176,85341,8852,163432,785,352,433
28670,177639,14178,85352,8852,163461,785,352,433
28675,177670,14180,85365,8853,163490,785,352,433
28680,177701,14182,85384,8853,163519,785,352,433
28685,177732,14185,85400,8854,163547,785,352,433
28690,177763,14189,85405,8855,163574,785,352,433
28695,177794,14193,85422,8857,163601,785,352,433
28700,177825,14198,85440,8859,163627,785,352,433
28705,177856,14203,85458,8864,163653,785,352,433
28710,177887,14209,85474,8870,163678,785,352,433
28715,177918,14214,85485,8873,163704,785,352,433
28720,177949,14220,85500,8878,163729,785,352,433
28725,177980,14226,85517,8883,163754,785,352,433
28730,178011,14232,85536,8888,163779,785,352,433
28735,178042,14238,85547,8893,163804,785,352,433
28740,178073,14243,85558,8895,163830,785,352,433
28745,178104,14247,85572,8898,163857,785,352,433
28750,178135,14249,85588,8899,163886,785,352,433
28755,178166,14251,85608,8901,163915,785,352,433
28760,178197,14253,85623,8903,163944,785,352,433
28765,178228,14255,85640,8904,163973,785,352,433
28770,178259,14257,85653,8904,164001,785,352,433
28775,178290,14259,85665,8905,164031,785,352,433
28780,178321,14260,85678,8906,164061,785,352,433
28785,178352,14261,85693,8907,164091,785,352,433
28790,178383,14262,85710,8908,164121,785,352,433
28795,178414,14263,85729,8908,164151,785,352,433
28800,178445,14264,85741,8908,164181,785,352,433
28805,178476,14265,85754,8908,164211,785,352,433
28810,178507,14266,85767,8908,164241,785,352,433
28815,178538,14267,85780,8908,164271,785,352,433
28820,178569,14268,85797,8908,164301,785,352,433
28825,178600,14269,85812,8908,164331,785,352,433
28830,178631,14270,85830,8909,164361,785,352,433
28835,178662,14271,85848,8909,164391,785,352,433
28840,178693,14272,85862,8909,164421,785,352,433
28845,178724,14273,85877,8910,164451,785,352,433
28850,178755,14277,85892,8914,164478,785,352,433
28855,178786,14281,85910,8917,164505,785,352,433
28860,178817,14285,85927,8920,164532,785,352,433
28865,178848,14288,85940,8922,164559,785,352,433
28870,178879,14292,85956,8924,164586,785,352,433
28875,178910,14295,85969,8926,164615,785,352,433
28880,178941,14299,85981,8928,164642,785,352,433
28885,178972,14303,85996,8930,164669,785,352,433
28890,179003,14308,86014,8934,164695,785,352,433
28895,179034,14312,86030,8936,164722,785,352,433
28900,179065,14316,86043,8938,164749,785,352,433
28905,179096,14319,86055,8939,164777,785,352,433
28910,179127,14322,86072,8941,164805,785,352,433
28915,179158,14326,86091,8943,164832,785,352,433
28920,179189,14329,86106,8945,164860,785,352,433
28925,179220,14332,86122,8946,164888,785,352,433
28930,179251,14336,86133,8947,164915,785,352,433
28935,179282,14340,86147,8950,164942,785,352,433
28940,179313,14344,86165,8954,164969,785,352,433
28945,179344,14347,86176,8957,164997,785,352,433
28950,179375,14351,86193,8961,165024,785,352,433
28955,179406,14355,86207,8964,165050,785,352,433
28960,179437,14359,86220,8965,165078,785,352,433
28965,179468,14363,86239,8969,165104,785,352,433
28970,179499,14366,86255,8971,165133,785,352,433
28975,179530,14370,86274,8975,165159,785,352,433
28980,179561,14375,86290,8978,165185,785,352,433
28985,179592,14377,86305,8979,165215,785,352,433
28990,179623,14378,86317,8979,165245,785,352,433
28995,179654,14379,86330,8979,165275,785,352,433
29000,179685,14380,86339,8980,165305,785,352,433
29005,179716,14381,86354,8981,165335,785,352,433
29010,179747,14382,86364,8982,165365,785,352,433
29015,179778,14384,86380,8984,165394,785,352,433
29020,179809,14386,86395,8985,165423,785,352,433
29025,179840,14388,86407,8986,165452,785,352,433
29030,179871,14390,86424,8988,165481,785,352,433
29035,179902,14391,86444,8989,165511,785,352,433
29040,179933,14392,86458,8990,165541,785,352,433
29045,179964,14395,86472,8990,165568,785,352,433
29050,179995,14400,86487,8993,165595,785,352,433
29055,180026,14403,86501,8995,165623,785,352,433
29060,180057,14406,86514,8995,165651,785,352,433
29065,180088,14410,86526,8997,165678,785,352,433
29070,180119,14415,86540,9000,165704,785,352,433
29075,180150,14420,86553,9002,165730,785,352,433
29080,180181,14426,86575,9007,165754,785,352,433
29085,180212,14433,86589,9013,165779,785,352,433
29090,180243,14438,86604,9017,165804,785,352,433
29095,180274,14444,86614,9021,165830,785,352,433
29100,180305,14445,86626,9021,165860,785,352,433
29105,180336,14447,86637,9022,165889,785,352,433
29110,180367,14448,86648,9022,165919,785,352,433
29115,180398,14450,86664,9023,165948,785,352,433
29120,180429,14452,86682,9025,165977,785,352,433
29125,180460,14453,86695,9026,166007,785,352,433
29130,180491,14454,86712,9026,166037,785,352,433
29135,180522,14455,86730,9027,166067,785,352,433
29140,180553,14457,86746,9029,166096,785,352,433
29145,180584,14459,86761,9031,166125,785,352,433
29150,180615,14460,86781,9032,166155,785,352,433
29155,180646,14461,86794,9032,166185,785,352,433
29160,180677,14462,86808,9032,166215,785,352,433
29165,180708,14463,86825,9033,166245,785,352,433
29170,180739,14464,86841,9034,166275,785,352,433
29175,180770,14465,86854,9035,166305,785,352,433
29180,180801,14466,86867,9036,166335,785,352,433
29185,180832,14467,86881,9036,166365,785,352,433
29190,180863,14469,86901,9037,166394,785,352,433
29195,180894,14471,86915,9039,166422,785,352,433
29200,180925,14474,86928,9041,166451,785,352,433
29205,180956,14477,86941,9042,166478,785,352,433
29210,180987,14483,86958,9047,166504,785,352,433
29215,181018,14487,86971,9049,166531,785,352,433
29220,181049,14491,86988,9051,166558,785,352,433
29225,181080,14494,87004,9054,166586,785,352,433
29230,181111,14499,87021,9058,166612,785,352,433
29235,181142,14503,87037,9062,166639,785,352,433
29240,181173,14507,87051,9064,166666,785,352,433
29245,181204,14512,87071,9069,166692,785,352,433
29250,181235,14516,87084,9071,166719,785,352,433
29255,181266,14521,87102,9075,166745,785,352,433
29260,181297,14526,87116,9078,166771,785,352,433
29265,181328,14532,87130,9081,166796,785,352,433
29270,181359,14536,87148,9084,166823,785,352,433
29275,181390,14538,87161,9085,166852,785,352,433
29280,181421,14540,87177,9087,166881,785,352,433
29285,181452,14542,87193,9088,166910,785,352,433
29290,181483,14543,87207,9089,166940,785,352,433
29295,181514,14544,87225,9090,166970,785,352,433
29300,181545,14545,87238,9090,167000,785,352,433
29305,181576,14547,87250,9091,167029,785,352,433
29310,181607,14549,87267,9092,167058,785,352,433
29315,181638,14551,87279,9093,167087,785,352,433
29320,181669,14553,87294,9094,167115,785,352,433
29325,181700,14557,87308,9098,167143,785,352,433
29330,181731,14560,87323,9101,167171,785,352,433
29335,181762,14561,87338,9102,167201,785,352,433
29340,181793,14563,87348,9104,167230,785,352,433
29345,181824,14564,87364,9105,167260,785,352,433
29350,181855,14566,87386,9107,167289,785,352,433
29355,181886,14567,87399,9108,167319,785,352,433
29360,181917,14569,87412,9109,167348,785,352,433
29365,181948,14570,87425,9109,167378,785,352,433
29370,181979,14572,87442,9110,167407,785,352,433
29375,182010,14576,87455,9112,167434,785,352,433
29380,182041,14581,87473,9116,167460,785,352,433
29385,182072,14584,87484,9118,167488,785,352,433
29390,182103,14588,87501,9121,167515,785,352,433
29395,182134,14591,87516,9122,167543,785,352,433
29400,182165,14595,87530,9125,167570,785,352,433
29405,182196,14602,87546,9129,167593,785,352,433
29410,182227,14608,87558,9133,167619,785,352,433
29415,182258,14614,87574,9138,167644,785,352,433
29420,182289,14619,87588,9141,167670,785,352,433
29425,182320,14624,87604,9145,167696,785,352,433
29430,182351,14629,87616,9147,167722,785,352,433
29435,182382,14633,87631,9149,167749,785,352,433
29440,182413,14639,87650,9153,167774,785,352,433
29445,182444,14643,87660,9155,167800,785,352,433
29450,182475,14648,87677,9159,167827,785,352,433
29455,182506,14652,87699,9163,167853,785,352,433
29460,182537,14655,87712,9166,167882,785,352,433
29465,182568,14658,87731,9168,167910,785,352,433
29470,182599,14660,87744,9169,167939,785,352,433
29475,182630,14661,87758,9169,167969,785,352,433
29480,182661,14662,87774,9169,167999,785,352,433
29485,182692,14663,87787,9169,168029,785,352,433
29490,182723,14664,87805,9170,168059,785,352,433
29495,182754,14665,87825,9171,168089,785,352,433
29500,182785,14666,87836,9172,168119,785,352,433
29505,182816,14667,87851,9172,168149,785,352,433
29510,182847,14668,87868,9173,168179,785,352,433
29515,182878,14669,87888,9174,168209,785,352,433
29520,182909,14670,87901,9174,168239,785,352,433
29525,182940,14671,87921,9175,168269,785,352,433
29530,182971,14672,87938,9175,168299,785,352,433
29535,183002,14673,87951,9176,168329,785,352,433
29540,183033,14674,87961,9176,168359,785,352,433
29545,183064,14675,87975,9176,168389,785,352,433
29550,183095,14677,87988,9178,168418,785,352,433
29555,183126,14680,88004,9180,168446,785,352,433
29560,183157,14683,88019,9182,168474,785,352,433
29565,183188,14686,88030,9184,168502,785,352,433
29570,183219,14689,88047,9187,168529,785,352,433
29575,183250,14692,88064,9190,168557,785,352,433
29580,183281,14696,88072,9194,168585,785,352,433
29585,183312,14700,88089,9197,168611,785,352,433
29590,183343,14704,88106,9199,168638,785,352,433
29595,183374,14708,88122,9202,168665,785,352,433
29600,183405,14712,88139,9204,168693,785,352,433
29605,183436,14715,88155,9206,168721,785,352,433
29610,183467,14718,88167,9208,168749,785,352,433
29615,183498,14721,88179,9210,168777,785,352,433
29620,183529,14724,88194,9212,168805,785,352,433
29625,183560,14727,88211,9214,168833,785,352,433
29630,183591,14730,88229,9215,168861,785,352,433
29635,183622,14733,88240,9216,168889,785,352,433
29640,183653,14736,88256,9217,168916,785,352,433
29645,183684,14740,88277,9220,168943,785,352,433
29650,183715,14744,88296,9223,168970,785,352,433
29655,183746,14749,88310,9228,168996,785,352,433
29660,183777,14754,88329,9232,169022,785,352,433
29665,183808,14758,88344,9234,169050,785,352,433
29670,183839,14762,88357,9237,169077,785,352,433
29675,183870,14766,88373,9240,169104,785,352,433
29680,183901,14769,88388,9243,169131,785,352,433
29685,183932,14775,88404,9249,169157,785,352,433
29690,183963,14778,88423,9251,169184,785,352,433
29695,183994,14784,88435,9255,169210,785,352,433
29700,184025,14786,88452,9257,169239,785,352,433
29705,184056,14789,88463,9260,169266,785,352,433
29710,184087,14794,88482,9264,169292,785,352,433
29715,184118,14798,88495,9267,169319,785,352,433
29720,184149,14801,88508,9270,169348,785,352,433
29725,184180,14802,88525,9271,169378,785,352,433
29730,184211,14804,88544,9273,169407,785,352,433
29735,184242,14805,88557,9273,169437,785,352,433
29740,184273,14806,88573,9273,169467,785,352,433
29745,184304,14807,88589,9273,169497,785,352,433
29750,184335,14808,88603,9273,169527,785,352,433
29755,184366,14809,88614,9273,169557,785,352,433
29760,184397,14810,88630,9274,169587,785,352,433
29765,184428,14810,88640,9274,169618,785,352,433
29770,184459,14810,88652,9274,169649,785,352,433
29775,184490,14810,88669,9274,169680,785,352,433
29780,184521,14810,88687,9274,169711,785,352,433
29785,184552,14810,88705,9274,169742,785,352,433
29790,184583,14810,88718,9274,169773,785,352,433
29795,184614,14810,88733,9274,169804,785,352,433
29800,184645,14810,88752,9274,169835,785,352,433
29805,184676,14812,88764,9275,169864,785,352,433
29810,184707,14815,88777,9276,169892,785,352,433
29815,184738,14817,88792,9278,169919,785,352,433
29820,184769,14822,88806,9283,169947,785,352,433
29825,184800,14826,88817,9286,169974,785,352,433
29830,184831,14829,88831,9288,170002,785,352,433
29835,184862,14833,88845,9291,170028,785,352,433
29840,184893,14838,88858,9295,170054,785,352,433
29845,184924,14843,88876,9299,170080,785,352,433
29850,184955,14849,88892,9303,170106,785,352,433
29855,184986,14854,88911,9307,170131,785,352,433
29860,185017,14858,88930,9309,170158,785,352,433
29865,185048,14862,88947,9312,170186,785,352,433
29870,185079,14864,88957,9312,170215,785,352,433
29875,185110,14866,88972,9312,170244,785,352,433
29880,185141,14869,88984,9314,170272,785,352,433
29885,185172,14872,88996,9316,170300,785,352,433
29890,185203,14874,89014,9318,170329,785,352,433
29895,185234,14876,89029,9320,170358,785,352,433
29900,185265,14878,89046,9322,170387,785,352,433
29905,185296,14881,89064,9324,170415,785,352,433
29910,185327,14883,89074,9325,170444,785,352,433
29915,185358,14885,89089,9326,170473,785,352,433
29920,185389,14888,89104,9329,170501,785,352,433
29925,185420,14891,89121,9332,170529,785,352,433
29930,185451,14895,89138,9334,170556,785,352,433
29935,185482,14900,89154,9338,170582,785,352,433
29940,185513,14903,89166,9341,170610,785,352,433
29945,185544,14906,89180,9342,170638,785,352,433
29950,185575,14911,89193,9346,170664,785,352,433
29955,185606,14915,89206,9348,170691,785,352,433
29960,185637,14918,89220,9349,170719,785,352,433
29965,185668,14922,89238,9351,170746,785,352,433
29970,185699,14926,89252,9354,170773,785,352,433
29975,185730,14930,89271,9355,170800,785,352,433
29980,185761,14934,89286,9358,170827,785,352,433
29985,185792,14938,89302,9360,170854,785,352,433
29990,185823,14941,89316,9360,170882,785,352,433
29995,185854,14944,89331,9362,170909,785,352,433
30000,185885,14948,89349,9365,170937,785,352,433
30005,185916,14948,89362,9365,170968,785,352,433
30010,185947,14948,89376,9365,170999,785,352,433
30015,185978,14948,89391,9365,171030,785,352,433
30020,186009,14948,89406,9365,171061,785,352,433
30025,186040,14948,89414,9365,171092,785,352,433
30030,186071,14948,89424,9365,171123,785,352,433
30035,186102,14948,89439,9365,171154,785,352,433
30040,186133,14948,89454,9365,171185,785,352,433
30045,186164,14948,89470,9365,171216,785,352,433
30050,186195,14949,89484,9365,171246,785,352,433
30055,186226,14950,89493,9366,171276,785,352,433
30060,186257,14951,89506,9366,171306,785,352,433
30065,186288,14956,89519,9370,171332,785,352,433
30070,186319,14959,89525,9371,171360,785,352,433
30075,186350,14963,89538,9375,171387,785,352,433
30080,186381,14966,89554,9378,171415,785,352,433
30085,186412,14970,89571,9381,171442,785,352,433
30090,186443,14974,89583,9383,171469,785,352,433
30095,186474,14976,89600,9384,171498,785,352,433
30100,186505,14979,89618,9387,171526,785,352,433
30105,186536,14981,89623,9387,171555,785,352,433
30110,186567,14983,89641,9387,171584,785,352,433
30115,186598,14985,89655,9387,171613,785,352,433
30120,186629,14989,89667,9388,171640,785,352,433
30125,186660,14991,89686,9390,171669,785,352,433
30130,186691,14993,89699,9391,171698,785,352,433
30135,186722,14995,89714,9392,171727,785,352,433
30140,186753,14997,89726,9393,171756,785,352,433
30145,186784,14999,89743,9395,171785,785,352,433
30150,186815,15001,89753,9396,171814,785,352,433
30155,186846,15003,89765,9397,171843,785,352,433
30160,186877,15005,89777,9397,171872,785,352,433
30165,186908,15007,89789,9398,171901,785,352,433
30170,186939,15009,89807,9399,171930,785,352,433
30175,186970,15011,89823,9400,171958,785,352,433
30180,187001,15014,89839,9402,171986,785,352,433
30185,187032,15018,89852,9405,172014,785,352,433
30190,187063,15021,89866,9407,172042,785,352,433
30195,187094,15024,89878,9408,172070,785,352,433
30200,187125,15027,89895,9409,172098,785,352,433
30205,187156,15030,89910,9410,172126,785,352,433
30210,187187,15033,89926,9411,172154,785,352,433
30215,187218,15036,89943,9413,172182,785,352,433
30220,187249,15039,89965,9415,172209,785,352,433
30225,187280,15043,89989,9418,172236,785,352,433
30230,187311,15047,90001,9420,172264,785,352,433
30235,187342,15051,90013,9422,172290,785,352,433
30240,187373,15056,90028,9425,172316,785,352,433
30245,187404,15058,90038,9426,172346,785,352,433
30250,187435,15060,90055,9427,172375,785,352,433
30255,187466,15061,90070,9427,172405,785,352,433
30260,187497,15062,90086,9428,172435,785,352,433
30265,187528,15064,90106,9429,172464,785,352,433
30270,187559,15065,90119,9429,172494,785,352,433
30275,187590,15066,90138,9429,172524,785,352,433
30280,187621,15067,90152,9430,172554,785,352,433
30285,187652,15068,90172,9430,172584,785,352,433
30290,187683,15069,90188,9431,172614,785,352,433
30295,187714,15071,90202,9433,172643,785,352,433
30300,187745,15073,90217,9435,172672,785,352,433
30305,187776,15075,90233,9437,172701,785,352,433
30310,187807,15076,90246,9437,172731,785,352,433
30315,187838,15078,90260,9438,172760,785,352,433
30320,187869,15080,90275,9439,172789,785,352,433
30325,187900,15081,90286,9439,172819,785,352,433
30330,187931,15083,90301,9440,172848,785,352,433
30335,187962,15085,90319,9442,172877,785,352,433
30340,187993,15087,90332,9444,172906,785,352,433
30345,188024,15090,90344,9445,172934,785,352,433
30350,188055,15093,90357,9446,172962,785,352,433
30355,188086,15096,90378,9449,172990,785,352,433
30360,188117,15098,90397,9451,173019,785,352,433
30365,188148,15101,90415,9453,173046,785,352,433
30370,188179,15104,90433,9455,173073,785,352,433
30375,188210,15108,90450,9457,173101,785,352,433
30380,188241,15111,90461,9458,173129,785,352,433
30385,188272,15114,90478,9460,173158,785,352,433
30390,188303,15116,90495,9461,173186,785,352,433
30395,188334,15119,90509,9462,173215,785,352,433
30400,188365,15121,90523,9464,173244,785,352,433
30405,188396,15123,90538,9464,173273,785,352,433
30410,188427,15125,90551,9465,173302,785,352,433
30415,188458,15128,90567,9466,173329,785,352,433
30420,188489,15132,90580,9468,173356,785,352,433
30425,188520,15136,90598,9471,173383,785,352,433
30430,188551,15140,90610,9473,173411,785,352,433
30435,188582,15143,90626,9474,173439,785,352,433
30440,188613,15146,90645,9474,173467,785,352,433
30445,188644,15149,90657,9475,173495,785,352,433
30450,188675,15152,90672,9475,173523,785,352,433
30455,188706,15156,90690,9479,173550,785,352,433
30460,188737,15160,90709,9480,173577,785,352,433
30465,188768,15165,90725,9483,173603,785,352,433
30470,188799,15169,90738,9486,173630,785,352,433
30475,188830,15174,90758,9489,173656,785,352,433
30480,188861,15177,90770,9489,173684,785,352,433
30485,188892,15179,90783,9489,173713,785,352,433
30490,188923,15181,90794,9490,173742,785,352,433
30495,188954,15185,90813,9494,173769,785,352,433
30500,188985,15187,90828,9496,173798,785,352,433
30505,189016,15190,90841,9497,173826,785,352,433
30510,189047,15193,90856,9499,173854,785,352,433
30515,189078,15195,90875,9500,173882,785,352,433
30520,189109,15198,90890,9502,173910,785,352,433
30525,189140,15202,90900,9505,173938,785,352,433
30530,189171,15205,90910,9507,173966,785,352,433
30535,189202,15208,90925,9509,173993,785,352,433
30540,189233,15211,90940,9511,174022,785,352,433
30545,189264,15215,90952,9513,174049,785,352,433
30550,189295,15218,90964,9514,174077,785,352,433
30555,189326,15222,90985,9517,174104,785,352,433
30560,189357,15226,91001,9519,174131,785,352,433
30565,189388,15229,91016,9520,174159,785,352,433
30570,189419,15230,91033,9520,174189,785,352,433
30575,189450,15232,91052,9522,174218,785,352,433
30580,189481,15234,91070,9524,174247,785,352,433
30585,189512,15236,91086,9525,174276,785,352,433
30590,189543,15239,91101,9527,174304,785,352,433
30595,189574,15241,91117,9528,174333,785,352,433
30600,189605,15244,91135,9530,174360,785,352,433
30605,189636,15247,91146,9531,174388,785,352,433
30610,189667,15250,91159,9533,174417,785,352,433
30615,189698,15252,91177,9534,174446,785,352,433
30620,189729,15254,91194,9536,174475,785,352,433
30625,189760,15256,91213,9538,174504,785,352,433
30630,189791,15258,91223,9539,174533,785,352,433
30635,189822,15260,91237,9541,174562,785,352,433
30640,189853,15262,91251,9541,174591,785,352,433
30645,189884,15264,91264,9541,174620,785,352,433
30650,189915,15267,91277,9544,174648,785,352,433
30655,189946,15269,91290,9545,174677,785,352,433
30660,189977,15271,91304,9545,174706,785,352,433
30665,190008,15273,91316,9545,174735,785,352,433
30670,190039,15275,91329,9546,174763,785,352,433
30675,190070,15279,91344,9550,174791,785,352,433
30680,190101,15282,91358,9552,174819,785,352,433
30685,190132,15285,91370,9553,174846,785,352,433
30690,190163,15289,91383,9555,174874,785,352,433
30695,190194,15292,91397,9556,174902,785,352,433
30700,190225,15296,91412,9558,174929,785,352,433
30705,190256,15299,91426,9558,174957,785,352,433
30710,190287,15302,91442,9559,174985,785,352,433
30715,190318,15306,91450,9561,175012,785,352,433
30720,190349,15309,91466,9564,175039,785,352,433
30725,190380,15314,91483,9567,175066,785,352,433
30730,190411,15317,91505,9569,175093,785,352,433
30735,190442,15320,91518,9571,175122,785,352,433
30740,190473,15321,91540,9572,175152,785,352,433
30745,190504,15322,91556,9572,175182,785,352,433
30750,190535,15323,91570,9573,175212,785,352,433
30755,190566,15324,91585,9573,175242,785,352,433
30760,190597,15325,91598,9573,175272,785,352,433
30765,190628,15327,91615,9575,175301,785,352,433
30770,190659,15329,91631,9577,175330,785,352,433
30775,190690,15331,91649,9579,175359,785,352,433
30780,190721,15332,91664,9580,175389,785,352,433
30785,190752,15333,91681,9580,175419,785,352,433
30790,190783,15334,91697,9581,175449,785,352,433
30795,190814,15335,91715,9582,175479,785,352,433
30800,190845,15336,91732,9582,175509,785,352,433
30805,190876,15337,91748,9582,175539,785,352,433
30810,190907,15338,91763,9583,175569,785,352,433
30815,190938,15339,91776,9584,175599,785,352,433
30820,190969,15340,91791,9585,175629,785,352,433
30825,191000,15342,91811,9587,175658,785,352,433
30830,191031,15346,91826,9589,175685,785,352,433
30835,191062,15350,91836,9590,175712,785,352,433
30840,191093,15355,91853,9595,175737,785,352,433
30845,191124,15360,91869,9600,175763,786,353,433
30850,191155,15364,91883,9602,175791,786,353,433
30855,191186,15368,91896,9604,175818,786,353,433
30860,191217,15372,91913,9607,175845,786,353,433
30865,191248,15376,91930,9610,175871,786,353,433
30870,191279,15380,91944,9612,175899,786,353,433
30875,191310,15383,91966,9614,175927,786,353,433
30880,191341,15387,91977,9616,175954,786,353,433
30885,191372,15392,91993,9618,175980,786,353,433
30890,191403,15397,92011,9621,176006,786,353,433
30895,191434,15400,92027,9624,176034,786,353,433
30900,191465,15403,92041,9625,176062,786,353,433
30905,191496,15407,92053,9627,176089,786,353,433
30910,191527,15409,92068,9629,176118,786,353,433
30915,191558,15410,92084,9630,176148,786,353,433
30920,191589,15413,92100,9632,176176,786,353,433
30925,191620,15415,92116,9633,176205,786,353,433
30930,191651,15416,92128,9634,176235,786,353,433
30935,191682,15417,92138,9634,176265,786,353,433
30940,191713,15418,92156,9634,176295,786,353,433
30945,191744,15418,92170,9634,176326,786,353,433
30950,191775,15419,92186,9635,176356,786,353,433
30955,191806,15420,92200,9636,176386,787,353,434
30960,191837,15421,92216,9636,176416,788,354,434
30965,191868,15422,92231,9637,176446,788,354,434
30970,191899,15424,92247,9638,176475,788,354,434
30975,191930,15425,92263,9638,176505,788,354,434
30980,191961,15427,92277,9640,176533,788,354,434
30985,191992,15429,92292,9641,176563,788,354,434
30990,192023,15430,92304,9641,176593,788,354,434
30995,192054,15431,92323,9642,176623,788,354,434
31000,192085,15433,92339,9644,176652,788,354,434
31005,192116,15435,92351,9645,176680,788,354,434
31010,192147,15439,92367,9648,176708,788,354,434
31015,192178,15442,92378,9649,176735,788,354,434
31020,192209,15446,92397,9652,176762,788,354,434
31025,192240,15451,92413,9656,176789,788,354,434
31030,192271,15456,92424,9658,176815,788,354,434
31035,192302,15460,92436,9659,176842,788,354,434
31040,192333,15464,92450,9661,176868,788,354,434
31045,192364,15470,92468,9666,176893,788,354,434
31050,192395,15475,92483,9670,176919,788,354,434
31055,192426,15481,92496,9675,176945,788,354,434
31060,192457,15485,92512,9678,176971,788,354,434
31065,192488,15492,92532,9684,176996,789,355,434
31070,192519,15498,92547,9687,177021,789,355,434
31075,192550,15504,92560,9691,177046,789,355,434
31080,192581,15509,92573,9695,177072,789,355,434
31085,192612,15514,92585,9698,177098,789,355,434
31090,192643,15517,92599,9700,177126,789,355,434
31095,192674,15519,92613,9702,177155,789,355,434
31100,192705,15521,92631,9702,177184,789,355,434
31105,192736,15523,92644,9702,177213,789,355,434
31110,192767,15525,92661,9704,177242,789,355,434
31115,192798,15526,92675,9704,177272,789,355,434
31120,192829,15527,92688,9704,177302,789,355,434
31125,192860,15528,92706,9704,177332,789,355,434
31130,192891,15530,92720,9706,177361,789,355,434
31135,192922,15532,92733,9707,177390,789,355,434
31140,192953,15534,92749,9709,177419,789,355,434
31145,192984,15537,92766,9712,177447,789,355,434
31150,193015,15538,92779,9712,177477,789,355,434
31155,193046,15538,92798,9712,177508,789,355,434
31160,193077,15538,92811,9712,177539,789,355,434
31165,193108,15538,92828,9712,177570,789,355,434
31170,193139,15538,92844,9712,177601,790,356,434
31175,193170,15538,92860,9712,177632,791,357,434
31180,193201,15538,92878,9712,177663,792,357,435
31185,193232,15538,92897,9712,177694,793,357,436
31190,193263,15538,92914,9712,177725,794,357,437
31195,193294,15541,92928,9714,177753,795,358,437
31200,193325,15545,92944,9717,177780,796,358,438
31205,193356,15550,92962,9721,177806,796,358,438
31210,193387,15554,92978,9723,177833,796,358,438
31215,193418,15558,92992,9726,177860,796,358,438
31220,193449,15562,93003,9728,177887,796,358,438
31225,193480,15566,93017,9731,177914,796,358,438
31230,193511,15570,93032,9733,177941,796,358,438
31235,193542,15574,93044,9736,177968,796,358,438
31240,193573,15577,93057,9738,177996,796,358,438
31245,193604,15580,93069,9739,178024,796,358,438
31250,193635,15584,93083,9742,178051,796,358,438
31255,193666,15588,93102,9745,178078,796,358,438
31260,193697,15593,93119,9749,178104,796,358,438
31265,193728,15598,93134,9751,178130,796,358,438
31270,193759,15603,93153,9755,178156,796,358,438
31275,193790,15607,93170,9758,178183,796,358,438
31280,193821,15612,93185,9761,178209,796,358,438
31285,193852,15615,93198,9762,178237,796,358,438
31290,193883,15618,93215,9762,178265,796,358,438
31295,193914,15622,93229,9765,178292,796,358,438
31300,193945,15626,93247,9767,178319,796,358,438
31305,193976,15629,93258,9768,178347,796,358,438
31310,194007,15632,93270,9769,178375,796,358,438
31315,194038,15634,93281,9769,178404,796,358,438
31320,194069,15637,93295,9770,178432,796,358,438
31325,194100,15640,93313,9771,178460,796,358,438
31330,194131,15643,93330,9773,178488,796,358,438
31335,194162,15645,93343,9775,178517,796,358,438
31340,194193,15647,93355,9775,178546,796,358,438
31345,194224,15649,93364,9776,178575,796,358,438
31350,194255,15651,93381,9778,178604,796,358,438
31355,194286,15654,93395,9780,178632,796,358,438
31360,194317,15657,93412,9781,178660,796,358,438
31365,194348,15659,93431,9781,178689,796,358,438
31370,194379,15661,93442,9782,178718,796,358,438
31375,194410,15664,93455,9785,178745,796,358,438
31380,194441,15667,93471,9787,178773,796,358,438
31385,194472,15672,93487,9792,178800,796,358,438
31390,194503,15675,93507,9794,178828,796,358,438
31395,194534,15678,93521,9796,178856,796,358,438
31400,194565,15680,93530,9797,178885,796,358,438
31405,194596,15683,93546,9800,178913,796,358,438
31410,194627,15686,93564,9802,178941,796,358,438
31415,194658,15688,93578,9803,178970,796,358,438
31420,194689,15690,93590,9805,178999,796,358,438
31425,194720,15694,93607,9807,179026,796,358,438
31430,194751,15697,93625,9810,179054,796,358,438
31435,194782,15700,93642,9812,179082,796,358,438
31440,194813,15703,93656,9814,179110,796,358,438
31445,194844,15706,93667,9817,179138,796,358,438
31450,194875,15710,93681,9819,179165,796,358,438
31455,194906,15713,93695,9820,179193,796,358,438
31460,194937,15716,93702,9820,179221,796,358,438
31465,194968,15720,93713,9822,179247,796,358,438
31470,194999,15724,93724,9825,179275,796,358,438
31475,195030,15727,93737,9825,179302,796,358,438
31480,195061,15733,93749,9828,179328,796,358,438
31485,195092,15735,93761,9828,179357,796,358,438
31490,195123,15737,93774,9828,179386,796,358,438
31495,195154,15739,93788,9828,179415,796,358,438
31500,195185,15741,93799,9828,179443,796,358,438
31505,195216,15746,93817,9831,179470,797,358,439
31510,195247,15748,93829,9832,179499,798,359,439
31515,195278,15749,93847,9832,179529,798,359,439
31520,195309,15751,93861,9834,179558,798,359,439
31525,195340,15752,93876,9834,179588,798,359,439
31530,195371,15753,93892,9834,179618,798,359,439
31535,195402,15754,93905,9834,179648,798,359,439
31540,195433,15756,93918,9835,179677,798,359,439
31545,195464,15757,93932,9836,179707,798,359,439
31550,195495,15759,93949,9838,179736,798,359,439
31555,195526,15760,93967,9838,179766,798,359,439
31560,195557,15761,93986,9838,179796,798,359,439
31565,195588,15762,93998,9839,179826,798,359,439
31570,195619,15763,94010,9839,179856,798,359,439
31575,195650,15764,94022,9839,179886,798,359,439
31580,195681,15765,94038,9839,179916,798,359,439
31585,195712,15766,94055,9840,179946,798,359,439
31590,195743,15767,94068,9840,179976,798,359,439
31595,195774,15768,94081,9841,180006,798,359,439
31600,195805,15769,94099,9842,180036,798,359,439
31605,195836,15771,94113,9843,180064,798,359,439
31610,195867,15774,94128,9845,180092,798,359,439
31615,195898,15780,94151,9851,180116,799,360,439
31620,195929,15788,94166,9857,180140,800,361,439
31625,195960,15793,94181,9859,180166,801,361,440
31630,195991,15798,94197,9863,180192,802,362,440
31635,196022,15801,94218,9866,180221,802,362,440
31640,196053,15803,94230,9867,180250,802,362,440
31645,196084,15805,94243,9868,180279,802,362,440
31650,196115,15807,94257,9869,180308,802,362,440
31655,196146,15809,94268,9869,180337,802,362,440
31660,196177,15811,94287,9871,180366,802,362,440
31665,196208,15813,94304,9872,180395,802,362,440
31670,196239,15815,94316,9873,180424,802,362,440
31675,196270,15817,94329,9874,180453,802,362,440
31680,196301,15819,94349,9875,180482,802,362,440
31685,196332,15821,94364,9877,180511,802,362,440
31690,196363,15823,94382,9879,180540,802,362,440
31695,196394,15825,94396,9880,180569,802,362,440
31700,196425,15827,94409,9881,180598,802,362,440
31705,196456,15829,94425,9882,180627,802,362,440
31710,196487,15831,94440,9884,180656,802,362,440
31715,196518,15833,94455,9885,180685,802,362,440
31720,196549,15835,94466,9885,180714,802,362,440
31725,196580,15837,94477,9885,180743,802,362,440
31730,196611,15839,94484,9885,180772,802,362,440
31735,196642,15841,94496,9886,180801,802,362,440
31740,196673,15844,94509,9888,180828,803,362,441
31745,196704,15848,94523,9890,180855,803,362,441
31750,196735,15852,94536,9893,180883,803,362,441
31755,196766,15854,94551,9895,180912,803,362,441
31760,196797,15855,94570,9895,180942,803,362,441
31765,196828,15857,94587,9897,180971,803,362,441
31770,196859,15859,94600,9898,181000,803,362,441
31775,196890,15859,94610,9898,181031,803,362,441
31780,196921,15859,94624,9898,181062,803,362,441
31785,196952,15859,94636,9898,181093,803,362,441
31790,196983,15859,94647,9898,181124,803,362,441
31795,197014,15859,94665,9898,181155,803,362,441
31800,197045,15859,94681,9898,181186,803,362,441
31805,197076,15861,94694,9899,181215,803,362,441
31810,197107,15862,94708,9900,181245,803,362,441
31815,197138,15863,94719,9901,181275,803,362,441
31820,197169,15864,94735,9902,181305,803,362,441
31825,197200,15865,94752,9902,181335,803,362,441
31830,197231,15866,94768,9903,181365,803,362,441
31835,197262,15867,94780,9904,181395,803,362,441
31840,197293,15868,94790,9904,181425,803,362,441
31845,197324,15870,94804,9904,181454,803,362,441
31850,197355,15873,94820,9905,181482,803,362,441
31855,197386,15877,94835,9907,181508,803,362,441
31860,197417,15882,94845,9909,181535,803,362,441
31865,197448,15885,94860,9912,181563,803,362,441
31870,197479,15889,94879,9915,181590,803,362,441
31875,197510,15892,94894,9916,181618,803,362,441
31880,197541,15896,94906,9916,181645,803,362,441
31885,197572,15900,94920,9918,181672,803,362,441
31890,197603,15905,94936,9921,181697,803,362,441
31895,197634,15911,94952,9926,181723,803,362,441
31900,197665,15916,94971,9928,181749,803,362,441
31905,197696,15920,94990,9931,181776,803,362,441
31910,197727,15925,95009,9934,181802,803,362,441
31915,197758,15930,95025,9938,181828,803,362,441
31920,197789,15934,95040,9940,181854,803,362,441
31925,197820,15938,95054,9943,181882,803,362,441
31930,197851,15941,95069,9945,181910,803,362,441
31935,197882,15945,95080,9947,181936,803,362,441
31940,197913,15949,95092,9949,181964,803,362,441
31945,197944,15953,95111,9951,181991,803,362,441
31950,197975,15957,95126,9953,182017,803,362,441
31955,198006,15960,95139,9956,182046,803,362,441
31960,198037,15963,95154,9957,182073,803,362,441
31965,198068,15967,95169,9960,182100,803,362,441
31970,198099,15970,95182,9962,182128,803,362,441
31975,198130,15973,95199,9965,182157,803,362,441
31980,198161,15975,95213,9966,182185,803,362,441
31985,198192,15978,95230,9968,182214,803,362,441
31990,198223,15981,95246,9969,182242,803,362,441
31995,198254,15984,95258,9971,182270,803,362,441
32000,198285,15985,95270,9971,182300,803,362,441
32005,198316,15986,95285,9971,182330,803,362,441
32010,198347,15987,95300,9972,182360,803,362,441
32015,198378,15988,95311,9972,182390,803,362,441
32020,198409,15990,95328,9973,182419,803,362,441
32025,198440,15991,95347,9974,182449,803,362,441
32030,198471,15993,95368,9975,182478,803,362,441
32035,198502,15996,95380,9977,182506,803,362,441
32040,198533,15998,95393,9977,182535,803,362,441
32045,198564,16001,95409,9979,182562,803,362,441
32050,198595,16006,95421,9984,182589,803,362,441
32055,198626,16009,95433,9986,182616,803,362,441
32060,198657,16014,95445,9989,182643,803,362,441
32065,198688,16018,95459,9990,182670,803,362,441
32070,198719,16021,95479,9992,182698,803,362,441
32075,198750,16026,95496,9997,182724,803,362,441
32080,198781,16029,95509,10000,182752,803,362,441
32085,198812,16031,95525,10002,182781,803,362,441
32090,198843,16033,95534,10003,182810,803,362,441
32095,198874,16035,95547,10004,182839,803,362,441
32100,198905,16038,95560,10005,182867,803,362,441
32105,198936,16042,95576,10008,182894,803,362,441
32110,198967,16044,95589,10009,182923,803,362,441
32115,198998,16046,95600,10010,182952,803,362,441
32120,199029,16048,95615,10010,182981,803,362,441
32125,199060,16050,95634,10011,183010,803,362,441
32130,199091,16052,95648,10012,183039,803,362,441
32135,199122,16054,95668,10014,183068,803,362,441
32140,199153,16056,95686,10015,183097,803,362,441
32145,199184,16058,95698,10016,183126,803,362,441
32150,199215,16060,95715,10016,183155,803,362,441
32155,199246,16062,95730,10016,183184,803,362,441
32160,199277,16064,95745,10016,183213,803,362,441
32165,199308,16066,95765,10017,183242,803,362,441
32170,199339,16068,95778,10019,183271,803,362,441
32175,199370,16070,95794,10020,183300,803,362,441
32180,199401,16072,95813,10020,183329,803,362,441
32185,199432,16074,95832,10021,183358,803,362,441
32190,199463,16077,95847,10024,183386,803,362,441
32195,199494,16079,95863,10025,183415,803,362,441
32200,199525,16082,95875,10027,183443,803,362,441
32205,199556,16086,95886,10028,183470,803,362,441
32210,199587,16090,95904,10031,183497,803,362,441
32215,199618,16095,95920,10035,183522,803,362,441
32220,199649,16101,95940,10041,183546,803,362,441
32225,199680,16106,95955,10045,183574,803,362,441
32230,199711,16110,95972,10048,183600,803,362,441
32235,199742,16115,95985,10050,183626,803,362,441
32240,199773,16120,96000,10053,183653,803,362,441
32245,199804,16122,96012,10053,183682,803,362,441
32250,199835,16125,96031,10056,183710,803,362,441
32255,199866,16128,96047,10058,183738,803,362,441
32260,199897,16130,96065,10060,183767,803,362,441
32265,199928,16133,96077,10061,183795,803,362,441
32270,199959,16136,96091,10063,183823,803,362,441
32275,199990,16138,96106,10064,183852,803,362,441
32280,200021,16139,96122,10065,183882,803,362,441
32285,200052,16140,96138,10066,183912,803,362,441
32290,200083,16141,96153,10067,183942,803,362,441
32295,200114,16142,96166,10067,183972,803,362,441
32300,200145,16143,96180,10068,184002,803,362,441
32305,200176,16144,96197,10069,184032,803,362,441
32310,200207,16145,96213,10069,184062,803,362,441
32315,200238,16146,96232,10070,184092,803,362,441
32320,200269,16147,96242,10070,184122,803,362,441
32325,200300,16149,96258,10071,184151,803,362,441
32330,200331,16151,96272,10072,184180,803,362,441
32335,200362,16153,96284,10073,184209,803,362,441
32340,200393,16155,96299,10074,184238,803,362,441
32345,200424,16158,96313,10075,184266,803,362,441
32350,200455,16161,96325,10076,184294,803,362,441
32355,200486,16166,96338,10079,184320,803,362,441
32360,200517,16168,96353,10081,184349,803,362,441
32365,200548,16170,96364,10082,184378,803,362,441
32370,200579,16173,96376,10083,184406,803,362,441
32375,200610,16175,96395,10084,184435,803,362,441
32380,200641,16178,96411,10085,184462,803,362,441
32385,200672,16181,96425,10088,184490,803,362,441
32390,200703,16184,96440,10090,184518,803,362,441
32395,200734,16188,96452,10092,184545,803,362,441
32400,200765,16191,96467,10095,184574,803,362,441
32405,200796,16192,96484,10096,184604,803,362,441
32410,200827,16193,96500,10097,184634,803,362,441
32415,200858,16194,96515,10097,184664,803,362,441
32420,200889,16195,96527,10098,184694,803,362,441
32425,200920,16197,96550,10099,184723,803,362,441
32430,200951,16199,96567,10099,184752,803,362,441
32435,200982,16202,96578,10101,184780,803,362,441
32440,201013,16205,96594,10102,184808,803,362,441
32445,201044,16207,96613,10104,184837,803,362,441
32450,201075,16210,96630,10106,184865,803,362,441
32455,201106,16212,96649,10108,184894,803,362,441
32460,201137,16214,96665,10109,184923,803,362,441
32465,201168,16216,96687,10110,184952,803,362,441
32470,201199,16218,96704,10112,184981,803,362,441
32475,201230,16219,96723,10113,185011,803,362,441
32480,201261,16221,96741,10114,185040,803,362,441
32485,201292,16223,96758,10116,185069,803,362,441
32490,201323,16225,96773,10118,185098,803,362,441
32495,201354,16226,96789,10119,185128,803,362,441
32500,201385,16227,96799,10120,185158,803,362,441
32505,201416,16229,96812,10122,185187,803,362,441
32510,201447,16234,96831,10126,185213,803,362,441
32515,201478,16240,96844,10132,185238,803,362,441
32520,201509,16245,96864,10136,185264,803,362,441
32525,201540,16248,96883,10139,185292,803,362,441
32530,201571,16251,96902,10142,185320,803,362,441
32535,201602,16254,96920,10145,185348,803,362,441
32540,201633,16256,96933,10147,185377,803,362,441
32545,201664,16259,96950,10150,185405,803,362,441
32550,201695,16261,96965,10150,185434,803,362,441
32555,201726,16263,96977,10150,185463,803,362,441
32560,201757,16265,96992,10151,185491,803,362,441
32565,201788,16269,97008,10155,185518,803,362,441
32570,201819,16274,97024,10159,185545,803,362,441
32575,201850,16277,97041,10161,185572,803,362,441
32580,201881,16282,97055,10164,185598,803,362,441
32585,201912,16287,97067,10167,185625,803,362,441
32590,201943,16291,97084,10169,185652,803,362,441
32595,201974,16295,97098,10171,185678,803,362,441
32600,202005,16300,97113,10174,185705,803,362,441
32605,202036,16304,97130,10176,185732,803,362,441
32610,202067,16308,97145,10177,185759,803,362,441
32615,202098,16312,97158,10179,185785,803,362,441
32620,202129,16317,97170,10181,185812,803,362,441
32625,202160,16323,97187,10184,185837,803,362,441
32630,202191,16328,97204,10187,185863,803,362,441
32635,202222,16331,97215,10188,185890,803,362,441
32640,202253,16336,97232,10192,185917,803,362,441
32645,202284,16338,97248,10193,185946,803,362,441
32650,202315,16339,97258,10194,185976,803,362,441
32655,202346,16340,97272,10195,186006,803,362,441
32660,202377,16341,97286,10195,186036,803,362,441
32665,202408,16342,97304,10196,186066,803,362,441
32670,202439,16343,97316,10196,186096,803,362,441
32675,202470,16344,97327,10196,186126,803,362,441
32680,202501,16345,97348,10197,186156,803,362,441
32685,202532,16346,97359,10197,186186,803,362,441
32690,202563,16347,97375,10197,186216,803,362,441
32695,202594,16349,97397,10198,186245,803,362,441
32700,202625,16350,97413,10198,186275,803,362,441
32705,202656,16351,97431,10198,186305,803,362,441
32710,202687,16352,97450,10198,186335,803,362,441
32715,202718,16353,97462,10198,186365,803,362,441
32720,202749,16354,97473,10198,186395,803,362,441
32725,202780,16355,97489,10198,186425,803,362,441
32730,202811,16357,97506,10199,186454,803,362,441
32735,202842,16360,97520,10200,186482,803,362,441
32740,202873,16362,97536,10201,186511,803,362,441
32745,202904,16364,97552,10203,186540,803,362,441
32750,202935,16366,97567,10204,186568,803,362,441
32755,202966,16369,97585,10205,186596,803,362,441
32760,202997,16372,97604,10208,186624,803,362,441
32765,203028,16375,97619,10210,186652,803,362,441
32770,203059,16378,97634,10212,186680,803,362,441
32775,203090,16382,97644,10215,186708,803,362,441
32780,203121,16385,97655,10217,186736,803,362,441
32785,203152,16388,97668,10219,186764,803,362,441
32790,203183,16389,97684,10219,186794,803,362,441
32795,203214,16390,97700,10219,186824,803,362,441
32800,203245,16391,97716,10219,186854,803,362,441
32805,203276,16395,97732,10221,186880,803,362,441
32810,203307,16400,97743,10224,186907,803,362,441
32815,203338,16404,97758,10227,186933,803,362,441
32820,203369,16408,97773,10230,186960,803,362,441
32825,203400,16411,97783,10231,186987,803,362,441
32830,203431,16415,97796,10234,187015,803,362,441
32835,203462,16419,97812,10236,187043,803,362,441
32840,203493,16422,97829,10238,187071,803,362,441
32845,203524,16425,97839,10239,187098,803,362,441
32850,203555,16428,97853,10241,187126,803,362,441
32855,203586,16431,97871,10243,187154,803,362,441
32860,203617,16435,97882,10245,187182,803,362,441
32865,203648,16436,97902,10246,187211,803,362,441
32870,203679,16438,97921,10248,187241,803,362,441
32875,203710,16439,97937,10249,187271,803,362,441
32880,203741,16440,97952,10249,187301,803,362,441
32885,203772,16440,97964,10249,187332,803,362,441
32890,203803,16440,97978,10249,187363,803,362,441
32895,203834,16442,97993,10251,187392,803,362,441
32900,203865,16443,98011,10252,187422,803,362,441
32905,203896,16445,98023,10253,187451,803,362,441
32910,203927,16446,98037,10253,187481,803,362,441
32915,203958,16447,98049,10253,187511,803,362,441
32920,203989,16451,98063,10257,187538,803,362,441
32925,204020,16455,98076,10259,187565,803,362,441
32930,204051,16457,98086,10259,187594,803,362,441
32935,204082,16462,98105,10264,187620,803,362,441
32940,204113,16465,98126,10265,187648,803,362,441
32945,204144,16469,98143,10269,187675,803,362,441
32950,204175,16474,98161,10270,187701,803,362,441
32955,204206,16479,98180,10273,187726,803,362,441
32960,204237,16485,98198,10277,187752,803,362,441
32965,204268,16490,98213,10280,187778,803,362,441
32970,204299,16496,98228,10284,187803,803,362,441
32975,204330,16501,98242,10286,187829,803,362,441
32980,204361,16505,98256,10287,187855,803,362,441
32985,204392,16510,98271,10290,187882,803,362,441
32990,204423,16515,98290,10292,187908,803,362,441
32995,204454,16519,98305,10294,187935,803,362,441
33000,204485,16523,98321,10296,187962,803,362,441
33005,204516,16526,98335,10298,187990,803,362,441
33010,204547,16529,98347,10300,188018,803,362,441
33015,204578,16532,98363,10301,188046,803,362,441
33020,204609,16535,98374,10301,188074,803,362,441
33025,204640,16538,98389,10303,188102,803,362,441
33030,204671,16541,98397,10303,188130,803,362,441
33035,204702,16544,98412,10305,188158,803,362,441
33040,204733,16547,98427,10306,188186,803,362,441
33045,204764,16551,98441,10308,188213,803,362,441
33050,204795,16556,98456,10311,188239,803,362,441
33055,204826,16560,98476,10315,188266,803,362,441
33060,204857,16563,98494,10317,188294,803,362,441
33065,204888,16563,98509,10317,188325,803,362,441
33070,204919,16563,98522,10317,188356,803,362,441
33075,204950,16563,98537,10317,188387,803,362,441
33080,204981,16563,98551,10317,188418,803,362,441
33085,205012,16563,98567,10317,188449,803,362,441
33090,205043,16563,98585,10317,188480,803,362,441
33095,205074,16563,98601,10317,188511,803,362,441
33100,205105,16563,98615,10317,188542,803,362,441
33105,205136,16563,98628,10317,188573,803,362,441
33110,205167,16564,98642,10317,188603,803,362,441
33115,205198,16565,98654,10317,188633,803,362,441
33120,205229,16566,98667,10317,188663,803,362,441
33125,205260,16571,98687,10320,188687,803,362,441
33130,205291,16578,98702,10325,188712,803,362,441
33135,205322,16582,98715,10327,188739,803,362,441
33140,205353,16586,98732,10330,188766,803,362,441
33145,205384,16591,98746,10333,188792,803,362,441
33150,205415,16594,98762,10334,188821,803,362,441
33155,205446,16597,98772,10336,188849,803,362,441
33160,205477,16599,98785,10337,188878,803,362,441
33165,205508,16601,98803,10338,188907,803,362,441
33170,205539,16604,98825,10340,188935,803,362,441
33175,205570,16606,98839,10341,188964,803,362,441
33180,205601,16608,98855,10343,188993,803,362,441
33185,205632,16610,98871,10344,189021,803,362,441
33190,205663,16613,98888,10347,189050,803,362,441
33195,205694,16615,98906,10349,189079,803,362,441
33200,205725,16617,98923,10350,189108,803,362,441
33205,205756,16619,98938,10351,189137,803,362,441
33210,205787,16621,98949,10351,189166,803,362,441
33215,205818,16623,98966,10352,189195,803,362,441
33220,205849,16625,98981,10352,189224,803,362,441
33225,205880,16627,98996,10354,189253,803,362,441
33230,205911,16629,99018,10355,189282,803,362,441
33235,205942,16633,99030,10357,189309,803,362,441
33240,205973,16636,99044,10359,189337,803,362,441
33245,206004,16637,99057,10360,189367,803,362,441
33250,206035,16639,99073,10362,189396,803,362,441
33255,206066,16640,99088,10362,189426,803,362,441
33260,206097,16642,99102,10364,189455,803,362,441
33265,206128,16643,99116,10364,189485,803,362,441
33270,206159,16644,99136,10365,189515,803,362,441
33275,206190,16646,99147,10366,189543,803,362,441
33280,206221,16648,99162,10367,189573,803,362,441
33285,206252,16649,99178,10367,189603,803,362,441
33290,206283,16651,99190,10368,189632,803,362,441
33295,206314,16652,99204,10369,189661,803,362,441
33300,206345,16656,99216,10372,189688,803,362,441
33305,206376,16658,99233,10373,189717,803,362,441
33310,206407,16660,99248,10375,189747,803,362,441
33315,206438,16661,99263,10376,189777,803,362,441
33320,206469,16662,99279,10376,189806,803,362,441
33325,206500,16663,99293,10377,189837,803,362,441
33330,206531,16663,99308,10377,189868,803,362,441
33335,206562,16663,99324,10377,189899,803,362,441
33340,206593,16663,99340,10377,189930,803,362,441
33345,206624,16663,99355,10377,189961,803,362,441
33350,206655,16665,99372,10378,189990,804,362,442
33355,206686,16667,99385,10379,190019,805,362,443
33360,206717,16671,99403,10381,190046,806,363,443
33365,206748,16676,99414,10384,190072,806,363,443
33370,206779,16680,99427,10385,190099,806,363,443
33375,206810,16685,99442,10389,190125,806,363,443
33380,206841,16690,99456,10392,190151,806,363,443
33385,206872,16695,99473,10394,190177,806,363,443
33390,206903,16699,99486,10396,190204,806,363,443
33395,206934,16703,99501,10398,190231,806,363,443
33400,206965,16707,99519,10399,190258,806,363,443
33405,206996,16711,99532,10400,190285,806,363,443
33410,207027,16715,99544,10402,190312,806,363,443
33415,207058,16720,99563,10406,190338,806,363,443
33420,207089,16726,99583,10412,190363,806,363,443
33425,207120,16729,99596,10413,190391,806,363,443
33430,207151,16732,99614,10415,190419,806,363,443
33435,207182,16733,99631,10416,190449,806,363,443
33440,207213,16734,99646,10417,190479,806,363,443
33445,207244,16735,99658,10418,190509,806,363,443
33450,207275,16736,99674,10418,190539,806,363,443
33455,207306,16737,99691,10418,190569,806,363,443
33460,207337,16738,99709,10419,190599,806,363,443
33465,207368,16739,99725,10420,190629,806,363,443
33470,207399,16741,99737,10421,190658,807,363,444
33475,207430,16742,99748,10421,190688,808,364,444
33480,207461,16744,99768,10422,190717,809,364,445
33485,207492,16746,99786,10424,190746,809,364,445
33490,207523,16747,99802,10424,190776,809,364,445
33495,207554,16748,99818,10424,190806,809,364,445
33500,207585,16750,99830,10425,190835,809,364,445
33505,207616,16751,99841,10426,190865,809,364,445
33510,207647,16753,99855,10427,190894,809,364,445
33515,207678,16755,99868,10428,190923,809,364,445
33520,207709,16757,99885,10429,190952,809,364,445
33525,207740,16759,99902,10430,190981,809,364,445
33530,207771,16761,99913,10430,191010,809,364,445
33535,207802,16764,99928,10431,191038,809,364,445
33540,207833,16767,99944,10432,191066,809,364,445
33545,207864,16769,99960,10433,191094,809,364,445
33550,207895,16772,99975,10435,191122,809,364,445
33555,207926,16775,99993,10438,191151,809,364,445
33560,207957,16777,100013,10439,191179,809,364,445
33565,207988,16780,100028,10440,191207,809,364,445
33570,208019,16783,100037,10442,191235,809,364,445
33575,208050,16786,100053,10444,191263,809,364,445
33580,208081,16789,100071,10447,191291,809,364,445
33585,208112,16794,100089,10451,191317,810,365,445
33590,208143,16798,100102,10453,191344,811,365,446
33595,208174,16803,100116,10456,191370,811,365,446
33600,208205,16809,100130,10461,191396,811,365,446
33605,208236,16812,100145,10462,191424,811,365,446
33610,208267,16814,100157,10463,191453,811,365,446
33615,208298,16817,100173,10465,191481,811,365,446
33620,208329,16820,100188,10468,191509,811,365,446
33625,208360,16822,100202,10469,191538,811,365,446
33630,208391,16825,100215,10470,191566,811,365,446
33635,208422,16828,100231,10472,191594,811,365,446
33640,208453,16831,100246,10474,191622,811,365,446
33645,208484,16833,100262,10474,191651,811,365,446
33650,208515,16835,100277,10474,191680,811,365,446
33655,208546,16837,100290,10475,191709,811,365,446
33660,208577,16839,100304,10477,191738,811,365,446
33665,208608,16840,100321,10478,191768,811,365,446
33670,208639,16841,100338,10478,191798,811,365,446
33675,208670,16842,100353,10478,191828,811,365,446
33680,208701,16843,100367,10479,191858,811,365,446
33685,208732,16844,100382,10480,191888,811,365,446
33690,208763,16845,100403,10480,191918,811,365,446
33695,208794,16847,100419,10482,191947,811,365,446
33700,208825,16849,100436,10483,191976,811,365,446
33705,208856,16853,100453,10486,192002,811,365,446
33710,208887,16858,100469,10490,192027,811,365,446
33715,208918,16862,100483,10493,192056,811,365,446
33720,208949,16867,100500,10497,192082,811,365,446
33725,208980,16870,100512,10499,192110,811,365,446
33730,209011,16873,100526,10499,192137,811,365,446
33735,209042,16876,100544,10501,192166,811,365,446
33740,209073,16878,100560,10502,192195,811,365,446
33745,209104,16880,100577,10504,192224,811,365,446
33750,209135,16882,100592,10505,192253,811,365,446
33755,209166,16884,100608,10505,192282,811,365,446
33760,209197,16886,100620,10507,192311,811,365,446
33765,209228,16888,100634,10508,192340,811,365,446
33770,209259,16890,100648,10508,192369,811,365,446
33775,209290,16892,100667,10508,192398,811,365,446
33780,209321,16894,100681,10510,192427,811,365,446
33785,209352,16898,100698,10512,192454,811,365,446
33790,209383,16902,100714,10514,192481,811,365,446
33795,209414,16905,100728,10515,192509,811,365,446
33800,209445,16908,100741,10517,192537,811,365,446
33805,209476,16912,100762,10518,192564,811,365,446
33810,209507,16916,100777,10519,192591,811,365,446
33815,209538,16921,100793,10523,192617,811,365,446
33820,209569,16925,100808,10525,192644,811,365,446
33825,209600,16929,100827,10528,192671,811,365,446
33830,209631,16932,100840,10529,192699,811,365,446
33835,209662,16935,100850,10531,192726,811,365,446
33840,209693,16941,100862,10537,192751,811,365,446
33845,209724,16944,100880,10539,192780,811,365,446
33850,209755,16946,100892,10541,192809,811,365,446
33855,209786,16947,100906,10541,192839,811,365,446
33860,209817,16948,100921,10541,192869,811,365,446
33865,209848,16949,100942,10542,192899,811,365,446
33870,209879,16950,100960,10542,192929,811,365,446
33875,209910,16951,100971,10543,192959,811,365,446
33880,209941,16952,100983,10543,192989,811,365,446
33885,209972,16953,101001,10544,193019,811,365,446
33890,210003,16954,101017,10545,193049,811,365,446
33895,210034,16955,101030,10545,193079,811,365,446
33900,210065,16956,101045,10546,193109,811,365,446
33905,210096,16958,101066,10547,193137,811,365,446
33910,210127,16960,101086,10548,193167,811,365,446
33915,210158,16961,101102,10549,193197,811,365,446
33920,210189,16962,101124,10550,193227,811,365,446
33925,210220,16964,101140,10551,193256,811,365,446
33930,210251,16965,101158,10552,193286,811,365,446
33935,210282,16967,101171,10553,193315,811,365,446
33940,210313,16969,101188,10553,193343,811,365,446
33945,210344,16972,101204,10555,193372,811,365,446
33950,210375,16976,101219,10557,193399,811,365,446
33955,210406,16980,101232,10560,193426,811,365,446
33960,210437,16985,101248,10563,193452,811,365,446
33965,210468,16989,101262,10564,193479,811,365,446
33970,210499,16993,101273,10566,193506,811,365,446
33975,210530,16997,101290,10569,193533,811,365,446
33980,210561,17000,101303,10570,193561,811,365,446
33985,210592,17003,101318,10572,193589,811,365,446
33990,210623,17006,101332,10574,193617,811,365,446
33995,210654,17010,101346,10577,193644,811,365,446
34000,210685,17014,101363,10579,193671,811,365,446
34005,210716,17017,101375,10580,193699,811,365,446
34010,210747,17021,101392,10583,193726,811,365,446
34015,210778,17024,101407,10584,193754,811,365,446
34020,210809,17027,101426,10585,193781,811,365,446
34025,210840,17031,101445,10587,193809,811,365,446
34030,210871,17034,101456,10588,193836,811,365,446
34035,210902,17038,101471,10590,193863,811,365,446
34040,210933,17041,101486,10591,193892,811,365,446
34045,210964,17044,101505,10592,193920,811,365,446
34050,210995,17045,101519,10593,193950,811,365,446
34055,211026,17046,101535,10594,193980,811,365,446
34060,211057,17047,101544,10594,194010,811,365,446
34065,211088,17049,101556,10596,194039,811,365,446
34070,211119,17052,101572,10599,194067,811,365,446
34075,211150,17055,101588,10601,194095,811,365,446
34080,211181,17059,101608,10605,194122,811,365,446
34085,211212,17062,101625,10608,194149,811,365,446
34090,211243,17066,101640,10611,194176,811,365,446
34095,211274,17071,101655,10615,194203,811,365,446
34100,211305,17073,101668,10616,194232,811,365,446
34105,211336,17077,101684,10620,194259,811,365,446
34110,211367,17079,101694,10621,194287,811,365,446
34115,211398,17082,101710,10623,194316,811,365,446
34120,211429,17083,101724,10624,194346,811,365,446
34125,211460,17084,101735,10624,194376,811,365,446
34130,211491,17085,101752,10624,194406,811,365,446
34135,211522,17086,101763,10625,194436,811,365,446
34140,211553,17087,101781,10626,194466,811,365,446
34145,211584,17087,101797,10626,194497,811,365,446
34150,211615,17087,101813,10626,194528,811,365,446
34155,211646,17087,101824,10626,194559,811,365,446
34160,211677,17087,101839,10626,194590,811,365,446
34165,211708,17087,101852,10626,194621,811,365,446
34170,211739,17087,101863,10626,194652,811,365,446
34175,211770,17087,101880,10626,194683,811,365,446
34180,211801,17087,101892,10626,194714,811,365,446
34185,211832,17088,101905,10626,194743,811,365,446
34190,211863,17090,101916,10627,194772,812,366,446
34195,211894,17093,101931,10630,194800,812,366,446
34200,211925,17097,101942,10632,194828,812,366,446
34205,211956,17099,101956,10633,194857,812,366,446
34210,211987,17101,101967,10634,194886,812,366,446
34215,212018,17104,101983,10635,194914,812,366,446
34220,212049,17107,101998,10636,194942,812,366,446
34225,212080,17110,102009,10637,194970,812,366,446
34230,212111,17114,102024,10640,194997,812,366,446
34235,212142,17119,102038,10643,195023,812,366,446
34240,212173,17123,102054,10646,195050,812,366,446
34245,212204,17126,102064,10647,195078,812,366,446
34250,212235,17131,102077,10650,195103,812,366,446
34255,212266,17136,102092,10651,195129,812,366,446
34260,212297,17142,102106,10654,195155,812,366,446
34265,212328,17146,102120,10658,195182,812,366,446
34270,212359,17151,102138,10662,195208,812,366,446
34275,212390,17155,102154,10663,195234,812,366,446
34280,212421,17160,102173,10667,195260,812,366,446
34285,212452,17165,102186,10670,195287,812,366,446
34290,212483,17169,102201,10672,195314,812,366,446
34295,212514,17174,102221,10675,195340,812,366,446
34300,212545,17177,102238,10677,195368,812,366,446
34305,212576,17179,102254,10679,195397,812,366,446
34310,212607,17181,102269,10680,195426,812,366,446
34315,212638,17183,102282,10681,195455,812,366,446
34320,212669,17185,102295,10682,195484,812,366,446
34325,212700,17187,102311,10683,195513,812,366,446
34330,212731,17190,102325,10684,195541,812,366,446
34335,212762,17193,102345,10686,195569,812,366,446
34340,212793,17194,102359,10687,195599,812,366,446
34345,212824,17195,102376,10688,195629,812,366,446
34350,212855,17196,102388,10688,195659,812,366,446
34355,212886,17197,102398,10688,195689,812,366,446
34360,212917,17198,102414,10688,195719,812,366,446
34365,212948,17199,102428,10688,195749,812,366,446
34370,212979,17201,102442,10690,195778,812,366,446
34375,213010,17204,102463,10693,195806,812,366,446
34380,213041,17206,102479,10693,195835,812,366,446
34385,213072,17211,102495,10697,195861,813,366,447
34390,213103,17217,102515,10703,195886,814,367,447
34395,213134,17220,102529,10704,195914,814,367,447
34400,213165,17225,102544,10708,195940,814,367,447
34405,213196,17228,102559,10709,195968,814,367,447
34410,213227,17232,102569,10710,195995,814,367,447
34415,213258,17236,102588,10712,196022,814,367,447
34420,213289,17240,102604,10715,196049,814,367,447
34425,213320,17245,102619,10718,196075,814,367,447
34430,213351,17247,102632,10719,196104,814,367,447
34435,213382,17249,102648,10720,196133,814,367,447
34440,213413,17251,102665,10720,196162,814,367,447
34445,213444,17255,102680,10723,196189,814,367,447
34450,213475,17260,102698,10727,196215,814,367,447
34455,213506,17264,102712,10729,196242,814,367,447
34460,213537,17267,102730,10732,196270,814,367,447
34465,213568,17270,102749,10734,196298,814,367,447
34470,213599,17273,102766,10736,196325,814,367,447
34475,213630,17277,102782,10740,196353,814,367,447
34480,213661,17280,102798,10742,196381,814,367,447
34485,213692,17283,102811,10743,196408,814,367,447
34490,213723,17287,102834,10747,196436,814,367,447
34495,213754,17290,102847,10748,196464,815,368,447
34500,213785,17293,102862,10750,196492,816,369,447
34505,213816,17296,102877,10753,196520,816,369,447
34510,213847,17297,102889,10754,196550,816,369,447
34515,213878,17298,102902,10755,196580,816,369,447
34520,213909,17299,102913,10756,196610,816,369,447
34525,213940,17300,102933,10756,196640,816,369,447
34530,213971,17302,102950,10757,196669,816,369,447
34535,214002,17304,102962,10758,196698,816,369,447
34540,214033,17305,102977,10759,196728,816,369,447
34545,214064,17306,102990,10760,196758,816,369,447
34550,214095,17308,103006,10761,196787,816,369,447
34555,214126,17309,103022,10762,196817,816,369,447
34560,214157,17311,103040,10763,196846,816,369,447
34565,214188,17315,103054,10766,196873,816,369,447
34570,214219,17317,103072,10768,196902,816,369,447
34575,214250,17319,103083,10768,196931,816,369,447
34580,214281,17321,103097,10769,196960,816,369,447
34585,214312,17324,103113,10772,196988,816,369,447
34590,214343,17327,103133,10774,197016,816,369,447
34595,214374,17329,103152,10776,197045,816,369,447
34600,214405,17332,103170,10779,197072,816,369,447
34605,214436,17335,103188,10781,197101,816,369,447
34610,214467,17338,103202,10783,197129,816,369,447
34615,214498,17341,103215,10784,197156,816,369,447
34620,214529,17345,103231,10786,197183,816,369,447
34625,214560,17348,103250,10787,197212,816,369,447
34630,214591,17350,103268,10788,197241,816,369,447
34635,214622,17352,103277,10789,197270,816,369,447
34640,214653,17355,103288,10790,197298,816,369,447
34645,214684,17358,103304,10791,197326,816,369,447
34650,214715,17360,103322,10793,197355,816,369,447
34655,214746,17363,103342,10794,197383,816,369,447
34660,214777,17365,103359,10794,197412,816,369,447
34665,214808,17368,103377,10795,197440,816,369,447
34670,214839,17370,103393,10796,197469,816,369,447
34675,214870,17371,103405,10796,197499,816,369,447
34680,214901,17372,103422,10797,197529,816,369,447
34685,214932,17374,103441,10798,197558,816,369,447
34690,214963,17376,103455,10799,197587,816,369,447
34695,214994,17378,103465,10799,197616,816,369,447
34700,215025,17380,103480,10801,197645,816,369,447
34705,215056,17382,103498,10803,197674,816,369,447
34710,215087,17384,103509,10804,197703,816,369,447
34715,215118,17386,103530,10805,197732,816,369,447
34720,215149,17388,103545,10806,197761,816,369,447
34725,215180,17391,103561,10809,197788,816,369,447
34730,215211,17396,103578,10813,197814,816,369,447
34735,215242,17401,103591,10817,197841,816,369,447
34740,215273,17404,103604,10819,197869,816,369,447
34745,215304,17406,103617,10820,197898,816,369,447
34750,215335,17409,103632,10821,197926,816,369,447
34755,215366,17412,103647,10824,197954,816,369,447
34760,215397,17414,103664,10826,197983,816,369,447
34765,215428,17416,103679,10827,198012,816,369,447
34770,215459,17419,103689,10828,198040,816,369,447
34775,215490,17422,103704,10830,198068,816,369,447
34780,215521,17427,103720,10834,198094,816,369,447
34785,215552,17431,103731,10837,198121,816,369,447
34790,215583,17437,103750,10841,198146,816,369,447
34795,215614,17442,103767,10845,198171,816,369,447
34800,215645,17447,103779,10850,198198,816,369,447
34805,215676,17450,103793,10852,198225,816,369,447
34810,215707,17454,103809,10854,198253,816,369,447
34815,215738,17457,103827,10856,198281,816,369,447
34820,215769,17459,103844,10858,198310,816,369,447
34825,215800,17461,103856,10859,198339,816,369,447
34830,215831,17462,103867,10859,198369,816,369,447
34835,215862,17463,103882,10860,198399,816,369,447
34840,215893,17464,103897,10860,198429,816,369,447
34845,215924,17465,103913,10861,198459,816,369,447
34850,215955,17466,103929,10862,198489,816,369,447
34855,215986,17467,103945,10863,198519,816,369,447
34860,216017,17468,103960,10864,198549,816,369,447
34865,216048,17471,103978,10867,198576,816,369,447
34870,216079,17473,103993,10869,198606,816,369,447
34875,216110,17475,104014,10871,198634,816,369,447
34880,216141,17477,104026,10873,198663,816,369,447
34885,216172,17480,104043,10875,198692,816,369,447
34890,216203,17480,104060,10875,198723,816,369,447
34895,216234,17480,104074,10875,198754,816,369,447
34900,216265,17480,104094,10875,198785,816,369,447
34905,216296,17480,104107,10875,198816,816,369,447
34910,216327,17481,104125,10876,198846,816,369,447
34915,216358,17483,104143,10877,198875,816,369,447
34920,216389,17484,104155,10878,198905,816,369,447
34925,216420,17486,104176,10880,198934,816,369,447
34930,216451,17487,104188,10880,198964,816,369,447
34935,216482,17490,104205,10883,198992,816,369,447
34940,216513,17493,104221,10885,199020,816,369,447
34945,216544,17496,104240,10887,199048,816,369,447
34950,216575,17498,104253,10889,199077,816,369,447
34955,216606,17501,104264,10890,199105,816,369,447
34960,216637,17503,104281,10892,199134,816,369,447
34965,216668,17505,104291,10892,199163,816,369,447
34970,216699,17508,104309,10894,199191,816,369,447
34975,216730,17511,104325,10895,199218,816,369,447
34980,216761,17517,104342,10900,199243,816,369,447
34985,216792,17522,104357,10904,199269,816,369,447
34990,216823,17528,104369,10908,199295,816,369,447
34995,216854,17533,104385,10911,199320,816,369,447
35000,216885,17537,104398,10913,199347,816,369,447
35005,216916,17540,104413,10915,199376,816,369,447
35010,216947,17543,104429,10917,199404,816,369,447
35015,216978,17546,104439,10919,199432,816,369,447
35020,217009,17550,104456,10921,199459,816,369,447
35025,217040,17552,104470,10921,199488,816,369,447
35030,217071,17553,104484,10922,199518,816,369,447
35035,217102,17554,104495,10922,199547,816,369,447
35040,217133,17556,104508,10924,199576,816,369,447
35045,217164,17558,104527,10925,199605,816,369,447
35050,217195,17560,104542,10926,199635,816,369,447
35055,217226,17561,104559,10927,199665,816,369,447
35060,217257,17562,104575,10928,199695,816,369,447
35065,217288,17563,104592,10929,199725,816,369,447
35070,217319,17564,104604,10929,199755,816,369,447
35075,217350,17565,104621,10930,199785,816,369,447
35080,217381,17566,104636,10930,199815,816,369,447
35085,217412,17567,104648,10930,199845,816,369,447
35090,217443,17569,104665,10931,199874,816,369,447
35095,217474,17571,104676,10932,199903,816,369,447
35100,217505,17573,104691,10932,199932,816,369,447
35105,217536,17576,104704,10933,199960,816,369,447
35110,217567,17582,104718,10938,199984,816,369,447
35115,217598,17586,104731,10939,200012,816,369,447
35120,217629,17590,104748,10942,200038,816,369,447
35125,217660,17595,104767,10945,200064,816,369,447
35130,217691,17598,104785,10946,200092,816,369,447
35135,217722,17603,104800,10949,200118,816,369,447
35140,217753,17607,104815,10952,200145,816,369,447
35145,217784,17612,104825,10956,200171,816,369,447
35150,217815,17616,104832,10959,200199,816,369,447
35155,217846,17620,104848,10961,200226,816,369,447
35160,217877,17621,104868,10962,200256,816,369,447
35165,217908,17622,104883,10962,200286,816,369,447
35170,217939,17623,104895,10962,200315,816,369,447
35175,217970,17625,104914,10963,200344,816,369,447
35180,218001,17627,104935,10964,200373,816,369,447
35185,218032,17629,104947,10966,200403,816,369,447
35190,218063,17630,104963,10967,200432,816,369,447
35195,218094,17632,104978,10968,200462,816,369,447
35200,218125,17633,104996,10969,200492,816,369,447
35205,218156,17634,105014,10970,200522,816,369,447
35210,218187,17635,105033,10971,200552,816,369,447
35215,218218,17637,105050,10973,200580,816,369,447
35220,218249,17640,105063,10975,200609,816,369,447
35225,218280,17644,105076,10976,200636,816,369,447
35230,218311,17647,105090,10978,200663,816,369,447
35235,218342,17651,105109,10981,200690,816,369,447
35240,218373,17654,105128,10983,200719,816,369,447
35245,218404,17656,105139,10984,200748,816,369,447
35250,218435,17658,105153,10985,200777,816,369,447
35255,218466,17660,105167,10985,200806,816,369,447
35260,218497,17662,105182,10987,200835,816,369,447
35265,218528,17665,105199,10989,200863,816,369,447
35270,218559,17668,105217,10992,200891,816,369,447
35275,218590,17671,105230,10993,200919,816,369,447
35280,218621,17673,105246,10994,200948,816,369,447
35285,218652,17675,105259,10994,200977,816,369,447
35290,218683,17677,105271,10994,201006,816,369,447
35295,218714,17679,105282,10995,201035,816,369,447
35300,218745,17681,105293,10995,201064,816,369,447
35305,218776,17683,105307,10995,201093,816,369,447
35310,218807,17685,105322,10996,201122,816,369,447
35315,218838,17687,105338,10997,201151,816,369,447
35320,218869,17689,105349,10997,201180,816,369,447
35325,218900,17692,105365,10999,201208,816,369,447
35330,218931,17694,105383,11001,201237,816,369,447
35335,218962,17697,105401,11003,201265,816,369,447
35340,218993,17699,105417,11003,201292,816,369,447
35345,219024,17704,105433,11007,201320,816,369,447
35350,219055,17706,105449,11008,201349,816,369,447
35355,219086,17708,105462,11008,201378,816,369,447
35360,219117,17710,105480,11009,201406,816,369,447
35365,219148,17713,105494,11012,201435,816,369,447
35370,219179,17715,105510,11012,201464,816,369,447
35375,219210,17717,105524,11013,201493,816,369,447
35380,219241,17719,105536,11014,201522,816,369,447
35385,219272,17721,105552,11016,201551,816,369,447
35390,219303,17723,105569,11018,201580,816,369,447
35395,219334,17725,105582,11019,201609,816,369,447
35400,219365,17727,105599,11020,201638,816,369,447
35405,219396,17730,105620,11023,201666,816,369,447
35410,219427,17733,105632,11025,201694,816,369,447
35415,219458,17735,105644,11026,201723,816,369,447
35420,219489,17737,105659,11026,201752,816,369,447
35425,219520,17739,105678,11026,201781,816,369,447
35430,219551,17741,105696,11028,201810,816,369,447
35435,219582,17744,105708,11029,201838,816,369,447
35440,219613,17748,105724,11033,201865,816,369,447
35445,219644,17751,105741,11035,201893,816,369,447
35450,219675,17756,105750,11036,201918,816,369,447
35455,219706,17762,105765,11039,201944,816,369,447
35460,219737,17766,105775,11040,201971,816,369,447
35465,219768,17770,105787,11041,201997,816,369,447
35470,219799,17777,105807,11046,202021,816,369,447
35475,219830,17784,105827,11051,202045,816,369,447
35480,219861,17790,105842,11053,202070,816,369,447
35485,219892,17794,105855,11055,202098,816,369,447
35490,219923,17797,105868,11057,202126,816,369,447
35495,219954,17800,105886,11059,202154,816,369,447
35500,219985,17804,105901,11063,202181,816,369,447
35505,220016,17808,105912,11065,202207,816,369,447
35510,220047,17812,105923,11068,202234,816,369,447
35515,220078,17816,105939,11072,202262,816,369,447
35520,220109,17817,105954,11072,202292,816,369,447
35525,220140,17819,105971,11074,202321,816,369,447
35530,220171,17820,105984,11075,202351,816,369,447
35535,220202,17821,106000,11076,202381,816,369,447
35540,220233,17822,106016,11076,202411,816,369,447
35545,220264,17823,106032,11076,202441,816,369,447
35550,220295,17824,106049,11076,202471,816,369,447
35555,220326,17825,106062,11076,202501,816,369,447
35560,220357,17826,106081,11077,202531,816,369,447
35565,220388,17828,106096,11078,202560,816,369,447
35570,220419,17829,106113,11079,202590,816,369,447
35575,220450,17831,106129,11080,202619,816,369,447
35580,220481,17833,106145,11082,202648,816,369,447
35585,220512,17835,106163,11083,202676,816,369,447
35590,220543,17838,106178,11085,202704,816,369,447
35595,220574,17840,106191,11086,202734,816,369,447
35600,220605,17841,106205,11087,202764,816,369,447
35605,220636,17842,106221,11087,202793,816,369,447
35610,220667,17844,106233,11088,202823,816,369,447
35615,220698,17846,106246,11089,202851,816,369,447
35620,220729,17849,106259,11091,202879,816,369,447
35625,220760,17852,106276,11093,202907,816,369,447
35630,220791,17857,106293,11097,202934,816,369,447
35635,220822,17860,106304,11097,202962,816,369,447
35640,220853,17863,106317,11097,202990,816,369,447
35645,220884,17867,106334,11100,203017,816,369,447
35650,220915,17871,106351,11104,203044,816,369,447
35655,220946,17873,106363,11104,203073,816,369,447
35660,220977,17876,106377,11105,203101,816,369,447
35665,221008,17880,106393,11108,203128,816,369,447
35670,221039,17883,106410,11110,203156,816,369,447
35675,221070,17885,106422,11110,203185,816,369,447
35680,221101,17888,106441,11112,203213,816,369,447
35685,221132,17890,106461,11114,203242,816,369,447
35690,221163,17892,106476,11114,203271,816,369,447
35695,221194,17895,106490,11116,203299,816,369,447
35700,221225,17899,106510,11120,203326,816,369,447
35705,221256,17902,106526,11121,203354,816,369,447
35710,221287,17906,106544,11124,203381,816,369,447
35715,221318,17910,106561,11128,203408,816,369,447
35720,221349,17913,106578,11129,203435,816,369,447
35725,221380,17918,106592,11131,203461,816,369,447
35730,221411,17922,106603,11133,203489,816,369,447
35735,221442,17926,106621,11137,203516,816,369,447
35740,221473,17930,106637,11141,203542,816,369,447
35745,221504,17934,106651,11144,203570,816,369,447
35750,221535,17937,106669,11146,203597,816,369,447
35755,221566,17942,106682,11149,203624,816,369,447
35760,221597,17945,106697,11152,203651,816,369,447
35765,221628,17946,106711,11153,203682,816,369,447
35770,221659,17946,106728,11153,203713,816,369,447
35775,221690,17946,106744,11153,203744,816,369,447
35780,221721,17946,106758,11153,203775,816,369,447
35785,221752,17946,106773,11153,203806,816,369,447
35790,221783,17946,106789,11153,203837,816,369,447
35795,221814,17946,106807,11153,203868,816,369,447
35800,221845,17946,106818,11153,203899,816,369,447
35805,221876,17946,106830,11153,203930,816,369,447
35810,221907,17946,106843,11153,203961,816,369,447
35815,221938,17948,106858,11155,203990,816,369,447
35820,221969,17949,106872,11156,204019,816,369,447
35825,222000,17952,106883,11157,204048,816,369,447
35830,222031,17954,106898,11157,204077,816,369,447
35835,222062,17956,106911,11157,204106,816,369,447
35840,222093,17958,106923,11158,204135,816,369,447
35845,222124,17960,106935,11158,204164,816,369,447
35850,222155,17962,106951,11158,204193,816,369,447
35855,222186,17964,106968,11159,204222,816,369,447
35860,222217,17966,106984,11159,204251,816,369,447
35865,222248,17968,107000,11160,204280,816,369,447
35870,222279,17973,107017,11164,204305,816,369,447
35875,222310,17979,107030,11166,204330,816,369,447
35880,222341,17985,107045,11171,204356,816,369,447
35885,222372,17989,107066,11175,204383,816,369,447
35890,222403,17992,107079,11177,204411,816,369,447
35895,222434,17994,107091,11177,204440,816,369,447
35900,222465,17996,107107,11179,204469,816,369,447
35905,222496,17998,107119,11179,204498,816,369,447
35910,222527,18001,107137,11182,204526,816,369,447
35915,222558,18004,107152,11183,204554,816,369,447
35920,222589,18007,107167,11184,204582,816,369,447
35925,222620,18009,107183,11185,204611,816,369,447
35930,222651,18012,107200,11188,204639,816,369,447
35935,222682,18014,107215,11189,204668,816,369,447
35940,222713,18016,107231,11189,204697,816,369,447
35945,222744,18019,107248,11192,204725,816,369,447
35950,222775,18021,107265,11194,204754,816,369,447
35955,222806,18024,107281,11196,204782,816,369,447
35960,222837,18027,107293,11198,204810,816,369,447
35965,222868,18029,107306,11199,204839,816,369,447
35970,222899,18032,107316,11201,204867,816,369,447
35975,222930,18033,107330,11201,204897,816,369,447
35980,222961,18035,107343,11203,204926,816,369,447
35985,222992,18039,107357,11205,204952,816,369,447
35990,223023,18044,107373,11208,204978,816,369,447
35995,223054,18051,107389,11213,205002,816,369,447
36000,223085,18057,107406,11216,205027,816,369,447
36005,223116,18062,107427,11219,205054,816,369,447
36010,223147,18065,107440,11221,205082,816,369,447
36015,223178,18069,107453,11223,205108,816,369,447
36020,223209,18073,107470,11226,205136,816,369,447
36025,223240,18076,107485,11227,205164,816,369,447
36030,223271,18080,107500,11229,205191,816,369,447
36035,223302,18083,107512,11231,205219,816,369,447
36040,223333,18086,107525,11232,205247,816,369,447
36045,223364,18090,107543,11235,205274,816,369,447
36050,223395,18093,107561,11237,205302,816,369,447
36055,223426,18096,107577,11238,205330,816,369,447
36060,223457,18100,107589,11240,205357,816,369,447
36065,223488,18102,107603,11240,205386,816,369,447
36070,223519,18105,107614,11242,205414,816,369,447
36075,223550,18107,107627,11243,205443,816,369,447
36080,223581,18109,107636,11245,205472,816,369,447
36085,223612,18111,107655,11246,205501,816,369,447
36090,223643,18113,107670,11247,205530,816,369,447
36095,223674,18115,107682,11247,205559,816,369,447
36100,223705,18117,107701,11247,205588,816,369,447
36105,223736,18119,107719,11249,205616,816,369,447
36110,223767,18124,107731,11253,205642,816,369,447
36115,223798,18127,107748,11255,205671,816,369,447
36120,223829,18128,107763,11256,205701,816,369,447
36125,223860,18129,107779,11256,205730,816,369,447
36130,223891,18131,107790,11257,205760,816,369,447
36135,223922,18132,107807,11258,205790,816,369,447
36140,223953,18133,107817,11258,205820,816,369,447
36145,223984,18134,107831,11258,205850,816,369,447
36150,224015,18135,107852,11258,205880,816,369,447
36155,224046,18136,107867,11259,205910,816,369,447
36160,224077,18137,107883,11260,205940,816,369,447
36165,224108,18138,107896,11260,205970,816,369,447
36170,224139,18139,107907,11260,206000,816,369,447
36175,224170,18143,107921,11263,206027,816,369,447
36180,224201,18146,107936,11265,206055,816,369,447
36185,224232,18148,107948,11267,206084,816,369,447
36190,224263,18152,107959,11269,206111,816,369,447
36195,224294,18154,107975,11271,206140,816,369,447
36200,224325,18156,107991,11273,206169,816,369,447
36205,224356,18159,108008,11274,206197,816,369,447
36210,224387,18161,108021,11276,206226,816,369,447
36215,224418,18166,108033,11278,206252,816,369,447
36220,224449,18171,108047,11282,206278,816,369,447
36225,224480,18175,108063,11285,206305,816,369,447
36230,224511,18181,108074,11288,206330,816,369,447
36235,224542,18185,108090,11291,206356,816,369,447
36240,224573,18189,108104,11293,206384,816,369,447
36245,224604,18192,108122,11294,206411,816,369,447
36250,224635,18197,108137,11299,206438,816,369,447
36255,224666,18200,108149,11300,206465,816,369,447
36260,224697,18204,108166,11302,206492,816,369,447
36265,224728,18209,108179,11305,206519,816,369,447
36270,224759,18213,108190,11307,206545,816,369,447
36275,224790,18217,108205,11310,206573,816,369,447
36280,224821,18221,108222,11312,206599,816,369,447
36285,224852,18226,108233,11315,206626,816,369,447
36290,224883,18229,108245,11316,206653,816,369,447
36295,224914,18234,108262,11321,206679,816,369,447
36300,224945,18238,108276,11323,206707,816,369,447
36305,224976,18241,108291,11323,206735,816,369,447
36310,225007,18244,108306,11324,206763,816,369,447
36315,225038,18248,108325,11328,206790,816,369,447
36320,225069,18251,108342,11330,206818,816,369,447
36325,225100,18254,108359,11331,206846,816,369,447
36330,225131,18258,108377,11334,206873,816,369,447
36335,225162,18262,108387,11335,206900,816,369,447
36340,225193,18268,108402,11339,206925,816,369,447
36345,225224,18272,108414,11342,206952,816,369,447
36350,225255,18277,108428,11345,206978,816,369,447
36355,225286,18283,108446,11349,207003,816,369,447
36360,225317,18286,108456,11351,207031,816,369,447
36365,225348,18287,108472,11352,207060,816,369,447
36370,225379,18289,108490,11354,207090,816,369,447
36375,225410,18290,108501,11355,207120,816,369,447
36380,225441,18291,108519,11356,207150,816,369,447
36385,225472,18292,108529,11356,207180,816,369,447
36390,225503,18293,108542,11357,207210,816,369,447
36395,225534,18294,108554,11357,207240,816,369,447
36400,225565,18295,108567,11357,207270,816,369,447
36405,225596,18296,108582,11358,207300,816,369,447
36410,225627,18297,108602,11358,207330,816,369,447
36415,225658,18298,108621,11358,207360,816,369,447
36420,225689,18299,108633,11358,207390,816,369,447
36425,225720,18300,108654,11359,207420,816,369,447
36430,225751,18301,108674,11359,207450,816,369,447
36435,225782,18302,108687,11359,207480,816,369,447
36440,225813,18303,108704,11359,207510,816,369,447
36445,225844,18305,108718,11359,207539,816,369,447
36450,225875,18307,108730,11360,207568,816,369,447
36455,225906,18309,108744,11362,207597,816,369,447
36460,225937,18312,108761,11364,207625,816,369,447
36465,225968,18314,108774,11364,207654,816,369,447
36470,225999,18319,108790,11366,207679,816,369,447
36475,226030,18323,108807,11369,207707,816,369,447
36480,226061,18326,108821,11371,207734,816,369,447
36485,226092,18330,108836,11373,207760,816,369,447
36490,226123,18336,108853,11377,207785,816,369,447
36495,226154,18342,108869,11381,207811,816,369,447
36500,226185,18347,108884,11384,207838,816,369,447
36505,226216,18351,108901,11387,207863,816,369,447
36510,226247,18356,108921,11391,207890,816,369,447
36515,226278,18361,108935,11395,207917,816,369,447
36520,226309,18365,108954,11397,207943,816,369,447
36525,226340,18370,108969,11400,207968,816,369,447
36530,226371,18376,108987,11404,207995,816,369,447
36535,226402,18378,109001,11405,208024,816,369,447
36540,226433,18380,109012,11405,208053,816,369,447
36545,226464,18382,109033,11407,208082,816,369,447
36550,226495,18383,109046,11408,208112,816,369,447
36555,226526,18385,109065,11409,208141,816,369,447
36560,226557,18387,109082,11410,208170,816,369,447
36565,226588,18388,109094,11411,208200,816,369,447
36570,226619,18390,109112,11413,208229,816,369,447
36575,226650,18392,109128,11414,208258,816,369,447
36580,226681,18395,109146,11416,208285,816,369,447
36585,226712,18399,109162,11419,208313,816,369,447
36590,226743,18401,109180,11420,208342,816,369,447
36595,226774,18402,109196,11420,208372,816,369,447
36600,226805,18403,109212,11421,208402,816,369,447
36605,226836,18406,109227,11424,208430,816,369,447
36610,226867,18408,109236,11424,208459,816,369,447
36615,226898,18411,109242,11425,208487,816,369,447
36620,226929,18414,109261,11427,208515,816,369,447
36625,226960,18416,109273,11427,208544,816,369,447
36630,226991,18418,109290,11427,208573,816,369,447
36635,227022,18420,109305,11428,208602,816,369,447
36640,227053,18423,109321,11429,208630,816,369,447
36645,227084,18426,109331,11429,208658,816,369,447
36650,227115,18429,109346,11429,208686,816,369,447
36655,227146,18432,109368,11431,208713,816,369,447
36660,227177,18436,109386,11434,208740,816,369,447
36665,227208,18441,109403,11438,208766,816,369,447
36670,227239,18445,109414,11441,208793,816,369,447
36675,227270,18450,109430,11445,208819,816,369,447
36680,227301,18454,109444,11448,208847,816,369,447
36685,227332,18458,109460,11451,208873,816,369,447
36690,227363,18462,109472,11455,208901,816,369,447
36695,227394,18466,109486,11459,208928,816,369,447
36700,227425,18469,109495,11460,208956,816,369,447
36705,227456,18473,109514,11464,208981,816,369,447
36710,227487,18478,109526,11467,209007,816,369,447
36715,227518,18486,109540,11474,209031,816,369,447
36720,227549,18489,109559,11477,209060,816,369,447
36725,227580,18491,109577,11479,209089,816,369,447
36730,227611,18493,109592,11481,209118,816,369,447
36735,227642,18494,109601,11481,209148,816,369,447
36740,227673,18496,109619,11483,209177,816,369,447
36745,227704,18497,109632,11484,209207,816,369,447
36750,227735,18499,109646,11486,209236,816,369,447
36755,227766,18501,109661,11487,209265,816,369,447
36760,227797,18502,109676,11487,209295,816,369,447
36765,227828,18503,109688,11488,209325,816,369,447
36770,227859,18505,109708,11490,209354,816,369,447
36775,227890,18506,109722,11491,209384,816,369,447
36780,227921,18507,109735,11491,209414,816,369,447
36785,227952,18508,109750,11492,209444,816,369,447
36790,227983,18509,109763,11493,209474,816,369,447
36795,228014,18511,109778,11494,209503,816,369,447
36800,228045,18513,109792,11494,209532,816,369,447
36805,228076,18515,109808,11495,209561,816,369,447
36810,228107,18518,109824,11496,209589,816,369,447
36815,228138,18519,109841,11496,209619,816,369,447
36820,228169,18521,109856,11496,209648,816,369,447
36825,228200,18523,109875,11498,209676,816,369,447
36830,228231,18529,109888,11502,209701,816,369,447
36835,228262,18534,109900,11505,209727,816,369,447
36840,228293,18538,109916,11507,209755,816,369,447
36845,228324,18541,109931,11508,209783,816,369,447
36850,228355,18544,109944,11509,209811,816,369,447
36855,228386,18547,109957,11509,209839,816,369,447
36860,228417,18550,109976,11510,209866,816,369,447
36865,228448,18554,109993,11514,209894,816,369,447
36870,228479,18557,110006,11516,209921,816,369,447
36875,228510,18561,110024,11519,209949,816,369,447
36880,228541,18565,110036,11521,209976,816,369,447
36885,228572,18568,110055,11524,210004,816,369,447
36890,228603,18570,110065,11526,210033,816,369,447
36895,228634,18572,110078,11527,210062,816,369,447
36900,228665,18575,110088,11528,210090,816,369,447
36905,228696,18578,110099,11530,210118,816,369,447
36910,228727,18581,110114,11532,210145,816,369,447
36915,228758,18585,110131,11535,210172,816,369,447
36920,228789,18588,110143,11537,210200,816,369,447
36925,228820,18591,110155,11539,210228,816,369,447
36930,228851,18594,110166,11540,210256,816,369,447
36935,228882,18598,110179,11543,210284,816,369,447
36940,228913,18601,110194,11544,210312,816,369,447
36945,228944,18604,110209,11546,210340,816,369,447
36950,228975,18605,110221,11546,210370,816,369,447
36955,229006,18606,110235,11546,210400,816,369,447
36960,229037,18607,110251,11547,210430,816,369,447
36965,229068,18610,110266,11549,210458,816,369,447
36970,229099,18613,110281,11552,210486,816,369,447
36975,229130,18615,110293,11552,210515,816,369,447
36980,229161,18617,110310,11553,210544,816,369,447
36985,229192,18620,110324,11555,210572,816,369,447
36990,229223,18623,110341,11558,210600,816,369,447
36995,229254,18627,110355,11560,210627,816,369,447
37000,229285,18631,110368,11562,210654,816,369,447
37005,229316,18635,110387,11565,210681,816,369,447
37010,229347,18638,110403,11566,210709,816,369,447
37015,229378,18642,110417,11567,210736,816,369,447
37020,229409,18645,110435,11569,210764,816,369,447
37025,229440,18647,110448,11570,210792,816,369,447
37030,229471,18651,110459,11573,210819,816,369,447
37035,229502,18655,110478,11575,210846,816,369,447
37040,229533,18657,110493,11577,210875,816,369,447
37045,229564,18659,110507,11578,210904,816,369,447
37050,229595,18661,110517,11579,210934,816,369,447
37055,229626,18663,110535,11581,210962,816,369,447
37060,229657,18668,110549,11586,210988,816,369,447
37065,229688,18672,110565,11590,211016,816,369,447
37070,229719,18677,110583,11595,211041,816,369,447
37075,229750,18682,110596,11599,211068,816,369,447
37080,229781,18687,110611,11603,211093,816,369,447
37085,229812,18689,110625,11604,211123,816,369,447
37090,229843,18690,110641,11605,211153,816,369,447
37095,229874,18691,110656,11605,211183,816,369,447
37100,229905,18692,110673,11606,211213,816,369,447
37105,229936,18693,110685,11606,211243,816,369,447
37110,229967,18694,110696,11607,211273,816,369,447
37115,229998,18695,110710,11608,211303,816,369,447
37120,230029,18696,110727,11608,211333,816,369,447
37125,230060,18697,110743,11608,211363,816,369,447
37130,230091,18699,110761,11609,211392,816,369,447
37135,230122,18701,110776,11609,211421,816,369,447
37140,230153,18703,110789,11609,211450,816,369,447
37145,230184,18705,110805,11610,211479,816,369,447
37150,230215,18707,110817,11610,211508,816,369,447
37155,230246,18709,110832,11610,211537,816,369,447
37160,230277,18711,110848,11611,211566,816,369,447
37165,230308,18713,110864,11611,211595,816,369,447
37170,230339,18715,110883,11612,211624,816,369,447
37175,230370,18717,110897,11614,211653,816,369,447
37180,230401,18719,110913,11614,211682,816,369,447
37185,230432,18721,110926,11615,211711,816,369,447
37190,230463,18724,110941,11615,211737,816,369,447
37195,230494,18731,110959,11620,211762,816,369,447
37200,230525,18736,110971,11622,211789,816,369,447
37205,230556,18738,110986,11624,211817,816,369,447
37210,230587,18741,111005,11627,211846,816,369,447
37215,230618,18743,111016,11629,211875,816,369,447
37220,230649,18746,111029,11631,211903,816,369,447
37225,230680,18749,111045,11634,211931,816,369,447
37230,230711,18752,111055,11636,211959,816,369,447
37235,230742,18755,111071,11638,211986,816,369,447
37240,230773,18758,111085,11639,212015,816,369,447
37245,230804,18760,111099,11640,212043,816,369,447
37250,230835,18763,111114,11643,212072,816,369,447
37255,230866,18765,111128,11644,212100,816,369,447
37260,230897,18767,111142,11646,212130,816,369,447
37265,230928,18769,111164,11647,212159,816,369,447
37270,230959,18770,111181,11648,212189,816,369,447
37275,230990,18771,111198,11648,212219,816,369,447
37280,231021,18773,111211,11649,212248,816,369,447
37285,231052,18774,111229,11649,212278,816,369,447
37290,231083,18775,111237,11649,212308,816,369,447
37295,231114,18777,111251,11651,212337,816,369,447
37300,231145,18779,111268,11653,212366,816,369,447
37305,231176,18783,111281,11656,212393,816,369,447
37310,231207,18786,111296,11658,212421,816,369,447
37315,231238,18790,111309,11662,212447,816,369,447
37320,231269,18792,111325,11663,212477,816,369,447
37325,231300,18794,111341,11664,212506,816,369,447
37330,231331,18796,111354,11665,212535,816,369,447
37335,231362,18798,111367,11665,212564,816,369,447
37340,231393,18800,111386,11666,212593,816,369,447
37345,231424,18802,111401,11667,212622,816,369,447
37350,231455,18804,111415,11668,212651,816,369,447
37355,231486,18806,111434,11669,212680,816,369,447
37360,231517,18808,111447,11669,212709,816,369,447
37365,231548,18810,111462,11670,212738,816,369,447
37370,231579,18812,111470,11670,212767,816,369,447
37375,231610,18815,111479,11670,212795,816,369,447
37380,231641,18818,111493,11671,212823,816,369,447
37385,231672,18824,111505,11675,212848,816,369,447
37390,231703,18828,111526,11679,212875,816,369,447
37395,231734,18832,111538,11681,212902,816,369,447
37400,231765,18837,111556,11684,212928,816,369,447
37405,231796,18840,111570,11685,212956,816,369,447
37410,231827,18844,111584,11687,212983,816,369,447
37415,231858,18848,111600,11690,213010,816,369,447
37420,231889,18851,111616,11690,213038,816,369,447
37425,231920,18855,111633,11692,213065,816,369,447
37430,231951,18861,111647,11696,213089,816,369,447
37435,231982,18868,111663,11700,213114,816,369,447
37440,232013,18872,111682,11703,213140,816,369,447
37445,232044,18873,111697,11704,213171,816,369,447
37450,232075,18873,111710,11704,213202,816,369,447
37455,232106,18873,111724,11704,213233,816,369,447
37460,232137,18873,111742,11704,213264,816,369,447
37465,232168,18873,111760,11704,213295,816,369,447
37470,232199,18873,111777,11704,213326,816,369,447
37475,232230,18873,111789,11704,213357,816,369,447
37480,232261,18873,111804,11704,213388,816,369,447
37485,232292,18873,111819,11704,213419,816,369,447
37490,232323,18873,111837,11704,213450,816,369,447
37495,232354,18873,111850,11704,213481,816,369,447
37500,232385,18873,111864,11704,213512,816,369,447
37505,232416,18875,111879,11706,213541,816,369,447
37510,232447,18877,111888,11706,213569,816,369,447
37515,232478,18881,111897,11708,213597,816,369,447
37520,232509,18883,111911,11708,213625,816,369,447
37525,232540,18886,111929,11710,213654,816,369,447
37530,232571,18888,111949,11711,213682,816,369,447
37535,232602,18890,111961,11712,213712,816,369,447
37540,232633,18891,111976,11713,213742,816,369,447
37545,232664,18893,111996,11714,213771,816,369,447
37550,232695,18894,112011,11714,213801,816,369,447
37555,232726,18897,112027,11715,213829,816,369,447
37560,232757,18900,112039,11717,213857,816,369,447
37565,232788,18904,112056,11720,213883,816,369,447
37570,232819,18908,112067,11723,213911,816,369,447
37575,232850,18912,112088,11727,213937,816,369,447
37580,232881,18916,112105,11730,213965,816,369,447
37585,232912,18919,112117,11730,213992,816,369,447
37590,232943,18923,112129,11732,214019,816,369,447
37595,232974,18927,112143,11733,214047,816,369,447
37600,233005,18929,112157,11734,214076,816,369,447
37605,233036,18931,112168,11736,214105,816,369,447
37610,233067,18933,112183,11737,214134,816,369,447
37615,233098,18935,112194,11738,214163,816,369,447
37620,233129,18938,112210,11740,214191,816,369,447
37625,233160,18940,112222,11740,214219,816,369,447
37630,233191,18943,112238,11741,214247,816,369,447
37635,233222,18946,112249,11744,214275,816,369,447
37640,233253,18949,112265,11747,214303,816,369,447
37645,233284,18952,112280,11748,214331,816,369,447
37650,233315,18955,112290,11750,214360,816,369,447
37655,233346,18957,112305,11750,214388,816,369,447
37660,233377,18960,112321,11752,214416,816,369,447
37665,233408,18964,112335,11756,214443,816,369,447
37670,233439,18968,112349,11758,214471,816,369,447
37675,233470,18970,112363,11759,214500,816,369,447
37680,233501,18973,112374,11760,214528,816,369,447
37685,233532,18977,112387,11762,214554,816,369,447
37690,233563,18982,112401,11764,214581,816,369,447
37695,233594,18986,112414,11766,214608,816,369,447
37700,233625,18991,112428,11770,214634,816,369,447
37705,233656,18994,112438,11772,214661,816,369,447
37710,233687,18999,112451,11777,214688,816,369,447
37715,233718,19002,112463,11778,214715,816,369,447
37720,233749,19006,112477,11780,214743,816,369,447
37725,233780,19009,112492,11782,214770,816,369,447
37730,233811,19014,112511,11787,214796,816,369,447
37735,233842,19018,112523,11789,214823,816,369,447
37740,233873,19022,112538,11790,214851,816,369,447
37745,233904,19022,112560,11790,214882,816,369,447
37750,233935,19022,112572,11790,214913,816,369,447
37755,233966,19022,112589,11790,214944,816,369,447
37760,233997,19022,112602,11790,214975,816,369,447
37765,234028,19022,112619,11790,215006,816,369,447
37770,234059,19022,112636,11790,215037,816,369,447
37775,234090,19022,112649,11790,215068,816,369,447
37780,234121,19022,112662,11790,215099,816,369,447
37785,234152,19022,112678,11790,215130,816,369,447
37790,234183,19022,112699,11790,215161,816,369,447
37795,234214,19022,112716,11790,215192,816,369,447
37800,234245,19022,112730,11790,215223,816,369,447
37805,234276,19022,112743,11790,215254,816,369,447
37810,234307,19022,112756,11790,215285,816,369,447
37815,234338,19022,112772,11790,215316,816,369,447
37820,234369,19022,112784,11790,215347,816,369,447
37825,234400,19022,112795,11790,215378,816,369,447
37830,234431,19022,112807,11790,215409,816,369,447
37835,234462,19022,112817,11790,215440,816,369,447
37840,234493,19022,112835,11790,215471,816,369,447
37845,234524,19023,112843,11791,215501,816,369,447
37850,234555,19026,112855,11791,215528,816,369,447
37855,234586,19031,112872,11795,215554,816,369,447
37860,234617,19037,112883,11798,215579,816,369,447
37865,234648,19043,112900,11803,215605,817,370,447
37870,234679,19048,112914,11806,215631,817,370,447
37875,234710,19052,112930,11810,215658,817,370,447
37880,234741,19056,112945,11811,215685,817,370,447
37885,234772,19061,112962,11814,215711,817,370,447
37890,234803,19066,112969,11816,215737,817,370,447
37895,234834,19071,112981,11820,215763,817,370,447
37900,234865,19076,112996,11821,215789,817,370,447
37905,234896,19080,113012,11821,215816,817,370,447
37910,234927,19084,113023,11823,215843,817,370,447
37915,234958,19090,113042,11827,215868,817,370,447
37920,234989,19094,113058,11830,215895,817,370,447
37925,235020,19096,113069,11831,215924,817,370,447
37930,235051,19098,113086,11832,215953,817,370,447
37935,235082,19101,113099,11834,215981,817,370,447
37940,235113,19104,113113,11837,216009,817,370,447
37945,235144,19106,113128,11837,216038,817,370,447
37950,235175,19109,113143,11838,216066,817,370,447
37955,235206,19110,113160,11838,216096,817,370,447
37960,235237,19111,113174,11839,216126,817,370,447
37965,235268,19112,113183,11839,216156,817,370,447
37970,235299,19115,113197,11842,216184,817,370,447
37975,235330,19117,113211,11844,216213,817,370,447
37980,235361,19119,113228,11846,216241,818,371,447
37985,235392,19124,113243,11850,216267,818,371,447
37990,235423,19127,113254,11852,216296,818,371,447
37995,235454,19129,113267,11853,216324,818,371,447
38000,235485,19132,113281,11855,216353,818,371,447
38005,235516,19134,113296,11857,216381,818,371,447
38010,235547,19137,113310,11859,216410,818,371,447
38015,235578,19139,113323,11860,216439,818,371,447
38020,235609,19141,113335,11861,216467,818,371,447
38025,235640,19145,113353,11864,216494,818,371,447
38030,235671,19149,113365,11867,216522,818,371,447
38035,235702,19152,113387,11869,216550,818,371,447
38040,235733,19154,113400,11869,216579,818,371,447
38045,235764,19155,113418,11870,216609,818,371,447
38050,235795,19156,113430,11871,216639,818,371,447
38055,235826,19157,113449,11872,216669,818,371,447
38060,235857,19158,113467,11872,216699,818,371,447
38065,235888,19159,113478,11872,216729,818,371,447
38070,235919,19160,113496,11873,216759,818,371,447
38075,235950,19161,113515,11873,216789,818,371,447
38080,235981,19162,113529,11873,216819,818,371,447
38085,236012,19164,113547,11875,216848,818,371,447
38090,236043,19166,113557,11876,216877,818,371,447
38095,236074,19168,113571,11877,216906,818,371,447
38100,236105,19170,113586,11878,216935,818,371,447
38105,236136,19172,113605,11880,216963,818,371,447
38110,236167,19174,113622,11881,216992,818,371,447
38115,236198,19176,113638,11882,217021,818,371,447
38120,236229,19179,113655,11884,217049,818,371,447
38125,236260,19181,113668,11886,217079,818,371,447
38130,236291,19182,113681,11886,217109,818,371,447
38135,236322,19184,113697,11888,217138,818,371,447
38140,236353,19186,113711,11889,217166,818,371,447
38145,236384,19188,113724,11890,217196,818,371,447
38150,236415,19190,113743,11891,217225,818,371,447
38155,236446,19192,113756,11893,217254,818,371,447
38160,236477,19194,113774,11895,217282,818,371,447
38165,236508,19199,113791,11899,217308,818,371,447
38170,236539,19203,113803,11901,217336,818,371,447
38175,236570,19207,113819,11905,217363,818,371,447
38180,236601,19211,113833,11907,217390,818,371,447
38185,236632,19214,113846,11909,217418,818,371,447
38190,236663,19216,113858,11911,217447,818,371,447
38195,236694,19219,113874,11912,217475,818,371,447
38200,236725,19220,113890,11913,217505,818,371,447
38205,236756,19221,113905,11914,217535,818,371,447
38210,236787,19222,113919,11915,217565,818,371,447
38215,236818,19222,113938,11915,217596,818,371,447
38220,236849,19222,113951,11915,217627,818,371,447
38225,236880,19222,113959,11915,217658,818,371,447
38230,236911,19222,113974,11915,217689,818,371,447
38235,236942,19222,113993,11915,217720,818,371,447
38240,236973,19222,114010,11915,217751,818,371,447
38245,237004,19222,114026,11915,217782,818,371,447
38250,237035,19222,114042,11915,217813,818,371,447
38255,237066,19222,114061,11915,217844,818,371,447
38260,237097,19222,114077,11915,217875,818,371,447
38265,237128,19223,114093,11916,217905,818,371,447
38270,237159,19225,114105,11917,217934,818,371,447
38275,237190,19227,114117,11918,217963,818,371,447
38280,237221,19229,114126,11919,217992,818,371,447
38285,237252,19233,114138,11921,218019,818,371,447
38290,237283,19238,114157,11924,218045,819,372,447
38295,237314,19242,114173,11926,218072,820,372,448
38300,237345,19245,114182,11928,218100,821,372,449
38305,237376,19248,114196,11929,218128,822,373,449
38310,237407,19251,114208,11930,218156,823,373,450
38315,237438,19254,114222,11932,218184,824,373,451
38320,237469,19257,114239,11933,218212,825,374,451
38325,237500,19261,114254,11935,218239,826,375,451
38330,237531,19265,114266,11936,218266,827,376,451
38335,237562,19270,114279,11939,218290,828,376,452
38340,237593,19276,114289,11943,218317,829,376,453
38345,237624,19280,114306,11945,218342,829,376,453
38350,237655,19287,114326,11951,218366,829,376,453
38355,237686,19293,114341,11955,218392,829,376,453
38360,237717,19299,114355,11960,218417,829,376,453
38365,237748,19305,114369,11964,218443,829,376,453
38370,237779,19310,114389,11967,218469,829,376,453
38375,237810,19315,114405,11970,218495,829,376,453
38380,237841,19318,114419,11971,218523,829,376,453
38385,237872,19321,114436,11972,218551,829,376,453
38390,237903,19325,114452,11975,218578,829,376,453
38395,237934,19328,114468,11976,218606,829,376,453
38400,237965,19332,114485,11979,218633,829,376,453
38405,237996,19335,114498,11980,218661,829,376,453
38410,238027,19336,114515,11981,218691,829,376,453
38415,238058,19337,114527,11982,218721,829,376,453
38420,238089,19338,114539,11982,218751,829,376,453
38425,238120,19339,114553,11982,218781,829,376,453
38430,238151,19340,114565,11982,218811,829,376,453
38435,238182,19341,114583,11982,218841,829,376,453
38440,238213,19342,114598,11982,218871,829,376,453
38445,238244,19343,114616,11982,218901,829,376,453
38450,238275,19343,114629,11982,218932,830,377,453
38455,238306,19343,114643,11982,218963,831,377,454
38460,238337,19343,114657,11982,218994,832,377,455
38465,238368,19344,114672,11982,219024,832,377,455
38470,238399,19345,114685,11982,219054,832,377,455
38475,238430,19346,114696,11982,219084,832,377,455
38480,238461,19347,114710,11983,219114,832,377,455
38485,238492,19348,114721,11983,219144,832,377,455
38490,238523,19349,114739,11984,219174,832,377,455
38495,238554,19350,114754,11984,219204,832,377,455
38500,238585,19351,114767,11985,219234,832,377,455
38505,238616,19352,114781,11985,219264,832,377,455
38510,238647,19354,114793,11986,219293,832,377,455
38515,238678,19357,114809,11988,219321,832,377,455
38520,238709,19362,114824,11993,219345,832,377,455
38525,238740,19368,114838,11997,219372,832,377,455
38530,238771,19372,114853,11999,219398,832,377,455
38535,238802,19376,114866,12001,219426,832,377,455
38540,238833,19379,114878,12003,219454,832,377,455
38545,238864,19382,114892,12005,219482,832,377,455
38550,238895,19385,114907,12007,219510,832,377,455
38555,238926,19388,114924,12009,219538,832,377,455
38560,238957,19391,114941,12010,219566,832,377,455
38565,238988,19394,114956,12012,219594,833,378,455
38570,239019,19398,114970,12013,219621,834,378,456
38575,239050,19403,114986,12017,219647,835,379,456
38580,239081,19408,115001,12019,219673,836,379,457
38585,239112,19410,115014,12020,219702,836,379,457
38590,239143,19412,115026,12022,219731,836,379,457
38595,239174,19414,115041,12022,219760,836,379,457
38600,239205,19416,115059,12022,219789,836,379,457
38605,239236,19418,115070,12024,219818,836,379,457
38610,239267,19420,115083,12024,219847,836,379,457
38615,239298,19422,115098,12026,219876,836,379,457
38620,239329,19424,115111,12027,219905,836,379,457
38625,239360,19427,115125,12029,219932,836,379,457
38630,239391,19431,115144,12032,219960,836,379,457
38635,239422,19433,115155,12033,219989,836,379,457
38640,239453,19436,115170,12034,220017,836,379,457
38645,239484,19437,115189,12035,220047,836,379,457
38650,239515,19438,115206,12036,220077,836,379,457
38655,239546,19439,115224,12036,220107,836,379,457
38660,239577,19441,115237,12038,220136,836,379,457
38665,239608,19443,115258,12039,220165,836,379,457
38670,239639,19445,115276,12040,220194,836,379,457
38675,239670,19446,115287,12040,220224,836,379,457
38680,239701,19448,115302,12041,220253,836,379,457
38685,239732,19449,115316,12041,220283,836,379,457
38690,239763,19452,115335,12043,220311,836,379,457
38695,239794,19455,115352,12045,220338,836,379,457
38700,239825,19458,115365,12046,220366,836,379,457
38705,239856,19461,115377,12048,220395,836,379,457
38710,239887,19464,115392,12050,220423,836,379,457
38715,239918,19468,115406,12052,220450,836,379,457
38720,239949,19471,115427,12055,220478,836,379,457
38725,239980,19472,115441,12055,220508,836,379,457
38730,240011,19473,115456,12056,220538,836,379,457
38735,240042,19474,115475,12057,220568,836,379,457
38740,240073,19475,115491,12058,220598,836,379,457
38745,240104,19476,115502,12059,220628,836,379,457
38750,240135,19478,115521,12059,220657,836,379,457
38755,240166,19480,115529,12060,220686,836,379,457
38760,240197,19482,115544,12060,220715,836,379,457
38765,240228,19486,115562,12063,220742,836,379,457
38770,240259,19489,115577,12064,220769,836,379,457
38775,240290,19493,115596,12067,220796,836,379,457
38780,240321,19497,115612,12068,220824,836,379,457
38785,240352,19500,115628,12070,220851,836,379,457
38790,240383,19504,115643,12073,220879,836,379,457
38795,240414,19507,115655,12073,220906,836,379,457
38800,240445,19511,115670,12074,220933,836,379,457
38805,240476,19516,115689,12079,220959,836,379,457
38810,240507,19521,115705,12083,220985,836,379,457
38815,240538,19525,115722,12086,221013,836,379,457
38820,240569,19529,115738,12090,221039,836,379,457
38825,240600,19531,115751,12092,221069,836,379,457
38830,240631,19532,115766,12093,221099,836,379,457
38835,240662,19534,115780,12095,221128,836,379,457
38840,240693,19536,115801,12097,221157,836,379,457
38845,240724,19538,115812,12099,221185,836,379,457
38850,240755,19540,115824,12101,221214,836,379,457
38855,240786,19542,115839,12103,221243,836,379,457
38860,240817,19545,115853,12105,221272,836,379,457
38865,240848,19547,115871,12107,221300,836,379,457
38870,240879,19550,115890,12110,221329,836,379,457
38875,240910,19550,115902,12110,221360,836,379,457
38880,240941,19550,115916,12110,221391,836,379,457
38885,240972,19551,115935,12110,221421,836,379,457
38890,241003,19552,115948,12111,221451,836,379,457
38895,241034,19553,115965,12111,221481,836,379,457
38900,241065,19554,115978,12112,221511,836,379,457
38905,241096,19555,115995,12113,221541,836,379,457
38910,241127,19556,116012,12114,221571,836,379,457
38915,241158,19557,116027,12115,221601,836,379,457
38920,241189,19558,116042,12116,221631,836,379,457
38925,241220,19559,116059,12117,221661,836,379,457
38930,241251,19562,116078,12120,221689,836,379,457
38935,241282,19565,116091,12121,221717,836,379,457
38940,241313,19568,116109,12123,221745,836,379,457
38945,241344,19572,116124,12126,221772,836,379,457
38950,241375,19576,116133,12127,221799,836,379,457
38955,241406,19580,116148,12129,221826,836,379,457
38960,241437,19584,116164,12133,221852,836,379,457
38965,241468,19588,116181,12135,221880,836,379,457
38970,241499,19591,116199,12137,221907,836,379,457
38975,241530,19596,116215,12142,221934,836,379,457
38980,241561,19600,116231,12144,221961,836,379,457
38985,241592,19605,116241,12146,221985,836,379,457
38990,241623,19612,116259,12151,222010,836,379,457
38995,241654,19618,116274,12154,222035,836,379,457
39000,241685,19624,116288,12156,222061,836,379,457
39005,241716,19627,116305,12157,222089,836,379,457
39010,241747,19629,116316,12158,222118,836,379,457
39015,241778,19632,116335,12161,222145,836,379,457
39020,241809,19635,116349,12163,222174,836,379,457
39025,241840,19637,116362,12164,222203,836,379,457
39030,241871,19639,116373,12165,222232,836,379,457
39035,241902,19641,116387,12167,222261,836,379,457
39040,241933,19644,116403,12168,222289,836,379,457
39045,241964,19645,116418,12169,222319,836,379,457
39050,241995,19645,116433,12169,222350,836,379,457
39055,242026,19645,116446,12169,222381,836,379,457
39060,242057,19645,116459,12169,222412,836,379,457
39065,242088,19646,116475,12170,222442,836,379,457
39070,242119,19647,116489,12171,222472,836,379,457
39075,242150,19648,116503,12172,222502,836,379,457
39080,242181,19649,116514,12172,222532,836,379,457
39085,242212,19650,116530,12172,222562,836,379,457
39090,242243,19651,116543,12173,222592,836,379,457
39095,242274,19652,116558,12174,222622,836,379,457
39100,242305,19653,116573,12175,222652,836,379,457
39105,242336,19654,116584,12175,222682,836,379,457
39110,242367,19658,116599,12178,222709,836,379,457
39115,242398,19662,116615,12179,222736,836,379,457
39120,242429,19666,116631,12182,222762,836,379,457
39125,242460,19672,116649,12186,222787,836,379,457
39130,242491,19677,116665,12190,222813,836,379,457
39135,242522,19681,116675,12193,222841,836,379,457
39140,242553,19683,116688,12194,222869,836,379,457
39145,242584,19687,116699,12197,222897,836,379,457
39150,242615,19688,116721,12198,222927,836,379,457
39155,242646,19690,116735,12199,222956,836,379,457
39160,242677,19691,116753,12200,222986,836,379,457
39165,242708,19694,116767,12202,223014,836,379,457
39170,242739,19697,116781,12205,223042,836,379,457
39175,242770,19699,116799,12207,223071,836,379,457
39180,242801,19700,116813,12207,223101,836,379,457
39185,242832,19701,116829,12208,223131,836,379,457
39190,242863,19703,116842,12209,223160,836,379,457
39195,242894,19704,116858,12210,223190,836,379,457
39200,242925,19705,116876,12211,223220,836,379,457
39205,242956,19707,116893,12213,223249,836,379,457
39210,242987,19708,116907,12213,223279,836,379,457
39215,243018,19709,116922,12214,223309,836,379,457
39220,243049,19711,116934,12216,223338,836,379,457
39225,243080,19713,116951,12216,223367,836,379,457
39230,243111,19714,116964,12217,223397,836,379,457
39235,243142,19715,116977,12217,223426,836,379,457
39240,243173,19719,116993,12221,223454,836,379,457
39245,243204,19722,117006,12222,223482,836,379,457
39250,243235,19725,117024,12225,223509,836,379,457
39255,243266,19730,117040,12228,223535,836,379,457
39260,243297,19734,117059,12230,223562,836,379,457
39265,243328,19738,117074,12233,223590,836,379,457
39270,243359,19740,117090,12234,223619,836,379,457
39275,243390,19742,117107,12234,223648,836,379,457
39280,243421,19744,117118,12235,223677,836,379,457
39285,243452,19746,117135,12236,223706,836,379,457
39290,243483,19748,117149,12236,223735,836,379,457
39295,243514,19750,117166,12237,223764,836,379,457
39300,243545,19752,117179,12237,223793,836,379,457
39305,243576,19754,117192,12237,223822,836,379,457
39310,243607,19756,117209,12239,223851,836,379,457
39315,243638,19758,117223,12239,223880,836,379,457
39320,243669,19760,117240,12239,223909,836,379,457
39325,243700,19762,117253,12241,223938,836,379,457
39330,243731,19764,117268,12242,223967,836,379,457
39335,243762,19767,117285,12244,223995,836,379,457
39340,243793,19770,117300,12246,224023,836,379,457
39345,243824,19774,117311,12247,224050,836,379,457
39350,243855,19778,117328,12249,224077,836,379,457
39355,243886,19782,117347,12252,224104,836,379,457
39360,243917,19785,117363,12254,224132,836,379,457
39365,243948,19789,117379,12257,224157,836,379,457
39370,243979,19794,117398,12261,224185,836,379,457
39375,244010,19799,117413,12265,224210,836,379,457
39380,244041,19806,117427,12271,224233,836,379,457
39385,244072,19813,117440,12276,224258,836,379,457
39390,244103,19820,117456,12281,224283,836,379,457
39395,244134,19825,117468,12285,224308,836,379,457
39400,244165,19831,117485,12289,224334,836,379,457
39405,244196,19834,117501,12290,224361,836,379,457
39410,244227,19838,117518,12292,224389,836,379,457
39415,244258,19842,117532,12294,224416,836,379,457
39420,244289,19846,117552,12297,224442,836,379,457
39425,244320,19847,117566,12298,224473,836,379,457
39430,244351,19847,117584,12298,224504,836,379,457
39435,244382,19847,117600,12298,224535,836,379,457
39440,244413,19847,117612,12298,224566,836,379,457
39445,244444,19847,117626,12298,224597,836,379,457
39450,244475,19847,117647,12298,224628,836,379,457
39455,244506,19847,117658,12298,224659,836,379,457
39460,244537,19847,117670,12298,224690,836,379,457
39465,244568,19848,117685,12299,224720,836,379,457
39470,244599,19849,117701,12299,224750,836,379,457
39475,244630,19850,117716,12300,224780,836,379,457
39480,244661,19851,117732,12300,224810,836,379,457
39485,244692,19856,117752,12304,224836,836,379,457
39490,244723,19861,117771,12307,224861,836,379,457
39495,244754,19867,117782,12311,224887,836,379,457
39500,244785,19871,117800,12312,224913,836,379,457
39505,244816,19875,117816,12314,224941,836,379,457
39510,244847,19879,117829,12316,224967,836,379,457
39515,244878,19884,117838,12319,224994,836,379,457
39520,244909,19886,117854,12319,225023,836,379,457
39525,244940,19888,117870,12321,225052,836,379,457
39530,244971,19891,117882,12322,225080,836,379,457
39535,245002,19894,117897,12323,225108,836,379,457
39540,245033,19898,117913,12326,225135,836,379,457
39545,245064,19900,117925,12327,225164,836,379,457
39550,245095,19902,117939,12328,225193,836,379,457
39555,245126,19905,117953,12330,225221,836,379,457
39560,245157,19907,117969,12330,225250,836,379,457
39565,245188,19909,117985,12330,225279,836,379,457
39570,245219,19912,117997,12332,225307,836,379,457
39575,245250,19915,118010,12334,225335,836,379,457
39580,245281,19918,118023,12335,225363,836,379,457
39585,245312,19921,118041,12338,225391,836,379,457
39590,245343,19923,118055,12340,225420,836,379,457
39595,245374,19925,118073,12342,225449,836,379,457
39600,245405,19927,118090,12343,225478,836,379,457
39605,245436,19930,118104,12344,225506,836,379,457
39610,245467,19931,118119,12345,225536,836,379,457
39615,245498,19932,118132,12345,225566,836,379,457
39620,245529,19933,118147,12345,225596,836,379,457
39625,245560,19935,118162,12347,225625,836,379,457
39630,245591,19938,118176,12349,225653,836,379,457
39635,245622,19941,118195,12351,225681,836,379,457
39640,245653,19944,118213,12354,225709,836,379,457
39645,245684,19946,118230,12355,225738,836,379,457
39650,245715,19949,118248,12357,225766,836,379,457
39655,245746,19951,118258,12357,225795,836,379,457
39660,245777,19954,118270,12359,225823,836,379,457
39665,245808,19955,118287,12360,225853,836,379,457
39670,245839,19957,118301,12361,225882,836,379,457
39675,245870,19958,118313,12361,225912,836,379,457
39680,245901,19959,118326,12361,225942,836,379,457
39685,245932,19960,118342,12361,225972,836,379,457
39690,245963,19961,118354,12362,226002,836,379,457
39695,245994,19962,118371,12363,226032,836,379,457
39700,246025,19963,118388,12364,226062,836,379,457
39705,246056,19964,118404,12364,226092,836,379,457
39710,246087,19966,118421,12366,226121,836,379,457
39715,246118,19968,118434,12367,226149,836,379,457
39720,246149,19971,118449,12368,226177,836,379,457
39725,246180,19974,118461,12370,226206,836,379,457
39730,246211,19977,118474,12372,226234,836,379,457
39735,246242,19979,118487,12373,226262,836,379,457
39740,246273,19983,118501,12377,226290,836,379,457
39745,246304,19985,118511,12377,226318,836,379,457
39750,246335,19989,118530,12379,226345,836,379,457
39755,246366,19992,118541,12381,226374,836,379,457
39760,246397,19994,118555,12382,226403,836,379,457
39765,246428,19997,118563,12385,226431,836,379,457
39770,246459,20000,118579,12388,226459,836,379,457
39775,246490,20003,118593,12390,226487,836,379,457
39780,246521,20006,118607,12392,226515,836,379,457
39785,246552,20011,118625,12395,226541,836,379,457
39790,246583,20014,118636,12395,226569,836,379,457
39795,246614,20019,118652,12399,226594,836,379,457
39800,246645,20022,118665,12401,226622,836,379,457
39805,246676,20026,118678,12404,226649,836,379,457
39810,246707,20027,118692,12405,226680,836,379,457
39815,246738,20027,118708,12405,226711,836,379,457
39820,246769,20027,118723,12405,226742,836,379,457
39825,246800,20027,118738,12405,226773,836,379,457
39830,246831,20027,118757,12405,226804,836,379,457
39835,246862,20027,118775,12405,226835,836,379,457
39840,246893,20027,118794,12405,226866,836,379,457
39845,246924,20027,118810,12405,226897,836,379,457
39850,246955,20027,118827,12405,226928,836,379,457
39855,246986,20027,118839,12405,226959,836,379,457
39860,247017,20027,118854,12405,226990,836,379,457
39865,247048,20027,118866,12405,227021,836,379,457
39870,247079,20027,118882,12405,227052,836,379,457
39875,247110,20028,118898,12405,227082,836,379,457
39880,247141,20029,118914,12406,227112,836,379,457
39885,247172,20030,118931,12407,227142,836,379,457
39890,247203,20031,118942,12407,227172,836,379,457
39895,247234,20033,118955,12408,227201,836,379,457
39900,247265,20035,118974,12410,227230,836,379,457
39905,247296,20039,118991,12413,227256,836,379,457
39910,247327,20045,119003,12416,227282,836,379,457
39915,247358,20050,119018,12421,227308,836,379,457
39920,247389,20055,119037,12424,227333,836,379,457
39925,247420,20061,119054,12429,227359,836,379,457
39930,247451,20066,119071,12432,227384,836,379,457
39935,247482,20073,119090,12437,227408,836,379,457
39940,247513,20078,119107,12440,227434,836,379,457
39945,247544,20084,119121,12445,227459,836,379,457
39950,247575,20091,119137,12450,227483,836,379,457
39955,247606,20098,119154,12456,227508,836,379,457
39960,247637,20103,119169,12460,227534,836,379,457
39965,247668,20105,119183,12461,227562,836,379,457
39970,247699,20108,119197,12463,227590,836,379,457
39975,247730,20110,119211,12464,227620,836,379,457
39980,247761,20111,119223,12465,227649,836,379,457
39985,247792,20113,119239,12467,227679,836,379,457
39990,247823,20114,119254,12467,227708,836,379,457
39995,247854,20116,119270,12468,227737,836,379,457
40000,247885,20118,119285,12470,227767,836,379,457
40005,247916,20118,119301,12470,227798,836,379,457
40010,247947,20118,119315,12470,227829,836,379,457
40015,247978,20118,119330,12470,227860,836,379,457
40020,248009,20118,119346,12470,227891,836,379,457
40025,248040,20118,119363,12470,227922,836,379,457
40030,248071,20118,119378,12470,227953,836,379,457
40035,248102,20118,119398,12470,227984,836,379,457
40040,248133,20118,119414,12470,228015,836,379,457
40045,248164,20118,119433,12470,228046,836,379,457
40050,248195,20118,119447,12470,228077,836,379,457
40055,248226,20118,119463,12470,228108,836,379,457
40060,248257,20118,119473,12470,228139,836,379,457
40065,248288,20118,119487,12470,228170,836,379,457
40070,248319,20120,119501,12472,228199,836,379,457
40075,248350,20122,119513,12473,228228,836,379,457
40080,248381,20126,119523,12476,228254,836,379,457
40085,248412,20132,119536,12480,228279,836,379,457
40090,248443,20138,119547,12484,228304,836,379,457
40095,248474,20145,119565,12488,228329,836,379,457
40100,248505,20150,119584,12491,228355,836,379,457
40105,248536,20155,119594,12493,228381,836,379,457
40110,248567,20159,119608,12495,228408,836,379,457
40115,248598,20162,119626,12497,228436,836,379,457
40120,248629,20166,119643,12499,228463,836,379,457
40125,248660,20170,119653,12501,228490,836,379,457
40130,248691,20173,119669,12503,228518,836,379,457
40135,248722,20177,119684,12506,228545,836,379,457
40140,248753,20181,119703,12510,228572,836,379,457
40145,248784,20184,119717,12512,228600,836,379,457
40150,248815,20187,119732,12513,228628,836,379,457
40155,248846,20190,119746,12514,228656,836,379,457
40160,248877,20193,119757,12514,228684,836,379,457
40165,248908,20196,119769,12515,228712,836,379,457
40170,248939,20199,119784,12518,228740,836,379,457
40175,248970,20202,119798,12519,228768,836,379,457
40180,249001,20205,119812,12521,228796,836,379,457
40185,249032,20208,119827,12522,228823,836,379,457
40190,249063,20213,119841,12524,228850,836,379,457
40195,249094,20217,119853,12526,228877,836,379,457
40200,249125,20222,119868,12529,228902,836,379,457
40205,249156,20225,119880,12530,228931,836,379,457
40210,249187,20227,119896,12531,228960,836,379,457
40215,249218,20229,119906,12532,228989,836,379,457
40220,249249,20231,119923,12534,229018,836,379,457
40225,249280,20232,119936,12535,229048,836,379,457
40230,249311,20233,119951,12535,229078,836,379,457
40235,249342,20235,119971,12537,229107,836,379,457
40240,249373,20236,119980,12537,229137,836,379,457
40245,249404,20238,119998,12538,229166,836,379,457
40250,249435,20239,120010,12538,229196,836,379,457
40255,249466,20240,120020,12538,229226,836,379,457
40260,249497,20241,120036,12539,229256,836,379,457
40265,249528,20247,120050,12543,229281,836,379,457
40270,249559,20252,120065,12547,229307,836,379,457
40275,249590,20258,120083,12549,229332,836,379,457
40280,249621,20263,120097,12552,229358,836,379,457
40285,249652,20268,120111,12556,229384,836,379,457
40290,249683,20272,120126,12558,229411,836,379,457
40295,249714,20275,120143,12560,229439,836,379,457
40300,249745,20277,120157,12562,229468,836,379,457
40305,249776,20280,120169,12564,229496,836,379,457
40310,249807,20282,120183,12566,229524,836,379,457
40315,249838,20285,120198,12569,229552,836,379,457
40320,249869,20287,120206,12570,229582,836,379,457
40325,249900,20288,120224,12571,229611,836,379,457
40330,249931,20290,120243,12573,229640,836,379,457
40335,249962,20292,120256,12574,229670,836,379,457
40340,249993,20292,120269,12574,229701,836,379,457
40345,250024,20292,120287,12574,229732,836,379,457
40350,250055,20292,120301,12574,229763,836,379,457
40355,250086,20292,120321,12574,229794,836,379,457
40360,250117,20292,120336,12574,229825,836,379,457
40365,250148,20292,120352,12574,229856,836,379,457
40370,250179,20292,120367,12574,229887,836,379,457
40375,250210,20292,120380,12574,229918,836,379,457
40380,250241,20292,120391,12574,229949,836,379,457
40385,250272,20298,120405,12578,229974,836,379,457
40390,250303,20300,120420,12578,230003,836,379,457
40395,250334,20302,120436,12579,230031,836,379,457
40400,250365,20307,120454,12582,230058,836,379,457
40405,250396,20310,120470,12584,230086,836,379,457
40410,250427,20313,120483,12585,230114,836,379,457
40415,250458,20315,120495,12585,230143,836,379,457
40420,250489,20317,120513,12586,230172,836,379,457
40425,250520,20321,120532,12589,230199,836,379,457
40430,250551,20325,120549,12592,230226,836,379,457
40435,250582,20329,120560,12594,230253,836,379,457
40440,250613,20334,120575,12598,230279,836,379,457
40445,250644,20339,120592,12601,230305,836,379,457
40450,250675,20345,120608,12606,230330,836,379,457
40455,250706,20350,120621,12610,230356,836,379,457
40460,250737,20354,120630,12611,230383,836,379,457
40465,250768,20357,120649,12613,230411,836,379,457
40470,250799,20360,120662,12614,230439,836,379,457
40475,250830,20364,120675,12615,230466,836,379,457
40480,250861,20366,120689,12616,230495,836,379,457
40485,250892,20368,120702,12617,230524,836,379,457
40490,250923,20371,120718,12620,230552,836,379,457
40495,250954,20374,120737,12622,230579,836,379,457
40500,250985,20377,120750,12623,230608,836,379,457
40505,251016,20379,120763,12624,230637,836,379,457
40510,251047,20380,120775,12624,230666,836,379,457
40515,251078,20382,120786,12626,230696,836,379,457
40520,251109,20383,120804,12626,230726,836,379,457
40525,251140,20384,120823,12626,230756,836,379,457
40530,251171,20385,120839,12627,230786,836,379,457
40535,251202,20386,120848,12627,230816,836,379,457
40540,251233,20387,120864,12627,230846,836,379,457
40545,251264,20388,120880,12628,230876,836,379,457
40550,251295,20389,120892,12628,230906,836,379,457
40555,251326,20390,120910,12629,230936,836,379,457
40560,251357,20391,120928,12630,230966,836,379,457
40565,251388,20392,120945,12630,230996,836,379,457
40570,251419,20394,120961,12632,231025,836,379,457
40575,251450,20396,120980,12634,231054,836,379,457
40580,251481,20400,120994,12637,231081,836,379,457
40585,251512,20404,121008,12639,231108,836,379,457
40590,251543,20406,121018,12640,231137,836,379,457
40595,251574,20409,121032,12642,231165,836,379,457
40600,251605,20413,121048,12645,231192,836,379,457
40605,251636,20416,121058,12648,231220,836,379,457
40610,251667,20419,121068,12648,231248,836,379,457
40615,251698,20423,121081,12650,231275,836,379,457
40620,251729,20426,121098,12652,231303,836,379,457
40625,251760,20431,121117,12657,231329,836,379,457
40630,251791,20435,121129,12659,231355,836,379,457
40635,251822,20441,121146,12663,231380,836,379,457
40640,251853,20445,121158,12665,231408,836,379,457
40645,251884,20449,121175,12668,231435,836,379,457
40650,251915,20453,121189,12672,231462,836,379,457
40655,251946,20457,121206,12674,231488,836,379,457
40660,251977,20462,121225,12679,231515,836,379,457
40665,252008,20464,121244,12680,231544,836,379,457
40670,252039,20467,121257,12683,231572,836,379,457
40675,252070,20470,121272,12684,231600,836,379,457
40680,252101,20472,121282,12685,231629,836,379,457
40685,252132,20475,121298,12688,231656,836,379,457
40690,252163,20478,121317,12691,231685,836,379,457
40695,252194,20479,121334,12691,231714,836,379,457
40700,252225,20481,121352,12692,231743,836,379,457
40705,252256,20483,121366,12694,231773,836,379,457
40710,252287,20484,121381,12695,231802,836,379,457
40715,252318,20486,121391,12697,231832,836,379,457
40720,252349,20488,121404,12698,231861,836,379,457
40725,252380,20489,121416,12698,231891,836,379,457
40730,252411,20490,121430,12698,231921,836,379,457
40735,252442,20491,121441,12699,231950,836,379,457
40740,252473,20493,121458,12701,231979,836,379,457
40745,252504,20495,121469,12702,232009,836,379,457
40750,252535,20496,121484,12702,232039,836,379,457
40755,252566,20497,121501,12703,232069,836,379,457
40760,252597,20498,121517,12704,232099,836,379,457
40765,252628,20499,121534,12705,232129,836,379,457
40770,252659,20500,121552,12705,232159,836,379,457
40775,252690,20501,121566,12706,232189,836,379,457
40780,252721,20502,121580,12707,232219,836,379,457
40785,252752,20504,121597,12708,232247,836,379,457
40790,252783,20508,121607,12711,232275,836,379,457
40795,252814,20512,121621,12714,232301,836,379,457
40800,252845,20516,121640,12716,232328,836,379,457
40805,252876,20521,121659,12720,232354,836,379,457
40810,252907,20528,121676,12725,232378,836,379,457
40815,252938,20532,121691,12727,232406,836,379,457
40820,252969,20537,121710,12729,232432,836,379,457
40825,253000,20539,121727,12731,232461,836,379,457
40830,253031,20541,121742,12733,232490,836,379,457
40835,253062,20543,121753,12734,232519,836,379,457
40840,253093,20546,121766,12736,232547,836,379,457
40845,253124,20550,121782,12738,232574,836,379,457
40850,253155,20551,121792,12738,232604,836,379,457
40855,253186,20553,121802,12739,232633,836,379,457
40860,253217,20554,121817,12740,232663,836,379,457
40865,253248,20556,121829,12740,232692,836,379,457
40870,253279,20559,121846,12742,232719,836,379,457
40875,253310,20563,121862,12744,232747,836,379,457
40880,253341,20566,121881,12745,232775,836,379,457
40885,253372,20568,121892,12747,232804,836,379,457
40890,253403,20570,121902,12748,232833,836,379,457
40895,253434,20572,121917,12750,232862,836,379,457
40900,253465,20574,121929,12751,232891,836,379,457
40905,253496,20575,121941,12751,232921,836,379,457
40910,253527,20578,121957,12753,232948,836,379,457
40915,253558,20582,121971,12756,232975,836,379,457
40920,253589,20586,121990,12760,233002,836,379,457
40925,253620,20589,122004,12763,233031,836,379,457
40930,253651,20591,122022,12764,233060,836,379,457
40935,253682,20593,122033,12764,233089,836,379,457
40940,253713,20595,122049,12765,233118,836,379,457
40945,253744,20597,122063,12766,233147,836,379,457
40950,253775,20599,122078,12766,233176,836,379,457
40955,253806,20601,122096,12767,233205,836,379,457
40960,253837,20603,122110,12769,233234,836,379,457
40965,253868,20605,122127,12770,233263,836,379,457
40970,253899,20607,122142,12771,233292,836,379,457
40975,253930,20609,122157,12772,233321,836,379,457
40980,253961,20611,122168,12774,233350,836,379,457
40985,253992,20617,122180,12779,233375,836,379,457
40990,254023,20621,122196,12782,233401,836,379,457
40995,254054,20626,122212,12785,233427,836,379,457
41000,254085,20632,122229,12791,233453,836,379,457
41005,254116,20635,122246,12794,233481,836,379,457
41010,254147,20638,122265,12796,233509,836,379,457
41015,254178,20640,122280,12797,233538,836,379,457
41020,254209,20641,122291,12798,233568,836,379,457
41025,254240,20644,122306,12800,233595,836,379,457
41030,254271,20647,122314,12802,233624,836,379,457
41035,254302,20648,122325,12802,233654,836,379,457
41040,254333,20649,122337,12802,233684,836,379,457
41045,254364,20650,122352,12803,233714,836,379,457
41050,254395,20651,122367,12803,233744,836,379,457
41055,254426,20652,122378,12803,233774,836,379,457
41060,254457,20653,122392,12804,233804,836,379,457
41065,254488,20654,122410,12804,233834,836,379,457
41070,254519,20655,122426,12804,233864,836,379,457
41075,254550,20656,122443,12805,233894,836,379,457
41080,254581,20657,122462,12806,233924,836,379,457
41085,254612,20658,122474,12807,233954,836,379,457
41090,254643,20659,122487,12808,233984,836,379,457
41095,254674,20660,122502,12808,234014,836,379,457
41100,254705,20661,122512,12809,234044,836,379,457
41105,254736,20663,122529,12810,234073,836,379,457
41110,254767,20666,122545,12813,234101,836,379,457
41115,254798,20669,122556,12815,234129,836,379,457
41120,254829,20671,122570,12816,234157,836,379,457
41125,254860,20675,122582,12819,234185,836,379,457
41130,254891,20678,122598,12819,234212,836,379,457
41135,254922,20685,122618,12825,234237,836,379,457
41140,254953,20690,122631,12829,234263,836,379,457
41145,254984,20694,122646,12829,234289,836,379,457
41150,255015,20702,122661,12835,234312,836,379,457
41155,255046,20708,122676,12839,234337,836,379,457
41160,255077,20715,122692,12844,234360,836,379,457
41165,255108,20721,122707,12849,234387,836,379,457
41170,255139,20724,122721,12851,234415,836,379,457
41175,255170,20727,122739,12853,234443,836,379,457
41180,255201,20730,122752,12855,234471,836,379,457
41185,255232,20733,122764,12855,234499,836,379,457
41190,255263,20736,122775,12856,234527,836,379,457
41195,255294,20740,122793,12858,234554,836,379,457
41200,255325,20744,122807,12859,234581,836,379,457
41205,255356,20748,122824,12861,234608,836,379,457
41210,255387,20751,122835,12862,234636,836,379,457
41215,255418,20755,122849,12865,234663,836,379,457
41220,255449,20759,122865,12868,234690,836,379,457
41225,255480,20763,122874,12870,234717,836,379,457
41230,255511,20766,122889,12870,234745,836,379,457
41235,255542,20769,122905,12871,234773,836,379,457
41240,255573,20772,122918,12873,234801,836,379,457
41245,255604,20776,122935,12876,234828,836,379,457
41250,255635,20780,122951,12878,234855,836,379,457
41255,255666,20784,122967,12880,234882,836,379,457
41260,255697,20788,122984,12883,234909,836,379,457
41265,255728,20791,122996,12884,234937,836,379,457
41270,255759,20793,123009,12885,234966,836,379,457
41275,255790,20796,123022,12886,234994,836,379,457
41280,255821,20801,123039,12891,235020,836,379,457
41285,255852,20803,123054,12893,235049,836,379,457
41290,255883,20804,123068,12893,235079,836,379,457
41295,255914,20804,123084,12893,235110,836,379,457
41300,255945,20804,123102,12893,235141,836,379,457
41305,255976,20804,123122,12893,235172,836,379,457
41310,256007,20804,123137,12893,235203,836,379,457
41315,256038,20804,123150,12893,235234,836,379,457
41320,256069,20804,123163,12893,235265,836,379,457
41325,256100,20804,123174,12893,235296,836,379,457
41330,256131,20806,123194,12894,235325,836,379,457
41335,256162,20807,123212,12894,235355,836,379,457
41340,256193,20808,123224,12894,235385,836,379,457
41345,256224,20809,123234,12894,235415,836,379,457
41350,256255,20810,123251,12894,235445,836,379,457
41355,256286,20812,123271,12896,235474,836,379,457
41360,256317,20814,123287,12897,235503,836,379,457
41365,256348,20816,123299,12897,235532,836,379,457
41370,256379,20819,123312,12900,235560,836,379,457
41375,256410,20822,123332,12902,235588,836,379,457
41380,256441,20825,123348,12904,235616,836,379,457
41385,256472,20828,123366,12907,235644,836,379,457
41390,256503,20833,123383,12911,235670,836,379,457
41395,256534,20839,123398,12915,235695,836,379,457
41400,256565,20845,123414,12919,235719,836,379,457
41405,256596,20849,123427,12923,235746,836,379,457
41410,256627,20852,123440,12924,235775,836,379,457
41415,256658,20854,123449,12925,235804,836,379,457
41420,256689,20856,123467,12927,235832,836,379,457
41425,256720,20859,123482,12929,235861,836,379,457
41430,256751,20861,123496,12929,235890,836,379,457
41435,256782,20863,123511,12930,235919,836,379,457
41440,256813,20865,123529,12931,235948,836,379,457
41445,256844,20867,123541,12932,235977,836,379,457
41450,256875,20869,123553,12932,236006,836,379,457
41455,256906,20870,123562,12933,236036,836,379,457
41460,256937,20871,123579,12934,236066,836,379,457
41465,256968,20872,123593,12934,236096,836,379,457
41470,256999,20873,123607,12934,236126,836,379,457
41475,257030,20874,123621,12935,236156,836,379,457
41480,257061,20875,123636,12936,236186,836,379,457
41485,257092,20876,123654,12937,236216,836,379,457
41490,257123,20877,123667,12938,236246,836,379,457
41495,257154,20878,123680,12939,236276,836,379,457
41500,257185,20879,123693,12940,236306,836,379,457
41505,257216,20880,123711,12941,236336,836,379,457
41510,257247,20882,123724,12942,236365,836,379,457
41515,257278,20889,123741,12946,236389,836,379,457
41520,257309,20894,123755,12950,236415,836,379,457
41525,257340,20898,123766,12951,236442,836,379,457
41530,257371,20903,123778,12953,236468,836,379,457
41535,257402,20907,123789,12954,236495,836,379,457
41540,257433,20911,123810,12957,236522,836,379,457
41545,257464,20915,123824,12958,236549,836,379,457
41550,257495,20920,123840,12962,236575,836,379,457
41555,257526,20924,123857,12964,236602,836,379,457
41560,257557,20929,123873,12965,236628,836,379,457
41565,257588,20934,123889,12969,236654,836,379,457
41570,257619,20940,123905,12974,236679,836,379,457
41575,257650,20944,123917,12976,236706,836,379,457
41580,257681,20949,123934,12979,236732,836,379,457
41585,257712,20952,123951,12981,236760,836,379,457
41590,257743,20955,123966,12981,236788,836,379,457
41595,257774,20958,123985,12983,236816,836,379,457
41600,257805,20961,123997,12984,236844,836,379,457
41605,257836,20964,124014,12986,236872,836,379,457
41610,257867,20967,124022,12988,236900,836,379,457
41615,257898,20970,124037,12988,236928,836,379,457
41620,257929,20973,124048,12988,236956,836,379,457
41625,257960,20976,124057,12989,236984,836,379,457
41630,257991,20979,124068,12991,237012,836,379,457
41635,258022,20981,124087,12993,237041,836,379,457
41640,258053,20982,124103,12994,237071,836,379,457
41645,258084,20982,124117,12994,237102,836,379,457
41650,258115,20982,124128,12994,237133,836,379,457
41655,258146,20982,124146,12994,237164,836,379,457
41660,258177,20982,124162,12994,237195,836,379,457
41665,258208,20982,124180,12994,237226,836,379,457
41670,258239,20982,124197,12994,237257,836,379,457
41675,258270,20982,124209,12994,237288,836,379,457
41680,258301,20982,124222,12994,237319,836,379,457
41685,258332,20982,124234,12994,237350,836,379,457
41690,258363,20983,124245,12995,237380,836,379,457
41695,258394,20984,124263,12996,237410,836,379,457
41700,258425,20985,124275,12997,237440,836,379,457
41705,258456,20986,124294,12998,237470,836,379,457
41710,258487,20987,124306,12998,237500,836,379,457
41715,258518,20988,124323,12999,237530,836,379,457
41720,258549,20989,124341,13000,237560,836,379,457
41725,258580,20990,124362,13000,237590,836,379,457
41730,258611,20991,124377,13001,237620,836,379,457
41735,258642,20992,124391,13002,237650,836,379,457
41740,258673,20995,124404,13003,237678,836,379,457
41745,258704,21000,124418,13004,237703,836,379,457
41750,258735,21005,124434,13009,237729,836,379,457
41755,258766,21012,124450,13014,237753,836,379,457
41760,258797,21018,124466,13019,237778,836,379,457
41765,258828,21022,124478,13021,237806,836,379,457
41770,258859,21026,124490,13024,237833,836,379,457
41775,258890,21031,124513,13028,237859,836,379,457
41780,258921,21034,124530,13030,237887,836,379,457
41785,258952,21038,124544,13033,237914,836,379,457
41790,258983,21043,124559,13037,237940,836,379,457
41795,259014,21049,124579,13041,237965,836,379,457
41800,259045,21052,124589,13041,237993,836,379,457
41805,259076,21056,124602,13044,238020,836,379,457
41810,259107,21059,124622,13046,238048,836,379,457
41815,259138,21061,124637,13047,238077,836,379,457
41820,259169,21064,124651,13050,238105,836,379,457
41825,259200,21066,124664,13051,238134,836,379,457
41830,259231,21069,124679,13052,238162,836,379,457
41835,259262,21071,124695,13052,238191,836,379,457
41840,259293,21074,124713,13053,238219,836,379,457
41845,259324,21076,124729,13053,238248,836,379,457
41850,259355,21079,124745,13054,238276,836,379,457
41855,259386,21081,124756,13055,238305,836,379,457
41860,259417,21083,124774,13057,238334,836,379,457
41865,259448,21087,124790,13060,238360,836,379,457
41870,259479,21091,124805,13062,238387,836,379,457
41875,259510,21095,124822,13065,238414,836,379,457
41880,259541,21097,124839,13067,238444,836,379,457
41885,259572,21099,124851,13068,238473,836,379,457
41890,259603,21100,124869,13069,238503,836,379,457
41895,259634,21101,124886,13070,238533,836,379,457
41900,259665,21103,124905,13072,238562,836,379,457
41905,259696,21105,124921,13073,238591,836,379,457
41910,259727,21106,124934,13073,238621,836,379,457
41915,259758,21107,124949,13073,238651,836,379,457
41920,259789,21109,124964,13074,238680,836,379,457
41925,259820,21111,124977,13075,238709,836,379,457
41930,259851,21113,124989,13077,238738,836,379,457
41935,259882,21115,125008,13078,238767,836,379,457
41940,259913,21117,125022,13078,238796,836,379,457
41945,259944,21119,125033,13078,238825,836,379,457
41950,259975,21121,125047,13079,238854,836,379,457
41955,260006,21123,125065,13081,238883,836,379,457
41960,260037,21125,125080,13082,238912,836,379,457
41965,260068,21127,125097,13083,238941,836,379,457
41970,260099,21129,125111,13084,238970,836,379,457
41975,260130,21131,125129,13086,238999,836,379,457
41980,260161,21135,125146,13088,239026,836,379,457
41985,260192,21140,125162,13093,239051,836,379,457
41990,260223,21146,125177,13098,239077,836,379,457
41995,260254,21151,125194,13100,239101,836,379,457
42000,260285,21157,125210,13103,239128,836,379,457
42005,260316,21160,125223,13103,239155,836,379,457
42010,260347,21164,125240,13105,239183,836,379,457
42015,260378,21167,125260,13107,239210,836,379,457
42020,260409,21171,125278,13109,239237,836,379,457
42025,260440,21175,125296,13112,239264,836,379,457
42030,260471,21180,125311,13114,239291,836,379,457
42035,260502,21183,125325,13115,239319,836,379,457
42040,260533,21187,125342,13118,239345,836,379,457
42045,260564,21191,125357,13121,239373,836,379,457
42050,260595,21193,125369,13122,239402,836,379,457
42055,260626,21196,125386,13125,239430,836,379,457
42060,260657,21199,125399,13127,239458,836,379,457
42065,260688,21204,125415,13130,239484,836,379,457
42070,260719,21207,125433,13131,239511,836,379,457
42075,260750,21212,125450,13136,239537,836,379,457
42080,260781,21216,125467,13138,239564,836,379,457
42085,260812,21220,125482,13142,239592,836,379,457
42090,260843,21223,125501,13144,239619,836,379,457
42095,260874,21225,125517,13145,239649,836,379,457
42100,260905,21226,125529,13146,239679,836,379,457
42105,260936,21227,125544,13147,239709,836,379,457
42110,260967,21228,125561,13147,239739,836,379,457
42115,260998,21229,125574,13147,239769,836,379,457
42120,261029,21230,125589,13148,239799,836,379,457
42125,261060,21232,125606,13150,239828,836,379,457
42130,261091,21233,125622,13151,239858,836,379,457
42135,261122,21234,125637,13151,239888,836,379,457
42140,261153,21235,125653,13152,239918,836,379,457
42145,261184,21236,125671,13153,239948,836,379,457
42150,261215,21237,125689,13154,239978,836,379,457
42155,261246,21238,125703,13155,240008,836,379,457
42160,261277,21239,125715,13155,240038,836,379,457
42165,261308,21240,125731,13155,240068,836,379,457
42170,261339,21241,125743,13156,240098,836,379,457
42175,261370,21242,125755,13157,240128,836,379,457
42180,261401,21243,125774,13157,240158,836,379,457
42185,261432,21245,125787,13158,240186,836,379,457
42190,261463,21248,125802,13161,240215,836,379,457
42195,261494,21249,125817,13162,240245,836,379,457
42200,261525,21251,125834,13163,240274,836,379,457
42205,261556,21253,125849,13165,240303,836,379,457
42210,261587,21255,125864,13167,240332,836,379,457
42215,261618,21257,125879,13168,240361,836,379,457
42220,261649,21259,125895,13170,240390,836,379,457
42225,261680,21262,125911,13173,240418,836,379,457
42230,261711,21265,125928,13175,240445,836,379,457
42235,261742,21269,125941,13177,240473,836,379,457
42240,261773,21272,125956,13180,240500,836,379,457
42245,261804,21276,125978,13182,240527,836,379,457
42250,261835,21280,125999,13184,240555,836,379,457
42255,261866,21284,126018,13187,240582,836,379,457
42260,261897,21287,126034,13189,240610,836,379,457
42265,261928,21290,126052,13190,240638,836,379,457
42270,261959,21294,126069,13194,240665,836,379,457
42275,261990,21297,126087,13196,240693,836,379,457
42280,262021,21300,126102,13198,240721,836,379,457
42285,262052,21304,126118,13200,240748,836,379,457
42290,262083,21308,126133,13202,240775,836,379,457
42295,262114,21311,126151,13202,240803,836,379,457
42300,262145,21317,126165,13207,240828,836,379,457
42305,262176,21321,126177,13208,240854,836,379,457
42310,262207,21326,126189,13211,240881,836,379,457
42315,262238,21329,126205,13213,240909,836,379,457
42320,262269,21331,126222,13215,240938,836,379,457
42325,262300,21334,126239,13217,240966,836,379,457
42330,262331,21338,126251,13220,240993,836,379,457
42335,262362,21342,126273,13224,241020,836,379,457
42340,262393,21343,126287,13224,241050,836,379,457
42345,262424,21345,126300,13225,241079,836,379,457
42350,262455,21347,126313,13227,241107,836,379,457
42355,262486,21350,126331,13230,241135,836,379,457
42360,262517,21352,126348,13232,241165,836,379,457
42365,262548,21352,126361,13232,241196,836,379,457
42370,262579,21352,126378,13232,241227,836,379,457
42375,262610,21352,126397,13232,241258,836,379,457
42380,262641,21352,126414,13232,241289,836,379,457
42385,262672,21352,126435,13232,241320,836,379,457
42390,262703,21352,126450,13232,241351,836,379,457
42395,262734,21352,126465,13232,241382,836,379,457
42400,262765,21352,126484,13232,241413,836,379,457
42405,262796,21353,126499,13233,241443,836,379,457
42410,262827,21354,126515,13234,241473,836,379,457
42415,262858,21355,126531,13234,241503,836,379,457
42420,262889,21357,126546,13235,241532,836,379,457
42425,262920,21360,126555,13238,241560,836,379,457
42430,262951,21362,126575,13239,241589,836,379,457
42435,262982,21365,126589,13241,241617,836,379,457
42440,263013,21368,126603,13244,241645,836,379,457
42445,263044,21372,126621,13246,241672,836,379,457
42450,263075,21375,126635,13246,241699,836,379,457
42455,263106,21380,126654,13251,241726,836,379,457
42460,263137,21384,126674,13255,241753,836,379,457
42465,263168,21389,126689,13260,241779,836,379,457
42470,263199,21393,126704,13262,241805,836,379,457
42475,263230,21398,126719,13266,241832,836,379,457
42480,263261,21403,126731,13269,241858,836,379,457
42485,263292,21408,126747,13272,241884,836,379,457
42490,263323,21412,126764,13273,241911,836,379,457
42495,263354,21417,126783,13276,241937,836,379,457
42500,263385,21422,126796,13279,241963,836,379,457
42505,263416,21426,126812,13282,241990,836,379,457
42510,263447,21430,126830,13284,242017,836,379,457
42515,263478,21434,126846,13287,242044,836,379,457
42520,263509,21439,126865,13290,242070,836,379,457
42525,263540,21444,126887,13292,242096,836,379,457
42530,263571,21449,126903,13294,242122,836,379,457
42535,263602,21454,126914,13295,242148,836,379,457
42540,263633,21459,126929,13298,242174,836,379,457
42545,263664,21462,126942,13300,242201,836,379,457
42550,263695,21467,126957,13304,242227,836,379,457
42555,263726,21473,126971,13309,242253,836,379,457
42560,263757,21477,126984,13312,242280,836,379,457
42565,263788,21479,126998,13313,242309,836,379,457
42570,263819,21481,127005,13313,242338,836,379,457
42575,263850,21484,127020,13314,242366,836,379,457
42580,263881,21486,127033,13315,242395,836,379,457
42585,263912,21487,127046,13316,242425,836,379,457
42590,263943,21489,127053,13317,242454,836,379,457
42595,263974,21491,127066,13318,242483,836,379,457
42600,264005,21493,127083,13320,242512,836,379,457
42605,264036,21496,127096,13321,242540,836,379,457
42610,264067,21499,127109,13321,242568,836,379,457
42615,264098,21502,127127,13322,242596,836,379,457
42620,264129,21505,127144,13323,242624,836,379,457
42625,264160,21508,127157,13325,242652,836,379,457
42630,264191,21511,127179,13326,242680,836,379,457
42635,264222,21514,127193,13327,242708,836,379,457
42640,264253,21517,127209,13329,242736,836,379,457
42645,264284,21520,127227,13332,242764,836,379,457
42650,264315,21524,127248,13334,242791,836,379,457
42655,264346,21527,127261,13335,242819,836,379,457
42660,264377,21530,127277,13336,242846,836,379,457
42665,264408,21533,127289,13338,242875,836,379,457
42670,264439,21534,127306,13339,242905,836,379,457
42675,264470,21535,127315,13339,242935,836,379,457
42680,264501,21536,127332,13340,242965,836,379,457
42685,264532,21538,127346,13342,242994,836,379,457
42690,264563,21540,127360,13344,243023,836,379,457
42695,264594,21542,127377,13346,243052,836,379,457
42700,264625,21544,127392,13347,243081,836,379,457
42705,264656,21544,127411,13347,243112,836,379,457
42710,264687,21544,127426,13347,243143,836,379,457
42715,264718,21544,127440,13347,243174,836,379,457
42720,264749,21544,127457,13347,243205,836,379,457
42725,264780,21544,127471,13347,243236,836,379,457
42730,264811,21544,127488,13347,243267,836,379,457
42735,264842,21544,127500,13347,243298,836,379,457
42740,264873,21544,127514,13347,243329,836,379,457
42745,264904,21544,127529,13347,243360,836,379,457
42750,264935,21544,127544,13347,243391,836,379,457
42755,264966,21544,127554,13347,243422,836,379,457
42760,264997,21544,127568,13347,243453,836,379,457
42765,265028,21547,127577,13350,243481,836,379,457
42770,265059,21550,127588,13351,243509,836,379,457
42775,265090,21554,127601,13353,243536,836,379,457
42780,265121,21559,127617,13357,243562,836,379,457
42785,265152,21563,127639,13360,243589,836,379,457
42790,265183,21566,127656,13363,243617,836,379,457
42795,265214,21568,127669,13365,243646,836,379,457
42800,265245,21570,127685,13367,243675,836,379,457
42805,265276,21572,127695,13368,243704,836,379,457
42810,265307,21575,127712,13370,243732,836,379,457
42815,265338,21578,127725,13371,243760,836,379,457
42820,265369,21582,127742,13375,243787,836,379,457
42825,265400,21586,127755,13378,243814,836,379,457
42830,265431,21589,127766,13378,243842,836,379,457
42835,265462,21592,127782,13380,243870,836,379,457
42840,265493,21595,127797,13382,243898,836,379,457
42845,265524,21598,127810,13383,243925,836,379,457
42850,265555,21602,127824,13385,243953,836,379,457
42855,265586,21605,127838,13387,243980,836,379,457
42860,265617,21609,127851,13389,244008,836,379,457
42865,265648,21612,127868,13391,244036,836,379,457
42870,265679,21615,127888,13393,244063,836,379,457
42875,265710,21619,127901,13395,244091,836,379,457
42880,265741,21622,127913,13396,244118,836,379,457
42885,265772,21626,127935,13400,244145,836,379,457
42890,265803,21631,127949,13402,244171,836,379,457
42895,265834,21636,127966,13405,244197,836,379,457
42900,265865,21643,127981,13411,244222,836,379,457
42905,265896,21647,128001,13415,244249,836,379,457
42910,265927,21651,128016,13419,244276,836,379,457
42915,265958,21653,128030,13419,244305,836,379,457
42920,265989,21655,128049,13420,244334,836,379,457
42925,266020,21659,128067,13424,244361,836,379,457
42930,266051,21662,128084,13426,244389,836,379,457
42935,266082,21664,128103,13427,244418,836,379,457
42940,266113,21668,128114,13429,244445,836,379,457
42945,266144,21671,128129,13430,244473,836,379,457
42950,266175,21674,128144,13432,244501,836,379,457
42955,266206,21676,128156,13433,244530,836,379,457
42960,266237,21676,128170,13433,244561,836,379,457
42965,266268,21676,128188,13433,244592,836,379,457
42970,266299,21676,128196,13433,244623,836,379,457
42975,266330,21676,128209,13433,244654,836,379,457
42980,266361,21676,128224,13433,244685,836,379,457
42985,266392,21676,128247,13433,244716,836,379,457
42990,266423,21676,128266,13433,244747,836,379,457
42995,266454,21676,128281,13433,244778,836,379,457
43000,266485,21676,128298,13433,244809,836,379,457
43005,266516,21676,128315,13433,244840,836,379,457
43010,266547,21676,128330,13433,244871,836,379,457
43015,266578,21678,128338,13435,244900,836,379,457
43020,266609,21680,128354,13436,244928,836,379,457
43025,266640,21686,128370,13440,244954,836,379,457
43030,266671,21691,128386,13443,244980,836,379,457
43035,266702,21695,128403,13445,245007,836,379,457
43040,266733,21698,128415,13446,245035,836,379,457
43045,266764,21701,128431,13447,245062,836,379,457
43050,266795,21705,128450,13450,245089,836,379,457
43055,266826,21709,128464,13453,245116,836,379,457
43060,266857,21714,128479,13457,245143,836,379,457
43065,266888,21717,128495,13459,245171,836,379,457
43070,266919,21721,128508,13462,245198,836,379,457
43075,266950,21725,128524,13463,245224,836,379,457
43080,266981,21729,128541,13466,245251,836,379,457
43085,267012,21732,128556,13467,245280,836,379,457
43090,267043,21735,128574,13469,245308,836,379,457
43095,267074,21737,128590,13470,245337,836,379,457
43100,267105,21739,128611,13472,245366,836,379,457
43105,267136,21742,128625,13474,245394,836,379,457
43110,267167,21743,128640,13474,245424,836,379,457
43115,267198,21744,128655,13474,245454,836,379,457
43120,267229,21745,128669,13474,245484,836,379,457
43125,267260,21746,128685,13475,245513,836,379,457
43130,267291,21749,128698,13477,245542,836,379,457
43135,267322,21752,128710,13479,245570,836,379,457
43140,267353,21754,128726,13481,245599,836,379,457
43145,267384,21757,128738,13483,245627,836,379,457
43150,267415,21761,128753,13486,245653,836,379,457
43155,267446,21764,128767,13488,245682,836,379,457
43160,267477,21766,128782,13490,245711,836,379,457
43165,267508,21769,128795,13493,245739,836,379,457
43170,267539,21771,128808,13494,245768,836,379,457
43175,267570,21773,128818,13494,245797,836,379,457
43180,267601,21775,128832,13495,245826,836,379,457
43185,267632,21777,128847,13497,245855,836,379,457
43190,267663,21780,128861,13498,245883,836,379,457
43195,267694,21782,128879,13500,245911,836,379,457
43200,267725,21786,128896,13503,245938,836,379,457
43205,267756,21789,128915,13506,245967,836,379,457
43210,267787,21791,128934,13508,245996,836,379,457
43215,267818,21791,128948,13508,246027,836,379,457
43220,267849,21791,128968,13508,246058,836,379,457
43225,267880,21791,128983,13508,246089,836,379,457
43230,267911,21791,128995,13508,246120,836,379,457
43235,267942,21791,129010,13508,246151,836,379,457
43240,267973,21791,129025,13508,246182,836,379,457
43245,268004,21793,129039,13510,246211,836,379,457
43250,268035,21795,129057,13512,246240,836,379,457
43255,268066,21796,129070,13513,246270,836,379,457
43260,268097,21799,129084,13514,246298,836,379,457
43265,268128,21802,129101,13515,246324,836,379,457
43270,268159,21808,129121,13521,246349,836,379,457
43275,268190,21816,129134,13528,246374,836,379,457
43280,268221,21819,129148,13531,246402,836,379,457
43285,268252,21823,129165,13534,246428,836,379,457
43290,268283,21827,129182,13538,246455,836,379,457
43295,268314,21829,129199,13539,246485,836,379,457
43300,268345,21830,129212,13539,246515,836,379,457
43305,268376,21831,129227,13539,246545,836,379,457
43310,268407,21831,129241,13539,246576,836,379,457
43315,268438,21831,129255,13539,246607,836,379,457
43320,268469,21832,129266,13539,246637,836,379,457
43325,268500,21834,129283,13541,246666,836,379,457
43330,268531,21835,129295,13542,246696,836,379,457
43335,268562,21836,129307,13543,246726,836,379,457
43340,268593,21837,129323,13544,246756,836,379,457
43345,268624,21839,129342,13545,246785,836,379,457
43350,268655,21840,129359,13545,246815,836,379,457
43355,268686,21842,129372,13546,246844,836,379,457
43360,268717,21844,129390,13548,246873,836,379,457
43365,268748,21845,129408,13549,246903,836,379,457
43370,268779,21847,129425,13551,246932,836,379,457
43375,268810,21849,129437,13553,246961,836,379,457
43380,268841,21851,129449,13554,246990,836,379,457
43385,268872,21853,129467,13556,247019,836,379,457
43390,268903,21856,129483,13557,247047,836,379,457
43395,268934,21859,129499,13558,247074,836,379,457
43400,268965,21865,129515,13562,247100,836,379,457
43405,268996,21869,129533,13566,247127,836,379,457
43410,269027,21871,129551,13567,247156,836,379,457
43415,269058,21873,129562,13568,247185,836,379,457
43420,269089,21875,129578,13569,247214,836,379,457
43425,269120,21880,129595,13572,247240,836,379,457
43430,269151,21883,129612,13573,247268,836,379,457
43435,269182,21886,129624,13575,247296,836,379,457
43440,269213,21891,129638,13578,247322,836,379,457
43445,269244,21893,129650,13578,247351,836,379,457
43450,269275,21896,129662,13579,247379,836,379,457
43455,269306,21899,129682,13581,247407,836,379,457
43460,269337,21902,129694,13583,247435,836,379,457
43465,269368,21904,129709,13584,247464,836,379,457
43470,269399,21907,129722,13586,247492,836,379,457
43475,269430,21910,129736,13588,247519,836,379,457
43480,269461,21914,129751,13590,247546,836,379,457
43485,269492,21917,129765,13592,247574,836,379,457
43490,269523,21920,129780,13594,247603,836,379,457
43495,269554,21922,129793,13596,247631,836,379,457
43500,269585,21925,129806,13597,247660,836,379,457
43505,269616,21927,129823,13598,247688,836,379,457
43510,269647,21930,129835,13600,247717,836,379,457
43515,269678,21931,129849,13600,247747,836,379,457
43520,269709,21932,129866,13600,247777,836,379,457
43525,269740,21933,129879,13600,247807,836,379,457
43530,269771,21934,129898,13601,247837,836,379,457
43535,269802,21935,129910,13602,247867,836,379,457
43540,269833,21936,129922,13602,247897,836,379,457
43545,269864,21938,129934,13602,247926,836,379,457
43550,269895,21940,129951,13604,247954,836,379,457
43555,269926,21943,129964,13606,247983,836,379,457
43560,269957,21946,129979,13607,248010,836,379,457
43565,269988,21951,129995,13611,248037,836,379,457
43570,270019,21953,130010,13612,248065,836,379,457
43575,270050,21956,130017,13614,248094,836,379,457
43580,270081,21956,130031,13614,248125,836,379,457
43585,270112,21956,130047,13614,248156,836,379,457
43590,270143,21956,130067,13614,248187,836,379,457
43595,270174,21956,130082,13614,248218,836,379,457
43600,270205,21956,130098,13614,248249,836,379,457
43605,270236,21956,130113,13614,248280,836,379,457
43610,270267,21956,130128,13614,248311,836,379,457
43615,270298,21956,130140,13614,248342,836,379,457
43620,270329,21956,130155,13614,248373,836,379,457
43625,270360,21956,130167,13614,248404,836,379,457
43630,270391,21956,130181,13614,248435,836,379,457
43635,270422,21956,130192,13614,248466,836,379,457
43640,270453,21956,130207,13614,248497,836,379,457
43645,270484,21956,130221,13614,248528,836,379,457
43650,270515,21956,130232,13614,248559,836,379,457
43655,270546,21956,130245,13614,248590,836,379,457
43660,270577,21956,130264,13614,248621,836,379,457
43665,270608,21956,130278,13614,248652,836,379,457
43670,270639,21958,130292,13615,248681,836,379,457
43675,270670,21963,130303,13618,248707,837,380,457
43680,270701,21969,130314,13622,248732,838,381,457
43685,270732,21973,130324,13623,248759,838,381,457
43690,270763,21978,130340,13627,248785,838,381,457
43695,270794,21983,130348,13628,248811,838,381,457
43700,270825,21989,130362,13631,248836,838,381,457
43705,270856,21994,130377,13634,248862,838,381,457
43710,270887,21997,130391,13637,248889,838,381,457
43715,270918,22001,130407,13639,248916,838,381,457
43720,270949,22006,130422,13643,248942,838,381,457
43725,270980,22012,130435,13648,248968,838,381,457
43730,271011,22015,130447,13650,248996,838,381,457
43735,271042,22019,130465,13652,249023,838,381,457
43740,271073,22022,130482,13655,249051,838,381,457
43745,271104,22027,130493,13658,249077,838,381,457
43750,271135,22032,130510,13662,249103,838,381,457
43755,271166,22036,130523,13663,249130,838,381,457
43760,271197,22039,130538,13666,249158,838,381,457
43765,271228,22044,130558,13671,249184,838,381,457
43770,271259,22047,130574,13671,249212,838,381,457
43775,271290,22050,130593,13673,249240,838,381,457
43780,271321,22054,130607,13675,249267,838,381,457
43785,271352,22057,130620,13676,249295,838,381,457
43790,271383,22062,130632,13678,249321,838,381,457
43795,271414,22065,130647,13680,249349,838,381,457
43800,271445,22066,130663,13680,249378,838,381,457
43805,271476,22067,130677,13681,249409,838,381,457
43810,271507,22067,130691,13681,249440,838,381,457
43815,271538,22067,130703,13681,249471,838,381,457
43820,271569,22067,130720,13681,249502,838,381,457
43825,271600,22067,130736,13681,249533,838,381,457
43830,271631,22067,130754,13681,249564,838,381,457
43835,271662,22068,130771,13682,249594,838,381,457
43840,271693,22070,130788,13683,249623,838,381,457
43845,271724,22071,130805,13684,249653,838,381,457
43850,271755,22073,130820,13686,249681,838,381,457
43855,271786,22076,130837,13688,249709,838,381,457
43860,271817,22078,130851,13689,249738,838,381,457
43865,271848,22080,130864,13690,249767,838,381,457
43870,271879,22082,130876,13691,249796,838,381,457
43875,271910,22084,130894,13692,249825,838,381,457
43880,271941,22087,130909,13695,249853,838,381,457
43885,271972,22089,130924,13697,249883,838,381,457
43890,272003,22089,130936,13697,249914,838,381,457
43895,272034,22089,130950,13697,249945,838,381,457
43900,272065,22090,130963,13698,249975,838,381,457
43905,272096,22092,130973,13698,250004,838,381,457
43910,272127,22095,130985,13698,250032,838,381,457
43915,272158,22100,130999,13702,250057,838,381,457
43920,272189,22106,131013,13706,250083,838,381,457
43925,272220,22110,131026,13706,250109,838,381,457
43930,272251,22115,131040,13707,250136,838,381,457
43935,272282,22120,131055,13710,250161,838,381,457
43940,272313,22125,131074,13715,250187,838,381,457
43945,272344,22130,131088,13719,250214,838,381,457
43950,272375,22134,131105,13720,250241,838,381,457
43955,272406,22138,131119,13722,250267,838,381,457
43960,272437,22144,131133,13726,250292,838,381,457
43965,272468,22149,131147,13729,250318,838,381,457
43970,272499,22155,131162,13733,250343,838,381,457
43975,272530,22159,131176,13736,250370,838,381,457
43980,272561,22162,131191,13737,250398,838,381,457
43985,272592,22166,131208,13739,250425,839,381,458
43990,272623,22171,131221,13743,250452,839,381,458
43995,272654,22174,131239,13745,250479,839,381,458
44000,272685,22176,131255,13747,250509,839,381,458
44005,272716,22176,131268,13747,250540,839,381,458
44010,272747,22176,131285,13747,250571,839,381,458
44015,272778,22176,131300,13747,250602,839,381,458
44020,272809,22176,131308,13747,250633,839,381,458
44025,272840,22176,131324,13747,250664,839,381,458
44030,272871,22176,131334,13747,250695,839,381,458
44035,272902,22176,131353,13747,250726,839,381,458
44040,272933,22176,131365,13747,250757,839,381,458
44045,272964,22180,131375,13748,250784,839,381,458
44050,272995,22184,131393,13752,250811,839,381,458
44055,273026,22188,131410,13755,250838,839,381,458
44060,273057,22192,131427,13757,250865,839,381,458
44065,273088,22196,131445,13758,250892,839,381,458
44070,273119,22200,131460,13760,250919,839,381,458
44075,273150,22202,131475,13762,250948,839,381,458
44080,273181,22205,131493,13764,250976,839,381,458
44085,273212,22208,131513,13767,251004,839,381,458
44090,273243,22210,131527,13769,251032,840,382,458
44095,273274,22213,131539,13771,251060,841,382,459
44100,273305,22217,131560,13773,251087,842,383,459
44105,273336,22219,131572,13774,251117,842,383,459
44110,273367,22221,131586,13775,251146,842,383,459
44115,273398,22223,131603,13777,251175,842,383,459
44120,273429,22224,131617,13778,251204,842,383,459
44125,273460,22226,131627,13779,251234,842,383,459
44130,273491,22227,131643,13780,251263,842,383,459
44135,273522,22229,131661,13781,251292,842,383,459
44140,273553,22231,131681,13783,251321,842,383,459
44145,273584,22233,131698,13784,251350,842,383,459
44150,273615,22235,131715,13786,251380,842,383,459
44155,273646,22236,131732,13786,251410,842,383,459
44160,273677,22237,131748,13787,251440,842,383,459
44165,273708,22241,131766,13789,251467,842,383,459
44170,273739,22244,131785,13791,251495,842,383,459
44175,273770,22247,131803,13792,251523,842,383,459
44180,273801,22250,131817,13795,251551,842,383,459
44185,273832,22253,131830,13796,251579,842,383,459
44190,273863,22256,131848,13797,251607,842,383,459
44195,273894,22259,131861,13799,251635,842,383,459
44200,273925,22262,131873,13801,251663,842,383,459
44205,273956,22265,131892,13804,251691,842,383,459
44210,273987,22268,131913,13806,251719,842,383,459
44215,274018,22271,131930,13808,251747,842,383,459
44220,274049,22274,131945,13811,251775,842,383,459
44225,274080,22277,131963,13813,251803,842,383,459
44230,274111,22280,131982,13815,251831,842,383,459
44235,274142,22283,131996,13817,251859,842,383,459
44240,274173,22286,132015,13819,251887,842,383,459
44245,274204,22287,132028,13819,251917,842,383,459
44250,274235,22288,132037,13819,251947,842,383,459
44255,274266,22289,132049,13819,251977,842,383,459
44260,274297,22290,132063,13819,252007,842,383,459
44265,274328,22292,132080,13821,252036,842,383,459
44270,274359,22295,132096,13823,252064,842,383,459
44275,274390,22297,132106,13824,252093,842,383,459
44280,274421,22299,132121,13825,252122,842,383,459
44285,274452,22301,132135,13827,252151,842,383,459
44290,274483,22304,132158,13828,252179,842,383,459
44295,274514,22306,132176,13829,252208,842,383,459
44300,274545,22308,132192,13830,252237,842,383,459
44305,274576,22311,132210,13833,252265,842,383,459
44310,274607,22313,132225,13834,252294,842,383,459
44315,274638,22314,132241,13834,252324,842,383,459
44320,274669,22315,132254,13834,252354,842,383,459
44325,274700,22316,132264,13834,252384,842,383,459
44330,274731,22318,132278,13834,252412,842,383,459
44335,274762,22321,132295,13836,252441,842,383,459
44340,274793,22323,132309,13836,252469,842,383,459
44345,274824,22326,132326,13838,252498,842,383,459
44350,274855,22328,132340,13840,252527,842,383,459
44355,274886,22330,132352,13842,252556,842,383,459
44360,274917,22332,132365,13843,252584,842,383,459
44365,274948,22336,132374,13847,252612,842,383,459
44370,274979,22339,132388,13849,252639,842,383,459
44375,275010,22344,132400,13853,252666,842,383,459
44380,275041,22348,132416,13856,252693,842,383,459
44385,275072,22352,132427,13859,252719,842,383,459
44390,275103,22358,132440,13864,252745,842,383,459
44395,275134,22362,132453,13867,252772,842,383,459
44400,275165,22366,132466,13870,252799,842,383,459
44405,275196,22369,132486,13873,252826,842,383,459
44410,275227,22370,132504,13874,252857,842,383,459
44415,275258,22372,132521,13876,252886,842,383,459
44420,275289,22374,132537,13877,252915,842,383,459
44425,275320,22376,132549,13879,252944,842,383,459
44430,275351,22377,132566,13880,252974,842,383,459
44435,275382,22378,132581,13880,253004,842,383,459
44440,275413,22380,132594,13881,253033,842,383,459
44445,275444,22382,132610,13883,253062,842,383,459
44450,275475,22383,132625,13883,253092,842,383,459
44455,275506,22385,132640,13885,253121,842,383,459
44460,275537,22387,132653,13887,253150,842,383,459
44465,275568,22389,132667,13888,253179,843,384,459
44470,275599,22391,132683,13889,253208,843,384,459
44475,275630,22393,132694,13890,253237,843,384,459
44480,275661,22395,132713,13890,253266,843,384,459
44485,275692,22397,132726,13890,253295,843,384,459
44490,275723,22399,132743,13890,253324,843,384,459
44495,275754,22402,132755,13891,253352,843,384,459
44500,275785,22405,132767,13893,253380,843,384,459
44505,275816,22408,132781,13896,253408,843,384,459
44510,275847,22412,132802,13898,253435,843,384,459
44515,275878,22416,132811,13899,253462,843,384,459
44520,275909,22420,132825,13903,253488,843,384,459
44525,275940,22423,132843,13905,253517,843,384,459
44530,275971,22425,132858,13907,253546,843,384,459
44535,276002,22428,132872,13909,253574,843,384,459
44540,276033,22431,132887,13911,253602,843,384,459
44545,276064,22434,132899,13914,253630,843,384,459
44550,276095,22438,132911,13918,253657,843,384,459
44555,276126,22441,132929,13920,253685,843,384,459
44560,276157,22443,132941,13921,253714,843,384,459
44565,276188,22446,132956,13923,253742,843,384,459
44570,276219,22447,132972,13923,253772,843,384,459
44575,276250,22447,132983,13923,253803,843,384,459
44580,276281,22447,133000,13923,253834,843,384,459
44585,276312,22447,133016,13923,253865,843,384,459
44590,276343,22447,133033,13923,253896,843,384,459
44595,276374,22447,133044,13923,253927,843,384,459
44600,276405,22447,133059,13923,253958,843,384,459
44605,276436,22447,133074,13923,253989,843,384,459
44610,276467,22447,133086,13923,254020,843,384,459
44615,276498,22447,133103,13923,254051,843,384,459
44620,276529,22447,133116,13923,254082,843,384,459
44625,276560,22447,133129,13923,254113,843,384,459
44630,276591,22449,133139,13923,254142,843,384,459
44635,276622,22452,133160,13925,254170,843,384,459
44640,276653,22454,133175,13926,254199,843,384,459
44645,276684,22456,133187,13926,254228,843,384,459
44650,276715,22458,133204,13928,254257,843,384,459
44655,276746,22460,133218,13928,254286,843,384,459
44660,276777,22462,133231,13929,254315,843,384,459
44665,276808,22464,133245,13929,254344,843,384,459
44670,276839,22467,133253,13930,254372,844,384,460
44675,276870,22470,133267,13931,254399,845,385,460
44680,276901,22475,133280,13934,254425,846,386,460
44685,276932,22480,133290,13936,254452,847,387,460
44690,276963,22485,133306,13939,254477,848,387,461
44695,276994,22492,133319,13943,254502,849,387,462
44700,277025,22497,133335,13944,254527,849,387,462
44705,277056,22502,133342,13945,254554,849,387,462
44710,277087,22506,133356,13947,254581,849,387,462
44715,277118,22509,133367,13948,254609,849,387,462
44720,277149,22515,133383,13954,254634,849,387,462
44725,277180,22519,133398,13957,254661,849,387,462
44730,277211,22521,133411,13958,254690,849,387,462
44735,277242,22524,133431,13960,254718,849,387,462
44740,277273,22528,133453,13964,254745,849,387,462
44745,277304,22530,133468,13966,254774,849,387,462
44750,277335,22534,133481,13969,254801,849,387,462
44755,277366,22537,133496,13971,254829,849,387,462
44760,277397,22539,133508,13972,254858,849,387,462
44765,277428,22541,133519,13972,254887,849,387,462
44770,277459,22544,133539,13975,254915,849,387,462
44775,277490,22546,133556,13976,254944,849,387,462
44780,277521,22548,133577,13977,254973,849,387,462
44785,277552,22550,133588,13978,255002,849,387,462
44790,277583,22552,133600,13978,255031,849,387,462
44795,277614,22554,133623,13979,255060,849,387,462
44800,277645,22557,133636,13981,255088,849,387,462
44805,277676,22559,133650,13982,255117,850,387,463
44810,277707,22561,133664,13983,255146,851,387,464
44815,277738,22564,133678,13985,255174,852,387,465
44820,277769,22566,133694,13985,255203,852,387,465
44825,277800,22569,133709,13987,255230,852,387,465
44830,277831,22572,133725,13990,255258,852,387,465
44835,277862,22576,133739,13993,255285,852,387,465
44840,277893,22579,133751,13995,255313,852,387,465
44845,277924,22582,133764,13997,255341,852,387,465
44850,277955,22585,133777,13999,255370,852,387,465
44855,277986,22587,133791,14001,255398,852,387,465
44860,278017,22590,133805,14003,255427,852,387,465
44865,278048,22591,133822,14003,255457,852,387,465
44870,278079,22592,133835,14004,255487,852,387,465
44875,278110,22593,133844,14005,255517,852,387,465
44880,278141,22594,133862,14006,255547,852,387,465
44885,278172,22598,133874,14009,255574,852,387,465
44890,278203,22600,133888,14011,255603,852,387,465
44895,278234,22601,133904,14011,255633,852,387,465
44900,278265,22604,133921,14013,255661,852,387,465
44905,278296,22606,133943,14015,255690,852,387,465
44910,278327,22607,133962,14016,255720,852,387,465
44915,278358,22609,133973,14017,255749,852,387,465
44920,278389,22612,133986,14019,255777,852,387,465
44925,278420,22613,133995,14019,255807,852,387,465
44930,278451,22613,134009,14019,255838,852,387,465
44935,278482,22614,134023,14020,255868,853,387,466
44940,278513,22615,134035,14020,255898,853,387,466
44945,278544,22617,134048,14020,255927,853,387,466
44950,278575,22620,134063,14022,255955,853,387,466
44955,278606,22622,134081,14023,255984,853,387,466
44960,278637,22625,134096,14025,256012,853,387,466
44965,278668,22628,134111,14028,256040,853,387,466
44970,278699,22631,134127,14029,256068,853,387,466
44975,278730,22633,134140,14030,256097,853,387,466
44980,278761,22635,134156,14031,256126,853,387,466
44985,278792,22636,134171,14032,256156,853,387,466
44990,278823,22638,134187,14034,256185,853,387,466
44995,278854,22640,134205,14035,256214,853,387,466
45000,278885,22642,134222,14036,256243,853,387,466
45005,278916,22645,134233,14038,256271,853,387,466
45010,278947,22650,134246,14041,256297,853,387,466
45015,278978,22654,134265,14044,256324,853,387,466
45020,279009,22657,134282,14045,256352,853,387,466
45025,279040,22660,134292,14046,256380,853,387,466
45030,279071,22663,134307,14048,256408,853,387,466
45035,279102,22666,134319,14049,256436,853,387,466
45040,279133,22670,134335,14052,256463,853,387,466
45045,279164,22673,134348,14053,256491,854,387,467
45050,279195,22678,134369,14056,256517,855,388,467
45055,279226,22683,134385,14059,256543,856,388,468
45060,279257,22687,134399,14062,256570,857,388,469
45065,279288,22691,134417,14065,256597,857,388,469
45070,279319,22694,134430,14067,256625,857,388,469
45075,279350,22696,134445,14068,256654,857,388,469
45080,279381,22697,134458,14069,256684,857,388,469
45085,279412,22698,134471,14070,256714,857,388,469
45090,279443,22699,134482,14070,256744,857,388,469
45095,279474,22700,134497,14071,256774,857,388,469
45100,279505,22701,134516,14071,256804,857,388,469
45105,279536,22702,134527,14071,256834,857,388,469
45110,279567,22703,134540,14071,256864,857,388,469
45115,279598,22704,134553,14072,256894,857,388,469
45120,279629,22705,134563,14072,256924,857,388,469
45125,279660,22707,134580,14074,256952,857,388,469
45130,279691,22709,134595,14075,256982,857,388,469
45135,279722,22710,134607,14076,257012,857,388,469
45140,279753,22711,134622,14077,257042,857,388,469
45145,279784,22712,134634,14078,257072,857,388,469
45150,279815,22713,134648,14079,257101,857,388,469
45155,279846,22715,134660,14080,257130,857,388,469
45160,279877,22718,134678,14082,257158,857,388,469
45165,279908,22720,134695,14083,257188,857,388,469
45170,279939,22723,134713,14086,257216,857,388,469
45175,279970,22726,134725,14088,257244,857,388,469
45180,280001,22729,134736,14089,257271,857,388,469
45185,280032,22734,134746,14092,257298,857,388,469
45190,280063,22737,134762,14093,257326,857,388,469
45195,280094,22741,134778,14095,257353,857,388,469
45200,280125,22745,134793,14098,257380,857,388,469
45205,280156,22749,134810,14100,257407,857,388,469
45210,280187,22754,134828,14104,257433,857,388,469
45215,280218,22758,134843,14106,257460,857,388,469
45220,280249,22762,134854,14108,257487,857,388,469
45225,280280,22767,134868,14113,257513,857,388,469
45230,280311,22771,134883,14114,257540,857,388,469
45235,280342,22775,134896,14116,257567,857,388,469
45240,280373,22778,134907,14118,257595,857,388,469
45245,280404,22781,134925,14120,257623,857,388,469
45250,280435,22782,134939,14120,257653,857,388,469
45255,280466,22782,134955,14120,257684,857,388,469
45260,280497,22782,134971,14120,257715,857,388,469
45265,280528,22782,134988,14120,257746,857,388,469
45270,280559,22782,135002,14120,257777,857,388,469
45275,280590,22783,135016,14120,257807,857,388,469
45280,280621,22784,135031,14121,257837,857,388,469
45285,280652,22785,135046,14121,257867,857,388,469
45290,280683,22786,135062,14122,257897,857,388,469
45295,280714,22787,135078,14122,257927,857,388,469
45300,280745,22788,135090,14122,257957,857,388,469
45305,280776,22791,135106,14125,257984,857,388,469
45310,280807,22795,135120,14128,258012,857,388,469
45315,280838,22797,135129,14129,258041,857,388,469
45320,280869,22799,135144,14130,258070,857,388,469
45325,280900,22801,135157,14130,258099,857,388,469
45330,280931,22803,135176,14130,258128,857,388,469
45335,280962,22805,135194,14131,258157,857,388,469
45340,280993,22808,135210,14133,258185,857,388,469
45345,281024,22811,135225,14134,258212,857,388,469
45350,281055,22817,135237,14138,258238,857,388,469
45355,281086,22821,135252,14140,258264,857,388,469
45360,281117,22828,135272,14147,258288,857,388,469
45365,281148,22831,135291,14149,258317,857,388,469
45370,281179,22833,135304,14150,258346,857,388,469
45375,281210,22835,135319,14151,258375,857,388,469
45380,281241,22837,135337,14151,258404,857,388,469
45385,281272,22839,135352,14153,258433,857,388,469
45390,281303,22841,135365,14153,258462,857,388,469
45395,281334,22843,135380,14154,258491,857,388,469
45400,281365,22845,135396,14155,258520,857,388,469
45405,281396,22847,135414,14156,258549,857,388,469
45410,281427,22849,135426,14157,258578,857,388,469
45415,281458,22851,135435,14159,258607,857,388,469
45420,281489,22853,135454,14160,258636,857,388,469
45425,281520,22855,135470,14161,258665,857,388,469
45430,281551,22857,135482,14163,258694,857,388,469
45435,281582,22859,135495,14165,258723,857,388,469
45440,281613,22861,135512,14167,258752,857,388,469
45445,281644,22863,135530,14167,258781,857,388,469
45450,281675,22865,135550,14167,258810,857,388,469
45455,281706,22867,135564,14169,258839,857,388,469
45460,281737,22869,135581,14170,258868,857,388,469
45465,281768,22871,135597,14171,258897,857,388,469
45470,281799,22878,135609,14176,258920,857,388,469
45475,281830,22882,135628,14178,258947,857,388,469
45480,281861,22886,135642,14180,258973,857,388,469
45485,281892,22890,135657,14184,259002,857,388,469
45490,281923,22893,135674,14186,259030,857,388,469
45495,281954,22895,135690,14187,259059,857,388,469
45500,281985,22897,135703,14189,259088,857,388,469
45505,282016,22899,135715,14190,259117,857,388,469
45510,282047,22901,135733,14192,259146,857,388,469
45515,282078,22903,135744,14193,259175,857,388,469
45520,282109,22905,135759,14193,259204,857,388,469
45525,282140,22907,135772,14193,259233,857,388,469
45530,282171,22909,135789,14194,259262,857,388,469
45535,282202,22911,135804,14196,259291,857,388,469
45540,282233,22913,135823,14198,259320,857,388,469
45545,282264,22915,135839,14200,259349,857,388,469
45550,282295,22917,135856,14201,259378,857,388,469
45555,282326,22919,135866,14202,259407,857,388,469
45560,282357,22921,135884,14202,259436,857,388,469
45565,282388,22923,135901,14203,259465,857,388,469
45570,282419,22925,135913,14204,259494,857,388,469
45575,282450,22929,135929,14207,259521,857,388,469
45580,282481,22935,135945,14211,259546,857,388,469
45585,282512,22940,135958,14213,259572,857,388,469
45590,282543,22945,135974,14217,259598,857,388,469
45595,282574,22952,135995,14223,259621,857,388,469
45600,282605,22959,136010,14228,259645,857,388,469
45605,282636,22963,136028,14231,259673,857,388,469
45610,282667,22966,136042,14234,259701,857,388,469
45615,282698,22968,136059,14235,259730,857,388,469
45620,282729,22970,136076,14236,259759,857,388,469
45625,282760,22973,136092,14237,259787,857,388,469
45630,282791,22976,136107,14238,259815,857,388,469
45635,282822,22978,136121,14238,259844,857,388,469
45640,282853,22980,136132,14239,259873,857,388,469
45645,282884,22983,136144,14240,259901,857,388,469
45650,282915,22984,136158,14241,259931,857,388,469
45655,282946,22986,136174,14243,259960,857,388,469
45660,282977,22987,136190,14243,259990,857,388,469
45665,283008,22988,136204,14244,260020,857,388,469
45670,283039,22989,136219,14245,260050,857,388,469
45675,283070,22990,136234,14245,260080,857,388,469
45680,283101,22991,136254,14246,260110,857,388,469
45685,283132,22992,136266,14247,260140,857,388,469
45690,283163,22993,136282,14247,260170,857,388,469
45695,283194,22995,136295,14249,260199,857,388,469
45700,283225,22995,136305,14249,260230,857,388,469
45705,283256,22996,136320,14250,260260,857,388,469
45710,283287,22997,136336,14250,260290,857,388,469
45715,283318,23000,136352,14251,260318,857,388,469
45720,283349,23003,136363,14253,260346,857,388,469
45725,283380,23007,136382,14257,260373,857,388,469
45730,283411,23011,136399,14260,260399,857,388,469
45735,283442,23016,136413,14264,260425,857,388,469
45740,283473,23021,136428,14267,260452,857,388,469
45745,283504,23024,136440,14267,260480,857,388,469
45750,283535,23027,136455,14268,260508,857,388,469
45755,283566,23030,136463,14269,260536,857,388,469
45760,283597,23033,136480,14270,260563,857,388,469
45765,283628,23037,136495,14271,260591,857,388,469
45770,283659,23040,136506,14273,260619,857,388,469
45775,283690,23043,136520,14273,260647,857,388,469
45780,283721,23046,136541,14274,260674,857,388,469
45785,283752,23049,136552,14276,260703,857,388,469
45790,283783,23051,136567,14277,260732,857,388,469
45795,283814,23053,136584,14279,260761,857,388,469
45800,283845,23055,136596,14280,260790,857,388,469
45805,283876,23057,136610,14281,260819,857,388,469
45810,283907,23060,136626,14283,260847,857,388,469
45815,283938,23064,136642,14286,260874,857,388,469
45820,283969,23067,136661,14288,260902,857,388,469
45825,284000,23070,136672,14290,260930,857,388,469
45830,284031,23073,136686,14292,260957,857,388,469
45835,284062,23079,136699,14297,260983,857,388,469
45840,284093,23081,136709,14297,261012,857,388,469
45845,284124,23083,136724,14298,261041,857,388,469
45850,284155,23087,136735,14301,261068,857,388,469
45855,284186,23090,136751,14304,261096,857,388,469
45860,284217,23092,136767,14305,261125,857,388,469
45865,284248,23095,136780,14307,261153,857,388,469
45870,284279,23097,136795,14309,261182,857,388,469
45875,284310,23101,136814,14313,261209,857,388,469
45880,284341,23103,136829,14314,261238,857,388,469
45885,284372,23105,136843,14316,261267,857,388,469
45890,284403,23108,136860,14319,261295,857,388,469
45895,284434,23110,136876,14320,261324,857,388,469
45900,284465,23113,136887,14322,261352,857,388,469
45905,284496,23113,136903,14322,261383,857,388,469
45910,284527,23113,136921,14322,261414,857,388,469
45915,284558,23113,136937,14322,261445,857,388,469
45920,284589,23113,136946,14322,261476,857,388,469
45925,284620,23113,136967,14322,261507,857,388,469
45930,284651,23113,136985,14322,261538,857,388,469
45935,284682,23113,137000,14322,261569,857,388,469
45940,284713,23113,137017,14322,261600,857,388,469
45945,284744,23114,137036,14323,261630,857,388,469
45950,284775,23117,137049,14324,261658,857,388,469
45955,284806,23120,137063,14325,261686,857,388,469
45960,284837,23124,137080,14328,261713,857,388,469
45965,284868,23128,137094,14330,261740,857,388,469
45970,284899,23132,137113,14332,261767,857,388,469
45975,284930,23136,137128,14334,261794,857,388,469
45980,284961,23140,137139,14336,261821,857,388,469
45985,284992,23145,137150,14338,261847,857,388,469
45990,285023,23149,137164,14341,261874,857,388,469
45995,285054,23153,137175,14342,261901,857,388,469
46000,285085,23157,137189,14345,261928,857,388,469
46005,285116,23162,137201,14348,261954,857,388,469
46010,285147,23166,137213,14349,261981,857,388,469
46015,285178,23170,137225,14352,262008,857,388,469
46020,285209,23176,137241,14357,262033,857,388,469
46025,285240,23179,137258,14359,262060,857,388,469
46030,285271,23183,137268,14361,262088,857,388,469
46035,285302,23187,137285,14364,262115,857,388,469
46040,285333,23191,137300,14368,262141,857,388,469
46045,285364,23195,137311,14371,262169,857,388,469
46050,285395,23199,137328,14374,262196,857,388,469
46055,285426,23201,137345,14374,262225,857,388,469
46060,285457,23203,137365,14375,262254,857,388,469
46065,285488,23206,137379,14377,262282,857,388,469
46070,285519,23210,137387,14379,262309,857,388,469
46075,285550,23212,137404,14381,262338,857,388,469
46080,285581,23213,137418,14381,262368,857,388,469
46085,285612,23214,137434,14382,262398,857,388,469
46090,285643,23215,137449,14383,262428,857,388,469
46095,285674,23216,137463,14383,262458,857,388,469
46100,285705,23217,137471,14383,262488,857,388,469
46105,285736,23218,137483,14383,262518,857,388,469
46110,285767,23219,137493,14383,262548,857,388,469
46115,285798,23220,137510,14383,262578,857,388,469
46120,285829,23221,137530,14384,262608,857,388,469
46125,285860,23223,137545,14386,262637,857,388,469
46130,285891,23226,137561,14388,262665,857,388,469
46135,285922,23228,137576,14390,262694,857,388,469
46140,285953,23230,137593,14390,262723,857,388,469
46145,285984,23233,137608,14393,262750,857,388,469
46150,286015,23236,137629,14396,262778,857,388,469
46155,286046,23242,137644,14399,262804,857,388,469
46160,286077,23247,137661,14404,262830,857,388,469
46165,286108,23250,137676,14406,262858,857,388,469
46170,286139,23254,137692,14410,262885,857,388,469
46175,286170,23259,137706,14414,262911,857,388,469
46180,286201,23263,137720,14417,262938,857,388,469
46185,286232,23268,137733,14422,262964,857,388,469
46190,286263,23270,137750,14423,262993,857,388,469
46195,286294,23272,137762,14423,263022,857,388,469
46200,286325,23274,137771,14423,263051,857,388,469
46205,286356,23276,137791,14424,263079,857,388,469
46210,286387,23279,137811,14426,263107,857,388,469
46215,286418,23282,137825,14429,263135,857,388,469
46220,286449,23285,137840,14430,263163,857,388,469
46225,286480,23288,137851,14432,263192,857,388,469
46230,286511,23290,137864,14433,263221,857,388,469
46235,286542,23292,137879,14434,263250,857,388,469
46240,286573,23294,137900,14435,263278,857,388,469
46245,286604,23297,137917,14437,263306,857,388,469
46250,286635,23302,137931,14440,263332,857,388,469
46255,286666,23307,137948,14444,263358,857,388,469
46260,286697,23312,137968,14446,263384,857,388,469
46265,286728,23315,137986,14448,263413,857,388,469
46270,286759,23318,138001,14449,263441,857,388,469
46275,286790,23320,138020,14450,263470,857,388,469
46280,286821,23322,138038,14452,263499,857,388,469
46285,286852,23324,138053,14454,263528,857,388,469
46290,286883,23326,138064,14454,263557,857,388,469
46295,286914,23328,138084,14456,263586,857,388,469
46300,286945,23330,138101,14457,263615,857,388,469
46305,286976,23333,138118,14458,263643,857,388,469
46310,287007,23335,138133,14458,263672,857,388,469
46315,287038,23338,138149,14461,263700,857,388,469
46320,287069,23341,138164,14463,263728,857,388,469
46325,287100,23345,138178,14466,263754,857,388,469
46330,287131,23350,138198,14470,263780,857,388,469
46335,287162,23354,138210,14471,263807,857,388,469
46340,287193,23359,138224,14476,263834,857,388,469
46345,287224,23362,138244,14479,263862,857,388,469
46350,287255,23364,138261,14481,263891,857,388,469
46355,287286,23367,138279,14483,263919,857,388,469
46360,287317,23370,138292,14484,263947,857,388,469
46365,287348,23374,138306,14488,263974,857,388,469
46370,287379,23377,138316,14489,264002,857,388,469
46375,287410,23378,138327,14489,264032,857,388,469
46380,287441,23379,138339,14489,264062,857,388,469
46385,287472,23381,138355,14491,264091,857,388,469
46390,287503,23384,138372,14493,264119,857,388,469
46395,287534,23386,138388,14495,264148,857,388,469
46400,287565,23387,138402,14495,264178,857,388,469
46405,287596,23388,138415,14495,264208,857,388,469
46410,287627,23389,138430,14496,264238,857,388,469
46415,287658,23390,138442,14497,264268,857,388,469
46420,287689,23391,138461,14498,264298,857,388,469
46425,287720,23393,138476,14499,264327,857,388,469
46430,287751,23395,138490,14500,264356,857,388,469
46435,287782,23397,138507,14502,264385,857,388,469
46440,287813,23399,138520,14502,264414,857,388,469
46445,287844,23402,138537,14505,264442,857,388,469
46450,287875,23404,138550,14505,264471,857,388,469
46455,287906,23405,138562,14506,264501,857,388,469
46460,287937,23406,138578,14507,264531,857,388,469
46465,287968,23407,138591,14507,264561,857,388,469
46470,287999,23408,138605,14508,264591,857,388,469
46475,288030,23410,138617,14509,264620,857,388,469
46480,288061,23412,138632,14511,264649,857,388,469
46485,288092,23414,138642,14511,264677,857,388,469
46490,288123,23418,138659,14514,264704,857,388,469
46495,288154,23422,138673,14517,264732,857,388,469
46500,288185,23425,138685,14518,264759,857,388,469
46505,288216,23430,138695,14520,264786,857,388,469
46510,288247,23434,138711,14521,264813,857,388,469
46515,288278,23438,138724,14522,264840,857,388,469
46520,288309,23442,138743,14525,264867,857,388,469
46525,288340,23446,138760,14527,264894,857,388,469
46530,288371,23450,138773,14529,264921,857,388,469
46535,288402,23454,138786,14530,264948,857,388,469
46540,288433,23458,138801,14532,264975,857,388,469
46545,288464,23462,138819,14534,265002,857,388,469
46550,288495,23467,138831,14535,265027,857,388,469
46555,288526,23474,138844,14539,265051,857,388,469
46560,288557,23480,138856,14542,265077,857,388,469
46565,288588,23483,138870,14544,265105,857,388,469
46570,288619,23485,138881,14544,265134,857,388,469
46575,288650,23487,138893,14545,265163,857,388,469
46580,288681,23490,138909,14548,265191,857,388,469
46585,288712,23493,138924,14551,265219,857,388,469
46590,288743,23495,138943,14552,265248,857,388,469
46595,288774,23497,138958,14553,265277,857,388,469
46600,288805,23499,138971,14555,265306,857,388,469
46605,288836,23502,138986,14558,265334,857,388,469
46610,288867,23504,138997,14560,265363,857,388,469
46615,288898,23505,139012,14561,265393,857,388,469
46620,288929,23507,139026,14563,265422,857,388,469
46625,288960,23508,139042,14563,265451,857,388,469
46630,288991,23510,139057,14565,265481,857,388,469
46635,289022,23511,139081,14566,265510,857,388,469
46640,289053,23512,139096,14567,265541,857,388,469
46645,289084,23512,139110,14567,265572,857,388,469
46650,289115,23512,139126,14567,265603,857,388,469
46655,289146,23512,139142,14567,265634,857,388,469
46660,289177,23512,139157,14567,265665,857,388,469
46665,289208,23513,139176,14567,265695,857,388,469
46670,289239,23514,139193,14568,265725,857,388,469
46675,289270,23515,139208,14568,265755,857,388,469
46680,289301,23516,139223,14568,265785,857,388,469
46685,289332,23518,139241,14570,265814,857,388,469
46690,289363,23522,139260,14573,265840,857,388,469
46695,289394,23525,139281,14576,265868,857,388,469
46700,289425,23528,139295,14577,265897,857,388,469
46705,289456,23531,139309,14580,265925,857,388,469
46710,289487,23532,139323,14580,265955,857,388,469
46715,289518,23534,139338,14581,265984,857,388,469
46720,289549,23536,139348,14582,266013,857,388,469
46725,289580,23540,139362,14585,266040,857,388,469
46730,289611,23546,139380,14590,266065,857,388,469
46735,289642,23550,139392,14592,266092,857,388,469
46740,289673,23554,139408,14595,266118,857,388,469
46745,289704,23558,139423,14597,266146,857,388,469
46750,289735,23561,139438,14599,266173,857,388,469
46755,289766,23565,139453,14603,266201,857,388,469
46760,289797,23568,139464,14604,266229,857,388,469
46765,289828,23571,139479,14606,266256,857,388,469
46770,289859,23575,139497,14609,266283,857,388,469
46775,289890,23579,139513,14611,266311,857,388,469
46780,289921,23582,139526,14613,266339,857,388,469
46785,289952,23585,139542,14614,266367,857,388,469
46790,289983,23588,139556,14617,266394,857,388,469
46795,290014,23592,139568,14619,266422,857,388,469
46800,290045,23596,139585,14620,266449,857,388,469
46805,290076,23600,139598,14621,266476,857,388,469
46810,290107,23605,139618,14626,266502,857,388,469
46815,290138,23610,139629,14630,266528,857,388,469
46820,290169,23613,139650,14632,266556,857,388,469
46825,290200,23617,139671,14636,266583,857,388,469
46830,290231,23620,139687,14637,266611,857,388,469
46835,290262,23623,139699,14638,266639,857,388,469
46840,290293,23627,139714,14640,266666,857,388,469
46845,290324,23632,139731,14644,266692,857,388,469
46850,290355,23636,139748,14647,266719,857,388,469
46855,290386,23639,139763,14648,266747,857,388,469
46860,290417,23641,139781,14649,266776,857,388,469
46865,290448,23643,139795,14650,266805,857,388,469
46870,290479,23645,139804,14651,266834,857,388,469
46875,290510,23647,139825,14652,266863,857,388,469
46880,290541,23649,139841,14653,266892,857,388,469
46885,290572,23651,139856,14654,266921,857,388,469
46890,290603,23653,139875,14655,266950,857,388,469
46895,290634,23655,139894,14656,266979,857,388,469
46900,290665,23657,139907,14657,267008,857,388,469
46905,290696,23659,139918,14658,267037,857,388,469
46910,290727,23661,139932,14658,267066,857,388,469
46915,290758,23663,139948,14659,267095,857,388,469
46920,290789,23665,139963,14661,267124,857,388,469
46925,290820,23666,139978,14662,267153,857,388,469
46930,290851,23668,139995,14663,267182,857,388,469
46935,290882,23670,140009,14665,267212,857,388,469
46940,290913,23671,140026,14665,267242,857,388,469
46945,290944,23672,140042,14666,267272,857,388,469
46950,290975,23673,140055,14667,267302,857,388,469
46955,291006,23674,140068,14667,267332,857,388,469
46960,291037,23675,140087,14668,267362,857,388,469
46965,291068,23676,140106,14668,267392,857,388,469
46970,291099,23677,140118,14669,267422,857,388,469
46975,291130,23679,140130,14670,267451,857,388,469
46980,291161,23682,140147,14672,267479,857,388,469
46985,291192,23686,140161,14673,267506,857,388,469
46990,291223,23690,140177,14677,267533,857,388,469
46995,291254,23694,140190,14679,267560,857,388,469
47000,291285,23697,140200,14679,267588,857,388,469
47005,291316,23702,140216,14682,267614,857,388,469
47010,291347,23705,140231,14684,267642,857,388,469
47015,291378,23707,140249,14686,267671,857,388,469
47020,291409,23709,140264,14687,267700,857,388,469
47025,291440,23712,140276,14687,267728,857,388,469
47030,291471,23715,140290,14689,267756,857,388,469
47035,291502,23720,140309,14693,267781,857,388,469
47040,291533,23726,140322,14696,267806,857,388,469
47045,291564,23729,140342,14699,267835,857,388,469
47050,291595,23731,140358,14700,267864,857,388,469
47055,291626,23733,140373,14700,267893,857,388,469
47060,291657,23736,140387,14701,267921,857,388,469
47065,291688,23738,140402,14703,267950,857,388,469
47070,291719,23740,140414,14704,267979,857,388,469
47075,291750,23743,140431,14705,268007,857,388,469
47080,291781,23745,140438,14705,268036,857,388,469
47085,291812,23748,140452,14708,268064,857,388,469
47090,291843,23751,140465,14710,268092,857,388,469
47095,291874,23754,140479,14712,268120,857,388,469
47100,291905,23755,140493,14713,268150,857,388,469
47105,291936,23756,140508,14714,268180,857,388,469
47110,291967,23758,140519,14716,268209,857,388,469
47115,291998,23760,140531,14717,268238,857,388,469
47120,292029,23763,140546,14719,268266,857,388,469
47125,292060,23766,140563,14722,268294,857,388,469
47130,292091,23769,140580,14725,268322,857,388,469
47135,292122,23772,140600,14728,268350,857,388,469
47140,292153,23774,140613,14728,268379,857,388,469
47145,292184,23776,140627,14729,268408,857,388,469
47150,292215,23778,140638,14729,268437,857,388,469
47155,292246,23780,140651,14730,268466,857,388,469
47160,292277,23782,140664,14731,268495,857,388,469
47165,292308,23787,140677,14735,268520,857,388,469
47170,292339,23791,140687,14736,268548,857,388,469
47175,292370,23795,140701,14739,268574,857,388,469
47180,292401,23801,140718,14743,268598,857,388,469
47185,292432,23807,140736,14749,268623,857,388,469
47190,292463,23811,140749,14752,268652,857,388,469
47195,292494,23812,140766,14752,268681,857,388,469
47200,292525,23814,140781,14753,268711,857,388,469
47205,292556,23815,140798,14754,268741,857,388,469
47210,292587,23817,140812,14754,268770,857,388,469
47215,292618,23819,140821,14755,268799,857,388,469
47220,292649,23821,140835,14755,268827,857,388,469
47225,292680,23826,140848,14756,268854,857,388,469
47230,292711,23830,140869,14759,268881,857,388,469
47235,292742,23833,140879,14759,268909,857,388,469
47240,292773,23837,140894,14761,268936,857,388,469
47245,292804,23840,140908,14762,268964,857,388,469
47250,292835,23843,140921,14762,268992,857,388,469
47255,292866,23846,140939,14765,269020,857,388,469
47260,292897,23851,140955,14768,269046,857,388,469
47265,292928,23854,140967,14771,269074,857,388,469
47270,292959,23858,140982,14774,269101,857,388,469
47275,292990,23861,140999,14776,269129,857,388,469
47280,293021,23864,141018,14778,269157,857,388,469
47285,293052,23867,141031,14780,269185,857,388,469
47290,293083,23869,141041,14781,269214,857,388,469
47295,293114,23872,141059,14782,269242,857,388,469
47300,293145,23873,141070,14782,269272,857,388,469
47305,293176,23874,141081,14782,269302,857,388,469
47310,293207,23875,141097,14783,269332,857,388,469
47315,293238,23876,141109,14783,269362,857,388,469
47320,293269,23877,141117,14784,269392,857,388,469
47325,293300,23878,141134,14785,269422,857,388,469
47330,293331,23879,141153,14785,269452,857,388,469
47335,293362,23882,141167,14788,269480,857,388,469
47340,293393,23883,141176,14788,269510,857,388,469
47345,293424,23885,141191,14789,269539,857,388,469
47350,293455,23886,141205,14789,269569,857,388,469
47355,293486,23887,141222,14790,269599,857,388,469
47360,293517,23888,141235,14791,269629,857,388,469
47365,293548,23889,141250,14792,269659,857,388,469
47370,293579,23890,141265,14793,269689,857,388,469
47375,293610,23892,141280,14795,269718,857,388,469
47380,293641,23894,141295,14797,269747,857,388,469
47385,293672,23896,141315,14798,269776,857,388,469
47390,293703,23899,141333,14800,269804,857,388,469
47395,293734,23902,141347,14802,269832,857,388,469
47400,293765,23904,141360,14804,269861,857,388,469
47405,293796,23907,141377,14806,269889,857,388,469
47410,293827,23910,141394,14808,269917,857,388,469
47415,293858,23913,141404,14808,269945,857,388,469
47420,293889,23917,141418,14811,269972,857,388,469
47425,293920,23920,141428,14813,270000,857,388,469
47430,293951,23924,141443,14817,270027,857,388,469
47435,293982,23927,141460,14818,270054,857,388,469
47440,294013,23935,141475,14823,270077,857,388,469
47445,294044,23941,141489,14827,270103,857,388,469
47450,294075,23945,141505,14829,270129,857,388,469
47455,294106,23951,141525,14835,270155,857,388,469
47460,294137,23954,141534,14836,270183,857,388,469
47465,294168,23957,141548,14838,270211,857,388,469
47470,294199,23959,141568,14839,270240,857,388,469
47475,294230,23961,141584,14840,270269,857,388,469
47480,294261,23963,141596,14841,270298,857,388,469
47485,294292,23965,141612,14843,270327,857,388,469
47490,294323,23967,141631,14845,270356,857,388,469
47495,294354,23969,141648,14846,270385,857,388,469
47500,294385,23971,141663,14847,270414,857,388,469
47505,294416,23973,141678,14849,270443,857,388,469
47510,294447,23976,141689,14852,270471,857,388,469
47515,294478,23980,141705,14854,270498,857,388,469
47520,294509,23983,141723,14857,270526,857,388,469
47525,294540,23987,141743,14860,270552,857,388,469
47530,294571,23991,141759,14864,270580,857,388,469
47535,294602,23994,141771,14865,270608,857,388,469
47540,294633,23996,141786,14867,270637,857,388,469
47545,294664,23998,141801,14869,270666,857,388,469
47550,294695,24001,141813,14871,270694,857,388,469
47555,294726,24003,141826,14872,270723,857,388,469
47560,294757,24005,141839,14873,270752,857,388,469
47565,294788,24007,141851,14873,270781,857,388,469
47570,294819,24010,141866,14875,270808,857,388,469
47575,294850,24012,141877,14876,270837,857,388,469
47580,294881,24014,141891,14878,270867,857,388,469
47585,294912,24015,141907,14879,270896,857,388,469
47590,294943,24018,141925,14882,270924,857,388,469
47595,294974,24021,141939,14885,270953,857,388,469
47600,295005,24023,141958,14887,270982,857,388,469
47605,295036,24024,141974,14888,271012,857,388,469
47610,295067,24026,141994,14890,271040,857,388,469
47615,295098,24028,142008,14891,271069,857,388,469
47620,295129,24030,142023,14893,271099,857,388,469
47625,295160,24031,142042,14894,271129,857,388,469
47630,295191,24032,142056,14895,271159,857,388,469
47635,295222,24035,142071,14896,271187,857,388,469
47640,295253,24038,142090,14899,271215,857,388,469
47645,295284,24043,142105,14902,271241,857,388,469
47650,295315,24047,142120,14904,271267,857,388,469
47655,295346,24053,142140,14908,271292,857,388,469
47660,295377,24059,142155,14912,271317,857,388,469
47665,295408,24063,142164,14914,271345,857,388,469
47670,295439,24066,142177,14916,271373,857,388,469
47675,295470,24070,142197,14920,271400,857,388,469
47680,295501,24073,142211,14921,271428,857,388,469
47685,295532,24076,142229,14923,271456,857,388,469
47690,295563,24078,142238,14923,271485,857,388,469
47695,295594,24080,142250,14923,271514,857,388,469
47700,295625,24082,142265,14923,271543,857,388,469
47705,295656,24084,142278,14924,271572,857,388,469
47710,295687,24086,142286,14924,271601,857,388,469
47715,295718,24088,142299,14925,271630,857,388,469
47720,295749,24090,142316,14926,271659,857,388,469
47725,295780,24092,142330,14927,271688,857,388,469
47730,295811,24094,142345,14929,271717,857,388,469
47735,295842,24096,142361,14929,271746,857,388,469
47740,295873,24098,142378,14929,271775,857,388,469
47745,295904,24100,142389,14929,271804,857,388,469
47750,295935,24102,142403,14929,271833,857,388,469
47755,295966,24106,142420,14931,271860,857,388,469
47760,295997,24108,142429,14931,271889,857,388,469
47765,296028,24111,142439,14933,271917,857,388,469
47770,296059,24114,142455,14935,271945,857,388,469
47775,296090,24119,142473,14938,271970,857,388,469
47780,296121,24125,142487,14942,271996,857,388,469
47785,296152,24129,142501,14945,272023,857,388,469
47790,296183,24133,142512,14948,272050,857,388,469
47795,296214,24137,142528,14951,272077,857,388,469
47800,296245,24140,142543,14953,272104,857,388,469
47805,296276,24145,142562,14956,272129,857,388,469
47810,296307,24149,142581,14959,272157,857,388,469
47815,296338,24152,142597,14961,272186,857,388,469
47820,296369,24153,142614,14962,272216,857,388,469
47825,296400,24154,142632,14963,272246,857,388,469
47830,296431,24155,142647,14964,272276,857,388,469
47835,296462,24156,142660,14964,272306,857,388,469
47840,296493,24157,142673,14964,272336,857,388,469
47845,296524,24158,142691,14965,272366,857,388,469
47850,296555,24159,142705,14966,272396,857,388,469
47855,296586,24160,142721,14967,272426,857,388,469
47860,296617,24161,142739,14967,272456,857,388,469
47865,296648,24162,142752,14967,272486,857,388,469
47870,296679,24165,142770,14970,272514,857,388,469
47875,296710,24167,142788,14970,272543,857,388,469
47880,296741,24169,142801,14971,272572,857,388,469
47885,296772,24172,142818,14974,272600,857,388,469
47890,296803,24175,142833,14976,272628,857,388,469
47895,296834,24178,142845,14977,272656,857,388,469
47900,296865,24182,142858,14979,272683,857,388,469
47905,296896,24185,142873,14979,272711,857,388,469
47910,296927,24189,142893,14981,272738,857,388,469
47915,296958,24194,142906,14984,272764,857,388,469
47920,296989,24200,142926,14988,272789,857,388,469
47925,297020,24207,142943,14994,272811,857,388,469
47930,297051,24214,142958,14998,272836,857,388,469
47935,297082,24220,142971,15003,272860,857,388,469
47940,297113,24227,142985,15008,272886,857,388,469
47945,297144,24229,142992,15009,272915,857,388,469
47950,297175,24233,143008,15012,272942,857,388,469
47955,297206,24236,143022,15013,272970,857,388,469
47960,297237,24240,143037,15016,272997,857,388,469
47965,297268,24242,143049,15018,273026,857,388,469
47970,297299,24245,143067,15020,273054,857,388,469
47975,297330,24246,143081,15020,273084,857,388,469
47980,297361,24248,143098,15022,273113,857,388,469
47985,297392,24248,143112,15022,273144,857,388,469
47990,297423,24248,143129,15022,273175,857,388,469
47995,297454,24248,143140,15022,273206,857,388,469
48000,297485,24248,143155,15022,273237,857,388,469
48005,297516,24250,143172,15023,273266,857,388,469
48010,297547,24250,143192,15023,273297,857,388,469
48015,297578,24250,143205,15023,273328,857,388,469
48020,297609,24250,143217,15023,273359,857,388,469
48025,297640,24250,143234,15023,273390,857,388,469
48030,297671,24250,143252,15023,273421,857,388,469
48035,297702,24250,143264,15023,273452,857,388,469
48040,297733,24250,143283,15023,273483,857,388,469
48045,297764,24251,143302,15024,273513,857,388,469
48050,297795,24254,143317,15026,273541,857,388,469
48055,297826,24257,143330,15027,273569,857,388,469
48060,297857,24261,143346,15031,273596,857,388,469
48065,297888,24265,143362,15033,273623,857,388,469
48070,297919,24270,143377,15035,273649,857,388,469
48075,297950,24273,143395,15037,273677,857,388,469
48080,297981,24277,143414,15040,273704,857,388,469
48085,298012,24281,143430,15043,273731,857,388,469
48090,298043,24284,143447,15044,273759,857,388,469
48095,298074,24287,143460,15045,273787,857,388,469
48100,298105,24291,143479,15048,273814,857,388,469
48105,298136,24294,143495,15049,273842,857,388,469
48110,298167,24296,143510,15051,273871,857,388,469
48115,298198,24298,143522,15053,273900,857,388,469
48120,298229,24301,143537,15056,273928,857,388,469
48125,298260,24303,143551,15058,273957,857,388,469
48130,298291,24305,143569,15059,273986,857,388,469
48135,298322,24307,143579,15060,274015,857,388,469
48140,298353,24310,143592,15061,274043,857,388,469
48145,298384,24312,143609,15062,274072,857,388,469
48150,298415,24315,143626,15064,274100,857,388,469
48155,298446,24317,143644,15065,274128,857,388,469
48160,298477,24320,143657,15067,274156,857,388,469
48165,298508,24323,143670,15069,274185,857,388,469
48170,298539,24325,143683,15069,274214,857,388,469
48175,298570,24328,143702,15070,274241,857,388,469
48180,298601,24332,143717,15072,274269,857,388,469
48185,298632,24337,143732,15076,274294,857,388,469
48190,298663,24341,143750,15079,274320,857,388,469
48195,298694,24346,143762,15082,274347,857,388,469
48200,298725,24351,143771,15085,274374,857,388,469
48205,298756,24354,143785,15086,274401,857,388,469
48210,298787,24359,143801,15089,274427,857,388,469
48215,298818,24364,143818,15093,274453,857,388,469
48220,298849,24369,143833,15097,274479,857,388,469
48225,298880,24372,143849,15099,274507,857,388,469
48230,298911,24375,143863,15102,274536,857,388,469
48235,298942,24376,143876,15102,274565,857,388,469
48240,298973,24378,143892,15104,274595,857,388,469
48245,299004,24380,143905,15106,274624,857,388,469
48250,299035,24381,143921,15106,274654,857,388,469
48255,299066,24382,143930,15106,274684,857,388,469
48260,299097,24383,143941,15106,274714,857,388,469
48265,299128,24384,143955,15107,274744,857,388,469
48270,299159,24385,143971,15108,274774,857,388,469
48275,299190,24386,143985,15108,274804,857,388,469
48280,299221,24387,143999,15108,274834,857,388,469
48285,299252,24388,144014,15108,274864,857,388,469
48290,299283,24389,144030,15108,274894,857,388,469
48295,299314,24390,144047,15108,274924,857,388,469
48300,299345,24391,144061,15108,274954,857,388,469
48305,299376,24392,144083,15108,274984,857,388,469
48310,299407,24393,144096,15109,275014,857,388,469
48315,299438,24394,144108,15109,275044,857,388,469
48320,299469,24395,144121,15109,275074,857,388,469
48325,299500,24398,144134,15111,275102,857,388,469
48330,299531,24401,144147,15111,275130,857,388,469
48335,299562,24404,144166,15113,275158,857,388,469
48340,299593,24409,144180,15116,275184,857,388,469
48345,299624,24413,144194,15117,275211,857,388,469
48350,299655,24418,144207,15119,275237,857,388,469
48355,299686,24422,144223,15122,275263,857,388,469
48360,299717,24427,144241,15127,275290,857,388,469
48365,299748,24432,144254,15130,275316,857,388,469
48370,299779,24437,144268,15133,275341,857,388,469
48375,299810,24442,144282,15138,275368,857,388,469
48380,299841,24446,144299,15141,275395,857,388,469
48385,299872,24450,144314,15143,275422,857,388,469
48390,299903,24453,144327,15145,275450,857,388,469
48395,299934,24456,144343,15146,275478,857,388,469
48400,299965,24459,144361,15147,275506,857,388,469
48405,299996,24463,144374,15149,275533,857,388,469
48410,300027,24466,144386,15150,275561,857,388,469
48415,300058,24469,144399,15152,275589,857,388,469
48420,300089,24472,144419,15154,275617,857,388,469
48425,300120,24475,144426,15155,275645,857,388,469
48430,300151,24477,144442,15156,275674,857,388,469
48435,300182,24479,144453,15157,275703,857,388,469
48440,300213,24481,144464,15157,275732,857,388,469
48445,300244,24483,144477,15158,275761,857,388,469
48450,300275,24485,144496,15160,275790,857,388,469
48455,300306,24487,144511,15161,275819,857,388,469
48460,300337,24489,144526,15162,275848,857,388,469
48465,300368,24491,144545,15163,275876,857,388,469
48470,300399,24493,144559,15164,275906,857,388,469
48475,300430,24496,144572,15165,275934,857,388,469
48480,300461,24498,144586,15167,275963,857,388,469
48485,300492,24500,144601,15169,275992,857,388,469
48490,300523,24501,144616,15169,276022,857,388,469
48495,300554,24502,144630,15170,276052,857,388,469
48500,300585,24504,144648,15171,276081,857,388,469
48505,300616,24506,144661,15172,276110,857,388,469
48510,300647,24508,144671,15174,276139,857,388,469
48515,300678,24509,144690,15174,276169,857,388,469
48520,300709,24510,144701,15174,276199,857,388,469
48525,300740,24511,144717,15174,276229,857,388,469
48530,300771,24513,144731,15175,276258,857,388,469
48535,300802,24515,144743,15176,276287,857,388,469
48540,300833,24518,144752,15178,276315,857,388,469
48545,300864,24521,144763,15180,276342,857,388,469
48550,300895,24524,144778,15182,276370,857,388,469
48555,300926,24529,144795,15187,276397,857,388,469
48560,300957,24531,144808,15188,276425,857,388,469
48565,300988,24534,144818,15190,276454,857,388,469
48570,301019,24537,144837,15192,276481,857,388,469
48575,301050,24539,144852,15194,276511,857,388,469
48580,301081,24539,144868,15194,276542,857,388,469
48585,301112,24539,144883,15194,276573,857,388,469
48590,301143,24540,144902,15195,276603,857,388,469
48595,301174,24542,144920,15197,276632,857,388,469
48600,301205,24545,144937,15199,276660,857,388,469
48605,301236,24547,144956,15200,276688,857,388,469
48610,301267,24551,144971,15202,276715,857,388,469
48615,301298,24554,144985,15203,276744,857,388,469
48620,301329,24556,144999,15203,276773,857,388,469
48625,301360,24558,145015,15204,276802,857,388,469
48630,301391,24560,145033,15206,276830,857,388,469
48635,301422,24563,145047,15208,276859,857,388,469
48640,301453,24565,145066,15208,276888,857,388,469
48645,301484,24567,145081,15208,276917,857,388,469
48650,301515,24569,145091,15210,276946,857,388,469
48655,301546,24570,145105,15211,276976,857,388,469
48660,301577,24571,145119,15211,277006,857,388,469
48665,301608,24574,145130,15213,277034,857,388,469
48670,301639,24577,145150,15215,277062,857,388,469
48675,301670,24580,145165,15217,277090,857,388,469
48680,301701,24584,145178,15218,277117,857,388,469
48685,301732,24587,145193,15219,277145,857,388,469
48690,301763,24589,145205,15219,277174,857,388,469
48695,301794,24591,145218,15220,277203,857,388,469
48700,301825,24593,145235,15221,277231,857,388,469
48705,301856,24596,145252,15224,277259,857,388,469
48710,301887,24599,145267,15227,277287,857,388,469
48715,301918,24602,145276,15229,277315,857,388,469
48720,301949,24606,145291,15231,277343,857,388,469
48725,301980,24607,145309,15231,277373,857,388,469
48730,302011,24608,145324,15232,277403,857,388,469
48735,302042,24609,145335,15232,277433,857,388,469
48740,302073,24610,145351,15233,277463,857,388,469
48745,302104,24611,145364,15233,277493,857,388,469
48750,302135,24612,145384,15234,277523,857,388,469
48755,302166,24614,145401,15235,277552,857,388,469
48760,302197,24616,145414,15235,277581,857,388,469
48765,302228,24618,145422,15236,277610,857,388,469
48770,302259,24620,145436,15238,277639,857,388,469
48775,302290,24622,145454,15239,277668,857,388,469
48780,302321,24624,145473,15240,277697,857,388,469
48785,302352,24626,145492,15242,277725,857,388,469
48790,302383,24629,145504,15244,277754,857,388,469
48795,302414,24631,145521,15245,277783,857,388,469
48800,302445,24633,145534,15246,277812,857,388,469
48805,302476,24635,145551,15248,277841,857,388,469
48810,302507,24637,145570,15250,277870,857,388,469
48815,302538,24639,145586,15251,277899,857,388,469
48820,302569,24641,145601,15251,277928,857,388,469
48825,302600,24644,145610,15252,277956,857,388,469
48830,302631,24648,145634,15256,277983,857,388,469
48835,302662,24652,145645,15258,278010,857,388,469
48840,302693,24656,145659,15260,278037,857,388,469
48845,302724,24660,145670,15262,278064,857,388,469
48850,302755,24665,145684,15265,278089,857,388,469
48855,302786,24670,145695,15268,278115,857,388,469
48860,302817,24673,145711,15271,278144,857,388,469
48865,302848,24675,145728,15272,278173,857,388,469
48870,302879,24677,145741,15274,278202,857,388,469
48875,302910,24679,145758,15275,278231,857,388,469
48880,302941,24681,145768,15276,278260,857,388,469
48885,302972,24685,145788,15280,278287,857,388,469
48890,303003,24687,145801,15281,278316,857,388,469
48895,303034,24690,145818,15282,278343,857,388,469
48900,303065,24693,145835,15284,278371,857,388,469
48905,303096,24696,145854,15287,278400,857,388,469
48910,303127,24697,145871,15288,278430,857,388,469
48915,303158,24698,145884,15288,278460,857,388,469
48920,303189,24699,145903,15289,278490,857,388,469
48925,303220,24700,145915,15289,278520,857,388,469
48930,303251,24701,145931,15289,278550,857,388,469
48935,303282,24702,145940,15289,278580,857,388,469
48940,303313,24703,145955,15289,278610,857,388,469
48945,303344,24704,145972,15289,278640,857,388,469
48950,303375,24705,145989,15290,278670,857,388,469
48955,303406,24706,146004,15290,278700,857,388,469
48960,303437,24707,146022,15290,278730,857,388,469
48965,303468,24711,146037,15293,278757,857,388,469
48970,303499,24713,146054,15294,278785,857,388,469
48975,303530,24717,146065,15296,278812,857,388,469
48980,303561,24721,146083,15298,278839,857,388,469
48985,303592,24724,146100,15301,278868,857,388,469
48990,303623,24726,146116,15302,278896,857,388,469
48995,303654,24729,146130,15303,278924,857,388,469
49000,303685,24732,146149,15305,278953,857,388,469
49005,303716,24733,146161,15306,278983,857,388,469
49010,303747,24734,146177,15307,279013,857,388,469
49015,303778,24737,146190,15308,279041,857,388,469
49020,303809,24739,146202,15309,279070,857,388,469
49025,303840,24745,146219,15313,279095,857,388,469
49030,303871,24749,146234,15315,279122,857,388,469
49035,303902,24753,146252,15319,279149,857,388,469
49040,303933,24758,146271,15323,279175,857,388,469
49045,303964,24765,146289,15328,279199,857,388,469
49050,303995,24770,146300,15330,279224,857,388,469
49055,304026,24775,146315,15333,279251,857,388,469
49060,304057,24779,146326,15334,279278,857,388,469
49065,304088,24784,146340,15338,279304,857,388,469
49070,304119,24789,146353,15342,279330,857,388,469
49075,304150,24793,146370,15346,279356,857,388,469
49080,304181,24796,146385,15348,279385,857,388,469
49085,304212,24797,146399,15349,279415,857,388,469
49090,304243,24798,146412,15349,279444,857,388,469
49095,304274,24800,146424,15351,279474,857,388,469
49100,304305,24801,146436,15352,279504,857,388,469
49105,304336,24802,146451,15352,279534,857,388,469
49110,304367,24803,146464,15352,279564,857,388,469
49115,304398,24803,146476,15352,279595,857,388,469
49120,304429,24803,146488,15352,279626,857,388,469
49125,304460,24803,146505,15352,279657,857,388,469
49130,304491,24803,146524,15352,279688,857,388,469
49135,304522,24803,146538,15352,279719,857,388,469
49140,304553,24803,146552,15352,279750,857,388,469
49145,304584,24805,146568,15353,279779,857,388,469
49150,304615,24807,146582,15354,279808,857,388,469
49155,304646,24809,146597,15355,279837,857,388,469
49160,304677,24809,146610,15355,279868,857,388,469
49165,304708,24809,146629,15355,279899,857,388,469
49170,304739,24809,146643,15355,279930,857,388,469
49175,304770,24809,146661,15355,279961,857,388,469
49180,304801,24810,146679,15356,279991,857,388,469
49185,304832,24813,146697,15358,280019,857,388,469
49190,304863,24816,146708,15360,280047,857,388,469
49195,304894,24820,146723,15361,280074,857,388,469
49200,304925,24825,146735,15364,280100,857,388,469
49205,304956,24830,146755,15369,280126,857,388,469
49210,304987,24833,146765,15369,280153,857,388,469
49215,305018,24837,146777,15370,280181,857,388,469
49220,305049,24840,146793,15372,280209,857,388,469
49225,305080,24843,146806,15374,280236,857,388,469
49230,305111,24847,146818,15377,280264,857,388,469
49235,305142,24850,146833,15379,280292,857,388,469
49240,305173,24853,146850,15381,280319,857,388,469
49245,305204,24857,146867,15384,280347,857,388,469
49250,305235,24860,146880,15385,280374,857,388,469
49255,305266,24865,146892,15388,280401,857,388,469
49260,305297,24869,146910,15391,280428,857,388,469
49265,305328,24873,146927,15393,280455,857,388,469
49270,305359,24877,146944,15395,280482,857,388,469
49275,305390,24879,146958,15396,280511,857,388,469
49280,305421,24881,146972,15398,280540,857,388,469
49285,305452,24883,146990,15399,280569,857,388,469
49290,305483,24885,147007,15400,280598,857,388,469
49295,305514,24885,147022,15400,280629,857,388,469
49300,305545,24885,147034,15400,280660,857,388,469
49305,305576,24885,147052,15400,280691,857,388,469
49310,305607,24885,147068,15400,280722,857,388,469
49315,305638,24885,147084,15400,280753,857,388,469
49320,305669,24885,147096,15400,280784,857,388,469
49325,305700,24887,147104,15401,280813,857,388,469
49330,305731,24889,147120,15402,280842,857,388,469
49335,305762,24890,147136,15402,280872,857,388,469
49340,305793,24891,147152,15403,280902,857,388,469
49345,305824,24893,147171,15405,280931,857,388,469
49350,305855,24893,147185,15405,280962,857,388,469
49355,305886,24893,147201,15405,280993,857,388,469
49360,305917,24893,147216,15405,281024,857,388,469
49365,305948,24894,147230,15405,281053,857,388,469
49370,305979,24897,147246,15408,281082,857,388,469
49375,306010,24901,147262,15410,281109,857,388,469
49380,306041,24904,147278,15412,281136,857,388,469
49385,306072,24909,147293,15416,281163,857,388,469
49390,306103,24913,147309,15419,281190,857,388,469
49395,306134,24917,147323,15421,281216,857,388,469
49400,306165,24921,147333,15423,281244,857,388,469
49405,306196,24925,147349,15426,281271,857,388,469
49410,306227,24930,147368,15429,281296,857,388,469
49415,306258,24936,147382,15433,281322,857,388,469
49420,306289,24941,147397,15436,281348,857,388,469
49425,306320,24946,147412,15439,281374,857,388,469
49430,306351,24951,147422,15442,281400,857,388,469
49435,306382,24955,147431,15444,281427,857,388,469
49440,306413,24959,147447,15447,281452,857,388,469
49445,306444,24961,147462,15449,281483,857,388,469
49450,306475,24961,147475,15449,281514,857,388,469
49455,306506,24962,147493,15449,281544,857,388,469
49460,306537,24963,147508,15449,281574,857,388,469
49465,306568,24964,147525,15449,281604,857,388,469
49470,306599,24965,147538,15450,281634,857,388,469
49475,306630,24966,147552,15451,281664,857,388,469
49480,306661,24967,147567,15451,281694,857,388,469
49485,306692,24968,147586,15452,281724,857,388,469
49490,306723,24969,147603,15453,281754,857,388,469
49495,306754,24970,147623,15454,281784,857,388,469
49500,306785,24972,147641,15455,281813,857,388,469
49505,306816,24978,147655,15460,281838,857,388,469
49510,306847,24982,147671,15463,281865,857,388,469
49515,306878,24986,147683,15464,281892,857,388,469
49520,306909,24989,147699,15466,281920,857,388,469
49525,306940,24993,147715,15469,281947,857,388,469
49530,306971,24997,147730,15470,281974,857,388,469
49535,307002,24999,147750,15472,282003,857,388,469
49540,307033,25001,147764,15472,282032,857,388,469
49545,307064,25003,147783,15473,282061,857,388,469
49550,307095,25006,147794,15475,282089,857,388,469
49555,307126,25010,147811,15478,282116,857,388,469
49560,307157,25014,147826,15482,282143,857,388,469
49565,307188,25018,147844,15484,282170,857,388,469
49570,307219,25022,147862,15488,282197,857,388,469
49575,307250,25026,147879,15490,282224,857,388,469
49580,307281,25029,147891,15491,282252,857,388,469
49585,307312,25033,147905,15492,282279,857,388,469
49590,307343,25036,147925,15493,282307,857,388,469
49595,307374,25040,147941,15494,282334,857,388,469
49600,307405,25043,147955,15495,282362,857,388,469
49605,307436,25047,147970,15498,282388,857,388,469
49610,307467,25052,147982,15500,282415,857,388,469
49615,307498,25056,147993,15502,282442,857,388,469
49620,307529,25061,148009,15505,282468,857,388,469
49625,307560,25064,148025,15506,282496,857,388,469
49630,307591,25065,148033,15506,282526,857,388,469
49635,307622,25067,148045,15508,282555,857,388,469
49640,307653,25069,148057,15510,282584,857,388,469
49645,307684,25069,148076,15510,282615,857,388,469
49650,307715,25069,148090,15510,282646,857,388,469
49655,307746,25069,148107,15510,282677,857,388,469
49660,307777,25069,148123,15510,282708,857,388,469
49665,307808,25069,148135,15510,282739,857,388,469
49670,307839,25069,148147,15510,282770,857,388,469
49675,307870,25069,148161,15510,282801,857,388,469
49680,307901,25069,148174,15510,282832,857,388,469
49685,307932,25069,148191,15510,282863,857,388,469
49690,307963,25069,148209,15510,282894,857,388,469
49695,307994,25069,148222,15510,282925,857,388,469
49700,308025,25069,148238,15510,282956,857,388,469
49705,308056,25069,148259,15510,282987,857,388,469
49710,308087,25069,148274,15510,283018,857,388,469
49715,308118,25069,148291,15510,283049,857,388,469
49720,308149,25069,148310,15510,283080,857,388,469
49725,308180,25069,148321,15510,283111,857,388,469
49730,308211,25071,148337,15511,283140,857,388,469
49735,308242,25075,148353,15515,283167,857,388,469
49740,308273,25080,148370,15518,283193,857,388,469
49745,308304,25087,148384,15522,283216,857,388,469
49750,308335,25092,148403,15525,283242,857,388,469
49755,308366,25100,148418,15532,283265,857,388,469
49760,308397,25105,148429,15534,283290,857,388,469
49765,308428,25111,148444,15538,283316,857,388,469
49770,308459,25116,148461,15541,283343,857,388,469
49775,308490,25121,148477,15545,283369,857,388,469
49780,308521,25125,148495,15548,283395,857,388,469
49785,308552,25129,148513,15552,283422,857,388,469
49790,308583,25134,148529,15556,283449,857,388,469
49795,308614,25138,148543,15558,283476,857,388,469
49800,308645,25141,148555,15560,283504,857,388,469
49805,308676,25143,148569,15560,283533,857,388,469
49810,308707,25145,148584,15562,283562,857,388,469
49815,308738,25146,148597,15562,283592,857,388,469
49820,308769,25147,148618,15563,283622,857,388,469
49825,308800,25148,148634,15564,283652,857,388,469
49830,308831,25150,148647,15566,283681,857,388,469
49835,308862,25151,148661,15566,283711,857,388,469
49840,308893,25152,148673,15566,283741,857,388,469
49845,308924,25154,148690,15567,283770,857,388,469
49850,308955,25156,148700,15568,283799,857,388,469
49855,308986,25158,148713,15569,283828,858,389,469
49860,309017,25159,148730,15570,283858,858,389,469
49865,309048,25161,148746,15572,283886,858,389,469
49870,309079,25163,148758,15574,283915,858,389,469
49875,309110,25166,148775,15577,283944,858,389,469
49880,309141,25167,148792,15578,283973,858,389,469
49885,309172,25169,148803,15579,284003,858,389,469
49890,309203,25171,148813,15580,284031,858,389,469
49895,309234,25174,148828,15582,284059,858,389,469
49900,309265,25178,148848,15585,284086,858,389,469
49905,309296,25181,148861,15588,284114,858,389,469
49910,309327,25183,148879,15590,284144,858,389,469
49915,309358,25185,148893,15591,284173,858,389,469
49920,309389,25188,148908,15593,284201,858,389,469
49925,309420,25192,148925,15597,284227,858,389,469
49930,309451,25197,148936,15599,284254,858,389,469
49935,309482,25201,148951,15601,284281,858,389,469
49940,309513,25205,148964,15604,284308,858,389,469
49945,309544,25210,148986,15609,284334,858,389,469
49950,309575,25214,149005,15613,284360,858,389,469
49955,309606,25219,149025,15616,284387,858,389,469
49960,309637,25222,149038,15618,284415,858,389,469
49965,309668,25228,149054,15622,284440,858,389,469
49970,309699,25232,149069,15625,284466,858,389,469
49975,309730,25237,149085,15629,284492,858,389,469
49980,309761,25242,149100,15632,284518,858,389,469
49985,309792,25243,149110,15633,284549,858,389,469
49990,309823,25243,149128,15633,284580,858,389,469
49995,309854,25243,149141,15633,284611,858,389,469
50000,309885,25243,149153,15633,284642,858,389,469
50005,309916,25243,149165,15633,284673,858,389,469
50010,309947,25243,149178,15633,284704,858,389,469
50015,309978,25244,149188,15633,284734,858,389,469
50020,310009,25245,149201,15633,284764,858,389,469
50025,310040,25246,149215,15633,284794,858,389,469
50030,310071,25248,149230,15634,284823,858,389,469
50035,310102,25249,149245,15635,284853,858,389,469
50040,310133,25251,149263,15636,284882,858,389,469
50045,310164,25254,149279,15639,284909,858,389,469
50050,310195,25258,149292,15642,284937,858,389,469
50055,310226,25261,149304,15645,284964,858,389,469
50060,310257,25264,149322,15648,284993,858,389,469
50065,310288,25267,149337,15649,285021,858,389,469
50070,310319,25268,149349,15649,285051,858,389,469
50075,310350,25269,149361,15650,285081,858,389,469
50080,310381,25270,149371,15650,285111,858,389,469
50085,310412,25271,149385,15650,285141,858,389,469
50090,310443,25272,149400,15650,285171,858,389,469
50095,310474,25276,149419,15654,285197,858,389,469
50100,310505,25281,149436,15657,285224,858,389,469
50105,310536,25284,149453,15659,285252,858,389,469
50110,310567,25287,149468,15662,285279,858,389,469
50115,310598,25290,149485,15664,285308,858,389,469
50120,310629,25292,149501,15666,285337,858,389,469
50125,310660,25294,149517,15668,285366,858,389,469
50130,310691,25296,149532,15670,285395,858,389,469
50135,310722,25297,149547,15670,285425,858,389,469
50140,310753,25298,149562,15670,285455,858,389,469
50145,310784,25299,149575,15670,285485,858,389,469
50150,310815,25300,149590,15671,285515,858,389,469
50155,310846,25301,149602,15672,285545,858,389,469
50160,310877,25302,149616,15673,285575,858,389,469
50165,310908,25303,149633,15673,285605,858,389,469
50170,310939,25304,149651,15673,285635,858,389,469
50175,310970,25306,149666,15674,285664,858,389,469
50180,311001,25308,149687,15675,285693,858,389,469
50185,311032,25310,149698,15677,285722,858,389,469
50190,311063,25312,149711,15678,285751,858,389,469
50195,311094,25314,149727,15678,285780,858,389,469
50200,311125,25317,149745,15681,285808,858,389,469
50205,311156,25321,149758,15683,285834,858,389,469
50210,311187,25327,149774,15686,285860,858,389,469
50215,311218,25333,149789,15690,285884,858,389,469
50220,311249,25339,149808,15695,285909,858,389,469
50225,311280,25344,149823,15699,285935,858,389,469
50230,311311,25349,149837,15703,285961,858,389,469
50235,311342,25354,149847,15706,285988,858,389,469
50240,311373,25358,149860,15709,286014,858,389,469
50245,311404,25363,149878,15713,286041,858,389,469
50250,311435,25366,149890,15715,286069,858,389,469
50255,311466,25370,149903,15718,286096,858,389,469
50260,311497,25370,149914,15718,286127,858,389,469
50265,311528,25370,149930,15718,286158,858,389,469
50270,311559,25370,149942,15718,286189,858,389,469
50275,311590,25370,149962,15718,286220,858,389,469
50280,311621,25370,149979,15718,286251,858,389,469
50285,311652,25372,149998,15720,286280,858,389,469
50290,311683,25373,150012,15720,286310,858,389,469
50295,311714,25375,150029,15721,286339,858,389,469
50300,311745,25377,150043,15722,286367,858,389,469
50305,311776,25380,150060,15724,286396,858,389,469
50310,311807,25381,150082,15725,286426,859,389,470
50315,311838,25381,150094,15725,286457,860,389,471
50320,311869,25381,150107,15725,286488,861,389,472
50325,311900,25381,150125,15725,286519,861,389,472
50330,311931,25382,150142,15726,286549,861,389,472
50335,311962,25383,150158,15727,286579,861,389,472
50340,311993,25384,150179,15728,286609,861,389,472
50345,312024,25385,150193,15728,286639,861,389,472
50350,312055,25386,150211,15729,286669,861,389,472
50355,312086,25387,150226,15729,286699,861,389,472
50360,312117,25389,150243,15729,286728,861,389,472
50365,312148,25393,150259,15733,286755,861,389,472
50370,312179,25396,150272,15733,286783,861,389,472
50375,312210,25400,150289,15735,286810,861,389,472
50380,312241,25404,150300,15737,286837,861,389,472
50385,312272,25408,150318,15738,286863,861,389,472
50390,312303,25413,150333,15741,286889,861,389,472
50395,312334,25419,150351,15745,286914,861,389,472
50400,312365,25425,150368,15749,286939,861,389,472
50405,312396,25429,150376,15752,286967,861,389,472
50410,312427,25431,150388,15752,286995,861,389,472
50415,312458,25436,150405,15755,287021,861,389,472
50420,312489,25441,150421,15759,287048,861,389,472
50425,312520,25445,150434,15762,287075,861,389,472
50430,312551,25449,150447,15765,287101,861,389,472
50435,312582,25454,150462,15769,287127,861,389,472
50440,312613,25460,150473,15773,287153,861,389,472
50445,312644,25464,150488,15776,287179,861,389,472
50450,312675,25468,150500,15778,287206,861,389,472
50455,312706,25473,150513,15782,287233,861,389,472
50460,312737,25476,150527,15784,287261,861,389,472
50465,312768,25477,150538,15785,287291,861,389,472
50470,312799,25478,150558,15786,287321,861,389,472
50475,312830,25480,150576,15788,287350,861,389,472
50480,312861,25482,150591,15789,287379,861,389,472
50485,312892,25483,150603,15790,287409,861,389,472
50490,312923,25485,150620,15791,287438,861,389,472
50495,312954,25487,150631,15793,287467,861,389,472
50500,312985,25488,150648,15793,287497,861,389,472
50505,313016,25490,150662,15794,287526,861,389,472
50510,313047,25492,150675,15796,287555,861,389,472
50515,313078,25494,150689,15797,287584,861,389,472
50520,313109,25497,150707,15799,287612,861,389,472
50525,313140,25498,150721,15800,287642,861,389,472
50530,313171,25500,150736,15802,287671,861,389,472
50535,313202,25502,150751,15804,287700,861,389,472
50540,313233,25503,150764,15804,287730,861,389,472
50545,313264,25504,150780,15804,287760,861,389,472
50550,313295,25505,150799,15804,287790,861,389,472
50555,313326,25506,150814,15805,287820,861,389,472
50560,313357,25508,150830,15806,287847,861,389,472
50565,313388,25513,150848,15809,287874,861,389,472
50570,313419,25518,150858,15812,287901,861,389,472
50575,313450,25522,150873,15815,287927,861,389,472
50580,313481,25526,150890,15818,287954,861,389,472
50585,313512,25531,150907,15821,287980,861,389,472
50590,313543,25536,150927,15825,288006,861,389,472
50595,313574,25540,150939,15828,288034,861,389,472
50600,313605,25543,150955,15830,288062,861,389,472
50605,313636,25546,150972,15831,288090,861,389,472
50610,313667,25548,150983,15833,288119,861,389,472
50615,313698,25551,151003,15835,288147,861,389,472
50620,313729,25553,151013,15835,288176,861,389,472
50625,313760,25557,151026,15838,288203,861,389,472
50630,313791,25560,151042,15838,288231,861,389,472
50635,313822,25565,151056,15842,288257,862,389,473
50640,313853,25570,151076,15846,288283,863,389,474
50645,313884,25575,151093,15849,288309,863,389,474
50650,313915,25578,151109,15851,288337,863,389,474
50655,313946,25582,151125,15854,288364,863,389,474
50660,313977,25585,151139,15855,288392,863,389,474
50665,314008,25589,151156,15858,288419,863,389,474
50670,314039,25592,151165,15860,288447,863,389,474
50675,314070,25596,151183,15862,288474,863,389,474
50680,314101,25599,151195,15863,288502,863,389,474
50685,314132,25602,151211,15865,288530,863,389,474
50690,314163,25607,151229,15868,288555,863,389,474
50695,314194,25611,151241,15870,288582,863,389,474
50700,314225,25615,151254,15873,288610,863,389,474
50705,314256,25616,151267,15874,288640,863,389,474
50710,314287,25617,151285,15875,288670,863,389,474
50715,314318,25619,151302,15876,288698,863,389,474
50720,314349,25621,151317,15878,288728,863,389,474
50725,314380,25622,151328,15878,288758,863,389,474
50730,314411,25623,151345,15879,288788,863,389,474
50735,314442,25623,151360,15879,288819,863,389,474
50740,314473,25623,151373,15879,288850,863,389,474
50745,314504,25623,151387,15879,288881,863,389,474
50750,314535,25624,151402,15880,288911,863,389,474
50755,314566,25625,151418,15881,288941,863,389,474
50760,314597,25627,151431,15883,288970,863,389,474
50765,314628,25631,151442,15886,288997,863,389,474
50770,314659,25634,151457,15888,289024,863,389,474
50775,314690,25639,151471,15891,289051,863,389,474
50780,314721,25643,151487,15894,289078,863,389,474
50785,314752,25646,151504,15895,289106,863,389,474
50790,314783,25648,151525,15897,289135,863,389,474
50795,314814,25651,151544,15899,289163,863,389,474
50800,314845,25654,151559,15902,289191,863,389,474
50805,314876,25657,151570,15904,289219,863,389,474
50810,314907,25659,151586,15905,289248,863,389,474
50815,314938,25662,151598,15906,289276,863,389,474
50820,314969,25665,151617,15906,289304,863,389,474
50825,315000,25669,151632,15908,289331,863,389,474
50830,315031,25672,151649,15909,289359,863,389,474
50835,315062,25675,151660,15911,289387,863,389,474
50840,315093,25678,151677,15913,289415,863,389,474
50845,315124,25682,151699,15916,289442,863,389,474
50850,315155,25686,151713,15918,289468,863,389,474
50855,315186,25690,151727,15920,289496,863,389,474
50860,315217,25693,151740,15920,289524,863,389,474
50865,315248,25696,151751,15920,289551,863,389,474
50870,315279,25700,151770,15923,289579,863,389,474
50875,315310,25705,151790,15928,289605,863,389,474
50880,315341,25708,151806,15931,289633,863,389,474
50885,315372,25708,151820,15931,289664,863,389,474
50890,315403,25709,151835,15932,289694,863,389,474
50895,315434,25711,151852,15934,289723,863,389,474
50900,315465,25712,151865,15934,289753,863,389,474
50905,315496,25713,151878,15934,289783,863,389,474
50910,315527,25714,151899,15935,289813,863,389,474
50915,315558,25715,151918,15936,289843,863,389,474
50920,315589,25716,151932,15937,289873,863,389,474
50925,315620,25717,151944,15937,289903,863,389,474
50930,315651,25719,151956,15939,289932,863,389,474
50935,315682,25721,151969,15940,289961,863,389,474
50940,315713,25722,151984,15940,289991,863,389,474
50945,315744,25724,151997,15941,290020,863,389,474
50950,315775,25726,152013,15943,290049,863,389,474
50955,315806,25728,152026,15945,290078,863,389,474
50960,315837,25729,152039,15945,290108,863,389,474
50965,315868,25730,152051,15946,290138,863,389,474
50970,315899,25731,152057,15946,290168,863,389,474
50975,315930,25732,152077,15947,290198,863,389,474
50980,315961,25734,152088,15948,290227,863,389,474
50985,315992,25736,152098,15950,290256,863,389,474
50990,316023,25740,152115,15951,290282,863,389,474
50995,316054,25746,152130,15957,290307,863,389,474
51000,316085,25754,152145,15962,290330,863,389,474
51005,316116,25759,152160,15965,290356,863,389,474
51010,316147,25764,152175,15968,290382,863,389,474
51015,316178,25768,152186,15970,290409,863,389,474
51020,316209,25772,152198,15973,290437,863,389,474
51025,316240,25776,152211,15974,290463,863,389,474
51030,316271,25780,152224,15976,290490,863,389,474
51035,316302,25785,152234,15979,290517,863,389,474
51040,316333,25789,152247,15983,290543,863,389,474
51045,316364,25794,152267,15987,290569,863,389,474
51050,316395,25797,152285,15988,290598,863,389,474
51055,316426,25799,152294,15988,290627,863,389,474
51060,316457,25801,152312,15989,290656,863,389,474
51065,316488,25803,152327,15991,290685,863,389,474
51070,316519,25804,152341,15992,290715,863,389,474
51075,316550,25805,152353,15992,290745,863,389,474
51080,316581,25806,152371,15992,290775,863,389,474
51085,316612,25807,152386,15992,290804,863,389,474
51090,316643,25809,152398,15993,290833,863,389,474
51095,316674,25811,152413,15994,290863,863,389,474
51100,316705,25812,152427,15994,290893,863,389,474
51105,316736,25813,152440,15995,290923,863,389,474
51110,316767,25816,152458,15998,290951,863,389,474
51115,316798,25819,152475,16001,290979,863,389,474
51120,316829,25820,152489,16001,291009,863,389,474
51125,316860,25820,152506,16001,291040,863,389,474
51130,316891,25820,152520,16001,291071,863,389,474
51135,316922,25820,152537,16001,291102,863,389,474
51140,316953,25820,152554,16001,291133,863,389,474
51145,316984,25820,152569,16001,291164,863,389,474
51150,317015,25821,152582,16002,291194,863,389,474
51155,317046,25823,152597,16003,291223,863,389,474
51160,317077,25825,152612,16004,291252,863,389,474
51165,317108,25828,152624,16005,291280,863,389,474
51170,317139,25830,152632,16006,291309,863,389,474
51175,317170,25834,152645,16008,291336,863,389,474
51180,317201,25837,152663,16010,291364,863,389,474
51185,317232,25842,152676,16013,291389,863,389,474
51190,317263,25847,152691,16017,291416,863,389,474
51195,317294,25852,152711,16019,291442,863,389,474
51200,317325,25856,152728,16021,291468,863,389,474
51205,317356,25861,152740,16023,291495,863,389,474
51210,317387,25865,152756,16025,291520,863,389,474
51215,317418,25871,152768,16029,291546,863,389,474
51220,317449,25876,152781,16032,291571,863,389,474
51225,317480,25885,152792,16041,291594,863,389,474
51230,317511,25891,152807,16046,291619,863,389,474
51235,317542,25898,152824,16051,291642,863,389,474
51240,317573,25903,152834,16054,291670,863,389,474
51245,317604,25906,152848,16055,291698,863,389,474
51250,317635,25910,152860,16058,291725,863,389,474
51255,317666,25912,152875,16059,291754,863,389,474
51260,317697,25914,152893,16059,291783,863,389,474
51265,317728,25916,152911,16060,291812,863,389,474
51270,317759,25918,152918,16060,291841,863,389,474
51275,317790,25920,152932,16062,291870,863,389,474
51280,317821,25922,152948,16062,291899,863,389,474
51285,317852,25924,152960,16063,291928,863,389,474
51290,317883,25927,152974,16066,291956,863,389,474
51295,317914,25930,152987,16068,291984,863,389,474
51300,317945,25933,153005,16070,292012,863,389,474
51305,317976,25935,153015,16071,292041,863,389,474
51310,318007,25936,153030,16072,292071,863,389,474
51315,318038,25937,153042,16073,292101,863,389,474
51320,318069,25938,153056,16074,292131,863,389,474
51325,318100,25939,153070,16075,292161,863,389,474
51330,318131,25940,153087,16075,292191,863,389,474
51335,318162,25941,153097,16075,292221,863,389,474
51340,318193,25942,153107,16076,292251,863,389,474
51345,318224,25944,153119,16078,292280,863,389,474
51350,318255,25947,153136,16080,292308,863,389,474
51355,318286,25949,153153,16080,292337,863,389,474
51360,318317,25951,153163,16080,292366,863,389,474
51365,318348,25953,153182,16081,292395,863,389,474
51370,318379,25955,153200,16081,292424,863,389,474
51375,318410,25957,153214,16081,292453,863,389,474
51380,318441,25959,153228,16082,292482,863,389,474
51385,318472,25961,153241,16082,292511,863,389,474
51390,318503,25963,153258,16082,292540,863,389,474
51395,318534,25965,153268,16082,292569,863,389,474
51400,318565,25967,153284,16082,292598,863,389,474
51405,318596,25969,153300,16083,292627,863,389,474
51410,318627,25973,153314,16086,292654,863,389,474
51415,318658,25978,153334,16091,292679,863,389,474
51420,318689,25984,153347,16095,292704,863,389,474
51425,318720,25988,153364,16097,292732,863,389,474
51430,318751,25991,153376,16098,292759,863,389,474
51435,318782,25995,153388,16100,292786,863,389,474
51440,318813,25999,153401,16101,292814,863,389,474
51445,318844,26002,153418,16103,292842,863,389,474
51450,318875,26005,153434,16106,292870,863,389,474
51455,318906,26008,153451,16108,292898,863,389,474
51460,318937,26011,153468,16111,292926,863,389,474
51465,318968,26014,153481,16113,292954,863,389,474
51470,318999,26017,153495,16115,292982,863,389,474
51475,319030,26021,153508,16117,293009,863,389,474
51480,319061,26024,153526,16119,293037,863,389,474
51485,319092,26026,153545,16120,293066,863,389,474
51490,319123,26028,153562,16120,293095,863,389,474
51495,319154,26030,153580,16121,293124,863,389,474
51500,319185,26032,153595,16123,293153,863,389,474
51505,319216,26034,153612,16125,293182,863,389,474
51510,319247,26036,153623,16125,293211,863,389,474
51515,319278,26038,153635,16125,293240,863,389,474
51520,319309,26040,153647,16125,293269,863,389,474
51525,319340,26043,153666,16127,293297,863,389,474
51530,319371,26047,153678,16130,293324,863,389,474
51535,319402,26051,153688,16132,293351,863,389,474
51540,319433,26056,153702,16137,293377,863,389,474
51545,319464,26059,153721,16139,293405,863,389,474
51550,319495,26061,153742,16140,293434,863,389,474
51555,319526,26063,153755,16141,293463,863,389,474
51560,319557,26065,153770,16142,293492,863,389,474
51565,319588,26067,153791,16144,293521,863,389,474
51570,319619,26069,153808,16145,293550,863,389,474
51575,319650,26071,153824,16146,293579,863,389,474
51580,319681,26073,153840,16146,293608,863,389,474
51585,319712,26075,153854,16148,293637,863,389,474
51590,319743,26077,153868,16148,293666,863,389,474
51595,319774,26079,153884,16149,293695,863,389,474
51600,319805,26081,153900,16151,293723,863,389,474
51605,319836,26084,153918,16154,293752,863,389,474
51610,319867,26086,153931,16155,293781,863,389,474
51615,319898,26088,153939,16155,293810,863,389,474
51620,319929,26090,153955,16155,293839,863,389,474
51625,319960,26092,153970,16156,293868,863,389,474
51630,319991,26095,153986,16158,293896,863,389,474
51635,320022,26096,154007,16159,293926,863,389,474
51640,320053,26097,154022,16159,293956,863,389,474
51645,320084,26098,154039,16160,293986,863,389,474
51650,320115,26101,154056,16162,294014,863,389,474
51655,320146,26103,154071,16163,294043,863,389,474
51660,320177,26107,154086,16164,294070,863,389,474
51665,320208,26111,154102,16166,294096,863,389,474
51670,320239,26116,154121,16170,294123,863,389,474
51675,320270,26118,154135,16171,294152,863,389,474
51680,320301,26120,154149,16171,294181,863,389,474
51685,320332,26122,154168,16173,294210,863,389,474
51690,320363,26125,154182,16175,294238,863,389,474
51695,320394,26127,154202,16177,294267,863,389,474
51700,320425,26129,154219,16177,294296,863,389,474
51705,320456,26131,154239,16178,294325,863,389,474
51710,320487,26133,154255,16178,294354,863,389,474
51715,320518,26135,154279,16179,294383,863,389,474
51720,320549,26137,154297,16180,294412,863,389,474
51725,320580,26138,154311,16180,294442,863,389,474
51730,320611,26139,154330,16180,294472,863,389,474
51735,320642,26140,154345,16181,294502,863,389,474
51740,320673,26141,154355,16181,294532,863,389,474
51745,320704,26143,154366,16182,294561,863,389,474
51750,320735,26145,154380,16184,294590,863,389,474
51755,320766,26146,154393,16185,294620,863,389,474
51760,320797,26146,154409,16185,294651,863,389,474
51765,320828,26146,154424,16185,294682,863,389,474
51770,320859,26146,154438,16185,294713,863,389,474
51775,320890,26147,154450,16185,294743,863,389,474
51780,320921,26148,154463,16186,294773,863,389,474
51785,320952,26154,154482,16191,294798,863,389,474
51790,320983,26159,154497,16195,294823,863,389,474
51795,321014,26164,154507,16197,294850,863,389,474
51800,321045,26168,154526,16201,294877,863,389,474
51805,321076,26173,154543,16205,294902,863,389,474
51810,321107,26177,154561,16208,294929,863,389,474
51815,321138,26181,154574,16210,294956,863,389,474
51820,321169,26186,154589,16215,294983,863,389,474
51825,321200,26190,154603,16217,295010,863,389,474
51830,321231,26193,154617,16218,295037,863,389,474
51835,321262,26198,154629,16220,295064,863,389,474
51840,321293,26201,154641,16221,295092,863,389,474
51845,321324,26202,154651,16222,295122,863,389,474
51850,321355,26204,154672,16224,295151,863,389,474
51855,321386,26205,154689,16225,295181,863,389,474
51860,321417,26207,154708,16226,295209,863,389,474
51865,321448,26208,154720,16227,295240,863,389,474
51870,321479,26208,154733,16227,295271,863,389,474
51875,321510,26208,154751,16227,295302,863,389,474
51880,321541,26208,154768,16227,295333,863,389,474
51885,321572,26208,154780,16227,295364,863,389,474
51890,321603,26208,154797,16227,295395,863,389,474
51895,321634,26208,154814,16227,295426,863,389,474
51900,321665,26211,154830,16230,295454,863,389,474
51905,321696,26214,154850,16232,295481,863,389,474
51910,321727,26219,154869,16234,295508,863,389,474
51915,321758,26223,154885,16237,295535,863,389,474
51920,321789,26225,154898,16238,295564,863,389,474
51925,321820,26227,154916,16240,295592,863,389,474
51930,321851,26231,154934,16243,295620,863,389,474
51935,321882,26234,154952,16245,295648,863,389,474
51940,321913,26237,154968,16247,295675,863,389,474
51945,321944,26239,154982,16248,295704,863,389,474
51950,321975,26242,154997,16250,295732,863,389,474
51955,322006,26244,155018,16252,295762,863,389,474
51960,322037,26245,155028,16252,295792,863,389,474
51965,322068,26247,155043,16252,295821,863,389,474
51970,322099,26249,155056,16253,295850,863,389,474
51975,322130,26252,155073,16256,295878,863,389,474
51980,322161,26255,155087,16257,295905,863,389,474
51985,322192,26259,155103,16260,295933,863,389,474
51990,322223,26263,155119,16263,295959,863,389,474
51995,322254,26266,155136,16265,295988,863,389,474
52000,322285,26267,155148,16266,296018,863,389,474
52005,322316,26268,155165,16267,296048,863,389,474
52010,322347,26269,155184,16267,296077,863,389,474
52015,322378,26271,155196,16268,296106,863,389,474
52020,322409,26273,155211,16270,296136,863,389,474
52025,322440,26274,155228,16271,296166,863,389,474
52030,322471,26275,155240,16271,296196,863,389,474
52035,322502,26276,155251,16271,296226,863,389,474
52040,322533,26277,155265,16271,296256,863,389,474
52045,322564,26278,155282,16271,296286,863,389,474
52050,322595,26280,155294,16271,296315,863,389,474
52055,322626,26282,155307,16273,296344,863,389,474
52060,322657,26285,155322,16275,296372,863,389,474
52065,322688,26289,155337,16279,296398,863,389,474
52070,322719,26294,155350,16282,296425,863,389,474
52075,322750,26297,155367,16284,296453,863,389,474
52080,322781,26301,155383,16287,296479,863,389,474
52085,322812,26306,155398,16290,296506,863,389,474
52090,322843,26310,155413,16294,296532,863,389,474
52095,322874,26314,155430,16297,296560,863,389,474
52100,322905,26316,155444,16299,296589,863,389,474
52105,322936,26320,155459,16302,296616,863,389,474
52110,322967,26323,155479,16305,296644,863,389,474
52115,322998,26326,155494,16307,296672,863,389,474
52120,323029,26327,155506,16308,296702,863,389,474
52125,323060,26329,155521,16310,296731,863,389,474
52130,323091,26330,155537,16310,296761,863,389,474
52135,323122,26332,155552,16312,296790,863,389,474
52140,323153,26333,155561,16313,296820,863,389,474
52145,323184,26335,155575,16314,296849,863,389,474
52150,323215,26338,155585,16316,296877,863,389,474
52155,323246,26340,155601,16317,296906,863,389,474
52160,323277,26343,155618,16318,296934,863,389,474
52165,323308,26345,155634,16320,296963,863,389,474
52170,323339,26348,155647,16322,296991,863,389,474
52175,323370,26350,155660,16322,297020,863,389,474
52180,323401,26352,155676,16323,297049,863,389,474
52185,323432,26354,155692,16323,297078,863,389,474
52190,323463,26358,155708,16324,297105,863,389,474
52195,323494,26361,155725,16324,297132,863,389,474
52200,323525,26367,155743,16327,297156,863,389,474
52205,323556,26372,155756,16332,297184,863,389,474
52210,323587,26375,155778,16334,297212,863,389,474
52215,323618,26378,155793,16336,297240,863,389,474
52220,323649,26380,155809,16338,297269,863,389,474
52225,323680,26383,155826,16341,297297,863,389,474
52230,323711,26385,155841,16343,297326,863,389,474
52235,323742,26388,155856,16345,297354,863,389,474
52240,323773,26391,155872,16346,297382,863,389,474
52245,323804,26393,155890,16347,297410,863,389,474
52250,323835,26397,155901,16349,297438,863,389,474
52255,323866,26399,155917,16349,297466,863,389,474
52260,323897,26402,155930,16351,297495,863,389,474
52265,323928,26404,155946,16351,297524,863,389,474
52270,323959,26406,155965,16352,297553,863,389,474
52275,323990,26408,155980,16353,297582,863,389,474
52280,324021,26410,155994,16353,297611,863,389,474
52285,324052,26412,156008,16354,297640,863,389,474
52290,324083,26414,156021,16354,297669,863,389,474
52295,324114,26416,156033,16355,297698,863,389,474
52300,324145,26418,156048,16356,297727,863,389,474
52305,324176,26421,156063,16359,297755,863,389,474
52310,324207,26427,156083,16364,297780,863,389,474
52315,324238,26431,156100,16366,297807,863,389,474
52320,324269,26435,156112,16370,297834,863,389,474
52325,324300,26437,156127,16370,297863,863,389,474
52330,324331,26440,156138,16372,297891,863,389,474
52335,324362,26443,156150,16374,297919,863,389,474
52340,324393,26446,156162,16376,297947,863,389,474
52345,324424,26449,156180,16378,297975,863,389,474
52350,324455,26452,156195,16381,298003,863,389,474
52355,324486,26455,156210,16383,298031,863,389,474
52360,324517,26457,156225,16384,298060,863,389,474
52365,324548,26460,156238,16386,298088,863,389,474
52370,324579,26461,156255,16387,298118,863,389,474
52375,324610,26462,156267,16388,298148,863,389,474
52380,324641,26463,156281,16389,298178,863,389,474
52385,324672,26464,156296,16389,298208,863,389,474
52390,324703,26466,156314,16391,298237,863,389,474
52395,324734,26467,156328,16392,298267,863,389,474
52400,324765,26468,156340,16393,298297,863,389,474
52405,324796,26470,156356,16394,298326,863,389,474
52410,324827,26472,156373,16396,298355,863,389,474
52415,324858,26473,156391,16397,298385,863,389,474
52420,324889,26474,156409,16398,298415,863,389,474
52425,324920,26476,156419,16399,298444,863,389,474
52430,324951,26479,156436,16402,298471,863,389,474
52435,324982,26484,156447,16405,298498,863,389,474
52440,325013,26487,156464,16406,298525,863,389,474
52445,325044,26490,156480,16409,298552,863,389,474
52450,325075,26496,156497,16415,298578,863,389,474
52455,325106,26501,156516,16419,298604,863,389,474
52460,325137,26503,156529,16421,298634,863,389,474
52465,325168,26504,156546,16422,298664,863,389,474
52470,325199,26506,156561,16424,298692,863,389,474
52475,325230,26510,156575,16427,298720,863,389,474
52480,325261,26512,156589,16429,298749,863,389,474
52485,325292,26516,156606,16433,298776,863,389,474
52490,325323,26518,156625,16435,298805,863,389,474
52495,325354,26520,156641,16437,298834,863,389,474
52500,325385,26522,156653,16438,298863,863,389,474
52505,325416,26523,156666,16438,298893,863,389,474
52510,325447,26524,156681,16439,298923,863,389,474
52515,325478,26525,156695,16440,298953,863,389,474
52520,325509,26526,156714,16441,298983,863,389,474
52525,325540,26528,156726,16443,299012,863,389,474
52530,325571,26529,156740,16443,299042,863,389,474
52535,325602,26531,156757,16444,299071,863,389,474
52540,325633,26532,156775,16444,299101,863,389,474
52545,325664,26533,156791,16444,299131,863,389,474
52550,325695,26536,156805,16447,299159,863,389,474
52555,325726,26539,156818,16449,299186,863,389,474
52560,325757,26543,156835,16452,299213,863,389,474
52565,325788,26548,156849,16457,299240,863,389,474
52570,325819,26552,156864,16460,299267,863,389,474
52575,325850,26555,156877,16460,299295,863,389,474
52580,325881,26561,156890,16464,299320,863,389,474
52585,325912,26565,156907,16465,299347,863,389,474
52590,325943,26570,156926,16469,299373,863,389,474
52595,325974,26572,156946,16470,299402,863,389,474
52600,326005,26574,156961,16471,299431,863,389,474
52605,326036,26576,156979,16473,299460,863,389,474
52610,326067,26578,156994,16473,299489,863,389,474
52615,326098,26580,157009,16474,299517,863,389,474
52620,326129,26583,157023,16476,299546,863,389,474
52625,326160,26589,157037,16479,299571,863,389,474
52630,326191,26593,157054,16482,299598,863,389,474
52635,326222,26598,157070,16487,299624,863,389,474
52640,326253,26604,157090,16491,299649,863,389,474
52645,326284,26609,157106,16495,299675,863,389,474
52650,326315,26614,157119,16497,299701,863,389,474
52655,326346,26620,157137,16501,299726,863,389,474
52660,326377,26624,157153,16502,299753,863,389,474
52665,326408,26628,157165,16503,299780,863,389,474
52670,326439,26633,157178,16508,299806,863,389,474
52675,326470,26637,157190,16511,299832,863,389,474
52680,326501,26642,157203,16514,299859,863,389,474
52685,326532,26643,157219,16514,299889,863,389,474
52690,326563,26644,157232,16515,299919,863,389,474
52695,326594,26645,157248,16516,299949,863,389,474
52700,326625,26646,157260,16516,299979,863,389,474
52705,326656,26647,157270,16517,300009,863,389,474
52710,326687,26648,157282,16517,300039,863,389,474
52715,326718,26649,157299,16518,300069,863,389,474
52720,326749,26650,157312,16518,300099,863,389,474
52725,326780,26651,157326,16519,300129,863,389,474
52730,326811,26652,157337,16519,300159,863,389,474
52735,326842,26654,157353,16520,300187,863,389,474
52740,326873,26656,157369,16522,300217,863,389,474
52745,326904,26656,157381,16522,300248,863,389,474
52750,326935,26656,157394,16522,300279,863,389,474
52755,326966,26656,157411,16522,300310,863,389,474
52760,326997,26656,157427,16522,300341,863,389,474
52765,327028,26656,157447,16522,300372,863,389,474
52770,327059,26656,157459,16522,300403,863,389,474
52775,327090,26656,157473,16522,300434,863,389,474
52780,327121,26656,157485,16522,300465,863,389,474
52785,327152,26656,157499,16522,300496,863,389,474
52790,327183,26658,157509,16522,300525,863,389,474
52795,327214,26663,157523,16525,300551,863,389,474
52800,327245,26668,157534,16527,300577,863,389,474
52805,327276,26672,157544,16529,300604,863,389,474
52810,327307,26676,157560,16532,300631,863,389,474
52815,327338,26682,157575,16536,300656,863,389,474
52820,327369,26686,157592,16540,300683,863,389,474
52825,327400,26691,157607,16544,300709,863,389,474
52830,327431,26696,157623,16546,300735,863,389,474
52835,327462,26700,157634,16548,300762,863,389,474
52840,327493,26703,157652,16550,300790,863,389,474
52845,327524,26706,157664,16551,300818,863,389,474
52850,327555,26709,157675,16553,300845,863,389,474
52855,327586,26714,157690,16557,300872,863,389,474
52860,327617,26718,157708,16560,300898,863,389,474
52865,327648,26721,157726,16562,300926,863,389,474
52870,327679,26724,157740,16563,300954,863,389,474
52875,327710,26727,157754,16566,300983,863,389,474
52880,327741,26729,157772,16568,301012,863,389,474
52885,327772,26731,157786,16570,301041,863,389,474
52890,327803,26733,157799,16571,301070,863,389,474
52895,327834,26735,157815,16571,301099,863,389,474
52900,327865,26737,157831,16571,301127,863,389,474
52905,327896,26740,157848,16573,301155,863,389,474
52910,327927,26743,157863,16575,301183,863,389,474
52915,327958,26746,157877,16577,301212,863,389,474
52920,327989,26748,157892,16578,301240,863,389,474
52925,328020,26751,157913,16581,301268,863,389,474
52930,328051,26754,157925,16582,301297,863,389,474
52935,328082,26756,157938,16583,301326,863,389,474
52940,328113,26758,157952,16584,301355,863,389,474
52945,328144,26761,157967,16585,301383,863,389,474
52950,328175,26764,157978,16585,301411,863,389,474
52955,328206,26767,157993,16587,301439,863,389,474
52960,328237,26770,158007,16588,301467,863,389,474
52965,328268,26773,158027,16589,301495,863,389,474
52970,328299,26776,158041,16591,301523,863,389,474
52975,328330,26778,158058,16593,301552,863,389,474
52980,328361,26781,158071,16595,301580,863,389,474
52985,328392,26785,158087,16599,301607,863,389,474
52990,328423,26788,158105,16601,301635,863,389,474
52995,328454,26791,158116,16602,301663,863,389,474
53000,328485,26795,158131,16604,301690,863,389,474
53005,328516,26799,158148,16606,301717,863,389,474
53010,328547,26804,158161,16608,301743,863,389,474
53015,328578,26809,158179,16612,301769,863,389,474
53020,328609,26814,158197,16616,301795,863,389,474
53025,328640,26818,158210,16619,301822,863,389,474
53030,328671,26822,158224,16622,301849,863,389,474
53035,328702,26825,158237,16625,301877,863,389,474
53040,328733,26828,158250,16625,301905,863,389,474
53045,328764,26828,158264,16625,301936,863,389,474
53050,328795,26828,158283,16625,301967,863,389,474
53055,328826,26828,158294,16625,301998,863,389,474
53060,328857,26828,158306,16625,302029,863,389,474
53065,328888,26828,158323,16625,302060,863,389,474
53070,328919,26828,158338,16625,302091,863,389,474
53075,328950,26829,158355,16626,302121,863,389,474
53080,328981,26830,158364,16626,302151,863,389,474
53085,329012,26831,158384,16626,302181,863,389,474
53090,329043,26832,158400,16627,302211,863,389,474
53095,329074,26833,158415,16627,302241,863,389,474
53100,329105,26834,158431,16628,302271,863,389,474
53105,329136,26836,158446,16629,302300,863,389,474
53110,329167,26838,158462,16630,302328,863,389,474
53115,329198,26841,158481,16633,302356,863,389,474
53120,329229,26844,158497,16635,302384,863,389,474
53125,329260,26847,158510,16637,302412,863,389,474
53130,329291,26850,158525,16639,302440,863,389,474
53135,329322,26853,158539,16642,302469,863,389,474
53140,329353,26855,158553,16644,302497,863,389,474
53145,329384,26859,158568,16646,302525,863,389,474
53150,329415,26863,158587,16649,302552,863,389,474
53155,329446,26870,158605,16654,302576,863,389,474
53160,329477,26876,158620,16660,302600,863,389,474
53165,329508,26880,158634,16662,302628,863,389,474
53170,329539,26884,158648,16664,302655,863,389,474
53175,329570,26886,158661,16664,302684,863,389,474
53180,329601,26889,158676,16667,302712,863,389,474
53185,329632,26891,158692,16669,302741,863,389,474
53190,329663,26894,158711,16671,302769,863,389,474
53195,329694,26897,158726,16673,302797,863,389,474
53200,329725,26899,158741,16673,302826,863,389,474
53205,329756,26900,158754,16673,302856,863,389,474
53210,329787,26901,158774,16674,302886,863,389,474
53215,329818,26902,158785,16674,302916,863,389,474
53220,329849,26903,158802,16675,302946,863,389,474
53225,329880,26905,158819,16676,302975,863,389,474
53230,329911,26907,158835,16678,303004,863,389,474
53235,329942,26908,158849,16679,303034,863,389,474
53240,329973,26909,158859,16679,303064,863,389,474
53245,330004,26910,158873,16679,303094,863,389,474
53250,330035,26911,158890,16680,303124,863,389,474
53255,330066,26913,158907,16682,303153,863,389,474
53260,330097,26914,158921,16683,303182,863,389,474
53265,330128,26916,158934,16685,303212,863,389,474
53270,330159,26917,158948,16685,303242,863,389,474
53275,330190,26918,158968,16686,303271,863,389,474
53280,330221,26920,158982,16687,303301,863,389,474
53285,330252,26923,158994,16689,303329,863,389,474
53290,330283,26926,159007,16690,303357,863,389,474
53295,330314,26929,159017,16690,303385,863,389,474
53300,330345,26932,159031,16690,303413,863,389,474
53305,330376,26935,159045,16691,303441,863,389,474
53310,330407,26938,159061,16694,303469,863,389,474
53315,330438,26941,159075,16695,303497,863,389,474
53320,330469,26944,159093,16696,303525,863,389,474
53325,330500,26947,159109,16698,303553,863,389,474
53330,330531,26953,159126,16702,303577,863,389,474
53335,330562,26957,159138,16705,303605,863,389,474
53340,330593,26962,159158,16708,303631,863,389,474
53345,330624,26966,159173,16710,303657,863,389,474
53350,330655,26972,159187,16715,303683,863,389,474
53355,330686,26976,159205,16718,303709,863,389,474
53360,330717,26981,159218,16720,303736,863,389,474
53365,330748,26985,159231,16723,303762,863,389,474
53370,330779,26989,159243,16725,303789,863,389,474
53375,330810,26993,159255,16727,303817,863,389,474
53380,330841,26996,159268,16728,303844,863,389,474
53385,330872,26999,159287,16731,303872,863,389,474
53390,330903,27002,159297,16733,303901,863,389,474
53395,330934,27002,159310,16733,303932,863,389,474
53400,330965,27002,159325,16733,303963,863,389,474
53405,330996,27003,159339,16734,303993,863,389,474
53410,331027,27004,159351,16734,304023,863,389,474
53415,331058,27005,159367,16735,304053,863,389,474
53420,331089,27007,159383,16736,304082,863,389,474
53425,331120,27008,159400,16737,304112,863,389,474
53430,331151,27009,159415,16738,304142,863,389,474
53435,331182,27012,159434,16741,304170,863,389,474
53440,331213,27013,159447,16742,304200,863,389,474
53445,331244,27015,159464,16743,304229,863,389,474
53450,331275,27017,159478,16744,304258,863,389,474
53455,331306,27019,159492,16745,304287,863,389,474
53460,331337,27021,159508,16747,304316,863,389,474
53465,331368,27024,159523,16749,304344,863,389,474
53470,331399,27027,159537,16751,304372,863,389,474
53475,331430,27029,159551,16753,304401,863,389,474
53480,331461,27031,159560,16753,304430,863,389,474
53485,331492,27033,159573,16753,304459,863,389,474
53490,331523,27036,159588,16755,304487,863,389,474
53495,331554,27041,159607,16759,304513,863,389,474
53500,331585,27047,159619,16762,304538,863,389,474
53505,331616,27052,159631,16765,304562,863,389,474
53510,331647,27059,159643,16771,304588,863,389,474
53515,331678,27064,159661,16773,304613,863,389,474
53520,331709,27070,159674,16777,304638,863,389,474
53525,331740,27074,159689,16780,304664,863,389,474
53530,331771,27077,159705,16782,304693,863,389,474
53535,331802,27079,159722,16783,304723,863,389,474
53540,331833,27080,159741,16783,304752,863,389,474
53545,331864,27082,159758,16784,304782,863,389,474
53550,331895,27083,159774,16785,304812,863,389,474
53555,331926,27084,159790,16786,304842,863,389,474
53560,331957,27085,159802,16787,304872,863,389,474
53565,331988,27086,159820,16788,304902,863,389,474
53570,332019,27087,159839,16789,304932,863,389,474
53575,332050,27088,159858,16790,304962,863,389,474
53580,332081,27089,159874,16790,304992,863,389,474
53585,332112,27090,159888,16790,305022,863,389,474
53590,332143,27091,159902,16790,305052,863,389,474
53595,332174,27092,159918,16790,305082,863,389,474
53600,332205,27093,159930,16790,305112,863,389,474
53605,332236,27094,159941,16791,305142,863,389,474
53610,332267,27095,159953,16791,305172,863,389,474
53615,332298,27096,159967,16792,305202,863,389,474
53620,332329,27097,159980,16793,305232,863,389,474
53625,332360,27099,159996,16794,305261,863,389,474
53630,332391,27102,160012,16797,305289,863,389,474
53635,332422,27109,160026,16801,305313,863,389,474
53640,332453,27113,160041,16803,305340,863,389,474
53645,332484,27119,160060,16808,305365,863,389,474
53650,332515,27122,160072,16811,305393,863,389,474
53655,332546,27124,160089,16812,305422,863,389,474
53660,332577,27126,160106,16813,305451,863,389,474
53665,332608,27128,160123,16814,305480,863,389,474
53670,332639,27130,160136,16814,305509,863,389,474
53675,332670,27133,160148,16815,305537,863,389,474
53680,332701,27136,160162,16817,305565,863,389,474
53685,332732,27138,160178,16818,305594,863,389,474
53690,332763,27141,160195,16819,305622,863,389,474
53695,332794,27144,160213,16821,305650,863,389,474
53700,332825,27147,160229,16823,305678,863,389,474
53705,332856,27149,160243,16824,305707,863,389,474
53710,332887,27150,160261,16825,305737,863,389,474
53715,332918,27151,160274,16825,305767,863,389,474
53720,332949,27152,160288,16825,305797,863,389,474
53725,332980,27153,160299,16825,305827,863,389,474
53730,333011,27154,160312,16826,305857,863,389,474
53735,333042,27155,160327,16827,305887,863,389,474
53740,333073,27157,160341,16828,305916,863,389,474
53745,333104,27159,160358,16829,305945,863,389,474
53750,333135,27161,160369,16830,305974,863,389,474
53755,333166,27165,160386,16833,306000,863,389,474
53760,333197,27169,160402,16835,306027,863,389,474
53765,333228,27174,160415,16839,306054,863,389,474
53770,333259,27176,160426,16839,306082,863,389,474
53775,333290,27180,160447,16842,306109,863,389,474
53780,333321,27182,160458,16843,306139,863,389,474
53785,333352,27183,160473,16843,306169,863,389,474
53790,333383,27185,160486,16845,306198,863,389,474
53795,333414,27187,160503,16846,306227,863,389,474
53800,333445,27188,160512,16846,306257,863,389,474
53805,333476,27189,160527,16846,306287,863,389,474
53810,333507,27190,160543,16847,306317,863,389,474
53815,333538,27191,160558,16847,306347,863,389,474
53820,333569,27192,160576,16847,306377,863,389,474
53825,333600,27193,160590,16847,306407,863,389,474
53830,333631,27195,160604,16848,306436,863,389,474
53835,333662,27195,160622,16848,306467,863,389,474
53840,333693,27195,160643,16848,306498,863,389,474
53845,333724,27195,160654,16848,306529,863,389,474
53850,333755,27195,160667,16848,306560,863,389,474
53855,333786,27195,160685,16848,306591,863,389,474
53860,333817,27195,160699,16848,306622,863,389,474
53865,333848,27196,160709,16848,306652,863,389,474
53870,333879,27197,160725,16849,306682,863,389,474
53875,333910,27200,160739,16850,306710,863,389,474
53880,333941,27202,160752,16851,306739,863,389,474
53885,333972,27208,160768,16856,306764,863,389,474
53890,334003,27213,160785,16859,306790,863,389,474
53895,334034,27218,160803,16862,306815,863,389,474
53900,334065,27224,160818,16865,306840,863,389,474
53905,334096,27229,160830,16868,306866,863,389,474
53910,334127,27233,160841,16870,306894,863,389,474
53915,334158,27236,160857,16871,306922,863,389,474
53920,334189,27239,160877,16872,306949,863,389,474
53925,334220,27243,160893,16874,306976,863,389,474
53930,334251,27247,160906,16876,307003,863,389,474
53935,334282,27251,160920,16878,307031,863,389,474
53940,334313,27254,160934,16879,307058,863,389,474
53945,334344,27258,160945,16883,307086,863,389,474
53950,334375,27260,160960,16884,307115,863,389,474
53955,334406,27262,160969,16886,307144,863,389,474
53960,334437,27265,160986,16889,307172,863,389,474
53965,334468,27267,161003,16890,307201,863,389,474
53970,334499,27268,161017,16890,307231,863,389,474
53975,334530,27269,161032,16890,307261,863,389,474
53980,334561,27270,161049,16891,307291,863,389,474
53985,334592,27271,161067,16892,307321,863,389,474
53990,334623,27272,161080,16892,307351,863,389,474
53995,334654,27275,161095,16894,307379,863,389,474
54000,334685,27276,161110,16895,307409,863,389,474
54005,334716,27279,161125,16896,307437,864,390,474
54010,334747,27283,161141,16898,307463,865,391,474
54015,334778,27289,161154,16903,307488,866,392,474
54020,334809,27294,161166,16906,307514,867,392,475
54025,334840,27298,161179,16909,307541,868,392,476
54030,334871,27302,161191,16911,307568,869,392,477
54035,334902,27306,161202,16914,307596,870,392,478
54040,334933,27308,161222,16915,307624,871,393,478
54045,334964,27311,161239,16917,307653,872,394,478
54050,334995,27313,161249,16917,307682,872,394,478
54055,335026,27316,161266,16920,307710,872,394,478
54060,335057,27318,161284,16922,307739,872,394,478
54065,335088,27320,161297,16924,307768,872,394,478
54070,335119,27321,161310,16924,307798,872,394,478
54075,335150,27322,161326,16924,307828,872,394,478
54080,335181,27323,161346,16924,307858,872,394,478
54085,335212,27324,161367,16925,307888,872,394,478
54090,335243,27325,161385,16925,307918,872,394,478
54095,335274,27326,161398,16925,307948,872,394,478
54100,335305,27327,161415,16925,307978,872,394,478
54105,335336,27328,161429,16925,308008,872,394,478
54110,335367,27329,161445,16925,308038,872,394,478
54115,335398,27330,161459,16926,308068,872,394,478
54120,335429,27331,161473,16926,308098,872,394,478
54125,335460,27332,161484,16926,308128,872,394,478
54130,335491,27335,161500,16927,308156,872,394,478
54135,335522,27338,161513,16929,308184,872,394,478
54140,335553,27340,161526,16930,308213,872,394,478
54145,335584,27342,161538,16931,308242,872,394,478
54150,335615,27345,161550,16933,308270,872,394,478
54155,335646,27348,161564,16935,308298,872,394,478
54160,335677,27351,161581,16937,308325,872,394,478
54165,335708,27356,161595,16941,308352,873,395,478
54170,335739,27362,161611,16945,308377,874,396,478
54175,335770,27369,161630,16951,308401,875,396,479
54180,335801,27376,161648,16957,308424,876,397,479
54185,335832,27380,161661,16961,308452,876,397,479
54190,335863,27383,161679,16963,308480,876,397,479
54195,335894,27385,161697,16964,308508,876,397,479
54200,335925,27389,161710,16967,308535,876,397,479
54205,335956,27392,161724,16970,308564,876,397,479
54210,335987,27394,161740,16970,308593,876,397,479
54215,336018,27396,161756,16970,308621,876,397,479
54220,336049,27399,161769,16973,308650,876,397,479
54225,336080,27401,161786,16974,308678,876,397,479
54230,336111,27403,161802,16976,308708,876,397,479
54235,336142,27404,161820,16977,308738,876,397,479
54240,336173,27405,161836,16978,308768,876,397,479
54245,336204,27409,161850,16981,308794,877,398,479
54250,336235,27413,161867,16984,308822,878,399,479
54255,336266,27416,161879,16986,308850,879,400,479
54260,336297,27418,161893,16986,308879,879,400,479
54265,336328,27420,161912,16987,308908,879,400,479
54270,336359,27422,161923,16988,308937,879,400,479
54275,336390,27424,161938,16989,308966,879,400,479
54280,336421,27426,161951,16990,308995,879,400,479
54285,336452,27429,161961,16992,309023,879,400,479
54290,336483,27433,161977,16995,309050,879,400,479
54295,336514,27436,161990,16996,309078,879,400,479
54300,336545,27440,162000,16998,309105,879,400,479
54305,336576,27442,162019,17000,309134,879,400,479
54310,336607,27445,162036,17002,309162,879,400,479
54315,336638,27448,162055,17004,309190,879,400,479
54320,336669,27451,162077,17006,309218,879,400,479
54325,336700,27453,162092,17007,309247,879,400,479
54330,336731,27456,162106,17010,309275,879,400,479
54335,336762,27458,162120,17012,309304,879,400,479
54340,336793,27460,162130,17013,309333,879,400,479
54345,336824,27462,162146,17013,309362,879,400,479
54350,336855,27464,162154,17014,309391,879,400,479
54355,336886,27467,162167,17016,309419,879,400,479
54360,336917,27469,162177,17018,309448,879,400,479
54365,336948,27474,162197,17023,309474,880,400,480
54370,336979,27476,162210,17024,309502,881,400,481
54375,337010,27481,162223,17028,309529,881,400,481
54380,337041,27482,162238,17028,309559,881,400,481
54385,337072,27483,162254,17028,309589,881,400,481
54390,337103,27484,162272,17028,309619,881,400,481
54395,337134,27485,162286,17028,309649,881,400,481
54400,337165,27486,162301,17029,309679,881,400,481
54405,337196,27487,162316,17030,309709,881,400,481
54410,337227,27488,162330,17031,309739,881,400,481
54415,337258,27489,162346,17032,309769,881,400,481
54420,337289,27490,162361,17032,309799,881,400,481
54425,337320,27491,162376,17032,309829,881,400,481
54430,337351,27492,162391,17033,309859,881,400,481
54435,337382,27493,162403,17033,309889,881,400,481
54440,337413,27494,162420,17034,309919,881,400,481
54445,337444,27495,162431,17034,309949,881,400,481
54450,337475,27496,162444,17034,309979,881,400,481
54455,337506,27497,162457,17035,310009,881,400,481
54460,337537,27498,162476,17036,310039,881,400,481
54465,337568,27500,162494,17037,310068,881,400,481
54470,337599,27502,162508,17038,310097,881,400,481
54475,337630,27506,162524,17041,310123,881,400,481
54480,337661,27510,162537,17044,310151,881,400,481
54485,337692,27513,162554,17046,310179,881,400,481
54490,337723,27519,162567,17050,310204,881,400,481
54495,337754,27524,162583,17054,310230,881,400,481
54500,337785,27528,162591,17055,310257,881,400,481
54505,337816,27532,162607,17058,310284,881,400,481
54510,337847,27536,162620,17061,310311,881,400,481
54515,337878,27538,162634,17061,310340,881,400,481
54520,337909,27540,162647,17063,310369,881,400,481
54525,337940,27542,162661,17063,310398,881,400,481
54530,337971,27544,162674,17063,310427,881,400,481
54535,338002,27546,162688,17063,310456,881,400,481
54540,338033,27548,162704,17064,310485,881,400,481
54545,338064,27550,162721,17066,310514,881,400,481
54550,338095,27551,162733,17067,310544,881,400,481
54555,338126,27552,162749,17067,310574,881,400,481
54560,338157,27553,162765,17068,310604,881,400,481
54565,338188,27554,162780,17069,310634,881,400,481
54570,338219,27555,162793,17070,310664,881,400,481
54575,338250,27556,162805,17070,310694,881,400,481
54580,338281,27557,162821,17071,310724,881,400,481
54585,338312,27558,162842,17072,310754,881,400,481
54590,338343,27560,162856,17073,310783,881,400,481
54595,338374,27562,162870,17075,310812,881,400,481
54600,338405,27565,162885,17077,310839,881,400,481
54605,338436,27567,162896,17078,310869,881,400,481
54610,338467,27568,162914,17078,310899,881,400,481
54615,338498,27570,162925,17078,310928,881,400,481
54620,338529,27573,162939,17079,310956,881,400,481
54625,338560,27575,162955,17081,310985,881,400,481
54630,338591,27577,162970,17082,311014,881,400,481
54635,338622,27580,162986,17084,311042,881,400,481
54640,338653,27582,163004,17086,311071,881,400,481
54645,338684,27584,163021,17087,311100,881,400,481
54650,338715,27588,163039,17091,311126,881,400,481
54655,338746,27592,163059,17094,311154,881,400,481
54660,338777,27595,163076,17096,311181,881,400,481
54665,338808,27600,163092,17099,311208,881,400,481
54670,338839,27605,163106,17102,311234,881,400,481
54675,338870,27609,163122,17104,311261,881,400,481
54680,338901,27613,163139,17105,311288,881,400,481
54685,338932,27617,163150,17106,311315,881,400,481
54690,338963,27622,163167,17110,311341,881,400,481
54695,338994,27627,163181,17114,311367,881,400,481
54700,339025,27633,163200,17117,311392,881,400,481
54705,339056,27640,163221,17123,311416,881,400,481
54710,339087,27644,163234,17126,311443,881,400,481
54715,339118,27649,163248,17129,311469,881,400,481
54720,339149,27653,163266,17131,311495,881,400,481
54725,339180,27656,163284,17134,311524,881,400,481
54730,339211,27658,163299,17136,311553,881,400,481
54735,339242,27660,163314,17137,311582,881,400,481
54740,339273,27661,163328,17137,311612,881,400,481
54745,339304,27663,163348,17139,311641,881,400,481
54750,339335,27664,163361,17140,311671,881,400,481
54755,339366,27665,163378,17141,311701,881,400,481
54760,339397,27666,163393,17142,311731,881,400,481
54765,339428,27667,163405,17143,311761,881,400,481
54770,339459,27669,163420,17145,311789,881,400,481
54775,339490,27672,163432,17148,311818,881,400,481
54780,339521,27672,163446,17148,311849,881,400,481
54785,339552,27674,163458,17149,311878,881,400,481
54790,339583,27675,163473,17150,311908,882,400,482
54795,339614,27677,163492,17152,311937,883,400,483
54800,339645,27679,163511,17154,311966,883,400,483
54805,339676,27680,163524,17155,311996,883,400,483
54810,339707,27681,163538,17156,312026,883,400,483
54815,339738,27684,163555,17158,312054,883,400,483
54820,339769,27687,163567,17159,312082,883,400,483
54825,339800,27690,163579,17161,312110,883,400,483
54830,339831,27693,163596,17163,312138,883,400,483
54835,339862,27697,163611,17166,312165,883,400,483
54840,339893,27701,163626,17168,312192,883,400,483
54845,339924,27705,163641,17170,312219,883,400,483
54850,339955,27709,163653,17172,312246,883,400,483
54855,339986,27713,163669,17175,312273,883,400,483
54860,340017,27717,163685,17177,312300,883,400,483
54865,340048,27720,163699,17179,312328,883,400,483
54870,340079,27724,163710,17181,312355,883,400,483
54875,340110,27727,163726,17183,312383,883,400,483
54880,340141,27731,163737,17186,312410,883,400,483
54885,340172,27735,163750,17187,312437,883,400,483
54890,340203,27739,163765,17189,312464,883,400,483
54895,340234,27743,163778,17189,312490,883,400,483
54900,340265,27751,163796,17194,312514,884,400,484
54905,340296,27755,163811,17197,312541,884,400,484
54910,340327,27758,163825,17200,312569,884,400,484
54915,340358,27758,163840,17200,312600,884,400,484
54920,340389,27758,163853,17200,312631,884,400,484
54925,340420,27758,163866,17200,312662,884,400,484
54930,340451,27758,163882,17200,312693,884,400,484
54935,340482,27758,163896,17200,312724,884,400,484
54940,340513,27758,163919,17200,312755,884,400,484
54945,340544,27758,163934,17200,312786,884,400,484
54950,340575,27758,163946,17200,312817,884,400,484
54955,340606,27758,163961,17200,312848,884,400,484
54960,340637,27758,163976,17200,312879,884,400,484
54965,340668,27758,163990,17200,312910,884,400,484
54970,340699,27758,164002,17200,312941,884,400,484
54975,340730,27758,164016,17200,312972,884,400,484
54980,340761,27758,164030,17200,313003,884,400,484
54985,340792,27758,164045,17200,313034,884,400,484
54990,340823,27758,164059,17200,313065,884,400,484
54995,340854,27758,164068,17200,313096,884,400,484
55000,340885,27758,164084,17200,313127,884,400,484
55005,340916,27758,164101,17200,313158,884,400,484
55010,340947,27759,164117,17201,313188,884,400,484
55015,340978,27762,164129,17202,313216,885,400,485
55020,341009,27768,164147,17207,313240,886,401,485
55025,341040,27773,164156,17209,313266,886,401,485
55030,341071,27778,164173,17213,313292,886,401,485
55035,341102,27782,164189,17215,313319,886,401,485
55040,341133,27786,164209,17219,313347,886,401,485
55045,341164,27789,164225,17222,313375,886,401,485
55050,341195,27792,164240,17224,313402,886,401,485
55055,341226,27796,164253,17226,313429,886,401,485
55060,341257,27800,164274,17229,313456,886,401,485
55065,341288,27804,164286,17232,313484,886,401,485
55070,341319,27807,164302,17235,313512,886,401,485
55075,341350,27810,164316,17236,313539,886,401,485
55080,341381,27814,164329,17239,313566,886,401,485
55085,341412,27818,164342,17240,313594,886,401,485
55090,341443,27821,164358,17243,313622,886,401,485
55095,341474,27824,164373,17243,313650,886,401,485
55100,341505,27827,164384,17244,313678,886,401,485
55105,341536,27830,164400,17246,313706,886,401,485
55110,341567,27833,164411,17246,313734,886,401,485
55115,341598,27836,164428,17248,313762,886,401,485
55120,341629,27839,164443,17250,313790,886,401,485
55125,341660,27843,164460,17253,313817,886,401,485
55130,341691,27849,164477,17259,313842,886,401,485
55135,341722,27856,164495,17266,313866,886,401,485
55140,341753,27860,164511,17269,313893,886,401,485
55145,341784,27862,164525,17271,313921,886,401,485
55150,341815,27864,164540,17272,313951,886,401,485
55155,341846,27865,164551,17272,313980,886,401,485
55160,341877,27867,164570,17274,314010,886,401,485
55165,341908,27867,164585,17274,314041,886,401,485
55170,341939,27867,164604,17274,314072,886,401,485
55175,341970,27867,164621,17274,314103,886,401,485
55180,342001,27867,164639,17274,314134,886,401,485
55185,342032,27867,164657,17274,314165,886,401,485
55190,342063,27867,164671,17274,314196,886,401,485
55195,342094,27867,164685,17274,314227,886,401,485
55200,342125,27867,164700,17274,314258,886,401,485
55205,342156,27867,164712,17274,314289,886,401,485
55210,342187,27867,164730,17274,314320,886,401,485
55215,342218,27867,164742,17274,314351,886,401,485
55220,342249,27867,164757,17274,314382,886,401,485
55225,342280,27867,164772,17274,314413,886,401,485
55230,342311,27867,164785,17274,314444,887,401,486
55235,342342,27867,164801,17274,314475,888,401,487
55240,342373,27868,164817,17274,314505,889,401,488
55245,342404,27869,164832,17275,314534,890,402,488
55250,342435,27876,164844,17281,314559,890,402,488
55255,342466,27881,164862,17285,314585,890,402,488
55260,342497,27886,164874,17287,314611,890,402,488
55265,342528,27890,164884,17290,314638,890,402,488
55270,342559,27894,164904,17293,314664,890,402,488
55275,342590,27898,164920,17296,314692,890,402,488
55280,342621,27901,164933,17296,314720,890,402,488
55285,342652,27904,164952,17298,314748,890,402,488
55290,342683,27907,164968,17300,314776,890,402,488
55295,342714,27910,164977,17300,314804,890,402,488
55300,342745,27913,164995,17302,314832,890,402,488
55305,342776,27916,165016,17302,314860,890,402,488
55310,342807,27919,165032,17303,314888,890,402,488
55315,342838,27922,165051,17306,314916,890,402,488
55320,342869,27925,165065,17306,314944,890,402,488
55325,342900,27928,165075,17307,314972,890,402,488
55330,342931,27932,165085,17309,314999,890,402,488
55335,342962,27935,165101,17311,315027,890,402,488
55340,342993,27939,165117,17312,315054,890,402,488
55345,343024,27942,165128,17313,315082,890,402,488
55350,343055,27945,165143,17316,315110,890,402,488
55355,343086,27949,165159,17319,315137,890,402,488
55360,343117,27953,165177,17323,315164,890,402,488
55365,343148,27957,165190,17323,315191,890,402,488
55370,343179,27962,165201,17324,315217,890,402,488
55375,343210,27969,165217,17327,315240,890,402,488
55380,343241,27974,165233,17330,315266,890,402,488
55385,343272,27977,165249,17333,315295,890,402,488
55390,343303,27978,165269,17333,315325,890,402,488
55395,343334,27980,165279,17335,315354,890,402,488
55400,343365,27982,165295,17336,315383,890,402,488
55405,343396,27983,165312,17337,315413,890,402,488
55410,343427,27984,165326,17337,315443,890,402,488
55415,343458,27985,165340,17337,315473,890,402,488
55420,343489,27986,165356,17337,315503,890,402,488
55425,343520,27987,165370,17337,315533,890,402,488
55430,343551,27988,165384,17337,315563,890,402,488
55435,343582,27989,165397,17338,315593,890,402,488
55440,343613,27990,165410,17339,315623,890,402,488
55445,343644,27990,165423,17339,315654,890,402,488
55450,343675,27990,165440,17339,315685,890,402,488
55455,343706,27990,165452,17339,315716,890,402,488
55460,343737,27990,165466,17339,315747,890,402,488
55465,343768,27990,165483,17339,315778,890,402,488
55470,343799,27990,165499,17339,315809,890,402,488
55475,343830,27990,165513,17339,315840,890,402,488
55480,343861,27990,165536,17339,315871,890,402,488
55485,343892,27992,165551,17340,315900,890,402,488
55490,343923,27996,165567,17343,315927,890,402,488
55495,343954,28001,165576,17346,315953,890,402,488
55500,343985,28006,165589,17349,315979,890,402,488
55505,344016,28011,165606,17353,316004,890,402,488
55510,344047,28016,165621,17357,316031,890,402,488
55515,344078,28020,165629,17358,316058,890,402,488
55520,344109,28024,165645,17361,316085,890,402,488
55525,344140,28028,165658,17362,316111,890,402,488
55530,344171,28033,165676,17365,316137,890,402,488
55535,344202,28038,165692,17370,316164,890,402,488
55540,344233,28043,165712,17373,316190,890,402,488
55545,344264,28047,165724,17375,316216,890,402,488
55550,344295,28052,165739,17377,316243,890,402,488
55555,344326,28056,165754,17379,316270,890,402,488
55560,344357,28060,165766,17380,316297,890,402,488
55565,344388,28063,165784,17382,316325,890,402,488
55570,344419,28066,165797,17384,316352,890,402,488
55575,344450,28070,165809,17387,316379,890,402,488
55580,344481,28074,165824,17388,316406,890,402,488
55585,344512,28078,165835,17390,316434,890,402,488
55590,344543,28081,165850,17391,316461,890,402,488
55595,344574,28084,165861,17393,316490,890,402,488
55600,344605,28087,165880,17395,316518,891,403,488
55605,344636,28090,165889,17396,316546,892,404,488
55610,344667,28092,165903,17397,316575,892,404,488
55615,344698,28095,165920,17400,316603,892,404,488
55620,344729,28097,165932,17400,316632,892,404,488
55625,344760,28101,165949,17402,316658,892,404,488
55630,344791,28106,165968,17406,316685,892,404,488
55635,344822,28107,165981,17407,316715,892,404,488
55640,344853,28108,165994,17408,316745,892,404,488
55645,344884,28109,166009,17409,316775,892,404,488
55650,344915,28110,166021,17409,316805,892,404,488
55655,344946,28111,166036,17410,316835,892,404,488
55660,344977,28112,166050,17410,316865,892,404,488
55665,345008,28112,166062,17410,316896,892,404,488
55670,345039,28112,166081,17410,316927,892,404,488
55675,345070,28112,166093,17410,316958,892,404,488
55680,345101,28112,166114,17410,316989,892,404,488
55685,345132,28112,166130,17410,317020,892,404,488
55690,345163,28112,166152,17410,317051,892,404,488
55695,345194,28112,166169,17410,317082,892,404,488
55700,345225,28112,166183,17410,317113,892,404,488
55705,345256,28112,166197,17410,317144,892,404,488
55710,345287,28112,166212,17410,317175,892,404,488
55715,345318,28112,166228,17410,317206,892,404,488
55720,345349,28112,166240,17410,317237,892,404,488
55725,345380,28112,166253,17410,317268,892,404,488
55730,345411,28112,166270,17410,317299,892,404,488
55735,345442,28115,166278,17411,317327,892,404,488
55740,345473,28118,166286,17413,317354,892,404,488
55745,345504,28123,166299,17416,317380,892,404,488
55750,345535,28130,166314,17420,317405,892,404,488
55755,345566,28135,166329,17422,317431,892,404,488
55760,345597,28140,166341,17424,317457,892,404,488
55765,345628,28145,166357,17425,317482,892,404,488
55770,345659,28152,166374,17430,317506,892,404,488
55775,345690,28157,166396,17435,317532,892,404,488
55780,345721,28162,166410,17438,317559,892,404,488
55785,345752,28166,166423,17442,317586,892,404,488
55790,345783,28170,166440,17445,317613,892,404,488
55795,345814,28173,166455,17447,317641,892,404,488
55800,345845,28177,166474,17449,317668,892,404,488
55805,345876,28180,166482,17451,317696,892,404,488
55810,345907,28184,166498,17452,317723,892,404,488
55815,345938,28187,166512,17453,317751,892,404,488
55820,345969,28189,166522,17454,317780,892,404,488
55825,346000,28192,166537,17456,317808,892,404,488
55830,346031,28195,166550,17458,317836,892,404,488
55835,346062,28198,166564,17460,317864,892,404,488
55840,346093,28201,166575,17461,317892,892,404,488
55845,346124,28204,166594,17462,317919,892,404,488
55850,346155,28209,166613,17467,317946,892,404,488
55855,346186,28213,166624,17469,317973,892,404,488
55860,346217,28214,166636,17469,318003,892,404,488
55865,346248,28216,166649,17471,318032,892,404,488
55870,346279,28218,166667,17473,318061,892,404,488
55875,346310,28221,166684,17474,318089,892,404,488
55880,346341,28224,166699,17476,318117,892,404,488
55885,346372,28227,166714,17479,318145,892,404,488
55890,346403,28229,166729,17480,318174,892,404,488
55895,346434,28231,166747,17481,318203,892,404,488
55900,346465,28234,166766,17483,318231,892,404,488
55905,346496,28236,166779,17485,318260,892,404,488
55910,346527,28239,166793,17487,318288,892,404,488
55915,346558,28242,166804,17488,318316,892,404,488
55920,346589,28244,166822,17490,318345,892,404,488
55925,346620,28246,166841,17491,318374,892,404,488
55930,346651,28247,166855,17491,318404,892,404,488
55935,346682,28248,166871,17491,318434,892,404,488
55940,346713,28249,166889,17491,318464,892,404,488
55945,346744,28250,166906,17491,318494,892,404,488
55950,346775,28251,166923,17492,318524,892,404,488
55955,346806,28252,166934,17492,318554,892,404,488
55960,346837,28253,166951,17493,318583,892,404,488
55965,346868,28256,166965,17496,318612,892,404,488
55970,346899,28260,166982,17497,318639,892,404,488
55975,346930,28263,166999,17500,318666,892,404,488
55980,346961,28266,167011,17503,318695,893,404,489
55985,346992,28269,167019,17504,318723,893,404,489
55990,347023,28273,167034,17507,318749,893,404,489
55995,347054,28276,167051,17510,318778,893,404,489
56000,347085,28278,167068,17510,318806,893,404,489
56005,347116,28281,167081,17511,318835,893,404,489
56010,347147,28283,167098,17511,318863,893,404,489
56015,347178,28286,167115,17513,318891,893,404,489
56020,347209,28289,167128,17515,318920,893,404,489
56025,347240,28291,167142,17517,318948,893,404,489
56030,347271,28294,167151,17519,318977,893,404,489
56035,347302,28296,167164,17520,319006,893,404,489
56040,347333,28298,167178,17521,319034,893,404,489
56045,347364,28300,167190,17523,319064,893,404,489
56050,347395,28301,167206,17524,319094,893,404,489
56055,347426,28302,167225,17525,319124,893,404,489
56060,347457,28303,167246,17526,319154,893,404,489
56065,347488,28304,167259,17526,319184,893,404,489
56070,347519,28305,167270,17527,319214,893,404,489
56075,347550,28306,167281,17527,319244,893,404,489
56080,347581,28307,167297,17527,319274,893,404,489
56085,347612,28308,167314,17527,319304,893,404,489
56090,347643,28309,167332,17528,319334,893,404,489
56095,347674,28312,167344,17530,319362,894,404,490
56100,347705,28318,167355,17535,319387,895,405,490
56105,347736,28321,167364,17536,319415,895,405,490
56110,347767,28324,167380,17539,319443,895,405,490
56115,347798,28327,167397,17542,319470,895,405,490
56120,347829,28331,167409,17544,319498,895,405,490
56125,347860,28334,167423,17545,319526,895,405,490
56130,347891,28335,167441,17546,319556,895,405,490
56135,347922,28336,167460,17547,319586,895,405,490
56140,347953,28337,167477,17548,319616,895,405,490
56145,347984,28338,167490,17549,319646,895,405,490
56150,348015,28339,167507,17550,319676,895,405,490
56155,348046,28340,167520,17550,319706,895,405,490
56160,348077,28341,167535,17551,319736,895,405,490
56165,348108,28342,167549,17551,319766,895,405,490
56170,348139,28343,167562,17551,319796,895,405,490
56175,348170,28344,167573,17551,319826,895,405,490
56180,348201,28345,167591,17552,319856,895,405,490
56185,348232,28346,167604,17552,319886,895,405,490
56190,348263,28347,167621,17552,319916,895,405,490
56195,348294,28348,167633,17552,319946,895,405,490
56200,348325,28349,167649,17553,319976,895,405,490
56205,348356,28353,167665,17556,320003,895,405,490
56210,348387,28358,167679,17559,320029,895,405,490
56215,348418,28362,167697,17563,320055,895,405,490
56220,348449,28366,167706,17565,320082,895,405,490
56225,348480,28369,167724,17568,320110,895,405,490
56230,348511,28373,167741,17572,320138,895,405,490
56235,348542,28376,167753,17573,320165,895,405,490
56240,348573,28381,167774,17578,320191,895,405,490
56245,348604,28385,167790,17580,320219,895,405,490
56250,348635,28387,167807,17582,320248,895,405,490
56255,348666,28390,167821,17584,320276,895,405,490
56260,348697,28393,167833,17585,320304,895,405,490
56265,348728,28396,167846,17587,320332,895,405,490
56270,348759,28399,167859,17589,320360,895,405,490
56275,348790,28402,167872,17590,320388,895,405,490
56280,348821,28406,167888,17594,320415,895,405,490
56285,348852,28408,167904,17594,320443,895,405,490
56290,348883,28412,167918,17597,320471,895,405,490
56295,348914,28415,167934,17600,320498,895,405,490
56300,348945,28418,167944,17602,320527,895,405,490
56305,348976,28420,167961,17604,320556,895,405,490
56310,349007,28421,167977,17605,320586,895,405,490
56315,349038,28422,167995,17605,320616,895,405,490
56320,349069,28423,168009,17605,320646,895,405,490
56325,349100,28424,168023,17606,320676,895,405,490
56330,349131,28426,168042,17607,320705,895,405,490
56335,349162,28428,168055,17608,320734,895,405,490
56340,349193,28430,168070,17610,320763,895,405,490
56345,349224,28431,168087,17611,320793,895,405,490
56350,349255,28434,168107,17614,320820,895,405,490
56355,349286,28437,168119,17616,320848,895,405,490
56360,349317,28442,168135,17621,320875,895,405,490
56365,349348,28444,168152,17623,320903,895,405,490
56370,349379,28448,168171,17626,320930,895,405,490
56375,349410,28451,168184,17627,320958,895,405,490
56380,349441,28454,168195,17630,320987,895,405,490
56385,349472,28456,168213,17631,321015,895,405,490
56390,349503,28460,168227,17634,321042,895,405,490
56395,349534,28463,168239,17637,321071,895,405,490
56400,349565,28466,168251,17639,321098,895,405,490
56405,349596,28470,168268,17642,321125,895,405,490
56410,349627,28473,168284,17643,321153,895,405,490
56415,349658,28477,168296,17646,321180,895,405,490
56420,349689,28481,168311,17649,321208,895,405,490
56425,349720,28483,168325,17651,321237,895,405,490
56430,349751,28485,168341,17653,321265,895,405,490
56435,349782,28489,168356,17655,321293,895,405,490
56440,349813,28492,168373,17657,321320,895,405,490
56445,349844,28496,168384,17661,321348,895,405,490
56450,349875,28499,168399,17664,321376,895,405,490
56455,349906,28502,168408,17666,321404,895,405,490
56460,349937,28506,168419,17668,321431,895,405,490
56465,349968,28510,168433,17671,321458,895,405,490
56470,349999,28513,168449,17673,321486,895,405,490
56475,350030,28517,168466,17676,321513,895,405,490
56480,350061,28521,168484,17679,321540,895,405,490
56485,350092,28523,168502,17680,321569,895,405,490
56490,350123,28525,168518,17680,321598,895,405,490
56495,350154,28527,168529,17681,321627,895,405,490
56500,350185,28529,168546,17682,321656,895,405,490
56505,350216,28531,168559,17683,321685,895,405,490
56510,350247,28533,168572,17684,321714,895,405,490
56515,350278,28535,168584,17685,321743,895,405,490
56520,350309,28537,168596,17686,321772,895,405,490
56525,350340,28539,168616,17688,321801,895,405,490
56530,350371,28541,168629,17690,321830,895,405,490
56535,350402,28543,168645,17690,321859,895,405,490
56540,350433,28546,168662,17692,321887,895,405,490
56545,350464,28548,168679,17694,321916,895,405,490
56550,350495,28550,168690,17696,321945,895,405,490
56555,350526,28552,168704,17696,321974,895,405,490
56560,350557,28554,168714,17697,322003,895,405,490
56565,350588,28556,168730,17697,322032,895,405,490
56570,350619,28559,168748,17698,322058,895,405,490
56575,350650,28564,168760,17702,322086,895,405,490
56580,350681,28567,168775,17704,322113,895,405,490
56585,350712,28572,168791,17708,322140,895,405,490
56590,350743,28576,168807,17711,322167,895,405,490
56595,350774,28579,168823,17714,322195,895,405,490
56600,350805,28582,168840,17716,322223,895,405,490
56605,350836,28587,168852,17718,322249,895,405,490
56610,350867,28591,168866,17720,322276,895,405,490
56615,350898,28593,168877,17720,322305,895,405,490
56620,350929,28596,168891,17723,322333,895,405,490
56625,350960,28598,168905,17723,322362,895,405,490
56630,350991,28601,168919,17726,322390,895,405,490
56635,351022,28604,168938,17728,322418,895,405,490
56640,351053,28606,168952,17729,322447,895,405,490
56645,351084,28609,168966,17731,322475,895,405,490
56650,351115,28614,168981,17734,322501,895,405,490
56655,351146,28618,168997,17737,322528,895,405,490
56660,351177,28622,169011,17740,322555,895,405,490
56665,351208,28626,169023,17741,322582,895,405,490
56670,351239,28629,169037,17743,322610,895,405,490
56675,351270,28632,169054,17745,322638,895,405,490
56680,351301,28636,169075,17748,322665,895,405,490
56685,351332,28642,169090,17752,322690,895,405,490
56690,351363,28645,169102,17754,322718,895,405,490
56695,351394,28648,169118,17757,322746,895,405,490
56700,351425,28652,169138,17761,322773,895,405,490
56705,351456,28654,169152,17762,322801,895,405,490
56710,351487,28657,169171,17764,322830,895,405,490
56715,351518,28659,169185,17766,322859,895,405,490
56720,351549,28660,169199,17767,322889,895,405,490
56725,351580,28661,169213,17768,322919,895,405,490
56730,351611,28662,169230,17768,322949,895,405,490
56735,351642,28663,169242,17769,322979,895,405,490
56740,351673,28664,169254,17770,323009,895,405,490
56745,351704,28665,169265,17770,323039,895,405,490
56750,351735,28666,169277,17771,323069,895,405,490
56755,351766,28667,169291,17772,323099,895,405,490
56760,351797,28668,169303,17772,323129,895,405,490
56765,351828,28669,169320,17772,323159,895,405,490
56770,351859,28670,169333,17772,323189,895,405,490
56775,351890,28671,169346,17772,323219,895,405,490
56780,351921,28672,169365,17773,323249,895,405,490
56785,351952,28673,169382,17773,323279,895,405,490
56790,351983,28675,169403,17774,323308,895,405,490
56795,352014,28678,169417,17776,323336,895,405,490
56800,352045,28682,169434,17778,323363,895,405,490
56805,352076,28686,169449,17780,323390,895,405,490
56810,352107,28691,169466,17783,323416,895,405,490
56815,352138,28695,169482,17784,323442,895,405,490
56820,352169,28700,169502,17788,323468,895,405,490
56825,352200,28705,169516,17792,323493,895,405,490
56830,352231,28710,169535,17796,323519,895,405,490
56835,352262,28715,169549,17799,323546,895,405,490
56840,352293,28721,169565,17804,323571,895,405,490
56845,352324,28726,169582,17808,323596,895,405,490
56850,352355,28732,169599,17812,323622,895,405,490
56855,352386,28738,169613,17818,323648,895,405,490
56860,352417,28743,169626,17823,323674,895,405,490
56865,352448,28748,169641,17826,323699,895,405,490
56870,352479,28751,169652,17828,323728,895,405,490
56875,352510,28753,169665,17829,323757,895,405,490
56880,352541,28755,169677,17830,323786,895,405,490
56885,352572,28755,169695,17830,323817,895,405,490
56890,352603,28755,169711,17830,323848,895,405,490
56895,352634,28755,169723,17830,323879,895,405,490
56900,352665,28755,169741,17830,323910,895,405,490
56905,352696,28755,169758,17830,323941,895,405,490
56910,352727,28755,169776,17830,323972,895,405,490
56915,352758,28755,169795,17830,324003,895,405,490
56920,352789,28755,169811,17830,324034,895,405,490
56925,352820,28755,169825,17830,324065,895,405,490
56930,352851,28755,169844,17830,324096,895,405,490
56935,352882,28755,169865,17830,324127,895,405,490
56940,352913,28755,169877,17830,324158,895,405,490
56945,352944,28755,169894,17830,324189,895,405,490
56950,352975,28755,169908,17830,324220,895,405,490
56955,353006,28755,169926,17830,324251,895,405,490
56960,353037,28755,169943,17830,324282,895,405,490
56965,353068,28755,169960,17830,324313,895,405,490
56970,353099,28755,169975,17830,324344,895,405,490
56975,353130,28755,169990,17830,324375,895,405,490
56980,353161,28755,170003,17830,324406,895,405,490
56985,353192,28756,170015,17831,324436,895,405,490
56990,353223,28760,170029,17833,324462,895,405,490
56995,353254,28768,170044,17838,324486,895,405,490
57000,353285,28773,170055,17839,324511,895,405,490
57005,353316,28776,170073,17841,324540,895,405,490
57010,353347,28778,170083,17843,324569,895,405,490
57015,353378,28780,170098,17844,324598,895,405,490
57020,353409,28782,170113,17845,324627,895,405,490
57025,353440,28784,170126,17846,324656,895,405,490
57030,353471,28786,170140,17848,324685,895,405,490
57035,353502,28788,170157,17848,324714,895,405,490
57040,353533,28790,170175,17849,324743,895,405,490
57045,353564,28792,170194,17851,324772,895,405,490
57050,353595,28794,170206,17852,324801,895,405,490
57055,353626,28796,170221,17854,324830,895,405,490
57060,353657,28798,170238,17855,324859,895,405,490
57065,353688,28800,170254,17855,324888,895,405,490
57070,353719,28802,170264,17855,324917,895,405,490
57075,353750,28804,170277,17856,324946,895,405,490
57080,353781,28806,170288,17857,324975,895,405,490
57085,353812,28808,170303,17859,325004,895,405,490
57090,353843,28810,170318,17859,325033,895,405,490
57095,353874,28812,170331,17860,325062,895,405,490
57100,353905,28814,170348,17861,325091,895,405,490
57105,353936,28816,170359,17861,325119,895,405,490
57110,353967,28822,170370,17864,325144,895,405,490
57115,353998,28830,170392,17871,325167,896,406,490
57120,354029,28836,170405,17875,325192,897,406,491
57125,354060,28839,170422,17877,325221,897,406,491
57130,354091,28840,170435,17877,325251,897,406,491
57135,354122,28841,170446,17877,325281,897,406,491
57140,354153,28842,170465,17878,325311,897,406,491
57145,354184,28843,170477,17878,325341,897,406,491
57150,354215,28845,170493,17879,325370,897,406,491
57155,354246,28845,170509,17879,325401,897,406,491
57160,354277,28845,170522,17879,325432,897,406,491
57165,354308,28845,170536,17879,325463,897,406,491
57170,354339,28845,170548,17879,325494,897,406,491
57175,354370,28845,170568,17879,325525,897,406,491
57180,354401,28845,170582,17879,325556,897,406,491
57185,354432,28845,170595,17879,325587,897,406,491
57190,354463,28845,170605,17879,325618,897,406,491
57195,354494,28845,170619,17879,325649,897,406,491
57200,354525,28845,170632,17879,325680,897,406,491
57205,354556,28845,170641,17879,325711,897,406,491
57210,354587,28845,170661,17879,325742,897,406,491
57215,354618,28846,170680,17880,325772,897,406,491
57220,354649,28848,170695,17881,325801,897,406,491
57225,354680,28849,170709,17881,325831,897,406,491
57230,354711,28852,170725,17883,325858,898,407,491
57235,354742,28856,170740,17885,325885,899,407,492
57240,354773,28860,170756,17887,325913,900,407,493
57245,354804,28864,170772,17890,325940,900,407,493
57250,354835,28868,170786,17891,325967,900,407,493
57255,354866,28873,170799,17894,325993,900,407,493
57260,354897,28878,170815,17898,326019,900,407,493
57265,354928,28882,170833,17902,326046,900,407,493
57270,354959,28885,170852,17904,326074,900,407,493
57275,354990,28887,170868,17906,326103,900,407,493
57280,355021,28890,170885,17909,326131,900,407,493
57285,355052,28893,170902,17912,326159,900,407,493
57290,355083,28895,170914,17913,326188,900,407,493
57295,355114,28898,170931,17916,326216,900,407,493
57300,355145,28901,170943,17919,326244,900,407,493
57305,355176,28903,170956,17919,326272,900,407,493
57310,355207,28906,170972,17921,326301,900,407,493
57315,355238,28908,170987,17921,326330,900,407,493
57320,355269,28910,171000,17921,326359,900,407,493
57325,355300,28912,171017,17921,326388,900,407,493
57330,355331,28914,171033,17921,326417,900,407,493
57335,355362,28916,171050,17922,326446,900,407,493
57340,355393,28918,171066,17923,326475,900,407,493
57345,355424,28921,171081,17924,326503,900,407,493
57350,355455,28924,171099,17927,326531,900,407,493
57355,355486,28929,171112,17930,326556,900,407,493
57360,355517,28933,171128,17932,326584,900,407,493
57365,355548,28934,171142,17932,326614,900,407,493
57370,355579,28935,171157,17933,326644,900,407,493
57375,355610,28936,171174,17933,326674,900,407,493
57380,355641,28937,171188,17934,326704,900,407,493
57385,355672,28938,171198,17934,326734,900,407,493
57390,355703,28939,171212,17934,326764,900,407,493
57395,355734,28940,171224,17934,326794,900,407,493
57400,355765,28941,171239,17935,326824,900,407,493
57405,355796,28942,171251,17935,326854,900,407,493
57410,355827,28944,171270,17936,326883,900,407,493
57415,355858,28946,171288,17938,326912,900,407,493
57420,355889,28948,171306,17939,326941,900,407,493
57425,355920,28951,171321,17941,326969,900,407,493
57430,355951,28954,171337,17943,326996,900,407,493
57435,355982,28958,171353,17945,327024,900,407,493
57440,356013,28960,171367,17947,327053,900,407,493
57445,356044,28962,171384,17947,327082,900,407,493
57450,356075,28964,171399,17948,327111,900,407,493
57455,356106,28966,171415,17950,327140,900,407,493
57460,356137,28968,171427,17952,327169,900,407,493
57465,356168,28971,171441,17955,327197,900,407,493
57470,356199,28974,171456,17956,327225,900,407,493
57475,356230,28978,171469,17959,327252,900,407,493
57480,356261,28983,171483,17963,327278,900,407,493
57485,356292,28986,171495,17966,327306,900,407,493
57490,356323,28989,171506,17967,327334,900,407,493
57495,356354,28993,171518,17969,327361,900,407,493
57500,356385,28996,171530,17970,327389,900,407,493
57505,356416,28999,171547,17972,327417,900,407,493
57510,356447,29003,171557,17974,327444,900,407,493
57515,356478,29007,171575,17977,327471,900,407,493
57520,356509,29011,171595,17978,327498,900,407,493
57525,356540,29014,171612,17980,327526,900,407,493
57530,356571,29017,171623,17982,327553,900,407,493
57535,356602,29021,171640,17986,327581,900,407,493
57540,356633,29025,171651,17989,327608,900,407,493
57545,356664,29026,171663,17989,327638,900,407,493
57550,356695,29028,171672,17990,327667,900,407,493
57555,356726,29029,171688,17991,327697,900,407,493
57560,356757,29030,171698,17991,327727,900,407,493
57565,356788,29031,171714,17992,327757,900,407,493
57570,356819,29032,171727,17992,327787,900,407,493
57575,356850,29033,171743,17993,327817,900,407,493
57580,356881,29034,171762,17993,327847,900,407,493
57585,356912,29035,171781,17993,327877,900,407,493
57590,356943,29037,171798,17995,327906,900,407,493
57595,356974,29039,171812,17996,327935,900,407,493
57600,357005,29041,171824,17997,327964,900,407,493
57605,357036,29045,171840,17999,327990,900,407,493
57610,357067,29050,171852,18002,328016,900,407,493
57615,357098,29054,171868,18005,328043,900,407,493
57620,357129,29057,171879,18008,328072,900,407,493
57625,357160,29058,171893,18008,328102,900,407,493
57630,357191,29059,171911,18009,328131,900,407,493
57635,357222,29061,171926,18010,328161,900,407,493
57640,357253,29062,171939,18010,328191,900,407,493
57645,357284,29063,171951,18011,328221,900,407,493
57650,357315,29065,171966,18013,328250,900,407,493
57655,357346,29067,171980,18015,328279,900,407,493
57660,357377,29070,171998,18017,328307,900,407,493
57665,357408,29075,172010,18019,328333,900,407,493
57670,357439,29079,172025,18021,328360,900,407,493
57675,357470,29083,172038,18024,328387,900,407,493
57680,357501,29087,172050,18026,328414,900,407,493
57685,357532,29090,172059,18027,328441,900,407,493
57690,357563,29095,172074,18031,328467,900,407,493
57695,357594,29099,172089,18033,328494,900,407,493
57700,357625,29104,172102,18036,328521,900,407,493
57705,357656,29107,172119,18038,328549,900,407,493
57710,357687,29110,172137,18039,328577,900,407,493
57715,357718,29113,172146,18040,328605,900,407,493
57720,357749,29116,172164,18043,328633,900,407,493
57725,357780,29121,172181,18047,328659,900,407,493
57730,357811,29123,172192,18049,328688,900,407,493
57735,357842,29125,172205,18050,328717,900,407,493
57740,357873,29126,172225,18051,328747,900,407,493
57745,357904,29127,172241,18051,328777,900,407,493
57750,357935,29128,172257,18052,328807,900,407,493
57755,357966,29129,172269,18053,328837,900,407,493
57760,357997,29130,172286,18053,328867,900,407,493
57765,358028,29131,172303,18053,328897,900,407,493
57770,358059,29132,172313,18054,328927,900,407,493
57775,358090,29133,172324,18054,328957,900,407,493
57780,358121,29134,172340,18055,328987,900,407,493
57785,358152,29135,172353,18056,329017,900,407,493
57790,358183,29136,172370,18057,329047,900,407,493
57795,358214,29137,172380,18058,329077,900,407,493
57800,358245,29138,172395,18059,329107,900,407,493
57805,358276,29139,172407,18060,329137,900,407,493
57810,358307,29140,172426,18060,329167,900,407,493
57815,358338,29141,172437,18061,329197,900,407,493
57820,358369,29142,172454,18062,329227,900,407,493
57825,358400,29143,172473,18063,329257,900,407,493
57830,358431,29146,172487,18065,329284,900,407,493
57835,358462,29151,172495,18067,329311,900,407,493
57840,358493,29156,172509,18069,329336,900,407,493
57845,358524,29161,172517,18072,329363,900,407,493
57850,358555,29166,172539,18076,329389,900,407,493
57855,358586,29170,172553,18079,329416,900,407,493
57860,358617,29174,172572,18081,329442,900,407,493
57865,358648,29179,172589,18086,329468,900,407,493
57870,358679,29184,172605,18089,329495,900,407,493
57875,358710,29189,172615,18092,329521,900,407,493
57880,358741,29194,172629,18094,329547,900,407,493
57885,358772,29199,172641,18097,329573,900,407,493
57890,358803,29204,172654,18102,329599,900,407,493
57895,358834,29209,172672,18107,329624,900,407,493
57900,358865,29214,172682,18110,329651,900,407,493
57905,358896,29217,172701,18111,329679,900,407,493
57910,358927,29219,172714,18111,329708,900,407,493
57915,358958,29220,172728,18111,329738,900,407,493
57920,358989,29221,172741,18112,329768,900,407,493
57925,359020,29222,172756,18112,329798,900,407,493
57930,359051,29223,172765,18112,329828,900,407,493
57935,359082,29224,172781,18113,329858,900,407,493
57940,359113,29225,172794,18113,329888,900,407,493
57945,359144,29226,172809,18114,329918,900,407,493
57950,359175,29227,172825,18114,329948,900,407,493
57955,359206,29228,172845,18115,329977,900,407,493
57960,359237,29230,172855,18117,330007,900,407,493
57965,359268,29231,172871,18118,330036,900,407,493
57970,359299,29233,172886,18119,330066,900,407,493
57975,359330,29234,172900,18120,330096,900,407,493
57980,359361,29235,172915,18120,330126,900,407,493
57985,359392,29236,172928,18121,330156,900,407,493
57990,359423,29237,172940,18122,330186,900,407,493
57995,359454,29238,172959,18123,330216,900,407,493
58000,359485,29239,172966,18124,330246,900,407,493
58005,359516,29241,172980,18125,330275,900,407,493
58010,359547,29243,173000,18125,330304,900,407,493
58015,359578,29246,173015,18126,330332,900,407,493
58020,359609,29249,173034,18128,330359,900,407,493
58025,359640,29255,173048,18131,330385,900,407,493
58030,359671,29259,173060,18134,330412,900,407,493
58035,359702,29264,173081,18139,330438,900,407,493
58040,359733,29269,173099,18142,330463,900,407,493
58045,359764,29274,173112,18145,330490,900,407,493
58050,359795,29279,173132,18149,330516,900,407,493
58055,359826,29283,173142,18150,330542,900,407,493
58060,359857,29288,173156,18153,330568,900,407,493
58065,359888,29290,173167,18154,330598,900,407,493
58070,359919,29291,173177,18154,330628,900,407,493
58075,359950,29291,173196,18154,330659,900,407,493
58080,359981,29291,173208,18154,330690,900,407,493
58085,360012,29291,173222,18154,330721,900,407,493
58090,360043,29291,173236,18154,330752,900,407,493
58095,360074,29291,173251,18154,330783,900,407,493
58100,360105,29291,173269,18154,330814,900,407,493
58105,360136,29291,173283,18154,330845,900,407,493
58110,360167,29291,173300,18154,330876,900,407,493
58115,360198,29291,173311,18154,330907,900,407,493
58120,360229,29291,173331,18154,330938,900,407,493
58125,360260,29291,173343,18154,330969,900,407,493
58130,360291,29291,173353,18154,331000,900,407,493
58135,360322,29292,173373,18154,331030,900,407,493
58140,360353,29293,173387,18154,331060,900,407,493
58145,360384,29295,173405,18155,331088,900,407,493
58150,360415,29298,173420,18157,331116,900,407,493
58155,360446,29301,173433,18159,331145,900,407,493
58160,360477,29304,173446,18160,331173,900,407,493
58165,360508,29307,173464,18162,331201,900,407,493
58170,360539,29311,173482,18164,331227,900,407,493
58175,360570,29316,173497,18169,331253,900,407,493
58180,360601,29322,173511,18175,331279,900,407,493
58185,360632,29326,173526,18177,331306,900,407,493
58190,360663,29333,173540,18182,331330,900,407,493
58195,360694,29341,173560,18189,331352,900,407,493
58200,360725,29349,173575,18194,331376,900,407,493
58205,360756,29352,173590,18195,331404,900,407,493
58210,360787,29353,173605,18195,331434,900,407,493
58215,360818,29354,173621,18196,331464,900,407,493
58220,360849,29355,173635,18197,331494,900,407,493
58225,360880,29355,173647,18197,331525,900,407,493
58230,360911,29355,173660,18197,331556,900,407,493
58235,360942,29355,173677,18197,331587,900,407,493
58240,360973,29355,173693,18197,331618,900,407,493
58245,361004,29355,173703,18197,331649,900,407,493
58250,361035,29355,173725,18197,331680,900,407,493
58255,361066,29355,173741,18197,331711,900,407,493
58260,361097,29355,173754,18197,331742,900,407,493
58265,361128,29355,173768,18197,331773,900,407,493
58270,361159,29355,173783,18197,331804,900,407,493
58275,361190,29355,173796,18197,331835,900,407,493
58280,361221,29355,173811,18197,331866,900,407,493
58285,361252,29355,173824,18197,331897,900,407,493
58290,361283,29355,173836,18197,331928,900,407,493
58295,361314,29355,173856,18197,331959,900,407,493
58300,361345,29355,173870,18197,331990,900,407,493
58305,361376,29356,173885,18198,332020,901,408,493
58310,361407,29357,173897,18198,332050,902,408,494
58315,361438,29359,173910,18199,332078,903,408,495
58320,361469,29363,173922,18201,332106,904,409,495
58325,361500,29367,173937,18203,332132,904,409,495
58330,361531,29373,173951,18206,332157,904,409,495
58335,361562,29379,173968,18208,332183,904,409,495
58340,361593,29383,173991,18210,332209,904,409,495
58345,361624,29389,174004,18214,332235,904,409,495
58350,361655,29393,174016,18214,332262,904,409,495
58355,361686,29398,174028,18217,332288,904,409,495
58360,361717,29403,174042,18220,332314,904,409,495
58365,361748,29408,174055,18222,332339,904,409,495
58370,361779,29413,174066,18225,332365,904,409,495
58375,361810,29416,174082,18228,332394,904,409,495
58380,361841,29419,174098,18230,332422,904,409,495
58385,361872,29421,174115,18230,332451,904,409,495
58390,361903,29423,174132,18230,332480,904,409,495
58395,361934,29425,174151,18232,332509,904,409,495
58400,361965,29427,174170,18234,332538,904,409,495
58405,361996,29429,174185,18236,332567,904,409,495
58410,362027,29431,174194,18236,332596,904,409,495
58415,362058,29433,174214,18237,332625,904,409,495
58420,362089,29435,174228,18238,332654,904,409,495
58425,362120,29437,174244,18239,332683,904,409,495
58430,362151,29439,174258,18240,332712,904,409,495
58435,362182,29441,174271,18242,332741,904,409,495
58440,362213,29444,174289,18244,332769,904,409,495
58445,362244,29448,174302,18246,332796,904,409,495
58450,362275,29450,174319,18246,332825,904,409,495
58455,362306,29452,174334,18248,332853,904,409,495
58460,362337,29455,174346,18249,332882,904,409,495
58465,362368,29457,174356,18250,332911,904,409,495
58470,362399,29459,174368,18251,332940,904,409,495
58475,362430,29461,174382,18253,332968,904,409,495
58480,362461,29464,174397,18256,332997,904,409,495
58485,362492,29466,174407,18257,333025,904,409,495
58490,362523,29469,174419,18259,333053,904,409,495
58495,362554,29472,174436,18261,333081,904,409,495
58500,362585,29475,174450,18263,333109,904,409,495
58505,362616,29477,174463,18264,333139,904,409,495
58510,362647,29478,174476,18264,333169,904,409,495
58515,362678,29479,174489,18264,333199,904,409,495
58520,362709,29480,174502,18264,333229,904,409,495
58525,362740,29481,174516,18265,333259,904,409,495
58530,362771,29482,174534,18266,333289,904,409,495
58535,362802,29483,174549,18266,333319,904,409,495
58540,362833,29484,174568,18266,333349,904,409,495
58545,362864,29487,174589,18269,333376,904,409,495
58550,362895,29490,174605,18271,333405,904,409,495
58555,362926,29494,174624,18273,333432,904,409,495
58560,362957,29496,174642,18275,333461,904,409,495
58565,362988,29499,174657,18277,333489,904,409,495
58570,363019,29503,174671,18279,333516,904,409,495
58575,363050,29506,174683,18279,333544,904,409,495
58580,363081,29509,174698,18280,333572,904,409,495
58585,363112,29512,174712,18281,333600,904,409,495
58590,363143,29516,174729,18283,333627,904,409,495
58595,363174,29519,174740,18284,333655,904,409,495
58600,363205,29522,174751,18286,333683,904,409,495
58605,363236,29525,174767,18287,333711,904,409,495
58610,363267,29528,174780,18287,333739,904,409,495
58615,363298,29531,174793,18287,333767,904,409,495
58620,363329,29534,174810,18290,333795,904,409,495
58625,363360,29537,174826,18291,333823,904,409,495
58630,363391,29540,174837,18292,333851,904,409,495
58635,363422,29543,174850,18292,333879,904,409,495
58640,363453,29546,174867,18293,333907,904,409,495
58645,363484,29549,174886,18295,333935,904,409,495
58650,363515,29552,174903,18296,333962,904,409,495
58655,363546,29557,174922,18299,333988,904,409,495
58660,363577,29563,174936,18303,334014,904,409,495
58665,363608,29569,174951,18307,334038,904,409,495
58670,363639,29576,174964,18312,334062,904,409,495
58675,363670,29583,174983,18317,334087,904,409,495
58680,363701,29588,174999,18322,334112,904,409,495
58685,363732,29593,175014,18327,334139,904,409,495
58690,363763,29597,175031,18330,334166,904,409,495
58695,363794,29600,175045,18331,334194,904,409,495
58700,363825,29603,175059,18333,334222,904,409,495
58705,363856,29605,175073,18334,334251,904,409,495
58710,363887,29608,175087,18336,334279,904,409,495
58715,363918,29609,175101,18336,334309,904,409,495
58720,363949,29610,175114,18337,334339,904,409,495
58725,363980,29611,175122,18338,334369,904,409,495
58730,364011,29612,175137,18338,334399,904,409,495
58735,364042,29613,175157,18339,334429,904,409,495
58740,364073,29614,175169,18339,334459,904,409,495
58745,364104,29615,175178,18340,334489,904,409,495
58750,364135,29616,175196,18341,334519,904,409,495
58755,364166,29617,175208,18341,334549,904,409,495
58760,364197,29618,175229,18342,334579,904,409,495
58765,364228,29619,175243,18342,334609,904,409,495
58770,364259,29620,175256,18342,334639,904,409,495
58775,364290,29622,175270,18343,334668,904,409,495
58780,364321,29624,175286,18345,334697,904,409,495
58785,364352,29626,175301,18347,334726,904,409,495
58790,364383,29629,175319,18347,334754,904,409,495
58795,364414,29633,175334,18349,334781,904,409,495
58800,364445,29636,175343,18350,334809,904,409,495
58805,364476,29641,175357,18354,334835,904,409,495
58810,364507,29644,175370,18356,334863,904,409,495
58815,364538,29647,175385,18357,334891,904,409,495
58820,364569,29650,175402,18358,334919,904,409,495
58825,364600,29654,175420,18361,334946,904,409,495
58830,364631,29657,175440,18363,334974,904,409,495
58835,364662,29661,175458,18367,335001,904,409,495
58840,364693,29664,175471,18368,335029,904,409,495
58845,364724,29668,175487,18370,335056,904,409,495
58850,364755,29671,175506,18373,335083,904,409,495
58855,364786,29676,175521,18377,335110,904,409,495
58860,364817,29680,175531,18378,335137,904,409,495
58865,364848,29683,175545,18379,335165,904,409,495
58870,364879,29686,175560,18381,335193,904,409,495
58875,364910,29689,175576,18383,335221,904,409,495
58880,364941,29692,175588,18384,335249,904,409,495
58885,364972,29695,175605,18386,335276,904,409,495
58890,365003,29700,175621,18389,335302,904,409,495
58895,365034,29704,175633,18391,335330,904,409,495
58900,365065,29707,175646,18392,335358,904,409,495
58905,365096,29710,175666,18393,335386,904,409,495
58910,365127,29712,175682,18394,335414,904,409,495
58915,365158,29717,175693,18397,335440,904,409,495
58920,365189,29722,175705,18400,335466,904,409,495
58925,365220,29725,175721,18403,335495,904,409,495
58930,365251,29728,175739,18405,335523,904,409,495
58935,365282,29729,175752,18406,335553,904,409,495
58940,365313,29730,175765,18407,335583,904,409,495
58945,365344,29731,175783,18408,335613,904,409,495
58950,365375,29732,175797,18408,335643,904,409,495
58955,365406,29733,175810,18409,335673,904,409,495
58960,365437,29734,175824,18409,335703,904,409,495
58965,365468,29735,175838,18410,335733,904,409,495
58970,365499,29736,175859,18410,335763,904,409,495
58975,365530,29737,175878,18411,335793,904,409,495
58980,365561,29738,175897,18412,335823,904,409,495
58985,365592,29739,175909,18412,335853,904,409,495
58990,365623,29740,175922,18413,335883,904,409,495
58995,365654,29741,175941,18414,335913,904,409,495
59000,365685,29742,175960,18415,335943,904,409,495
59005,365716,29743,175979,18416,335973,904,409,495
59010,365747,29745,175995,18417,336002,904,409,495
59015,365778,29747,176010,18419,336031,904,409,495
59020,365809,29748,176027,18420,336061,904,409,495
59025,365840,29749,176042,18420,336090,904,409,495
59030,365871,29753,176055,18423,336118,904,409,495
59035,365902,29757,176072,18426,336144,904,409,495
59040,365933,29764,176089,18431,336168,904,409,495
59045,365964,29768,176104,18434,336196,904,409,495
59050,365995,29770,176120,18436,336225,904,409,495
59055,366026,29772,176128,18436,336254,904,409,495
59060,366057,29774,176139,18436,336283,904,409,495
59065,366088,29776,176149,18436,336312,904,409,495
59070,366119,29778,176162,18436,336341,904,409,495
59075,366150,29780,176177,18438,336370,904,409,495
59080,366181,29782,176189,18438,336399,904,409,495
59085,366212,29784,176204,18439,336428,904,409,495
59090,366243,29786,176218,18440,336457,904,409,495
59095,366274,29788,176233,18441,336486,904,409,495
59100,366305,29790,176245,18441,336515,904,409,495
59105,366336,29792,176262,18442,336544,904,409,495
59110,366367,29794,176275,18443,336573,904,409,495
59115,366398,29796,176292,18444,336602,904,409,495
59120,366429,29798,176307,18445,336631,904,409,495
59125,366460,29800,176322,18447,336660,904,409,495
59130,366491,29802,176336,18447,336689,904,409,495
59135,366522,29804,176350,18448,336718,904,409,495
59140,366553,29806,176364,18448,336747,904,409,495
59145,366584,29810,176379,18451,336773,904,409,495
59150,366615,29816,176397,18457,336799,904,409,495
59155,366646,29818,176410,18457,336827,904,409,495
59160,366677,29825,176430,18463,336851,904,409,495
59165,366708,29828,176443,18465,336880,904,409,495
59170,366739,29830,176457,18467,336909,904,409,495
59175,366770,29834,176468,18469,336936,904,409,495
59180,366801,29837,176486,18472,336964,904,409,495
59185,366832,29838,176500,18473,336994,904,409,495
59190,366863,29839,176513,18474,337024,904,409,495
59195,366894,29840,176533,18475,337054,904,409,495
59200,366925,29841,176550,18475,337084,904,409,495
59205,366956,29842,176568,18476,337114,904,409,495
59210,366987,29843,176583,18476,337144,904,409,495
59215,367018,29844,176591,18476,337174,904,409,495
59220,367049,29845,176608,18476,337204,904,409,495
59225,367080,29846,176620,18477,337234,904,409,495
59230,367111,29847,176630,18478,337264,904,409,495
59235,367142,29848,176644,18479,337294,904,409,495
59240,367173,29849,176657,18480,337324,904,409,495
59245,367204,29850,176669,18481,337354,904,409,495
59250,367235,29852,176682,18483,337383,904,409,495
59255,367266,29854,176698,18484,337412,904,409,495
59260,367297,29857,176713,18486,337440,904,409,495
59265,367328,29860,176728,18488,337467,904,409,495
59270,367359,29864,176745,18491,337494,904,409,495
59275,367390,29869,176755,18494,337521,904,409,495
59280,367421,29872,176768,18495,337549,904,409,495
59285,367452,29877,176787,18497,337574,904,409,495
59290,367483,29881,176801,18498,337602,904,409,495
59295,367514,29885,176821,18500,337629,904,409,495
59300,367545,29889,176838,18503,337656,904,409,495
59305,367576,29893,176852,18504,337683,904,409,495
59310,367607,29896,176867,18505,337711,904,409,495
59315,367638,29899,176883,18505,337739,904,409,495
59320,367669,29902,176900,18506,337767,904,409,495
59325,367700,29906,176914,18509,337794,904,409,495
59330,367731,29910,176928,18510,337821,904,409,495
59335,367762,29914,176943,18512,337848,904,409,495
59340,367793,29918,176958,18515,337875,904,409,495
59345,367824,29921,176975,18518,337903,904,409,495
59350,367855,29922,176990,18519,337933,904,409,495
59355,367886,29923,177008,18520,337963,904,409,495
59360,367917,29924,177019,18520,337993,904,409,495
59365,367948,29925,177034,18520,338023,904,409,495
59370,367979,29926,177047,18521,338053,904,409,495
59375,368010,29927,177066,18521,338083,904,409,495
59380,368041,29928,177083,18521,338113,904,409,495
59385,368072,29929,177093,18521,338143,904,409,495
59390,368103,29931,177110,18522,338170,904,409,495
59395,368134,29936,177131,18527,338196,904,409,495
59400,368165,29942,177150,18533,338221,904,409,495
59405,368196,29946,177168,18536,338249,904,409,495
59410,368227,29949,177183,18539,338278,904,409,495
59415,368258,29951,177202,18541,338307,904,409,495
59420,368289,29951,177221,18541,338338,904,409,495
59425,368320,29951,177229,18541,338369,904,409,495
59430,368351,29951,177244,18541,338400,904,409,495
59435,368382,29951,177263,18541,338431,904,409,495
59440,368413,29951,177276,18541,338462,904,409,495
59445,368444,29951,177297,18541,338493,904,409,495
59450,368475,29951,177309,18541,338524,904,409,495
59455,368506,29952,177326,18542,338554,904,409,495
59460,368537,29953,177344,18543,338584,904,409,495
59465,368568,29957,177359,18547,338611,904,409,495
59470,368599,29961,177372,18548,338638,904,409,495
59475,368630,29965,177384,18548,338664,904,409,495
59480,368661,29970,177396,18552,338691,904,409,495
59485,368692,29974,177415,18555,338718,904,409,495
59490,368723,29978,177430,18556,338745,904,409,495
59495,368754,29982,177444,18559,338771,904,409,495
59500,368785,29987,177457,18562,338798,904,409,495
59505,368816,29991,177469,18563,338824,904,409,495
59510,368847,29997,177484,18568,338849,904,409,495
59515,368878,30003,177497,18570,338875,904,409,495
59520,368909,30007,177514,18572,338902,904,409,495
59525,368940,30010,177527,18574,338930,904,409,495
59530,368971,30013,177541,18574,338958,904,409,495
59535,369002,30016,177554,18575,338986,904,409,495
59540,369033,30019,177568,18577,339013,904,409,495
59545,369064,30023,177585,18579,339041,904,409,495
59550,369095,30026,177603,18582,339068,904,409,495
59555,369126,30029,177618,18584,339097,904,409,495
59560,369157,30031,177636,18586,339126,904,409,495
59565,369188,30033,177646,18588,339155,904,409,495
59570,369219,30035,177660,18590,339184,904,409,495
59575,369250,30036,177674,18591,339214,904,409,495
59580,369281,30037,177694,18592,339244,904,409,495
59585,369312,30039,177708,18593,339273,904,409,495
59590,369343,30040,177721,18593,339303,904,409,495
59595,369374,30042,177738,18594,339332,904,409,495
59600,369405,30043,177755,18594,339362,904,409,495
59605,369436,30043,177775,18594,339393,904,409,495
59610,369467,30043,177789,18594,339424,904,409,495
59615,369498,30043,177805,18594,339455,904,409,495
59620,369529,30044,177816,18595,339485,904,409,495
59625,369560,30045,177827,18595,339515,904,409,495
59630,369591,30046,177844,18596,339545,904,409,495
59635,369622,30047,177859,18597,339574,904,409,495
59640,369653,30049,177872,18599,339604,904,409,495
59645,369684,30052,177887,18600,339630,904,409,495
59650,369715,30057,177902,18603,339657,904,409,495
59655,369746,30061,177913,18607,339685,904,409,495
59660,369777,30063,177930,18608,339714,904,409,495
59665,369808,30065,177944,18609,339743,904,409,495
59670,369839,30067,177957,18610,339772,904,409,495
59675,369870,30070,177973,18611,339800,904,409,495
59680,369901,30073,177986,18612,339828,904,409,495
59685,369932,30078,178003,18615,339854,904,409,495
59690,369963,30083,178022,18619,339880,904,409,495
59695,369994,30086,178035,18620,339908,904,409,495
59700,370025,30089,178052,18622,339936,904,409,495
59705,370056,30092,178067,18624,339964,904,409,495
59710,370087,30095,178081,18627,339992,904,409,495
59715,370118,30098,178095,18629,340020,904,409,495
59720,370149,30101,178108,18631,340048,904,409,495
59725,370180,30105,178124,18634,340075,904,409,495
59730,370211,30109,178138,18636,340102,904,409,495
59735,370242,30113,178155,18638,340129,904,409,495
59740,370273,30116,178175,18640,340157,904,409,495
59745,370304,30120,178196,18642,340184,904,409,495
59750,370335,30125,178214,18646,340210,904,409,495
59755,370366,30129,178229,18648,340237,904,409,495
59760,370397,30133,178244,18650,340264,904,409,495
59765,370428,30134,178258,18651,340294,904,409,495
59770,370459,30136,178270,18653,340323,904,409,495
59775,370490,30138,178285,18654,340352,905,410,495
59780,370521,30139,178303,18654,340382,906,410,496
59785,370552,30140,178317,18654,340412,907,411,496
59790,370583,30142,178333,18656,340441,908,411,497
59795,370614,30144,178352,18657,340470,909,411,498
59800,370645,30145,178369,18657,340500,910,412,498
59805,370676,30146,178380,18657,340530,911,413,498
59810,370707,30149,178393,18659,340558,912,413,499
59815,370738,30152,178408,18661,340586,913,413,500
59820,370769,30156,178423,18664,340613,914,413,501
59825,370800,30157,178433,18664,340643,914,413,501
59830,370831,30158,178449,18664,340673,914,413,501
59835,370862,30159,178458,18664,340703,914,413,501
59840,370893,30160,178471,18665,340733,914,413,501
59845,370924,30161,178490,18666,340763,914,413,501
59850,370955,30162,178501,18666,340793,914,413,501
59855,370986,30163,178514,18667,340823,914,413,501
59860,371017,30164,178529,18667,340853,914,413,501
59865,371048,30166,178545,18669,340882,914,413,501
59870,371079,30168,178556,18670,340911,914,413,501
59875,371110,30171,178570,18671,340939,914,413,501
59880,371141,30173,178588,18672,340967,914,413,501
59885,371172,30178,178607,18676,340994,914,413,501
59890,371203,30180,178623,18676,341023,914,413,501
59895,371234,30183,178637,18677,341051,914,413,501
59900,371265,30187,178653,18680,341078,914,413,501
59905,371296,30190,178663,18681,341106,914,413,501
59910,371327,30192,178680,18683,341135,914,413,501
59915,371358,30194,178697,18684,341164,914,413,501
59920,371389,30196,178710,18686,341193,914,413,501
59925,371420,30196,178724,18686,341224,914,413,501
59930,371451,30198,178739,18687,341253,914,413,501
59935,371482,30199,178755,18688,341282,914,413,501
59940,371513,30201,178771,18690,341311,914,413,501
59945,371544,30205,178791,18693,341339,914,413,501
59950,371575,30207,178807,18694,341368,914,413,501
59955,371606,30208,178821,18694,341398,914,413,501
59960,371637,30209,178835,18694,341428,914,413,501
59965,371668,30210,178848,18695,341458,914,413,501
59970,371699,30211,178862,18695,341488,914,413,501
59975,371730,30212,178880,18695,341518,914,413,501
59980,371761,30213,178893,18696,341548,914,413,501
59985,371792,30214,178909,18697,341578,914,413,501
59990,371823,30215,178924,18697,341608,914,413,501
59995,371854,30216,178938,18697,341638,914,413,501
60000,371885,30217,178950,18698,341668,914,413,501
60005,371916,30218,178964,18699,341698,914,413,501
60010,371947,30221,178977,18701,341726,914,413,501
60015,371978,30223,178993,18702,341755,914,413,501
60020,372009,30226,179012,18704,341783,914,413,501
60025,372040,30228,179028,18705,341812,914,413,501
60030,372071,30231,179041,18706,341840,914,413,501
60035,372102,30235,179054,18709,341867,914,413,501
60040,372133,30239,179067,18712,341894,914,413,501
60045,372164,30242,179084,18714,341921,914,413,501
60050,372195,30246,179096,18717,341949,914,413,501
60055,372226,30252,179112,18722,341973,914,413,501
60060,372257,30260,179126,18727,341995,914,413,501
60065,372288,30266,179143,18732,342022,914,413,501
60070,372319,30267,179162,18733,342051,914,413,501
60075,372350,30269,179177,18735,342081,914,413,501
60080,372381,30270,179196,18736,342110,914,413,501
60085,372412,30272,179213,18738,342140,914,413,501
60090,372443,30273,179225,18739,342170,914,413,501
60095,372474,30274,179240,18739,342199,914,413,501
60100,372505,30276,179256,18740,342229,914,413,501
60105,372536,30277,179273,18740,342258,914,413,501
60110,372567,30279,179288,18742,342287,914,413,501
60115,372598,30281,179305,18743,342317,914,413,501
60120,372629,30282,179318,18744,342347,914,413,501
60125,372660,30285,179334,18746,342375,914,413,501
60130,372691,30288,179346,18747,342403,914,413,501
60135,372722,30290,179364,18749,342432,914,413,501
60140,372753,30292,179380,18749,342460,914,413,501
60145,372784,30295,179393,18751,342489,914,413,501
60150,372815,30297,179413,18753,342518,914,413,501
60155,372846,30299,179432,18755,342547,914,413,501
60160,372877,30301,179442,18756,342576,914,413,501
60165,372908,30305,179453,18758,342603,914,413,501
60170,372939,30308,179469,18760,342631,914,413,501
60175,372970,30312,179483,18763,342658,915,413,502
60180,373001,30315,179498,18765,342686,916,413,503
60185,373032,30317,179515,18765,342715,916,413,503
60190,373063,30320,179530,18766,342743,916,413,503
60195,373094,30322,179543,18767,342772,916,413,503
60200,373125,30324,179563,18768,342801,916,413,503
60205,373156,30326,179581,18770,342830,916,413,503
60210,373187,30328,179598,18771,342859,916,413,503
60215,373218,30330,179611,18772,342888,916,413,503
60220,373249,30332,179625,18773,342917,916,413,503
60225,373280,30334,179637,18773,342946,916,413,503
60230,373311,30336,179652,18774,342975,916,413,503
60235,373342,30338,179667,18775,343004,916,413,503
60240,373373,30340,179684,18777,343033,916,413,503
60245,373404,30342,179694,18779,343062,916,413,503
60250,373435,30344,179713,18780,343091,916,413,503
60255,373466,30346,179728,18781,343120,916,413,503
60260,373497,30347,179745,18782,343150,916,413,503
60265,373528,30348,179764,18783,343180,916,413,503
60270,373559,30350,179777,18785,343209,916,413,503
60275,373590,30351,179794,18786,343239,916,413,503
60280,373621,30352,179809,18786,343269,916,413,503
60285,373652,30354,179828,18787,343297,916,413,503
60290,373683,30357,179844,18789,343325,916,413,503
60295,373714,30361,179858,18792,343352,916,413,503
60300,373745,30365,179874,18796,343379,916,413,503
60305,373776,30368,179887,18799,343408,916,413,503
60310,373807,30371,179901,18800,343436,916,413,503
60315,373838,30373,179922,18802,343465,916,413,503
60320,373869,30375,179934,18803,343494,916,413,503
60325,373900,30377,179951,18804,343523,916,413,503
60330,373931,30380,179964,18806,343551,916,413,503
60335,373962,30382,179980,18807,343580,916,413,503
60340,373993,30384,179992,18808,343609,916,413,503
60345,374024,30386,180010,18808,343638,916,413,503
60350,374055,30388,180023,18809,343667,916,413,503
60355,374086,30391,180039,18811,343695,916,413,503
60360,374117,30394,180053,18812,343722,916,413,503
60365,374148,30396,180068,18814,343752,916,413,503
60370,374179,30398,180083,18815,343781,916,413,503
60375,374210,30399,180101,18816,343811,916,413,503
60380,374241,30400,180117,18816,343841,916,413,503
60385,374272,30401,180125,18816,343871,916,413,503
60390,374303,30402,180143,18817,343901,916,413,503
60395,374334,30403,180161,18817,343931,916,413,503
60400,374365,30404,180173,18817,343961,916,413,503
60405,374396,30405,180190,18818,343991,916,413,503
60410,374427,30407,180204,18819,344019,916,413,503
60415,374458,30410,180216,18822,344048,916,413,503
60420,374489,30412,180232,18824,344076,916,413,503
60425,374520,30417,180245,18827,344103,916,413,503
60430,374551,30423,180261,18829,344128,916,413,503
60435,374582,30427,180274,18830,344155,916,413,503
60440,374613,30430,180294,18831,344183,916,413,503
60445,374644,30433,180312,18834,344211,916,413,503
60450,374675,30436,180323,18836,344239,916,413,503
60455,374706,30439,180343,18839,344267,916,413,503
60460,374737,30442,180356,18841,344295,916,413,503
60465,374768,30445,180372,18841,344323,916,413,503
60470,374799,30448,180386,18844,344351,916,413,503
60475,374830,30452,180392,18846,344377,916,413,503
60480,374861,30455,180411,18848,344406,916,413,503
60485,374892,30456,180423,18849,344436,916,413,503
60490,374923,30458,180437,18850,344465,916,413,503
60495,374954,30459,180450,18851,344495,916,413,503
60500,374985,30460,180468,18852,344525,916,413,503
60505,375016,30461,180485,18852,344555,916,413,503
60510,375047,30462,180499,18852,344585,916,413,503
60515,375078,30463,180518,18853,344615,916,413,503
60520,375109,30464,180534,18853,344645,916,413,503
60525,375140,30465,180551,18854,344675,916,413,503
60530,375171,30466,180566,18854,344705,916,413,503
60535,375202,30467,180578,18854,344735,916,413,503
60540,375233,30469,180590,18854,344763,916,413,503
60545,375264,30473,180608,18858,344791,916,413,503
60550,375295,30474,180626,18858,344821,916,413,503
60555,375326,30475,180636,18859,344851,916,413,503
60560,375357,30476,180652,18860,344881,916,413,503
60565,375388,30477,180670,18861,344911,916,413,503
60570,375419,30478,180681,18862,344941,916,413,503
60575,375450,30479,180692,18862,344971,916,413,503
60580,375481,30480,180703,18863,345001,916,413,503
60585,375512,30481,180721,18864,345031,916,413,503
60590,375543,30483,180734,18864,345060,916,413,503
60595,375574,30485,180748,18864,345089,916,413,503
60600,375605,30487,180760,18864,345117,916,413,503
60605,375636,30492,180772,18867,345144,916,413,503
60610,375667,30494,180784,18869,345173,916,413,503
60615,375698,30497,180792,18872,345201,916,413,503
60620,375729,30500,180809,18873,345228,916,413,503
60625,375760,30503,180822,18875,345257,916,413,503
60630,375791,30505,180836,18877,345286,916,413,503
60635,375822,30506,180851,18878,345316,916,413,503
60640,375853,30507,180863,18878,345346,916,413,503
60645,375884,30509,180879,18879,345375,916,413,503
60650,375915,30513,180891,18882,345402,916,413,503
60655,375946,30518,180908,18887,345428,916,413,503
60660,375977,30522,180921,18890,345455,916,413,503
60665,376008,30525,180934,18891,345483,916,413,503
60670,376039,30527,180950,18893,345512,916,413,503
60675,376070,30529,180961,18893,345541,916,413,503
60680,376101,30532,180970,18894,345569,916,413,503
60685,376132,30535,180988,18897,345597,916,413,503
60690,376163,30538,181005,18899,345625,916,413,503
60695,376194,30540,181015,18900,345654,916,413,503
60700,376225,30543,181033,18903,345682,916,413,503
60705,376256,30546,181051,18905,345710,916,413,503
60710,376287,30548,181069,18906,345739,916,413,503
60715,376318,30550,181081,18906,345768,916,413,503
60720,376349,30552,181096,18906,345797,916,413,503
60725,376380,30556,181114,18908,345824,916,413,503
60730,376411,30559,181126,18910,345852,916,413,503
60735,376442,30561,181141,18911,345881,916,413,503
60740,376473,30564,181152,18912,345909,916,413,503
60745,376504,30565,181172,18912,345939,916,413,503
60750,376535,30566,181187,18913,345969,916,413,503
60755,376566,30567,181204,18913,345999,916,413,503
60760,376597,30568,181219,18913,346029,916,413,503
60765,376628,30571,181234,18914,346056,916,413,503
60770,376659,30574,181249,18916,346085,916,413,503
60775,376690,30576,181263,18918,346113,916,413,503
60780,376721,30580,181278,18921,346140,916,413,503
60785,376752,30586,181292,18925,346166,916,413,503
60790,376783,30590,181306,18926,346193,916,413,503
60795,376814,30594,181321,18928,346220,916,413,503
60800,376845,30598,181339,18930,346246,916,413,503
60805,376876,30603,181355,18933,346273,916,413,503
60810,376907,30607,181372,18934,346300,916,413,503
60815,376938,30611,181385,18935,346327,916,413,503
60820,376969,30615,181400,18936,346354,916,413,503
60825,377000,30619,181411,18938,346380,916,413,503
60830,377031,30625,181425,18942,346406,916,413,503
60835,377062,30630,181436,18944,346431,916,413,503
60840,377093,30636,181453,18948,346457,916,413,503
60845,377124,30638,181468,18949,346486,916,413,503
60850,377155,30640,181482,18949,346515,916,413,503
60855,377186,30642,181496,18949,346544,916,413,503
60860,377217,30644,181513,18951,346573,916,413,503
60865,377248,30645,181530,18952,346603,916,413,503
60870,377279,30646,181546,18953,346633,916,413,503
60875,377310,30647,181558,18953,346663,916,413,503
60880,377341,30648,181568,18953,346693,916,413,503
60885,377372,30649,181583,18953,346723,916,413,503
60890,377403,30651,181599,18954,346752,916,413,503
60895,377434,30652,181608,18954,346782,916,413,503
60900,377465,30654,181627,18956,346811,916,413,503
60905,377496,30656,181643,18956,346840,916,413,503
60910,377527,30659,181660,18959,346868,916,413,503
60915,377558,30664,181679,18963,346894,916,413,503
60920,377589,30666,181695,18963,346923,916,413,503
60925,377620,30670,181708,18966,346950,916,413,503
60930,377651,30673,181720,18969,346978,916,413,503
60935,377682,30674,181736,18969,347008,916,413,503
60940,377713,30675,181752,18969,347038,916,413,503
60945,377744,30676,181770,18969,347068,916,413,503
60950,377775,30678,181784,18969,347096,916,413,503
60955,377806,30681,181798,18972,347125,916,413,503
60960,377837,30683,181814,18973,347154,916,413,503
60965,377868,30685,181832,18974,347182,916,413,503
60970,377899,30688,181847,18976,347211,916,413,503
60975,377930,30689,181860,18976,347241,916,413,503
60980,377961,30690,181869,18977,347270,916,413,503
60985,377992,30691,181882,18978,347301,916,413,503
60990,378023,30691,181899,18978,347332,916,413,503
60995,378054,30691,181913,18978,347363,916,413,503
61000,378085,30691,181925,18978,347394,916,413,503
61005,378116,30691,181935,18978,347425,916,413,503
61010,378147,30692,181952,18978,347455,916,413,503
61015,378178,30693,181966,18978,347485,916,413,503
61020,378209,30694,181985,18978,347515,916,413,503
61025,378240,30696,182002,18979,347544,916,413,503
61030,378271,30697,182018,18979,347574,916,413,503
61035,378302,30698,182035,18979,347604,916,413,503
61040,378333,30699,182049,18980,347634,916,413,503
61045,378364,30700,182061,18980,347664,916,413,503
61050,378395,30701,182077,18980,347694,916,413,503
61055,378426,30702,182091,18981,347724,916,413,503
61060,378457,30703,182104,18981,347754,916,413,503
61065,378488,30705,182121,18982,347783,916,413,503
61070,378519,30707,182138,18984,347812,916,413,503
61075,378550,30710,182155,18987,347840,916,413,503
61080,378581,30713,182172,18989,347868,916,413,503
61085,378612,30716,182188,18991,347896,916,413,503
61090,378643,30719,182202,18992,347924,916,413,503
61095,378674,30723,182221,18995,347951,916,413,503
61100,378705,30727,182240,18997,347978,916,413,503
61105,378736,30730,182257,19000,348006,916,413,503
61110,378767,30734,182268,19003,348033,916,413,503
61115,378798,30737,182283,19005,348061,916,413,503
61120,378829,30741,182296,19007,348088,916,413,503
61125,378860,30746,182313,19009,348114,916,413,503
61130,378891,30751,182330,19013,348140,916,413,503
61135,378922,30755,182344,19014,348166,916,413,503
61140,378953,30761,182360,19018,348192,916,413,503
61145,378984,30763,182368,19019,348220,916,413,503
61150,379015,30766,182382,19021,348249,916,413,503
61155,379046,30768,182398,19021,348278,916,413,503
61160,379077,30770,182414,19022,348307,916,413,503
61165,379108,30772,182431,19024,348336,916,413,503
61170,379139,30774,182443,19024,348365,916,413,503
61175,379170,30776,182458,19024,348393,916,413,503
61180,379201,30779,182473,19026,348421,916,413,503
61185,379232,30782,182486,19028,348450,916,413,503
61190,379263,30785,182496,19030,348478,916,413,503
61195,379294,30788,182513,19032,348506,916,413,503
61200,379325,30790,182523,19032,348534,916,413,503
61205,379356,30795,182534,19035,348561,916,413,503
61210,379387,30798,182549,19038,348589,916,413,503
61215,379418,30801,182562,19039,348617,916,413,503
61220,379449,30805,182582,19041,348644,916,413,503
61225,379480,30807,182598,19043,348673,916,413,503
61230,379511,30809,182613,19044,348702,916,413,503
61235,379542,30811,182623,19044,348731,916,413,503
61240,379573,30813,182636,19045,348760,916,413,503
61245,379604,30815,182653,19047,348789,916,413,503
61250,379635,30817,182665,19049,348818,916,413,503
61255,379666,30820,182679,19050,348845,916,413,503
61260,379697,30823,182699,19052,348873,916,413,503
61265,379728,30825,182714,19053,348903,916,413,503
61270,379759,30826,182727,19053,348933,916,413,503
61275,379790,30827,182740,19053,348963,916,413,503
61280,379821,30828,182752,19054,348993,916,413,503
61285,379852,30829,182768,19054,349023,916,413,503
61290,379883,30830,182785,19055,349053,916,413,503
61295,379914,30831,182804,19056,349083,916,413,503
61300,379945,30832,182820,19056,349113,916,413,503
61305,379976,30833,182832,19056,349143,916,413,503
61310,380007,30834,182851,19056,349172,916,413,503
61315,380038,30837,182860,19058,349201,916,413,503
61320,380069,30837,182875,19058,349232,916,413,503
61325,380100,30839,182897,19059,349260,916,413,503
61330,380131,30841,182917,19061,349290,916,413,503
61335,380162,30843,182930,19063,349319,916,413,503
61340,380193,30844,182943,19063,349349,916,413,503
61345,380224,30845,182959,19063,349379,916,413,503
61350,380255,30846,182980,19064,349409,916,413,503
61355,380286,30847,182995,19065,349439,916,413,503
61360,380317,30849,183008,19065,349468,916,413,503
61365,380348,30852,183026,19067,349496,916,413,503
61370,380379,30855,183044,19068,349524,916,413,503
61375,380410,30857,183059,19069,349553,916,413,503
61380,380441,30860,183076,19070,349581,916,413,503
61385,380472,30864,183090,19072,349608,916,413,503
61390,380503,30867,183105,19073,349636,916,413,503
61395,380534,30873,183124,19078,349661,916,413,503
61400,380565,30876,183139,19080,349689,916,413,503
61405,380596,30879,183154,19080,349717,916,413,503
61410,380627,30883,183169,19083,349744,916,413,503
61415,380658,30887,183183,19086,349771,916,413,503
61420,380689,30891,183196,19088,349798,916,413,503
61425,380720,30894,183205,19090,349826,916,413,503
61430,380751,30898,183215,19091,349853,916,413,503
61435,380782,30903,183229,19093,349878,916,413,503
61440,380813,30910,183244,19098,349903,916,413,503
61445,380844,30914,183256,19099,349930,916,413,503
61450,380875,30919,183274,19103,349956,916,413,503
61455,380906,30922,183290,19104,349983,916,413,503
61460,380937,30927,183307,19108,350009,916,413,503
61465,380968,30930,183317,19110,350038,916,413,503
61470,380999,30931,183332,19110,350068,916,413,503
61475,381030,30932,183348,19110,350097,916,413,503
61480,381061,30934,183365,19112,350127,916,413,503
61485,381092,30934,183379,19112,350158,916,413,503
61490,381123,30934,183393,19112,350189,916,413,503
61495,381154,30934,183406,19112,350220,916,413,503
61500,381185,30934,183419,19112,350251,916,413,503
61505,381216,30936,183432,19113,350280,916,413,503
61510,381247,30938,183448,19114,350309,916,413,503
61515,381278,30939,183463,19115,350339,916,413,503
61520,381309,30941,183482,19116,350368,916,413,503
61525,381340,30943,183499,19118,350397,916,413,503
61530,381371,30945,183518,19119,350426,916,413,503
61535,381402,30946,183537,19119,350456,916,413,503
61540,381433,30947,183559,19120,350486,916,413,503
61545,381464,30948,183576,19121,350516,916,413,503
61550,381495,30949,183592,19121,350546,916,413,503
61555,381526,30950,183607,19121,350576,916,413,503
61560,381557,30951,183625,19121,350606,916,413,503
61565,381588,30953,183641,19123,350635,916,413,503
61570,381619,30954,183664,19124,350665,916,413,503
61575,381650,30956,183678,19126,350694,916,413,503
61580,381681,30958,183699,19128,350723,916,413,503
61585,381712,30961,183710,19131,350751,916,413,503
61590,381743,30964,183730,19133,350778,916,413,503
61595,381774,30967,183748,19136,350807,916,413,503
61600,381805,30969,183766,19136,350835,916,413,503
61605,381836,30972,183779,19137,350863,916,413,503
61610,381867,30976,183792,19140,350890,916,413,503
61615,381898,30980,183808,19142,350917,916,413,503
61620,381929,30984,183821,19143,350944,916,413,503
61625,381960,30989,183838,19148,350971,916,413,503
61630,381991,30991,183854,19150,350999,916,413,503
61635,382022,30994,183873,19152,351027,916,413,503
61640,382053,30997,183893,19154,351055,916,413,503
61645,382084,31000,183907,19156,351084,916,413,503
61650,382115,31002,183918,19157,351113,916,413,503
61655,382146,31004,183934,19158,351142,916,413,503
61660,382177,31007,183947,19160,351169,916,413,503
61665,382208,31011,183965,19163,351197,916,413,503
61670,382239,31013,183977,19164,351226,916,413,503
61675,382270,31017,183993,19167,351252,916,413,503
61680,382301,31022,184005,19170,351279,916,413,503
61685,382332,31024,184017,19172,351308,916,413,503
61690,382363,31026,184035,19174,351337,916,413,503
61695,382394,31027,184048,19175,351367,916,413,503
61700,382425,31028,184061,19175,351397,916,413,503
61705,382456,31030,184078,19177,351426,916,413,503
61710,382487,31031,184098,19178,351456,916,413,503
61715,382518,31032,184113,19179,351486,916,413,503
61720,382549,31033,184130,19179,351516,916,413,503
61725,382580,31035,184144,19180,351545,916,413,503
61730,382611,31039,184162,19184,351572,916,413,503
61735,382642,31043,184175,19186,351599,916,413,503
61740,382673,31046,184191,19188,351627,916,413,503
61745,382704,31050,184207,19190,351654,916,413,503
61750,382735,31052,184221,19191,351683,916,413,503
61755,382766,31054,184240,19191,351712,916,413,503
61760,382797,31056,184258,19191,351741,916,413,503
61765,382828,31058,184275,19192,351770,916,413,503
61770,382859,31060,184290,19193,351799,916,413,503
61775,382890,31062,184304,19193,351827,916,413,503
61780,382921,31065,184322,19195,351856,916,413,503
61785,382952,31067,184340,19196,351885,916,413,503
61790,382983,31071,184359,19199,351911,916,413,503
61795,383014,31075,184371,19202,351939,916,413,503
61800,383045,31077,184386,19204,351968,916,413,503
61805,383076,31078,184401,19205,351998,916,413,503
61810,383107,31079,184418,19205,352027,916,413,503
61815,383138,31081,184435,19206,352057,916,413,503
61820,383169,31082,184453,19207,352086,916,413,503
61825,383200,31084,184465,19208,352116,916,413,503
61830,383231,31085,184481,19208,352146,916,413,503
61835,383262,31086,184493,19209,352176,916,413,503
61840,383293,31087,184508,19209,352206,916,413,503
61845,383324,31088,184524,19210,352236,916,413,503
61850,383355,31091,184544,19212,352264,916,413,503
61855,383386,31093,184554,19213,352293,916,413,503
61860,383417,31095,184568,19214,352322,916,413,503
61865,383448,31101,184588,19219,352347,916,413,503
61870,383479,31106,184600,19221,352373,916,413,503
61875,383510,31111,184616,19224,352399,916,413,503
61880,383541,31116,184633,19226,352425,916,413,503
61885,383572,31121,184648,19229,352451,916,413,503
61890,383603,31126,184662,19232,352477,916,413,503
61895,383634,31132,184680,19235,352502,916,413,503
61900,383665,31138,184700,19238,352527,916,413,503
61905,383696,31145,184716,19241,352551,916,413,503
61910,383727,31148,184729,19243,352579,916,413,503
61915,383758,31153,184745,19246,352605,916,413,503
61920,383789,31156,184762,19248,352633,916,413,503
61925,383820,31156,184776,19248,352664,916,413,503
61930,383851,31156,184788,19248,352695,916,413,503
61935,383882,31156,184802,19248,352726,916,413,503
61940,383913,31156,184813,19248,352757,916,413,503
61945,383944,31156,184828,19248,352788,916,413,503
61950,383975,31156,184842,19248,352819,916,413,503
61955,384006,31156,184857,19248,352850,916,413,503
61960,384037,31156,184869,19248,352881,916,413,503
61965,384068,31156,184882,19248,352912,916,413,503
61970,384099,31156,184897,19248,352943,916,413,503
61975,384130,31156,184913,19248,352974,916,413,503
61980,384161,31156,184930,19248,353005,916,413,503
61985,384192,31156,184942,19248,353036,916,413,503
61990,384223,31156,184956,19248,353067,916,413,503
61995,384254,31156,184975,19248,353098,916,413,503
62000,384285,31156,184989,19248,353129,916,413,503
62005,384316,31156,185006,19248,353160,916,413,503
62010,384347,31156,185018,19248,353191,916,413,503
62015,384378,31157,185037,19249,353221,916,413,503
62020,384409,31158,185054,19249,353251,916,413,503
62025,384440,31161,185071,19251,353279,916,413,503
62030,384471,31166,185086,19254,353305,916,413,503
62035,384502,31172,185100,19258,353330,916,413,503
62040,384533,31177,185113,19261,353356,916,413,503
62045,384564,31183,185125,19265,353381,916,413,503
62050,384595,31186,185139,19266,353407,916,413,503
62055,384626,31192,185155,19271,353433,916,413,503
62060,384657,31196,185171,19273,353461,916,413,503
62065,384688,31199,185182,19276,353489,916,413,503
62070,384719,31201,185198,19276,353518,916,413,503
62075,384750,31203,185213,19276,353547,916,413,503
62080,384781,31205,185227,19276,353576,916,413,503
62085,384812,31208,185240,19278,353604,916,413,503
62090,384843,31210,185253,19278,353633,916,413,503
62095,384874,31213,185268,19280,353661,916,413,503
62100,384905,31215,185282,19281,353690,916,413,503
62105,384936,31217,185297,19282,353719,916,413,503
62110,384967,31219,185310,19283,353748,916,413,503
62115,384998,31221,185324,19285,353777,916,413,503
62120,385029,31224,185342,19288,353805,916,413,503
62125,385060,31227,185356,19290,353833,916,413,503
62130,385091,31230,185373,19292,353861,916,413,503
62135,385122,31232,185389,19293,353890,916,413,503
62140,385153,31234,185407,19295,353919,916,413,503
62145,385184,31237,185423,19297,353947,916,413,503
62150,385215,31238,185437,19297,353977,916,413,503
62155,385246,31241,185457,19299,354004,916,413,503
62160,385277,31244,185470,19301,354032,916,413,503
62165,385308,31249,185487,19305,354059,916,413,503
62170,385339,31252,185505,19308,354087,916,413,503
62175,385370,31255,185519,19309,354115,916,413,503
62180,385401,31257,185537,19311,354144,916,413,503
62185,385432,31259,185548,19311,354173,916,413,503
62190,385463,31262,185564,19314,354201,916,413,503
62195,385494,31265,185577,19316,354229,916,413,503
62200,385525,31268,185595,19319,354257,916,413,503
62205,385556,31270,185611,19320,354286,916,413,503
62210,385587,31272,185621,19321,354315,916,413,503
62215,385618,31274,185633,19322,354344,916,413,503
62220,385649,31276,185645,19323,354372,916,413,503
62225,385680,31281,185659,19327,354398,916,413,503
62230,385711,31286,185672,19331,354425,916,413,503
62235,385742,31289,185686,19332,354452,916,413,503
62240,385773,31294,185701,19336,354478,916,413,503
62245,385804,31297,185717,19338,354506,916,413,503
62250,385835,31300,185734,19341,354535,916,413,503
62255,385866,31303,185753,19342,354563,916,413,503
62260,385897,31306,185769,19343,354591,916,413,503
62265,385928,31309,185785,19343,354619,916,413,503
62270,385959,31312,185800,19346,354647,916,413,503
62275,385990,31316,185813,19349,354674,916,413,503
62280,386021,31320,185830,19353,354701,916,413,503
62285,386052,31322,185842,19354,354730,916,413,503
62290,386083,31323,185854,19355,354760,916,413,503
62295,386114,31326,185870,19357,354788,916,413,503
62300,386145,31328,185886,19359,354817,916,413,503
62305,386176,31329,185901,19360,354847,916,413,503
62310,386207,31331,185915,19362,354876,916,413,503
62315,386238,31333,185929,19363,354905,916,413,503
62320,386269,31334,185943,19364,354935,916,413,503
62325,386300,31336,185954,19365,354964,916,413,503
62330,386331,31337,185970,19366,354994,916,413,503
62335,386362,31338,185983,19367,355024,916,413,503
62340,386393,31339,185991,19368,355054,916,413,503
62345,386424,31340,186005,19369,355084,916,413,503
62350,386455,31341,186020,19369,355114,916,413,503
62355,386486,31343,186030,19371,355143,916,413,503
62360,386517,31345,186050,19373,355172,916,413,503
62365,386548,31348,186066,19376,355200,916,413,503
62370,386579,31350,186081,19378,355229,916,413,503
62375,386610,31352,186098,19379,355258,916,413,503
62380,386641,31354,186114,19380,355287,916,413,503
62385,386672,31358,186135,19382,355313,916,413,503
62390,386703,31364,186149,19387,355339,916,413,503
62395,386734,31368,186159,19389,355365,916,413,503
62400,386765,31372,186169,19392,355393,916,413,503
62405,386796,31377,186185,19394,355419,916,413,503
62410,386827,31383,186203,19399,355444,916,413,503
62415,386858,31386,186216,19400,355472,916,413,503
62420,386889,31389,186228,19402,355500,916,413,503
62425,386920,31392,186242,19403,355528,916,413,503
62430,386951,31394,186255,19404,355557,916,413,503
62435,386982,31398,186271,19407,355584,916,413,503
62440,387013,31400,186286,19408,355613,916,413,503
62445,387044,31404,186302,19411,355640,916,413,503
62450,387075,31406,186324,19412,355669,916,413,503
62455,387106,31408,186342,19414,355698,916,413,503
62460,387137,31408,186352,19414,355729,916,413,503
62465,387168,31409,186369,19415,355759,916,413,503
62470,387199,31409,186382,19415,355790,916,413,503
62475,387230,31409,186393,19415,355821,916,413,503
62480,387261,31409,186409,19415,355852,916,413,503
62485,387292,31409,186424,19415,355883,916,413,503
62490,387323,31409,186438,19415,355914,916,413,503
62495,387354,31409,186449,19415,355945,916,413,503
62500,387385,31409,186467,19415,355976,916,413,503
62505,387416,31409,186477,19415,356007,916,413,503
62510,387447,31409,186491,19415,356038,916,413,503
62515,387478,31411,186508,19417,356067,916,413,503
62520,387509,31414,186521,19419,356095,916,413,503
62525,387540,31419,186539,19424,356121,916,413,503
62530,387571,31423,186552,19426,356148,916,413,503
62535,387602,31426,186564,19428,356176,916,413,503
62540,387633,31430,186574,19429,356202,916,413,503
62545,387664,31434,186585,19432,356229,916,413,503
62550,387695,31438,186601,19434,356256,916,413,503
62555,387726,31443,186622,19438,356283,916,413,503
62560,387757,31447,186634,19441,356310,916,413,503
62565,387788,31450,186650,19443,356338,916,413,503
62570,387819,31454,186667,19445,356364,916,413,503
62575,387850,31459,186682,19448,356391,916,413,503
62580,387881,31462,186698,19450,356419,916,413,503
62585,387912,31466,186711,19453,356446,916,413,503
62590,387943,31471,186726,19457,356472,916,413,503
62595,387974,31475,186740,19459,356499,916,413,503
62600,388005,31478,186754,19460,356527,916,413,503
62605,388036,31480,186763,19461,356556,916,413,503
62610,388067,31482,186776,19463,356585,916,413,503
62615,388098,31485,186791,19464,356613,916,413,503
62620,388129,31487,186802,19465,356642,916,413,503
62625,388160,31489,186818,19466,356671,916,413,503
62630,388191,31492,186833,19469,356699,916,413,503
62635,388222,31495,186850,19471,356727,916,413,503
62640,388253,31499,186864,19474,356754,916,413,503
62645,388284,31501,186879,19475,356783,916,413,503
62650,388315,31504,186897,19478,356811,916,413,503
62655,388346,31507,186908,19480,356839,916,413,503
62660,388377,31509,186925,19481,356868,916,413,503
62665,388408,31513,186937,19483,356895,916,413,503
62670,388439,31514,186948,19483,356925,916,413,503
62675,388470,31515,186963,19484,356955,916,413,503
62680,388501,31516,186979,19484,356985,916,413,503
62685,388532,31518,186995,19484,357014,916,413,503
62690,388563,31520,187008,19485,357043,916,413,503
62695,388594,31522,187025,19486,357072,916,413,503
62700,388625,31524,187036,19486,357100,916,413,503
62705,388656,31530,187050,19489,357124,916,413,503
62710,388687,31534,187066,19493,357152,916,413,503
62715,388718,31536,187080,19495,357182,916,413,503
62720,388749,31537,187093,19495,357212,916,413,503
62725,388780,31538,187104,19495,357242,916,413,503
62730,388811,31539,187122,19495,357272,916,413,503
62735,388842,31540,187138,19495,357302,916,413,503
62740,388873,31541,187160,19495,357332,916,413,503
62745,388904,31542,187174,19496,357362,916,413,503
62750,388935,31544,187187,19497,357391,916,413,503
62755,388966,31546,187199,19499,357420,916,413,503
62760,388997,31549,187207,19501,357448,916,413,503
62765,389028,31552,187219,19502,357476,916,413,503
62770,389059,31555,187236,19505,357504,916,413,503
62775,389090,31557,187255,19506,357533,916,413,503
62780,389121,31560,187270,19509,357561,916,413,503
62785,389152,31562,187288,19509,357590,916,413,503
62790,389183,31565,187306,19511,357618,916,413,503
62795,389214,31567,187323,19512,357647,916,413,503
62800,389245,31570,187340,19515,357675,916,413,503
62805,389276,31573,187359,19517,357703,916,413,503
62810,389307,31574,187373,19518,357733,916,413,503
62815,389338,31576,187387,19518,357762,916,413,503
62820,389369,31578,187401,19518,357791,916,413,503
62825,389400,31582,187416,19521,357817,916,413,503
62830,389431,31585,187430,19522,357846,916,413,503
62835,389462,31587,187447,19522,357875,916,413,503
62840,389493,31590,187463,19523,357902,916,413,503
62845,389524,31595,187481,19526,357929,916,413,503
62850,389555,31598,187493,19527,357956,916,413,503
62855,389586,31601,187504,19528,357985,916,413,503
62860,389617,31604,187518,19530,358013,916,413,503
62865,389648,31608,187537,19532,358040,916,413,503
62870,389679,31612,187551,19535,358066,916,413,503
62875,389710,31617,187569,19539,358093,916,413,503
62880,389741,31620,187587,19541,358121,916,413,503
62885,389772,31622,187599,19541,358150,916,413,503
62890,389803,31624,187609,19542,358179,916,413,503
62895,389834,31626,187622,19542,358208,916,413,503
62900,389865,31628,187638,19544,358236,916,413,503
62905,389896,31631,187651,19545,358265,916,413,503
62910,389927,31633,187665,19546,358294,916,413,503
62915,389958,31636,187682,19548,358321,916,413,503
62920,389989,31640,187693,19551,358348,916,413,503
62925,390020,31644,187707,19553,358375,916,413,503
62930,390051,31648,187723,19556,358403,916,413,503
62935,390082,31650,187736,19557,358432,916,413,503
62940,390113,31652,187753,19558,358461,916,413,503
62945,390144,31653,187767,19558,358491,916,413,503
62950,390175,31654,187783,19558,358521,916,413,503
62955,390206,31655,187798,19558,358551,916,413,503
62960,390237,31656,187819,19558,358581,916,413,503
62965,390268,31657,187836,19558,358611,916,413,503
62970,390299,31658,187851,19559,358641,916,413,503
62975,390330,31659,187862,19559,358671,916,413,503
62980,390361,31660,187880,19559,358701,916,413,503
62985,390392,31661,187897,19559,358731,916,413,503
62990,390423,31662,187906,19559,358761,916,413,503
62995,390454,31664,187917,19561,358790,916,413,503
63000,390485,31667,187930,19563,358818,916,413,503
63005,390516,31670,187941,19564,358846,916,413,503
63010,390547,31674,187959,19567,358873,916,413,503
63015,390578,31679,187981,19570,358899,916,413,503
63020,390609,31683,187997,19574,358926,916,413,503
63025,390640,31688,188017,19579,358952,916,413,503
63030,390671,31692,188033,19582,358979,916,413,503
63035,390702,31696,188054,19585,359006,916,413,503
63040,390733,31700,188072,19589,359033,916,413,503
63045,390764,31703,188082,19590,359061,916,413,503
63050,390795,31707,188100,19591,359088,916,413,503
63055,390826,31711,188114,19594,359114,916,413,503
63060,390857,31715,188132,19596,359141,916,413,503
63065,390888,31717,188143,19597,359171,916,413,503
63070,390919,31719,188163,19599,359200,916,413,503
63075,390950,31721,188177,19601,359229,916,413,503
63080,390981,31722,188198,19602,359259,916,413,503
63085,391012,31723,188212,19602,359289,916,413,503
63090,391043,31724,188232,19603,359319,916,413,503
63095,391074,31725,188244,19603,359349,916,413,503
63100,391105,31726,188256,19604,359379,916,413,503
63105,391136,31728,188272,19606,359407,916,413,503
63110,391167,31732,188287,19608,359434,916,413,503
63115,391198,31735,188301,19609,359463,916,413,503
63120,391229,31737,188316,19611,359492,916,413,503
63125,391260,31740,188332,19612,359519,916,413,503
63130,391291,31745,188345,19617,359546,916,413,503
63135,391322,31748,188364,19619,359573,916,413,503
63140,391353,31751,188376,19621,359601,916,413,503
63145,391384,31755,188394,19625,359628,916,413,503
63150,391415,31759,188407,19627,359656,916,413,503
63155,391446,31760,188422,19628,359686,916,413,503
63160,391477,31761,188440,19628,359716,916,413,503
63165,391508,31763,188456,19629,359745,916,413,503
63170,391539,31765,188471,19630,359774,916,413,503
63175,391570,31767,188492,19632,359803,916,413,503
63180,391601,31769,188511,19632,359832,916,413,503
63185,391632,31775,188524,19635,359857,917,413,504
63190,391663,31778,188540,19635,359885,917,413,504
63195,391694,31782,188556,19638,359912,917,413,504
63200,391725,31785,188564,19640,359939,917,413,504
63205,391756,31788,188582,19642,359968,917,413,504
63210,391787,31790,188594,19642,359997,917,413,504
63215,391818,31792,188611,19644,360026,917,413,504
63220,391849,31794,188621,19645,360055,917,413,504
63225,391880,31796,188638,19646,360084,917,413,504
63230,391911,31798,188655,19648,360113,917,413,504
63235,391942,31800,188669,19648,360142,917,413,504
63240,391973,31803,188683,19650,360170,917,413,504
63245,392004,31807,188702,19652,360196,917,413,504
63250,392035,31811,188715,19655,360224,917,413,504
63255,392066,31814,188727,19656,360252,917,413,504
63260,392097,31817,188747,19658,360279,917,413,504
63265,392128,31821,188764,19661,360307,917,413,504
63270,392159,31821,188782,19661,360338,917,413,504
63275,392190,31821,188801,19661,360369,917,413,504
63280,392221,31821,188814,19661,360400,917,413,504
63285,392252,31821,188833,19661,360431,917,413,504
63290,392283,31821,188846,19661,360462,918,413,505
63295,392314,31822,188863,19661,360492,919,413,506
63300,392345,31824,188880,19662,360521,919,413,506
63305,392376,31827,188901,19664,360549,919,413,506
63310,392407,31829,188917,19665,360578,919,413,506
63315,392438,31831,188926,19666,360607,919,413,506
63320,392469,31833,188935,19666,360636,919,413,506
63325,392500,31835,188951,19667,360665,919,413,506
63330,392531,31837,188964,19667,360694,919,413,506
63335,392562,31840,188976,19669,360722,919,413,506
63340,392593,31842,188994,19670,360751,919,413,506
63345,392624,31845,189009,19671,360779,919,413,506
63350,392655,31848,189028,19674,360807,919,413,506
63355,392686,31853,189043,19676,360833,919,413,506
63360,392717,31856,189059,19679,360861,919,413,506
63365,392748,31860,189072,19682,360888,919,413,506
63370,392779,31865,189092,19687,360914,919,413,506
63375,392810,31869,189106,19691,360941,919,413,506
63380,392841,31874,189122,19693,360967,919,413,506
63385,392872,31878,189136,19695,360994,919,413,506
63390,392903,31882,189153,19697,361021,919,413,506
63395,392934,31886,189166,19698,361048,919,413,506
63400,392965,31891,189185,19703,361074,919,413,506
63405,392996,31894,189204,19705,361102,919,413,506
63410,393027,31896,189218,19705,361131,919,413,506
63415,393058,31899,189239,19707,361158,919,413,506
63420,393089,31903,189260,19709,361185,919,413,506
63425,393120,31905,189274,19711,361215,919,413,506
63430,393151,31905,189289,19711,361246,919,413,506
63435,393182,31905,189301,19711,361277,919,413,506
63440,393213,31905,189318,19711,361308,919,413,506
63445,393244,31905,189333,19711,361339,919,413,506
63450,393275,31905,189346,19711,361370,919,413,506
63455,393306,31905,189357,19711,361401,919,413,506
63460,393337,31905,189370,19711,361432,919,413,506
63465,393368,31906,189387,19711,361462,919,413,506
63470,393399,31907,189403,19711,361492,919,413,506
63475,393430,31908,189414,19711,361522,919,413,506
63480,393461,31909,189423,19712,361552,919,413,506
63485,393492,31912,189438,19712,361580,919,413,506
63490,393523,31915,189455,19714,361608,919,413,506
63495,393554,31918,189471,19715,361636,919,413,506
63500,393585,31921,189489,19718,361664,919,413,506
63505,393616,31924,189508,19719,361692,919,413,506
63510,393647,31927,189526,19721,361720,919,413,506
63515,393678,31931,189540,19723,361747,919,413,506
63520,393709,31935,189558,19726,361774,919,413,506
63525,393740,31939,189571,19728,361801,919,413,506
63530,393771,31944,189585,19733,361827,919,413,506
63535,393802,31951,189606,19739,361850,919,413,506
63540,393833,31958,189622,19744,361875,919,413,506
63545,393864,31959,189636,19744,361905,919,413,506
63550,393895,31960,189651,19744,361935,919,413,506
63555,393926,31961,189667,19745,361965,919,413,506
63560,393957,31962,189681,19745,361995,919,413,506
63565,393988,31963,189694,19746,362025,919,413,506
63570,394019,31964,189704,19746,362055,919,413,506
63575,394050,31965,189715,19747,362085,919,413,506
63580,394081,31966,189727,19747,362115,919,413,506
63585,394112,31967,189739,19748,362145,919,413,506
63590,394143,31968,189755,19748,362175,919,413,506
63595,394174,31969,189771,19749,362205,919,413,506
63600,394205,31970,189789,19750,362235,919,413,506
63605,394236,31971,189803,19751,362265,920,414,506
63610,394267,31972,189820,19751,362295,921,415,506
63615,394298,31973,189835,19751,362325,922,415,507
63620,394329,31974,189845,19751,362355,923,415,508
63625,394360,31975,189858,19751,362385,924,415,509
63630,394391,31976,189873,19752,362415,925,415,510
63635,394422,31977,189885,19752,362445,926,416,510
63640,394453,31978,189901,19753,362475,927,416,511
63645,394484,31982,189921,19756,362502,927,416,511
63650,394515,31988,189936,19760,362527,927,416,511
63655,394546,31993,189953,19765,362553,927,416,511
63660,394577,31998,189970,19767,362578,927,416,511
63665,394608,32003,189983,19770,362604,928,416,512
63670,394639,32006,189999,19773,362633,929,416,513
63675,394670,32009,190014,19774,362661,930,416,514
63680,394701,32012,190029,19776,362689,931,416,515
63685,394732,32014,190046,19777,362718,932,417,515
63690,394763,32016,190062,19779,362747,933,417,516
63695,394794,32019,190079,19781,362775,934,418,516
63700,394825,32022,190094,19783,362803,935,419,516
63705,394856,32023,190110,19783,362833,935,419,516
63710,394887,32024,190121,19784,362863,935,419,516
63715,394918,32025,190136,19785,362893,935,419,516
63720,394949,32026,190146,19785,362923,935,419,516
63725,394980,32029,190161,19788,362950,935,419,516
63730,395011,32034,190175,19793,362976,935,419,516
63735,395042,32037,190194,19795,363005,935,419,516
63740,395073,32038,190208,19795,363034,935,419,516
63745,395104,32042,190227,19798,363062,935,419,516
63750,395135,32042,190244,19798,363093,935,419,516
63755,395166,32042,190259,19798,363124,935,419,516
63760,395197,32042,190276,19798,363155,935,419,516
63765,395228,32042,190289,19798,363186,935,419,516
63770,395259,32043,190305,19799,363216,935,419,516
63775,395290,32046,190319,19802,363244,935,419,516
63780,395321,32047,190335,19803,363274,935,419,516
63785,395352,32048,190347,19803,363304,935,419,516
63790,395383,32049,190366,19804,363334,935,419,516
63795,395414,32050,190380,19805,363364,935,419,516
63800,395445,32051,190394,19805,363394,935,419,516
63805,395476,32053,190408,19806,363423,935,419,516
63810,395507,32055,190422,19806,363452,936,419,517
63815,395538,32057,190435,19807,363481,937,420,517
63820,395569,32059,190447,19808,363510,938,420,518
63825,395600,32061,190464,19810,363539,939,420,519
63830,395631,32063,190481,19811,363568,940,420,520
63835,395662,32065,190500,19812,363597,941,420,521
63840,395693,32067,190513,19812,363626,942,421,521
63845,395724,32070,190527,19814,363654,942,421,521
63850,395755,32074,190542,19815,363681,942,421,521
63855,395786,32079,190558,19816,363707,942,421,521
63860,395817,32085,190574,19820,363732,942,421,521
63865,395848,32091,190591,19825,363756,942,421,521
63870,395879,32098,190604,19830,363780,942,421,521
63875,395910,32104,190620,19835,363804,942,421,521
63880,395941,32112,190632,19841,363828,942,421,521
63885,395972,32119,190651,19848,363852,942,421,521
63890,396003,32127,190663,19852,363875,942,421,521
63895,396034,32131,190680,19855,363903,942,421,521
63900,396065,32137,190698,19860,363928,942,421,521
63905,396096,32139,190711,19862,363957,942,421,521
63910,396127,32141,190726,19863,363986,942,421,521
63915,396158,32143,190742,19865,364015,942,421,521
63920,396189,32144,190751,19865,364045,942,421,521
63925,396220,32146,190765,19866,364074,942,421,521
63930,396251,32146,190779,19866,364105,942,421,521
63935,396282,32146,190797,19866,364136,942,421,521
63940,396313,32146,190811,19866,364167,942,421,521
63945,396344,32146,190829,19866,364198,942,421,521
63950,396375,32146,190845,19866,364229,942,421,521
63955,396406,32146,190862,19866,364260,942,421,521
63960,396437,32146,190873,19866,364291,942,421,521
63965,396468,32148,190887,19867,364319,942,421,521
63970,396499,32151,190905,19869,364348,942,421,521
63975,396530,32151,190921,19869,364379,942,421,521
63980,396561,32151,190935,19869,364410,942,421,521
63985,396592,32151,190949,19869,364441,942,421,521
63990,396623,32151,190965,19869,364472,942,421,521
63995,396654,32151,190978,19869,364503,942,421,521
64000,396685,32152,190990,19870,364533,942,421,521
64005,396716,32155,191004,19872,364560,942,421,521
64010,396747,32158,191020,19873,364588,942,421,521
64015,396778,32163,191037,19875,364614,942,421,521
64020,396809,32169,191053,19880,364640,942,421,521
64025,396840,32173,191072,19881,364667,942,421,521
64030,396871,32178,191092,19885,364693,942,421,521
64035,396902,32182,191104,19889,364720,942,421,521
64040,396933,32185,191119,19890,364748,942,421,521
64045,396964,32187,191135,19890,364777,942,421,521
64050,396995,32189,191155,19892,364806,942,421,521
64055,397026,32191,191168,19892,364835,942,421,521
64060,397057,32193,191187,19893,364864,942,421,521
64065,397088,32195,191203,19893,364893,942,421,521
64070,397119,32197,191221,19894,364922,942,421,521
64075,397150,32199,191233,19894,364950,942,421,521
64080,397181,32202,191254,19896,364978,942,421,521
64085,397212,32205,191268,19898,365007,942,421,521
64090,397243,32208,191280,19900,365035,942,421,521
64095,397274,32211,191295,19903,365063,942,421,521
64100,397305,32213,191315,19904,365092,942,421,521
64105,397336,32215,191328,19904,365121,942,421,521
64110,397367,32218,191346,19906,365149,942,421,521
64115,397398,32221,191362,19907,365177,942,421,521
64120,397429,32224,191376,19909,365205,942,421,521
64125,397460,32229,191388,19912,365231,942,421,521
64130,397491,32233,191403,19915,365257,942,421,521
64135,397522,32238,191416,19918,365284,942,421,521
64140,397553,32241,191429,19919,365312,942,421,521
64145,397584,32245,191447,19922,365339,942,421,521
64150,397615,32247,191466,19924,365368,942,421,521
64155,397646,32251,191483,19927,365395,942,421,521
64160,397677,32255,191498,19930,365422,942,421,521
64165,397708,32257,191514,19932,365451,942,421,521
64170,397739,32258,191528,19932,365481,942,421,521
64175,397770,32259,191543,19933,365511,942,421,521
64180,397801,32260,191555,19933,365541,942,421,521
64185,397832,32261,191568,19933,365570,942,421,521
64190,397863,32263,191580,19934,365600,942,421,521
64195,397894,32264,191591,19934,365630,942,421,521
64200,397925,32265,191612,19935,365660,942,421,521
64205,397956,32266,191627,19935,365690,942,421,521
64210,397987,32267,191647,19936,365720,942,421,521
64215,398018,32268,191657,19936,365750,942,421,521
64220,398049,32269,191675,19937,365780,942,421,521
64225,398080,32270,191684,19937,365810,942,421,521
64230,398111,32271,191701,19937,365840,942,421,521
64235,398142,32272,191715,19938,365870,942,421,521
64240,398173,32273,191728,19938,365900,942,421,521
64245,398204,32274,191746,19939,365930,942,421,521
64250,398235,32275,191760,19940,365960,942,421,521
64255,398266,32276,191773,19940,365990,942,421,521
64260,398297,32277,191788,19940,366020,942,421,521
64265,398328,32280,191801,19942,366048,942,421,521
64270,398359,32284,191817,19945,366075,942,421,521
64275,398390,32288,191832,19948,366102,942,421,521
64280,398421,32293,191851,19953,366128,942,421,521
64285,398452,32297,191868,19955,366155,942,421,521
64290,398483,32300,191879,19956,366183,942,421,521
64295,398514,32305,191897,19960,366209,942,421,521
64300,398545,32308,191911,19963,366237,942,421,521
64305,398576,32311,191925,19965,366264,942,421,521
64310,398607,32319,191943,19972,366288,942,421,521
64315,398638,32324,191959,19974,366314,942,421,521
64320,398669,32330,191977,19979,366339,942,421,521
64325,398700,32333,191996,19981,366367,942,421,521
64330,398731,32337,192008,19982,366394,942,421,521
64335,398762,32341,192025,19984,366421,942,421,521
64340,398793,32344,192040,19985,366449,942,421,521
64345,398824,32348,192053,19987,366476,942,421,521
64350,398855,32351,192065,19987,366504,942,421,521
64355,398886,32353,192083,19988,366533,942,421,521
64360,398917,32355,192097,19989,366562,942,421,521
64365,398948,32357,192112,19990,366590,942,421,521
64370,398979,32360,192123,19992,366619,942,421,521
64375,399010,32362,192134,19993,366648,942,421,521
64380,399041,32364,192146,19993,366677,942,421,521
64385,399072,32366,192161,19995,366705,942,421,521
64390,399103,32369,192175,19997,366734,942,421,521
64395,399134,32371,192190,19998,366763,942,421,521
64400,399165,32373,192206,19999,366792,942,421,521
64405,399196,32375,192217,20000,366821,942,421,521
64410,399227,32377,192229,20000,366850,942,421,521
64415,399258,32379,192243,20000,366879,942,421,521
64420,399289,32381,192255,20000,366908,942,421,521
64425,399320,32385,192271,20003,366935,942,421,521
64430,399351,32388,192282,20005,366962,942,421,521
64435,399382,32391,192297,20008,366991,942,421,521
64440,399413,32394,192310,20010,367019,942,421,521
64445,399444,32397,192326,20013,367047,942,421,521
64450,399475,32399,192335,20014,367076,942,421,521
64455,399506,32401,192349,20015,367105,942,421,521
64460,399537,32403,192361,20015,367134,942,421,521
64465,399568,32405,192374,20015,367163,942,421,521
64470,399599,32407,192392,20016,367192,942,421,521
64475,399630,32409,192406,20017,367221,942,421,521
64480,399661,32411,192422,20018,367250,942,421,521
64485,399692,32413,192434,20020,367279,942,421,521
64490,399723,32415,192452,20020,367308,942,421,521
64495,399754,32417,192468,20022,367337,942,421,521
64500,399785,32419,192483,20023,367366,942,421,521
64505,399816,32421,192496,20024,367395,942,421,521
64510,399847,32423,192510,20024,367424,942,421,521
64515,399878,32425,192524,20024,367453,942,421,521
64520,399909,32427,192541,20026,367482,942,421,521
64525,399940,32429,192553,20026,367511,942,421,521
64530,399971,32431,192569,20027,367540,942,421,521
64535,400002,32433,192580,20028,367569,942,421,521
64540,400033,32435,192601,20029,367598,942,421,521
64545,400064,32437,192615,20029,367627,942,421,521
64550,400095,32441,192627,20031,367653,942,421,521
64555,400126,32448,192644,20037,367678,942,421,521
64560,400157,32452,192652,20039,367705,942,421,521
64565,400188,32455,192664,20040,367732,942,421,521
64570,400219,32459,192682,20041,367759,942,421,521
64575,400250,32466,192699,20046,367783,942,421,521
64580,400281,32472,192715,20049,367808,942,421,521
64585,400312,32477,192726,20053,367835,942,421,521
64590,400343,32480,192744,20056,367863,942,421,521
64595,400374,32482,192762,20058,367892,942,421,521
64600,400405,32484,192771,20059,367921,942,421,521
64605,400436,32486,192784,20059,367950,942,421,521
64610,400467,32489,192797,20060,367978,942,421,521
64615,400498,32491,192810,20060,368007,942,421,521
64620,400529,32494,192824,20062,368035,942,421,521
64625,400560,32495,192834,20063,368065,942,421,521
64630,400591,32496,192853,20064,368095,942,421,521
64635,400622,32497,192865,20064,368125,942,421,521
64640,400653,32498,192881,20065,368155,942,421,521
64645,400684,32499,192897,20065,368185,942,421,521
64650,400715,32500,192910,20065,368215,942,421,521
64655,400746,32501,192926,20066,368245,942,421,521
64660,400777,32502,192942,20066,368275,942,421,521
64665,400808,32503,192956,20067,368305,942,421,521
64670,400839,32504,192971,20068,368335,942,421,521
64675,400870,32506,192985,20069,368364,942,421,521
64680,400901,32508,192999,20071,368393,942,421,521
64685,400932,32510,193016,20072,368422,942,421,521
64690,400963,32513,193027,20073,368450,942,421,521
64695,400994,32517,193044,20075,368476,942,421,521
64700,401025,32522,193057,20077,368502,942,421,521
64705,401056,32526,193068,20080,368530,942,421,521
64710,401087,32529,193080,20080,368558,942,421,521
64715,401118,32533,193091,20082,368585,942,421,521
64720,401149,32536,193111,20085,368612,942,421,521
64725,401180,32541,193125,20088,368638,942,421,521
64730,401211,32546,193134,20090,368665,942,421,521
64735,401242,32549,193154,20092,368692,942,421,521
64740,401273,32553,193169,20094,368719,942,421,521
64745,401304,32557,193185,20097,368747,942,421,521
64750,401335,32561,193202,20099,368773,942,421,521
64755,401366,32565,193213,20100,368801,942,421,521
64760,401397,32568,193225,20101,368829,942,421,521
64765,401428,32572,193240,20104,368856,942,421,521
64770,401459,32576,193255,20105,368883,942,421,521
64775,401490,32580,193270,20106,368910,942,421,521
64780,401521,32586,193282,20109,368935,942,421,521
64785,401552,32590,193296,20111,368962,942,421,521
64790,401583,32593,193314,20113,368990,942,421,521
64795,401614,32596,193323,20116,369018,942,421,521
64800,401645,32600,193343,20119,369045,942,421,521
64805,401676,32605,193357,20123,369071,942,421,521
64810,401707,32606,193371,20124,369101,942,421,521
64815,401738,32606,193386,20124,369132,942,421,521
64820,401769,32606,193393,20124,369163,942,421,521
64825,401800,32606,193408,20124,369194,942,421,521
64830,401831,32606,193421,20124,369225,942,421,521
64835,401862,32606,193432,20124,369256,942,421,521
64840,401893,32606,193445,20124,369287,942,421,521
64845,401924,32608,193464,20125,369315,942,421,521
64850,401955,32610,193477,20127,369344,942,421,521
64855,401986,32612,193493,20128,369373,942,421,521
64860,402017,32615,193511,20131,369402,942,421,521
64865,402048,32617,193524,20132,369430,942,421,521
64870,402079,32621,193541,20136,369457,942,421,521
64875,402110,32624,193551,20138,369486,942,421,521
64880,402141,32626,193564,20138,369515,942,421,521
64885,402172,32629,193580,20141,369543,942,421,521
64890,402203,32631,193593,20141,369572,942,421,521
64895,402234,32633,193609,20142,369601,942,421,521
64900,402265,32635,193629,20144,369630,942,421,521
64905,402296,32637,193645,20146,369659,942,421,521
64910,402327,32640,193662,20149,369686,942,421,521
64915,402358,32646,193674,20153,369712,942,421,521
64920,402389,32652,193693,20158,369736,942,421,521
64925,402420,32655,193709,20161,369765,942,421,521
64930,402451,32658,193724,20163,369793,942,421,521
64935,402482,32660,193736,20163,369822,942,421,521
64940,402513,32662,193747,20164,369851,942,421,521
64945,402544,32665,193762,20165,369879,942,421,521
64950,402575,32668,193779,20166,369907,942,421,521
64955,402606,32671,193793,20168,369935,942,421,521
64960,402637,32674,193808,20170,369963,942,421,521
64965,402668,32676,193826,20172,369992,942,421,521
64970,402699,32678,193837,20172,370021,942,421,521
64975,402730,32680,193851,20173,370050,942,421,521
64980,402761,32683,193866,20176,370078,942,421,521
64985,402792,32686,193881,20177,370106,942,421,521
64990,402823,32690,193899,20179,370132,942,421,521
64995,402854,32694,193918,20182,370160,942,421,521
65000,402885,32698,193931,20185,370187,942,421,521
65005,402916,32701,193941,20186,370214,942,421,521
65010,402947,32705,193956,20189,370241,942,421,521
65015,402978,32709,193969,20191,370269,942,421,521
65020,403009,32712,193986,20193,370296,942,421,521
65025,403040,32716,193999,20195,370324,942,421,521
65030,403071,32722,194016,20199,370348,942,421,521
65035,403102,32729,194032,20204,370371,942,421,521
65040,403133,32737,194046,20210,370396,942,421,521
65045,403164,32738,194060,20211,370426,942,421,521
65050,403195,32739,194075,20212,370456,942,421,521
65055,403226,32740,194088,20212,370486,942,421,521
65060,403257,32741,194102,20212,370516,942,421,521
65065,403288,32742,194114,20212,370545,942,421,521
65070,403319,32744,194126,20213,370574,942,421,521
65075,403350,32746,194142,20215,370603,942,421,521
65080,403381,32748,194157,20217,370633,942,421,521
65085,403412,32749,194173,20218,370663,942,421,521
65090,403443,32750,194187,20219,370693,942,421,521
65095,403474,32751,194194,20219,370723,942,421,521
65100,403505,32751,194213,20219,370754,942,421,521
65105,403536,32753,194227,20220,370783,942,421,521
65110,403567,32755,194245,20222,370812,942,421,521
65115,403598,32757,194260,20224,370841,942,421,521
65120,403629,32758,194276,20225,370871,942,421,521
65125,403660,32760,194292,20227,370900,942,421,521
65130,403691,32762,194305,20228,370929,942,421,521
65135,403722,32764,194323,20230,370958,942,421,521
65140,403753,32765,194342,20231,370988,942,421,521
65145,403784,32767,194356,20233,371017,942,421,521
65150,403815,32768,194372,20233,371047,942,421,521
65155,403846,32770,194388,20235,371076,942,421,521
65160,403877,32773,194406,20236,371104,942,421,521
65165,403908,32777,194421,20240,371130,942,421,521
65170,403939,32781,194429,20241,371157,942,421,521
65175,403970,32785,194444,20245,371183,942,421,521
65180,404001,32790,194457,20247,371210,942,421,521
65185,404032,32794,194472,20250,371237,942,421,521
65190,404063,32798,194489,20252,371265,942,421,521
65195,404094,32801,194508,20254,371292,942,421,521
65200,404125,32805,194520,20256,371320,942,421,521
65205,404156,32808,194531,20257,371348,942,421,521
65210,404187,32811,194543,20258,371376,942,421,521
65215,404218,32814,194560,20259,371404,942,421,521
65220,404249,32817,194576,20261,371432,942,421,521
65225,404280,32819,194593,20261,371461,942,421,521
65230,404311,32821,194611,20262,371490,942,421,521
65235,404342,32823,194621,20262,371519,942,421,521
65240,404373,32826,194639,20264,371547,942,421,521
65245,404404,32828,194650,20265,371576,942,421,521
65250,404435,32830,194662,20266,371605,942,421,521
65255,404466,32833,194672,20267,371633,942,421,521
65260,404497,32834,194690,20268,371663,942,421,521
65265,404528,32836,194711,20270,371692,942,421,521
65270,404559,32839,194729,20272,371720,942,421,521
65275,404590,32843,194743,20274,371747,942,421,521
65280,404621,32847,194763,20277,371774,942,421,521
65285,404652,32849,194775,20278,371803,942,421,521
65290,404683,32852,194792,20280,371831,942,421,521
65295,404714,32854,194808,20282,371860,942,421,521
65300,404745,32857,194824,20284,371888,942,421,521
65305,404776,32859,194838,20285,371917,942,421,521
65310,404807,32862,194854,20286,371944,942,421,521
65315,404838,32866,194866,20289,371972,942,421,521
65320,404869,32868,194881,20291,372000,942,421,521
65325,404900,32871,194896,20293,372029,942,421,521
65330,404931,32873,194912,20294,372058,942,421,521
65335,404962,32875,194930,20295,372087,942,421,521
65340,404993,32877,194944,20297,372116,942,421,521
65345,405024,32881,194964,20301,372142,942,421,521
65350,405055,32884,194982,20304,372171,942,421,521
65355,405086,32886,194996,20305,372200,942,421,521
65360,405117,32888,195013,20307,372229,942,421,521
65365,405148,32890,195030,20309,372258,942,421,521
65370,405179,32892,195042,20310,372287,942,421,521
65375,405210,32894,195054,20312,372316,942,421,521
65380,405241,32896,195065,20313,372345,942,421,521
65385,405272,32898,195080,20314,372373,942,421,521
65390,405303,32901,195091,20316,372402,942,421,521
65395,405334,32903,195105,20316,372431,942,421,521
65400,405365,32906,195118,20317,372459,942,421,521
65405,405396,32909,195132,20318,372487,942,421,521
65410,405427,32913,195145,20321,372514,942,421,521
65415,405458,32915,195162,20323,372543,942,421,521
65420,405489,32917,195174,20324,372572,942,421,521
65425,405520,32919,195191,20325,372601,942,421,521
65430,405551,32920,195205,20325,372631,942,421,521
65435,405582,32922,195223,20326,372660,942,421,521
65440,405613,32924,195242,20328,372689,942,421,521
65445,405644,32924,195256,20328,372720,942,421,521
65450,405675,32924,195273,20328,372751,942,421,521
65455,405706,32925,195286,20328,372781,942,421,521
65460,405737,32927,195304,20330,372809,942,421,521
65465,405768,32931,195321,20333,372837,942,421,521
65470,405799,32934,195335,20335,372865,942,421,521
65475,405830,32937,195353,20338,372893,942,421,521
65480,405861,32939,195368,20339,372922,942,421,521
65485,405892,32941,195380,20339,372951,942,421,521
65490,405923,32943,195394,20340,372980,942,421,521
65495,405954,32945,195409,20341,373009,942,421,521
65500,405985,32947,195422,20341,373038,942,421,521
65505,406016,32949,195439,20342,373067,942,421,521
65510,406047,32950,195452,20343,373097,942,421,521
65515,406078,32952,195467,20344,373126,942,421,521
65520,406109,32954,195483,20346,373155,942,421,521
65525,406140,32958,195498,20347,373180,942,421,521
65530,406171,32963,195516,20351,373207,942,421,521
65535,406202,32967,195533,20354,373234,942,421,521
65540,406233,32971,195543,20356,373262,942,421,521
65545,406264,32974,195556,20358,373290,942,421,521
65550,406295,32979,195574,20361,373316,942,421,521
65555,406326,32982,195588,20361,373343,942,421,521
65560,406357,32985,195603,20363,373372,942,421,521
65565,406388,32987,195615,20365,373401,942,421,521
65570,406419,32992,195629,20369,373427,942,421,521
65575,406450,32993,195641,20370,373457,942,421,521
65580,406481,32995,195656,20371,373486,942,421,521
65585,406512,32996,195673,20371,373516,942,421,521
65590,406543,32996,195690,20371,373547,942,421,521
65595,406574,32996,195709,20371,373578,942,421,521
65600,406605,32996,195724,20371,373609,942,421,521
65605,406636,32996,195740,20371,373640,942,421,521
65610,406667,32996,195757,20371,373671,942,421,521
65615,406698,32996,195767,20371,373702,942,421,521
65620,406729,32996,195784,20371,373733,942,421,521
65625,406760,32996,195794,20371,373764,942,421,521
65630,406791,32997,195816,20372,373794,942,421,521
65635,406822,32998,195834,20372,373823,942,421,521
65640,406853,33001,195851,20374,373852,942,421,521
65645,406884,33004,195862,20375,373880,942,421,521
65650,406915,33007,195873,20377,373908,942,421,521
65655,406946,33011,195887,20379,373934,942,421,521
65660,406977,33015,195905,20382,373961,942,421,521
65665,407008,33019,195919,20385,373989,942,421,521
65670,407039,33023,195932,20388,374016,942,421,521
65675,407070,33027,195945,20389,374043,942,421,521
65680,407101,33032,195958,20392,374069,942,421,521
65685,407132,33037,195976,20395,374094,942,421,521
65690,407163,33043,195991,20399,374119,942,421,521
65695,407194,33047,196007,20401,374147,942,421,521
65700,407225,33052,196022,20404,374172,942,421,521
65705,407256,33057,196040,20407,374198,942,421,521
65710,407287,33061,196056,20409,374226,942,421,521
65715,407318,33064,196069,20409,374253,942,421,521
65720,407349,33068,196086,20412,374281,942,421,521
65725,407380,33071,196099,20413,374309,942,421,521
65730,407411,33075,196113,20415,374336,942,421,521
65735,407442,33078,196133,20416,374363,942,421,521
65740,407473,33082,196145,20418,374391,942,421,521
65745,407504,33086,196157,20420,374418,942,421,521
65750,407535,33089,196173,20420,374446,942,421,521
65755,407566,33093,196189,20423,374473,942,421,521
65760,407597,33097,196205,20425,374500,942,421,521
65765,407628,33098,196214,20426,374530,942,421,521
65770,407659,33100,196225,20428,374558,942,421,521
65775,407690,33102,196241,20430,374588,942,421,521
65780,407721,33102,196253,20430,374619,942,421,521
65785,407752,33102,196268,20430,374650,942,421,521
65790,407783,33102,196283,20430,374681,942,421,521
65795,407814,33102,196297,20430,374712,942,421,521
65800,407845,33103,196314,20431,374742,942,421,521
65805,407876,33104,196334,20431,374772,942,421,521
65810,407907,33105,196350,20432,374802,942,421,521
65815,407938,33106,196366,20433,374832,942,421,521
65820,407969,33107,196376,20433,374862,942,421,521
65825,408000,33110,196389,20435,374890,942,421,521
65830,408031,33112,196400,20436,374919,942,421,521
65835,408062,33114,196420,20438,374948,942,421,521
65840,408093,33116,196436,20439,374977,942,421,521
65845,408124,33118,196452,20439,375006,942,421,521
65850,408155,33120,196469,20440,375035,942,421,521
65855,408186,33122,196483,20441,375064,942,421,521
65860,408217,33124,196500,20442,375093,942,421,521
65865,408248,33127,196514,20444,375121,942,421,521
65870,408279,33132,196526,20448,375147,942,421,521
65875,408310,33137,196540,20451,375172,942,421,521
65880,408341,33142,196555,20455,375199,942,421,521
65885,408372,33144,196571,20457,375227,942,421,521
65890,408403,33147,196584,20459,375255,942,421,521
65895,408434,33150,196592,20461,375284,942,421,521
65900,408465,33152,196608,20462,375311,942,421,521
65905,408496,33156,196626,20465,375339,942,421,521
65910,408527,33159,196642,20467,375367,942,421,521
65915,408558,33162,196659,20470,375395,942,421,521
65920,408589,33165,196672,20471,375423,942,421,521
65925,408620,33168,196691,20474,375450,942,421,521
65930,408651,33172,196707,20476,375477,942,421,521
65935,408682,33175,196721,20478,375507,942,421,521
65940,408713,33176,196734,20478,375537,942,421,521
65945,408744,33177,196750,20478,375567,942,421,521
65950,408775,33178,196766,20479,375597,942,421,521
65955,408806,33179,196779,20480,375627,942,421,521
65960,408837,33180,196791,20481,375657,942,421,521
65965,408868,33181,196807,20482,375687,942,421,521
65970,408899,33182,196825,20482,375717,942,421,521
65975,408930,33183,196835,20482,375747,942,421,521
65980,408961,33184,196858,20483,375777,942,421,521
65985,408992,33185,196872,20483,375807,942,421,521
65990,409023,33187,196894,20485,375836,942,421,521
65995,409054,33189,196910,20486,375865,942,421,521
66000,409085,33191,196924,20487,375894,942,421,521
66005,409116,33196,196940,20489,375920,942,421,521
66010,409147,33202,196957,20494,375945,942,421,521
66015,409178,33206,196975,20496,375972,942,421,521
66020,409209,33209,196994,20497,376000,942,421,521
66025,409240,33212,197005,20498,376028,942,421,521
66030,409271,33215,197018,20499,376056,942,421,521
66035,409302,33219,197033,20500,376083,942,421,521
66040,409333,33223,197044,20502,376110,942,421,521
66045,409364,33226,197064,20503,376137,942,421,521
66050,409395,33231,197082,20507,376164,942,421,521
66055,409426,33236,197095,20512,376190,942,421,521
66060,409457,33239,197111,20513,376217,942,421,521
66065,409488,33241,197123,20514,376247,942,421,521
66070,409519,33242,197138,20515,376277,942,421,521
66075,409550,33243,197158,20515,376307,942,421,521
66080,409581,33244,197172,20516,376337,942,421,521
66085,409612,33245,197184,20516,376367,942,421,521
66090,409643,33246,197199,20516,376397,942,421,521
66095,409674,33247,197214,20517,376427,942,421,521
66100,409705,33248,197229,20517,376457,942,421,521
66105,409736,33249,197239,20518,376487,942,421,521
66110,409767,33250,197256,20518,376517,942,421,521
66115,409798,33251,197266,20519,376547,942,421,521
66120,409829,33253,197286,20519,376575,942,421,521
66125,409860,33256,197297,20522,376603,942,421,521
66130,409891,33259,197311,20524,376632,942,421,521
66135,409922,33261,197327,20524,376661,942,421,521
66140,409953,33263,197346,20525,376689,942,421,521
66145,409984,33266,197364,20527,376717,942,421,521
66150,410015,33269,197379,20529,376746,942,421,521
66155,410046,33271,197394,20530,376775,942,421,521
66160,410077,33273,197412,20530,376803,942,421,521
66165,410108,33276,197427,20532,376832,942,421,521
66170,410139,33279,197445,20534,376859,942,421,521
66175,410170,33286,197460,20540,376884,942,421,521
66180,410201,33292,197476,20544,376909,942,421,521
66185,410232,33295,197485,20545,376937,942,421,521
66190,410263,33298,197496,20546,376964,942,421,521
66195,410294,33301,197511,20547,376993,942,421,521
66200,410325,33303,197526,20548,377022,942,421,521
66205,410356,33305,197543,20549,377051,942,421,521
66210,410387,33307,197554,20550,377080,942,421,521
66215,410418,33309,197567,20551,377109,942,421,521
66220,410449,33311,197582,20552,377138,942,421,521
66225,410480,33313,197597,20552,377167,942,421,521
66230,410511,33315,197608,20552,377196,942,421,521
66235,410542,33317,197620,20553,377225,942,421,521
66240,410573,33319,197634,20553,377254,942,421,521
66245,410604,33321,197645,20553,377283,942,421,521
66250,410635,33323,197659,20554,377312,942,421,521
66255,410666,33325,197671,20555,377341,942,421,521
66260,410697,33328,197681,20556,377369,942,421,521
66265,410728,33330,197693,20558,377398,942,421,521
66270,410759,33333,197706,20559,377426,942,421,521
66275,410790,33335,197716,20559,377455,942,421,521
66280,410821,33337,197729,20559,377483,942,421,521
66285,410852,33343,197742,20562,377509,942,421,521
66290,410883,33348,197756,20565,377535,942,421,521
66295,410914,33353,197774,20569,377560,942,421,521
66300,410945,33360,197789,20574,377584,942,421,521
66305,410976,33364,197810,20577,377612,942,421,521
66310,411007,33366,197824,20578,377641,942,421,521
66315,411038,33368,197835,20580,377670,942,421,521
66320,411069,33370,197847,20581,377699,942,421,521
66325,411100,33372,197864,20582,377728,942,421,521
66330,411131,33374,197875,20583,377757,942,421,521
66335,411162,33376,197890,20585,377786,942,421,521
66340,411193,33378,197906,20585,377815,942,421,521
66345,411224,33380,197922,20586,377844,942,421,521
66350,411255,33382,197938,20588,377873,942,421,521
66355,411286,33384,197952,20589,377902,942,421,521
66360,411317,33386,197963,20590,377931,942,421,521
66365,411348,33388,197977,20591,377960,942,421,521
66370,411379,33390,197991,20592,377989,942,421,521
66375,411410,33392,198005,20593,378018,942,421,521
66380,411441,33394,198020,20594,378047,942,421,521
66385,411472,33396,198033,20596,378076,942,421,521
66390,411503,33398,198051,20598,378105,942,421,521
66395,411534,33401,198064,20601,378133,942,421,521
66400,411565,33403,198078,20603,378162,942,421,521
66405,411596,33405,198094,20605,378191,942,421,521
66410,411627,33409,198111,20608,378217,942,421,521
66415,411658,33414,198125,20612,378243,942,421,521
66420,411689,33418,198145,20615,378271,942,421,521
66425,411720,33424,198155,20617,378296,942,421,521
66430,411751,33429,198169,20619,378322,942,421,521
66435,411782,33435,198186,20624,378347,942,421,521
66440,411813,33439,198200,20626,378374,942,421,521
66445,411844,33444,198211,20629,378400,942,421,521
66450,411875,33449,198231,20632,378425,942,421,521
66455,411906,33453,198247,20635,378453,942,421,521
66460,411937,33457,198265,20638,378479,942,421,521
66465,411968,33462,198278,20641,378505,942,421,521
66470,411999,33467,198290,20645,378531,942,421,521
66475,412030,33472,198311,20649,378557,942,421,521
66480,412061,33475,198329,20652,378585,942,421,521
66485,412092,33477,198343,20654,378615,942,421,521
66490,412123,33478,198357,20655,378645,942,421,521
66495,412154,33479,198373,20656,378675,942,421,521
66500,412185,33480,198385,20656,378705,942,421,521
66505,412216,33481,198406,20656,378735,942,421,521
66510,412247,33482,198421,20656,378765,942,421,521
66515,412278,33483,198430,20656,378795,942,421,521
66520,412309,33483,198446,20656,378826,942,421,521
66525,412340,33483,198461,20656,378857,942,421,521
66530,412371,33483,198481,20656,378888,942,421,521
66535,412402,33483,198498,20656,378919,942,421,521
66540,412433,33483,198513,20656,378950,942,421,521
66545,412464,33483,198526,20656,378981,942,421,521
66550,412495,33483,198543,20656,379012,942,421,521
66555,412526,33485,198561,20658,379041,942,421,521
66560,412557,33486,198576,20658,379071,942,421,521
66565,412588,33487,198591,20659,379101,942,421,521
66570,412619,33489,198606,20660,379130,942,421,521
66575,412650,33491,198621,20660,379159,942,421,521
66580,412681,33493,198640,20661,379188,942,421,521
66585,412712,33495,198654,20661,379217,942,421,521
66590,412743,33498,198665,20663,379244,942,421,521
66595,412774,33504,198681,20668,379269,942,421,521
66600,412805,33510,198695,20672,379293,942,421,521
66605,412836,33515,198706,20675,379320,942,421,521
66610,412867,33519,198718,20678,379347,942,421,521
66615,412898,33522,198735,20680,379376,942,421,521
66620,412929,33524,198746,20681,379405,942,421,521
66625,412960,33526,198758,20682,379434,942,421,521
66630,412991,33529,198775,20683,379462,942,421,521
66635,413022,33531,198785,20684,379491,942,421,521
66640,413053,33533,198800,20685,379520,942,421,521
66645,413084,33535,198810,20686,379549,942,421,521
66650,413115,33537,198825,20687,379578,942,421,521
66655,413146,33539,198843,20688,379607,942,421,521
66660,413177,33541,198856,20690,379636,942,421,521
66665,413208,33544,198872,20690,379664,942,421,521
66670,413239,33547,198882,20692,379692,942,421,521
66675,413270,33551,198901,20695,379719,942,421,521
66680,413301,33554,198916,20698,379747,942,421,521
66685,413332,33557,198925,20698,379775,942,421,521
66690,413363,33560,198941,20699,379803,942,421,521
66695,413394,33564,198956,20701,379830,942,421,521
66700,413425,33567,198966,20702,379858,942,421,521
66705,413456,33570,198981,20705,379886,942,421,521
66710,413487,33574,198999,20707,379913,942,421,521
66715,413518,33580,199016,20712,379938,942,421,521
66720,413549,33585,199031,20714,379963,942,421,521
66725,413580,33590,199043,20716,379988,942,421,521
66730,413611,33596,199057,20720,380014,942,421,521
66735,413642,33601,199068,20724,380040,942,421,521
66740,413673,33607,199081,20729,380066,942,421,521
66745,413704,33611,199095,20731,380092,942,421,521
66750,413735,33616,199109,20736,380119,942,421,521
66755,413766,33621,199127,20738,380145,942,421,521
66760,413797,33624,199140,20740,380173,942,421,521
66765,413828,33629,199157,20743,380199,942,421,521
66770,413859,33632,199176,20745,380227,942,421,521
66775,413890,33634,199192,20746,380256,942,421,521
66780,413921,33637,199207,20747,380284,942,421,521
66785,413952,33639,199222,20747,380313,942,421,521
66790,413983,33641,199232,20748,380342,942,421,521
66795,414014,33643,199250,20748,380371,942,421,521
66800,414045,33646,199264,20750,380399,942,421,521
66805,414076,33648,199281,20751,380428,942,421,521
66810,414107,33650,199294,20752,380457,942,421,521
66815,414138,33652,199309,20754,380486,942,421,521
66820,414169,33654,199323,20755,380515,942,421,521
66825,414200,33656,199340,20757,380544,942,421,521
66830,414231,33659,199353,20759,380572,942,421,521
66835,414262,33659,199372,20759,380603,942,421,521
66840,414293,33659,199389,20759,380634,942,421,521
66845,414324,33659,199402,20759,380665,942,421,521
66850,414355,33659,199418,20759,380696,942,421,521
66855,414386,33660,199434,20759,380726,942,421,521
66860,414417,33661,199449,20759,380756,942,421,521
66865,414448,33662,199460,20759,380786,942,421,521
66870,414479,33663,199472,20759,380816,942,421,521
66875,414510,33665,199488,20761,380845,942,421,521
66880,414541,33667,199501,20763,380874,942,421,521
66885,414572,33669,199520,20765,380903,942,421,521
66890,414603,33671,199537,20766,380932,942,421,521
66895,414634,33673,199556,20766,380960,942,421,521
66900,414665,33676,199574,20769,380989,942,421,521
66905,414696,33678,199589,20770,381018,942,421,521
66910,414727,33682,199612,20772,381045,942,421,521
66915,414758,33684,199626,20773,381074,942,421,521
66920,414789,33687,199643,20775,381102,942,421,521
66925,414820,33691,199665,20778,381129,942,421,521
66930,414851,33694,199675,20780,381157,942,421,521
66935,414882,33697,199692,20782,381185,942,421,521
66940,414913,33700,199705,20785,381213,942,421,521
66945,414944,33705,199722,20787,381239,942,421,521
66950,414975,33712,199742,20792,381263,942,421,521
66955,415006,33716,199758,20793,381290,942,421,521
66960,415037,33721,199776,20797,381315,942,421,521
66965,415068,33724,199796,20800,381344,942,421,521
66970,415099,33726,199813,20802,381373,942,421,521
66975,415130,33728,199828,20802,381402,942,421,521
66980,415161,33730,199844,20803,381431,942,421,521
66985,415192,33732,199861,20804,381460,942,421,521
66990,415223,33734,199875,20805,381489,942,421,521
66995,415254,33736,199886,20806,381518,942,421,521
67000,415285,33738,199907,20808,381547,942,421,521
67005,415316,33740,199921,20808,381576,942,421,521
67010,415347,33742,199935,20809,381605,942,421,521
67015,415378,33744,199953,20809,381634,942,421,521
67020,415409,33746,199967,20810,381663,942,421,521
67025,415440,33749,199981,20811,381691,942,421,521
67030,415471,33752,199989,20812,381719,942,421,521
67035,415502,33756,200001,20813,381746,942,421,521
67040,415533,33760,200013,20815,381773,942,421,521
67045,415564,33764,200025,20817,381800,942,421,521
67050,415595,33769,200040,20819,381826,942,421,521
67055,415626,33773,200054,20821,381853,942,421,521
67060,415657,33778,200067,20823,381879,942,421,521
67065,415688,33782,200083,20824,381906,942,421,521
67070,415719,33788,200100,20829,381931,942,421,521
67075,415750,33793,200113,20833,381957,942,421,521
67080,415781,33799,200129,20837,381982,942,421,521
67085,415812,33801,200148,20838,382010,942,421,521
67090,415843,33804,200161,20840,382038,942,421,521
67095,415874,33806,200175,20841,382068,942,421,521
67100,415905,33806,200190,20841,382099,942,421,521
67105,415936,33806,200209,20841,382130,942,421,521
67110,415967,33806,200222,20841,382161,942,421,521
67115,415998,33806,200236,20841,382192,942,421,521
67120,416029,33806,200255,20841,382223,942,421,521
67125,416060,33806,200265,20841,382254,942,421,521
67130,416091,33806,200279,20841,382285,942,421,521
67135,416122,33806,200294,20841,382316,942,421,521
67140,416153,33806,200305,20841,382347,942,421,521
67145,416184,33806,200317,20841,382378,942,421,521
67150,416215,33806,200327,20841,382409,942,421,521
67155,416246,33806,200338,20841,382440,942,421,521
67160,416277,33806,200350,20841,382471,942,421,521
67165,416308,33806,200363,20841,382502,942,421,521
67170,416339,33806,200383,20841,382533,942,421,521
67175,416370,33806,200396,20841,382564,942,421,521
67180,416401,33806,200406,20841,382595,942,421,521
67185,416432,33807,200420,20841,382625,942,421,521
67190,416463,33810,200438,20843,382653,942,421,521
67195,416494,33813,200458,20844,382681,942,421,521
67200,416525,33816,200471,20846,382709,942,421,521
67205,416556,33822,200488,20850,382733,942,421,521
67210,416587,33829,200498,20853,382758,942,421,521
67215,416618,33835,200515,20858,382782,942,421,521
67220,416649,33840,200529,20861,382809,942,421,521
67225,416680,33845,200542,20863,382835,942,421,521
67230,416711,33850,200556,20866,382860,942,421,521
67235,416742,33856,200571,20871,382886,942,421,521
67240,416773,33860,200590,20874,382913,942,421,521
67245,416804,33863,200600,20875,382941,942,421,521
67250,416835,33866,200616,20876,382969,942,421,521
67255,416866,33869,200631,20877,382997,942,421,521
67260,416897,33872,200649,20880,383025,942,421,521
67265,416928,33876,200667,20883,383052,942,421,521
67270,416959,33880,200683,20885,383079,942,421,521
67275,416990,33884,200697,20887,383106,942,421,521
67280,417021,33888,200711,20889,383133,942,421,521
67285,417052,33892,200723,20890,383160,942,421,521
67290,417083,33896,200737,20892,383187,942,421,521
67295,417114,33900,200751,20895,383214,942,421,521
67300,417145,33904,200763,20896,383241,942,421,521
67305,417176,33908,200772,20897,383268,942,421,521
67310,417207,33912,200785,20898,383294,942,421,521
67315,417238,33919,200802,20902,383318,942,421,521
67320,417269,33928,200821,20908,383340,942,421,521
67325,417300,33930,200835,20910,383370,942,421,521
67330,417331,33931,200854,20911,383400,942,421,521
67335,417362,33932,200867,20912,383430,942,421,521
67340,417393,33933,200884,20912,383460,942,421,521
67345,417424,33934,200897,20912,383490,942,421,521
67350,417455,33935,200914,20913,383520,942,421,521
67355,417486,33936,200928,20913,383550,942,421,521
67360,417517,33937,200940,20914,383580,942,421,521
67365,417548,33938,200955,20915,383610,942,421,521
67370,417579,33939,200972,20916,383640,942,421,521
67375,417610,33940,200982,20916,383670,942,421,521
67380,417641,33941,200994,20917,383700,942,421,521
67385,417672,33945,201009,20920,383727,942,421,521
67390,417703,33947,201018,20921,383756,942,421,521
67395,417734,33949,201032,20923,383785,942,421,521
67400,417765,33951,201047,20923,383814,942,421,521
67405,417796,33953,201066,20925,383843,942,421,521
67410,417827,33955,201083,20925,383871,942,421,521
67415,417858,33958,201097,20927,383899,942,421,521
67420,417889,33961,201109,20930,383928,942,421,521
67425,417920,33963,201126,20932,383957,942,421,521
67430,417951,33966,201140,20934,383985,942,421,521
67435,417982,33970,201158,20935,384012,942,421,521
67440,418013,33973,201172,20936,384040,942,421,521
67445,418044,33975,201183,20937,384068,942,421,521
67450,418075,33978,201205,20940,384097,942,421,521
67455,418106,33979,201213,20940,384127,942,421,521
67460,418137,33980,201228,20941,384157,942,421,521
67465,418168,33981,201241,20941,384187,942,421,521
67470,418199,33982,201255,20942,384217,942,421,521
67475,418230,33983,201268,20942,384247,942,421,521
67480,418261,33985,201284,20944,384276,942,421,521
67485,418292,33987,201296,20946,384305,942,421,521
67490,418323,33989,201313,20947,384334,942,421,521
67495,418354,33990,201331,20947,384364,942,421,521
67500,418385,33992,201347,20949,384393,942,421,521
67505,418416,33994,201363,20950,384422,942,421,521
67510,418447,33995,201381,20950,384451,942,421,521
67515,418478,33998,201396,20953,384479,942,421,521
67520,418509,34000,201411,20955,384509,942,421,521
67525,418540,34002,201422,20956,384537,942,421,521
67530,418571,34004,201433,20958,384567,942,421,521
67535,418602,34006,201450,20960,384595,942,421,521
67540,418633,34008,201461,20961,384625,942,421,521
67545,418664,34009,201481,20962,384654,942,421,521
67550,418695,34012,201496,20965,384683,942,421,521
67555,418726,34012,201512,20965,384714,942,421,521
67560,418757,34014,201531,20967,384743,942,421,521
67565,418788,34017,201549,20969,384771,942,421,521
67570,418819,34021,201563,20970,384798,942,421,521
67575,418850,34024,201577,20971,384826,942,421,521
67580,418881,34027,201594,20972,384854,942,421,521
67585,418912,34030,201610,20974,384882,942,421,521
67590,418943,34033,201625,20976,384910,942,421,521
67595,418974,34036,201639,20979,384938,942,421,521
67600,419005,34039,201653,20980,384966,942,421,521
67605,419036,34042,201665,20981,384994,942,421,521
67610,419067,34045,201681,20982,385022,942,421,521
67615,419098,34049,201695,20985,385049,942,421,521
67620,419129,34052,201709,20986,385077,942,421,521
67625,419160,34056,201722,20988,385104,942,421,521
67630,419191,34060,201734,20989,385131,942,421,521
67635,419222,34065,201753,20991,385157,942,421,521
67640,419253,34069,201768,20993,385184,942,421,521
67645,419284,34074,201783,20996,385210,942,421,521
67650,419315,34079,201798,20998,385236,942,421,521
67655,419346,34084,201819,21002,385262,942,421,521
67660,419377,34088,201832,21003,385289,942,421,521
67665,419408,34092,201845,21004,385316,942,421,521
67670,419439,34097,201862,21007,385341,942,421,521
67675,419470,34104,201880,21013,385364,942,421,521
67680,419501,34110,201893,21018,385389,942,421,521
67685,419532,34113,201906,21020,385418,942,421,521
67690,419563,34115,201919,21022,385447,942,421,521
67695,419594,34117,201929,21024,385476,942,421,521
67700,419625,34120,201946,21027,385505,942,421,521
67705,419656,34122,201957,21028,385534,942,421,521
67710,419687,34123,201972,21028,385564,942,421,521
67715,419718,34123,201983,21028,385595,942,421,521
67720,419749,34123,201996,21028,385626,942,421,521
67725,419780,34123,202013,21028,385657,942,421,521
67730,419811,34123,202028,21028,385688,942,421,521
67735,419842,34123,202040,21028,385719,942,421,521
67740,419873,34123,202052,21028,385750,942,421,521
67745,419904,34125,202065,21030,385779,942,421,521
67750,419935,34126,202080,21031,385808,942,421,521
67755,419966,34129,202096,21034,385837,942,421,521
67760,419997,34131,202110,21035,385866,942,421,521
67765,420028,34133,202122,21036,385895,942,421,521
67770,420059,34135,202134,21037,385924,942,421,521
67775,420090,34136,202147,21037,385953,942,421,521
67780,420121,34139,202165,21039,385982,942,421,521
67785,420152,34141,202180,21041,386011,942,421,521
67790,420183,34144,202198,21043,386039,942,421,521
67795,420214,34147,202215,21045,386067,942,421,521
67800,420245,34151,202227,21047,386094,942,421,521
67805,420276,34155,202246,21048,386121,942,421,521
67810,420307,34159,202260,21049,386147,942,421,521
67815,420338,34164,202277,21051,386173,942,421,521
67820,420369,34169,202289,21055,386200,942,421,521
67825,420400,34173,202305,21056,386227,942,421,521
67830,420431,34176,202317,21057,386254,942,421,521
67835,420462,34181,202328,21060,386280,942,421,521
67840,420493,34185,202341,21062,386307,942,421,521
67845,420524,34190,202356,21066,386334,942,421,521
67850,420555,34193,202369,21067,386361,942,421,521
67855,420586,34197,202383,21070,386389,942,421,521
67860,420617,34201,202402,21073,386416,942,421,521
67865,420648,34203,202417,21075,386445,942,421,521
67870,420679,34205,202432,21077,386474,942,421,521
67875,420710,34206,202444,21077,386504,942,421,521
67880,420741,34207,202457,21077,386534,942,421,521
67885,420772,34208,202470,21077,386564,942,421,521
67890,420803,34210,202485,21079,386593,942,421,521
67895,420834,34214,202498,21081,386620,942,421,521
67900,420865,34218,202519,21085,386647,942,421,521
67905,420896,34220,202537,21086,386675,942,421,521
67910,420927,34225,202554,21091,386701,942,421,521
67915,420958,34228,202568,21093,386729,942,421,521
67920,420989,34231,202583,21096,386758,942,421,521
67925,421020,34232,202597,21097,386788,942,421,521
67930,421051,34233,202616,21098,386818,942,421,521
67935,421082,34234,202627,21099,386848,942,421,521
67940,421113,34235,202638,21099,386878,942,421,521
67945,421144,34236,202653,21099,386908,942,421,521
67950,421175,34237,202671,21099,386938,942,421,521
67955,421206,34238,202684,21099,386968,942,421,521
67960,421237,34239,202700,21099,386998,942,421,521
67965,421268,34240,202716,21099,387027,942,421,521
67970,421299,34244,202729,21102,387055,942,421,521
67975,421330,34246,202743,21104,387084,942,421,521
67980,421361,34248,202755,21105,387113,942,421,521
67985,421392,34253,202768,21108,387139,942,421,521
67990,421423,34255,202782,21110,387168,942,421,521
67995,421454,34258,202796,21112,387196,942,421,521
68000,421485,34260,202811,21113,387225,942,421,521
68005,421516,34262,202822,21114,387254,942,421,521
68010,421547,34264,202833,21114,387283,942,421,521
68015,421578,34267,202851,21116,387311,942,421,521
68020,421609,34270,202866,21118,387339,942,421,521
68025,421640,34273,202878,21120,387367,942,421,521
68030,421671,34275,202891,21121,387396,942,421,521
68035,421702,34277,202904,21121,387425,942,421,521
68040,421733,34279,202920,21122,387454,942,421,521
68045,421764,34280,202936,21123,387484,942,421,521
68050,421795,34281,202957,21124,387514,942,421,521
68055,421826,34282,202976,21125,387544,942,421,521
68060,421857,34283,202987,21126,387574,942,421,521
68065,421888,34284,202999,21127,387604,942,421,521
68070,421919,34285,203013,21127,387634,942,421,521
68075,421950,34286,203021,21127,387664,942,421,521
68080,421981,34287,203031,21128,387694,942,421,521
68085,422012,34288,203044,21129,387724,942,421,521
68090,422043,34289,203059,21129,387754,942,421,521
68095,422074,34292,203074,21132,387782,942,421,521
68100,422105,34296,203092,21134,387809,942,421,521
68105,422136,34302,203109,21137,387834,942,421,521
68110,422167,34307,203123,21141,387860,942,421,521
68115,422198,34311,203139,21143,387887,942,421,521
68120,422229,34316,203153,21145,387913,942,421,521
68125,422260,34321,203168,21147,387939,942,421,521
68130,422291,34326,203186,21152,387965,942,421,521
68135,422322,34331,203203,21155,387991,942,421,521
68140,422353,34335,203220,21159,388018,942,421,521
68145,422384,34339,203237,21161,388044,942,421,521
68150,422415,34345,203253,21165,388069,942,421,521
68155,422446,34350,203266,21167,388096,942,421,521
68160,422477,34353,203280,21169,388123,942,421,521
68165,422508,34354,203297,21170,388154,942,421,521
68170,422539,34354,203313,21170,388185,942,421,521
68175,422570,34354,203331,21170,388216,942,421,521
68180,422601,34354,203344,21170,388247,942,421,521
68185,422632,34354,203356,21170,388278,942,421,521
68190,422663,34354,203372,21170,388309,942,421,521
68195,422694,34354,203384,21170,388340,942,421,521
68200,422725,34354,203399,21170,388371,942,421,521
68205,422756,34354,203409,21170,388402,942,421,521
68210,422787,34354,203426,21170,388433,942,421,521
68215,422818,34354,203442,21170,388464,942,421,521
68220,422849,34354,203461,21170,388495,942,421,521
68225,422880,34356,203479,21171,388524,942,421,521
68230,422911,34358,203493,21172,388553,942,421,521
68235,422942,34360,203507,21174,388582,942,421,521
68240,422973,34363,203524,21176,388610,942,421,521
68245,423004,34366,203544,21179,388638,942,421,521
68250,423035,34367,203557,21179,388668,942,421,521
68255,423066,34368,203571,21179,388698,942,421,521
68260,423097,34369,203580,21179,388728,942,421,521
68265,423128,34372,203597,21180,388756,942,421,521
68270,423159,34377,203611,21183,388781,942,421,521
68275,423190,34383,203625,21186,388807,942,421,521
68280,423221,34389,203643,21191,388831,942,421,521
68285,423252,34394,203657,21194,388858,942,421,521
68290,423283,34398,203669,21196,388885,942,421,521
68295,423314,34403,203685,21200,388911,942,421,521
68300,423345,34407,203699,21202,388938,942,421,521
68305,423376,34411,203708,21203,388965,942,421,521
68310,423407,34415,203726,21205,388992,942,421,521
68315,423438,34419,203741,21206,389019,942,421,521
68320,423469,34422,203755,21207,389047,942,421,521
68325,423500,34425,203767,21210,389075,942,421,521
68330,423531,34429,203777,21213,389101,942,421,521
68335,423562,34432,203793,21216,389130,942,421,521
68340,423593,34434,203807,21218,389159,942,421,521
68345,423624,34437,203822,21220,389186,942,421,521
68350,423655,34441,203838,21222,389214,942,421,521
68355,423686,34444,203847,21224,389242,942,421,521
68360,423717,34449,203864,21228,389268,942,421,521
68365,423748,34450,203880,21228,389298,942,421,521
68370,423779,34452,203899,21230,389327,942,421,521
68375,423810,34454,203911,21231,389356,942,421,521
68380,423841,34455,203925,21232,389386,942,421,521
68385,423872,34456,203939,21232,389416,942,421,521
68390,423903,34457,203949,21232,389446,942,421,521
68395,423934,34458,203968,21233,389476,942,421,521
68400,423965,34459,203984,21234,389506,942,421,521
68405,423996,34461,204000,21234,389535,942,421,521
68410,424027,34463,204018,21235,389563,942,421,521
68415,424058,34466,204034,21237,389592,942,421,521
68420,424089,34468,204047,21239,389621,942,421,521
68425,424120,34470,204065,21240,389650,942,421,521
68430,424151,34472,204081,21240,389678,942,421,521
68435,424182,34475,204099,21242,389706,942,421,521
68440,424213,34478,204114,21245,389734,942,421,521
68445,424244,34482,204130,21248,389762,942,421,521
68450,424275,34486,204149,21251,389789,942,421,521
68455,424306,34489,204165,21253,389817,942,421,521
68460,424337,34493,204180,21254,389843,942,421,521
68465,424368,34495,204191,21255,389873,942,421,521
68470,424399,34498,204207,21256,389900,942,421,521
68475,424430,34503,204220,21259,389927,942,421,521
68480,424461,34505,204238,21261,389956,942,421,521
68485,424492,34507,204251,21262,389985,942,421,521
68490,424523,34510,204268,21265,390013,942,421,521
68495,424554,34512,204281,21266,390042,942,421,521
68500,424585,34514,204297,21266,390071,942,421,521
68505,424616,34516,204309,21267,390100,942,421,521
68510,424647,34519,204321,21268,390128,942,421,521
68515,424678,34521,204338,21268,390157,942,421,521
68520,424709,34523,204347,21268,390186,942,421,521
68525,424740,34526,204364,21269,390214,942,421,521
68530,424771,34528,204379,21271,390243,942,421,521
68535,424802,34531,204393,21273,390271,942,421,521
68540,424833,34533,204408,21274,390300,942,421,521
68545,424864,34536,204426,21276,390328,942,421,521
68550,424895,34539,204441,21279,390356,942,421,521
68555,424926,34541,204458,21279,390385,942,421,521
68560,424957,34544,204475,21281,390413,942,421,521
68565,424988,34545,204489,21281,390443,942,421,521
68570,425019,34547,204504,21282,390472,942,421,521
68575,425050,34549,204521,21282,390500,942,421,521
68580,425081,34552,204535,21284,390529,942,421,521
68585,425112,34557,204542,21286,390555,942,421,521
68590,425143,34559,204553,21286,390584,942,421,521
68595,425174,34563,204569,21290,390611,942,421,521
68600,425205,34565,204585,21291,390640,942,421,521
68605,425236,34567,204601,21293,390669,942,421,521
68610,425267,34569,204616,21293,390698,942,421,521
68615,425298,34571,204627,21295,390727,942,421,521
68620,425329,34573,204644,21296,390756,942,421,521
68625,425360,34575,204662,21296,390785,942,421,521
68630,425391,34577,204674,21298,390814,942,421,521
68635,425422,34579,204693,21299,390843,942,421,521
68640,425453,34581,204708,21300,390872,942,421,521
68645,425484,34584,204721,21302,390900,942,421,521
68650,425515,34587,204738,21304,390928,942,421,521
68655,425546,34590,204755,21306,390956,942,421,521
68660,425577,34593,204766,21309,390984,942,421,521
68665,425608,34595,204786,21310,391013,942,421,521
68670,425639,34597,204799,21310,391042,942,421,521
68675,425670,34599,204812,21311,391071,942,421,521
68680,425701,34602,204832,21312,391099,942,421,521
68685,425732,34604,204846,21313,391128,942,421,521
68690,425763,34606,204856,21313,391157,942,421,521
68695,425794,34608,204869,21315,391186,942,421,521
68700,425825,34611,204883,21318,391214,942,421,521
68705,425856,34613,204900,21319,391242,942,421,521
68710,425887,34616,204915,21321,391270,942,421,521
68715,425918,34619,204933,21323,391298,942,421,521
68720,425949,34622,204949,21325,391326,942,421,521
68725,425980,34625,204961,21327,391354,942,421,521
68730,426011,34628,204974,21329,391382,942,421,521
68735,426042,34631,204993,21331,391410,942,421,521
68740,426073,34634,205004,21333,391438,942,421,521
68745,426104,34637,205015,21334,391466,942,421,521
68750,426135,34640,205041,21337,391493,942,421,521
68755,426166,34644,205058,21341,391520,942,421,521
68760,426197,34648,205070,21343,391548,942,421,521
68765,426228,34650,205088,21345,391578,942,421,521
68770,426259,34652,205099,21346,391607,942,421,521
68775,426290,34654,205110,21347,391636,942,421,521
68780,426321,34656,205127,21348,391665,942,421,521
68785,426352,34657,205141,21348,391695,942,421,521
68790,426383,34658,205157,21349,391725,942,421,521
68795,426414,34659,205172,21350,391755,942,421,521
68800,426445,34660,205185,21350,391785,942,421,521
68805,426476,34661,205200,21351,391815,942,421,521
68810,426507,34662,205215,21351,391845,942,421,521
68815,426538,34663,205229,21351,391875,942,421,521
68820,426569,34666,205245,21353,391903,942,421,521
68825,426600,34667,205257,21354,391933,942,421,521
68830,426631,34668,205271,21354,391963,942,421,521
68835,426662,34669,205285,21355,391993,942,421,521
68840,426693,34670,205299,21355,392023,942,421,521
68845,426724,34671,205315,21355,392053,942,421,521
68850,426755,34672,205326,21356,392083,942,421,521
68855,426786,34673,205339,21357,392113,942,421,521
68860,426817,34674,205354,21358,392143,942,421,521
68865,426848,34677,205371,21360,392170,942,421,521
68870,426879,34682,205385,21365,392196,942,421,521
68875,426910,34687,205402,21369,392222,942,421,521
68880,426941,34693,205417,21374,392248,942,421,521
68885,426972,34697,205429,21374,392274,942,421,521
68890,427003,34702,205444,21376,392300,942,421,521
68895,427034,34707,205455,21379,392327,942,421,521
68900,427065,34712,205470,21382,392352,942,421,521
68905,427096,34718,205482,21386,392378,942,421,521
68910,427127,34721,205498,21388,392406,942,421,521
68915,427158,34724,205511,21388,392434,942,421,521
68920,427189,34727,205523,21389,392462,942,421,521
68925,427220,34731,205534,21392,392489,942,421,521
68930,427251,34735,205549,21394,392515,942,421,521
68935,427282,34740,205566,21398,392542,942,421,521
68940,427313,34743,205579,21399,392569,942,421,521
68945,427344,34744,205594,21400,392600,942,421,521
68950,427375,34744,205607,21400,392631,942,421,521
68955,427406,34744,205622,21400,392662,942,421,521
68960,427437,34744,205639,21400,392693,942,421,521
68965,427468,34744,205653,21400,392724,942,421,521
68970,427499,34744,205665,21400,392755,942,421,521
68975,427530,34744,205676,21400,392786,942,421,521
68980,427561,34744,205691,21400,392817,942,421,521
68985,427592,34744,205708,21400,392848,942,421,521
68990,427623,34744,205723,21400,392879,942,421,521
68995,427654,34744,205735,21400,392910,942,421,521
69000,427685,34744,205749,21400,392941,942,421,521
69005,427716,34745,205762,21401,392971,942,421,521
69010,427747,34748,205774,21404,392999,942,421,521
69015,427778,34751,205795,21406,393027,942,421,521
69020,427809,34754,205808,21407,393055,942,421,521
69025,427840,34756,205824,21408,393084,942,421,521
69030,427871,34759,205838,21410,393112,942,421,521
69035,427902,34761,205848,21411,393141,942,421,521
69040,427933,34764,205862,21412,393169,942,421,521
69045,427964,34767,205872,21414,393197,942,421,521
69050,427995,34771,205888,21416,393223,942,421,521
69055,428026,34776,205903,21420,393250,942,421,521
69060,428057,34779,205918,21421,393277,942,421,521
69065,428088,34783,205934,21423,393305,942,421,521
69070,428119,34786,205953,21426,393333,942,421,521
69075,428150,34789,205968,21427,393361,942,421,521
69080,428181,34793,205987,21430,393388,942,421,521
69085,428212,34797,205998,21433,393415,942,421,521
69090,428243,34800,206010,21436,393443,942,421,521
69095,428274,34804,206024,21438,393470,942,421,521
69100,428305,34808,206044,21441,393497,942,421,521
69105,428336,34811,206061,21443,393525,942,421,521
69110,428367,34814,206076,21444,393552,942,421,521
69115,428398,34819,206091,21447,393579,942,421,521
69120,428429,34823,206106,21450,393606,942,421,521
69125,428460,34827,206122,21452,393632,942,421,521
69130,428491,34832,206140,21456,393658,942,421,521
69135,428522,34836,206154,21459,393685,942,421,521
69140,428553,34840,206169,21462,393713,942,421,521
69145,428584,34844,206184,21465,393739,942,421,521
69150,428615,34849,206203,21467,393766,942,421,521
69155,428646,34852,206220,21469,393794,942,421,521
69160,428677,34856,206233,21472,393821,942,421,521
69165,428708,34859,206252,21475,393849,942,421,521
69170,428739,34863,206267,21477,393875,942,421,521
69175,428770,34869,206286,21480,393901,942,421,521
69180,428801,34870,206301,21481,393931,942,421,521
69185,428832,34870,206313,21481,393962,942,421,521
69190,428863,34870,206326,21481,393993,942,421,521
69195,428894,34870,206345,21481,394024,942,421,521
69200,428925,34870,206365,21481,394055,942,421,521
69205,428956,34870,206376,21481,394086,942,421,521
69210,428987,34870,206389,21481,394117,942,421,521
69215,429018,34870,206404,21481,394148,942,421,521
69220,429049,34870,206415,21481,394179,942,421,521
69225,429080,34870,206431,21481,394209,942,421,521
69230,429111,34872,206441,21483,394239,942,421,521
69235,429142,34874,206456,21485,394267,942,421,521
69240,429173,34877,206471,21488,394295,942,421,521
69245,429204,34879,206479,21490,394325,942,421,521
69250,429235,34881,206494,21491,394354,942,421,521
69255,429266,34882,206507,21491,394384,942,421,521
69260,429297,34884,206524,21493,394413,942,421,521
69265,429328,34886,206540,21494,394442,942,421,521
69270,429359,34887,206550,21494,394472,942,421,521
69275,429390,34888,206560,21495,394502,942,421,521
69280,429421,34889,206573,21496,394532,942,421,521
69285,429452,34894,206585,21499,394558,942,421,521
69290,429483,34897,206593,21501,394586,942,421,521
69295,429514,34900,206608,21503,394614,942,421,521
69300,429545,34904,206624,21506,394641,942,421,521
69305,429576,34910,206637,21511,394666,942,421,521
69310,429607,34913,206650,21511,394694,942,421,521
69315,429638,34916,206659,21511,394722,942,421,521
69320,429669,34919,206671,21512,394750,942,421,521
69325,429700,34922,206683,21514,394778,942,421,521
69330,429731,34926,206698,21516,394805,942,421,521
69335,429762,34929,206718,21517,394833,942,421,521
69340,429793,34932,206732,21518,394860,942,421,521
69345,429824,34937,206744,21522,394886,942,421,521
69350,429855,34942,206759,21526,394912,942,421,521
69355,429886,34947,206773,21529,394937,942,421,521
69360,429917,34952,206787,21532,394964,942,421,521
69365,429948,34958,206807,21536,394990,942,421,521
69370,429979,34961,206817,21537,395018,942,421,521
69375,430010,34964,206834,21538,395045,942,421,521
69380,430041,34968,206850,21541,395072,942,421,521
69385,430072,34972,206865,21544,395100,942,421,521
69390,430103,34977,206882,21548,395125,942,421,521
69395,430134,34981,206897,21551,395152,942,421,521
69400,430165,34986,206913,21554,395179,942,421,521
69405,430196,34990,206928,21557,395205,942,421,521
69410,430227,34993,206935,21559,395234,942,421,521
69415,430258,34997,206949,21562,395261,942,421,521
69420,430289,35000,206962,21563,395289,942,421,521
69425,430320,35001,206980,21564,395319,942,421,521
69430,430351,35002,206993,21565,395349,942,421,521
69435,430382,35003,207009,21565,395379,942,421,521
69440,430413,35004,207024,21566,395409,942,421,521
69445,430444,35005,207043,21567,395439,942,421,521
69450,430475,35006,207056,21567,395469,942,421,521
69455,430506,35007,207071,21568,395498,942,421,521
69460,430537,35009,207084,21569,395527,942,421,521
69465,430568,35010,207099,21570,395558,942,421,521
69470,430599,35010,207112,21570,395589,942,421,521
69475,430630,35010,207130,21570,395620,942,421,521
69480,430661,35010,207142,21570,395651,942,421,521
69485,430692,35013,207157,21573,395679,942,421,521
69490,430723,35013,207176,21573,395710,942,421,521
69495,430754,35013,207193,21573,395741,942,421,521
69500,430785,35013,207208,21573,395772,942,421,521
69505,430816,35013,207224,21573,395803,942,421,521
69510,430847,35013,207244,21573,395834,942,421,521
69515,430878,35014,207260,21573,395864,942,421,521
69520,430909,35015,207276,21573,395894,942,421,521
69525,430940,35016,207292,21574,395924,942,421,521
69530,430971,35019,207309,21576,395952,942,421,521
69535,431002,35022,207319,21578,395980,942,421,521
69540,431033,35024,207335,21578,396008,942,421,521
69545,431064,35029,207353,21583,396034,942,421,521
69550,431095,35034,207370,21586,396060,942,421,521
69555,431126,35039,207383,21587,396087,942,421,521
69560,431157,35043,207399,21589,396114,942,421,521
69565,431188,35047,207417,21592,396140,942,421,521
69570,431219,35053,207430,21596,396165,942,421,521
69575,431250,35058,207446,21599,396192,942,421,521
69580,431281,35063,207460,21601,396218,942,421,521
69585,431312,35067,207477,21604,396245,942,421,521
69590,431343,35072,207494,21606,396271,942,421,521
69595,431374,35078,207511,21610,396295,942,421,521
69600,431405,35085,207528,21615,396320,942,421,521
69605,431436,35085,207546,21615,396351,942,421,521
69610,431467,35085,207556,21615,396382,942,421,521
69615,431498,35085,207573,21615,396413,942,421,521
69620,431529,35085,207584,21615,396444,942,421,521
69625,431560,35085,207601,21615,396475,942,421,521
69630,431591,35085,207620,21615,396506,942,421,521
69635,431622,35085,207636,21615,396537,942,421,521
69640,431653,35085,207653,21615,396568,942,421,521
69645,431684,35085,207666,21615,396599,942,421,521
69650,431715,35085,207683,21615,396630,942,421,521
69655,431746,35085,207701,21615,396661,942,421,521
69660,431777,35085,207717,21615,396692,942,421,521
69665,431808,35088,207736,21617,396720,942,421,521
69670,431839,35090,207752,21619,396749,942,421,521
69675,431870,35092,207765,21621,396778,942,421,521
69680,431901,35093,207778,21622,396808,942,421,521
69685,431932,35094,207797,21623,396838,942,421,521
69690,431963,35095,207811,21624,396868,942,421,521
69695,431994,35096,207829,21624,396898,942,421,521
69700,432025,35097,207849,21624,396928,942,421,521
69705,432056,35097,207860,21624,396959,942,421,521
69710,432087,35098,207878,21624,396989,942,421,521
69715,432118,35103,207891,21628,397014,942,421,521
69720,432149,35108,207904,21631,397041,942,421,521
69725,432180,35112,207913,21632,397068,942,421,521
69730,432211,35115,207924,21633,397096,942,421,521
69735,432242,35119,207939,21636,397123,942,421,521
69740,432273,35123,207956,21639,397150,942,421,521
69745,432304,35128,207976,21643,397176,942,421,521
69750,432335,35132,207985,21645,397202,942,421,521
69755,432366,35136,208002,21648,397229,942,421,521
69760,432397,35141,208008,21651,397256,942,421,521
69765,432428,35144,208023,21653,397283,942,421,521
69770,432459,35149,208031,21655,397310,942,421,521
69775,432490,35153,208044,21657,397336,942,421,521
69780,432521,35159,208060,21661,397362,942,421,521
69785,432552,35163,208073,21664,397389,942,421,521
69790,432583,35168,208084,21666,397415,942,421,521
69795,432614,35173,208101,21668,397441,942,421,521
69800,432645,35177,208116,21670,397467,942,421,521
69805,432676,35182,208132,21675,397494,942,421,521
69810,432707,35185,208141,21676,397522,942,421,521
69815,432738,35188,208160,21677,397550,942,421,521
69820,432769,35191,208177,21680,397578,942,421,521
69825,432800,35195,208189,21683,397605,942,421,521
69830,432831,35198,208204,21684,397633,942,421,521
69835,432862,35201,208221,21686,397660,942,421,521
69840,432893,35205,208236,21689,397688,942,421,521
69845,432924,35207,208251,21690,397717,942,421,521
69850,432955,35209,208263,21690,397746,942,421,521
69855,432986,35211,208279,21691,397775,942,421,521
69860,433017,35213,208293,21692,397804,942,421,521
69865,433048,35215,208307,21693,397833,942,421,521
69870,433079,35217,208319,21693,397862,942,421,521
69875,433110,35219,208337,21694,397891,942,421,521
69880,433141,35221,208351,21695,397920,942,421,521
69885,433172,35225,208366,21698,397947,942,421,521
69890,433203,35227,208379,21699,397976,942,421,521
69895,433234,35228,208393,21700,398006,942,421,521
69900,433265,35230,208406,21702,398035,942,421,521
69905,433296,35232,208421,21703,398064,942,421,521
69910,433327,35234,208432,21704,398093,942,421,521
69915,433358,35236,208454,21706,398122,942,421,521
69920,433389,35237,208465,21706,398151,942,421,521
69925,433420,35240,208479,21708,398180,942,421,521
69930,433451,35242,208493,21709,398208,942,421,521
69935,433482,35245,208510,21711,398236,942,421,521
69940,433513,35247,208526,21713,398265,942,421,521
69945,433544,35249,208535,21714,398294,942,421,521
69950,433575,35252,208555,21715,398323,942,421,521
69955,433606,35255,208569,21716,398350,942,421,521
69960,433637,35259,208584,21719,398378,942,421,521
69965,433668,35262,208602,21720,398405,942,421,521
69970,433699,35266,208619,21723,398433,942,421,521
69975,433730,35269,208634,21725,398461,942,421,521
69980,433761,35272,208647,21727,398488,942,421,521
69985,433792,35276,208666,21731,398516,942,421,521
69990,433823,35279,208684,21733,398544,942,421,521
69995,433854,35282,208697,21734,398572,942,421,521
70000,433885,35286,208710,21735,398599,942,421,521
70005,433916,35290,208722,21738,398626,942,421,521
70010,433947,35294,208738,21740,398653,942,421,521
70015,433978,35298,208752,21741,398680,942,421,521
70020,434009,35303,208769,21744,398706,942,421,521
70025,434040,35306,208784,21747,398733,942,421,521
70030,434071,35309,208801,21748,398761,942,421,521
70035,434102,35312,208816,21750,398789,942,421,521
70040,434133,35315,208828,21751,398818,942,421,521
70045,434164,35317,208843,21752,398847,942,421,521
70050,434195,35320,208859,21753,398875,942,421,521
70055,434226,35323,208875,21754,398903,942,421,521
70060,434257,35326,208889,21757,398931,942,421,521
70065,434288,35328,208902,21758,398959,942,421,521
70070,434319,35331,208916,21760,398987,942,421,521
70075,434350,35335,208932,21763,399015,942,421,521
70080,434381,35337,208953,21765,399044,942,421,521
70085,434412,35339,208970,21767,399073,942,421,521
70090,434443,35341,208980,21768,399102,942,421,521
70095,434474,35343,208993,21769,399131,942,421,521
70100,434505,35345,209009,21769,399160,942,421,521
70105,434536,35347,209023,21769,399189,942,421,521
70110,434567,35349,209035,21769,399218,942,421,521
70115,434598,35351,209050,21770,399247,942,421,521
70120,434629,35353,209068,21772,399276,942,421,521
70125,434660,35355,209080,21772,399305,942,421,521
70130,434691,35357,209094,21774,399334,942,421,521
70135,434722,35359,209109,21774,399363,942,421,521
70140,434753,35361,209118,21774,399392,942,421,521
70145,434784,35364,209134,21776,399420,942,421,521
70150,434815,35367,209146,21778,399448,942,421,521
70155,434846,35370,209163,21780,399476,942,421,521
70160,434877,35373,209174,21781,399504,942,421,521
70165,434908,35376,209186,21782,399532,942,421,521
70170,434939,35379,209203,21785,399560,942,421,521
70175,434970,35382,209220,21786,399588,942,421,521
70180,435001,35385,209236,21788,399615,942,421,521
70185,435032,35390,209257,21793,399641,942,421,521
70190,435063,35396,209267,21795,399667,942,421,521
70195,435094,35401,209282,21799,399693,942,421,521
70200,435125,35404,209294,21800,399720,942,421,521
70205,435156,35406,209304,21801,399749,942,421,521
70210,435187,35408,209317,21803,399778,942,421,521
70215,435218,35410,209329,21805,399807,942,421,521
70220,435249,35412,209341,21807,399836,942,421,521
70225,435280,35414,209357,21808,399866,942,421,521
70230,435311,35415,209373,21809,399896,942,421,521
70235,435342,35416,209391,21809,399926,942,421,521
70240,435373,35417,209404,21809,399956,942,421,521
70245,435404,35418,209416,21810,399986,942,421,521
70250,435435,35419,209429,21811,400015,942,421,521
70255,435466,35420,209441,21812,400046,942,421,521
70260,435497,35420,209462,21812,400077,942,421,521
70265,435528,35420,209478,21812,400108,942,421,521
70270,435559,35420,209495,21812,400139,942,421,521
70275,435590,35420,209513,21812,400170,942,421,521
70280,435621,35420,209529,21812,400201,942,421,521
70285,435652,35420,209541,21812,400232,942,421,521
70290,435683,35420,209556,21812,400263,942,421,521
70295,435714,35420,209573,21812,400294,942,421,521
70300,435745,35421,209587,21812,400324,942,421,521
70305,435776,35423,209599,21813,400353,942,421,521
70310,435807,35428,209619,21818,400378,942,421,521
70315,435838,35433,209637,21822,400404,942,421,521
70320,435869,35439,209654,21827,400429,942,421,521
70325,435900,35445,209669,21830,400455,942,421,521
70330,435931,35450,209684,21834,400481,942,421,521
70335,435962,35453,209698,21836,400509,942,421,521
70340,435993,35456,209717,21838,400537,942,421,521
70345,436024,35460,209734,21841,400564,942,421,521
70350,436055,35464,209753,21844,400591,942,421,521
70355,436086,35467,209768,21845,400619,942,421,521
70360,436117,35470,209780,21847,400647,942,421,521
70365,436148,35473,209798,21850,400675,942,421,521
70370,436179,35477,209810,21852,400702,942,421,521
70375,436210,35481,209824,21853,400729,942,421,521
70380,436241,35484,209841,21855,400756,942,421,521
70385,436272,35485,209854,21856,400787,942,421,521
70390,436303,35485,209872,21856,400818,942,421,521
70395,436334,35485,209883,21856,400849,942,421,521
70400,436365,35485,209901,21856,400880,942,421,521
70405,436396,35485,209919,21856,400911,942,421,521
70410,436427,35485,209932,21856,400942,942,421,521
70415,436458,35485,209945,21856,400973,942,421,521
70420,436489,35485,209961,21856,401004,942,421,521
70425,436520,35485,209978,21856,401035,942,421,521
70430,436551,35485,209997,21856,401066,942,421,521
70435,436582,35486,210017,21857,401096,942,421,521
70440,436613,35487,210033,21857,401125,942,421,521
70445,436644,35491,210046,21859,401153,942,421,521
70450,436675,35494,210059,21861,401181,942,421,521
70455,436706,35497,210076,21863,401209,942,421,521
70460,436737,35500,210094,21864,401237,942,421,521
70465,436768,35503,210109,21866,401265,942,421,521
70470,436799,35506,210126,21868,401293,942,421,521
70475,436830,35509,210142,21870,401321,942,421,521
70480,436861,35512,210155,21873,401349,942,421,521
70485,436892,35515,210168,21874,401377,942,421,521
70490,436923,35519,210187,21877,401404,942,421,521
70495,436954,35523,210201,21880,401431,942,421,521
70500,436985,35526,210217,21880,401458,942,421,521
70505,437016,35531,210230,21883,401485,942,421,521
70510,437047,35535,210247,21885,401511,942,421,521
70515,437078,35540,210262,21888,401538,942,421,521
70520,437109,35544,210279,21891,401565,942,421,521
70525,437140,35548,210293,21893,401591,942,421,521
70530,437171,35553,210306,21897,401618,942,421,521
70535,437202,35556,210321,21898,401646,942,421,521
70540,437233,35559,210336,21900,401674,942,421,521
70545,437264,35562,210351,21901,401702,942,421,521
70550,437295,35567,210367,21904,401728,942,421,521
70555,437326,35570,210388,21906,401756,942,421,521
70560,437357,35571,210402,21907,401786,942,421,521
70565,437388,35571,210416,21907,401817,942,421,521
70570,437419,35571,210433,21907,401848,942,421,521
70575,437450,35571,210453,21907,401879,942,421,521
70580,437481,35571,210470,21907,401910,942,421,521
70585,437512,35571,210487,21907,401941,942,421,521
70590,437543,35571,210503,21907,401972,942,421,521
70595,437574,35571,210521,21907,402003,942,421,521
70600,437605,35571,210537,21907,402034,942,421,521
70605,437636,35571,210550,21907,402065,942,421,521
70610,437667,35571,210568,21907,402096,942,421,521
70615,437698,35571,210580,21907,402127,942,421,521
70620,437729,35571,210596,21907,402158,942,421,521
70625,437760,35572,210614,21908,402188,942,421,521
70630,437791,35573,210631,21909,402218,942,421,521
70635,437822,35574,210648,21909,402248,942,421,521
70640,437853,35576,210661,21910,402277,942,421,521
70645,437884,35578,210677,21910,402306,942,421,521
70650,437915,35580,210694,21912,402335,942,421,521
70655,437946,35582,210713,21914,402364,942,421,521
70660,437977,35584,210727,21916,402392,942,421,521
70665,438008,35588,210743,21919,402420,942,421,521
70670,438039,35592,210757,21921,402446,942,421,521
70675,438070,35598,210772,21925,402472,942,421,521
70680,438101,35603,210786,21927,402496,942,421,521
70685,438132,35610,210799,21931,402521,942,421,521
70690,438163,35616,210815,21937,402545,942,421,521
70695,438194,35622,210829,21942,402572,942,421,521
70700,438225,35626,210839,21943,402599,942,421,521
70705,438256,35631,210854,21948,402625,942,421,521
70710,438287,35634,210868,21951,402653,942,421,521
70715,438318,35638,210886,21955,402680,942,421,521
70720,438349,35642,210902,21957,402707,942,421,521
70725,438380,35646,210918,21959,402734,942,421,521
70730,438411,35650,210931,21961,402761,942,421,521
70735,438442,35654,210946,21964,402788,942,421,521
70740,438473,35657,210962,21965,402816,942,421,521
70745,438504,35657,210975,21965,402847,942,421,521
70750,438535,35657,210991,21965,402878,942,421,521
70755,438566,35657,211009,21965,402909,942,421,521
70760,438597,35657,211028,21965,402940,942,421,521
70765,438628,35657,211042,21965,402971,942,421,521
70770,438659,35657,211055,21965,403002,942,421,521
70775,438690,35657,211070,21965,403033,942,421,521
70780,438721,35657,211082,21965,403064,942,421,521
70785,438752,35657,211096,21965,403095,942,421,521
70790,438783,35657,211112,21965,403126,942,421,521
70795,438814,35657,211130,21965,403157,942,421,521
70800,438845,35657,211144,21965,403188,942,421,521
70805,438876,35659,211161,21967,403217,942,421,521
70810,438907,35661,211175,21968,403246,942,421,521
70815,438938,35664,211195,21970,403274,942,421,521
70820,438969,35666,211210,21970,403303,942,421,521
70825,439000,35668,211225,21971,403332,942,421,521
70830,439031,35671,211244,21974,403360,942,421,521
70835,439062,35674,211259,21977,403388,942,421,521
70840,439093,35676,211277,21979,403417,942,421,521
70845,439124,35679,211295,21982,403445,942,421,521
70850,439155,35684,211305,21984,403470,942,421,521
70855,439186,35690,211318,21988,403496,942,421,521
70860,439217,35696,211338,21994,403521,942,421,521
70865,439248,35699,211348,21996,403549,942,421,521
70870,439279,35704,211365,22000,403575,942,421,521
70875,439310,35706,211380,22000,403604,942,421,521
70880,439341,35708,211397,22001,403633,942,421,521
70885,439372,35711,211412,22003,403661,942,421,521
70890,439403,35713,211429,22005,403690,942,421,521
70895,439434,35716,211445,22006,403718,942,421,521
70900,439465,35720,211466,22010,403745,942,421,521
70905,439496,35724,211483,22012,403772,942,421,521
70910,439527,35728,211489,22014,403799,942,421,521
70915,439558,35730,211506,22016,403828,942,421,521
70920,439589,35731,211515,22017,403858,942,421,521
70925,439620,35731,211529,22017,403889,942,421,521
70930,439651,35731,211544,22017,403920,942,421,521
70935,439682,35731,211559,22017,403951,942,421,521
70940,439713,35731,211573,22017,403982,942,421,521
70945,439744,35731,211590,22017,404013,942,421,521
70950,439775,35731,211604,22017,404044,942,421,521
70955,439806,35731,211621,22017,404075,942,421,521
70960,439837,35731,211633,22017,404106,942,421,521
70965,439868,35731,211649,22017,404137,942,421,521
70970,439899,35732,211666,22018,404167,942,421,521
70975,439930,35734,211682,22020,404195,942,421,521
70980,439961,35738,211698,22022,404223,942,421,521
70985,439992,35741,211711,22022,404249,942,421,521
70990,440023,35746,211728,22025,404276,942,421,521
70995,440054,35750,211735,22026,404303,942,421,521
71000,440085,35755,211752,22029,404329,942,421,521
71005,440116,35759,211768,22032,404357,942,421,521
71010,440147,35762,211782,22035,404385,942,421,521
71015,440178,35765,211799,22037,404413,942,421,521
71020,440209,35768,211819,22038,404440,942,421,521
71025,440240,35772,211829,22039,404468,942,421,521
71030,440271,35775,211846,22041,404495,942,421,521
71035,440302,35778,211856,22044,404524,942,421,521
71040,440333,35780,211870,22044,404553,942,421,521
71045,440364,35783,211887,22045,404581,942,421,521
71050,440395,35785,211900,22046,404610,942,421,521
71055,440426,35786,211917,22047,404640,942,421,521
71060,440457,35787,211935,22048,404670,942,421,521
71065,440488,35788,211948,22048,404700,942,421,521
71070,440519,35789,211965,22048,404730,942,421,521
71075,440550,35790,211986,22049,404760,942,421,521
71080,440581,35791,211999,22050,404790,942,421,521
71085,440612,35793,212013,22052,404819,942,421,521
71090,440643,35796,212032,22055,404847,942,421,521
71095,440674,35799,212046,22057,404875,942,421,521
71100,440705,35801,212052,22058,404904,942,421,521
71105,440736,35805,212070,22060,404931,942,421,521
71110,440767,35808,212084,22062,404959,942,421,521
71115,440798,35811,212096,22064,404987,942,421,521
71120,440829,35813,212111,22065,405016,942,421,521
71125,440860,35816,212128,22067,405044,942,421,521
71130,440891,35818,212145,22067,405073,942,421,521
71135,440922,35821,212162,22069,405101,942,421,521
71140,440953,35824,212180,22071,405129,942,421,521
71145,440984,35827,212193,22073,405157,942,421,521
71150,441015,35829,212209,22074,405186,942,421,521
71155,441046,35831,212226,22075,405215,943,422,521
71160,441077,35834,212238,22076,405242,944,422,522
71165,441108,35839,212259,22079,405268,945,423,522
71170,441139,35843,212274,22081,405295,945,423,522
71175,441170,35848,212289,22085,405321,945,423,522
71180,441201,35852,212303,22087,405349,945,423,522
71185,441232,35856,212316,22088,405376,945,423,522
71190,441263,35859,212333,22088,405403,945,423,522
71195,441294,35862,212346,22090,405431,945,423,522
71200,441325,35864,212358,22091,405460,945,423,522
71205,441356,35866,212375,22093,405490,945,423,522
71210,441387,35866,212391,22093,405521,945,423,522
71215,441418,35866,212406,22093,405552,945,423,522
71220,441449,35866,212422,22093,405583,945,423,522
71225,441480,35866,212439,22093,405614,945,423,522
71230,441511,35866,212453,22093,405645,945,423,522
71235,441542,35866,212469,22093,405676,945,423,522
71240,441573,35866,212487,22093,405707,945,423,522
71245,441604,35866,212502,22093,405738,945,423,522
71250,441635,35867,212518,22094,405768,945,423,522
71255,441666,35868,212532,22094,405798,945,423,522
71260,441697,35869,212549,22095,405828,945,423,522
71265,441728,35870,212563,22095,405858,945,423,522
71270,441759,35871,212575,22095,405888,945,423,522
71275,441790,35872,212585,22095,405918,946,423,523
71280,441821,35873,212600,22095,405948,947,423,524
71285,441852,35876,212615,22097,405976,947,423,524
71290,441883,35880,212630,22099,406002,947,423,524
71295,441914,35884,212643,22102,406029,947,423,524
71300,441945,35890,212659,22106,406055,947,423,524
71305,441976,35893,212673,22107,406083,947,423,524
71310,442007,35899,212686,22110,406107,947,423,524
71315,442038,35904,212702,22115,406133,947,423,524
71320,442069,35908,212715,22117,406159,947,423,524
71325,442100,35913,212734,22121,406186,947,423,524
71330,442131,35918,212751,22125,406212,947,423,524
71335,442162,35924,212767,22129,406238,947,423,524
71340,442193,35928,212777,22131,406265,947,423,524
71345,442224,35932,212791,22133,406292,947,423,524
71350,442255,35939,212804,22137,406316,947,423,524
71355,442286,35943,212817,22140,406343,947,423,524
71360,442317,35948,212831,22144,406369,947,423,524
71365,442348,35952,212846,22146,406396,947,423,524
71370,442379,35957,212862,22149,406422,947,423,524
71375,442410,35960,212878,22150,406450,947,423,524
71380,442441,35962,212893,22152,406479,947,423,524
71385,442472,35963,212907,22153,406509,947,423,524
71390,442503,35964,212924,22154,406539,947,423,524
71395,442534,35965,212939,22155,406569,947,423,524
71400,442565,35966,212951,22155,406599,947,423,524
71405,442596,35968,212968,22156,406628,947,423,524
71410,442627,35968,212980,22156,406659,947,423,524
71415,442658,35968,212991,22156,406690,947,423,524
71420,442689,35968,213003,22156,406721,947,423,524
71425,442720,35968,213021,22156,406752,947,423,524
71430,442751,35968,213030,22156,406783,947,423,524
71435,442782,35968,213045,22156,406814,947,423,524
71440,442813,35968,213064,22156,406845,947,423,524
71445,442844,35969,213077,22157,406875,947,423,524
71450,442875,35970,213095,22157,406905,947,423,524
71455,442906,35971,213107,22157,406935,947,423,524
71460,442937,35972,213122,22157,406965,947,423,524
71465,442968,35977,213138,22162,406991,947,423,524
71470,442999,35981,213151,22164,407018,947,423,524
71475,443030,35985,213168,22168,407044,947,423,524
71480,443061,35989,213180,22170,407072,947,423,524
71485,443092,35993,213198,22172,407098,947,423,524
71490,443123,35999,213213,22176,407124,947,423,524
71495,443154,36004,213224,22178,407150,947,423,524
71500,443185,36008,213238,22180,407176,947,423,524
71505,443216,36015,213253,22186,407201,947,423,524
71510,443247,36021,213268,22190,407226,947,423,524
71515,443278,36025,213278,22192,407253,947,423,524
71520,443309,36029,213290,22195,407280,947,423,524
71525,443340,36034,213307,22200,407306,947,423,524
71530,443371,36040,213321,22205,407331,947,423,524
71535,443402,36044,213338,22209,407358,947,423,524
71540,443433,36049,213358,22213,407384,947,423,524
71545,443464,36053,213373,22217,407411,947,423,524
71550,443495,36057,213395,22221,407438,947,423,524
71555,443526,36059,213405,22221,407467,947,423,524
71560,443557,36061,213418,22222,407496,947,423,524
71565,443588,36065,213433,22225,407523,947,423,524
71570,443619,36067,213443,22225,407552,947,423,524
71575,443650,36070,213455,22227,407580,947,423,524
71580,443681,36073,213471,22229,407608,947,423,524
71585,443712,36077,213485,22233,407635,947,423,524
71590,443743,36078,213501,22233,407665,947,423,524
71595,443774,36079,213513,22233,407695,947,423,524
71600,443805,36080,213527,22233,407725,947,423,524
71605,443836,36081,213539,22234,407755,947,423,524
71610,443867,36082,213552,22235,407785,947,423,524
71615,443898,36084,213568,22236,407813,947,423,524
71620,443929,36087,213587,22239,407841,947,423,524
71625,443960,36090,213602,22240,407869,947,423,524
71630,443991,36093,213615,22241,407898,947,423,524
71635,444022,36095,213624,22242,407927,947,423,524
71640,444053,36097,213636,22242,407955,947,423,524
71645,444084,36100,213653,22244,407984,947,423,524
71650,444115,36103,213668,22246,408012,947,423,524
71655,444146,36106,213684,22248,408040,947,423,524
71660,444177,36109,213697,22249,408068,947,423,524
71665,444208,36111,213713,22249,408097,947,423,524
71670,444239,36114,213726,22251,408125,947,423,524
71675,444270,36116,213739,22253,408154,947,423,524
71680,444301,36119,213753,22254,408182,947,423,524
71685,444332,36121,213765,22255,408211,947,423,524
71690,444363,36123,213779,22256,408240,947,423,524
71695,444394,36125,213788,22256,408269,947,423,524
71700,444425,36128,213808,22257,408297,947,423,524
71705,444456,36131,213822,22259,408325,947,423,524
71710,444487,36133,213835,22261,408354,947,423,524
71715,444518,36135,213851,22263,408383,947,423,524
71720,444549,36136,213862,22263,408413,947,423,524
71725,444580,36138,213876,22265,408442,947,423,524
71730,444611,36139,213888,22265,408472,947,423,524
71735,444642,36141,213907,22267,408501,947,423,524
71740,444673,36142,213922,22267,408531,947,423,524
71745,444704,36143,213933,22268,408561,947,423,524
71750,444735,36147,213945,22271,408588,947,423,524
71755,444766,36151,213964,22275,408615,947,423,524
71760,444797,36153,213982,22276,408644,947,423,524
71765,444828,36157,213995,22279,408671,947,423,524
71770,444859,36161,214006,22282,408698,947,423,524
71775,444890,36165,214019,22284,408725,947,423,524
71780,444921,36168,214034,22287,408753,947,423,524
71785,444952,36170,214050,22287,408782,947,423,524
71790,444983,36172,214065,22289,408811,947,423,524
71795,445014,36175,214081,22292,408839,947,423,524
71800,445045,36178,214095,22292,408867,947,423,524
71805,445076,36183,214111,22295,408893,947,423,524
71810,445107,36186,214124,22296,408921,947,423,524
71815,445138,36190,214141,22298,408948,947,423,524
71820,445169,36194,214158,22299,408975,947,423,524
71825,445200,36196,214169,22300,409004,947,423,524
71830,445231,36198,214186,22301,409033,947,423,524
71835,445262,36200,214201,22302,409062,947,423,524
71840,445293,36202,214215,22304,409091,947,423,524
71845,445324,36203,214228,22305,409121,947,423,524
71850,445355,36206,214245,22307,409149,947,423,524
71855,445386,36208,214260,22309,409178,947,423,524
71860,445417,36209,214274,22309,409208,947,423,524
71865,445448,36210,214288,22309,409238,947,423,524
71870,445479,36211,214304,22310,409268,947,423,524
71875,445510,36212,214321,22311,409298,947,423,524
71880,445541,36212,214334,22311,409329,947,423,524
71885,445572,36213,214348,22311,409359,947,423,524
71890,445603,36214,214360,22311,409389,947,423,524
71895,445634,36215,214374,22312,409419,947,423,524
71900,445665,36216,214388,22312,409449,947,423,524
71905,445696,36217,214402,22312,409479,947,423,524
71910,445727,36218,214422,22312,409509,947,423,524
71915,445758,36220,214437,22313,409538,947,423,524
71920,445789,36221,214453,22313,409568,947,423,524
71925,445820,36224,214470,22314,409596,947,423,524
71930,445851,36227,214480,22316,409624,947,423,524
71935,445882,36231,214494,22318,409650,947,423,524
71940,445913,36236,214512,22321,409677,947,423,524
71945,445944,36241,214529,22325,409703,947,423,524
71950,445975,36247,214543,22328,409728,947,423,524
71955,446006,36252,214556,22331,409754,947,423,524
71960,446037,36258,214571,22335,409779,947,423,524
71965,446068,36263,214587,22338,409805,947,423,524
71970,446099,36269,214607,22342,409830,947,423,524
71975,446130,36273,214621,22345,409857,947,423,524
71980,446161,36278,214633,22347,409883,947,423,524
71985,446192,36283,214651,22351,409909,947,423,524
71990,446223,36288,214667,22354,409934,947,423,524
71995,446254,36295,214675,22358,409959,947,423,524
72000,446285,36299,214691,22360,409986,947,423,524
72005,446316,36301,214700,22360,410015,947,423,524
72010,446347,36303,214717,22362,410043,947,423,524
72015,446378,36306,214730,22365,410072,947,423,524
72020,446409,36308,214750,22367,410100,947,423,524
72025,446440,36311,214766,22369,410129,947,423,524
72030,446471,36313,214785,22370,410157,947,423,524
72035,446502,36315,214805,22372,410187,947,423,524
72040,446533,36317,214822,22373,410216,947,423,524
72045,446564,36318,214839,22374,410246,947,423,524
72050,446595,36320,214853,22375,410274,947,423,524
72055,446626,36322,214863,22376,410304,947,423,524
72060,446657,36324,214879,22377,410333,947,423,524
72065,446688,36326,214897,22378,410362,947,423,524
72070,446719,36329,214910,22380,410390,947,423,524
72075,446750,36331,214929,22382,410419,947,423,524
72080,446781,36334,214942,22383,410447,947,423,524
72085,446812,36336,214958,22385,410476,947,423,524
72090,446843,36338,214975,22386,410505,947,423,524
72095,446874,36340,214984,22386,410534,947,423,524
72100,446905,36343,215004,22387,410562,947,423,524
72105,446936,36345,215017,22388,410591,947,423,524
72110,446967,36347,215030,22390,410620,947,423,524
72115,446998,36350,215047,22392,410648,947,423,524
72120,447029,36353,215062,22395,410676,947,423,524
72125,447060,36355,215075,22396,410705,947,423,524
72130,447091,36358,215088,22398,410733,947,423,524
72135,447122,36359,215103,22399,410763,947,423,524
72140,447153,36360,215121,22400,410793,947,423,524
72145,447184,36361,215135,22401,410823,947,423,524
72150,447215,36362,215146,22402,410853,947,423,524
72155,447246,36363,215163,22403,410883,947,423,524
72160,447277,36364,215179,22404,410913,947,423,524
72165,447308,36367,215197,22407,410941,947,423,524
72170,447339,36369,215211,22409,410970,947,423,524
72175,447370,36373,215229,22413,410997,947,423,524
72180,447401,36375,215241,22415,411025,947,423,524
72185,447432,36379,215264,22418,411052,947,423,524
72190,447463,36383,215275,22421,411080,947,423,524
72195,447494,36387,215287,22423,411106,947,423,524
72200,447525,36391,215301,22427,411134,947,423,524
72205,447556,36394,215316,22428,411161,947,423,524
72210,447587,36397,215334,22429,411189,947,423,524
72215,447618,36400,215349,22431,411218,947,423,524
72220,447649,36401,215362,22431,411248,947,423,524
72225,447680,36403,215374,22432,411277,947,423,524
72230,447711,36405,215388,22433,411306,947,423,524
72235,447742,36406,215402,22433,411335,947,423,524
72240,447773,36408,215417,22435,411365,947,423,524
72245,447804,36409,215432,22435,411394,947,423,524
72250,447835,36412,215448,22438,411423,947,423,524
72255,447866,36414,215466,22440,411452,947,423,524
72260,447897,36415,215482,22441,411482,947,423,524
72265,447928,36416,215495,22441,411511,947,423,524
72270,447959,36419,215511,22443,411540,947,423,524
72275,447990,36420,215522,22443,411570,947,423,524
72280,448021,36422,215535,22443,411599,947,423,524
72285,448052,36425,215547,22445,411626,947,423,524
72290,448083,36428,215561,22447,411655,947,423,524
72295,448114,36430,215575,22447,411683,947,423,524
72300,448145,36433,215586,22449,411711,947,423,524
72305,448176,36438,215605,22454,411738,947,423,524
72310,448207,36442,215620,22456,411765,947,423,524
72315,448238,36445,215633,22457,411793,947,423,524
72320,448269,36449,215649,22461,411820,947,423,524
72325,448300,36453,215665,22462,411847,947,423,524
72330,448331,36458,215683,22466,411873,947,423,524
72335,448362,36462,215699,22470,411900,947,423,524
72340,448393,36466,215717,22472,411927,947,423,524
72345,448424,36469,215737,22475,411955,947,423,524
72350,448455,36471,215755,22476,411984,947,423,524
72355,448486,36473,215769,22477,412013,947,423,524
72360,448517,36475,215787,22479,412042,947,423,524
72365,448548,36477,215805,22480,412071,947,423,524
72370,448579,36479,215820,22480,412100,947,423,524
72375,448610,36481,215835,22480,412129,947,423,524
72380,448641,36483,215845,22482,412158,947,423,524
72385,448672,36485,215859,22484,412187,947,423,524
72390,448703,36487,215877,22485,412216,947,423,524
72395,448734,36489,215887,22485,412245,947,423,524
72400,448765,36491,215899,22486,412274,947,423,524
72405,448796,36493,215913,22487,412303,947,423,524
72410,448827,36497,215927,22490,412330,947,423,524
72415,448858,36501,215941,22494,412356,947,423,524
72420,448889,36506,215957,22496,412382,947,423,524
72425,448920,36508,215972,22497,412411,947,423,524
72430,448951,36510,215986,22499,412441,947,423,524
72435,448982,36512,216002,22500,412470,947,423,524
72440,449013,36513,216019,22501,412499,947,423,524
72445,449044,36516,216037,22504,412527,947,423,524
72450,449075,36521,216055,22508,412554,947,423,524
72455,449106,36526,216069,22512,412580,947,423,524
72460,449137,36529,216082,22515,412608,947,423,524
72465,449168,36532,216097,22516,412636,947,423,524
72470,449199,36533,216110,22516,412666,947,423,524
72475,449230,36535,216129,22518,412695,947,423,524
72480,449261,36537,216146,22520,412724,947,423,524
72485,449292,36539,216160,22521,412753,947,423,524
72490,449323,36540,216180,22522,412783,947,423,524
72495,449354,36541,216197,22522,412813,947,423,524
72500,449385,36542,216212,22522,412843,947,423,524
72505,449416,36543,216230,22523,412873,947,423,524
72510,449447,36544,216244,22523,412903,947,423,524
72515,449478,36545,216260,22523,412933,947,423,524
72520,449509,36546,216275,22523,412963,947,423,524
72525,449540,36547,216286,22523,412993,947,423,524
72530,449571,36548,216298,22524,413023,947,423,524
72535,449602,36552,216312,22526,413050,947,423,524
72540,449633,36556,216326,22529,413077,947,423,524
72545,449664,36560,216348,22532,413104,947,423,524
72550,449695,36564,216362,22534,413130,947,423,524
72555,449726,36568,216377,22536,413157,947,423,524
72560,449757,36572,216394,22538,413185,947,423,524
72565,449788,36574,216412,22540,413213,947,423,524
72570,449819,36578,216428,22544,413240,947,423,524
72575,449850,36582,216437,22545,413268,947,423,524
72580,449881,36585,216453,22546,413296,947,423,524
72585,449912,36589,216467,22548,413322,947,423,524
72590,449943,36593,216480,22551,413349,947,423,524
72595,449974,36599,216500,22555,413374,947,423,524
72600,450005,36604,216518,22558,413399,947,423,524
72605,450036,36608,216531,22561,413428,947,423,524
72610,450067,36609,216544,22562,413458,947,423,524
72615,450098,36610,216558,22563,413488,947,423,524
72620,450129,36612,216574,22565,413517,947,423,524
72625,450160,36612,216585,22565,413548,947,423,524
72630,450191,36612,216604,22565,413579,947,423,524
72635,450222,36612,216617,22565,413610,947,423,524
72640,450253,36612,216627,22565,413641,947,423,524
72645,450284,36612,216645,22565,413672,947,423,524
72650,450315,36612,216661,22565,413703,947,423,524
72655,450346,36612,216677,22565,413734,947,423,524
72660,450377,36612,216688,22565,413765,947,423,524
72665,450408,36615,216705,22566,413793,947,423,524
72670,450439,36618,216718,22568,413821,947,423,524
72675,450470,36621,216734,22570,413849,947,423,524
72680,450501,36625,216750,22573,413876,947,423,524
72685,450532,36627,216766,22575,413905,947,423,524
72690,450563,36629,216775,22576,413934,947,423,524
72695,450594,36630,216795,22577,413964,947,423,524
72700,450625,36632,216812,22579,413993,947,423,524
72705,450656,36633,216833,22580,414023,947,423,524
72710,450687,36634,216848,22581,414053,947,423,524
72715,450718,36637,216866,22583,414081,947,423,524
72720,450749,36638,216883,22584,414111,947,423,524
72725,450780,36639,216894,22585,414141,947,423,524
72730,450811,36641,216910,22585,414170,947,423,524
72735,450842,36643,216924,22586,414199,947,423,524
72740,450873,36645,216944,22587,414228,947,423,524
72745,450904,36647,216952,22587,414257,947,423,524
72750,450935,36649,216966,22587,414286,947,423,524
72755,450966,36651,216977,22588,414315,947,423,524
72760,450997,36653,216993,22589,414344,947,423,524
72765,451028,36655,217004,22590,414373,947,423,524
72770,451059,36657,217016,22591,414402,947,423,524
72775,451090,36659,217032,22593,414431,947,423,524
72780,451121,36661,217043,22594,414460,947,423,524
72785,451152,36668,217058,22598,414483,947,423,524
72790,451183,36676,217073,22603,414506,947,423,524
72795,451214,36682,217087,22608,414530,947,423,524
72800,451245,36688,217105,22612,414556,947,423,524
72805,451276,36692,217121,22614,414583,947,423,524
72810,451307,36696,217138,22617,414610,947,423,524
72815,451338,36701,217150,22620,414636,947,423,524
72820,451369,36704,217163,22622,414665,947,423,524
72825,451400,36706,217179,22622,414693,947,423,524
72830,451431,36710,217200,22625,414719,947,423,524
72835,451462,36714,217215,22629,414748,947,423,524
72840,451493,36716,217227,22630,414777,947,423,524
72845,451524,36719,217246,22632,414805,947,423,524
72850,451555,36720,217256,22632,414835,947,423,524
72855,451586,36721,217268,22632,414865,947,423,524
72860,451617,36722,217283,22632,414895,947,423,524
72865,451648,36723,217293,22632,414925,947,423,524
72870,451679,36724,217309,22632,414955,947,423,524
72875,451710,36725,217330,22632,414985,947,423,524
72880,451741,36726,217342,22633,415015,947,423,524
72885,451772,36727,217357,22634,415045,947,423,524
72890,451803,36728,217367,22634,415075,947,423,524
72895,451834,36730,217380,22634,415104,947,423,524
72900,451865,36733,217390,22636,415132,947,423,524
72905,451896,36737,217401,22638,415158,947,423,524
72910,451927,36742,217416,22643,415185,947,423,524
72915,451958,36746,217432,22646,415212,947,423,524
72920,451989,36749,217446,22647,415240,947,423,524
72925,452020,36752,217460,22647,415268,947,423,524
72930,452051,36755,217477,22648,415296,947,423,524
72935,452082,36758,217491,22649,415324,947,423,524
72940,452113,36761,217503,22650,415352,947,423,524
72945,452144,36764,217522,22651,415380,947,423,524
72950,452175,36767,217534,22652,415408,947,423,524
72955,452206,36771,217547,22655,415435,947,423,524
72960,452237,36774,217563,22656,415463,947,423,524
72965,452268,36778,217586,22660,415490,947,423,524
72970,452299,36782,217601,22663,415517,947,423,524
72975,452330,36784,217617,22663,415546,947,423,524
72980,452361,36786,217634,22664,415575,947,423,524
72985,452392,36788,217647,22665,415604,947,423,524
72990,452423,36790,217659,22666,415633,947,423,524
72995,452454,36792,217671,22668,415662,947,423,524
73000,452485,36794,217679,22668,415691,947,423,524
73005,452516,36796,217692,22668,415720,947,423,524
73010,452547,36799,217709,22669,415748,947,423,524
73015,452578,36803,217720,22672,415775,947,423,524
73020,452609,36809,217735,22677,415800,947,423,524
73025,452640,36811,217750,22678,415827,947,423,524
73030,452671,36816,217763,22681,415853,947,423,524
73035,452702,36821,217775,22684,415880,947,423,524
73040,452733,36824,217789,22685,415908,947,423,524
73045,452764,36827,217799,22688,415936,947,423,524
73050,452795,36831,217817,22691,415962,947,423,524
73055,452826,36835,217833,22695,415990,947,423,524
73060,452857,36836,217847,22696,416021,947,423,524
73065,452888,36836,217861,22696,416052,947,423,524
73070,452919,36836,217875,22696,416083,947,423,524
73075,452950,36836,217889,22696,416114,947,423,524
73080,452981,36836,217902,22696,416145,947,423,524
73085,453012,36836,217918,22696,416176,947,423,524
73090,453043,36836,217933,22696,416207,947,423,524
73095,453074,36836,217946,22696,416238,947,423,524
73100,453105,36836,217965,22696,416269,947,423,524
73105,453136,36836,217981,22696,416300,947,423,524
73110,453167,36836,217994,22696,416331,947,423,524
73115,453198,36836,218010,22696,416362,947,423,524
73120,453229,36836,218028,22696,416393,947,423,524
73125,453260,36836,218045,22696,416424,947,423,524
73130,453291,36839,218056,22697,416452,947,423,524
73135,453322,36842,218068,22699,416480,947,423,524
73140,453353,36845,218084,22701,416508,947,423,524
73145,453384,36848,218097,22703,416536,947,423,524
73150,453415,36851,218113,22704,416564,947,423,524
73155,453446,36854,218123,22705,416592,947,423,524
73160,453477,36857,218139,22706,416620,947,423,524
73165,453508,36861,218155,22707,416646,947,423,524
73170,453539,36866,218173,22710,416673,947,423,524
73175,453570,36870,218184,22712,416700,947,423,524
73180,453601,36874,218199,22713,416726,947,423,524
73185,453632,36879,218218,22715,416752,947,423,524
73190,453663,36884,218231,22718,416778,947,423,524
73195,453694,36889,218249,22722,416804,947,423,524
73200,453725,36894,218267,22725,416831,947,423,524
73205,453756,36899,218282,22729,416857,947,423,524
73210,453787,36904,218297,22733,416883,947,423,524
73215,453818,36908,218309,22736,416910,947,423,524
73220,453849,36912,218324,22738,416937,947,423,524
73225,453880,36916,218341,22742,416964,947,423,524
73230,453911,36920,218352,22745,416991,947,423,524
73235,453942,36925,218368,22749,417016,947,423,524
73240,453973,36930,218380,22751,417043,947,423,524
73245,454004,36934,218393,22754,417069,947,423,524
73250,454035,36940,218408,22758,417094,947,423,524
73255,454066,36945,218418,22761,417121,947,423,524
73260,454097,36950,218436,22765,417146,947,423,524
73265,454128,36955,218450,22768,417173,947,423,524
73270,454159,36959,218463,22772,417200,947,423,524
73275,454190,36963,218480,22774,417227,947,423,524
73280,454221,36966,218496,22775,417255,947,423,524
73285,454252,36970,218513,22777,417282,947,423,524
73290,454283,36974,218533,22781,417309,947,423,524
73295,454314,36976,218548,22781,417338,947,423,524
73300,454345,36978,218567,22783,417367,947,423,524
73305,454376,36980,218578,22784,417395,947,423,524
73310,454407,36983,218593,22787,417423,947,423,524
73315,454438,36986,218605,22790,417452,947,423,524
73320,454469,36988,218621,22791,417480,947,423,524
73325,454500,36991,218634,22794,417509,947,423,524
73330,454531,36993,218646,22795,417538,947,423,524
73335,454562,36995,218661,22797,417567,947,423,524
73340,454593,36997,218678,22798,417596,947,423,524
73345,454624,36999,218695,22800,417625,947,423,524
73350,454655,37001,218712,22801,417654,947,423,524
73355,454686,37003,218723,22802,417683,947,423,524
73360,454717,37005,218736,22802,417712,947,423,524
73365,454748,37007,218754,22803,417741,947,423,524
73370,454779,37009,218769,22803,417770,947,423,524
73375,454810,37011,218788,22804,417799,947,423,524
73380,454841,37014,218802,22806,417827,947,423,524
73385,454872,37015,218819,22807,417857,947,423,524
73390,454903,37016,218831,22807,417887,947,423,524
73395,454934,37017,218844,22808,417917,947,423,524
73400,454965,37018,218857,22808,417947,947,423,524
73405,454996,37019,218870,22809,417977,947,423,524
73410,455027,37020,218885,22809,418007,947,423,524
73415,455058,37021,218901,22809,418037,947,423,524
73420,455089,37022,218917,22809,418067,947,423,524
73425,455120,37024,218933,22810,418095,947,423,524
73430,455151,37028,218941,22811,418123,947,423,524
73435,455182,37031,218954,22812,418150,947,423,524
73440,455213,37035,218970,22814,418177,947,423,524
73445,455244,37039,218988,22816,418205,947,423,524
73450,455275,37043,219003,22820,418232,947,423,524
73455,455306,37046,219017,22822,418260,947,423,524
73460,455337,37050,219032,22823,418287,947,423,524
73465,455368,37053,219044,22823,418315,947,423,524
73470,455399,37058,219064,22828,418341,947,423,524
73475,455430,37062,219077,22830,418368,947,423,524
73480,455461,37066,219095,22833,418395,947,423,524
73485,455492,37070,219111,22834,418422,947,423,524
73490,455523,37074,219128,22838,418449,947,423,524
73495,455554,37080,219148,22843,418474,947,423,524
73500,455585,37083,219162,22844,418501,947,423,524
73505,455616,37087,219173,22847,418528,947,423,524
73510,455647,37090,219187,22848,418557,947,423,524
73515,455678,37092,219204,22850,418586,947,423,524
73520,455709,37093,219219,22850,418616,947,423,524
73525,455740,37095,219237,22851,418645,947,423,524
73530,455771,37097,219250,22852,418674,947,423,524
73535,455802,37098,219263,22853,418704,947,423,524
73540,455833,37098,219279,22853,418735,947,423,524
73545,455864,37098,219293,22853,418766,947,423,524
73550,455895,37098,219308,22853,418797,947,423,524
73555,455926,37098,219318,22853,418828,947,423,524
73560,455957,37098,219332,22853,418859,947,423,524
73565,455988,37098,219347,22853,418890,947,423,524
73570,456019,37098,219364,22853,418921,947,423,524
73575,456050,37098,219381,22853,418952,947,423,524
73580,456081,37098,219396,22853,418983,947,423,524
73585,456112,37098,219412,22853,419014,947,423,524
73590,456143,37098,219425,22853,419045,947,423,524
73595,456174,37098,219437,22853,419076,947,423,524
73600,456205,37098,219452,22853,419107,947,423,524
73605,456236,37099,219469,22854,419137,947,423,524
73610,456267,37101,219487,22855,419166,947,423,524
73615,456298,37105,219501,22857,419193,947,423,524
73620,456329,37110,219514,22859,419219,947,423,524
73625,456360,37115,219531,22863,419245,947,423,524
73630,456391,37118,219544,22864,419273,947,423,524
73635,456422,37123,219562,22866,419299,947,423,524
73640,456453,37129,219578,22869,419324,947,423,524
73645,456484,37133,219591,22871,419351,947,423,524
73650,456515,37137,219603,22872,419378,947,423,524
73655,456546,37141,219616,22873,419405,947,423,524
73660,456577,37145,219632,22875,419432,947,423,524
73665,456608,37149,219643,22877,419459,947,423,524
73670,456639,37154,219657,22880,419485,947,423,524
73675,456670,37159,219670,22884,419511,947,423,524
73680,456701,37163,219683,22885,419538,947,423,524
73685,456732,37166,219696,22886,419566,947,423,524
73690,456763,37169,219712,22887,419594,947,423,524
73695,456794,37172,219727,22889,419622,947,423,524
73700,456825,37175,219741,22891,419650,947,423,524
73705,456856,37179,219758,22894,419677,947,423,524
73710,456887,37182,219774,22896,419705,947,423,524
73715,456918,37185,219794,22897,419733,947,423,524
73720,456949,37188,219813,22897,419760,947,423,524
73725,456980,37192,219827,22900,419788,947,423,524
73730,457011,37195,219841,22902,419815,947,423,524
73735,457042,37200,219856,22905,419841,947,423,524
73740,457073,37205,219869,22908,419867,947,423,524
73745,457104,37207,219883,22910,419897,947,423,524
73750,457135,37208,219897,22910,419927,947,423,524
73755,457166,37209,219909,22910,419957,947,423,524
73760,457197,37210,219924,22910,419987,947,423,524
73765,457228,37211,219942,22910,420017,947,423,524
73770,457259,37212,219957,22911,420047,947,423,524
73775,457290,37213,219975,22911,420077,947,423,524
73780,457321,37214,219991,22911,420107,947,423,524
73785,457352,37215,220005,22911,420137,947,423,524
73790,457383,37217,220019,22912,420166,947,423,524
73795,457414,37219,220033,22912,420194,947,423,524
73800,457445,37223,220046,22915,420221,947,423,524
73805,457476,37227,220065,22917,420249,947,423,524
73810,457507,37232,220077,22920,420275,947,423,524
73815,457538,37235,220092,22921,420303,947,423,524
73820,457569,37239,220105,22925,420330,947,423,524
73825,457600,37244,220123,22930,420356,947,423,524
73830,457631,37248,220138,22932,420383,947,423,524
73835,457662,37253,220154,22935,420409,947,423,524
73840,457693,37257,220167,22937,420436,947,423,524
73845,457724,37260,220182,22939,420464,947,423,524
73850,457755,37264,220200,22942,420491,947,423,524
73855,457786,37267,220217,22943,420519,947,423,524
73860,457817,37270,220227,22944,420547,947,423,524
73865,457848,37272,220244,22946,420575,947,423,524
73870,457879,37275,220255,22947,420603,947,423,524
73875,457910,37278,220270,22950,420631,947,423,524
73880,457941,37281,220283,22952,420660,947,423,524
73885,457972,37283,220302,22953,420688,947,423,524
73890,458003,37285,220316,22955,420718,947,423,524
73895,458034,37286,220331,22955,420748,947,423,524
73900,458065,37287,220346,22955,420778,947,423,524
73905,458096,37288,220361,22955,420808,947,423,524
73910,458127,37289,220374,22956,420838,947,423,524
73915,458158,37290,220386,22956,420868,947,423,524
73920,458189,37291,220401,22956,420898,947,423,524
73925,458220,37294,220419,22957,420926,947,423,524
73930,458251,37297,220434,22960,420954,947,423,524
73935,458282,37299,220453,22960,420983,947,423,524
73940,458313,37302,220469,22962,421011,947,423,524
73945,458344,37305,220489,22965,421039,947,423,524
73950,458375,37308,220503,22968,421067,947,423,524
73955,458406,37310,220520,22969,421096,947,423,524
73960,458437,37312,220533,22971,421125,947,423,524
73965,458468,37315,220548,22973,421153,947,423,524
73970,458499,37319,220566,22975,421180,947,423,524
73975,458530,37324,220581,22980,421206,947,423,524
73980,458561,37328,220600,22984,421233,947,423,524
73985,458592,37332,220616,22987,421260,947,423,524
73990,458623,37335,220629,22989,421288,947,423,524
73995,458654,37337,220639,22989,421317,947,423,524
74000,458685,37339,220653,22991,421346,947,423,524
74005,458716,37341,220664,22991,421375,947,423,524
74010,458747,37343,220679,22993,421404,947,423,524
74015,458778,37345,220696,22994,421433,947,423,524
74020,458809,37347,220708,22995,421462,947,423,524
74025,458840,37349,220723,22996,421491,947,423,524
74030,458871,37351,220738,22996,421520,947,423,524
74035,458902,37353,220756,22998,421549,947,423,524
74040,458933,37355,220773,23000,421578,947,423,524
74045,458964,37359,220792,23003,421605,947,423,524
74050,458995,37363,220808,23007,421632,947,423,524
74055,459026,37366,220818,23008,421660,947,423,524
74060,459057,37369,220833,23011,421688,947,423,524
74065,459088,37372,220854,23014,421716,947,423,524
74070,459119,37375,220867,23015,421744,947,423,524
74075,459150,37378,220880,23017,421772,947,423,524
74080,459181,37381,220892,23020,421800,947,423,524
74085,459212,37385,220908,23022,421826,947,423,524
74090,459243,37390,220923,23024,421852,947,423,524
74095,459274,37396,220935,23027,421877,947,423,524
74100,459305,37402,220948,23030,421902,947,423,524
74105,459336,37406,220968,23034,421930,947,423,524
74110,459367,37410,220982,23035,421957,947,423,524
74115,459398,37414,220999,23038,421984,947,423,524
74120,459429,37418,221015,23040,422011,947,423,524
74125,459460,37421,221030,23042,422039,947,423,524
74130,459491,37425,221050,23044,422066,947,423,524
74135,459522,37429,221061,23046,422093,947,423,524
74140,459553,37433,221076,23049,422120,947,423,524
74145,459584,37436,221088,23049,422148,947,423,524
74150,459615,37439,221104,23051,422176,947,423,524
74155,459646,37443,221114,23052,422203,947,423,524
74160,459677,37447,221127,23054,422230,947,423,524
74165,459708,37448,221139,23055,422260,947,423,524
74170,459739,37449,221155,23055,422290,947,423,524
74175,459770,37450,221170,23056,422320,947,423,524
74180,459801,37451,221187,23056,422350,947,423,524
74185,459832,37452,221202,23057,422380,947,423,524
74190,459863,37453,221216,23057,422410,947,423,524
74195,459894,37454,221228,23058,422440,947,423,524
74200,459925,37455,221245,23058,422470,947,423,524
74205,459956,37456,221261,23059,422500,947,423,524
74210,459987,37457,221282,23060,422530,947,423,524
74215,460018,37458,221298,23061,422560,947,423,524
74220,460049,37459,221315,23062,422590,947,423,524
74225,460080,37462,221331,23064,422618,947,423,524
74230,460111,37465,221346,23066,422645,947,423,524
74235,460142,37468,221363,23068,422673,947,423,524
74240,460173,37471,221384,23070,422701,947,423,524
74245,460204,37473,221395,23071,422730,947,423,524
74250,460235,37475,221407,23072,422760,947,423,524
74255,460266,37475,221423,23072,422791,947,423,524
74260,460297,37475,221443,23072,422822,947,423,524
74265,460328,37475,221456,23072,422853,947,423,524
74270,460359,37476,221468,23072,422883,947,423,524
74275,460390,37477,221484,23072,422913,947,423,524
74280,460421,37478,221498,23073,422943,947,423,524
74285,460452,37482,221512,23074,422970,947,423,524
74290,460483,37486,221522,23075,422997,947,423,524
74295,460514,37490,221539,23076,423024,947,423,524
74300,460545,37494,221552,23077,423051,947,423,524
74305,460576,37498,221569,23079,423078,947,423,524
74310,460607,37502,221583,23082,423105,947,423,524
74315,460638,37506,221596,23083,423132,947,423,524
74320,460669,37510,221607,23085,423159,947,423,524
74325,460700,37514,221618,23086,423186,947,423,524
74330,460731,37518,221628,23086,423213,947,423,524
74335,460762,37522,221641,23088,423240,947,423,524
74340,460793,37527,221660,23091,423266,947,423,524
74345,460824,37530,221673,23092,423294,947,423,524
74350,460855,37534,221687,23095,423321,947,423,524
74355,460886,37537,221696,23095,423349,947,423,524
74360,460917,37541,221711,23096,423376,947,423,524
74365,460948,37545,221723,23098,423403,947,423,524
74370,460979,37549,221737,23100,423430,947,423,524
74375,461010,37552,221755,23101,423458,947,423,524
74380,461041,37554,221768,23102,423487,947,423,524
74385,461072,37556,221782,23103,423516,947,423,524
74390,461103,37559,221801,23106,423543,947,423,524
74395,461134,37564,221821,23111,423569,947,423,524
74400,461165,37568,221833,23114,423597,947,423,524
74405,461196,37569,221846,23114,423626,947,423,524
74410,461227,37571,221860,23115,423656,947,423,524
74415,461258,37572,221872,23115,423686,947,423,524
74420,461289,37573,221887,23116,423716,947,423,524
74425,461320,37574,221903,23116,423746,947,423,524
74430,461351,37575,221913,23117,423776,947,423,524
74435,461382,37576,221928,23117,423806,947,423,524
74440,461413,37577,221943,23118,423836,947,423,524
74445,461444,37579,221951,23118,423865,947,423,524
74450,461475,37581,221966,23119,423894,947,423,524
74455,461506,37583,221976,23119,423923,947,423,524
74460,461537,37585,221990,23120,423952,947,423,524
74465,461568,37586,222001,23120,423982,947,423,524
74470,461599,37587,222013,23120,424011,947,423,524
74475,461630,37589,222028,23121,424040,947,423,524
74480,461661,37591,222039,23123,424069,947,423,524
74485,461692,37594,222057,23125,424098,947,423,524
74490,461723,37596,222070,23126,424126,947,423,524
74495,461754,37599,222084,23127,424154,947,423,524
74500,461785,37602,222099,23130,424183,947,423,524
74505,461816,37604,222116,23131,424211,947,423,524
74510,461847,37610,222136,23135,424236,947,423,524
74515,461878,37616,222147,23138,424262,947,423,524
74520,461909,37620,222164,23142,424289,947,423,524
74525,461940,37625,222177,23145,424315,947,423,524
74530,461971,37629,222187,23146,424342,947,423,524
74535,462002,37633,222202,23149,424369,947,423,524
74540,462033,37636,222213,23149,424397,947,423,524
74545,462064,37640,222227,23153,424424,947,423,524
74550,462095,37644,222241,23155,424451,947,423,524
74555,462126,37648,222256,23157,424478,947,423,524
74560,462157,37651,222270,23159,424506,947,423,524
74565,462188,37655,222284,23161,424533,947,423,524
74570,462219,37659,222297,23164,424560,947,423,524
74575,462250,37662,222314,23167,424588,947,423,524
74580,462281,37664,222326,23169,424617,947,423,524
74585,462312,37665,222339,23170,424647,947,423,524
74590,462343,37666,222355,23171,424677,947,423,524
74595,462374,37667,222372,23172,424707,947,423,524
74600,462405,37668,222391,23173,424737,947,423,524
74605,462436,37669,222404,23174,424767,947,423,524
74610,462467,37670,222419,23174,424797,947,423,524
74615,462498,37671,222434,23175,424827,947,423,524
74620,462529,37672,222448,23175,424857,947,423,524
74625,462560,37674,222462,23176,424886,947,423,524
74630,462591,37678,222479,23178,424913,947,423,524
74635,462622,37680,222494,23179,424942,947,423,524
74640,462653,37682,222510,23180,424971,947,423,524
74645,462684,37684,222524,23180,425000,947,423,524
74650,462715,37687,222538,23181,425028,947,423,524
74655,462746,37690,222556,23183,425056,947,423,524
74660,462777,37692,222570,23183,425085,947,423,524
74665,462808,37695,222584,23186,425113,947,423,524
74670,462839,37698,222598,23188,425141,947,423,524
74675,462870,37701,222614,23190,425169,947,423,524
74680,462901,37704,222626,23191,425197,947,423,524
74685,462932,37707,222637,23193,425225,947,423,524
74690,462963,37711,222650,23195,425252,947,423,524
74695,462994,37714,222663,23196,425280,947,423,524
74700,463025,37718,222679,23200,425307,947,423,524
74705,463056,37722,222694,23203,425334,947,423,524
74710,463087,37726,222705,23204,425361,947,423,524
74715,463118,37730,222721,23207,425388,947,423,524
74720,463149,37733,222735,23209,425416,947,423,524
74725,463180,37736,222752,23212,425444,947,423,524
74730,463211,37739,222766,23213,425472,947,423,524
74735,463242,37743,222779,23216,425499,947,423,524
74740,463273,37747,222797,23219,425526,947,423,524
74745,463304,37751,222812,23221,425553,947,423,524
74750,463335,37754,222827,23223,425581,947,423,524
74755,463366,37758,222844,23225,425607,947,423,524
74760,463397,37762,222858,23227,425634,947,423,524
74765,463428,37767,222873,23230,425660,947,423,524
74770,463459,37771,222887,23232,425687,947,423,524
74775,463490,37776,222904,23236,425713,947,423,524
74780,463521,37780,222918,23238,425740,947,423,524
74785,463552,37785,222930,23240,425766,947,423,524
74790,463583,37789,222944,23243,425794,947,423,524
74795,463614,37793,222960,23245,425821,947,423,524
74800,463645,37797,222972,23247,425848,947,423,524
74805,463676,37800,222984,23248,425875,947,423,524
74810,463707,37803,222997,23251,425904,947,423,524
74815,463738,37805,223013,23252,425933,947,423,524
74820,463769,37807,223024,23253,425962,947,423,524
74825,463800,37808,223043,23253,425992,947,423,524
74830,463831,37809,223057,23253,426022,947,423,524
74835,463862,37810,223073,23254,426052,947,423,524
74840,463893,37811,223089,23254,426082,947,423,524
74845,463924,37812,223106,23255,426112,947,423,524
74850,463955,37813,223120,23255,426142,947,423,524
74855,463986,37814,223133,23255,426172,947,423,524
74860,464017,37815,223152,23255,426202,947,423,524
74865,464048,37816,223166,23255,426232,947,423,524
74870,464079,37818,223180,23256,426261,947,423,524
74875,464110,37819,223191,23256,426291,947,423,524
74880,464141,37822,223204,23258,426319,947,423,524
74885,464172,37824,223223,23259,426348,947,423,524
74890,464203,37825,223234,23259,426378,947,423,524
74895,464234,37826,223248,23259,426408,947,423,524
74900,464265,37827,223264,23260,426438,947,423,524
74905,464296,37828,223279,23260,426468,947,423,524
74910,464327,37830,223293,23262,426497,947,423,524
74915,464358,37832,223305,23264,426526,947,423,524
74920,464389,37834,223320,23264,426555,947,423,524
74925,464420,37837,223333,23265,426583,947,423,524
74930,464451,37840,223347,23267,426611,947,423,524
74935,464482,37843,223365,23268,426639,947,423,524
74940,464513,37846,223385,23271,426667,947,423,524
74945,464544,37849,223399,23273,426695,947,423,524
74950,464575,37852,223411,23276,426723,947,423,524
74955,464606,37855,223422,23277,426751,947,423,524
74960,464637,37858,223435,23279,426779,947,423,524
74965,464668,37861,223450,23280,426807,947,423,524
74970,464699,37864,223459,23283,426835,947,423,524
74975,464730,37867,223473,23284,426863,947,423,524
74980,464761,37870,223484,23285,426891,947,423,524
74985,464792,37875,223502,23287,426917,947,423,524
74990,464823,37880,223515,23289,426943,947,423,524
74995,464854,37886,223532,23292,426967,947,423,524
75000,464885,37892,223549,23297,426992,947,423,524
75005,464916,37898,223567,23300,427018,947,423,524
75010,464947,37902,223583,23303,427045,947,423,524
75015,464978,37906,223597,23305,427072,947,423,524
75020,465009,37910,223618,23306,427098,947,423,524
75025,465040,37915,223628,23310,427125,947,423,524
75030,465071,37920,223640,23313,427151,947,423,524
75035,465102,37924,223655,23315,427177,947,423,524
75040,465133,37929,223668,23317,427204,947,423,524
75045,465164,37933,223679,23319,427231,947,423,524
75050,465195,37935,223693,23320,427260,947,423,524
75055,465226,37937,223709,23321,427289,947,423,524
75060,465257,37939,223723,23322,427318,947,423,524
75065,465288,37941,223741,23322,427347,947,423,524
75070,465319,37943,223759,23322,427376,947,423,524
75075,465350,37945,223770,23323,427405,947,423,524
75080,465381,37947,223784,23324,427434,947,423,524
75085,465412,37949,223802,23324,427463,947,423,524
75090,465443,37951,223813,23325,427492,947,423,524
75095,465474,37953,223831,23327,427521,947,423,524
75100,465505,37955,223846,23328,427550,947,423,524
75105,465536,37957,223863,23329,427579,947,423,524
75110,465567,37960,223874,23330,427607,947,423,524
75115,465598,37963,223889,23332,427635,947,423,524
75120,465629,37965,223905,23334,427664,947,423,524
75125,465660,37967,223921,23334,427693,947,423,524
75130,465691,37970,223940,23337,427721,947,423,524
75135,465722,37972,223955,23339,427750,947,423,524
75140,465753,37974,223967,23340,427779,947,423,524
75145,465784,37977,223983,23341,427807,947,423,524
75150,465815,37979,224002,23343,427836,947,423,524
75155,465846,37982,224021,23345,427864,947,423,524
75160,465877,37986,224043,23349,427890,947,423,524
75165,465908,37990,224057,23353,427918,947,423,524
75170,465939,37994,224075,23354,427945,947,423,524
75175,465970,37997,224083,23355,427973,947,423,524
75180,466001,38000,224095,23357,428001,947,423,524
75185,466032,38003,224114,23358,428028,947,423,524
75190,466063,38007,224130,23361,428055,947,423,524
75195,466094,38011,224145,23364,428083,947,423,524
75200,466125,38014,224160,23367,428111,947,423,524
75205,466156,38017,224174,23369,428139,947,423,524
75210,466187,38020,224191,23371,428167,947,423,524
75215,466218,38023,224211,23374,428195,947,423,524
75220,466249,38026,224233,23376,428223,947,423,524
75225,466280,38030,224246,23378,428249,947,423,524
75230,466311,38035,224261,23380,428276,947,423,524
75235,466342,38038,224274,23382,428303,947,423,524
75240,466373,38041,224290,23384,428332,947,423,524
75245,466404,38043,224307,23385,428361,947,423,524
75250,466435,38045,224319,23386,428390,947,423,524
75255,466466,38049,224336,23388,428417,947,423,524
75260,466497,38052,224350,23391,428445,947,423,524
75265,466528,38055,224366,23393,428473,947,423,524
75270,466559,38059,224375,23396,428500,947,423,524
75275,466590,38061,224389,23396,428529,947,423,524
75280,466621,38064,224402,23397,428557,947,423,524
75285,466652,38067,224417,23399,428585,947,423,524
75290,466683,38069,224429,23400,428614,947,423,524
75295,466714,38072,224446,23402,428642,947,423,524
75300,466745,38074,224458,23404,428671,947,423,524
75305,466776,38075,224473,23405,428701,947,423,524
75310,466807,38076,224491,23406,428731,947,423,524
75315,466838,38077,224504,23407,428761,947,423,524
75320,466869,38078,224519,23408,428791,947,423,524
75325,466900,38079,224531,23408,428821,947,423,524
75330,466931,38080,224544,23408,428851,947,423,524
75335,466962,38082,224561,23409,428880,947,423,524
75340,466993,38084,224576,23411,428909,947,423,524
75345,467024,38087,224596,23413,428936,947,423,524
75350,467055,38092,224611,23417,428962,947,423,524
75355,467086,38097,224625,23419,428988,947,423,524
75360,467117,38101,224643,23421,429015,947,423,524
75365,467148,38104,224655,23422,429044,947,423,524
75370,467179,38107,224670,23423,429072,947,423,524
75375,467210,38109,224686,23424,429101,947,423,524
75380,467241,38111,224700,23424,429130,947,423,524
75385,467272,38114,224716,23426,429158,947,423,524
75390,467303,38116,224732,23427,429187,947,423,524
75395,467334,38119,224750,23428,429215,947,423,524
75400,467365,38121,224764,23429,429244,947,423,524
75405,467396,38124,224774,23431,429272,947,423,524
75410,467427,38128,224792,23434,429299,947,423,524
75415,467458,38132,224809,23437,429326,947,423,524
75420,467489,38135,224825,23440,429354,947,423,524
75425,467520,38138,224841,23440,429382,947,423,524
75430,467551,38141,224851,23440,429410,947,423,524
75435,467582,38144,224866,23442,429438,947,423,524
75440,467613,38147,224879,23442,429466,947,423,524
75445,467644,38150,224900,23444,429494,947,423,524
75450,467675,38154,224915,23448,429521,947,423,524
75455,467706,38157,224928,23449,429549,947,423,524
75460,467737,38161,224946,23452,429576,947,423,524
75465,467768,38164,224962,23455,429604,947,423,524
75470,467799,38170,224975,23458,429627,947,423,524
75475,467830,38178,224991,23464,429652,947,423,524
75480,467861,38184,225009,23467,429675,947,423,524
75485,467892,38191,225022,23472,429701,947,423,524
75490,467923,38194,225033,23474,429729,947,423,524
75495,467954,38196,225053,23475,429758,947,423,524
75500,467985,38198,225069,23477,429787,947,423,524
75505,468016,38200,225077,23477,429816,947,423,524
75510,468047,38202,225096,23477,429845,947,423,524
75515,468078,38204,225108,23479,429874,947,423,524
75520,468109,38206,225121,23480,429903,947,423,524
75525,468140,38208,225133,23481,429932,947,423,524
75530,468171,38210,225148,23482,429961,947,423,524
75535,468202,38212,225165,23484,429990,947,423,524
75540,468233,38214,225180,23485,430019,947,423,524
75545,468264,38216,225197,23487,430048,947,423,524
75550,468295,38218,225207,23487,430077,947,423,524
75555,468326,38220,225217,23489,430106,947,423,524
75560,468357,38222,225233,23491,430135,947,423,524
75565,468388,38224,225247,23491,430164,947,423,524
75570,468419,38226,225260,23491,430193,947,423,524
75575,468450,38228,225272,23491,430222,947,423,524
75580,468481,38230,225285,23492,430251,947,423,524
75585,468512,38232,225301,23493,430279,947,423,524
75590,468543,38235,225316,23495,430307,947,423,524
75595,468574,38241,225335,23499,430332,947,423,524
75600,468605,38246,225352,23503,430359,947,423,524
75605,468636,38251,225369,23506,430384,947,423,524
75610,468667,38255,225381,23508,430412,947,423,524
75615,468698,38258,225399,23510,430440,947,423,524
75620,468729,38261,225414,23512,430468,947,423,524
75625,468760,38263,225431,23513,430497,947,423,524
75630,468791,38265,225447,23515,430526,947,423,524
75635,468822,38268,225461,23517,430554,947,423,524
75640,468853,38271,225477,23519,430582,947,423,524
75645,468884,38274,225492,23522,430610,947,423,524
75650,468915,38276,225505,23522,430639,947,423,524
75655,468946,38278,225518,23523,430668,947,423,524
75660,468977,38280,225533,23523,430697,947,423,524
75665,469008,38282,225547,23524,430726,947,423,524
75670,469039,38284,225560,23526,430755,947,423,524
75675,469070,38286,225570,23526,430784,947,423,524
75680,469101,38289,225592,23529,430812,947,423,524
75685,469132,38293,225604,23531,430839,947,423,524
75690,469163,38295,225621,23532,430868,947,423,524
75695,469194,38296,225638,23532,430898,947,423,524
75700,469225,38297,225656,23532,430928,947,423,524
75705,469256,38299,225670,23533,430957,947,423,524
75710,469287,38302,225684,23534,430983,947,423,524
75715,469318,38307,225696,23538,431011,947,423,524
75720,469349,38309,225711,23539,431040,947,423,524
75725,469380,38313,225728,23542,431067,947,423,524
75730,469411,38317,225749,23546,431094,947,423,524
75735,469442,38320,225768,23548,431122,947,423,524
75740,469473,38323,225778,23549,431150,947,423,524
75745,469504,38326,225790,23551,431178,947,423,524
75750,469535,38329,225805,23553,431206,947,423,524
75755,469566,38332,225818,23555,431234,947,423,524
75760,469597,38335,225831,23556,431262,947,423,524
75765,469628,38338,225841,23558,431290,947,423,524
75770,469659,38341,225858,23561,431318,947,423,524
75775,469690,38344,225874,23563,431346,947,423,524
75780,469721,38347,225889,23565,431374,947,423,524
75785,469752,38350,225898,23566,431402,947,423,524
75790,469783,38353,225915,23567,431430,947,423,524
75795,469814,38356,225931,23568,431458,947,423,524
75800,469845,38360,225943,23570,431485,947,423,524
75805,469876,38362,225952,23571,431514,947,423,524
75810,469907,38365,225973,23573,431542,947,423,524
75815,469938,38367,225988,23575,431571,947,423,524
75820,469969,38370,226000,23575,431599,947,423,524
75825,470000,38373,226012,23575,431627,947,423,524
75830,470031,38376,226033,23576,431654,947,423,524
75835,470062,38381,226045,23580,431680,947,423,524
75840,470093,38387,226063,23584,431705,947,423,524
75845,470124,38392,226080,23587,431732,947,423,524
75850,470155,38396,226099,23590,431759,947,423,524
75855,470186,38400,226118,23593,431785,947,423,524
75860,470217,38405,226130,23596,431811,947,423,524
75865,470248,38408,226143,23598,431840,947,423,524
75870,470279,38411,226157,23599,431868,947,423,524
75875,470310,38412,226171,23599,431898,947,423,524
75880,470341,38413,226186,23599,431928,947,423,524
75885,470372,38414,226202,23599,431958,947,423,524
75890,470403,38415,226215,23600,431988,947,423,524
75895,470434,38416,226229,23601,432018,947,423,524
75900,470465,38417,226243,23601,432048,947,423,524
75905,470496,38418,226258,23601,432078,947,423,524
75910,470527,38419,226270,23602,432108,947,423,524
75915,470558,38420,226287,23603,432138,947,423,524
75920,470589,38422,226304,23604,432167,947,423,524
75925,470620,38424,226322,23606,432196,947,423,524
75930,470651,38424,226335,23606,432227,947,423,524
75935,470682,38424,226349,23606,432258,947,423,524
75940,470713,38424,226362,23606,432289,947,423,524
75945,470744,38424,226378,23606,432320,947,423,524
75950,470775,38424,226394,23606,432351,947,423,524
75955,470806,38425,226407,23606,432380,947,423,524
75960,470837,38427,226420,23608,432409,947,423,524
75965,470868,38431,226432,23610,432436,947,423,524
75970,470899,38436,226448,23613,432463,947,423,524
75975,470930,38439,226462,23614,432491,947,423,524
75980,470961,38442,226468,23614,432519,947,423,524
75985,470992,38446,226486,23617,432546,947,423,524
75990,471023,38449,226503,23620,432574,947,423,524
75995,471054,38453,226515,23622,432600,947,423,524
76000,471085,38457,226529,23623,432628,947,423,524
76005,471116,38461,226548,23626,432655,947,423,524
76010,471147,38464,226564,23628,432683,947,423,524
76015,471178,38468,226581,23631,432709,947,423,524
76020,471209,38472,226595,23634,432736,947,423,524
76025,471240,38478,226612,23639,432762,947,423,524
76030,471271,38481,226629,23642,432790,947,423,524
76035,471302,38485,226643,23644,432817,947,423,524
76040,471333,38489,226659,23647,432844,947,423,524
76045,471364,38493,226674,23650,432871,947,423,524
76050,471395,38497,226691,23654,432898,947,423,524
76055,471426,38501,226710,23657,432925,947,423,524
76060,471457,38506,226728,23660,432951,947,423,524
76065,471488,38510,226742,23662,432978,947,423,524
76070,471519,38516,226754,23666,433002,947,423,524
76075,471550,38520,226769,23669,433029,947,423,524
76080,471581,38523,226787,23670,433058,947,423,524
76085,471612,38524,226797,23670,433088,947,423,524
76090,471643,38525,226814,23670,433118,947,423,524
76095,471674,38526,226828,23670,433148,947,423,524
76100,471705,38527,226846,23671,433178,947,423,524
76105,471736,38528,226861,23671,433208,947,423,524
76110,471767,38529,226870,23672,433238,947,423,524
76115,471798,38530,226891,23672,433268,947,423,524
76120,471829,38531,226915,23673,433298,947,423,524
76125,471860,38532,226928,23673,433328,947,423,524
76130,471891,38534,226942,23674,433357,947,423,524
76135,471922,38537,226953,23677,433385,947,423,524
76140,471953,38540,226966,23678,433413,947,423,524
76145,471984,38543,226978,23678,433441,947,423,524
76150,472015,38546,226992,23679,433468,947,423,524
76155,472046,38550,227007,23681,433496,947,423,524
76160,472077,38553,227023,23682,433523,947,423,524
76165,472108,38557,227039,23685,433551,947,423,524
76170,472139,38560,227055,23687,433579,947,423,524
76175,472170,38563,227069,23688,433607,947,423,524
76180,472201,38567,227082,23688,433634,947,423,524
76185,472232,38571,227094,23690,433661,947,423,524
76190,472263,38575,227104,23692,433688,947,423,524
76195,472294,38580,227113,23694,433714,947,423,524
76200,472325,38584,227127,23695,433740,947,423,524
76205,472356,38590,227143,23699,433766,947,423,524
76210,472387,38594,227161,23701,433793,947,423,524
76215,472418,38597,227176,23704,433821,947,423,524
76220,472449,38600,227191,23706,433849,947,423,524
76225,472480,38604,227207,23708,433876,947,423,524
76230,472511,38608,227224,23711,433903,947,423,524
76235,472542,38611,227241,23711,433931,947,423,524
76240,472573,38614,227255,23711,433959,947,423,524
76245,472604,38617,227269,23711,433987,947,423,524
76250,472635,38621,227286,23714,434014,947,423,524
76255,472666,38624,227300,23715,434042,947,423,524
76260,472697,38628,227318,23717,434069,947,423,524
76265,472728,38632,227338,23719,434096,947,423,524
76270,472759,38635,227351,23721,434124,947,423,524
76275,472790,38637,227362,23722,434153,947,423,524
76280,472821,38641,227384,23725,434180,947,423,524
76285,472852,38643,227399,23725,434209,947,423,524
76290,472883,38644,227414,23725,434239,947,423,524
76295,472914,38646,227437,23727,434268,947,423,524
76300,472945,38648,227452,23728,434297,947,423,524
76305,472976,38648,227467,23728,434328,947,423,524
76310,473007,38648,227486,23728,434359,947,423,524
76315,473038,38648,227499,23728,434390,947,423,524
76320,473069,38648,227510,23728,434421,947,423,524
76325,473100,38648,227521,23728,434452,947,423,524
76330,473131,38648,227534,23728,434483,947,423,524
76335,473162,38648,227547,23728,434514,947,423,524
76340,473193,38648,227562,23728,434545,947,423,524
76345,473224,38648,227577,23728,434576,947,423,524
76350,473255,38648,227588,23728,434607,947,423,524
76355,473286,38648,227603,23728,434638,947,423,524
76360,473317,38648,227619,23728,434669,947,423,524
76365,473348,38648,227633,23728,434700,947,423,524
76370,473379,38650,227647,23729,434729,947,423,524
76375,473410,38652,227661,23729,434758,947,423,524
76380,473441,38654,227677,23730,434787,947,423,524
76385,473472,38658,227695,23733,434814,947,423,524
76390,473503,38663,227711,23737,434840,947,423,524
76395,473534,38668,227731,23740,434866,947,423,524
76400,473565,38672,227747,23743,434893,947,423,524
76405,473596,38678,227765,23748,434918,947,423,524
76410,473627,38683,227783,23752,434944,947,423,524
76415,473658,38688,227796,23753,434970,947,423,524
76420,473689,38694,227811,23759,434995,947,423,524
76425,473720,38701,227827,23762,435019,947,423,524
76430,473751,38705,227843,23762,435046,947,423,524
76435,473782,38710,227862,23765,435072,947,423,524
76440,473813,38714,227878,23767,435099,947,423,524
76445,473844,38717,227895,23769,435127,947,423,524
76450,473875,38721,227912,23772,435153,947,423,524
76455,473906,38725,227931,23775,435181,947,423,524
76460,473937,38727,227947,23777,435210,947,423,524
76465,473968,38729,227962,23778,435239,947,423,524
76470,473999,38731,227978,23778,435268,947,423,524
76475,474030,38733,227992,23780,435297,947,423,524
76480,474061,38735,228007,23781,435326,947,423,524
76485,474092,38737,228020,23783,435355,947,423,524
76490,474123,38739,228027,23783,435384,947,423,524
76495,474154,38741,228037,23785,435412,947,423,524
76500,474185,38744,228049,23788,435440,947,423,524
76505,474216,38747,228064,23789,435469,947,423,524
76510,474247,38749,228081,23789,435497,947,423,524
76515,474278,38753,228099,23792,435525,947,423,524
76520,474309,38756,228112,23794,435553,947,423,524
76525,474340,38758,228124,23796,435582,947,423,524
76530,474371,38760,228141,23796,435611,947,423,524
76535,474402,38763,228153,23798,435639,947,423,524
76540,474433,38766,228167,23800,435667,947,423,524
76545,474464,38770,228177,23802,435694,947,423,524
76550,474495,38774,228197,23805,435720,947,423,524
76555,474526,38779,228214,23810,435746,947,423,524
76560,474557,38783,228227,23812,435773,947,423,524
76565,474588,38788,228238,23814,435800,947,423,524
76570,474619,38793,228252,23818,435825,947,423,524
76575,474650,38797,228264,23820,435853,947,423,524
76580,474681,38801,228278,23823,435880,947,423,524
76585,474712,38804,228294,23824,435907,947,423,524
76590,474743,38808,228308,23827,435935,947,423,524
76595,474774,38810,228322,23827,435963,947,423,524
76600,474805,38814,228332,23830,435991,947,423,524
76605,474836,38816,228345,23832,436020,947,423,524
76610,474867,38818,228358,23832,436049,947,423,524
76615,474898,38821,228371,23833,436077,947,423,524
76620,474929,38823,228383,23835,436105,947,423,524
76625,474960,38825,228395,23837,436135,947,423,524
76630,474991,38826,228404,23837,436165,947,423,524
76635,475022,38827,228419,23838,436195,947,423,524
76640,475053,38828,228432,23839,436225,947,423,524
76645,475084,38829,228447,23840,436255,947,423,524
76650,475115,38830,228458,23840,436285,947,423,524
76655,475146,38831,228470,23841,436315,947,423,524
76660,475177,38831,228483,23841,436346,947,423,524
76665,475208,38831,228501,23841,436377,947,423,524
76670,475239,38831,228515,23841,436408,947,423,524
76675,475270,38831,228530,23841,436439,947,423,524
76680,475301,38833,228542,23842,436468,947,423,524
76685,475332,38835,228555,23843,436496,947,423,524
76690,475363,38838,228565,23844,436524,947,423,524
76695,475394,38841,228583,23847,436553,947,423,524
76700,475425,38843,228601,23847,436582,947,423,524
76705,475456,38845,228613,23849,436611,947,423,524
76710,475487,38847,228628,23849,436640,947,423,524
76715,475518,38849,228645,23851,436669,947,423,524
76720,475549,38851,228657,23851,436698,947,423,524
76725,475580,38853,228667,23851,436727,947,423,524
76730,475611,38856,228677,23852,436755,947,423,524
76735,475642,38859,228692,23853,436783,947,423,524
76740,475673,38862,228709,23855,436811,947,423,524
76745,475704,38866,228725,23856,436838,947,423,524
76750,475735,38870,228739,23860,436865,947,423,524
76755,475766,38873,228755,23863,436893,947,423,524
76760,475797,38878,228775,23866,436919,947,423,524
76765,475828,38881,228790,23868,436947,947,423,524
76770,475859,38884,228804,23869,436975,947,423,524
76775,475890,38887,228816,23871,437003,947,423,524
76780,475921,38890,228833,23872,437031,947,423,524
76785,475952,38893,228851,23873,437059,947,423,524
76790,475983,38896,228864,23874,437087,947,423,524
76795,476014,38900,228878,23875,437114,947,423,524
76800,476045,38904,228892,23877,437140,947,423,524
76805,476076,38906,228909,23879,437170,947,423,524
76810,476107,38907,228927,23880,437200,947,423,524
76815,476138,38908,228942,23880,437230,947,423,524
76820,476169,38909,228957,23880,437260,947,423,524
76825,476200,38910,228972,23880,437290,947,423,524
76830,476231,38911,228989,23880,437320,947,423,524
76835,476262,38912,229004,23881,437350,947,423,524
76840,476293,38913,229022,23881,437380,947,423,524
76845,476324,38914,229042,23881,437410,947,423,524
76850,476355,38915,229056,23881,437440,947,423,524
76855,476386,38916,229075,23882,437470,947,423,524
76860,476417,38917,229091,23882,437500,947,423,524
76865,476448,38921,229106,23884,437527,947,423,524
76870,476479,38926,229127,23889,437553,947,423,524
76875,476510,38930,229143,23892,437580,947,423,524
76880,476541,38934,229156,23894,437607,947,423,524
76885,476572,38938,229171,23896,437634,947,423,524
76890,476603,38943,229187,23900,437660,947,423,524
76895,476634,38947,229203,23903,437687,947,423,524
76900,476665,38952,229214,23905,437713,947,423,524
76905,476696,38956,229231,23907,437740,947,423,524
76910,476727,38959,229241,23908,437767,947,423,524
76915,476758,38964,229254,23911,437794,947,423,524
76920,476789,38967,229266,23912,437822,947,423,524
76925,476820,38969,229282,23913,437851,947,423,524
76930,476851,38971,229297,23913,437880,947,423,524
76935,476882,38973,229308,23914,437909,947,423,524
76940,476913,38976,229325,23916,437937,947,423,524
76945,476944,38978,229338,23918,437966,947,423,524
76950,476975,38980,229351,23919,437995,947,423,524
76955,477006,38982,229366,23921,438024,947,423,524
76960,477037,38984,229380,23922,438053,947,423,524
76965,477068,38986,229391,23923,438081,947,423,524
76970,477099,38988,229408,23925,438111,947,423,524
76975,477130,38989,229424,23926,438141,947,423,524
76980,477161,38990,229440,23926,438171,947,423,524
76985,477192,38993,229453,23928,438199,947,423,524
76990,477223,38996,229471,23930,438226,947,423,524
76995,477254,38999,229487,23933,438254,947,423,524
77000,477285,39003,229504,23937,438282,947,423,524
77005,477316,39005,229519,23938,438311,947,423,524
77010,477347,39007,229537,23940,438340,947,423,524
77015,477378,39009,229554,23942,438369,947,423,524
77020,477409,39011,229567,23943,438398,947,423,524
77025,477440,39013,229583,23944,438427,947,423,524
77030,477471,39015,229597,23946,438456,947,423,524
77035,477502,39018,229609,23948,438484,947,423,524
77040,477533,39021,229627,23950,438511,947,423,524
77045,477564,39027,229641,23954,438537,947,423,524
77050,477595,39029,229653,23956,438566,947,423,524
77055,477626,39031,229664,23957,438595,947,423,524
77060,477657,39031,229680,23957,438626,947,423,524
77065,477688,39031,229693,23957,438657,947,423,524
77070,477719,39031,229710,23957,438688,947,423,524
77075,477750,39031,229727,23957,438719,947,423,524
77080,477781,39032,229741,23957,438749,947,423,524
77085,477812,39033,229750,23957,438779,947,423,524
77090,477843,39035,229769,23958,438808,947,423,524
77095,477874,39036,229783,23959,438838,947,423,524
77100,477905,39038,229795,23961,438867,947,423,524
77105,477936,39042,229809,23963,438894,947,423,524
77110,477967,39045,229827,23965,438921,947,423,524
77115,477998,39049,229844,23969,438949,947,423,524
77120,478029,39050,229859,23969,438979,947,423,524
77125,478060,39051,229872,23970,439009,947,423,524
77130,478091,39052,229888,23970,439039,947,423,524
77135,478122,39053,229900,23971,439069,947,423,524
77140,478153,39054,229917,23972,439099,947,423,524
77145,478184,39055,229934,23973,439129,947,423,524
77150,478215,39056,229951,23973,439159,947,423,524
77155,478246,39059,229964,23973,439187,947,423,524
77160,478277,39063,229979,23975,439214,947,423,524
77165,478308,39066,229988,23976,439242,947,423,524
77170,478339,39069,230005,23978,439269,947,423,524
77175,478370,39073,230019,23980,439297,947,423,524
77180,478401,39076,230039,23982,439324,947,423,524
77185,478432,39080,230051,23983,439351,947,423,524
77190,478463,39084,230067,23985,439378,947,423,524
77195,478494,39088,230080,23988,439406,947,423,524
77200,478525,39090,230094,23990,439435,947,423,524
77205,478556,39093,230106,23992,439463,947,423,524
77210,478587,39096,230119,23994,439491,947,423,524
77215,478618,39098,230131,23995,439520,947,423,524
77220,478649,39101,230143,23996,439548,947,423,524
77225,478680,39104,230155,23997,439576,947,423,524
77230,478711,39106,230173,23997,439605,947,423,524
77235,478742,39108,230189,23997,439634,947,423,524
77240,478773,39111,230204,23998,439662,947,423,524
77245,478804,39113,230218,23998,439691,947,423,524
77250,478835,39116,230235,24000,439719,947,423,524
77255,478866,39118,230249,24001,439748,947,423,524
77260,478897,39121,230262,24003,439776,947,423,524
77265,478928,39123,230272,24004,439805,947,423,524
77270,478959,39126,230285,24006,439833,947,423,524
77275,478990,39129,230301,24007,439861,947,423,524
77280,479021,39130,230314,24007,439891,947,423,524
77285,479052,39132,230323,24008,439920,947,423,524
77290,479083,39134,230341,24010,439949,947,423,524
77295,479114,39136,230353,24011,439978,947,423,524
77300,479145,39138,230361,24011,440007,947,423,524
77305,479176,39141,230372,24012,440035,947,423,524
77310,479207,39143,230385,24013,440064,947,423,524
77315,479238,39145,230405,24015,440093,947,423,524
77320,479269,39148,230423,24017,440121,947,423,524
77325,479300,39152,230441,24020,440148,947,423,524
77330,479331,39156,230457,24022,440174,947,423,524
77335,479362,39161,230474,24025,440200,947,423,524
77340,479393,39166,230485,24027,440226,947,423,524
77345,479424,39170,230501,24030,440254,947,423,524
77350,479455,39173,230518,24032,440282,947,423,524
77355,479486,39176,230535,24034,440310,947,423,524
77360,479517,39180,230549,24037,440337,947,423,524
77365,479548,39184,230566,24041,440364,947,423,524
77370,479579,39187,230583,24042,440392,947,423,524
77375,479610,39191,230599,24045,440419,947,423,524
77380,479641,39194,230617,24047,440447,947,423,524
77385,479672,39197,230635,24049,440475,947,423,524
77390,479703,39200,230646,24051,440503,947,423,524
77395,479734,39203,230662,24052,440531,947,423,524
77400,479765,39206,230672,24053,440559,947,423,524
77405,479796,39210,230691,24056,440586,947,423,524
77410,479827,39213,230707,24057,440614,947,423,524
77415,479858,39217,230720,24059,440641,947,423,524
77420,479889,39221,230737,24061,440668,947,423,524
77425,479920,39225,230755,24064,440695,947,423,524
77430,479951,39227,230770,24066,440724,947,423,524
77435,479982,39229,230785,24068,440753,947,423,524
77440,480013,39231,230801,24070,440782,947,423,524
77445,480044,39233,230817,24071,440811,947,423,524
77450,480075,39236,230831,24072,440838,947,423,524
77455,480106,39240,230850,24074,440865,947,423,524
77460,480137,39242,230864,24076,440894,947,423,524
77465,480168,39243,230876,24077,440925,947,423,524
77470,480199,39243,230886,24077,440956,947,423,524
77475,480230,39243,230901,24077,440987,947,423,524
77480,480261,39243,230919,24077,441018,947,423,524
77485,480292,39243,230939,24077,441049,947,423,524
77490,480323,39243,230952,24077,441080,947,423,524
77495,480354,39243,230965,24077,441111,947,423,524
77500,480385,39243,230980,24077,441142,947,423,524
77505,480416,39243,230997,24077,441173,947,423,524
77510,480447,39244,231016,24077,441203,947,423,524
77515,480478,39245,231034,24078,441233,947,423,524
77520,480509,39247,231047,24079,441262,947,423,524
77525,480540,39249,231067,24081,441290,947,423,524
77530,480571,39254,231082,24086,441317,947,423,524
77535,480602,39256,231093,24087,441346,947,423,524
77540,480633,39259,231111,24088,441374,947,423,524
77545,480664,39262,231127,24089,441402,947,423,524
77550,480695,39264,231140,24089,441431,947,423,524
77555,480726,39266,231156,24090,441460,947,423,524
77560,480757,39270,231173,24093,441487,947,423,524
77565,480788,39275,231186,24095,441512,947,423,524
77570,480819,39280,231198,24098,441539,947,423,524
77575,480850,39285,231214,24101,441564,947,423,524
77580,480881,39291,231234,24106,441589,947,423,524
77585,480912,39297,231248,24109,441614,947,423,524
77590,480943,39302,231265,24112,441641,947,423,524
77595,480974,39306,231284,24114,441668,947,423,524
77600,481005,39310,231297,24116,441695,947,423,524
77605,481036,39315,231311,24120,441721,947,423,524
77610,481067,39319,231324,24122,441748,947,423,524
77615,481098,39323,231338,24125,441775,947,423,524
77620,481129,39326,231355,24126,441803,947,423,524
77625,481160,39328,231367,24127,441832,947,423,524
77630,481191,39330,231380,24127,441861,947,423,524
77635,481222,39333,231397,24129,441889,947,423,524
77640,481253,39336,231408,24131,441917,947,423,524
77645,481284,39340,231426,24133,441943,947,423,524
77650,481315,39343,231439,24134,441971,947,423,524
77655,481346,39346,231453,24137,442000,947,423,524
77660,481377,39348,231467,24139,442029,947,423,524
77665,481408,39350,231483,24141,442058,947,423,524
77670,481439,39352,231499,24141,442087,947,423,524
77675,481470,39354,231510,24141,442116,947,423,524
77680,481501,39357,231523,24143,442144,947,423,524
77685,481532,39360,231541,24145,442172,947,423,524
77690,481563,39363,231562,24147,442200,947,423,524
77695,481594,39364,231575,24147,442230,947,423,524
77700,481625,39365,231589,24148,442260,947,423,524
77705,481656,39366,231601,24148,442290,947,423,524
77710,481687,39367,231616,24149,442320,947,423,524
77715,481718,39368,231629,24149,442350,947,423,524
77720,481749,39370,231642,24149,442379,947,423,524
77725,481780,39372,231659,24150,442408,947,423,524
77730,481811,39374,231674,24151,442437,947,423,524
77735,481842,39376,231687,24153,442466,947,423,524
77740,481873,39378,231701,24153,442495,947,423,524
77745,481904,39380,231716,24153,442524,947,423,524
77750,481935,39383,231734,24155,442552,947,423,524
77755,481966,39387,231745,24158,442579,947,423,524
77760,481997,39391,231761,24161,442606,947,423,524
77765,482028,39396,231772,24165,442632,947,423,524
77770,482059,39401,231787,24168,442658,947,423,524
77775,482090,39406,231801,24172,442684,947,423,524
77780,482121,39412,231816,24175,442709,947,423,524
77785,482152,39417,231832,24179,442735,947,423,524
77790,482183,39421,231846,24180,442762,947,423,524
77795,482214,39426,231861,24182,442788,947,423,524
77800,482245,39431,231877,24185,442814,947,423,524
77805,482276,39433,231890,24187,442843,947,423,524
77810,482307,39436,231904,24189,442871,947,423,524
77815,482338,39439,231920,24190,442898,947,423,524
77820,482369,39442,231932,24191,442926,947,423,524
77825,482400,39445,231950,24194,442955,947,423,524
77830,482431,39446,231964,24194,442985,947,423,524
77835,482462,39447,231984,24195,443015,947,423,524
77840,482493,39448,231993,24196,443045,947,423,524
77845,482524,39449,232006,24196,443075,947,423,524
77850,482555,39450,232023,24197,443105,947,423,524
77855,482586,39451,232039,24198,443135,947,423,524
77860,482617,39452,232051,24199,443165,947,423,524
77865,482648,39453,232065,24199,443195,947,423,524
77870,482679,39454,232083,24200,443225,947,423,524
77875,482710,39455,232098,24201,443255,947,423,524
77880,482741,39456,232113,24201,443285,947,423,524
77885,482772,39459,232129,24202,443313,947,423,524
77890,482803,39462,232141,24204,443341,947,423,524
77895,482834,39464,232156,24205,443370,947,423,524
77900,482865,39466,232169,24206,443399,947,423,524
77905,482896,39468,232184,24208,443428,947,423,524
77910,482927,39471,232196,24209,443456,947,423,524
77915,482958,39473,232211,24209,443485,947,423,524
77920,482989,39476,232228,24212,443513,947,423,524
77925,483020,39480,232247,24216,443540,947,423,524
77930,483051,39485,232263,24220,443566,947,423,524
77935,483082,39491,232278,24224,443591,947,423,524
77940,483113,39496,232297,24229,443617,947,423,524
77945,483144,39498,232315,24231,443646,947,423,524
77950,483175,39501,232329,24232,443674,947,423,524
77955,483206,39504,232342,24233,443702,947,423,524
77960,483237,39507,232357,24235,443730,947,423,524
77965,483268,39509,232373,24235,443759,947,423,524
77970,483299,39511,232389,24236,443788,947,423,524
77975,483330,39513,232404,24238,443817,947,423,524
77980,483361,39515,232422,24238,443846,947,423,524
77985,483392,39518,232435,24240,443874,947,423,524
77990,483423,39520,232450,24240,443903,947,423,524
77995,483454,39523,232468,24243,443931,947,423,524
78000,483485,39525,232485,24244,443960,947,423,524
78005,483516,39527,232499,24246,443989,947,423,524
78010,483547,39529,232516,24247,444018,947,423,524
78015,483578,39532,232532,24249,444046,947,423,524
78020,483609,39534,232550,24251,444075,947,423,524
78025,483640,39535,232565,24252,444105,947,423,524
78030,483671,39536,232575,24252,444135,947,423,524
78035,483702,39538,232590,24252,444164,947,423,524
78040,483733,39540,232606,24253,444193,947,423,524
78045,483764,39543,232620,24255,444221,947,423,524
78050,483795,39547,232636,24258,444248,947,423,524
78055,483826,39552,232652,24262,444274,947,423,524
78060,483857,39555,232668,24263,444302,947,423,524
78065,483888,39558,232679,24264,444330,947,423,524
78070,483919,39561,232694,24265,444358,947,423,524
78075,483950,39564,232711,24267,444386,947,423,524
78080,483981,39567,232727,24267,444413,947,423,524
78085,484012,39571,232746,24270,444440,947,423,524
78090,484043,39575,232763,24272,444467,947,423,524
78095,484074,39579,232777,24274,444495,947,423,524
78100,484105,39582,232795,24277,444523,947,423,524
78105,484136,39585,232810,24278,444551,947,423,524
78110,484167,39588,232827,24280,444579,947,423,524
78115,484198,39591,232843,24282,444607,947,423,524
78120,484229,39594,232858,24282,444635,947,423,524
78125,484260,39597,232874,24284,444663,947,423,524
78130,484291,39601,232887,24286,444689,947,423,524
78135,484322,39605,232904,24289,444717,947,423,524
78140,484353,39609,232915,24290,444743,947,423,524
78145,484384,39613,232927,24292,444771,947,423,524
78150,484415,39616,232941,24293,444799,947,423,524
78155,484446,39619,232958,24296,444827,947,423,524
78160,484477,39623,232970,24298,444853,947,423,524
78165,484508,39626,232982,24300,444882,947,423,524
78170,484539,39627,232994,24301,444912,947,423,524
78175,484570,39629,233008,24303,444941,947,423,524
78180,484601,39631,233026,24305,444970,947,423,524
78185,484632,39634,233041,24307,444998,947,423,524
78190,484663,39636,233048,24308,445027,947,423,524
78195,484694,39638,233060,24309,445056,947,423,524
78200,484725,39640,233074,24310,445084,947,423,524
78205,484756,39643,233095,24312,445112,947,423,524
78210,484787,39646,233109,24315,445141,947,423,524
78215,484818,39648,233125,24316,445169,947,423,524
78220,484849,39651,233140,24318,445197,947,423,524
78225,484880,39654,233158,24320,445225,947,423,524
78230,484911,39657,233174,24321,445253,947,423,524
78235,484942,39660,233191,24322,445281,947,423,524
78240,484973,39664,233203,24325,445309,947,423,524
78245,485004,39666,233217,24326,445338,947,423,524
78250,485035,39668,233233,24328,445367,947,423,524
78255,485066,39669,233243,24328,445397,947,423,524
78260,485097,39671,233257,24329,445426,947,423,524
78265,485128,39673,233277,24331,445455,947,423,524
78270,485159,39675,233292,24332,445484,947,423,524
78275,485190,39676,233306,24333,445514,947,423,524
78280,485221,39676,233321,24333,445545,947,423,524
78285,485252,39676,233331,24333,445576,947,423,524
78290,485283,39677,233346,24333,445606,947,423,524
78295,485314,39678,233365,24334,445636,947,423,524
78300,485345,39679,233380,24335,445666,947,423,524
78305,485376,39681,233391,24336,445694,947,423,524
78310,485407,39684,233408,24337,445723,947,423,524
78315,485438,39686,233423,24338,445752,947,423,524
78320,485469,39688,233438,24339,445781,947,423,524
78325,485500,39690,233450,24340,445810,947,423,524
78330,485531,39692,233469,24341,445839,947,423,524
78335,485562,39694,233482,24341,445868,947,423,524
78340,485593,39696,233501,24343,445897,947,423,524
78345,485624,39698,233517,24345,445926,947,423,524
78350,485655,39701,233535,24345,445954,947,423,524
78355,485686,39705,233553,24348,445981,947,423,524
78360,485717,39709,233569,24351,446008,947,423,524
78365,485748,39713,233589,24352,446034,947,423,524
78370,485779,39718,233606,24356,446060,947,423,524
78375,485810,39723,233623,24360,446087,947,423,524
78380,485841,39727,233639,24363,446114,947,423,524
78385,485872,39730,233652,24365,446142,947,423,524
78390,485903,39733,233669,24368,446170,947,423,524
78395,485934,39735,233684,24368,446199,947,423,524
78400,485965,39737,233699,24369,446228,947,423,524
78405,485996,39739,233714,24370,446257,947,423,524
78410,486027,39741,233730,24371,446286,947,423,524
78415,486058,39744,233745,24373,446314,947,423,524
78420,486089,39747,233759,24374,446342,947,423,524
78425,486120,39750,233775,24376,446370,947,423,524
78430,486151,39752,233788,24377,446399,947,423,524
78435,486182,39754,233803,24377,446428,947,423,524
78440,486213,39756,233822,24377,446457,947,423,524
78445,486244,39759,233841,24380,446485,947,423,524
78450,486275,39761,233857,24382,446514,947,423,524
78455,486306,39764,233875,24384,446542,947,423,524
78460,486337,39766,233892,24385,446571,947,423,524
78465,486368,39768,233908,24385,446600,947,423,524
78470,486399,39772,233923,24388,446627,947,423,524
78475,486430,39777,233934,24390,446653,947,423,524
78480,486461,39780,233949,24393,446681,947,423,524
78485,486492,39783,233969,24396,446708,947,423,524
78490,486523,39788,233981,24398,446734,947,423,524
78495,486554,39792,233994,24399,446762,947,423,524
78500,486585,39796,234012,24402,446789,947,423,524
78505,486616,39800,234030,24405,446816,947,423,524
78510,486647,39803,234045,24407,446844,947,423,524
78515,486678,39807,234060,24411,446871,947,423,524
78520,486709,39810,234073,24413,446899,947,423,524
78525,486740,39813,234092,24414,446927,947,423,524
78530,486771,39817,234107,24416,446954,947,423,524
78535,486802,39820,234122,24418,446982,947,423,524
78540,486833,39823,234142,24419,447010,947,423,524
78545,486864,39826,234155,24420,447038,947,423,524
78550,486895,39830,234170,24424,447065,947,423,524
78555,486926,39834,234183,24425,447092,947,423,524
78560,486957,39836,234197,24426,447121,947,423,524
78565,486988,39838,234215,24428,447150,947,423,524
78570,487019,39840,234226,24428,447179,947,423,524
78575,487050,39842,234240,24429,447208,947,423,524
78580,487081,39844,234254,24430,447237,947,423,524
78585,487112,39847,234269,24431,447265,947,423,524
78590,487143,39850,234280,24432,447293,947,423,524
78595,487174,39853,234292,24433,447321,947,423,524
78600,487205,39856,234305,24436,447349,947,423,524
78605,487236,39858,234324,24437,447378,947,423,524
78610,487267,39860,234337,24438,447407,947,423,524
78615,487298,39862,234353,24440,447436,947,423,524
78620,487329,39864,234364,24440,447465,947,423,524
78625,487360,39866,234381,24442,447494,947,423,524
78630,487391,39868,234400,24442,447523,947,423,524
78635,487422,39870,234414,24442,447552,947,423,524
78640,487453,39872,234429,24442,447581,947,423,524
78645,487484,39874,234440,24442,447610,947,423,524
78650,487515,39876,234453,24443,447639,947,423,524
78655,487546,39878,234473,24444,447668,947,423,524
78660,487577,39881,234491,24447,447696,947,423,524
78665,487608,39883,234510,24449,447725,947,423,524
78670,487639,39886,234531,24452,447753,947,423,524
78675,487670,39888,234550,24453,447782,947,423,524
78680,487701,39889,234561,24453,447812,947,423,524
78685,487732,39890,234575,24454,447842,947,423,524
78690,487763,39892,234593,24456,447871,947,423,524
78695,487794,39894,234604,24457,447900,947,423,524
78700,487825,39896,234622,24459,447929,947,423,524
78705,487856,39897,234634,24459,447959,947,423,524
78710,487887,39899,234648,24459,447988,947,423,524
78715,487918,39902,234658,24461,448016,947,423,524
78720,487949,39906,234679,24465,448043,947,423,524
78725,487980,39910,234690,24466,448070,947,423,524
78730,488011,39915,234704,24468,448096,947,423,524
78735,488042,39920,234719,24471,448122,947,423,524
78740,488073,39924,234735,24473,448149,947,423,524
78745,488104,39929,234755,24477,448175,947,423,524
78750,488135,39933,234772,24478,448202,947,423,524
78755,488166,39938,234782,24479,448228,947,423,524
78760,488197,39942,234802,24482,448254,947,423,524
78765,488228,39947,234818,24485,448281,947,423,524
78770,488259,39951,234833,24487,448308,947,423,524
78775,488290,39955,234849,24489,448334,947,423,524
78780,488321,39959,234864,24491,448361,947,423,524
78785,488352,39962,234881,24493,448390,947,423,524
78790,488383,39965,234895,24496,448418,947,423,524
78795,488414,39967,234905,24497,448447,947,423,524
78800,488445,39969,234924,24499,448476,947,423,524
78805,488476,39972,234941,24502,448504,947,423,524
78810,488507,39974,234956,24502,448533,947,423,524
78815,488538,39977,234969,24503,448561,947,423,524
78820,488569,39979,234984,24503,448590,947,423,524
78825,488600,39982,235002,24506,448617,947,423,524
78830,488631,39985,235013,24507,448645,947,423,524
78835,488662,39988,235027,24510,448674,947,423,524
78840,488693,39990,235041,24511,448702,947,423,524
78845,488724,39995,235056,24515,448728,947,423,524
78850,488755,40001,235067,24519,448754,947,423,524
78855,488786,40005,235082,24520,448781,947,423,524
78860,488817,40007,235096,24522,448810,947,423,524
78865,488848,40009,235113,24522,448839,947,423,524
78870,488879,40011,235127,24523,448868,947,423,524
78875,488910,40013,235144,24523,448897,947,423,524
78880,488941,40016,235155,24525,448925,947,423,524
78885,488972,40019,235167,24526,448953,947,423,524
78890,489003,40022,235185,24527,448981,947,423,524
78895,489034,40025,235202,24530,449009,947,423,524
78900,489065,40028,235221,24532,449037,947,423,524
78905,489096,40029,235238,24532,449067,947,423,524
78910,489127,40030,235253,24533,449097,947,423,524
78915,489158,40031,235265,24533,449127,947,423,524
78920,489189,40032,235282,24534,449157,947,423,524
78925,489220,40033,235294,24535,449187,947,423,524
78930,489251,40034,235306,24536,449217,947,423,524
78935,489282,40035,235321,24536,449247,947,423,524
78940,489313,40036,235331,24536,449277,947,423,524
78945,489344,40037,235345,24536,449307,947,423,524
78950,489375,40039,235361,24538,449336,947,423,524
78955,489406,40041,235373,24539,449365,947,423,524
78960,489437,40044,235388,24540,449393,947,423,524
78965,489468,40048,235406,24544,449420,947,423,524
78970,489499,40052,235422,24545,449446,947,423,524
78975,489530,40057,235436,24548,449473,947,423,524
78980,489561,40059,235454,24550,449501,947,423,524
78985,489592,40062,235465,24553,449529,947,423,524
78990,489623,40065,235479,24555,449557,947,423,524
78995,489654,40068,235493,24556,449586,947,423,524
79000,489685,40070,235508,24556,449615,947,423,524
79005,489716,40072,235518,24557,449644,947,423,524
79010,489747,40074,235531,24558,449672,947,423,524
79015,489778,40077,235548,24559,449701,947,423,524
79020,489809,40079,235564,24559,449729,947,423,524
79025,489840,40082,235575,24561,449758,947,423,524
79030,489871,40083,235594,24562,449788,947,423,524
79035,489902,40084,235607,24563,449818,947,423,524
79040,489933,40085,235622,24563,449848,947,423,524
79045,489964,40086,235638,24564,449878,947,423,524
79050,489995,40087,235651,24564,449908,947,423,524
79055,490026,40089,235662,24565,449937,947,423,524
79060,490057,40090,235679,24566,449967,947,423,524
79065,490088,40092,235695,24568,449996,947,423,524
79070,490119,40094,235711,24569,450025,947,423,524
79075,490150,40097,235723,24571,450053,947,423,524
79080,490181,40099,235741,24572,450082,947,423,524
79085,490212,40102,235754,24573,450110,947,423,524
79090,490243,40105,235767,24573,450137,947,423,524
79095,490274,40109,235779,24577,450164,947,423,524
79100,490305,40114,235798,24581,450190,947,423,524
79105,490336,40118,235810,24583,450217,947,423,524
79110,490367,40122,235823,24587,450244,947,423,524
79115,490398,40127,235840,24591,450271,947,423,524
79120,490429,40130,235850,24591,450299,947,423,524
79125,490460,40134,235866,24593,450326,947,423,524
79130,490491,40139,235889,24596,450351,947,423,524
79135,490522,40145,235901,24599,450377,947,423,524
79140,490553,40149,235916,24601,450404,947,423,524
79145,490584,40152,235928,24602,450432,947,423,524
79150,490615,40155,235950,24605,450460,947,423,524
79155,490646,40159,235964,24609,450487,947,423,524
79160,490677,40163,235977,24612,450514,947,423,524
79165,490708,40167,235994,24615,450541,947,423,524
79170,490739,40170,236010,24616,450569,947,423,524
79175,490770,40173,236023,24617,450597,947,423,524
79180,490801,40177,236036,24619,450624,947,423,524
79185,490832,40180,236053,24619,450652,947,423,524
79190,490863,40184,236074,24623,450679,947,423,524
79195,490894,40188,236090,24626,450706,947,423,524
79200,490925,40192,236106,24630,450733,947,423,524
79205,490956,40195,236123,24632,450760,947,423,524
79210,490987,40200,236137,24634,450787,947,423,524
79215,491018,40203,236149,24635,450814,947,423,524
79220,491049,40207,236164,24638,450842,947,423,524
79225,491080,40210,236181,24641,450870,947,423,524
79230,491111,40213,236195,24642,450898,947,423,524
79235,491142,40215,236208,24643,450927,947,423,524
79240,491173,40217,236229,24644,450956,947,423,524
79245,491204,40220,236240,24647,450984,947,423,524
79250,491235,40224,236258,24648,451010,947,423,524
79255,491266,40229,236278,24652,451037,947,423,524
79260,491297,40232,236292,24654,451064,947,423,524
79265,491328,40237,236306,24657,451091,947,423,524
79270,491359,40240,236318,24659,451119,947,423,524
79275,491390,40243,236338,24661,451147,947,423,524
79280,491421,40246,236356,24662,451175,947,423,524
79285,491452,40249,236375,24665,451203,947,423,524
79290,491483,40252,236391,24667,451230,947,423,524
79295,491514,40256,236405,24670,451258,947,423,524
79300,491545,40259,236422,24672,451285,947,423,524
79305,491576,40264,236437,24676,451311,947,423,524
79310,491607,40268,236451,24680,451339,947,423,524
79315,491638,40271,236466,24682,451367,947,423,524
79320,491669,40274,236479,24683,451395,947,423,524
79325,491700,40277,236494,24685,451422,947,423,524
79330,491731,40281,236510,24688,451449,947,423,524
79335,491762,40285,236529,24691,451476,947,423,524
79340,491793,40289,236548,24694,451504,947,423,524
79345,491824,40292,236555,24695,451531,947,423,524
79350,491855,40296,236571,24698,451558,947,423,524
79355,491886,40299,236583,24699,451586,947,423,524
79360,491917,40302,236604,24702,451615,947,423,524
79365,491948,40303,236620,24703,451645,947,423,524
79370,491979,40305,236635,24704,451674,947,423,524
79375,492010,40307,236653,24704,451703,947,423,524
79380,492041,40311,236677,24708,451730,947,423,524
79385,492072,40313,236694,24710,451759,947,423,524
79390,492103,40316,236711,24713,451787,947,423,524
79395,492134,40318,236725,24714,451816,947,423,524
79400,492165,40320,236742,24716,451845,947,423,524
79405,492196,40323,236755,24718,451873,947,423,524
79410,492227,40325,236769,24719,451902,947,423,524
79415,492258,40326,236786,24720,451932,947,423,524
79420,492289,40328,236802,24721,451961,947,423,524
79425,492320,40330,236817,24723,451990,947,423,524
79430,492351,40331,236830,24723,452020,947,423,524
79435,492382,40333,236845,24724,452049,947,423,524
79440,492413,40334,236863,24725,452079,947,423,524
79445,492444,40336,236880,24726,452108,947,423,524
79450,492475,40337,236891,24726,452138,947,423,524
79455,492506,40338,236904,24726,452168,947,423,524
79460,492537,40340,236918,24727,452197,947,423,524
79465,492568,40342,236933,24728,452226,947,423,524
79470,492599,40344,236945,24728,452255,947,423,524
79475,492630,40346,236959,24729,452284,947,423,524
79480,492661,40348,236974,24730,452312,947,423,524
79485,492692,40351,236990,24732,452341,947,423,524
79490,492723,40354,237002,24734,452369,947,423,524
79495,492754,40358,237020,24737,452395,947,423,524
79500,492785,40362,237033,24740,452423,947,423,524
79505,492816,40365,237048,24742,452451,947,423,524
79510,492847,40369,237064,24745,452478,947,423,524
79515,492878,40372,237077,24746,452506,947,423,524
79520,492909,40375,237087,24747,452534,947,423,524
79525,492940,40378,237101,24749,452562,947,423,524
79530,492971,40381,237119,24752,452589,947,423,524
79535,493002,40385,237136,24755,452616,947,423,524
79540,493033,40389,237156,24759,452643,947,423,524
79545,493064,40393,237162,24761,452671,947,423,524
79550,493095,40396,237179,24763,452698,947,423,524
79555,493126,40400,237192,24765,452726,947,423,524
79560,493157,40403,237208,24766,452753,947,423,524
79565,493188,40406,237218,24768,452782,947,423,524
79570,493219,40408,237234,24769,452811,947,423,524
79575,493250,40410,237251,24769,452840,947,423,524
79580,493281,40412,237267,24770,452869,947,423,524
79585,493312,40414,237285,24771,452898,947,423,524
79590,493343,40416,237301,24772,452927,947,423,524
79595,493374,40418,237314,24773,452956,947,423,524
79600,493405,40420,237328,24774,452985,947,423,524
79605,493436,40422,237344,24775,453014,947,423,524
79610,493467,40424,237360,24776,453043,947,423,524
79615,493498,40427,237373,24778,453071,947,423,524
79620,493529,40431,237390,24780,453098,947,423,524
79625,493560,40435,237402,24781,453125,947,423,524
79630,493591,40439,237416,24784,453152,947,423,524
79635,493622,40443,237423,24785,453179,947,423,524
79640,493653,40447,237434,24788,453206,947,423,524
79645,493684,40451,237450,24789,453233,947,423,524
79650,493715,40455,237463,24790,453260,947,423,524
79655,493746,40459,237480,24793,453287,947,423,524
79660,493777,40463,237492,24794,453314,947,423,524
79665,493808,40467,237508,24795,453341,947,423,524
79670,493839,40471,237526,24797,453368,947,423,524
79675,493870,40475,237544,24800,453395,947,423,524
79680,493901,40479,237554,24800,453422,947,423,524
79685,493932,40481,237570,24802,453451,947,423,524
79690,493963,40483,237585,24803,453480,947,423,524
79695,493994,40485,237597,24804,453509,947,423,524
79700,494025,40487,237612,24805,453538,947,423,524
79705,494056,40489,237629,24806,453566,947,423,524
79710,494087,40492,237646,24809,453595,947,423,524
79715,494118,40494,237660,24811,453623,947,423,524
79720,494149,40497,237678,24813,453651,947,423,524
79725,494180,40501,237692,24816,453678,947,423,524
79730,494211,40503,237703,24817,453708,947,423,524
79735,494242,40504,237717,24817,453738,947,423,524
79740,494273,40505,237736,24818,453767,947,423,524
79745,494304,40507,237750,24819,453796,947,423,524
79750,494335,40509,237760,24820,453826,947,423,524
79755,494366,40510,237776,24820,453856,947,423,524
79760,494397,40511,237790,24821,453885,947,423,524
79765,494428,40513,237805,24822,453915,947,423,524
79770,494459,40514,237819,24823,453945,947,423,524
79775,494490,40515,237837,24823,453975,947,423,524
79780,494521,40516,237849,24823,454004,947,423,524
79785,494552,40519,237864,24825,454033,947,423,524
79790,494583,40522,237878,24825,454060,947,423,524
79795,494614,40526,237890,24827,454088,947,423,524
79800,494645,40529,237909,24829,454116,947,423,524
79805,494676,40531,237930,24829,454145,947,423,524
79810,494707,40533,237942,24829,454174,947,423,524
79815,494738,40535,237955,24829,454203,947,423,524
79820,494769,40537,237970,24829,454232,947,423,524
79825,494800,40539,237985,24829,454261,947,423,524
79830,494831,40541,238000,24829,454290,947,423,524
79835,494862,40545,238014,24832,454317,947,423,524
79840,494893,40548,238031,24833,454345,947,423,524
79845,494924,40551,238047,24835,454373,947,423,524
79850,494955,40554,238063,24836,454401,947,423,524
79855,494986,40557,238076,24839,454429,947,423,524
79860,495017,40560,238090,24841,454457,947,423,524
79865,495048,40563,238103,24842,454485,947,423,524
79870,495079,40566,238116,24842,454513,947,423,524
79875,495110,40569,238130,24843,454541,947,423,524
79880,495141,40572,238145,24845,454569,947,423,524
79885,495172,40575,238161,24846,454597,947,423,524
79890,495203,40578,238175,24848,454625,947,423,524
79895,495234,40581,238188,24848,454653,947,423,524
79900,495265,40584,238206,24850,454681,947,423,524
79905,495296,40588,238221,24850,454708,947,423,524
79910,495327,40592,238237,24851,454735,947,423,524
79915,495358,40596,238251,24853,454761,947,423,524
79920,495389,40601,238269,24855,454788,947,423,524
79925,495420,40605,238287,24857,454814,947,423,524
79930,495451,40610,238303,24859,454841,947,423,524
79935,495482,40614,238322,24861,454867,947,423,524
79940,495513,40619,238336,24864,454894,947,423,524
79945,495544,40623,238351,24865,454920,947,423,524
79950,495575,40628,238366,24866,454946,947,423,524
79955,495606,40633,238378,24870,454973,947,423,524
79960,495637,40637,238392,24872,455000,947,423,524
79965,495668,40641,238406,24874,455026,947,423,524
79970,495699,40646,238418,24877,455053,947,423,524
79975,495730,40651,238436,24881,455078,947,423,524
79980,495761,40656,238451,24885,455104,947,423,524
79985,495792,40660,238466,24888,455132,947,423,524
79990,495823,40662,238476,24888,455161,947,423,524
79995,495854,40664,238493,24889,455190,947,423,524
80000,495885,40667,238510,24892,455218,947,423,524
80005,495916,40670,238524,24893,455246,947,423,524
80010,495947,40673,238539,24896,455274,947,423,524
80015,495978,40675,238553,24897,455303,947,423,524
80020,496009,40678,238568,24899,455331,947,423,524
80025,496040,40681,238585,24900,455359,947,423,524
80030,496071,40682,238603,24900,455389,947,423,524
80035,496102,40683,238618,24900,455419,947,423,524
80040,496133,40684,238633,24901,455449,947,423,524
80045,496164,40685,238647,24901,455479,947,423,524
80050,496195,40686,238663,24902,455509,947,423,524
80055,496226,40687,238680,24903,455539,947,423,524
80060,496257,40688,238692,24904,455569,947,423,524
80065,496288,40689,238704,24904,455599,947,423,524
80070,496319,40691,238716,24905,455628,947,423,524
80075,496350,40692,238730,24905,455658,947,423,524
80080,496381,40693,238739,24905,455688,947,423,524
80085,496412,40695,238750,24905,455717,947,423,524
80090,496443,40698,238766,24906,455745,947,423,524
80095,496474,40701,238781,24908,455773,947,423,524
80100,496505,40704,238790,24909,455801,947,423,524
80105,496536,40708,238811,24913,455827,947,423,524
80110,496567,40712,238826,24917,455855,947,423,524
80115,496598,40715,238840,24919,455883,947,423,524
80120,496629,40719,238857,24922,455909,947,423,524
80125,496660,40724,238873,24924,455935,947,423,524
80130,496691,40728,238890,24927,455962,947,423,524
80135,496722,40734,238906,24931,455987,947,423,524
80140,496753,40740,238920,24934,456013,947,423,524
80145,496784,40745,238930,24936,456038,947,423,524
80150,496815,40751,238946,24939,456064,947,423,524
80155,496846,40755,238951,24939,456091,947,423,524
80160,496877,40759,238969,24942,456118,947,423,524
80165,496908,40763,238988,24944,456145,947,423,524
80170,496939,40767,239004,24946,456172,947,423,524
80175,496970,40770,239021,24948,456200,947,423,524
80180,497001,40774,239039,24951,456227,947,423,524
80185,497032,40777,239055,24952,456255,947,423,524
80190,497063,40781,239072,24956,456282,947,423,524
80195,497094,40784,239093,24958,456310,947,423,524
80200,497125,40787,239107,24960,456338,947,423,524
80205,497156,40790,239118,24962,456366,947,423,524
80210,497187,40793,239130,24962,456394,947,423,524
80215,497218,40796,239144,24962,456422,947,423,524
80220,497249,40799,239160,24963,456450,947,423,524
80225,497280,40801,239172,24965,456479,947,423,524
80230,497311,40803,239186,24967,456508,947,423,524
80235,497342,40805,239199,24968,456537,947,423,524
80240,497373,40807,239209,24968,456566,947,423,524
80245,497404,40809,239225,24969,456595,947,423,524
80250,497435,40811,239243,24971,456624,947,423,524
80255,497466,40813,239257,24972,456652,947,423,524
80260,497497,40816,239269,24974,456681,947,423,524
80265,497528,40818,239286,24974,456709,947,423,524
80270,497559,40822,239295,24976,456737,947,423,524
80275,497590,40824,239311,24976,456766,947,423,524
80280,497621,40826,239328,24977,456795,947,423,524
80285,497652,40829,239346,24978,456823,947,423,524
80290,497683,40831,239359,24979,456852,947,423,524
80295,497714,40833,239374,24981,456881,947,423,524
80300,497745,40836,239390,24983,456909,947,423,524
80305,497776,40838,239406,24985,456938,947,423,524
80310,497807,40841,239424,24987,456966,947,423,524
80315,497838,40843,239434,24987,456995,947,423,524
80320,497869,40846,239449,24988,457023,947,423,524
80325,497900,40849,239467,24989,457051,947,423,524
80330,497931,40853,239482,24993,457078,947,423,524
80335,497962,40856,239502,24995,457106,947,423,524
80340,497993,40858,239517,24997,457135,947,423,524
80345,498024,40860,239528,24997,457164,947,423,524
80350,498055,40862,239544,24998,457193,947,423,524
80355,498086,40864,239557,25000,457222,947,423,524
80360,498117,40866,239572,25001,457251,947,423,524
80365,498148,40868,239593,25001,457280,947,423,524
80370,498179,40870,239611,25001,457309,947,423,524
80375,498210,40872,239627,25002,457338,947,423,524
80380,498241,40875,239646,25003,457366,947,423,524
80385,498272,40878,239656,25004,457394,947,423,524
80390,498303,40881,239669,25004,457422,947,423,524
80395,498334,40884,239683,25006,457450,947,423,524
80400,498365,40887,239696,25007,457478,947,423,524
80405,498396,40890,239713,25008,457506,947,423,524
80410,498427,40893,239730,25009,457534,947,423,524
80415,498458,40896,239744,25010,457562,947,423,524
80420,498489,40899,239756,25012,457590,947,423,524
80425,498520,40902,239766,25012,457618,947,423,524
80430,498551,40905,239781,25015,457646,947,423,524
80435,498582,40908,239798,25016,457674,947,423,524
80440,498613,40911,239810,25018,457702,947,423,524
80445,498644,40914,239824,25020,457729,947,423,524
80450,498675,40918,239835,25023,457757,947,423,524
80455,498706,40921,239852,25024,457784,947,423,524
80460,498737,40925,239869,25027,457812,947,423,524
80465,498768,40930,239884,25028,457837,947,423,524
80470,498799,40935,239896,25031,457864,947,423,524
80475,498830,40940,239912,25034,457889,947,423,524
80480,498861,40946,239929,25038,457915,947,423,524
80485,498892,40950,239946,25040,457941,947,423,524
80490,498923,40955,239958,25042,457968,947,423,524
80495,498954,40960,239971,25043,457994,947,423,524
80500,498985,40965,239985,25044,458020,947,423,524
80505,499016,40969,240004,25047,458047,947,423,524
80510,499047,40974,240018,25050,458073,947,423,524
80515,499078,40979,240036,25055,458099,947,423,524
80520,499109,40983,240051,25057,458126,947,423,524
80525,499140,40985,240062,25057,458155,947,423,524
80530,499171,40987,240075,25058,458184,947,423,524
80535,499202,40989,240093,25059,458213,947,423,524
80540,499233,40991,240109,25060,458242,947,423,524
80545,499264,40993,240123,25061,458271,947,423,524
80550,499295,40995,240139,25062,458300,947,423,524
80555,499326,40997,240154,25063,458329,947,423,524
80560,499357,40999,240171,25065,458358,947,423,524
80565,499388,41001,240189,25066,458387,947,423,524
80570,499419,41003,240203,25068,458416,947,423,524
80575,499450,41005,240217,25069,458445,947,423,524
80580,499481,41007,240229,25070,458474,947,423,524
80585,499512,41009,240247,25071,458503,947,423,524
80590,499543,41011,240265,25073,458532,947,423,524
80595,499574,41013,240280,25075,458561,947,423,524
80600,499605,41015,240295,25076,458590,947,423,524
80605,499636,41017,240312,25077,458619,947,423,524
80610,499667,41020,240328,25078,458646,947,423,524
80615,499698,41024,240347,25081,458674,947,423,524
80620,499729,41026,240359,25081,458703,947,423,524
80625,499760,41028,240377,25082,458732,947,423,524
80630,499791,41033,240394,25087,458758,947,423,524
80635,499822,41036,240412,25089,458786,947,423,524
80640,499853,41039,240428,25091,458814,947,423,524
80645,499884,41041,240447,25092,458843,947,423,524
80650,499915,41043,240460,25092,458872,947,423,524
80655,499946,41045,240479,25094,458901,947,423,524
80660,499977,41047,240492,25094,458930,947,423,524
80665,500008,41049,240503,25095,458959,947,423,524
80670,500039,41051,240522,25097,458988,947,423,524
80675,500070,41053,240535,25098,459017,947,423,524
80680,500101,41055,240551,25099,459046,947,423,524
80685,500132,41057,240565,25099,459075,947,423,524
80690,500163,41059,240582,25100,459104,947,423,524
80695,500194,41061,240599,25102,459133,947,423,524
80700,500225,41063,240615,25103,459162,947,423,524
80705,500256,41065,240625,25103,459191,947,423,524
80710,500287,41067,240643,25104,459220,947,423,524
80715,500318,41069,240655,25106,459249,947,423,524
80720,500349,41072,240672,25108,459277,947,423,524
80725,500380,41075,240689,25110,459305,947,423,524
80730,500411,41078,240706,25110,459333,947,423,524
80735,500442,41081,240720,25112,459361,947,423,524
80740,500473,41085,240734,25113,459388,947,423,524
80745,500504,41089,240750,25114,459415,947,423,524
80750,500535,41093,240761,25116,459442,947,423,524
80755,500566,41099,240775,25119,459467,947,423,524
80760,500597,41103,240789,25120,459494,947,423,524
80765,500628,41108,240809,25123,459519,947,423,524
80770,500659,41113,240820,25124,459545,947,423,524
80775,500690,41118,240836,25128,459572,947,423,524
80780,500721,41123,240851,25131,459598,947,423,524
80785,500752,41127,240864,25134,459624,947,423,524
80790,500783,41133,240879,25138,459650,947,423,524
80795,500814,41137,240892,25140,459676,947,423,524
80800,500845,41143,240911,25146,459702,947,423,524
80805,500876,41147,240920,25147,459729,947,423,524
80810,500907,41151,240937,25148,459756,947,423,524
80815,500938,41156,240953,25150,459782,947,423,524
80820,500969,41160,240971,25151,459809,947,423,524
80825,501000,41162,240986,25152,459838,947,423,524
80830,501031,41164,240997,25154,459867,947,423,524
80835,501062,41166,241014,25154,459896,947,423,524
80840,501093,41168,241026,25155,459925,947,423,524
80845,501124,41170,241043,25156,459954,947,423,524
80850,501155,41172,241058,25156,459983,947,423,524
80855,501186,41174,241069,25156,460012,947,423,524
80860,501217,41177,241083,25158,460040,947,423,524
80865,501248,41180,241097,25160,460068,947,423,524
80870,501279,41183,241112,25162,460096,947,423,524
80875,501310,41185,241131,25163,460125,947,423,524
80880,501341,41187,241142,25164,460154,947,423,524
80885,501372,41189,241161,25166,460183,947,423,524
80890,501403,41191,241177,25167,460212,947,423,524
80895,501434,41193,241190,25167,460241,947,423,524
80900,501465,41195,241207,25168,460269,947,423,524
80905,501496,41198,241222,25170,460297,947,423,524
80910,501527,41201,241240,25171,460325,947,423,524
80915,501558,41204,241251,25174,460354,947,423,524
80920,501589,41206,241267,25175,460383,947,423,524
80925,501620,41209,241280,25176,460410,947,423,524
80930,501651,41213,241296,25178,460438,947,423,524
80935,501682,41217,241310,25181,460465,947,423,524
80940,501713,41220,241324,25184,460492,947,423,524
80945,501744,41225,241343,25188,460519,947,423,524
80950,501775,41229,241360,25192,460546,947,423,524
80955,501806,41231,241377,25193,460575,947,423,524
80960,501837,41232,241387,25194,460605,947,423,524
80965,501868,41234,241405,25195,460634,947,423,524
80970,501899,41235,241422,25196,460664,947,423,524
80975,501930,41236,241437,25197,460694,947,423,524
80980,501961,41237,241451,25198,460724,947,423,524
80985,501992,41238,241465,25198,460754,947,423,524
80990,502023,41239,241483,25198,460784,947,423,524
80995,502054,41240,241498,25198,460814,947,423,524
81000,502085,41241,241515,25199,460844,947,423,524
81005,502116,41242,241530,25200,460874,947,423,524
81010,502147,41243,241544,25200,460904,947,423,524
81015,502178,41244,241563,25201,460934,947,423,524
81020,502209,41245,241580,25201,460964,947,423,524
81025,502240,41246,241591,25201,460994,947,423,524
81030,502271,41247,241609,25202,461024,947,423,524
81035,502302,41248,241627,25202,461054,947,423,524
81040,502333,41249,241650,25203,461084,947,423,524
81045,502364,41250,241669,25203,461114,947,423,524
81050,502395,41251,241686,25203,461144,947,423,524
81055,502426,41253,241705,25203,461172,947,423,524
81060,502457,41256,241718,25205,461201,947,423,524
81065,502488,41260,241734,25208,461227,947,423,524
81070,502519,41264,241753,25212,461254,947,423,524
81075,502550,41268,241769,25215,461281,947,423,524
81080,502581,41272,241781,25217,461308,947,423,524
81085,502612,41276,241795,25219,461335,947,423,524
81090,502643,41281,241811,25223,461362,947,423,524
81095,502674,41284,241827,25224,461390,947,423,524
81100,502705,41288,241844,25227,461417,947,423,524
81105,502736,41292,241859,25228,461444,947,423,524
81110,502767,41296,241875,25230,461471,947,423,524
81115,502798,41300,241895,25233,461498,947,423,524
81120,502829,41302,241909,25234,461527,947,423,524
81125,502860,41304,241925,25236,461556,947,423,524
81130,502891,41306,241940,25237,461585,947,423,524
81135,502922,41308,241956,25238,461614,947,423,524
81140,502953,41310,241969,25240,461643,947,423,524
81145,502984,41312,241986,25242,461672,947,423,524
81150,503015,41314,242001,25243,461701,947,423,524
81155,503046,41316,242010,25244,461730,947,423,524
81160,503077,41318,242027,25245,461759,947,423,524
81165,503108,41320,242045,25246,461788,947,423,524
81170,503139,41322,242060,25247,461817,947,423,524
81175,503170,41324,242077,25248,461846,947,423,524
81180,503201,41326,242092,25249,461875,947,423,524
81185,503232,41328,242103,25250,461904,947,423,524
81190,503263,41331,242118,25252,461932,947,423,524
81195,503294,41333,242134,25253,461960,947,423,524
81200,503325,41336,242149,25254,461989,947,423,524
81205,503356,41338,242164,25254,462017,947,423,524
81210,503387,41341,242177,25256,462045,947,423,524
81215,503418,41344,242194,25257,462074,947,423,524
81220,503449,41347,242206,25258,462101,947,423,524
81225,503480,41350,242226,25260,462130,947,423,524
81230,503511,41352,242243,25261,462158,947,423,524
81235,503542,41355,242261,25264,462187,947,423,524
81240,503573,41357,242279,25265,462215,947,423,524
81245,503604,41362,242292,25268,462241,947,423,524
81250,503635,41367,242308,25272,462268,947,423,524
81255,503666,41368,242320,25272,462298,947,423,524
81260,503697,41369,242337,25272,462328,947,423,524
81265,503728,41371,242350,25274,462357,947,423,524
81270,503759,41373,242360,25276,462386,947,423,524
81275,503790,41375,242382,25278,462415,947,423,524
81280,503821,41376,242395,25279,462445,947,423,524
81285,503852,41377,242405,25279,462475,947,423,524
81290,503883,41378,242417,25279,462505,947,423,524
81295,503914,41379,242434,25280,462535,947,423,524
81300,503945,41380,242452,25280,462565,947,423,524
81305,503976,41381,242466,25281,462595,947,423,524
81310,504007,41382,242482,25281,462625,947,423,524
81315,504038,41383,242498,25282,462655,947,423,524
81320,504069,41384,242513,25282,462685,947,423,524
81325,504100,41386,242533,25284,462714,947,423,524
81330,504131,41388,242548,25284,462743,947,423,524
81335,504162,41390,242564,25285,462772,947,423,524
81340,504193,41392,242585,25287,462801,947,423,524
81345,504224,41394,242602,25288,462830,947,423,524
81350,504255,41396,242617,25289,462859,947,423,524
81355,504286,41399,242635,25291,462887,947,423,524
81360,504317,41402,242652,25292,462915,947,423,524
81365,504348,41406,242671,25294,462941,947,423,524
81370,504379,41410,242680,25295,462969,947,423,524
81375,504410,41413,242692,25296,462996,947,423,524
81380,504441,41419,242710,25299,463021,947,423,524
81385,504472,41424,242718,25301,463047,947,423,524
81390,504503,41428,242733,25304,463075,947,423,524
81395,504534,41432,242747,25307,463102,947,423,524
81400,504565,41436,242763,25310,463128,947,423,524
81405,504596,41440,242776,25312,463156,947,423,524
81410,504627,41444,242789,25314,463183,947,423,524
81415,504658,41446,242800,25314,463212,947,423,524
81420,504689,41448,242816,25314,463241,947,423,524
81425,504720,41450,242833,25315,463270,947,423,524
81430,504751,41452,242848,25316,463299,947,423,524
81435,504782,41454,242867,25317,463328,947,423,524
81440,504813,41456,242884,25319,463357,947,423,524
81445,504844,41458,242901,25320,463386,947,423,524
81450,504875,41460,242915,25320,463415,947,423,524
81455,504906,41462,242929,25321,463444,947,423,524
81460,504937,41464,242939,25321,463473,947,423,524
81465,504968,41466,242952,25322,463502,947,423,524
81470,504999,41468,242964,25322,463531,947,423,524
81475,505030,41470,242975,25323,463560,947,423,524
81480,505061,41472,242991,25324,463589,947,423,524
81485,505092,41475,243006,25327,463616,947,423,524
81490,505123,41478,243018,25329,463645,947,423,524
81495,505154,41481,243032,25330,463673,947,423,524
81500,505185,41484,243051,25333,463701,947,423,524
81505,505216,41486,243066,25334,463730,947,423,524
81510,505247,41487,243082,25334,463760,947,423,524
81515,505278,41489,243095,25334,463789,947,423,524
81520,505309,41491,243110,25335,463818,947,423,524
81525,505340,41493,243127,25336,463847,947,423,524
81530,505371,41495,243139,25336,463876,947,423,524
81535,505402,41497,243148,25336,463905,947,423,524
81540,505433,41499,243159,25338,463934,947,423,524
81545,505464,41500,243172,25339,463964,947,423,524
81550,505495,41501,243189,25340,463994,947,423,524
81555,505526,41502,243207,25340,464024,947,423,524
81560,505557,41503,243221,25340,464054,947,423,524
81565,505588,41504,243239,25341,464084,947,423,524
81570,505619,41505,243259,25342,464114,947,423,524
81575,505650,41506,243272,25342,464144,947,423,524
81580,505681,41507,243286,25342,464174,947,423,524
81585,505712,41508,243302,25342,464204,947,423,524
81590,505743,41509,243319,25342,464234,947,423,524
81595,505774,41510,243340,25342,464263,947,423,524
81600,505805,41512,243358,25343,464292,947,423,524
81605,505836,41514,243377,25345,464321,947,423,524
81610,505867,41516,243391,25347,464350,947,423,524
81615,505898,41519,243406,25349,464378,947,423,524
81620,505929,41521,243417,25350,464408,947,423,524
81625,505960,41522,243436,25351,464437,947,423,524
81630,505991,41524,243453,25353,464467,947,423,524
81635,506022,41525,243464,25353,464497,947,423,524
81640,506053,41526,243473,25353,464527,947,423,524
81645,506084,41527,243486,25353,464557,947,423,524
81650,506115,41528,243502,25354,464587,947,423,524
81655,506146,41529,243516,25354,464617,947,423,524
81660,506177,41530,243527,25354,464647,947,423,524
81665,506208,41531,243542,25355,464677,947,423,524
81670,506239,41532,243558,25356,464707,947,423,524
81675,506270,41533,243574,25357,464737,947,423,524
81680,506301,41534,243592,25357,464767,947,423,524
81685,506332,41535,243604,25357,464797,947,423,524
81690,506363,41536,243618,25358,464827,947,423,524
81695,506394,41537,243632,25359,464857,947,423,524
81700,506425,41538,243648,25359,464887,947,423,524
81705,506456,41539,243661,25359,464917,947,423,524
81710,506487,41541,243674,25360,464946,947,423,524
81715,506518,41543,243687,25362,464975,947,423,524
81720,506549,41545,243704,25363,465004,947,423,524
81725,506580,41547,243718,25365,465033,947,423,524
81730,506611,41549,243732,25365,465062,947,423,524
81735,506642,41551,243747,25366,465090,947,423,524
81740,506673,41554,243761,25368,465119,947,423,524
81745,506704,41556,243775,25368,465147,947,423,524
81750,506735,41559,243794,25370,465175,947,423,524
81755,506766,41562,243809,25371,465203,947,423,524
81760,506797,41565,243828,25373,465232,947,423,524
81765,506828,41567,243842,25374,465261,947,423,524
81770,506859,41569,243856,25375,465290,947,423,524
81775,506890,41571,243869,25376,465319,947,423,524
81780,506921,41573,243885,25378,465348,947,423,524
81785,506952,41574,243902,25379,465377,947,423,524
81790,506983,41576,243916,25381,465407,947,423,524
81795,507014,41577,243929,25381,465437,947,423,524
81800,507045,41578,243947,25382,465467,947,423,524
81805,507076,41579,243964,25383,465497,947,423,524
81810,507107,41580,243979,25383,465527,947,423,524
81815,507138,41581,243999,25384,465557,947,423,524
81820,507169,41582,244014,25385,465587,947,423,524
81825,507200,41583,244026,25385,465617,947,423,524
81830,507231,41584,244037,25386,465647,947,423,524
81835,507262,41585,244047,25387,465677,947,423,524
81840,507293,41586,244061,25387,465707,947,423,524
81845,507324,41587,244071,25387,465737,947,423,524
81850,507355,41588,244086,25388,465767,947,423,524
81855,507386,41589,244098,25388,465797,947,423,524
81860,507417,41590,244114,25388,465827,947,423,524
81865,507448,41591,244128,25388,465857,947,423,524
81870,507479,41592,244145,25388,465887,947,423,524
81875,507510,41593,244160,25389,465917,947,423,524
81880,507541,41594,244168,25389,465947,947,423,524
81885,507572,41595,244188,25390,465977,947,423,524
81890,507603,41597,244199,25392,466006,947,423,524
81895,507634,41599,244213,25394,466035,947,423,524
81900,507665,41601,244228,25395,466063,947,423,524
81905,507696,41604,244245,25397,466092,947,423,524
81910,507727,41606,244261,25398,466121,947,423,524
81915,507758,41608,244278,25398,466150,947,423,524
81920,507789,41610,244292,25399,466179,947,423,524
81925,507820,41612,244306,25401,466208,947,423,524
81930,507851,41614,244321,25402,466237,947,423,524
81935,507882,41616,244334,25403,466266,947,423,524
81940,507913,41618,244348,25405,466295,947,423,524
81945,507944,41620,244362,25407,466323,947,423,524
81950,507975,41623,244380,25409,466352,947,423,524
81955,508006,41625,244394,25409,466381,947,423,524
81960,508037,41627,244406,25410,466410,947,423,524
81965,508068,41629,244415,25410,466439,947,423,524
81970,508099,41631,244435,25412,466468,947,423,524
81975,508130,41633,244450,25413,466497,947,423,524
81980,508161,41636,244469,25415,466525,947,423,524
81985,508192,41639,244482,25417,466553,947,423,524
81990,508223,41641,244496,25418,466582,947,423,524
81995,508254,41643,244512,25419,466611,947,423,524
82000,508285,41645,244526,25419,466640,947,423,524
82005,508316,41647,244541,25420,466669,947,423,524
82010,508347,41649,244556,25420,466698,947,423,524
82015,508378,41651,244573,25420,466727,947,423,524
82020,508409,41653,244594,25421,466756,947,423,524
82025,508440,41655,244604,25422,466785,947,423,524
82030,508471,41657,244620,25423,466814,947,423,524
82035,508502,41659,244636,25424,466843,947,423,524
82040,508533,41661,244656,25426,466872,947,423,524
82045,508564,41663,244666,25426,466901,947,423,524
82050,508595,41665,244681,25427,466930,947,423,524
82055,508626,41667,244701,25429,466959,947,423,524
82060,508657,41669,244716,25430,466987,947,423,524
82065,508688,41672,244728,25431,467016,947,423,524
82070,508719,41674,244735,25431,467045,947,423,524
82075,508750,41676,244752,25431,467073,947,423,524
82080,508781,41679,244769,25433,467102,947,423,524
82085,508812,41680,244786,25433,467132,947,423,524
82090,508843,41681,244801,25434,467162,947,423,524
82095,508874,41683,244818,25436,467191,947,423,524
82100,508905,41684,244833,25437,467221,947,423,524
82105,508936,41686,244849,25438,467249,947,423,524
82110,508967,41689,244860,25440,467278,947,423,524
82115,508998,41690,244876,25441,467308,947,423,524
82120,509029,41690,244889,25441,467339,947,423,524
82125,509060,41690,244904,25441,467370,947,423,524
82130,509091,41690,244920,25441,467401,947,423,524
82135,509122,41690,244939,25441,467432,947,423,524
82140,509153,41690,244960,25441,467463,947,423,524
82145,509184,41690,244973,25441,467494,947,423,524
82150,509215,41690,244991,25441,467525,947,423,524
82155,509246,41690,245004,25441,467556,947,423,524
82160,509277,41690,245016,25441,467587,947,423,524
82165,509308,41690,245032,25441,467618,947,423,524
82170,509339,41690,245045,25441,467649,947,423,524
82175,509370,41690,245061,25441,467680,947,423,524
82180,509401,41690,245074,25441,467711,947,423,524
82185,509432,41690,245093,25441,467742,947,423,524
82190,509463,41691,245107,25441,467772,947,423,524
82195,509494,41692,245120,25441,467802,947,423,524
82200,509525,41693,245134,25441,467832,947,423,524
82205,509556,41694,245147,25442,467862,947,423,524
82210,509587,41695,245158,25442,467892,947,423,524
82215,509618,41696,245171,25443,467922,947,423,524
82220,509649,41697,245189,25444,467952,947,423,524
82225,509680,41698,245208,25445,467982,947,423,524
82230,509711,41699,245223,25445,468012,947,423,524
82235,509742,41700,245234,25445,468042,947,423,524
82240,509773,41701,245250,25445,468072,947,423,524
82245,509804,41702,245261,25446,468102,947,423,524
82250,509835,41703,245271,25446,468131,947,423,524
82255,509866,41705,245285,25447,468160,947,423,524
82260,509897,41707,245303,25448,468189,947,423,524
82265,509928,41709,245322,25450,468218,947,423,524
82270,509959,41711,245337,25451,468248,947,423,524
82275,509990,41712,245352,25451,468277,947,423,524
82280,510021,41714,245369,25453,468307,947,423,524
82285,510052,41715,245383,25454,468337,947,423,524
82290,510083,41716,245398,25454,468367,947,423,524
82295,510114,41717,245413,25454,468397,947,423,524
82300,510145,41718,245429,25455,468427,947,423,524
82305,510176,41719,245439,25456,468457,947,423,524
82310,510207,41720,245453,25456,468487,947,423,524
82315,510238,41721,245469,25456,468517,947,423,524
82320,510269,41722,245485,25456,468547,947,423,524
82325,510300,41723,245501,25457,468577,947,423,524
82330,510331,41724,245519,25457,468607,947,423,524
82335,510362,41725,245536,25458,468637,947,423,524
82340,510393,41726,245550,25458,468667,947,423,524
82345,510424,41727,245569,25459,468697,947,423,524
82350,510455,41728,245587,25459,468727,947,423,524
82355,510486,41729,245602,25459,468757,947,423,524
82360,510517,41730,245620,25459,468787,947,423,524
82365,510548,41731,245632,25459,468817,947,423,524
82370,510579,41732,245648,25460,468847,947,423,524
82375,510610,41733,245664,25460,468877,947,423,524
82380,510641,41734,245685,25461,468906,947,423,524
82385,510672,41736,245698,25463,468935,947,423,524
82390,510703,41738,245714,25464,468965,947,423,524
82395,510734,41739,245729,25465,468994,947,423,524
82400,510765,41741,245742,25466,469024,947,423,524
82405,510796,41742,245758,25467,469054,947,423,524
82410,510827,41743,245773,25467,469084,947,423,524
82415,510858,41744,245790,25467,469114,947,423,524
82420,510889,41745,245803,25467,469144,947,423,524
82425,510920,41746,245815,25468,469174,947,423,524
82430,510951,41747,245827,25469,469204,947,423,524
82435,510982,41748,245837,25469,469233,947,423,524
82440,511013,41749,245856,25470,469264,947,423,524
82445,511044,41749,245871,25470,469295,947,423,524
82450,511075,41749,245893,25470,469326,947,423,524
82455,511106,41749,245903,25470,469357,947,423,524
82460,511137,41749,245916,25470,469388,947,423,524
82465,511168,41749,245930,25470,469419,947,423,524
82470,511199,41749,245945,25470,469450,947,423,524
82475,511230,41749,245957,25470,469481,947,423,524
82480,511261,41749,245971,25470,469512,947,423,524
82485,511292,41749,245985,25470,469543,947,423,524
82490,511323,41749,245993,25470,469574,947,423,524
82495,511354,41749,246009,25470,469605,947,423,524
82500,511385,41749,246027,25470,469636,947,423,524
82505,511416,41749,246040,25470,469667,947,423,524
82510,511447,41749,246054,25470,469698,947,423,524
82515,511478,41749,246070,25470,469729,947,423,524
82520,511509,41749,246083,25470,469760,947,423,524
82525,511540,41749,246099,25470,469791,947,423,524
82530,511571,41749,246108,25470,469822,947,423,524
82535,511602,41749,246125,25470,469853,947,423,524
82540,511633,41749,246138,25470,469884,947,423,524
82545,511664,41750,246155,25470,469914,947,423,524
82550,511695,41751,246169,25471,469943,947,423,524
82555,511726,41753,246187,25472,469972,947,423,524
82560,511757,41755,246208,25473,470001,947,423,524
82565,511788,41757,246225,25475,470030,947,423,524
82570,511819,41759,246236,25476,470060,947,423,524
82575,511850,41760,246252,25477,470090,947,423,524
82580,511881,41761,246265,25477,470120,947,423,524
82585,511912,41762,246279,25478,470150,947,423,524
82590,511943,41763,246288,25479,470180,947,423,524
82595,511974,41764,246301,25479,470210,947,423,524
82600,512005,41765,246317,25480,470240,947,423,524
82605,512036,41766,246331,25481,470270,947,423,524
82610,512067,41767,246345,25481,470300,947,423,524
82615,512098,41768,246359,25481,470330,947,423,524
82620,512129,41769,246367,25482,470360,947,423,524
82625,512160,41770,246380,25483,470390,947,423,524
82630,512191,41771,246392,25484,470420,947,423,524
82635,512222,41772,246407,25484,470450,947,423,524
82640,512253,41773,246422,25485,470480,947,423,524
82645,512284,41774,246437,25485,470510,947,423,524
82650,512315,41775,246448,25485,470540,947,423,524
82655,512346,41776,246461,25485,470570,947,423,524
82660,512377,41777,246475,25486,470600,947,423,524
82665,512408,41778,246487,25486,470630,947,423,524
82670,512439,41779,246499,25487,470660,947,423,524
82675,512470,41780,246518,25488,470689,947,423,524
82680,512501,41782,246535,25490,470718,947,423,524
82685,512532,41784,246549,25492,470747,947,423,524
82690,512563,41786,246563,25493,470777,947,423,524
82695,512594,41787,246578,25494,470807,947,423,524
82700,512625,41788,246592,25494,470837,947,423,524
82705,512656,41789,246612,25495,470867,947,423,524
82710,512687,41790,246624,25496,470897,947,423,524
82715,512718,41791,246640,25496,470927,947,423,524
82720,512749,41792,246656,25497,470957,947,423,524
82725,512780,41793,246665,25497,470987,947,423,524
82730,512811,41794,246678,25498,471017,947,423,524
82735,512842,41795,246690,25499,471047,947,423,524
82740,512873,41796,246704,25500,471077,947,423,524
82745,512904,41797,246716,25501,471107,947,423,524
82750,512935,41798,246732,25501,471137,947,423,524
82755,512966,41799,246750,25502,471167,947,423,524
82760,512997,41800,246766,25503,471197,947,423,524
82765,513028,41801,246777,25503,471227,947,423,524
82770,513059,41802,246793,25504,471257,947,423,524
82775,513090,41803,246813,25505,471287,947,423,524
82780,513121,41804,246830,25505,471317,947,423,524
82785,513152,41805,246843,25505,471347,947,423,524
82790,513183,41806,246861,25505,471377,947,423,524
82795,513214,41807,246881,25505,471406,947,423,524
82800,513245,41809,246893,25506,471436,947,423,524
82805,513276,41809,246907,25506,471467,947,423,524
82810,513307,41809,246925,25506,471498,947,423,524
82815,513338,41809,246937,25506,471529,947,423,524
82820,513369,41809,246953,25506,471560,947,423,524
82825,513400,41809,246967,25506,471591,947,423,524
82830,513431,41809,246979,25506,471622,947,423,524
82835,513462,41809,246993,25506,471653,947,423,524
82840,513493,41809,247005,25506,471684,947,423,524
82845,513524,41809,247020,25506,471715,947,423,524
82850,513555,41809,247036,25506,471746,947,423,524
82855,513586,41809,247053,25506,471777,947,423,524
82860,513617,41809,247069,25506,471808,947,423,524
82865,513648,41809,247086,25506,471839,947,423,524
82870,513679,41809,247101,25506,471870,947,423,524
82875,513710,41809,247114,25506,471901,947,423,524
82880,513741,41809,247125,25506,471932,947,423,524
82885,513772,41809,247139,25506,471963,947,423,524
82890,513803,41809,247156,25506,471994,947,423,524
82895,513834,41809,247172,25506,472025,947,423,524
82900,513865,41809,247187,25506,472056,947,423,524
82905,513896,41810,247202,25507,472086,947,423,524
82910,513927,41811,247216,25507,472116,947,423,524
82915,513958,41812,247229,25508,472146,947,423,524
82920,513989,41813,247244,25508,472176,947,423,524
82925,514020,41814,247258,25509,472206,947,423,524
82930,514051,41815,247276,25509,472236,947,423,524
82935,514082,41816,247294,25509,472266,947,423,524
82940,514113,41817,247311,25510,472295,947,423,524
82945,514144,41819,247330,25511,472325,947,423,524
82950,514175,41820,247343,25511,472355,947,423,524
82955,514206,41821,247355,25511,472384,947,423,524
82960,514237,41823,247371,25512,472413,947,423,524
82965,514268,41825,247388,25513,472443,947,423,524
82970,514299,41825,247405,25513,472474,947,423,524
82975,514330,41825,247420,25513,472505,947,423,524
82980,514361,41825,247432,25513,472536,947,423,524
82985,514392,41825,247443,25513,472567,947,423,524
82990,514423,41825,247459,25513,472598,947,423,524
82995,514454,41825,247479,25513,472629,947,423,524
83000,514485,41825,247498,25513,472660,947,423,524
83005,514516,41825,247512,25513,472691,947,423,524
83010,514547,41825,247527,25513,472722,947,423,524
83015,514578,41825,247545,25513,472753,947,423,524
83020,514609,41825,247560,25513,472784,947,423,524
83025,514640,41825,247571,25513,472815,947,423,524
83030,514671,41825,247587,25513,472846,947,423,524
83035,514702,41825,247602,25513,472877,947,423,524
83040,514733,41825,247618,25513,472908,947,423,524
83045,514764,41825,247636,25513,472939,947,423,524
83050,514795,41825,247652,25513,472970,947,423,524
83055,514826,41825,247664,25513,473001,947,423,524
83060,514857,41825,247675,25513,473032,947,423,524
83065,514888,41825,247692,25513,473063,947,423,524
83070,514919,41825,247711,25513,473094,947,423,524
83075,514950,41825,247723,25513,473125,947,423,524
83080,514981,41825,247738,25513,473156,947,423,524
83085,515012,41825,247756,25513,473187,947,423,524
83090,515043,41825,247771,25513,473218,947,423,524
83095,515074,41825,247788,25513,473249,947,423,524
83100,515105,41825,247802,25513,473280,947,423,524
83105,515136,41825,247814,25513,473311,947,423,524
83110,515167,41825,247832,25513,473342,947,423,524
83115,515198,41825,247846,25513,473373,947,423,524
83120,515229,41825,247862,25513,473404,947,423,524
83125,515260,41825,247880,25513,473435,947,423,524
83130,515291,41825,247899,25513,473466,947,423,524
83135,515322,41825,247913,25513,473497,947,423,524
83140,515353,41825,247929,25513,473528,947,423,524
83145,515384,41825,247949,25513,473559,947,423,524
83150,515415,41825,247967,25513,473590,947,423,524
83155,515446,41825,247984,25513,473621,947,423,524
83160,515477,41825,248001,25513,473652,947,423,524
83165,515508,41825,248018,25513,473683,947,423,524
83170,515539,41825,248027,25513,473714,947,423,524
83175,515570,41825,248042,25513,473745,947,423,524
83180,515601,41825,248058,25513,473776,947,423,524
83185,515632,41825,248078,25513,473807,947,423,524
83190,515663,41825,248094,25513,473838,947,423,524
83195,515694,41825,248107,25513,473869,947,423,524
83200,515725,41825,248120,25513,473900,947,423,524
83205,515756,41825,248135,25513,473931,947,423,524
83210,515787,41825,248149,25513,473962,947,423,524
83215,515818,41825,248165,25513,473993,947,423,524
83220,515849,41825,248175,25513,474024,947,423,524
83225,515880,41825,248191,25513,474055,947,423,524
83230,515911,41825,248202,25513,474086,947,423,524
83235,515942,41825,248217,25513,474117,947,423,524
83240,515973,41825,248232,25513,474148,947,423,524
83245,516004,41825,248254,25513,474179,947,423,524
83250,516035,41825,248265,25513,474210,947,423,524
83255,516066,41825,248281,25513,474241,947,423,524
83260,516097,41825,248292,25513,474272,947,423,524
83265,516128,41825,248303,25513,474303,947,423,524
