Time,  Packets Generated,  Packets Reached,High Priority Packets Generated, High Priority Packets reached, Packet Dropped, Packet Dropped due to Faulty Node, High Prio Packet Dropped due to Faulty Node, Low Prio Packet Dropped due to Faulty Node 
5,1,1,1,1,0,0,0,0
10,6,3,5,2,3,3,3,0
15,8,3,6,2,4,4,4,0
20,16,7,10,3,8,8,6,2
25,20,10,11,5,10,10,6,4
30,30,16,16,7,14,14,9,5
35,36,16,19,7,18,18,11,7
40,47,22,23,10,24,24,13,11
45,51,25,27,12,26,26,15,11
50,61,31,30,14,30,30,16,14
55,67,31,32,14,34,34,18,16
60,78,37,36,16,40,40,20,20
65,82,40,37,16,41,41,21,20
70,92,47,43,20,45,45,23,22
75,98,47,44,20,49,49,24,25
80,109,54,50,23,52,52,26,26
85,113,59,54,26,53,53,27,26
90,123,66,59,30,57,57,29,28
95,129,66,63,30,61,61,32,29
100,140,73,68,33,64,64,34,30
105,144,78,70,35,65,65,35,30
110,154,85,75,39,69,69,36,33
115,160,85,79,39,73,73,40,33
120,171,92,85,42,76,76,41,35
125,175,97,88,45,77,77,42,35
130,185,104,94,50,79,79,44,35
135,191,105,95,50,82,82,44,38
140,202,114,101,53,85,85,46,39
145,206,119,104,56,86,86,47,39
150,216,125,107,59,89,88,47,41
155,222,125,110,59,93,91,48,43
160,233,131,113,62,100,94,49,45
165,237,135,115,65,101,95,50,45
170,247,140,120,67,105,97,52,45
175,253,140,123,67,110,100,53,47
180,264,147,131,73,114,103,55,48
185,268,151,132,76,116,104,56,48
190,278,157,137,80,119,106,56,50
195,284,158,138,81,122,109,56,53
200,295,163,144,85,128,111,58,53
205,299,165,145,86,133,112,58,54
210,309,171,151,90,136,114,60,54
215,315,171,156,90,140,117,62,55
220,326,178,161,96,144,119,63,56
225,330,182,163,99,147,120,64,56
230,340,187,170,103,151,122,66,56
235,346,187,172,103,157,125,67,58
240,357,192,177,106,162,127,69,58
245,361,195,178,108,165,128,70,58
250,371,200,183,110,169,130,71,59
255,377,200,186,110,175,133,74,59
260,388,203,193,112,182,135,75,60
265,392,204,194,112,188,136,75,61
270,402,207,200,115,194,138,77,61
275,408,207,200,115,200,141,77,64
280,419,210,205,117,206,143,78,65
285,423,211,206,117,212,144,79,65
290,433,214,210,120,218,146,79,67
295,439,214,212,120,223,149,80,69
300,450,217,218,122,230,151,81,70
305,454,218,221,123,236,152,82,70
310,464,221,223,124,242,154,83,71
315,470,221,225,124,248,157,84,73
320,481,224,227,125,256,159,84,75
325,485,225,228,126,260,160,84,76
330,495,228,231,127,266,162,86,76
335,501,228,234,127,271,165,87,78
340,512,231,241,129,278,167,89,78
345,516,232,242,129,284,168,90,78
350,526,235,245,130,289,170,90,80
355,532,235,247,130,295,173,90,83
360,543,239,252,132,301,175,90,85
365,547,242,253,135,305,176,90,86
370,557,247,255,136,308,178,90,88
375,563,248,257,137,314,181,91,90
380,574,253,261,140,319,183,91,92
385,578,257,264,143,320,184,92,92
390,588,263,270,147,324,186,94,92
395,594,263,274,147,328,189,96,93
400,605,271,281,155,333,191,97,94
405,609,272,283,155,336,192,97,95
410,619,275,286,156,342,194,98,96
415,625,275,290,156,349,197,100,97
420,636,278,296,157,356,199,101,98
425,640,279,297,158,361,200,101,99
430,650,282,302,160,366,202,101,101
435,656,282,306,160,373,205,102,103
440,667,284,312,162,382,207,103,104
445,671,285,315,163,385,208,104,104
450,681,288,322,165,391,210,104,106
455,687,288,325,165,399,213,105,108
460,698,291,333,168,404,215,105,110
465,702,291,335,168,410,216,106,110
470,712,293,340,169,418,218,107,111
475,718,293,344,169,425,221,110,111
480,729,295,350,170,432,223,110,113
485,733,296,353,171,437,224,111,113
490,743,297,357,172,445,226,112,114
495,749,297,360,172,452,229,114,115
500,760,299,365,174,460,231,114,117
505,764,299,368,174,465,232,115,117
510,774,302,374,176,471,234,116,118
515,780,302,375,176,477,237,116,121
520,791,305,380,178,484,239,117,122
525,795,306,381,179,489,240,117,123
530,805,308,384,180,496,242,117,125
535,811,308,385,180,503,245,118,127
540,822,311,389,181,510,247,119,128
545,826,311,390,181,515,248,120,128
550,836,314,392,182,521,250,121,129
555,842,314,396,182,526,253,123,130
560,853,319,401,186,534,255,124,131
565,857,319,402,186,538,256,125,131
570,867,322,407,188,544,258,126,132
575,873,322,410,188,550,261,127,134
580,884,326,417,191,557,263,128,135
585,888,327,418,192,561,264,128,136
590,898,331,422,195,566,266,128,138
595,904,331,425,195,573,269,130,139
600,915,334,431,197,580,271,132,139
605,919,335,433,198,584,272,132,140
610,929,338,437,200,590,274,132,142
615,935,338,440,200,596,277,134,143
620,946,342,446,204,602,279,135,144
625,950,345,448,207,604,280,135,145
630,960,351,454,212,607,282,135,147
635,966,352,458,213,612,285,138,147
640,977,357,461,217,619,287,138,149
645,981,358,462,218,622,288,138,150
650,991,363,467,222,627,290,140,150
655,997,363,471,222,632,293,142,151
660,1008,369,478,227,636,295,143,152
665,1012,369,479,227,643,296,143,153
670,1022,370,483,228,651,298,144,154
675,1028,370,486,228,657,301,145,156
680,1039,373,492,230,666,303,146,157
685,1043,373,494,230,670,304,146,158
690,1053,375,497,231,677,306,147,159
695,1059,375,501,231,683,309,148,161
700,1070,377,509,233,693,311,150,161
705,1074,377,511,233,697,312,150,162
710,1084,380,515,235,703,314,150,164
715,1090,380,515,235,710,317,150,167
720,1101,382,520,236,719,319,151,168
725,1105,383,523,237,722,320,152,168
730,1115,384,527,237,730,322,153,169
735,1121,384,533,237,736,325,156,169
740,1132,386,539,238,746,327,158,169
745,1136,387,543,239,749,328,159,169
750,1146,390,548,241,755,330,160,170
755,1152,390,551,241,762,333,161,172
760,1163,392,556,241,771,335,163,172
765,1167,393,560,242,774,336,164,172
770,1177,396,565,244,779,338,164,174
775,1183,396,567,244,787,341,166,175
780,1194,399,571,246,794,343,167,176
785,1198,401,573,248,797,344,168,176
790,1208,404,579,250,802,346,170,176
795,1214,404,581,250,809,349,170,179
800,1225,408,585,253,816,351,170,181
805,1229,409,587,254,820,352,170,182
810,1239,412,593,257,826,354,171,183
815,1245,412,594,257,832,357,171,186
820,1256,414,598,258,841,359,172,187
825,1260,415,600,259,845,360,173,187
830,1270,418,607,261,850,362,175,187
835,1276,418,609,261,857,365,176,189
840,1287,421,615,264,864,367,176,191
845,1291,421,616,264,870,368,176,192
850,1301,425,619,266,875,370,176,194
855,1307,425,622,266,881,373,177,196
860,1318,428,627,269,888,375,177,198
865,1322,429,628,270,893,376,178,198
870,1332,432,631,272,899,378,178,200
875,1338,432,634,272,905,381,180,201
880,1349,435,639,274,913,383,181,202
885,1353,435,640,274,918,384,181,203
890,1363,438,648,277,924,386,182,204
895,1369,438,650,277,931,389,183,206
900,1380,441,656,280,938,391,184,207
905,1384,443,659,282,941,392,185,207
910,1394,445,662,283,948,394,185,209
915,1400,445,665,283,955,397,187,210
920,1411,450,671,287,961,399,188,211
925,1415,451,673,288,964,400,189,211
930,1425,453,678,289,971,402,190,212
935,1431,453,682,289,977,405,192,213
940,1442,459,687,293,983,407,192,215
945,1446,460,689,294,986,408,192,216
950,1456,463,693,296,992,410,193,217
955,1462,463,697,296,998,413,195,218
960,1473,468,701,299,1005,415,196,219
965,1477,468,701,299,1009,416,196,220
970,1487,472,706,302,1014,418,197,221
975,1493,472,710,302,1019,421,199,222
980,1504,478,717,308,1026,423,199,224
985,1508,480,720,310,1028,424,200,224
990,1518,485,726,314,1032,426,202,224
995,1524,485,727,314,1038,429,202,227
1000,1535,490,732,318,1044,431,203,228
1005,1539,492,735,320,1047,432,204,228
1010,1549,493,740,320,1054,434,204,230
1015,1555,493,743,320,1060,437,206,231
1020,1566,496,747,321,1069,439,207,232
1025,1570,497,750,322,1073,440,208,232
1030,1580,498,752,322,1081,442,209,233
1035,1586,498,754,322,1088,445,210,235
1040,1597,500,760,323,1095,447,211,236
1045,1601,501,763,324,1099,448,211,237
1050,1611,502,766,324,1107,450,212,238
1055,1617,502,769,324,1114,453,213,240
1060,1628,504,774,325,1124,455,214,241
1065,1632,505,777,326,1127,456,215,241
1070,1642,506,781,327,1134,458,216,242
1075,1648,506,785,327,1142,461,219,242
1080,1659,509,792,328,1148,463,221,242
1085,1663,510,794,329,1152,464,221,243
1090,1673,511,799,330,1160,466,222,244
1095,1679,511,803,330,1167,469,224,245
1100,1690,514,809,332,1174,471,224,247
1105,1694,514,809,332,1180,472,224,248
1110,1704,516,813,333,1186,474,224,250
1115,1710,516,816,333,1193,477,225,252
1120,1721,520,822,336,1200,479,225,254
1125,1725,520,824,336,1205,480,226,254
1130,1735,522,829,337,1212,482,228,254
1135,1741,522,832,337,1217,485,229,256
1140,1752,526,838,339,1224,487,231,256
1145,1756,527,839,340,1229,488,231,257
1150,1766,530,843,341,1235,490,232,258
1155,1772,530,844,341,1242,493,233,260
1160,1783,532,846,341,1251,495,233,262
1165,1787,532,847,341,1255,496,233,263
1170,1797,536,853,343,1260,498,234,264
1175,1803,536,856,343,1266,501,235,266
1180,1814,540,860,346,1274,503,236,267
1185,1818,541,864,347,1277,504,237,267
1190,1828,545,870,349,1282,506,238,268
1195,1834,545,874,349,1288,509,240,269
1200,1845,548,876,351,1296,511,240,271
1205,1849,550,879,353,1299,512,241,271
1210,1859,552,886,355,1306,514,243,271
1215,1865,552,888,355,1313,517,243,274
1220,1876,556,895,359,1320,519,244,275
1225,1880,556,895,359,1324,520,244,276
1230,1890,560,900,361,1329,522,246,276
1235,1896,560,902,361,1335,525,246,279
1240,1907,566,911,366,1340,527,248,279
1245,1911,568,914,368,1343,528,249,279
1250,1921,572,920,371,1347,530,250,280
1255,1927,573,925,372,1351,533,253,280
1260,1938,579,929,377,1357,535,253,282
1265,1942,582,932,380,1359,536,254,282
1270,1952,586,937,384,1365,538,255,283
1275,1958,587,940,385,1370,541,256,285
1280,1969,589,946,386,1378,543,257,286
1285,1973,589,947,386,1384,544,257,287
1290,1983,591,951,387,1392,546,258,288
1295,1989,591,953,387,1397,549,259,290
1300,2000,593,956,387,1406,551,259,292
1305,2004,593,958,387,1410,552,259,293
1310,2014,594,960,387,1419,554,259,295
1315,2020,594,963,387,1426,557,261,296
1320,2031,597,972,390,1432,559,263,296
1325,2035,597,972,390,1438,560,263,297
1330,2045,600,980,393,1444,562,265,297
1335,2051,600,983,393,1451,565,267,298
1340,2062,602,989,394,1457,567,267,300
1345,2066,602,991,394,1464,568,268,300
1350,2076,604,994,395,1472,570,268,302
1355,2082,604,998,395,1477,573,269,304
1360,2093,606,1006,397,1487,575,271,304
1365,2097,607,1009,398,1490,576,272,304
1370,2107,609,1014,399,1498,578,273,305
1375,2113,609,1016,399,1503,581,274,307
1380,2124,613,1022,401,1510,583,276,307
1385,2128,614,1024,402,1514,584,276,308
1390,2138,616,1027,402,1521,586,277,309
1395,2144,616,1030,402,1526,589,278,311
1400,2155,620,1034,405,1534,591,278,313
1405,2159,621,1037,406,1538,592,279,313
1410,2169,624,1043,408,1544,594,280,314
1415,2175,624,1047,408,1551,597,282,315
1420,2186,626,1051,410,1560,599,282,317
1425,2190,626,1052,410,1564,600,282,318
1430,2200,631,1060,414,1568,602,283,319
1435,2206,631,1064,414,1574,605,285,320
1440,2217,635,1069,417,1582,607,286,321
1445,2221,637,1072,419,1584,608,286,322
1450,2231,641,1077,422,1589,610,287,323
1455,2237,641,1077,422,1596,613,287,326
1460,2248,646,1086,426,1601,615,289,326
1465,2252,649,1090,429,1603,616,290,326
1470,2262,652,1093,432,1610,618,290,328
1475,2268,652,1096,432,1616,621,292,329
1480,2279,655,1100,434,1624,623,294,329
1485,2283,656,1103,435,1627,624,295,329
1490,2293,659,1107,437,1633,626,296,330
1495,2299,659,1110,437,1639,629,298,331
1500,2310,663,1114,440,1647,631,299,332
1505,2314,664,1115,441,1650,632,299,333
1510,2324,667,1118,442,1657,634,301,333
1515,2330,667,1121,442,1662,637,303,334
1520,2341,672,1128,446,1666,639,304,335
1525,2345,677,1131,451,1668,640,305,335
1530,2355,680,1134,453,1675,642,306,336
1535,2361,680,1137,453,1678,645,306,339
1540,2372,686,1143,459,1684,647,307,340
1545,2376,690,1146,463,1685,648,307,341
1550,2386,692,1153,465,1692,650,307,343
1555,2392,692,1154,465,1699,653,307,346
1560,2403,695,1161,468,1706,655,307,348
1565,2407,696,1163,469,1710,656,307,349
1570,2417,697,1169,469,1718,658,308,350
1575,2423,697,1173,469,1723,661,309,352
1580,2434,700,1179,471,1732,663,310,353
1585,2438,701,1180,472,1737,664,310,354
1590,2448,703,1181,473,1745,666,310,356
1595,2454,703,1184,473,1750,669,311,358
1600,2465,704,1188,473,1761,671,312,359
1605,2469,704,1190,473,1765,672,313,359
1610,2479,705,1192,473,1773,674,313,361
1615,2485,705,1195,473,1780,677,315,362
1620,2496,706,1200,473,1788,679,315,364
1625,2500,706,1203,473,1794,680,316,364
1630,2510,707,1210,474,1802,682,318,364
1635,2516,707,1213,474,1809,685,319,366
1640,2527,708,1216,475,1819,687,319,368
1645,2531,708,1218,475,1823,688,320,368
1650,2541,709,1221,475,1832,690,320,370
1655,2547,709,1224,475,1837,693,322,371
1660,2558,710,1230,476,1847,695,323,372
1665,2562,710,1233,476,1852,696,324,372
1670,2572,712,1239,477,1860,698,326,372
1675,2578,712,1242,477,1865,701,327,374
1680,2589,715,1248,480,1874,703,329,374
1685,2593,715,1249,480,1878,704,329,375
1690,2603,717,1253,480,1886,706,330,376
1695,2609,717,1256,480,1890,709,331,378
1700,2620,723,1263,484,1896,711,333,378
1705,2624,725,1264,486,1899,712,333,379
1710,2634,729,1271,490,1905,714,335,379
1715,2640,729,1273,490,1910,717,336,381
1720,2651,735,1280,495,1915,719,337,382
1725,2655,737,1282,497,1918,720,338,382
1730,2665,739,1284,498,1925,722,338,384
1735,2671,739,1286,498,1930,725,339,386
1740,2682,744,1290,503,1938,727,340,387
1745,2686,746,1293,505,1940,728,341,387
1750,2696,750,1297,508,1946,730,342,388
1755,2702,750,1299,508,1951,733,343,390
1760,2713,755,1303,513,1958,735,343,392
1765,2717,756,1304,514,1961,736,343,393
1770,2727,761,1310,518,1966,738,344,394
1775,2733,761,1313,518,1971,741,345,396
1780,2744,766,1319,522,1978,743,345,398
1785,2748,767,1322,523,1981,744,346,398
1790,2758,769,1325,525,1988,746,346,400
1795,2764,769,1328,525,1995,749,348,401
1800,2775,772,1334,526,2003,751,350,401
1805,2779,772,1337,526,2007,752,351,401
1810,2789,774,1343,528,2015,754,351,403
1815,2795,774,1347,528,2021,757,353,404
1820,2806,776,1352,530,2030,759,354,405
1825,2810,776,1353,530,2034,760,355,405
1830,2820,779,1358,532,2040,762,355,407
1835,2826,779,1361,532,2047,765,356,409
1840,2837,781,1367,534,2056,767,358,409
1845,2841,782,1369,535,2059,768,358,410
1850,2851,784,1376,537,2066,770,360,410
1855,2857,784,1378,537,2072,773,361,412
1860,2868,786,1382,538,2081,775,362,413
1865,2872,786,1384,538,2085,776,362,414
1870,2882,789,1391,540,2092,778,364,414
1875,2888,789,1393,540,2098,781,365,416
1880,2899,791,1399,541,2107,783,367,416
1885,2903,791,1401,541,2112,784,368,416
1890,2913,795,1404,543,2118,786,369,417
1895,2919,795,1407,543,2123,789,371,418
1900,2930,800,1413,547,2127,791,371,420
1905,2934,804,1415,551,2129,792,371,421
1910,2944,807,1416,552,2136,794,371,423
1915,2950,807,1420,552,2141,797,373,424
1920,2961,810,1424,554,2149,799,374,425
1925,2965,812,1427,556,2152,800,374,426
1930,2975,815,1434,559,2159,802,375,427
1935,2981,815,1437,559,2165,805,376,429
1940,2992,819,1443,561,2171,807,378,429
1945,2996,821,1445,563,2174,808,378,430
1950,3006,825,1450,565,2180,810,379,431
1955,3012,825,1454,565,2186,813,381,432
1960,3023,828,1458,566,2193,815,382,433
1965,3027,829,1458,567,2198,816,382,434
1970,3037,832,1461,568,2205,818,383,435
1975,3043,832,1462,568,2210,821,383,438
1980,3054,835,1466,570,2218,823,384,439
1985,3058,836,1468,571,2222,824,385,439
1990,3068,839,1472,572,2229,826,386,440
1995,3074,839,1475,572,2234,829,388,441
2000,3085,842,1478,573,2242,831,388,443
2005,3089,843,1481,574,2246,832,388,444
2010,3099,846,1487,576,2252,834,390,444
2015,3105,846,1490,576,2258,837,391,446
2020,3116,850,1497,578,2265,839,393,446
2025,3120,852,1499,580,2268,840,393,447
2030,3130,854,1502,580,2275,842,394,448
2035,3136,854,1505,580,2282,845,397,448
2040,3147,857,1510,582,2290,847,398,449
2045,3151,857,1510,582,2294,848,398,450
2050,3161,859,1513,583,2301,850,399,451
2055,3167,859,1517,583,2307,853,401,452
2060,3178,862,1518,584,2316,855,402,453
2065,3182,864,1521,586,2318,856,403,453
2070,3192,867,1527,589,2325,858,404,454
2075,3198,867,1530,589,2331,861,405,456
2080,3209,869,1532,589,2340,863,405,458
2085,3213,871,1535,591,2342,864,406,458
2090,3223,874,1541,592,2348,866,408,458
2095,3229,874,1545,592,2354,869,410,459
2100,3240,878,1551,596,2361,871,411,460
2105,3244,879,1554,597,2365,872,412,460
2110,3254,882,1560,599,2372,874,414,460
2115,3260,882,1564,599,2378,877,417,460
2120,3271,883,1570,599,2387,879,418,461
2125,3275,885,1573,601,2390,880,419,461
2130,3285,888,1577,602,2396,882,420,462
2135,3291,888,1579,602,2402,885,421,464
2140,3302,891,1584,605,2411,887,421,466
2145,3306,892,1588,606,2413,888,422,466
2150,3316,897,1594,610,2418,890,423,467
2155,3322,898,1599,611,2422,893,425,468
2160,3333,899,1605,612,2432,895,426,469
2165,3337,899,1607,612,2438,896,426,470
2170,3347,900,1613,612,2445,898,427,471
2175,3353,900,1615,612,2450,901,427,474
2180,3364,901,1623,613,2462,903,429,474
2185,3368,901,1625,613,2466,904,429,475
2190,3378,902,1634,614,2474,906,430,476
2195,3384,902,1640,614,2479,909,433,476
2200,3395,903,1646,614,2491,911,434,477
2205,3399,903,1649,614,2496,912,435,477
2210,3409,906,1654,616,2503,914,436,478
2215,3415,906,1658,616,2508,917,438,479
2220,3426,908,1663,617,2516,919,438,481
2225,3430,909,1666,618,2521,920,438,482
2230,3440,911,1669,619,2529,922,439,483
2235,3446,911,1671,619,2535,925,440,485
2240,3457,913,1676,620,2544,927,441,486
2245,3461,913,1677,620,2548,928,441,487
2250,3471,914,1679,620,2557,930,442,488
2255,3477,914,1683,620,2563,933,445,488
2260,3488,918,1689,623,2569,935,446,489
2265,3492,919,1689,624,2573,936,446,490
2270,3502,921,1693,625,2581,938,447,491
2275,3508,921,1695,625,2587,941,449,492
2280,3519,923,1701,626,2595,943,451,492
2285,3523,925,1703,628,2598,944,452,492
2290,3533,928,1705,629,2605,946,453,493
2295,3539,928,1708,629,2611,949,454,495
2300,3550,932,1713,632,2617,951,454,497
2305,3554,934,1714,634,2620,952,454,498
2310,3564,936,1716,635,2628,954,454,500
2315,3570,936,1718,635,2634,957,456,501
2320,3581,939,1723,637,2642,959,456,503
2325,3585,940,1726,638,2645,960,457,503
2330,3595,943,1728,639,2652,962,458,504
2335,3601,943,1731,639,2656,965,459,506
2340,3612,948,1737,643,2662,967,461,506
2345,3616,950,1738,645,2666,968,462,506
2350,3626,953,1743,646,2671,970,464,506
2355,3632,954,1745,647,2676,973,465,508
2360,3643,959,1751,652,2683,975,467,508
2365,3647,961,1753,654,2686,976,468,508
2370,3657,964,1758,656,2691,978,469,509
2375,3663,965,1761,657,2696,981,471,510
2380,3674,970,1767,661,2703,983,473,510
2385,3678,971,1771,662,2706,984,474,510
2390,3688,973,1775,664,2715,986,474,512
2395,3694,973,1776,664,2721,989,475,514
2400,3705,976,1781,667,2729,991,475,516
2405,3709,977,1782,668,2732,992,475,517
2410,3719,979,1788,670,2739,994,476,518
2415,3725,979,1792,670,2745,997,478,519
2420,3736,982,1797,671,2753,999,479,520
2425,3740,983,1799,672,2757,1000,480,520
2430,3750,984,1801,672,2765,1002,480,522
2435,3756,984,1805,672,2772,1005,482,523
2440,3767,986,1809,672,2780,1007,483,524
2445,3771,986,1811,672,2785,1008,484,524
2450,3781,988,1816,674,2793,1010,486,524
2455,3787,988,1817,674,2799,1013,487,526
2460,3798,991,1823,677,2806,1015,487,528
2465,3802,991,1825,677,2810,1016,487,529
2470,3812,994,1832,679,2817,1018,488,530
2475,3818,994,1835,679,2824,1021,490,531
2480,3829,997,1842,680,2829,1023,491,532
2485,3833,1000,1844,683,2832,1024,492,532
2490,3843,1004,1851,687,2838,1026,493,533
2495,3849,1004,1855,687,2843,1029,494,535
2500,3860,1008,1862,690,2851,1031,496,535
2505,3864,1009,1864,691,2855,1032,497,535
2510,3874,1013,1870,695,2860,1034,498,536
2515,3880,1013,1874,695,2866,1037,501,536
2520,3891,1018,1880,700,2872,1039,502,537
2525,3895,1021,1883,703,2874,1040,503,537
2530,3905,1023,1885,704,2882,1042,503,539
2535,3911,1023,1889,704,2888,1045,505,540
2540,3922,1025,1894,705,2897,1047,507,540
2545,3926,1025,1894,705,2901,1048,507,541
2550,3936,1028,1896,707,2908,1050,507,543
2555,3942,1028,1899,707,2914,1053,510,543
2560,3953,1032,1906,709,2920,1055,512,543
2565,3957,1035,1909,712,2922,1056,512,544
2570,3967,1038,1914,714,2929,1058,512,546
2575,3973,1038,1916,714,2935,1061,513,548
2580,3984,1042,1921,717,2942,1063,514,549
2585,3988,1043,1924,718,2945,1064,515,549
2590,3998,1045,1928,720,2952,1066,515,551
2595,4004,1045,1933,720,2957,1069,517,552
2600,4015,1050,1938,725,2964,1071,518,553
2605,4019,1052,1941,727,2967,1072,519,553
2610,4029,1055,1948,730,2973,1074,520,554
2615,4035,1055,1950,730,2980,1077,521,556
2620,4046,1058,1956,733,2988,1079,522,557
2625,4050,1059,1959,734,2991,1080,523,557
2630,4060,1060,1962,735,3000,1082,524,558
2635,4066,1060,1964,735,3005,1085,525,560
2640,4077,1063,1971,738,3012,1087,526,561
2645,4081,1064,1974,739,3016,1088,526,562
2650,4091,1065,1976,739,3026,1090,526,564
2655,4097,1065,1979,739,3031,1093,527,566
2660,4108,1068,1982,740,3040,1095,527,568
2665,4112,1069,1985,741,3042,1096,527,569
2670,4122,1071,1991,742,3049,1098,528,570
2675,4128,1071,1994,742,3055,1101,529,572
2680,4139,1073,2001,744,3064,1103,530,573
2685,4143,1073,2003,744,3070,1104,531,573
2690,4153,1074,2006,745,3079,1106,532,574
2695,4159,1074,2008,745,3085,1109,533,576
2700,4170,1077,2012,747,3092,1111,534,577
2705,4174,1078,2015,748,3096,1112,535,577
2710,4184,1081,2020,751,3103,1114,536,578
2715,4190,1081,2024,751,3107,1117,538,579
2720,4201,1086,2031,756,3112,1119,539,580
2725,4205,1090,2033,760,3114,1120,539,581
2730,4215,1093,2037,763,3122,1122,539,583
2735,4221,1093,2038,763,3128,1125,540,585
2740,4232,1096,2043,766,3135,1127,541,586
2745,4236,1097,2046,767,3138,1128,541,587
2750,4246,1099,2051,768,3145,1130,541,589
2755,4252,1099,2055,768,3152,1133,543,590
2760,4263,1101,2059,769,3161,1135,544,591
2765,4267,1101,2061,769,3166,1136,545,591
2770,4277,1103,2067,770,3174,1138,547,591
2775,4283,1103,2069,770,3179,1141,548,593
2780,4294,1105,2073,771,3189,1143,549,594
2785,4298,1105,2074,771,3193,1144,549,595
2790,4308,1107,2083,772,3200,1146,551,595
2795,4314,1107,2086,772,3206,1149,552,597
2800,4325,1109,2092,773,3215,1151,554,597
2805,4329,1109,2096,773,3220,1152,555,597
2810,4339,1111,2100,774,3228,1154,556,598
2815,4345,1111,2104,774,3233,1157,559,598
2820,4356,1112,2110,774,3242,1159,560,599
2825,4360,1113,2111,775,3247,1160,560,600
2830,4370,1115,2116,776,3254,1162,560,602
2835,4376,1115,2120,776,3260,1165,562,603
2840,4387,1118,2125,779,3269,1167,564,603
2845,4391,1119,2127,780,3272,1168,564,604
2850,4401,1121,2130,780,3280,1170,566,604
2855,4407,1121,2136,780,3285,1173,569,604
2860,4418,1126,2142,783,3292,1175,570,605
2865,4422,1127,2143,784,3295,1176,570,606
2870,4432,1129,2145,785,3303,1178,570,608
2875,4438,1129,2147,785,3309,1181,571,610
2880,4449,1133,2154,788,3315,1183,572,611
2885,4453,1136,2157,791,3317,1184,573,611
2890,4463,1140,2163,793,3322,1186,574,612
2895,4469,1140,2166,793,3329,1189,576,613
2900,4480,1144,2170,795,3336,1191,577,614
2905,4484,1144,2170,795,3340,1192,577,615
2910,4494,1149,2178,800,3345,1194,579,615
2915,4500,1149,2181,800,3350,1197,581,616
2920,4511,1154,2188,803,3356,1199,583,616
2925,4515,1156,2189,805,3359,1200,583,617
2930,4525,1160,2195,808,3364,1202,585,617
2935,4531,1161,2198,809,3368,1205,586,619
2940,4542,1166,2203,813,3374,1207,587,620
2945,4546,1168,2204,815,3378,1208,587,621
2950,4556,1171,2212,817,3383,1210,589,621
2955,4562,1171,2216,817,3390,1213,592,621
2960,4573,1174,2222,818,3397,1215,594,621
2965,4577,1174,2223,818,3403,1216,594,622
2970,4587,1177,2227,820,3409,1218,594,624
2975,4593,1177,2230,820,3415,1221,596,625
2980,4604,1180,2235,821,3423,1223,597,626
2985,4608,1180,2236,821,3428,1224,597,627
2990,4618,1182,2240,823,3435,1226,597,629
2995,4624,1182,2243,823,3440,1229,599,630
3000,4635,1185,2249,824,3448,1231,600,631
3005,4639,1185,2250,824,3453,1232,600,632
3010,4649,1187,2256,826,3462,1234,601,633
3015,4655,1187,2259,826,3467,1237,602,635
3020,4666,1189,2263,827,3477,1239,603,636
3025,4670,1189,2264,827,3481,1240,604,636
3030,4680,1191,2269,828,3487,1242,606,636
3035,4686,1191,2271,828,3494,1245,607,638
3040,4697,1194,2278,831,3501,1247,607,640
3045,4701,1195,2280,832,3506,1248,608,640
3050,4711,1197,2284,834,3513,1250,609,641
3055,4717,1197,2287,834,3519,1253,610,643
3060,4728,1200,2295,837,3526,1255,612,643
3065,4732,1202,2297,839,3530,1256,612,644
3070,4742,1205,2302,841,3536,1258,613,645
3075,4748,1205,2305,841,3542,1261,614,647
3080,4759,1209,2309,844,3549,1263,615,648
3085,4763,1210,2310,845,3553,1264,616,648
3090,4773,1213,2315,848,3559,1266,616,650
3095,4779,1213,2319,848,3565,1269,617,652
3100,4790,1216,2325,851,3573,1271,618,653
3105,4794,1218,2327,853,3576,1272,618,654
3110,4804,1220,2329,853,3584,1274,618,656
3115,4810,1220,2333,853,3589,1277,619,658
3120,4821,1225,2339,858,3596,1279,619,660
3125,4825,1225,2340,858,3600,1280,619,661
3130,4835,1229,2346,860,3605,1282,621,661
3135,4841,1229,2349,860,3612,1285,622,663
3140,4852,1232,2355,862,3619,1287,624,663
3145,4856,1234,2356,864,3622,1288,624,664
3150,4866,1236,2360,864,3630,1290,626,664
3155,4872,1236,2362,864,3636,1293,627,666
3160,4883,1238,2364,864,3645,1295,627,668
3165,4887,1240,2368,866,3647,1296,628,668
3170,4897,1244,2373,868,3652,1298,630,668
3175,4903,1244,2377,868,3656,1301,632,669
3180,4914,1250,2382,872,3662,1303,634,669
3185,4918,1253,2385,875,3664,1304,635,669
3190,4928,1258,2390,879,3668,1306,635,671
3195,4934,1259,2394,880,3672,1309,637,672
3200,4945,1264,2402,885,3680,1311,638,673
3205,4949,1264,2402,885,3685,1312,638,674
3210,4959,1265,2404,885,3693,1314,639,675
3215,4965,1265,2407,885,3699,1317,640,677
3220,4976,1268,2412,887,3707,1319,641,678
3225,4980,1268,2413,887,3711,1320,641,679
3230,4990,1269,2418,888,3721,1322,643,679
3235,4996,1269,2423,888,3725,1325,645,680
3240,5007,1272,2429,890,3733,1327,645,682
3245,5011,1273,2432,891,3738,1328,646,682
3250,5021,1276,2440,894,3744,1330,647,683
3255,5027,1276,2442,894,3751,1333,648,685
3260,5038,1279,2448,896,3758,1335,650,685
3265,5042,1279,2450,896,3763,1336,650,686
3270,5052,1280,2453,896,3771,1338,651,687
3275,5058,1280,2458,896,3778,1341,654,687
3280,5069,1281,2463,896,3788,1343,655,688
3285,5073,1281,2466,896,3792,1344,656,688
3290,5083,1282,2469,896,3801,1346,656,690
3295,5089,1282,2473,896,3807,1349,658,691
3300,5100,1283,2476,896,3816,1351,658,693
3305,5104,1283,2479,896,3821,1352,659,693
3310,5114,1285,2483,896,3829,1354,659,695
3315,5120,1285,2487,896,3835,1357,662,695
3320,5131,1286,2492,897,3845,1359,663,696
3325,5135,1286,2495,897,3849,1360,664,696
3330,5145,1288,2501,897,3856,1362,665,697
3335,5151,1288,2505,897,3862,1365,667,698
3340,5162,1291,2509,899,3870,1367,668,699
3345,5166,1292,2513,900,3874,1368,669,699
3350,5176,1294,2520,901,3881,1370,670,700
3355,5182,1294,2523,901,3887,1373,672,701
3360,5193,1297,2528,903,3896,1375,673,702
3365,5197,1298,2531,904,3899,1376,673,703
3370,5207,1301,2535,907,3906,1378,674,704
3375,5213,1301,2539,907,3911,1381,676,705
3380,5224,1306,2543,910,3918,1383,677,706
3385,5228,1307,2544,911,3921,1384,677,707
3390,5238,1311,2549,915,3927,1386,677,709
3395,5244,1311,2550,915,3932,1389,677,712
3400,5255,1316,2558,920,3938,1391,677,714
3405,5259,1318,2559,922,3941,1392,677,715
3410,5269,1324,2566,928,3945,1394,678,716
3415,5275,1324,2569,928,3950,1397,680,717
3420,5286,1328,2573,932,3957,1399,680,719
3425,5290,1330,2576,934,3959,1400,681,719
3430,5300,1335,2582,939,3963,1402,681,721
3435,5306,1336,2584,940,3969,1405,682,723
3440,5317,1338,2589,941,3978,1407,684,723
3445,5321,1339,2591,942,3981,1408,684,724
3450,5331,1341,2598,944,3988,1410,685,725
3455,5337,1341,2602,944,3994,1413,687,726
3460,5348,1343,2606,944,4005,1415,688,727
3465,5352,1343,2608,944,4008,1416,689,727
3470,5362,1345,2612,945,4016,1418,691,727
3475,5368,1345,2613,945,4022,1421,692,729
3480,5379,1347,2616,946,4032,1423,693,730
3485,5383,1348,2619,947,4034,1424,693,731
3490,5393,1349,2622,947,4042,1426,693,733
3495,5399,1349,2625,947,4049,1429,694,735
3500,5410,1351,2629,947,4058,1431,694,737
3505,5414,1351,2629,947,4063,1432,694,738
3510,5424,1353,2637,949,4070,1434,696,738
3515,5430,1353,2640,949,4077,1437,698,739
3520,5441,1356,2644,950,4085,1439,698,741
3525,5445,1357,2647,951,4088,1440,699,741
3530,5455,1359,2651,952,4095,1442,700,742
3535,5461,1359,2654,952,4102,1445,702,743
3540,5472,1362,2657,953,4110,1447,703,744
3545,5476,1362,2658,953,4114,1448,703,745
3550,5486,1365,2664,956,4120,1450,705,745
3555,5492,1365,2667,956,4125,1453,706,747
3560,5503,1370,2672,959,4131,1455,706,749
3565,5507,1372,2673,961,4135,1456,706,750
3570,5517,1374,2676,962,4143,1458,707,751
3575,5523,1374,2679,962,4148,1461,708,753
3580,5534,1378,2683,965,4155,1463,709,754
3585,5538,1381,2686,968,4157,1464,710,754
3590,5548,1384,2691,970,4164,1466,711,755
3595,5554,1384,2692,970,4170,1469,712,757
3600,5565,1388,2697,974,4176,1471,712,759
3605,5569,1391,2700,977,4178,1472,712,760
3610,5579,1395,2707,979,4183,1474,714,760
3615,5585,1395,2709,979,4190,1477,716,761
3620,5596,1398,2711,980,4197,1479,716,763
3625,5600,1400,2714,982,4200,1480,717,763
3630,5610,1403,2717,984,4207,1482,718,764
3635,5616,1403,2721,984,4211,1485,720,765
3640,5627,1407,2729,988,4217,1487,722,765
3645,5631,1409,2731,990,4222,1488,723,765
3650,5641,1413,2734,993,4228,1490,723,767
3655,5647,1413,2735,993,4233,1493,723,770
3660,5658,1417,2741,996,4237,1495,723,772
3665,5662,1420,2743,999,4242,1496,724,772
3670,5672,1423,2748,1001,4248,1498,726,772
3675,5678,1423,2751,1001,4254,1501,727,774
3680,5689,1427,2756,1003,4261,1503,729,774
3685,5693,1428,2756,1004,4265,1504,729,775
3690,5703,1430,2760,1005,4272,1506,730,776
3695,5709,1430,2762,1005,4279,1509,730,779
3700,5720,1433,2768,1007,4287,1511,731,780
3705,5724,1433,2768,1007,4291,1512,731,781
3710,5734,1436,2774,1009,4298,1514,732,782
3715,5740,1436,2776,1009,4304,1517,733,784
3720,5751,1439,2781,1011,4312,1519,734,785
3725,5755,1439,2782,1011,4316,1520,735,785
3730,5765,1441,2787,1012,4323,1522,735,787
3735,5771,1441,2791,1012,4330,1525,737,788
3740,5782,1444,2796,1014,4337,1527,738,789
3745,5786,1445,2799,1015,4341,1528,739,789
3750,5796,1446,2803,1015,4349,1530,740,790
3755,5802,1446,2807,1015,4355,1533,741,792
3760,5813,1447,2812,1015,4366,1535,742,793
3765,5817,1447,2814,1015,4370,1536,743,793
3770,5827,1448,2821,1016,4377,1538,744,794
3775,5833,1448,2823,1016,4383,1541,745,796
3780,5844,1449,2829,1017,4395,1543,746,797
3785,5848,1449,2831,1017,4399,1544,747,797
3790,5858,1453,2836,1020,4404,1546,748,798
3795,5864,1453,2839,1020,4410,1549,750,799
3800,5875,1457,2850,1024,4417,1551,752,799
3805,5879,1458,2852,1025,4421,1552,753,799
3810,5889,1462,2857,1029,4426,1554,754,800
3815,5895,1462,2859,1029,4432,1557,755,802
3820,5906,1465,2864,1031,4441,1559,755,804
3825,5910,1466,2868,1032,4444,1560,756,804
3830,5920,1469,2870,1033,4450,1562,757,805
3835,5926,1469,2873,1033,4456,1565,758,807
3840,5937,1472,2879,1035,4465,1567,759,808
3845,5941,1472,2880,1035,4469,1568,759,809
3850,5951,1476,2885,1038,4474,1570,759,811
3855,5957,1476,2888,1038,4480,1573,760,813
3860,5968,1481,2897,1042,4486,1575,762,813
3865,5972,1482,2898,1043,4490,1576,762,814
3870,5982,1486,2903,1047,4495,1578,762,816
3875,5988,1486,2908,1047,4500,1581,765,816
3880,5999,1492,2916,1052,4507,1583,767,816
3885,6003,1492,2917,1052,4511,1584,768,816
3890,6013,1493,2921,1052,4518,1586,769,817
3895,6019,1493,2924,1052,4525,1589,771,818
3900,6030,1495,2928,1053,4534,1591,772,819
3905,6034,1496,2930,1054,4538,1592,772,820
3910,6044,1497,2934,1055,4545,1594,773,821
3915,6050,1497,2936,1055,4553,1597,774,823
3920,6061,1500,2944,1058,4560,1599,776,823
3925,6065,1500,2944,1058,4565,1600,776,824
3930,6075,1503,2950,1060,4570,1602,776,826
3935,6081,1503,2953,1060,4578,1605,778,827
3940,6092,1505,2955,1060,4585,1607,778,829
3945,6096,1505,2957,1060,4591,1608,779,829
3950,6106,1506,2960,1060,4598,1610,779,831
3955,6112,1506,2964,1060,4605,1613,780,833
3960,6123,1508,2968,1061,4614,1615,782,833
3965,6127,1509,2970,1062,4618,1616,783,833
3970,6137,1512,2978,1065,4623,1618,785,833
3975,6143,1512,2983,1065,4630,1621,787,834
3980,6154,1514,2988,1067,4639,1623,787,836
3985,6158,1514,2990,1067,4644,1624,788,836
3990,6168,1518,2996,1070,4649,1626,789,837
3995,6174,1518,2999,1070,4654,1629,790,839
4000,6185,1522,3004,1073,4661,1631,790,841
4005,6189,1523,3004,1074,4666,1632,790,842
4010,6199,1527,3013,1078,4671,1634,792,842
4015,6205,1527,3015,1078,4678,1637,793,844
4020,6216,1530,3021,1080,4684,1639,793,846
4025,6220,1532,3024,1082,4688,1640,794,846
4030,6230,1535,3029,1085,4694,1642,795,847
4035,6236,1535,3029,1085,4701,1645,795,850
4040,6247,1540,3037,1089,4706,1647,795,852
4045,6251,1541,3038,1090,4710,1648,796,852
4050,6261,1544,3040,1091,4716,1650,797,853
4055,6267,1544,3046,1091,4722,1653,800,853
4060,6278,1548,3051,1093,4729,1655,802,853
4065,6282,1551,3053,1096,4731,1656,802,854
4070,6292,1554,3055,1098,4737,1658,802,856
4075,6298,1554,3058,1098,4744,1661,804,857
4080,6309,1557,3066,1101,4751,1663,805,858
4085,6313,1560,3069,1104,4753,1664,805,859
4090,6323,1565,3075,1107,4757,1666,806,860
4095,6329,1565,3080,1107,4763,1669,808,861
4100,6340,1569,3083,1109,4771,1671,808,863
4105,6344,1571,3085,1111,4773,1672,808,864
4110,6354,1576,3091,1115,4777,1674,808,866
4115,6360,1576,3097,1115,4782,1677,811,866
4120,6371,1582,3102,1120,4789,1679,812,867
4125,6375,1583,3104,1121,4792,1680,812,868
4130,6385,1585,3108,1123,4799,1682,814,868
4135,6391,1585,3111,1123,4804,1685,815,870
4140,6402,1590,3117,1128,4811,1687,816,871
4145,6406,1591,3119,1129,4815,1688,817,871
4150,6416,1592,3123,1130,4823,1690,818,872
4155,6422,1592,3126,1130,4829,1693,819,874
4160,6433,1595,3130,1133,4838,1695,820,875
4165,6437,1596,3132,1134,4841,1696,820,876
4170,6447,1598,3137,1136,4847,1698,822,876
4175,6453,1598,3138,1136,4854,1701,822,879
4180,6464,1600,3141,1137,4862,1703,822,881
4185,6468,1600,3143,1137,4867,1704,822,882
4190,6478,1602,3149,1139,4874,1706,822,884
4195,6484,1602,3151,1139,4880,1709,823,886
4200,6495,1605,3155,1140,4890,1711,824,887
4205,6499,1606,3159,1141,4892,1712,825,887
4210,6509,1608,3166,1142,4899,1714,827,887
4215,6515,1608,3169,1142,4905,1717,828,889
4220,6526,1611,3175,1144,4913,1719,828,891
4225,6530,1611,3176,1144,4919,1720,829,891
4230,6540,1612,3179,1145,4926,1722,830,892
4235,6546,1612,3181,1145,4934,1725,831,894
4240,6557,1615,3187,1147,4940,1727,833,894
4245,6561,1615,3189,1147,4946,1728,834,894
4250,6571,1617,3191,1148,4953,1730,834,896
4255,6577,1617,3196,1148,4959,1733,837,896
4260,6588,1621,3202,1151,4964,1735,837,898
4265,6592,1622,3203,1152,4970,1736,838,898
4270,6602,1625,3208,1153,4976,1738,840,898
4275,6608,1625,3209,1153,4983,1741,840,901
4280,6619,1629,3216,1156,4988,1743,842,901
4285,6623,1630,3219,1157,4993,1744,843,901
4290,6633,1633,3220,1158,5000,1746,843,903
4295,6639,1633,3224,1158,5005,1749,845,904
4300,6650,1636,3228,1161,5013,1751,846,905
4305,6654,1636,3230,1161,5018,1752,846,906
4310,6664,1639,3234,1163,5024,1754,847,907
4315,6670,1639,3236,1163,5030,1757,848,909
4320,6681,1641,3239,1163,5039,1759,849,910
4325,6685,1643,3241,1165,5042,1760,849,911
4330,6695,1647,3249,1169,5048,1762,850,912
4335,6701,1647,3252,1169,5054,1765,852,913
4340,6712,1649,3256,1171,5063,1767,852,915
4345,6716,1649,3258,1171,5067,1768,852,916
4350,6726,1651,3261,1172,5074,1770,852,918
4355,6732,1651,3264,1172,5079,1773,853,920
4360,6743,1653,3270,1173,5089,1775,854,921
4365,6747,1654,3271,1174,5093,1776,855,921
4370,6757,1657,3279,1177,5099,1778,856,922
4375,6763,1657,3281,1177,5105,1781,857,924
4380,6774,1659,3285,1178,5114,1783,857,926
4385,6778,1659,3287,1178,5119,1784,858,926
4390,6788,1662,3295,1181,5125,1786,859,927
4395,6794,1662,3299,1181,5131,1789,861,928
4400,6805,1664,3305,1183,5140,1791,863,928
4405,6809,1665,3306,1184,5144,1792,863,929
4410,6819,1667,3312,1185,5151,1794,864,930
4415,6825,1667,3314,1185,5157,1797,865,932
4420,6836,1671,3322,1189,5164,1799,866,933
4425,6840,1672,3324,1190,5168,1800,866,934
4430,6850,1675,3328,1192,5174,1802,867,935
4435,6856,1675,3331,1192,5180,1805,869,936
4440,6867,1680,3338,1196,5186,1807,870,937
4445,6871,1682,3340,1198,5189,1808,870,938
4450,6881,1685,3343,1200,5196,1810,870,940
4455,6887,1685,3345,1200,5201,1813,870,943
4460,6898,1689,3350,1203,5208,1815,871,944
4465,6902,1691,3352,1205,5211,1816,872,944
4470,6912,1695,3356,1208,5217,1818,873,945
4475,6918,1695,3357,1208,5223,1821,874,947
4480,6929,1698,3363,1210,5230,1823,875,948
4485,6933,1700,3367,1212,5233,1824,876,948
4490,6943,1702,3372,1214,5240,1826,876,950
4495,6949,1702,3373,1214,5246,1829,876,953
4500,6960,1704,3378,1215,5256,1831,877,954
4505,6964,1704,3380,1215,5259,1832,877,955
4510,6974,1707,3384,1217,5267,1834,878,956
4515,6980,1707,3388,1217,5272,1837,880,957
4520,6991,1709,3393,1218,5282,1839,882,957
4525,6995,1709,3396,1218,5285,1840,883,957
4530,7005,1712,3401,1220,5293,1842,884,958
4535,7011,1712,3402,1220,5299,1845,885,960
4540,7022,1715,3409,1222,5306,1847,887,960
4545,7026,1715,3411,1222,5310,1848,888,960
4550,7036,1718,3415,1224,5318,1850,889,961
4555,7042,1718,3419,1224,5323,1853,891,962
4560,7053,1721,3422,1225,5330,1855,891,964
4565,7057,1722,3424,1226,5335,1856,891,965
4570,7067,1723,3427,1227,5344,1858,891,967
4575,7073,1723,3429,1227,5350,1861,892,969
4580,7084,1725,3432,1228,5359,1863,893,970
4585,7088,1725,3434,1228,5362,1864,894,970
4590,7098,1731,3439,1232,5366,1866,895,971
4595,7104,1731,3444,1232,5370,1869,898,971
4600,7115,1737,3449,1236,5376,1871,900,971
4605,7119,1739,3451,1238,5379,1872,901,971
4610,7129,1744,3456,1242,5383,1874,901,973
4615,7135,1745,3459,1243,5388,1877,902,975
4620,7146,1748,3464,1246,5397,1879,903,976
4625,7150,1750,3466,1248,5400,1880,904,976
4630,7160,1753,3472,1251,5406,1882,906,976
4635,7166,1753,3477,1251,5411,1885,908,977
4640,7177,1756,3480,1252,5419,1887,909,978
4645,7181,1758,3482,1254,5423,1888,910,978
4650,7191,1761,3488,1257,5430,1890,912,978
4655,7197,1761,3494,1257,5434,1893,915,978
4660,7208,1765,3499,1261,5441,1895,915,980
4665,7212,1766,3500,1262,5446,1896,916,980
4670,7222,1768,3503,1262,5453,1898,916,982
4675,7228,1768,3506,1262,5459,1901,917,984
4680,7239,1771,3511,1265,5466,1903,918,985
4685,7243,1773,3514,1267,5470,1904,919,985
4690,7253,1777,3519,1269,5476,1906,921,985
4695,7259,1777,3522,1269,5482,1909,923,986
4700,7270,1779,3527,1269,5490,1911,924,987
4705,7274,1780,3529,1270,5494,1912,924,988
4710,7284,1783,3536,1272,5500,1914,925,989
4715,7290,1783,3541,1272,5505,1917,928,989
4720,7301,1786,3546,1275,5513,1919,928,991
4725,7305,1787,3546,1276,5518,1920,928,992
4730,7315,1790,3552,1278,5525,1922,930,992
4735,7321,1790,3557,1278,5530,1925,932,993
4740,7332,1793,3561,1280,5538,1927,934,993
4745,7336,1796,3564,1283,5540,1928,935,993
4750,7346,1798,3570,1285,5547,1930,935,995
4755,7352,1798,3576,1285,5553,1933,938,995
4760,7363,1803,3584,1289,5559,1935,939,996
4765,7367,1806,3587,1292,5561,1936,939,997
4770,7377,1807,3593,1293,5570,1938,941,997
4775,7383,1807,3599,1293,5576,1941,944,997
4780,7394,1809,3605,1295,5585,1943,946,997
4785,7398,1810,3607,1296,5588,1944,946,998
4790,7408,1812,3612,1298,5596,1946,947,999
4795,7414,1812,3613,1298,5602,1949,947,1002
4800,7425,1815,3621,1300,5610,1951,949,1002
4805,7429,1816,3623,1301,5613,1952,949,1003
4810,7439,1818,3631,1302,5620,1954,951,1003
4815,7445,1818,3634,1302,5627,1957,953,1004
4820,7456,1821,3640,1304,5635,1959,954,1005
4825,7460,1821,3643,1304,5639,1960,955,1005
4830,7470,1824,3648,1307,5645,1962,956,1006
4835,7476,1824,3653,1307,5649,1965,958,1007
4840,7487,1825,3660,1308,5661,1967,960,1007
4845,7491,1825,3662,1308,5665,1968,960,1008
4850,7501,1826,3665,1308,5675,1970,961,1009
4855,7507,1826,3667,1308,5681,1973,963,1010
4860,7518,1827,3672,1308,5689,1975,964,1011
4865,7522,1827,3675,1308,5694,1976,965,1011
4870,7532,1828,3677,1308,5703,1978,965,1013
4875,7538,1829,3679,1309,5708,1981,966,1015
4880,7549,1831,3681,1310,5717,1983,966,1017
4885,7553,1832,3681,1311,5721,1984,966,1018
4890,7563,1834,3684,1312,5728,1986,967,1019
4895,7569,1834,3688,1312,5733,1989,970,1019
4900,7580,1837,3692,1315,5741,1991,970,1021
4905,7584,1840,3694,1318,5744,1992,971,1021
4910,7594,1843,3697,1320,5751,1994,971,1023
4915,7600,1843,3702,1320,5755,1997,974,1023
4920,7611,1848,3708,1324,5761,1999,975,1024
4925,7615,1850,3710,1326,5765,2000,976,1024
4930,7625,1854,3715,1329,5770,2002,976,1026
4935,7631,1855,3716,1330,5776,2005,977,1028
4940,7642,1859,3723,1333,5782,2007,979,1028
4945,7646,1860,3725,1334,5786,2008,980,1028
4950,7656,1863,3728,1336,5793,2010,980,1030
4955,7662,1863,3731,1336,5799,2013,982,1031
4960,7673,1865,3736,1337,5805,2015,983,1032
4965,7677,1867,3740,1339,5809,2016,984,1032
4970,7687,1870,3746,1341,5816,2018,986,1032
4975,7693,1870,3750,1341,5822,2021,989,1032
4980,7704,1874,3760,1345,5827,2023,991,1032
4985,7708,1875,3763,1346,5833,2024,992,1032
4990,7718,1878,3770,1348,5839,2026,994,1032
4995,7724,1878,3772,1348,5845,2029,995,1034
5000,7735,1882,3778,1351,5853,2031,997,1034
5005,7739,1882,3779,1351,5857,2032,997,1035
5010,7749,1885,3784,1353,5864,2034,998,1036
5015,7755,1885,3786,1353,5870,2037,999,1038
5020,7766,1889,3793,1356,5876,2039,1000,1039
5025,7770,1889,3793,1356,5881,2040,1000,1040
5030,7780,1892,3798,1359,5888,2042,1001,1041
5035,7786,1892,3798,1359,5894,2045,1001,1044
5040,7797,1896,3802,1361,5901,2047,1002,1045
5045,7801,1896,3803,1361,5905,2048,1002,1046
5050,7811,1898,3807,1362,5913,2050,1003,1047
5055,7817,1898,3810,1362,5919,2053,1005,1048
5060,7828,1901,3818,1365,5927,2055,1007,1048
5065,7832,1902,3821,1366,5930,2056,1007,1049
5070,7842,1904,3824,1367,5938,2058,1008,1050
5075,7848,1904,3829,1367,5943,2061,1010,1051
5080,7859,1906,3837,1369,5952,2063,1011,1052
5085,7863,1907,3840,1370,5956,2064,1011,1053
5090,7873,1908,3842,1370,5964,2066,1011,1055
5095,7879,1908,3844,1370,5971,2069,1012,1057
5100,7890,1910,3849,1370,5980,2071,1014,1057
5105,7894,1911,3852,1371,5983,2072,1015,1057
5110,7904,1913,3857,1372,5990,2074,1015,1059
5115,7910,1913,3862,1372,5997,2077,1018,1059
5120,7921,1915,3866,1373,6006,2079,1019,1060
5125,7925,1915,3868,1373,6010,2080,1020,1060
5130,7935,1916,3872,1374,6019,2082,1020,1062
5135,7941,1916,3877,1374,6024,2085,1022,1063
5140,7952,1919,3881,1376,6033,2087,1022,1065
5145,7956,1920,3883,1377,6036,2088,1023,1065
5150,7966,1923,3886,1378,6043,2090,1024,1066
5155,7972,1923,3889,1378,6047,2093,1025,1068
5160,7983,1929,3895,1383,6053,2095,1026,1069
5165,7987,1930,3895,1384,6057,2096,1026,1070
5170,7997,1934,3900,1386,6063,2098,1028,1070
5175,8003,1934,3902,1386,6069,2101,1030,1071
5180,8014,1936,3904,1386,6077,2103,1030,1073
5185,8018,1938,3906,1388,6080,2104,1031,1073
5190,8028,1941,3911,1391,6085,2106,1031,1075
5195,8034,1942,3913,1392,6090,2109,1032,1077
5200,8045,1946,3917,1395,6096,2111,1032,1079
5205,8049,1951,3919,1400,6098,2112,1032,1080
5210,8059,1954,3922,1402,6104,2114,1032,1082
5215,8065,1954,3924,1402,6110,2117,1034,1083
5220,8076,1959,3931,1405,6113,2119,1035,1084
5225,8080,1963,3932,1409,6117,2120,1035,1085
5230,8090,1965,3935,1410,6125,2122,1036,1086
5235,8096,1965,3937,1410,6130,2125,1036,1089
5240,8107,1968,3945,1411,6137,2127,1038,1089
5245,8111,1969,3947,1412,6141,2128,1038,1090
5250,8121,1972,3953,1414,6149,2130,1040,1090
5255,8127,1972,3957,1414,6154,2133,1042,1091
5260,8138,1975,3963,1416,6161,2135,1043,1092
5265,8142,1975,3964,1416,6166,2136,1043,1093
5270,8152,1977,3970,1418,6174,2138,1044,1094
5275,8158,1977,3975,1418,6180,2141,1047,1094
5280,8169,1980,3981,1420,6188,2143,1049,1094
5285,8173,1981,3983,1421,6192,2144,1049,1095
5290,8183,1983,3988,1423,6200,2146,1050,1096
5295,8189,1983,3989,1423,6205,2149,1050,1099
5300,8200,1985,3994,1424,6215,2151,1051,1100
5305,8204,1985,3997,1424,6219,2152,1052,1100
5310,8214,1988,4003,1426,6226,2154,1054,1100
5315,8220,1988,4005,1426,6232,2157,1054,1103
5320,8231,1990,4009,1427,6240,2159,1054,1105
5325,8235,1991,4011,1428,6244,2160,1054,1106
5330,8245,1992,4014,1428,6252,2162,1054,1108
5335,8251,1992,4015,1428,6259,2165,1055,1110
5340,8262,1995,4022,1430,6265,2167,1056,1111
5345,8266,1996,4023,1431,6270,2168,1057,1111
5350,8276,1999,4028,1433,6276,2170,1058,1112
5355,8282,1999,4031,1433,6283,2173,1060,1113
5360,8293,2001,4035,1434,6292,2175,1060,1115
5365,8297,2002,4037,1435,6295,2176,1061,1115
5370,8307,2006,4044,1439,6301,2178,1063,1115
5375,8313,2006,4048,1439,6307,2181,1065,1116
5380,8324,2008,4052,1441,6316,2183,1066,1117
5385,8328,2008,4053,1441,6320,2184,1066,1118
5390,8338,2010,4056,1441,6327,2186,1066,1120
5395,8344,2010,4060,1441,6333,2189,1068,1121
5400,8355,2013,4065,1443,6342,2191,1069,1122
5405,8359,2014,4067,1444,6345,2192,1070,1122
5410,8369,2017,4070,1447,6352,2194,1070,1124
5415,8375,2017,4073,1447,6357,2197,1072,1125
5420,8386,2020,4079,1450,6365,2199,1073,1126
5425,8390,2022,4082,1452,6368,2200,1074,1126
5430,8400,2026,4087,1454,6373,2202,1075,1127
5435,8406,2026,4089,1454,6379,2205,1075,1130
5440,8417,2028,4094,1456,6388,2207,1075,1132
5445,8421,2030,4098,1458,6391,2208,1076,1132
5450,8431,2033,4104,1460,6397,2210,1078,1132
5455,8437,2033,4107,1460,6402,2213,1080,1133
5460,8448,2037,4112,1463,6408,2215,1080,1135
5465,8452,2040,4114,1466,6411,2216,1080,1136
5470,8462,2041,4119,1467,6421,2218,1081,1137
5475,8468,2041,4119,1467,6427,2221,1081,1140
5480,8479,2043,4124,1467,6434,2223,1082,1141
5485,8483,2044,4127,1468,6439,2224,1083,1141
5490,8493,2047,4134,1470,6444,2226,1084,1142
5495,8499,2047,4138,1470,6449,2229,1085,1144
5500,8510,2050,4143,1472,6458,2231,1085,1146
5505,8514,2051,4146,1473,6463,2232,1086,1146
5510,8524,2054,4150,1475,6468,2234,1086,1148
5515,8530,2054,4153,1475,6475,2237,1088,1149
5520,8541,2056,4159,1475,6483,2239,1090,1149
5525,8545,2057,4160,1476,6488,2240,1090,1150
5530,8555,2059,4165,1478,6495,2242,1091,1151
5535,8561,2059,4169,1478,6502,2245,1094,1151
5540,8572,2061,4175,1480,6510,2247,1096,1151
5545,8576,2062,4177,1481,6514,2248,1096,1152
5550,8586,2064,4182,1482,6521,2250,1097,1153
5555,8592,2064,4186,1482,6527,2253,1099,1154
5560,8603,2066,4194,1484,6536,2255,1101,1154
5565,8607,2066,4196,1484,6541,2256,1102,1154
5570,8617,2069,4201,1486,6548,2258,1103,1155
5575,8623,2069,4203,1486,6553,2261,1104,1157
5580,8634,2073,4212,1490,6559,2263,1105,1158
5585,8638,2075,4214,1492,6563,2264,1106,1158
5590,8648,2078,4218,1493,6569,2266,1107,1159
5595,8654,2078,4220,1493,6576,2269,1109,1160
5600,8665,2082,4226,1496,6583,2271,1110,1161
5605,8669,2082,4228,1496,6587,2272,1110,1162
5610,8679,2086,4235,1499,6592,2274,1112,1162
5615,8685,2086,4236,1499,6599,2277,1112,1165
5620,8696,2091,4242,1503,6605,2279,1113,1166
5625,8700,2092,4245,1504,6608,2280,1114,1166
5630,8710,2095,4249,1506,6615,2282,1114,1168
5635,8716,2095,4250,1506,6621,2285,1115,1170
5640,8727,2098,4252,1507,6629,2287,1116,1171
5645,8731,2099,4253,1508,6632,2288,1116,1172
5650,8741,2104,4258,1511,6636,2290,1117,1173
5655,8747,2104,4259,1511,6643,2293,1118,1175
5660,8758,2108,4266,1514,6650,2295,1120,1175
5665,8762,2108,4267,1514,6654,2296,1121,1175
5670,8772,2111,4272,1516,6660,2298,1123,1175
5675,8778,2111,4277,1516,6665,2301,1125,1176
5680,8789,2116,4282,1521,6673,2303,1126,1177
5685,8793,2117,4284,1522,6676,2304,1126,1178
5690,8803,2122,4288,1526,6681,2306,1126,1180
5695,8809,2122,4291,1526,6685,2309,1127,1182
5700,8820,2128,4298,1532,6690,2311,1128,1183
5705,8824,2130,4300,1534,6693,2312,1129,1183
5710,8834,2133,4305,1536,6699,2314,1129,1185
5715,8840,2134,4305,1537,6705,2317,1129,1188
5720,8851,2137,4311,1539,6712,2319,1130,1189
5725,8855,2137,4312,1539,6718,2320,1130,1190
5730,8865,2138,4314,1540,6727,2322,1130,1192
5735,8871,2138,4316,1540,6732,2325,1130,1195
5740,8882,2139,4322,1540,6741,2327,1131,1196
5745,8886,2139,4324,1540,6746,2328,1132,1196
5750,8896,2140,4327,1540,6755,2330,1132,1198
5755,8902,2140,4330,1540,6760,2333,1133,1200
5760,8913,2141,4335,1540,6771,2335,1135,1200
5765,8917,2141,4339,1540,6775,2336,1136,1200
5770,8927,2142,4345,1541,6785,2338,1138,1200
5775,8933,2142,4350,1541,6790,2341,1141,1200
5780,8944,2143,4353,1541,6800,2343,1142,1201
5785,8948,2143,4354,1541,6805,2344,1142,1202
5790,8958,2144,4359,1541,6814,2346,1142,1204
5795,8964,2144,4361,1541,6820,2349,1143,1206
5800,8975,2145,4365,1542,6828,2351,1143,1208
5805,8979,2145,4365,1542,6834,2352,1143,1209
5810,8989,2147,4369,1544,6842,2354,1143,1211
5815,8995,2147,4370,1544,6848,2357,1143,1214
5820,9006,2150,4377,1546,6855,2359,1144,1215
5825,9010,2150,4378,1546,6860,2360,1145,1215
5830,9020,2153,4383,1548,6866,2362,1147,1215
5835,9026,2153,4387,1548,6872,2365,1149,1216
5840,9037,2156,4391,1550,6881,2367,1150,1217
5845,9041,2157,4395,1551,6884,2368,1151,1217
5850,9051,2159,4401,1553,6891,2370,1153,1217
5855,9057,2159,4405,1553,6897,2373,1155,1218
5860,9068,2162,4410,1555,6904,2375,1156,1219
5865,9072,2163,4413,1556,6909,2376,1157,1219
5870,9082,2166,4420,1559,6915,2378,1158,1220
5875,9088,2166,4426,1559,6920,2381,1161,1220
5880,9099,2170,4430,1562,6928,2383,1161,1222
5885,9103,2173,4432,1565,6930,2384,1161,1223
5890,9113,2177,4439,1569,6935,2386,1162,1224
5895,9119,2177,4442,1569,6941,2389,1163,1226
5900,9130,2182,4450,1574,6947,2391,1164,1227
5905,9134,2185,4453,1577,6949,2392,1165,1227
5910,9144,2187,4456,1577,6956,2394,1166,1228
5915,9150,2187,4457,1577,6963,2397,1167,1230
5920,9161,2191,4463,1580,6969,2399,1167,1232
5925,9165,2193,4464,1582,6972,2400,1167,1233
5930,9175,2196,4469,1584,6978,2402,1169,1233
5935,9181,2196,4473,1584,6983,2405,1170,1235
5940,9192,2202,4477,1588,6990,2407,1171,1236
5945,9196,2203,4480,1589,6993,2408,1172,1236
5950,9206,2206,4483,1591,6999,2410,1172,1238
5955,9212,2206,4487,1591,7004,2413,1174,1239
5960,9223,2212,4491,1596,7010,2415,1174,1241
5965,9227,2215,4495,1599,7012,2416,1175,1241
5970,9237,2217,4500,1601,7019,2418,1177,1241
5975,9243,2217,4504,1601,7026,2421,1180,1241
5980,9254,2220,4511,1603,7032,2423,1181,1242
5985,9258,2221,4513,1604,7037,2424,1181,1243
5990,9268,2223,4517,1605,7044,2426,1182,1244
5995,9274,2223,4519,1605,7049,2429,1183,1246
6000,9285,2225,4525,1607,7059,2431,1183,1248
6005,9289,2225,4525,1607,7064,2432,1183,1249
6010,9299,2226,4528,1607,7071,2434,1183,1251
6015,9305,2226,4531,1607,7078,2437,1186,1251
6020,9316,2229,4537,1609,7085,2439,1187,1252
6025,9320,2229,4538,1609,7090,2440,1187,1253
6030,9330,2231,4542,1610,7099,2442,1188,1254
6035,9336,2231,4545,1610,7104,2445,1190,1255
6040,9347,2234,4550,1611,7111,2447,1190,1257
6045,9351,2234,4551,1611,7117,2448,1190,1258
6050,9361,2236,4556,1612,7124,2450,1191,1259
6055,9367,2236,4558,1612,7129,2453,1192,1261
6060,9378,2239,4562,1614,7139,2455,1193,1262
6065,9382,2240,4565,1615,7141,2456,1194,1262
6070,9392,2243,4570,1618,7149,2458,1195,1263
6075,9398,2243,4574,1618,7153,2461,1196,1265
6080,9409,2247,4578,1620,7160,2463,1197,1266
6085,9413,2248,4580,1621,7165,2464,1198,1266
6090,9423,2251,4584,1623,7171,2466,1199,1267
6095,9429,2251,4588,1623,7177,2469,1202,1267
6100,9440,2254,4595,1624,7183,2471,1204,1267
6105,9444,2256,4598,1626,7187,2472,1205,1267
6110,9454,2258,4604,1626,7196,2474,1206,1268
6115,9460,2258,4608,1626,7200,2477,1207,1270
6120,9471,2261,4615,1629,7208,2479,1208,1271
6125,9475,2261,4617,1629,7214,2480,1208,1272
6130,9485,2263,4622,1630,7222,2482,1209,1273
6135,9491,2263,4628,1630,7227,2485,1212,1273
6140,9502,2265,4634,1632,7236,2487,1214,1273
6145,9506,2266,4635,1633,7240,2488,1214,1274
6150,9516,2268,4640,1633,7247,2490,1215,1275
6155,9522,2268,4645,1633,7253,2493,1218,1275
6160,9533,2270,4652,1635,7262,2495,1220,1275
6165,9537,2271,4653,1636,7266,2496,1220,1276
6170,9547,2273,4657,1637,7274,2498,1221,1277
6175,9553,2273,4659,1637,7280,2501,1222,1279
6180,9564,2276,4666,1639,7287,2503,1224,1279
6185,9568,2277,4667,1640,7291,2504,1224,1280
6190,9578,2279,4672,1642,7298,2506,1224,1282
6195,9584,2279,4675,1642,7304,2509,1224,1285
6200,9595,2283,4684,1646,7311,2511,1225,1286
6205,9599,2284,4686,1647,7315,2512,1225,1287
6210,9609,2288,4693,1651,7320,2514,1226,1288
6215,9615,2288,4697,1651,7326,2517,1229,1288
6220,9626,2294,4702,1655,7332,2519,1230,1289
6225,9630,2295,4704,1656,7335,2520,1231,1289
6230,9640,2300,4710,1660,7340,2522,1233,1289
6235,9646,2300,4713,1660,7344,2525,1234,1291
6240,9657,2305,4721,1664,7348,2527,1236,1291
6245,9661,2310,4723,1669,7351,2528,1236,1292
6250,9671,2312,4730,1671,7358,2530,1238,1292
6255,9677,2312,4731,1671,7363,2533,1238,1295
6260,9688,2315,4736,1673,7372,2535,1238,1297
6265,9692,2316,4738,1674,7375,2536,1238,1298
6270,9702,2317,4743,1675,7384,2538,1239,1299
6275,9708,2317,4744,1675,7391,2541,1240,1301
6280,9719,2320,4751,1677,7399,2543,1242,1301
6285,9723,2320,4753,1677,7402,2544,1243,1301
6290,9733,2322,4758,1679,7409,2546,1243,1303
6295,9739,2322,4761,1679,7415,2549,1245,1304
6300,9750,2325,4769,1681,7423,2551,1247,1304
6305,9754,2326,4771,1682,7428,2552,1248,1304
6310,9764,2327,4776,1683,7435,2554,1250,1304
6315,9770,2327,4779,1683,7443,2557,1251,1306
6320,9781,2330,4783,1684,7450,2559,1252,1307
6325,9785,2330,4784,1684,7455,2560,1253,1307
6330,9795,2331,4790,1684,7463,2562,1255,1307
6335,9801,2331,4793,1684,7469,2565,1256,1309
6340,9812,2333,4795,1684,7478,2567,1256,1311
6345,9816,2334,4796,1685,7482,2568,1256,1312
6350,9826,2335,4799,1685,7490,2570,1256,1314
6355,9832,2335,4803,1685,7495,2573,1257,1316
6360,9843,2339,4809,1689,7503,2575,1258,1317
6365,9847,2340,4810,1690,7507,2576,1259,1317
6370,9857,2343,4815,1691,7513,2578,1260,1318
6375,9863,2343,4818,1691,7520,2581,1263,1318
6380,9874,2347,4825,1695,7526,2583,1263,1320
6385,9878,2348,4827,1696,7530,2584,1264,1320
6390,9888,2352,4834,1700,7536,2586,1265,1321
6395,9894,2352,4837,1700,7541,2589,1266,1323
6400,9905,2355,4843,1702,7549,2591,1267,1324
6405,9909,2356,4845,1703,7553,2592,1268,1324
6410,9919,2359,4851,1705,7559,2594,1269,1325
6415,9925,2359,4853,1705,7565,2597,1270,1327
6420,9936,2365,4859,1710,7571,2599,1271,1328
6425,9940,2366,4861,1711,7574,2600,1272,1328
6430,9950,2369,4865,1713,7580,2602,1273,1329
6435,9956,2369,4867,1713,7586,2605,1274,1331
6440,9967,2372,4871,1715,7595,2607,1276,1331
6445,9971,2373,4872,1716,7598,2608,1276,1332
6450,9981,2376,4875,1719,7605,2610,1276,1334
6455,9987,2376,4877,1719,7610,2613,1277,1336
6460,9998,2380,4879,1722,7618,2615,1277,1338
6465,10002,2380,4880,1722,7622,2616,1278,1338
6470,10012,2383,4885,1725,7629,2618,1279,1339
6475,10018,2383,4889,1725,7634,2621,1281,1340
6480,10029,2388,4896,1729,7640,2623,1282,1341
6485,10033,2391,4898,1732,7642,2624,1282,1342
6490,10043,2394,4901,1734,7649,2626,1283,1343
6495,10049,2394,4903,1734,7653,2629,1283,1346
6500,10060,2399,4909,1739,7659,2631,1284,1347
6505,10064,2402,4912,1742,7661,2632,1285,1347
6510,10074,2403,4916,1742,7671,2634,1286,1348
6515,10080,2403,4919,1742,7676,2637,1287,1350
6520,10091,2406,4926,1745,7685,2639,1288,1351
6525,10095,2406,4926,1745,7689,2640,1288,1352
6530,10105,2407,4929,1746,7698,2642,1288,1354
6535,10111,2407,4931,1746,7703,2645,1289,1356
6540,10122,2410,4940,1749,7709,2647,1291,1356
6545,10126,2411,4943,1750,7714,2648,1292,1356
6550,10136,2413,4950,1752,7722,2650,1294,1356
6555,10142,2413,4952,1752,7729,2653,1295,1358
6560,10153,2415,4957,1752,7738,2655,1297,1358
6565,10157,2415,4960,1752,7741,2656,1298,1358
6570,10167,2416,4964,1753,7749,2658,1298,1360
6575,10173,2416,4968,1753,7756,2661,1300,1361
6580,10184,2419,4971,1756,7765,2663,1300,1363
6585,10188,2420,4973,1757,7768,2664,1301,1363
6590,10198,2421,4978,1757,7777,2666,1303,1363
6595,10204,2421,4980,1757,7783,2669,1304,1365
6600,10215,2423,4985,1758,7791,2671,1306,1365
6605,10219,2423,4987,1758,7796,2672,1306,1366
6610,10229,2426,4991,1760,7803,2674,1307,1367
6615,10235,2426,4993,1760,7808,2677,1308,1369
6620,10246,2429,5001,1763,7814,2679,1309,1370
6625,10250,2431,5004,1765,7819,2680,1309,1371
6630,10260,2434,5007,1766,7825,2682,1309,1373
6635,10266,2434,5007,1766,7832,2685,1309,1376
6640,10277,2437,5013,1769,7840,2687,1310,1377
6645,10281,2437,5014,1769,7844,2688,1310,1378
6650,10291,2440,5019,1771,7851,2690,1311,1379
6655,10297,2440,5021,1771,7856,2693,1312,1381
6660,10308,2444,5026,1774,7863,2695,1312,1383
6665,10312,2444,5028,1774,7868,2696,1313,1383
6670,10322,2448,5037,1778,7873,2698,1315,1383
6675,10328,2448,5040,1778,7880,2701,1317,1384
6680,10339,2451,5045,1781,7888,2703,1318,1385
6685,10343,2453,5048,1783,7890,2704,1318,1386
6690,10353,2458,5053,1787,7895,2706,1319,1387
6695,10359,2458,5055,1787,7901,2709,1320,1389
6700,10370,2461,5060,1790,7908,2711,1320,1391
6705,10374,2463,5063,1792,7911,2712,1321,1391
6710,10384,2467,5072,1796,7916,2714,1323,1391
6715,10390,2467,5077,1796,7922,2717,1326,1391
6720,10401,2471,5085,1800,7929,2719,1328,1391
6725,10405,2472,5086,1801,7933,2720,1328,1392
6730,10415,2475,5091,1802,7940,2722,1330,1392
6735,10421,2475,5095,1802,7945,2725,1333,1392
6740,10432,2480,5102,1807,7952,2727,1334,1393
6745,10436,2481,5104,1808,7955,2728,1334,1394
6750,10446,2483,5106,1809,7962,2730,1334,1396
6755,10452,2483,5107,1809,7969,2733,1335,1398
6760,10463,2487,5113,1812,7975,2735,1335,1400
6765,10467,2489,5114,1814,7978,2736,1335,1401
6770,10477,2493,5119,1818,7983,2738,1335,1403
6775,10483,2494,5121,1819,7989,2741,1337,1404
6780,10494,2497,5126,1821,7995,2743,1338,1405
6785,10498,2500,5127,1824,7998,2744,1338,1406
6790,10508,2503,5133,1827,8004,2746,1339,1407
6795,10514,2503,5136,1827,8009,2749,1341,1408
6800,10525,2506,5140,1829,8019,2751,1343,1408
6805,10529,2507,5143,1830,8022,2752,1344,1408
6810,10539,2510,5149,1832,8028,2754,1346,1408
6815,10545,2511,5154,1833,8033,2757,1349,1408
6820,10556,2512,5161,1833,8042,2759,1351,1408
6825,10560,2512,5164,1833,8048,2760,1352,1408
6830,10570,2513,5168,1833,8057,2762,1354,1408
6835,10576,2513,5171,1833,8061,2765,1354,1411
6840,10587,2514,5176,1833,8071,2767,1354,1413
6845,10591,2514,5176,1833,8077,2768,1354,1414
6850,10601,2515,5178,1833,8085,2770,1354,1416
6855,10607,2515,5182,1833,8091,2773,1357,1416
6860,10618,2516,5188,1834,8101,2775,1358,1417
6865,10622,2516,5191,1834,8106,2776,1359,1417
6870,10632,2517,5199,1835,8113,2778,1360,1418
6875,10638,2517,5202,1835,8120,2781,1361,1420
6880,10649,2518,5204,1835,8131,2783,1362,1421
6885,10653,2518,5205,1835,8135,2784,1363,1421
6890,10663,2521,5209,1837,8140,2786,1363,1423
6895,10669,2521,5213,1837,8148,2789,1365,1424
6900,10680,2523,5218,1838,8156,2791,1366,1425
6905,10684,2523,5219,1838,8161,2792,1367,1425
6910,10694,2525,5224,1839,8168,2794,1368,1426
6915,10700,2525,5227,1839,8174,2797,1370,1427
6920,10711,2528,5234,1842,8182,2799,1371,1428
6925,10715,2528,5235,1842,8187,2800,1371,1429
6930,10725,2531,5240,1844,8193,2802,1372,1430
6935,10731,2531,5245,1844,8200,2805,1375,1430
6940,10742,2534,5250,1845,8207,2807,1376,1431
6945,10746,2535,5252,1846,8211,2808,1377,1431
6950,10756,2538,5255,1848,8218,2810,1377,1433
6955,10762,2538,5259,1848,8224,2813,1379,1434
6960,10773,2543,5264,1851,8230,2815,1379,1436
6965,10777,2544,5265,1852,8233,2816,1379,1437
6970,10787,2548,5272,1856,8239,2818,1380,1438
6975,10793,2548,5275,1856,8245,2821,1382,1439
6980,10804,2552,5282,1860,8251,2823,1383,1440
6985,10808,2554,5285,1862,8254,2824,1384,1440
6990,10818,2557,5291,1864,8260,2826,1385,1441
6995,10824,2557,5294,1864,8266,2829,1387,1442
7000,10835,2562,5300,1867,8273,2831,1389,1442
7005,10839,2563,5302,1868,8276,2832,1389,1443
7010,10849,2565,5303,1869,8284,2834,1389,1445
7015,10855,2565,5304,1869,8290,2837,1390,1447
7020,10866,2568,5311,1871,8297,2839,1391,1448
7025,10870,2570,5313,1873,8300,2840,1391,1449
7030,10880,2574,5317,1875,8306,2842,1392,1450
7035,10886,2574,5321,1875,8311,2845,1395,1450
7040,10897,2579,5328,1879,8316,2847,1397,1450
7045,10901,2583,5332,1883,8317,2848,1398,1450
7050,10911,2588,5336,1887,8323,2850,1399,1451
7055,10917,2588,5339,1887,8327,2853,1400,1453
7060,10928,2594,5346,1892,8333,2855,1401,1454
7065,10932,2594,5348,1892,8337,2856,1401,1455
7070,10942,2597,5354,1895,8344,2858,1402,1456
7075,10948,2597,5358,1895,8348,2861,1403,1458
7080,10959,2600,5367,1898,8356,2863,1404,1459
7085,10963,2601,5368,1899,8362,2864,1404,1460
7090,10973,2604,5373,1902,8368,2866,1404,1462
7095,10979,2604,5376,1902,8374,2869,1406,1463
7100,10990,2606,5381,1904,8383,2871,1407,1464
7105,10994,2607,5385,1905,8386,2872,1408,1464
7110,11004,2609,5392,1907,8393,2874,1410,1464
7115,11010,2609,5395,1907,8400,2877,1412,1465
7120,11021,2611,5401,1909,8408,2879,1413,1466
7125,11025,2611,5402,1909,8414,2880,1413,1467
7130,11035,2613,5409,1910,8422,2882,1415,1467
7135,11041,2613,5410,1910,8428,2885,1416,1469
7140,11052,2615,5415,1911,8436,2887,1417,1470
7145,11056,2615,5417,1911,8441,2888,1417,1471
7150,11066,2616,5422,1911,8449,2890,1419,1471
7155,11072,2616,5425,1911,8455,2893,1419,1474
7160,11083,2619,5429,1912,8464,2895,1420,1475
7165,11087,2620,5432,1913,8467,2896,1420,1476
7170,11097,2622,5436,1914,8474,2898,1420,1478
7175,11103,2622,5439,1914,8481,2901,1423,1478
7180,11114,2624,5444,1915,8488,2903,1425,1478
7185,11118,2626,5446,1917,8492,2904,1425,1479
7190,11128,2630,5452,1921,8497,2906,1426,1480
7195,11134,2630,5455,1921,8503,2909,1428,1481
7200,11145,2633,5461,1923,8511,2911,1430,1481
7205,11149,2635,5463,1925,8514,2912,1430,1482
7210,11159,2637,5467,1927,8522,2914,1431,1483
7215,11165,2637,5471,1927,8528,2917,1434,1483
7220,11176,2641,5474,1929,8535,2919,1434,1485
7225,11180,2642,5475,1930,8538,2920,1434,1486
7230,11190,2645,5480,1933,8545,2922,1434,1488
7235,11196,2645,5484,1933,8550,2925,1435,1490
7240,11207,2650,5489,1937,8556,2927,1436,1491
7245,11211,2653,5492,1940,8558,2928,1437,1491
7250,11221,2658,5499,1944,8562,2930,1438,1492
7255,11227,2658,5502,1944,8568,2933,1439,1494
7260,11238,2662,5509,1947,8575,2935,1441,1494
7265,11242,2664,5511,1949,8578,2936,1442,1494
7270,11252,2668,5517,1952,8583,2938,1443,1495
7275,11258,2668,5522,1952,8588,2941,1445,1496
7280,11269,2672,5529,1955,8597,2943,1446,1497
7285,11273,2672,5530,1955,8601,2944,1447,1497
7290,11283,2676,5535,1958,8606,2946,1447,1499
7295,11289,2676,5538,1958,8612,2949,1449,1500
7300,11300,2679,5542,1961,8620,2951,1449,1502
7305,11304,2681,5544,1963,8622,2952,1449,1503
7310,11314,2684,5549,1965,8629,2954,1449,1505
7315,11320,2684,5553,1965,8635,2957,1451,1506
7320,11331,2685,5557,1965,8645,2959,1451,1508
7325,11335,2685,5560,1965,8649,2960,1452,1508
7330,11345,2686,5563,1965,8659,2962,1453,1509
7335,11351,2686,5564,1965,8665,2965,1453,1512
7340,11362,2687,5567,1965,8675,2967,1453,1514
7345,11366,2687,5569,1965,8679,2968,1454,1514
7350,11376,2688,5573,1965,8688,2970,1454,1516
7355,11382,2688,5576,1965,8693,2973,1456,1517
7360,11393,2689,5581,1965,8703,2975,1457,1518
7365,11397,2689,5583,1965,8708,2976,1458,1518
7370,11407,2691,5586,1966,8715,2978,1458,1520
7375,11413,2691,5589,1966,8721,2981,1460,1521
7380,11424,2694,5593,1968,8730,2983,1460,1523
7385,11428,2694,5595,1968,8733,2984,1461,1523
7390,11438,2696,5599,1970,8741,2986,1461,1525
7395,11444,2696,5604,1970,8745,2989,1463,1526
7400,11455,2698,5607,1971,8756,2991,1463,1528
7405,11459,2698,5609,1971,8760,2992,1464,1528
7410,11469,2701,5616,1974,8766,2994,1465,1529
7415,11475,2701,5618,1974,8773,2997,1466,1531
7420,11486,2704,5623,1977,8781,2999,1466,1533
7425,11490,2705,5626,1978,8785,3000,1467,1533
7430,11500,2708,5630,1981,8792,3002,1468,1534
7435,11506,2708,5633,1981,8797,3005,1470,1535
7440,11517,2712,5636,1984,8805,3007,1470,1537
7445,11521,2712,5637,1984,8809,3008,1470,1538
7450,11531,2714,5641,1985,8817,3010,1472,1538
7455,11537,2714,5643,1985,8821,3013,1472,1541
7460,11548,2717,5644,1987,8831,3015,1472,1543
7465,11552,2718,5646,1988,8833,3016,1472,1544
7470,11562,2722,5651,1990,8839,3018,1473,1545
7475,11568,2722,5653,1990,8846,3021,1474,1547
7480,11579,2724,5656,1990,8853,3023,1475,1548
7485,11583,2725,5656,1991,8858,3024,1475,1549
7490,11593,2727,5660,1991,8865,3026,1476,1550
7495,11599,2727,5663,1991,8871,3029,1478,1551
7500,11610,2733,5668,1996,8876,3031,1478,1553
7505,11614,2734,5671,1997,8880,3032,1479,1553
7510,11624,2737,5675,1998,8887,3034,1481,1553
7515,11630,2737,5677,1998,8892,3037,1482,1555
7520,11641,2741,5683,2001,8898,3039,1483,1556
7525,11645,2742,5685,2002,8903,3040,1484,1556
7530,11655,2746,5690,2005,8909,3042,1485,1557
7535,11661,2746,5691,2005,8915,3045,1486,1559
7540,11672,2751,5697,2008,8921,3047,1487,1560
7545,11676,2751,5699,2008,8925,3048,1488,1560
7550,11686,2755,5704,2011,8931,3050,1488,1562
7555,11692,2755,5705,2011,8936,3053,1488,1565
7560,11703,2757,5707,2011,8945,3055,1489,1566
7565,11707,2758,5710,2012,8949,3056,1490,1566
7570,11717,2761,5718,2014,8955,3058,1492,1566
7575,11723,2761,5720,2014,8961,3061,1493,1568
7580,11734,2765,5725,2016,8968,3063,1493,1570
7585,11738,2767,5728,2018,8971,3064,1494,1570
7590,11748,2770,5734,2021,8978,3066,1496,1570
7595,11754,2770,5738,2021,8984,3069,1499,1570
7600,11765,2774,5744,2025,8991,3071,1500,1571
7605,11769,2774,5745,2025,8995,3072,1501,1571
7610,11779,2779,5749,2028,9000,3074,1502,1572
7615,11785,2779,5752,2028,9005,3077,1503,1574
7620,11796,2784,5756,2032,9012,3079,1503,1576
7625,11800,2786,5758,2034,9014,3080,1503,1577
7630,11810,2788,5759,2035,9022,3082,1503,1579
7635,11816,2788,5762,2035,9028,3085,1505,1580
7640,11827,2792,5768,2038,9035,3087,1506,1581
7645,11831,2794,5772,2040,9037,3088,1507,1581
7650,11841,2798,5776,2043,9042,3090,1507,1583
7655,11847,2798,5778,2043,9048,3093,1508,1585
7660,11858,2802,5783,2046,9055,3095,1510,1585
7665,11862,2805,5787,2049,9057,3096,1511,1585
7670,11872,2811,5793,2053,9061,3098,1512,1586
7675,11878,2811,5796,2053,9065,3101,1512,1589
7680,11889,2816,5803,2058,9072,3103,1512,1591
7685,11893,2817,5806,2059,9076,3104,1513,1591
7690,11903,2818,5813,2060,9083,3106,1514,1592
7695,11909,2818,5814,2060,9089,3109,1514,1595
7700,11920,2819,5823,2060,9098,3111,1516,1595
7705,11924,2819,5825,2060,9105,3112,1517,1595
7710,11934,2820,5830,2060,9113,3114,1517,1597
7715,11940,2820,5832,2060,9119,3117,1519,1598
7720,11951,2821,5837,2060,9129,3119,1521,1598
7725,11955,2821,5839,2060,9133,3120,1521,1599
7730,11965,2822,5845,2061,9141,3122,1521,1601
7735,11971,2822,5846,2061,9148,3125,1522,1603
7740,11982,2823,5851,2061,9156,3127,1522,1605
7745,11986,2823,5853,2061,9163,3128,1523,1605
7750,11996,2824,5857,2061,9172,3130,1523,1607
7755,12002,2824,5860,2061,9178,3133,1524,1609
7760,12013,2825,5866,2062,9187,3135,1525,1610
7765,12017,2825,5868,2062,9192,3136,1526,1610
7770,12027,2826,5874,2062,9199,3138,1527,1611
7775,12033,2826,5877,2062,9207,3141,1529,1612
7780,12044,2827,5883,2063,9214,3143,1529,1614
7785,12048,2827,5885,2063,9221,3144,1530,1614
7790,12058,2829,5889,2064,9228,3146,1531,1615
7795,12064,2829,5894,2064,9234,3149,1534,1615
7800,12075,2832,5899,2066,9239,3151,1534,1617
7805,12079,2833,5901,2067,9246,3152,1535,1617
7810,12089,2836,5907,2069,9252,3154,1537,1617
7815,12095,2836,5913,2069,9257,3157,1540,1617
7820,12106,2839,5917,2071,9266,3159,1540,1619
7825,12110,2841,5918,2073,9269,3160,1540,1620
7830,12120,2844,5923,2076,9275,3162,1541,1621
7835,12126,2844,5928,2076,9281,3165,1544,1621
7840,12137,2847,5936,2078,9288,3167,1546,1621
7845,12141,2848,5937,2079,9293,3168,1546,1622
7850,12151,2851,5940,2081,9300,3170,1546,1624
7855,12157,2851,5944,2081,9304,3173,1548,1625
7860,12168,2855,5949,2083,9312,3175,1550,1625
7865,12172,2857,5952,2085,9315,3176,1551,1625
7870,12182,2860,5955,2086,9322,3178,1552,1626
7875,12188,2860,5958,2086,9327,3181,1554,1627
7880,12199,2864,5960,2089,9335,3183,1554,1629
7885,12203,2865,5962,2090,9338,3184,1554,1630
7890,12213,2868,5966,2092,9345,3186,1555,1631
7895,12219,2868,5971,2092,9350,3189,1558,1631
7900,12230,2874,5978,2097,9356,3191,1560,1631
7905,12234,2874,5978,2097,9360,3192,1560,1632
7910,12244,2880,5986,2103,9363,3194,1560,1634
7915,12250,2880,5987,2103,9370,3197,1561,1636
7920,12261,2883,5992,2105,9377,3199,1563,1636
7925,12265,2884,5992,2106,9381,3200,1563,1637
7930,12275,2886,5994,2107,9389,3202,1564,1638
7935,12281,2886,5996,2107,9395,3205,1565,1640
7940,12292,2889,6001,2108,9403,3207,1567,1640
7945,12296,2890,6003,2109,9406,3208,1567,1641
7950,12306,2892,6005,2110,9414,3210,1568,1642
7955,12312,2892,6005,2110,9420,3213,1568,1645
7960,12323,2895,6010,2112,9428,3215,1570,1645
7965,12327,2897,6013,2114,9429,3216,1570,1646
7970,12337,2901,6017,2118,9435,3218,1570,1648
7975,12343,2902,6020,2119,9439,3221,1571,1650
7980,12354,2908,6024,2124,9445,3223,1571,1652
7985,12358,2909,6024,2125,9449,3224,1571,1653
7990,12368,2912,6028,2128,9455,3226,1571,1655
7995,12374,2912,6031,2128,9460,3229,1572,1657
8000,12385,2914,6032,2128,9470,3231,1572,1659
8005,12389,2914,6032,2128,9475,3232,1572,1660
8010,12399,2916,6036,2129,9482,3234,1573,1661
8015,12405,2916,6037,2129,9488,3237,1573,1664
8020,12416,2918,6042,2131,9497,3239,1574,1665
8025,12420,2919,6044,2132,9501,3240,1574,1666
8030,12430,2921,6048,2134,9508,3242,1574,1668
8035,12436,2921,6049,2134,9514,3245,1575,1670
8040,12447,2924,6054,2137,9523,3247,1576,1671
8045,12451,2924,6056,2137,9526,3248,1577,1671
8050,12461,2927,6064,2139,9533,3250,1579,1671
8055,12467,2927,6065,2139,9539,3253,1580,1673
8060,12478,2929,6066,2139,9549,3255,1581,1674
8065,12482,2930,6068,2140,9552,3256,1581,1675
8070,12492,2932,6075,2142,9560,3258,1583,1675
8075,12498,2932,6078,2142,9564,3261,1584,1677
8080,12509,2935,6083,2144,9573,3263,1585,1678
8085,12513,2935,6084,2144,9578,3264,1585,1679
8090,12523,2938,6087,2146,9584,3266,1585,1681
8095,12529,2938,6090,2146,9588,3269,1586,1683
8100,12540,2944,6096,2152,9594,3271,1587,1684
8105,12544,2946,6098,2154,9597,3272,1587,1685
8110,12554,2950,6102,2157,9604,3274,1587,1687
8115,12560,2950,6103,2157,9610,3277,1587,1690
8120,12571,2954,6109,2161,9615,3279,1587,1692
8125,12575,2954,6111,2161,9620,3280,1588,1692
8130,12585,2958,6117,2164,9626,3282,1589,1693
8135,12591,2958,6119,2164,9633,3285,1590,1695
8140,12602,2961,6125,2165,9638,3287,1590,1697
8145,12606,2963,6127,2167,9643,3288,1590,1698
8150,12616,2967,6133,2170,9649,3290,1591,1699
8155,12622,2967,6136,2170,9654,3293,1592,1701
8160,12633,2971,6143,2173,9661,3295,1593,1702
8165,12637,2973,6145,2175,9664,3296,1593,1703
8170,12647,2976,6149,2177,9671,3298,1594,1704
8175,12653,2976,6152,2177,9677,3301,1595,1706
8180,12664,2978,6155,2177,9685,3303,1595,1708
8185,12668,2980,6158,2179,9688,3304,1596,1708
8190,12678,2983,6163,2180,9694,3306,1598,1708
8195,12684,2983,6166,2180,9701,3309,1600,1709
8200,12695,2985,6171,2182,9710,3311,1601,1710
8205,12699,2986,6175,2183,9713,3312,1602,1710
8210,12709,2988,6176,2184,9721,3314,1602,1712
8215,12715,2988,6179,2184,9727,3317,1604,1713
8220,12726,2991,6181,2185,9735,3319,1604,1715
8225,12730,2992,6184,2186,9738,3320,1604,1716
8230,12740,2994,6188,2186,9746,3322,1605,1717
8235,12746,2994,6189,2186,9752,3325,1606,1719
8240,12757,2995,6190,2186,9762,3327,1606,1721
8245,12761,2996,6192,2187,9765,3328,1607,1721
8250,12771,2999,6198,2190,9772,3330,1608,1722
8255,12777,2999,6200,2190,9777,3333,1609,1724
8260,12788,3003,6206,2193,9785,3335,1610,1725
8265,12792,3004,6208,2194,9788,3336,1610,1726
8270,12802,3006,6213,2195,9796,3338,1612,1726
8275,12808,3006,6216,2195,9801,3341,1614,1727
8280,12819,3010,6220,2198,9807,3343,1614,1729
8285,12823,3012,6223,2200,9810,3344,1615,1729
8290,12833,3017,6230,2204,9815,3346,1616,1730
8295,12839,3017,6231,2204,9821,3349,1617,1732
8300,12850,3020,6239,2207,9828,3351,1619,1732
8305,12854,3021,6241,2208,9833,3352,1620,1732
8310,12864,3022,6246,2209,9841,3354,1622,1732
8315,12870,3022,6250,2209,9845,3357,1623,1734
8320,12881,3023,6256,2209,9857,3359,1624,1735
8325,12885,3023,6259,2209,9861,3360,1624,1736
8330,12895,3025,6262,2210,9869,3362,1625,1737
8335,12901,3025,6266,2210,9875,3365,1628,1737
8340,12912,3027,6271,2211,9883,3367,1629,1738
8345,12916,3028,6272,2212,9888,3368,1629,1739
8350,12926,3030,6275,2213,9896,3370,1630,1740
8355,12932,3030,6277,2213,9902,3373,1631,1742
8360,12943,3032,6283,2215,9909,3375,1632,1743
8365,12947,3033,6286,2216,9913,3376,1632,1744
8370,12957,3035,6291,2218,9921,3378,1633,1745
8375,12963,3035,6293,2218,9928,3381,1634,1747
8380,12974,3037,6301,2220,9934,3383,1636,1747
8385,12978,3038,6303,2221,9940,3384,1636,1748
8390,12988,3041,6310,2223,9947,3386,1638,1748
8395,12994,3041,6314,2223,9953,3389,1641,1748
8400,13005,3043,6321,2225,9960,3391,1642,1749
8405,13009,3044,6324,2226,9965,3392,1642,1750
8410,13019,3047,6328,2227,9972,3394,1642,1752
8415,13025,3047,6331,2227,9977,3397,1644,1753
8420,13036,3052,6339,2232,9983,3399,1645,1754
8425,13040,3053,6342,2233,9987,3400,1646,1754
8430,13050,3056,6347,2234,9993,3402,1648,1754
8435,13056,3056,6351,2234,9999,3405,1651,1754
8440,13067,3059,6358,2237,10006,3407,1652,1755
8445,13071,3060,6359,2238,10011,3408,1652,1756
8450,13081,3062,6363,2238,10019,3410,1654,1756
8455,13087,3062,6366,2238,10024,3413,1656,1757
8460,13098,3066,6368,2240,10031,3415,1656,1759
8465,13102,3067,6368,2241,10035,3416,1656,1760
8470,13112,3070,6373,2243,10042,3418,1658,1760
8475,13118,3070,6376,2243,10047,3421,1658,1763
8480,13129,3075,6382,2247,10053,3423,1660,1763
8485,13133,3078,6385,2250,10055,3424,1660,1764
8490,13143,3081,6387,2251,10062,3426,1661,1765
8495,13149,3081,6389,2251,10068,3429,1662,1767
8500,13160,3085,6394,2254,10075,3431,1662,1769
8505,13164,3086,6396,2255,10078,3432,1662,1770
8510,13174,3091,6401,2259,10082,3434,1662,1772
8515,13180,3091,6404,2259,10088,3437,1663,1774
8520,13191,3096,6410,2264,10094,3439,1664,1775
8525,13195,3099,6413,2267,10096,3440,1665,1775
8530,13205,3103,6416,2269,10102,3442,1666,1776
8535,13211,3103,6419,2269,10108,3445,1668,1777
8540,13222,3105,6423,2271,10117,3447,1668,1779
8545,13226,3106,6425,2272,10120,3448,1668,1780
8550,13236,3111,6432,2276,10123,3450,1669,1781
8555,13242,3112,6433,2277,10128,3453,1669,1784
8560,13253,3117,6440,2281,10133,3455,1671,1784
8565,13257,3119,6442,2283,10138,3456,1672,1784
8570,13267,3121,6445,2284,10145,3458,1672,1786
8575,13273,3121,6445,2284,10152,3461,1672,1789
8580,13284,3123,6449,2285,10158,3463,1672,1791
8585,13288,3124,6452,2286,10163,3464,1672,1792
8590,13298,3125,6456,2287,10172,3466,1674,1792
8595,13304,3125,6461,2287,10177,3469,1677,1792
8600,13315,3127,6465,2288,10187,3471,1677,1794
8605,13319,3128,6466,2289,10191,3472,1677,1795
8610,13329,3130,6474,2291,10197,3474,1679,1795
8615,13335,3130,6478,2291,10204,3477,1681,1796
8620,13346,3133,6486,2293,10211,3479,1683,1796
8625,13350,3134,6488,2294,10216,3480,1684,1796
8630,13360,3136,6491,2296,10224,3482,1685,1797
8635,13366,3136,6495,2296,10229,3485,1687,1798
8640,13377,3139,6501,2297,10237,3487,1688,1799
8645,13381,3139,6503,2297,10242,3488,1689,1799
8650,13391,3140,6506,2298,10250,3490,1689,1801
8655,13397,3140,6511,2298,10256,3493,1691,1802
8660,13408,3141,6517,2299,10266,3495,1691,1804
8665,13412,3141,6520,2299,10271,3496,1692,1804
8670,13422,3143,6528,2301,10278,3498,1693,1805
8675,13428,3143,6530,2301,10284,3501,1694,1807
8680,13439,3145,6536,2303,10293,3503,1696,1807
8685,13443,3146,6538,2304,10297,3504,1697,1807
8690,13453,3148,6541,2304,10305,3506,1698,1808
8695,13459,3148,6543,2304,10311,3509,1698,1811
8700,13470,3149,6550,2305,10321,3511,1699,1812
8705,13474,3150,6554,2306,10324,3512,1700,1812
8710,13484,3152,6556,2306,10332,3514,1701,1813
8715,13490,3152,6558,2306,10338,3517,1701,1816
8720,13501,3154,6563,2308,10347,3519,1703,1816
8725,13505,3155,6566,2309,10350,3520,1704,1816
8730,13515,3157,6571,2311,10358,3522,1706,1816
8735,13521,3157,6575,2311,10364,3525,1708,1817
8740,13532,3159,6582,2313,10372,3527,1710,1817
8745,13536,3161,6586,2315,10375,3528,1711,1817
8750,13546,3164,6590,2317,10382,3530,1712,1818
8755,13552,3164,6592,2317,10388,3533,1714,1819
8760,13563,3167,6598,2319,10395,3535,1716,1819
8765,13567,3169,6600,2321,10398,3536,1717,1819
8770,13577,3173,6606,2324,10402,3538,1718,1820
8775,13583,3174,6611,2325,10406,3541,1721,1820
8780,13594,3180,6616,2331,10413,3543,1722,1821
8785,13598,3182,6619,2333,10415,3544,1723,1821
8790,13608,3185,6623,2336,10423,3546,1723,1823
8795,13614,3185,6624,2336,10429,3549,1724,1825
8800,13625,3187,6628,2337,10437,3551,1725,1826
8805,13629,3188,6632,2338,10440,3552,1726,1826
8810,13639,3189,6634,2338,10450,3554,1727,1827
8815,13645,3189,6637,2338,10455,3557,1728,1829
8820,13656,3192,6642,2341,10464,3559,1729,1830
8825,13660,3193,6644,2342,10466,3560,1729,1831
8830,13670,3194,6649,2343,10475,3562,1730,1832
8835,13676,3194,6652,2343,10479,3565,1731,1834
8840,13687,3197,6658,2344,10487,3567,1731,1836
8845,13691,3197,6660,2344,10493,3568,1731,1837
8850,13701,3198,6664,2344,10503,3570,1732,1838
8855,13707,3198,6667,2344,10509,3573,1734,1839
8860,13718,3200,6669,2344,10518,3575,1735,1840
8865,13722,3200,6671,2344,10522,3576,1736,1840
8870,13732,3201,6673,2344,10531,3578,1737,1841
8875,13738,3201,6677,2344,10537,3581,1739,1842
8880,13749,3204,6683,2345,10542,3583,1740,1843
8885,13753,3204,6684,2345,10549,3584,1740,1844
8890,13763,3206,6686,2346,10556,3586,1740,1846
8895,13769,3206,6688,2346,10563,3589,1741,1848
8900,13780,3209,6693,2347,10569,3591,1741,1850
8905,13784,3211,6695,2349,10573,3592,1742,1850
8910,13794,3214,6701,2351,10580,3594,1744,1850
8915,13800,3214,6704,2351,10584,3597,1745,1852
8920,13811,3218,6710,2355,10593,3599,1746,1853
8925,13815,3219,6713,2356,10596,3600,1747,1853
8930,13825,3222,6719,2358,10602,3602,1748,1854
8935,13831,3222,6721,2358,10609,3605,1750,1855
8940,13842,3224,6727,2359,10616,3607,1751,1856
8945,13846,3225,6728,2360,10621,3608,1751,1857
8950,13856,3227,6731,2360,10628,3610,1753,1857
8955,13862,3227,6732,2360,10635,3613,1754,1859
8960,13873,3230,6736,2363,10643,3615,1755,1860
8965,13877,3231,6737,2364,10646,3616,1755,1861
8970,13887,3235,6741,2366,10652,3618,1757,1861
8975,13893,3235,6743,2366,10657,3621,1757,1864
8980,13904,3239,6746,2368,10665,3623,1757,1866
8985,13908,3240,6747,2369,10668,3624,1757,1867
8990,13918,3243,6753,2371,10674,3626,1759,1867
8995,13924,3244,6754,2372,10680,3629,1760,1869
9000,13935,3248,6758,2374,10686,3631,1761,1870
9005,13939,3250,6760,2376,10688,3632,1761,1871
9010,13949,3256,6766,2381,10692,3634,1762,1872
9015,13955,3257,6769,2382,10696,3637,1763,1874
9020,13966,3262,6772,2385,10702,3639,1763,1876
9025,13970,3265,6773,2388,10705,3640,1763,1877
9030,13980,3268,6777,2389,10711,3642,1765,1877
9035,13986,3269,6781,2390,10714,3645,1766,1879
9040,13997,3275,6787,2396,10720,3647,1767,1880
9045,14001,3276,6788,2397,10725,3648,1767,1881
9050,14011,3277,6791,2397,10733,3650,1767,1883
9055,14017,3277,6794,2397,10739,3653,1768,1885
9060,14028,3279,6799,2399,10749,3655,1769,1886
9065,14032,3279,6800,2399,10753,3656,1769,1887
9070,14042,3282,6802,2401,10759,3658,1769,1889
9075,14048,3282,6804,2401,10766,3661,1770,1891
9080,14059,3284,6810,2403,10775,3663,1771,1892
9085,14063,3285,6812,2404,10778,3664,1772,1892
9090,14073,3288,6820,2407,10784,3666,1774,1892
9095,14079,3288,6821,2407,10791,3669,1774,1895
9100,14090,3291,6829,2410,10799,3671,1775,1896
9105,14094,3292,6832,2411,10802,3672,1776,1896
9110,14104,3293,6836,2412,10810,3674,1777,1897
9115,14110,3293,6838,2412,10817,3677,1779,1898
9120,14121,3295,6843,2412,10826,3679,1781,1898
9125,14125,3295,6843,2412,10830,3680,1781,1899
9130,14135,3297,6848,2413,10837,3682,1781,1901
9135,14141,3297,6853,2413,10844,3685,1784,1901
9140,14152,3299,6856,2413,10853,3687,1785,1902
9145,14156,3299,6856,2413,10857,3688,1785,1903
9150,14166,3302,6862,2416,10863,3690,1785,1905
9155,14172,3302,6864,2416,10869,3693,1786,1907
9160,14183,3304,6868,2416,10877,3695,1787,1908
9165,14187,3306,6868,2418,10881,3696,1787,1909
9170,14197,3310,6873,2422,10886,3698,1788,1910
9175,14203,3310,6874,2422,10892,3701,1788,1913
9180,14214,3315,6878,2426,10898,3703,1788,1915
9185,14218,3318,6880,2429,10900,3704,1788,1916
9190,14228,3323,6886,2432,10903,3706,1790,1916
9195,14234,3324,6887,2433,10910,3709,1791,1918
9200,14245,3329,6895,2437,10913,3711,1792,1919
9205,14249,3334,6898,2442,10914,3712,1792,1920
9210,14259,3339,6902,2446,10919,3714,1793,1921
9215,14265,3339,6908,2446,10923,3717,1796,1921
9220,14276,3343,6914,2450,10932,3719,1797,1922
9225,14280,3344,6917,2451,10935,3720,1797,1923
9230,14290,3345,6924,2452,10944,3722,1799,1923
9235,14296,3345,6926,2452,10949,3725,1799,1926
9240,14307,3347,6930,2452,10959,3727,1800,1927
9245,14311,3348,6931,2453,10963,3728,1800,1928
9250,14321,3350,6937,2455,10970,3730,1800,1930
9255,14327,3350,6941,2455,10977,3733,1802,1931
9260,14338,3353,6947,2458,10985,3735,1803,1932
9265,14342,3354,6948,2459,10988,3736,1803,1933
9270,14352,3355,6953,2459,10996,3738,1805,1933
9275,14358,3355,6955,2459,11002,3741,1805,1936
9280,14369,3358,6956,2460,11011,3743,1805,1938
9285,14373,3359,6958,2461,11014,3744,1806,1938
9290,14383,3361,6964,2463,11021,3746,1807,1939
9295,14389,3361,6967,2463,11028,3749,1809,1940
9300,14400,3363,6972,2463,11037,3751,1811,1940
9305,14404,3364,6975,2464,11040,3752,1811,1941
9310,14414,3365,6977,2464,11048,3754,1811,1943
9315,14420,3365,6978,2464,11055,3757,1812,1945
9320,14431,3368,6985,2466,11062,3759,1813,1946
9325,14435,3368,6986,2466,11067,3760,1813,1947
9330,14445,3371,6992,2469,11073,3762,1815,1947
9335,14451,3371,6995,2469,11080,3765,1818,1947
9340,14462,3374,7001,2472,11087,3767,1818,1949
9345,14466,3377,7004,2475,11089,3768,1818,1950
9350,14476,3381,7010,2477,11094,3770,1818,1952
9355,14482,3381,7012,2477,11099,3773,1819,1954
9360,14493,3387,7015,2481,11106,3775,1820,1955
9365,14497,3388,7016,2482,11109,3776,1820,1956
9370,14507,3392,7021,2486,11114,3778,1821,1957
9375,14513,3392,7023,2486,11120,3781,1821,1960
9380,14524,3396,7028,2489,11128,3783,1823,1960
9385,14528,3397,7030,2490,11131,3784,1823,1961
9390,14538,3401,7034,2493,11136,3786,1824,1962
9395,14544,3401,7037,2493,11142,3789,1825,1964
9400,14555,3406,7044,2498,11148,3791,1826,1965
9405,14559,3409,7047,2501,11150,3792,1826,1966
9410,14569,3412,7051,2502,11156,3794,1827,1967
9415,14575,3412,7055,2502,11161,3797,1828,1969
9420,14586,3416,7062,2506,11169,3799,1830,1969
9425,14590,3418,7066,2508,11172,3800,1831,1969
9430,14600,3421,7071,2511,11178,3802,1832,1970
9435,14606,3421,7076,2511,11184,3805,1834,1971
9440,14617,3422,7079,2511,11195,3807,1835,1972
9445,14621,3422,7080,2511,11199,3808,1835,1973
9450,14631,3423,7083,2511,11207,3810,1835,1975
9455,14637,3423,7085,2511,11214,3813,1836,1977
9460,14648,3424,7090,2511,11224,3815,1837,1978
9465,14652,3424,7091,2511,11228,3816,1837,1979
9470,14662,3425,7097,2512,11235,3818,1838,1980
9475,14668,3425,7099,2512,11242,3821,1839,1982
9480,14679,3426,7103,2513,11252,3823,1840,1983
9485,14683,3426,7105,2513,11257,3824,1840,1984
9490,14693,3427,7109,2513,11265,3826,1841,1985
9495,14699,3427,7111,2513,11272,3829,1842,1987
9500,14710,3428,7119,2514,11279,3831,1844,1987
9505,14714,3428,7120,2514,11286,3832,1845,1987
9510,14724,3429,7124,2515,11294,3834,1846,1988
9515,14730,3429,7127,2515,11299,3837,1847,1990
9520,14741,3431,7134,2517,11307,3839,1848,1991
9525,14745,3431,7135,2517,11313,3840,1848,1992
9530,14755,3432,7140,2518,11322,3842,1849,1993
9535,14761,3432,7144,2518,11328,3845,1851,1994
9540,14772,3435,7150,2521,11334,3847,1852,1995
9545,14776,3437,7154,2523,11339,3848,1853,1995
9550,14786,3440,7161,2525,11345,3850,1854,1996
9555,14792,3440,7163,2525,11352,3853,1855,1998
9560,14803,3443,7170,2528,11358,3855,1856,1999
9565,14807,3444,7172,2529,11363,3856,1857,1999
9570,14817,3447,7177,2531,11369,3858,1859,1999
9575,14823,3447,7180,2531,11374,3861,1859,2002
9580,14834,3450,7185,2534,11382,3863,1859,2004
9585,14838,3451,7186,2535,11387,3864,1860,2004
9590,14848,3454,7188,2537,11394,3866,1860,2006
9595,14854,3454,7192,2537,11398,3869,1862,2007
9600,14865,3458,7198,2540,11406,3871,1863,2008
9605,14869,3460,7200,2542,11409,3872,1864,2008
9610,14879,3462,7201,2542,11417,3874,1864,2010
9615,14885,3462,7202,2542,11423,3877,1865,2012
9620,14896,3465,7209,2545,11430,3879,1867,2012
9625,14900,3466,7211,2546,11434,3880,1868,2012
9630,14910,3470,7216,2549,11440,3882,1869,2013
9635,14916,3470,7218,2549,11446,3885,1870,2015
9640,14927,3474,7220,2551,11453,3887,1870,2017
9645,14931,3475,7223,2552,11456,3888,1871,2017
9650,14941,3479,7228,2556,11462,3890,1871,2019
9655,14947,3479,7232,2556,11466,3893,1873,2020
9660,14958,3483,7237,2559,11474,3895,1874,2021
9665,14962,3485,7239,2561,11477,3896,1875,2021
9670,14972,3489,7243,2563,11481,3898,1875,2023
9675,14978,3490,7247,2564,11486,3901,1878,2023
9680,14989,3495,7253,2569,11493,3903,1880,2023
9685,14993,3497,7254,2571,11496,3904,1880,2024
9690,15003,3500,7256,2572,11503,3906,1881,2025
9695,15009,3500,7258,2572,11508,3909,1882,2027
9700,15020,3503,7263,2575,11517,3911,1883,2028
9705,15024,3504,7266,2576,11519,3912,1884,2028
9710,15034,3506,7271,2577,11526,3914,1885,2029
9715,15040,3506,7274,2577,11532,3917,1886,2031
9720,15051,3509,7280,2578,11541,3919,1888,2031
9725,15055,3510,7284,2579,11545,3920,1889,2031
9730,15065,3513,7288,2582,11551,3922,1889,2033
9735,15071,3513,7292,2582,11558,3925,1891,2034
9740,15082,3516,7298,2585,11566,3927,1891,2036
9745,15086,3516,7299,2585,11570,3928,1891,2037
9750,15096,3518,7303,2586,11578,3930,1892,2038
9755,15102,3518,7306,2586,11584,3933,1894,2039
9760,15113,3521,7313,2588,11592,3935,1895,2040
9765,15117,3522,7315,2589,11595,3936,1895,2041
9770,15127,3524,7321,2591,11602,3938,1897,2041
9775,15133,3524,7324,2591,11609,3941,1899,2042
9780,15144,3527,7331,2592,11617,3943,1901,2042
9785,15148,3528,7333,2593,11620,3944,1902,2042
9790,15158,3530,7339,2595,11628,3946,1903,2043
9795,15164,3530,7343,2595,11634,3949,1906,2043
9800,15175,3532,7349,2597,11642,3951,1906,2045
9805,15179,3533,7349,2598,11646,3952,1906,2046
9810,15189,3537,7353,2601,11652,3954,1907,2047
9815,15195,3537,7355,2601,11658,3957,1909,2048
9820,15206,3539,7356,2602,11667,3959,1909,2050
9825,15210,3540,7359,2603,11669,3960,1910,2050
9830,15220,3544,7366,2607,11676,3962,1911,2051
9835,15226,3544,7369,2607,11681,3965,1913,2052
9840,15237,3548,7373,2611,11688,3967,1913,2054
9845,15241,3549,7373,2612,11692,3968,1913,2055
9850,15251,3552,7380,2615,11697,3970,1915,2055
9855,15257,3552,7383,2615,11705,3973,1917,2056
9860,15268,3554,7386,2616,11713,3975,1918,2057
9865,15272,3554,7387,2616,11718,3976,1918,2058
9870,15282,3557,7391,2618,11725,3978,1919,2059
9875,15288,3557,7392,2618,11731,3981,1919,2062
9880,15299,3559,7395,2618,11739,3983,1920,2063
9885,15303,3561,7397,2620,11741,3984,1920,2064
9890,15313,3563,7404,2621,11748,3986,1922,2064
9895,15319,3563,7407,2621,11754,3989,1923,2066
9900,15330,3568,7413,2625,11760,3991,1924,2067
9905,15334,3570,7415,2627,11764,3992,1924,2068
9910,15344,3573,7420,2629,11770,3994,1925,2069
9915,15350,3573,7424,2629,11774,3997,1927,2070
9920,15361,3579,7431,2634,11779,3999,1929,2070
9925,15365,3584,7435,2639,11781,4000,1930,2070
9930,15375,3586,7439,2641,11789,4002,1931,2071
9935,15381,3586,7442,2641,11794,4005,1932,2073
9940,15392,3591,7448,2645,11799,4007,1933,2074
9945,15396,3592,7448,2646,11804,4008,1933,2075
9950,15406,3595,7454,2649,11810,4010,1933,2077
9955,15412,3595,7457,2649,11817,4013,1935,2078
9960,15423,3597,7459,2649,11825,4015,1936,2079
9965,15427,3599,7461,2651,11828,4016,1936,2080
9970,15437,3601,7464,2651,11835,4018,1936,2082
9975,15443,3601,7469,2651,11840,4021,1938,2083
9980,15454,3607,7473,2655,11847,4023,1938,2085
9985,15458,3608,7474,2656,11850,4024,1938,2086
9990,15468,3611,7478,2658,11857,4026,1939,2087
9995,15474,3611,7481,2658,11862,4029,1941,2088
10000,15485,3616,7488,2662,11868,4031,1942,2089
10005,15489,3618,7490,2664,11871,4032,1942,2090
10010,15499,3620,7495,2665,11879,4034,1944,2090
10015,15505,3620,7498,2665,11884,4037,1945,2092
10020,15516,3625,7504,2669,11890,4039,1947,2092
10025,15520,3626,7507,2670,11894,4040,1948,2092
10030,15530,3628,7511,2671,11902,4042,1949,2093
10035,15536,3628,7514,2671,11906,4045,1950,2095
10040,15547,3631,7520,2673,11915,4047,1951,2096
10045,15551,3631,7523,2673,11920,4048,1952,2096
10050,15561,3632,7527,2674,11929,4050,1953,2097
10055,15567,3632,7530,2674,11935,4053,1955,2098
10060,15578,3633,7537,2674,11945,4055,1955,2100
10065,15582,3633,7539,2674,11949,4056,1955,2101
10070,15592,3634,7544,2674,11958,4058,1957,2101
10075,15598,3634,7547,2674,11963,4061,1959,2102
10080,15609,3635,7554,2675,11974,4063,1961,2102
10085,15613,3635,7557,2675,11978,4064,1961,2103
10090,15623,3636,7563,2676,11986,4066,1963,2103
10095,15629,3636,7568,2676,11992,4069,1965,2104
10100,15640,3637,7576,2677,12003,4071,1967,2104
10105,15644,3637,7578,2677,12007,4072,1968,2104
10110,15654,3638,7583,2678,12016,4074,1968,2106
10115,15660,3638,7586,2678,12022,4077,1970,2107
10120,15671,3639,7594,2679,12032,4079,1972,2107
10125,15675,3639,7598,2679,12036,4080,1973,2107
10130,15685,3641,7603,2681,12043,4082,1974,2108
10135,15691,3641,7607,2681,12050,4085,1977,2108
10140,15702,3644,7610,2682,12058,4087,1977,2110
10145,15706,3644,7611,2682,12062,4088,1978,2110
10150,15716,3648,7616,2685,12068,4090,1979,2111
10155,15722,3648,7620,2685,12072,4093,1981,2112
10160,15733,3654,7626,2691,12078,4095,1982,2113
10165,15737,3656,7628,2693,12080,4096,1982,2114
10170,15747,3661,7633,2697,12085,4098,1983,2115
10175,15753,3661,7638,2697,12089,4101,1986,2115
10180,15764,3666,7643,2701,12095,4103,1987,2116
10185,15768,3669,7644,2704,12098,4104,1987,2117
10190,15778,3675,7649,2708,12101,4106,1987,2119
10195,15784,3676,7653,2709,12105,4109,1989,2120
10200,15795,3682,7658,2714,12111,4111,1990,2121
10205,15799,3684,7659,2716,12115,4112,1990,2122
10210,15809,3685,7661,2716,12124,4114,1991,2123
10215,15815,3685,7664,2716,12129,4117,1992,2125
10220,15826,3688,7673,2719,12136,4119,1994,2125
10225,15830,3688,7675,2719,12142,4120,1995,2125
10230,15840,3691,7680,2722,12149,4122,1995,2127
10235,15846,3691,7683,2722,12155,4125,1996,2129
10240,15857,3694,7689,2725,12161,4127,1996,2131
10245,15861,3695,7692,2726,12166,4128,1997,2131
10250,15871,3698,7699,2729,12171,4130,1998,2132
10255,15877,3698,7702,2729,12178,4133,1998,2135
10260,15888,3701,7705,2730,12187,4135,1999,2136
10265,15892,3701,7706,2730,12191,4136,2000,2136
10270,15902,3702,7710,2730,12199,4138,2000,2138
10275,15908,3702,7714,2730,12206,4141,2002,2139
10280,15919,3704,7718,2731,12213,4143,2003,2140
10285,15923,3704,7719,2731,12219,4144,2004,2140
10290,15933,3705,7722,2732,12227,4146,2005,2141
10295,15939,3705,7725,2732,12233,4149,2006,2143
10300,15950,3708,7730,2733,12241,4151,2007,2144
10305,15954,3708,7731,2733,12246,4152,2007,2145
10310,15964,3710,7736,2735,12254,4154,2008,2146
10315,15970,3710,7739,2735,12259,4157,2010,2147
10320,15981,3715,7747,2740,12265,4159,2011,2148
10325,15985,3717,7750,2742,12268,4160,2011,2149
10330,15995,3720,7758,2745,12275,4162,2013,2149
10335,16001,3720,7759,2745,12281,4165,2013,2152
10340,16012,3724,7767,2749,12287,4167,2015,2152
10345,16016,3726,7769,2751,12290,4168,2015,2153
10350,16026,3730,7776,2753,12295,4170,2017,2153
10355,16032,3730,7779,2753,12301,4173,2018,2155
10360,16043,3734,7783,2756,12308,4175,2018,2157
10365,16047,3737,7786,2759,12310,4176,2018,2158
10370,16057,3741,7793,2762,12315,4178,2020,2158
10375,16063,3741,7795,2762,12322,4181,2022,2159
10380,16074,3744,7800,2765,12329,4183,2022,2161
10385,16078,3746,7801,2767,12332,4184,2022,2162
10390,16088,3752,7808,2772,12335,4186,2022,2164
10395,16094,3752,7812,2772,12341,4189,2024,2165
10400,16105,3755,7818,2774,12349,4191,2025,2166
10405,16109,3756,7821,2775,12353,4192,2026,2166
10410,16119,3759,7825,2777,12360,4194,2027,2167
10415,16125,3759,7829,2777,12365,4197,2029,2168
10420,16136,3763,7839,2781,12372,4199,2031,2168
10425,16140,3764,7841,2782,12376,4200,2032,2168
10430,16150,3767,7847,2784,12382,4202,2033,2169
10435,16156,3767,7852,2784,12387,4205,2035,2170
10440,16167,3768,7857,2785,12397,4207,2037,2170
10445,16171,3768,7857,2785,12403,4208,2037,2171
10450,16181,3769,7861,2786,12412,4210,2038,2172
10455,16187,3769,7863,2786,12417,4213,2039,2174
10460,16198,3770,7866,2786,12428,4215,2040,2175
10465,16202,3770,7868,2786,12432,4216,2040,2176
10470,16212,3771,7873,2786,12440,4218,2040,2178
10475,16218,3771,7879,2786,12445,4221,2043,2178
10480,16229,3772,7884,2787,12456,4223,2045,2178
10485,16233,3772,7886,2787,12461,4224,2046,2178
10490,16243,3773,7890,2788,12469,4226,2046,2180
10495,16249,3773,7893,2788,12476,4229,2048,2181
10500,16260,3775,7899,2789,12482,4231,2049,2182
10505,16264,3775,7901,2789,12489,4232,2050,2182
10510,16274,3776,7904,2789,12497,4234,2051,2183
10515,16280,3776,7907,2789,12503,4237,2052,2185
10520,16291,3779,7912,2791,12511,4239,2053,2186
10525,16295,3780,7915,2792,12515,4240,2054,2186
10530,16305,3783,7920,2794,12521,4242,2054,2188
10535,16311,3783,7923,2794,12527,4245,2056,2189
10540,16322,3788,7930,2799,12533,4247,2058,2189
10545,16326,3789,7931,2800,12537,4248,2058,2190
10550,16336,3792,7937,2801,12544,4250,2060,2190
10555,16342,3792,7941,2801,12549,4253,2062,2191
10560,16353,3796,7944,2803,12556,4255,2063,2192
10565,16357,3797,7946,2804,12560,4256,2064,2192
10570,16367,3799,7951,2805,12567,4258,2065,2193
10575,16373,3799,7954,2805,12572,4261,2066,2195
10580,16384,3804,7959,2809,12579,4263,2066,2197
10585,16388,3805,7962,2810,12583,4264,2066,2198
10590,16398,3807,7967,2811,12591,4266,2067,2199
10595,16404,3807,7971,2811,12596,4269,2070,2199
10600,16415,3810,7977,2813,12604,4271,2072,2199
10605,16419,3810,7978,2813,12609,4272,2072,2200
10610,16429,3814,7985,2816,12615,4274,2074,2200
10615,16435,3814,7986,2816,12621,4277,2075,2202
10620,16446,3816,7990,2817,12629,4279,2076,2203
10625,16450,3818,7994,2819,12632,4280,2077,2203
10630,16460,3821,7998,2821,12639,4282,2078,2204
10635,16466,3821,8001,2821,12645,4285,2080,2205
10640,16477,3825,8007,2824,12652,4287,2081,2206
10645,16481,3826,8010,2825,12655,4288,2082,2206
10650,16491,3829,8013,2826,12661,4290,2082,2208
10655,16497,3829,8015,2826,12668,4293,2082,2211
10660,16508,3832,8019,2827,12675,4295,2083,2212
10665,16512,3834,8020,2829,12678,4296,2083,2213
10670,16522,3837,8027,2831,12684,4298,2085,2213
10675,16528,3837,8028,2831,12691,4301,2086,2215
10680,16539,3840,8032,2832,12699,4303,2087,2216
10685,16543,3840,8033,2832,12703,4304,2087,2217
10690,16553,3844,8040,2835,12709,4306,2089,2217
10695,16559,3844,8044,2835,12715,4309,2091,2218
10700,16570,3847,8048,2837,12723,4311,2091,2220
10705,16574,3849,8052,2839,12725,4312,2092,2220
10710,16584,3852,8054,2840,12732,4314,2092,2222
10715,16590,3852,8058,2840,12737,4317,2094,2223
10720,16601,3855,8060,2841,12746,4319,2095,2224
10725,16605,3856,8063,2842,12749,4320,2096,2224
10730,16615,3860,8068,2844,12753,4322,2097,2225
10735,16621,3861,8070,2845,12758,4325,2098,2227
10740,16632,3867,8075,2850,12764,4327,2099,2228
10745,16636,3869,8076,2852,12767,4328,2099,2229
10750,16646,3873,8082,2856,12771,4330,2099,2231
10755,16652,3874,8084,2857,12775,4333,2099,2234
10760,16663,3879,8090,2860,12783,4335,2101,2234
10765,16667,3879,8091,2860,12788,4336,2101,2235
10770,16677,3881,8096,2862,12795,4338,2103,2235
10775,16683,3881,8100,2862,12800,4341,2104,2237
10780,16694,3883,8105,2863,12810,4343,2105,2238
10785,16698,3883,8105,2863,12815,4344,2105,2239
10790,16708,3884,8108,2863,12824,4346,2106,2240
10795,16714,3884,8111,2863,12829,4349,2108,2241
10800,16725,3886,8114,2863,12839,4351,2109,2242
10805,16729,3886,8114,2863,12843,4352,2109,2243
10810,16739,3888,8118,2864,12850,4354,2109,2245
10815,16745,3888,8120,2864,12857,4357,2110,2247
10820,16756,3891,8125,2865,12864,4359,2111,2248
10825,16760,3892,8129,2866,12867,4360,2112,2248
10830,16770,3893,8131,2866,12876,4362,2112,2250
10835,16776,3893,8134,2866,12883,4365,2114,2251
10840,16787,3896,8139,2868,12891,4367,2115,2252
10845,16791,3896,8140,2868,12895,4368,2116,2252
10850,16801,3898,8145,2870,12902,4370,2116,2254
10855,16807,3898,8148,2870,12909,4373,2117,2256
10860,16818,3901,8154,2872,12916,4375,2119,2256
10865,16822,3901,8157,2872,12921,4376,2120,2256
10870,16832,3904,8162,2874,12928,4378,2121,2257
10875,16838,3904,8165,2874,12933,4381,2122,2259
10880,16849,3907,8169,2876,12942,4383,2124,2259
10885,16853,3908,8172,2877,12945,4384,2125,2259
10890,16863,3911,8175,2878,12952,4386,2125,2261
10895,16869,3911,8178,2878,12958,4389,2127,2262
10900,16880,3914,8183,2880,12964,4391,2128,2263
10905,16884,3914,8185,2880,12970,4392,2128,2264
10910,16894,3918,8191,2883,12976,4394,2130,2264
10915,16900,3918,8193,2883,12981,4397,2131,2266
10920,16911,3924,8200,2888,12987,4399,2132,2267
10925,16915,3925,8203,2889,12990,4400,2133,2267
10930,16925,3927,8208,2891,12997,4402,2134,2268
10935,16931,3927,8211,2891,13003,4405,2135,2270
10940,16942,3931,8215,2893,13011,4407,2136,2271
10945,16946,3932,8216,2894,13014,4408,2136,2272
10950,16956,3935,8221,2896,13021,4410,2136,2274
10955,16962,3935,8225,2896,13026,4413,2138,2275
10960,16973,3940,8229,2899,13033,4415,2139,2276
10965,16977,3941,8231,2900,13036,4416,2140,2276
10970,16987,3945,8236,2904,13042,4418,2140,2278
10975,16993,3945,8239,2904,13047,4421,2142,2279
10980,17004,3949,8244,2907,13055,4423,2143,2280
10985,17008,3950,8246,2908,13058,4424,2144,2280
10990,17018,3954,8251,2911,13064,4426,2145,2281
10995,17024,3954,8253,2911,13070,4429,2146,2283
11000,17035,3957,8258,2913,13077,4431,2147,2284
11005,17039,3958,8260,2914,13081,4432,2148,2284
11010,17049,3962,8266,2917,13087,4434,2150,2284
11015,17055,3962,8269,2917,13092,4437,2152,2285
11020,17066,3966,8276,2921,13100,4439,2153,2286
11025,17070,3966,8278,2921,13103,4440,2154,2286
11030,17080,3971,8284,2926,13108,4442,2155,2287
11035,17086,3971,8287,2926,13112,4445,2156,2289
11040,17097,3976,8293,2931,13120,4447,2156,2291
11045,17101,3977,8296,2932,13123,4448,2157,2291
11050,17111,3979,8302,2934,13131,4450,2158,2292
11055,17117,3979,8305,2934,13136,4453,2160,2293
11060,17128,3982,8310,2936,13146,4455,2160,2295
11065,17132,3982,8311,2936,13150,4456,2160,2296
11070,17142,3984,8315,2937,13157,4458,2160,2298
11075,17148,3984,8318,2937,13163,4461,2161,2300
11080,17159,3987,8322,2939,13171,4463,2162,2301
11085,17163,3988,8326,2940,13174,4464,2163,2301
11090,17173,3990,8333,2941,13181,4466,2165,2301
11095,17179,3990,8338,2941,13188,4469,2168,2301
11100,17190,3992,8343,2941,13197,4471,2169,2302
11105,17194,3993,8347,2942,13200,4472,2170,2302
11110,17204,3994,8350,2943,13209,4474,2170,2304
11115,17210,3994,8353,2943,13216,4477,2172,2305
11120,17221,3995,8356,2943,13226,4479,2173,2306
11125,17225,3995,8357,2943,13230,4480,2173,2307
11130,17235,3996,8362,2944,13239,4482,2174,2308
11135,17241,3996,8364,2944,13245,4485,2175,2310
11140,17252,3997,8369,2944,13254,4487,2176,2311
11145,17256,3997,8371,2944,13258,4488,2176,2312
11150,17266,3999,8372,2945,13266,4490,2176,2314
11155,17272,3999,8376,2945,13272,4493,2178,2315
11160,17283,4001,8380,2947,13281,4495,2178,2317
11165,17287,4001,8381,2947,13286,4496,2178,2318
11170,17297,4003,8386,2948,13293,4498,2179,2319
11175,17303,4003,8389,2948,13299,4501,2180,2321
11180,17314,4005,8394,2949,13307,4503,2181,2322
11185,17318,4006,8398,2950,13312,4504,2182,2322
11190,17328,4008,8404,2951,13319,4506,2184,2322
11195,17334,4008,8407,2951,13325,4509,2186,2323
11200,17345,4011,8411,2954,13333,4511,2186,2325
11205,17349,4012,8413,2955,13337,4512,2186,2326
11210,17359,4015,8417,2957,13343,4514,2186,2328
11215,17365,4015,8418,2957,13350,4517,2187,2330
11220,17376,4019,8421,2959,13357,4519,2188,2331
11225,17380,4019,8422,2959,13361,4520,2188,2332
11230,17390,4021,8425,2959,13368,4522,2189,2333
11235,17396,4021,8426,2959,13375,4525,2190,2335
11240,17407,4025,8432,2963,13382,4527,2191,2336
11245,17411,4025,8434,2963,13386,4528,2192,2336
11250,17421,4028,8441,2965,13392,4530,2194,2336
11255,17427,4028,8442,2965,13399,4533,2194,2339
11260,17438,4030,8448,2967,13407,4535,2194,2341
11265,17442,4032,8450,2969,13410,4536,2195,2341
11270,17452,4037,8455,2972,13414,4538,2196,2342
11275,17458,4037,8457,2972,13419,4541,2196,2345
11280,17469,4041,8461,2975,13427,4543,2197,2346
11285,17473,4043,8462,2977,13430,4544,2197,2347
11290,17483,4047,8469,2981,13435,4546,2198,2348
11295,17489,4047,8473,2981,13441,4549,2201,2348
11300,17500,4051,8476,2984,13449,4551,2201,2350
11305,17504,4053,8479,2986,13451,4552,2202,2350
11310,17514,4059,8485,2991,13454,4554,2202,2352
11315,17520,4059,8487,2991,13461,4557,2203,2354
11320,17531,4063,8490,2993,13468,4559,2203,2356
11325,17535,4065,8494,2995,13470,4560,2204,2356
11330,17545,4069,8499,2997,13475,4562,2206,2356
11335,17551,4069,8502,2997,13480,4565,2208,2357
11340,17562,4073,8506,3000,13487,4567,2209,2358
11345,17566,4074,8509,3001,13492,4568,2210,2358
11350,17576,4076,8515,3003,13498,4570,2210,2360
11355,17582,4076,8519,3003,13503,4573,2211,2362
11360,17593,4078,8523,3004,13515,4575,2212,2363
11365,17597,4079,8525,3005,13517,4576,2212,2364
11370,17607,4080,8532,3006,13525,4578,2214,2364
11375,17613,4080,8536,3006,13531,4581,2217,2364
11380,17624,4082,8539,3007,13541,4583,2217,2366
11385,17628,4082,8540,3007,13546,4584,2218,2366
11390,17638,4084,8545,3009,13552,4586,2219,2367
11395,17644,4084,8548,3009,13559,4589,2221,2368
11400,17655,4087,8556,3011,13566,4591,2223,2368
11405,17659,4087,8558,3011,13571,4592,2223,2369
11410,17669,4089,8562,3012,13579,4594,2224,2370
11415,17675,4089,8565,3012,13585,4597,2226,2371
11420,17686,4091,8571,3013,13594,4599,2227,2372
11425,17690,4091,8571,3013,13599,4600,2227,2373
11430,17700,4093,8574,3015,13606,4602,2228,2374
11435,17706,4093,8578,3015,13612,4605,2229,2376
11440,17717,4095,8583,3016,13620,4607,2230,2377
11445,17721,4096,8585,3017,13625,4608,2231,2377
11450,17731,4100,8590,3021,13630,4610,2231,2379
11455,17737,4100,8593,3021,13637,4613,2233,2380
11460,17748,4103,8597,3022,13644,4615,2234,2381
11465,17752,4104,8598,3023,13648,4616,2234,2382
11470,17762,4107,8603,3026,13654,4618,2235,2383
11475,17768,4107,8606,3026,13660,4621,2235,2386
11480,17779,4110,8611,3028,13669,4623,2236,2387
11485,17783,4110,8612,3028,13673,4624,2236,2388
11490,17793,4113,8617,3029,13679,4626,2238,2388
11495,17799,4113,8618,3029,13686,4629,2238,2391
11500,17810,4116,8624,3031,13694,4631,2240,2391
11505,17814,4116,8627,3031,13698,4632,2241,2391
11510,17824,4118,8631,3031,13705,4634,2242,2392
11515,17830,4118,8633,3031,13712,4637,2243,2394
11520,17841,4121,8638,3033,13720,4639,2244,2395
11525,17845,4123,8642,3035,13722,4640,2245,2395
11530,17855,4126,8646,3036,13728,4642,2245,2397
11535,17861,4126,8650,3036,13734,4645,2247,2398
11540,17872,4132,8655,3040,13740,4647,2248,2399
11545,17876,4132,8657,3040,13744,4648,2249,2399
11550,17886,4137,8663,3044,13748,4650,2249,2401
11555,17892,4137,8667,3044,13753,4653,2251,2402
11560,17903,4143,8674,3048,13759,4655,2252,2403
11565,17907,4144,8674,3049,13763,4656,2252,2404
11570,17917,4149,8678,3053,13767,4658,2252,2406
11575,17923,4149,8681,3053,13772,4661,2253,2408
11580,17934,4155,8688,3058,13776,4663,2254,2409
11585,17938,4159,8691,3062,13778,4664,2255,2409
11590,17948,4161,8695,3064,13786,4666,2256,2410
11595,17954,4161,8698,3064,13791,4669,2258,2411
11600,17965,4163,8705,3065,13799,4671,2259,2412
11605,17969,4164,8708,3066,13804,4672,2260,2412
11610,17979,4165,8713,3066,13812,4674,2260,2414
11615,17985,4165,8716,3066,13820,4677,2262,2415
11620,17996,4168,8723,3068,13826,4679,2262,2417
11625,18000,4169,8725,3069,13830,4680,2262,2418
11630,18010,4172,8730,3072,13837,4682,2263,2419
11635,18016,4172,8735,3072,13843,4685,2265,2420
11640,18027,4175,8743,3073,13850,4687,2267,2420
11645,18031,4175,8745,3073,13856,4688,2267,2421
11650,18041,4176,8750,3074,13864,4690,2268,2422
11655,18047,4176,8754,3074,13870,4693,2269,2424
11660,18058,4178,8759,3075,13880,4695,2270,2425
11665,18062,4179,8762,3076,13883,4696,2271,2425
11670,18072,4181,8769,3077,13890,4698,2272,2426
11675,18078,4181,8772,3077,13897,4701,2274,2427
11680,18089,4183,8774,3077,13905,4703,2274,2429
11685,18093,4183,8774,3077,13910,4704,2274,2430
11690,18103,4185,8777,3078,13918,4706,2276,2430
11695,18109,4185,8782,3078,13924,4709,2279,2430
11700,18120,4188,8786,3080,13932,4711,2279,2432
11705,18124,4189,8789,3081,13935,4712,2280,2432
11710,18134,4192,8793,3082,13941,4714,2280,2434
11715,18140,4192,8797,3082,13947,4717,2282,2435
11720,18151,4196,8802,3085,13955,4719,2283,2436
11725,18155,4198,8806,3087,13957,4720,2284,2436
11730,18165,4202,8809,3089,13963,4722,2285,2437
11735,18171,4202,8809,3089,13969,4725,2285,2440
11740,18182,4206,8815,3092,13975,4727,2286,2441
11745,18186,4208,8817,3094,13978,4728,2286,2442
11750,18196,4212,8823,3096,13984,4730,2288,2442
11755,18202,4212,8828,3096,13989,4733,2291,2442
11760,18213,4217,8832,3100,13996,4735,2291,2444
11765,18217,4218,8834,3101,13999,4736,2291,2445
11770,18227,4221,8840,3102,14005,4738,2292,2446
11775,18233,4221,8845,3102,14011,4741,2295,2446
11780,18244,4224,8850,3104,14020,4743,2297,2446
11785,18248,4225,8853,3105,14023,4744,2298,2446
11790,18258,4229,8858,3107,14027,4746,2298,2448
11795,18264,4230,8860,3108,14032,4749,2299,2450
11800,18275,4233,8867,3111,14038,4751,2301,2450
11805,18279,4237,8869,3115,14041,4752,2301,2451
11810,18289,4240,8872,3116,14049,4754,2303,2451
11815,18295,4240,8873,3116,14055,4757,2304,2453
11820,18306,4242,8878,3117,14062,4759,2305,2454
11825,18310,4243,8878,3118,14067,4760,2305,2455
11830,18320,4244,8884,3119,14076,4762,2307,2455
11835,18326,4244,8888,3119,14080,4765,2308,2457
11840,18337,4245,8893,3120,14090,4767,2309,2458
11845,18341,4245,8896,3120,14095,4768,2309,2459
11850,18351,4246,8900,3121,14105,4770,2310,2460
11855,18357,4246,8904,3121,14109,4773,2311,2462
11860,18368,4247,8910,3122,14119,4775,2312,2463
11865,18372,4247,8913,3122,14124,4776,2313,2463
11870,18382,4249,8918,3124,14133,4778,2314,2464
11875,18388,4249,8923,3124,14137,4781,2316,2465
11880,18399,4252,8930,3126,14146,4783,2318,2465
11885,18403,4253,8932,3127,14150,4784,2318,2466
11890,18413,4255,8938,3128,14157,4786,2319,2467
11895,18419,4255,8943,3128,14163,4789,2321,2468
11900,18430,4258,8950,3130,14171,4791,2323,2468
11905,18434,4259,8951,3131,14175,4792,2323,2469
11910,18444,4261,8956,3133,14183,4794,2324,2470
11915,18450,4261,8960,3133,14188,4797,2325,2472
11920,18461,4263,8967,3134,14197,4799,2326,2473
11925,18465,4264,8968,3135,14201,4800,2326,2474
11930,18475,4267,8971,3137,14208,4802,2326,2476
11935,18481,4267,8974,3137,14213,4805,2328,2477
11940,18492,4271,8978,3140,14221,4807,2329,2478
11945,18496,4272,8980,3141,14224,4808,2330,2478
11950,18506,4275,8985,3142,14230,4810,2331,2479
11955,18512,4275,8989,3142,14236,4813,2333,2480
11960,18523,4279,8993,3145,14243,4815,2334,2481
11965,18527,4280,8994,3146,14247,4816,2335,2481
11970,18537,4283,8999,3149,14254,4818,2336,2482
11975,18543,4283,9001,3149,14260,4821,2338,2483
11980,18554,4285,9005,3149,14268,4823,2339,2484
11985,18558,4286,9007,3150,14272,4824,2339,2485
11990,18568,4290,9014,3153,14277,4826,2340,2486
11995,18574,4290,9019,3153,14283,4829,2343,2486
12000,18585,4294,9025,3156,14289,4831,2344,2487
12005,18589,4297,9027,3159,14292,4832,2344,2488
12010,18599,4301,9032,3162,14298,4834,2345,2489
12015,18605,4301,9034,3162,14304,4837,2347,2490
12020,18616,4304,9038,3164,14311,4839,2347,2492
12025,18620,4306,9041,3166,14314,4840,2348,2492
12030,18630,4309,9044,3168,14321,4842,2349,2493
12035,18636,4309,9046,3168,14327,4845,2351,2494
12040,18647,4313,9053,3170,14333,4847,2352,2495
12045,18651,4315,9056,3172,14336,4848,2353,2495
12050,18661,4319,9060,3175,14342,4850,2354,2496
12055,18667,4319,9064,3175,14346,4853,2355,2498
12060,18678,4326,9072,3181,14352,4855,2357,2498
12065,18682,4326,9072,3181,14356,4856,2357,2499
12070,18692,4332,9076,3185,14360,4858,2357,2501
12075,18698,4332,9078,3185,14365,4861,2358,2503
12080,18709,4336,9082,3187,14373,4863,2359,2504
12085,18713,4336,9083,3187,14377,4864,2359,2505
12090,18723,4340,9088,3190,14382,4866,2360,2506
12095,18729,4340,9093,3190,14387,4869,2362,2507
12100,18740,4345,9101,3195,14395,4871,2363,2508
12105,18744,4346,9104,3196,14398,4872,2364,2508
12110,18754,4348,9109,3197,14405,4874,2366,2508
12115,18760,4348,9113,3197,14410,4877,2367,2510
12120,18771,4351,9115,3198,14420,4879,2368,2511
12125,18775,4351,9117,3198,14424,4880,2368,2512
12130,18785,4352,9119,3198,14432,4882,2368,2514
12135,18791,4352,9123,3198,14437,4885,2370,2515
12140,18802,4353,9132,3199,14446,4887,2372,2515
12145,18806,4353,9133,3199,14452,4888,2372,2516
12150,18816,4354,9137,3200,14462,4890,2373,2517
12155,18822,4354,9139,3200,14467,4893,2373,2520
12160,18833,4355,9142,3200,14478,4895,2374,2521
12165,18837,4355,9144,3200,14482,4896,2375,2521
12170,18847,4356,9152,3200,14489,4898,2377,2521
12175,18853,4356,9156,3200,14496,4901,2380,2521
12180,18864,4357,9162,3201,14505,4903,2382,2521
12185,18868,4357,9164,3201,14511,4904,2382,2522
12190,18878,4358,9172,3202,14519,4906,2384,2522
12195,18884,4358,9176,3202,14525,4909,2386,2523
12200,18895,4359,9179,3203,14536,4911,2387,2524
12205,18899,4359,9181,3203,14540,4912,2387,2525
12210,18909,4361,9189,3205,14548,4914,2389,2525
12215,18915,4361,9191,3205,14553,4917,2389,2528
12220,18926,4363,9195,3207,14562,4919,2390,2529
12225,18930,4363,9197,3207,14567,4920,2391,2529
12230,18940,4366,9201,3208,14574,4922,2393,2529
12235,18946,4366,9206,3208,14578,4925,2395,2530
12240,18957,4370,9209,3210,14586,4927,2395,2532
12245,18961,4371,9210,3211,14590,4928,2395,2533
12250,18971,4375,9217,3214,14595,4930,2396,2534
12255,18977,4375,9220,3214,14601,4933,2397,2536
12260,18988,4379,9226,3218,14608,4935,2398,2537
12265,18992,4380,9228,3219,14612,4936,2399,2537
12270,19002,4382,9230,3219,14619,4938,2399,2539
12275,19008,4382,9231,3219,14625,4941,2399,2542
12280,19019,4386,9236,3222,14632,4943,2400,2543
12285,19023,4387,9238,3223,14636,4944,2401,2543
12290,19033,4389,9243,3224,14643,4946,2402,2544
12295,19039,4389,9246,3224,14650,4949,2404,2545
12300,19050,4393,9252,3227,14656,4951,2406,2545
12305,19054,4394,9254,3228,14660,4952,2407,2545
12310,19064,4397,9256,3229,14667,4954,2407,2547
12315,19070,4397,9259,3229,14672,4957,2408,2549
12320,19081,4401,9266,3232,14679,4959,2410,2549
12325,19085,4402,9267,3233,14683,4960,2410,2550
12330,19095,4407,9276,3237,14687,4962,2412,2550
12335,19101,4407,9279,3237,14694,4965,2414,2551
12340,19112,4409,9283,3238,14703,4967,2415,2552
12345,19116,4409,9284,3238,14707,4968,2415,2553
12350,19126,4414,9292,3243,14711,4970,2416,2554
12355,19132,4414,9295,3243,14718,4973,2418,2555
12360,19143,4417,9302,3246,14725,4975,2420,2555
12365,19147,4418,9303,3247,14729,4976,2421,2555
12370,19157,4421,9306,3248,14735,4978,2422,2556
12375,19163,4421,9309,3248,14740,4981,2422,2559
12380,19174,4425,9312,3251,14749,4983,2423,2560
12385,19178,4427,9314,3253,14751,4984,2423,2561
12390,19188,4432,9321,3258,14755,4986,2424,2562
12395,19194,4432,9326,3258,14760,4989,2426,2563
12400,19205,4438,9333,3263,14766,4991,2427,2564
12405,19209,4440,9334,3265,14769,4992,2427,2565
12410,19219,4443,9339,3268,14774,4994,2427,2567
12415,19225,4444,9342,3269,14779,4997,2429,2568
12420,19236,4448,9346,3271,14786,4999,2430,2569
12425,19240,4448,9346,3271,14792,5000,2430,2570
12430,19250,4449,9350,3271,14800,5002,2431,2571
12435,19256,4449,9353,3271,14806,5005,2432,2573
12440,19267,4452,9358,3273,14815,5007,2433,2574
12445,19271,4452,9360,3273,14819,5008,2434,2574
12450,19281,4454,9365,3274,14827,5010,2435,2575
12455,19287,4454,9368,3274,14831,5013,2436,2577
12460,19298,4457,9371,3275,14841,5015,2436,2579
12465,19302,4458,9373,3276,14844,5016,2436,2580
12470,19312,4460,9377,3277,14850,5018,2437,2581
12475,19318,4460,9380,3277,14856,5021,2438,2583
12480,19329,4462,9385,3277,14866,5023,2439,2584
12485,19333,4462,9388,3277,14870,5024,2440,2584
12490,19343,4464,9394,3279,14878,5026,2442,2584
12495,19349,4464,9397,3279,14885,5029,2443,2586
12500,19360,4467,9402,3281,14891,5031,2443,2588
12505,19364,4467,9403,3281,14896,5032,2443,2589
12510,19374,4470,9409,3283,14903,5034,2443,2591
12515,19380,4470,9412,3283,14909,5037,2443,2594
12520,19391,4472,9417,3285,14917,5039,2443,2596
12525,19395,4473,9418,3286,14922,5040,2443,2597
12530,19405,4476,9423,3288,14929,5042,2444,2598
12535,19411,4476,9426,3288,14934,5045,2445,2600
12540,19422,4479,9433,3290,14941,5047,2447,2600
12545,19426,4481,9434,3292,14945,5048,2447,2601
12550,19436,4485,9439,3294,14951,5050,2448,2602
12555,19442,4485,9443,3294,14956,5053,2450,2603
12560,19453,4488,9449,3296,14964,5055,2451,2604
12565,19457,4489,9452,3297,14968,5056,2452,2604
12570,19467,4492,9456,3299,14974,5058,2452,2606
12575,19473,4492,9460,3299,14980,5061,2454,2607
12580,19484,4495,9464,3300,14989,5063,2455,2608
12585,19488,4496,9467,3301,14992,5064,2456,2608
12590,19498,4498,9472,3303,15000,5066,2457,2609
12595,19504,4498,9473,3303,15005,5069,2457,2612
12600,19515,4503,9478,3307,15011,5071,2457,2614
12605,19519,4506,9481,3310,15013,5072,2457,2615
12610,19529,4509,9487,3312,15019,5074,2458,2616
12615,19535,4509,9490,3312,15026,5077,2461,2616
12620,19546,4513,9496,3314,15032,5079,2462,2617
12625,19550,4516,9499,3317,15034,5080,2463,2617
12630,19560,4518,9502,3318,15042,5082,2464,2618
12635,19566,4518,9505,3318,15047,5085,2465,2620
12640,19577,4522,9510,3321,15054,5087,2466,2621
12645,19581,4524,9513,3323,15057,5088,2467,2621
12650,19591,4528,9517,3325,15063,5090,2468,2622
12655,19597,4528,9520,3325,15068,5093,2469,2624
12660,19608,4533,9525,3330,15075,5095,2469,2626
12665,19612,4533,9526,3330,15079,5096,2470,2626
12670,19622,4536,9529,3331,15086,5098,2472,2626
12675,19628,4536,9533,3331,15091,5101,2475,2626
12680,19639,4540,9540,3334,15098,5103,2476,2627
12685,19643,4541,9541,3335,15102,5104,2476,2628
12690,19653,4543,9544,3336,15110,5106,2476,2630
12695,19659,4543,9548,3336,15114,5109,2478,2631
12700,19670,4547,9554,3339,15120,5111,2478,2633
12705,19674,4549,9556,3341,15124,5112,2478,2634
12710,19684,4550,9559,3341,15133,5114,2479,2635
12715,19690,4550,9563,3341,15138,5117,2481,2636
12720,19701,4551,9570,3341,15148,5119,2482,2637
12725,19705,4551,9571,3341,15154,5120,2483,2637
12730,19715,4552,9577,3342,15161,5122,2485,2637
12735,19721,4552,9578,3342,15168,5125,2486,2639
12740,19732,4553,9585,3342,15176,5127,2487,2640
12745,19736,4553,9587,3342,15183,5128,2488,2640
12750,19746,4554,9595,3343,15191,5130,2489,2641
12755,19752,4554,9599,3343,15198,5133,2492,2641
12760,19763,4555,9604,3344,15207,5135,2493,2642
12765,19767,4555,9605,3344,15211,5136,2493,2643
12770,19777,4556,9610,3345,15220,5138,2493,2645
12775,19783,4556,9613,3345,15227,5141,2495,2646
12780,19794,4558,9617,3345,15235,5143,2496,2647
12785,19798,4558,9620,3345,15240,5144,2497,2647
12790,19808,4561,9627,3348,15246,5146,2498,2648
12795,19814,4561,9630,3348,15252,5149,2500,2649
12800,19825,4564,9634,3350,15261,5151,2501,2650
12805,19829,4564,9636,3350,15265,5152,2502,2650
12810,19839,4567,9641,3352,15272,5154,2503,2651
12815,19845,4567,9645,3352,15276,5157,2505,2652
12820,19856,4571,9651,3355,15284,5159,2506,2653
12825,19860,4571,9653,3355,15289,5160,2506,2654
12830,19870,4575,9659,3359,15295,5162,2507,2655
12835,19876,4575,9662,3359,15301,5165,2510,2655
12840,19887,4577,9666,3360,15309,5167,2511,2656
12845,19891,4579,9669,3362,15312,5168,2511,2657
12850,19901,4582,9674,3364,15319,5170,2513,2657
12855,19907,4582,9676,3364,15324,5173,2514,2659
12860,19918,4585,9680,3366,15333,5175,2515,2660
12865,19922,4587,9682,3368,15335,5176,2515,2661
12870,19932,4589,9686,3369,15343,5178,2517,2661
12875,19938,4589,9689,3369,15349,5181,2519,2662
12880,19949,4592,9693,3372,15357,5183,2520,2663
12885,19953,4593,9696,3373,15360,5184,2521,2663
12890,19963,4595,9698,3373,15367,5186,2521,2665
12895,19969,4595,9701,3373,15372,5189,2522,2667
12900,19980,4599,9707,3377,15381,5191,2524,2667
12905,19984,4599,9709,3377,15385,5192,2525,2667
12910,19994,4601,9711,3377,15392,5194,2525,2669
12915,20000,4601,9714,3377,15398,5197,2527,2670
12920,20011,4605,9720,3381,15405,5199,2528,2671
12925,20015,4607,9722,3383,15408,5200,2528,2672
12930,20025,4612,9728,3387,15413,5202,2529,2673
12935,20031,4612,9730,3387,15419,5205,2530,2675
12940,20042,4615,9735,3389,15426,5207,2531,2676
12945,20046,4616,9737,3390,15429,5208,2532,2676
12950,20056,4620,9743,3394,15434,5210,2533,2677
12955,20062,4621,9748,3395,15437,5213,2535,2678
12960,20073,4628,9754,3401,15443,5215,2537,2678
12965,20077,4631,9756,3404,15446,5216,2538,2678
12970,20087,4636,9762,3408,15449,5218,2538,2680
12975,20093,4637,9765,3409,15452,5221,2538,2683
12980,20104,4641,9772,3412,15462,5223,2539,2684
12985,20108,4642,9773,3413,15466,5224,2539,2685
12990,20118,4643,9774,3413,15475,5226,2539,2687
12995,20124,4643,9777,3413,15480,5229,2541,2688
13000,20135,4646,9781,3414,15488,5231,2542,2689
13005,20139,4647,9784,3415,15491,5232,2542,2690
13010,20149,4649,9787,3416,15500,5234,2544,2690
13015,20155,4649,9790,3416,15505,5237,2546,2691
13020,20166,4651,9794,3417,15514,5239,2547,2692
13025,20170,4651,9794,3417,15519,5240,2547,2693
13030,20180,4653,9799,3419,15526,5242,2548,2694
13035,20186,4653,9802,3419,15533,5245,2551,2694
13040,20197,4656,9808,3421,15539,5247,2552,2695
13045,20201,4657,9810,3422,15544,5248,2553,2695
13050,20211,4659,9814,3424,15552,5250,2554,2696
13055,20217,4659,9818,3424,15558,5253,2556,2697
13060,20228,4662,9822,3427,15566,5255,2556,2699
13065,20232,4662,9824,3427,15570,5256,2556,2700
13070,20242,4664,9829,3428,15578,5258,2558,2700
13075,20248,4664,9831,3428,15584,5261,2559,2702
13080,20259,4666,9836,3429,15592,5263,2561,2702
13085,20263,4667,9836,3430,15596,5264,2561,2703
13090,20273,4671,9841,3433,15602,5266,2563,2703
13095,20279,4671,9844,3433,15607,5269,2565,2704
13100,20290,4673,9846,3434,15617,5271,2566,2705
13105,20294,4673,9846,3434,15621,5272,2566,2706
13110,20304,4676,9851,3436,15627,5274,2568,2706
13115,20310,4676,9855,3436,15633,5277,2571,2706
13120,20321,4680,9858,3438,15640,5279,2571,2708
13125,20325,4681,9861,3439,15644,5280,2572,2708
13130,20335,4684,9867,3442,15651,5282,2573,2709
13135,20341,4684,9869,3442,15657,5285,2575,2710
13140,20352,4686,9873,3443,15664,5287,2576,2711
13145,20356,4688,9874,3445,15668,5288,2576,2712
13150,20366,4691,9879,3447,15674,5290,2577,2713
13155,20372,4691,9883,3447,15681,5293,2580,2713
13160,20383,4695,9890,3450,15686,5295,2582,2713
13165,20387,4698,9892,3453,15689,5296,2582,2714
13170,20397,4703,9899,3457,15693,5298,2584,2714
13175,20403,4703,9900,3457,15700,5301,2585,2716
13180,20414,4707,9906,3459,15705,5303,2587,2716
13185,20418,4709,9907,3461,15709,5304,2587,2717
13190,20428,4711,9912,3462,15717,5306,2588,2718
13195,20434,4711,9915,3462,15722,5309,2589,2720
13200,20445,4713,9920,3463,15730,5311,2590,2721
13205,20449,4715,9922,3465,15734,5312,2591,2721
13210,20459,4717,9924,3465,15742,5314,2592,2722
13215,20465,4717,9929,3465,15746,5317,2594,2723
13220,20476,4720,9934,3468,15756,5319,2594,2725
13225,20480,4721,9936,3469,15759,5320,2595,2725
13230,20490,4723,9941,3471,15767,5322,2595,2727
13235,20496,4723,9946,3471,15772,5325,2598,2727
13240,20507,4724,9951,3472,15782,5327,2600,2727
13245,20511,4725,9952,3473,15786,5328,2600,2728
13250,20521,4727,9958,3474,15794,5330,2601,2729
13255,20527,4727,9962,3474,15799,5333,2604,2729
13260,20538,4730,9964,3476,15808,5335,2604,2731
13265,20542,4730,9966,3476,15812,5336,2605,2731
13270,20552,4733,9972,3478,15818,5338,2606,2732
13275,20558,4733,9973,3478,15825,5341,2607,2734
13280,20569,4735,9978,3479,15834,5343,2609,2734
13285,20573,4735,9980,3479,15838,5344,2609,2735
13290,20583,4739,9984,3481,15844,5346,2611,2735
13295,20589,4739,9985,3481,15850,5349,2612,2737
13300,20600,4743,9992,3485,15857,5351,2613,2738
13305,20604,4745,9995,3487,15859,5352,2613,2739
13310,20614,4751,10005,3493,15862,5354,2615,2739
13315,20620,4751,10009,3493,15868,5357,2617,2740
13320,20631,4756,10016,3498,15875,5359,2618,2741
13325,20635,4757,10018,3499,15878,5360,2618,2742
13330,20645,4758,10021,3499,15887,5362,2619,2743
13335,20651,4758,10023,3499,15893,5365,2621,2744
13340,20662,4760,10029,3500,15902,5367,2622,2745
13345,20666,4760,10031,3500,15906,5368,2623,2745
13350,20676,4763,10036,3502,15912,5370,2624,2746
13355,20682,4763,10039,3502,15917,5373,2625,2748
13360,20693,4765,10043,3503,15927,5375,2625,2750
13365,20697,4765,10044,3503,15932,5376,2625,2751
13370,20707,4767,10049,3504,15939,5378,2627,2751
13375,20713,4767,10050,3504,15946,5381,2627,2754
13380,20724,4769,10054,3505,15954,5383,2628,2755
13385,20728,4769,10055,3505,15959,5384,2629,2755
13390,20738,4772,10062,3508,15965,5386,2630,2756
13395,20744,4772,10067,3508,15971,5389,2633,2756
13400,20755,4775,10070,3510,15980,5391,2633,2758
13405,20759,4776,10072,3511,15983,5392,2634,2758
13410,20769,4778,10078,3512,15989,5394,2635,2759
13415,20775,4778,10079,3512,15996,5397,2636,2761
13420,20786,4780,10083,3512,16004,5399,2637,2762
13425,20790,4781,10085,3513,16008,5400,2637,2763
13430,20800,4787,10091,3519,16012,5402,2637,2765
13435,20806,4787,10094,3519,16016,5405,2638,2767
13440,20817,4794,10101,3525,16021,5407,2640,2767
13445,20821,4794,10103,3525,16026,5408,2641,2767
13450,20831,4797,10108,3527,16033,5410,2643,2767
13455,20837,4797,10112,3527,16039,5413,2645,2768
13460,20848,4800,10119,3529,16044,5415,2646,2769
13465,20852,4802,10121,3531,16049,5416,2646,2770
13470,20862,4805,10126,3533,16056,5418,2647,2771
13475,20868,4805,10129,3533,16062,5421,2649,2772
13480,20879,4808,10133,3535,16068,5423,2649,2774
13485,20883,4810,10134,3537,16073,5424,2649,2775
13490,20893,4813,10138,3539,16080,5426,2650,2776
13495,20899,4813,10141,3539,16084,5429,2651,2778
13500,20910,4817,10149,3543,16092,5431,2653,2778
13505,20914,4818,10152,3544,16096,5432,2654,2778
13510,20924,4821,10155,3546,16103,5434,2655,2779
13515,20930,4821,10157,3546,16108,5437,2656,2781
13520,20941,4825,10163,3550,16115,5439,2656,2783
13525,20945,4826,10163,3551,16119,5440,2656,2784
13530,20955,4829,10168,3553,16125,5442,2656,2786
13535,20961,4829,10169,3553,16132,5445,2656,2789
13540,20972,4833,10175,3555,16139,5447,2658,2789
13545,20976,4834,10177,3556,16142,5448,2658,2790
13550,20986,4838,10181,3558,16148,5450,2659,2791
13555,20992,4838,10184,3558,16153,5453,2660,2793
13560,21003,4842,10189,3561,16160,5455,2661,2794
13565,21007,4844,10192,3563,16163,5456,2662,2794
13570,21017,4846,10193,3563,16171,5458,2662,2796
13575,21023,4846,10196,3563,16176,5461,2663,2798
13580,21034,4851,10200,3566,16183,5463,2664,2799
13585,21038,4852,10201,3567,16186,5464,2664,2800
13590,21048,4855,10207,3570,16192,5466,2665,2801
13595,21054,4855,10211,3570,16197,5469,2667,2802
13600,21065,4860,10216,3574,16205,5471,2668,2803
13605,21069,4860,10216,3574,16209,5472,2668,2804
13610,21079,4863,10221,3576,16215,5474,2669,2805
13615,21085,4863,10225,3576,16220,5477,2670,2807
13620,21096,4868,10230,3581,16228,5479,2672,2807
13625,21100,4868,10231,3581,16232,5480,2672,2808
13630,21110,4870,10235,3582,16239,5482,2673,2809
13635,21116,4870,10239,3582,16245,5485,2676,2809
13640,21127,4873,10244,3583,16254,5487,2678,2809
13645,21131,4874,10247,3584,16257,5488,2679,2809
13650,21141,4876,10252,3585,16265,5490,2680,2810
13655,21147,4876,10253,3585,16270,5493,2680,2813
13660,21158,4878,10259,3586,16280,5495,2681,2814
13665,21162,4879,10260,3587,16283,5496,2681,2815
13670,21172,4880,10263,3587,16291,5498,2683,2815
13675,21178,4880,10266,3587,16297,5501,2684,2817
13680,21189,4881,10272,3588,16305,5503,2685,2818
13685,21193,4881,10272,3588,16312,5504,2685,2819
13690,21203,4882,10276,3588,16319,5506,2686,2820
13695,21209,4882,10279,3588,16327,5509,2688,2821
13700,21220,4883,10286,3589,16335,5511,2689,2822
13705,21224,4883,10289,3589,16340,5512,2690,2822
13710,21234,4884,10296,3590,16349,5514,2690,2824
13715,21240,4884,10299,3590,16356,5517,2692,2825
13720,21251,4885,10306,3591,16364,5519,2693,2826
13725,21255,4885,10308,3591,16370,5520,2694,2826
13730,21265,4887,10314,3593,16377,5522,2695,2827
13735,21271,4887,10316,3593,16383,5525,2696,2829
13740,21282,4888,10317,3593,16394,5527,2697,2830
13745,21286,4889,10320,3594,16397,5528,2698,2830
13750,21296,4891,10327,3595,16404,5530,2699,2831
13755,21302,4891,10327,3595,16411,5533,2699,2834
13760,21313,4893,10333,3597,16419,5535,2701,2834
13765,21317,4893,10333,3597,16424,5536,2701,2835
13770,21327,4895,10335,3597,16431,5538,2701,2837
13775,21333,4895,10339,3597,16436,5541,2702,2839
13780,21344,4901,10346,3602,16441,5543,2703,2840
13785,21348,4903,10348,3604,16445,5544,2704,2840
13790,21358,4906,10351,3607,16451,5546,2704,2842
13795,21364,4906,10355,3607,16458,5549,2707,2842
13800,21375,4909,10360,3609,16464,5551,2708,2843
13805,21379,4910,10362,3610,16469,5552,2708,2844
13810,21389,4914,10367,3613,16474,5554,2710,2844
13815,21395,4914,10371,3613,16480,5557,2712,2845
13820,21406,4918,10377,3616,16486,5559,2712,2847
13825,21410,4919,10378,3617,16491,5560,2712,2848
13830,21420,4922,10382,3619,16497,5562,2712,2850
13835,21426,4922,10383,3619,16504,5565,2712,2853
13840,21437,4927,10391,3623,16509,5567,2713,2854
13845,21441,4928,10391,3624,16513,5568,2713,2855
13850,21451,4932,10398,3628,16518,5570,2713,2857
13855,21457,4932,10401,3628,16525,5573,2716,2857
13860,21468,4937,10409,3632,16530,5575,2717,2858
13865,21472,4939,10412,3634,16533,5576,2718,2858
13870,21482,4944,10419,3639,16537,5578,2719,2859
13875,21488,4944,10421,3639,16544,5581,2721,2860
13880,21499,4947,10424,3641,16552,5583,2721,2862
13885,21503,4948,10427,3642,16555,5584,2722,2862
13890,21513,4951,10429,3643,16561,5586,2723,2863
13895,21519,4951,10431,3643,16568,5589,2723,2866
13900,21530,4955,10438,3646,16575,5591,2725,2866
13905,21534,4956,10440,3647,16578,5592,2725,2867
13910,21544,4959,10443,3648,16584,5594,2726,2868
13915,21550,4959,10447,3648,16589,5597,2727,2870
13920,21561,4965,10452,3653,16596,5599,2728,2871
13925,21565,4965,10454,3653,16600,5600,2729,2871
13930,21575,4968,10462,3656,16606,5602,2731,2871
13935,21581,4968,10465,3656,16611,5605,2732,2873
13940,21592,4971,10472,3659,16619,5607,2732,2875
13945,21596,4971,10473,3659,16624,5608,2732,2876
13950,21606,4973,10479,3661,16631,5610,2734,2876
13955,21612,4973,10484,3661,16638,5613,2737,2876
13960,21623,4976,10490,3664,16646,5615,2737,2878
13965,21627,4976,10491,3664,16650,5616,2737,2879
13970,21637,4977,10494,3664,16659,5618,2738,2880
13975,21643,4977,10499,3664,16665,5621,2741,2880
13980,21654,4979,10506,3666,16673,5623,2742,2881
13985,21658,4980,10508,3667,16677,5624,2742,2882
13990,21668,4983,10514,3670,16684,5626,2743,2883
13995,21674,4983,10516,3670,16691,5629,2745,2884
14000,21685,4985,10521,3670,16698,5631,2746,2885
14005,21689,4986,10524,3671,16702,5632,2747,2885
14010,21699,4988,10528,3673,16710,5634,2748,2886
14015,21705,4988,10533,3673,16716,5637,2751,2886
14020,21716,4990,10537,3675,16725,5639,2752,2887
14025,21720,4991,10540,3676,16728,5640,2752,2888
14030,21730,4994,10543,3678,16735,5642,2753,2889
14035,21736,4994,10545,3678,16741,5645,2753,2892
14040,21747,4996,10550,3679,16750,5647,2754,2893
14045,21751,4996,10550,3679,16755,5648,2754,2894
14050,21761,5000,10556,3683,16760,5650,2756,2894
14055,21767,5000,10559,3683,16766,5653,2758,2895
14060,21778,5004,10565,3687,16773,5655,2759,2896
14065,21782,5006,10566,3689,16776,5656,2759,2897
14070,21792,5009,10570,3691,16782,5658,2760,2898
14075,21798,5009,10572,3691,16789,5661,2761,2900
14080,21809,5012,10575,3692,16796,5663,2762,2901
14085,21813,5013,10575,3693,16800,5664,2762,2902
14090,21823,5018,10581,3697,16804,5666,2762,2904
14095,21829,5018,10585,3697,16809,5669,2764,2905
14100,21840,5024,10593,3702,16814,5671,2765,2906
14105,21844,5027,10597,3705,16817,5672,2766,2906
14110,21854,5030,10603,3708,16823,5674,2766,2908
14115,21860,5030,10606,3708,16829,5677,2766,2911
14120,21871,5036,10612,3712,16835,5679,2767,2912
14125,21875,5036,10612,3712,16839,5680,2767,2913
14130,21885,5040,10619,3714,16844,5682,2769,2913
14135,21891,5040,10623,3714,16849,5685,2770,2915
14140,21902,5046,10629,3720,16856,5687,2770,2917
14145,21906,5046,10629,3720,16860,5688,2770,2918
14150,21916,5050,10635,3723,16865,5690,2772,2918
14155,21922,5050,10639,3723,16871,5693,2774,2919
14160,21933,5055,10645,3727,16878,5695,2775,2920
14165,21937,5056,10648,3728,16881,5696,2776,2920
14170,21947,5059,10653,3729,16887,5698,2778,2920
14175,21953,5059,10657,3729,16893,5701,2780,2921
14180,21964,5060,10661,3729,16904,5703,2782,2921
14185,21968,5060,10663,3729,16908,5704,2783,2921
14190,21978,5061,10667,3730,16916,5706,2783,2923
14195,21984,5061,10671,3730,16923,5709,2785,2924
14200,21995,5062,10675,3730,16933,5711,2785,2926
14205,21999,5062,10676,3730,16937,5712,2785,2927
14210,22009,5063,10681,3731,16944,5714,2787,2927
14215,22015,5063,10685,3731,16950,5717,2788,2929
14220,22026,5064,10689,3732,16961,5719,2790,2929
14225,22030,5064,10691,3732,16966,5720,2790,2930
14230,22040,5065,10695,3732,16974,5722,2790,2932
14235,22046,5065,10697,3732,16979,5725,2790,2935
14240,22057,5066,10703,3733,16990,5727,2791,2936
14245,22061,5066,10705,3733,16995,5728,2791,2937
14250,22071,5067,10709,3733,17003,5730,2792,2938
14255,22077,5067,10710,3733,17008,5733,2792,2941
14260,22088,5068,10715,3734,17018,5735,2793,2942
14265,22092,5068,10718,3734,17023,5736,2794,2942
14270,22102,5070,10721,3735,17032,5738,2795,2943
14275,22108,5070,10724,3735,17038,5741,2797,2944
14280,22119,5074,10731,3738,17042,5743,2798,2945
14285,22123,5076,10733,3740,17047,5744,2798,2946
14290,22133,5078,10736,3741,17055,5746,2799,2947
14295,22139,5078,10738,3741,17060,5749,2800,2949
14300,22150,5081,10741,3742,17068,5751,2801,2950
14305,22154,5082,10742,3743,17072,5752,2801,2951
14310,22164,5085,10747,3744,17078,5754,2802,2952
14315,22170,5085,10749,3744,17085,5757,2803,2954
14320,22181,5089,10754,3746,17090,5759,2804,2955
14325,22185,5091,10756,3748,17094,5760,2805,2955
14330,22195,5095,10759,3750,17100,5762,2805,2957
14335,22201,5095,10761,3750,17105,5765,2805,2960
14340,22212,5098,10768,3752,17111,5767,2806,2961
14345,22216,5098,10768,3752,17118,5768,2806,2962
14350,22226,5100,10772,3753,17126,5770,2807,2963
14355,22232,5100,10776,3753,17131,5773,2809,2964
14360,22243,5104,10779,3755,17138,5775,2810,2965
14365,22247,5105,10781,3756,17142,5776,2810,2966
14370,22257,5109,10785,3759,17148,5778,2810,2968
14375,22263,5109,10787,3759,17153,5781,2810,2971
14380,22274,5111,10793,3761,17160,5783,2811,2972
14385,22278,5113,10796,3763,17165,5784,2812,2972
14390,22288,5116,10801,3766,17171,5786,2813,2973
14395,22294,5116,10801,3766,17177,5789,2813,2976
14400,22305,5121,10805,3770,17183,5791,2813,2978
14405,22309,5124,10807,3773,17185,5792,2813,2979
14410,22319,5127,10812,3774,17190,5794,2815,2979
14415,22325,5128,10816,3775,17195,5797,2818,2979
14420,22336,5134,10821,3779,17201,5799,2820,2979
14425,22340,5135,10822,3780,17205,5800,2820,2980
14430,22350,5138,10826,3781,17212,5802,2821,2981
14435,22356,5138,10828,3781,17217,5805,2822,2983
14440,22367,5141,10832,3783,17225,5807,2823,2984
14445,22371,5142,10834,3784,17229,5808,2824,2984
14450,22381,5147,10841,3788,17233,5810,2825,2985
14455,22387,5147,10844,3788,17239,5813,2826,2987
14460,22398,5151,10852,3792,17246,5815,2828,2987
14465,22402,5153,10854,3794,17249,5816,2829,2987
14470,22412,5154,10859,3794,17257,5818,2831,2987
14475,22418,5154,10861,3794,17264,5821,2832,2989
14480,22429,5157,10867,3797,17272,5823,2832,2991
14485,22433,5157,10868,3797,17276,5824,2833,2991
14490,22443,5159,10873,3798,17283,5826,2834,2992
14495,22449,5159,10877,3798,17290,5829,2837,2992
14500,22460,5162,10882,3800,17298,5831,2838,2993
14505,22464,5162,10883,3800,17302,5832,2838,2994
14510,22474,5164,10888,3801,17309,5834,2838,2996
14515,22480,5164,10890,3801,17316,5837,2839,2998
14520,22491,5166,10894,3801,17325,5839,2840,2999
14525,22495,5166,10895,3801,17329,5840,2840,3000
14530,22505,5168,10899,3802,17337,5842,2840,3002
14535,22511,5168,10903,3802,17342,5845,2842,3003
14540,22522,5171,10908,3803,17351,5847,2844,3003
14545,22526,5171,10908,3803,17355,5848,2844,3004
14550,22536,5172,10912,3803,17363,5850,2845,3005
14555,22542,5172,10917,3803,17369,5853,2848,3005
14560,22553,5174,10923,3804,17379,5855,2850,3005
14565,22557,5174,10924,3804,17383,5856,2850,3006
14570,22567,5179,10930,3808,17387,5858,2851,3007
14575,22573,5180,10934,3809,17390,5861,2852,3009
14580,22584,5186,10940,3814,17395,5863,2853,3010
14585,22588,5191,10944,3819,17396,5864,2854,3010
14590,22598,5196,10947,3823,17402,5866,2854,3012
14595,22604,5196,10950,3823,17407,5869,2856,3013
14600,22615,5200,10953,3825,17413,5871,2856,3015
14605,22619,5204,10955,3829,17415,5872,2856,3016
14610,22629,5208,10962,3831,17419,5874,2858,3016
14615,22635,5208,10966,3831,17426,5877,2859,3018
14620,22646,5211,10972,3833,17435,5879,2861,3018
14625,22650,5212,10974,3834,17438,5880,2862,3018
14630,22660,5214,10976,3835,17446,5882,2862,3020
14635,22666,5214,10981,3835,17451,5885,2864,3021
14640,22677,5217,10987,3837,17459,5887,2865,3022
14645,22681,5217,10988,3837,17463,5888,2865,3023
14650,22691,5219,10993,3838,17471,5890,2866,3024
14655,22697,5219,10995,3838,17478,5893,2866,3027
14660,22708,5221,11001,3839,17485,5895,2866,3029
14665,22712,5221,11003,3839,17490,5896,2866,3030
14670,22722,5224,11007,3841,17497,5898,2866,3032
14675,22728,5224,11009,3841,17503,5901,2867,3034
14680,22739,5226,11015,3842,17510,5903,2868,3035
14685,22743,5227,11017,3843,17516,5904,2868,3036
14690,22753,5229,11022,3845,17523,5906,2869,3037
14695,22759,5229,11026,3845,17530,5909,2871,3038
14700,22770,5232,11032,3846,17536,5911,2873,3038
14705,22774,5232,11033,3846,17542,5912,2874,3038
14710,22784,5234,11037,3848,17550,5914,2874,3040
14715,22790,5234,11040,3848,17556,5917,2876,3041
14720,22801,5238,11046,3851,17563,5919,2877,3042
14725,22805,5239,11048,3852,17566,5920,2877,3043
14730,22815,5241,11053,3852,17574,5922,2879,3043
14735,22821,5241,11056,3852,17579,5925,2880,3045
14740,22832,5244,11062,3854,17587,5927,2881,3046
14745,22836,5246,11065,3856,17590,5928,2882,3046
14750,22846,5248,11067,3857,17598,5930,2883,3047
14755,22852,5248,11071,3857,17603,5933,2885,3048
14760,22863,5252,11078,3860,17611,5935,2887,3048
14765,22867,5253,11080,3861,17614,5936,2887,3049
14770,22877,5255,11086,3863,17622,5938,2889,3049
14775,22883,5255,11091,3863,17627,5941,2891,3050
14780,22894,5258,11096,3865,17635,5943,2892,3051
14785,22898,5259,11098,3866,17639,5944,2893,3051
14790,22908,5261,11104,3868,17646,5946,2895,3051
14795,22914,5261,11106,3868,17653,5949,2897,3052
14800,22925,5263,11112,3869,17661,5951,2898,3053
14805,22929,5264,11114,3870,17665,5952,2899,3053
14810,22939,5267,11120,3873,17670,5954,2900,3054
14815,22945,5268,11124,3874,17674,5957,2902,3055
14820,22956,5273,11131,3879,17681,5959,2904,3055
14825,22960,5276,11133,3882,17684,5960,2904,3056
14830,22970,5277,11135,3883,17692,5962,2904,3058
14835,22976,5277,11138,3883,17698,5965,2906,3059
14840,22987,5279,11145,3885,17706,5967,2908,3059
14845,22991,5280,11147,3886,17711,5968,2908,3060
14850,23001,5282,11151,3887,17719,5970,2909,3061
14855,23007,5282,11153,3887,17724,5973,2910,3063
14860,23018,5284,11161,3889,17732,5975,2911,3064
14865,23022,5285,11164,3890,17736,5976,2911,3065
14870,23032,5287,11168,3891,17744,5978,2911,3067
14875,23038,5287,11171,3891,17750,5981,2912,3069
14880,23049,5289,11175,3893,17758,5983,2912,3071
14885,23053,5290,11177,3894,17763,5984,2913,3071
14890,23063,5293,11182,3896,17770,5986,2914,3072
14895,23069,5293,11184,3896,17776,5989,2915,3074
14900,23080,5295,11190,3898,17783,5991,2916,3075
14905,23084,5295,11190,3898,17789,5992,2916,3076
14910,23094,5297,11196,3899,17795,5994,2918,3076
14915,23100,5297,11199,3899,17803,5997,2919,3078
14920,23111,5300,11207,3901,17809,5999,2920,3079
14925,23115,5300,11208,3901,17815,6000,2921,3079
14930,23125,5302,11213,3902,17822,6002,2922,3080
14935,23131,5302,11214,3902,17829,6005,2923,3082
14940,23142,5305,11219,3905,17836,6007,2924,3083
14945,23146,5306,11221,3906,17840,6008,2924,3084
14950,23156,5308,11226,3907,17847,6010,2926,3084
14955,23162,5308,11230,3907,17853,6013,2928,3085
14960,23173,5310,11234,3909,17862,6015,2928,3087
14965,23177,5311,11235,3910,17866,6016,2928,3088
14970,23187,5314,11238,3912,17873,6018,2929,3089
14975,23193,5314,11240,3912,17878,6021,2930,3091
14980,23204,5316,11243,3913,17888,6023,2931,3092
14985,23208,5317,11245,3914,17891,6024,2932,3092
14990,23218,5321,11252,3918,17897,6026,2932,3094
14995,23224,5321,11256,3918,17901,6029,2934,3095
15000,23235,5324,11259,3920,17911,6031,2934,3097
15005,23239,5324,11259,3920,17915,6032,2934,3098
15010,23249,5327,11261,3921,17922,6034,2935,3099
15015,23255,5327,11265,3921,17927,6037,2938,3099
15020,23266,5332,11273,3925,17933,6039,2940,3099
15025,23270,5334,11276,3927,17936,6040,2941,3099
15030,23280,5338,11282,3931,17941,6042,2942,3100
15035,23286,5338,11286,3931,17947,6045,2944,3101
15040,23297,5342,11291,3934,17954,6047,2945,3102
15045,23301,5345,11294,3937,17956,6048,2946,3102
15050,23311,5348,11296,3938,17963,6050,2947,3103
15055,23317,5348,11297,3938,17968,6053,2947,3106
15060,23328,5353,11304,3942,17974,6055,2948,3107
15065,23332,5355,11307,3944,17977,6056,2949,3107
15070,23342,5360,11312,3948,17981,6058,2949,3109
15075,23348,5360,11315,3948,17988,6061,2951,3110
15080,23359,5363,11319,3949,17996,6063,2953,3110
15085,23363,5364,11321,3950,17999,6064,2953,3111
15090,23373,5366,11324,3951,18006,6066,2954,3112
15095,23379,5366,11325,3951,18012,6069,2954,3115
15100,23390,5370,11331,3954,18020,6071,2955,3116
15105,23394,5370,11332,3954,18024,6072,2956,3116
15110,23404,5374,11335,3957,18030,6074,2956,3118
15115,23410,5374,11338,3957,18036,6077,2959,3118
15120,23421,5378,11345,3959,18039,6079,2960,3119
15125,23425,5382,11346,3963,18043,6080,2960,3120
15130,23435,5384,11353,3965,18049,6082,2961,3121
15135,23441,5384,11357,3965,18054,6085,2963,3122
15140,23452,5387,11363,3967,18064,6087,2964,3123
15145,23456,5387,11364,3967,18069,6088,2965,3123
15150,23466,5388,11367,3967,18077,6090,2967,3123
15155,23472,5388,11370,3967,18082,6093,2969,3124
15160,23483,5391,11376,3969,18090,6095,2971,3124
15165,23487,5391,11378,3969,18095,6096,2971,3125
15170,23497,5394,11384,3971,18101,6098,2972,3126
15175,23503,5394,11386,3971,18109,6101,2974,3127
15180,23514,5396,11392,3972,18115,6103,2974,3129
15185,23518,5397,11395,3973,18121,6104,2975,3129
15190,23528,5400,11400,3975,18128,6106,2976,3130
15195,23534,5400,11403,3975,18133,6109,2978,3131
15200,23545,5403,11409,3977,18141,6111,2980,3131
15205,23549,5404,11411,3978,18145,6112,2980,3132
15210,23559,5407,11418,3981,18151,6114,2982,3132
15215,23565,5407,11421,3981,18157,6117,2982,3135
15220,23576,5410,11424,3982,18165,6119,2983,3136
15225,23580,5410,11425,3982,18170,6120,2983,3137
15230,23590,5413,11430,3984,18176,6122,2985,3137
15235,23596,5413,11435,3984,18181,6125,2988,3137
15240,23607,5417,11439,3987,18189,6127,2989,3138
15245,23611,5417,11441,3987,18194,6128,2990,3138
15250,23621,5420,11446,3988,18200,6130,2991,3139
15255,23627,5420,11448,3988,18207,6133,2993,3140
15260,23638,5423,11454,3990,18215,6135,2994,3141
15265,23642,5424,11457,3991,18218,6136,2995,3141
15270,23652,5427,11462,3993,18224,6138,2996,3142
15275,23658,5427,11463,3993,18231,6141,2997,3144
15280,23669,5431,11468,3995,18237,6143,2999,3144
15285,23673,5434,11470,3998,18239,6144,2999,3145
15290,23683,5437,11473,3999,18246,6146,3000,3146
15295,23689,5437,11475,3999,18252,6149,3002,3147
15300,23700,5441,11481,4002,18259,6151,3003,3148
15305,23704,5441,11482,4002,18263,6152,3004,3148
15310,23714,5443,11488,4003,18270,6154,3005,3149
15315,23720,5443,11491,4003,18276,6157,3007,3150
15320,23731,5446,11495,4005,18285,6159,3007,3152
15325,23735,5446,11495,4005,18289,6160,3007,3153
15330,23745,5450,11500,4008,18295,6162,3008,3154
15335,23751,5450,11502,4008,18301,6165,3009,3156
15340,23762,5451,11506,4008,18311,6167,3009,3158
15345,23766,5451,11507,4008,18315,6168,3010,3158
15350,23776,5454,11508,4009,18322,6170,3010,3160
15355,23782,5454,11510,4009,18327,6173,3011,3162
15360,23793,5457,11514,4011,18335,6175,3012,3163
15365,23797,5459,11517,4013,18337,6176,3012,3164
15370,23807,5464,11521,4016,18342,6178,3012,3166
15375,23813,5465,11526,4017,18345,6181,3014,3167
15380,23824,5470,11534,4022,18352,6183,3016,3167
15385,23828,5472,11535,4024,18356,6184,3016,3168
15390,23838,5473,11543,4025,18363,6186,3018,3168
15395,23844,5473,11545,4025,18369,6189,3019,3170
15400,23855,5474,11551,4025,18380,6191,3020,3171
15405,23859,5474,11553,4025,18384,6192,3020,3172
15410,23869,5477,11559,4028,18392,6194,3021,3173
15415,23875,5477,11564,4028,18396,6197,3023,3174
15420,23886,5480,11571,4030,18405,6199,3025,3174
15425,23890,5480,11571,4030,18410,6200,3025,3175
15430,23900,5481,11575,4030,18417,6202,3025,3177
15435,23906,5481,11580,4030,18424,6205,3028,3177
15440,23917,5484,11586,4033,18433,6207,3029,3178
15445,23921,5485,11589,4034,18435,6208,3030,3178
15450,23931,5487,11594,4036,18444,6210,3031,3179
15455,23937,5487,11598,4036,18449,6213,3033,3180
15460,23948,5489,11604,4038,18458,6215,3035,3180
15465,23952,5489,11605,4038,18463,6216,3036,3180
15470,23962,5491,11609,4039,18471,6218,3038,3180
15475,23968,5491,11611,4039,18477,6221,3039,3182
15480,23979,5494,11615,4041,18485,6223,3040,3183
15485,23983,5494,11618,4041,18489,6224,3041,3183
15490,23993,5497,11626,4043,18495,6226,3043,3183
15495,23999,5497,11630,4043,18500,6229,3045,3184
15500,24010,5500,11634,4045,18509,6231,3046,3185
15505,24014,5501,11635,4046,18513,6232,3046,3186
15510,24024,5504,11641,4048,18520,6234,3048,3186
15515,24030,5504,11645,4048,18525,6237,3050,3187
15520,24041,5509,11653,4052,18531,6239,3051,3188
15525,24045,5512,11656,4055,18533,6240,3052,3188
15530,24055,5515,11659,4056,18540,6242,3053,3189
15535,24061,5515,11660,4056,18546,6245,3054,3191
15540,24072,5518,11664,4058,18554,6247,3055,3192
15545,24076,5519,11665,4059,18557,6248,3055,3193
15550,24086,5523,11670,4061,18562,6250,3056,3194
15555,24092,5523,11671,4061,18569,6253,3056,3197
15560,24103,5528,11677,4066,18575,6255,3057,3198
15565,24107,5529,11679,4067,18578,6256,3057,3199
15570,24117,5532,11684,4069,18584,6258,3058,3200
15575,24123,5532,11685,4069,18590,6261,3058,3203
15580,24134,5536,11690,4072,18598,6263,3060,3203
15585,24138,5536,11691,4072,18602,6264,3060,3204
15590,24148,5539,11695,4074,18608,6266,3061,3205
15595,24154,5539,11697,4074,18615,6269,3062,3207
15600,24165,5541,11700,4075,18623,6271,3062,3209
15605,24169,5542,11700,4076,18627,6272,3062,3210
15610,24179,5547,11707,4081,18631,6274,3063,3211
15615,24185,5547,11707,4081,18637,6277,3063,3214
15620,24196,5552,11715,4086,18642,6279,3065,3214
15625,24200,5555,11716,4089,18645,6280,3065,3215
15630,24210,5558,11720,4091,18650,6282,3065,3217
15635,24216,5559,11723,4092,18654,6285,3066,3219
15640,24227,5564,11728,4096,18661,6287,3067,3220
15645,24231,5564,11729,4096,18667,6288,3067,3221
15650,24241,5566,11732,4097,18674,6290,3068,3222
15655,24247,5566,11735,4097,18680,6293,3070,3223
15660,24258,5568,11741,4099,18688,6295,3071,3224
15665,24262,5568,11742,4099,18694,6296,3072,3224
15670,24272,5571,11748,4101,18700,6298,3074,3224
15675,24278,5571,11750,4101,18707,6301,3075,3226
15680,24289,5573,11754,4102,18715,6303,3076,3227
15685,24293,5573,11755,4102,18719,6304,3076,3228
15690,24303,5575,11763,4104,18726,6306,3078,3228
15695,24309,5575,11767,4104,18733,6309,3080,3229
15700,24320,5578,11771,4105,18741,6311,3081,3230
15705,24324,5579,11774,4106,18744,6312,3082,3230
15710,24334,5581,11781,4108,18751,6314,3084,3230
15715,24340,5581,11783,4108,18759,6317,3085,3232
15720,24351,5584,11788,4110,18765,6319,3085,3234
15725,24355,5584,11788,4110,18771,6320,3085,3235
15730,24365,5585,11794,4111,18780,6322,3086,3236
15735,24371,5585,11798,4111,18785,6325,3089,3236
15740,24382,5587,11806,4113,18794,6327,3090,3237
15745,24386,5588,11808,4114,18798,6328,3091,3237
15750,24396,5591,11814,4116,18804,6330,3093,3237
15755,24402,5591,11817,4116,18811,6333,3095,3238
15760,24413,5593,11819,4117,18820,6335,3096,3239
15765,24417,5594,11822,4118,18823,6336,3097,3239
15770,24427,5596,11824,4118,18831,6338,3098,3240
15775,24433,5596,11826,4118,18837,6341,3099,3242
15780,24444,5598,11831,4119,18846,6343,3101,3242
15785,24448,5598,11833,4119,18850,6344,3101,3243
15790,24458,5601,11836,4120,18857,6346,3102,3244
15795,24464,5601,11839,4120,18862,6349,3104,3245
15800,24475,5605,11846,4124,18869,6351,3105,3246
15805,24479,5606,11846,4125,18873,6352,3105,3247
15810,24489,5609,11850,4127,18879,6354,3106,3248
15815,24495,5609,11855,4127,18885,6357,3109,3248
15820,24506,5615,11863,4131,18890,6359,3110,3249
15825,24510,5617,11864,4133,18893,6360,3110,3250
15830,24520,5620,11869,4135,18900,6362,3112,3250
15835,24526,5620,11873,4135,18904,6365,3113,3252
15840,24537,5625,11878,4139,18911,6367,3113,3254
15845,24541,5628,11880,4142,18913,6368,3113,3255
15850,24551,5633,11886,4146,18918,6370,3115,3255
15855,24557,5633,11889,4146,18922,6373,3116,3257
15860,24568,5639,11892,4151,18929,6375,3116,3259
15865,24572,5640,11895,4152,18931,6376,3117,3259
15870,24582,5646,11899,4157,18936,6378,3117,3261
15875,24588,5646,11901,4157,18942,6381,3119,3262
15880,24599,5649,11905,4159,18948,6383,3119,3264
15885,24603,5652,11907,4162,18951,6384,3120,3264
15890,24613,5656,11911,4165,18957,6386,3121,3265
15895,24619,5656,11914,4165,18961,6389,3122,3267
15900,24630,5661,11918,4169,18969,6391,3123,3268
15905,24634,5661,11918,4169,18973,6392,3123,3269
15910,24644,5663,11922,4170,18979,6394,3123,3271
15915,24650,5663,11927,4170,18984,6397,3125,3272
15920,24661,5665,11931,4171,18995,6399,3126,3273
15925,24665,5665,11931,4171,19000,6400,3126,3274
15930,24675,5667,11935,4172,19007,6402,3127,3275
15935,24681,5667,11937,4172,19013,6405,3127,3278
15940,24692,5670,11941,4173,19022,6407,3129,3278
15945,24696,5671,11944,4174,19024,6408,3130,3278
15950,24706,5674,11951,4176,19031,6410,3131,3279
15955,24712,5674,11954,4176,19038,6413,3133,3280
15960,24723,5675,11961,4176,19048,6415,3135,3280
15965,24727,5675,11963,4176,19051,6416,3135,3281
15970,24737,5676,11968,4177,19061,6418,3136,3282
15975,24743,5676,11970,4177,19067,6421,3138,3283
15980,24754,5677,11977,4178,19075,6423,3140,3283
15985,24758,5677,11979,4178,19081,6424,3141,3283
15990,24768,5678,11982,4178,19089,6426,3142,3284
15995,24774,5678,11984,4178,19095,6429,3142,3287
16000,24785,5679,11991,4179,19104,6431,3144,3287
16005,24789,5679,11995,4179,19109,6432,3145,3287
16010,24799,5681,11999,4180,19118,6434,3145,3289
16015,24805,5681,12002,4180,19123,6437,3147,3290
16020,24816,5683,12009,4182,19131,6439,3148,3291
16025,24820,5684,12012,4183,19136,6440,3149,3291
16030,24830,5686,12017,4184,19143,6442,3149,3293
16035,24836,5686,12021,4184,19148,6445,3150,3295
16040,24847,5688,12026,4186,19157,6447,3151,3296
16045,24851,5689,12030,4187,19162,6448,3152,3296
16050,24861,5691,12033,4188,19169,6450,3153,3297
16055,24867,5691,12037,4188,19174,6453,3154,3299
16060,24878,5695,12041,4192,19182,6455,3154,3301
16065,24882,5695,12041,4192,19187,6456,3154,3302
16070,24892,5698,12046,4194,19194,6458,3156,3302
16075,24898,5698,12046,4194,19200,6461,3156,3305
16080,24909,5703,12054,4198,19204,6463,3156,3307
16085,24913,5704,12056,4199,19209,6464,3157,3307
16090,24923,5706,12059,4200,19217,6466,3158,3308
16095,24929,5706,12061,4200,19223,6469,3159,3310
16100,24940,5709,12066,4202,19230,6471,3161,3310
16105,24944,5710,12067,4203,19234,6472,3162,3310
16110,24954,5713,12073,4206,19240,6474,3163,3311
16115,24960,5713,12076,4206,19246,6477,3165,3312
16120,24971,5717,12081,4209,19253,6479,3166,3313
16125,24975,5719,12082,4211,19256,6480,3166,3314
16130,24985,5722,12084,4212,19263,6482,3167,3315
16135,24991,5722,12087,4212,19268,6485,3169,3316
16140,25002,5726,12089,4214,19276,6487,3169,3318
16145,25006,5727,12090,4215,19279,6488,3169,3319
16150,25016,5729,12091,4215,19287,6490,3170,3320
16155,25022,5729,12093,4215,19293,6493,3172,3321
16160,25033,5731,12098,4217,19302,6495,3173,3322
16165,25037,5732,12100,4218,19305,6496,3173,3323
16170,25047,5737,12106,4222,19309,6498,3174,3324
16175,25053,5737,12108,4222,19316,6501,3175,3326
16180,25064,5740,12113,4225,19324,6503,3175,3328
16185,25068,5741,12114,4226,19327,6504,3175,3329
16190,25078,5745,12119,4229,19332,6506,3176,3330
16195,25084,5745,12123,4229,19336,6509,3178,3331
16200,25095,5752,12128,4234,19342,6511,3180,3331
16205,25099,5753,12130,4235,19345,6512,3181,3331
16210,25109,5757,12135,4238,19350,6514,3182,3332
16215,25115,5758,12138,4239,19355,6517,3184,3333
16220,25126,5763,12146,4244,19362,6519,3185,3334
16225,25130,5763,12147,4244,19367,6520,3185,3335
16230,25140,5764,12151,4244,19375,6522,3186,3336
16235,25146,5764,12154,4244,19379,6525,3187,3338
16240,25157,5767,12159,4246,19390,6527,3189,3338
16245,25161,5768,12162,4247,19392,6528,3189,3339
16250,25171,5770,12168,4249,19401,6530,3191,3339
16255,25177,5770,12172,4249,19405,6533,3193,3340
16260,25188,5773,12176,4251,19413,6535,3193,3342
16265,25192,5773,12177,4251,19419,6536,3194,3342
16270,25202,5775,12181,4253,19427,6538,3195,3343
16275,25208,5775,12184,4253,19433,6541,3197,3344
16280,25219,5777,12189,4254,19441,6543,3198,3345
16285,25223,5778,12192,4255,19444,6544,3198,3346
16290,25233,5779,12197,4256,19453,6546,3198,3348
16295,25239,5779,12198,4256,19459,6549,3198,3351
16300,25250,5781,12205,4257,19467,6551,3199,3352
16305,25254,5781,12206,4257,19473,6552,3199,3353
16310,25264,5782,12211,4258,19481,6554,3201,3353
16315,25270,5782,12213,4258,19488,6557,3202,3355
16320,25281,5785,12219,4260,19494,6559,3203,3356
16325,25285,5785,12219,4260,19500,6560,3203,3357
16330,25295,5787,12222,4260,19507,6562,3204,3358
16335,25301,5787,12223,4260,19514,6565,3205,3360
16340,25312,5789,12227,4262,19522,6567,3206,3361
16345,25316,5790,12231,4263,19526,6568,3207,3361
16350,25326,5793,12234,4265,19532,6570,3207,3363
16355,25332,5793,12236,4265,19539,6573,3208,3365
16360,25343,5797,12243,4267,19545,6575,3209,3366
16365,25347,5798,12243,4268,19549,6576,3209,3367
16370,25357,5801,12249,4271,19555,6578,3209,3369
16375,25363,5801,12251,4271,19562,6581,3211,3370
16380,25374,5804,12256,4273,19569,6583,3212,3371
16385,25378,5805,12256,4274,19573,6584,3212,3372
16390,25388,5808,12261,4276,19579,6586,3214,3372
16395,25394,5808,12263,4276,19586,6589,3215,3374
16400,25405,5811,12268,4277,19593,6591,3217,3374
16405,25409,5813,12271,4279,19596,6592,3218,3374
16410,25419,5816,12274,4280,19603,6594,3219,3375
16415,25425,5816,12275,4280,19609,6597,3220,3377
16420,25436,5820,12280,4283,19615,6599,3221,3378
16425,25440,5821,12281,4284,19618,6600,3221,3379
16430,25450,5825,12284,4287,19624,6602,3221,3381
16435,25456,5825,12287,4287,19629,6605,3223,3382
16440,25467,5829,12290,4290,19637,6607,3224,3383
16445,25471,5832,12293,4293,19639,6608,3225,3383
16450,25481,5837,12300,4297,19644,6610,3227,3383
16455,25487,5837,12300,4297,19650,6613,3227,3386
16460,25498,5841,12305,4300,19657,6615,3228,3387
16465,25502,5842,12306,4301,19660,6616,3228,3388
16470,25512,5847,12312,4304,19664,6618,3229,3389
16475,25518,5847,12314,4304,19670,6621,3230,3391
16480,25529,5852,12319,4307,19677,6623,3231,3392
16485,25533,5853,12322,4308,19680,6624,3232,3392
16490,25543,5856,12326,4310,19687,6626,3233,3393
16495,25549,5856,12328,4310,19693,6629,3235,3394
16500,25560,5861,12333,4313,19698,6631,3236,3395
16505,25564,5863,12334,4315,19701,6632,3236,3396
16510,25574,5868,12338,4319,19706,6634,3236,3398
16515,25580,5868,12339,4319,19712,6637,3237,3400
16520,25591,5872,12347,4323,19719,6639,3238,3401
16525,25595,5873,12349,4324,19722,6640,3238,3402
16530,25605,5874,12353,4324,19730,6642,3239,3403
16535,25611,5874,12357,4324,19737,6645,3242,3403
16540,25622,5876,12362,4326,19746,6647,3243,3404
16545,25626,5876,12364,4326,19750,6648,3243,3405
16550,25636,5878,12371,4328,19757,6650,3244,3406
16555,25642,5878,12375,4328,19762,6653,3246,3407
16560,25653,5881,12381,4330,19771,6655,3248,3407
16565,25657,5881,12384,4330,19775,6656,3249,3407
16570,25667,5883,12389,4331,19783,6658,3251,3407
16575,25673,5883,12392,4331,19789,6661,3253,3408
16580,25684,5886,12400,4334,19795,6663,3255,3408
16585,25688,5886,12403,4334,19801,6664,3256,3408
16590,25698,5889,12407,4336,19808,6666,3257,3409
16595,25704,5889,12411,4336,19814,6669,3259,3410
16600,25715,5892,12418,4339,19821,6671,3260,3411
16605,25719,5892,12419,4339,19826,6672,3260,3412
16610,25729,5894,12424,4340,19833,6674,3261,3413
16615,25735,5894,12427,4340,19841,6677,3262,3415
16620,25746,5896,12428,4340,19849,6679,3262,3417
16625,25750,5896,12429,4340,19854,6680,3263,3417
16630,25760,5898,12433,4340,19862,6682,3265,3417
16635,25766,5898,12436,4340,19868,6685,3268,3417
16640,25777,5899,12441,4341,19877,6687,3268,3419
16645,25781,5899,12444,4341,19882,6688,3269,3419
16650,25791,5901,12451,4342,19889,6690,3270,3420
16655,25797,5901,12454,4342,19894,6693,3270,3423
16660,25808,5903,12462,4343,19903,6695,3272,3423
16665,25812,5904,12465,4344,19908,6696,3273,3423
16670,25822,5906,12468,4344,19915,6698,3274,3424
16675,25828,5906,12470,4344,19921,6701,3274,3427
16680,25839,5909,12477,4347,19929,6703,3274,3429
16685,25843,5910,12478,4348,19933,6704,3274,3430
16690,25853,5912,12483,4348,19940,6706,3275,3431
16695,25859,5912,12486,4348,19946,6709,3276,3433
16700,25870,5915,12490,4350,19955,6711,3276,3435
16705,25874,5915,12492,4350,19959,6712,3276,3436
16710,25884,5917,12494,4350,19967,6714,3276,3438
16715,25890,5917,12497,4350,19972,6717,3277,3440
16720,25901,5919,12502,4352,19982,6719,3279,3440
16725,25905,5919,12504,4352,19986,6720,3279,3441
16730,25915,5924,12508,4355,19990,6722,3279,3443
16735,25921,5924,12512,4355,19996,6725,3281,3444
16740,25932,5929,12518,4359,20003,6727,3282,3445
16745,25936,5929,12519,4359,20007,6728,3283,3445
16750,25946,5932,12523,4360,20014,6730,3285,3445
16755,25952,5932,12526,4360,20020,6733,3288,3445
16760,25963,5935,12532,4363,20027,6735,3288,3447
16765,25967,5937,12534,4365,20030,6736,3288,3448
16770,25977,5939,12538,4367,20038,6738,3290,3448
16775,25983,5939,12542,4367,20042,6741,3292,3449
16780,25994,5945,12546,4371,20047,6743,3292,3451
16785,25998,5949,12550,4375,20048,6744,3293,3451
16790,26008,5953,12553,4378,20055,6746,3294,3452
16795,26014,5953,12558,4378,20059,6749,3297,3452
16800,26025,5959,12564,4383,20065,6751,3299,3452
16805,26029,5960,12565,4384,20069,6752,3300,3452
16810,26039,5962,12571,4385,20076,6754,3302,3452
16815,26045,5962,12575,4385,20081,6757,3304,3453
16820,26056,5965,12582,4388,20091,6759,3306,3453
16825,26060,5965,12583,4388,20094,6760,3306,3454
16830,26070,5966,12587,4388,20102,6762,3307,3455
16835,26076,5966,12590,4388,20109,6765,3310,3455
16840,26087,5968,12594,4389,20118,6767,3310,3457
16845,26091,5969,12597,4390,20121,6768,3310,3458
16850,26101,5972,12601,4392,20129,6770,3310,3460
16855,26107,5972,12604,4392,20134,6773,3311,3462
16860,26118,5974,12608,4394,20142,6775,3311,3464
16865,26122,5974,12609,4394,20148,6776,3311,3465
16870,26132,5977,12613,4396,20155,6778,3313,3465
16875,26138,5977,12614,4396,20161,6781,3313,3468
16880,26149,5980,12619,4397,20168,6783,3314,3469
16885,26153,5981,12621,4398,20171,6784,3314,3470
16890,26163,5983,12625,4400,20180,6786,3315,3471
16895,26169,5983,12627,4400,20185,6789,3315,3474
16900,26180,5986,12633,4401,20192,6791,3317,3474
16905,26184,5986,12635,4401,20197,6792,3318,3474
16910,26194,5990,12641,4403,20203,6794,3319,3475
16915,26200,5990,12646,4403,20208,6797,3321,3476
16920,26211,5995,12652,4407,20214,6799,3322,3477
16925,26215,5996,12656,4408,20219,6800,3323,3477
16930,26225,5999,12661,4410,20225,6802,3323,3479
16935,26231,5999,12664,4410,20231,6805,3324,3481
16940,26242,6003,12671,4413,20237,6807,3326,3481
16945,26246,6004,12673,4414,20242,6808,3326,3482
16950,26256,6007,12677,4417,20249,6810,3326,3484
16955,26262,6007,12680,4417,20254,6813,3327,3486
16960,26273,6011,12687,4421,20261,6815,3328,3487
16965,26277,6013,12688,4423,20264,6816,3328,3488
16970,26287,6017,12693,4425,20270,6818,3329,3489
16975,26293,6017,12696,4425,20276,6821,3330,3491
16980,26304,6022,12703,4430,20282,6823,3331,3492
16985,26308,6022,12704,4430,20286,6824,3332,3492
16990,26318,6025,12709,4432,20293,6826,3332,3494
16995,26324,6025,12711,4432,20299,6829,3334,3495
17000,26335,6028,12718,4435,20307,6831,3336,3495
17005,26339,6029,12720,4436,20310,6832,3337,3495
17010,26349,6032,12725,4437,20316,6834,3338,3496
17015,26355,6032,12729,4437,20323,6837,3341,3496
17020,26366,6035,12733,4439,20330,6839,3342,3497
17025,26370,6037,12735,4441,20333,6840,3343,3497
17030,26380,6040,12739,4443,20339,6842,3343,3499
17035,26386,6040,12741,4443,20346,6845,3345,3500
17040,26397,6043,12746,4445,20354,6847,3346,3501
17045,26401,6045,12749,4447,20356,6848,3347,3501
17050,26411,6049,12755,4450,20362,6850,3349,3501
17055,26417,6049,12758,4450,20366,6853,3350,3503
17060,26428,6055,12765,4455,20371,6855,3352,3503
17065,26432,6058,12768,4458,20373,6856,3353,3503
17070,26442,6062,12771,4461,20380,6858,3354,3504
17075,26448,6062,12774,4461,20384,6861,3355,3506
17080,26459,6066,12781,4464,20391,6863,3356,3507
17085,26463,6066,12781,4464,20397,6864,3356,3508
17090,26473,6069,12785,4467,20404,6866,3356,3510
17095,26479,6069,12789,4467,20409,6869,3358,3511
17100,26490,6071,12795,4468,20416,6871,3359,3512
17105,26494,6071,12798,4468,20422,6872,3360,3512
17110,26504,6072,12802,4468,20431,6874,3360,3514
17115,26510,6072,12806,4468,20438,6877,3363,3514
17120,26521,6073,12809,4469,20448,6879,3363,3516
17125,26525,6073,12811,4469,20452,6880,3363,3517
17130,26535,6074,12819,4470,20460,6882,3364,3518
17135,26541,6074,12820,4470,20467,6885,3365,3520
17140,26552,6075,12828,4471,20476,6887,3367,3520
17145,26556,6075,12829,4471,20480,6888,3367,3521
17150,26566,6076,12832,4471,20489,6890,3367,3523
17155,26572,6076,12835,4471,20496,6893,3369,3524
17160,26583,6077,12839,4471,20504,6895,3369,3526
17165,26587,6077,12841,4471,20510,6896,3369,3527
17170,26597,6078,12847,4471,20518,6898,3370,3528
17175,26603,6078,12849,4471,20524,6901,3371,3530
17180,26614,6079,12854,4472,20534,6903,3372,3531
17185,26618,6080,12857,4473,20538,6904,3373,3531
17190,26628,6082,12863,4473,20545,6906,3373,3533
17195,26634,6082,12864,4473,20552,6909,3374,3535
17200,26645,6083,12870,4474,20561,6911,3375,3536
17205,26649,6084,12872,4475,20565,6912,3375,3537
17210,26659,6087,12876,4477,20571,6914,3376,3538
17215,26665,6087,12879,4477,20577,6917,3378,3539
17220,26676,6092,12885,4480,20582,6919,3378,3541
17225,26680,6094,12888,4482,20586,6920,3379,3541
17230,26690,6096,12892,4483,20593,6922,3381,3541
17235,26696,6096,12894,4483,20600,6925,3383,3542
17240,26707,6101,12900,4488,20606,6927,3383,3544
17245,26711,6101,12901,4488,20610,6928,3384,3544
17250,26721,6103,12907,4490,20617,6930,3385,3545
17255,26727,6103,12909,4490,20623,6933,3385,3548
17260,26738,6109,12915,4495,20629,6935,3387,3548
17265,26742,6110,12918,4496,20632,6936,3388,3548
17270,26752,6114,12923,4498,20636,6938,3388,3550
17275,26758,6115,12925,4499,20641,6941,3389,3552
17280,26769,6122,12934,4506,20644,6943,3390,3553
17285,26773,6127,12937,4511,20646,6944,3390,3554
17290,26783,6130,12942,4512,20652,6946,3392,3554
17295,26789,6130,12944,4512,20658,6949,3393,3556
17300,26800,6135,12952,4516,20664,6951,3395,3556
17305,26804,6138,12954,4519,20666,6952,3395,3557
17310,26814,6139,12960,4520,20674,6954,3396,3558
17315,26820,6139,12960,4520,20681,6957,3396,3561
17320,26831,6142,12967,4523,20689,6959,3398,3561
17325,26835,6143,12970,4524,20692,6960,3399,3561
17330,26845,6146,12979,4527,20698,6962,3401,3561
17335,26851,6146,12984,4527,20705,6965,3404,3561
17340,26862,6148,12991,4529,20714,6967,3406,3561
17345,26866,6148,12993,4529,20718,6968,3407,3561
17350,26876,6150,12997,4531,20725,6970,3407,3563
17355,26882,6150,12999,4531,20731,6973,3407,3566
17360,26893,6153,13002,4532,20740,6975,3408,3567
17365,26897,6153,13003,4532,20744,6976,3408,3568
17370,26907,6155,13009,4533,20751,6978,3410,3568
17375,26913,6155,13012,4533,20758,6981,3411,3570
17380,26924,6158,13017,4534,20766,6983,3412,3571
17385,26928,6158,13018,4534,20770,6984,3412,3572
17390,26938,6161,13024,4537,20776,6986,3413,3573
17395,26944,6161,13026,4537,20782,6989,3414,3575
17400,26955,6163,13034,4538,20791,6991,3415,3576
17405,26959,6164,13036,4539,20795,6992,3416,3576
17410,26969,6168,13041,4543,20800,6994,3416,3578
17415,26975,6168,13043,4543,20806,6997,3417,3580
17420,26986,6172,13049,4546,20814,6999,3417,3582
17425,26990,6173,13051,4547,20817,7000,3418,3582
17430,27000,6175,13056,4548,20824,7002,3420,3582
17435,27006,6175,13060,4548,20830,7005,3422,3583
17440,27017,6180,13065,4551,20835,7007,3422,3585
17445,27021,6181,13068,4552,20839,7008,3423,3585
17450,27031,6183,13071,4553,20846,7010,3423,3587
17455,27037,6183,13076,4553,20853,7013,3426,3587
17460,27048,6186,13084,4555,20859,7015,3428,3587
17465,27052,6188,13085,4557,20864,7016,3428,3588
17470,27062,6191,13093,4559,20870,7018,3430,3588
17475,27068,6191,13096,4559,20877,7021,3432,3589
17480,27079,6193,13103,4561,20884,7023,3433,3590
17485,27083,6193,13104,4561,20890,7024,3433,3591
17490,27093,6195,13108,4561,20897,7026,3435,3591
17495,27099,6195,13113,4561,20902,7029,3438,3591
17500,27110,6198,13120,4564,20909,7031,3440,3591
17505,27114,6199,13123,4565,20915,7032,3441,3591
17510,27124,6201,13128,4566,20922,7034,3442,3592
17515,27130,6201,13131,4566,20929,7037,3444,3593
17520,27141,6202,13138,4567,20936,7039,3446,3593
17525,27145,6203,13139,4568,20942,7040,3446,3594
17530,27155,6205,13144,4569,20949,7042,3447,3595
17535,27161,6205,13146,4569,20955,7045,3448,3597
17540,27172,6209,13154,4573,20961,7047,3448,3599
17545,27176,6211,13157,4575,20965,7048,3449,3599
17550,27186,6213,13158,4575,20972,7050,3450,3600
17555,27192,6213,13160,4575,20978,7053,3451,3602
17560,27203,6215,13163,4576,20988,7055,3452,3603
17565,27207,6216,13167,4577,20991,7056,3453,3603
17570,27217,6218,13172,4578,20998,7058,3453,3605
17575,27223,6218,13173,4578,21004,7061,3453,3608
17580,27234,6221,13182,4581,21011,7063,3455,3608
17585,27238,6223,13184,4583,21015,7064,3455,3609
17590,27248,6227,13189,4586,21020,7066,3456,3610
17595,27254,6227,13192,4586,21027,7069,3457,3612
17600,27265,6230,13199,4589,21034,7071,3458,3613
17605,27269,6232,13201,4591,21037,7072,3459,3613
17610,27279,6236,13207,4594,21042,7074,3460,3614
17615,27285,6236,13212,4594,21049,7077,3463,3614
17620,27296,6238,13215,4595,21057,7079,3463,3616
17625,27300,6241,13218,4598,21059,7080,3463,3617
17630,27310,6245,13223,4601,21064,7082,3464,3618
17635,27316,6245,13225,4601,21070,7085,3465,3620
17640,27327,6250,13229,4606,21077,7087,3465,3622
17645,27331,6251,13231,4607,21080,7088,3465,3623
17650,27341,6253,13235,4609,21087,7090,3465,3625
17655,27347,6253,13237,4609,21094,7093,3466,3627
17660,27358,6256,13242,4611,21102,7095,3466,3629
17665,27362,6256,13244,4611,21106,7096,3467,3629
17670,27372,6258,13249,4612,21113,7098,3468,3630
17675,27378,6258,13254,4612,21119,7101,3470,3631
17680,27389,6260,13258,4613,21129,7103,3470,3633
17685,27393,6261,13259,4614,21132,7104,3470,3634
17690,27403,6263,13264,4616,21139,7106,3471,3635
17695,27409,6263,13267,4616,21145,7109,3472,3637
17700,27420,6265,13269,4617,21155,7111,3472,3639
17705,27424,6266,13270,4618,21158,7112,3472,3640
17710,27434,6267,13275,4618,21166,7114,3473,3641
17715,27440,6267,13279,4618,21172,7117,3475,3642
17720,27451,6269,13283,4618,21181,7119,3476,3643
17725,27455,6269,13284,4618,21186,7120,3477,3643
17730,27465,6271,13286,4619,21194,7122,3477,3645
17735,27471,6271,13290,4619,21199,7125,3479,3646
17740,27482,6274,13294,4620,21207,7127,3480,3647
17745,27486,6275,13295,4621,21211,7128,3480,3648
17750,27496,6278,13301,4623,21216,7130,3482,3648
17755,27502,6279,13304,4624,21221,7133,3484,3649
17760,27513,6283,13310,4627,21227,7135,3486,3649
17765,27517,6287,13313,4631,21229,7136,3487,3649
17770,27527,6289,13316,4632,21238,7138,3488,3650
17775,27533,6289,13318,4632,21244,7141,3489,3652
17780,27544,6292,13322,4633,21250,7143,3490,3653
17785,27548,6294,13324,4635,21253,7144,3490,3654
17790,27558,6297,13329,4636,21259,7146,3491,3655
17795,27564,6297,13332,4636,21266,7149,3492,3657
17800,27575,6299,13334,4637,21275,7151,3492,3659
17805,27579,6299,13335,4637,21279,7152,3492,3660
17810,27589,6302,13340,4638,21286,7154,3494,3660
17815,27595,6302,13342,4638,21292,7157,3495,3662
17820,27606,6305,13347,4641,21300,7159,3496,3663
17825,27610,6305,13347,4641,21305,7160,3496,3664
17830,27620,6307,13351,4643,21313,7162,3497,3665
17835,27626,6307,13353,4643,21319,7165,3499,3666
17840,27637,6309,13355,4644,21328,7167,3499,3668
17845,27641,6309,13356,4644,21332,7168,3499,3669
17850,27651,6311,13362,4646,21340,7170,3500,3670
17855,27657,6311,13365,4646,21345,7173,3501,3672
17860,27668,6314,13370,4648,21354,7175,3502,3673
17865,27672,6315,13374,4649,21357,7176,3503,3673
17870,27682,6318,13378,4651,21363,7178,3504,3674
17875,27688,6318,13384,4651,21368,7181,3507,3674
17880,27699,6321,13387,4652,21378,7183,3509,3674
17885,27703,6322,13388,4653,21381,7184,3509,3675
17890,27713,6325,13392,4655,21387,7186,3510,3676
17895,27719,6325,13394,4655,21394,7189,3512,3677
17900,27730,6329,13396,4657,21401,7191,3512,3679
17905,27734,6330,13399,4658,21404,7192,3513,3679
17910,27744,6332,13402,4659,21412,7194,3514,3680
17915,27750,6332,13406,4659,21416,7197,3515,3682
17920,27761,6335,13408,4660,21425,7199,3515,3684
17925,27765,6336,13411,4661,21429,7200,3516,3684
17930,27775,6341,13420,4665,21433,7202,3518,3684
17935,27781,6341,13425,4665,21439,7205,3521,3684
17940,27792,6345,13427,4668,21447,7207,3521,3686
17945,27796,6346,13430,4669,21450,7208,3522,3686
17950,27806,6348,13431,4669,21457,7210,3522,3688
17955,27812,6348,13434,4669,21463,7213,3523,3690
17960,27823,6353,13439,4673,21469,7215,3523,3692
17965,27827,6354,13440,4674,21473,7216,3524,3692
17970,27837,6358,13447,4677,21478,7218,3526,3692
17975,27843,6358,13449,4677,21485,7221,3528,3693
17980,27854,6362,13454,4680,21491,7223,3528,3695
17985,27858,6363,13456,4681,21495,7224,3529,3695
17990,27868,6367,13460,4684,21501,7226,3529,3697
17995,27874,6367,13462,4684,21507,7229,3530,3699
18000,27885,6371,13469,4687,21513,7231,3531,3700
18005,27889,6373,13471,4689,21516,7232,3532,3700
18010,27899,6378,13479,4693,21520,7234,3533,3701
18015,27905,6378,13481,4693,21527,7237,3534,3703
18020,27916,6381,13488,4695,21535,7239,3535,3704
18025,27920,6381,13490,4695,21539,7240,3535,3705
18030,27930,6383,13494,4696,21546,7242,3536,3706
18035,27936,6383,13498,4696,21551,7245,3538,3707
18040,27947,6386,13503,4698,21561,7247,3539,3708
18045,27951,6387,13505,4699,21564,7248,3540,3708
18050,27961,6390,13510,4702,21571,7250,3540,3710
18055,27967,6390,13513,4702,21576,7253,3542,3711
18060,27978,6392,13520,4703,21583,7255,3543,3712
18065,27982,6392,13521,4703,21590,7256,3543,3713
18070,27992,6393,13525,4703,21597,7258,3544,3714
18075,27998,6393,13526,4703,21603,7261,3544,3717
18080,28009,6396,13531,4705,21612,7263,3545,3718
18085,28013,6397,13532,4706,21616,7264,3545,3719
18090,28023,6399,13538,4707,21623,7266,3547,3719
18095,28029,6399,13540,4707,21628,7269,3548,3721
18100,28040,6402,13545,4710,21637,7271,3548,3723
18105,28044,6403,13549,4711,21640,7272,3549,3723
18110,28054,6406,13555,4714,21647,7274,3549,3725
18115,28060,6406,13557,4714,21654,7277,3551,3726
18120,28071,6408,13561,4716,21662,7279,3552,3727
18125,28075,6408,13562,4716,21667,7280,3552,3728
18130,28085,6410,13565,4718,21675,7282,3553,3729
18135,28091,6410,13568,4718,21680,7285,3555,3730
18140,28102,6413,13574,4721,21687,7287,3557,3730
18145,28106,6415,13576,4723,21691,7288,3558,3730
18150,28116,6417,13578,4723,21699,7290,3559,3731
18155,28122,6417,13579,4723,21705,7293,3560,3733
18160,28133,6419,13584,4724,21712,7295,3562,3733
18165,28137,6421,13586,4726,21716,7296,3562,3734
18170,28147,6425,13591,4729,21721,7298,3563,3735
18175,28153,6425,13594,4729,21727,7301,3564,3737
18180,28164,6429,13599,4732,21733,7303,3565,3738
18185,28168,6429,13600,4732,21739,7304,3565,3739
18190,28178,6433,13604,4735,21745,7306,3565,3741
18195,28184,6433,13606,4735,21749,7309,3565,3744
18200,28195,6436,13617,4738,21757,7311,3567,3744
18205,28199,6437,13619,4739,21762,7312,3567,3745
18210,28209,6439,13624,4739,21769,7314,3568,3746
18215,28215,6439,13625,4739,21775,7317,3568,3749
18220,28226,6440,13628,4739,21785,7319,3569,3750
18225,28230,6442,13630,4741,21788,7320,3569,3751
18230,28240,6444,13636,4743,21796,7322,3569,3753
18235,28246,6444,13641,4743,21800,7325,3571,3754
18240,28257,6447,13645,4745,21810,7327,3571,3756
18245,28261,6447,13645,4745,21814,7328,3571,3757
18250,28271,6449,13649,4746,21821,7330,3571,3759
18255,28277,6449,13653,4746,21827,7333,3573,3760
18260,28288,6452,13660,4748,21836,7335,3575,3760
18265,28292,6453,13661,4749,21839,7336,3575,3761
18270,28302,6455,13668,4751,21847,7338,3577,3761
18275,28308,6455,13671,4751,21852,7341,3579,3762
18280,28319,6458,13674,4754,21861,7343,3580,3763
18285,28323,6459,13676,4755,21864,7344,3580,3764
18290,28333,6461,13679,4756,21871,7346,3580,3766
18295,28339,6461,13679,4756,21878,7349,3580,3769
18300,28350,6465,13683,4758,21885,7351,3581,3770
18305,28354,6466,13684,4759,21888,7352,3581,3771
18310,28364,6469,13688,4761,21895,7354,3582,3772
18315,28370,6469,13690,4761,21901,7357,3583,3774
18320,28381,6474,13696,4765,21907,7359,3584,3775
18325,28385,6474,13697,4765,21911,7360,3585,3775
18330,28395,6477,13700,4767,21918,7362,3586,3776
18335,28401,6477,13703,4767,21923,7365,3587,3778
18340,28412,6481,13708,4770,21930,7367,3588,3779
18345,28416,6483,13710,4772,21933,7368,3589,3779
18350,28426,6485,13714,4774,21939,7370,3589,3781
18355,28432,6486,13717,4775,21944,7373,3591,3782
18360,28443,6491,13723,4779,21949,7375,3592,3783
18365,28447,6492,13725,4780,21955,7376,3593,3783
18370,28457,6493,13731,4781,21962,7378,3594,3784
18375,28463,6493,13734,4781,21968,7381,3596,3785
18380,28474,6495,13740,4782,21976,7383,3597,3786
18385,28478,6495,13742,4782,21982,7384,3598,3786
18390,28488,6496,13745,4783,21992,7386,3599,3787
18395,28494,6496,13748,4783,21998,7389,3601,3788
18400,28505,6499,13754,4786,22005,7391,3602,3789
18405,28509,6500,13756,4787,22009,7392,3603,3789
18410,28519,6503,13763,4790,22016,7394,3604,3790
18415,28525,6503,13766,4790,22021,7397,3606,3791
18420,28536,6506,13773,4793,22030,7399,3607,3792
18425,28540,6507,13776,4794,22032,7400,3607,3793
18430,28550,6509,13779,4795,22040,7402,3607,3795
18435,28556,6509,13783,4795,22046,7405,3608,3797
18440,28567,6512,13787,4796,22053,7407,3608,3799
18445,28571,6512,13788,4796,22058,7408,3608,3800
18450,28581,6513,13791,4797,22068,7410,3609,3801
18455,28587,6513,13793,4797,22073,7413,3610,3803
18460,28598,6515,13798,4798,22082,7415,3611,3804
18465,28602,6515,13801,4798,22087,7416,3612,3804
18470,28612,6518,13807,4799,22093,7418,3614,3804
18475,28618,6518,13811,4799,22098,7421,3616,3805
18480,28629,6522,13816,4803,22106,7423,3616,3807
18485,28633,6523,13817,4804,22110,7424,3616,3808
18490,28643,6526,13820,4806,22117,7426,3616,3810
18495,28649,6526,13823,4806,22122,7429,3617,3812
18500,28660,6529,13825,4807,22131,7431,3617,3814
18505,28664,6530,13827,4808,22134,7432,3618,3814
18510,28674,6533,13831,4810,22141,7434,3619,3815
18515,28680,6533,13835,4810,22146,7437,3620,3817
18520,28691,6536,13840,4812,22155,7439,3622,3817
18525,28695,6537,13842,4813,22158,7440,3622,3818
18530,28705,6540,13847,4816,22165,7442,3624,3818
18535,28711,6540,13851,4816,22171,7445,3626,3819
18540,28722,6543,13857,4819,22179,7447,3627,3820
18545,28726,6545,13861,4821,22181,7448,3628,3820
18550,28736,6547,13867,4823,22188,7450,3628,3822
18555,28742,6547,13870,4823,22195,7453,3630,3823
18560,28753,6550,13874,4825,22203,7455,3632,3823
18565,28757,6552,13877,4827,22205,7456,3633,3823
18570,28767,6556,13882,4829,22210,7458,3634,3824
18575,28773,6556,13885,4829,22217,7461,3636,3825
18580,28784,6559,13890,4831,22225,7463,3637,3826
18585,28788,6561,13893,4833,22226,7464,3637,3827
18590,28798,6565,13899,4837,22232,7466,3639,3827
18595,28804,6566,13902,4838,22237,7469,3641,3828
18600,28815,6570,13906,4840,22243,7471,3642,3829
18605,28819,6573,13907,4843,22246,7472,3642,3830
18610,28829,6577,13913,4846,22250,7474,3643,3831
18615,28835,6578,13915,4847,22256,7477,3645,3832
18620,28846,6581,13918,4848,22263,7479,3646,3833
18625,28850,6584,13920,4851,22266,7480,3647,3833
18630,28860,6586,13923,4853,22274,7482,3648,3834
18635,28866,6586,13928,4853,22278,7485,3651,3834
18640,28877,6592,13935,4858,22282,7487,3652,3835
18645,28881,6595,13935,4861,22286,7488,3652,3836
18650,28891,6598,13939,4863,22292,7490,3653,3837
18655,28897,6598,13940,4863,22298,7493,3653,3840
18660,28908,6600,13945,4864,22305,7495,3653,3842
18665,28912,6600,13947,4864,22312,7496,3654,3842
18670,28922,6601,13951,4865,22320,7498,3655,3843
18675,28928,6601,13954,4865,22325,7501,3656,3845
18680,28939,6604,13960,4867,22333,7503,3657,3846
18685,28943,6604,13961,4867,22339,7504,3658,3846
18690,28953,6606,13968,4869,22345,7506,3659,3847
18695,28959,6606,13971,4869,22353,7509,3660,3849
18700,28970,6609,13976,4871,22361,7511,3662,3849
18705,28974,6609,13977,4871,22365,7512,3662,3850
18710,28984,6611,13979,4872,22373,7514,3663,3851
18715,28990,6611,13983,4872,22378,7517,3664,3853
18720,29001,6613,13986,4873,22388,7519,3665,3854
18725,29005,6613,13987,4873,22392,7520,3665,3855
18730,29015,6615,13990,4874,22400,7522,3666,3856
18735,29021,6615,13992,4874,22405,7525,3666,3859
18740,29032,6617,13995,4875,22414,7527,3667,3860
18745,29036,6617,13995,4875,22419,7528,3667,3861
18750,29046,6618,13998,4875,22427,7530,3669,3861
18755,29052,6618,14003,4875,22432,7533,3671,3862
18760,29063,6623,14010,4879,22440,7535,3673,3862
18765,29067,6624,14012,4880,22443,7536,3673,3863
18770,29077,6627,14017,4882,22449,7538,3673,3865
18775,29083,6627,14019,4882,22455,7541,3674,3867
18780,29094,6630,14024,4885,22463,7543,3674,3869
18785,29098,6631,14024,4886,22467,7544,3674,3870
18790,29108,6633,14030,4887,22474,7546,3676,3870
18795,29114,6633,14035,4887,22479,7549,3678,3871
18800,29125,6637,14041,4891,22487,7551,3678,3873
18805,29129,6639,14044,4893,22490,7552,3679,3873
18810,29139,6642,14048,4895,22497,7554,3680,3874
18815,29145,6642,14051,4895,22502,7557,3681,3876
18820,29156,6646,14054,4898,22510,7559,3682,3877
18825,29160,6648,14057,4900,22512,7560,3683,3877
18830,29170,6651,14062,4902,22519,7562,3684,3878
18835,29176,6651,14067,4902,22524,7565,3687,3878
18840,29187,6655,14072,4905,22532,7567,3688,3879
18845,29191,6655,14073,4905,22536,7568,3688,3880
18850,29201,6660,14080,4910,22540,7570,3688,3882
18855,29207,6660,14081,4910,22546,7573,3688,3885
18860,29218,6666,14091,4916,22551,7575,3690,3885
18865,29222,6668,14093,4918,22554,7576,3690,3886
18870,29232,6672,14100,4921,22559,7578,3692,3886
18875,29238,6672,14103,4921,22565,7581,3694,3887
18880,29249,6678,14108,4926,22571,7583,3695,3888
18885,29253,6680,14111,4928,22573,7584,3696,3888
18890,29263,6684,14115,4930,22579,7586,3697,3889
18895,29269,6684,14118,4930,22585,7589,3699,3890
18900,29280,6687,14125,4933,22593,7591,3701,3890
18905,29284,6687,14128,4933,22596,7592,3702,3890
18910,29294,6690,14131,4935,22604,7594,3702,3892
18915,29300,6690,14135,4935,22609,7597,3704,3893
18920,29311,6693,14139,4937,22616,7599,3704,3895
18925,29315,6694,14140,4938,22621,7600,3704,3896
18930,29325,6696,14145,4940,22628,7602,3704,3898
18935,29331,6696,14148,4940,22634,7605,3706,3899
18940,29342,6699,14152,4941,22641,7607,3706,3901
18945,29346,6700,14154,4942,22645,7608,3706,3902
18950,29356,6702,14157,4943,22653,7610,3706,3904
18955,29362,6702,14159,4943,22658,7613,3707,3906
18960,29373,6705,14167,4945,22666,7615,3709,3906
18965,29377,6705,14167,4945,22672,7616,3709,3907
18970,29387,6706,14171,4946,22680,7618,3710,3908
18975,29393,6706,14174,4946,22686,7621,3711,3910
18980,29404,6707,14179,4946,22695,7623,3712,3911
18985,29408,6707,14180,4946,22700,7624,3712,3912
18990,29418,6708,14184,4947,22708,7626,3712,3914
18995,29424,6708,14187,4947,22715,7629,3713,3916
19000,29435,6710,14194,4949,22722,7631,3714,3917
19005,29439,6711,14197,4950,22728,7632,3715,3917
19010,29449,6713,14202,4952,22735,7634,3715,3919
19015,29455,6713,14206,4952,22741,7637,3717,3920
19020,29466,6715,14213,4954,22750,7639,3718,3921
19025,29470,6715,14214,4954,22755,7640,3719,3921
19030,29480,6717,14219,4954,22762,7642,3721,3921
19035,29486,6717,14222,4954,22768,7645,3722,3923
19040,29497,6719,14227,4956,22777,7647,3723,3924
19045,29501,6720,14229,4957,22781,7648,3724,3924
19050,29511,6722,14236,4959,22789,7650,3726,3924
19055,29517,6722,14238,4959,22794,7653,3726,3927
19060,29528,6724,14248,4961,22804,7655,3728,3927
19065,29532,6724,14251,4961,22808,7656,3728,3928
19070,29542,6727,14257,4963,22815,7658,3730,3928
19075,29548,6727,14257,4963,22821,7661,3730,3931
19080,29559,6730,14265,4966,22829,7663,3732,3931
19085,29563,6730,14266,4966,22833,7664,3733,3931
19090,29573,6733,14270,4968,22839,7666,3733,3933
19095,29579,6733,14273,4968,22846,7669,3735,3934
19100,29590,6736,14277,4971,22854,7671,3736,3935
19105,29594,6736,14279,4971,22858,7672,3737,3935
19110,29604,6740,14284,4974,22863,7674,3738,3936
19115,29610,6740,14288,4974,22869,7677,3740,3937
19120,29621,6744,14292,4976,22876,7679,3741,3938
19125,29625,6746,14293,4978,22879,7680,3741,3939
19130,29635,6752,14299,4982,22883,7682,3743,3939
19135,29641,6752,14303,4982,22887,7685,3745,3940
19140,29652,6759,14309,4988,22892,7687,3746,3941
19145,29656,6762,14313,4991,22893,7688,3747,3941
19150,29666,6768,14320,4996,22897,7690,3749,3941
19155,29672,6768,14324,4996,22901,7693,3751,3942
19160,29683,6774,14330,5001,22907,7695,3753,3942
19165,29687,6775,14330,5002,22912,7696,3753,3943
19170,29697,6777,14336,5004,22918,7698,3753,3945
19175,29703,6777,14339,5004,22924,7701,3755,3946
19180,29714,6779,14343,5005,22933,7703,3755,3948
19185,29718,6780,14345,5006,22938,7704,3756,3948
19190,29728,6781,14350,5007,22946,7706,3758,3948
19195,29734,6781,14352,5007,22951,7709,3758,3951
19200,29745,6784,14359,5010,22960,7711,3759,3952
19205,29749,6784,14359,5010,22965,7712,3759,3953
19210,29759,6787,14367,5013,22971,7714,3761,3953
19215,29765,6787,14370,5013,22978,7717,3762,3955
19220,29776,6790,14376,5014,22986,7719,3763,3956
19225,29780,6791,14380,5015,22989,7720,3764,3956
19230,29790,6792,14386,5016,22998,7722,3766,3956
19235,29796,6792,14389,5016,23004,7725,3767,3958
19240,29807,6795,14396,5019,23012,7727,3768,3959
19245,29811,6795,14396,5019,23016,7728,3768,3960
19250,29821,6797,14401,5021,23024,7730,3769,3961
19255,29827,6797,14404,5021,23030,7733,3770,3963
19260,29838,6799,14411,5023,23039,7735,3771,3964
19265,29842,6800,14415,5024,23042,7736,3772,3964
19270,29852,6801,14419,5024,23051,7738,3774,3964
19275,29858,6801,14421,5024,23057,7741,3776,3965
19280,29869,6805,14426,5027,23063,7743,3776,3967
19285,29873,6807,14428,5029,23066,7744,3777,3967
19290,29883,6809,14430,5029,23074,7746,3778,3968
19295,29889,6809,14434,5029,23079,7749,3779,3970
19300,29900,6813,14440,5032,23087,7751,3780,3971
19305,29904,6814,14441,5033,23090,7752,3780,3972
19310,29914,6818,14447,5037,23096,7754,3781,3973
19315,29920,6818,14451,5037,23100,7757,3783,3974
19320,29931,6824,14456,5042,23106,7759,3784,3975
19325,29935,6826,14457,5044,23109,7760,3784,3976
19330,29945,6830,14461,5047,23115,7762,3785,3977
19335,29951,6830,14464,5047,23119,7765,3786,3979
19340,29962,6836,14472,5053,23123,7767,3787,3980
19345,29966,6841,14474,5058,23125,7768,3787,3981
19350,29976,6844,14478,5060,23130,7770,3787,3983
19355,29982,6845,14482,5061,23135,7773,3790,3983
19360,29993,6851,14487,5066,23141,7775,3790,3985
19365,29997,6852,14490,5067,23145,7776,3791,3985
19370,30007,6855,14496,5069,23151,7778,3793,3985
19375,30013,6855,14500,5069,23157,7781,3795,3986
19380,30024,6856,14506,5069,23166,7783,3797,3986
19385,30028,6856,14508,5069,23172,7784,3797,3987
19390,30038,6857,14515,5069,23181,7786,3799,3987
19395,30044,6857,14516,5069,23187,7789,3800,3989
19400,30055,6858,14518,5070,23197,7791,3800,3991
19405,30059,6858,14521,5070,23201,7792,3800,3992
19410,30069,6859,14527,5070,23209,7794,3801,3993
19415,30075,6859,14529,5070,23215,7797,3802,3995
19420,30086,6860,14533,5070,23226,7799,3802,3997
19425,30090,6860,14534,5070,23230,7800,3802,3998
19430,30100,6861,14541,5071,23238,7802,3802,4000
19435,30106,6861,14545,5071,23245,7805,3805,4000
19440,30117,6862,14552,5072,23255,7807,3806,4001
19445,30121,6862,14552,5072,23259,7808,3806,4002
19450,30131,6863,14555,5072,23268,7810,3807,4003
19455,30137,6863,14558,5072,23274,7813,3809,4004
19460,30148,6864,14563,5072,23284,7815,3810,4005
19465,30152,6864,14565,5072,23288,7816,3810,4006
19470,30162,6867,14567,5073,23295,7818,3810,4008
19475,30168,6867,14569,5073,23300,7821,3810,4011
19480,30179,6871,14574,5076,23308,7823,3812,4011
19485,30183,6873,14577,5078,23310,7824,3813,4011
19490,30193,6878,14582,5082,23315,7826,3813,4013
19495,30199,6878,14586,5082,23320,7829,3815,4014
19500,30210,6883,14591,5085,23327,7831,3817,4014
19505,30214,6884,14592,5086,23330,7832,3817,4015
19510,30224,6887,14595,5087,23336,7834,3818,4016
19515,30230,6887,14597,5087,23342,7837,3818,4019
19520,30241,6891,14604,5091,23349,7839,3820,4019
19525,30245,6892,14605,5092,23353,7840,3821,4019
19530,30255,6897,14611,5096,23357,7842,3821,4021
19535,30261,6897,14614,5096,23363,7845,3823,4022
19540,30272,6900,14617,5099,23372,7847,3823,4024
19545,30276,6902,14620,5101,23374,7848,3824,4024
19550,30286,6905,14624,5103,23380,7850,3825,4025
19555,30292,6905,14627,5103,23384,7853,3826,4027
19560,30303,6912,14631,5109,23390,7855,3826,4029
19565,30307,6912,14632,5109,23395,7856,3827,4029
19570,30317,6915,14637,5112,23402,7858,3827,4031
19575,30323,6915,14640,5112,23407,7861,3829,4032
19580,30334,6918,14647,5114,23414,7863,3829,4034
19585,30338,6919,14650,5115,23418,7864,3830,4034
19590,30348,6920,14652,5115,23427,7866,3830,4036
19595,30354,6920,14655,5115,23433,7869,3831,4038
19600,30365,6923,14662,5118,23441,7871,3833,4038
19605,30369,6923,14662,5118,23446,7872,3833,4039
19610,30379,6924,14667,5119,23454,7874,3834,4040
19615,30385,6924,14670,5119,23460,7877,3835,4042
19620,30396,6927,14676,5121,23468,7879,3837,4042
19625,30400,6927,14677,5121,23472,7880,3837,4043
19630,30410,6929,14683,5122,23479,7882,3839,4043
19635,30416,6929,14686,5122,23486,7885,3840,4045
19640,30427,6931,14693,5123,23494,7887,3842,4045
19645,30431,6932,14695,5124,23499,7888,3843,4045
19650,30441,6934,14700,5126,23507,7890,3845,4045
19655,30447,6934,14702,5126,23512,7893,3845,4048
19660,30458,6937,14707,5128,23520,7895,3846,4049
19665,30462,6937,14707,5128,23525,7896,3846,4050
19670,30472,6939,14711,5129,23532,7898,3846,4052
19675,30478,6939,14714,5129,23537,7901,3847,4054
19680,30489,6943,14720,5132,23544,7903,3847,4056
19685,30493,6944,14722,5133,23549,7904,3848,4056
19690,30503,6948,14727,5135,23555,7906,3850,4056
19695,30509,6948,14730,5135,23560,7909,3851,4058
19700,30520,6951,14733,5136,23568,7911,3851,4060
19705,30524,6954,14736,5139,23570,7912,3851,4061
19710,30534,6957,14742,5142,23577,7914,3852,4062
19715,30540,6957,14744,5142,23583,7917,3854,4063
19720,30551,6961,14748,5145,23590,7919,3854,4065
19725,30555,6961,14750,5145,23594,7920,3855,4065
19730,30565,6963,14755,5147,23602,7922,3856,4066
19735,30571,6963,14760,5147,23606,7925,3858,4067
19740,30582,6968,14768,5152,23614,7927,3859,4068
19745,30586,6970,14772,5154,23616,7928,3860,4068
19750,30596,6974,14779,5158,23621,7930,3860,4070
19755,30602,6974,14783,5158,23627,7933,3862,4071
19760,30613,6980,14789,5163,23632,7935,3862,4073
19765,30617,6981,14791,5164,23636,7936,3863,4073
19770,30627,6986,14796,5167,23640,7938,3864,4074
19775,30633,6986,14799,5167,23646,7941,3865,4076
19780,30644,6990,14805,5171,23653,7943,3866,4077
19785,30648,6991,14807,5172,23657,7944,3867,4077
19790,30658,6996,14812,5175,23662,7946,3868,4078
19795,30664,6996,14816,5175,23666,7949,3869,4080
19800,30675,7001,14823,5180,23674,7951,3870,4081
19805,30679,7002,14826,5181,23677,7952,3871,4081
19810,30689,7004,14831,5182,23685,7954,3873,4081
19815,30695,7004,14835,5182,23690,7957,3875,4082
19820,30706,7006,14840,5183,23700,7959,3877,4082
19825,30710,7006,14842,5183,23704,7960,3878,4082
19830,30720,7008,14843,5184,23712,7962,3878,4084
19835,30726,7008,14845,5184,23718,7965,3880,4085
19840,30737,7010,14850,5186,23727,7967,3881,4086
19845,30741,7010,14851,5186,23730,7968,3881,4087
19850,30751,7012,14853,5188,23739,7970,3881,4089
19855,30757,7012,14856,5188,23743,7973,3882,4091
19860,30768,7015,14866,5191,23750,7975,3884,4091
19865,30772,7016,14868,5192,23756,7976,3885,4091
19870,30782,7017,14871,5193,23765,7978,3886,4092
19875,30788,7017,14876,5193,23770,7981,3889,4092
19880,30799,7020,14882,5195,23778,7983,3890,4093
19885,30803,7020,14884,5195,23783,7984,3891,4093
19890,30813,7023,14889,5198,23790,7986,3892,4094
19895,30819,7023,14893,5198,23794,7989,3894,4095
19900,30830,7026,14898,5199,23802,7991,3894,4097
19905,30834,7028,14899,5201,23805,7992,3894,4098
19910,30844,7033,14904,5205,23810,7994,3895,4099
19915,30850,7033,14907,5205,23816,7997,3898,4099
19920,30861,7038,14911,5208,23822,7999,3899,4100
19925,30865,7038,14914,5208,23826,8000,3899,4101
19930,30875,7040,14918,5209,23835,8002,3901,4101
19935,30881,7040,14920,5209,23840,8005,3901,4104
19940,30892,7043,14924,5211,23849,8007,3902,4105
19945,30896,7043,14927,5211,23852,8008,3903,4105
19950,30906,7045,14932,5212,23861,8010,3904,4106
19955,30912,7045,14934,5212,23866,8013,3905,4108
19960,30923,7047,14942,5214,23874,8015,3907,4108
19965,30927,7047,14943,5214,23879,8016,3907,4109
19970,30937,7049,14950,5215,23887,8018,3908,4110
19975,30943,7049,14953,5215,23893,8021,3909,4112
19980,30954,7051,14956,5216,23901,8023,3909,4114
19985,30958,7052,14959,5217,23906,8024,3910,4114
19990,30968,7054,14962,5217,23914,8026,3911,4115
19995,30974,7054,14966,5217,23918,8029,3913,4116
20000,30985,7057,14971,5220,23928,8031,3915,4116
20005,30989,7057,14975,5220,23932,8032,3916,4116
20010,30999,7059,14982,5221,23939,8034,3917,4117
20015,31005,7059,14985,5221,23945,8037,3919,4118
20020,31016,7062,14993,5224,23953,8039,3919,4120
20025,31020,7064,14996,5226,23956,8040,3920,4120
20030,31030,7068,15000,5228,23962,8042,3920,4122
20035,31036,7068,15002,5228,23967,8045,3921,4124
20040,31047,7072,15007,5231,23974,8047,3922,4125
20045,31051,7073,15008,5232,23978,8048,3922,4126
20050,31061,7075,15013,5234,23986,8050,3923,4127
20055,31067,7075,15017,5234,23991,8053,3925,4128
20060,31078,7078,15020,5237,23999,8055,3925,4130
20065,31082,7081,15023,5240,24001,8056,3925,4131
20070,31092,7084,15027,5242,24008,8058,3926,4132
20075,31098,7084,15029,5242,24014,8061,3927,4134
20080,31109,7087,15034,5244,24022,8063,3929,4134
20085,31113,7089,15037,5246,24024,8064,3929,4135
20090,31123,7091,15040,5246,24031,8066,3930,4136
20095,31129,7091,15044,5246,24038,8069,3932,4137
20100,31140,7093,15048,5248,24047,8071,3933,4138
20105,31144,7094,15049,5249,24050,8072,3933,4139
20110,31154,7099,15054,5253,24054,8074,3934,4140
20115,31160,7099,15058,5253,24060,8077,3936,4141
20120,31171,7102,15060,5254,24069,8079,3937,4142
20125,31175,7102,15060,5254,24073,8080,3937,4143
20130,31185,7103,15064,5254,24081,8082,3939,4143
20135,31191,7103,15065,5254,24087,8085,3939,4146
20140,31202,7105,15071,5256,24096,8087,3939,4148
20145,31206,7105,15072,5256,24100,8088,3939,4149
20150,31216,7106,15073,5256,24109,8090,3939,4151
20155,31222,7106,15074,5256,24116,8093,3940,4153
20160,31233,7108,15079,5257,24124,8095,3942,4153
20165,31237,7108,15080,5257,24128,8096,3942,4154
20170,31247,7111,15087,5259,24135,8098,3943,4155
20175,31253,7111,15091,5259,24140,8101,3945,4156
20180,31264,7114,15098,5261,24148,8103,3947,4156
20185,31268,7114,15100,5261,24154,8104,3948,4156
20190,31278,7116,15106,5263,24160,8106,3949,4157
20195,31284,7116,15109,5263,24166,8109,3950,4159
20200,31295,7118,15117,5265,24174,8111,3952,4159
20205,31299,7119,15118,5266,24180,8112,3952,4160
20210,31309,7121,15123,5268,24187,8114,3954,4160
20215,31315,7121,15125,5268,24193,8117,3955,4162
20220,31326,7124,15131,5270,24199,8119,3956,4163
20225,31330,7126,15132,5272,24204,8120,3956,4164
20230,31340,7129,15138,5274,24210,8122,3958,4164
20235,31346,7129,15139,5274,24217,8125,3959,4166
20240,31357,7133,15145,5276,24223,8127,3960,4167
20245,31361,7135,15148,5278,24226,8128,3960,4168
20250,31371,7138,15152,5279,24232,8130,3960,4170
20255,31377,7138,15155,5279,24238,8133,3961,4172
20260,31388,7141,15157,5280,24246,8135,3962,4173
20265,31392,7142,15159,5281,24250,8136,3963,4173
20270,31402,7146,15166,5285,24255,8138,3964,4174
20275,31408,7146,15170,5285,24261,8141,3966,4175
20280,31419,7149,15173,5286,24269,8143,3967,4176
20285,31423,7149,15173,5286,24274,8144,3967,4177
20290,31433,7151,15177,5286,24281,8146,3968,4178
20295,31439,7151,15180,5286,24288,8149,3970,4179
20300,31450,7155,15186,5290,24295,8151,3971,4180
20305,31454,7155,15187,5290,24299,8152,3972,4180
20310,31464,7158,15193,5292,24305,8154,3974,4180
20315,31470,7158,15199,5292,24310,8157,3977,4180
20320,31481,7163,15206,5297,24316,8159,3978,4181
20325,31485,7164,15206,5298,24321,8160,3978,4182
20330,31495,7167,15210,5299,24326,8162,3979,4183
20335,31501,7168,15214,5300,24329,8165,3980,4185
20340,31512,7174,15218,5306,24336,8167,3980,4187
20345,31516,7178,15220,5310,24338,8168,3980,4188
20350,31526,7183,15225,5314,24342,8170,3980,4190
20355,31532,7183,15227,5314,24348,8173,3981,4192
20360,31543,7187,15232,5318,24356,8175,3982,4193
20365,31547,7187,15233,5318,24360,8176,3982,4194
20370,31557,7191,15238,5321,24365,8178,3984,4194
20375,31563,7191,15240,5321,24371,8181,3984,4197
20380,31574,7197,15244,5325,24377,8183,3984,4199
20385,31578,7198,15245,5326,24380,8184,3984,4200
20390,31588,7202,15250,5330,24385,8186,3984,4202
20395,31594,7202,15253,5330,24391,8189,3985,4204
20400,31605,7207,15262,5335,24398,8191,3986,4205
20405,31609,7207,15265,5335,24402,8192,3987,4205
20410,31619,7210,15269,5338,24408,8194,3988,4206
20415,31625,7210,15271,5338,24415,8197,3988,4209
20420,31636,7212,15274,5339,24424,8199,3988,4211
20425,31640,7212,15275,5339,24428,8200,3988,4212
20430,31650,7215,15279,5342,24434,8202,3988,4214
20435,31656,7215,15281,5342,24440,8205,3988,4217
20440,31667,7218,15287,5344,24449,8207,3988,4219
20445,31671,7219,15289,5345,24452,8208,3989,4219
20450,31681,7222,15295,5348,24458,8210,3991,4219
20455,31687,7222,15296,5348,24465,8213,3992,4221
20460,31698,7224,15300,5348,24474,8215,3994,4221
20465,31702,7224,15302,5348,24477,8216,3994,4222
20470,31712,7225,15308,5349,24485,8218,3995,4223
20475,31718,7225,15312,5349,24490,8221,3997,4224
20480,31729,7226,15320,5350,24502,8223,3998,4225
20485,31733,7226,15323,5350,24506,8224,3998,4226
20490,31743,7227,15328,5351,24515,8226,3998,4228
20495,31749,7227,15332,5351,24521,8229,4000,4229
20500,31760,7228,15336,5351,24531,8231,4000,4231
20505,31764,7228,15337,5351,24536,8232,4000,4232
20510,31774,7230,15344,5352,24543,8234,4001,4233
20515,31780,7230,15348,5352,24549,8237,4004,4233
20520,31791,7232,15351,5353,24559,8239,4004,4235
20525,31795,7232,15352,5353,24563,8240,4004,4236
20530,31805,7234,15355,5353,24570,8242,4005,4237
20535,31811,7234,15358,5353,24575,8245,4006,4239
20540,31822,7236,15363,5355,24583,8247,4007,4240
20545,31826,7237,15365,5356,24589,8248,4007,4241
20550,31836,7239,15371,5358,24596,8250,4007,4243
20555,31842,7239,15374,5358,24602,8253,4009,4244
20560,31853,7241,15380,5360,24609,8255,4010,4245
20565,31857,7241,15380,5360,24616,8256,4010,4246
20570,31867,7243,15382,5360,24623,8258,4010,4248
20575,31873,7243,15387,5360,24628,8261,4012,4249
20580,31884,7248,15391,5364,24635,8263,4012,4251
20585,31888,7249,15393,5365,24639,8264,4013,4251
20590,31898,7252,15399,5367,24645,8266,4014,4252
20595,31904,7252,15402,5367,24652,8269,4015,4254
20600,31915,7256,15409,5371,24659,8271,4017,4254
20605,31919,7256,15411,5371,24663,8272,4018,4254
20610,31929,7259,15416,5373,24669,8274,4019,4255
20615,31935,7259,15418,5373,24676,8277,4020,4257
20620,31946,7263,15424,5375,24682,8279,4021,4258
20625,31950,7266,15428,5378,24684,8280,4022,4258
20630,31960,7269,15433,5380,24690,8282,4024,4258
20635,31966,7269,15434,5380,24696,8285,4024,4261
20640,31977,7274,15442,5384,24703,8287,4026,4261
20645,31981,7276,15444,5386,24705,8288,4026,4262
20650,31991,7280,15448,5388,24710,8290,4027,4263
20655,31997,7280,15452,5388,24717,8293,4029,4264
20660,32008,7284,15457,5390,24724,8295,4031,4264
20665,32012,7285,15458,5391,24727,8296,4031,4265
20670,32022,7288,15461,5392,24734,8298,4032,4266
20675,32028,7288,15465,5392,24739,8301,4033,4268
20680,32039,7294,15471,5396,24744,8303,4033,4270
20685,32043,7296,15472,5398,24747,8304,4033,4271
20690,32053,7299,15477,5400,24753,8306,4034,4272
20695,32059,7299,15481,5400,24759,8309,4036,4273
20700,32070,7302,15489,5402,24766,8311,4038,4273
20705,32074,7302,15491,5402,24772,8312,4039,4273
20710,32084,7303,15495,5402,24781,8314,4040,4274
20715,32090,7303,15500,5402,24786,8317,4043,4274
20720,32101,7305,15504,5402,24794,8319,4044,4275
20725,32105,7305,15506,5402,24799,8320,4045,4275
20730,32115,7308,15511,5404,24806,8322,4045,4277
20735,32121,7308,15512,5404,24813,8325,4045,4280
20740,32132,7310,15515,5404,24821,8327,4046,4281
20745,32136,7311,15517,5405,24825,8328,4046,4282
20750,32146,7313,15524,5407,24831,8330,4047,4283
20755,32152,7313,15529,5407,24837,8333,4050,4283
20760,32163,7316,15533,5408,24845,8335,4050,4285
20765,32167,7316,15533,5408,24851,8336,4050,4286
20770,32177,7317,15538,5408,24859,8338,4052,4286
20775,32183,7317,15541,5408,24866,8341,4054,4287
20780,32194,7319,15545,5409,24874,8343,4055,4288
20785,32198,7319,15547,5409,24879,8344,4056,4288
20790,32208,7321,15552,5410,24886,8346,4058,4288
20795,32214,7321,15555,5410,24892,8349,4060,4289
20800,32225,7324,15561,5412,24899,8351,4061,4290
20805,32229,7324,15561,5412,24905,8352,4061,4291
20810,32239,7327,15566,5414,24911,8354,4061,4293
20815,32245,7327,15570,5414,24916,8357,4063,4294
20820,32256,7332,15576,5418,24923,8359,4064,4295
20825,32260,7332,15579,5418,24928,8360,4065,4295
20830,32270,7336,15586,5421,24933,8362,4066,4296
20835,32276,7336,15588,5421,24939,8365,4066,4299
20840,32287,7341,15596,5426,24946,8367,4067,4300
20845,32291,7341,15597,5426,24950,8368,4067,4301
20850,32301,7343,15602,5427,24957,8370,4069,4301
20855,32307,7343,15604,5427,24964,8373,4071,4302
20860,32318,7346,15609,5429,24972,8375,4072,4303
20865,32322,7346,15609,5429,24976,8376,4072,4304
20870,32332,7349,15613,5430,24983,8378,4073,4305
20875,32338,7349,15615,5430,24988,8381,4074,4307
20880,32349,7354,15620,5434,24994,8383,4075,4308
20885,32353,7356,15623,5436,24997,8384,4076,4308
20890,32363,7359,15626,5437,25003,8386,4077,4309
20895,32369,7359,15628,5437,25009,8389,4077,4312
20900,32380,7363,15633,5440,25017,8391,4077,4314
20905,32384,7363,15634,5440,25021,8392,4078,4314
20910,32394,7369,15641,5445,25024,8394,4079,4315
20915,32400,7369,15644,5445,25030,8397,4080,4317
20920,32411,7374,15652,5449,25037,8399,4082,4317
20925,32415,7374,15654,5449,25041,8400,4083,4317
20930,32425,7378,15661,5453,25047,8402,4085,4317
20935,32431,7378,15664,5453,25052,8405,4086,4319
20940,32442,7384,15668,5457,25058,8407,4086,4321
20945,32446,7386,15671,5459,25060,8408,4086,4322
20950,32456,7391,15677,5463,25064,8410,4086,4324
20955,32462,7391,15680,5463,25069,8413,4086,4327
20960,32473,7397,15687,5467,25075,8415,4087,4328
20965,32477,7398,15690,5468,25079,8416,4088,4328
20970,32487,7400,15694,5469,25086,8418,4088,4330
20975,32493,7400,15698,5469,25092,8421,4090,4331
20980,32504,7402,15705,5471,25102,8423,4091,4332
20985,32508,7403,15708,5472,25105,8424,4092,4332
20990,32518,7406,15715,5474,25111,8426,4093,4333
20995,32524,7406,15718,5474,25117,8429,4094,4335
21000,32535,7409,15727,5477,25124,8431,4096,4335
21005,32539,7409,15728,5477,25130,8432,4096,4336
21010,32549,7412,15735,5480,25136,8434,4098,4336
21015,32555,7412,15740,5480,25140,8437,4100,4337
21020,32566,7415,15744,5481,25151,8439,4101,4338
21025,32570,7415,15745,5481,25155,8440,4102,4338
21030,32580,7416,15746,5481,25164,8442,4102,4340
21035,32586,7416,15747,5481,25169,8445,4102,4343
21040,32597,7419,15751,5482,25178,8447,4103,4344
21045,32601,7420,15753,5483,25181,8448,4103,4345
21050,32611,7422,15756,5484,25189,8450,4104,4346
21055,32617,7422,15760,5484,25194,8453,4105,4348
21060,32628,7425,15764,5485,25201,8455,4105,4350
21065,32632,7425,15766,5485,25207,8456,4105,4351
21070,32642,7426,15771,5485,25215,8458,4106,4352
21075,32648,7426,15773,5485,25222,8461,4108,4353
21080,32659,7427,15777,5485,25230,8463,4109,4354
21085,32663,7427,15779,5485,25236,8464,4110,4354
21090,32673,7429,15783,5487,25244,8466,4110,4356
21095,32679,7429,15786,5487,25249,8469,4112,4357
21100,32690,7430,15791,5487,25258,8471,4114,4357
21105,32694,7430,15792,5487,25264,8472,4114,4358
21110,32704,7432,15795,5488,25271,8474,4115,4359
21115,32710,7432,15796,5488,25278,8477,4116,4361
21120,32721,7433,15802,5488,25285,8479,4117,4362
21125,32725,7434,15805,5489,25291,8480,4118,4362
21130,32735,7436,15811,5490,25299,8482,4120,4362
21135,32741,7436,15812,5490,25305,8485,4121,4364
21140,32752,7437,15816,5491,25313,8487,4121,4366
21145,32756,7438,15817,5492,25318,8488,4122,4366
21150,32766,7440,15824,5493,25326,8490,4124,4366
21155,32772,7440,15827,5493,25331,8493,4126,4367
21160,32783,7442,15832,5495,25340,8495,4127,4368
21165,32787,7443,15835,5496,25344,8496,4127,4369
21170,32797,7446,15839,5497,25351,8498,4128,4370
21175,32803,7446,15844,5497,25355,8501,4130,4371
21180,32814,7450,15850,5500,25362,8503,4132,4371
21185,32818,7453,15852,5503,25365,8504,4132,4372
21190,32828,7457,15857,5506,25371,8506,4133,4373
21195,32834,7457,15862,5506,25377,8509,4136,4373
21200,32845,7460,15867,5509,25385,8511,4138,4373
21205,32849,7460,15869,5509,25389,8512,4139,4373
21210,32859,7463,15872,5511,25396,8514,4140,4374
21215,32865,7463,15876,5511,25402,8517,4142,4375
21220,32876,7466,15882,5513,25410,8519,4143,4376
21225,32880,7467,15884,5514,25413,8520,4143,4377
21230,32890,7469,15889,5516,25420,8522,4143,4379
21235,32896,7469,15892,5516,25427,8525,4146,4379
21240,32907,7472,15896,5517,25435,8527,4147,4380
21245,32911,7473,15897,5518,25438,8528,4147,4381
21250,32921,7476,15901,5520,25445,8530,4148,4382
21255,32927,7476,15902,5520,25450,8533,4148,4385
21260,32938,7481,15909,5524,25456,8535,4150,4385
21265,32942,7482,15910,5525,25460,8536,4150,4386
21270,32952,7485,15918,5528,25466,8538,4152,4386
21275,32958,7485,15921,5528,25472,8541,4153,4388
21280,32969,7489,15925,5531,25480,8543,4154,4389
21285,32973,7491,15929,5533,25482,8544,4155,4389
21290,32983,7496,15938,5538,25485,8546,4157,4389
21295,32989,7497,15939,5539,25490,8549,4157,4392
21300,33000,7502,15945,5544,25495,8551,4157,4394
21305,33004,7506,15947,5548,25498,8552,4158,4394
21310,33014,7509,15949,5550,25505,8554,4158,4396
21315,33020,7509,15950,5550,25511,8557,4159,4398
21320,33031,7512,15955,5552,25518,8559,4160,4399
21325,33035,7514,15958,5554,25520,8560,4161,4399
21330,33045,7518,15962,5557,25526,8562,4162,4400
21335,33051,7518,15965,5557,25532,8565,4164,4401
21340,33062,7524,15973,5563,25537,8567,4165,4402
21345,33066,7524,15974,5563,25542,8568,4165,4403
21350,33076,7526,15980,5565,25550,8570,4166,4404
21355,33082,7526,15982,5565,25555,8573,4166,4407
21360,33093,7528,15987,5566,25565,8575,4167,4408
21365,33097,7529,15990,5567,25567,8576,4167,4409
21370,33107,7532,15994,5569,25575,8578,4168,4410
21375,33113,7532,15999,5569,25579,8581,4171,4410
21380,33124,7534,16003,5570,25589,8583,4173,4410
21385,33128,7534,16005,5570,25593,8584,4173,4411
21390,33138,7535,16009,5570,25602,8586,4175,4411
21395,33144,7535,16015,5570,25607,8589,4178,4411
21400,33155,7537,16017,5570,25618,8591,4179,4412
21405,33159,7537,16019,5570,25621,8592,4180,4412
21410,33169,7539,16024,5572,25629,8594,4180,4414
21415,33175,7539,16025,5572,25635,8597,4181,4416
21420,33186,7542,16028,5574,25644,8599,4181,4418
21425,33190,7542,16030,5574,25648,8600,4182,4418
21430,33200,7545,16037,5577,25655,8602,4183,4419
21435,33206,7545,16041,5577,25660,8605,4186,4419
21440,33217,7547,16045,5577,25669,8607,4188,4419
21445,33221,7548,16047,5578,25673,8608,4189,4419
21450,33231,7551,16051,5580,25679,8610,4189,4421
21455,33237,7551,16056,5580,25685,8613,4192,4421
21460,33248,7555,16061,5583,25692,8615,4193,4422
21465,33252,7555,16062,5583,25697,8616,4193,4423
21470,33262,7558,16064,5584,25703,8618,4193,4425
21475,33268,7558,16066,5584,25710,8621,4195,4426
21480,33279,7561,16073,5586,25715,8623,4196,4427
21485,33283,7562,16076,5587,25721,8624,4197,4427
21490,33293,7565,16080,5589,25728,8626,4197,4429
21495,33299,7565,16085,5589,25732,8629,4199,4430
21500,33310,7569,16090,5591,25740,8631,4200,4431
21505,33314,7570,16092,5592,25744,8632,4201,4431
21510,33324,7574,16097,5595,25750,8634,4203,4431
21515,33330,7574,16100,5595,25755,8637,4204,4433
21520,33341,7577,16103,5597,25764,8639,4205,4434
21525,33345,7579,16106,5599,25766,8640,4205,4435
21530,33355,7583,16113,5603,25772,8642,4206,4436
21535,33361,7583,16115,5603,25777,8645,4207,4438
21540,33372,7587,16119,5606,25785,8647,4207,4440
21545,33376,7587,16121,5606,25789,8648,4208,4440
21550,33386,7592,16127,5609,25794,8650,4210,4440
21555,33392,7592,16131,5609,25799,8653,4212,4441
21560,33403,7595,16136,5611,25806,8655,4212,4443
21565,33407,7598,16140,5614,25809,8656,4213,4443
21570,33417,7602,16146,5617,25814,8658,4214,4444
21575,33423,7602,16149,5617,25821,8661,4216,4445
21580,33434,7606,16155,5620,25828,8663,4217,4446
21585,33438,7606,16156,5620,25832,8664,4218,4446
21590,33448,7610,16162,5623,25837,8666,4220,4446
21595,33454,7611,16166,5624,25841,8669,4222,4447
21600,33465,7617,16175,5629,25844,8671,4224,4447
21605,33469,7622,16179,5634,25847,8672,4225,4447
21610,33479,7624,16186,5636,25854,8674,4226,4448
21615,33485,7624,16189,5636,25860,8677,4227,4450
21620,33496,7627,16195,5639,25869,8679,4228,4451
21625,33500,7627,16196,5639,25873,8680,4228,4452
21630,33510,7629,16201,5640,25880,8682,4229,4453
21635,33516,7629,16204,5640,25886,8685,4231,4454
21640,33527,7631,16212,5642,25896,8687,4233,4454
21645,33531,7631,16215,5642,25900,8688,4234,4454
21650,33541,7633,16220,5644,25907,8690,4235,4455
21655,33547,7633,16222,5644,25914,8693,4236,4457
21660,33558,7635,16224,5645,25923,8695,4237,4458
21665,33562,7635,16225,5645,25927,8696,4237,4459
21670,33572,7637,16232,5647,25934,8698,4238,4460
21675,33578,7637,16235,5647,25941,8701,4240,4461
21680,33589,7640,16240,5648,25949,8703,4241,4462
21685,33593,7640,16241,5648,25953,8704,4241,4463
21690,33603,7643,16250,5650,25959,8706,4243,4463
21695,33609,7643,16252,5650,25966,8709,4244,4465
21700,33620,7645,16257,5652,25975,8711,4244,4467
21705,33624,7645,16259,5652,25979,8712,4244,4468
21710,33634,7650,16263,5655,25983,8714,4244,4470
21715,33640,7650,16266,5655,25989,8717,4246,4471
21720,33651,7653,16271,5657,25997,8719,4247,4472
21725,33655,7654,16274,5658,26001,8720,4247,4473
21730,33665,7656,16279,5658,26008,8722,4249,4473
21735,33671,7656,16281,5658,26014,8725,4250,4475
21740,33682,7659,16287,5660,26021,8727,4251,4476
21745,33686,7660,16290,5661,26026,8728,4252,4476
21750,33696,7662,16296,5663,26033,8730,4254,4476
21755,33702,7662,16299,5663,26040,8733,4256,4477
21760,33713,7663,16304,5663,26048,8735,4258,4477
21765,33717,7664,16306,5664,26053,8736,4258,4478
21770,33727,7666,16308,5665,26061,8738,4258,4480
21775,33733,7666,16312,5665,26066,8741,4261,4480
21780,33744,7667,16319,5666,26074,8743,4262,4481
21785,33748,7668,16321,5667,26080,8744,4263,4481
21790,33758,7670,16325,5668,26087,8746,4263,4483
21795,33764,7670,16327,5668,26094,8749,4264,4485
21800,33775,7671,16335,5669,26100,8751,4265,4486
21805,33779,7672,16336,5670,26107,8752,4266,4486
21810,33789,7674,16339,5670,26114,8754,4266,4488
21815,33795,7674,16341,5670,26119,8757,4266,4491
21820,33806,7678,16348,5673,26127,8759,4268,4491
21825,33810,7679,16350,5674,26131,8760,4269,4491
21830,33820,7681,16357,5675,26138,8762,4271,4491
21835,33826,7681,16358,5675,26145,8765,4272,4493
21840,33837,7685,16364,5677,26150,8767,4274,4493
21845,33841,7687,16367,5679,26154,8768,4275,4493
21850,33851,7689,16373,5681,26161,8770,4276,4494
21855,33857,7689,16376,5681,26168,8773,4278,4495
21860,33868,7694,16383,5685,26173,8775,4279,4496
21865,33872,7696,16385,5687,26176,8776,4279,4497
21870,33882,7700,16388,5689,26182,8778,4279,4499
21875,33888,7700,16391,5689,26188,8781,4281,4500
21880,33899,7704,16396,5691,26194,8783,4283,4500
21885,33903,7706,16397,5693,26197,8784,4283,4501
21890,33913,7709,16402,5695,26204,8786,4285,4501
21895,33919,7709,16406,5695,26209,8789,4287,4502
21900,33930,7713,16411,5698,26216,8791,4288,4503
21905,33934,7716,16413,5701,26218,8792,4288,4504
21910,33944,7719,16419,5704,26224,8794,4290,4504
21915,33950,7719,16421,5704,26230,8797,4291,4506
21920,33961,7724,16429,5708,26236,8799,4293,4506
21925,33965,7725,16431,5709,26240,8800,4294,4506
21930,33975,7728,16434,5711,26247,8802,4295,4507
21935,33981,7728,16436,5711,26252,8805,4296,4509
21940,33992,7731,16442,5714,26260,8807,4297,4510
21945,33996,7733,16444,5716,26263,8808,4298,4510
21950,34006,7737,16449,5719,26269,8810,4300,4510
21955,34012,7737,16453,5719,26272,8813,4301,4512
21960,34023,7741,16457,5722,26281,8815,4301,4514
21965,34027,7741,16458,5722,26285,8816,4301,4515
21970,34037,7742,16461,5722,26294,8818,4302,4516
21975,34043,7742,16464,5722,26299,8821,4304,4517
21980,34054,7744,16468,5722,26308,8823,4306,4517
21985,34058,7745,16470,5723,26313,8824,4306,4518
21990,34068,7747,16476,5724,26319,8826,4308,4518
21995,34074,7747,16479,5724,26326,8829,4311,4518
22000,34085,7750,16482,5725,26335,8831,4312,4519
22005,34089,7750,16484,5725,26339,8832,4313,4519
22010,34099,7752,16489,5727,26345,8834,4314,4520
22015,34105,7752,16494,5727,26350,8837,4317,4520
22020,34116,7754,16499,5728,26361,8839,4317,4522
22025,34120,7755,16501,5729,26365,8840,4318,4522
22030,34130,7757,16505,5731,26372,8842,4318,4524
22035,34136,7757,16510,5731,26377,8845,4321,4524
22040,34147,7760,16518,5734,26385,8847,4323,4524
22045,34151,7760,16521,5734,26390,8848,4324,4524
22050,34161,7762,16526,5736,26399,8850,4325,4525
22055,34167,7762,16529,5736,26404,8853,4326,4527
22060,34178,7765,16535,5737,26411,8855,4327,4528
22065,34182,7767,16538,5739,26414,8856,4327,4529
22070,34192,7769,16543,5740,26422,8858,4329,4529
22075,34198,7769,16546,5740,26428,8861,4331,4530
22080,34209,7774,16551,5744,26433,8863,4331,4532
22085,34213,7775,16552,5745,26438,8864,4331,4533
22090,34223,7779,16560,5749,26444,8866,4332,4534
22095,34229,7779,16563,5749,26449,8869,4333,4536
22100,34240,7782,16570,5751,26457,8871,4335,4536
22105,34244,7783,16572,5752,26461,8872,4335,4537
22110,34254,7785,16577,5752,26468,8874,4337,4537
22115,34260,7785,16580,5752,26475,8877,4338,4539
22120,34271,7789,16588,5755,26482,8879,4340,4539
22125,34275,7789,16589,5755,26486,8880,4341,4539
22130,34285,7792,16594,5757,26492,8882,4342,4540
22135,34291,7792,16595,5757,26499,8885,4343,4542
22140,34302,7795,16601,5759,26506,8887,4344,4543
22145,34306,7797,16605,5761,26509,8888,4345,4543
22150,34316,7800,16606,5762,26516,8890,4345,4545
22155,34322,7800,16608,5762,26522,8893,4346,4547
22160,34333,7804,16613,5764,26528,8895,4348,4547
22165,34337,7805,16614,5765,26532,8896,4349,4547
22170,34347,7809,16623,5768,26537,8898,4351,4547
22175,34353,7809,16625,5768,26543,8901,4352,4549
22180,34364,7813,16629,5771,26550,8903,4353,4550
22185,34368,7815,16631,5773,26553,8904,4353,4551
22190,34378,7818,16635,5774,26560,8906,4354,4552
22195,34384,7818,16639,5774,26565,8909,4356,4553
22200,34395,7821,16645,5777,26573,8911,4357,4554
22205,34399,7823,16648,5779,26576,8912,4358,4554
22210,34409,7825,16650,5780,26583,8914,4358,4556
22215,34415,7825,16654,5780,26587,8917,4360,4557
22220,34426,7831,16660,5785,26594,8919,4361,4558
22225,34430,7833,16663,5787,26596,8920,4361,4559
22230,34440,7837,16670,5790,26601,8922,4362,4560
22235,34446,7837,16671,5790,26608,8925,4363,4562
22240,34457,7838,16677,5791,26617,8927,4365,4562
22245,34461,7838,16680,5791,26622,8928,4366,4562
22250,34471,7839,16684,5791,26630,8930,4366,4564
22255,34477,7839,16688,5791,26635,8933,4367,4566
22260,34488,7840,16695,5792,26646,8935,4368,4567
22265,34492,7840,16697,5792,26652,8936,4369,4567
22270,34502,7841,16701,5792,26661,8938,4371,4567
22275,34508,7841,16704,5792,26666,8941,4372,4569
22280,34519,7842,16710,5792,26675,8943,4373,4570
22285,34523,7842,16712,5792,26681,8944,4373,4571
22290,34533,7845,16716,5795,26687,8946,4373,4573
22295,34539,7845,16720,5795,26694,8949,4376,4573
22300,34550,7848,16726,5798,26702,8951,4377,4574
22305,34554,7848,16727,5798,26706,8952,4377,4575
22310,34564,7849,16731,5798,26714,8954,4378,4576
22315,34570,7849,16733,5798,26721,8957,4379,4578
22320,34581,7852,16738,5799,26729,8959,4381,4578
22325,34585,7853,16740,5800,26732,8960,4381,4579
22330,34595,7854,16745,5801,26741,8962,4382,4580
22335,34601,7854,16746,5801,26747,8965,4382,4583
22340,34612,7856,16750,5802,26756,8967,4383,4584
22345,34616,7856,16752,5802,26760,8968,4384,4584
22350,34626,7858,16758,5803,26767,8970,4385,4585
22355,34632,7858,16760,5803,26772,8973,4385,4588
22360,34643,7862,16765,5806,26780,8975,4386,4589
22365,34647,7864,16768,5808,26783,8976,4387,4589
22370,34657,7868,16775,5812,26788,8978,4389,4589
22375,34663,7868,16778,5812,26794,8981,4391,4590
22380,34674,7873,16784,5815,26800,8983,4393,4590
22385,34678,7874,16785,5816,26804,8984,4393,4591
22390,34688,7877,16789,5817,26810,8986,4395,4591
22395,34694,7877,16792,5817,26815,8989,4396,4593
22400,34705,7881,16797,5819,26823,8991,4397,4594
22405,34709,7882,16799,5820,26827,8992,4398,4594
22410,34719,7884,16803,5821,26834,8994,4400,4594
22415,34725,7884,16805,5821,26840,8997,4401,4596
22420,34736,7890,16811,5825,26846,8999,4402,4597
22425,34740,7890,16812,5825,26850,9000,4403,4597
22430,34750,7893,16816,5827,26857,9002,4404,4598
22435,34756,7893,16819,5827,26862,9005,4406,4599
22440,34767,7896,16823,5828,26870,9007,4408,4599
22445,34771,7897,16824,5829,26874,9008,4408,4600
22450,34781,7902,16830,5833,26879,9010,4410,4600
22455,34787,7902,16831,5833,26885,9013,4411,4602
22460,34798,7906,16836,5837,26891,9015,4411,4604
22465,34802,7908,16839,5839,26894,9016,4412,4604
22470,34812,7911,16843,5841,26900,9018,4413,4605
22475,34818,7911,16848,5841,26905,9021,4416,4605
22480,34829,7916,16853,5846,26913,9023,4417,4606
22485,34833,7918,16857,5848,26915,9024,4418,4606
22490,34843,7923,16863,5852,26919,9026,4419,4607
22495,34849,7924,16866,5853,26924,9029,4421,4608
22500,34860,7927,16872,5854,26931,9031,4422,4609
22505,34864,7928,16875,5855,26935,9032,4423,4609
22510,34874,7929,16878,5856,26945,9034,4423,4611
22515,34880,7929,16879,5856,26950,9037,4423,4614
22520,34891,7931,16882,5856,26960,9039,4424,4615
22525,34895,7931,16883,5856,26964,9040,4425,4615
22530,34905,7933,16888,5857,26971,9042,4426,4616
22535,34911,7933,16892,5857,26977,9045,4429,4616
22540,34922,7935,16896,5858,26986,9047,4429,4618
22545,34926,7935,16897,5858,26991,9048,4429,4619
22550,34936,7938,16904,5860,26996,9050,4430,4620
22555,34942,7938,16907,5860,27002,9053,4431,4622
22560,34953,7940,16911,5861,27012,9055,4432,4623
22565,34957,7941,16914,5862,27015,9056,4432,4624
22570,34967,7942,16918,5863,27024,9058,4433,4625
22575,34973,7942,16920,5863,27031,9061,4434,4627
22580,34984,7945,16923,5864,27037,9063,4434,4629
22585,34988,7945,16925,5864,27043,9064,4435,4629
22590,34998,7948,16931,5867,27050,9066,4436,4630
22595,35004,7948,16934,5867,27055,9069,4437,4632
22600,35015,7951,16939,5869,27061,9071,4437,4634
22605,35019,7952,16940,5870,27067,9072,4437,4635
22610,35029,7955,16946,5872,27073,9074,4438,4636
22615,35035,7955,16949,5872,27078,9077,4438,4639
22620,35046,7958,16953,5875,27088,9079,4439,4640
22625,35050,7958,16954,5875,27092,9080,4440,4640
22630,35060,7961,16958,5878,27099,9082,4441,4641
22635,35066,7961,16961,5878,27104,9085,4442,4643
22640,35077,7966,16972,5883,27107,9087,4444,4643
22645,35081,7967,16975,5884,27114,9088,4445,4643
22650,35091,7969,16978,5884,27122,9090,4446,4644
22655,35097,7969,16982,5884,27127,9093,4448,4645
22660,35108,7972,16987,5887,27136,9095,4450,4645
22665,35112,7972,16988,5887,27140,9096,4450,4646
22670,35122,7974,16991,5888,27148,9098,4450,4648
22675,35128,7974,16994,5888,27152,9101,4451,4650
22680,35139,7978,16998,5890,27160,9103,4453,4650
22685,35143,7980,17002,5892,27163,9104,4454,4650
22690,35153,7983,17006,5895,27170,9106,4454,4652
22695,35159,7983,17010,5895,27174,9109,4455,4654
22700,35170,7988,17017,5900,27180,9111,4455,4656
22705,35174,7990,17020,5902,27184,9112,4456,4656
22710,35184,7994,17024,5905,27190,9114,4457,4657
22715,35190,7994,17027,5905,27195,9117,4459,4658
22720,35201,7999,17035,5909,27201,9119,4460,4659
22725,35205,8001,17037,5911,27204,9120,4461,4659
22730,35215,8004,17040,5912,27211,9122,4461,4661
22735,35221,8004,17041,5912,27217,9125,4462,4663
22740,35232,8006,17047,5914,27226,9127,4464,4663
22745,35236,8007,17049,5915,27229,9128,4464,4664
22750,35246,8011,17054,5918,27234,9130,4465,4665
22755,35252,8011,17059,5918,27240,9133,4467,4666
22760,35263,8015,17062,5921,27248,9135,4467,4668
22765,35267,8016,17065,5922,27251,9136,4468,4668
22770,35277,8019,17069,5924,27258,9138,4469,4669
22775,35283,8019,17070,5924,27264,9141,4469,4672
22780,35294,8023,17076,5927,27271,9143,4469,4674
22785,35298,8023,17077,5927,27275,9144,4469,4675
22790,35308,8027,17081,5929,27280,9146,4470,4676
22795,35314,8027,17085,5929,27286,9149,4472,4677
22800,35325,8032,17091,5933,27292,9151,4472,4679
22805,35329,8033,17091,5934,27296,9152,4472,4680
22810,35339,8035,17096,5936,27303,9154,4472,4682
22815,35345,8035,17098,5936,27310,9157,4474,4683
22820,35356,8037,17099,5936,27319,9159,4474,4685
22825,35360,8037,17100,5936,27323,9160,4474,4686
22830,35370,8040,17109,5938,27328,9162,4476,4686
22835,35376,8040,17112,5938,27335,9165,4478,4687
22840,35387,8042,17117,5939,27344,9167,4480,4687
22845,35391,8043,17119,5940,27347,9168,4480,4688
22850,35401,8044,17125,5941,27356,9170,4481,4689
22855,35407,8044,17129,5941,27362,9173,4484,4689
22860,35418,8046,17134,5943,27372,9175,4486,4689
22865,35422,8047,17137,5944,27375,9176,4487,4689
22870,35432,8048,17141,5945,27384,9178,4489,4689
22875,35438,8048,17144,5945,27389,9181,4490,4691
22880,35449,8050,17148,5946,27397,9183,4490,4693
22885,35453,8050,17148,5946,27403,9184,4490,4694
22890,35463,8053,17153,5948,27410,9186,4491,4695
22895,35469,8053,17156,5948,27416,9189,4493,4696
22900,35480,8056,17164,5951,27422,9191,4494,4697
22905,35484,8057,17166,5952,27426,9192,4494,4698
22910,35494,8062,17169,5955,27431,9194,4494,4700
22915,35500,8062,17174,5955,27434,9197,4496,4701
22920,35511,8070,17182,5963,27438,9199,4497,4702
22925,35515,8070,17184,5963,27445,9200,4497,4703
22930,35525,8073,17187,5964,27452,9202,4498,4704
22935,35531,8073,17190,5964,27457,9205,4499,4706
22940,35542,8076,17195,5967,27466,9207,4501,4706
22945,35546,8076,17197,5967,27470,9208,4502,4706
22950,35556,8078,17202,5968,27478,9210,4504,4706
22955,35562,8078,17205,5968,27483,9213,4505,4708
22960,35573,8081,17211,5971,27491,9215,4506,4709
22965,35577,8082,17211,5972,27495,9216,4506,4710
22970,35587,8085,17217,5974,27501,9218,4507,4711
22975,35593,8085,17221,5974,27506,9221,4508,4713
22980,35604,8089,17227,5977,27513,9223,4509,4714
22985,35608,8090,17229,5978,27518,9224,4510,4714
22990,35618,8093,17235,5981,27524,9226,4511,4715
22995,35624,8093,17238,5981,27530,9229,4512,4717
23000,35635,8096,17240,5982,27538,9231,4513,4718
23005,35639,8096,17243,5982,27543,9232,4514,4718
23010,35649,8099,17247,5983,27549,9234,4515,4719
23015,35655,8099,17249,5983,27556,9237,4515,4722
23020,35666,8103,17256,5985,27563,9239,4517,4722
23025,35670,8103,17257,5985,27567,9240,4518,4722
23030,35680,8107,17262,5988,27573,9242,4520,4722
23035,35686,8107,17263,5988,27578,9245,4520,4725
23040,35697,8111,17270,5991,27585,9247,4521,4726
23045,35701,8112,17270,5992,27589,9248,4521,4727
23050,35711,8117,17274,5995,27594,9250,4521,4729
23055,35717,8117,17277,5995,27599,9253,4523,4730
23060,35728,8121,17282,5998,27606,9255,4523,4732
23065,35732,8123,17284,6000,27609,9256,4523,4733
23070,35742,8128,17290,6004,27613,9258,4523,4735
23075,35748,8128,17295,6004,27619,9261,4525,4736
23080,35759,8130,17301,6005,27629,9263,4527,4736
23085,35763,8130,17302,6005,27633,9264,4528,4736
23090,35773,8132,17305,6007,27641,9266,4528,4738
23095,35779,8132,17310,6007,27646,9269,4530,4739
23100,35790,8135,17317,6010,27655,9271,4532,4739
23105,35794,8135,17320,6010,27659,9272,4533,4739
23110,35804,8137,17326,6011,27666,9274,4535,4739
23115,35810,8137,17326,6011,27673,9277,4535,4742
23120,35821,8139,17330,6012,27680,9279,4535,4744
23125,35825,8140,17331,6013,27685,9280,4535,4745
23130,35835,8142,17338,6015,27691,9282,4536,4746
23135,35841,8142,17341,6015,27696,9285,4537,4748
23140,35852,8145,17346,6016,27705,9287,4538,4749
23145,35856,8145,17347,6016,27711,9288,4538,4750
23150,35866,8147,17353,6018,27719,9290,4540,4750
23155,35872,8147,17358,6018,27724,9293,4543,4750
23160,35883,8150,17363,6020,27733,9295,4544,4751
23165,35887,8150,17366,6020,27736,9296,4545,4751
23170,35897,8153,17372,6023,27743,9298,4545,4753
23175,35903,8153,17376,6023,27748,9301,4547,4754
23180,35914,8157,17380,6025,27754,9303,4547,4756
23185,35918,8159,17381,6027,27759,9304,4547,4757
23190,35928,8161,17384,6028,27767,9306,4548,4758
23195,35934,8161,17388,6028,27772,9309,4550,4759
23200,35945,8164,17395,6030,27778,9311,4552,4759
23205,35949,8165,17396,6031,27784,9312,4552,4760
23210,35959,8168,17403,6034,27790,9314,4553,4761
23215,35965,8168,17407,6034,27797,9317,4556,4761
23220,35976,8171,17413,6037,27803,9319,4556,4763
23225,35980,8172,17416,6038,27808,9320,4557,4763
23230,35990,8174,17421,6038,27815,9322,4558,4764
23235,35996,8174,17424,6038,27820,9325,4559,4766
23240,36007,8177,17430,6040,27829,9327,4560,4767
23245,36011,8177,17433,6040,27834,9328,4561,4767
23250,36021,8179,17436,6041,27842,9330,4562,4768
23255,36027,8179,17439,6041,27847,9333,4563,4770
23260,36038,8180,17444,6041,27856,9335,4564,4771
23265,36042,8181,17446,6042,27861,9336,4565,4771
23270,36052,8183,17451,6043,27868,9338,4565,4773
23275,36058,8183,17455,6043,27874,9341,4567,4774
23280,36069,8185,17460,6044,27884,9343,4568,4775
23285,36073,8186,17464,6045,27887,9344,4569,4775
23290,36083,8188,17469,6046,27894,9346,4569,4777
23295,36089,8188,17473,6046,27901,9349,4571,4778
23300,36100,8191,17479,6049,27909,9351,4572,4779
23305,36104,8192,17480,6050,27912,9352,4572,4780
23310,36114,8195,17488,6053,27919,9354,4574,4780
23315,36120,8195,17491,6053,27924,9357,4575,4782
23320,36131,8198,17496,6056,27932,9359,4576,4783
23325,36135,8199,17499,6057,27936,9360,4577,4783
23330,36145,8204,17505,6060,27940,9362,4579,4783
23335,36151,8204,17508,6060,27946,9365,4580,4785
23340,36162,8209,17514,6065,27952,9367,4580,4787
23345,36166,8211,17515,6067,27955,9368,4580,4788
23350,36176,8214,17517,6068,27962,9370,4580,4790
23355,36182,8214,17517,6068,27968,9373,4580,4793
23360,36193,8217,17523,6071,27975,9375,4580,4795
23365,36197,8220,17526,6074,27977,9376,4581,4795
23370,36207,8223,17530,6075,27983,9378,4582,4796
23375,36213,8223,17534,6075,27989,9381,4585,4796
23380,36224,8228,17541,6079,27993,9383,4586,4797
23385,36228,8231,17543,6082,27996,9384,4587,4797
23390,36238,8237,17548,6086,28000,9386,4588,4798
23395,36244,8237,17552,6086,28006,9389,4591,4798
23400,36255,8240,17557,6087,28014,9391,4593,4798
23405,36259,8241,17558,6088,28018,9392,4593,4799
23410,36269,8243,17566,6090,28025,9394,4595,4799
23415,36275,8243,17569,6090,28031,9397,4596,4801
23420,36286,8246,17577,6093,28038,9399,4597,4802
23425,36290,8246,17580,6093,28043,9400,4598,4802
23430,36300,8248,17583,6094,28051,9402,4599,4803
23435,36306,8248,17588,6094,28055,9405,4601,4804
23440,36317,8250,17590,6095,28066,9407,4601,4806
23445,36321,8250,17592,6095,28071,9408,4602,4806
23450,36331,8253,17597,6097,28076,9410,4602,4808
23455,36337,8253,17600,6097,28083,9413,4604,4809
23460,36348,8255,17602,6097,28092,9415,4605,4810
23465,36352,8256,17605,6098,28095,9416,4605,4811
23470,36362,8258,17609,6099,28102,9418,4606,4812
23475,36368,8258,17612,6099,28109,9421,4606,4815
23480,36379,8260,17618,6100,28119,9423,4608,4815
23485,36383,8261,17621,6101,28122,9424,4608,4816
23490,36393,8263,17628,6102,28129,9426,4610,4816
23495,36399,8263,17629,6102,28135,9429,4610,4819
23500,36410,8267,17634,6104,28143,9431,4611,4820
23505,36414,8268,17636,6105,28146,9432,4611,4821
23510,36424,8272,17642,6108,28151,9434,4613,4821
23515,36430,8272,17646,6108,28157,9437,4615,4822
23520,36441,8276,17650,6110,28165,9439,4616,4823
23525,36445,8276,17651,6110,28169,9440,4617,4823
23530,36455,8279,17653,6112,28176,9442,4617,4825
23535,36461,8279,17654,6112,28182,9445,4617,4828
23540,36472,8282,17660,6115,28190,9447,4618,4829
23545,36476,8282,17662,6115,28194,9448,4619,4829
23550,36486,8285,17666,6117,28201,9450,4620,4830
23555,36492,8285,17669,6117,28207,9453,4622,4831
23560,36503,8288,17674,6120,28215,9455,4623,4832
23565,36507,8290,17677,6122,28217,9456,4623,4833
23570,36517,8293,17682,6125,28223,9458,4623,4835
23575,36523,8293,17686,6125,28229,9461,4625,4836
23580,36534,8297,17691,6127,28237,9463,4627,4836
23585,36538,8298,17693,6128,28240,9464,4627,4837
23590,36548,8300,17696,6129,28248,9466,4627,4839
23595,36554,8300,17699,6129,28253,9469,4629,4840
23600,36565,8302,17704,6131,28261,9471,4630,4841
23605,36569,8304,17704,6133,28265,9472,4630,4842
23610,36579,8307,17709,6136,28271,9474,4630,4844
23615,36585,8307,17711,6136,28277,9477,4631,4846
23620,36596,8310,17717,6138,28285,9479,4631,4848
23625,36600,8312,17720,6140,28287,9480,4631,4849
23630,36610,8315,17724,6143,28295,9482,4632,4850
23635,36616,8315,17727,6143,28300,9485,4634,4851
23640,36627,8318,17730,6145,28307,9487,4634,4853
23645,36631,8320,17731,6147,28311,9488,4634,4854
23650,36641,8322,17733,6148,28318,9490,4634,4856
23655,36647,8323,17737,6149,28322,9493,4636,4857
23660,36658,8327,17743,6152,28330,9495,4636,4859
23665,36662,8327,17745,6152,28334,9496,4636,4860
23670,36672,8328,17748,6152,28344,9498,4636,4862
23675,36678,8328,17751,6152,28350,9501,4639,4862
23680,36689,8329,17758,6153,28357,9503,4640,4863
23685,36693,8329,17759,6153,28363,9504,4640,4864
23690,36703,8332,17765,6155,28370,9506,4640,4866
23695,36709,8332,17768,6155,28377,9509,4642,4867
23700,36720,8335,17771,6156,28384,9511,4642,4869
23705,36724,8335,17772,6156,28388,9512,4642,4870
23710,36734,8337,17777,6158,28396,9514,4642,4872
23715,36740,8337,17779,6158,28403,9517,4644,4873
23720,36751,8340,17786,6161,28409,9519,4645,4874
23725,36755,8340,17788,6161,28415,9520,4646,4874
23730,36765,8342,17792,6162,28422,9522,4646,4876
23735,36771,8342,17795,6162,28428,9525,4647,4878
23740,36782,8345,17799,6163,28437,9527,4648,4879
23745,36786,8346,17803,6164,28440,9528,4649,4879
23750,36796,8347,17810,6165,28449,9530,4651,4879
23755,36802,8347,17814,6165,28454,9533,4652,4881
23760,36813,8350,17817,6166,28463,9535,4653,4882
23765,36817,8351,17820,6167,28466,9536,4654,4882
23770,36827,8353,17824,6169,28474,9538,4655,4883
23775,36833,8353,17826,6169,28478,9541,4655,4886
23780,36844,8357,17829,6171,28486,9543,4656,4887
23785,36848,8358,17831,6172,28490,9544,4657,4887
23790,36858,8361,17837,6175,28496,9546,4657,4889
23795,36864,8361,17839,6175,28503,9549,4659,4890
23800,36875,8364,17844,6177,28511,9551,4661,4890
23805,36879,8365,17845,6178,28514,9552,4661,4891
23810,36889,8369,17849,6181,28520,9554,4661,4893
23815,36895,8369,17853,6181,28524,9557,4662,4895
23820,36906,8374,17859,6185,28531,9559,4663,4896
23825,36910,8375,17860,6186,28534,9560,4663,4897
23830,36920,8379,17866,6190,28540,9562,4664,4898
23835,36926,8379,17869,6190,28545,9565,4664,4901
23840,36937,8383,17871,6192,28553,9567,4664,4903
23845,36941,8384,17871,6193,28557,9568,4664,4904
23850,36951,8389,17876,6198,28561,9570,4664,4906
23855,36957,8389,17879,6198,28567,9573,4666,4907
23860,36968,8394,17885,6203,28574,9575,4668,4907
23865,36972,8395,17887,6204,28577,9576,4669,4907
23870,36982,8397,17890,6206,28584,9578,4670,4908
23875,36988,8397,17892,6206,28591,9581,4671,4910
23880,36999,8401,17897,6209,28598,9583,4672,4911
23885,37003,8402,17898,6210,28601,9584,4672,4912
23890,37013,8407,17905,6214,28605,9586,4673,4913
23895,37019,8407,17907,6214,28611,9589,4674,4915
23900,37030,8412,17914,6218,28617,9591,4676,4915
23905,37034,8415,17918,6221,28619,9592,4677,4915
23910,37044,8417,17920,6222,28626,9594,4678,4916
23915,37050,8417,17923,6222,28631,9597,4678,4919
23920,37061,8421,17930,6225,28640,9599,4680,4919
23925,37065,8422,17933,6226,28643,9600,4681,4919
23930,37075,8424,17940,6228,28650,9602,4683,4919
23935,37081,8424,17942,6228,28655,9605,4684,4921
23940,37092,8426,17947,6229,28665,9607,4686,4921
23945,37096,8426,17949,6229,28669,9608,4686,4922
23950,37106,8428,17954,6231,28676,9610,4686,4924
23955,37112,8428,17955,6231,28683,9613,4687,4926
23960,37123,8430,17962,6233,28692,9615,4688,4927
23965,37127,8430,17962,6233,28697,9616,4688,4928
23970,37137,8432,17966,6235,28704,9618,4688,4930
23975,37143,8432,17969,6235,28711,9621,4690,4931
23980,37154,8434,17976,6235,28718,9623,4692,4931
23985,37158,8434,17977,6235,28724,9624,4693,4931
23990,37168,8437,17980,6237,28730,9626,4693,4933
23995,37174,8437,17982,6237,28736,9629,4694,4935
24000,37185,8439,17986,6238,28746,9631,4696,4935
24005,37189,8440,17988,6239,28749,9632,4696,4936
24010,37199,8441,17991,6240,28757,9634,4696,4938
24015,37205,8441,17993,6240,28763,9637,4697,4940
24020,37216,8443,17996,6240,28770,9639,4697,4942
24025,37220,8444,17996,6241,28776,9640,4697,4943
24030,37230,8447,18001,6244,28782,9642,4699,4943
24035,37236,8447,18005,6244,28788,9645,4701,4944
24040,37247,8450,18011,6246,28794,9647,4701,4946
24045,37251,8451,18012,6247,28800,9648,4702,4946
24050,37261,8454,18016,6248,28806,9650,4704,4946
24055,37267,8454,18020,6248,28812,9653,4706,4947
24060,37278,8459,18025,6252,28818,9655,4707,4948
24065,37282,8461,18028,6254,28821,9656,4708,4948
24070,37292,8464,18033,6257,28827,9658,4709,4949
24075,37298,8464,18037,6257,28833,9661,4712,4949
24080,37309,8469,18045,6261,28837,9663,4714,4949
24085,37313,8469,18047,6261,28844,9664,4715,4949
24090,37323,8472,18053,6263,28850,9666,4716,4950
24095,37329,8472,18055,6263,28857,9669,4717,4952
24100,37340,8475,18061,6265,28863,9671,4719,4952
24105,37344,8478,18065,6268,28865,9672,4720,4952
24110,37354,8482,18071,6272,28870,9674,4722,4952
24115,37360,8483,18074,6273,28875,9677,4723,4954
24120,37371,8489,18081,6279,28881,9679,4725,4954
24125,37375,8492,18084,6282,28882,9680,4725,4955
24130,37385,8496,18091,6286,28887,9682,4726,4956
24135,37391,8497,18091,6287,28893,9685,4726,4959
24140,37402,8499,18099,6289,28901,9687,4728,4959
24145,37406,8501,18101,6291,28905,9688,4728,4960
24150,37416,8502,18106,6291,28913,9690,4728,4962
24155,37422,8502,18107,6291,28920,9693,4728,4965
24160,37433,8503,18114,6291,28930,9695,4729,4966
24165,37437,8503,18116,6291,28934,9696,4730,4966
24170,37447,8504,18120,6291,28942,9698,4731,4967
24175,37453,8504,18124,6291,28949,9701,4733,4968
24180,37464,8505,18129,6291,28959,9703,4734,4969
24185,37468,8505,18129,6291,28963,9704,4734,4970
24190,37478,8506,18133,6291,28971,9706,4735,4971
24195,37484,8506,18135,6291,28978,9709,4735,4974
24200,37495,8507,18137,6291,28988,9711,4736,4975
24205,37499,8507,18138,6291,28992,9712,4736,4976
24210,37509,8508,18140,6292,29000,9714,4736,4978
24215,37515,8508,18142,6292,29007,9717,4737,4980
24220,37526,8509,18147,6292,29017,9719,4738,4981
24225,37530,8509,18148,6292,29021,9720,4738,4982
24230,37540,8511,18154,6293,29028,9722,4740,4982
24235,37546,8511,18158,6293,29035,9725,4742,4983
24240,37557,8513,18165,6295,29044,9727,4744,4983
24245,37561,8514,18169,6296,29047,9728,4745,4983
24250,37571,8515,18172,6297,29055,9730,4746,4984
24255,37577,8515,18175,6297,29059,9733,4747,4986
24260,37588,8523,18182,6305,29064,9735,4748,4987
24265,37592,8526,18186,6308,29065,9736,4749,4987
24270,37602,8531,18190,6311,29070,9738,4750,4988
24275,37608,8531,18193,6311,29074,9741,4751,4990
24280,37619,8537,18197,6316,29080,9743,4751,4992
24285,37623,8541,18199,6320,29082,9744,4751,4993
24290,37633,8545,18203,6322,29086,9746,4752,4994
24295,37639,8546,18206,6323,29092,9749,4754,4995
24300,37650,8549,18209,6325,29100,9751,4755,4996
24305,37654,8549,18212,6325,29104,9752,4756,4996
24310,37664,8551,18219,6327,29112,9754,4757,4997
24315,37670,8551,18220,6327,29119,9757,4758,4999
24320,37681,8554,18227,6329,29126,9759,4759,5000
24325,37685,8554,18228,6329,29130,9760,4759,5001
24330,37695,8556,18233,6330,29137,9762,4759,5003
24335,37701,8556,18236,6330,29144,9765,4760,5005
24340,37712,8558,18239,6330,29153,9767,4762,5005
24345,37716,8559,18240,6331,29157,9768,4762,5006
24350,37726,8562,18247,6334,29162,9770,4763,5007
24355,37732,8562,18250,6334,29170,9773,4764,5009
24360,37743,8565,18257,6336,29178,9775,4766,5009
24365,37747,8566,18258,6337,29181,9776,4766,5010
24370,37757,8569,18264,6339,29187,9778,4767,5011
24375,37763,8569,18265,6339,29194,9781,4768,5013
24380,37774,8571,18272,6340,29203,9783,4770,5013
24385,37778,8572,18276,6341,29206,9784,4771,5013
24390,37788,8573,18280,6341,29215,9786,4772,5014
24395,37794,8573,18284,6341,29220,9789,4774,5015
24400,37805,8576,18288,6342,29228,9791,4774,5017
24405,37809,8577,18290,6343,29232,9792,4774,5018
24410,37819,8580,18293,6344,29238,9794,4774,5020
24415,37825,8580,18296,6344,29244,9797,4775,5022
24420,37836,8584,18304,6348,29251,9799,4777,5022
24425,37840,8585,18305,6349,29255,9800,4777,5023
24430,37850,8588,18310,6352,29261,9802,4777,5025
24435,37856,8588,18313,6352,29267,9805,4777,5028
24440,37867,8592,18316,6354,29275,9807,4777,5030
24445,37871,8593,18318,6355,29278,9808,4778,5030
24450,37881,8596,18324,6358,29284,9810,4779,5031
24455,37887,8596,18327,6358,29291,9813,4780,5033
24460,37898,8599,18331,6359,29298,9815,4780,5035
24465,37902,8601,18333,6361,29301,9816,4781,5035
24470,37912,8606,18338,6364,29305,9818,4781,5037
24475,37918,8606,18342,6364,29312,9821,4784,5037
24480,37929,8610,18348,6366,29318,9823,4786,5037
24485,37933,8611,18349,6367,29322,9824,4786,5038
24490,37943,8616,18354,6371,29327,9826,4787,5039
24495,37949,8616,18356,6371,29332,9829,4788,5041
24500,37960,8620,18361,6374,29340,9831,4789,5042
24505,37964,8621,18363,6375,29343,9832,4790,5042
24510,37974,8626,18368,6379,29348,9834,4791,5043
24515,37980,8626,18371,6379,29352,9837,4792,5045
24520,37991,8631,18378,6382,29359,9839,4794,5045
24525,37995,8632,18378,6383,29363,9840,4794,5046
24530,38005,8636,18384,6386,29368,9842,4796,5046
24535,38011,8637,18386,6387,29373,9845,4797,5048
24540,38022,8642,18392,6392,29379,9847,4798,5049
24545,38026,8642,18396,6392,29383,9848,4799,5049
24550,38036,8643,18403,6393,29391,9850,4800,5050
24555,38042,8643,18407,6393,29397,9853,4802,5051
24560,38053,8644,18411,6394,29408,9855,4802,5053
24565,38057,8644,18415,6394,29412,9856,4803,5053
24570,38067,8645,18419,6394,29421,9858,4804,5054
24575,38073,8645,18420,6394,29428,9861,4804,5057
24580,38084,8646,18429,6395,29437,9863,4806,5057
24585,38088,8646,18432,6395,29442,9864,4807,5057
24590,38098,8647,18436,6395,29449,9866,4807,5059
24595,38104,8647,18438,6395,29456,9869,4807,5062
24600,38115,8648,18446,6395,29464,9871,4808,5063
24605,38119,8648,18447,6395,29471,9872,4808,5064
24610,38129,8649,18453,6396,29480,9874,4809,5065
24615,38135,8649,18455,6396,29485,9877,4809,5068
24620,38146,8650,18460,6397,29496,9879,4809,5070
24625,38150,8650,18462,6397,29500,9880,4810,5070
24630,38160,8651,18466,6398,29509,9882,4812,5070
24635,38166,8651,18472,6398,29514,9885,4815,5070
24640,38177,8652,18477,6399,29525,9887,4816,5071
24645,38181,8652,18477,6399,29529,9888,4816,5072
24650,38191,8655,18482,6402,29536,9890,4817,5073
24655,38197,8655,18484,6402,29541,9893,4818,5075
24660,38208,8658,18489,6403,29549,9895,4820,5075
24665,38212,8658,18490,6403,29554,9896,4821,5075
24670,38222,8661,18494,6406,29561,9898,4821,5077
24675,38228,8661,18497,6406,29567,9901,4823,5078
24680,38239,8665,18503,6409,29574,9903,4825,5078
24685,38243,8666,18506,6410,29577,9904,4826,5078
24690,38253,8668,18510,6411,29584,9906,4826,5080
24695,38259,8668,18514,6411,29591,9909,4829,5080
24700,38270,8670,18518,6413,29600,9911,4831,5080
24705,38274,8671,18520,6414,29603,9912,4831,5081
24710,38284,8675,18526,6417,29609,9914,4831,5083
24715,38290,8675,18528,6417,29615,9917,4833,5084
24720,38301,8678,18533,6418,29622,9919,4833,5086
24725,38305,8679,18533,6419,29626,9920,4833,5087
24730,38315,8685,18539,6423,29630,9922,4834,5088
24735,38321,8685,18542,6423,29634,9925,4834,5091
24740,38332,8690,18547,6428,29642,9927,4834,5093
24745,38336,8691,18548,6429,29645,9928,4834,5094
24750,38346,8696,18554,6433,29650,9930,4835,5095
24755,38352,8696,18557,6433,29655,9933,4837,5096
24760,38363,8701,18561,6436,29662,9935,4839,5096
24765,38367,8702,18563,6437,29665,9936,4840,5096
24770,38377,8706,18568,6440,29671,9938,4842,5096
24775,38383,8706,18572,6440,29676,9941,4845,5096
24780,38394,8710,18577,6442,29684,9943,4847,5096
24785,38398,8710,18578,6442,29688,9944,4848,5096
24790,38408,8713,18583,6445,29694,9946,4849,5097
24795,38414,8713,18585,6445,29701,9949,4851,5098
24800,38425,8717,18591,6448,29705,9951,4851,5100
24805,38429,8721,18592,6452,29708,9952,4851,5101
24810,38439,8725,18597,6455,29713,9954,4852,5102
24815,38445,8725,18601,6455,29717,9957,4854,5103
24820,38456,8733,18608,6463,29722,9959,4855,5104
24825,38460,8734,18608,6464,29726,9960,4855,5105
24830,38470,8737,18611,6465,29731,9962,4855,5107
24835,38476,8738,18612,6466,29737,9965,4856,5109
24840,38487,8740,18614,6467,29747,9967,4856,5111
24845,38491,8740,18614,6467,29751,9968,4856,5112
24850,38501,8743,18621,6470,29757,9970,4858,5112
24855,38507,8743,18623,6470,29763,9973,4859,5114
24860,38518,8746,18629,6472,29770,9975,4859,5116
24865,38522,8747,18631,6473,29775,9976,4859,5117
24870,38532,8748,18636,6473,29783,9978,4860,5118
24875,38538,8748,18638,6473,29788,9981,4861,5120
24880,38549,8751,18642,6475,29798,9983,4862,5121
24885,38553,8751,18645,6475,29801,9984,4863,5121
24890,38563,8753,18650,6477,29809,9986,4864,5122
24895,38569,8753,18653,6477,29815,9989,4866,5123
24900,38580,8755,18658,6478,29824,9991,4867,5124
24905,38584,8755,18659,6478,29829,9992,4867,5125
24910,38594,8758,18664,6481,29836,9994,4867,5127
24915,38600,8758,18668,6481,29841,9997,4869,5128
24920,38611,8760,18671,6483,29850,9999,4869,5130
24925,38615,8761,18673,6484,29854,10000,4870,5130
24930,38625,8764,18680,6487,29860,10002,4872,5130
24935,38631,8764,18682,6487,29867,10005,4873,5132
24940,38642,8767,18687,6488,29873,10007,4874,5133
24945,38646,8767,18687,6488,29879,10008,4874,5134
24950,38656,8771,18693,6490,29883,10010,4875,5135
24955,38662,8771,18697,6490,29891,10013,4878,5135
24960,38673,8774,18700,6491,29897,10015,4878,5137
24965,38677,8775,18703,6492,29902,10016,4878,5138
24970,38687,8777,18705,6493,29910,10018,4879,5139
24975,38693,8777,18707,6493,29914,10021,4879,5142
24980,38704,8779,18711,6495,29925,10023,4880,5143
24985,38708,8779,18712,6495,29929,10024,4880,5144
24990,38718,8781,18717,6496,29937,10026,4881,5145
24995,38724,8781,18722,6496,29942,10029,4884,5145
25000,38735,8782,18730,6497,29950,10031,4885,5146
25005,38739,8783,18732,6498,29956,10032,4886,5146
25010,38749,8785,18738,6499,29964,10034,4887,5147
25015,38755,8785,18741,6499,29969,10037,4888,5149
25020,38766,8789,18749,6503,29976,10039,4890,5149
25025,38770,8790,18751,6504,29980,10040,4891,5149
25030,38780,8792,18756,6504,29987,10042,4893,5149
25035,38786,8792,18758,6504,29992,10045,4893,5152
25040,38797,8794,18760,6505,30003,10047,4893,5154
25045,38801,8795,18762,6506,30006,10048,4893,5155
25050,38811,8797,18766,6507,30014,10050,4894,5156
25055,38817,8797,18770,6507,30019,10053,4896,5157
25060,38828,8798,18774,6508,30029,10055,4897,5158
25065,38832,8799,18777,6509,30033,10056,4898,5158
25070,38842,8803,18783,6512,30039,10058,4900,5158
25075,38848,8803,18786,6512,30044,10061,4900,5161
25080,38859,8807,18794,6516,30051,10063,4902,5161
25085,38863,8809,18796,6518,30054,10064,4902,5162
25090,38873,8814,18804,6522,30058,10066,4903,5163
25095,38879,8814,18807,6522,30065,10069,4904,5165
25100,38890,8818,18813,6525,30071,10071,4905,5166
25105,38894,8820,18816,6527,30074,10072,4906,5166
25110,38904,8825,18822,6530,30078,10074,4907,5167
25115,38910,8825,18822,6530,30085,10077,4907,5170
25120,38921,8828,18827,6531,30092,10079,4908,5171
25125,38925,8830,18828,6533,30095,10080,4908,5172
25130,38935,8835,18834,6536,30100,10082,4910,5172
25135,38941,8835,18837,6536,30105,10085,4912,5173
25140,38952,8841,18845,6541,30110,10087,4913,5174
25145,38956,8843,18846,6543,30113,10088,4913,5175
25150,38966,8848,18851,6546,30117,10090,4913,5177
25155,38972,8848,18855,6546,30123,10093,4915,5178
25160,38983,8850,18859,6547,30133,10095,4915,5180
25165,38987,8851,18861,6548,30136,10096,4915,5181
25170,38997,8854,18868,6551,30143,10098,4917,5181
25175,39003,8854,18870,6551,30148,10101,4918,5183
25180,39014,8856,18872,6552,30157,10103,4918,5185
25185,39018,8857,18875,6553,30161,10104,4919,5185
25190,39028,8860,18881,6555,30166,10106,4920,5186
25195,39034,8860,18886,6555,30171,10109,4922,5187
25200,39045,8863,18895,6557,30180,10111,4924,5187
25205,39049,8864,18896,6558,30185,10112,4924,5188
25210,39059,8866,18900,6560,30192,10114,4925,5189
25215,39065,8866,18902,6560,30199,10117,4927,5190
25220,39076,8868,18908,6562,30205,10119,4928,5191
25225,39080,8869,18911,6563,30210,10120,4929,5191
25230,39090,8871,18915,6564,30218,10122,4931,5191
25235,39096,8871,18919,6564,30222,10125,4933,5192
25240,39107,8873,18923,6565,30232,10127,4934,5193
25245,39111,8873,18924,6565,30238,10128,4935,5193
25250,39121,8875,18929,6566,30245,10130,4936,5194
25255,39127,8875,18931,6566,30252,10133,4937,5196
25260,39138,8879,18938,6569,30256,10135,4938,5197
25265,39142,8879,18940,6569,30263,10136,4938,5198
25270,39152,8881,18942,6569,30271,10138,4938,5200
25275,39158,8881,18947,6569,30276,10141,4941,5200
25280,39169,8883,18953,6571,30285,10143,4943,5200
25285,39173,8884,18955,6572,30289,10144,4943,5201
25290,39183,8886,18961,6572,30296,10146,4945,5201
25295,39189,8886,18964,6572,30302,10149,4946,5203
25300,39200,8889,18971,6574,30310,10151,4947,5204
25305,39204,8889,18973,6574,30315,10152,4948,5204
25310,39214,8891,18979,6576,30322,10154,4948,5206
25315,39220,8891,18983,6576,30327,10157,4950,5207
25320,39231,8893,18988,6578,30337,10159,4950,5209
25325,39235,8893,18990,6578,30342,10160,4950,5210
25330,39245,8895,18994,6578,30349,10162,4950,5212
25335,39251,8895,18996,6578,30355,10165,4951,5214
25340,39262,8897,19000,6579,30364,10167,4953,5214
25345,39266,8898,19000,6580,30368,10168,4953,5215
25350,39276,8900,19007,6581,30375,10170,4955,5215
25355,39282,8900,19009,6581,30382,10173,4956,5217
25360,39293,8902,19015,6583,30391,10175,4957,5218
25365,39297,8903,19018,6584,30394,10176,4958,5218
25370,39307,8906,19023,6586,30400,10178,4958,5220
25375,39313,8906,19026,6586,30407,10181,4960,5221
25380,39324,8910,19033,6590,30414,10183,4961,5222
25385,39328,8911,19036,6591,30417,10184,4962,5222
25390,39338,8915,19042,6595,30422,10186,4963,5223
25395,39344,8915,19046,6595,30428,10189,4965,5224
25400,39355,8919,19054,6599,30435,10191,4966,5225
25405,39359,8922,19058,6602,30437,10192,4967,5225
25410,39369,8927,19063,6606,30442,10194,4967,5227
25415,39375,8927,19066,6606,30447,10197,4969,5228
25420,39386,8932,19070,6609,30454,10199,4970,5229
25425,39390,8933,19072,6610,30457,10200,4971,5229
25430,39400,8938,19075,6613,30462,10202,4971,5231
25435,39406,8938,19079,6613,30466,10205,4973,5232
25440,39417,8943,19083,6617,30474,10207,4974,5233
25445,39421,8944,19085,6618,30477,10208,4975,5233
25450,39431,8948,19090,6620,30482,10210,4976,5234
25455,39437,8948,19092,6620,30488,10213,4977,5236
25460,39448,8951,19096,6623,30497,10215,4977,5238
25465,39452,8952,19098,6624,30500,10216,4977,5239
25470,39462,8954,19102,6626,30507,10218,4977,5241
25475,39468,8954,19108,6626,30512,10221,4980,5241
25480,39479,8957,19113,6628,30522,10223,4981,5242
25485,39483,8957,19114,6628,30526,10224,4982,5242
25490,39493,8959,19120,6630,30533,10226,4983,5243
25495,39499,8959,19125,6630,30538,10229,4986,5243
25500,39510,8962,19133,6632,30546,10231,4987,5244
25505,39514,8962,19134,6632,30552,10232,4988,5244
25510,39524,8964,19139,6633,30560,10234,4989,5245
25515,39530,8964,19144,6633,30564,10237,4991,5246
25520,39541,8967,19150,6636,30573,10239,4992,5247
25525,39545,8967,19152,6636,30577,10240,4993,5247
25530,39555,8968,19158,6637,30586,10242,4994,5248
25535,39561,8968,19162,6637,30593,10245,4997,5248
25540,39572,8971,19165,6639,30601,10247,4998,5249
25545,39576,8972,19167,6640,30603,10248,4998,5250
25550,39586,8973,19170,6641,30613,10250,4999,5251
25555,39592,8973,19172,6641,30619,10253,5001,5252
25560,39603,8976,19177,6643,30626,10255,5003,5252
25565,39607,8977,19179,6644,30630,10256,5003,5253
25570,39617,8981,19186,6647,30634,10258,5004,5254
25575,39623,8981,19191,6647,30641,10261,5007,5254
25580,39634,8983,19194,6648,30649,10263,5007,5256
25585,39638,8984,19196,6649,30654,10264,5007,5257
25590,39648,8988,19203,6652,30660,10266,5008,5258
25595,39654,8988,19206,6652,30665,10269,5009,5260
25600,39665,8992,19213,6654,30670,10271,5009,5262
25605,39669,8994,19215,6656,30675,10272,5009,5263
25610,39679,8997,19217,6658,30682,10274,5009,5265
25615,39685,8997,19221,6658,30686,10277,5010,5267
25620,39696,9001,19227,6661,30695,10279,5012,5267
25625,39700,9001,19229,6661,30699,10280,5012,5268
25630,39710,9003,19235,6663,30706,10282,5014,5268
25635,39716,9003,19237,6663,30712,10285,5015,5270
25640,39727,9006,19243,6666,30720,10287,5016,5271
25645,39731,9008,19246,6668,30723,10288,5017,5271
25650,39741,9010,19252,6669,30731,10290,5019,5271
25655,39747,9010,19255,6669,30736,10293,5020,5273
25660,39758,9012,19259,6670,30744,10295,5021,5274
25665,39762,9013,19260,6671,30749,10296,5021,5275
25670,39772,9015,19263,6672,30757,10298,5021,5277
25675,39778,9015,19265,6672,30763,10301,5022,5279
25680,39789,9016,19267,6672,30773,10303,5022,5281
25685,39793,9017,19268,6673,30776,10304,5022,5282
25690,39803,9019,19275,6674,30783,10306,5023,5283
25695,39809,9019,19277,6674,30790,10309,5024,5285
25700,39820,9021,19286,6675,30798,10311,5026,5285
25705,39824,9022,19287,6676,30802,10312,5026,5286
25710,39834,9026,19295,6679,30807,10314,5027,5287
25715,39840,9026,19297,6679,30814,10317,5029,5288
25720,39851,9027,19300,6680,30824,10319,5029,5290
25725,39855,9027,19302,6680,30828,10320,5030,5290
25730,39865,9032,19307,6684,30833,10322,5030,5292
25735,39871,9032,19307,6684,30839,10325,5030,5295
25740,39882,9035,19311,6686,30846,10327,5030,5297
25745,39886,9037,19314,6688,30849,10328,5031,5297
25750,39896,9041,19320,6691,30854,10330,5032,5298
25755,39902,9041,19325,6691,30859,10333,5035,5298
25760,39913,9045,19327,6693,30868,10335,5036,5299
25765,39917,9046,19329,6694,30871,10336,5037,5299
25770,39927,9049,19332,6696,30878,10338,5037,5301
25775,39933,9049,19335,6696,30883,10341,5038,5303
25780,39944,9054,19338,6699,30890,10343,5038,5305
25785,39948,9056,19340,6701,30892,10344,5038,5306
25790,39958,9059,19343,6703,30899,10346,5039,5307
25795,39964,9059,19346,6703,30903,10349,5040,5309
25800,39975,9064,19350,6706,30909,10351,5041,5310
25805,39979,9066,19352,6708,30912,10352,5041,5311
25810,39989,9067,19354,6708,30922,10354,5042,5312
25815,39995,9067,19357,6708,30927,10357,5043,5314
25820,40006,9070,19361,6709,30935,10359,5043,5316
25825,40010,9071,19363,6710,30939,10360,5044,5316
25830,40020,9073,19368,6711,30946,10362,5045,5317
25835,40026,9073,19369,6711,30953,10365,5045,5320
25840,40037,9075,19375,6712,30959,10367,5046,5321
25845,40041,9076,19378,6713,30965,10368,5047,5321
25850,40051,9078,19385,6715,30971,10370,5049,5321
25855,40057,9078,19391,6715,30976,10373,5052,5321
25860,40068,9080,19399,6717,30985,10375,5052,5323
25865,40072,9080,19402,6717,30991,10376,5053,5323
25870,40082,9081,19406,6718,30999,10378,5053,5325
25875,40088,9081,19407,6718,31007,10381,5053,5328
25880,40099,9083,19409,6718,31014,10383,5053,5330
25885,40103,9083,19411,6718,31019,10384,5054,5330
25890,40113,9085,19415,6719,31027,10386,5055,5331
25895,40119,9085,19418,6719,31033,10389,5056,5333
25900,40130,9087,19425,6720,31040,10391,5058,5333
25905,40134,9088,19428,6721,31046,10392,5059,5333
25910,40144,9091,19433,6723,31052,10394,5060,5334
25915,40150,9091,19435,6723,31058,10397,5061,5336
25920,40161,9095,19441,6726,31065,10399,5062,5337
25925,40165,9095,19442,6726,31070,10400,5063,5337
25930,40175,9098,19446,6727,31076,10402,5063,5339
25935,40181,9098,19449,6727,31082,10405,5063,5342
25940,40192,9103,19456,6731,31088,10407,5064,5343
25945,40196,9104,19456,6732,31092,10408,5064,5344
25950,40206,9107,19459,6735,31099,10410,5064,5346
25955,40212,9107,19462,6735,31104,10413,5065,5348
25960,40223,9111,19464,6737,31112,10415,5065,5350
25965,40227,9112,19467,6738,31115,10416,5066,5350
25970,40237,9115,19470,6739,31122,10418,5067,5351
25975,40243,9115,19474,6739,31127,10421,5069,5352
25980,40254,9119,19481,6743,31135,10423,5071,5352
25985,40258,9120,19482,6744,31138,10424,5071,5353
25990,40268,9124,19487,6746,31144,10426,5073,5353
25995,40274,9124,19490,6746,31149,10429,5073,5356
26000,40285,9128,19494,6748,31157,10431,5075,5356
26005,40289,9129,19496,6749,31160,10432,5075,5357
26010,40299,9132,19499,6751,31166,10434,5075,5359
26015,40305,9132,19504,6751,31172,10437,5078,5359
26020,40316,9136,19511,6755,31179,10439,5080,5359
26025,40320,9138,19512,6757,31182,10440,5080,5360
26030,40330,9141,19517,6759,31187,10442,5081,5361
26035,40336,9142,19519,6760,31191,10445,5081,5364
26040,40347,9149,19524,6765,31197,10447,5083,5364
26045,40351,9152,19528,6768,31198,10448,5084,5364
26050,40361,9156,19535,6772,31203,10450,5086,5364
26055,40367,9156,19537,6772,31209,10453,5086,5367
26060,40378,9158,19538,6772,31219,10455,5086,5369
26065,40382,9158,19538,6772,31224,10456,5086,5370
26070,40392,9161,19544,6775,31230,10458,5087,5371
26075,40398,9161,19547,6775,31236,10461,5089,5372
26080,40409,9164,19553,6777,31243,10463,5089,5374
26085,40413,9164,19554,6777,31249,10464,5090,5374
26090,40423,9166,19557,6779,31257,10466,5091,5375
26095,40429,9166,19560,6779,31262,10469,5093,5376
26100,40440,9169,19563,6780,31270,10471,5093,5378
26105,40444,9170,19564,6781,31274,10472,5093,5379
26110,40454,9171,19570,6782,31282,10474,5094,5380
26115,40460,9171,19573,6782,31289,10477,5096,5381
26120,40471,9174,19582,6784,31294,10479,5098,5381
26125,40475,9175,19583,6785,31300,10480,5098,5382
26130,40485,9176,19587,6785,31309,10482,5099,5383
26135,40491,9176,19592,6785,31314,10485,5102,5383
26140,40502,9177,19598,6785,31323,10487,5103,5384
26145,40506,9177,19598,6785,31329,10488,5103,5385
26150,40516,9178,19603,6786,31338,10490,5104,5386
26155,40522,9178,19605,6786,31343,10493,5105,5388
26160,40533,9179,19609,6787,31352,10495,5105,5390
26165,40537,9180,19610,6788,31357,10496,5106,5390
26170,40547,9182,19611,6788,31365,10498,5106,5392
26175,40553,9182,19615,6788,31370,10501,5108,5393
26180,40564,9184,19619,6789,31379,10503,5108,5395
26185,40568,9185,19621,6790,31383,10504,5108,5396
26190,40578,9187,19628,6792,31390,10506,5109,5397
26195,40584,9187,19631,6792,31397,10509,5111,5398
26200,40595,9188,19635,6792,31406,10511,5112,5399
26205,40599,9189,19637,6793,31410,10512,5113,5399
26210,40609,9191,19642,6794,31418,10514,5113,5401
26215,40615,9191,19644,6794,31423,10517,5114,5403
26220,40626,9195,19650,6798,31431,10519,5115,5404
26225,40630,9196,19653,6799,31434,10520,5116,5404
26230,40640,9198,19655,6799,31441,10522,5116,5406
26235,40646,9198,19657,6799,31448,10525,5117,5408
26240,40657,9201,19664,6802,31455,10527,5118,5409
26245,40661,9202,19664,6803,31459,10528,5118,5410
26250,40671,9204,19667,6803,31467,10530,5120,5410
26255,40677,9204,19669,6803,31472,10533,5121,5412
26260,40688,9208,19672,6805,31480,10535,5122,5413
26265,40692,9209,19675,6806,31483,10536,5123,5413
26270,40702,9212,19679,6807,31488,10538,5124,5414
26275,40708,9213,19681,6808,31493,10541,5125,5416
26280,40719,9217,19683,6810,31501,10543,5126,5417
26285,40723,9220,19686,6813,31503,10544,5127,5417
26290,40733,9224,19691,6815,31509,10546,5129,5417
26295,40739,9224,19693,6815,31513,10549,5129,5420
26300,40750,9230,19699,6821,31519,10551,5129,5422
26305,40754,9231,19700,6822,31522,10552,5129,5423
26310,40764,9236,19705,6827,31528,10554,5129,5425
26315,40770,9236,19708,6827,31532,10557,5129,5428
26320,40781,9238,19714,6829,31543,10559,5130,5429
26325,40785,9239,19716,6830,31546,10560,5131,5429
26330,40795,9242,19725,6832,31552,10562,5133,5429
26335,40801,9242,19727,6832,31559,10565,5135,5430
26340,40812,9244,19730,6833,31568,10567,5135,5432
26345,40816,9244,19732,6833,31572,10568,5136,5432
26350,40826,9246,19736,6835,31579,10570,5137,5433
26355,40832,9246,19737,6835,31586,10573,5138,5435
26360,40843,9248,19742,6836,31595,10575,5139,5436
26365,40847,9249,19746,6837,31597,10576,5140,5436
26370,40857,9252,19752,6839,31604,10578,5141,5437
26375,40863,9252,19757,6839,31609,10581,5143,5438
26380,40874,9254,19761,6839,31619,10583,5145,5438
26385,40878,9255,19763,6840,31623,10584,5146,5438
26390,40888,9257,19768,6841,31630,10586,5147,5439
26395,40894,9257,19772,6841,31635,10589,5149,5440
26400,40905,9259,19776,6842,31645,10591,5150,5441
26405,40909,9259,19778,6842,31650,10592,5151,5441
26410,40919,9261,19784,6844,31657,10594,5152,5442
26415,40925,9261,19788,6844,31663,10597,5153,5444
26420,40936,9263,19792,6845,31671,10599,5153,5446
26425,40940,9265,19796,6847,31674,10600,5154,5446
26430,40950,9268,19802,6849,31681,10602,5155,5447
26435,40956,9268,19804,6849,31687,10605,5156,5449
26440,40967,9271,19807,6850,31694,10607,5156,5451
26445,40971,9271,19808,6850,31700,10608,5156,5452
26450,40981,9274,19812,6852,31707,10610,5157,5453
26455,40987,9274,19815,6852,31711,10613,5158,5455
26460,40998,9279,19822,6857,31716,10615,5158,5457
26465,41002,9279,19824,6857,31723,10616,5158,5458
26470,41012,9282,19829,6859,31730,10618,5159,5459
26475,41018,9282,19831,6859,31735,10621,5160,5461
26480,41029,9287,19839,6863,31740,10623,5161,5462
26485,41033,9289,19842,6865,31744,10624,5161,5463
26490,41043,9292,19849,6868,31750,10626,5162,5464
26495,41049,9292,19852,6868,31756,10629,5164,5465
26500,41060,9297,19859,6872,31763,10631,5165,5466
26505,41064,9298,19863,6873,31766,10632,5166,5466
26510,41074,9301,19867,6875,31772,10634,5167,5467
26515,41080,9301,19870,6875,31778,10637,5169,5468
26520,41091,9306,19877,6879,31784,10639,5170,5469
26525,41095,9308,19880,6881,31787,10640,5171,5469
26530,41105,9310,19883,6882,31795,10642,5171,5471
26535,41111,9310,19886,6882,31800,10645,5173,5472
26540,41122,9315,19894,6887,31806,10647,5174,5473
26545,41126,9317,19897,6889,31809,10648,5174,5474
26550,41136,9322,19902,6893,31814,10650,5175,5475
26555,41142,9322,19905,6893,31819,10653,5176,5477
26560,41153,9326,19911,6897,31826,10655,5177,5478
26565,41157,9328,19912,6899,31829,10656,5177,5479
26570,41167,9333,19918,6903,31832,10658,5177,5481
26575,41173,9334,19923,6904,31835,10661,5179,5482
26580,41184,9342,19932,6912,31839,10663,5181,5482
26585,41188,9344,19935,6914,31844,10664,5182,5482
26590,41198,9346,19943,6916,31851,10666,5183,5483
26595,41204,9346,19944,6916,31858,10669,5184,5485
26600,41215,9348,19948,6918,31867,10671,5185,5486
26605,41219,9349,19951,6919,31870,10672,5185,5487
26610,41229,9351,19956,6921,31877,10674,5186,5488
26615,41235,9351,19960,6921,31884,10677,5189,5488
26620,41246,9353,19963,6922,31893,10679,5189,5490
26625,41250,9354,19964,6923,31896,10680,5189,5491
26630,41260,9355,19970,6924,31904,10682,5190,5492
26635,41266,9355,19973,6924,31911,10685,5192,5493
26640,41277,9357,19979,6925,31920,10687,5193,5494
26645,41281,9357,19980,6925,31924,10688,5193,5495
26650,41291,9360,19987,6928,31930,10690,5194,5496
26655,41297,9360,19989,6928,31937,10693,5196,5497
26660,41308,9361,19993,6928,31947,10695,5197,5498
26665,41312,9361,19995,6928,31951,10696,5197,5499
26670,41322,9362,19998,6928,31960,10698,5197,5501
26675,41328,9362,20000,6928,31966,10701,5198,5503
26680,41339,9363,20009,6929,31976,10703,5199,5504
26685,41343,9363,20011,6929,31979,10704,5200,5504
26690,41353,9367,20015,6932,31986,10706,5202,5504
26695,41359,9367,20018,6932,31992,10709,5205,5504
26700,41370,9369,20024,6934,31998,10711,5205,5506
26705,41374,9372,20026,6937,32001,10712,5206,5506
26710,41384,9375,20032,6938,32007,10714,5207,5507
26715,41390,9375,20033,6938,32015,10717,5207,5510
26720,41401,9377,20036,6939,32024,10719,5208,5511
26725,41405,9377,20037,6939,32028,10720,5208,5512
26730,41415,9379,20040,6940,32036,10722,5209,5513
26735,41421,9379,20045,6940,32040,10725,5211,5514
26740,41432,9381,20048,6942,32051,10727,5212,5515
26745,41436,9381,20050,6942,32055,10728,5213,5515
26750,41446,9383,20052,6942,32063,10730,5213,5517
26755,41452,9383,20056,6942,32068,10733,5216,5517
26760,41463,9385,20058,6942,32078,10735,5217,5518
26765,41467,9385,20058,6942,32082,10736,5217,5519
26770,41477,9389,20061,6944,32088,10738,5217,5521
26775,41483,9389,20064,6944,32093,10741,5219,5522
26780,41494,9393,20067,6947,32100,10743,5219,5524
26785,41498,9395,20070,6949,32102,10744,5219,5525
26790,41508,9399,20076,6951,32107,10746,5221,5525
26795,41514,9399,20078,6951,32115,10749,5222,5527
26800,41525,9403,20084,6954,32119,10751,5222,5529
26805,41529,9405,20086,6956,32123,10752,5222,5530
26810,41539,9409,20091,6958,32129,10754,5223,5531
26815,41545,9410,20094,6959,32133,10757,5224,5533
26820,41556,9414,20099,6962,32139,10759,5225,5534
26825,41560,9416,20102,6964,32144,10760,5226,5534
26830,41570,9419,20107,6967,32151,10762,5227,5535
26835,41576,9419,20109,6967,32157,10765,5228,5537
26840,41587,9423,20116,6970,32162,10767,5229,5538
26845,41591,9426,20120,6973,32165,10768,5230,5538
26850,41601,9429,20127,6975,32171,10770,5232,5538
26855,41607,9429,20131,6975,32177,10773,5234,5539
26860,41618,9431,20137,6977,32185,10775,5235,5540
26865,41622,9433,20139,6979,32189,10776,5236,5540
26870,41632,9435,20144,6981,32197,10778,5237,5541
26875,41638,9435,20146,6981,32202,10781,5237,5544
26880,41649,9439,20151,6985,32210,10783,5237,5546
26885,41653,9441,20153,6987,32212,10784,5237,5547
26890,41663,9445,20158,6990,32217,10786,5238,5548
26895,41669,9445,20160,6990,32223,10789,5238,5551
26900,41680,9448,20167,6992,32230,10791,5239,5552
26905,41684,9450,20169,6994,32234,10792,5239,5553
26910,41694,9452,20173,6995,32242,10794,5240,5554
26915,41700,9452,20176,6995,32248,10797,5241,5556
26920,41711,9455,20184,6998,32256,10799,5242,5557
26925,41715,9456,20186,6999,32259,10800,5242,5558
26930,41725,9458,20191,7000,32266,10802,5244,5558
26935,41731,9458,20195,7000,32272,10805,5247,5558
26940,41742,9461,20202,7002,32281,10807,5249,5558
26945,41746,9462,20204,7003,32284,10808,5249,5559
26950,41756,9464,20209,7005,32292,10810,5250,5560
26955,41762,9464,20213,7005,32297,10813,5252,5561
26960,41773,9466,20218,7006,32307,10815,5253,5562
26965,41777,9466,20219,7006,32311,10816,5254,5562
26970,41787,9468,20223,7008,32319,10818,5254,5564
26975,41793,9468,20226,7008,32325,10821,5256,5565
26980,41804,9470,20228,7008,32334,10823,5256,5567
26985,41808,9471,20232,7009,32337,10824,5257,5567
26990,41818,9472,20236,7009,32345,10826,5257,5569
26995,41824,9472,20238,7009,32352,10829,5257,5572
27000,41835,9474,20243,7010,32361,10831,5258,5573
27005,41839,9475,20246,7011,32364,10832,5259,5573
27010,41849,9479,20250,7013,32370,10834,5261,5573
27015,41855,9479,20253,7013,32375,10837,5263,5574
27020,41866,9484,20259,7017,32381,10839,5265,5574
27025,41870,9485,20261,7018,32384,10840,5266,5574
27030,41880,9490,20265,7022,32390,10842,5267,5575
27035,41886,9490,20267,7022,32395,10845,5268,5577
27040,41897,9496,20274,7027,32399,10847,5269,5578
27045,41901,9499,20275,7030,32402,10848,5269,5579
27050,41911,9504,20280,7034,32406,10850,5269,5581
27055,41917,9504,20283,7034,32410,10853,5270,5583
27060,41928,9510,20289,7040,32416,10855,5270,5585
27065,41932,9510,20290,7040,32422,10856,5271,5585
27070,41942,9512,20295,7041,32428,10858,5273,5585
27075,41948,9512,20297,7041,32435,10861,5274,5587
27080,41959,9515,20301,7043,32443,10863,5274,5589
27085,41963,9515,20302,7043,32447,10864,5274,5590
27090,41973,9516,20306,7044,32456,10866,5276,5590
27095,41979,9516,20309,7044,32460,10869,5277,5592
27100,41990,9519,20316,7046,32468,10871,5277,5594
27105,41994,9520,20317,7047,32474,10872,5277,5595
27110,42004,9522,20323,7048,32481,10874,5278,5596
27115,42010,9522,20327,7048,32488,10877,5280,5597
27120,42021,9524,20330,7048,32496,10879,5281,5598
27125,42025,9525,20332,7049,32500,10880,5281,5599
27130,42035,9526,20336,7050,32509,10882,5282,5600
27135,42041,9526,20338,7050,32514,10885,5282,5603
27140,42052,9527,20343,7051,32523,10887,5282,5605
27145,42056,9527,20344,7051,32529,10888,5282,5606
27150,42066,9528,20351,7052,32537,10890,5284,5606
27155,42072,9528,20354,7052,32543,10893,5286,5607
27160,42083,9529,20358,7052,32554,10895,5287,5608
27165,42087,9529,20359,7052,32558,10896,5287,5609
27170,42097,9531,20364,7054,32566,10898,5288,5610
27175,42103,9531,20366,7054,32570,10901,5288,5613
27180,42114,9534,20372,7056,32578,10903,5288,5615
27185,42118,9534,20374,7056,32584,10904,5288,5616
27190,42128,9536,20377,7057,32592,10906,5289,5617
27195,42134,9536,20381,7057,32597,10909,5291,5618
27200,42145,9537,20387,7058,32607,10911,5293,5618
27205,42149,9538,20388,7059,32611,10912,5293,5619
27210,42159,9540,20393,7059,32618,10914,5294,5620
27215,42165,9540,20396,7059,32624,10917,5295,5622
27220,42176,9541,20402,7060,32634,10919,5296,5623
27225,42180,9543,20406,7062,32637,10920,5297,5623
27230,42190,9548,20413,7067,32641,10922,5298,5624
27235,42196,9548,20415,7067,32648,10925,5300,5625
27240,42207,9551,20420,7069,32655,10927,5301,5626
27245,42211,9554,20424,7072,32657,10928,5302,5626
27250,42221,9558,20430,7075,32663,10930,5304,5626
27255,42227,9558,20432,7075,32669,10933,5306,5627
27260,42238,9562,20440,7079,32675,10935,5307,5628
27265,42242,9564,20443,7081,32678,10936,5308,5628
27270,42252,9567,20447,7082,32684,10938,5310,5628
27275,42258,9567,20450,7082,32690,10941,5311,5630
27280,42269,9571,20452,7084,32698,10943,5311,5632
27285,42273,9573,20455,7086,32700,10944,5312,5632
27290,42283,9578,20461,7090,32705,10946,5314,5632
27295,42289,9578,20464,7090,32709,10949,5315,5634
27300,42300,9583,20470,7095,32717,10951,5316,5635
27305,42304,9584,20471,7096,32720,10952,5316,5636
27310,42314,9587,20475,7097,32726,10954,5317,5637
27315,42320,9587,20478,7097,32732,10957,5318,5639
27320,42331,9592,20484,7101,32738,10959,5318,5641
27325,42335,9594,20486,7103,32741,10960,5319,5641
27330,42345,9599,20493,7107,32744,10962,5320,5642
27335,42351,9599,20494,7107,32751,10965,5321,5644
27340,42362,9601,20499,7108,32760,10967,5322,5645
27345,42366,9601,20501,7108,32764,10968,5322,5646
27350,42376,9603,20505,7110,32773,10970,5323,5647
27355,42382,9603,20508,7110,32778,10973,5324,5649
27360,42393,9605,20512,7111,32787,10975,5324,5651
27365,42397,9605,20513,7111,32791,10976,5324,5652
27370,42407,9606,20519,7112,32799,10978,5325,5653
27375,42413,9606,20522,7112,32806,10981,5327,5654
27380,42424,9608,20527,7112,32814,10983,5327,5656
27385,42428,9608,20527,7112,32820,10984,5327,5657
27390,42438,9610,20531,7113,32827,10986,5327,5659
27395,42444,9610,20534,7113,32831,10989,5327,5662
27400,42455,9613,20543,7115,32840,10991,5329,5662
27405,42459,9613,20544,7115,32846,10992,5330,5662
27410,42469,9615,20550,7117,32853,10994,5332,5662
27415,42475,9615,20552,7117,32859,10997,5333,5664
27420,42486,9617,20556,7119,32868,10999,5334,5665
27425,42490,9617,20557,7119,32873,11000,5334,5666
27430,42500,9619,20562,7120,32879,11002,5335,5667
27435,42506,9619,20565,7120,32886,11005,5337,5668
27440,42517,9621,20570,7121,32895,11007,5339,5668
27445,42521,9623,20572,7123,32898,11008,5339,5669
27450,42531,9626,20579,7126,32904,11010,5341,5669
27455,42537,9626,20583,7126,32910,11013,5343,5670
27460,42548,9629,20589,7128,32918,11015,5344,5671
27465,42552,9630,20591,7129,32922,11016,5345,5671
27470,42562,9633,20594,7131,32929,11018,5346,5672
27475,42568,9633,20598,7131,32934,11021,5348,5673
27480,42579,9638,20605,7134,32940,11023,5349,5674
27485,42583,9640,20608,7136,32943,11024,5349,5675
27490,42593,9642,20614,7138,32950,11026,5350,5676
27495,42599,9642,20618,7138,32956,11029,5352,5677
27500,42610,9646,20620,7141,32964,11031,5352,5679
27505,42614,9646,20621,7141,32968,11032,5352,5680
27510,42624,9648,20623,7141,32976,11034,5354,5680
27515,42630,9648,20625,7141,32981,11037,5355,5682
27520,42641,9652,20632,7143,32988,11039,5357,5682
27525,42645,9655,20635,7146,32990,11040,5358,5682
27530,42655,9658,20639,7148,32996,11042,5359,5683
27535,42661,9658,20643,7148,33002,11045,5360,5685
27540,42672,9661,20649,7151,33009,11047,5362,5685
27545,42676,9664,20651,7154,33012,11048,5363,5685
27550,42686,9667,20653,7155,33019,11050,5364,5686
27555,42692,9667,20656,7155,33023,11053,5365,5688
27560,42703,9671,20659,7158,33031,11055,5366,5689
27565,42707,9673,20662,7160,33033,11056,5367,5689
27570,42717,9677,20668,7163,33038,11058,5369,5689
27575,42723,9678,20669,7164,33043,11061,5369,5692
27580,42734,9684,20676,7169,33048,11063,5370,5693
27585,42738,9685,20679,7170,33052,11064,5370,5694
27590,42748,9688,20685,7172,33059,11066,5371,5695
27595,42754,9688,20687,7172,33065,11069,5373,5696
27600,42765,9690,20691,7172,33074,11071,5375,5696
27605,42769,9691,20693,7173,33078,11072,5375,5697
27610,42779,9693,20698,7175,33086,11074,5377,5697
27615,42785,9693,20700,7175,33092,11077,5378,5699
27620,42796,9695,20707,7177,33099,11079,5380,5699
27625,42800,9695,20708,7177,33105,11080,5381,5699
27630,42810,9697,20712,7178,33113,11082,5382,5700
27635,42816,9697,20717,7178,33118,11085,5385,5700
27640,42827,9699,20723,7179,33126,11087,5386,5701
27645,42831,9699,20725,7179,33132,11088,5386,5702
27650,42841,9702,20729,7181,33139,11090,5387,5703
27655,42847,9702,20733,7181,33145,11093,5389,5704
27660,42858,9705,20741,7184,33152,11095,5390,5705
27665,42862,9706,20742,7185,33156,11096,5390,5706
27670,42872,9708,20750,7187,33163,11098,5392,5706
27675,42878,9708,20752,7187,33169,11101,5393,5708
27680,42889,9711,20757,7189,33178,11103,5393,5710
27685,42893,9711,20757,7189,33182,11104,5393,5711
27690,42903,9714,20760,7190,33189,11106,5394,5712
27695,42909,9714,20762,7190,33195,11109,5396,5713
27700,42920,9716,20767,7191,33202,11111,5397,5714
27705,42924,9718,20768,7193,33206,11112,5397,5715
27710,42934,9722,20774,7196,33212,11114,5398,5716
27715,42940,9722,20776,7196,33218,11117,5399,5718
27720,42951,9727,20782,7200,33224,11119,5400,5719
27725,42955,9728,20784,7201,33227,11120,5401,5719
27730,42965,9733,20790,7205,33232,11122,5402,5720
27735,42971,9733,20792,7205,33238,11125,5403,5722
27740,42982,9734,20794,7205,33247,11127,5403,5724
27745,42986,9735,20794,7206,33251,11128,5403,5725
27750,42996,9738,20797,7208,33258,11130,5404,5726
27755,43002,9738,20800,7208,33263,11133,5406,5727
27760,43013,9740,20805,7209,33271,11135,5408,5727
27765,43017,9741,20807,7210,33276,11136,5409,5727
27770,43027,9743,20814,7211,33283,11138,5410,5728
27775,43033,9743,20817,7211,33289,11141,5411,5730
27780,43044,9745,20823,7212,33296,11143,5412,5731
27785,43048,9749,20824,7216,33299,11144,5412,5732
27790,43058,9751,20827,7216,33306,11146,5414,5732
27795,43064,9752,20829,7217,33311,11149,5415,5734
27800,43075,9754,20833,7219,33319,11151,5415,5736
27805,43079,9757,20836,7222,33321,11152,5416,5736
27810,43089,9760,20841,7225,33328,11154,5417,5737
27815,43095,9760,20845,7225,33334,11157,5420,5737
27820,43106,9762,20848,7226,33343,11159,5421,5738
27825,43110,9764,20851,7228,33346,11160,5422,5738
27830,43120,9767,20853,7229,33353,11162,5423,5739
27835,43126,9767,20854,7229,33358,11165,5423,5742
27840,43137,9772,20858,7232,33365,11167,5423,5744
27845,43141,9772,20860,7232,33369,11168,5423,5745
27850,43151,9774,20864,7233,33376,11170,5424,5746
27855,43157,9774,20867,7233,33382,11173,5425,5748
27860,43168,9776,20869,7234,33392,11175,5426,5749
27865,43172,9777,20872,7235,33395,11176,5427,5749
27870,43182,9779,20879,7237,33402,11178,5428,5750
27875,43188,9779,20881,7237,33408,11181,5429,5752
27880,43199,9781,20887,7238,33418,11183,5430,5753
27885,43203,9781,20889,7238,33422,11184,5431,5753
27890,43213,9783,20894,7239,33429,11186,5432,5754
27895,43219,9783,20898,7239,33436,11189,5434,5755
27900,43230,9785,20900,7240,33445,11191,5434,5757
27905,43234,9785,20901,7240,33449,11192,5434,5758
27910,43244,9786,20903,7240,33458,11194,5436,5758
27915,43250,9786,20905,7240,33463,11197,5437,5760
27920,43261,9789,20911,7241,33469,11199,5438,5761
27925,43265,9790,20913,7242,33475,11200,5439,5761
27930,43275,9792,20919,7244,33482,11202,5440,5762
27935,43281,9792,20924,7244,33488,11205,5442,5763
27940,43292,9794,20928,7244,33497,11207,5443,5764
27945,43296,9795,20930,7245,33501,11208,5444,5764
27950,43306,9799,20938,7248,33505,11210,5446,5764
27955,43312,9799,20939,7248,33513,11213,5447,5766
27960,43323,9803,20945,7251,33519,11215,5449,5766
27965,43327,9804,20946,7252,33523,11216,5449,5767
27970,43337,9807,20951,7255,33529,11218,5449,5769
27975,43343,9807,20955,7255,33535,11221,5451,5770
27980,43354,9810,20960,7256,33542,11223,5453,5770
27985,43358,9810,20961,7256,33548,11224,5454,5770
27990,43368,9812,20964,7256,33556,11226,5455,5771
27995,43374,9812,20966,7256,33562,11229,5456,5773
28000,43385,9814,20972,7257,33569,11231,5458,5773
28005,43389,9815,20972,7258,33574,11232,5458,5774
28010,43399,9817,20975,7259,33581,11234,5458,5776
28015,43405,9817,20976,7259,33587,11237,5458,5779
28020,43416,9822,20982,7262,33592,11239,5460,5779
28025,43420,9823,20983,7263,33597,11240,5460,5780
28030,43430,9826,20989,7265,33603,11242,5461,5781
28035,43436,9826,20995,7265,33608,11245,5464,5781
28040,43447,9829,21000,7266,33616,11247,5466,5781
28045,43451,9830,21002,7267,33621,11248,5467,5781
28050,43461,9833,21007,7268,33627,11250,5468,5782
28055,43467,9833,21009,7268,33634,11253,5470,5783
28060,43478,9837,21014,7272,33641,11255,5471,5784
28065,43482,9838,21015,7273,33644,11256,5471,5785
28070,43492,9840,21018,7274,33651,11258,5471,5787
28075,43498,9840,21020,7274,33658,11261,5472,5789
28080,43509,9844,21028,7277,33663,11263,5474,5789
28085,43513,9846,21030,7279,33667,11264,5475,5789
28090,43523,9851,21037,7283,33671,11266,5476,5790
28095,43529,9851,21041,7283,33677,11269,5479,5790
28100,43540,9855,21045,7285,33684,11271,5480,5791
28105,43544,9856,21047,7286,33688,11272,5481,5791
28110,43554,9859,21051,7289,33695,11274,5482,5792
28115,43560,9859,21055,7289,33699,11277,5483,5794
28120,43571,9865,21062,7294,33705,11279,5484,5795
28125,43575,9866,21065,7295,33709,11280,5485,5795
28130,43585,9868,21070,7297,33716,11282,5486,5796
28135,43591,9868,21071,7297,33722,11285,5487,5798
28140,43602,9871,21074,7300,33730,11287,5487,5800
28145,43606,9874,21077,7303,33732,11288,5488,5800
28150,43616,9878,21082,7306,33737,11290,5488,5802
28155,43622,9878,21086,7306,33743,11293,5491,5802
28160,43633,9884,21094,7311,33749,11295,5492,5803
28165,43637,9885,21096,7312,33752,11296,5492,5804
28170,43647,9887,21102,7314,33760,11298,5493,5805
28175,43653,9887,21106,7314,33766,11301,5495,5806
28180,43664,9890,21113,7317,33774,11303,5496,5807
28185,43668,9890,21115,7317,33778,11304,5497,5807
28190,43678,9891,21119,7318,33786,11306,5497,5809
28195,43684,9891,21121,7318,33792,11309,5497,5812
28200,43695,9894,21129,7320,33801,11311,5499,5812
28205,43699,9894,21130,7320,33805,11312,5500,5812
28210,43709,9897,21135,7322,33811,11314,5500,5814
28215,43715,9897,21136,7322,33817,11317,5500,5817
28220,43726,9899,21140,7322,33827,11319,5500,5819
28225,43730,9899,21141,7322,33831,11320,5500,5820
28230,43740,9902,21145,7325,33838,11322,5500,5822
28235,43746,9902,21149,7325,33844,11325,5503,5822
28240,43757,9904,21154,7326,33853,11327,5504,5823
28245,43761,9905,21157,7327,33855,11328,5505,5823
28250,43771,9907,21161,7328,33864,11330,5506,5824
28255,43777,9907,21165,7328,33869,11333,5508,5825
28260,43788,9909,21169,7328,33878,11335,5509,5826
28265,43792,9910,21172,7329,33881,11336,5510,5826
28270,43802,9916,21178,7334,33885,11338,5511,5827
28275,43808,9917,21181,7335,33889,11341,5512,5829
28280,43819,9922,21188,7340,33894,11343,5513,5830
28285,43823,9925,21191,7343,33897,11344,5513,5831
28290,43833,9928,21195,7344,33904,11346,5513,5833
28295,43839,9928,21197,7344,33911,11349,5515,5834
28300,43850,9932,21203,7347,33917,11351,5517,5834
28305,43854,9933,21205,7348,33921,11352,5517,5835
28310,43864,9936,21208,7349,33928,11354,5518,5836
28315,43870,9936,21209,7349,33934,11357,5519,5838
28320,43881,9940,21216,7351,33938,11359,5520,5839
28325,43885,9941,21217,7352,33944,11360,5521,5839
28330,43895,9943,21223,7353,33951,11362,5523,5839
28335,43901,9943,21225,7353,33957,11365,5524,5841
28340,43912,9944,21227,7353,33967,11367,5525,5842
28345,43916,9945,21228,7354,33971,11368,5525,5843
28350,43926,9947,21231,7354,33978,11370,5525,5845
28355,43932,9947,21232,7354,33984,11373,5525,5848
28360,43943,9949,21235,7355,33993,11375,5525,5850
28365,43947,9949,21236,7355,33998,11376,5525,5851
28370,43957,9951,21241,7357,34006,11378,5527,5851
28375,43963,9951,21244,7357,34011,11381,5528,5853
28380,43974,9952,21249,7357,34021,11383,5529,5854
28385,43978,9953,21250,7358,34025,11384,5529,5855
28390,43988,9955,21257,7359,34032,11386,5530,5856
28395,43994,9955,21260,7359,34037,11389,5531,5858
28400,44005,9958,21266,7361,34046,11391,5532,5859
28405,44009,9958,21267,7361,34051,11392,5532,5860
28410,44019,9960,21271,7361,34058,11394,5532,5862
28415,44025,9960,21274,7361,34065,11397,5534,5863
28420,44036,9962,21280,7363,34074,11399,5535,5864
28425,44040,9962,21282,7363,34078,11400,5535,5865
28430,44050,9966,21287,7365,34083,11402,5536,5866
28435,44056,9966,21290,7365,34090,11405,5538,5867
28440,44067,9969,21294,7366,34098,11407,5539,5868
28445,44071,9970,21297,7367,34101,11408,5540,5868
28450,44081,9973,21301,7369,34108,11410,5541,5869
28455,44087,9973,21303,7369,34114,11413,5543,5870
28460,44098,9977,21307,7372,34121,11415,5543,5872
28465,44102,9979,21311,7374,34123,11416,5544,5872
28470,44112,9982,21316,7377,34130,11418,5545,5873
28475,44118,9982,21320,7377,34134,11421,5547,5874
28480,44129,9988,21325,7382,34141,11423,5548,5875
28485,44133,9988,21327,7382,34145,11424,5549,5875
28490,44143,9993,21333,7386,34149,11426,5550,5876
28495,44149,9993,21337,7386,34155,11429,5553,5876
28500,44160,9997,21343,7389,34162,11431,5554,5877
28505,44164,10000,21347,7392,34164,11432,5555,5877
28510,44174,10003,21353,7394,34169,11434,5557,5877
28515,44180,10004,21355,7395,34175,11437,5559,5878
28520,44191,10008,21362,7399,34180,11439,5560,5879
28525,44195,10010,21364,7401,34185,11440,5561,5879
28530,44205,10012,21370,7403,34193,11442,5562,5880
28535,44211,10012,21374,7403,34198,11445,5564,5881
28540,44222,10014,21379,7404,34207,11447,5565,5882
28545,44226,10015,21381,7405,34210,11448,5565,5883
28550,44236,10017,21383,7406,34219,11450,5565,5885
28555,44242,10017,21386,7406,34224,11453,5567,5886
28560,44253,10020,21390,7407,34232,11455,5569,5886
28565,44257,10021,21394,7408,34235,11456,5570,5886
28570,44267,10022,21400,7408,34243,11458,5572,5886
28575,44273,10022,21402,7408,34249,11461,5573,5888
28580,44284,10025,21409,7410,34257,11463,5573,5890
28585,44288,10026,21413,7411,34261,11464,5574,5890
28590,44298,10027,21414,7411,34271,11466,5574,5892
28595,44304,10027,21418,7411,34276,11469,5576,5893
28600,44315,10030,21421,7413,34285,11471,5576,5895
28605,44319,10030,21424,7413,34289,11472,5577,5895
28610,44329,10032,21429,7415,34296,11474,5578,5896
28615,44335,10032,21431,7415,34303,11477,5579,5898
28620,44346,10035,21436,7417,34309,11479,5580,5899
28625,44350,10035,21439,7417,34315,11480,5581,5899
28630,44360,10037,21444,7418,34323,11482,5583,5899
28635,44366,10037,21448,7418,34327,11485,5584,5901
28640,44377,10040,21455,7421,34335,11487,5585,5902
28645,44381,10042,21458,7423,34339,11488,5586,5902
28650,44391,10045,21465,7425,34345,11490,5588,5902
28655,44397,10045,21470,7425,34350,11493,5590,5903
28660,44408,10048,21477,7428,34359,11495,5591,5904
28665,44412,10049,21478,7429,34363,11496,5592,5904
28670,44422,10053,21484,7432,34368,11498,5593,5905
28675,44428,10053,21486,7432,34375,11501,5595,5906
28680,44439,10056,21490,7434,34382,11503,5595,5908
28685,44443,10058,21493,7436,34385,11504,5596,5908
28690,44453,10062,21500,7439,34390,11506,5597,5909
28695,44459,10062,21503,7439,34396,11509,5599,5910
28700,44470,10066,21508,7442,34403,11511,5600,5911
28705,44474,10068,21510,7444,34406,11512,5600,5912
28710,44484,10072,21514,7447,34412,11514,5600,5914
28715,44490,10072,21517,7447,34418,11517,5602,5915
28720,44501,10075,21521,7449,34425,11519,5602,5917
28725,44505,10078,21524,7452,34427,11520,5602,5918
28730,44515,10081,21529,7454,34434,11522,5604,5918
28735,44521,10081,21533,7454,34439,11525,5606,5919
28740,44532,10086,21540,7458,34446,11527,5608,5919
28745,44536,10086,21541,7458,34450,11528,5609,5919
28750,44546,10088,21545,7460,34457,11530,5610,5920
28755,44552,10088,21548,7460,34463,11533,5611,5922
28760,44563,10092,21552,7463,34471,11535,5612,5923
28765,44567,10093,21553,7464,34474,11536,5612,5924
28770,44577,10097,21557,7466,34479,11538,5613,5925
28775,44583,10098,21560,7467,34484,11541,5615,5926
28780,44594,10103,21565,7470,34489,11543,5616,5927
28785,44598,10107,21568,7474,34491,11544,5617,5927
28790,44608,10111,21575,7477,34495,11546,5619,5927
28795,44614,10111,21577,7477,34502,11549,5621,5928
28800,44625,10113,21577,7477,34512,11551,5621,5930
28805,44629,10114,21580,7478,34515,11552,5622,5930
28810,44639,10115,21587,7478,34523,11554,5623,5931
28815,44645,10115,21590,7478,34529,11557,5625,5932
28820,44656,10116,21593,7479,34540,11559,5626,5933
28825,44660,10116,21595,7479,34543,11560,5626,5934
28830,44670,10117,21599,7479,34553,11562,5627,5935
28835,44676,10117,21602,7479,34557,11565,5628,5937
28840,44687,10118,21605,7479,34569,11567,5628,5939
28845,44691,10118,21608,7479,34572,11568,5628,5940
28850,44701,10119,21612,7480,34581,11570,5629,5941
28855,44707,10119,21615,7480,34587,11573,5631,5942
28860,44718,10120,21620,7481,34597,11575,5632,5943
28865,44722,10120,21621,7481,34602,11576,5632,5944
28870,44732,10121,21626,7481,34610,11578,5633,5945
28875,44738,10121,21629,7481,34616,11581,5634,5947
28880,44749,10122,21632,7481,34626,11583,5636,5947
28885,44753,10122,21634,7481,34630,11584,5636,5948
28890,44763,10123,21635,7481,34639,11586,5636,5950
28895,44769,10123,21640,7481,34645,11589,5638,5951
28900,44780,10125,21644,7482,34653,11591,5638,5953
28905,44784,10125,21646,7482,34658,11592,5638,5954
28910,44794,10128,21649,7484,34666,11594,5638,5956
28915,44800,10128,21650,7484,34671,11597,5638,5959
28920,44811,10131,21656,7486,34677,11599,5639,5960
28925,44815,10132,21657,7487,34683,11600,5639,5961
28930,44825,10135,21661,7489,34690,11602,5639,5963
28935,44831,10135,21664,7489,34696,11605,5641,5964
28940,44842,10138,21669,7490,34704,11607,5643,5964
28945,44846,10139,21671,7491,34707,11608,5644,5964
28950,44856,10141,21673,7492,34715,11610,5644,5966
28955,44862,10141,21674,7492,34721,11613,5645,5968
28960,44873,10145,21680,7494,34726,11615,5647,5968
28965,44877,10147,21682,7496,34730,11616,5648,5968
28970,44887,10150,21689,7499,34737,11618,5649,5969
28975,44893,10150,21692,7499,34743,11621,5651,5970
28980,44904,10153,21696,7500,34750,11623,5652,5971
28985,44908,10154,21697,7501,34754,11624,5652,5972
28990,44918,10157,21701,7503,34760,11626,5652,5974
28995,44924,10157,21706,7503,34765,11629,5654,5975
29000,44935,10161,21711,7506,34773,11631,5655,5976
29005,44939,10163,21715,7508,34776,11632,5656,5976
29010,44949,10167,21721,7511,34782,11634,5657,5977
29015,44955,10167,21726,7511,34788,11637,5660,5977
29020,44966,10171,21730,7514,34795,11639,5661,5978
29025,44970,10172,21733,7515,34798,11640,5662,5978
29030,44980,10176,21740,7519,34803,11642,5663,5979
29035,44986,10176,21742,7519,34809,11645,5664,5981
29040,44997,10182,21750,7524,34814,11647,5665,5982
29045,45001,10184,21751,7526,34817,11648,5665,5983
29050,45011,10190,21759,7532,34821,11650,5666,5984
29055,45017,10190,21763,7532,34826,11653,5668,5985
29060,45028,10195,21766,7535,34833,11655,5669,5986
29065,45032,10196,21767,7536,34836,11656,5669,5987
29070,45042,10200,21771,7538,34841,11658,5670,5988
29075,45048,10200,21774,7538,34847,11661,5671,5990
29080,45059,10204,21777,7540,34855,11663,5671,5992
29085,45063,10205,21778,7541,34858,11664,5671,5993
29090,45073,10207,21781,7541,34865,11666,5672,5994
29095,45079,10207,21783,7541,34872,11669,5674,5995
29100,45090,10211,21789,7545,34879,11671,5675,5996
29105,45094,10212,21791,7546,34882,11672,5675,5997
29110,45104,10215,21796,7548,34887,11674,5676,5998
29115,45110,10216,21799,7549,34891,11677,5677,6000
29120,45121,10219,21804,7551,34901,11679,5678,6001
29125,45125,10220,21806,7552,34904,11680,5678,6002
29130,45135,10223,21811,7554,34911,11682,5679,6003
29135,45141,10223,21812,7554,34918,11685,5680,6005
29140,45152,10226,21817,7555,34925,11687,5681,6006
29145,45156,10226,21817,7555,34930,11688,5681,6007
29150,45166,10228,21822,7557,34938,11690,5682,6008
29155,45172,10228,21825,7557,34943,11693,5683,6010
29160,45183,10231,21832,7560,34951,11695,5685,6010
29165,45187,10231,21835,7560,34955,11696,5686,6010
29170,45197,10232,21837,7561,34965,11698,5687,6011
29175,45203,10232,21839,7561,34971,11701,5689,6012
29180,45214,10233,21846,7562,34979,11703,5691,6012
29185,45218,10233,21849,7562,34984,11704,5691,6013
29190,45228,10234,21854,7562,34994,11706,5693,6013
29195,45234,10234,21857,7562,34999,11709,5695,6014
29200,45245,10235,21864,7563,35008,11711,5696,6015
29205,45249,10235,21865,7563,35014,11712,5696,6016
29210,45259,10236,21868,7563,35023,11714,5697,6017
29215,45265,10236,21870,7563,35029,11717,5699,6018
29220,45276,10237,21877,7564,35035,11719,5699,6020
29225,45280,10238,21880,7565,35042,11720,5700,6020
29230,45290,10240,21883,7565,35050,11722,5701,6021
29235,45296,10240,21884,7565,35056,11725,5702,6023
29240,45307,10241,21889,7566,35064,11727,5703,6024
29245,45311,10241,21890,7566,35069,11728,5703,6025
29250,45321,10243,21893,7566,35077,11730,5704,6026
29255,45327,10243,21896,7566,35082,11733,5705,6028
29260,45338,10245,21903,7567,35090,11735,5706,6029
29265,45342,10245,21905,7567,35097,11736,5706,6030
29270,45352,10249,21914,7570,35102,11738,5708,6030
29275,45358,10249,21918,7570,35107,11741,5710,6031
29280,45369,10252,21921,7573,35117,11743,5711,6032
29285,45373,10253,21923,7574,35120,11744,5712,6032
29290,45383,10257,21929,7577,35126,11746,5713,6033
29295,45389,10257,21931,7577,35132,11749,5715,6034
29300,45400,10260,21937,7580,35139,11751,5716,6035
29305,45404,10263,21939,7583,35141,11752,5716,6036
29310,45414,10266,21946,7586,35147,11754,5717,6037
29315,45420,10266,21948,7586,35153,11757,5717,6040
29320,45431,10270,21955,7590,35160,11759,5718,6041
29325,45435,10272,21958,7592,35163,11760,5719,6041
29330,45445,10275,21961,7595,35170,11762,5719,6043
29335,45451,10275,21963,7595,35175,11765,5720,6045
29340,45462,10281,21967,7599,35181,11767,5720,6047
29345,45466,10282,21969,7600,35184,11768,5720,6048
29350,45476,10284,21972,7600,35191,11770,5721,6049
29355,45482,10284,21974,7600,35198,11773,5722,6051
29360,45493,10288,21980,7603,35205,11775,5723,6052
29365,45497,10289,21982,7604,35208,11776,5724,6052
29370,45507,10292,21988,7607,35214,11778,5726,6052
29375,45513,10292,21990,7607,35220,11781,5726,6055
29380,45524,10297,21996,7611,35226,11783,5727,6056
29385,45528,10299,21997,7613,35229,11784,5727,6057
29390,45538,10303,22001,7615,35234,11786,5728,6058
29395,45544,10303,22006,7615,35238,11789,5731,6058
29400,45555,10309,22011,7620,35244,11791,5732,6059
29405,45559,10310,22014,7621,35249,11792,5733,6059
29410,45569,10312,22019,7623,35255,11794,5734,6060
29415,45575,10312,22023,7623,35262,11797,5736,6061
29420,45586,10315,22030,7624,35270,11799,5738,6061
29425,45590,10315,22032,7624,35274,11800,5739,6061
29430,45600,10318,22038,7627,35280,11802,5741,6061
29435,45606,10318,22042,7627,35287,11805,5744,6061
29440,45617,10320,22048,7628,35295,11807,5745,6062
29445,45621,10321,22051,7629,35299,11808,5745,6063
29450,45631,10324,22056,7631,35306,11810,5745,6065
29455,45637,10324,22060,7631,35311,11813,5747,6066
29460,45648,10326,22065,7631,35321,11815,5748,6067
29465,45652,10326,22065,7631,35326,11816,5748,6068
29470,45662,10329,22069,7633,35331,11818,5748,6070
29475,45668,10329,22073,7633,35338,11821,5751,6070
29480,45679,10331,22076,7633,35346,11823,5751,6072
29485,45683,10331,22077,7633,35352,11824,5751,6073
29490,45693,10332,22081,7633,35360,11826,5752,6074
29495,45699,10332,22084,7633,35366,11829,5754,6075
29500,45710,10335,22088,7634,35374,11831,5755,6076
29505,45714,10336,22092,7635,35378,11832,5756,6076
29510,45724,10340,22096,7637,35383,11834,5756,6078
29515,45730,10340,22100,7637,35389,11837,5758,6079
29520,45741,10344,22103,7639,35395,11839,5758,6081
29525,45745,10346,22106,7641,35399,11840,5759,6081
29530,45755,10348,22108,7641,35406,11842,5760,6082
29535,45761,10348,22110,7641,35413,11845,5762,6083
29540,45772,10351,22117,7643,35420,11847,5763,6084
29545,45776,10353,22121,7645,35423,11848,5764,6084
29550,45786,10355,22126,7646,35430,11850,5765,6085
29555,45792,10355,22130,7646,35435,11853,5767,6086
29560,45803,10360,22135,7650,35442,11855,5767,6088
29565,45807,10362,22138,7652,35445,11856,5768,6088
29570,45817,10365,22142,7653,35451,11858,5769,6089
29575,45823,10365,22146,7653,35457,11861,5772,6089
29580,45834,10368,22149,7654,35465,11863,5772,6091
29585,45838,10370,22153,7656,35468,11864,5773,6091
29590,45848,10372,22159,7657,35475,11866,5774,6092
29595,45854,10372,22162,7657,35481,11869,5775,6094
29600,45865,10374,22169,7659,35490,11871,5776,6095
29605,45869,10376,22171,7661,35493,11872,5776,6096
29610,45879,10379,22178,7663,35499,11874,5778,6096
29615,45885,10379,22181,7663,35506,11877,5780,6097
29620,45896,10381,22188,7665,35515,11879,5781,6098
29625,45900,10381,22190,7665,35519,11880,5782,6098
29630,45910,10384,22197,7668,35525,11882,5784,6098
29635,45916,10384,22199,7668,35532,11885,5785,6100
29640,45927,10386,22206,7669,35540,11887,5786,6101
29645,45931,10388,22208,7671,35543,11888,5786,6102
29650,45941,10391,22212,7673,35549,11890,5786,6104
29655,45947,10391,22217,7673,35554,11893,5789,6104
29660,45958,10396,22225,7677,35561,11895,5790,6105
29665,45962,10397,22225,7678,35565,11896,5790,6106
29670,45972,10400,22229,7680,35571,11898,5790,6108
29675,45978,10400,22232,7680,35577,11901,5791,6110
29680,45989,10401,22236,7681,35588,11903,5792,6111
29685,45993,10401,22239,7681,35591,11904,5793,6111
29690,46003,10404,22245,7684,35597,11906,5794,6112
29695,46009,10404,22246,7684,35604,11909,5794,6115
29700,46020,10406,22251,7685,35613,11911,5794,6117
29705,46024,10406,22254,7685,35617,11912,5795,6117
29710,46034,10408,22260,7687,35624,11914,5797,6117
29715,46040,10408,22261,7687,35631,11917,5797,6120
29720,46051,10410,22266,7688,35639,11919,5797,6122
29725,46055,10411,22267,7689,35644,11920,5797,6123
29730,46065,10413,22271,7690,35651,11922,5797,6125
29735,46071,10413,22274,7690,35657,11925,5798,6127
29740,46082,10415,22276,7690,35667,11927,5799,6128
29745,46086,10415,22278,7690,35670,11928,5800,6128
29750,46096,10416,22283,7690,35678,11930,5801,6129
29755,46102,10416,22286,7690,35685,11933,5802,6131
29760,46113,10419,22294,7693,35692,11935,5804,6131
29765,46117,10419,22297,7693,35697,11936,5805,6131
29770,46127,10421,22299,7694,35705,11938,5806,6132
29775,46133,10421,22304,7694,35710,11941,5808,6133
29780,46144,10426,22308,7697,35718,11943,5810,6133
29785,46148,10427,22310,7698,35721,11944,5810,6134
29790,46158,10430,22315,7701,35727,11946,5811,6135
29795,46164,10430,22318,7701,35732,11949,5812,6137
29800,46175,10434,22321,7704,35741,11951,5813,6138
29805,46179,10434,22324,7704,35745,11952,5814,6138
29810,46189,10437,22330,7707,35751,11954,5815,6139
29815,46195,10437,22335,7707,35756,11957,5817,6140
29820,46206,10442,22343,7711,35761,11959,5818,6141
29825,46210,10442,22344,7711,35768,11960,5819,6141
29830,46220,10446,22349,7714,35773,11962,5821,6141
29835,46226,10446,22350,7714,35780,11965,5822,6143
29840,46237,10450,22357,7718,35787,11967,5823,6144
29845,46241,10452,22361,7720,35789,11968,5824,6144
29850,46251,10455,22366,7723,35795,11970,5824,6146
29855,46257,10455,22369,7723,35802,11973,5826,6147
29860,46268,10458,22374,7724,35810,11975,5827,6148
29865,46272,10459,22376,7725,35813,11976,5828,6148
29870,46282,10462,22381,7727,35819,11978,5829,6149
29875,46288,10462,22384,7727,35826,11981,5831,6150
29880,46299,10466,22391,7731,35833,11983,5832,6151
29885,46303,10466,22393,7731,35837,11984,5833,6151
29890,46313,10470,22398,7734,35843,11986,5834,6152
29895,46319,10470,22401,7734,35849,11989,5836,6153
29900,46330,10474,22408,7737,35855,11991,5837,6154
29905,46334,10476,22410,7739,35858,11992,5838,6154
29910,46344,10481,22417,7743,35863,11994,5840,6154
29915,46350,10481,22418,7743,35869,11997,5841,6156
29920,46361,10484,22424,7746,35877,11999,5842,6157
29925,46365,10485,22426,7747,35880,12000,5843,6157
29930,46375,10489,22430,7749,35886,12002,5845,6157
29935,46381,10489,22433,7749,35890,12005,5846,6159
29940,46392,10495,22437,7754,35896,12007,5846,6161
29945,46396,10497,22440,7756,35898,12008,5847,6161
29950,46406,10502,22444,7759,35904,12010,5849,6161
29955,46412,10502,22446,7759,35910,12013,5851,6162
29960,46423,10507,22451,7762,35915,12015,5852,6163
29965,46427,10507,22453,7762,35919,12016,5852,6164
29970,46437,10509,22460,7764,35926,12018,5853,6165
29975,46443,10509,22463,7764,35933,12021,5855,6166
29980,46454,10512,22472,7767,35940,12023,5856,6167
29985,46458,10512,22472,7767,35946,12024,5856,6168
29990,46468,10514,22476,7768,35954,12026,5856,6170
29995,46474,10514,22478,7768,35959,12029,5857,6172
30000,46485,10517,22480,7770,35968,12031,5857,6174
30005,46489,10517,22483,7770,35971,12032,5858,6174
30010,46499,10520,22489,7773,35979,12034,5860,6174
30015,46505,10520,22490,7773,35985,12037,5860,6177
30020,46516,10523,22496,7776,35991,12039,5861,6178
30025,46520,10523,22498,7776,35996,12040,5861,6179
30030,46530,10526,22503,7778,36004,12042,5862,6180
30035,46536,10526,22505,7778,36010,12045,5863,6182
30040,46547,10527,22509,7778,36020,12047,5865,6182
30045,46551,10527,22510,7778,36024,12048,5866,6182
30050,46561,10528,22517,7779,36031,12050,5867,6183
30055,46567,10528,22519,7779,36038,12053,5867,6186
30060,46578,10529,22524,7779,36047,12055,5868,6187
30065,46582,10529,22526,7779,36053,12056,5869,6187
30070,46592,10531,22533,7779,36060,12058,5871,6187
30075,46598,10531,22536,7779,36066,12061,5872,6189
30080,46609,10534,22540,7781,36074,12063,5872,6191
30085,46613,10535,22543,7782,36078,12064,5873,6191
30090,46623,10537,22545,7782,36086,12066,5873,6193
30095,46629,10537,22549,7782,36091,12069,5875,6194
30100,46640,10540,22553,7785,36100,12071,5876,6195
30105,46644,10540,22555,7785,36104,12072,5876,6196
30110,46654,10542,22561,7786,36111,12074,5878,6196
30115,46660,10542,22563,7786,36117,12077,5878,6199
30120,46671,10546,22571,7789,36123,12079,5880,6199
30125,46675,10547,22572,7790,36128,12080,5880,6200
30130,46685,10549,22577,7791,36135,12082,5882,6200
30135,46691,10549,22580,7791,36140,12085,5882,6203
30140,46702,10555,22587,7796,36146,12087,5883,6204
30145,46706,10557,22588,7798,36149,12088,5883,6205
30150,46716,10560,22595,7801,36155,12090,5885,6205
30155,46722,10560,22597,7801,36161,12093,5886,6207
30160,46733,10565,22602,7804,36167,12095,5887,6208
30165,46737,10568,22605,7807,36169,12096,5888,6208
30170,46747,10571,22610,7809,36174,12098,5889,6209
30175,46753,10572,22612,7810,36179,12101,5890,6211
30180,46764,10578,22617,7815,36186,12103,5891,6212
30185,46768,10579,22619,7816,36189,12104,5891,6213
30190,46778,10582,22628,7819,36196,12106,5893,6213
30195,46784,10582,22630,7819,36202,12109,5894,6215
30200,46795,10585,22636,7821,36210,12111,5894,6217
30205,46799,10585,22637,7821,36214,12112,5894,6218
30210,46809,10587,22640,7823,36222,12114,5894,6220
30215,46815,10587,22641,7823,36228,12117,5895,6222
30220,46826,10589,22644,7823,36237,12119,5895,6224
30225,46830,10589,22646,7823,36241,12120,5895,6225
30230,46840,10591,22651,7825,36248,12122,5895,6227
30235,46846,10591,22652,7825,36255,12125,5896,6229
30240,46857,10593,22659,7826,36264,12127,5897,6230
30245,46861,10593,22662,7826,36268,12128,5898,6230
30250,46871,10596,22666,7828,36274,12130,5898,6232
30255,46877,10596,22668,7828,36281,12133,5899,6234
30260,46888,10599,22673,7830,36289,12135,5900,6235
30265,46892,10599,22675,7830,36293,12136,5901,6235
30270,46902,10602,22680,7833,36299,12138,5901,6237
30275,46908,10602,22684,7833,36306,12141,5903,6238
30280,46919,10604,22688,7834,36313,12143,5903,6240
30285,46923,10605,22691,7835,36317,12144,5904,6240
30290,46933,10611,22697,7839,36320,12146,5905,6241
30295,46939,10612,22702,7840,36324,12149,5908,6241
30300,46950,10618,22706,7845,36330,12151,5908,6243
30305,46954,10621,22710,7848,36332,12152,5909,6243
30310,46964,10623,22715,7849,36340,12154,5910,6244
30315,46970,10623,22720,7849,36345,12157,5912,6245
30320,46981,10628,22725,7853,36352,12159,5913,6246
30325,46985,10629,22728,7854,36356,12160,5914,6246
30330,46995,10632,22732,7855,36363,12162,5916,6246
30335,47001,10632,22736,7855,36367,12165,5918,6247
30340,47012,10637,22742,7859,36373,12167,5918,6249
30345,47016,10637,22742,7859,36379,12168,5918,6250
30350,47026,10639,22747,7860,36385,12170,5918,6252
30355,47032,10639,22748,7860,36393,12173,5918,6255
30360,47043,10641,22751,7861,36400,12175,5918,6257
30365,47047,10642,22752,7862,36405,12176,5918,6258
30370,47057,10644,22758,7864,36412,12178,5919,6259
30375,47063,10644,22762,7864,36418,12181,5921,6260
30380,47074,10649,22767,7867,36425,12183,5922,6261
30385,47078,10650,22769,7868,36428,12184,5922,6262
30390,47088,10653,22773,7869,36434,12186,5923,6263
30395,47094,10653,22777,7869,36440,12189,5926,6263
30400,47105,10655,22781,7870,36450,12191,5928,6263
30405,47109,10656,22784,7871,36453,12192,5929,6263
30410,47119,10659,22790,7874,36459,12194,5930,6264
30415,47125,10659,22792,7874,36464,12197,5930,6267
30420,47136,10664,22797,7878,36471,12199,5930,6269
30425,47140,10665,22797,7879,36475,12200,5930,6270
30430,47150,10669,22802,7881,36480,12202,5930,6272
30435,47156,10669,22805,7881,36487,12205,5931,6274
30440,47167,10672,22807,7882,36495,12207,5932,6275
30445,47171,10672,22809,7882,36499,12208,5932,6276
30450,47181,10674,22812,7883,36507,12210,5932,6278
30455,47187,10674,22814,7883,36513,12213,5933,6280
30460,47198,10676,22820,7885,36522,12215,5934,6281
30465,47202,10676,22821,7885,36526,12216,5934,6282
30470,47212,10679,22828,7887,36533,12218,5935,6283
30475,47218,10679,22834,7887,36537,12221,5938,6283
30480,47229,10683,22839,7890,36545,12223,5940,6283
30485,47233,10685,22841,7892,36548,12224,5940,6284
30490,47243,10686,22849,7893,36556,12226,5941,6285
30495,47249,10686,22850,7893,36563,12229,5942,6287
30500,47260,10687,22855,7893,36573,12231,5943,6288
30505,47264,10687,22855,7893,36577,12232,5943,6289
30510,47274,10688,22859,7893,36585,12234,5944,6290
30515,47280,10688,22860,7893,36592,12237,5944,6293
30520,47291,10689,22866,7894,36602,12239,5945,6294
30525,47295,10689,22867,7894,36606,12240,5946,6294
30530,47305,10690,22872,7895,36615,12242,5948,6294
30535,47311,10690,22874,7895,36620,12245,5948,6297
30540,47322,10691,22879,7896,36629,12247,5949,6298
30545,47326,10691,22881,7896,36635,12248,5950,6298
30550,47336,10692,22886,7897,36642,12250,5952,6298
30555,47342,10692,22889,7897,36649,12253,5954,6299
30560,47353,10695,22894,7899,36656,12255,5955,6300
30565,47357,10696,22896,7900,36660,12256,5955,6301
30570,47367,10699,22901,7903,36668,12258,5956,6302
30575,47373,10699,22902,7903,36673,12261,5956,6305
30580,47384,10701,22907,7904,36681,12263,5957,6306
30585,47388,10702,22909,7905,36685,12264,5957,6307
30590,47398,10707,22915,7909,36690,12266,5958,6308
30595,47404,10707,22916,7909,36695,12269,5958,6311
30600,47415,10711,22920,7912,36703,12271,5960,6311
30605,47419,10712,22921,7913,36707,12272,5961,6311
30610,47429,10716,22925,7916,36713,12274,5961,6313
30615,47435,10716,22925,7916,36719,12277,5961,6316
30620,47446,10719,22929,7918,36727,12279,5963,6316
30625,47450,10719,22930,7918,36730,12280,5963,6317
30630,47460,10724,22934,7921,36735,12282,5964,6318
30635,47466,10724,22938,7921,36740,12285,5966,6319
30640,47477,10729,22942,7925,36747,12287,5967,6320
30645,47481,10730,22944,7926,36750,12288,5968,6320
30650,47491,10735,22949,7930,36755,12290,5968,6322
30655,47497,10735,22954,7930,36759,12293,5970,6323
30660,47508,10740,22959,7935,36767,12295,5972,6323
30665,47512,10741,22960,7936,36771,12296,5972,6324
30670,47522,10742,22961,7936,36780,12298,5973,6325
30675,47528,10742,22962,7936,36786,12301,5974,6327
30680,47539,10744,22965,7937,36795,12303,5974,6329
30685,47543,10745,22968,7938,36798,12304,5975,6329
30690,47553,10747,22970,7939,36806,12306,5976,6330
30695,47559,10747,22973,7939,36811,12309,5978,6331
30700,47570,10749,22976,7940,36820,12311,5978,6333
30705,47574,10750,22978,7941,36824,12312,5978,6334
30710,47584,10752,22985,7943,36831,12314,5980,6334
30715,47590,10752,22987,7943,36838,12317,5981,6336
30720,47601,10754,22994,7944,36846,12319,5983,6336
30725,47605,10755,22997,7945,36850,12320,5984,6336
30730,47615,10757,23003,7947,36857,12322,5985,6337
30735,47621,10757,23005,7947,36864,12325,5987,6338
30740,47632,10759,23011,7948,36873,12327,5989,6338
30745,47636,10760,23014,7949,36876,12328,5990,6338
30750,47646,10763,23019,7952,36883,12330,5991,6339
30755,47652,10763,23021,7952,36889,12333,5992,6341
30760,47663,10765,23026,7954,36896,12335,5993,6342
30765,47667,10766,23028,7955,36901,12336,5994,6342
30770,47677,10769,23034,7957,36907,12338,5994,6344
30775,47683,10769,23038,7957,36913,12341,5997,6344
30780,47694,10773,23044,7960,36921,12343,5999,6344
30785,47698,10774,23046,7961,36924,12344,5999,6345
30790,47708,10777,23052,7963,36930,12346,6000,6346
30795,47714,10777,23057,7963,36935,12349,6002,6347
30800,47725,10782,23062,7966,36941,12351,6002,6349
30805,47729,10785,23066,7969,36944,12352,6003,6349
30810,47739,10787,23071,7970,36952,12354,6004,6350
30815,47745,10787,23075,7970,36956,12357,6005,6352
30820,47756,10790,23081,7973,36964,12359,6005,6354
30825,47760,10792,23083,7975,36968,12360,6006,6354
30830,47770,10794,23088,7976,36975,12362,6007,6355
30835,47776,10794,23091,7976,36982,12365,6009,6356
30840,47787,10796,23096,7978,36990,12367,6010,6357
30845,47791,10798,23098,7980,36993,12368,6010,6358
30850,47801,10803,23104,7984,36998,12370,6011,6359
30855,47807,10803,23107,7984,37004,12373,6014,6359
30860,47818,10806,23112,7987,37012,12375,6015,6360
30865,47822,10807,23114,7988,37015,12376,6016,6360
30870,47832,10812,23121,7992,37019,12378,6018,6360
30875,47838,10812,23124,7992,37025,12381,6020,6361
30880,47849,10817,23130,7997,37032,12383,6021,6362
30885,47853,10818,23131,7998,37035,12384,6021,6363
30890,47863,10823,23136,8001,37039,12386,6022,6364
30895,47869,10823,23139,8001,37045,12389,6024,6365
30900,47880,10827,23143,8003,37053,12391,6025,6366
30905,47884,10827,23143,8003,37057,12392,6025,6367
30910,47894,10830,23146,8005,37064,12394,6025,6369
30915,47900,10830,23148,8005,37069,12397,6025,6372
30920,47911,10833,23149,8007,37078,12399,6025,6374
30925,47915,10833,23151,8007,37082,12400,6026,6374
30930,47925,10838,23156,8010,37087,12402,6028,6374
30935,47931,10838,23158,8010,37093,12405,6030,6375
30940,47942,10843,23166,8014,37097,12407,6032,6375
30945,47946,10843,23168,8014,37102,12408,6033,6375
30950,47956,10845,23174,8016,37110,12410,6035,6375
30955,47962,10845,23177,8016,37114,12413,6035,6378
30960,47973,10848,23180,8017,37125,12415,6036,6379
30965,47977,10849,23182,8018,37127,12416,6036,6380
30970,47987,10851,23188,8020,37134,12418,6037,6381
30975,47993,10851,23191,8020,37140,12421,6039,6382
30980,48004,10853,23195,8021,37150,12423,6040,6383
30985,48008,10854,23197,8022,37153,12424,6040,6384
30990,48018,10856,23202,8023,37161,12426,6041,6385
30995,48024,10856,23206,8023,37167,12429,6044,6385
31000,48035,10859,23209,8024,37174,12431,6044,6387
31005,48039,10860,23213,8025,37178,12432,6045,6387
31010,48049,10862,23219,8027,37186,12434,6047,6387
31015,48055,10862,23221,8027,37193,12437,6048,6389
31020,48066,10864,23226,8029,37201,12439,6049,6390
31025,48070,10865,23229,8030,37204,12440,6050,6390
31030,48080,10866,23234,8031,37213,12442,6051,6391
31035,48086,10866,23235,8031,37220,12445,6052,6393
31040,48097,10867,23241,8031,37228,12447,6053,6394
31045,48101,10867,23243,8031,37234,12448,6054,6394
31050,48111,10869,23248,8032,37241,12450,6055,6395
31055,48117,10869,23251,8032,37247,12453,6057,6396
31060,48128,10870,23256,8033,37257,12455,6058,6397
31065,48132,10871,23259,8034,37261,12456,6059,6397
31070,48142,10873,23265,8034,37269,12458,6060,6398
31075,48148,10873,23270,8034,37273,12461,6063,6398
31080,48159,10876,23277,8036,37281,12463,6063,6400
31085,48163,10877,23278,8037,37286,12464,6063,6401
31090,48173,10879,23286,8038,37293,12466,6064,6402
31095,48179,10879,23288,8038,37300,12469,6065,6404
31100,48190,10880,23291,8039,37310,12471,6066,6405
31105,48194,10880,23294,8039,37314,12472,6067,6405
31110,48204,10882,23296,8039,37322,12474,6067,6407
31115,48210,10882,23297,8039,37328,12477,6068,6409
31120,48221,10885,23302,8042,37335,12479,6068,6411
31125,48225,10886,23303,8043,37339,12480,6068,6412
31130,48235,10889,23307,8044,37345,12482,6069,6413
31135,48241,10889,23312,8044,37351,12485,6071,6414
31140,48252,10892,23317,8047,37359,12487,6071,6416
31145,48256,10894,23319,8049,37362,12488,6071,6417
31150,48266,10898,23323,8051,37368,12490,6072,6418
31155,48272,10898,23329,8051,37373,12493,6075,6418
31160,48283,10904,23333,8055,37378,12495,6075,6420
31165,48287,10906,23336,8057,37381,12496,6076,6420
31170,48297,10910,23339,8060,37387,12498,6076,6422
31175,48303,10910,23342,8060,37392,12501,6078,6423
31180,48314,10914,23348,8063,37399,12503,6079,6424
31185,48318,10916,23350,8065,37402,12504,6080,6424
31190,48328,10920,23354,8068,37408,12506,6081,6425
31195,48334,10920,23357,8068,37413,12509,6083,6426
31200,48345,10926,23364,8072,37417,12511,6085,6426
31205,48349,10928,23366,8074,37420,12512,6085,6427
31210,48359,10930,23372,8076,37428,12514,6086,6428
31215,48365,10930,23373,8076,37435,12517,6087,6430
31220,48376,10932,23376,8077,37443,12519,6088,6431
31225,48380,10932,23377,8077,37448,12520,6088,6432
31230,48390,10934,23382,8078,37454,12522,6089,6433
31235,48396,10934,23384,8078,37459,12525,6089,6436
31240,48407,10937,23389,8080,37469,12527,6091,6436
31245,48411,10937,23389,8080,37474,12528,6091,6437
31250,48421,10939,23396,8082,37480,12530,6093,6437
31255,48427,10939,23399,8082,37486,12533,6094,6439
31260,48438,10942,23404,8083,37495,12535,6096,6439
31265,48442,10943,23405,8084,37499,12536,6096,6440
31270,48452,10946,23411,8086,37505,12538,6096,6442
31275,48458,10946,23415,8086,37512,12541,6098,6443
31280,48469,10949,23420,8088,37518,12543,6098,6445
31285,48473,10950,23422,8089,37523,12544,6099,6445
31290,48483,10952,23427,8091,37530,12546,6100,6446
31295,48489,10952,23430,8091,37537,12549,6102,6447
31300,48500,10954,23436,8093,37543,12551,6103,6448
31305,48504,10955,23438,8094,37549,12552,6103,6449
31310,48514,10957,23442,8095,37557,12554,6103,6451
31315,48520,10957,23445,8095,37563,12557,6105,6452
31320,48531,10959,23451,8097,37570,12559,6106,6453
31325,48535,10960,23454,8098,37575,12560,6107,6453
31330,48545,10963,23459,8100,37582,12562,6109,6453
31335,48551,10963,23461,8100,37588,12565,6111,6454
31340,48562,10967,23467,8104,37595,12567,6112,6455
31345,48566,10968,23470,8105,37598,12568,6113,6455
31350,48576,10971,23472,8106,37604,12570,6113,6457
31355,48582,10971,23473,8106,37611,12573,6114,6459
31360,48593,10975,23477,8108,37618,12575,6115,6460
31365,48597,10975,23479,8108,37622,12576,6116,6460
31370,48607,10977,23482,8109,37630,12578,6117,6461
31375,48613,10977,23486,8109,37635,12581,6119,6462
31380,48624,10983,23493,8115,37640,12583,6119,6464
31385,48628,10984,23495,8116,37644,12584,6120,6464
31390,48638,10987,23501,8118,37650,12586,6121,6465
31395,48644,10987,23504,8118,37655,12589,6121,6468
31400,48655,10991,23509,8121,37663,12591,6123,6468
31405,48659,10992,23512,8122,37667,12592,6124,6468
31410,48669,10994,23515,8123,37675,12594,6125,6469
31415,48675,10994,23519,8123,37681,12597,6127,6470
31420,48686,10998,23527,8127,37687,12599,6129,6470
31425,48690,10999,23528,8128,37691,12600,6129,6471
31430,48700,11001,23533,8130,37698,12602,6130,6472
31435,48706,11001,23536,8130,37704,12605,6132,6473
31440,48717,11006,23541,8134,37711,12607,6133,6474
31445,48721,11007,23542,8135,37714,12608,6133,6475
31450,48731,11013,23549,8141,37717,12610,6133,6477
31455,48737,11013,23553,8141,37722,12613,6135,6478
31460,48748,11019,23560,8147,37728,12615,6136,6479
31465,48752,11021,23562,8149,37731,12616,6136,6480
31470,48762,11025,23566,8152,37736,12618,6136,6482
31475,48768,11025,23569,8152,37741,12621,6137,6484
31480,48779,11029,23574,8155,37750,12623,6137,6486
31485,48783,11029,23577,8155,37754,12624,6138,6486
31490,48793,11032,23579,8156,37761,12626,6138,6488
31495,48799,11032,23580,8156,37767,12629,6139,6490
31500,48810,11035,23584,8158,37774,12631,6139,6492
31505,48814,11036,23587,8159,37778,12632,6139,6493
31510,48824,11037,23593,8160,37786,12634,6140,6494
31515,48830,11037,23597,8160,37790,12637,6141,6496
31520,48841,11038,23602,8160,37802,12639,6142,6497
31525,48845,11038,23604,8160,37807,12640,6143,6497
31530,48855,11039,23607,8160,37815,12642,6145,6497
31535,48861,11039,23608,8160,37821,12645,6145,6500
31540,48872,11040,23610,8160,37831,12647,6146,6501
31545,48876,11040,23611,8160,37836,12648,6146,6502
31550,48886,11041,23617,8161,37845,12650,6147,6503
31555,48892,11041,23619,8161,37850,12653,6147,6506
31560,48903,11042,23623,8161,37860,12655,6147,6508
31565,48907,11042,23623,8161,37865,12656,6147,6509
31570,48917,11043,23627,8161,37873,12658,6149,6509
31575,48923,11043,23629,8161,37880,12661,6150,6511
31580,48934,11046,23638,8164,37885,12663,6151,6512
31585,48938,11046,23641,8164,37891,12664,6152,6512
31590,48948,11047,23642,8164,37901,12666,6152,6514
31595,48954,11047,23646,8164,37906,12669,6154,6515
31600,48965,11049,23651,8166,37916,12671,6155,6516
31605,48969,11050,23653,8167,37919,12672,6155,6517
31610,48979,11053,23656,8168,37926,12674,6156,6518
31615,48985,11053,23657,8168,37931,12677,6156,6521
31620,48996,11056,23661,8169,37937,12679,6157,6522
31625,49000,11057,23662,8170,37943,12680,6157,6523
31630,49010,11061,23671,8173,37947,12682,6159,6523
31635,49016,11061,23676,8173,37954,12685,6162,6523
31640,49027,11065,23681,8177,37961,12687,6163,6524
31645,49031,11066,23683,8178,37965,12688,6164,6524
31650,49041,11068,23687,8180,37973,12690,6166,6524
31655,49047,11068,23692,8180,37977,12693,6168,6525
31660,49058,11073,23700,8184,37981,12695,6169,6526
31665,49062,11074,23702,8185,37988,12696,6170,6526
31670,49072,11076,23706,8186,37995,12698,6171,6527
31675,49078,11076,23708,8186,38000,12701,6171,6530
31680,49089,11080,23715,8190,38007,12703,6173,6530
31685,49093,11081,23717,8191,38012,12704,6173,6531
31690,49103,11083,23724,8193,38020,12706,6175,6531
31695,49109,11083,23727,8193,38026,12709,6177,6532
31700,49120,11088,23733,8197,38031,12711,6178,6533
31705,49124,11089,23734,8198,38035,12712,6178,6534
31710,49134,11091,23739,8199,38043,12714,6180,6534
31715,49140,11091,23743,8199,38048,12717,6182,6535
31720,49151,11094,23748,8200,38054,12719,6183,6536
31725,49155,11096,23750,8202,38059,12720,6183,6537
31730,49165,11100,23759,8206,38064,12722,6185,6537
31735,49171,11100,23762,8206,38070,12725,6187,6538
31740,49182,11104,23764,8208,38077,12727,6187,6540
31745,49186,11106,23767,8210,38080,12728,6188,6540
31750,49196,11108,23770,8211,38088,12730,6188,6542
31755,49202,11108,23771,8211,38093,12733,6188,6545
31760,49213,11113,23776,8216,38100,12735,6188,6547
31765,49217,11113,23778,8216,38104,12736,6189,6547
31770,49227,11117,23785,8219,38109,12738,6190,6548
31775,49233,11117,23789,8219,38115,12741,6192,6549
31780,49244,11122,23796,8224,38121,12743,6192,6551
31785,49248,11123,23797,8225,38125,12744,6192,6552
31790,49258,11125,23801,8226,38132,12746,6193,6553
31795,49264,11125,23805,8226,38138,12749,6196,6553
31800,49275,11130,23811,8230,38145,12751,6198,6553
31805,49279,11131,23813,8231,38148,12752,6198,6554
31810,49289,11133,23816,8232,38156,12754,6200,6554
31815,49295,11133,23820,8232,38162,12757,6202,6555
31820,49306,11136,23823,8233,38170,12759,6203,6556
31825,49310,11137,23825,8234,38173,12760,6204,6556
31830,49320,11139,23829,8235,38180,12762,6206,6556
31835,49326,11139,23833,8235,38185,12765,6208,6557
31840,49337,11143,23835,8237,38194,12767,6209,6558
31845,49341,11144,23837,8238,38197,12768,6210,6558
31850,49351,11147,23841,8240,38204,12770,6212,6558
31855,49357,11147,23845,8240,38209,12773,6214,6559
31860,49368,11149,23850,8241,38219,12775,6214,6561
31865,49372,11149,23853,8241,38223,12776,6215,6561
31870,49382,11151,23860,8243,38230,12778,6215,6563
31875,49388,11151,23863,8243,38237,12781,6216,6565
31880,49399,11153,23869,8244,38246,12783,6218,6565
31885,49403,11153,23870,8244,38250,12784,6218,6566
31890,49413,11156,23876,8246,38257,12786,6220,6566
31895,49419,11156,23881,8246,38261,12789,6222,6567
31900,49430,11158,23884,8247,38271,12791,6222,6569
31905,49434,11158,23886,8247,38276,12792,6223,6569
31910,49444,11160,23892,8249,38282,12794,6224,6570
31915,49450,11160,23894,8249,38289,12797,6225,6572
31920,49461,11163,23899,8250,38297,12799,6226,6573
31925,49465,11164,23901,8251,38301,12800,6226,6574
31930,49475,11165,23904,8251,38308,12802,6226,6576
31935,49481,11165,23908,8251,38313,12805,6227,6578
31940,49492,11167,23912,8251,38323,12807,6228,6579
31945,49496,11167,23913,8251,38329,12808,6228,6580
31950,49506,11169,23919,8253,38336,12810,6229,6581
31955,49512,11169,23922,8253,38342,12813,6231,6582
31960,49523,11174,23928,8257,38347,12815,6232,6583
31965,49527,11177,23930,8260,38350,12816,6233,6583
31970,49537,11179,23931,8260,38358,12818,6234,6584
31975,49543,11179,23937,8260,38361,12821,6237,6584
31980,49554,11185,23942,8265,38367,12823,6238,6585
31985,49558,11186,23944,8266,38372,12824,6239,6585
31990,49568,11188,23947,8266,38379,12826,6241,6585
31995,49574,11188,23949,8266,38385,12829,6242,6587
32000,49585,11191,23954,8268,38392,12831,6243,6588
32005,49589,11191,23956,8268,38397,12832,6244,6588
32010,49599,11195,23964,8271,38402,12834,6246,6588
32015,49605,11195,23967,8271,38409,12837,6247,6590
32020,49616,11198,23971,8273,38417,12839,6248,6591
32025,49620,11198,23973,8273,38422,12840,6249,6591
32030,49630,11201,23978,8275,38428,12842,6249,6593
32035,49636,11201,23982,8275,38434,12845,6252,6593
32040,49647,11204,23985,8276,38443,12847,6253,6594
32045,49651,11205,23988,8277,38446,12848,6254,6594
32050,49661,11208,23993,8279,38452,12850,6255,6595
32055,49667,11208,23997,8279,38459,12853,6257,6596
32060,49678,11211,24004,8282,38466,12855,6257,6598
32065,49682,11213,24006,8284,38469,12856,6257,6599
32070,49692,11216,24011,8287,38475,12858,6257,6601
32075,49698,11216,24014,8287,38482,12861,6259,6602
32080,49709,11219,24022,8290,38490,12863,6261,6602
32085,49713,11220,24023,8291,38493,12864,6261,6603
32090,49723,11222,24027,8291,38500,12866,6262,6604
32095,49729,11222,24030,8291,38507,12869,6263,6606
32100,49740,11226,24035,8293,38513,12871,6264,6607
32105,49744,11228,24036,8295,38516,12872,6264,6608
32110,49754,11231,24040,8297,38522,12874,6266,6608
32115,49760,11231,24042,8297,38528,12877,6266,6611
32120,49771,11235,24045,8300,38536,12879,6266,6613
32125,49775,11237,24048,8302,38538,12880,6267,6613
32130,49785,11242,24053,8306,38542,12882,6268,6614
32135,49791,11242,24057,8306,38548,12885,6271,6614
32140,49802,11246,24063,8310,38555,12887,6272,6615
32145,49806,11248,24065,8312,38558,12888,6273,6615
32150,49816,11251,24068,8313,38564,12890,6274,6616
32155,49822,11251,24071,8313,38568,12893,6275,6618
32160,49833,11255,24076,8317,38577,12895,6275,6620
32165,49837,11255,24079,8317,38581,12896,6276,6620
32170,49847,11256,24083,8317,38590,12898,6277,6621
32175,49853,11256,24086,8317,38595,12901,6278,6623
32180,49864,11258,24087,8317,38605,12903,6278,6625
32185,49868,11258,24088,8317,38610,12904,6279,6625
32190,49878,11260,24092,8318,38617,12906,6279,6627
32195,49884,11260,24096,8318,38622,12909,6280,6629
32200,49895,11263,24102,8320,38629,12911,6280,6631
32205,49899,11263,24103,8320,38636,12912,6280,6632
32210,49909,11265,24107,8321,38642,12914,6282,6632
32215,49915,11265,24109,8321,38649,12917,6283,6634
32220,49926,11268,24117,8324,38655,12919,6283,6636
32225,49930,11268,24118,8324,38662,12920,6284,6636
32230,49940,11270,24124,8326,38669,12922,6285,6637
32235,49946,11270,24127,8326,38676,12925,6287,6638
32240,49957,11273,24134,8329,38683,12927,6289,6638
32245,49961,11274,24138,8330,38687,12928,6290,6638
32250,49971,11276,24142,8331,38694,12930,6291,6639
32255,49977,11276,24145,8331,38700,12933,6292,6641
32260,49988,11278,24150,8332,38709,12935,6293,6642
32265,49992,11279,24151,8333,38713,12936,6294,6642
32270,50002,11281,24153,8333,38720,12938,6295,6643
32275,50008,11281,24159,8333,38725,12941,6298,6643
32280,50019,11284,24163,8334,38734,12943,6299,6644
32285,50023,11284,24164,8334,38739,12944,6300,6644
32290,50033,11287,24168,8336,38745,12946,6301,6645
32295,50039,11287,24169,8336,38752,12949,6302,6647
32300,50050,11290,24173,8337,38759,12951,6303,6648
32305,50054,11290,24174,8337,38764,12952,6304,6648
32310,50064,11294,24179,8340,38769,12954,6306,6648
32315,50070,11294,24181,8340,38776,12957,6307,6650
32320,50081,11297,24185,8342,38783,12959,6307,6652
32325,50085,11297,24187,8342,38788,12960,6308,6652
32330,50095,11301,24190,8344,38793,12962,6308,6654
32335,50101,11301,24192,8344,38799,12965,6309,6656
32340,50112,11305,24196,8347,38806,12967,6309,6658
32345,50116,11307,24197,8349,38809,12968,6309,6659
32350,50126,11310,24202,8351,38815,12970,6311,6659
32355,50132,11310,24206,8351,38820,12973,6313,6660
32360,50143,11315,24213,8356,38826,12975,6315,6660
32365,50147,11318,24215,8359,38829,12976,6316,6660
32370,50157,11322,24219,8362,38833,12978,6316,6662
32375,50163,11323,24223,8363,38838,12981,6318,6663
32380,50174,11327,24227,8367,38845,12983,6318,6665
32385,50178,11329,24228,8369,38849,12984,6319,6665
32390,50188,11332,24231,8370,38854,12986,6320,6666
32395,50194,11333,24234,8371,38859,12989,6321,6668
32400,50205,11337,24239,8375,38866,12991,6322,6669
32405,50209,11340,24241,8378,38869,12992,6323,6669
32410,50219,11341,24243,8379,38877,12994,6324,6670
32415,50225,11341,24248,8379,38884,12997,6327,6670
32420,50236,11343,24254,8381,38893,12999,6327,6672
32425,50240,11344,24257,8382,38896,13000,6328,6672
32430,50250,11346,24264,8384,38903,13002,6329,6673
32435,50256,11346,24268,8384,38909,13005,6331,6674
32440,50267,11348,24274,8386,38919,13007,6332,6675
32445,50271,11349,24276,8387,38922,13008,6332,6676
32450,50281,11351,24282,8388,38929,13010,6334,6676
32455,50287,11351,24285,8388,38936,13013,6336,6677
32460,50298,11353,24289,8389,38945,13015,6336,6679
32465,50302,11354,24290,8390,38948,13016,6336,6680
32470,50312,11357,24297,8393,38954,13018,6337,6681
32475,50318,11357,24300,8393,38961,13021,6338,6683
32480,50329,11359,24304,8395,38970,13023,6339,6684
32485,50333,11359,24307,8395,38974,13024,6340,6684
32490,50343,11360,24312,8396,38982,13026,6341,6685
32495,50349,11360,24313,8396,38988,13029,6341,6688
32500,50360,11362,24320,8398,38998,13031,6342,6689
32505,50364,11363,24323,8399,39001,13032,6343,6689
32510,50374,11364,24328,8399,39008,13034,6344,6690
32515,50380,11364,24331,8399,39016,13037,6346,6691
32520,50391,11367,24336,8401,39021,13039,6346,6693
32525,50395,11369,24339,8403,39025,13040,6347,6693
32530,50405,11371,24342,8403,39033,13042,6348,6694
32535,50411,11371,24346,8403,39038,13045,6350,6695
32540,50422,11376,24352,8408,39046,13047,6351,6696
32545,50426,11376,24354,8408,39049,13048,6352,6696
32550,50436,11379,24360,8411,39056,13050,6354,6696
32555,50442,11379,24363,8411,39062,13053,6356,6697
32560,50453,11382,24369,8412,39067,13055,6357,6698
32565,50457,11383,24371,8413,39074,13056,6358,6698
32570,50467,11385,24376,8413,39081,13058,6360,6698
32575,50473,11385,24380,8413,39087,13061,6362,6699
32580,50484,11387,24384,8414,39096,13063,6363,6700
32585,50488,11388,24386,8415,39100,13064,6364,6700
32590,50498,11391,24390,8417,39107,13066,6365,6701
32595,50504,11391,24394,8417,39112,13069,6367,6702
32600,50515,11393,24397,8418,39121,13071,6367,6704
32605,50519,11394,24397,8419,39125,13072,6367,6705
32610,50529,11397,24402,8421,39131,13074,6367,6707
32615,50535,11397,24403,8421,39137,13077,6367,6710
32620,50546,11402,24408,8425,39143,13079,6368,6711
32625,50550,11403,24410,8426,39147,13080,6368,6712
32630,50560,11407,24413,8428,39152,13082,6368,6714
32635,50566,11407,24416,8428,39159,13085,6370,6715
32640,50577,11409,24419,8430,39167,13087,6370,6717
32645,50581,11411,24421,8432,39170,13088,6371,6717
32650,50591,11415,24425,8434,39176,13090,6372,6718
32655,50597,11415,24429,8434,39182,13093,6375,6718
32660,50608,11419,24436,8436,39189,13095,6377,6718
32665,50612,11421,24440,8438,39191,13096,6378,6718
32670,50622,11424,24445,8441,39198,13098,6379,6719
32675,50628,11424,24447,8441,39204,13101,6380,6721
32680,50639,11427,24450,8442,39212,13103,6382,6721
32685,50643,11428,24452,8443,39215,13104,6382,6722
32690,50653,11433,24457,8448,39220,13106,6382,6724
32695,50659,11433,24459,8448,39224,13109,6382,6727
32700,50670,11438,24466,8453,39232,13111,6384,6727
32705,50674,11439,24468,8454,39235,13112,6384,6728
32710,50684,11443,24474,8457,39241,13114,6386,6728
32715,50690,11443,24477,8457,39246,13117,6388,6729
32720,50701,11447,24481,8459,39253,13119,6389,6730
32725,50705,11450,24483,8462,39255,13120,6389,6731
32730,50715,11455,24489,8466,39260,13122,6391,6731
32735,50721,11455,24494,8466,39263,13125,6393,6732
32740,50732,11460,24501,8469,39270,13127,6395,6732
32745,50736,11461,24503,8470,39274,13128,6395,6733
32750,50746,11463,24509,8471,39281,13130,6397,6733
32755,50752,11463,24511,8471,39287,13133,6398,6735
32760,50763,11465,24514,8472,39297,13135,6399,6736
32765,50767,11465,24515,8472,39301,13136,6399,6737
32770,50777,11468,24519,8474,39307,13138,6399,6739
32775,50783,11468,24521,8474,39312,13141,6399,6742
32780,50794,11471,24526,8476,39322,13143,6400,6743
32785,50798,11472,24528,8477,39326,13144,6401,6743
32790,50808,11474,24535,8479,39332,13146,6403,6743
32795,50814,11474,24540,8479,39339,13149,6406,6743
32800,50825,11476,24546,8480,39347,13151,6407,6744
32805,50829,11476,24549,8480,39352,13152,6408,6744
32810,50839,11478,24553,8481,39361,13154,6410,6744
32815,50845,11478,24557,8481,39367,13157,6412,6745
32820,50856,11480,24562,8481,39375,13159,6414,6745
32825,50860,11481,24565,8482,39379,13160,6415,6745
32830,50870,11482,24569,8483,39388,13162,6417,6745
32835,50876,11482,24573,8483,39393,13165,6419,6746
32840,50887,11485,24579,8485,39402,13167,6420,6747
32845,50891,11486,24581,8486,39405,13168,6420,6748
32850,50901,11490,24585,8488,39411,13170,6420,6750
32855,50907,11490,24587,8488,39416,13173,6420,6753
32860,50918,11493,24590,8489,39425,13175,6421,6754
32865,50922,11493,24590,8489,39429,13176,6421,6755
32870,50932,11497,24597,8493,39435,13178,6422,6756
32875,50938,11497,24598,8493,39441,13181,6422,6759
32880,50949,11501,24602,8496,39448,13183,6423,6760
32885,50953,11501,24604,8496,39452,13184,6424,6760
32890,50963,11503,24608,8498,39459,13186,6425,6761
32895,50969,11503,24613,8498,39465,13189,6427,6762
32900,50980,11506,24618,8500,39473,13191,6428,6763
32905,50984,11508,24621,8502,39476,13192,6428,6764
32910,50994,11511,24625,8503,39483,13194,6428,6766
32915,51000,11511,24630,8503,39488,13197,6430,6767
32920,51011,11513,24633,8504,39498,13199,6431,6768
32925,51015,11513,24634,8504,39502,13200,6431,6769
32930,51025,11516,24640,8506,39508,13202,6433,6769
32935,51031,11516,24641,8506,39515,13205,6434,6771
32940,51042,11517,24646,8507,39524,13207,6436,6771
32945,51046,11519,24649,8509,39527,13208,6436,6772
32950,51056,11523,24655,8513,39532,13210,6437,6773
32955,51062,11523,24658,8513,39538,13213,6439,6774
32960,51073,11526,24664,8516,39547,13215,6440,6775
32965,51077,11526,24666,8516,39551,13216,6441,6775
32970,51087,11530,24673,8519,39556,13218,6442,6776
32975,51093,11530,24675,8519,39562,13221,6442,6779
32980,51104,11534,24680,8522,39569,13223,6442,6781
32985,51108,11535,24682,8523,39573,13224,6442,6782
32990,51118,11540,24687,8527,39577,13226,6442,6784
32995,51124,11541,24689,8528,39581,13229,6442,6787
33000,51135,11545,24692,8530,39587,13231,6442,6789
33005,51139,11546,24692,8531,39593,13232,6442,6790
33010,51149,11547,24699,8532,39600,13234,6443,6791
33015,51155,11547,24702,8532,39606,13237,6445,6792
33020,51166,11550,24709,8534,39613,13239,6446,6793
33025,51170,11551,24713,8535,39618,13240,6447,6793
33030,51180,11553,24717,8536,39627,13242,6448,6794
33035,51186,11553,24719,8536,39632,13245,6449,6796
33040,51197,11556,24725,8539,39641,13247,6450,6797
33045,51201,11556,24726,8539,39645,13248,6451,6797
33050,51211,11559,24733,8542,39651,13250,6452,6798
33055,51217,11559,24736,8542,39657,13253,6453,6800
33060,51228,11561,24740,8543,39667,13255,6454,6801
33065,51232,11561,24741,8543,39670,13256,6454,6802
33070,51242,11564,24746,8546,39677,13258,6455,6803
33075,51248,11564,24749,8546,39683,13261,6457,6804
33080,51259,11566,24752,8546,39692,13263,6458,6805
33085,51263,11567,24756,8547,39695,13264,6459,6805
33090,51273,11569,24760,8548,39704,13266,6460,6806
33095,51279,11569,24765,8548,39709,13269,6462,6807
33100,51290,11572,24770,8550,39717,13271,6463,6808
33105,51294,11572,24771,8550,39722,13272,6463,6809
33110,51304,11574,24778,8552,39729,13274,6465,6809
33115,51310,11574,24781,8552,39736,13277,6467,6810
33120,51321,11577,24787,8554,39741,13279,6467,6812
33125,51325,11579,24790,8556,39746,13280,6468,6812
33130,51335,11582,24794,8557,39752,13282,6469,6813
33135,51341,11582,24798,8557,39758,13285,6471,6814
33140,51352,11584,24800,8558,39768,13287,6471,6816
33145,51356,11585,24803,8559,39771,13288,6472,6816
33150,51366,11588,24809,8561,39777,13290,6473,6817
33155,51372,11588,24810,8561,39784,13293,6474,6819
33160,51383,11591,24815,8562,39792,13295,6476,6819
33165,51387,11591,24816,8562,39796,13296,6477,6819
33170,51397,11595,24821,8566,39802,13298,6478,6820
33175,51403,11595,24822,8566,39808,13301,6479,6822
33180,51414,11599,24827,8569,39815,13303,6480,6823
33185,51418,11600,24829,8570,39818,13304,6480,6824
33190,51428,11604,24837,8573,39823,13306,6481,6825
33195,51434,11604,24841,8573,39830,13309,6484,6825
33200,51445,11607,24847,8575,39838,13311,6486,6825
33205,51449,11608,24848,8576,39841,13312,6486,6826
33210,51459,11611,24852,8578,39848,13314,6486,6828
33215,51465,11611,24854,8578,39854,13317,6487,6830
33220,51476,11614,24858,8580,39862,13319,6487,6832
33225,51480,11615,24860,8581,39865,13320,6487,6833
33230,51490,11619,24866,8585,39870,13322,6488,6834
33235,51496,11619,24867,8585,39877,13325,6489,6836
33240,51507,11624,24872,8589,39883,13327,6489,6838
33245,51511,11624,24873,8589,39886,13328,6489,6839
33250,51521,11628,24876,8592,39892,13330,6489,6841
33255,51527,11629,24877,8593,39898,13333,6490,6843
33260,51538,11632,24883,8596,39903,13335,6490,6845
33265,51542,11636,24886,8600,39905,13336,6491,6845
33270,51552,11640,24888,8602,39912,13338,6492,6846
33275,51558,11640,24892,8602,39917,13341,6495,6846
33280,51569,11645,24898,8606,39922,13343,6496,6847
33285,51573,11648,24900,8609,39924,13344,6496,6848
33290,51583,11654,24903,8613,39929,13346,6496,6850
33295,51589,11654,24907,8613,39932,13349,6497,6852
33300,51600,11661,24914,8619,39936,13351,6498,6853
33305,51604,11662,24916,8620,39942,13352,6499,6853
33310,51614,11663,24919,8620,39950,13354,6499,6855
33315,51620,11663,24921,8620,39957,13357,6500,6857
33320,51631,11664,24925,8620,39966,13359,6500,6859
33325,51635,11664,24926,8620,39971,13360,6500,6860
33330,51645,11665,24931,8620,39978,13362,6501,6861
33335,51651,11665,24934,8620,39986,13365,6503,6862
33340,51662,11666,24940,8620,39994,13367,6503,6864
33345,51666,11666,24941,8620,40000,13368,6503,6865
33350,51676,11667,24945,8620,40009,13370,6505,6865
33355,51682,11667,24948,8620,40014,13373,6506,6867
33360,51693,11668,24953,8621,40025,13375,6507,6868
33365,51697,11668,24956,8621,40029,13376,6508,6868
33370,51707,11669,24959,8622,40038,13378,6508,6870
33375,51713,11669,24961,8622,40044,13381,6509,6872
33380,51724,11670,24966,8623,40053,13383,6510,6873
33385,51728,11670,24969,8623,40058,13384,6511,6873
33390,51738,11671,24974,8624,40067,13386,6513,6873
33395,51744,11671,24977,8624,40072,13389,6514,6875
33400,51755,11672,24982,8625,40082,13391,6515,6876
33405,51759,11672,24984,8625,40087,13392,6516,6876
33410,51769,11676,24992,8629,40092,13394,6517,6877
33415,51775,11676,24995,8629,40098,13397,6519,6878
33420,51786,11681,25000,8632,40104,13399,6519,6880
33425,51790,11682,25002,8633,40108,13400,6519,6881
33430,51800,11684,25008,8635,40115,13402,6520,6882
33435,51806,11684,25009,8635,40121,13405,6520,6885
33440,51817,11688,25014,8638,40128,13407,6520,6887
33445,51821,11690,25016,8640,40131,13408,6520,6888
33450,51831,11693,25023,8642,40138,13410,6522,6888
33455,51837,11693,25028,8642,40144,13413,6525,6888
33460,51848,11698,25036,8646,40150,13415,6527,6888
33465,51852,11699,25038,8647,40153,13416,6527,6889
33470,51862,11703,25043,8650,40159,13418,6528,6890
33475,51868,11703,25045,8650,40164,13421,6528,6893
33480,51879,11706,25048,8652,40173,13423,6529,6894
33485,51883,11708,25050,8654,40175,13424,6529,6895
33490,51893,11712,25053,8656,40181,13426,6530,6896
33495,51899,11712,25057,8656,40186,13429,6533,6896
33500,51910,11716,25061,8658,40194,13431,6533,6898
33505,51914,11718,25064,8660,40196,13432,6533,6899
33510,51924,11721,25068,8663,40203,13434,6533,6901
33515,51930,11721,25072,8663,40208,13437,6535,6902
33520,51941,11725,25075,8665,40216,13439,6535,6904
33525,51945,11727,25077,8667,40218,13440,6535,6905
33530,51955,11730,25083,8669,40223,13442,6537,6905
33535,51961,11731,25085,8670,40228,13445,6538,6907
33540,51972,11734,25092,8673,40236,13447,6539,6908
33545,51976,11734,25094,8673,40241,13448,6539,6909
33550,51986,11735,25099,8673,40250,13450,6541,6909
33555,51992,11735,25101,8673,40255,13453,6541,6912
33560,52003,11737,25105,8675,40266,13455,6543,6912
33565,52007,11737,25106,8675,40270,13456,6544,6912
33570,52017,11739,25112,8676,40277,13458,6546,6912
33575,52023,11739,25116,8676,40282,13461,6547,6914
33580,52034,11742,25120,8677,40292,13463,6547,6916
33585,52038,11742,25122,8677,40296,13464,6548,6916
33590,52048,11744,25129,8679,40303,13466,6549,6917
33595,52054,11744,25133,8679,40309,13469,6552,6917
33600,52065,11746,25138,8680,40316,13471,6553,6918
33605,52069,11747,25140,8681,40322,13472,6554,6918
33610,52079,11749,25148,8683,40329,13474,6556,6918
33615,52085,11749,25151,8683,40336,13477,6558,6919
33620,52096,11751,25154,8684,40345,13479,6560,6919
33625,52100,11751,25155,8684,40349,13480,6561,6919
33630,52110,11753,25158,8685,40357,13482,6562,6920
33635,52116,11753,25159,8685,40363,13485,6562,6923
33640,52127,11755,25162,8686,40370,13487,6562,6925
33645,52131,11755,25163,8686,40376,13488,6563,6925
33650,52141,11758,25167,8688,40382,13490,6564,6926
33655,52147,11758,25170,8688,40389,13493,6566,6927
33660,52158,11761,25176,8690,40394,13495,6566,6929
33665,52162,11762,25177,8691,40400,13496,6567,6929
33670,52172,11766,25182,8695,40405,13498,6567,6931
33675,52178,11766,25185,8695,40411,13501,6568,6933
33680,52189,11770,25190,8699,40419,13503,6569,6934
33685,52193,11771,25192,8700,40422,13504,6570,6934
33690,52203,11773,25196,8701,40430,13506,6571,6935
33695,52209,11773,25198,8701,40436,13509,6573,6936
33700,52220,11776,25204,8704,40443,13511,6574,6937
33705,52224,11778,25208,8706,40446,13512,6575,6937
33710,52234,11781,25216,8708,40452,13514,6577,6937
33715,52240,11781,25218,8708,40459,13517,6579,6938
33720,52251,11784,25221,8710,40467,13519,6580,6939
33725,52255,11785,25224,8711,40470,13520,6581,6939
33730,52265,11790,25231,8714,40474,13522,6583,6939
33735,52271,11790,25232,8714,40481,13525,6584,6941
33740,52282,11795,25241,8718,40486,13527,6586,6941
33745,52286,11796,25243,8719,40490,13528,6586,6942
33750,52296,11801,25250,8722,40494,13530,6588,6942
33755,52302,11801,25255,8722,40500,13533,6590,6943
33760,52313,11805,25261,8726,40508,13535,6591,6944
33765,52317,11805,25262,8726,40512,13536,6592,6944
33770,52327,11810,25266,8730,40517,13538,6592,6946
33775,52333,11810,25269,8730,40522,13541,6593,6948
33780,52344,11814,25272,8732,40530,13543,6594,6949
33785,52348,11816,25274,8734,40532,13544,6594,6950
33790,52358,11821,25280,8737,40536,13546,6595,6951
33795,52364,11821,25281,8737,40543,13549,6596,6953
33800,52375,11825,25286,8740,40550,13551,6597,6954
33805,52379,11827,25288,8742,40552,13552,6597,6955
33810,52389,11831,25293,8745,40557,13554,6598,6956
33815,52395,11831,25296,8745,40564,13557,6600,6957
33820,52406,11834,25301,8747,40572,13559,6601,6958
33825,52410,11835,25303,8748,40575,13560,6601,6959
33830,52420,11840,25307,8751,40580,13562,6601,6961
33835,52426,11840,25309,8751,40586,13565,6603,6962
33840,52437,11842,25314,8753,40594,13567,6605,6962
33845,52441,11843,25314,8754,40598,13568,6605,6963
33850,52451,11847,25318,8756,40603,13570,6606,6964
33855,52457,11847,25321,8756,40607,13573,6607,6966
33860,52468,11852,25327,8761,40615,13575,6608,6967
33865,52472,11853,25328,8762,40619,13576,6608,6968
33870,52482,11856,25334,8765,40626,13578,6609,6969
33875,52488,11856,25336,8765,40630,13581,6609,6972
33880,52499,11859,25343,8768,40639,13583,6609,6974
33885,52503,11859,25344,8768,40644,13584,6609,6975
33890,52513,11860,25347,8768,40652,13586,6609,6977
33895,52519,11860,25350,8768,40657,13589,6610,6979
33900,52530,11861,25357,8769,40666,13591,6611,6980
33905,52534,11861,25358,8769,40673,13592,6611,6981
33910,52544,11862,25359,8769,40682,13594,6612,6982
33915,52550,11862,25361,8769,40687,13597,6613,6984
33920,52561,11863,25366,8770,40696,13599,6615,6984
33925,52565,11863,25367,8770,40701,13600,6615,6985
33930,52575,11864,25373,8770,40709,13602,6616,6986
33935,52581,11864,25373,8770,40717,13605,6616,6989
33940,52592,11865,25379,8771,40725,13607,6617,6990
33945,52596,11865,25381,8771,40731,13608,6618,6990
33950,52606,11866,25387,8772,40739,13610,6619,6991
33955,52612,11866,25390,8772,40745,13613,6620,6993
33960,52623,11867,25395,8773,40755,13615,6621,6994
33965,52627,11867,25397,8773,40760,13616,6622,6994
33970,52637,11869,25403,8774,40768,13618,6624,6994
33975,52643,11869,25403,8774,40774,13621,6624,6997
33980,52654,11870,25406,8774,40783,13623,6624,6999
33985,52658,11870,25406,8774,40788,13624,6624,7000
33990,52668,11874,25412,8776,40793,13626,6625,7001
33995,52674,11874,25415,8776,40799,13629,6626,7003
34000,52685,11878,25420,8780,40806,13631,6626,7005
34005,52689,11880,25421,8782,40809,13632,6626,7006
34010,52699,11883,25426,8785,40816,13634,6626,7008
34015,52705,11883,25427,8785,40822,13637,6627,7010
34020,52716,11886,25431,8787,40830,13639,6628,7011
34025,52720,11886,25431,8787,40834,13640,6628,7012
34030,52730,11889,25435,8789,40841,13642,6628,7014
34035,52736,11889,25437,8789,40846,13645,6629,7016
34040,52747,11893,25444,8792,40853,13647,6630,7017
34045,52751,11895,25446,8794,40856,13648,6630,7018
34050,52761,11899,25453,8798,40861,13650,6631,7019
34055,52767,11899,25456,8798,40867,13653,6632,7021
34060,52778,11903,25461,8801,40875,13655,6633,7022
34065,52782,11903,25463,8801,40879,13656,6634,7022
34070,52792,11906,25467,8803,40885,13658,6635,7023
34075,52798,11906,25472,8803,40889,13661,6638,7023
34080,52809,11912,25477,8808,40896,13663,6639,7024
34085,52813,11914,25480,8810,40899,13664,6640,7024
34090,52823,11917,25483,8811,40906,13666,6641,7025
34095,52829,11917,25485,8811,40911,13669,6641,7028
34100,52840,11922,25492,8816,40917,13671,6643,7028
34105,52844,11925,25495,8819,40919,13672,6644,7028
34110,52854,11928,25499,8821,40926,13674,6646,7028
34115,52860,11928,25502,8821,40931,13677,6648,7029
34120,52871,11933,25507,8825,40937,13679,6648,7031
34125,52875,11935,25509,8827,40940,13680,6648,7032
34130,52885,11940,25515,8830,40944,13682,6649,7033
34135,52891,11940,25519,8830,40949,13685,6650,7035
34140,52902,11945,25525,8835,40957,13687,6651,7036
34145,52906,11947,25529,8837,40959,13688,6652,7036
34150,52916,11949,25531,8837,40966,13690,6653,7037
34155,52922,11949,25535,8837,40972,13693,6655,7038
34160,52933,11953,25538,8839,40980,13695,6656,7039
34165,52937,11954,25539,8840,40983,13696,6656,7040
34170,52947,11959,25545,8843,40987,13698,6657,7041
34175,52953,11959,25548,8843,40993,13701,6658,7043
34180,52964,11963,25553,8846,40998,13703,6658,7045
34185,52968,11965,25553,8848,41003,13704,6658,7046
34190,52978,11967,25557,8850,41010,13706,6659,7047
34195,52984,11967,25560,8850,41015,13709,6661,7048
34200,52995,11970,25566,8852,41024,13711,6662,7049
34205,52999,11971,25568,8853,41027,13712,6662,7050
34210,53009,11972,25575,8853,41036,13714,6663,7051
34215,53015,11972,25576,8853,41042,13717,6663,7054
34220,53026,11973,25583,8854,41051,13719,6663,7056
34225,53030,11973,25586,8854,41056,13720,6663,7057
34230,53040,11974,25593,8854,41064,13722,6665,7057
34235,53046,11974,25597,8854,41071,13725,6668,7057
34240,53057,11975,25603,8855,41079,13727,6668,7059
34245,53061,11975,25605,8855,41086,13728,6669,7059
34250,53071,11976,25609,8855,41093,13730,6670,7060
34255,53077,11976,25611,8855,41101,13733,6672,7061
34260,53088,11977,25616,8855,41111,13735,6673,7062
34265,53092,11977,25619,8855,41115,13736,6673,7063
34270,53102,11978,25623,8855,41124,13738,6675,7063
34275,53108,11978,25628,8855,41129,13741,6677,7064
34280,53119,11979,25632,8855,41140,13743,6679,7064
34285,53123,11979,25634,8855,41144,13744,6679,7065
34290,53133,11981,25638,8857,41151,13746,6679,7067
34295,53139,11981,25640,8857,41157,13749,6679,7070
34300,53150,11982,25644,8857,41167,13751,6680,7071
34305,53154,11982,25644,8857,41172,13752,6680,7072
34310,53164,11984,25650,8858,41180,13754,6682,7072
34315,53170,11984,25652,8858,41186,13757,6684,7073
34320,53181,11988,25657,8861,41192,13759,6684,7075
34325,53185,11990,25658,8863,41195,13760,6684,7076
34330,53195,11993,25660,8864,41202,13762,6684,7078
34335,53201,11993,25665,8864,41207,13765,6687,7078
34340,53212,11995,25671,8865,41215,13767,6689,7078
34345,53216,11997,25675,8867,41219,13768,6690,7078
34350,53226,12001,25681,8870,41224,13770,6690,7080
34355,53232,12001,25684,8870,41230,13773,6692,7081
34360,53243,12006,25690,8874,41236,13775,6692,7083
34365,53247,12006,25692,8874,41241,13776,6693,7083
34370,53257,12009,25698,8876,41247,13778,6694,7084
34375,53263,12009,25700,8876,41253,13781,6695,7086
34380,53274,12013,25706,8878,41261,13783,6697,7086
34385,53278,12013,25708,8878,41265,13784,6698,7086
34390,53288,12016,25711,8880,41272,13786,6699,7087
34395,53294,12016,25713,8880,41278,13789,6700,7089
34400,53305,12019,25718,8882,41286,13791,6701,7090
34405,53309,12021,25722,8884,41288,13792,6702,7090
34410,53319,12023,25726,8885,41296,13794,6704,7090
34415,53325,12023,25730,8885,41302,13797,6706,7091
34420,53336,12026,25737,8888,41310,13799,6708,7091
34425,53340,12027,25739,8889,41313,13800,6709,7091
34430,53350,12032,25746,8892,41318,13802,6711,7091
34435,53356,12032,25748,8892,41324,13805,6713,7092
34440,53367,12036,25753,8894,41331,13807,6715,7092
34445,53371,12037,25756,8895,41334,13808,6716,7092
34450,53381,12040,25759,8897,41340,13810,6716,7094
34455,53387,12040,25761,8897,41347,13813,6718,7095
34460,53398,12043,25763,8899,41355,13815,6718,7097
34465,53402,12044,25766,8900,41358,13816,6719,7097
34470,53412,12048,25770,8903,41364,13818,6720,7098
34475,53418,12048,25772,8903,41370,13821,6722,7099
34480,53429,12051,25774,8904,41378,13823,6722,7101
34485,53433,12051,25774,8904,41382,13824,6722,7102
34490,53443,12056,25781,8909,41386,13826,6723,7103
34495,53449,12057,25785,8910,41390,13829,6725,7104
34500,53460,12062,25790,8913,41395,13831,6726,7105
34505,53464,12066,25791,8917,41398,13832,6726,7106
34510,53474,12070,25796,8920,41404,13834,6728,7106
34515,53480,12070,25800,8920,41408,13837,6730,7107
34520,53491,12076,25808,8925,41411,13839,6731,7108
34525,53495,12082,25810,8931,41413,13840,6731,7109
34530,53505,12086,25816,8935,41419,13842,6732,7110
34535,53511,12086,25820,8935,41423,13845,6733,7112
34540,53522,12088,25825,8936,41432,13847,6735,7112
34545,53526,12089,25827,8937,41437,13848,6735,7113
34550,53536,12090,25831,8938,41445,13850,6737,7113
34555,53542,12090,25833,8938,41450,13853,6738,7115
34560,53553,12093,25840,8940,41458,13855,6740,7115
34565,53557,12093,25842,8940,41463,13856,6741,7115
34570,53567,12094,25849,8941,41472,13858,6742,7116
34575,53573,12094,25852,8941,41476,13861,6743,7118
34580,53584,12095,25857,8942,41487,13863,6744,7119
34585,53588,12095,25858,8942,41493,13864,6744,7120
34590,53598,12096,25860,8942,41502,13866,6744,7122
34595,53604,12096,25861,8942,41508,13869,6745,7124
34600,53615,12097,25868,8943,41517,13871,6746,7125
34605,53619,12097,25869,8943,41522,13872,6746,7126
34610,53629,12098,25871,8944,41531,13874,6747,7127
34615,53635,12098,25872,8944,41536,13877,6747,7130
34620,53646,12099,25882,8945,41544,13879,6749,7130
34625,53650,12099,25886,8945,41551,13880,6750,7130
34630,53660,12100,25890,8945,41560,13882,6750,7132
34635,53666,12100,25893,8945,41564,13885,6750,7135
34640,53677,12102,25899,8947,41575,13887,6751,7136
34645,53681,12102,25901,8947,41579,13888,6751,7137
34650,53691,12104,25907,8949,41586,13890,6752,7138
34655,53697,12104,25912,8949,41591,13893,6754,7139
34660,53708,12107,25916,8951,41600,13895,6754,7141
34665,53712,12107,25918,8951,41605,13896,6755,7141
34670,53722,12110,25925,8954,41611,13898,6755,7143
34675,53728,12110,25929,8954,41616,13901,6757,7144
34680,53739,12115,25936,8957,41623,13903,6758,7145
34685,53743,12117,25939,8959,41626,13904,6759,7145
34690,53753,12120,25945,8962,41632,13906,6759,7147
34695,53759,12120,25948,8962,41639,13909,6761,7148
34700,53770,12124,25953,8966,41646,13911,6762,7149
34705,53774,12125,25956,8967,41649,13912,6763,7149
34710,53784,12129,25963,8970,41654,13914,6764,7150
34715,53790,12129,25964,8970,41661,13917,6765,7152
34720,53801,12134,25969,8973,41666,13919,6765,7154
34725,53805,12137,25972,8976,41668,13920,6766,7154
34730,53815,12139,25978,8977,41675,13922,6767,7155
34735,53821,12139,25980,8977,41681,13925,6768,7157
34740,53832,12145,25984,8981,41687,13927,6768,7159
34745,53836,12145,25984,8981,41691,13928,6768,7160
34750,53846,12148,25990,8983,41697,13930,6770,7160
34755,53852,12148,25991,8983,41704,13933,6770,7163
34760,53863,12152,25999,8986,41710,13935,6771,7164
34765,53867,12153,26001,8987,41714,13936,6772,7164
34770,53877,12157,26005,8990,41719,13938,6772,7166
34775,53883,12157,26008,8990,41726,13941,6774,7167
34780,53894,12161,26014,8994,41733,13943,6775,7168
34785,53898,12162,26015,8995,41736,13944,6775,7169
34790,53908,12166,26018,8997,41741,13946,6775,7171
34795,53914,12167,26020,8998,41747,13949,6777,7172
34800,53925,12170,26025,8999,41753,13951,6779,7172
34805,53929,12172,26025,9001,41757,13952,6779,7173
34810,53939,12176,26030,9004,41763,13954,6781,7173
34815,53945,12176,26032,9004,41768,13957,6782,7175
34820,53956,12178,26037,9004,41776,13959,6783,7176
34825,53960,12179,26040,9005,41780,13960,6784,7176
34830,53970,12181,26042,9007,41789,13962,6784,7178
34835,53976,12181,26042,9007,41795,13965,6784,7181
34840,53987,12183,26047,9008,41804,13967,6786,7181
34845,53991,12183,26049,9008,41807,13968,6786,7182
34850,54001,12186,26054,9010,41814,13970,6786,7184
34855,54007,12186,26056,9010,41821,13973,6788,7185
34860,54018,12188,26062,9011,41829,13975,6790,7185
34865,54022,12188,26064,9011,41834,13976,6791,7185
34870,54032,12189,26066,9011,41843,13978,6791,7187
34875,54038,12189,26069,9011,41849,13981,6793,7188
34880,54049,12191,26074,9012,41857,13983,6793,7190
34885,54053,12192,26077,9013,41860,13984,6793,7191
34890,54063,12193,26083,9014,41868,13986,6795,7191
34895,54069,12193,26085,9014,41875,13989,6795,7194
34900,54080,12196,26092,9017,41881,13991,6796,7195
34905,54084,12196,26094,9017,41888,13992,6797,7195
34910,54094,12198,26100,9019,41895,13994,6798,7196
34915,54100,12198,26103,9019,41900,13997,6799,7198
34920,54111,12201,26107,9021,41909,13999,6800,7199
34925,54115,12201,26110,9021,41913,14000,6801,7199
34930,54125,12205,26117,9024,41920,14002,6803,7199
34935,54131,12205,26117,9024,41926,14005,6803,7202
34940,54142,12207,26122,9026,41934,14007,6803,7204
34945,54146,12207,26124,9026,41939,14008,6804,7204
34950,54156,12210,26129,9027,41945,14010,6805,7205
34955,54162,12210,26133,9027,41950,14013,6806,7207
34960,54173,12214,26139,9030,41957,14015,6807,7208
34965,54177,12215,26141,9031,41962,14016,6807,7209
34970,54187,12217,26143,9031,41970,14018,6808,7210
34975,54193,12217,26146,9031,41975,14021,6808,7213
34980,54204,12221,26152,9035,41983,14023,6810,7213
34985,54208,12222,26154,9036,41986,14024,6810,7214
34990,54218,12225,26160,9038,41992,14026,6811,7215
34995,54224,12225,26164,9038,41998,14029,6814,7215
35000,54235,12229,26167,9041,42006,14031,6814,7217
35005,54239,12229,26168,9041,42010,14032,6815,7217
35010,54249,12232,26173,9044,42016,14034,6815,7219
35015,54255,12232,26175,9044,42023,14037,6816,7221
35020,54266,12236,26181,9047,42029,14039,6816,7223
35025,54270,12237,26182,9048,42033,14040,6817,7223
35030,54280,12241,26187,9051,42038,14042,6817,7225
35035,54286,12241,26191,9051,42044,14045,6819,7226
35040,54297,12244,26193,9052,42053,14047,6819,7228
35045,54301,12246,26196,9054,42055,14048,6819,7229
35050,54311,12250,26199,9056,42061,14050,6819,7231
35055,54317,12250,26202,9056,42066,14053,6821,7232
35060,54328,12255,26207,9059,42073,14055,6821,7234
35065,54332,12255,26208,9059,42077,14056,6821,7235
35070,54342,12259,26214,9061,42081,14058,6823,7235
35075,54348,12260,26217,9062,42084,14061,6823,7238
35080,54359,12267,26223,9069,42091,14063,6825,7238
35085,54363,12268,26224,9070,42094,14064,6825,7239
35090,54373,12271,26226,9072,42101,14066,6825,7241
35095,54379,12271,26230,9072,42105,14069,6827,7242
35100,54390,12276,26234,9076,42113,14071,6829,7242
35105,54394,12277,26234,9077,42117,14072,6829,7243
35110,54404,12282,26240,9082,42122,14074,6830,7244
35115,54410,12282,26243,9082,42128,14077,6833,7244
35120,54421,12284,26246,9082,42135,14079,6834,7245
35125,54425,12287,26247,9085,42138,14080,6834,7246
35130,54435,12289,26250,9086,42145,14082,6835,7247
35135,54441,12289,26253,9086,42149,14085,6836,7249
35140,54452,12293,26260,9090,42159,14087,6838,7249
35145,54456,12294,26263,9091,42161,14088,6838,7250
35150,54466,12296,26269,9093,42168,14090,6839,7251
35155,54472,12296,26271,9093,42175,14093,6840,7253
35160,54483,12299,26280,9095,42181,14095,6842,7253
35165,54487,12299,26281,9095,42188,14096,6842,7254
35170,54497,12300,26283,9095,42196,14098,6843,7255
35175,54503,12300,26286,9095,42203,14101,6844,7257
35180,54514,12302,26291,9096,42210,14103,6845,7258
35185,54518,12302,26294,9096,42216,14104,6846,7258
35190,54528,12305,26300,9099,42222,14106,6846,7260
35195,54534,12305,26303,9099,42228,14109,6848,7261
35200,54545,12307,26305,9099,42237,14111,6849,7262
35205,54549,12307,26306,9099,42242,14112,6849,7263
35210,54559,12309,26309,9100,42250,14114,6850,7264
35215,54565,12309,26313,9100,42256,14117,6852,7265
35220,54576,12311,26316,9101,42265,14119,6853,7266
35225,54580,12312,26317,9102,42268,14120,6853,7267
35230,54590,12315,26324,9105,42275,14122,6854,7268
35235,54596,12315,26327,9105,42281,14125,6856,7269
35240,54607,12318,26332,9107,42289,14127,6856,7271
35245,54611,12318,26333,9107,42293,14128,6857,7271
35250,54621,12320,26336,9109,42301,14130,6857,7273
35255,54627,12320,26339,9109,42307,14133,6859,7274
35260,54638,12322,26343,9111,42316,14135,6859,7276
35265,54642,12323,26346,9112,42319,14136,6860,7276
35270,54652,12325,26349,9113,42327,14138,6861,7277
35275,54658,12325,26353,9113,42332,14141,6863,7278
35280,54669,12328,26359,9116,42339,14143,6863,7280
35285,54673,12330,26361,9118,42343,14144,6863,7281
35290,54683,12333,26366,9119,42350,14146,6865,7281
35295,54689,12333,26372,9119,42354,14149,6868,7281
35300,54700,12337,26375,9121,42363,14151,6870,7281
35305,54704,12339,26377,9123,42365,14152,6870,7282
35310,54714,12344,26382,9127,42370,14154,6870,7284
35315,54720,12344,26383,9127,42375,14157,6870,7287
35320,54731,12347,26388,9130,42383,14159,6871,7288
35325,54735,12348,26391,9131,42387,14160,6872,7288
35330,54745,12351,26395,9133,42393,14162,6873,7289
35335,54751,12351,26397,9133,42399,14165,6873,7292
35340,54762,12354,26403,9136,42408,14167,6875,7292
35345,54766,12354,26405,9136,42412,14168,6876,7292
35350,54776,12356,26408,9137,42420,14170,6877,7293
35355,54782,12356,26410,9137,42425,14173,6878,7295
35360,54793,12359,26415,9140,42434,14175,6879,7296
35365,54797,12359,26415,9140,42438,14176,6879,7297
35370,54807,12361,26418,9140,42445,14178,6880,7298
35375,54813,12361,26420,9140,42452,14181,6881,7300
35380,54824,12363,26427,9141,42460,14183,6882,7301
35385,54828,12365,26429,9143,42463,14184,6882,7302
35390,54838,12369,26434,9146,42468,14186,6882,7304
35395,54844,12369,26436,9146,42475,14189,6883,7306
35400,54855,12371,26442,9148,42483,14191,6884,7307
35405,54859,12373,26445,9150,42486,14192,6885,7307
35410,54869,12375,26450,9152,42494,14194,6887,7307
35415,54875,12375,26454,9152,42499,14197,6889,7308
35420,54886,12378,26460,9155,42507,14199,6889,7310
35425,54890,12380,26463,9157,42510,14200,6890,7310
35430,54900,12382,26468,9159,42517,14202,6891,7311
35435,54906,12382,26472,9159,42521,14205,6893,7312
35440,54917,12388,26478,9164,42528,14207,6895,7312
35445,54921,12388,26479,9164,42533,14208,6895,7313
35450,54931,12390,26481,9165,42541,14210,6896,7314
35455,54937,12390,26483,9165,42546,14213,6897,7316
35460,54948,12392,26486,9165,42555,14215,6898,7317
35465,54952,12393,26490,9166,42558,14216,6899,7317
35470,54962,12396,26497,9169,42565,14218,6901,7317
35475,54968,12396,26503,9169,42570,14221,6904,7317
35480,54979,12399,26510,9171,42578,14223,6905,7318
35485,54983,12399,26510,9171,42584,14224,6905,7319
35490,54993,12401,26515,9173,42591,14226,6906,7320
35495,54999,12401,26520,9173,42595,14229,6909,7320
35500,55010,12403,26525,9174,42606,14231,6909,7322
35505,55014,12403,26528,9174,42610,14232,6910,7322
35510,55024,12405,26533,9176,42618,14234,6911,7323
35515,55030,12405,26535,9176,42622,14237,6911,7326
35520,55041,12408,26542,9179,42633,14239,6912,7327
35525,55045,12409,26545,9180,42635,14240,6912,7328
35530,55055,12410,26548,9180,42644,14242,6913,7329
35535,55061,12410,26553,9180,42650,14245,6916,7329
35540,55072,12413,26560,9182,42658,14247,6917,7330
35545,55076,12413,26561,9182,42662,14248,6917,7331
35550,55086,12417,26567,9184,42668,14250,6918,7332
35555,55092,12417,26570,9184,42675,14253,6920,7333
35560,55103,12420,26576,9185,42682,14255,6922,7333
35565,55107,12420,26578,9185,42687,14256,6923,7333
35570,55117,12423,26583,9186,42694,14258,6925,7333
35575,55123,12423,26584,9186,42700,14261,6926,7335
35580,55134,12426,26588,9188,42707,14263,6926,7337
35585,55138,12427,26589,9189,42710,14264,6926,7338
35590,55148,12430,26596,9192,42717,14266,6926,7340
35595,55154,12430,26599,9192,42723,14269,6927,7342
35600,55165,12433,26602,9194,42732,14271,6928,7343
35605,55169,12434,26603,9195,42735,14272,6928,7344
35610,55179,12437,26607,9197,42741,14274,6928,7346
35615,55185,12437,26608,9197,42747,14277,6928,7349
35620,55196,12442,26616,9200,42752,14279,6930,7349
35625,55200,12445,26618,9203,42755,14280,6931,7349
35630,55210,12448,26620,9205,42762,14282,6931,7351
35635,55216,12448,26623,9205,42766,14285,6932,7353
35640,55227,12454,26628,9210,42772,14287,6933,7354
35645,55231,12456,26629,9212,42775,14288,6933,7355
35650,55241,12459,26632,9214,42782,14290,6934,7356
35655,55247,12459,26634,9214,42788,14293,6935,7358
35660,55258,12462,26638,9216,42795,14295,6936,7359
35665,55262,12463,26638,9217,42799,14296,6936,7360
35670,55272,12466,26645,9220,42805,14298,6937,7361
35675,55278,12466,26647,9220,42811,14301,6938,7363
35680,55289,12471,26657,9225,42814,14303,6940,7363
35685,55293,12473,26660,9227,42820,14304,6941,7363
35690,55303,12476,26664,9229,42827,14306,6941,7365
35695,55309,12476,26668,9229,42831,14309,6942,7367
35700,55320,12480,26672,9232,42840,14311,6944,7367
35705,55324,12482,26675,9234,42842,14312,6944,7368
35710,55334,12485,26678,9235,42849,14314,6945,7369
35715,55340,12485,26682,9235,42853,14317,6946,7371
35720,55351,12489,26687,9238,42859,14319,6946,7373
35725,55355,12491,26688,9240,42864,14320,6946,7374
35730,55365,12493,26690,9241,42872,14322,6946,7376
35735,55371,12493,26692,9241,42878,14325,6947,7378
35740,55382,12496,26698,9243,42886,14327,6948,7379
35745,55386,12496,26699,9243,42890,14328,6948,7380
35750,55396,12498,26703,9244,42897,14330,6948,7382
35755,55402,12498,26707,9244,42904,14333,6950,7383
35760,55413,12500,26710,9245,42913,14335,6951,7384
35765,55417,12501,26713,9246,42916,14336,6952,7384
35770,55427,12504,26719,9248,42923,14338,6953,7385
35775,55433,12504,26724,9248,42929,14341,6956,7385
35780,55444,12507,26731,9249,42937,14343,6958,7385
35785,55448,12507,26732,9249,42941,14344,6959,7385
35790,55458,12509,26737,9250,42948,14346,6960,7386
35795,55464,12509,26740,9250,42955,14349,6961,7388
35800,55475,12512,26745,9252,42963,14351,6961,7390
35805,55479,12513,26747,9253,42966,14352,6962,7390
35810,55489,12515,26753,9255,42974,14354,6964,7390
35815,55495,12515,26755,9255,42980,14357,6966,7391
35820,55506,12518,26763,9258,42988,14359,6967,7392
35825,55510,12519,26765,9259,42991,14360,6967,7393
35830,55520,12521,26767,9259,42998,14362,6967,7395
35835,55526,12521,26769,9259,43003,14365,6967,7398
35840,55537,12525,26774,9263,43012,14367,6967,7400
35845,55541,12526,26778,9264,43015,14368,6968,7400
35850,55551,12529,26781,9265,43021,14370,6968,7402
35855,55557,12529,26784,9265,43027,14373,6969,7404
35860,55568,12533,26788,9269,43035,14375,6969,7406
35865,55572,12534,26790,9270,43038,14376,6969,7407
35870,55582,12537,26794,9271,43045,14378,6970,7408
35875,55588,12537,26796,9271,43050,14381,6971,7410
35880,55599,12540,26801,9273,43057,14383,6971,7412
35885,55603,12543,26804,9276,43059,14384,6971,7413
35890,55613,12548,26810,9280,43065,14386,6972,7414
35895,55619,12548,26814,9280,43068,14389,6973,7416
35900,55630,12550,26818,9282,43080,14391,6973,7418
35905,55634,12550,26820,9282,43084,14392,6974,7418
35910,55644,12551,26824,9283,43091,14394,6975,7419
35915,55650,12551,26826,9283,43097,14397,6976,7421
35920,55661,12552,26831,9283,43107,14399,6976,7423
35925,55665,12552,26833,9283,43113,14400,6977,7423
35930,55675,12554,26837,9285,43120,14402,6977,7425
35935,55681,12554,26837,9285,43126,14405,6977,7428
35940,55692,12556,26842,9287,43135,14407,6978,7429
35945,55696,12557,26844,9288,43139,14408,6979,7429
35950,55706,12558,26847,9288,43147,14410,6981,7429
35955,55712,12558,26849,9288,43154,14413,6981,7432
35960,55723,12560,26854,9289,43161,14415,6982,7433
35965,55727,12560,26855,9289,43167,14416,6983,7433
35970,55737,12561,26858,9289,43174,14418,6984,7434
35975,55743,12561,26862,9289,43181,14421,6986,7435
35980,55754,12563,26866,9290,43190,14423,6987,7436
35985,55758,12564,26869,9291,43194,14424,6988,7436
35990,55768,12566,26874,9292,43202,14426,6990,7436
35995,55774,12566,26879,9292,43207,14429,6993,7436
36000,55785,12569,26884,9295,43214,14431,6993,7438
36005,55789,12569,26886,9295,43220,14432,6994,7438
36010,55799,12573,26891,9298,43226,14434,6995,7439
36015,55805,12573,26894,9298,43231,14437,6996,7441
36020,55816,12576,26899,9299,43239,14439,6998,7441
36025,55820,12577,26901,9300,43243,14440,6998,7442
36030,55830,12581,26907,9302,43248,14442,7000,7442
36035,55836,12581,26910,9302,43254,14445,7001,7444
36040,55847,12584,26914,9304,43263,14447,7001,7446
36045,55851,12585,26915,9305,43266,14448,7001,7447
36050,55861,12588,26920,9307,43272,14450,7001,7449
36055,55867,12588,26922,9307,43279,14453,7002,7451
36060,55878,12592,26928,9309,43286,14455,7004,7451
36065,55882,12593,26931,9310,43289,14456,7005,7451
36070,55892,12596,26935,9313,43296,14458,7005,7453
36075,55898,12596,26939,9313,43301,14461,7007,7454
36080,55909,12602,26947,9319,43306,14463,7008,7455
36085,55913,12603,26947,9320,43310,14464,7008,7456
36090,55923,12606,26950,9321,43317,14466,7008,7458
36095,55929,12606,26951,9321,43323,14469,7009,7460
36100,55940,12609,26956,9322,43331,14471,7011,7460
36105,55944,12610,26957,9323,43334,14472,7011,7461
36110,55954,12613,26963,9325,43340,14474,7012,7462
36115,55960,12613,26966,9325,43347,14477,7014,7463
36120,55971,12616,26970,9326,43355,14479,7015,7464
36125,55975,12617,26971,9327,43358,14480,7015,7465
36130,55985,12621,26975,9329,43363,14482,7015,7467
36135,55991,12621,26979,9329,43368,14485,7017,7468
36140,56002,12627,26983,9333,43374,14487,7018,7469
36145,56006,12629,26985,9335,43377,14488,7019,7469
36150,56016,12631,26987,9335,43384,14490,7020,7470
36155,56022,12632,26990,9336,43389,14493,7022,7471
36160,56033,12636,26994,9339,43395,14495,7022,7473
36165,56037,12638,26996,9341,43398,14496,7023,7473
36170,56047,12641,26998,9342,43404,14498,7023,7475
36175,56053,12642,27000,9343,43409,14501,7024,7477
36180,56064,12647,27003,9347,43417,14503,7025,7478
36185,56068,12647,27005,9347,43420,14504,7025,7479
36190,56078,12649,27009,9348,43429,14506,7026,7480
36195,56084,12649,27014,9348,43433,14509,7028,7481
36200,56095,12651,27018,9349,43442,14511,7029,7482
36205,56099,12652,27020,9350,43446,14512,7029,7483
36210,56109,12655,27026,9352,43452,14514,7030,7484
36215,56115,12655,27029,9352,43457,14517,7031,7486
36220,56126,12657,27034,9353,43467,14519,7032,7487
36225,56130,12658,27036,9354,43471,14520,7032,7488
36230,56140,12659,27037,9354,43481,14522,7032,7490
36235,56146,12659,27038,9354,43487,14525,7033,7492
36240,56157,12662,27042,9355,43495,14527,7034,7493
36245,56161,12663,27045,9356,43498,14528,7035,7493
36250,56171,12666,27050,9358,43505,14530,7036,7494
36255,56177,12666,27053,9358,43511,14533,7038,7495
36260,56188,12668,27059,9359,43519,14535,7039,7496
36265,56192,12669,27062,9360,43523,14536,7040,7496
36270,56202,12671,27068,9362,43530,14538,7040,7498
36275,56208,12671,27072,9362,43536,14541,7042,7499
36280,56219,12674,27076,9363,43545,14543,7043,7500
36285,56223,12674,27078,9363,43549,14544,7043,7501
36290,56233,12677,27082,9364,43556,14546,7045,7501
36295,56239,12677,27086,9364,43561,14549,7047,7502
36300,56250,12682,27091,9367,43566,14551,7048,7503
36305,56254,12684,27095,9369,43570,14552,7049,7503
36310,56264,12688,27101,9372,43576,14554,7050,7504
36315,56270,12688,27104,9372,43582,14557,7052,7505
36320,56281,12691,27110,9373,43589,14559,7053,7506
36325,56285,12693,27111,9375,43592,14560,7053,7507
36330,56295,12696,27114,9376,43599,14562,7054,7508
36335,56301,12696,27116,9376,43605,14565,7056,7509
36340,56312,12699,27119,9377,43613,14567,7056,7511
36345,56316,12700,27122,9378,43616,14568,7057,7511
36350,56326,12702,27127,9379,43624,14570,7059,7511
36355,56332,12702,27129,9379,43629,14573,7060,7513
36360,56343,12705,27136,9382,43637,14575,7061,7514
36365,56347,12706,27137,9383,43641,14576,7062,7514
36370,56357,12709,27143,9385,43648,14578,7063,7515
36375,56363,12709,27145,9385,43653,14581,7064,7517
36380,56374,12711,27150,9386,43662,14583,7065,7518
36385,56378,12712,27151,9387,43666,14584,7066,7518
36390,56388,12715,27156,9389,43673,14586,7068,7518
36395,56394,12715,27160,9389,43678,14589,7071,7518
36400,56405,12718,27165,9391,43687,14591,7073,7518
36405,56409,12719,27167,9392,43690,14592,7073,7519
36410,56419,12721,27172,9392,43696,14594,7075,7519
36415,56425,12722,27176,9393,43700,14597,7076,7521
36420,56436,12728,27183,9399,43706,14599,7077,7522
36425,56440,12731,27186,9402,43708,14600,7078,7522
36430,56450,12732,27193,9403,43716,14602,7079,7523
36435,56456,12732,27195,9403,43722,14605,7080,7525
36440,56467,12733,27204,9403,43732,14607,7082,7525
36445,56471,12733,27205,9403,43737,14608,7082,7526
36450,56481,12736,27210,9405,43744,14610,7083,7527
36455,56487,12736,27211,9405,43750,14613,7084,7529
36460,56498,12738,27215,9407,43758,14615,7084,7531
36465,56502,12738,27218,9407,43763,14616,7085,7531
36470,56512,12740,27224,9408,43770,14618,7087,7531
36475,56518,12740,27227,9408,43778,14621,7088,7533
36480,56529,12742,27235,9410,43785,14623,7090,7533
36485,56533,12742,27236,9410,43791,14624,7091,7533
36490,56543,12745,27241,9413,43797,14626,7091,7535
36495,56549,12745,27244,9413,43804,14629,7093,7536
36500,56560,12748,27248,9414,43812,14631,7095,7536
36505,56564,12748,27250,9414,43816,14632,7095,7537
36510,56574,12750,27255,9416,43823,14634,7097,7537
36515,56580,12750,27258,9416,43830,14637,7099,7538
36520,56591,12753,27265,9418,43838,14639,7101,7538
36525,56595,12754,27267,9419,43841,14640,7101,7539
36530,56605,12756,27273,9421,43848,14642,7101,7541
36535,56611,12756,27277,9421,43854,14645,7103,7542
36540,56622,12759,27282,9422,43862,14647,7104,7543
36545,56626,12760,27283,9423,43866,14648,7104,7544
36550,56636,12763,27289,9425,43872,14650,7105,7545
36555,56642,12763,27293,9425,43879,14653,7108,7545
36560,56653,12765,27295,9425,43888,14655,7108,7547
36565,56657,12765,27297,9425,43892,14656,7109,7547
36570,56667,12768,27303,9427,43898,14658,7110,7548
36575,56673,12768,27309,9427,43904,14661,7113,7548
36580,56684,12773,27317,9432,43911,14663,7115,7548
36585,56688,12774,27318,9433,43914,14664,7115,7549
36590,56698,12779,27325,9438,43918,14666,7115,7551
36595,56704,12779,27326,9438,43924,14669,7115,7554
36600,56715,12783,27331,9442,43932,14671,7116,7555
36605,56719,12783,27332,9442,43936,14672,7117,7555
36610,56729,12786,27336,9444,43942,14674,7118,7556
36615,56735,12786,27337,9444,43949,14677,7119,7558
36620,56746,12791,27344,9447,43954,14679,7120,7559
36625,56750,12794,27346,9450,43956,14680,7120,7560
36630,56760,12799,27350,9454,43960,14682,7120,7562
36635,56766,12799,27353,9454,43967,14685,7123,7562
36640,56777,12803,27359,9457,43974,14687,7124,7563
36645,56781,12804,27361,9458,43977,14688,7124,7564
36650,56791,12808,27368,9462,43982,14690,7125,7565
36655,56797,12808,27369,9462,43988,14693,7126,7567
36660,56808,12812,27375,9466,43994,14695,7127,7568
36665,56812,12815,27376,9469,43997,14696,7127,7569
36670,56822,12820,27382,9472,44001,14698,7129,7569
36675,56828,12820,27382,9472,44007,14701,7129,7572
36680,56839,12822,27389,9474,44014,14703,7130,7573
36685,56843,12822,27391,9474,44021,14704,7131,7573
36690,56853,12824,27395,9475,44028,14706,7132,7574
36695,56859,12824,27398,9475,44033,14709,7134,7575
36700,56870,12827,27405,9477,44042,14711,7135,7576
36705,56874,12828,27407,9478,44046,14712,7136,7576
36710,56884,12830,27411,9479,44052,14714,7137,7577
36715,56890,12830,27413,9479,44059,14717,7138,7579
36720,56901,12832,27417,9479,44068,14719,7140,7579
36725,56905,12832,27418,9479,44073,14720,7140,7580
36730,56915,12833,27425,9480,44080,14722,7141,7581
36735,56921,12833,27426,9480,44088,14725,7141,7584
36740,56932,12835,27431,9481,44095,14727,7141,7586
36745,56936,12835,27431,9481,44101,14728,7141,7587
36750,56946,12836,27434,9481,44109,14730,7143,7587
36755,56952,12836,27437,9481,44116,14733,7145,7588
36760,56963,12838,27442,9483,44124,14735,7146,7589
36765,56967,12838,27444,9483,44128,14736,7146,7590
36770,56977,12840,27450,9484,44135,14738,7148,7590
36775,56983,12840,27451,9484,44142,14741,7148,7593
36780,56994,12843,27453,9486,44151,14743,7148,7595
36785,56998,12844,27455,9487,44154,14744,7149,7595
36790,57008,12847,27458,9488,44160,14746,7150,7596
36795,57014,12847,27461,9488,44166,14749,7152,7597
36800,57025,12849,27465,9490,44174,14751,7152,7599
36805,57029,12851,27466,9492,44178,14752,7152,7600
36810,57039,12854,27470,9494,44184,14754,7152,7602
36815,57045,12854,27472,9494,44191,14757,7154,7603
36820,57056,12858,27480,9498,44197,14759,7155,7604
36825,57060,12860,27482,9500,44200,14760,7155,7605
36830,57070,12863,27486,9501,44206,14762,7156,7606
36835,57076,12863,27488,9501,44213,14765,7157,7608
36840,57087,12865,27492,9503,44222,14767,7158,7609
36845,57091,12867,27494,9505,44224,14768,7158,7610
36850,57101,12869,27500,9506,44231,14770,7160,7610
36855,57107,12869,27503,9506,44237,14773,7161,7612
36860,57118,12875,27508,9510,44243,14775,7161,7614
36865,57122,12876,27510,9511,44246,14776,7162,7614
36870,57132,12880,27517,9514,44251,14778,7162,7616
36875,57138,12880,27518,9514,44257,14781,7162,7619
36880,57149,12884,27523,9517,44265,14783,7163,7620
36885,57153,12884,27523,9517,44269,14784,7163,7621
36890,57163,12888,27530,9521,44274,14786,7164,7622
36895,57169,12888,27531,9521,44281,14789,7165,7624
36900,57180,12891,27533,9522,44289,14791,7165,7626
36905,57184,12891,27534,9522,44293,14792,7165,7627
36910,57194,12895,27539,9525,44298,14794,7167,7627
36915,57200,12895,27541,9525,44304,14797,7168,7629
36920,57211,12899,27546,9528,44312,14799,7170,7629
36925,57215,12900,27548,9529,44315,14800,7170,7630
36930,57225,12903,27552,9531,44321,14802,7171,7631
36935,57231,12903,27555,9531,44328,14805,7173,7632
36940,57242,12907,27564,9534,44334,14807,7175,7632
36945,57246,12908,27566,9535,44337,14808,7176,7632
36950,57256,12914,27571,9541,44342,14810,7176,7634
36955,57262,12914,27573,9541,44347,14813,7177,7636
36960,57273,12917,27577,9543,44355,14815,7178,7637
36965,57277,12919,27580,9545,44357,14816,7179,7637
36970,57287,12922,27585,9547,44365,14818,7180,7638
36975,57293,12922,27589,9547,44369,14821,7182,7639
36980,57304,12926,27596,9550,44377,14823,7184,7639
36985,57308,12927,27597,9551,44381,14824,7185,7639
36990,57318,12928,27601,9551,44390,14826,7185,7641
36995,57324,12928,27603,9551,44395,14829,7186,7643
37000,57335,12929,27606,9552,44406,14831,7187,7644
37005,57339,12929,27609,9552,44410,14832,7188,7644
37010,57349,12930,27613,9552,44417,14834,7189,7645
37015,57355,12930,27616,9552,44423,14837,7190,7647
37020,57366,12931,27621,9552,44433,14839,7190,7649
37025,57370,12931,27624,9552,44438,14840,7190,7650
37030,57380,12932,27628,9552,44447,14842,7190,7652
37035,57386,12932,27632,9552,44452,14845,7192,7653
37040,57397,12933,27637,9553,44462,14847,7192,7655
37045,57401,12933,27639,9553,44468,14848,7193,7655
37050,57411,12934,27644,9553,44477,14850,7194,7656
37055,57417,12934,27648,9553,44482,14853,7195,7658
37060,57428,12935,27652,9553,44491,14855,7196,7659
37065,57432,12935,27653,9553,44497,14856,7197,7659
37070,57442,12937,27657,9554,44504,14858,7198,7660
37075,57448,12937,27658,9554,44511,14861,7198,7663
37080,57459,12940,27666,9557,44517,14863,7200,7663
37085,57463,12941,27669,9558,44522,14864,7200,7664
37090,57473,12944,27676,9561,44529,14866,7201,7665
37095,57479,12944,27680,9561,44534,14869,7203,7666
37100,57490,12947,27685,9563,44543,14871,7203,7668
37105,57494,12947,27685,9563,44547,14872,7203,7669
37110,57504,12950,27690,9566,44554,14874,7204,7670
37115,57510,12950,27693,9566,44559,14877,7206,7671
37120,57521,12953,27694,9567,44568,14879,7206,7673
37125,57525,12954,27695,9568,44571,14880,7206,7674
37130,57535,12958,27699,9570,44577,14882,7207,7675
37135,57541,12958,27701,9570,44582,14885,7208,7677
37140,57552,12961,27705,9572,44590,14887,7208,7679
37145,57556,12961,27707,9572,44595,14888,7209,7679
37150,57566,12964,27712,9574,44601,14890,7209,7681
37155,57572,12964,27715,9574,44607,14893,7209,7684
37160,57583,12970,27721,9579,44613,14895,7209,7686
37165,57587,12972,27724,9581,44615,14896,7209,7687
37170,57597,12975,27728,9582,44621,14898,7210,7688
37175,57603,12975,27730,9582,44627,14901,7211,7690
37180,57614,12980,27737,9586,44634,14903,7212,7691
37185,57618,12980,27737,9586,44638,14904,7212,7692
37190,57628,12983,27740,9587,44645,14906,7214,7692
37195,57634,12983,27743,9587,44650,14909,7215,7694
37200,57645,12986,27744,9588,44659,14911,7216,7695
37205,57649,12986,27744,9588,44663,14912,7216,7696
37210,57659,12990,27748,9591,44669,14914,7217,7697
37215,57665,12990,27752,9591,44675,14917,7220,7697
37220,57676,12993,27758,9593,44682,14919,7220,7699
37225,57680,12995,27759,9595,44685,14920,7220,7700
37230,57690,13000,27766,9599,44689,14922,7221,7701
37235,57696,13000,27771,9599,44694,14925,7223,7702
37240,57707,13005,27775,9602,44702,14927,7223,7704
37245,57711,13006,27777,9603,44705,14928,7223,7705
37250,57721,13011,27782,9606,44709,14930,7224,7706
37255,57727,13011,27785,9606,44714,14933,7226,7707
37260,57738,13016,27791,9611,44720,14935,7227,7708
37265,57742,13019,27793,9614,44722,14936,7227,7709
37270,57752,13023,27795,9617,44729,14938,7227,7711
37275,57758,13023,27800,9617,44733,14941,7230,7711
37280,57769,13025,27803,9617,44743,14943,7230,7713
37285,57773,13026,27804,9618,44747,14944,7230,7714
37290,57783,13027,27809,9619,44754,14946,7231,7715
37295,57789,13027,27812,9619,44760,14949,7232,7717
37300,57800,13029,27818,9621,44768,14951,7232,7719
37305,57804,13029,27819,9621,44775,14952,7232,7720
37310,57814,13030,27826,9622,44782,14954,7234,7720
37315,57820,13030,27829,9622,44790,14957,7235,7722
37320,57831,13032,27834,9622,44797,14959,7235,7724
37325,57835,13033,27835,9623,44802,14960,7235,7725
37330,57845,13035,27839,9624,44809,14962,7236,7726
37335,57851,13035,27842,9624,44815,14965,7237,7728
37340,57862,13037,27846,9625,44825,14967,7239,7728
37345,57866,13037,27848,9625,44829,14968,7239,7729
37350,57876,13040,27855,9627,44835,14970,7240,7730
37355,57882,13040,27858,9627,44841,14973,7241,7732
37360,57893,13042,27864,9629,44850,14975,7242,7733
37365,57897,13043,27866,9630,44854,14976,7242,7734
37370,57907,13045,27869,9631,44862,14978,7243,7735
37375,57913,13045,27873,9631,44866,14981,7245,7736
37380,57924,13049,27877,9634,44875,14983,7246,7737
37385,57928,13049,27878,9634,44879,14984,7246,7738
37390,57938,13052,27884,9637,44886,14986,7248,7738
37395,57944,13052,27887,9637,44892,14989,7250,7739
37400,57955,13054,27891,9638,44901,14991,7250,7741
37405,57959,13054,27891,9638,44905,14992,7250,7742
37410,57969,13058,27897,9641,44910,14994,7251,7743
37415,57975,13058,27899,9641,44917,14997,7252,7745
37420,57986,13060,27904,9642,44925,14999,7253,7746
37425,57990,13062,27907,9644,44928,15000,7254,7746
37430,58000,13065,27912,9646,44934,15002,7255,7747
37435,58006,13065,27915,9646,44940,15005,7257,7748
37440,58017,13069,27923,9650,44947,15007,7258,7749
37445,58021,13072,27927,9653,44949,15008,7259,7749
37450,58031,13077,27933,9658,44954,15010,7260,7750
37455,58037,13077,27937,9658,44960,15013,7263,7750
37460,58048,13080,27941,9660,44967,15015,7263,7752
37465,58052,13083,27945,9663,44969,15016,7264,7752
37470,58062,13086,27949,9665,44975,15018,7264,7754
37475,58068,13086,27954,9665,44980,15021,7266,7755
37480,58079,13092,27960,9670,44986,15023,7267,7756
37485,58083,13094,27961,9672,44989,15024,7267,7757
37490,58093,13097,27966,9674,44995,15026,7269,7757
37495,58099,13098,27968,9675,44999,15029,7269,7760
37500,58110,13103,27971,9678,45005,15031,7269,7762
37505,58114,13104,27974,9679,45010,15032,7270,7762
37510,58124,13105,27978,9679,45018,15034,7271,7763
37515,58130,13105,27981,9679,45024,15037,7273,7764
37520,58141,13107,27985,9680,45032,15039,7274,7765
37525,58145,13107,27985,9680,45038,15040,7274,7766
37530,58155,13109,27990,9681,45045,15042,7276,7766
37535,58161,13109,27992,9681,45050,15045,7277,7768
37540,58172,13111,27997,9683,45061,15047,7278,7769
37545,58176,13111,27999,9683,45064,15048,7278,7770
37550,58186,13114,28004,9685,45071,15050,7279,7771
37555,58192,13114,28008,9685,45076,15053,7281,7772
37560,58203,13116,28015,9687,45085,15055,7282,7773
37565,58207,13117,28017,9688,45090,15056,7282,7774
37570,58217,13119,28023,9690,45096,15058,7283,7775
37575,58223,13119,28027,9690,45103,15061,7285,7776
37580,58234,13122,28032,9691,45110,15063,7286,7777
37585,58238,13123,28033,9692,45115,15064,7286,7778
37590,58248,13125,28037,9694,45122,15066,7287,7779
37595,58254,13125,28043,9694,45128,15069,7290,7779
37600,58265,13127,28049,9696,45135,15071,7291,7780
37605,58269,13127,28050,9696,45142,15072,7291,7781
37610,58279,13129,28057,9698,45149,15074,7292,7782
37615,58285,13129,28061,9698,45154,15077,7294,7783
37620,58296,13134,28069,9703,45161,15079,7295,7784
37625,58300,13134,28070,9703,45166,15080,7296,7784
37630,58310,13136,28075,9704,45173,15082,7297,7785
37635,58316,13136,28079,9704,45179,15085,7299,7786
37640,58327,13139,28082,9705,45187,15087,7299,7788
37645,58331,13141,28086,9707,45190,15088,7300,7788
37650,58341,13145,28090,9709,45195,15090,7300,7790
37655,58347,13145,28095,9709,45201,15093,7303,7790
37660,58358,13150,28104,9714,45207,15095,7303,7792
37665,58362,13151,28106,9715,45211,15096,7304,7792
37670,58372,13155,28111,9717,45217,15098,7306,7792
37675,58378,13155,28114,9717,45223,15101,7308,7793
37680,58389,13159,28119,9720,45230,15103,7309,7794
37685,58393,13159,28120,9720,45234,15104,7309,7795
37690,58403,13161,28124,9721,45242,15106,7310,7796
37695,58409,13161,28126,9721,45248,15109,7311,7798
37700,58420,13163,28132,9723,45257,15111,7312,7799
37705,58424,13163,28133,9723,45261,15112,7312,7800
37710,58434,13166,28141,9726,45267,15114,7313,7801
37715,58440,13166,28143,9726,45273,15117,7313,7804
37720,58451,13170,28149,9729,45280,15119,7314,7805
37725,58455,13172,28151,9731,45283,15120,7315,7805
37730,58465,13175,28155,9733,45290,15122,7317,7805
37735,58471,13175,28157,9733,45295,15125,7318,7807
37740,58482,13178,28161,9735,45303,15127,7319,7808
37745,58486,13180,28164,9737,45306,15128,7320,7808
37750,58496,13184,28173,9741,45311,15130,7322,7808
37755,58502,13184,28176,9741,45316,15133,7323,7810
37760,58513,13187,28181,9743,45325,15135,7324,7811
37765,58517,13187,28184,9743,45330,15136,7325,7811
37770,58527,13188,28188,9743,45339,15138,7327,7811
37775,58533,13188,28190,9743,45344,15141,7328,7813
37780,58544,13189,28196,9744,45355,15143,7329,7814
37785,58548,13189,28198,9744,45358,15144,7330,7814
37790,58558,13191,28205,9746,45366,15146,7331,7815
37795,58564,13191,28209,9746,45372,15149,7333,7816
37800,58575,13194,28214,9748,45380,15151,7333,7818
37805,58579,13195,28215,9749,45384,15152,7333,7819
37810,58589,13197,28218,9750,45392,15154,7333,7821
37815,58595,13197,28220,9750,45398,15157,7335,7822
37820,58606,13200,28225,9752,45404,15159,7335,7824
37825,58610,13201,28226,9753,45409,15160,7335,7825
37830,58620,13203,28232,9755,45416,15162,7336,7826
37835,58626,13203,28234,9755,45421,15165,7337,7828
37840,58637,13206,28239,9757,45430,15167,7338,7829
37845,58641,13206,28239,9757,45435,15168,7338,7830
37850,58651,13208,28246,9759,45442,15170,7339,7831
37855,58657,13208,28249,9759,45448,15173,7341,7832
37860,58668,13210,28252,9760,45458,15175,7341,7834
37865,58672,13211,28253,9761,45461,15176,7341,7835
37870,58682,13213,28256,9762,45468,15178,7342,7836
37875,58688,13213,28258,9762,45474,15181,7343,7838
37880,58699,13217,28265,9765,45480,15183,7344,7839
37885,58703,13217,28266,9765,45486,15184,7344,7840
37890,58713,13221,28272,9768,45492,15186,7346,7840
37895,58719,13221,28276,9768,45497,15189,7348,7841
37900,58730,13225,28281,9770,45503,15191,7350,7841
37905,58734,13226,28284,9771,45507,15192,7351,7841
37910,58744,13229,28287,9773,45515,15194,7352,7842
37915,58750,13229,28288,9773,45521,15197,7353,7844
37920,58761,13231,28291,9774,45530,15199,7354,7845
37925,58765,13231,28293,9774,45534,15200,7355,7845
37930,58775,13234,28295,9775,45541,15202,7356,7846
37935,58781,13234,28299,9775,45546,15205,7358,7847
37940,58792,13238,28305,9778,45552,15207,7359,7848
37945,58796,13240,28308,9780,45556,15208,7360,7848
37950,58806,13242,28313,9781,45563,15210,7362,7848
37955,58812,13242,28316,9781,45569,15213,7363,7850
37960,58823,13245,28320,9783,45576,15215,7363,7852
37965,58827,13248,28321,9786,45579,15216,7363,7853
37970,58837,13252,28325,9789,45584,15218,7363,7855
37975,58843,13252,28329,9789,45588,15221,7365,7856
37980,58854,13259,28334,9795,45594,15223,7366,7857
37985,58858,13260,28335,9796,45598,15224,7366,7858
37990,58868,13264,28341,9798,45604,15226,7367,7859
37995,58874,13264,28344,9798,45610,15229,7370,7859
38000,58885,13267,28350,9801,45617,15231,7371,7860
38005,58889,13269,28354,9803,45620,15232,7372,7860
38010,58899,13271,28359,9805,45627,15234,7374,7860
38015,58905,13271,28362,9805,45632,15237,7375,7862
38020,58916,13277,28369,9809,45637,15239,7376,7863
38025,58920,13279,28370,9811,45641,15240,7376,7864
38030,58930,13281,28374,9812,45649,15242,7377,7865
38035,58936,13281,28377,9812,45654,15245,7379,7866
38040,58947,13286,28384,9816,45659,15247,7379,7868
38045,58951,13287,28385,9817,45664,15248,7379,7869
38050,58961,13290,28387,9818,45671,15250,7379,7871
38055,58967,13290,28390,9818,45676,15253,7381,7872
38060,58978,13294,28396,9820,45683,15255,7382,7873
38065,58982,13295,28398,9821,45687,15256,7383,7873
38070,58992,13297,28402,9821,45695,15258,7385,7873
38075,58998,13297,28407,9821,45699,15261,7387,7874
38080,59009,13302,28411,9825,45706,15263,7387,7876
38085,59013,13303,28413,9826,45710,15264,7388,7876
38090,59023,13307,28420,9830,45716,15266,7390,7876
38095,59029,13307,28421,9830,45722,15269,7391,7878
38100,59040,13309,28426,9831,45728,15271,7392,7879
38105,59044,13314,28429,9836,45730,15272,7393,7879
38110,59054,13315,28431,9837,45739,15274,7393,7881
38115,59060,13315,28433,9837,45745,15277,7393,7884
38120,59071,13316,28438,9837,45755,15279,7394,7885
38125,59075,13316,28440,9837,45759,15280,7395,7885
38130,59085,13317,28444,9837,45768,15282,7396,7886
38135,59091,13317,28450,9837,45773,15285,7399,7886
38140,59102,13318,28457,9838,45784,15287,7400,7887
38145,59106,13318,28458,9838,45788,15288,7400,7888
38150,59116,13319,28462,9838,45796,15290,7400,7890
38155,59122,13319,28464,9838,45803,15293,7401,7892
38160,59133,13320,28473,9839,45813,15295,7403,7892
38165,59137,13320,28474,9839,45817,15296,7403,7893
38170,59147,13321,28477,9839,45826,15298,7404,7894
38175,59153,13321,28481,9839,45832,15301,7406,7895
38180,59164,13322,28484,9839,45842,15303,7406,7897
38185,59168,13322,28485,9839,45846,15304,7406,7898
38190,59178,13323,28490,9840,45854,15306,7408,7898
38195,59184,13323,28491,9840,45860,15309,7408,7901
38200,59195,13324,28497,9841,45871,15311,7409,7902
38205,59199,13324,28501,9841,45875,15312,7410,7902
38210,59209,13326,28503,9842,45883,15314,7411,7903
38215,59215,13326,28505,9842,45888,15317,7412,7905
38220,59226,13329,28509,9844,45895,15319,7413,7906
38225,59230,13333,28512,9848,45897,15320,7414,7906
38230,59240,13336,28516,9849,45903,15322,7416,7906
38235,59246,13337,28516,9850,45909,15325,7416,7909
38240,59257,13341,28524,9854,45914,15327,7418,7909
38245,59261,13343,28525,9856,45918,15328,7419,7909
38250,59271,13349,28530,9860,45921,15330,7419,7911
38255,59277,13349,28531,9860,45926,15333,7419,7914
38260,59288,13354,28534,9863,45934,15335,7421,7914
38265,59292,13355,28537,9864,45936,15336,7422,7914
38270,59302,13361,28542,9869,45940,15338,7422,7916
38275,59308,13362,28547,9870,45945,15341,7425,7916
38280,59319,13364,28551,9871,45953,15343,7425,7918
38285,59323,13365,28553,9872,45958,15344,7426,7918
38290,59333,13367,28560,9874,45965,15346,7428,7918
38295,59339,13367,28563,9874,45969,15349,7429,7920
38300,59350,13370,28568,9876,45978,15351,7429,7922
38305,59354,13370,28570,9876,45984,15352,7430,7922
38310,59364,13372,28573,9878,45991,15354,7430,7924
38315,59370,13372,28576,9878,45997,15357,7431,7926
38320,59381,13375,28580,9880,46006,15359,7432,7927
38325,59385,13375,28580,9880,46010,15360,7432,7928
38330,59395,13376,28585,9881,46018,15362,7433,7929
38335,59401,13376,28587,9881,46025,15365,7433,7932
38340,59412,13379,28593,9884,46032,15367,7434,7933
38345,59416,13379,28594,9884,46037,15368,7434,7934
38350,59426,13381,28599,9886,46044,15370,7435,7935
38355,59432,13381,28603,9886,46051,15373,7437,7936
38360,59443,13384,28608,9887,46057,15375,7438,7937
38365,59447,13385,28612,9888,46062,15376,7439,7937
38370,59457,13386,28614,9888,46071,15378,7439,7939
38375,59463,13386,28616,9888,46077,15381,7441,7940
38380,59474,13388,28622,9890,46085,15383,7442,7941
38385,59478,13390,28626,9892,46088,15384,7443,7941
38390,59488,13393,28631,9894,46095,15386,7444,7942
38395,59494,13393,28634,9894,46100,15389,7445,7944
38400,59505,13398,28638,9897,46106,15391,7446,7945
38405,59509,13400,28641,9899,46109,15392,7447,7945
38410,59519,13404,28648,9902,46114,15394,7449,7945
38415,59525,13404,28649,9902,46121,15397,7450,7947
38420,59536,13409,28656,9906,46127,15399,7452,7947
38425,59540,13411,28658,9908,46129,15400,7452,7948
38430,59550,13414,28662,9911,46136,15402,7453,7949
38435,59556,13414,28666,9911,46141,15405,7454,7951
38440,59567,13418,28674,9915,46148,15407,7456,7951
38445,59571,13421,28678,9918,46150,15408,7457,7951
38450,59581,13424,28682,9921,46157,15410,7457,7953
38455,59587,13424,28686,9921,46163,15413,7459,7954
38460,59598,13428,28691,9925,46170,15415,7460,7955
38465,59602,13430,28694,9927,46172,15416,7461,7955
38470,59612,13434,28699,9929,46177,15418,7462,7956
38475,59618,13434,28703,9929,46182,15421,7463,7958
38480,59629,13441,28710,9936,46188,15423,7464,7959
38485,59633,13443,28714,9938,46190,15424,7465,7959
38490,59643,13447,28718,9940,46196,15426,7465,7961
38495,59649,13447,28721,9940,46201,15429,7466,7963
38500,59660,13449,28726,9941,46211,15431,7468,7963
38505,59664,13450,28729,9942,46214,15432,7469,7963
38510,59674,13451,28735,9943,46222,15434,7470,7964
38515,59680,13451,28737,9943,46228,15437,7471,7966
38520,59691,13454,28743,9946,46236,15439,7472,7967
38525,59695,13454,28743,9946,46241,15440,7472,7968
38530,59705,13455,28749,9947,46249,15442,7473,7969
38535,59711,13455,28751,9947,46255,15445,7474,7971
38540,59722,13456,28760,9947,46263,15447,7475,7972
38545,59726,13456,28763,9947,46269,15448,7475,7973
38550,59736,13457,28767,9947,46278,15450,7476,7974
38555,59742,13457,28771,9947,46285,15453,7479,7974
38560,59753,13458,28773,9947,46295,15455,7479,7976
38565,59757,13458,28776,9947,46298,15456,7480,7976
38570,59767,13459,28780,9947,46308,15458,7481,7977
38575,59773,13459,28785,9947,46313,15461,7483,7978
38580,59784,13460,28788,9947,46324,15463,7484,7979
38585,59788,13460,28790,9947,46328,15464,7484,7980
38590,59798,13461,28797,9948,46336,15466,7485,7981
38595,59804,13461,28800,9948,46342,15469,7486,7983
38600,59815,13462,28803,9948,46353,15471,7487,7984
38605,59819,13462,28806,9948,46356,15472,7487,7985
38610,59829,13464,28810,9948,46365,15474,7488,7986
38615,59835,13464,28812,9948,46370,15477,7489,7988
38620,59846,13467,28820,9951,46377,15479,7490,7989
38625,59850,13467,28821,9951,46383,15480,7490,7990
38630,59860,13470,28825,9952,46390,15482,7491,7991
38635,59866,13470,28827,9952,46395,15485,7492,7993
38640,59877,13474,28832,9955,46402,15487,7493,7994
38645,59881,13475,28834,9956,46406,15488,7494,7994
38650,59891,13477,28834,9956,46414,15490,7494,7996
38655,59897,13477,28836,9956,46420,15493,7496,7997
38660,59908,13481,28841,9958,46426,15495,7497,7998
38665,59912,13482,28842,9959,46430,15496,7497,7999
38670,59922,13486,28846,9961,46436,15498,7498,8000
38675,59928,13486,28852,9961,46440,15501,7501,8000
38680,59939,13490,28855,9964,46449,15503,7501,8002
38685,59943,13491,28857,9965,46452,15504,7501,8003
38690,59953,13493,28859,9965,46460,15506,7502,8004
38695,59959,13493,28861,9965,46465,15509,7502,8007
38700,59970,13496,28866,9968,46473,15511,7503,8008
38705,59974,13498,28868,9970,46476,15512,7503,8009
38710,59984,13502,28876,9973,46481,15514,7505,8009
38715,59990,13502,28879,9973,46487,15517,7506,8011
38720,60001,13505,28882,9974,46495,15519,7508,8011
38725,60005,13506,28884,9975,46499,15520,7509,8011
38730,60015,13509,28889,9978,46506,15522,7510,8012
38735,60021,13509,28893,9978,46511,15525,7513,8012
38740,60032,13513,28897,9980,46519,15527,7515,8012
38745,60036,13515,28901,9982,46521,15528,7516,8012
38750,60046,13518,28907,9985,46527,15530,7518,8012
38755,60052,13519,28910,9986,46532,15533,7520,8013
38760,60063,13523,28917,9990,46537,15535,7521,8014
38765,60067,13527,28919,9994,46540,15536,7521,8015
38770,60077,13530,28923,9997,46547,15538,7522,8016
38775,60083,13530,28924,9997,46553,15541,7523,8018
38780,60094,13534,28930,10000,46559,15543,7524,8019
38785,60098,13535,28932,10001,46563,15544,7525,8019
38790,60108,13541,28942,10007,46566,15546,7527,8019
38795,60114,13541,28942,10007,46573,15549,7527,8022
38800,60125,13544,28946,10009,46581,15551,7528,8023
38805,60129,13544,28946,10009,46585,15552,7528,8024
38810,60139,13549,28953,10013,46589,15554,7530,8024
38815,60145,13549,28955,10013,46595,15557,7530,8027
38820,60156,13554,28962,10017,46602,15559,7532,8027
38825,60160,13556,28965,10019,46604,15560,7532,8028
38830,60170,13560,28969,10022,46610,15562,7532,8030
38835,60176,13560,28969,10022,46616,15565,7532,8033
38840,60187,13563,28973,10024,46624,15567,7533,8034
38845,60191,13564,28976,10025,46627,15568,7534,8034
38850,60201,13566,28982,10027,46634,15570,7535,8035
38855,60207,13566,28984,10027,46641,15573,7536,8037
38860,60218,13568,28990,10029,46650,15575,7537,8038
38865,60222,13569,28992,10030,46653,15576,7538,8038
38870,60232,13570,28998,10030,46661,15578,7540,8038
38875,60238,13570,29002,10030,46667,15581,7542,8039
38880,60249,13573,29008,10032,46674,15583,7543,8040
38885,60253,13573,29009,10032,46680,15584,7543,8041
38890,60263,13574,29011,10032,46689,15586,7544,8042
38895,60269,13574,29012,10032,46695,15589,7545,8044
38900,60280,13576,29017,10033,46703,15591,7546,8045
38905,60284,13576,29019,10033,46707,15592,7546,8046
38910,60294,13577,29024,10033,46715,15594,7548,8046
38915,60300,13577,29028,10033,46720,15597,7550,8047
38920,60311,13579,29033,10034,46731,15599,7551,8048
38925,60315,13579,29036,10034,46735,15600,7552,8048
38930,60325,13581,29042,10035,46743,15602,7554,8048
38935,60331,13581,29044,10035,46749,15605,7555,8050
38940,60342,13584,29051,10038,46756,15607,7557,8050
38945,60346,13586,29053,10040,46759,15608,7557,8051
38950,60356,13589,29059,10042,46765,15610,7557,8053
38955,60362,13589,29062,10042,46772,15613,7559,8054
38960,60373,13592,29069,10044,46778,15615,7561,8054
38965,60377,13592,29069,10044,46785,15616,7561,8055
38970,60387,13595,29073,10045,46791,15618,7562,8056
38975,60393,13595,29076,10045,46797,15621,7564,8057
38980,60404,13598,29082,10047,46805,15623,7566,8057
38985,60408,13599,29085,10048,46809,15624,7566,8058
38990,60418,13602,29088,10049,46816,15626,7567,8059
38995,60424,13602,29092,10049,46821,15629,7569,8060
39000,60435,13606,29097,10052,46828,15631,7570,8061
39005,60439,13608,29101,10054,46831,15632,7571,8061
39010,60449,13611,29105,10055,46838,15634,7572,8062
39015,60455,13611,29110,10055,46844,15637,7575,8062
39020,60466,13614,29113,10056,46852,15639,7576,8063
39025,60470,13616,29115,10058,46854,15640,7576,8064
39030,60480,13619,29120,10059,46860,15642,7577,8065
39035,60486,13619,29122,10059,46866,15645,7577,8068
39040,60497,13623,29127,10062,46874,15647,7577,8070
39045,60501,13623,29129,10062,46878,15648,7578,8070
39050,60511,13627,29135,10065,46884,15650,7580,8070
39055,60517,13627,29140,10065,46889,15653,7582,8071
39060,60528,13633,29147,10069,46895,15655,7584,8071
39065,60532,13634,29149,10070,46898,15656,7585,8071
39070,60542,13636,29153,10072,46906,15658,7587,8071
39075,60548,13636,29156,10072,46910,15661,7588,8073
39080,60559,13641,29162,10077,46917,15663,7589,8074
39085,60563,13643,29164,10079,46920,15664,7590,8074
39090,60573,13647,29169,10082,46925,15666,7591,8075
39095,60579,13648,29171,10083,46931,15669,7593,8076
39100,60590,13650,29174,10084,46940,15671,7594,8077
39105,60594,13651,29175,10085,46943,15672,7594,8078
39110,60604,13653,29179,10086,46950,15674,7594,8080
39115,60610,13653,29182,10086,46955,15677,7596,8081
39120,60621,13655,29186,10087,46964,15679,7596,8083
39125,60625,13656,29189,10088,46968,15680,7596,8084
39130,60635,13658,29193,10089,46976,15682,7597,8085
39135,60641,13658,29197,10089,46982,15685,7600,8085
39140,60652,13660,29202,10090,46990,15687,7601,8086
39145,60656,13661,29206,10091,46995,15688,7602,8086
39150,60666,13664,29212,10093,47002,15690,7603,8087
39155,60672,13664,29215,10093,47008,15693,7605,8088
39160,60683,13666,29221,10094,47015,15695,7605,8090
39165,60687,13667,29223,10095,47020,15696,7606,8090
39170,60697,13670,29230,10097,47026,15698,7607,8091
39175,60703,13670,29233,10097,47033,15701,7608,8093
39180,60714,13673,29237,10098,47039,15703,7608,8095
39185,60718,13673,29239,10098,47045,15704,7609,8095
39190,60728,13674,29247,10099,47053,15706,7611,8095
39195,60734,13674,29251,10099,47059,15709,7614,8095
39200,60745,13675,29255,10100,47070,15711,7615,8096
39205,60749,13675,29257,10100,47074,15712,7616,8096
39210,60759,13677,29262,10102,47081,15714,7616,8098
39215,60765,13677,29267,10102,47087,15717,7619,8098
39220,60776,13680,29274,10105,47095,15719,7620,8099
39225,60780,13682,29277,10107,47098,15720,7621,8099
39230,60790,13684,29282,10107,47106,15722,7621,8101
39235,60796,13684,29283,10107,47112,15725,7622,8103
39240,60807,13687,29290,10109,47119,15727,7623,8104
39245,60811,13688,29293,10110,47123,15728,7624,8104
39250,60821,13691,29300,10113,47130,15730,7626,8104
39255,60827,13691,29303,10113,47135,15733,7628,8105
39260,60838,13694,29306,10116,47144,15735,7628,8107
39265,60842,13695,29307,10117,47147,15736,7628,8108
39270,60852,13697,29313,10118,47154,15738,7629,8109
39275,60858,13697,29317,10118,47160,15741,7631,8110
39280,60869,13700,29320,10120,47168,15743,7631,8112
39285,60873,13702,29323,10122,47171,15744,7632,8112
39290,60883,13705,29326,10124,47178,15746,7633,8113
39295,60889,13705,29328,10124,47184,15749,7635,8114
39300,60900,13709,29336,10127,47188,15751,7637,8114
39305,60904,13713,29337,10131,47191,15752,7637,8115
39310,60914,13717,29341,10133,47196,15754,7638,8116
39315,60920,13718,29343,10134,47202,15757,7639,8118
39320,60931,13720,29348,10136,47210,15759,7640,8119
39325,60935,13720,29348,10136,47215,15760,7640,8120
39330,60945,13722,29351,10137,47222,15762,7641,8121
39335,60951,13722,29354,10137,47226,15765,7641,8124
39340,60962,13725,29360,10139,47237,15767,7642,8125
39345,60966,13726,29364,10140,47239,15768,7643,8125
39350,60976,13729,29369,10142,47246,15770,7644,8126
39355,60982,13729,29371,10142,47252,15773,7645,8128
39360,60993,13732,29377,10143,47259,15775,7646,8129
39365,60997,13732,29380,10143,47265,15776,7647,8129
39370,61007,13734,29383,10145,47273,15778,7647,8131
39375,61013,13734,29386,10145,47279,15781,7649,8132
39380,61024,13737,29391,10146,47287,15783,7649,8134
39385,61028,13737,29392,10146,47291,15784,7649,8135
39390,61038,13739,29396,10148,47299,15786,7650,8136
39395,61044,13739,29399,10148,47305,15789,7652,8137
39400,61055,13741,29403,10149,47314,15791,7652,8139
39405,61059,13741,29403,10149,47318,15792,7652,8140
39410,61069,13744,29408,10152,47325,15794,7652,8142
39415,61075,13744,29412,10152,47331,15797,7655,8142
39420,61086,13746,29415,10152,47339,15799,7656,8143
39425,61090,13747,29418,10153,47343,15800,7657,8143
39430,61100,13751,29424,10155,47348,15802,7658,8144
39435,61106,13751,29424,10155,47355,15805,7658,8147
39440,61117,13754,29431,10157,47363,15807,7660,8147
39445,61121,13754,29432,10157,47367,15808,7661,8147
39450,61131,13758,29436,10159,47372,15810,7662,8148
39455,61137,13758,29437,10159,47379,15813,7663,8150
39460,61148,13761,29441,10160,47386,15815,7664,8151
39465,61152,13764,29445,10163,47388,15816,7665,8151
39470,61162,13768,29449,10165,47393,15818,7666,8152
39475,61168,13768,29451,10165,47398,15821,7667,8154
39480,61179,13773,29457,10169,47403,15823,7668,8155
39485,61183,13776,29459,10172,47406,15824,7669,8155
39490,61193,13780,29463,10174,47412,15826,7671,8155
39495,61199,13780,29464,10174,47417,15829,7671,8158
39500,61210,13786,29470,10179,47421,15831,7671,8160
39505,61214,13789,29470,10182,47425,15832,7671,8161
39510,61224,13794,29476,10186,47428,15834,7671,8163
39515,61230,13794,29478,10186,47434,15837,7672,8165
39520,61241,13796,29482,10187,47445,15839,7673,8166
39525,61245,13796,29484,10187,47449,15840,7674,8166
39530,61255,13797,29487,10188,47458,15842,7675,8167
39535,61261,13797,29492,10188,47463,15845,7678,8167
39540,61272,13799,29496,10189,47473,15847,7679,8168
39545,61276,13799,29496,10189,47477,15848,7679,8169
39550,61286,13802,29503,10192,47484,15850,7681,8169
39555,61292,13802,29507,10192,47489,15853,7683,8170
39560,61303,13804,29513,10193,47498,15855,7684,8171
39565,61307,13805,29515,10194,47502,15856,7684,8172
39570,61317,13807,29521,10195,47509,15858,7685,8173
39575,61323,13807,29525,10195,47515,15861,7686,8175
39580,61334,13810,29531,10196,47523,15863,7687,8176
39585,61338,13811,29533,10197,47527,15864,7688,8176
39590,61348,13813,29541,10199,47534,15866,7690,8176
39595,61354,13813,29542,10199,47541,15869,7691,8178
39600,61365,13815,29546,10200,47550,15871,7692,8179
39605,61369,13815,29547,10200,47554,15872,7693,8179
39610,61379,13816,29550,10200,47563,15874,7694,8180
39615,61385,13816,29553,10200,47568,15877,7696,8181
39620,61396,13821,29561,10204,47574,15879,7698,8181
39625,61400,13822,29564,10205,47578,15880,7699,8181
39630,61410,13826,29569,10208,47584,15882,7701,8181
39635,61416,13826,29570,10208,47590,15885,7702,8183
39640,61427,13828,29577,10210,47598,15887,7703,8184
39645,61431,13829,29577,10211,47602,15888,7703,8185
39650,61441,13832,29581,10213,47609,15890,7704,8186
39655,61447,13832,29584,10213,47614,15893,7706,8187
39660,61458,13838,29590,10217,47619,15895,7706,8189
39665,61462,13840,29592,10219,47622,15896,7706,8190
39670,61472,13845,29598,10224,47627,15898,7706,8192
39675,61478,13845,29601,10224,47632,15901,7707,8194
39680,61489,13849,29603,10226,47640,15903,7708,8195
39685,61493,13849,29604,10226,47644,15904,7709,8195
39690,61503,13854,29610,10229,47648,15906,7711,8195
39695,61509,13854,29616,10229,47653,15909,7714,8195
39700,61520,13860,29621,10234,47659,15911,7715,8196
39705,61524,13861,29623,10235,47663,15912,7716,8196
39710,61534,13865,29628,10239,47668,15914,7716,8198
39715,61540,13865,29632,10239,47672,15917,7718,8199
39720,61551,13870,29636,10242,47678,15919,7719,8200
39725,61555,13872,29639,10244,47682,15920,7719,8201
39730,61565,13874,29645,10246,47689,15922,7719,8203
39735,61571,13874,29648,10246,47695,15925,7721,8204
39740,61582,13876,29654,10248,47705,15927,7722,8205
39745,61586,13876,29655,10248,47710,15928,7723,8205
39750,61596,13878,29662,10250,47717,15930,7725,8205
39755,61602,13878,29663,10250,47724,15933,7726,8207
39760,61613,13880,29669,10252,47731,15935,7726,8209
39765,61617,13880,29670,10252,47737,15936,7727,8209
39770,61627,13881,29674,10253,47746,15938,7728,8210
39775,61633,13881,29678,10253,47751,15941,7729,8212
39780,61644,13884,29684,10256,47759,15943,7729,8214
39785,61648,13884,29685,10256,47764,15944,7729,8215
39790,61658,13887,29692,10259,47770,15946,7730,8216
39795,61664,13887,29694,10259,47776,15949,7731,8218
39800,61675,13889,29697,10259,47785,15951,7733,8218
39805,61679,13890,29699,10260,47789,15952,7733,8219
39810,61689,13892,29705,10261,47797,15954,7734,8220
39815,61695,13892,29707,10261,47803,15957,7734,8223
39820,61706,13893,29713,10262,47811,15959,7735,8224
39825,61710,13893,29713,10262,47817,15960,7735,8225
39830,61720,13895,29717,10263,47825,15962,7735,8227
39835,61726,13895,29722,10263,47829,15965,7737,8228
39840,61737,13897,29726,10265,47839,15967,7738,8229
39845,61741,13897,29729,10265,47844,15968,7739,8229
39850,61751,13899,29732,10266,47852,15970,7740,8230
39855,61757,13899,29736,10266,47857,15973,7742,8231
39860,61768,13901,29742,10267,47865,15975,7743,8232
39865,61772,13902,29743,10268,47870,15976,7743,8233
39870,61782,13904,29747,10269,47878,15978,7744,8234
39875,61788,13904,29751,10269,47882,15981,7746,8235
39880,61799,13908,29758,10272,47890,15983,7747,8236
39885,61803,13909,29759,10273,47894,15984,7748,8236
39890,61813,13912,29763,10274,47901,15986,7750,8236
39895,61819,13912,29767,10274,47906,15989,7752,8237
39900,61830,13915,29769,10277,47915,15991,7752,8239
39905,61834,13915,29769,10277,47919,15992,7752,8240
39910,61844,13917,29775,10279,47926,15994,7754,8240
39915,61850,13917,29777,10279,47932,15997,7755,8242
39920,61861,13922,29783,10283,47938,15999,7756,8243
39925,61865,13923,29783,10284,47942,16000,7756,8244
39930,61875,13927,29789,10288,47947,16002,7757,8245
39935,61881,13927,29791,10288,47953,16005,7757,8248
39940,61892,13931,29795,10290,47959,16007,7758,8249
39945,61896,13933,29797,10292,47962,16008,7758,8250
39950,61906,13938,29803,10296,47967,16010,7760,8250
39955,61912,13938,29803,10296,47973,16013,7760,8253
39960,61923,13942,29809,10300,47980,16015,7762,8253
39965,61927,13944,29810,10302,47983,16016,7762,8254
39970,61937,13946,29816,10304,47989,16018,7763,8255
39975,61943,13946,29820,10304,47996,16021,7765,8256
39980,61954,13948,29826,10304,48004,16023,7767,8256
39985,61958,13949,29828,10305,48009,16024,7767,8257
39990,61968,13952,29836,10307,48014,16026,7769,8257
39995,61974,13952,29840,10307,48021,16029,7772,8257
40000,61985,13954,29844,10308,48030,16031,7773,8258
40005,61989,13955,29846,10309,48033,16032,7773,8259
40010,61999,13956,29848,10309,48042,16034,7773,8261
40015,62005,13956,29852,10309,48048,16037,7775,8262
40020,62016,13958,29859,10310,48055,16039,7776,8263
40025,62020,13959,29861,10311,48061,16040,7776,8264
40030,62030,13960,29863,10311,48069,16042,7777,8265
40035,62036,13960,29866,10311,48076,16045,7780,8265
40040,62047,13963,29872,10313,48081,16047,7781,8266
40045,62051,13963,29873,10313,48088,16048,7781,8267
40050,62061,13965,29880,10314,48095,16050,7782,8268
40055,62067,13965,29884,10314,48102,16053,7783,8270
40060,62078,13968,29890,10317,48110,16055,7783,8272
40065,62082,13968,29892,10317,48114,16056,7784,8272
40070,62092,13971,29898,10320,48120,16058,7786,8272
40075,62098,13971,29902,10320,48126,16061,7788,8273
40080,62109,13976,29908,10323,48133,16063,7790,8273
40085,62113,13977,29910,10324,48136,16064,7790,8274
40090,62123,13981,29915,10326,48141,16066,7791,8275
40095,62129,13981,29918,10326,48148,16069,7792,8277
40100,62140,13984,29926,10328,48155,16071,7794,8277
40105,62144,13986,29928,10330,48158,16072,7794,8278
40110,62154,13989,29932,10332,48164,16074,7795,8279
40115,62160,13989,29933,10332,48171,16077,7796,8281
40120,62171,13991,29938,10334,48179,16079,7796,8283
40125,62175,13993,29939,10336,48182,16080,7796,8284
40130,62185,13996,29943,10338,48188,16082,7796,8286
40135,62191,13996,29946,10338,48194,16085,7797,8288
40140,62202,14000,29951,10342,48202,16087,7798,8289
40145,62206,14001,29953,10343,48205,16088,7799,8289
40150,62216,14006,29959,10346,48208,16090,7800,8290
40155,62222,14007,29963,10347,48212,16093,7802,8291
40160,62233,14013,29965,10351,48219,16095,7802,8293
40165,62237,14016,29968,10354,48220,16096,7802,8294
40170,62247,14020,29971,10357,48226,16098,7802,8296
40175,62253,14020,29973,10357,48231,16101,7803,8298
40180,62264,14025,29979,10360,48236,16103,7805,8298
40185,62268,14028,29979,10363,48240,16104,7805,8299
40190,62278,14029,29982,10363,48248,16106,7806,8300
40195,62284,14029,29987,10363,48253,16109,7808,8301
40200,62295,14032,29990,10364,48263,16111,7809,8302
40205,62299,14032,29991,10364,48267,16112,7809,8303
40210,62309,14034,29998,10365,48274,16114,7811,8303
40215,62315,14034,30001,10365,48280,16117,7812,8305
40220,62326,14036,30005,10367,48288,16119,7812,8307
40225,62330,14036,30006,10367,48294,16120,7812,8308
40230,62340,14038,30012,10369,48301,16122,7814,8308
40235,62346,14038,30013,10369,48308,16125,7814,8311
40240,62357,14041,30019,10371,48314,16127,7815,8312
40245,62361,14042,30021,10372,48319,16128,7816,8312
40250,62371,14043,30026,10373,48327,16130,7817,8313
40255,62377,14043,30028,10373,48334,16133,7817,8316
40260,62388,14045,30033,10373,48342,16135,7819,8316
40265,62392,14045,30033,10373,48347,16136,7819,8317
40270,62402,14048,30040,10376,48353,16138,7821,8317
40275,62408,14048,30042,10376,48360,16141,7822,8319
40280,62419,14051,30047,10378,48368,16143,7822,8321
40285,62423,14051,30047,10378,48372,16144,7822,8322
40290,62433,14052,30052,10379,48380,16146,7823,8323
40295,62439,14052,30055,10379,48386,16149,7824,8325
40300,62450,14056,30061,10382,48392,16151,7825,8326
40305,62454,14058,30062,10384,48396,16152,7825,8327
40310,62464,14062,30066,10387,48401,16154,7825,8329
40315,62470,14062,30067,10387,48407,16157,7825,8332
40320,62481,14066,30073,10390,48414,16159,7825,8334
40325,62485,14068,30074,10392,48417,16160,7825,8335
40330,62495,14073,30083,10396,48421,16162,7827,8335
40335,62501,14073,30085,10396,48427,16165,7827,8338
40340,62512,14078,30090,10399,48433,16167,7827,8340
40345,62516,14079,30091,10400,48437,16168,7828,8340
40350,62526,14082,30095,10402,48443,16170,7829,8341
40355,62532,14082,30100,10402,48450,16173,7832,8341
40360,62543,14087,30106,10405,48455,16175,7833,8342
40365,62547,14089,30108,10407,48458,16176,7833,8343
40370,62557,14093,30115,10411,48463,16178,7835,8343
40375,62563,14093,30119,10411,48469,16181,7837,8344
40380,62574,14097,30123,10414,48476,16183,7837,8346
40385,62578,14099,30125,10416,48479,16184,7837,8347
40390,62588,14103,30130,10419,48484,16186,7838,8348
40395,62594,14103,30131,10419,48491,16189,7839,8350
40400,62605,14106,30136,10421,48499,16191,7840,8351
40405,62609,14107,30138,10422,48502,16192,7840,8352
40410,62619,14108,30141,10422,48510,16194,7840,8354
40415,62625,14108,30143,10422,48517,16197,7841,8356
40420,62636,14109,30147,10422,48527,16199,7843,8356
40425,62640,14109,30150,10422,48531,16200,7844,8356
40430,62650,14110,30154,10423,48539,16202,7844,8358
40435,62656,14110,30156,10423,48546,16205,7845,8360
40440,62667,14111,30161,10424,48556,16207,7845,8362
40445,62671,14111,30163,10424,48559,16208,7845,8363
40450,62681,14112,30166,10424,48569,16210,7846,8364
40455,62687,14112,30170,10424,48573,16213,7847,8366
40460,62698,14113,30177,10424,48583,16215,7848,8367
40465,62702,14113,30179,10424,48589,16216,7849,8367
40470,62712,14114,30187,10425,48596,16218,7849,8369
40475,62718,14114,30190,10425,48603,16221,7851,8370
40480,62729,14115,30195,10425,48611,16223,7852,8371
40485,62733,14115,30197,10425,48617,16224,7852,8372
40490,62743,14117,30201,10426,48625,16226,7853,8373
40495,62749,14117,30205,10426,48631,16229,7855,8374
40500,62760,14119,30211,10428,48640,16231,7857,8374
40505,62764,14119,30212,10428,48645,16232,7857,8375
40510,62774,14122,30216,10431,48651,16234,7857,8377
40515,62780,14122,30217,10431,48658,16237,7858,8379
40520,62791,14125,30222,10433,48665,16239,7859,8380
40525,62795,14126,30225,10434,48668,16240,7859,8381
40530,62805,14130,30229,10436,48674,16242,7860,8382
40535,62811,14130,30231,10436,48681,16245,7862,8383
40540,62822,14132,30236,10437,48688,16247,7864,8383
40545,62826,14133,30237,10438,48693,16248,7864,8384
40550,62836,14136,30242,10441,48699,16250,7864,8386
40555,62842,14136,30243,10441,48705,16253,7864,8389
40560,62853,14139,30249,10444,48712,16255,7865,8390
40565,62857,14141,30253,10446,48716,16256,7866,8390
40570,62867,14145,30257,10448,48722,16258,7867,8391
40575,62873,14145,30260,10448,48727,16261,7868,8393
40580,62884,14149,30264,10450,48734,16263,7869,8394
40585,62888,14150,30264,10451,48738,16264,7869,8395
40590,62898,14153,30267,10453,48745,16266,7869,8397
40595,62904,14153,30270,10453,48750,16269,7870,8399
40600,62915,14158,30274,10456,48756,16271,7870,8401
40605,62919,14160,30276,10458,48759,16272,7871,8401
40610,62929,14163,30279,10459,48766,16274,7872,8402
40615,62935,14163,30283,10459,48771,16277,7873,8404
40620,62946,14166,30285,10461,48780,16279,7873,8406
40625,62950,14167,30287,10462,48783,16280,7874,8406
40630,62960,14170,30292,10463,48789,16282,7876,8406
40635,62966,14170,30294,10463,48795,16285,7876,8409
40640,62977,14173,30300,10466,48803,16287,7877,8410
40645,62981,14175,30303,10468,48806,16288,7878,8410
40650,62991,14178,30309,10471,48812,16290,7878,8412
40655,62997,14178,30313,10471,48818,16293,7880,8413
40660,63008,14182,30317,10474,48825,16295,7881,8414
40665,63012,14183,30319,10475,48829,16296,7882,8414
40670,63022,14186,30322,10477,48835,16298,7882,8416
40675,63028,14187,30325,10478,48839,16301,7883,8418
40680,63039,14193,30331,10482,48843,16303,7884,8419
40685,63043,14197,30333,10486,48846,16304,7885,8419
40690,63053,14201,30336,10489,48852,16306,7885,8421
40695,63059,14201,30340,10489,48856,16309,7887,8422
40700,63070,14207,30347,10494,48861,16311,7888,8423
40705,63074,14210,30349,10497,48864,16312,7889,8423
40710,63084,14211,30353,10497,48872,16314,7890,8424
40715,63090,14211,30354,10497,48879,16317,7891,8426
40720,63101,14214,30362,10500,48886,16319,7892,8427
40725,63105,14214,30364,10500,48890,16320,7892,8428
40730,63115,14216,30370,10502,48898,16322,7892,8430
40735,63121,14216,30372,10502,48905,16325,7893,8432
40740,63132,14219,30378,10504,48913,16327,7895,8432
40745,63136,14219,30379,10504,48917,16328,7896,8432
40750,63146,14222,30383,10506,48924,16330,7897,8433
40755,63152,14222,30387,10506,48928,16333,7899,8434
40760,63163,14224,30397,10508,48938,16335,7901,8434
40765,63167,14225,30400,10509,48942,16336,7902,8434
40770,63177,14226,30405,10510,48951,16338,7903,8435
40775,63183,14226,30407,10510,48956,16341,7903,8438
40780,63194,14228,30413,10512,48966,16343,7905,8438
40785,63198,14228,30415,10512,48970,16344,7905,8439
40790,63208,14229,30418,10512,48978,16346,7905,8441
40795,63214,14229,30418,10512,48985,16349,7905,8444
40800,63225,14231,30421,10513,48993,16351,7905,8446
40805,63229,14231,30423,10513,48998,16352,7905,8447
40810,63239,14233,30428,10515,49006,16354,7907,8447
40815,63245,14233,30429,10515,49012,16357,7908,8449
40820,63256,14238,30437,10519,49016,16359,7910,8449
40825,63260,14239,30438,10520,49021,16360,7911,8449
40830,63270,14243,30442,10523,49027,16362,7912,8450
40835,63276,14243,30444,10523,49032,16365,7913,8452
40840,63287,14247,30447,10526,49040,16367,7914,8453
40845,63291,14247,30449,10526,49044,16368,7915,8453
40850,63301,14250,30454,10528,49051,16370,7917,8453
40855,63307,14250,30456,10528,49056,16373,7918,8455
40860,63318,14253,30461,10530,49063,16375,7919,8456
40865,63322,14255,30464,10532,49067,16376,7920,8456
40870,63332,14258,30469,10534,49073,16378,7921,8457
40875,63338,14258,30472,10534,49079,16381,7923,8458
40880,63349,14262,30477,10536,49087,16383,7925,8458
40885,63353,14263,30479,10537,49090,16384,7926,8458
40890,63363,14267,30482,10540,49096,16386,7926,8460
40895,63369,14267,30484,10540,49101,16389,7926,8463
40900,63380,14271,30490,10542,49107,16391,7927,8464
40905,63384,14273,30492,10544,49111,16392,7927,8465
40910,63394,14277,30497,10547,49116,16394,7927,8467
40915,63400,14277,30501,10547,49121,16397,7929,8468
40920,63411,14282,30507,10551,49128,16399,7930,8469
40925,63415,14283,30509,10552,49132,16400,7931,8469
40930,63425,14285,30514,10553,49139,16402,7932,8470
40935,63431,14285,30517,10553,49145,16405,7934,8471
40940,63442,14290,30521,10556,49151,16407,7934,8473
40945,63446,14292,30524,10558,49154,16408,7935,8473
40950,63456,14296,30530,10561,49159,16410,7936,8474
40955,63462,14296,30534,10561,49165,16413,7939,8474
40960,63473,14300,30537,10564,49173,16415,7940,8475
40965,63477,14301,30538,10565,49176,16416,7940,8476
40970,63487,14306,30543,10569,49181,16418,7940,8478
40975,63493,14306,30547,10569,49185,16421,7942,8479
40980,63504,14310,30554,10573,49193,16423,7943,8480
40985,63508,14311,30556,10574,49197,16424,7943,8481
40990,63518,14312,30564,10574,49205,16426,7945,8481
40995,63524,14312,30566,10574,49212,16429,7946,8483
41000,63535,14313,30567,10574,49222,16431,7947,8484
41005,63539,14313,30570,10574,49226,16432,7948,8484
41010,63549,14314,30573,10574,49234,16434,7948,8486
41015,63555,14314,30577,10574,49240,16437,7951,8486
41020,63566,14315,30583,10574,49251,16439,7952,8487
41025,63570,14315,30585,10574,49255,16440,7952,8488
41030,63580,14316,30590,10575,49264,16442,7954,8488
41035,63586,14316,30593,10575,49269,16445,7955,8490
41040,63597,14317,30597,10576,49280,16447,7955,8492
41045,63601,14317,30599,10576,49283,16448,7955,8493
41050,63611,14318,30607,10577,49291,16450,7956,8494
41055,63617,14318,30610,10577,49297,16453,7957,8496
41060,63628,14319,30613,10577,49307,16455,7958,8497
41065,63632,14319,30615,10577,49313,16456,7959,8497
41070,63642,14320,30619,10577,49320,16458,7960,8498
41075,63648,14320,30620,10577,49327,16461,7961,8500
41080,63659,14323,30623,10579,49336,16463,7961,8502
41085,63663,14323,30624,10579,49339,16464,7961,8503
41090,63673,14325,30630,10580,49346,16466,7963,8503
41095,63679,14326,30634,10581,49350,16469,7965,8504
41100,63690,14333,30639,10587,49356,16471,7966,8505
41105,63694,14335,30640,10589,49359,16472,7966,8506
41110,63704,14339,30645,10592,49364,16474,7967,8507
41115,63710,14339,30647,10592,49370,16477,7968,8509
41120,63721,14341,30651,10593,49378,16479,7969,8510
41125,63725,14342,30652,10594,49383,16480,7970,8510
41130,63735,14346,30661,10598,49388,16482,7972,8510
41135,63741,14346,30662,10598,49395,16485,7973,8512
41140,63752,14348,30667,10600,49403,16487,7974,8513
41145,63756,14349,30670,10601,49406,16488,7975,8513
41150,63766,14353,30677,10605,49412,16490,7976,8514
41155,63772,14353,30680,10605,49417,16493,7976,8517
41160,63783,14356,30686,10608,49426,16495,7978,8517
41165,63787,14357,30688,10609,49429,16496,7979,8517
41170,63797,14360,30693,10611,49436,16498,7979,8519
41175,63803,14360,30694,10611,49442,16501,7979,8522
41180,63814,14364,30699,10613,49449,16503,7980,8523
41185,63818,14366,30702,10615,49452,16504,7981,8523
41190,63828,14369,30707,10617,49458,16506,7982,8524
41195,63834,14369,30712,10617,49464,16509,7985,8524
41200,63845,14373,30718,10620,49472,16511,7985,8526
41205,63849,14374,30721,10621,49475,16512,7986,8526
41210,63859,14376,30724,10621,49482,16514,7987,8527
41215,63865,14376,30725,10621,49488,16517,7987,8530
41220,63876,14382,30732,10625,49493,16519,7987,8532
41225,63880,14384,30735,10627,49496,16520,7988,8532
41230,63890,14387,30738,10629,49502,16522,7988,8534
41235,63896,14387,30741,10629,49509,16525,7990,8535
41240,63907,14392,30747,10632,49514,16527,7991,8536
41245,63911,14394,30749,10634,49517,16528,7991,8537
41250,63921,14397,30754,10635,49523,16530,7992,8538
41255,63927,14397,30756,10635,49530,16533,7993,8540
41260,63938,14402,30763,10638,49535,16535,7995,8540
41265,63942,14404,30765,10640,49538,16536,7995,8541
41270,63952,14407,30771,10643,49544,16538,7996,8542
41275,63958,14407,30773,10643,49549,16541,7997,8544
41280,63969,14412,30780,10647,49554,16543,7999,8544
41285,63973,14413,30782,10648,49559,16544,7999,8545
41290,63983,14416,30787,10650,49567,16546,7999,8547
41295,63989,14416,30789,10650,49572,16549,8000,8549
41300,64000,14418,30792,10650,49581,16551,8001,8550
41305,64004,14419,30796,10651,49584,16552,8002,8550
41310,64014,14421,30802,10653,49591,16554,8002,8552
41315,64020,14421,30804,10653,49597,16557,8003,8554
41320,64031,14424,30812,10655,49605,16559,8005,8554
41325,64035,14425,30815,10656,49610,16560,8005,8555
41330,64045,14426,30820,10656,49618,16562,8006,8556
41335,64051,14426,30821,10656,49624,16565,8006,8559
41340,64062,14429,30825,10657,49632,16567,8006,8561
41345,64066,14430,30827,10658,49636,16568,8006,8562
41350,64076,14431,30834,10659,49644,16570,8006,8564
41355,64082,14431,30837,10659,49650,16573,8008,8565
41360,64093,14432,30844,10659,49661,16575,8010,8565
41365,64097,14432,30846,10659,49665,16576,8011,8565
41370,64107,14433,30851,10660,49674,16578,8011,8567
41375,64113,14433,30853,10660,49679,16581,8011,8570
41380,64124,14434,30859,10660,49689,16583,8012,8571
41385,64128,14434,30862,10660,49694,16584,8013,8571
41390,64138,14436,30869,10661,49701,16586,8015,8571
41395,64144,14436,30871,10661,49708,16589,8017,8572
41400,64155,14438,30879,10663,49716,16591,8018,8573
41405,64159,14439,30880,10664,49720,16592,8018,8574
41410,64169,14441,30884,10666,49728,16594,8019,8575
41415,64175,14441,30887,10666,49734,16597,8021,8576
41420,64186,14443,30894,10667,49742,16599,8023,8576
41425,64190,14444,30897,10668,49746,16600,8024,8576
41430,64200,14446,30901,10668,49754,16602,8026,8576
41435,64206,14446,30904,10668,49760,16605,8027,8578
41440,64217,14447,30909,10668,49770,16607,8029,8578
41445,64221,14447,30911,10668,49774,16608,8029,8579
41450,64231,14450,30915,10670,49780,16610,8030,8580
41455,64237,14450,30916,10670,49786,16613,8030,8583
41460,64248,14455,30922,10675,49793,16615,8031,8584
41465,64252,14457,30924,10677,49795,16616,8031,8585
41470,64262,14459,30928,10679,49802,16618,8032,8586
41475,64268,14459,30929,10679,49809,16621,8032,8589
41480,64279,14462,30934,10681,49816,16623,8033,8590
41485,64283,14464,30935,10683,49819,16624,8033,8591
41490,64293,14467,30940,10685,49825,16626,8034,8592
41495,64299,14467,30944,10685,49829,16629,8035,8594
41500,64310,14475,30951,10693,49834,16631,8035,8596
41505,64314,14476,30953,10694,49837,16632,8036,8596
41510,64324,14481,30958,10698,49843,16634,8038,8596
41515,64330,14481,30961,10698,49846,16637,8038,8599
41520,64341,14486,30964,10701,49853,16639,8039,8600
41525,64345,14488,30967,10703,49856,16640,8040,8600
41530,64355,14490,30973,10704,49863,16642,8041,8601
41535,64361,14490,30975,10704,49869,16645,8042,8603
41540,64372,14492,30981,10704,49877,16647,8042,8605
41545,64376,14492,30983,10704,49883,16648,8043,8605
41550,64386,14494,30988,10705,49891,16650,8045,8605
41555,64392,14494,30990,10705,49898,16653,8046,8607
41560,64403,14497,30995,10707,49905,16655,8047,8608
41565,64407,14498,30998,10708,49908,16656,8047,8609
41570,64417,14500,31003,10709,49916,16658,8048,8610
41575,64423,14500,31006,10709,49922,16661,8049,8612
41580,64434,14502,31013,10711,49930,16663,8050,8613
41585,64438,14503,31014,10712,49935,16664,8050,8614
41590,64448,14505,31019,10714,49942,16666,8050,8616
41595,64454,14505,31023,10714,49948,16669,8051,8618
41600,64465,14507,31029,10716,49958,16671,8053,8618
41605,64469,14508,31032,10717,49961,16672,8054,8618
41610,64479,14510,31037,10718,49969,16674,8056,8618
41615,64485,14510,31040,10718,49974,16677,8057,8620
41620,64496,14512,31045,10719,49984,16679,8058,8621
41625,64500,14513,31047,10720,49987,16680,8059,8621
41630,64510,14516,31053,10723,49993,16682,8060,8622
41635,64516,14516,31056,10723,49999,16685,8061,8624
41640,64527,14519,31060,10724,50008,16687,8062,8625
41645,64531,14520,31064,10725,50011,16688,8063,8625
41650,64541,14524,31071,10728,50016,16690,8063,8627
41655,64547,14524,31074,10728,50023,16693,8065,8628
41660,64558,14527,31078,10729,50031,16695,8067,8628
41665,64562,14528,31081,10730,50034,16696,8068,8628
41670,64572,14531,31086,10732,50040,16698,8070,8628
41675,64578,14531,31090,10732,50046,16701,8072,8629
41680,64589,14536,31097,10737,50052,16703,8073,8630
41685,64593,14537,31098,10738,50056,16704,8074,8630
41690,64603,14540,31100,10739,50063,16706,8075,8631
41695,64609,14540,31102,10739,50069,16709,8076,8633
41700,64620,14544,31106,10742,50076,16711,8076,8635
41705,64624,14545,31108,10743,50079,16712,8076,8636
41710,64634,14549,31114,10746,50084,16714,8078,8636
41715,64640,14549,31116,10746,50090,16717,8079,8638
41720,64651,14553,31123,10749,50097,16719,8081,8638
41725,64655,14554,31125,10750,50101,16720,8082,8638
41730,64665,14557,31130,10753,50108,16722,8083,8639
41735,64671,14557,31132,10753,50113,16725,8084,8641
41740,64682,14561,31138,10757,50119,16727,8085,8642
41745,64686,14565,31141,10761,50120,16728,8085,8643
41750,64696,14572,31149,10767,50123,16730,8087,8643
41755,64702,14573,31150,10768,50129,16733,8088,8645
41760,64713,14577,31159,10772,50133,16735,8090,8645
41765,64717,14578,31160,10773,50138,16736,8090,8646
41770,64727,14581,31166,10776,50146,16738,8091,8647
41775,64733,14581,31171,10776,50150,16741,8094,8647
41780,64744,14584,31179,10778,50158,16743,8096,8647
41785,64748,14584,31181,10778,50163,16744,8097,8647
41790,64758,14586,31185,10780,50171,16746,8097,8649
41795,64764,14586,31188,10780,50176,16749,8099,8650
41800,64775,14589,31194,10782,50184,16751,8101,8650
41805,64779,14589,31195,10782,50189,16752,8101,8651
41810,64789,14590,31198,10782,50199,16754,8102,8652
41815,64795,14590,31200,10782,50205,16757,8104,8653
41820,64806,14592,31204,10782,50212,16759,8104,8655
41825,64810,14593,31207,10783,50217,16760,8105,8655
41830,64820,14594,31213,10784,50225,16762,8105,8657
41835,64826,14594,31218,10784,50231,16765,8108,8657
41840,64837,14595,31222,10785,50242,16767,8108,8659
41845,64841,14595,31224,10785,50246,16768,8109,8659
41850,64851,14596,31231,10786,50254,16770,8111,8659
41855,64857,14596,31233,10786,50260,16773,8112,8661
41860,64868,14597,31239,10787,50271,16775,8112,8663
41865,64872,14597,31240,10787,50275,16776,8113,8663
41870,64882,14599,31245,10789,50282,16778,8114,8664
41875,64888,14599,31247,10789,50289,16781,8115,8666
41880,64899,14601,31254,10790,50296,16783,8117,8666
41885,64903,14602,31257,10791,50301,16784,8118,8666
41890,64913,14604,31264,10793,50309,16786,8120,8666
41895,64919,14604,31268,10793,50315,16789,8122,8667
41900,64930,14605,31274,10794,50324,16791,8123,8668
41905,64934,14606,31275,10795,50328,16792,8123,8669
41910,64944,14608,31279,10796,50336,16794,8125,8669
41915,64950,14608,31282,10796,50342,16797,8127,8670
41920,64961,14609,31286,10797,50351,16799,8127,8672
41925,64965,14611,31287,10799,50354,16800,8127,8673
41930,64975,14615,31291,10802,50360,16802,8128,8674
41935,64981,14615,31295,10802,50365,16805,8130,8675
41940,64992,14620,31300,10806,50372,16807,8131,8676
41945,64996,14620,31302,10806,50376,16808,8132,8676
41950,65006,14623,31308,10809,50382,16810,8133,8677
41955,65012,14623,31311,10809,50388,16813,8135,8678
41960,65023,14626,31316,10812,50397,16815,8137,8678
41965,65027,14627,31318,10813,50400,16816,8137,8679
41970,65037,14629,31322,10814,50407,16818,8138,8680
41975,65043,14629,31325,10814,50412,16821,8139,8682
41980,65054,14633,31330,10817,50420,16823,8141,8682
41985,65058,14635,31331,10819,50423,16824,8141,8683
41990,65068,14638,31335,10821,50429,16826,8142,8684
41995,65074,14638,31337,10821,50433,16829,8142,8687
42000,65085,14643,31339,10825,50441,16831,8142,8689
42005,65089,14645,31340,10827,50444,16832,8142,8690
42010,65099,14649,31345,10830,50449,16834,8143,8691
42015,65105,14649,31348,10830,50454,16837,8145,8692
42020,65116,14654,31350,10834,50462,16839,8145,8694
42025,65120,14656,31354,10836,50463,16840,8146,8694
42030,65130,14661,31360,10841,50468,16842,8147,8695
42035,65136,14661,31362,10841,50473,16845,8148,8697
42040,65147,14663,31368,10842,50482,16847,8149,8698
42045,65151,14663,31369,10842,50487,16848,8149,8699
42050,65161,14664,31375,10843,50495,16850,8150,8700
42055,65167,14664,31378,10843,50502,16853,8152,8701
42060,65178,14666,31382,10843,50510,16855,8153,8702
42065,65182,14666,31383,10843,50516,16856,8153,8703
42070,65192,14669,31388,10845,50521,16858,8153,8705
42075,65198,14669,31391,10845,50528,16861,8154,8707
42080,65209,14672,31396,10847,50535,16863,8154,8709
42085,65213,14673,31399,10848,50540,16864,8155,8709
42090,65223,14675,31403,10849,50548,16866,8156,8710
42095,65229,14675,31407,10849,50553,16869,8158,8711
42100,65240,14677,31412,10851,50563,16871,8159,8712
42105,65244,14678,31415,10852,50566,16872,8160,8712
42110,65254,14681,31422,10854,50573,16874,8162,8712
42115,65260,14681,31422,10854,50579,16877,8162,8715
42120,65271,14683,31426,10855,50587,16879,8163,8716
42125,65275,14683,31427,10855,50592,16880,8163,8717
42130,65285,14686,31434,10858,50598,16882,8164,8718
42135,65291,14686,31440,10858,50603,16885,8167,8718
42140,65302,14691,31445,10862,50610,16887,8167,8720
42145,65306,14693,31448,10864,50613,16888,8168,8720
42150,65316,14696,31453,10865,50619,16890,8169,8721
42155,65322,14696,31457,10865,50625,16893,8172,8721
42160,65333,14699,31462,10867,50634,16895,8174,8721
42165,65337,14699,31462,10867,50638,16896,8174,8722
42170,65347,14702,31466,10868,50645,16898,8176,8722
42175,65353,14702,31468,10868,50651,16901,8178,8723
42180,65364,14705,31472,10870,50659,16903,8178,8725
42185,65368,14706,31474,10871,50662,16904,8178,8726
42190,65378,14709,31479,10873,50668,16906,8180,8726
42195,65384,14709,31483,10873,50675,16909,8182,8727
42200,65395,14714,31490,10877,50680,16911,8183,8728
42205,65399,14715,31491,10878,50684,16912,8183,8729
42210,65409,14719,31498,10881,50689,16914,8185,8729
42215,65415,14719,31503,10881,50695,16917,8187,8730
42220,65426,14724,31509,10884,50701,16919,8187,8732
42225,65430,14726,31511,10886,50704,16920,8187,8733
42230,65440,14730,31518,10889,50709,16922,8188,8734
42235,65446,14730,31522,10889,50715,16925,8191,8734
42240,65457,14733,31526,10891,50723,16927,8192,8735
42245,65461,14734,31526,10892,50727,16928,8192,8736
42250,65471,14739,31533,10896,50732,16930,8194,8736
42255,65477,14739,31536,10896,50737,16933,8195,8738
42260,65488,14742,31540,10898,50744,16935,8196,8739
42265,65492,14745,31542,10901,50746,16936,8196,8740
42270,65502,14749,31545,10903,50751,16938,8196,8742
42275,65508,14750,31548,10904,50755,16941,8197,8744
42280,65519,14755,31552,10907,50761,16943,8198,8745
42285,65523,14758,31555,10910,50764,16944,8199,8745
42290,65533,14759,31560,10910,50772,16946,8200,8746
42295,65539,14759,31562,10910,50778,16949,8201,8748
42300,65550,14762,31567,10911,50787,16951,8203,8748
42305,65554,14763,31570,10912,50791,16952,8204,8748
42310,65564,14765,31575,10913,50797,16954,8205,8749
42315,65570,14765,31579,10913,50805,16957,8207,8750
42320,65581,14767,31583,10915,50813,16959,8208,8751
42325,65585,14768,31585,10916,50816,16960,8208,8752
42330,65595,14771,31591,10918,50823,16962,8210,8752
42335,65601,14771,31595,10918,50829,16965,8211,8754
42340,65612,14774,31603,10920,50837,16967,8213,8754
42345,65616,14774,31604,10920,50842,16968,8214,8754
42350,65626,14776,31608,10921,50849,16970,8214,8756
42355,65632,14776,31611,10921,50855,16973,8215,8758
42360,65643,14779,31618,10923,50864,16975,8217,8758
42365,65647,14779,31620,10923,50868,16976,8217,8759
42370,65657,14780,31625,10924,50877,16978,8218,8760
42375,65663,14780,31627,10924,50883,16981,8218,8763
42380,65674,14781,31633,10925,50893,16983,8219,8764
42385,65678,14781,31635,10925,50897,16984,8220,8764
42390,65688,14782,31641,10925,50906,16986,8221,8765
42395,65694,14782,31645,10925,50911,16989,8223,8766
42400,65705,14785,31650,10927,50919,16991,8223,8768
42405,65709,14787,31653,10929,50922,16992,8223,8769
42410,65719,14789,31659,10931,50930,16994,8225,8769
42415,65725,14789,31661,10931,50936,16997,8227,8770
42420,65736,14791,31663,10932,50945,16999,8227,8772
42425,65740,14792,31665,10933,50948,17000,8227,8773
42430,65750,14794,31667,10934,50956,17002,8227,8775
42435,65756,14794,31671,10934,50962,17005,8230,8775
42440,65767,14796,31676,10936,50971,17007,8231,8776
42445,65771,14797,31679,10937,50974,17008,8232,8776
42450,65781,14800,31683,10939,50981,17010,8233,8777
42455,65787,14800,31687,10939,50985,17013,8235,8778
42460,65798,14804,31692,10942,50993,17015,8236,8779
42465,65802,14806,31695,10944,50995,17016,8237,8779
42470,65812,14812,31702,10949,50998,17018,8238,8780
42475,65818,14813,31705,10950,51001,17021,8238,8783
42480,65829,14820,31708,10956,51008,17023,8238,8785
42485,65833,14822,31710,10958,51011,17024,8239,8785
42490,65843,14825,31716,10960,51017,17026,8240,8786
42495,65849,14825,31717,10960,51023,17029,8240,8789
42500,65860,14827,31723,10961,51030,17031,8242,8789
42505,65864,14828,31727,10962,51035,17032,8243,8789
42510,65874,14831,31733,10965,51042,17034,8244,8790
42515,65880,14831,31738,10965,51048,17037,8247,8790
42520,65891,14833,31744,10966,51056,17039,8248,8791
42525,65895,14834,31746,10967,51061,17040,8249,8791
42530,65905,14836,31752,10968,51068,17042,8250,8792
42535,65911,14836,31752,10968,51075,17045,8250,8795
42540,65922,14839,31756,10970,51082,17047,8251,8796
42545,65926,14839,31757,10970,51087,17048,8251,8797
42550,65936,14840,31757,10970,51096,17050,8251,8799
42555,65942,14840,31758,10970,51102,17053,8251,8802
42560,65953,14843,31767,10972,51107,17055,8253,8802
42565,65957,14844,31770,10973,51113,17056,8254,8802
42570,65967,14845,31773,10973,51122,17058,8254,8804
42575,65973,14845,31779,10973,51127,17061,8257,8804
42580,65984,14848,31785,10976,51135,17063,8258,8805
42585,65988,14848,31787,10976,51140,17064,8259,8805
42590,65998,14852,31792,10978,51146,17066,8260,8806
42595,66004,14852,31793,10978,51151,17069,8260,8809
42600,66015,14856,31799,10980,51158,17071,8261,8810
42605,66019,14856,31800,10980,51163,17072,8262,8810
42610,66029,14859,31805,10983,51169,17074,8263,8811
42615,66035,14859,31808,10983,51175,17077,8264,8813
42620,66046,14863,31813,10987,51182,17079,8264,8815
42625,66050,14865,31816,10989,51185,17080,8265,8815
42630,66060,14868,31821,10992,51192,17082,8266,8816
42635,66066,14868,31824,10992,51197,17085,8268,8817
42640,66077,14871,31827,10994,51206,17087,8269,8818
42645,66081,14872,31828,10995,51209,17088,8269,8819
42650,66091,14875,31833,10997,51216,17090,8270,8820
42655,66097,14875,31837,10997,51221,17093,8272,8821
42660,66108,14880,31844,11001,51228,17095,8274,8821
42665,66112,14881,31847,11002,51231,17096,8275,8821
42670,66122,14885,31850,11004,51237,17098,8276,8822
42675,66128,14885,31852,11004,51243,17101,8277,8824
42680,66139,14890,31859,11008,51248,17103,8278,8825
42685,66143,14891,31860,11009,51252,17104,8279,8825
42690,66153,14896,31866,11013,51257,17106,8280,8826
42695,66159,14896,31869,11013,51262,17109,8282,8827
42700,66170,14899,31871,11015,51271,17111,8283,8828
42705,66174,14900,31873,11016,51274,17112,8284,8828
42710,66184,14902,31876,11017,51281,17114,8285,8829
42715,66190,14902,31878,11017,51285,17117,8285,8832
42720,66201,14908,31882,11022,51292,17119,8286,8833
42725,66205,14910,31883,11024,51295,17120,8286,8834
42730,66215,14914,31887,11027,51300,17122,8286,8836
42735,66221,14915,31890,11028,51305,17125,8288,8837
42740,66232,14917,31895,11029,51314,17127,8290,8837
42745,66236,14918,31897,11030,51318,17128,8291,8837
42750,66246,14920,31903,11032,51325,17130,8292,8838
42755,66252,14920,31905,11032,51331,17133,8293,8840
42760,66263,14922,31912,11034,51339,17135,8295,8840
42765,66267,14923,31913,11035,51344,17136,8295,8841
42770,66277,14926,31920,11038,51349,17138,8296,8842
42775,66283,14926,31924,11038,51356,17141,8297,8844
42780,66294,14928,31929,11039,51364,17143,8298,8845
42785,66298,14928,31932,11039,51369,17144,8299,8845
42790,66308,14929,31937,11040,51378,17146,8300,8846
42795,66314,14929,31941,11040,51384,17149,8301,8848
42800,66325,14930,31946,11040,51394,17151,8301,8850
42805,66329,14930,31948,11040,51399,17152,8301,8851
42810,66339,14931,31951,11041,51408,17154,8302,8852
42815,66345,14931,31953,11041,51414,17157,8303,8854
42820,66356,14932,31956,11042,51424,17159,8304,8855
42825,66360,14932,31957,11042,51428,17160,8304,8856
42830,66370,14933,31963,11042,51436,17162,8306,8856
42835,66376,14933,31966,11042,51442,17165,8307,8858
42840,66387,14934,31970,11042,51453,17167,8308,8859
42845,66391,14934,31972,11042,51457,17168,8308,8860
42850,66401,14936,31977,11043,51464,17170,8310,8860
42855,66407,14936,31978,11043,51470,17173,8310,8863
42860,66418,14937,31983,11044,51480,17175,8311,8864
42865,66422,14938,31985,11045,51484,17176,8311,8865
42870,66432,14941,31989,11047,51490,17178,8311,8867
42875,66438,14941,31992,11047,51497,17181,8312,8869
42880,66449,14944,31999,11050,51504,17183,8312,8871
42885,66453,14945,32000,11051,51508,17184,8313,8871
42890,66463,14948,32004,11052,51515,17186,8315,8871
42895,66469,14948,32007,11052,51520,17189,8317,8872
42900,66480,14954,32014,11057,51525,17191,8318,8873
42905,66484,14956,32017,11059,51528,17192,8319,8873
42910,66494,14959,32021,11061,51535,17194,8320,8874
42915,66500,14959,32021,11061,51541,17197,8320,8877
42920,66511,14964,32029,11066,51546,17199,8321,8878
42925,66515,14967,32032,11069,51548,17200,8322,8878
42930,66525,14971,32036,11072,51554,17202,8322,8880
42935,66531,14971,32038,11072,51559,17205,8323,8882
42940,66542,14976,32042,11075,51565,17207,8324,8883
42945,66546,14977,32042,11076,51569,17208,8324,8884
42950,66556,14982,32046,11080,51574,17210,8324,8886
42955,66562,14982,32048,11080,51579,17213,8325,8888
42960,66573,14987,32053,11084,51586,17215,8326,8889
42965,66577,14987,32056,11084,51590,17216,8327,8889
42970,66587,14990,32061,11087,51597,17218,8328,8890
42975,66593,14990,32064,11087,51603,17221,8330,8891
42980,66604,14993,32069,11088,51610,17223,8330,8893
42985,66608,14994,32071,11089,51614,17224,8330,8894
42990,66618,14997,32076,11092,51620,17226,8330,8896
42995,66624,14997,32079,11092,51625,17229,8331,8898
43000,66635,15000,32084,11095,51635,17231,8333,8898
43005,66639,15001,32087,11096,51637,17232,8334,8898
43010,66649,15002,32091,11097,51647,17234,8334,8900
43015,66655,15002,32095,11097,51652,17237,8336,8901
43020,66666,15004,32100,11098,51661,17239,8336,8903
43025,66670,15005,32101,11099,51665,17240,8336,8904
43030,66680,15007,32106,11100,51672,17242,8338,8904
43035,66686,15007,32111,11100,51677,17245,8341,8904
43040,66697,15010,32119,11102,51685,17247,8342,8905
43045,66701,15010,32120,11102,51690,17248,8342,8906
43050,66711,15012,32127,11103,51698,17250,8343,8907
43055,66717,15012,32129,11103,51705,17253,8345,8908
43060,66728,15015,32135,11105,51712,17255,8346,8909
43065,66732,15015,32135,11105,51717,17256,8346,8910
43070,66742,15017,32140,11106,51724,17258,8348,8910
43075,66748,15017,32144,11106,51730,17261,8350,8911
43080,66759,15020,32146,11108,51739,17263,8350,8913
43085,66763,15021,32148,11109,51742,17264,8350,8914
43090,66773,15024,32153,11111,51749,17266,8351,8915
43095,66779,15024,32157,11111,51754,17269,8353,8916
43100,66790,15028,32161,11113,51761,17271,8354,8917
43105,66794,15028,32163,11113,51766,17272,8354,8918
43110,66804,15031,32170,11116,51773,17274,8356,8918
43115,66810,15031,32173,11116,51778,17277,8357,8920
43120,66821,15035,32178,11118,51784,17279,8359,8920
43125,66825,15036,32179,11119,51789,17280,8359,8921
43130,66835,15038,32184,11121,51797,17282,8361,8921
43135,66841,15038,32189,11121,51801,17285,8364,8921
43140,66852,15043,32195,11125,51807,17287,8365,8922
43145,66856,15045,32197,11127,51811,17288,8365,8923
43150,66866,15049,32203,11130,51817,17290,8365,8925
43155,66872,15049,32206,11130,51821,17293,8366,8927
43160,66883,15053,32210,11133,51828,17295,8367,8928
43165,66887,15056,32212,11136,51831,17296,8368,8928
43170,66897,15059,32217,11139,51837,17298,8369,8929
43175,66903,15060,32221,11140,51841,17301,8371,8930
43180,66914,15064,32222,11142,51850,17303,8372,8931
43185,66918,15065,32224,11143,51853,17304,8373,8931
43190,66928,15069,32230,11147,51858,17306,8374,8932
43195,66934,15070,32232,11148,51863,17309,8375,8934
43200,66945,15076,32240,11154,51868,17311,8375,8936
43205,66949,15077,32241,11155,51872,17312,8375,8937
43210,66959,15079,32243,11156,51880,17314,8375,8939
43215,66965,15079,32246,11156,51885,17317,8376,8941
43220,66976,15084,32255,11160,51891,17319,8378,8941
43225,66980,15085,32257,11161,51895,17320,8379,8941
43230,66990,15087,32261,11162,51903,17322,8380,8942
43235,66996,15087,32263,11162,51908,17325,8380,8945
43240,67007,15089,32272,11164,51917,17327,8382,8945
43245,67011,15089,32273,11164,51922,17328,8382,8946
43250,67021,15092,32277,11166,51928,17330,8383,8947
43255,67027,15092,32280,11166,51934,17333,8384,8949
43260,67038,15095,32288,11168,51942,17335,8385,8950
43265,67042,15095,32290,11168,51947,17336,8386,8950
43270,67052,15096,32296,11168,51956,17338,8388,8950
43275,67058,15096,32300,11168,51962,17341,8390,8951
43280,67069,15097,32305,11169,51972,17343,8392,8951
43285,67073,15097,32308,11169,51976,17344,8392,8952
43290,67083,15098,32312,11169,51985,17346,8392,8954
43295,67089,15098,32315,11169,51991,17349,8393,8956
43300,67100,15099,32322,11169,52001,17351,8394,8957
43305,67104,15099,32323,11169,52005,17352,8395,8957
43310,67114,15100,32328,11169,52014,17354,8396,8958
43315,67120,15100,32329,11169,52020,17357,8397,8960
43320,67131,15101,32332,11169,52030,17359,8397,8962
43325,67135,15102,32333,11170,52033,17360,8397,8963
43330,67145,15106,32342,11174,52039,17362,8399,8963
43335,67151,15106,32345,11174,52045,17365,8402,8963
43340,67162,15108,32351,11175,52054,17367,8403,8964
43345,67166,15109,32354,11176,52057,17368,8403,8965
43350,67176,15112,32361,11178,52063,17370,8405,8965
43355,67182,15112,32364,11178,52069,17373,8407,8966
43360,67193,15115,32370,11181,52078,17375,8409,8966
43365,67197,15115,32372,11181,52082,17376,8410,8966
43370,67207,15119,32377,11183,52087,17378,8412,8966
43375,67213,15120,32378,11184,52093,17381,8413,8968
43380,67224,15122,32383,11185,52100,17383,8415,8968
43385,67228,15125,32384,11188,52103,17384,8415,8969
43390,67238,15129,32389,11191,52108,17386,8416,8970
43395,67244,15129,32391,11191,52113,17389,8417,8972
43400,67255,15133,32394,11195,52122,17391,8417,8974
43405,67259,15134,32398,11196,52124,17392,8418,8974
43410,67269,15138,32405,11200,52130,17394,8418,8976
43415,67275,15138,32406,11200,52136,17397,8418,8979
43420,67286,15140,32408,11200,52145,17399,8418,8981
43425,67290,15140,32410,11200,52150,17400,8419,8981
43430,67300,15144,32418,11203,52154,17402,8420,8982
43435,67306,15144,32422,11203,52161,17405,8423,8982
43440,67317,15147,32427,11205,52168,17407,8424,8983
43445,67321,15149,32429,11207,52171,17408,8424,8984
43450,67331,15153,32434,11210,52177,17410,8425,8985
43455,67337,15153,32437,11210,52183,17413,8427,8986
43460,67348,15158,32444,11215,52188,17415,8428,8987
43465,67352,15158,32447,11215,52193,17416,8429,8987
43470,67362,15160,32449,11215,52202,17418,8429,8989
43475,67368,15160,32453,11215,52206,17421,8431,8990
43480,67379,15163,32457,11216,52216,17423,8433,8990
43485,67383,15163,32457,11216,52220,17424,8433,8991
43490,67393,15165,32463,11217,52228,17426,8435,8991
43495,67399,15165,32466,11217,52233,17429,8437,8992
43500,67410,15170,32471,11220,52239,17431,8438,8993
43505,67414,15170,32472,11220,52244,17432,8438,8994
43510,67424,15174,32477,11224,52250,17434,8438,8996
43515,67430,15174,32479,11224,52255,17437,8438,8999
43520,67441,15180,32486,11229,52260,17439,8439,9000
43525,67445,15181,32487,11230,52264,17440,8440,9000
43530,67455,15185,32492,11233,52270,17442,8441,9001
43535,67461,15185,32495,11233,52276,17445,8443,9002
43540,67472,15187,32500,11233,52284,17447,8444,9003
43545,67476,15187,32502,11233,52289,17448,8445,9003
43550,67486,15189,32507,11235,52297,17450,8446,9004
43555,67492,15189,32511,11235,52302,17453,8448,9005
43560,67503,15191,32514,11235,52311,17455,8449,9006
43565,67507,15192,32515,11236,52315,17456,8449,9007
43570,67517,15194,32520,11238,52323,17458,8450,9008
43575,67523,15194,32523,11238,52328,17461,8452,9009
43580,67534,15196,32528,11239,52337,17463,8454,9009
43585,67538,15197,32530,11240,52340,17464,8454,9010
43590,67548,15199,32534,11241,52349,17466,8455,9011
43595,67554,15199,32537,11241,52354,17469,8456,9013
43600,67565,15202,32544,11243,52363,17471,8457,9014
43605,67569,15203,32546,11244,52366,17472,8457,9015
43610,67579,15205,32552,11246,52374,17474,8459,9015
43615,67585,15205,32556,11246,52380,17477,8462,9015
43620,67596,15208,32564,11249,52388,17479,8464,9015
43625,67600,15209,32565,11250,52391,17480,8464,9016
43630,67610,15211,32572,11252,52399,17482,8466,9016
43635,67616,15211,32576,11252,52404,17485,8468,9017
43640,67627,15216,32582,11257,52410,17487,8468,9019
43645,67631,15219,32586,11260,52412,17488,8469,9019
43650,67641,15223,32589,11262,52418,17490,8470,9020
43655,67647,15223,32593,11262,52423,17493,8473,9020
43660,67658,15227,32596,11264,52431,17495,8475,9020
43665,67662,15227,32597,11264,52435,17496,8476,9020
43670,67672,15229,32601,11265,52442,17498,8477,9021
43675,67678,15229,32605,11265,52447,17501,8479,9022
43680,67689,15236,32610,11271,52453,17503,8480,9023
43685,67693,15237,32612,11272,52456,17504,8481,9023
43690,67703,15239,32612,11272,52464,17506,8481,9025
43695,67709,15239,32615,11272,52468,17509,8482,9027
43700,67720,15244,32618,11276,52475,17511,8482,9029
43705,67724,15246,32620,11278,52478,17512,8483,9029
43710,67734,15250,32627,11282,52483,17514,8485,9029
43715,67740,15251,32632,11283,52486,17517,8487,9030
43720,67751,15257,32636,11288,52492,17519,8487,9032
43725,67755,15259,32638,11290,52495,17520,8488,9032
43730,67765,15260,32642,11291,52505,17522,8489,9033
43735,67771,15260,32645,11291,52510,17525,8490,9035
43740,67782,15262,32649,11291,52518,17527,8490,9037
43745,67786,15263,32651,11292,52523,17528,8490,9038
43750,67796,15264,32656,11293,52531,17530,8490,9040
43755,67802,15264,32659,11293,52537,17533,8492,9041
43760,67813,15266,32664,11294,52546,17535,8493,9042
43765,67817,15266,32665,11294,52551,17536,8494,9042
43770,67827,15268,32668,11295,52559,17538,8494,9044
43775,67833,15268,32672,11295,52564,17541,8497,9044
43780,67844,15270,32675,11295,52573,17543,8499,9044
43785,67848,15270,32678,11295,52578,17544,8500,9044
43790,67858,15271,32681,11295,52587,17546,8501,9045
43795,67864,15271,32684,11295,52592,17549,8501,9048
43800,67875,15273,32687,11296,52601,17551,8501,9050
43805,67879,15273,32690,11296,52606,17552,8502,9050
43810,67889,15276,32696,11298,52612,17554,8503,9051
43815,67895,15276,32698,11298,52619,17557,8504,9053
43820,67906,15279,32707,11301,52625,17559,8506,9053
43825,67910,15280,32709,11302,52630,17560,8506,9054
43830,67920,15283,32715,11305,52637,17562,8507,9055
43835,67926,15283,32718,11305,52642,17565,8508,9057
43840,67937,15286,32725,11308,52650,17567,8510,9057
43845,67941,15287,32726,11309,52654,17568,8511,9057
43850,67951,15289,32727,11309,52661,17570,8511,9059
43855,67957,15289,32730,11309,52667,17573,8512,9061
43860,67968,15293,32735,11311,52674,17575,8513,9062
43865,67972,15295,32736,11313,52677,17576,8513,9063
43870,67982,15299,32742,11316,52682,17578,8513,9065
43875,67988,15299,32745,11316,52688,17581,8515,9066
43880,67999,15305,32752,11320,52692,17583,8516,9067
43885,68003,15307,32754,11322,52696,17584,8517,9067
43890,68013,15310,32759,11324,52703,17586,8519,9067
43895,68019,15310,32764,11324,52708,17589,8522,9067
43900,68030,15315,32768,11328,52714,17591,8522,9069
43905,68034,15318,32770,11331,52716,17592,8522,9070
43910,68044,15322,32775,11334,52722,17594,8522,9072
43915,68050,15322,32777,11334,52728,17597,8524,9073
43920,68061,15326,32782,11336,52734,17599,8525,9074
43925,68065,15328,32784,11338,52737,17600,8525,9075
43930,68075,15330,32790,11339,52745,17602,8526,9076
43935,68081,15330,32792,11339,52749,17605,8526,9079
43940,68092,15333,32795,11341,52757,17607,8526,9081
43945,68096,15335,32797,11343,52760,17608,8526,9082
43950,68106,15336,32799,11343,52769,17610,8527,9083
43955,68112,15336,32802,11343,52776,17613,8528,9085
43960,68123,15337,32808,11344,52786,17615,8529,9086
43965,68127,15337,32811,11344,52790,17616,8530,9086
43970,68137,15338,32815,11345,52799,17618,8531,9087
43975,68143,15338,32817,11345,52805,17621,8531,9090
43980,68154,15339,32820,11346,52815,17623,8531,9092
43985,68158,15339,32822,11346,52819,17624,8532,9092
43990,68168,15340,32827,11346,52827,17626,8534,9092
43995,68174,15340,32832,11346,52833,17629,8537,9092
44000,68185,15341,32841,11347,52844,17631,8539,9092
44005,68189,15341,32842,11347,52848,17632,8539,9093
44010,68199,15342,32845,11348,52857,17634,8539,9095
44015,68205,15342,32846,11348,52863,17637,8540,9097
44020,68216,15343,32850,11348,52873,17639,8541,9098
44025,68220,15343,32852,11348,52877,17640,8542,9098
44030,68230,15345,32859,11350,52885,17642,8544,9098
44035,68236,15345,32860,11350,52891,17645,8544,9101
44040,68247,15348,32865,11353,52899,17647,8545,9102
44045,68251,15348,32868,11353,52903,17648,8546,9102
44050,68261,15351,32875,11356,52909,17650,8547,9103
44055,68267,15351,32877,11356,52914,17653,8548,9105
44060,68278,15356,32883,11360,52920,17655,8550,9105
44065,68282,15359,32884,11363,52923,17656,8550,9106
44070,68292,15363,32887,11365,52927,17658,8550,9108
44075,68298,15364,32888,11366,52934,17661,8551,9110
44080,68309,15368,32894,11368,52939,17663,8553,9110
44085,68313,15371,32896,11371,52941,17664,8553,9111
44090,68323,15376,32901,11375,52946,17666,8554,9112
44095,68329,15376,32903,11375,52950,17669,8554,9115
44100,68340,15384,32907,11381,52955,17671,8554,9117
44105,68344,15385,32909,11382,52959,17672,8555,9117
44110,68354,15387,32914,11384,52966,17674,8556,9118
44115,68360,15387,32916,11384,52973,17677,8557,9120
44120,68371,15389,32918,11385,52982,17679,8557,9122
44125,68375,15389,32920,11385,52986,17680,8558,9122
44130,68385,15391,32925,11387,52993,17682,8559,9123
44135,68391,15391,32927,11387,53000,17685,8560,9125
44140,68402,15394,32933,11390,53006,17687,8560,9127
44145,68406,15395,32936,11391,53010,17688,8561,9127
44150,68416,15397,32940,11392,53018,17690,8563,9127
44155,68422,15397,32941,11392,53025,17693,8564,9129
44160,68433,15400,32947,11394,53031,17695,8566,9129
44165,68437,15401,32951,11395,53035,17696,8567,9129
44170,68447,15403,32957,11397,53042,17698,8567,9131
44175,68453,15403,32961,11397,53049,17701,8568,9133
44180,68464,15405,32966,11398,53059,17703,8570,9133
44185,68468,15406,32968,11399,53062,17704,8570,9134
44190,68478,15409,32975,11401,53068,17706,8571,9135
44195,68484,15409,32978,11401,53075,17709,8573,9136
44200,68495,15411,32983,11403,53084,17711,8573,9138
44205,68499,15412,32984,11404,53087,17712,8573,9139
44210,68509,15415,32990,11407,53093,17714,8574,9140
44215,68515,15415,32994,11407,53099,17717,8577,9140
44220,68526,15419,32999,11409,53105,17719,8578,9141
44225,68530,15421,33001,11411,53109,17720,8579,9141
44230,68540,15424,33003,11412,53115,17722,8580,9142
44235,68546,15424,33006,11412,53120,17725,8581,9144
44240,68557,15428,33011,11415,53127,17727,8581,9146
44245,68561,15430,33012,11417,53131,17728,8581,9147
44250,68571,15433,33018,11418,53137,17730,8583,9147
44255,68577,15433,33019,11418,53144,17733,8584,9149
44260,68588,15436,33024,11420,53151,17735,8586,9149
44265,68592,15437,33024,11421,53155,17736,8586,9150
44270,68602,15439,33027,11421,53162,17738,8587,9151
44275,68608,15439,33031,11421,53168,17741,8588,9153
44280,68619,15443,33037,11424,53176,17743,8590,9153
44285,68623,15443,33039,11424,53180,17744,8591,9153
44290,68633,15447,33043,11427,53185,17746,8591,9155
44295,68639,15447,33047,11427,53192,17749,8594,9155
44300,68650,15449,33052,11428,53201,17751,8595,9156
44305,68654,15451,33055,11430,53203,17752,8596,9156
44310,68664,15455,33058,11432,53208,17754,8597,9157
44315,68670,15455,33063,11432,53214,17757,8600,9157
44320,68681,15459,33066,11435,53222,17759,8600,9159
44325,68685,15460,33068,11436,53225,17760,8600,9160
44330,68695,15463,33073,11439,53231,17762,8601,9161
44335,68701,15463,33077,11439,53237,17765,8604,9161
44340,68712,15469,33084,11443,53243,17767,8606,9161
44345,68716,15471,33088,11445,53245,17768,8607,9161
44350,68726,15474,33092,11447,53251,17770,8608,9162
44355,68732,15474,33097,11447,53256,17773,8611,9162
44360,68743,15479,33100,11451,53263,17775,8611,9164
44365,68747,15482,33103,11454,53264,17776,8611,9165
44370,68757,15488,33109,11460,53268,17778,8612,9166
44375,68763,15488,33112,11460,53274,17781,8613,9168
44380,68774,15489,33117,11460,53283,17783,8613,9170
44385,68778,15489,33119,11460,53288,17784,8614,9170
44390,68788,15490,33121,11460,53297,17786,8615,9171
44395,68794,15490,33123,11460,53304,17789,8616,9173
44400,68805,15491,33129,11461,53312,17791,8618,9173
44405,68809,15491,33131,11461,53318,17792,8619,9173
44410,68819,15492,33136,11461,53326,17794,8621,9173
44415,68825,15492,33138,11461,53332,17797,8623,9174
44420,68836,15493,33144,11462,53341,17799,8624,9175
44425,68840,15493,33146,11462,53347,17800,8625,9175
44430,68850,15494,33150,11462,53355,17802,8625,9177
44435,68856,15494,33152,11462,53361,17805,8626,9179
44440,68867,15495,33157,11462,53371,17807,8626,9181
44445,68871,15495,33159,11462,53375,17808,8626,9182
44450,68881,15496,33162,11463,53383,17810,8626,9184
44455,68887,15496,33165,11463,53390,17813,8627,9186
44460,68898,15497,33170,11463,53401,17815,8628,9187
44465,68902,15497,33172,11463,53405,17816,8628,9188
44470,68912,15498,33178,11464,53412,17818,8629,9189
44475,68918,15498,33180,11464,53420,17821,8631,9190
44480,68929,15501,33185,11466,53426,17823,8632,9191
44485,68933,15502,33187,11467,53431,17824,8633,9191
44490,68943,15504,33191,11467,53438,17826,8634,9192
44495,68949,15504,33193,11467,53444,17829,8634,9195
44500,68960,15507,33198,11469,53452,17831,8635,9196
44505,68964,15507,33199,11469,53457,17832,8635,9197
44510,68974,15509,33201,11470,53464,17834,8635,9199
44515,68980,15509,33202,11470,53470,17837,8635,9202
44520,68991,15512,33210,11471,53475,17839,8637,9202
44525,68995,15513,33212,11472,53482,17840,8637,9203
44530,69005,15517,33216,11474,53487,17842,8637,9205
44535,69011,15517,33217,11474,53494,17845,8638,9207
44540,69022,15520,33221,11476,53502,17847,8638,9209
44545,69026,15521,33223,11477,53505,17848,8638,9210
44550,69036,15523,33224,11477,53512,17850,8638,9212
44555,69042,15523,33227,11477,53518,17853,8639,9214
44560,69053,15528,33232,11480,53525,17855,8640,9215
44565,69057,15528,33235,11480,53529,17856,8641,9215
44570,69067,15531,33238,11482,53535,17858,8642,9216
44575,69073,15531,33240,11482,53542,17861,8643,9218
44580,69084,15533,33243,11484,53551,17863,8644,9219
44585,69088,15533,33245,11484,53555,17864,8645,9219
44590,69098,15535,33249,11486,53563,17866,8645,9221
44595,69104,15535,33251,11486,53568,17869,8646,9223
44600,69115,15539,33256,11489,53575,17871,8647,9224
44605,69119,15541,33258,11491,53578,17872,8648,9224
44610,69129,15543,33261,11492,53586,17874,8650,9224
44615,69135,15543,33264,11492,53591,17877,8651,9226
44620,69146,15549,33273,11497,53596,17879,8652,9227
44625,69150,15552,33276,11500,53598,17880,8652,9228
44630,69160,15557,33282,11504,53601,17882,8652,9230
44635,69166,15558,33286,11505,53604,17885,8653,9232
44640,69177,15564,33290,11510,53611,17887,8654,9233
44645,69181,15566,33290,11512,53615,17888,8654,9234
44650,69191,15570,33294,11515,53621,17890,8655,9235
44655,69197,15570,33297,11515,53625,17893,8656,9237
44660,69208,15575,33302,11518,53632,17895,8657,9238
44665,69212,15575,33304,11518,53636,17896,8657,9239
44670,69222,15578,33309,11521,53644,17898,8658,9240
44675,69228,15578,33314,11521,53648,17901,8661,9240
44680,69239,15581,33321,11523,53656,17903,8661,9242
44685,69243,15582,33324,11524,53660,17904,8662,9242
44690,69253,15584,33327,11525,53668,17906,8662,9244
44695,69259,15584,33329,11525,53673,17909,8663,9246
44700,69270,15586,33335,11525,53681,17911,8665,9246
44705,69274,15586,33336,11525,53688,17912,8665,9247
44710,69284,15588,33339,11526,53696,17914,8665,9249
44715,69290,15588,33340,11526,53702,17917,8665,9252
44720,69301,15590,33346,11527,53709,17919,8666,9253
44725,69305,15590,33346,11527,53715,17920,8666,9254
44730,69315,15592,33351,11528,53722,17922,8668,9254
44735,69321,15592,33353,11528,53729,17925,8668,9257
44740,69332,15595,33359,11531,53736,17927,8669,9258
44745,69336,15596,33362,11532,53739,17928,8669,9259
44750,69346,15598,33368,11534,53747,17930,8670,9260
44755,69352,15598,33371,11534,53754,17933,8671,9262
44760,69363,15600,33376,11535,53763,17935,8672,9263
44765,69367,15601,33379,11536,53766,17936,8673,9263
44770,69377,15604,33383,11539,53773,17938,8674,9264
44775,69383,15604,33384,11539,53778,17941,8674,9267
44780,69394,15607,33388,11540,53786,17943,8675,9268
44785,69398,15609,33391,11542,53789,17944,8676,9268
44790,69408,15612,33396,11545,53796,17946,8677,9269
44795,69414,15612,33399,11545,53802,17949,8679,9270
44800,69425,15614,33401,11546,53811,17951,8679,9272
44805,69429,15615,33402,11547,53814,17952,8679,9273
44810,69439,15618,33407,11549,53821,17954,8679,9275
44815,69445,15618,33411,11549,53826,17957,8681,9276
44820,69456,15623,33417,11553,53832,17959,8681,9278
44825,69460,15624,33417,11554,53836,17960,8681,9279
44830,69470,15627,33421,11556,53842,17962,8681,9281
44835,69476,15627,33423,11556,53849,17965,8683,9282
44840,69487,15629,33428,11557,53857,17967,8684,9283
44845,69491,15630,33430,11558,53861,17968,8684,9284
44850,69501,15634,33436,11560,53867,17970,8686,9284
44855,69507,15634,33441,11560,53871,17973,8688,9285
44860,69518,15640,33448,11565,53876,17975,8690,9285
44865,69522,15642,33450,11567,53879,17976,8691,9285
44870,69532,15646,33454,11571,53885,17978,8691,9287
44875,69538,15647,33456,11572,53890,17981,8692,9289
44880,69549,15650,33458,11573,53897,17983,8692,9291
44885,69553,15653,33459,11576,53900,17984,8692,9292
44890,69563,15658,33467,11581,53904,17986,8694,9292
44895,69569,15658,33470,11581,53909,17989,8695,9294
44900,69580,15662,33475,11584,53917,17991,8697,9294
44905,69584,15664,33476,11586,53920,17992,8697,9295
44910,69594,15668,33481,11589,53926,17994,8697,9297
44915,69600,15668,33483,11589,53932,17997,8698,9299
44920,69611,15670,33484,11589,53941,17999,8699,9300
44925,69615,15670,33486,11589,53945,18000,8699,9301
44930,69625,15672,33490,11590,53952,18002,8700,9302
44935,69631,15672,33493,11590,53958,18005,8701,9304
44940,69642,15675,33498,11592,53967,18007,8702,9305
44945,69646,15676,33502,11593,53970,18008,8703,9305
44950,69656,15677,33505,11593,53979,18010,8704,9306
44955,69662,15677,33508,11593,53984,18013,8705,9308
44960,69673,15680,33513,11595,53993,18015,8706,9309
44965,69677,15681,33516,11596,53996,18016,8706,9310
44970,69687,15682,33521,11596,54004,18018,8707,9311
44975,69693,15682,33524,11596,54011,18021,8709,9312
44980,69704,15685,33528,11597,54019,18023,8709,9314
44985,69708,15686,33531,11598,54021,18024,8709,9315
44990,69718,15689,33536,11600,54029,18026,8709,9317
44995,69724,15689,33538,11600,54035,18029,8711,9318
45000,69735,15691,33545,11601,54042,18031,8712,9319
45005,69739,15691,33546,11601,54048,18032,8713,9319
45010,69749,15693,33550,11603,54055,18034,8714,9320
45015,69755,15693,33553,11603,54062,18037,8717,9320
45020,69766,15697,33559,11606,54068,18039,8718,9321
45025,69770,15697,33559,11606,54073,18040,8718,9322
45030,69780,15700,33566,11609,54079,18042,8720,9322
45035,69786,15700,33570,11609,54084,18045,8722,9323
45040,69797,15703,33574,11611,54092,18047,8723,9324
45045,69801,15704,33576,11612,54096,18048,8723,9325
45050,69811,15707,33581,11613,54102,18050,8724,9326
45055,69817,15707,33584,11613,54109,18053,8725,9328
45060,69828,15710,33589,11615,54116,18055,8726,9329
45065,69832,15710,33590,11615,54122,18056,8726,9330
45070,69842,15712,33592,11616,54130,18058,8726,9332
45075,69848,15712,33596,11616,54136,18061,8729,9332
45080,69859,15716,33603,11620,54141,18063,8730,9333
45085,69863,15716,33604,11620,54147,18064,8730,9334
45090,69873,15719,33607,11622,54153,18066,8730,9336
45095,69879,15719,33612,11622,54159,18069,8733,9336
45100,69890,15721,33614,11623,54168,18071,8733,9338
45105,69894,15722,33617,11624,54172,18072,8734,9338
45110,69904,15726,33625,11628,54177,18074,8736,9338
45115,69910,15726,33629,11628,54183,18077,8738,9339
45120,69921,15730,33634,11631,54190,18079,8738,9341
45125,69925,15731,33636,11632,54194,18080,8738,9342
45130,69935,15733,33640,11633,54202,18082,8739,9343
45135,69941,15733,33644,11633,54208,18085,8741,9344
45140,69952,15735,33651,11634,54216,18087,8743,9344
45145,69956,15736,33653,11635,54220,18088,8743,9345
45150,69966,15738,33656,11636,54227,18090,8744,9346
45155,69972,15738,33661,11636,54233,18093,8746,9347
45160,69983,15742,33667,11640,54240,18095,8746,9349
45165,69987,15744,33671,11642,54243,18096,8747,9349
45170,69997,15746,33677,11642,54250,18098,8748,9350
45175,70003,15746,33681,11642,54256,18101,8750,9351
45180,70014,15749,33686,11645,54265,18103,8752,9351
45185,70018,15749,33687,11645,54269,18104,8752,9352
45190,70028,15751,33690,11646,54277,18106,8754,9352
45195,70034,15751,33693,11646,54283,18109,8756,9353
45200,70045,15753,33698,11647,54291,18111,8757,9354
45205,70049,15755,33702,11649,54294,18112,8758,9354
45210,70059,15758,33707,11651,54300,18114,8758,9356
45215,70065,15758,33711,11651,54305,18117,8760,9357
45220,70076,15762,33717,11654,54313,18119,8761,9358
45225,70080,15764,33718,11656,54316,18120,8761,9359
45230,70090,15766,33722,11658,54323,18122,8762,9360
45235,70096,15767,33725,11659,54327,18125,8763,9362
45240,70107,15774,33733,11665,54330,18127,8764,9363
45245,70111,15776,33735,11667,54335,18128,8765,9363
45250,70121,15778,33738,11669,54343,18130,8766,9364
45255,70127,15778,33739,11669,54348,18133,8766,9367
45260,70138,15781,33746,11671,54355,18135,8766,9369
45265,70142,15782,33748,11672,54359,18136,8766,9370
45270,70152,15784,33753,11674,54368,18138,8766,9372
45275,70158,15784,33756,11674,54372,18141,8766,9375
45280,70169,15786,33763,11674,54380,18143,8768,9375
45285,70173,15786,33765,11674,54386,18144,8768,9376
45290,70183,15787,33770,11674,54394,18146,8770,9376
45295,70189,15787,33771,11674,54402,18149,8771,9378
45300,70200,15789,33775,11675,54411,18151,8773,9378
45305,70204,15789,33777,11675,54414,18152,8773,9379
45310,70214,15790,33781,11676,54423,18154,8773,9381
45315,70220,15790,33783,11676,54430,18157,8773,9384
45320,70231,15793,33790,11678,54436,18159,8775,9384
45325,70235,15793,33791,11678,54442,18160,8776,9384
45330,70245,15794,33797,11679,54449,18162,8777,9385
45335,70251,15794,33799,11679,54456,18165,8778,9387
45340,70262,15797,33805,11682,54465,18167,8778,9389
45345,70266,15797,33805,11682,54469,18168,8778,9390
45350,70276,15799,33807,11682,54476,18170,8778,9392
45355,70282,15799,33810,11682,54483,18173,8780,9393
45360,70293,15802,33814,11683,54490,18175,8782,9393
45365,70297,15803,33815,11684,54494,18176,8782,9394
45370,70307,15805,33819,11685,54501,18178,8784,9394
45375,70313,15805,33821,11685,54508,18181,8786,9395
45380,70324,15809,33827,11687,54515,18183,8788,9395
45385,70328,15810,33829,11688,54518,18184,8788,9396
45390,70338,15813,33834,11690,54524,18186,8789,9397
45395,70344,15813,33835,11690,54530,18189,8789,9400
45400,70355,15817,33839,11692,54537,18191,8790,9401
45405,70359,15819,33841,11694,54540,18192,8791,9401
45410,70369,15821,33846,11696,54547,18194,8791,9403
45415,70375,15821,33851,11696,54552,18197,8794,9403
45420,70386,15824,33856,11699,54561,18199,8794,9405
45425,70390,15824,33858,11699,54566,18200,8795,9405
45430,70400,15828,33862,11702,54571,18202,8795,9407
45435,70406,15828,33865,11702,54578,18205,8798,9407
45440,70417,15832,33869,11704,54584,18207,8798,9409
45445,70421,15834,33872,11706,54587,18208,8799,9409
45450,70431,15837,33875,11707,54594,18210,8800,9410
45455,70437,15837,33877,11707,54599,18213,8801,9412
45460,70448,15842,33884,11712,54605,18215,8802,9413
45465,70452,15845,33887,11715,54607,18216,8802,9414
45470,70462,15848,33891,11717,54614,18218,8803,9415
45475,70468,15848,33892,11717,54619,18221,8803,9418
45480,70479,15852,33899,11720,54626,18223,8805,9418
45485,70483,15853,33899,11721,54630,18224,8805,9419
45490,70493,15859,33906,11726,54633,18226,8806,9420
45495,70499,15859,33909,11726,54639,18229,8807,9422
45500,70510,15863,33912,11728,54647,18231,8808,9423
45505,70514,15864,33914,11729,54650,18232,8808,9424
45510,70524,15867,33918,11731,54657,18234,8809,9425
45515,70530,15867,33921,11731,54661,18237,8810,9427
45520,70541,15872,33929,11735,54669,18239,8812,9427
45525,70545,15873,33931,11736,54672,18240,8813,9427
45530,70555,15875,33936,11738,54679,18242,8814,9428
45535,70561,15875,33940,11738,54684,18245,8816,9429
45540,70572,15878,33945,11740,54692,18247,8816,9431
45545,70576,15879,33946,11741,54697,18248,8816,9432
45550,70586,15881,33951,11742,54704,18250,8817,9433
45555,70592,15881,33954,11742,54708,18253,8818,9435
45560,70603,15883,33961,11744,54718,18255,8820,9435
45565,70607,15883,33962,11744,54724,18256,8820,9436
45570,70617,15886,33968,11747,54731,18258,8821,9437
45575,70623,15886,33971,11747,54736,18261,8823,9438
45580,70634,15888,33975,11748,54746,18263,8824,9439
45585,70638,15888,33975,11748,54750,18264,8824,9440
45590,70648,15890,33980,11750,54757,18266,8826,9440
45595,70654,15890,33981,11750,54763,18269,8827,9442
45600,70665,15892,33986,11751,54772,18271,8828,9443
45605,70669,15893,33987,11752,54776,18272,8828,9444
45610,70679,15895,33991,11754,54783,18274,8828,9446
45615,70685,15895,33993,11754,54790,18277,8830,9447
45620,70696,15897,33998,11755,54798,18279,8830,9449
45625,70700,15898,34000,11756,54802,18280,8830,9450
45630,70710,15900,34006,11756,54808,18282,8832,9450
45635,70716,15900,34008,11756,54816,18285,8833,9452
45640,70727,15903,34011,11757,54823,18287,8834,9453
45645,70731,15904,34014,11758,54826,18288,8835,9453
45650,70741,15907,34017,11760,54834,18290,8836,9454
45655,70747,15907,34019,11760,54839,18293,8837,9456
45660,70758,15910,34023,11762,54848,18295,8839,9456
45665,70762,15911,34026,11763,54850,18296,8840,9456
45670,70772,15914,34031,11765,54857,18298,8842,9456
45675,70778,15914,34035,11765,54863,18301,8844,9457
45680,70789,15918,34041,11767,54868,18303,8845,9458
45685,70793,15919,34043,11768,54873,18304,8846,9458
45690,70803,15922,34044,11769,54881,18306,8846,9460
45695,70809,15922,34048,11769,54885,18309,8848,9461
45700,70820,15926,34054,11772,54891,18311,8848,9463
45705,70824,15928,34057,11774,54896,18312,8848,9464
45710,70834,15930,34063,11775,54903,18314,8849,9465
45715,70840,15930,34066,11775,54908,18317,8850,9467
45720,70851,15935,34073,11779,54915,18319,8851,9468
45725,70855,15937,34076,11781,54918,18320,8852,9468
45730,70865,15941,34082,11784,54923,18322,8853,9469
45735,70871,15941,34085,11784,54930,18325,8854,9471
45740,70882,15945,34090,11787,54937,18327,8856,9471
45745,70886,15947,34094,11789,54939,18328,8857,9471
45750,70896,15949,34098,11789,54946,18330,8858,9472
45755,70902,15949,34101,11789,54953,18333,8860,9473
45760,70913,15952,34104,11792,54961,18335,8860,9475
45765,70917,15954,34106,11794,54963,18336,8860,9476
45770,70927,15956,34110,11796,54971,18338,8860,9478
45775,70933,15956,34114,11796,54976,18341,8862,9479
45780,70944,15962,34122,11801,54981,18343,8863,9480
45785,70948,15963,34123,11802,54985,18344,8863,9481
45790,70958,15965,34128,11803,54992,18346,8864,9482
45795,70964,15965,34129,11803,54999,18349,8865,9484
45800,70975,15969,34136,11807,55006,18351,8866,9485
45805,70979,15971,34139,11809,55008,18352,8866,9486
45810,70989,15975,34144,11811,55013,18354,8866,9488
45815,70995,15975,34147,11811,55019,18357,8868,9489
45820,71006,15980,34153,11815,55026,18359,8869,9490
45825,71010,15981,34154,11816,55029,18360,8869,9491
45830,71020,15984,34157,11817,55035,18362,8870,9492
45835,71026,15984,34160,11817,55040,18365,8872,9493
45840,71037,15989,34164,11821,55048,18367,8874,9493
45845,71041,15989,34167,11821,55051,18368,8875,9493
45850,71051,15992,34173,11823,55057,18370,8876,9494
45855,71057,15992,34176,11823,55063,18373,8878,9495
45860,71068,15995,34180,11826,55072,18375,8878,9497
45865,71072,15995,34182,11826,55077,18376,8879,9497
45870,71082,15996,34187,11827,55085,18378,8880,9498
45875,71088,15996,34188,11827,55091,18381,8880,9501
45880,71099,15998,34192,11827,55101,18383,8881,9502
45885,71103,15998,34194,11827,55104,18384,8882,9502
45890,71113,15999,34198,11827,55113,18386,8883,9503
45895,71119,15999,34201,11827,55118,18389,8885,9504
45900,71130,16001,34206,11829,55128,18391,8886,9505
45905,71134,16002,34209,11830,55132,18392,8887,9505
45910,71144,16004,34217,11832,55138,18394,8888,9506
45915,71150,16004,34221,11832,55145,18397,8889,9508
45920,71161,16006,34228,11833,55154,18399,8891,9508
45925,71165,16007,34231,11834,55158,18400,8892,9508
45930,71175,16010,34236,11837,55164,18402,8893,9509
45935,71181,16010,34238,11837,55171,18405,8895,9510
45940,71192,16012,34242,11838,55179,18407,8896,9511
45945,71196,16012,34244,11838,55184,18408,8897,9511
45950,71206,16016,34250,11840,55189,18410,8899,9511
45955,71212,16016,34255,11840,55194,18413,8902,9511
45960,71223,16020,34261,11843,55202,18415,8903,9512
45965,71227,16021,34262,11844,55206,18416,8904,9512
45970,71237,16023,34265,11844,55214,18418,8905,9513
45975,71243,16023,34266,11844,55220,18421,8906,9515
45980,71254,16024,34273,11845,55229,18423,8908,9515
45985,71258,16025,34277,11846,55233,18424,8909,9515
45990,71268,16027,34283,11847,55241,18426,8910,9516
45995,71274,16027,34286,11847,55246,18429,8911,9518
46000,71285,16030,34293,11850,55255,18431,8912,9519
46005,71289,16030,34296,11850,55259,18432,8912,9520
46010,71299,16032,34300,11850,55266,18434,8914,9520
46015,71305,16032,34302,11850,55273,18437,8916,9521
46020,71316,16034,34308,11852,55281,18439,8918,9521
46025,71320,16035,34308,11853,55285,18440,8918,9522
46030,71330,16038,34313,11855,55291,18442,8919,9523
46035,71336,16038,34317,11855,55297,18445,8922,9523
46040,71347,16040,34321,11857,55307,18447,8922,9525
46045,71351,16041,34324,11858,55310,18448,8923,9525
46050,71361,16044,34331,11861,55316,18450,8924,9526
46055,71367,16044,34334,11861,55322,18453,8926,9527
46060,71378,16046,34339,11862,55331,18455,8928,9527
46065,71382,16048,34341,11864,55334,18456,8928,9528
46070,71392,16052,34344,11866,55339,18458,8928,9530
46075,71398,16053,34348,11867,55342,18461,8929,9532
46080,71409,16058,34351,11871,55350,18463,8930,9533
46085,71413,16060,34352,11873,55353,18464,8930,9534
46090,71423,16062,34354,11874,55361,18466,8931,9535
46095,71429,16062,34355,11874,55366,18469,8931,9538
46100,71440,16066,34361,11878,55372,18471,8932,9539
46105,71444,16068,34363,11880,55375,18472,8932,9540
46110,71454,16070,34367,11882,55383,18474,8932,9542
46115,71460,16070,34371,11882,55389,18477,8935,9542
46120,71471,16072,34376,11883,55399,18479,8937,9542
46125,71475,16072,34377,11883,55402,18480,8937,9543
46130,71485,16074,34382,11885,55410,18482,8938,9544
46135,71491,16074,34385,11885,55415,18485,8939,9546
46140,71502,16076,34391,11887,55424,18487,8940,9547
46145,71506,16076,34393,11887,55430,18488,8940,9548
46150,71516,16078,34398,11889,55437,18490,8941,9549
46155,71522,16078,34402,11889,55443,18493,8944,9549
46160,71533,16080,34409,11890,55451,18495,8946,9549
46165,71537,16080,34411,11890,55457,18496,8947,9549
46170,71547,16081,34413,11890,55466,18498,8948,9550
46175,71553,16081,34414,11890,55472,18501,8949,9552
46180,71564,16084,34424,11893,55477,18503,8950,9553
46185,71568,16085,34426,11894,55483,18504,8950,9554
46190,71578,16086,34430,11895,55491,18506,8950,9556
46195,71584,16086,34431,11895,55498,18509,8951,9558
46200,71595,16089,34435,11896,55506,18511,8951,9560
46205,71599,16089,34437,11896,55510,18512,8952,9560
46210,71609,16091,34445,11898,55517,18514,8954,9560
46215,71615,16091,34450,11898,55523,18517,8957,9560
46220,71626,16096,34456,11902,55529,18519,8957,9562
46225,71630,16097,34457,11903,55533,18520,8958,9562
46230,71640,16099,34460,11904,55540,18522,8959,9563
46235,71646,16099,34461,11904,55547,18525,8960,9565
46240,71657,16102,34467,11907,55555,18527,8961,9566
46245,71661,16104,34470,11909,55557,18528,8962,9566
46250,71671,16106,34473,11909,55564,18530,8963,9567
46255,71677,16106,34475,11909,55570,18533,8964,9569
46260,71688,16111,34481,11914,55577,18535,8964,9571
46265,71692,16112,34483,11915,55580,18536,8965,9571
46270,71702,16116,34486,11918,55586,18538,8965,9573
46275,71708,16116,34489,11918,55592,18541,8967,9574
46280,71719,16119,34494,11920,55600,18543,8968,9575
46285,71723,16121,34497,11922,55602,18544,8969,9575
46290,71733,16125,34500,11924,55608,18546,8970,9576
46295,71739,16125,34501,11924,55614,18549,8971,9578
46300,71750,16128,34506,11927,55622,18551,8973,9578
46305,71754,16129,34507,11928,55625,18552,8973,9579
46310,71764,16132,34510,11929,55632,18554,8974,9580
46315,71770,16132,34513,11929,55637,18557,8976,9581
46320,71781,16136,34519,11933,55642,18559,8976,9583
46325,71785,16141,34522,11938,55644,18560,8977,9583
46330,71795,16146,34527,11941,55647,18562,8977,9585
46335,71801,16147,34529,11942,55652,18565,8978,9587
46340,71812,16151,34532,11945,55660,18567,8979,9588
46345,71816,16152,34534,11946,55663,18568,8980,9588
46350,71826,16157,34540,11951,55668,18570,8981,9589
46355,71832,16157,34542,11951,55675,18573,8982,9591
46360,71843,16160,34549,11952,55680,18575,8984,9591
46365,71847,16160,34550,11952,55687,18576,8984,9592
46370,71857,16161,34554,11953,55695,18578,8985,9593
46375,71863,16161,34556,11953,55702,18581,8985,9596
46380,71874,16164,34562,11956,55709,18583,8986,9597
46385,71878,16165,34565,11957,55712,18584,8986,9598
46390,71888,16166,34569,11957,55721,18586,8987,9599
46395,71894,16166,34573,11957,55727,18589,8989,9600
46400,71905,16169,34579,11959,55733,18591,8989,9602
46405,71909,16169,34580,11959,55740,18592,8989,9603
46410,71919,16171,34585,11961,55747,18594,8990,9604
46415,71925,16171,34587,11961,55753,18597,8991,9606
46420,71936,16174,34594,11964,55762,18599,8991,9608
46425,71940,16174,34595,11964,55766,18600,8991,9609
46430,71950,16175,34599,11965,55774,18602,8993,9609
46435,71956,16175,34602,11965,55781,18605,8995,9610
46440,71967,16178,34608,11967,55788,18607,8995,9612
46445,71971,16178,34611,11967,55793,18608,8996,9612
46450,71981,16180,34618,11969,55800,18610,8997,9613
46455,71987,16180,34621,11969,55806,18613,8999,9614
46460,71998,16183,34623,11970,55814,18615,8999,9616
46465,72002,16185,34624,11972,55817,18616,8999,9617
46470,72012,16189,34628,11976,55823,18618,8999,9619
46475,72018,16189,34630,11976,55829,18621,9001,9620
46480,72029,16192,34634,11978,55837,18623,9001,9622
46485,72033,16193,34635,11979,55840,18624,9001,9623
46490,72043,16196,34641,11981,55846,18626,9003,9623
46495,72049,16196,34643,11981,55853,18629,9005,9624
46500,72060,16199,34647,11983,55861,18631,9006,9625
46505,72064,16200,34649,11984,55864,18632,9007,9625
46510,72074,16203,34652,11986,55870,18634,9007,9627
46515,72080,16203,34655,11986,55876,18637,9007,9630
46520,72091,16208,34663,11991,55883,18639,9008,9631
46525,72095,16208,34664,11991,55887,18640,9009,9631
46530,72105,16212,34670,11994,55892,18642,9010,9632
46535,72111,16212,34671,11994,55899,18645,9011,9634
46540,72122,16215,34677,11995,55906,18647,9012,9635
46545,72126,16217,34680,11997,55909,18648,9013,9635
46550,72136,16221,34684,11999,55914,18650,9014,9636
46555,72142,16221,34685,11999,55919,18653,9014,9639
46560,72153,16225,34689,12003,55926,18655,9014,9641
46565,72157,16229,34693,12007,55927,18656,9015,9641
46570,72167,16234,34698,12010,55932,18658,9016,9642
46575,72173,16234,34700,12010,55937,18661,9016,9645
46580,72184,16239,34707,12014,55945,18663,9018,9645
46585,72188,16239,34708,12014,55949,18664,9018,9646
46590,72198,16242,34714,12017,55956,18666,9020,9646
46595,72204,16242,34717,12017,55961,18669,9021,9648
46600,72215,16245,34722,12019,55970,18671,9022,9649
46605,72219,16246,34723,12020,55973,18672,9022,9650
46610,72229,16249,34728,12023,55980,18674,9023,9651
46615,72235,16249,34730,12023,55986,18677,9024,9653
46620,72246,16252,34736,12025,55994,18679,9026,9653
46625,72250,16252,34738,12025,55997,18680,9027,9653
46630,72260,16255,34744,12027,56004,18682,9029,9653
46635,72266,16255,34747,12027,56010,18685,9031,9654
46640,72277,16257,34752,12028,56019,18687,9031,9656
46645,72281,16258,34755,12029,56023,18688,9032,9656
46650,72291,16259,34758,12030,56032,18690,9032,9658
46655,72297,16259,34763,12030,56036,18693,9034,9659
46660,72308,16261,34770,12031,56047,18695,9035,9660
46665,72312,16262,34774,12032,56049,18696,9036,9660
46670,72322,16264,34782,12034,56056,18698,9038,9660
46675,72328,16264,34783,12034,56062,18701,9038,9663
46680,72339,16266,34788,12036,56071,18703,9039,9664
46685,72343,16266,34788,12036,56077,18704,9039,9665
46690,72353,16269,34793,12039,56084,18706,9040,9666
46695,72359,16269,34794,12039,56090,18709,9041,9668
46700,72370,16271,34799,12040,56096,18711,9041,9670
46705,72374,16273,34803,12042,56100,18712,9042,9670
46710,72384,16277,34810,12045,56106,18714,9044,9670
46715,72390,16277,34813,12045,56112,18717,9046,9671
46720,72401,16280,34818,12048,56119,18719,9047,9672
46725,72405,16280,34820,12048,56124,18720,9048,9672
46730,72415,16284,34825,12050,56130,18722,9049,9673
46735,72421,16284,34828,12050,56136,18725,9051,9674
46740,72432,16288,34834,12054,56142,18727,9051,9676
46745,72436,16288,34835,12054,56148,18728,9052,9676
46750,72446,16290,34840,12055,56156,18730,9053,9677
46755,72452,16290,34842,12055,56161,18733,9054,9679
46760,72463,16293,34849,12057,56168,18735,9056,9679
46765,72467,16294,34851,12058,56173,18736,9057,9679
46770,72477,16296,34858,12059,56181,18738,9059,9679
46775,72483,16296,34862,12059,56186,18741,9062,9679
46780,72494,16299,34867,12062,56195,18743,9062,9681
46785,72498,16299,34869,12062,56199,18744,9063,9681
46790,72508,16301,34874,12062,56207,18746,9065,9681
46795,72514,16301,34878,12062,56211,18749,9066,9683
46800,72525,16305,34886,12065,56219,18751,9068,9683
46805,72529,16306,34888,12066,56223,18752,9068,9684
46810,72539,16308,34894,12067,56231,18754,9070,9684
46815,72545,16308,34896,12067,56236,18757,9071,9686
46820,72556,16312,34902,12070,56243,18759,9072,9687
46825,72560,16313,34904,12071,56247,18760,9073,9687
46830,72570,16315,34907,12072,56254,18762,9074,9688
46835,72576,16315,34911,12072,56260,18765,9077,9688
46840,72587,16317,34914,12073,56269,18767,9077,9690
46845,72591,16318,34915,12074,56273,18768,9078,9690
46850,72601,16320,34919,12075,56281,18770,9080,9690
46855,72607,16320,34923,12075,56286,18773,9082,9691
46860,72618,16324,34927,12079,56294,18775,9082,9693
46865,72622,16325,34928,12080,56297,18776,9082,9694
46870,72632,16329,34931,12082,56303,18778,9082,9696
46875,72638,16329,34935,12082,56307,18781,9083,9698
46880,72649,16336,34942,12089,56312,18783,9084,9699
46885,72653,16339,34944,12092,56314,18784,9084,9700
46890,72663,16342,34949,12094,56320,18786,9085,9701
46895,72669,16342,34953,12094,56326,18789,9087,9702
46900,72680,16344,34955,12095,56336,18791,9087,9704
46905,72684,16345,34958,12096,56339,18792,9087,9705
46910,72694,16347,34965,12098,56347,18794,9089,9705
46915,72700,16347,34969,12098,56353,18797,9092,9705
46920,72711,16350,34976,12100,56360,18799,9094,9705
46925,72715,16350,34978,12100,56364,18800,9094,9706
46930,72725,16353,34985,12102,56371,18802,9095,9707
46935,72731,16353,34988,12102,56377,18805,9096,9709
46940,72742,16355,34996,12104,56384,18807,9097,9710
46945,72746,16356,34999,12105,56389,18808,9098,9710
46950,72756,16359,35004,12107,56395,18810,9098,9712
46955,72762,16359,35006,12107,56401,18813,9098,9715
46960,72773,16362,35012,12109,56410,18815,9099,9716
46965,72777,16362,35015,12109,56414,18816,9100,9716
46970,72787,16365,35024,12112,56421,18818,9102,9716
46975,72793,16365,35027,12112,56427,18821,9104,9717
46980,72804,16367,35034,12113,56434,18823,9105,9718
46985,72808,16368,35037,12114,56440,18824,9105,9719
46990,72818,16371,35040,12115,56447,18826,9106,9720
46995,72824,16371,35042,12115,56452,18829,9107,9722
47000,72835,16376,35048,12119,56458,18831,9108,9723
47005,72839,16378,35051,12121,56461,18832,9108,9724
47010,72849,16381,35056,12123,56467,18834,9110,9724
47015,72855,16381,35058,12123,56473,18837,9111,9726
47020,72866,16384,35063,12126,56481,18839,9111,9728
47025,72870,16384,35065,12126,56486,18840,9111,9729
47030,72880,16388,35070,12129,56492,18842,9111,9731
47035,72886,16388,35071,12129,56497,18845,9111,9734
47040,72897,16392,35077,12132,56504,18847,9112,9735
47045,72901,16392,35079,12132,56509,18848,9112,9736
47050,72911,16394,35084,12132,56517,18850,9114,9736
47055,72917,16394,35088,12132,56522,18853,9116,9737
47060,72928,16397,35096,12135,56530,18855,9117,9738
47065,72932,16398,35098,12136,56534,18856,9118,9738
47070,72942,16400,35101,12137,56542,18858,9119,9739
47075,72948,16400,35103,12137,56548,18861,9120,9741
47080,72959,16401,35107,12137,56557,18863,9120,9743
47085,72963,16403,35109,12139,56560,18864,9121,9743
47090,72973,16405,35111,12140,56568,18866,9122,9744
47095,72979,16405,35116,12140,56572,18869,9124,9745
47100,72990,16409,35122,12144,56580,18871,9125,9746
47105,72994,16410,35123,12145,56584,18872,9125,9747
47110,73004,16414,35129,12148,56590,18874,9126,9748
47115,73010,16414,35129,12148,56596,18877,9126,9751
47120,73021,16415,35135,12148,56605,18879,9128,9751
47125,73025,16416,35136,12149,56609,18880,9128,9752
47130,73035,16418,35140,12149,56616,18882,9129,9753
47135,73041,16418,35144,12149,56622,18885,9131,9754
47140,73052,16421,35152,12151,56630,18887,9133,9754
47145,73056,16422,35155,12152,56634,18888,9134,9754
47150,73066,16426,35159,12155,56640,18890,9135,9755
47155,73072,16426,35162,12155,56644,18893,9136,9757
47160,73083,16430,35165,12159,56652,18895,9136,9759
47165,73087,16431,35165,12160,56656,18896,9136,9760
47170,73097,16436,35172,12164,56659,18898,9137,9761
47175,73103,16437,35174,12165,56664,18901,9138,9763
47180,73114,16442,35179,12168,56670,18903,9138,9765
47185,73118,16442,35180,12168,56676,18904,9139,9765
47190,73128,16445,35186,12170,56683,18906,9141,9765
47195,73134,16445,35189,12170,56688,18909,9142,9767
47200,73145,16448,35194,12172,56695,18911,9142,9769
47205,73149,16448,35196,12172,56700,18912,9143,9769
47210,73159,16450,35200,12174,56708,18914,9143,9771
47215,73165,16450,35204,12174,56712,18917,9145,9772
47220,73176,16453,35211,12177,56723,18919,9147,9772
47225,73180,16454,35213,12178,56726,18920,9148,9772
47230,73190,16455,35216,12178,56734,18922,9148,9774
47235,73196,16455,35219,12178,56740,18925,9150,9775
47240,73207,16457,35226,12179,56747,18927,9151,9776
47245,73211,16457,35227,12179,56754,18928,9151,9777
47250,73221,16459,35231,12180,56762,18930,9152,9778
47255,73227,16459,35234,12180,56767,18933,9153,9780
47260,73238,16461,35239,12181,56777,18935,9155,9780
47265,73242,16461,35241,12181,56781,18936,9155,9781
47270,73252,16464,35247,12184,56788,18938,9156,9782
47275,73258,16464,35248,12184,56794,18941,9156,9785
47280,73269,16467,35254,12186,56801,18943,9157,9786
47285,73273,16468,35256,12187,56805,18944,9157,9787
47290,73283,16471,35262,12189,56812,18946,9158,9788
47295,73289,16471,35265,12189,56817,18949,9159,9790
47300,73300,16475,35268,12191,56824,18951,9159,9792
47305,73304,16476,35270,12192,56828,18952,9160,9792
47310,73314,16480,35276,12195,56834,18954,9161,9793
47315,73320,16480,35279,12195,56840,18957,9163,9794
47320,73331,16484,35283,12197,56846,18959,9163,9796
47325,73335,16485,35286,12198,56850,18960,9164,9796
47330,73345,16487,35292,12200,56857,18962,9165,9797
47335,73351,16487,35294,12200,56864,18965,9166,9799
47340,73362,16491,35301,12203,56871,18967,9167,9800
47345,73366,16492,35303,12204,56874,18968,9167,9801
47350,73376,16494,35307,12205,56882,18970,9168,9802
47355,73382,16494,35308,12205,56888,18973,9169,9804
47360,73393,16499,35316,12210,56893,18975,9171,9804
47365,73397,16501,35318,12212,56896,18976,9171,9805
47370,73407,16505,35321,12215,56902,18978,9171,9807
47375,73413,16505,35324,12215,56908,18981,9173,9808
47380,73424,16507,35328,12215,56916,18983,9174,9809
47385,73428,16508,35329,12216,56920,18984,9175,9809
47390,73438,16510,35333,12216,56926,18986,9177,9809
47395,73444,16511,35338,12217,56930,18989,9180,9809
47400,73455,16516,35343,12222,56937,18991,9181,9810
47405,73459,16518,35345,12224,56940,18992,9182,9810
47410,73469,16524,35350,12229,56945,18994,9183,9811
47415,73475,16524,35354,12229,56948,18997,9184,9813
47420,73486,16530,35359,12233,56953,18999,9185,9814
47425,73490,16534,35362,12237,56956,19000,9186,9814
47430,73500,16535,35367,12238,56964,19002,9187,9815
47435,73506,16535,35371,12238,56971,19005,9190,9815
47440,73517,16537,35376,12239,56979,19007,9191,9816
47445,73521,16537,35378,12239,56984,19008,9192,9816
47450,73531,16539,35382,12240,56992,19010,9193,9817
47455,73537,16539,35386,12240,56996,19013,9195,9818
47460,73548,16542,35396,12243,57004,19015,9197,9818
47465,73552,16543,35399,12244,57009,19016,9198,9818
47470,73562,16546,35404,12246,57015,19018,9199,9819
47475,73568,16546,35405,12246,57022,19021,9200,9821
47480,73579,16549,35412,12248,57028,19023,9201,9822
47485,73583,16550,35414,12249,57033,19024,9201,9823
47490,73593,16553,35419,12252,57039,19026,9201,9825
47495,73599,16553,35422,12252,57045,19029,9203,9826
47500,73610,16554,35428,12253,57054,19031,9204,9827
47505,73614,16554,35430,12253,57060,19032,9205,9827
47510,73624,16555,35436,12253,57068,19034,9207,9827
47515,73630,16555,35438,12253,57075,19037,9208,9829
47520,73641,16556,35446,12254,57084,19039,9210,9829
47525,73645,16556,35449,12254,57089,19040,9210,9830
47530,73655,16557,35452,12254,57098,19042,9212,9830
47535,73661,16557,35457,12254,57103,19045,9215,9830
47540,73672,16559,35463,12256,57113,19047,9216,9831
47545,73676,16559,35465,12256,57117,19048,9217,9831
47550,73686,16561,35471,12257,57124,19050,9218,9832
47555,73692,16561,35471,12257,57131,19053,9218,9835
47560,73703,16563,35475,12258,57139,19055,9219,9836
47565,73707,16564,35476,12259,57143,19056,9219,9837
47570,73717,16566,35480,12261,57150,19058,9220,9838
47575,73723,16566,35482,12261,57157,19061,9221,9840
47580,73734,16568,35487,12262,57165,19063,9222,9841
47585,73738,16570,35490,12264,57168,19064,9223,9841
47590,73748,16572,35493,12265,57175,19066,9223,9843
47595,73754,16572,35498,12265,57181,19069,9225,9844
47600,73765,16575,35501,12267,57190,19071,9225,9846
47605,73769,16575,35502,12267,57194,19072,9226,9846
47610,73779,16577,35505,12268,57202,19074,9227,9847
47615,73785,16577,35508,12268,57208,19077,9228,9849
47620,73796,16582,35514,12272,57213,19079,9229,9850
47625,73800,16584,35517,12274,57216,19080,9230,9850
47630,73810,16588,35523,12278,57221,19082,9230,9852
47635,73816,16588,35526,12278,57227,19085,9232,9853
47640,73827,16592,35531,12281,57234,19087,9233,9854
47645,73831,16595,35535,12284,57236,19088,9234,9854
47650,73841,16600,35539,12287,57241,19090,9235,9855
47655,73847,16600,35542,12287,57246,19093,9236,9857
47660,73858,16604,35546,12290,57253,19095,9237,9858
47665,73862,16605,35546,12291,57257,19096,9237,9859
47670,73872,16608,35548,12293,57264,19098,9237,9861
47675,73878,16608,35553,12293,57268,19101,9239,9862
47680,73889,16614,35561,12299,57275,19103,9240,9863
47685,73893,16615,35563,12300,57278,19104,9240,9864
47690,73903,16619,35566,12302,57284,19106,9241,9865
47695,73909,16619,35570,12302,57288,19109,9243,9866
47700,73920,16624,35575,12306,57294,19111,9244,9867
47705,73924,16625,35577,12307,57299,19112,9245,9867
47710,73934,16627,35583,12309,57306,19114,9247,9867
47715,73940,16627,35585,12309,57312,19117,9248,9869
47720,73951,16630,35589,12311,57320,19119,9249,9870
47725,73955,16631,35590,12312,57324,19120,9249,9871
47730,73965,16632,35594,12312,57332,19122,9250,9872
47735,73971,16632,35596,12312,57339,19125,9252,9873
47740,73982,16634,35601,12313,57347,19127,9253,9874
47745,73986,16635,35604,12314,57350,19128,9254,9874
47750,73996,16638,35610,12317,57356,19130,9254,9876
47755,74002,16638,35614,12317,57362,19133,9256,9877
47760,74013,16640,35617,12318,57372,19135,9256,9879
47765,74017,16641,35619,12319,57376,19136,9257,9879
47770,74027,16644,35625,12322,57382,19138,9258,9880
47775,74033,16644,35629,12322,57388,19141,9260,9881
47780,74044,16646,35636,12323,57397,19143,9262,9881
47785,74048,16647,35638,12324,57400,19144,9262,9882
47790,74058,16648,35641,12325,57408,19146,9262,9884
47795,74064,16648,35644,12325,57415,19149,9263,9886
47800,74075,16651,35651,12328,57423,19151,9264,9887
47805,74079,16652,35653,12329,57427,19152,9264,9888
47810,74089,16656,35660,12332,57432,19154,9265,9889
47815,74095,16656,35660,12332,57439,19157,9265,9892
47820,74106,16659,35665,12335,57447,19159,9266,9893
47825,74110,16659,35666,12335,57451,19160,9266,9894
47830,74120,16661,35671,12337,57459,19162,9268,9894
47835,74126,16661,35674,12337,57463,19165,9268,9897
47840,74137,16664,35677,12339,57472,19167,9269,9898
47845,74141,16666,35678,12341,57475,19168,9269,9899
47850,74151,16669,35683,12344,57481,19170,9269,9901
47855,74157,16669,35686,12344,57487,19173,9270,9903
47860,74168,16671,35693,12345,57493,19175,9272,9903
47865,74172,16672,35695,12346,57500,19176,9272,9904
47870,74182,16675,35700,12349,57506,19178,9272,9906
47875,74188,16675,35704,12349,57511,19181,9273,9908
47880,74199,16680,35709,12352,57518,19183,9273,9910
47885,74203,16682,35710,12354,57521,19184,9273,9911
47890,74213,16685,35712,12355,57528,19186,9274,9912
47895,74219,16685,35716,12355,57534,19189,9276,9913
47900,74230,16688,35719,12356,57542,19191,9277,9914
47905,74234,16689,35721,12357,57545,19192,9277,9915
47910,74244,16692,35726,12358,57551,19194,9278,9916
47915,74250,16692,35726,12358,57558,19197,9278,9919
47920,74261,16696,35732,12362,57564,19199,9278,9921
47925,74265,16697,35733,12363,57568,19200,9278,9922
47930,74275,16700,35738,12366,57575,19202,9279,9923
47935,74281,16700,35740,12366,57581,19205,9280,9925
47940,74292,16705,35746,12369,57587,19207,9281,9926
47945,74296,16706,35748,12370,57590,19208,9281,9927
47950,74306,16708,35749,12370,57597,19210,9281,9929
47955,74312,16708,35750,12370,57603,19213,9281,9932
47960,74323,16714,35756,12375,57608,19215,9281,9934
47965,74327,16716,35757,12377,57611,19216,9281,9935
47970,74337,16720,35761,12379,57616,19218,9282,9936
47975,74343,16720,35764,12379,57622,19221,9284,9937
47980,74354,16724,35771,12383,57629,19223,9285,9938
47985,74358,16725,35774,12384,57632,19224,9286,9938
47990,74368,16729,35780,12387,57638,19226,9287,9939
47995,74374,16729,35784,12387,57641,19229,9288,9941
48000,74385,16735,35791,12393,57647,19231,9290,9941
48005,74389,16735,35793,12393,57653,19232,9290,9942
48010,74399,16736,35796,12393,57663,19234,9291,9943
48015,74405,16736,35800,12393,57667,19237,9293,9944
48020,74416,16737,35805,12394,57679,19239,9293,9946
48025,74420,16737,35807,12394,57683,19240,9293,9947
48030,74430,16738,35812,12395,57691,19242,9294,9948
48035,74436,16738,35816,12395,57697,19245,9297,9948
48040,74447,16739,35822,12396,57707,19247,9298,9949
48045,74451,16739,35825,12396,57712,19248,9299,9949
48050,74461,16740,35833,12397,57719,19250,9301,9949
48055,74467,16740,35835,12397,57725,19253,9302,9951
48060,74478,16741,35840,12398,57736,19255,9303,9952
48065,74482,16741,35844,12398,57740,19256,9304,9952
48070,74492,16742,35851,12398,57748,19258,9304,9954
48075,74498,16742,35852,12398,57756,19261,9305,9956
48080,74509,16745,35857,12400,57764,19263,9306,9957
48085,74513,16746,35859,12401,57767,19264,9307,9957
48090,74523,16749,35867,12404,57773,19266,9309,9957
48095,74529,16749,35869,12404,57780,19269,9309,9960
48100,74540,16751,35874,12405,57787,19271,9310,9961
48105,74544,16752,35877,12406,57792,19272,9310,9962
48110,74554,16755,35880,12407,57799,19274,9310,9964
48115,74560,16755,35882,12407,57805,19277,9312,9965
48120,74571,16757,35886,12409,57814,19279,9312,9967
48125,74575,16758,35888,12410,57817,19280,9313,9967
48130,74585,16761,35893,12413,57824,19282,9314,9968
48135,74591,16761,35896,12413,57830,19285,9316,9969
48140,74602,16763,35900,12413,57838,19287,9317,9970
48145,74606,16763,35900,12413,57843,19288,9317,9971
48150,74616,16766,35906,12414,57850,19290,9319,9971
48155,74622,16766,35908,12414,57855,19293,9320,9973
48160,74633,16769,35913,12416,57863,19295,9320,9975
48165,74637,16770,35916,12417,57867,19296,9321,9975
48170,74647,16772,35919,12417,57874,19298,9322,9976
48175,74653,16772,35922,12417,57881,19301,9324,9977
48180,74664,16776,35929,12420,57888,19303,9326,9977
48185,74668,16777,35932,12421,57891,19304,9327,9977
48190,74678,16779,35937,12423,57898,19306,9328,9978
48195,74684,16779,35941,12423,57904,19309,9330,9979
48200,74695,16783,35945,12425,57912,19311,9331,9980
48205,74699,16785,35949,12427,57914,19312,9332,9980
48210,74709,16789,35954,12429,57920,19314,9333,9981
48215,74715,16789,35958,12429,57924,19317,9334,9983
48220,74726,16794,35964,12434,57932,19319,9336,9983
48225,74730,16794,35965,12434,57936,19320,9337,9983
48230,74740,16798,35971,12436,57941,19322,9339,9983
48235,74746,16798,35973,12436,57947,19325,9339,9986
48240,74757,16803,35977,12439,57953,19327,9340,9987
48245,74761,16806,35979,12442,57955,19328,9340,9988
48250,74771,16810,35984,12445,57961,19330,9341,9989
48255,74777,16810,35987,12445,57966,19333,9343,9990
48260,74788,16815,35991,12450,57973,19335,9343,9992
48265,74792,16815,35993,12450,57977,19336,9344,9992
48270,74802,16818,35999,12453,57983,19338,9346,9992
48275,74808,16818,36002,12453,57988,19341,9347,9994
48280,74819,16823,36008,12458,57995,19343,9348,9995
48285,74823,16825,36010,12460,57998,19344,9349,9995
48290,74833,16829,36015,12463,58003,19346,9350,9996
48295,74839,16829,36018,12463,58008,19349,9352,9997
48300,74850,16835,36021,12468,58015,19351,9352,9999
48305,74854,16835,36022,12468,58019,19352,9352,10000
48310,74864,16837,36028,12469,58025,19354,9353,10001
48315,74870,16837,36031,12469,58032,19357,9355,10002
48320,74881,16839,36037,12471,58040,19359,9356,10003
48325,74885,16839,36040,12471,58045,19360,9357,10003
48330,74895,16840,36042,12472,58054,19362,9358,10004
48335,74901,16840,36043,12472,58061,19365,9359,10006
48340,74912,16843,36047,12473,58068,19367,9360,10007
48345,74916,16843,36050,12473,58072,19368,9361,10007
48350,74926,16845,36057,12474,58079,19370,9362,10008
48355,74932,16845,36061,12474,58086,19373,9365,10008
48360,74943,16848,36065,12476,58095,19375,9367,10008
48365,74947,16849,36068,12477,58097,19376,9367,10009
48370,74957,16852,36074,12479,58104,19378,9368,10010
48375,74963,16852,36077,12479,58110,19381,9369,10012
48380,74974,16855,36083,12480,58117,19383,9371,10012
48385,74978,16855,36085,12480,58122,19384,9372,10012
48390,74988,16857,36090,12481,58129,19386,9373,10013
48395,74994,16857,36091,12481,58136,19389,9373,10016
48400,75005,16859,36096,12481,58144,19391,9375,10016
48405,75009,16860,36098,12482,58149,19392,9375,10017
48410,75019,16863,36104,12485,58155,19394,9375,10019
48415,75025,16863,36107,12485,58162,19397,9378,10019
48420,75036,16867,36112,12487,58168,19399,9379,10020
48425,75040,16868,36114,12488,58172,19400,9379,10021
48430,75050,16870,36119,12489,58179,19402,9380,10022
48435,75056,16870,36123,12489,58185,19405,9381,10024
48440,75067,16875,36130,12494,58192,19407,9382,10025
48445,75071,16875,36130,12494,58196,19408,9382,10026
48450,75081,16878,36134,12495,58202,19410,9384,10026
48455,75087,16878,36137,12495,58209,19413,9385,10028
48460,75098,16881,36144,12496,58216,19415,9386,10029
48465,75102,16883,36146,12498,58219,19416,9386,10030
48470,75112,16886,36151,12500,58225,19418,9387,10031
48475,75118,16886,36153,12500,58231,19421,9387,10034
48480,75129,16890,36157,12502,58239,19423,9388,10035
48485,75133,16891,36158,12503,58242,19424,9388,10036
48490,75143,16894,36163,12504,58248,19426,9388,10038
48495,75149,16894,36167,12504,58255,19429,9391,10038
48500,75160,16896,36173,12506,58263,19431,9392,10039
48505,75164,16898,36175,12508,58266,19432,9392,10040
48510,75174,16901,36177,12510,58272,19434,9392,10042
48515,75180,16901,36180,12510,58278,19437,9394,10043
48520,75191,16907,36187,12516,58283,19439,9395,10044
48525,75195,16909,36189,12518,58286,19440,9395,10045
48530,75205,16914,36194,12522,58290,19442,9396,10046
48535,75211,16914,36197,12522,58296,19445,9398,10047
48540,75222,16919,36203,12527,58302,19447,9399,10048
48545,75226,16921,36205,12529,58304,19448,9399,10049
48550,75236,16924,36208,12530,58311,19450,9400,10050
48555,75242,16924,36212,12530,58315,19453,9402,10051
48560,75253,16926,36217,12531,58325,19455,9403,10052
48565,75257,16926,36218,12531,58331,19456,9404,10052
48570,75267,16928,36222,12533,58337,19458,9404,10054
48575,75273,16928,36227,12533,58343,19461,9407,10054
48580,75284,16931,36236,12535,58350,19463,9409,10054
48585,75288,16932,36240,12536,58355,19464,9410,10054
48590,75298,16934,36246,12538,58362,19466,9410,10056
48595,75304,16934,36249,12538,58370,19469,9412,10057
48600,75315,16937,36252,12540,58378,19471,9413,10058
48605,75319,16937,36255,12540,58382,19472,9414,10058
48610,75329,16938,36261,12541,58390,19474,9415,10059
48615,75335,16938,36266,12541,58396,19477,9417,10060
48620,75346,16939,36271,12542,58407,19479,9418,10061
48625,75350,16939,36274,12542,58411,19480,9419,10061
48630,75360,16940,36279,12543,58419,19482,9420,10062
48635,75366,16940,36283,12543,58426,19485,9422,10063
48640,75377,16941,36290,12544,58435,19487,9423,10064
48645,75381,16941,36291,12544,58440,19488,9423,10065
48650,75391,16942,36297,12544,58448,19490,9425,10065
48655,75397,16942,36299,12544,58454,19493,9426,10067
48660,75408,16943,36304,12545,58464,19495,9427,10068
48665,75412,16943,36306,12545,58469,19496,9428,10068
48670,75422,16945,36310,12546,58476,19498,9429,10069
48675,75428,16945,36312,12546,58482,19501,9430,10071
48680,75439,16948,36318,12548,58489,19503,9431,10072
48685,75443,16949,36321,12549,58494,19504,9432,10072
48690,75453,16951,36325,12549,58501,19506,9433,10073
48695,75459,16951,36327,12549,58508,19509,9435,10074
48700,75470,16952,36332,12550,58518,19511,9436,10075
48705,75474,16953,36334,12551,58521,19512,9436,10076
48710,75484,16956,36337,12553,58527,19514,9436,10078
48715,75490,16956,36338,12553,58534,19517,9437,10080
48720,75501,16959,36347,12556,58541,19519,9439,10080
48725,75505,16960,36347,12557,58545,19520,9439,10081
48730,75515,16965,36351,12560,58549,19522,9439,10083
48735,75521,16965,36353,12560,58554,19525,9439,10086
48740,75532,16971,36357,12564,58561,19527,9439,10088
48745,75536,16972,36358,12565,58564,19528,9439,10089
48750,75546,16977,36365,12570,58568,19530,9440,10090
48755,75552,16977,36368,12570,58575,19533,9442,10091
48760,75563,16982,36373,12574,58581,19535,9442,10093
48765,75567,16984,36377,12576,58583,19536,9443,10093
48770,75577,16990,36383,12581,58586,19538,9444,10094
48775,75583,16990,36386,12581,58591,19541,9444,10097
48780,75594,16995,36390,12586,58599,19543,9444,10099
48785,75598,16995,36393,12586,58603,19544,9445,10099
48790,75608,16998,36398,12588,58610,19546,9447,10099
48795,75614,16998,36399,12588,58615,19549,9447,10102
48800,75625,17000,36406,12589,58625,19551,9449,10102
48805,75629,17001,36407,12590,58628,19552,9449,10103
48810,75639,17003,36412,12591,58635,19554,9451,10103
48815,75645,17003,36415,12591,58640,19557,9453,10104
48820,75656,17005,36420,12592,58649,19559,9454,10105
48825,75660,17005,36421,12592,58655,19560,9455,10105
48830,75670,17006,36424,12593,58664,19562,9456,10106
48835,75676,17006,36428,12593,58669,19565,9458,10107
48840,75687,17008,36434,12594,58678,19567,9459,10108
48845,75691,17009,36436,12595,58682,19568,9459,10109
48850,75701,17011,36440,12596,58689,19570,9460,10110
48855,75707,17011,36440,12596,58696,19573,9460,10113
48860,75718,17014,36443,12598,58704,19575,9460,10115
48865,75722,17015,36447,12599,58706,19576,9461,10115
48870,75732,17017,36452,12600,58713,19578,9462,10116
48875,75738,17017,36456,12600,58719,19581,9464,10117
48880,75749,17019,36461,12602,58730,19583,9465,10118
48885,75753,17020,36464,12603,58732,19584,9465,10119
48890,75763,17025,36468,12606,58737,19586,9465,10121
48895,75769,17025,36470,12606,58743,19589,9466,10123
48900,75780,17028,36477,12609,58750,19591,9468,10123
48905,75784,17030,36480,12611,58754,19592,9468,10124
48910,75794,17034,36486,12613,58760,19594,9470,10124
48915,75800,17034,36489,12613,58765,19597,9472,10125
48920,75811,17039,36496,12617,58770,19599,9474,10125
48925,75815,17039,36498,12617,58776,19600,9475,10125
48930,75825,17043,36503,12619,58782,19602,9476,10126
48935,75831,17043,36506,12619,58787,19605,9478,10127
48940,75842,17046,36508,12621,58795,19607,9478,10129
48945,75846,17046,36509,12621,58800,19608,9479,10129
48950,75856,17050,36514,12624,58805,19610,9479,10131
48955,75862,17050,36516,12624,58811,19613,9480,10133
48960,75873,17055,36523,12628,58816,19615,9481,10134
48965,75877,17055,36524,12628,58822,19616,9482,10134
48970,75887,17059,36527,12630,58828,19618,9483,10135
48975,75893,17059,36529,12630,58833,19621,9484,10137
48980,75904,17061,36533,12631,58843,19623,9485,10138
48985,75908,17061,36535,12631,58847,19624,9485,10139
48990,75918,17063,36539,12632,58855,19626,9486,10140
48995,75924,17063,36541,12632,58860,19629,9487,10142
49000,75935,17067,36544,12636,58868,19631,9487,10144
49005,75939,17069,36547,12638,58870,19632,9487,10145
49010,75949,17073,36552,12641,58875,19634,9487,10147
49015,75955,17073,36555,12641,58880,19637,9488,10149
49020,75966,17077,36558,12643,58889,19639,9489,10150
49025,75970,17077,36560,12643,58893,19640,9490,10150
49030,75980,17080,36565,12645,58900,19642,9492,10150
49035,75986,17080,36568,12645,58905,19645,9493,10152
49040,75997,17084,36575,12649,58912,19647,9494,10153
49045,76001,17087,36578,12652,58914,19648,9495,10153
49050,76011,17089,36583,12653,58922,19650,9496,10154
49055,76017,17089,36584,12653,58928,19653,9497,10156
49060,76028,17091,36588,12654,58937,19655,9498,10157
49065,76032,17092,36589,12655,58940,19656,9498,10158
49070,76042,17094,36591,12655,58947,19658,9498,10160
49075,76048,17094,36592,12655,58954,19661,9499,10162
49080,76059,17095,36596,12656,58964,19663,9501,10162
49085,76063,17096,36597,12657,58967,19664,9501,10163
49090,76073,17098,36601,12657,58975,19666,9503,10163
49095,76079,17098,36604,12657,58978,19669,9503,10166
49100,76090,17103,36608,12661,58986,19671,9504,10167
49105,76094,17104,36610,12662,58989,19672,9505,10167
49110,76104,17109,36615,12666,58993,19674,9505,10169
49115,76110,17110,36619,12667,58997,19677,9507,10170
49120,76121,17113,36625,12669,59008,19679,9509,10170
49125,76125,17113,36628,12669,59012,19680,9510,10170
49130,76135,17114,36630,12669,59021,19682,9511,10171
49135,76141,17114,36633,12669,59026,19685,9512,10173
49140,76152,17115,36640,12670,59037,19687,9513,10174
49145,76156,17115,36642,12670,59041,19688,9514,10174
49150,76166,17116,36647,12671,59049,19690,9514,10176
49155,76172,17116,36649,12671,59056,19693,9514,10179
49160,76183,17119,36656,12673,59064,19695,9515,10180
49165,76187,17119,36658,12673,59068,19696,9515,10181
49170,76197,17120,36663,12674,59076,19698,9515,10183
49175,76203,17120,36665,12674,59083,19701,9516,10185
49180,76214,17122,36670,12676,59092,19703,9517,10186
49185,76218,17122,36670,12676,59096,19704,9517,10187
49190,76228,17123,36675,12677,59104,19706,9518,10188
49195,76234,17123,36680,12677,59110,19709,9520,10189
49200,76245,17125,36687,12678,59120,19711,9522,10189
49205,76249,17125,36689,12678,59124,19712,9522,10190
49210,76259,17127,36694,12680,59131,19714,9523,10191
49215,76265,17127,36698,12680,59137,19717,9525,10192
49220,76276,17129,36703,12681,59145,19719,9526,10193
49225,76280,17130,36705,12682,59150,19720,9527,10193
49230,76290,17132,36709,12683,59157,19722,9529,10193
49235,76296,17132,36710,12683,59162,19725,9529,10196
49240,76307,17138,36714,12688,59168,19727,9529,10198
49245,76311,17140,36715,12690,59171,19728,9529,10199
49250,76321,17143,36717,12691,59178,19730,9530,10200
49255,76327,17143,36721,12691,59182,19733,9532,10201
49260,76338,17148,36726,12695,59188,19735,9533,10202
49265,76342,17151,36728,12698,59191,19736,9534,10202
49270,76352,17156,36735,12702,59195,19738,9536,10202
49275,76358,17156,36737,12702,59200,19741,9537,10204
49280,76369,17161,36744,12706,59205,19743,9539,10204
49285,76373,17166,36747,12711,59207,19744,9540,10204
49290,76383,17169,36752,12714,59214,19746,9541,10205
49295,76389,17169,36755,12714,59218,19749,9541,10208
49300,76400,17174,36759,12718,59225,19751,9541,10210
49305,76404,17174,36761,12718,59229,19752,9541,10211
49310,76414,17175,36764,12719,59239,19754,9542,10212
49315,76420,17175,36764,12719,59245,19757,9542,10215
49320,76431,17178,36768,12720,59252,19759,9543,10216
49325,76435,17178,36769,12720,59256,19760,9543,10217
49330,76445,17181,36776,12722,59262,19762,9544,10218
49335,76451,17181,36778,12722,59270,19765,9545,10220
49340,76462,17183,36781,12723,59278,19767,9546,10221
49345,76466,17183,36783,12723,59283,19768,9546,10222
49350,76476,17185,36788,12724,59291,19770,9547,10223
49355,76482,17185,36792,12724,59296,19773,9549,10224
49360,76493,17187,36799,12725,59304,19775,9550,10225
49365,76497,17187,36800,12725,59310,19776,9550,10226
49370,76507,17190,36806,12727,59316,19778,9552,10226
49375,76513,17190,36809,12727,59323,19781,9553,10228
49380,76524,17193,36816,12729,59330,19783,9554,10229
49385,76528,17194,36819,12730,59334,19784,9555,10229
49390,76538,17196,36824,12731,59341,19786,9555,10231
49395,76544,17196,36827,12731,59347,19789,9556,10233
49400,76555,17199,36833,12732,59355,19791,9557,10234
49405,76559,17200,36834,12733,59359,19792,9557,10235
49410,76569,17203,36838,12735,59365,19794,9558,10236
49415,76575,17203,36842,12735,59370,19797,9559,10238
49420,76586,17208,36848,12738,59377,19799,9560,10239
49425,76590,17209,36851,12739,59381,19800,9561,10239
49430,76600,17213,36854,12741,59386,19802,9561,10241
49435,76606,17213,36856,12741,59392,19805,9562,10243
49440,76617,17216,36857,12742,59400,19807,9562,10245
49445,76621,17217,36859,12743,59404,19808,9563,10245
49450,76631,17219,36861,12744,59411,19810,9563,10247
49455,76637,17219,36863,12744,59418,19813,9564,10249
49460,76648,17222,36870,12746,59426,19815,9566,10249
49465,76652,17223,36871,12747,59429,19816,9566,10250
49470,76662,17227,36878,12751,59434,19818,9567,10251
49475,76668,17227,36881,12751,59440,19821,9569,10252
49480,76679,17231,36884,12754,59448,19823,9570,10253
49485,76683,17233,36888,12756,59450,19824,9571,10253
49490,76693,17239,36894,12760,59454,19826,9572,10254
49495,76699,17239,36896,12760,59459,19829,9572,10257
49500,76710,17244,36900,12763,59466,19831,9572,10259
49505,76714,17246,36902,12765,59468,19832,9572,10260
49510,76724,17250,36906,12767,59473,19834,9572,10262
49515,76730,17250,36910,12767,59478,19837,9573,10264
49520,76741,17256,36916,12771,59484,19839,9573,10266
49525,76745,17258,36919,12773,59487,19840,9574,10266
49530,76755,17262,36924,12776,59492,19842,9575,10267
49535,76761,17262,36927,12776,59497,19845,9577,10268
49540,76772,17266,36931,12780,59504,19847,9577,10270
49545,76776,17269,36934,12783,59506,19848,9578,10270
49550,76786,17272,36938,12786,59514,19850,9579,10271
49555,76792,17272,36943,12786,59519,19853,9582,10271
49560,76803,17275,36951,12789,59527,19855,9583,10272
49565,76807,17275,36953,12789,59532,19856,9583,10273
49570,76817,17276,36959,12789,59540,19858,9584,10274
49575,76823,17276,36963,12789,59545,19861,9586,10275
49580,76834,17277,36967,12789,59555,19863,9587,10276
49585,76838,17277,36970,12789,59560,19864,9588,10276
49590,76848,17278,36975,12789,59569,19866,9589,10277
49595,76854,17278,36980,12789,59573,19869,9591,10278
49600,76865,17279,36986,12790,59583,19871,9592,10279
49605,76869,17279,36986,12790,59590,19872,9592,10280
49610,76879,17280,36993,12791,59598,19874,9593,10281
49615,76885,17280,36996,12791,59604,19877,9595,10282
49620,76896,17281,37001,12791,59614,19879,9596,10283
49625,76900,17281,37003,12791,59618,19880,9597,10283
49630,76910,17282,37009,12792,59627,19882,9599,10283
49635,76916,17282,37011,12792,59634,19885,9601,10284
49640,76927,17283,37012,12792,59644,19887,9602,10285
49645,76931,17283,37015,12792,59648,19888,9603,10285
49650,76941,17284,37020,12792,59657,19890,9604,10286
49655,76947,17284,37024,12792,59662,19893,9607,10286
49660,76958,17287,37029,12794,59669,19895,9607,10288
49665,76962,17288,37031,12795,59674,19896,9608,10288
49670,76972,17291,37035,12797,59680,19898,9609,10289
49675,76978,17291,37037,12797,59686,19901,9610,10291
49680,76989,17293,37043,12798,59695,19903,9612,10291
49685,76993,17295,37047,12800,59698,19904,9613,10291
49690,77003,17297,37050,12801,59706,19906,9614,10292
49695,77009,17297,37052,12801,59712,19909,9616,10293
49700,77020,17300,37058,12804,59719,19911,9616,10295
49705,77024,17301,37060,12805,59723,19912,9617,10295
49710,77034,17304,37066,12807,59729,19914,9618,10296
49715,77040,17304,37068,12807,59736,19917,9619,10298
49720,77051,17307,37073,12810,59743,19919,9620,10299
49725,77055,17308,37073,12811,59747,19920,9620,10300
49730,77065,17310,37076,12812,59755,19922,9620,10302
49735,77071,17310,37077,12812,59761,19925,9621,10304
49740,77082,17313,37083,12814,59768,19927,9623,10304
49745,77086,17315,37084,12816,59771,19928,9623,10305
49750,77096,17318,37090,12819,59777,19930,9624,10306
49755,77102,17318,37094,12819,59783,19933,9625,10308
49760,77113,17322,37099,12821,59790,19935,9626,10309
49765,77117,17324,37101,12823,59793,19936,9627,10309
49770,77127,17328,37106,12825,59798,19938,9628,10310
49775,77133,17328,37108,12825,59804,19941,9629,10312
49780,77144,17333,37113,12829,59811,19943,9630,10313
49785,77148,17333,37115,12829,59815,19944,9631,10313
49790,77158,17337,37120,12831,59821,19946,9633,10313
49795,77164,17337,37122,12831,59826,19949,9634,10315
49800,77175,17343,37128,12836,59832,19951,9634,10317
49805,77179,17345,37132,12838,59834,19952,9635,10317
49810,77189,17347,37135,12839,59841,19954,9636,10318
49815,77195,17347,37137,12839,59846,19957,9637,10320
49820,77206,17352,37141,12843,59853,19959,9638,10321
49825,77210,17354,37143,12845,59855,19960,9638,10322
49830,77220,17358,37145,12847,59861,19962,9638,10324
49835,77226,17358,37146,12847,59867,19965,9639,10326
49840,77237,17360,37151,12848,59875,19967,9640,10327
49845,77241,17360,37152,12848,59881,19968,9641,10327
49850,77251,17362,37157,12850,59888,19970,9641,10329
49855,77257,17362,37158,12850,59895,19973,9642,10331
49860,77268,17365,37161,12852,59902,19975,9642,10333
49865,77272,17365,37162,12852,59907,19976,9643,10333
49870,77282,17366,37166,12852,59914,19978,9644,10334
49875,77288,17366,37169,12852,59920,19981,9646,10335
49880,77299,17369,37173,12854,59929,19983,9646,10337
49885,77303,17369,37173,12854,59934,19984,9646,10338
49890,77313,17372,37179,12856,59939,19986,9647,10339
49895,77319,17372,37182,12856,59944,19989,9648,10341
49900,77330,17375,37190,12859,59954,19991,9649,10342
49905,77334,17375,37191,12859,59959,19992,9650,10342
49910,77344,17378,37196,12861,59966,19994,9651,10343
49915,77350,17378,37198,12861,59971,19997,9652,10345
49920,77361,17381,37203,12862,59979,19999,9654,10345
49925,77365,17382,37206,12863,59982,20000,9654,10346
49930,77375,17383,37209,12863,59991,20002,9655,10347
49935,77381,17383,37213,12863,59997,20005,9658,10347
49940,77392,17387,37215,12865,60004,20007,9658,10349
49945,77396,17388,37218,12866,60007,20008,9659,10349
49950,77406,17392,37223,12868,60013,20010,9659,10351
49955,77412,17392,37228,12868,60018,20013,9661,10352
49960,77423,17397,37234,12871,60025,20015,9662,10353
49965,77427,17398,37236,12872,60029,20016,9662,10354
49970,77437,17402,37241,12875,60034,20018,9662,10356
49975,77443,17402,37243,12875,60041,20021,9664,10357
49980,77454,17405,37248,12877,60048,20023,9664,10359
49985,77458,17407,37250,12879,60051,20024,9664,10360
49990,77468,17411,37257,12882,60057,20026,9666,10360
49995,77474,17411,37258,12882,60063,20029,9667,10362
50000,77485,17414,37263,12883,60070,20031,9668,10363
50005,77489,17416,37264,12885,60073,20032,9668,10364
50010,77499,17418,37265,12886,60081,20034,9668,10366
50015,77505,17418,37269,12886,60086,20037,9671,10366
50020,77516,17421,37271,12888,60095,20039,9671,10368
50025,77520,17421,37273,12888,60099,20040,9672,10368
50030,77530,17423,37279,12890,60106,20042,9673,10369
50035,77536,17423,37285,12890,60111,20045,9676,10369
50040,77547,17426,37294,12893,60119,20047,9677,10370
50045,77551,17428,37296,12895,60123,20048,9677,10371
50050,77561,17430,37300,12896,60130,20050,9677,10373
50055,77567,17430,37303,12896,60137,20053,9679,10374
50060,77578,17432,37309,12898,60146,20055,9680,10375
50065,77582,17433,37311,12899,60149,20056,9681,10375
50070,77592,17436,37316,12901,60156,20058,9681,10377
50075,77598,17436,37318,12901,60161,20061,9682,10379
50080,77609,17438,37327,12903,60170,20063,9684,10379
50085,77613,17440,37331,12905,60173,20064,9685,10379
50090,77623,17444,37339,12908,60178,20066,9687,10379
50095,77629,17444,37341,12908,60183,20069,9687,10382
50100,77640,17449,37350,12913,60190,20071,9688,10383
50105,77644,17451,37354,12915,60193,20072,9689,10383
50110,77654,17454,37359,12918,60200,20074,9690,10384
50115,77660,17454,37362,12918,60206,20077,9692,10385
50120,77671,17457,37367,12919,60214,20079,9694,10385
50125,77675,17457,37367,12919,60218,20080,9694,10386
50130,77685,17458,37371,12919,60227,20082,9695,10387
50135,77691,17458,37375,12919,60233,20085,9697,10388
50140,77702,17460,37381,12920,60242,20087,9698,10389
50145,77706,17461,37382,12921,60245,20088,9698,10390
50150,77716,17463,37388,12922,60251,20090,9699,10391
50155,77722,17463,37392,12922,60257,20093,9701,10392
50160,77733,17466,37395,12923,60267,20095,9702,10393
50165,77737,17467,37399,12924,60269,20096,9703,10393
50170,77747,17469,37404,12926,60278,20098,9704,10394
50175,77753,17469,37410,12926,60282,20101,9707,10394
50180,77764,17471,37414,12927,60293,20103,9708,10395
50185,77768,17472,37417,12928,60295,20104,9708,10396
50190,77778,17475,37423,12930,60302,20106,9708,10398
50195,77784,17475,37427,12930,60307,20109,9710,10399
50200,77795,17478,37436,12932,60317,20111,9712,10399
50205,77799,17478,37439,12932,60320,20112,9713,10399
50210,77809,17480,37443,12933,60328,20114,9714,10400
50215,77815,17480,37445,12933,60335,20117,9715,10402
50220,77826,17483,37449,12934,60343,20119,9716,10403
50225,77830,17483,37450,12934,60347,20120,9717,10403
50230,77840,17486,37457,12936,60353,20122,9718,10404
50235,77846,17486,37461,12936,60359,20125,9720,10405
50240,77857,17489,37463,12938,60368,20127,9720,10407
50245,77861,17489,37463,12938,60372,20128,9720,10408
50250,77871,17492,37468,12940,60378,20130,9721,10409
50255,77877,17492,37471,12940,60384,20133,9723,10410
50260,77888,17495,37475,12941,60392,20135,9724,10411
50265,77892,17496,37476,12942,60395,20136,9724,10412
50270,77902,17498,37477,12942,60404,20138,9724,10414
50275,77908,17498,37480,12942,60409,20141,9725,10416
50280,77919,17501,37485,12943,60415,20143,9726,10417
50285,77923,17502,37487,12944,60420,20144,9726,10418
50290,77933,17504,37488,12945,60429,20146,9726,10420
50295,77939,17504,37489,12945,60435,20149,9727,10422
50300,77950,17507,37492,12947,60442,20151,9727,10424
50305,77954,17509,37493,12949,60445,20152,9727,10425
50310,77964,17513,37500,12953,60450,20154,9728,10426
50315,77970,17513,37502,12953,60455,20157,9729,10428
50320,77981,17518,37506,12958,60463,20159,9730,10429
50325,77985,17518,37506,12958,60467,20160,9730,10430
50330,77995,17522,37511,12961,60472,20162,9731,10431
50335,78001,17522,37514,12961,60476,20165,9732,10433
50340,78012,17529,37519,12968,60482,20167,9732,10435
50345,78016,17532,37521,12971,60484,20168,9732,10436
50350,78026,17536,37526,12974,60489,20170,9733,10437
50355,78032,17536,37528,12974,60494,20173,9734,10439
50360,78043,17541,37533,12978,60500,20175,9735,10440
50365,78047,17543,37535,12980,60504,20176,9736,10440
50370,78057,17547,37539,12983,60509,20178,9736,10442
50375,78063,17547,37541,12983,60515,20181,9737,10444
50380,78074,17551,37546,12985,60521,20183,9738,10445
50385,78078,17552,37547,12986,60526,20184,9738,10446
50390,78088,17555,37549,12988,60533,20186,9738,10448
50395,78094,17555,37554,12988,60537,20189,9740,10449
50400,78105,17560,37559,12992,60544,20191,9741,10450
50405,78109,17560,37560,12992,60549,20192,9742,10450
50410,78119,17563,37567,12995,60555,20194,9743,10451
50415,78125,17563,37568,12995,60562,20197,9744,10453
50420,78136,17566,37571,12996,60568,20199,9744,10455
50425,78140,17569,37575,12999,60571,20200,9745,10455
50430,78150,17571,37579,12999,60578,20202,9746,10456
50435,78156,17571,37583,12999,60583,20205,9748,10457
50440,78167,17575,37587,13001,60592,20207,9749,10458
50445,78171,17576,37589,13002,60595,20208,9749,10459
50450,78181,17579,37596,13005,60602,20210,9751,10459
50455,78187,17579,37601,13005,60608,20213,9754,10459
50460,78198,17582,37606,13007,60616,20215,9754,10461
50465,78202,17582,37608,13007,60620,20216,9755,10461
50470,78212,17584,37611,13008,60628,20218,9755,10463
50475,78218,17584,37614,13008,60634,20221,9757,10464
50480,78229,17586,37620,13008,60643,20223,9758,10465
50485,78233,17587,37623,13009,60646,20224,9759,10465
50490,78243,17589,37629,13011,60654,20226,9761,10465
50495,78249,17589,37634,13011,60660,20229,9764,10465
50500,78260,17591,37640,13012,60669,20231,9766,10465
50505,78264,17591,37642,13012,60673,20232,9766,10466
50510,78274,17593,37646,13013,60680,20234,9766,10468
50515,78280,17593,37647,13013,60687,20237,9766,10471
50520,78291,17595,37649,13013,60696,20239,9766,10473
50525,78295,17595,37651,13013,60700,20240,9767,10473
50530,78305,17597,37656,13014,60708,20242,9769,10473
50535,78311,17597,37659,13014,60714,20245,9770,10475
50540,78322,17599,37668,13016,60722,20247,9772,10475
50545,78326,17602,37672,13019,60724,20248,9773,10475
50550,78336,17607,37679,13023,60728,20250,9775,10475
50555,78342,17607,37682,13023,60733,20253,9776,10477
50560,78353,17613,37689,13027,60737,20255,9778,10477
50565,78357,17618,37692,13032,60739,20256,9779,10477
50570,78367,17622,37698,13035,60744,20258,9781,10477
50575,78373,17623,37702,13036,60748,20261,9783,10478
50580,78384,17628,37707,13040,60754,20263,9783,10480
50585,78388,17630,37709,13042,60758,20264,9783,10481
50590,78398,17631,37715,13043,60766,20266,9784,10482
50595,78404,17631,37716,13043,60772,20269,9785,10484
50600,78415,17632,37719,13043,60782,20271,9786,10485
50605,78419,17632,37719,13043,60787,20272,9786,10486
50610,78429,17633,37724,13043,60795,20274,9788,10486
50615,78435,17633,37727,13043,60800,20277,9789,10488
50620,78446,17634,37731,13043,60811,20279,9790,10489
50625,78450,17634,37732,13043,60816,20280,9790,10490
50630,78460,17635,37737,13043,60824,20282,9792,10490
50635,78466,17635,37739,13043,60830,20285,9793,10492
50640,78477,17636,37743,13044,60841,20287,9795,10492
50645,78481,17636,37746,13044,60845,20288,9796,10492
50650,78491,17637,37749,13045,60854,20290,9796,10494
50655,78497,17637,37753,13045,60859,20293,9798,10495
50660,78508,17638,37759,13045,60869,20295,9799,10496
50665,78512,17638,37761,13045,60873,20296,9800,10496
50670,78522,17639,37765,13045,60882,20298,9801,10497
50675,78528,17639,37767,13045,60889,20301,9802,10499
50680,78539,17642,37770,13046,60897,20303,9802,10501
50685,78543,17643,37772,13047,60899,20304,9802,10502
50690,78553,17646,37776,13050,60907,20306,9802,10504
50695,78559,17646,37778,13050,60913,20309,9804,10505
50700,78570,17649,37783,13052,60919,20311,9805,10506
50705,78574,17650,37784,13053,60923,20312,9805,10507
50710,78584,17653,37789,13056,60930,20314,9806,10508
50715,78590,17653,37791,13056,60937,20317,9807,10510
50720,78601,17656,37795,13058,60945,20319,9808,10511
50725,78605,17657,37797,13059,60948,20320,9808,10512
50730,78615,17661,37803,13062,60954,20322,9810,10512
50735,78621,17661,37806,13062,60960,20325,9813,10512
50740,78632,17665,37811,13064,60966,20327,9815,10512
50745,78636,17667,37814,13066,60969,20328,9816,10512
50750,78646,17671,37819,13070,60974,20330,9816,10514
50755,78652,17671,37821,13070,60980,20333,9817,10516
50760,78663,17674,37826,13073,60988,20335,9817,10518
50765,78667,17675,37828,13074,60992,20336,9818,10518
50770,78677,17679,37834,13078,60997,20338,9818,10520
50775,78683,17679,37837,13078,61003,20341,9820,10521
50780,78694,17682,37840,13080,61012,20343,9821,10522
50785,78698,17684,37842,13082,61014,20344,9821,10523
50790,78708,17687,37845,13083,61020,20346,9822,10524
50795,78714,17687,37847,13083,61026,20349,9822,10527
50800,78725,17691,37851,13085,61034,20351,9823,10528
50805,78729,17691,37853,13085,61038,20352,9824,10528
50810,78739,17695,37857,13088,61044,20354,9824,10530
50815,78745,17695,37860,13088,61050,20357,9826,10531
50820,78756,17699,37867,13091,61056,20359,9827,10532
50825,78760,17701,37870,13093,61059,20360,9828,10532
50830,78770,17705,37876,13096,61064,20362,9830,10532
50835,78776,17705,37878,13096,61070,20365,9830,10535
50840,78787,17709,37885,13100,61077,20367,9831,10536
50845,78791,17712,37888,13103,61079,20368,9831,10537
50850,78801,17717,37893,13106,61084,20370,9832,10538
50855,78807,17717,37896,13106,61089,20373,9834,10539
50860,78818,17722,37902,13110,61095,20375,9834,10541
50865,78822,17724,37905,13112,61098,20376,9835,10541
50870,78832,17725,37908,13112,61106,20378,9837,10541
50875,78838,17725,37910,13112,61112,20381,9838,10543
50880,78849,17728,37915,13115,61120,20383,9838,10545
50885,78853,17728,37916,13115,61125,20384,9839,10545
50890,78863,17729,37920,13116,61134,20386,9840,10546
50895,78869,17729,37921,13116,61140,20389,9841,10548
50900,78880,17731,37926,13117,61149,20391,9843,10548
50905,78884,17732,37928,13118,61152,20392,9844,10548
50910,78894,17733,37934,13119,61160,20394,9846,10548
50915,78900,17733,37938,13119,61166,20397,9848,10549
50920,78911,17735,37943,13120,61174,20399,9849,10550
50925,78915,17735,37945,13120,61180,20400,9850,10550
50930,78925,17737,37948,13121,61187,20402,9850,10552
50935,78931,17737,37949,13121,61193,20405,9850,10555
50940,78942,17739,37953,13121,61201,20407,9850,10557
50945,78946,17739,37955,13121,61206,20408,9851,10557
50950,78956,17742,37960,13123,61214,20410,9852,10558
50955,78962,17742,37965,13123,61219,20413,9855,10558
50960,78973,17744,37971,13124,61227,20415,9856,10559
50965,78977,17744,37974,13124,61232,20416,9857,10559
50970,78987,17748,37979,13127,61239,20418,9857,10561
50975,78993,17748,37983,13127,61244,20421,9859,10562
50980,79004,17752,37990,13129,61249,20423,9861,10562
50985,79008,17753,37993,13130,61255,20424,9861,10563
50990,79018,17756,37999,13131,61261,20426,9863,10563
50995,79024,17756,38001,13131,61268,20429,9864,10565
51000,79035,17758,38006,13132,61274,20431,9865,10566
51005,79039,17759,38008,13133,61280,20432,9866,10566
51010,79049,17761,38011,13134,61288,20434,9867,10567
51015,79055,17761,38016,13134,61292,20437,9870,10567
51020,79066,17766,38020,13138,61300,20439,9870,10569
51025,79070,17767,38022,13139,61303,20440,9870,10570
51030,79080,17771,38027,13141,61309,20442,9871,10571
51035,79086,17771,38032,13141,61313,20445,9873,10572
51040,79097,17776,38036,13145,61321,20447,9873,10574
51045,79101,17776,38036,13145,61325,20448,9873,10575
51050,79111,17780,38044,13149,61330,20450,9873,10577
51055,79117,17780,38047,13149,61335,20453,9874,10579
51060,79128,17784,38051,13152,61343,20455,9874,10581
51065,79132,17785,38055,13153,61347,20456,9875,10581
51070,79142,17787,38059,13153,61355,20458,9877,10581
51075,79148,17787,38062,13153,61361,20461,9879,10582
51080,79159,17789,38065,13155,61370,20463,9880,10583
51085,79163,17789,38067,13155,61374,20464,9881,10583
51090,79173,17792,38073,13158,61381,20466,9883,10583
51095,79179,17792,38077,13158,61386,20469,9884,10585
51100,79190,17795,38082,13161,61395,20471,9884,10587
51105,79194,17796,38086,13162,61398,20472,9885,10587
51110,79204,17800,38091,13165,61403,20474,9885,10589
51115,79210,17800,38094,13165,61408,20477,9885,10592
51120,79221,17804,38097,13168,61416,20479,9885,10594
51125,79225,17805,38099,13169,61420,20480,9886,10594
51130,79235,17809,38105,13171,61425,20482,9888,10594
51135,79241,17809,38108,13171,61431,20485,9890,10595
51140,79252,17811,38110,13172,61441,20487,9890,10597
51145,79256,17811,38113,13172,61445,20488,9891,10597
51150,79266,17814,38119,13174,61451,20490,9892,10598
51155,79272,17814,38122,13174,61456,20493,9893,10600
51160,79283,17818,38126,13177,61465,20495,9895,10600
51165,79287,17818,38129,13177,61469,20496,9896,10600
51170,79297,17822,38134,13179,61473,20498,9897,10601
51175,79303,17822,38134,13179,61480,20501,9897,10604
51180,79314,17824,38141,13180,61487,20503,9899,10604
51185,79318,17824,38142,13180,61494,20504,9900,10604
51190,79328,17826,38145,13181,61502,20506,9902,10604
51195,79334,17826,38148,13181,61507,20509,9903,10606
51200,79345,17828,38152,13182,61516,20511,9905,10606
51205,79349,17829,38154,13183,61520,20512,9905,10607
51210,79359,17832,38161,13186,61527,20514,9907,10607
51215,79365,17832,38163,13186,61532,20517,9908,10609
51220,79376,17835,38169,13188,61541,20519,9909,10610
51225,79380,17836,38173,13189,61543,20520,9910,10610
51230,79390,17837,38179,13190,61553,20522,9912,10610
51235,79396,17837,38183,13190,61559,20525,9915,10610
51240,79407,17839,38186,13190,61567,20527,9916,10611
51245,79411,17840,38188,13191,61570,20528,9916,10612
51250,79421,17842,38192,13193,61578,20530,9916,10614
51255,79427,17842,38197,13193,61584,20533,9919,10614
51260,79438,17844,38202,13194,61593,20535,9921,10614
51265,79442,17845,38205,13195,61597,20536,9922,10614
51270,79452,17847,38210,13196,61604,20538,9924,10614
51275,79458,17847,38212,13196,61611,20541,9926,10615
51280,79469,17850,38216,13197,61618,20543,9927,10616
51285,79473,17851,38219,13198,61621,20544,9928,10616
51290,79483,17853,38223,13199,61629,20546,9929,10617
51295,79489,17853,38226,13199,61635,20549,9931,10618
51300,79500,17856,38231,13201,61642,20551,9933,10618
51305,79504,17856,38232,13201,61648,20552,9934,10618
51310,79514,17859,38237,13203,61654,20554,9935,10619
51315,79520,17859,38239,13203,61661,20557,9936,10621
51320,79531,17861,38242,13205,61670,20559,9936,10623
51325,79535,17861,38243,13205,61674,20560,9936,10624
51330,79545,17864,38248,13206,61681,20562,9937,10625
51335,79551,17864,38252,13206,61686,20565,9939,10626
51340,79562,17868,38259,13209,61692,20567,9941,10626
51345,79566,17869,38259,13210,61697,20568,9941,10627
51350,79576,17872,38262,13212,61703,20570,9941,10629
51355,79582,17872,38266,13212,61709,20573,9943,10630
51360,79593,17876,38270,13215,61717,20575,9944,10631
51365,79597,17877,38271,13216,61720,20576,9944,10632
51370,79607,17879,38276,13217,61727,20578,9946,10632
51375,79613,17879,38276,13217,61734,20581,9946,10635
51380,79624,17882,38283,13219,61740,20583,9947,10636
51385,79628,17883,38284,13220,61745,20584,9948,10636
51390,79638,17886,38288,13222,61751,20586,9949,10637
51395,79644,17886,38290,13222,61758,20589,9951,10638
51400,79655,17891,38298,13225,61762,20591,9952,10639
51405,79659,17893,38300,13227,61766,20592,9953,10639
51410,79669,17896,38305,13229,61772,20594,9953,10641
51415,79675,17896,38308,13229,61778,20597,9955,10642
51420,79686,17901,38312,13234,61785,20599,9955,10644
51425,79690,17902,38314,13235,61788,20600,9956,10644
51430,79700,17907,38318,13238,61793,20602,9957,10645
51435,79706,17907,38319,13238,61798,20605,9957,10648
51440,79717,17912,38326,13243,61803,20607,9958,10649
51445,79721,17915,38327,13246,61806,20608,9958,10650
51450,79731,17920,38333,13250,61811,20610,9960,10650
51455,79737,17920,38336,13250,61816,20613,9962,10651
51460,79748,17925,38341,13254,61821,20615,9962,10653
51465,79752,17929,38344,13258,61822,20616,9962,10654
51470,79762,17933,38352,13261,61828,20618,9964,10654
51475,79768,17933,38356,13261,61835,20621,9966,10655
51480,79779,17936,38362,13263,61843,20623,9967,10656
51485,79783,17937,38365,13264,61846,20624,9968,10656
51490,79793,17939,38372,13265,61853,20626,9969,10657
51495,79799,17939,38375,13265,61859,20629,9970,10659
51500,79810,17941,38382,13266,61869,20631,9971,10660
51505,79814,17941,38383,13266,61873,20632,9971,10661
51510,79824,17944,38387,13268,61880,20634,9972,10662
51515,79830,17944,38389,13268,61886,20637,9974,10663
51520,79841,17946,38392,13269,61895,20639,9974,10665
51525,79845,17946,38394,13269,61899,20640,9975,10665
51530,79855,17948,38398,13271,61907,20642,9975,10667
51535,79861,17948,38400,13271,61913,20645,9976,10669
51540,79872,17951,38405,13273,61921,20647,9977,10670
51545,79876,17951,38407,13273,61925,20648,9978,10670
51550,79886,17953,38412,13275,61933,20650,9979,10671
51555,79892,17953,38416,13275,61938,20653,9981,10672
51560,79903,17955,38419,13275,61948,20655,9981,10674
51565,79907,17956,38421,13276,61951,20656,9981,10675
51570,79917,17959,38425,13278,61957,20658,9981,10677
51575,79923,17959,38428,13278,61962,20661,9983,10678
51580,79934,17965,38434,13284,61968,20663,9984,10679
51585,79938,17967,38437,13286,61970,20664,9985,10679
51590,79948,17971,38441,13289,61976,20666,9986,10680
51595,79954,17972,38443,13290,61982,20669,9988,10681
51600,79965,17975,38447,13292,61988,20671,9988,10683
51605,79969,17976,38449,13293,61992,20672,9988,10684
51610,79979,17979,38452,13295,61999,20674,9988,10686
51615,79985,17979,38455,13295,62006,20677,9990,10687
51620,79996,17982,38460,13298,62013,20679,9990,10689
51625,80000,17982,38462,13298,62018,20680,9991,10689
51630,80010,17984,38467,13298,62024,20682,9993,10689
51635,80016,17984,38470,13298,62032,20685,9995,10690
51640,80027,17987,38476,13300,62037,20687,9995,10692
51645,80031,17988,38477,13301,62043,20688,9995,10693
51650,80041,17991,38481,13304,62049,20690,9995,10695
51655,80047,17991,38482,13304,62056,20693,9996,10697
51660,80058,17994,38487,13306,62064,20695,9998,10697
51665,80062,17995,38488,13307,62067,20696,9998,10698
51670,80072,17997,38492,13307,62075,20698,9999,10699
51675,80078,17997,38496,13307,62079,20701,10001,10700
51680,80089,18000,38502,13309,62087,20703,10001,10702
51685,80093,18001,38502,13310,62092,20704,10001,10703
51690,80103,18003,38510,13311,62099,20706,10003,10703
51695,80109,18003,38512,13311,62105,20709,10004,10705
51700,80120,18005,38516,13312,62112,20711,10004,10707
51705,80124,18006,38516,13313,62118,20712,10004,10708
51710,80134,18008,38521,13314,62126,20714,10005,10709
51715,80140,18008,38525,13314,62130,20717,10007,10710
51720,80151,18011,38529,13317,62139,20719,10008,10711
51725,80155,18011,38531,13317,62144,20720,10009,10711
51730,80165,18013,38536,13319,62152,20722,10009,10713
51735,80171,18013,38540,13319,62157,20725,10011,10714
51740,80182,18015,38545,13320,62166,20727,10013,10714
51745,80186,18016,38548,13321,62170,20728,10014,10714
51750,80196,18019,38552,13323,62176,20730,10014,10716
51755,80202,18019,38555,13323,62182,20733,10016,10717
51760,80213,18022,38561,13326,62190,20735,10016,10719
51765,80217,18023,38565,13327,62194,20736,10017,10719
51770,80227,18025,38568,13328,62201,20738,10018,10720
51775,80233,18025,38572,13328,62207,20741,10020,10721
51780,80244,18030,38579,13332,62213,20743,10021,10722
51785,80248,18031,38580,13333,62217,20744,10021,10723
51790,80258,18033,38584,13335,62225,20746,10022,10724
51795,80264,18033,38589,13335,62230,20749,10024,10725
51800,80275,18038,38596,13339,62237,20751,10026,10725
51805,80279,18039,38598,13340,62240,20752,10027,10725
51810,80289,18042,38602,13342,62246,20754,10027,10727
51815,80295,18042,38603,13342,62253,20757,10027,10730
51820,80306,18045,38610,13344,62260,20759,10028,10731
51825,80310,18047,38612,13346,62263,20760,10029,10731
51830,80320,18052,38619,13351,62268,20762,10030,10732
51835,80326,18052,38621,13351,62274,20765,10032,10733
51840,80337,18054,38627,13353,62283,20767,10034,10733
51845,80341,18055,38628,13354,62286,20768,10034,10734
51850,80351,18058,38631,13355,62292,20770,10035,10735
51855,80357,18058,38635,13355,62298,20773,10038,10735
51860,80368,18062,38641,13358,62306,20775,10039,10736
51865,80372,18063,38644,13359,62309,20776,10040,10736
51870,80382,18064,38648,13360,62317,20778,10040,10738
51875,80388,18064,38652,13360,62324,20781,10043,10738
51880,80399,18067,38658,13361,62332,20783,10043,10740
51885,80403,18067,38660,13361,62336,20784,10044,10740
51890,80413,18069,38667,13363,62342,20786,10045,10741
51895,80419,18069,38669,13363,62348,20789,10046,10743
51900,80430,18072,38671,13364,62357,20791,10046,10745
51905,80434,18072,38674,13364,62361,20792,10047,10745
51910,80444,18074,38679,13365,62368,20794,10048,10746
51915,80450,18074,38682,13365,62375,20797,10050,10747
51920,80461,18077,38688,13367,62383,20799,10051,10748
51925,80465,18077,38690,13367,62387,20800,10051,10749
51930,80475,18079,38695,13369,62396,20802,10051,10751
51935,80481,18079,38698,13369,62402,20805,10053,10752
51940,80492,18081,38701,13369,62410,20807,10054,10753
51945,80496,18081,38703,13369,62414,20808,10054,10754
51950,80506,18084,38712,13372,62420,20810,10055,10755
51955,80512,18084,38714,13372,62426,20813,10056,10757
51960,80523,18086,38717,13372,62435,20815,10056,10759
51965,80527,18086,38718,13372,62440,20816,10056,10760
51970,80537,18088,38724,13374,62448,20818,10058,10760
51975,80543,18088,38726,13374,62453,20821,10058,10763
51980,80554,18092,38730,13376,62462,20823,10059,10764
51985,80558,18093,38732,13377,62465,20824,10060,10764
51990,80568,18096,38737,13378,62472,20826,10062,10764
51995,80574,18096,38741,13378,62477,20829,10064,10765
52000,80585,18100,38743,13381,62485,20831,10064,10767
52005,80589,18101,38745,13382,62488,20832,10064,10768
52010,80599,18104,38750,13383,62495,20834,10066,10768
52015,80605,18104,38754,13383,62500,20837,10067,10770
52020,80616,18108,38758,13386,62508,20839,10068,10771
52025,80620,18108,38759,13386,62512,20840,10068,10772
52030,80630,18111,38761,13387,62519,20842,10069,10773
52035,80636,18111,38764,13387,62525,20845,10072,10773
52040,80647,18115,38770,13391,62531,20847,10073,10774
52045,80651,18117,38772,13393,62534,20848,10074,10774
52050,80661,18119,38778,13395,62542,20850,10075,10775
52055,80667,18119,38781,13395,62548,20853,10078,10775
52060,80678,18123,38787,13398,62555,20855,10079,10776
52065,80682,18124,38790,13399,62558,20856,10080,10776
52070,80692,18128,38795,13402,62564,20858,10081,10777
52075,80698,18128,38799,13402,62569,20861,10083,10778
52080,80709,18131,38805,13404,62577,20863,10085,10778
52085,80713,18133,38806,13406,62580,20864,10085,10779
52090,80723,18135,38810,13407,62587,20866,10087,10779
52095,80729,18135,38813,13407,62591,20869,10088,10781
52100,80740,18143,38819,13414,62597,20871,10090,10781
52105,80744,18143,38821,13414,62600,20872,10091,10781
52110,80754,18148,38828,13419,62604,20874,10092,10782
52115,80760,18149,38831,13420,62609,20877,10094,10783
52120,80771,18154,38835,13423,62615,20879,10095,10784
52125,80775,18158,38837,13427,62617,20880,10095,10785
52130,80785,18161,38842,13428,62622,20882,10097,10785
52135,80791,18162,38847,13429,62626,20885,10100,10785
52140,80802,18168,38854,13434,62632,20887,10101,10786
52145,80806,18168,38855,13434,62638,20888,10101,10787
52150,80816,18169,38858,13435,62647,20890,10101,10789
52155,80822,18169,38861,13435,62652,20893,10102,10791
52160,80833,18172,38867,13437,62660,20895,10103,10792
52165,80837,18172,38870,13437,62664,20896,10104,10792
52170,80847,18174,38877,13439,62671,20898,10106,10792
52175,80853,18174,38880,13439,62678,20901,10108,10793
52180,80864,18177,38885,13441,62687,20903,10109,10794
52185,80868,18177,38887,13441,62690,20904,10109,10795
52190,80878,18178,38890,13441,62699,20906,10109,10797
52195,80884,18178,38892,13441,62706,20909,10110,10799
52200,80895,18181,38899,13442,62712,20911,10112,10799
52205,80899,18182,38900,13443,62717,20912,10112,10800
52210,80909,18183,38906,13444,62725,20914,10113,10801
52215,80915,18183,38912,13444,62731,20917,10116,10801
52220,80926,18184,38917,13445,62742,20919,10116,10803
52225,80930,18184,38919,13445,62746,20920,10116,10804
52230,80940,18185,38925,13445,62754,20922,10117,10805
52235,80946,18185,38927,13445,62760,20925,10117,10808
52240,80957,18186,38934,13446,62771,20927,10118,10809
52245,80961,18186,38936,13446,62775,20928,10118,10810
52250,80971,18188,38943,13448,62783,20930,10120,10810
52255,80977,18188,38945,13448,62789,20933,10122,10811
52260,80988,18189,38949,13448,62799,20935,10123,10812
52265,80992,18189,38950,13448,62803,20936,10123,10813
52270,81002,18191,38954,13450,62810,20938,10124,10814
52275,81008,18191,38958,13450,62816,20941,10126,10815
52280,81019,18195,38963,13453,62823,20943,10126,10817
52285,81023,18197,38965,13455,62826,20944,10126,10818
52290,81033,18199,38970,13456,62834,20946,10127,10819
52295,81039,18199,38973,13456,62840,20949,10129,10820
52300,81050,18200,38978,13456,62850,20951,10131,10820
52305,81054,18201,38981,13457,62853,20952,10132,10820
52310,81064,18206,38986,13460,62858,20954,10132,10822
52315,81070,18206,38990,13460,62863,20957,10134,10823
52320,81081,18210,38993,13462,62871,20959,10135,10824
52325,81085,18211,38994,13463,62874,20960,10135,10825
52330,81095,18214,38997,13464,62880,20962,10136,10826
52335,81101,18214,39001,13464,62886,20965,10139,10826
52340,81112,18217,39001,13465,62895,20967,10139,10828
52345,81116,18219,39004,13467,62896,20968,10139,10829
52350,81126,18225,39011,13472,62899,20970,10140,10830
52355,81132,18226,39013,13473,62904,20973,10141,10832
52360,81143,18233,39020,13479,62908,20975,10142,10833
52365,81147,18236,39021,13482,62911,20976,10142,10834
52370,81157,18238,39027,13484,62919,20978,10144,10834
52375,81163,18238,39028,13484,62924,20981,10144,10837
52380,81174,18240,39033,13485,62933,20983,10146,10837
52385,81178,18241,39035,13486,62937,20984,10146,10838
52390,81188,18244,39039,13489,62944,20986,10147,10839
52395,81194,18244,39044,13489,62948,20989,10150,10839
52400,81205,18247,39049,13491,62958,20991,10152,10839
52405,81209,18247,39050,13491,62962,20992,10153,10839
52410,81219,18249,39056,13492,62969,20994,10155,10839
52415,81225,18249,39062,13492,62973,20997,10158,10839
52420,81236,18252,39067,13493,62983,20999,10159,10840
52425,81240,18253,39070,13494,62986,21000,10160,10840
52430,81250,18255,39072,13495,62995,21002,10160,10842
52435,81256,18255,39077,13495,63000,21005,10163,10842
52440,81267,18257,39080,13495,63009,21007,10164,10843
52445,81271,18257,39082,13495,63013,21008,10165,10843
52450,81281,18259,39088,13496,63022,21010,10167,10843
52455,81287,18259,39091,13496,63027,21013,10169,10844
52460,81298,18262,39094,13497,63036,21015,10169,10846
52465,81302,18262,39094,13497,63040,21016,10169,10847
52470,81312,18264,39097,13498,63047,21018,10169,10849
52475,81318,18264,39099,13498,63053,21021,10169,10852
52480,81329,18267,39104,13500,63061,21023,10170,10853
52485,81333,18267,39105,13500,63066,21024,10171,10853
52490,81343,18270,39111,13502,63073,21026,10173,10853
52495,81349,18270,39113,13502,63079,21029,10174,10855
52500,81360,18273,39121,13505,63085,21031,10175,10856
52505,81364,18275,39124,13507,63089,21032,10175,10857
52510,81374,18279,39127,13509,63094,21034,10175,10859
52515,81380,18279,39129,13509,63101,21037,10176,10861
52520,81391,18281,39137,13511,63109,21039,10178,10861
52525,81395,18282,39138,13512,63113,21040,10178,10862
52530,81405,18286,39144,13516,63119,21042,10179,10863
52535,81411,18286,39147,13516,63124,21045,10181,10864
52540,81422,18291,39154,13520,63130,21047,10182,10865
52545,81426,18293,39156,13522,63133,21048,10183,10865
52550,81436,18296,39161,13523,63139,21050,10184,10866
52555,81442,18296,39163,13523,63146,21053,10185,10868
52560,81453,18298,39167,13524,63153,21055,10186,10869
52565,81457,18300,39168,13526,63157,21056,10187,10869
52570,81467,18305,39175,13530,63161,21058,10188,10870
52575,81473,18305,39179,13530,63167,21061,10190,10871
52580,81484,18308,39182,13531,63176,21063,10192,10871
52585,81488,18309,39184,13532,63179,21064,10192,10872
52590,81498,18313,39187,13534,63184,21066,10192,10874
52595,81504,18313,39189,13534,63191,21069,10194,10875
52600,81515,18317,39194,13536,63197,21071,10195,10876
52605,81519,18318,39195,13537,63201,21072,10196,10876
52610,81529,18322,39200,13540,63206,21074,10197,10877
52615,81535,18322,39202,13540,63212,21077,10197,10880
52620,81546,18328,39210,13545,63217,21079,10198,10881
52625,81550,18330,39213,13547,63220,21080,10199,10881
52630,81560,18334,39218,13550,63226,21082,10199,10883
52635,81566,18334,39223,13550,63230,21085,10202,10883
52640,81577,18338,39229,13554,63238,21087,10204,10883
52645,81581,18339,39230,13555,63242,21088,10204,10884
52650,81591,18342,39238,13557,63248,21090,10206,10884
52655,81597,18342,39241,13557,63254,21093,10208,10885
52660,81608,18345,39247,13559,63263,21095,10210,10885
52665,81612,18345,39249,13559,63267,21096,10211,10885
52670,81622,18348,39254,13561,63272,21098,10212,10886
52675,81628,18348,39255,13561,63278,21101,10212,10889
52680,81639,18349,39261,13561,63287,21103,10213,10890
52685,81643,18349,39265,13561,63293,21104,10214,10890
52690,81653,18350,39268,13562,63303,21106,10215,10891
52695,81659,18350,39272,13562,63307,21109,10217,10892
52700,81670,18351,39275,13562,63319,21111,10217,10894
52705,81674,18351,39279,13562,63322,21112,10218,10894
52710,81684,18352,39285,13563,63332,21114,10219,10895
52715,81690,18352,39285,13563,63338,21117,10219,10898
52720,81701,18353,39292,13563,63347,21119,10220,10899
52725,81705,18353,39294,13563,63351,21120,10220,10900
52730,81715,18355,39300,13564,63360,21122,10221,10901
52735,81721,18355,39304,13564,63366,21125,10223,10902
52740,81732,18358,39312,13567,63373,21127,10224,10903
52745,81736,18359,39316,13568,63376,21128,10225,10903
52750,81746,18362,39322,13570,63384,21130,10226,10904
52755,81752,18362,39325,13570,63389,21133,10227,10906
52760,81763,18364,39332,13572,63398,21135,10228,10907
52765,81767,18364,39333,13572,63403,21136,10228,10908
52770,81777,18366,39336,13573,63411,21138,10228,10910
52775,81783,18366,39340,13573,63416,21141,10230,10911
52780,81794,18370,39342,13575,63424,21143,10230,10913
52785,81798,18371,39344,13576,63426,21144,10230,10914
52790,81808,18375,39350,13578,63432,21146,10232,10914
52795,81814,18375,39351,13578,63439,21149,10233,10916
52800,81825,18378,39358,13580,63444,21151,10234,10917
52805,81829,18379,39359,13581,63450,21152,10235,10917
52810,81839,18382,39364,13583,63456,21154,10236,10918
52815,81845,18382,39367,13583,63462,21157,10237,10920
52820,81856,18387,39374,13587,63466,21159,10237,10922
52825,81860,18388,39376,13588,63472,21160,10238,10922
52830,81870,18392,39382,13591,63477,21162,10239,10923
52835,81876,18392,39384,13591,63483,21165,10240,10925
52840,81887,18395,39387,13593,63492,21167,10241,10926
52845,81891,18395,39387,13593,63496,21168,10241,10927
52850,81901,18399,39394,13596,63501,21170,10241,10929
52855,81907,18399,39396,13596,63508,21173,10243,10930
52860,81918,18403,39402,13599,63515,21175,10244,10931
52865,81922,18405,39405,13601,63517,21176,10245,10931
52870,81932,18409,39411,13604,63523,21178,10246,10932
52875,81938,18409,39413,13604,63529,21181,10248,10933
52880,81949,18413,39420,13606,63534,21183,10250,10933
52885,81953,18416,39423,13609,63537,21184,10251,10933
52890,81963,18419,39430,13611,63544,21186,10253,10933
52895,81969,18419,39432,13611,63549,21189,10253,10936
52900,81980,18421,39435,13611,63559,21191,10255,10936
52905,81984,18421,39436,13611,63563,21192,10255,10937
52910,81994,18424,39443,13613,63569,21194,10257,10937
52915,82000,18424,39444,13613,63576,21197,10258,10939
52920,82011,18428,39449,13615,63582,21199,10259,10940
52925,82015,18429,39451,13616,63586,21200,10260,10940
52930,82025,18433,39456,13619,63592,21202,10260,10942
52935,82031,18433,39460,13619,63597,21205,10261,10944
52940,82042,18437,39465,13622,63604,21207,10262,10945
52945,82046,18439,39467,13624,63607,21208,10262,10946
52950,82056,18442,39473,13627,63613,21210,10264,10946
52955,82062,18442,39478,13627,63619,21213,10267,10946
52960,82073,18447,39483,13630,63625,21215,10267,10948
52965,82077,18449,39486,13632,63628,21216,10268,10948
52970,82087,18453,39492,13635,63633,21218,10270,10948
52975,82093,18453,39498,13635,63638,21221,10273,10948
52980,82104,18457,39499,13637,63647,21223,10273,10950
52985,82108,18458,39503,13638,63650,21224,10274,10950
52990,82118,18460,39508,13640,63658,21226,10276,10950
52995,82124,18460,39513,13640,63662,21229,10279,10950
53000,82135,18463,39518,13642,63671,21231,10280,10951
53005,82139,18465,39519,13644,63674,21232,10280,10952
53010,82149,18467,39522,13644,63682,21234,10282,10952
53015,82155,18467,39528,13644,63686,21237,10285,10952
53020,82166,18470,39535,13647,63696,21239,10286,10953
53025,82170,18470,39536,13647,63700,21240,10286,10954
53030,82180,18471,39541,13648,63709,21242,10287,10955
53035,82186,18471,39543,13648,63715,21245,10289,10956
53040,82197,18472,39547,13648,63723,21247,10290,10957
53045,82201,18472,39550,13648,63728,21248,10291,10957
53050,82211,18473,39554,13648,63737,21250,10292,10958
53055,82217,18473,39557,13648,63742,21253,10294,10959
53060,82228,18474,39561,13648,63752,21255,10294,10961
53065,82232,18474,39563,13648,63758,21256,10295,10961
53070,82242,18475,39569,13649,63766,21258,10297,10961
53075,82248,18475,39570,13649,63772,21261,10298,10963
53080,82259,18476,39578,13650,63781,21263,10300,10963
53085,82263,18476,39580,13650,63787,21264,10300,10964
53090,82273,18477,39584,13651,63795,21266,10300,10966
53095,82279,18477,39587,13651,63802,21269,10302,10967
53100,82290,18480,39595,13653,63808,21271,10304,10967
53105,82294,18481,39597,13654,63813,21272,10305,10967
53110,82304,18484,39604,13657,63819,21274,10306,10968
53115,82310,18484,39609,13657,63823,21277,10308,10969
53120,82321,18486,39615,13658,63832,21279,10308,10971
53125,82325,18488,39618,13660,63836,21280,10309,10971
53130,82335,18490,39621,13660,63844,21282,10310,10972
53135,82341,18490,39625,13660,63849,21285,10311,10974
53140,82352,18494,39629,13663,63858,21287,10312,10975
53145,82356,18495,39631,13664,63861,21288,10312,10976
53150,82366,18498,39636,13666,63868,21290,10313,10977
53155,82372,18498,39639,13666,63873,21293,10315,10978
53160,82383,18503,39645,13670,63879,21295,10316,10979
53165,82387,18503,39646,13670,63884,21296,10316,10980
53170,82397,18507,39652,13674,63889,21298,10317,10981
53175,82403,18507,39653,13674,63896,21301,10318,10983
53180,82414,18510,39660,13676,63901,21303,10319,10984
53185,82418,18511,39661,13677,63907,21304,10319,10985
53190,82428,18514,39664,13679,63914,21306,10320,10986
53195,82434,18514,39665,13679,63920,21309,10321,10988
53200,82445,18517,39672,13681,63925,21311,10322,10989
53205,82449,18518,39675,13682,63931,21312,10322,10990
53210,82459,18521,39681,13685,63938,21314,10324,10990
53215,82465,18521,39686,13685,63943,21317,10327,10990
53220,82476,18524,39691,13686,63950,21319,10327,10992
53225,82480,18525,39693,13687,63955,21320,10328,10992
53230,82490,18529,39699,13691,63960,21322,10328,10994
53235,82496,18529,39700,13691,63967,21325,10329,10996
53240,82507,18534,39705,13694,63973,21327,10330,10997
53245,82511,18535,39707,13695,63976,21328,10331,10997
53250,82521,18538,39713,13697,63982,21330,10333,10997
53255,82527,18538,39715,13697,63989,21333,10334,10999
53260,82538,18542,39719,13700,63996,21335,10335,11000
53265,82542,18542,39719,13700,64000,21336,10335,11001
53270,82552,18547,39726,13705,64004,21338,10335,11003
53275,82558,18547,39729,13705,64010,21341,10336,11005
53280,82569,18553,39736,13711,64015,21343,10336,11007
53285,82573,18555,39738,13713,64018,21344,10336,11008
53290,82583,18558,39743,13716,64024,21346,10337,11009
53295,82589,18558,39747,13716,64030,21349,10338,11011
53300,82600,18562,39750,13719,64037,21351,10338,11013
53305,82604,18564,39753,13721,64040,21352,10339,11013
53310,82614,18566,39755,13721,64047,21354,10339,11015
53315,82620,18566,39759,13721,64052,21357,10340,11017
53320,82631,18571,39763,13725,64060,21359,10341,11018
53325,82635,18571,39765,13725,64064,21360,10342,11018
53330,82645,18575,39770,13728,64070,21362,10344,11018
53335,82651,18575,39773,13728,64074,21365,10345,11020
53340,82662,18581,39778,13733,64079,21367,10345,11022
53345,82666,18582,39782,13734,64083,21368,10346,11022
53350,82676,18583,39788,13735,64092,21370,10347,11023
53355,82682,18583,39790,13735,64098,21373,10348,11025
53360,82693,18585,39797,13736,64106,21375,10349,11026
53365,82697,18585,39797,13736,64112,21376,10349,11027
53370,82707,18587,39802,13737,64119,21378,10351,11027
53375,82713,18587,39805,13737,64124,21381,10352,11029
53380,82724,18589,39810,13737,64133,21383,10354,11029
53385,82728,18589,39812,13737,64138,21384,10354,11030
53390,82738,18592,39818,13740,64145,21386,10354,11032
53395,82744,18592,39820,13740,64151,21389,10354,11035
53400,82755,18595,39822,13741,64160,21391,10355,11036
53405,82759,18596,39825,13742,64162,21392,10355,11037
53410,82769,18598,39830,13743,64169,21394,10356,11038
53415,82775,18598,39833,13743,64177,21397,10358,11039
53420,82786,18601,39840,13744,64185,21399,10360,11039
53425,82790,18602,39843,13745,64188,21400,10361,11039
53430,82800,18604,39845,13747,64196,21402,10361,11041
53435,82806,18604,39849,13747,64201,21405,10364,11041
53440,82817,18606,39854,13747,64210,21407,10364,11043
53445,82821,18607,39858,13748,64214,21408,10365,11043
53450,82831,18610,39864,13751,64221,21410,10365,11045
53455,82837,18610,39867,13751,64226,21413,10366,11047
53460,82848,18613,39871,13753,64235,21415,10367,11048
53465,82852,18614,39873,13754,64238,21416,10367,11049
53470,82862,18616,39878,13755,64246,21418,10367,11051
53475,82868,18616,39883,13755,64251,21421,10370,11051
53480,82879,18618,39888,13756,64261,21423,10371,11052
53485,82883,18618,39891,13756,64265,21424,10372,11052
53490,82893,18620,39897,13757,64272,21426,10372,11054
53495,82899,18620,39900,13757,64279,21429,10373,11056
53500,82910,18621,39905,13758,64289,21431,10374,11057
53505,82914,18621,39905,13758,64293,21432,10374,11058
53510,82924,18623,39912,13759,64300,21434,10374,11060
53515,82930,18623,39914,13759,64307,21437,10375,11062
53520,82941,18624,39918,13760,64316,21439,10375,11064
53525,82945,18626,39921,13762,64319,21440,10376,11064
53530,82955,18630,39927,13765,64325,21442,10377,11065
53535,82961,18630,39931,13765,64329,21445,10379,11066
53540,82972,18634,39936,13768,64337,21447,10380,11067
53545,82976,18635,39937,13769,64341,21448,10380,11068
53550,82986,18639,39944,13772,64347,21450,10381,11069
53555,82992,18639,39945,13772,64352,21453,10381,11072
53560,83003,18643,39949,13775,64360,21455,10381,11074
53565,83007,18644,39953,13776,64362,21456,10382,11074
53570,83017,18647,39956,13778,64368,21458,10382,11076
53575,83023,18648,39958,13779,64373,21461,10383,11078
53580,83034,18653,39965,13783,64378,21463,10385,11078
53585,83038,18656,39968,13786,64382,21464,10386,11078
53590,83048,18657,39970,13786,64390,21466,10387,11079
53595,83054,18657,39974,13786,64396,21469,10389,11080
53600,83065,18660,39982,13788,64403,21471,10390,11081
53605,83069,18660,39984,13788,64408,21472,10390,11082
53610,83079,18662,39988,13790,64417,21474,10390,11084
53615,83085,18662,39992,13790,64422,21477,10392,11085
53620,83096,18664,39998,13791,64430,21479,10392,11087
53625,83100,18664,40000,13791,64435,21480,10393,11087
53630,83110,18666,40007,13793,64442,21482,10394,11088
53635,83116,18666,40010,13793,64449,21485,10395,11090
53640,83127,18669,40015,13794,64457,21487,10396,11091
53645,83131,18669,40016,13794,64462,21488,10396,11092
53650,83141,18671,40018,13795,64470,21490,10397,11093
53655,83147,18671,40019,13795,64476,21493,10397,11096
53660,83158,18673,40022,13795,64485,21495,10399,11096
53665,83162,18674,40024,13796,64488,21496,10400,11096
53670,83172,18675,40028,13797,64497,21498,10401,11097
53675,83178,18675,40032,13797,64503,21501,10403,11098
53680,83189,18678,40038,13799,64511,21503,10404,11099
53685,83193,18679,40041,13800,64514,21504,10404,11100
53690,83203,18681,40047,13802,64521,21506,10404,11102
53695,83209,18681,40050,13802,64528,21509,10405,11104
53700,83220,18684,40055,13804,64535,21511,10406,11105
53705,83224,18686,40058,13806,64538,21512,10406,11106
53710,83234,18688,40063,13807,64546,21514,10408,11106
53715,83240,18688,40065,13807,64552,21517,10408,11109
53720,83251,18693,40072,13811,64557,21519,10409,11110
53725,83255,18694,40073,13812,64561,21520,10409,11111
53730,83265,18697,40079,13814,64568,21522,10410,11112
53735,83271,18697,40082,13814,64574,21525,10413,11112
53740,83282,18701,40087,13817,64581,21527,10413,11114
53745,83286,18701,40088,13817,64585,21528,10414,11114
53750,83296,18706,40092,13820,64589,21530,10414,11116
53755,83302,18707,40097,13821,64592,21533,10416,11117
53760,83313,18713,40104,13827,64596,21535,10416,11119
53765,83317,18719,40107,13833,64598,21536,10417,11119
53770,83327,18722,40109,13835,64605,21538,10417,11121
53775,83333,18722,40112,13835,64610,21541,10419,11122
53780,83344,18727,40117,13838,64615,21543,10420,11123
53785,83348,18728,40119,13839,64620,21544,10421,11123
53790,83358,18730,40125,13841,64628,21546,10423,11123
53795,83364,18730,40129,13841,64632,21549,10425,11124
53800,83375,18732,40131,13842,64643,21551,10426,11125
53805,83379,18733,40134,13843,64645,21552,10427,11125
53810,83389,18735,40139,13845,64652,21554,10428,11126
53815,83395,18735,40142,13845,64658,21557,10430,11127
53820,83406,18738,40148,13848,64668,21559,10431,11128
53825,83410,18739,40151,13849,64670,21560,10432,11128
53830,83420,18740,40154,13849,64680,21562,10434,11128
53835,83426,18740,40157,13849,64686,21565,10436,11129
53840,83437,18742,40162,13850,64692,21567,10437,11130
53845,83441,18742,40165,13850,64698,21568,10438,11130
53850,83451,18743,40168,13851,64708,21570,10439,11131
53855,83457,18743,40171,13851,64714,21573,10440,11133
53860,83468,18745,40174,13852,64722,21575,10440,11135
53865,83472,18745,40176,13852,64727,21576,10440,11136
53870,83482,18747,40181,13854,64734,21578,10442,11136
53875,83488,18747,40184,13854,64741,21581,10444,11137
53880,83499,18750,40187,13855,64749,21583,10445,11138
53885,83503,18751,40188,13856,64752,21584,10445,11139
53890,83513,18754,40193,13858,64758,21586,10447,11139
53895,83519,18754,40196,13858,64763,21589,10448,11141
53900,83530,18759,40203,13861,64767,21591,10449,11142
53905,83534,18761,40204,13863,64773,21592,10449,11143
53910,83544,18764,40211,13865,64779,21594,10450,11144
53915,83550,18764,40213,13865,64785,21597,10451,11146
53920,83561,18769,40220,13870,64791,21599,10451,11148
53925,83565,18770,40223,13871,64795,21600,10452,11148
53930,83575,18772,40227,13873,64802,21602,10452,11150
53935,83581,18772,40228,13873,64808,21605,10452,11153
53940,83592,18774,40232,13875,64818,21607,10453,11154
53945,83596,18775,40234,13876,64821,21608,10453,11155
53950,83606,18778,40240,13878,64827,21610,10455,11155
53955,83612,18778,40243,13878,64834,21613,10458,11155
53960,83623,18782,40249,13882,64841,21615,10459,11156
53965,83627,18783,40252,13883,64844,21616,10460,11156
53970,83637,18787,40258,13886,64849,21618,10461,11157
53975,83643,18787,40260,13886,64856,21621,10463,11158
53980,83654,18791,40264,13889,64862,21623,10463,11160
53985,83658,18793,40266,13891,64865,21624,10463,11161
53990,83668,18796,40271,13893,64871,21626,10465,11161
53995,83674,18796,40275,13893,64877,21629,10467,11162
54000,83685,18801,40282,13897,64884,21631,10468,11163
54005,83689,18802,40283,13898,64887,21632,10468,11164
54010,83699,18805,40288,13900,64893,21634,10469,11165
54015,83705,18805,40292,13900,64899,21637,10471,11166
54020,83716,18811,40298,13904,64905,21639,10471,11168
54025,83720,18812,40301,13905,64908,21640,10472,11168
54030,83730,18817,40305,13908,64912,21642,10473,11169
54035,83736,18817,40309,13908,64918,21645,10475,11170
54040,83747,18821,40311,13910,64926,21647,10475,11172
54045,83751,18823,40314,13912,64927,21648,10475,11173
54050,83761,18828,40317,13915,64932,21650,10475,11175
54055,83767,18828,40319,13915,64936,21653,10475,11178
54060,83778,18834,40321,13919,64943,21655,10475,11180
54065,83782,18834,40325,13919,64947,21656,10476,11180
54070,83792,18835,40327,13919,64956,21658,10476,11182
54075,83798,18835,40329,13919,64962,21661,10477,11184
54080,83809,18836,40333,13920,64973,21663,10478,11185
54085,83813,18836,40334,13920,64977,21664,10478,11186
54090,83823,18837,40341,13921,64985,21666,10480,11186
54095,83829,18837,40343,13921,64990,21669,10480,11189
54100,83840,18838,40347,13922,65002,21671,10481,11190
54105,83844,18838,40349,13922,65006,21672,10481,11191
54110,83854,18839,40353,13923,65014,21674,10482,11192
54115,83860,18839,40354,13923,65021,21677,10483,11194
54120,83871,18840,40359,13924,65030,21679,10484,11195
54125,83875,18840,40362,13924,65034,21680,10485,11195
54130,83885,18841,40368,13924,65043,21682,10487,11195
54135,83891,18841,40373,13924,65048,21685,10489,11196
54140,83902,18842,40376,13924,65059,21687,10489,11198
54145,83906,18842,40377,13924,65064,21688,10489,11199
54150,83916,18843,40383,13924,65072,21690,10490,11200
54155,83922,18843,40386,13924,65078,21693,10491,11202
54160,83933,18844,40389,13924,65089,21695,10492,11203
54165,83937,18844,40391,13924,65092,21696,10493,11203
54170,83947,18846,40395,13925,65100,21698,10494,11204
54175,83953,18846,40400,13925,65106,21701,10497,11204
54180,83964,18851,40408,13929,65110,21703,10498,11205
54185,83968,18853,40410,13931,65114,21704,10498,11206
54190,83978,18855,40413,13932,65122,21706,10499,11207
54195,83984,18855,40416,13932,65129,21709,10502,11207
54200,83995,18859,40424,13936,65133,21711,10503,11208
54205,83999,18860,40426,13937,65138,21712,10503,11209
54210,84009,18862,40430,13937,65145,21714,10504,11210
54215,84015,18862,40433,13937,65151,21717,10504,11213
54220,84026,18866,40440,13941,65158,21719,10506,11213
54225,84030,18866,40441,13941,65164,21720,10507,11213
54230,84040,18870,40448,13944,65169,21722,10508,11214
54235,84046,18870,40449,13944,65176,21725,10509,11216
54240,84057,18873,40453,13945,65182,21727,10510,11217
54245,84061,18873,40453,13945,65188,21728,10510,11218
54250,84071,18877,40460,13948,65193,21730,10510,11220
54255,84077,18877,40463,13948,65199,21733,10512,11221
54260,84088,18880,40470,13951,65206,21735,10513,11222
54265,84092,18882,40473,13953,65210,21736,10514,11222
54270,84102,18885,40477,13955,65216,21738,10515,11223
54275,84108,18885,40478,13955,65223,21741,10516,11225
54280,84119,18888,40482,13956,65230,21743,10517,11226
54285,84123,18890,40484,13958,65233,21744,10518,11226
54290,84133,18892,40490,13960,65240,21746,10519,11227
54295,84139,18892,40493,13960,65246,21749,10520,11229
54300,84150,18895,40495,13961,65255,21751,10521,11230
54305,84154,18896,40498,13962,65258,21752,10522,11230
54310,84164,18900,40504,13965,65263,21754,10524,11230
54315,84170,18900,40509,13965,65269,21757,10527,11230
54320,84181,18906,40516,13969,65275,21759,10529,11230
54325,84185,18907,40518,13970,65278,21760,10529,11231
54330,84195,18911,40525,13972,65283,21762,10531,11231
54335,84201,18911,40527,13972,65289,21765,10531,11234
54340,84212,18915,40533,13975,65296,21767,10532,11235
54345,84216,18918,40537,13978,65298,21768,10533,11235
54350,84226,18920,40540,13980,65305,21770,10534,11236
54355,84232,18920,40542,13980,65310,21773,10534,11239
54360,84243,18924,40545,13982,65319,21775,10536,11239
54365,84247,18924,40547,13982,65323,21776,10537,11239
54370,84257,18929,40554,13986,65326,21778,10538,11240
54375,84263,18929,40558,13986,65332,21781,10540,11241
54380,84274,18931,40563,13987,65341,21783,10541,11242
54385,84278,18931,40564,13987,65346,21784,10541,11243
54390,84288,18934,40571,13989,65352,21786,10543,11243
54395,84294,18934,40575,13989,65357,21789,10544,11245
54400,84305,18937,40581,13992,65366,21791,10545,11246
54405,84309,18937,40583,13992,65372,21792,10546,11246
54410,84319,18939,40587,13994,65380,21794,10546,11248
54415,84325,18939,40591,13994,65385,21797,10548,11249
54420,84336,18941,40594,13995,65394,21799,10549,11250
54425,84340,18942,40596,13996,65397,21800,10549,11251
54430,84350,18945,40601,13999,65405,21802,10549,11253
54435,84356,18945,40604,13999,65410,21805,10550,11255
54440,84367,18947,40608,14000,65418,21807,10550,11257
54445,84371,18947,40609,14000,65424,21808,10550,11258
54450,84381,18948,40614,14000,65432,21810,10551,11259
54455,84387,18948,40616,14000,65439,21813,10552,11261
54460,84398,18951,40621,14001,65447,21815,10553,11262
54465,84402,18951,40621,14001,65451,21816,10553,11263
54470,84412,18953,40627,14003,65458,21818,10555,11263
54475,84418,18953,40631,14003,65464,21821,10557,11264
54480,84429,18958,40638,14008,65471,21823,10558,11265
54485,84433,18958,40640,14008,65475,21824,10559,11265
54490,84443,18960,40643,14009,65482,21826,10559,11267
54495,84449,18960,40646,14009,65487,21829,10560,11269
54500,84460,18964,40653,14011,65494,21831,10562,11269
54505,84464,18966,40657,14013,65498,21832,10563,11269
54510,84474,18970,40664,14017,65503,21834,10563,11271
54515,84480,18970,40667,14017,65509,21837,10565,11272
54520,84491,18973,40671,14018,65517,21839,10567,11272
54525,84495,18975,40672,14020,65520,21840,10567,11273
54530,84505,18978,40677,14022,65527,21842,10568,11274
54535,84511,18978,40678,14022,65533,21845,10569,11276
54540,84522,18981,40684,14024,65540,21847,10570,11277
54545,84526,18982,40684,14025,65544,21848,10570,11278
54550,84536,18984,40686,14025,65552,21850,10570,11280
54555,84542,18984,40690,14025,65557,21853,10572,11281
54560,84553,18989,40696,14030,65563,21855,10572,11283
54565,84557,18991,40698,14032,65566,21856,10572,11284
54570,84567,18993,40701,14033,65573,21858,10573,11285
54575,84573,18993,40706,14033,65578,21861,10575,11286
54580,84584,18999,40712,14038,65584,21863,10576,11287
54585,84588,19001,40713,14040,65587,21864,10576,11288
54590,84598,19006,40720,14044,65591,21866,10577,11289
54595,84604,19006,40722,14044,65598,21869,10578,11291
54600,84615,19009,40728,14046,65606,21871,10579,11292
54605,84619,19010,40731,14047,65609,21872,10580,11292
54610,84629,19016,40737,14052,65613,21874,10581,11293
54615,84635,19016,40739,14052,65619,21877,10582,11295
54620,84646,19019,40742,14053,65627,21879,10583,11296
54625,84650,19019,40743,14053,65630,21880,10583,11297
54630,84660,19021,40746,14055,65639,21882,10583,11299
54635,84666,19021,40749,14055,65644,21885,10585,11300
54640,84677,19024,40754,14057,65652,21887,10586,11301
54645,84681,19025,40757,14058,65656,21888,10587,11301
54650,84691,19027,40762,14059,65663,21890,10588,11302
54655,84697,19027,40767,14059,65669,21893,10591,11302
54660,84708,19030,40777,14062,65675,21895,10593,11302
54665,84712,19030,40778,14062,65682,21896,10593,11303
54670,84722,19032,40785,14063,65688,21898,10594,11304
54675,84728,19032,40787,14063,65695,21901,10595,11306
54680,84739,19035,40791,14064,65702,21903,10595,11308
54685,84743,19036,40794,14065,65707,21904,10596,11308
54690,84753,19038,40800,14067,65713,21906,10596,11310
54695,84759,19038,40803,14067,65720,21909,10597,11312
54700,84770,19039,40808,14068,65729,21911,10597,11314
54705,84774,19039,40811,14068,65735,21912,10598,11314
54710,84784,19040,40818,14069,65743,21914,10599,11315
54715,84790,19040,40820,14069,65748,21917,10599,11318
54720,84801,19043,40828,14072,65755,21919,10600,11319
54725,84805,19044,40829,14073,65761,21920,10600,11320
54730,84815,19046,40834,14075,65769,21922,10601,11321
54735,84821,19046,40836,14075,65774,21925,10602,11323
54740,84832,19049,40842,14078,65783,21927,10604,11323
54745,84836,19049,40844,14078,65787,21928,10604,11324
54750,84846,19051,40848,14079,65794,21930,10605,11325
54755,84852,19051,40850,14079,65801,21933,10606,11327
54760,84863,19053,40854,14081,65810,21935,10606,11329
54765,84867,19053,40855,14081,65814,21936,10607,11329
54770,84877,19055,40857,14081,65822,21938,10607,11331
54775,84883,19055,40859,14081,65828,21941,10608,11333
54780,84894,19058,40864,14084,65836,21943,10608,11335
54785,84898,19059,40866,14085,65839,21944,10608,11336
54790,84908,19061,40869,14085,65846,21946,10608,11338
54795,84914,19061,40872,14085,65852,21949,10610,11339
54800,84925,19066,40877,14088,65858,21951,10611,11340
54805,84929,19068,40878,14090,65861,21952,10611,11341
54810,84939,19072,40882,14092,65867,21954,10611,11343
54815,84945,19072,40885,14092,65872,21957,10612,11345
54820,84956,19076,40889,14095,65880,21959,10613,11346
54825,84960,19077,40890,14096,65883,21960,10613,11347
54830,84970,19080,40894,14097,65889,21962,10615,11347
54835,84976,19081,40896,14098,65894,21965,10616,11349
54840,84987,19086,40902,14101,65899,21967,10618,11349
54845,84991,19086,40903,14101,65904,21968,10618,11350
54850,85001,19088,40906,14102,65913,21970,10619,11351
54855,85007,19088,40910,14102,65919,21973,10622,11351
54860,85018,19090,40915,14102,65926,21975,10623,11352
54865,85022,19091,40918,14103,65930,21976,10623,11353
54870,85032,19093,40923,14105,65938,21978,10624,11354
54875,85038,19093,40925,14105,65943,21981,10624,11357
54880,85049,19095,40931,14107,65953,21983,10626,11357
54885,85053,19095,40933,14107,65957,21984,10626,11358
54890,85063,19096,40937,14107,65966,21986,10628,11358
54895,85069,19096,40941,14107,65972,21989,10629,11360
54900,85080,19099,40950,14110,65981,21991,10631,11360
54905,85084,19100,40953,14111,65984,21992,10631,11361
54910,85094,19102,40958,14113,65992,21994,10632,11362
54915,85100,19102,40960,14113,65998,21997,10634,11363
54920,85111,19104,40964,14113,66007,21999,10636,11363
54925,85115,19104,40966,14113,66011,22000,10637,11363
54930,85125,19105,40968,14114,66020,22002,10637,11365
54935,85131,19105,40971,14114,66026,22005,10638,11367
54940,85142,19107,40977,14115,66035,22007,10639,11368
54945,85146,19108,40979,14116,66038,22008,10640,11368
54950,85156,19111,40982,14117,66045,22010,10640,11370
54955,85162,19111,40984,14117,66050,22013,10641,11372
54960,85173,19115,40991,14121,66057,22015,10642,11373
54965,85177,19117,40994,14123,66060,22016,10642,11374
54970,85187,19120,40999,14126,66067,22018,10642,11376
54975,85193,19120,41002,14126,66072,22021,10643,11378
54980,85204,19125,41008,14130,66079,22023,10644,11379
54985,85208,19125,41009,14130,66083,22024,10644,11380
54990,85218,19127,41015,14132,66090,22026,10645,11381
54995,85224,19127,41019,14132,66096,22029,10648,11381
55000,85235,19132,41027,14136,66100,22031,10649,11382
55005,85239,19134,41029,14138,66105,22032,10649,11383
55010,85249,19139,41035,14142,66109,22034,10650,11384
55015,85255,19140,41037,14143,66114,22037,10651,11386
55020,85266,19144,41043,14147,66119,22039,10651,11388
55025,85270,19148,41045,14151,66122,22040,10652,11388
55030,85280,19150,41047,14152,66130,22042,10652,11390
55035,85286,19150,41049,14152,66136,22045,10653,11392
55040,85297,19153,41056,14155,66143,22047,10655,11392
55045,85301,19154,41057,14156,66147,22048,10655,11393
55050,85311,19158,41063,14158,66153,22050,10657,11393
55055,85317,19158,41066,14158,66158,22053,10658,11395
55060,85328,19162,41075,14162,66164,22055,10660,11395
55065,85332,19165,41077,14165,66167,22056,10660,11396
55070,85342,19168,41083,14167,66173,22058,10662,11396
55075,85348,19168,41087,14167,66179,22061,10665,11396
55080,85359,19171,41094,14169,66186,22063,10667,11396
55085,85363,19173,41097,14171,66190,22064,10668,11396
55090,85373,19176,41101,14172,66196,22066,10669,11397
55095,85379,19176,41106,14172,66201,22069,10671,11398
55100,85390,19179,41111,14175,66210,22071,10672,11399
55105,85394,19180,41112,14176,66214,22072,10673,11399
55110,85404,19182,41119,14177,66221,22074,10675,11399
55115,85410,19182,41119,14177,66228,22077,10675,11402
55120,85421,19184,41124,14178,66235,22079,10676,11403
55125,85425,19186,41125,14180,66239,22080,10676,11404
55130,85435,19188,41128,14181,66246,22082,10677,11405
55135,85441,19188,41131,14181,66251,22085,10679,11406
55140,85452,19193,41135,14184,66258,22087,10681,11406
55145,85456,19195,41138,14186,66260,22088,10682,11406
55150,85466,19197,41142,14187,66269,22090,10683,11407
55155,85472,19197,41144,14187,66275,22093,10685,11408
55160,85483,19199,41149,14188,66283,22095,10686,11409
55165,85487,19200,41152,14189,66287,22096,10687,11409
55170,85497,19201,41155,14190,66295,22098,10688,11410
55175,85503,19201,41159,14190,66301,22101,10690,11411
55180,85514,19203,41162,14191,66311,22103,10690,11413
55185,85518,19204,41164,14192,66314,22104,10691,11413
55190,85528,19207,41167,14194,66321,22106,10692,11414
55195,85534,19207,41169,14194,66326,22109,10693,11416
55200,85545,19210,41173,14196,66335,22111,10693,11418
55205,85549,19211,41174,14197,66338,22112,10693,11419
55210,85559,19213,41178,14199,66346,22114,10694,11420
55215,85565,19213,41181,14199,66351,22117,10696,11421
55220,85576,19215,41182,14199,66361,22119,10697,11422
55225,85580,19216,41185,14200,66364,22120,10697,11423
55230,85590,19218,41189,14201,66372,22122,10698,11424
55235,85596,19218,41192,14201,66378,22125,10700,11425
55240,85607,19220,41195,14203,66386,22127,10700,11427
55245,85611,19220,41196,14203,66391,22128,10700,11428
55250,85621,19221,41199,14204,66399,22130,10701,11429
55255,85627,19221,41202,14204,66404,22133,10703,11430
55260,85638,19228,41207,14210,66410,22135,10704,11431
55265,85642,19229,41209,14211,66412,22136,10704,11432
55270,85652,19235,41213,14215,66417,22138,10705,11433
55275,85658,19235,41217,14215,66420,22141,10706,11435
55280,85669,19241,41223,14219,66424,22143,10707,11436
55285,85673,19247,41226,14225,66426,22144,10708,11436
55290,85683,19251,41231,14228,66431,22146,10709,11437
55295,85689,19251,41235,14228,66436,22149,10712,11437
55300,85700,19256,41240,14233,66443,22151,10712,11439
55305,85704,19256,41242,14233,66447,22152,10712,11440
55310,85714,19259,41247,14236,66454,22154,10712,11442
55315,85720,19259,41248,14236,66460,22157,10712,11445
55320,85731,19262,41253,14237,66468,22159,10714,11445
55325,85735,19262,41254,14237,66473,22160,10714,11446
55330,85745,19264,41262,14238,66479,22162,10716,11446
55335,85751,19264,41265,14238,66487,22165,10717,11448
55340,85762,19266,41268,14238,66495,22167,10718,11449
55345,85766,19266,41268,14238,66500,22168,10718,11450
55350,85776,19269,41275,14240,66505,22170,10720,11450
55355,85782,19269,41279,14240,66513,22173,10722,11451
55360,85793,19271,41284,14240,66522,22175,10723,11452
55365,85797,19271,41285,14240,66526,22176,10723,11453
55370,85807,19272,41289,14241,66534,22178,10724,11454
55375,85813,19272,41293,14241,66541,22181,10726,11455
55380,85824,19274,41297,14242,66550,22183,10726,11457
55385,85828,19274,41299,14242,66554,22184,10727,11457
55390,85838,19275,41302,14242,66562,22186,10728,11458
55395,85844,19275,41304,14242,66569,22189,10729,11460
55400,85855,19278,41309,14245,66577,22191,10729,11462
55405,85859,19279,41311,14246,66580,22192,10729,11463
55410,85869,19281,41314,14246,66588,22194,10731,11463
55415,85875,19281,41317,14246,66594,22197,10733,11464
55420,85886,19284,41321,14247,66602,22199,10735,11464
55425,85890,19285,41325,14248,66605,22200,10736,11464
55430,85900,19287,41327,14249,66613,22202,10736,11466
55435,85906,19287,41330,14249,66618,22205,10737,11468
55440,85917,19292,41333,14253,66625,22207,10737,11470
55445,85921,19293,41335,14254,66628,22208,10738,11470
55450,85931,19297,41339,14258,66634,22210,10738,11472
55455,85937,19297,41342,14258,66639,22213,10739,11474
55460,85948,19302,41350,14263,66643,22215,10740,11475
55465,85952,19305,41350,14266,66647,22216,10740,11476
55470,85962,19308,41354,14268,66653,22218,10741,11477
55475,85968,19308,41357,14268,66658,22221,10743,11478
55480,85979,19313,41360,14271,66665,22223,10744,11479
55485,85983,19315,41362,14273,66667,22224,10744,11480
55490,85993,19319,41366,14276,66673,22226,10745,11481
55495,85999,19319,41370,14276,66677,22229,10747,11482
55500,86010,19326,41377,14283,66682,22231,10748,11483
55505,86014,19327,41379,14284,66687,22232,10749,11483
55510,86024,19328,41383,14284,66696,22234,10751,11483
55515,86030,19328,41388,14284,66701,22237,10753,11484
55520,86041,19330,41392,14285,66709,22239,10753,11486
55525,86045,19331,41395,14286,66714,22240,10753,11487
55530,86055,19333,41400,14287,66721,22242,10754,11488
55535,86061,19333,41405,14287,66727,22245,10756,11489
55540,86072,19336,41412,14289,66735,22247,10758,11489
55545,86076,19337,41415,14290,66739,22248,10759,11489
55550,86086,19339,41419,14292,66746,22250,10759,11491
55555,86092,19339,41422,14292,66752,22253,10760,11493
55560,86103,19342,41429,14294,66761,22255,10761,11494
55565,86107,19342,41431,14294,66765,22256,10761,11495
55570,86117,19343,41435,14294,66774,22258,10762,11496
55575,86123,19343,41439,14294,66779,22261,10763,11498
55580,86134,19344,41443,14294,66790,22263,10763,11500
55585,86138,19344,41444,14294,66794,22264,10763,11501
55590,86148,19345,41448,14294,66803,22266,10764,11502
55595,86154,19345,41450,14294,66809,22269,10766,11503
55600,86165,19346,41452,14294,66819,22271,10768,11503
55605,86169,19346,41453,14294,66823,22272,10768,11504
55610,86179,19347,41457,14294,66831,22274,10768,11506
55615,86185,19347,41460,14294,66838,22277,10770,11507
55620,86196,19349,41466,14295,66846,22279,10771,11508
55625,86200,19350,41467,14296,66850,22280,10772,11508
55630,86210,19352,41470,14298,66858,22282,10772,11510
55635,86216,19352,41475,14298,66862,22285,10775,11510
55640,86227,19357,41484,14303,66869,22287,10775,11512
55645,86231,19359,41488,14305,66872,22288,10776,11512
55650,86241,19362,41493,14307,66878,22290,10777,11513
55655,86247,19362,41495,14307,66884,22293,10777,11516
55660,86258,19366,41501,14310,66891,22295,10777,11518
55665,86262,19367,41503,14311,66895,22296,10777,11519
55670,86272,19370,41507,14313,66901,22298,10778,11520
55675,86278,19370,41510,14313,66908,22301,10780,11521
55680,86289,19373,41514,14315,66916,22303,10781,11522
55685,86293,19375,41518,14317,66918,22304,10782,11522
55690,86303,19380,41523,14320,66923,22306,10784,11522
55695,86309,19380,41527,14320,66927,22309,10786,11523
55700,86320,19385,41532,14324,66933,22311,10787,11524
55705,86324,19387,41534,14326,66937,22312,10788,11524
55710,86334,19389,41537,14327,66944,22314,10789,11525
55715,86340,19389,41543,14327,66949,22317,10792,11525
55720,86351,19391,41548,14328,66959,22319,10793,11526
55725,86355,19391,41548,14328,66964,22320,10793,11527
55730,86365,19394,41555,14331,66970,22322,10794,11528
55735,86371,19394,41558,14331,66976,22325,10797,11528
55740,86382,19396,41562,14333,66985,22327,10798,11529
55745,86386,19396,41563,14333,66989,22328,10798,11530
55750,86396,19398,41569,14335,66997,22330,10799,11531
55755,86402,19398,41572,14335,67004,22333,10801,11532
55760,86413,19401,41577,14336,67010,22335,10802,11533
55765,86417,19401,41580,14336,67015,22336,10803,11533
55770,86427,19404,41585,14339,67023,22338,10803,11535
55775,86433,19404,41589,14339,67028,22341,10805,11536
55780,86444,19407,41595,14340,67034,22343,10806,11537
55785,86448,19407,41596,14340,67041,22344,10806,11538
55790,86458,19409,41599,14341,67049,22346,10807,11539
55795,86464,19409,41600,14341,67054,22349,10807,11542
55800,86475,19412,41604,14342,67063,22351,10808,11543
55805,86479,19413,41606,14343,67066,22352,10809,11543
55810,86489,19414,41607,14343,67074,22354,10809,11545
55815,86495,19414,41609,14343,67080,22357,10810,11547
55820,86506,19417,41613,14346,67087,22359,10810,11549
55825,86510,19419,41614,14348,67091,22360,10810,11550
55830,86520,19422,41621,14351,67097,22362,10812,11550
55835,86526,19422,41622,14351,67104,22365,10812,11553
55840,86537,19426,41627,14354,67109,22367,10812,11555
55845,86541,19427,41630,14355,67114,22368,10813,11555
55850,86551,19430,41633,14358,67121,22370,10813,11557
55855,86557,19430,41637,14358,67126,22373,10815,11558
55860,86568,19435,41643,14362,67131,22375,10816,11559
55865,86572,19437,41646,14364,67135,22376,10817,11559
55870,86582,19439,41649,14364,67143,22378,10818,11560
55875,86588,19439,41651,14364,67149,22381,10819,11562
55880,86599,19444,41655,14368,67155,22383,10819,11564
55885,86603,19444,41657,14368,67159,22384,10820,11564
55890,86613,19447,41663,14370,67166,22386,10821,11565
55895,86619,19447,41667,14370,67170,22389,10823,11566
55900,86630,19452,41675,14374,67177,22391,10825,11566
55905,86634,19455,41678,14377,67179,22392,10825,11567
55910,86644,19459,41683,14380,67185,22394,10826,11568
55915,86650,19459,41687,14380,67190,22397,10828,11569
55920,86661,19462,41689,14381,67199,22399,10828,11571
55925,86665,19463,41692,14382,67202,22400,10829,11571
55930,86675,19466,41695,14383,67209,22402,10830,11572
55935,86681,19466,41698,14383,67215,22405,10833,11572
55940,86692,19470,41702,14385,67222,22407,10834,11573
55945,86696,19471,41704,14386,67225,22408,10834,11574
55950,86706,19474,41709,14388,67231,22410,10835,11575
55955,86712,19474,41712,14388,67237,22413,10836,11577
55960,86723,19480,41720,14394,67243,22415,10837,11578
55965,86727,19480,41720,14394,67247,22416,10837,11579
55970,86737,19483,41723,14395,67253,22418,10837,11581
55975,86743,19483,41726,14395,67259,22421,10839,11582
55980,86754,19488,41733,14400,67266,22423,10840,11583
55985,86758,19490,41735,14402,67268,22424,10840,11584
55990,86768,19494,41740,14405,67274,22426,10841,11585
55995,86774,19494,41744,14405,67279,22429,10843,11586
56000,86785,19498,41751,14409,67286,22431,10844,11587
56005,86789,19499,41753,14410,67290,22432,10845,11587
56010,86799,19502,41758,14412,67297,22434,10846,11588
56015,86805,19502,41759,14412,67303,22437,10847,11590
56020,86816,19504,41762,14412,67312,22439,10847,11592
56025,86820,19505,41764,14413,67315,22440,10847,11593
56030,86830,19507,41770,14414,67322,22442,10849,11593
56035,86836,19507,41774,14414,67329,22445,10851,11594
56040,86847,19510,41780,14416,67337,22447,10852,11595
56045,86851,19510,41782,14416,67341,22448,10853,11595
56050,86861,19511,41785,14417,67350,22450,10854,11596
56055,86867,19511,41789,14417,67355,22453,10855,11598
56060,86878,19512,41793,14417,67364,22455,10856,11599
56065,86882,19512,41796,14417,67370,22456,10857,11599
56070,86892,19513,41799,14417,67379,22458,10857,11601
56075,86898,19513,41801,14417,67384,22461,10858,11603
56080,86909,19514,41807,14418,67393,22463,10859,11604
56085,86913,19514,41809,14418,67398,22464,10859,11605
56090,86923,19515,41813,14418,67408,22466,10860,11606
56095,86929,19515,41816,14418,67413,22469,10862,11607
56100,86940,19516,41825,14419,67421,22471,10864,11607
56105,86944,19517,41826,14420,67427,22472,10864,11608
56110,86954,19519,41832,14421,67434,22474,10864,11610
56115,86960,19519,41835,14421,67441,22477,10867,11610
56120,86971,19521,41837,14422,67450,22479,10868,11611
56125,86975,19521,41840,14422,67454,22480,10869,11611
56130,86985,19523,41844,14422,67462,22482,10870,11612
56135,86991,19523,41845,14422,67468,22485,10870,11615
56140,87002,19524,41852,14423,67475,22487,10871,11616
56145,87006,19524,41854,14423,67482,22488,10871,11617
56150,87016,19527,41859,14425,67487,22490,10872,11618
56155,87022,19527,41863,14425,67494,22493,10874,11619
56160,87033,19532,41870,14429,67498,22495,10875,11620
56165,87037,19533,41873,14430,67503,22496,10876,11620
56170,87047,19535,41876,14432,67511,22498,10876,11622
56175,87053,19535,41879,14432,67517,22501,10878,11623
56180,87064,19539,41884,14435,67523,22503,10878,11625
56185,87068,19539,41885,14435,67529,22504,10878,11626
56190,87078,19541,41890,14436,67536,22506,10879,11627
56195,87084,19541,41893,14436,67541,22509,10880,11629
56200,87095,19544,41896,14438,67550,22511,10880,11631
56205,87099,19546,41900,14440,67553,22512,10881,11631
56210,87109,19549,41905,14442,67560,22514,10883,11631
56215,87115,19549,41909,14442,67565,22517,10886,11631
56220,87126,19553,41914,14444,67573,22519,10888,11631
56225,87130,19555,41918,14446,67575,22520,10889,11631
56230,87140,19558,41923,14449,67581,22522,10889,11633
56235,87146,19558,41927,14449,67587,22525,10891,11634
56240,87157,19562,41930,14452,67595,22527,10892,11635
56245,87161,19564,41934,14454,67597,22528,10893,11635
56250,87171,19568,41938,14457,67603,22530,10893,11637
56255,87177,19568,41940,14457,67608,22533,10894,11639
56260,87188,19571,41947,14460,67616,22535,10895,11640
56265,87192,19574,41950,14463,67618,22536,10895,11641
56270,87202,19576,41954,14463,67625,22538,10895,11643
56275,87208,19576,41956,14463,67632,22541,10896,11645
56280,87219,19580,41960,14465,67639,22543,10898,11645
56285,87223,19581,41962,14466,67642,22544,10899,11645
56290,87233,19584,41967,14468,67648,22546,10900,11646
56295,87239,19584,41970,14468,67655,22549,10903,11646
56300,87250,19589,41977,14472,67661,22551,10904,11647
56305,87254,19590,41979,14473,67664,22552,10905,11647
56310,87264,19594,41985,14476,67669,22554,10907,11647
56315,87270,19594,41987,14476,67674,22557,10907,11650
56320,87281,19599,41993,14480,67681,22559,10908,11651
56325,87285,19601,41995,14482,67684,22560,10908,11652
56330,87295,19607,42004,14487,67686,22562,10910,11652
56335,87301,19608,42005,14488,67692,22565,10911,11654
56340,87312,19612,42010,14491,67698,22567,10911,11656
56345,87316,19613,42011,14492,67703,22568,10911,11657
56350,87326,19614,42017,14493,67711,22570,10913,11657
56355,87332,19614,42021,14493,67716,22573,10915,11658
56360,87343,19616,42028,14494,67724,22575,10916,11659
56365,87347,19617,42032,14495,67729,22576,10917,11659
56370,87357,19619,42034,14496,67737,22578,10917,11661
56375,87363,19619,42036,14496,67743,22581,10918,11663
56380,87374,19622,42045,14498,67749,22583,10920,11663
56385,87378,19622,42045,14498,67756,22584,10920,11664
56390,87388,19625,42051,14500,67761,22586,10921,11665
56395,87394,19625,42053,14500,67768,22589,10922,11667
56400,87405,19628,42057,14502,67776,22591,10923,11668
56405,87409,19628,42058,14502,67781,22592,10923,11669
56410,87419,19631,42065,14505,67787,22594,10924,11670
56415,87425,19631,42069,14505,67793,22597,10926,11671
56420,87436,19634,42076,14507,67800,22599,10928,11671
56425,87440,19634,42077,14507,67806,22600,10929,11671
56430,87450,19636,42081,14509,67814,22602,10929,11673
56435,87456,19636,42083,14509,67820,22605,10930,11675
56440,87467,19639,42089,14512,67827,22607,10930,11677
56445,87471,19639,42091,14512,67832,22608,10931,11677
56450,87481,19641,42095,14514,67839,22610,10932,11678
56455,87487,19641,42099,14514,67844,22613,10933,11680
56460,87498,19646,42105,14517,67851,22615,10934,11681
56465,87502,19648,42108,14519,67854,22616,10935,11681
56470,87512,19650,42112,14521,67862,22618,10935,11683
56475,87518,19650,42114,14521,67867,22621,10935,11686
56480,87529,19654,42119,14523,67875,22623,10936,11687
56485,87533,19654,42122,14523,67879,22624,10937,11687
56490,87543,19658,42130,14527,67884,22626,10938,11688
56495,87549,19658,42135,14527,67891,22629,10941,11688
56500,87560,19662,42140,14531,67897,22631,10941,11690
56505,87564,19664,42142,14533,67900,22632,10942,11690
56510,87574,19668,42147,14536,67906,22634,10943,11691
56515,87580,19668,42152,14536,67912,22637,10946,11691
56520,87591,19672,42157,14538,67919,22639,10947,11692
56525,87595,19672,42157,14538,67923,22640,10947,11693
56530,87605,19675,42162,14540,67929,22642,10948,11694
56535,87611,19675,42166,14540,67936,22645,10950,11695
56540,87622,19678,42170,14542,67944,22647,10952,11695
56545,87626,19678,42172,14542,67948,22648,10953,11695
56550,87636,19684,42179,14546,67952,22650,10955,11695
56555,87642,19684,42180,14546,67958,22653,10956,11697
56560,87653,19687,42183,14548,67965,22655,10956,11699
56565,87657,19689,42184,14550,67968,22656,10956,11700
56570,87667,19694,42191,14555,67972,22658,10957,11701
56575,87673,19695,42195,14556,67977,22661,10960,11701
56580,87684,19700,42201,14560,67983,22663,10962,11701
56585,87688,19702,42203,14562,67985,22664,10962,11702
56590,87698,19703,42208,14562,67995,22666,10964,11702
56595,87704,19703,42209,14562,68001,22669,10965,11704
56600,87715,19704,42214,14562,68009,22671,10965,11706
56605,87719,19704,42217,14562,68015,22672,10966,11706
56610,87729,19705,42221,14563,68024,22674,10966,11708
56615,87735,19705,42225,14563,68029,22677,10968,11709
56620,87746,19706,42229,14563,68038,22679,10968,11711
56625,87750,19706,42231,14563,68044,22680,10968,11712
56630,87760,19707,42238,14564,68052,22682,10970,11712
56635,87766,19707,42242,14564,68056,22685,10972,11713
56640,87777,19708,42250,14565,68068,22687,10974,11713
56645,87781,19708,42251,14565,68072,22688,10974,11714
56650,87791,19709,42257,14566,68081,22690,10975,11715
56655,87797,19709,42261,14566,68087,22693,10976,11717
56660,87808,19710,42267,14567,68096,22695,10977,11718
56665,87812,19710,42271,14567,68101,22696,10978,11718
56670,87822,19711,42277,14568,68111,22698,10979,11719
56675,87828,19711,42279,14568,68117,22701,10981,11720
56680,87839,19712,42287,14569,68125,22703,10982,11721
56685,87843,19712,42289,14569,68131,22704,10982,11722
56690,87853,19715,42294,14571,68138,22706,10983,11723
56695,87859,19715,42297,14571,68143,22709,10985,11724
56700,87870,19720,42301,14575,68149,22711,10985,11726
56705,87874,19721,42304,14576,68153,22712,10986,11726
56710,87884,19725,42309,14579,68159,22714,10987,11727
56715,87890,19725,42312,14579,68163,22717,10987,11730
56720,87901,19729,42317,14582,68171,22719,10988,11731
56725,87905,19730,42318,14583,68175,22720,10988,11732
56730,87915,19733,42322,14585,68182,22722,10988,11734
56735,87921,19733,42323,14585,68188,22725,10988,11737
56740,87932,19736,42328,14587,68195,22727,10989,11738
56745,87936,19738,42329,14589,68198,22728,10989,11739
56750,87946,19742,42335,14591,68204,22730,10991,11739
56755,87952,19742,42336,14591,68210,22733,10992,11741
56760,87963,19746,42341,14594,68216,22735,10992,11743
56765,87967,19749,42344,14597,68218,22736,10993,11743
56770,87977,19752,42350,14600,68224,22738,10993,11745
56775,87983,19752,42355,14600,68229,22741,10995,11746
56780,87994,19756,42361,14603,68236,22743,10995,11748
56785,87998,19758,42363,14605,68240,22744,10995,11749
56790,88008,19762,42369,14609,68246,22746,10996,11750
56795,88014,19762,42369,14609,68252,22749,10996,11753
56800,88025,19765,42373,14611,68260,22751,10998,11753
56805,88029,19766,42374,14612,68263,22752,10998,11754
56810,88039,19771,42380,14615,68267,22754,10999,11755
56815,88045,19771,42382,14615,68274,22757,11001,11756
56820,88056,19775,42388,14617,68280,22759,11002,11757
56825,88060,19777,42390,14619,68283,22760,11002,11758
56830,88070,19781,42395,14622,68288,22762,11002,11760
56835,88076,19781,42397,14622,68294,22765,11003,11762
56840,88087,19785,42401,14625,68302,22767,11004,11763
56845,88091,19785,42402,14625,68306,22768,11004,11764
56850,88101,19789,42407,14628,68312,22770,11005,11765
56855,88107,19789,42409,14628,68318,22773,11007,11766
56860,88118,19791,42416,14630,68326,22775,11009,11766
56865,88122,19793,42420,14632,68329,22776,11010,11766
56870,88132,19796,42425,14635,68335,22778,11010,11768
56875,88138,19796,42425,14635,68342,22781,11010,11771
56880,88149,19797,42426,14635,68352,22783,11010,11773
56885,88153,19797,42427,14635,68356,22784,11011,11773
56890,88163,19801,42431,14637,68361,22786,11011,11775
56895,88169,19801,42436,14637,68365,22789,11014,11775
56900,88180,19806,42442,14641,68372,22791,11016,11775
56905,88184,19806,42444,14641,68377,22792,11017,11775
56910,88194,19807,42448,14641,68386,22794,11018,11776
56915,88200,19807,42450,14641,68392,22797,11018,11779
56920,88211,19808,42456,14642,68401,22799,11018,11781
56925,88215,19808,42457,14642,68406,22800,11018,11782
56930,88225,19809,42461,14643,68416,22802,11019,11783
56935,88231,19809,42463,14643,68422,22805,11020,11785
56940,88242,19810,42467,14643,68430,22807,11020,11787
56945,88246,19810,42470,14643,68435,22808,11021,11787
56950,88256,19811,42476,14643,68444,22810,11023,11787
56955,88262,19811,42478,14643,68450,22813,11024,11789
56960,88273,19814,42483,14644,68458,22815,11025,11790
56965,88277,19814,42484,14644,68463,22816,11026,11790
56970,88287,19815,42485,14644,68471,22818,11026,11792
56975,88293,19815,42490,14644,68477,22821,11028,11793
56980,88304,19818,42496,14646,68485,22823,11028,11795
56985,88308,19818,42496,14646,68490,22824,11028,11796
56990,88318,19821,42505,14649,68495,22826,11030,11796
56995,88324,19821,42507,14649,68503,22829,11032,11797
57000,88335,19823,42513,14650,68511,22831,11034,11797
57005,88339,19823,42516,14650,68516,22832,11035,11797
57010,88349,19827,42521,14652,68522,22834,11036,11798
57015,88355,19827,42523,14652,68527,22837,11037,11800
57020,88366,19831,42531,14655,68534,22839,11038,11801
57025,88370,19833,42533,14657,68537,22840,11039,11801
57030,88380,19837,42540,14661,68542,22842,11040,11802
57035,88386,19837,42545,14661,68547,22845,11043,11802
57040,88397,19841,42548,14663,68555,22847,11044,11803
57045,88401,19842,42549,14664,68559,22848,11044,11804
57050,88411,19844,42553,14666,68567,22850,11045,11805
57055,88417,19844,42554,14666,68572,22853,11045,11808
57060,88428,19847,42560,14669,68580,22855,11046,11809
57065,88432,19849,42562,14671,68583,22856,11046,11810
57070,88442,19852,42565,14672,68590,22858,11047,11811
57075,88448,19852,42567,14672,68595,22861,11048,11813
57080,88459,19855,42571,14675,68603,22863,11048,11815
57085,88463,19858,42574,14678,68605,22864,11048,11816
57090,88473,19862,42578,14680,68611,22866,11048,11818
57095,88479,19862,42583,14680,68617,22869,11051,11818
57100,88490,19866,42588,14683,68624,22871,11051,11820
57105,88494,19867,42590,14684,68627,22872,11051,11821
57110,88504,19871,42595,14687,68632,22874,11052,11822
57115,88510,19871,42598,14687,68637,22877,11053,11824
57120,88521,19876,42603,14691,68645,22879,11054,11825
57125,88525,19877,42606,14692,68648,22880,11055,11825
57130,88535,19880,42612,14695,68654,22882,11057,11825
57135,88541,19880,42616,14695,68660,22885,11059,11826
57140,88552,19884,42620,14699,68667,22887,11059,11828
57145,88556,19886,42622,14701,68670,22888,11059,11829
57150,88566,19891,42626,14705,68674,22890,11059,11831
57155,88572,19891,42629,14705,68681,22893,11062,11831
57160,88583,19896,42635,14709,68686,22895,11062,11833
57165,88587,19898,42637,14711,68689,22896,11063,11833
57170,88597,19901,42641,14713,68694,22898,11064,11834
57175,88603,19902,42643,14714,68700,22901,11065,11836
57180,88614,19905,42649,14716,68707,22903,11066,11837
57185,88618,19906,42650,14717,68712,22904,11066,11838
57190,88628,19908,42656,14719,68718,22906,11067,11839
57195,88634,19908,42660,14719,68725,22909,11069,11840
57200,88645,19910,42665,14720,68733,22911,11070,11841
57205,88649,19910,42666,14720,68739,22912,11071,11841
57210,88659,19912,42670,14721,68745,22914,11071,11843
57215,88665,19912,42673,14721,68752,22917,11074,11843
57220,88676,19915,42677,14722,68759,22919,11074,11845
57225,88680,19915,42678,14722,68764,22920,11074,11846
57230,88690,19918,42682,14724,68771,22922,11075,11847
57235,88696,19918,42683,14724,68777,22925,11076,11849
57240,88707,19920,42690,14725,68784,22927,11078,11849
57245,88711,19920,42692,14725,68790,22928,11078,11850
57250,88721,19922,42697,14726,68798,22930,11079,11851
57255,88727,19922,42702,14726,68804,22933,11081,11852
57260,88738,19924,42708,14727,68812,22935,11082,11853
57265,88742,19924,42709,14727,68818,22936,11082,11854
57270,88752,19926,42716,14729,68825,22938,11084,11854
57275,88758,19926,42719,14729,68831,22941,11084,11857
57280,88769,19930,42725,14732,68838,22943,11084,11859
57285,88773,19931,42727,14733,68842,22944,11085,11859
57290,88783,19934,42730,14734,68848,22946,11086,11860
57295,88789,19934,42731,14734,68855,22949,11087,11862
57300,88800,19938,42735,14737,68862,22951,11088,11863
57305,88804,19938,42735,14737,68866,22952,11088,11864
57310,88814,19941,42741,14738,68872,22954,11090,11864
57315,88820,19941,42744,14738,68879,22957,11092,11865
57320,88831,19944,42752,14741,68887,22959,11094,11865
57325,88835,19944,42755,14741,68891,22960,11095,11865
57330,88845,19947,42759,14743,68897,22962,11096,11866
57335,88851,19947,42760,14743,68904,22965,11097,11868
57340,88862,19950,42762,14744,68912,22967,11098,11869
57345,88866,19951,42765,14745,68915,22968,11099,11869
57350,88876,19954,42771,14747,68921,22970,11101,11869
57355,88882,19954,42774,14747,68928,22973,11103,11870
57360,88893,19958,42780,14751,68935,22975,11103,11872
57365,88897,19958,42780,14751,68939,22976,11103,11873
57370,88907,19961,42786,14753,68945,22978,11105,11873
57375,88913,19961,42789,14753,68952,22981,11108,11873
57380,88924,19965,42794,14756,68958,22983,11108,11875
57385,88928,19967,42796,14758,68961,22984,11109,11875
57390,88938,19970,42800,14759,68967,22986,11111,11875
57395,88944,19970,42803,14759,68972,22989,11112,11877
57400,88955,19976,42808,14763,68979,22991,11114,11877
57405,88959,19976,42809,14763,68982,22992,11114,11878
57410,88969,19979,42814,14766,68988,22994,11114,11880
57415,88975,19980,42818,14767,68994,22997,11117,11880
57420,88986,19982,42820,14768,69003,22999,11117,11882
57425,88990,19984,42822,14770,69005,23000,11117,11883
57430,89000,19989,42827,14774,69010,23002,11117,11885
57435,89006,19989,42829,14774,69016,23005,11118,11887
57440,89017,19992,42834,14777,69023,23007,11119,11888
57445,89021,19994,42836,14779,69027,23008,11120,11888
57450,89031,19996,42840,14780,69034,23010,11121,11889
57455,89037,19996,42842,14780,69038,23013,11121,11892
57460,89048,20002,42851,14786,69043,23015,11122,11893
57465,89052,20002,42853,14786,69049,23016,11122,11894
57470,89062,20003,42859,14787,69058,23018,11123,11895
57475,89068,20003,42862,14787,69064,23021,11125,11896
57480,89079,20004,42866,14787,69074,23023,11125,11898
57485,89083,20004,42866,14787,69079,23024,11125,11899
57490,89093,20005,42870,14788,69087,23026,11126,11900
57495,89099,20005,42873,14788,69094,23029,11128,11901
57500,89110,20006,42878,14788,69103,23031,11129,11902
57505,89114,20006,42879,14788,69107,23032,11129,11903
57510,89124,20009,42885,14791,69114,23034,11130,11904
57515,89130,20009,42887,14791,69121,23037,11131,11906
57520,89141,20012,42892,14793,69128,23039,11132,11907
57525,89145,20013,42894,14794,69132,23040,11132,11908
57530,89155,20015,42900,14796,69139,23042,11133,11909
57535,89161,20015,42903,14796,69145,23045,11134,11911
57540,89172,20018,42906,14797,69154,23047,11135,11912
57545,89176,20019,42910,14798,69157,23048,11136,11912
57550,89186,20021,42915,14799,69164,23050,11136,11914
57555,89192,20021,42919,14799,69170,23053,11137,11916
57560,89203,20023,42925,14801,69180,23055,11138,11917
57565,89207,20024,42928,14802,69183,23056,11138,11918
57570,89217,20026,42931,14803,69190,23058,11138,11920
57575,89223,20026,42936,14803,69195,23061,11140,11921
57580,89234,20030,42942,14806,69202,23063,11141,11922
57585,89238,20032,42945,14808,69206,23064,11142,11922
57590,89248,20035,42949,14810,69212,23066,11142,11924
57595,89254,20035,42954,14810,69219,23069,11145,11924
57600,89265,20038,42959,14813,69227,23071,11146,11925
57605,89269,20038,42961,14813,69231,23072,11147,11925
57610,89279,20040,42964,14814,69238,23074,11147,11927
57615,89285,20040,42967,14814,69244,23077,11148,11929
57620,89296,20045,42972,14819,69251,23079,11148,11931
57625,89300,20047,42974,14821,69253,23080,11148,11932
57630,89310,20049,42977,14822,69261,23082,11148,11934
57635,89316,20049,42980,14822,69266,23085,11149,11936
57640,89327,20052,42984,14824,69275,23087,11150,11937
57645,89331,20052,42985,14824,69279,23088,11150,11938
57650,89341,20056,42989,14826,69285,23090,11151,11939
57655,89347,20056,42992,14826,69290,23093,11152,11941
57660,89358,20060,42995,14829,69298,23095,11153,11942
57665,89362,20061,42997,14830,69301,23096,11154,11942
57670,89372,20064,43000,14831,69308,23098,11155,11943
57675,89378,20064,43004,14831,69313,23101,11158,11943
57680,89389,20070,43009,14836,69319,23103,11158,11945
57685,89393,20070,43010,14836,69323,23104,11158,11946
57690,89403,20074,43016,14839,69328,23106,11160,11946
57695,89409,20074,43018,14839,69332,23109,11160,11949
57700,89420,20080,43023,14843,69337,23111,11161,11950
57705,89424,20083,43024,14846,69340,23112,11161,11951
57710,89434,20088,43029,14850,69345,23114,11162,11952
57715,89440,20089,43031,14851,69350,23117,11163,11954
57720,89451,20092,43035,14853,69356,23119,11163,11956
57725,89455,20094,43038,14855,69360,23120,11164,11956
57730,89465,20095,43041,14855,69369,23122,11165,11957
57735,89471,20095,43045,14855,69374,23125,11167,11958
57740,89482,20098,43050,14857,69382,23127,11167,11960
57745,89486,20099,43052,14858,69387,23128,11168,11960
57750,89496,20101,43057,14860,69394,23130,11168,11962
57755,89502,20101,43062,14860,69399,23133,11171,11962
57760,89513,20104,43071,14861,69406,23135,11173,11962
57765,89517,20104,43074,14861,69413,23136,11174,11962
57770,89527,20106,43079,14862,69421,23138,11175,11963
57775,89533,20106,43082,14862,69426,23141,11175,11966
57780,89544,20109,43090,14865,69434,23143,11176,11967
57785,89548,20110,43094,14866,69438,23144,11177,11967
57790,89558,20112,43100,14867,69445,23146,11178,11968
57795,89564,20112,43102,14867,69452,23149,11179,11970
57800,89575,20115,43108,14869,69460,23151,11181,11970
57805,89579,20116,43110,14870,69463,23152,11181,11971
57810,89589,20118,43115,14872,69471,23154,11182,11972
57815,89595,20118,43119,14872,69477,23157,11185,11972
57820,89606,20120,43126,14874,69485,23159,11186,11973
57825,89610,20121,43129,14875,69489,23160,11187,11973
57830,89620,20125,43135,14877,69494,23162,11189,11973
57835,89626,20125,43138,14877,69501,23165,11191,11974
57840,89637,20128,43142,14879,69508,23167,11191,11976
57845,89641,20129,43144,14880,69512,23168,11191,11977
57850,89651,20131,43148,14881,69519,23170,11191,11979
57855,89657,20131,43152,14881,69526,23173,11193,11980
57860,89668,20132,43158,14881,69535,23175,11195,11980
57865,89672,20134,43160,14883,69538,23176,11195,11981
57870,89682,20136,43165,14884,69546,23178,11196,11982
57875,89688,20136,43167,14884,69551,23181,11196,11985
57880,89699,20139,43172,14887,69559,23183,11197,11986
57885,89703,20141,43174,14889,69562,23184,11197,11987
57890,89713,20145,43176,14891,69568,23186,11197,11989
57895,89719,20145,43180,14891,69573,23189,11199,11990
57900,89730,20149,43186,14895,69581,23191,11201,11990
57905,89734,20149,43187,14895,69585,23192,11201,11991
57910,89744,20154,43193,14898,69589,23194,11203,11991
57915,89750,20154,43194,14898,69596,23197,11203,11994
57920,89761,20156,43201,14900,69604,23199,11205,11994
57925,89765,20157,43203,14901,69608,23200,11206,11994
57930,89775,20162,43209,14905,69612,23202,11207,11995
57935,89781,20162,43211,14905,69617,23205,11208,11997
57940,89792,20166,43221,14909,69622,23207,11210,11997
57945,89796,20170,43223,14913,69625,23208,11211,11997
57950,89806,20175,43228,14916,69629,23210,11212,11998
57955,89812,20175,43232,14916,69636,23213,11214,11999
57960,89823,20177,43237,14918,69645,23215,11215,12000
57965,89827,20177,43238,14918,69650,23216,11216,12000
57970,89837,20180,43243,14918,69657,23218,11218,12000
57975,89843,20180,43243,14918,69663,23221,11218,12003
57980,89854,20182,43247,14919,69672,23223,11219,12004
57985,89858,20183,43250,14920,69675,23224,11220,12004
57990,89868,20186,43257,14923,69681,23226,11221,12005
57995,89874,20186,43259,14923,69687,23229,11221,12008
58000,89885,20188,43266,14924,69696,23231,11223,12008
58005,89889,20188,43266,14924,69701,23232,11223,12009
58010,89899,20191,43268,14925,69708,23234,11223,12011
58015,89905,20191,43273,14925,69713,23237,11226,12011
58020,89916,20193,43279,14926,69721,23239,11227,12012
58025,89920,20194,43281,14927,69725,23240,11227,12013
58030,89930,20197,43286,14929,69732,23242,11227,12015
58035,89936,20197,43290,14929,69738,23245,11229,12016
58040,89947,20199,43298,14931,69747,23247,11231,12016
58045,89951,20199,43299,14931,69751,23248,11231,12017
58050,89961,20202,43303,14932,69759,23250,11232,12018
58055,89967,20202,43307,14932,69763,23253,11234,12019
58060,89978,20206,43310,14935,69772,23255,11235,12020
58065,89982,20207,43312,14936,69775,23256,11236,12020
58070,89992,20211,43314,14937,69781,23258,11236,12022
58075,89998,20211,43316,14937,69786,23261,11237,12024
58080,90009,20215,43325,14941,69792,23263,11239,12024
58085,90013,20216,43326,14942,69797,23264,11240,12024
58090,90023,20221,43333,14945,69801,23266,11242,12024
58095,90029,20221,43337,14945,69807,23269,11244,12025
58100,90040,20224,43340,14947,69815,23271,11244,12027
58105,90044,20226,43342,14949,69818,23272,11245,12027
58110,90054,20230,43346,14951,69824,23274,11246,12028
58115,90060,20230,43348,14951,69829,23277,11247,12030
58120,90071,20233,43353,14954,69837,23279,11248,12031
58125,90075,20234,43355,14955,69841,23280,11249,12031
58130,90085,20238,43360,14958,69847,23282,11250,12032
58135,90091,20238,43364,14958,69852,23285,11252,12033
58140,90102,20242,43370,14961,69858,23287,11252,12035
58145,90106,20245,43372,14964,69861,23288,11252,12036
58150,90116,20249,43379,14967,69866,23290,11254,12036
58155,90122,20249,43382,14967,69872,23293,11257,12036
58160,90133,20253,43387,14970,69879,23295,11259,12036
58165,90137,20255,43389,14972,69882,23296,11260,12036
58170,90147,20259,43396,14976,69887,23298,11262,12036
58175,90153,20260,43401,14977,69891,23301,11265,12036
58180,90164,20265,43406,14982,69898,23303,11266,12037
58185,90168,20267,43407,14984,69901,23304,11266,12038
58190,90178,20270,43409,14985,69908,23306,11266,12040
58195,90184,20270,43412,14985,69914,23309,11268,12041
58200,90195,20272,43417,14986,69922,23311,11269,12042
58205,90199,20273,43419,14987,69926,23312,11269,12043
58210,90209,20276,43422,14989,69932,23314,11269,12045
58215,90215,20276,43423,14989,69939,23317,11270,12047
58220,90226,20278,43427,14990,69948,23319,11270,12049
58225,90230,20278,43429,14990,69952,23320,11271,12049
58230,90240,20281,43432,14990,69959,23322,11272,12050
58235,90246,20281,43433,14990,69965,23325,11272,12053
58240,90257,20283,43435,14990,69974,23327,11272,12055
58245,90261,20283,43437,14990,69978,23328,11273,12055
58250,90271,20286,43440,14991,69985,23330,11273,12057
58255,90277,20286,43445,14991,69990,23333,11276,12057
58260,90288,20288,43450,14992,70000,23335,11276,12059
58265,90292,20288,43451,14992,70004,23336,11276,12060
58270,90302,20291,43457,14994,70011,23338,11278,12060
58275,90308,20291,43460,14994,70017,23341,11281,12060
58280,90319,20293,43464,14994,70026,23343,11282,12061
58285,90323,20294,43467,14995,70029,23344,11283,12061
58290,90333,20298,43473,14998,70035,23346,11284,12062
58295,90339,20298,43475,14998,70041,23349,11286,12063
58300,90350,20301,43482,15000,70048,23351,11286,12065
58305,90354,20302,43482,15001,70052,23352,11286,12066
58310,90364,20307,43485,15004,70057,23354,11286,12068
58315,90370,20307,43487,15004,70062,23357,11287,12070
58320,90381,20311,43490,15006,70069,23359,11287,12072
58325,90385,20312,43490,15007,70073,23360,11287,12073
58330,90395,20317,43496,15011,70077,23362,11288,12074
58335,90401,20318,43498,15012,70082,23365,11289,12076
58340,90412,20321,43502,15014,70088,23367,11289,12078
58345,90416,20325,43505,15018,70090,23368,11290,12078
58350,90426,20331,43512,15023,70094,23370,11292,12078
58355,90432,20332,43516,15024,70100,23373,11295,12078
58360,90443,20335,43521,15027,70107,23375,11296,12079
58365,90447,20337,43524,15029,70110,23376,11297,12079
58370,90457,20341,43530,15033,70116,23378,11298,12080
58375,90463,20341,43531,15033,70121,23381,11298,12083
58380,90474,20344,43538,15036,70127,23383,11298,12085
58385,90478,20345,43540,15037,70133,23384,11298,12086
58390,90488,20348,43545,15038,70140,23386,11300,12086
58395,90494,20348,43549,15038,70146,23389,11303,12086
58400,90505,20350,43555,15040,70155,23391,11304,12087
58405,90509,20350,43558,15040,70159,23392,11305,12087
58410,90519,20353,43563,15042,70165,23394,11306,12088
58415,90525,20353,43566,15042,70171,23397,11307,12090
58420,90536,20355,43571,15043,70179,23399,11307,12092
58425,90540,20356,43574,15044,70184,23400,11308,12092
58430,90550,20359,43581,15046,70190,23402,11308,12094
58435,90556,20359,43583,15046,70196,23405,11308,12097
58440,90567,20361,43587,15047,70206,23407,11309,12098
58445,90571,20361,43588,15047,70210,23408,11310,12098
58450,90581,20364,43594,15048,70216,23410,11310,12100
58455,90587,20364,43596,15048,70222,23413,11311,12102
58460,90598,20366,43600,15049,70232,23415,11312,12103
58465,90602,20366,43601,15049,70236,23416,11312,12104
58470,90612,20369,43604,15051,70242,23418,11312,12106
58475,90618,20369,43606,15051,70249,23421,11313,12108
58480,90629,20371,43612,15052,70258,23423,11314,12109
58485,90633,20371,43613,15052,70262,23424,11314,12110
58490,90643,20374,43617,15055,70268,23426,11314,12112
58495,90649,20374,43620,15055,70275,23429,11316,12113
58500,90660,20377,43627,15058,70283,23431,11316,12115
58505,90664,20378,43629,15059,70286,23432,11317,12115
58510,90674,20383,43637,15064,70291,23434,11319,12115
58515,90680,20383,43639,15064,70297,23437,11320,12117
58520,90691,20386,43643,15066,70305,23439,11320,12119
58525,90695,20388,43645,15068,70307,23440,11320,12120
58530,90705,20393,43649,15071,70312,23442,11320,12122
58535,90711,20393,43652,15071,70317,23445,11321,12124
58540,90722,20398,43659,15075,70323,23447,11321,12126
58545,90726,20400,43661,15077,70326,23448,11322,12126
58550,90736,20404,43666,15080,70332,23450,11323,12127
58555,90742,20404,43670,15080,70337,23453,11325,12128
58560,90753,20409,43673,15083,70343,23455,11325,12130
58565,90757,20411,43674,15085,70346,23456,11325,12131
58570,90767,20416,43678,15087,70350,23458,11326,12132
58575,90773,20417,43681,15088,70354,23461,11327,12134
58580,90784,20422,43686,15093,70362,23463,11328,12135
58585,90788,20424,43688,15095,70364,23464,11328,12136
58590,90798,20428,43692,15097,70369,23466,11329,12137
58595,90804,20428,43695,15097,70374,23469,11331,12138
58600,90815,20432,43700,15100,70380,23471,11331,12140
58605,90819,20433,43702,15101,70386,23472,11331,12141
58610,90829,20436,43707,15102,70391,23474,11331,12143
58615,90835,20436,43711,15102,70398,23477,11332,12145
58620,90846,20438,43716,15103,70407,23479,11333,12146
58625,90850,20438,43717,15103,70412,23480,11333,12147
58630,90860,20441,43718,15103,70419,23482,11333,12149
58635,90866,20441,43721,15103,70425,23485,11335,12150
58640,90877,20443,43725,15104,70433,23487,11336,12151
58645,90881,20443,43726,15104,70437,23488,11336,12152
58650,90891,20446,43731,15106,70445,23490,11337,12153
58655,90897,20446,43733,15106,70450,23493,11337,12156
58660,90908,20448,43740,15108,70459,23495,11339,12156
58665,90912,20449,43743,15109,70463,23496,11340,12156
58670,90922,20452,43744,15110,70470,23498,11340,12158
58675,90928,20452,43746,15110,70476,23501,11342,12159
58680,90939,20454,43755,15112,70483,23503,11344,12159
58685,90943,20454,43756,15112,70489,23504,11344,12160
58690,90953,20457,43761,15114,70495,23506,11345,12161
58695,90959,20457,43764,15114,70502,23509,11348,12161
58700,90970,20459,43770,15116,70508,23511,11348,12163
58705,90974,20460,43772,15117,70513,23512,11348,12164
58710,90984,20463,43775,15119,70521,23514,11349,12165
58715,90990,20463,43776,15119,70527,23517,11350,12167
58720,91001,20467,43783,15123,70533,23519,11351,12168
58725,91005,20467,43784,15123,70538,23520,11351,12169
58730,91015,20470,43788,15125,70544,23522,11352,12170
58735,91021,20470,43791,15125,70550,23525,11353,12172
58740,91032,20473,43795,15127,70558,23527,11354,12173
58745,91036,20475,43798,15129,70561,23528,11355,12173
58750,91046,20480,43804,15134,70566,23530,11355,12175
58755,91052,20480,43806,15134,70572,23533,11357,12176
58760,91063,20483,43813,15136,70579,23535,11358,12177
58765,91067,20484,43815,15137,70583,23536,11359,12177
58770,91077,20487,43820,15139,70590,23538,11360,12178
58775,91083,20487,43825,15139,70595,23541,11362,12179
58780,91094,20491,43831,15142,70602,23543,11363,12180
58785,91098,20493,43832,15144,70605,23544,11363,12181
58790,91108,20496,43837,15146,70611,23546,11364,12182
58795,91114,20496,43838,15146,70618,23549,11364,12185
58800,91125,20498,43844,15147,70626,23551,11366,12185
58805,91129,20500,43847,15149,70629,23552,11367,12185
58810,91139,20503,43851,15151,70635,23554,11367,12187
58815,91145,20503,43856,15151,70640,23557,11370,12187
58820,91156,20507,43862,15155,70648,23559,11371,12188
58825,91160,20509,43864,15157,70651,23560,11371,12189
58830,91170,20512,43866,15158,70658,23562,11372,12190
58835,91176,20512,43869,15158,70664,23565,11374,12191
58840,91187,20513,43873,15159,70673,23567,11375,12192
58845,91191,20516,43877,15162,70675,23568,11376,12192
58850,91201,20519,43880,15164,70681,23570,11376,12194
58855,91207,20519,43885,15164,70684,23573,11378,12195
58860,91218,20522,43892,15166,70695,23575,11380,12195
58865,91222,20523,43893,15166,70698,23576,11380,12196
58870,91232,20524,43896,15166,70707,23578,11380,12198
58875,91238,20524,43901,15166,70712,23581,11382,12199
58880,91249,20525,43907,15167,70723,23583,11383,12200
58885,91253,20526,43910,15168,70726,23584,11384,12200
58890,91263,20527,43917,15169,70734,23586,11385,12201
58895,91269,20527,43923,15169,70739,23589,11388,12201
58900,91280,20529,43931,15171,70750,23591,11389,12202
58905,91284,20530,43933,15172,70754,23592,11390,12202
58910,91294,20532,43939,15174,70761,23594,11390,12204
58915,91300,20532,43942,15174,70767,23597,11392,12205
58920,91311,20533,43946,15175,70777,23599,11393,12206
58925,91315,20534,43948,15176,70781,23600,11393,12207
58930,91325,20537,43955,15179,70787,23602,11394,12208
58935,91331,20537,43958,15179,70794,23605,11396,12209
58940,91342,20539,43965,15181,70802,23607,11397,12210
58945,91346,20540,43967,15182,70806,23608,11398,12210
58950,91356,20541,43970,15182,70813,23610,11399,12211
58955,91362,20541,43974,15182,70819,23613,11401,12212
58960,91373,20543,43979,15183,70828,23615,11402,12213
58965,91377,20544,43980,15183,70833,23616,11402,12214
58970,91387,20547,43986,15186,70838,23618,11402,12216
58975,91393,20547,43989,15186,70846,23621,11403,12218
58980,91404,20549,43995,15188,70855,23623,11404,12219
58985,91408,20550,43995,15188,70858,23624,11404,12220
58990,91418,20554,44001,15191,70863,23626,11404,12222
58995,91424,20554,44003,15191,70869,23629,11404,12225
59000,91435,20556,44007,15192,70878,23631,11404,12227
59005,91439,20558,44009,15194,70881,23632,11405,12227
59010,91449,20562,44012,15197,70887,23634,11405,12229
59015,91455,20562,44014,15197,70893,23637,11405,12232
59020,91466,20564,44019,15199,70901,23639,11407,12232
59025,91470,20567,44022,15202,70903,23640,11407,12233
59030,91480,20571,44030,15206,70908,23642,11409,12233
59035,91486,20571,44035,15206,70914,23645,11411,12234
59040,91497,20575,44041,15210,70921,23647,11412,12235
59045,91501,20578,44042,15212,70923,23648,11412,12236
59050,91511,20581,44047,15215,70930,23650,11413,12237
59055,91517,20581,44049,15215,70936,23653,11415,12238
59060,91528,20583,44054,15217,70945,23655,11415,12240
59065,91532,20584,44056,15218,70948,23656,11416,12240
59070,91542,20588,44061,15221,70954,23658,11417,12241
59075,91548,20588,44065,15221,70959,23661,11419,12242
59080,91559,20593,44072,15226,70966,23663,11420,12243
59085,91563,20595,44074,15227,70968,23664,11421,12243
59090,91573,20598,44078,15229,70974,23666,11422,12244
59095,91579,20599,44080,15230,70979,23669,11423,12246
59100,91590,20602,44084,15232,70986,23671,11424,12247
59105,91594,20605,44085,15235,70989,23672,11424,12248
59110,91604,20610,44091,15239,70993,23674,11425,12249
59115,91610,20610,44094,15239,70998,23677,11427,12250
59120,91621,20613,44100,15241,71006,23679,11428,12251
59125,91625,20614,44101,15242,71011,23680,11428,12252
59130,91635,20617,44105,15245,71018,23682,11429,12253
59135,91641,20617,44109,15245,71022,23685,11430,12255
59140,91652,20618,44114,15246,71033,23687,11431,12256
59145,91656,20619,44116,15247,71037,23688,11431,12257
59150,91666,20621,44120,15248,71044,23690,11431,12259
59155,91672,20621,44124,15248,71050,23693,11434,12259
59160,91683,20623,44128,15249,71060,23695,11435,12260
59165,91687,20624,44129,15250,71063,23696,11435,12261
59170,91697,20627,44136,15253,71069,23698,11437,12261
59175,91703,20627,44140,15253,71075,23701,11439,12262
59180,91714,20628,44141,15253,71086,23703,11439,12264
59185,91718,20629,44142,15254,71089,23704,11439,12265
59190,91728,20630,44144,15254,71098,23706,11439,12267
59195,91734,20630,44146,15254,71103,23709,11439,12270
59200,91745,20632,44154,15256,71112,23711,11441,12270
59205,91749,20633,44157,15257,71115,23712,11442,12270
59210,91759,20635,44162,15259,71124,23714,11442,12272
59215,91765,20635,44165,15259,71130,23717,11444,12273
59220,91776,20637,44172,15261,71139,23719,11445,12274
59225,91780,20638,44174,15261,71141,23720,11446,12274
59230,91790,20641,44178,15263,71149,23722,11446,12276
59235,91796,20641,44182,15263,71153,23725,11447,12278
59240,91807,20645,44188,15267,71162,23727,11448,12279
59245,91811,20646,44190,15268,71165,23728,11448,12280
59250,91821,20650,44197,15271,71171,23730,11449,12281
59255,91827,20650,44202,15271,71176,23733,11452,12281
59260,91838,20651,44205,15271,71186,23735,11453,12282
59265,91842,20652,44208,15272,71189,23736,11453,12283
59270,91852,20654,44211,15273,71198,23738,11454,12284
59275,91858,20654,44212,15273,71204,23741,11455,12286
59280,91869,20655,44215,15273,71213,23743,11456,12287
59285,91873,20656,44217,15274,71217,23744,11457,12287
59290,91883,20658,44222,15275,71225,23746,11458,12288
59295,91889,20658,44225,15275,71231,23749,11460,12289
59300,91900,20659,44229,15275,71240,23751,11461,12290
59305,91904,20661,44233,15277,71242,23752,11462,12290
59310,91914,20664,44239,15280,71250,23754,11463,12291
59315,91920,20664,44245,15280,71253,23757,11466,12291
59320,91931,20668,44247,15283,71263,23759,11467,12292
59325,91935,20670,44250,15285,71264,23760,11467,12293
59330,91945,20674,44255,15288,71271,23762,11468,12294
59335,91951,20674,44257,15288,71276,23765,11469,12296
59340,91962,20677,44262,15290,71283,23767,11470,12297
59345,91966,20679,44263,15291,71287,23768,11470,12298
59350,91976,20681,44268,15292,71295,23770,11471,12299
59355,91982,20681,44271,15292,71300,23773,11472,12301
59360,91993,20684,44275,15294,71307,23775,11472,12303
59365,91997,20685,44275,15294,71312,23776,11472,12304
59370,92007,20688,44280,15296,71319,23778,11473,12305
59375,92013,20688,44284,15296,71324,23781,11475,12306
59380,92024,20690,44288,15298,71334,23783,11476,12307
59385,92028,20691,44289,15298,71337,23784,11476,12308
59390,92038,20693,44295,15299,71345,23786,11478,12308
59395,92044,20693,44300,15299,71349,23789,11480,12309
59400,92055,20697,44304,15303,71358,23791,11480,12311
59405,92059,20699,44305,15304,71360,23792,11480,12312
59410,92069,20701,44309,15304,71368,23794,11482,12312
59415,92075,20701,44310,15304,71373,23797,11482,12315
59420,92086,20704,44315,15307,71382,23799,11483,12316
59425,92090,20705,44317,15308,71385,23800,11484,12316
59430,92100,20708,44321,15310,71392,23802,11484,12318
59435,92106,20708,44321,15310,71398,23805,11484,12321
59440,92117,20710,44327,15312,71406,23807,11485,12322
59445,92121,20711,44329,15313,71410,23808,11486,12322
59450,92131,20714,44333,15314,71417,23810,11487,12323
59455,92137,20714,44336,15314,71423,23813,11489,12324
59460,92148,20716,44340,15316,71430,23815,11489,12326
59465,92152,20718,44340,15317,71434,23816,11489,12327
59470,92162,20721,44343,15319,71441,23818,11489,12329
59475,92168,20721,44346,15319,71446,23821,11491,12330
59480,92179,20723,44352,15321,71455,23823,11493,12330
59485,92183,20725,44356,15323,71458,23824,11494,12330
59490,92193,20729,44361,15325,71464,23826,11495,12331
59495,92199,20729,44363,15325,71469,23829,11496,12333
59500,92210,20732,44369,15328,71476,23831,11497,12334
59505,92214,20735,44371,15330,71478,23832,11498,12334
59510,92224,20739,44374,15332,71485,23834,11499,12335
59515,92230,20739,44375,15332,71490,23837,11499,12338
59520,92241,20743,44380,15335,71496,23839,11500,12339
59525,92245,20745,44380,15336,71500,23840,11500,12340
59530,92255,20747,44384,15337,71508,23842,11501,12341
59535,92261,20747,44384,15337,71514,23845,11501,12344
59540,92272,20748,44390,15338,71523,23847,11502,12345
59545,92276,20749,44393,15338,71526,23848,11503,12345
59550,92286,20750,44396,15338,71536,23850,11504,12346
59555,92292,20750,44398,15338,71542,23853,11506,12347
59560,92303,20752,44405,15339,71551,23855,11508,12347
59565,92307,20753,44409,15340,71553,23856,11509,12347
59570,92317,20755,44416,15342,71562,23858,11511,12347
59575,92323,20755,44418,15342,71567,23861,11512,12349
59580,92334,20757,44423,15343,71576,23863,11513,12350
59585,92338,20758,44425,15344,71580,23864,11514,12350
59590,92348,20760,44429,15345,71588,23866,11515,12351
59595,92354,20760,44432,15345,71593,23869,11516,12353
59600,92365,20762,44436,15346,71603,23871,11516,12355
59605,92369,20763,44439,15347,71605,23872,11517,12355
59610,92379,20766,44444,15350,71613,23874,11518,12356
59615,92385,20766,44446,15350,71618,23877,11519,12358
59620,92396,20768,44452,15351,71627,23879,11519,12360
59625,92400,20769,44453,15352,71631,23880,11519,12361
59630,92410,20774,44459,15357,71636,23882,11519,12363
59635,92416,20774,44462,15357,71640,23885,11520,12365
59640,92427,20778,44465,15360,71647,23887,11520,12367
59645,92431,20779,44466,15361,71652,23888,11520,12368
59650,92441,20782,44470,15362,71659,23890,11521,12369
59655,92447,20782,44473,15362,71664,23893,11522,12371
59660,92458,20785,44477,15364,71671,23895,11522,12373
59665,92462,20786,44478,15364,71675,23896,11522,12374
59670,92472,20790,44481,15367,71682,23898,11522,12376
59675,92478,20790,44483,15367,71687,23901,11522,12379
59680,92489,20792,44488,15368,71695,23903,11523,12380
59685,92493,20793,44491,15369,71700,23904,11523,12381
59690,92503,20796,44496,15370,71707,23906,11524,12382
59695,92509,20796,44500,15370,71711,23909,11525,12384
59700,92520,20800,44507,15373,71718,23911,11527,12384
59705,92524,20802,44510,15375,71722,23912,11527,12385
59710,92534,20804,44514,15376,71730,23914,11528,12386
59715,92540,20804,44514,15376,71736,23917,11528,12389
59720,92551,20807,44520,15378,71743,23919,11528,12391
59725,92555,20808,44522,15379,71747,23920,11529,12391
59730,92565,20811,44528,15380,71754,23922,11531,12391
59735,92571,20811,44532,15380,71759,23925,11534,12391
59740,92582,20814,44538,15382,71766,23927,11535,12392
59745,92586,20816,44538,15383,71770,23928,11535,12393
59750,92596,20819,44543,15385,71777,23930,11535,12395
59755,92602,20819,44545,15385,71782,23933,11536,12397
59760,92613,20822,44550,15388,71791,23935,11538,12397
59765,92617,20824,44552,15389,71793,23936,11538,12398
59770,92627,20828,44558,15392,71799,23938,11539,12399
59775,92633,20828,44559,15392,71804,23941,11539,12402
59780,92644,20829,44561,15392,71815,23943,11541,12402
59785,92648,20830,44561,15392,71818,23944,11541,12403
59790,92658,20832,44564,15392,71826,23946,11541,12405
59795,92664,20832,44566,15392,71832,23949,11543,12406
59800,92675,20834,44574,15394,71838,23951,11544,12407
59805,92679,20839,44575,15398,71840,23952,11544,12408
59810,92689,20842,44580,15401,71847,23954,11545,12409
59815,92695,20842,44583,15401,71851,23957,11546,12411
59820,92706,20845,44587,15403,71859,23959,11547,12412
59825,92710,20848,44588,15406,71862,23960,11547,12413
59830,92720,20851,44592,15409,71869,23962,11548,12414
59835,92726,20851,44593,15409,71875,23965,11549,12416
59840,92737,20853,44597,15410,71882,23967,11549,12418
59845,92741,20857,44599,15413,71884,23968,11550,12418
59850,92751,20862,44604,15417,71889,23970,11551,12419
59855,92757,20862,44606,15417,71894,23973,11551,12422
59860,92768,20864,44611,15419,71903,23975,11552,12423
59865,92772,20865,44612,15420,71907,23976,11552,12424
59870,92782,20867,44617,15421,71915,23978,11553,12425
59875,92788,20867,44621,15421,71921,23981,11556,12425
59880,92799,20868,44625,15421,71930,23983,11557,12426
59885,92803,20869,44626,15421,71934,23984,11557,12427
59890,92813,20872,44629,15423,71941,23986,11558,12428
59895,92819,20872,44630,15423,71946,23989,11558,12431
59900,92830,20874,44637,15425,71955,23991,11559,12432
59905,92834,20875,44639,15426,71959,23992,11560,12432
59910,92844,20878,44645,15429,71966,23994,11560,12434
59915,92850,20878,44646,15429,71971,23997,11560,12437
59920,92861,20879,44650,15429,71980,23999,11560,12439
59925,92865,20880,44651,15430,71985,24000,11560,12440
59930,92875,20882,44655,15431,71993,24002,11561,12441
59935,92881,20882,44659,15431,71997,24005,11563,12442
59940,92892,20883,44663,15432,72008,24007,11563,12444
59945,92896,20884,44666,15432,72011,24008,11564,12444
59950,92906,20885,44670,15433,72021,24010,11564,12446
59955,92912,20885,44674,15433,72025,24013,11566,12447
59960,92923,20888,44678,15435,72033,24015,11567,12448
59965,92927,20892,44680,15439,72035,24016,11567,12449
59970,92937,20894,44681,15440,72043,24018,11567,12451
59975,92943,20894,44686,15440,72048,24021,11570,12451
59980,92954,20896,44691,15442,72056,24023,11572,12451
59985,92958,20897,44694,15442,72060,24024,11573,12451
59990,92968,20901,44701,15446,72067,24026,11574,12452
59995,92974,20901,44703,15446,72073,24029,11575,12454
60000,92985,20902,44705,15446,72082,24031,11576,12455
60005,92989,20903,44707,15447,72086,24032,11576,12456
60010,92999,20905,44710,15447,72094,24034,11577,12457
60015,93005,20905,44712,15447,72100,24037,11578,12459
60020,93016,20906,44716,15447,72109,24039,11579,12460
60025,93020,20907,44717,15447,72113,24040,11580,12460
60030,93030,20909,44722,15448,72121,24042,11582,12460
60035,93036,20909,44723,15448,72127,24045,11582,12463
60040,93047,20911,44728,15449,72135,24047,11584,12463
60045,93051,20913,44729,15450,72138,24048,11585,12463
60050,93061,20917,44735,15453,72144,24050,11586,12464
60055,93067,20917,44738,15453,72150,24053,11588,12465
60060,93078,20919,44744,15455,72159,24055,11588,12467
60065,93082,20920,44745,15455,72162,24056,11588,12468
60070,93092,20923,44751,15457,72169,24058,11590,12468
60075,93098,20923,44756,15457,72174,24061,11593,12468
60080,93109,20928,44762,15462,72181,24063,11594,12469
60085,93113,20930,44763,15463,72183,24064,11594,12470
60090,93123,20934,44769,15467,72189,24066,11596,12470
60095,93129,20934,44772,15467,72193,24069,11596,12473
60100,93140,20938,44777,15470,72201,24071,11597,12474
60105,93144,20940,44778,15471,72204,24072,11597,12475
60110,93154,20942,44780,15473,72212,24074,11597,12477
60115,93160,20942,44783,15473,72218,24077,11599,12478
60120,93171,20946,44791,15476,72224,24079,11600,12479
60125,93175,20948,44793,15477,72227,24080,11601,12479
60130,93185,20951,44798,15478,72234,24082,11602,12480
60135,93191,20951,44799,15478,72239,24085,11602,12483
60140,93202,20954,44805,15480,72246,24087,11604,12483
60145,93206,20958,44808,15484,72248,24088,11604,12484
60150,93216,20961,44812,15485,72255,24090,11605,12485
60155,93222,20961,44814,15485,72260,24093,11606,12487
60160,93233,20963,44819,15486,72268,24095,11607,12488
60165,93237,20967,44821,15490,72270,24096,11607,12489
60170,93247,20970,44824,15492,72277,24098,11607,12491
60175,93253,20970,44828,15492,72282,24101,11609,12492
60180,93264,20972,44835,15494,72292,24103,11610,12493
60185,93268,20973,44837,15494,72295,24104,11611,12493
60190,93278,20974,44842,15494,72304,24106,11613,12493
60195,93284,20974,44845,15494,72309,24109,11615,12494
60200,93295,20975,44851,15495,72320,24111,11617,12494
60205,93299,20976,44854,15496,72323,24112,11618,12494
60210,93309,20977,44859,15497,72332,24114,11620,12494
60215,93315,20977,44863,15497,72338,24117,11623,12494
60220,93326,20978,44868,15497,72347,24119,11625,12494
60225,93330,20979,44870,15497,72351,24120,11626,12494
60230,93340,20980,44874,15497,72360,24122,11627,12495
60235,93346,20980,44875,15497,72366,24125,11627,12498
60240,93357,20982,44883,15499,72374,24127,11629,12498
60245,93361,20983,44886,15499,72378,24128,11630,12498
60250,93371,20984,44889,15499,72387,24130,11631,12499
60255,93377,20984,44893,15499,72392,24133,11633,12500
60260,93388,20985,44899,15500,72403,24135,11634,12501
60265,93392,20986,44900,15501,72406,24136,11634,12502
60270,93402,20987,44907,15502,72415,24138,11636,12502
60275,93408,20987,44911,15502,72420,24141,11638,12503
60280,93419,20992,44918,15506,72426,24143,11639,12504
60285,93423,20994,44920,15508,72429,24144,11640,12504
60290,93433,20996,44923,15508,72437,24146,11641,12505
60295,93439,20996,44925,15508,72442,24149,11642,12507
60300,93450,20999,44929,15510,72451,24151,11643,12508
60305,93454,21001,44932,15512,72453,24152,11643,12509
60310,93464,21004,44938,15515,72460,24154,11645,12509
60315,93470,21004,44943,15515,72464,24157,11647,12510
60320,93481,21009,44950,15520,72470,24159,11648,12511
60325,93485,21013,44953,15524,72472,24160,11649,12511
60330,93495,21015,44957,15526,72480,24162,11649,12513
60335,93501,21015,44959,15526,72485,24165,11650,12515
60340,93512,21019,44967,15530,72492,24167,11651,12516
60345,93516,21022,44969,15533,72494,24168,11651,12517
60350,93526,21024,44973,15534,72502,24170,11652,12518
60355,93532,21024,44977,15534,72506,24173,11654,12519
60360,93543,21028,44985,15538,72514,24175,11656,12519
60365,93547,21029,44988,15539,72518,24176,11656,12520
60370,93557,21030,44994,15540,72527,24178,11656,12522
60375,93563,21030,44997,15540,72532,24181,11657,12524
60380,93574,21031,45002,15540,72542,24183,11659,12524
60385,93578,21032,45005,15540,72546,24184,11660,12524
60390,93588,21033,45009,15541,72555,24186,11660,12526
60395,93594,21033,45013,15541,72561,24189,11663,12526
60400,93605,21035,45019,15543,72570,24191,11663,12528
60405,93609,21036,45020,15543,72573,24192,11663,12529
60410,93619,21037,45025,15543,72582,24194,11665,12529
60415,93625,21037,45028,15543,72587,24197,11666,12531
60420,93636,21039,45033,15544,72596,24199,11667,12532
60425,93640,21040,45034,15545,72600,24200,11667,12533
60430,93650,21041,45037,15545,72609,24202,11667,12535
60435,93656,21041,45039,15545,72615,24205,11667,12538
60440,93667,21042,45045,15546,72625,24207,11667,12540
60445,93671,21043,45048,15547,72628,24208,11668,12540
60450,93681,21044,45053,15547,72637,24210,11670,12540
60455,93687,21044,45058,15547,72643,24213,11673,12540
60460,93698,21045,45063,15548,72652,24215,11674,12541
60465,93702,21046,45065,15548,72656,24216,11675,12541
60470,93712,21048,45070,15548,72664,24218,11676,12542
60475,93718,21048,45072,15548,72669,24221,11677,12544
60480,93729,21051,45078,15551,72676,24223,11677,12546
60485,93733,21053,45081,15553,72680,24224,11678,12546
60490,93743,21055,45085,15555,72688,24226,11679,12547
60495,93749,21055,45089,15555,72693,24229,11681,12548
60500,93760,21059,45095,15558,72700,24231,11682,12549
60505,93764,21061,45097,15559,72703,24232,11683,12549
60510,93774,21063,45101,15559,72711,24234,11684,12550
60515,93780,21063,45103,15559,72716,24237,11685,12552
60520,93791,21066,45107,15560,72724,24239,11686,12553
60525,93795,21068,45110,15562,72727,24240,11686,12554
60530,93805,21072,45117,15565,72733,24242,11688,12554
60535,93811,21072,45120,15565,72738,24245,11689,12556
60540,93822,21076,45126,15568,72745,24247,11689,12558
60545,93826,21078,45128,15570,72748,24248,11690,12558
60550,93836,21081,45132,15572,72755,24250,11691,12559
60555,93842,21081,45134,15572,72761,24253,11692,12561
60560,93853,21083,45136,15572,72769,24255,11692,12563
60565,93857,21085,45137,15574,72772,24256,11692,12564
60570,93867,21088,45142,15576,72779,24258,11693,12565
60575,93873,21088,45147,15576,72783,24261,11696,12565
60580,93884,21093,45155,15581,72790,24263,11697,12566
60585,93888,21095,45157,15582,72793,24264,11698,12566
60590,93898,21098,45165,15585,72800,24266,11699,12567
60595,93904,21098,45170,15585,72804,24269,11701,12568
60600,93915,21103,45173,15589,72812,24271,11701,12570
60605,93919,21104,45173,15589,72815,24272,11701,12571
60610,93929,21105,45180,15590,72824,24274,11703,12571
60615,93935,21105,45184,15590,72829,24277,11705,12572
60620,93946,21107,45189,15591,72839,24279,11706,12573
60625,93950,21108,45191,15591,72842,24280,11707,12573
60630,93960,21109,45195,15591,72851,24282,11707,12575
60635,93966,21109,45198,15591,72857,24285,11710,12575
60640,93977,21111,45204,15593,72866,24287,11710,12577
60645,93981,21112,45206,15594,72869,24288,11710,12578
60650,93991,21113,45211,15595,72878,24290,11710,12580
60655,93997,21113,45214,15595,72884,24293,11712,12581
60660,94008,21115,45221,15597,72892,24295,11713,12582
60665,94012,21116,45223,15597,72896,24296,11714,12582
60670,94022,21117,45227,15597,72905,24298,11715,12583
60675,94028,21117,45230,15597,72910,24301,11716,12585
60680,94039,21119,45237,15598,72919,24303,11718,12585
60685,94043,21120,45239,15598,72923,24304,11718,12586
60690,94053,21121,45242,15598,72932,24306,11718,12588
60695,94059,21121,45243,15598,72938,24309,11718,12591
60700,94070,21123,45250,15599,72946,24311,11719,12592
60705,94074,21125,45252,15601,72949,24312,11720,12592
60710,94084,21129,45258,15604,72955,24314,11720,12594
60715,94090,21129,45260,15604,72961,24317,11722,12595
60720,94101,21131,45267,15605,72968,24319,11724,12595
60725,94105,21135,45270,15609,72970,24320,11725,12595
60730,94115,21137,45275,15610,72978,24322,11726,12596
60735,94121,21137,45278,15610,72984,24325,11728,12597
60740,94132,21139,45283,15611,72991,24327,11729,12598
60745,94136,21142,45284,15613,72994,24328,11730,12598
60750,94146,21145,45289,15615,73001,24330,11731,12599
60755,94152,21145,45293,15615,73005,24333,11733,12600
60760,94163,21149,45297,15618,73013,24335,11733,12602
60765,94167,21152,45301,15621,73015,24336,11734,12602
60770,94177,21155,45304,15623,73022,24338,11735,12603
60775,94183,21155,45307,15623,73027,24341,11737,12604
60780,94194,21159,45314,15625,73033,24343,11739,12604
60785,94198,21163,45315,15628,73035,24344,11739,12605
60790,94208,21164,45319,15628,73044,24346,11740,12606
60795,94214,21164,45321,15628,73050,24349,11742,12607
60800,94225,21166,45327,15629,73058,24351,11743,12608
60805,94229,21167,45328,15630,73062,24352,11743,12609
60810,94239,21168,45333,15630,73071,24354,11744,12610
60815,94245,21168,45335,15630,73077,24357,11745,12612
60820,94256,21170,45341,15632,73085,24359,11746,12613
60825,94260,21171,45343,15633,73089,24360,11746,12614
60830,94270,21172,45351,15634,73098,24362,11748,12614
60835,94276,21172,45354,15634,73104,24365,11750,12615
60840,94287,21174,45357,15634,73113,24367,11751,12616
60845,94291,21175,45359,15635,73116,24368,11751,12617
60850,94301,21176,45365,15636,73125,24370,11752,12618
60855,94307,21176,45368,15636,73131,24373,11754,12619
60860,94318,21178,45376,15638,73139,24375,11755,12620
60865,94322,21179,45378,15639,73143,24376,11755,12621
60870,94332,21180,45383,15639,73152,24378,11756,12622
60875,94338,21180,45388,15639,73158,24381,11759,12622
60880,94349,21182,45393,15641,73167,24383,11760,12623
60885,94353,21183,45394,15641,73170,24384,11760,12624
60890,94363,21184,45400,15641,73179,24386,11761,12625
60895,94369,21184,45402,15641,73185,24389,11762,12627
60900,94380,21186,45406,15641,73193,24391,11762,12629
60905,94384,21188,45408,15642,73196,24392,11763,12629
60910,94394,21190,45413,15642,73204,24394,11764,12630
60915,94400,21190,45418,15642,73210,24397,11767,12630
60920,94411,21192,45422,15643,73219,24399,11768,12631
60925,94415,21193,45424,15643,73222,24400,11769,12631
60930,94425,21195,45429,15643,73230,24402,11771,12631
60935,94431,21195,45432,15643,73235,24405,11773,12632
60940,94442,21198,45436,15644,73243,24407,11774,12633
60945,94446,21199,45439,15644,73247,24408,11775,12633
60950,94456,21201,45448,15646,73255,24410,11777,12633
60955,94462,21201,45452,15646,73259,24413,11779,12634
60960,94473,21205,45457,15649,73266,24415,11779,12636
60965,94477,21208,45460,15652,73269,24416,11780,12636
60970,94487,21210,45463,15652,73277,24418,11781,12637
60975,94493,21210,45468,15652,73282,24421,11784,12637
60980,94504,21213,45469,15653,73290,24423,11784,12639
60985,94508,21216,45472,15655,73292,24424,11785,12639
60990,94518,21218,45473,15655,73300,24426,11785,12641
60995,94524,21218,45476,15655,73306,24429,11787,12642
61000,94535,21221,45484,15658,73313,24431,11789,12642
61005,94539,21224,45487,15660,73315,24432,11790,12642
61010,94549,21227,45491,15663,73322,24434,11791,12643
61015,94555,21227,45493,15663,73327,24437,11792,12645
61020,94566,21231,45500,15666,73334,24439,11793,12646
61025,94570,21233,45500,15667,73337,24440,11793,12647
61030,94580,21236,45505,15669,73344,24442,11793,12649
61035,94586,21236,45508,15669,73350,24445,11795,12650
61040,94597,21239,45516,15670,73357,24447,11797,12650
61045,94601,21242,45519,15673,73359,24448,11797,12651
61050,94611,21245,45523,15675,73366,24450,11797,12653
61055,94617,21245,45527,15675,73371,24453,11799,12654
61060,94628,21248,45528,15676,73380,24455,11799,12656
61065,94632,21250,45529,15677,73382,24456,11799,12657
61070,94642,21253,45534,15679,73389,24458,11800,12658
61075,94648,21253,45539,15679,73394,24461,11803,12658
61080,94659,21257,45544,15682,73401,24463,11803,12660
61085,94663,21259,45548,15684,73404,24464,11804,12660
61090,94673,21260,45551,15685,73413,24466,11805,12661
61095,94679,21260,45554,15685,73419,24469,11806,12663
61100,94690,21262,45560,15686,73427,24471,11807,12664
61105,94694,21263,45561,15687,73431,24472,11807,12665
61110,94704,21264,45566,15687,73440,24474,11809,12665
61115,94710,21264,45568,15687,73446,24477,11810,12667
61120,94721,21266,45572,15687,73455,24479,11811,12668
61125,94725,21267,45574,15687,73458,24480,11812,12668
61130,94735,21268,45579,15687,73467,24482,11813,12669
61135,94741,21268,45582,15687,73472,24485,11814,12671
61140,94752,21270,45589,15688,73481,24487,11815,12672
61145,94756,21271,45592,15689,73485,24488,11815,12673
61150,94766,21272,45597,15690,73494,24490,11816,12674
61155,94772,21272,45599,15690,73499,24493,11817,12676
61160,94783,21274,45604,15691,73509,24495,11819,12676
61165,94787,21275,45606,15692,73512,24496,11819,12677
61170,94797,21276,45613,15693,73521,24498,11820,12678
61175,94803,21276,45617,15693,73527,24501,11822,12679
61180,94814,21278,45621,15693,73536,24503,11823,12680
61185,94818,21279,45623,15693,73539,24504,11824,12680
61190,94828,21281,45630,15695,73547,24506,11825,12681
61195,94834,21281,45634,15695,73552,24509,11827,12682
61200,94845,21284,45641,15697,73559,24511,11828,12683
61205,94849,21286,45643,15698,73563,24512,11829,12683
61210,94859,21288,45645,15698,73571,24514,11829,12685
61215,94865,21288,45648,15698,73577,24517,11830,12687
61220,94876,21290,45653,15698,73586,24519,11832,12687
61225,94880,21291,45654,15698,73589,24520,11832,12688
61230,94890,21293,45658,15700,73597,24522,11833,12689
61235,94896,21293,45664,15700,73602,24525,11836,12689
61240,94907,21296,45669,15702,73609,24527,11836,12691
61245,94911,21298,45672,15704,73613,24528,11837,12691
61250,94921,21300,45679,15705,73621,24530,11838,12692
61255,94927,21300,45681,15705,73627,24533,11838,12695
61260,94938,21303,45687,15707,73634,24535,11838,12697
61265,94942,21306,45690,15710,73636,24536,11838,12698
61270,94952,21309,45696,15713,73643,24538,11840,12698
61275,94958,21309,45699,15713,73648,24541,11841,12700
61280,94969,21313,45706,15717,73655,24543,11841,12702
61285,94973,21316,45708,15719,73657,24544,11842,12702
61290,94983,21318,45714,15721,73665,24546,11844,12702
61295,94989,21318,45720,15721,73669,24549,11847,12702
61300,95000,21322,45726,15725,73678,24551,11848,12703
61305,95004,21324,45728,15726,73680,24552,11848,12704
61310,95014,21326,45732,15727,73688,24554,11849,12705
61315,95020,21326,45735,15727,73693,24557,11850,12707
61320,95031,21329,45737,15729,73701,24559,11850,12709
61325,95035,21331,45739,15731,73704,24560,11851,12709
61330,95045,21335,45746,15735,73710,24562,11852,12710
61335,95051,21335,45750,15735,73714,24565,11854,12711
61340,95062,21340,45757,15739,73722,24567,11855,12712
61345,95066,21341,45758,15739,73725,24568,11856,12712
61350,95076,21344,45766,15741,73732,24570,11858,12712
61355,95082,21344,45768,15741,73738,24573,11860,12713
61360,95093,21346,45774,15743,73745,24575,11861,12714
61365,95097,21349,45775,15745,73748,24576,11861,12715
61370,95107,21351,45780,15746,73756,24578,11863,12715
61375,95113,21351,45785,15746,73761,24581,11866,12715
61380,95124,21354,45789,15747,73768,24583,11866,12717
61385,95128,21356,45791,15748,73772,24584,11867,12717
61390,95138,21357,45794,15749,73781,24586,11868,12718
61395,95144,21357,45797,15749,73786,24589,11869,12720
61400,95155,21359,45802,15751,73796,24591,11870,12721
61405,95159,21360,45804,15751,73799,24592,11871,12721
61410,95169,21361,45809,15752,73808,24594,11871,12723
61415,95175,21361,45811,15752,73813,24597,11872,12725
61420,95186,21363,45815,15753,73822,24599,11872,12727
61425,95190,21364,45816,15754,73826,24600,11872,12728
61430,95200,21365,45818,15754,73835,24602,11872,12730
61435,95206,21365,45820,15754,73840,24605,11872,12733
61440,95217,21367,45826,15755,73849,24607,11874,12733
61445,95221,21368,45827,15756,73853,24608,11874,12734
61450,95231,21369,45830,15756,73862,24610,11874,12736
61455,95237,21369,45832,15756,73867,24613,11874,12739
61460,95248,21371,45837,15758,73877,24615,11875,12740
61465,95252,21372,45838,15759,73880,24616,11875,12741
61470,95262,21373,45847,15760,73889,24618,11877,12741
61475,95268,21373,45850,15760,73895,24621,11878,12743
61480,95279,21375,45854,15761,73904,24623,11879,12744
61485,95283,21376,45856,15762,73907,24624,11880,12744
61490,95293,21379,45863,15764,73914,24626,11882,12744
61495,95299,21379,45867,15764,73919,24629,11884,12745
61500,95310,21382,45875,15767,73926,24631,11886,12745
61505,95314,21386,45878,15771,73928,24632,11887,12745
61510,95324,21389,45881,15773,73935,24634,11887,12747
61515,95330,21389,45883,15773,73940,24637,11888,12749
61520,95341,21392,45888,15775,73948,24639,11889,12750
61525,95345,21393,45889,15775,73952,24640,11889,12751
61530,95355,21395,45892,15776,73960,24642,11890,12752
61535,95361,21395,45895,15776,73966,24645,11891,12754
61540,95372,21397,45898,15776,73975,24647,11892,12755
61545,95376,21398,45899,15776,73978,24648,11893,12755
61550,95386,21400,45905,15778,73986,24650,11894,12756
61555,95392,21400,45907,15778,73991,24653,11895,12758
61560,95403,21403,45914,15780,73998,24655,11897,12758
61565,95407,21405,45917,15782,74002,24656,11898,12758
61570,95417,21407,45921,15782,74010,24658,11900,12758
61575,95423,21407,45923,15782,74016,24661,11901,12760
61580,95434,21409,45930,15783,74023,24663,11901,12762
61585,95438,21411,45933,15785,74027,24664,11902,12762
61590,95448,21413,45937,15785,74035,24666,11904,12762
61595,95454,21413,45939,15785,74041,24669,11905,12764
61600,95465,21415,45948,15785,74048,24671,11907,12764
61605,95469,21417,45952,15787,74052,24672,11908,12764
61610,95479,21419,45959,15789,74060,24674,11910,12764
61615,95485,21419,45963,15789,74065,24677,11912,12765
61620,95496,21423,45967,15793,74073,24679,11913,12766
61625,95500,21425,45969,15794,74075,24680,11913,12767
61630,95510,21427,45973,15794,74083,24682,11914,12768
61635,95516,21427,45977,15794,74088,24685,11915,12770
61640,95527,21430,45981,15795,74096,24687,11916,12771
61645,95531,21431,45983,15796,74100,24688,11916,12772
61650,95541,21433,45987,15797,74108,24690,11916,12774
61655,95547,21433,45990,15797,74113,24693,11917,12776
61660,95558,21437,45995,15799,74120,24695,11918,12777
61665,95562,21440,45997,15801,74122,24696,11919,12777
61670,95572,21442,46003,15802,74130,24698,11920,12778
61675,95578,21442,46006,15802,74136,24701,11922,12779
61680,95589,21444,46011,15802,74144,24703,11923,12780
61685,95593,21446,46013,15803,74147,24704,11924,12780
61690,95603,21448,46019,15804,74155,24706,11925,12781
61695,95609,21448,46022,15804,74160,24709,11927,12782
61700,95620,21452,46028,15807,74167,24711,11929,12782
61705,95624,21455,46031,15809,74169,24712,11930,12782
61710,95634,21457,46036,15811,74177,24714,11930,12784
61715,95640,21457,46036,15811,74183,24717,11930,12787
61720,95651,21459,46043,15813,74190,24719,11931,12788
61725,95655,21462,46046,15816,74193,24720,11932,12788
61730,95665,21465,46050,15818,74200,24722,11933,12789
61735,95671,21465,46055,15818,74205,24725,11936,12789
61740,95682,21469,46063,15820,74211,24727,11937,12790
61745,95686,21472,46065,15822,74214,24728,11938,12790
61750,95696,21474,46069,15822,74222,24730,11940,12790
61755,95702,21474,46072,15822,74227,24733,11942,12791
61760,95713,21478,46078,15826,74234,24735,11942,12793
61765,95717,21479,46081,15826,74238,24736,11943,12793
61770,95727,21480,46085,15827,74247,24738,11944,12794
61775,95733,21480,46088,15827,74252,24741,11946,12795
61780,95744,21482,46093,15828,74262,24743,11948,12795
61785,95748,21483,46095,15829,74265,24744,11949,12795
61790,95758,21484,46100,15830,74274,24746,11950,12796
61795,95764,21484,46104,15830,74280,24749,11952,12797
61800,95775,21486,46112,15831,74289,24751,11954,12797
61805,95779,21487,46115,15832,74292,24752,11954,12798
61810,95789,21488,46118,15832,74301,24754,11954,12800
61815,95795,21488,46121,15832,74306,24757,11956,12801
61820,95806,21490,46128,15833,74315,24759,11956,12803
61825,95810,21491,46130,15834,74319,24760,11956,12804
61830,95820,21492,46136,15834,74328,24762,11957,12805
61835,95826,21492,46140,15834,74334,24765,11959,12806
61840,95837,21494,46146,15835,74342,24767,11960,12807
61845,95841,21495,46147,15835,74346,24768,11961,12807
61850,95851,21496,46153,15836,74355,24770,11962,12808
61855,95857,21496,46157,15836,74360,24773,11963,12810
61860,95868,21498,46160,15836,74370,24775,11963,12812
61865,95872,21499,46162,15837,74373,24776,11963,12813
61870,95882,21502,46167,15839,74380,24778,11963,12815
61875,95888,21502,46171,15839,74384,24781,11965,12816
61880,95899,21507,46176,15843,74392,24783,11966,12817
61885,95903,21509,46180,15845,74394,24784,11967,12817
61890,95913,21513,46186,15848,74400,24786,11968,12818
61895,95919,21513,46189,15848,74405,24789,11970,12819
61900,95930,21516,46193,15849,74412,24791,11970,12821
61905,95934,21520,46195,15853,74414,24792,11970,12822
61910,95944,21523,46200,15855,74421,24794,11970,12824
61915,95950,21523,46201,15855,74426,24797,11970,12827
61920,95961,21527,46206,15859,74434,24799,11971,12828
61925,95965,21529,46208,15860,74436,24800,11972,12828
61930,95975,21532,46214,15862,74443,24802,11974,12828
61935,95981,21532,46216,15862,74449,24805,11976,12829
61940,95992,21535,46219,15863,74456,24807,11976,12831
61945,95996,21537,46220,15864,74459,24808,11977,12831
61950,96006,21539,46224,15864,74467,24810,11977,12833
61955,96012,21539,46226,15864,74472,24813,11978,12835
61960,96023,21543,46232,15867,74480,24815,11980,12835
61965,96027,21545,46233,15868,74482,24816,11980,12836
61970,96037,21547,46235,15870,74490,24818,11980,12838
61975,96043,21547,46237,15870,74494,24821,11980,12841
61980,96054,21552,46245,15874,74501,24823,11981,12842
61985,96058,21553,46246,15875,74505,24824,11981,12843
61990,96068,21554,46253,15875,74514,24826,11983,12843
61995,96074,21554,46254,15875,74520,24829,11983,12846
62000,96085,21556,46259,15876,74529,24831,11985,12846
62005,96089,21557,46261,15877,74532,24832,11986,12846
62010,96099,21558,46269,15878,74541,24834,11988,12846
62015,96105,21558,46271,15878,74547,24837,11989,12848
62020,96116,21560,46278,15880,74555,24839,11990,12849
62025,96120,21561,46279,15880,74559,24840,11991,12849
62030,96130,21562,46284,15880,74568,24842,11993,12849
62035,96136,21562,46286,15880,74574,24845,11994,12851
62040,96147,21564,46291,15881,74583,24847,11995,12852
62045,96151,21565,46292,15881,74586,24848,11995,12853
62050,96161,21566,46295,15882,74595,24850,11995,12855
62055,96167,21566,46299,15882,74601,24853,11996,12857
62060,96178,21568,46305,15883,74610,24855,11997,12858
62065,96182,21569,46307,15884,74613,24856,11997,12859
62070,96192,21570,46312,15884,74622,24858,11998,12860
62075,96198,21570,46317,15884,74628,24861,12001,12860
62080,96209,21572,46320,15884,74636,24863,12002,12861
62085,96213,21573,46322,15884,74640,24864,12003,12861
62090,96223,21575,46328,15884,74648,24866,12005,12861
62095,96229,21575,46330,15884,74654,24869,12006,12863
62100,96240,21577,46332,15884,74663,24871,12006,12865
62105,96244,21579,46334,15885,74665,24872,12006,12866
62110,96254,21581,46339,15887,74673,24874,12007,12867
62115,96260,21581,46342,15887,74679,24877,12009,12868
62120,96271,21583,46347,15888,74686,24879,12010,12869
62125,96275,21586,46349,15891,74689,24880,12011,12869
62130,96285,21588,46351,15891,74697,24882,12012,12870
62135,96291,21588,46353,15891,74703,24885,12014,12871
62140,96302,21590,46358,15892,74711,24887,12016,12871
62145,96306,21593,46361,15895,74713,24888,12017,12871
62150,96316,21595,46365,15895,74721,24890,12018,12872
62155,96322,21595,46368,15895,74725,24893,12019,12874
62160,96333,21600,46374,15900,74731,24895,12019,12876
62165,96337,21604,46377,15904,74733,24896,12019,12877
62170,96347,21606,46380,15905,74741,24898,12019,12879
62175,96353,21606,46383,15905,74746,24901,12020,12881
62180,96364,21608,46388,15906,74756,24903,12021,12882
62185,96368,21610,46390,15908,74758,24904,12021,12883
62190,96378,21611,46394,15908,74767,24906,12022,12884
62195,96384,21611,46396,15908,74772,24909,12023,12886
62200,96395,21613,46401,15910,74781,24911,12023,12888
62205,96399,21615,46404,15912,74784,24912,12024,12888
62210,96409,21617,46407,15914,74792,24914,12024,12890
62215,96415,21617,46410,15914,74798,24917,12026,12891
62220,96426,21619,46417,15916,74807,24919,12027,12892
62225,96430,21621,46418,15917,74809,24920,12027,12893
62230,96440,21624,46424,15919,74816,24922,12029,12893
62235,96446,21624,46426,15919,74821,24925,12029,12896
62240,96457,21627,46435,15922,74828,24927,12030,12897
62245,96461,21630,46438,15924,74831,24928,12031,12897
62250,96471,21630,46443,15924,74841,24930,12032,12898
62255,96477,21630,46444,15924,74846,24933,12032,12901
62260,96488,21631,46449,15924,74856,24935,12033,12902
62265,96492,21632,46452,15925,74860,24936,12033,12903
62270,96502,21632,46457,15925,74870,24938,12035,12903
62275,96508,21632,46459,15925,74876,24941,12036,12905
62280,96519,21633,46465,15925,74886,24943,12038,12905
62285,96523,21634,46468,15926,74889,24944,12039,12905
62290,96533,21634,46471,15926,74899,24946,12040,12906
62295,96539,21634,46475,15926,74904,24949,12042,12907
62300,96550,21635,46481,15926,74915,24951,12043,12908
62305,96554,21636,46484,15926,74918,24952,12044,12908
62310,96564,21636,46488,15926,74928,24954,12045,12909
62315,96570,21636,46492,15926,74934,24957,12047,12910
62320,96581,21637,46498,15927,74944,24959,12048,12911
62325,96585,21638,46500,15927,74947,24960,12049,12911
62330,96595,21638,46505,15927,74957,24962,12050,12912
62335,96601,21638,46507,15927,74963,24965,12051,12914
62340,96612,21639,46516,15928,74972,24967,12052,12915
62345,96616,21640,46518,15929,74976,24968,12052,12916
62350,96626,21640,46522,15929,74986,24970,12053,12917
62355,96632,21640,46525,15929,74990,24973,12054,12919
62360,96643,21644,46532,15933,74997,24975,12055,12920
62365,96647,21648,46534,15937,74999,24976,12055,12921
62370,96657,21651,46540,15939,75006,24978,12056,12922
62375,96663,21651,46545,15939,75011,24981,12059,12922
62380,96674,21654,46550,15941,75019,24983,12060,12923
62385,96678,21657,46553,15944,75021,24984,12061,12923
62390,96688,21660,46560,15947,75028,24986,12061,12925
62395,96694,21660,46565,15947,75033,24989,12064,12925
62400,96705,21663,46571,15950,75040,24991,12064,12927
62405,96709,21665,46572,15951,75044,24992,12064,12928
62410,96719,21666,46577,15951,75053,24994,12064,12930
62415,96725,21666,46582,15951,75059,24997,12067,12930
62420,96736,21667,46586,15951,75068,24999,12069,12930
62425,96740,21668,46586,15951,75072,25000,12069,12931
62430,96750,21669,46590,15951,75081,25002,12070,12932
62435,96756,21669,46592,15951,75086,25005,12071,12934
62440,96767,21671,46595,15952,75095,25007,12071,12936
62445,96771,21672,46596,15952,75099,25008,12071,12937
62450,96781,21673,46599,15953,75108,25010,12072,12938
62455,96787,21673,46601,15953,75114,25013,12073,12940
62460,96798,21674,46605,15954,75123,25015,12073,12942
62465,96802,21675,46607,15955,75127,25016,12074,12942
62470,96812,21676,46613,15956,75136,25018,12074,12944
62475,96818,21676,46616,15956,75142,25021,12076,12945
62480,96829,21677,46620,15956,75150,25023,12078,12945
62485,96833,21679,46622,15958,75154,25024,12078,12946
62490,96843,21680,46627,15959,75163,25026,12079,12947
62495,96849,21680,46630,15959,75169,25029,12081,12948
62500,96860,21681,46633,15959,75178,25031,12082,12949
62505,96864,21682,46635,15959,75182,25032,12082,12950
62510,96874,21685,46641,15962,75189,25034,12082,12952
62515,96880,21685,46644,15962,75195,25037,12084,12953
62520,96891,21687,46651,15963,75203,25039,12085,12954
62525,96895,21689,46653,15964,75206,25040,12086,12954
62530,96905,21690,46658,15964,75215,25041,12087,12954
62535,96911,21690,46661,15964,75220,25044,12088,12956
62540,96922,21693,46670,15966,75227,25046,12090,12956
62545,96926,21696,46673,15968,75230,25047,12091,12956
62550,96936,21698,46679,15970,75238,25048,12092,12956
62555,96942,21698,46681,15970,75243,25051,12093,12958
62560,96953,21700,46687,15972,75251,25053,12094,12959
62565,96957,21704,46688,15975,75253,25054,12094,12960
62570,96967,21704,46696,15975,75263,25055,12095,12960
62575,96973,21704,46700,15975,75268,25058,12097,12961
62580,96984,21705,46705,15976,75278,25060,12098,12962
62585,96988,21706,46707,15976,75282,25061,12099,12962
62590,96998,21706,46711,15976,75292,25062,12099,12963
62595,97004,21706,46714,15976,75298,25065,12101,12964
62600,97015,21707,46718,15976,75307,25067,12102,12965
62605,97019,21708,46721,15977,75311,25068,12103,12965
62610,97029,21708,46725,15977,75321,25069,12104,12965
62615,97035,21708,46728,15977,75327,25072,12105,12967
62620,97046,21709,46732,15978,75336,25074,12106,12968
62625,97050,21710,46733,15979,75340,25075,12106,12969
62630,97060,21710,46741,15979,75350,25076,12107,12969
62635,97066,21710,46743,15979,75355,25079,12108,12971
62640,97077,21711,46750,15980,75365,25081,12110,12971
62645,97081,21712,46753,15981,75369,25082,12111,12971
62650,97091,21712,46755,15981,75379,25084,12112,12972
62655,97097,21712,46759,15981,75384,25087,12114,12973
62660,97108,21713,46765,15981,75394,25089,12116,12973
62665,97112,21714,46768,15982,75398,25090,12117,12973
62670,97122,21714,46771,15982,75408,25092,12118,12974
62675,97128,21714,46776,15982,75413,25095,12121,12974
62680,97139,21717,46780,15985,75421,25097,12121,12976
62685,97143,21719,46782,15986,75424,25098,12122,12976
62690,97153,21722,46787,15988,75431,25100,12123,12977
62695,97159,21722,46791,15988,75436,25103,12125,12978
62700,97170,21724,46795,15990,75445,25105,12126,12979
62705,97174,21726,46799,15992,75448,25106,12127,12979
62710,97184,21728,46803,15993,75456,25108,12128,12980
62715,97190,21728,46804,15993,75462,25111,12129,12982
62720,97201,21729,46809,15994,75471,25113,12129,12984
62725,97205,21731,46811,15995,75474,25114,12130,12984
62730,97215,21733,46818,15996,75482,25116,12132,12984
62735,97221,21733,46821,15996,75488,25119,12134,12985
62740,97232,21735,46826,15998,75496,25121,12135,12986
62745,97236,21737,46830,16000,75499,25122,12136,12986
62750,97246,21740,46835,16002,75506,25124,12136,12988
62755,97252,21740,46836,16002,75512,25127,12136,12991
62760,97263,21741,46842,16003,75521,25129,12138,12991
62765,97267,21743,46843,16005,75524,25130,12138,12992
62770,97277,21745,46847,16006,75532,25131,12138,12993
62775,97283,21745,46851,16006,75538,25134,12140,12994
62780,97294,21746,46856,16006,75547,25136,12142,12994
62785,97298,21747,46858,16006,75551,25137,12143,12994
62790,97308,21748,46861,16007,75560,25138,12143,12995
62795,97314,21748,46863,16007,75565,25141,12143,12998
62800,97325,21750,46869,16008,75573,25143,12144,12999
62805,97329,21752,46872,16010,75577,25144,12144,13000
62810,97339,21753,46877,16010,75586,25145,12144,13001
62815,97345,21753,46880,16010,75591,25148,12146,13002
62820,97356,21755,46886,16011,75599,25150,12147,13003
62825,97360,21757,46889,16013,75603,25151,12147,13004
62830,97370,21758,46895,16014,75612,25152,12148,13004
62835,97376,21758,46901,16014,75617,25155,12151,13004
62840,97387,21760,46907,16015,75625,25157,12152,13005
62845,97391,21762,46911,16017,75629,25158,12153,13005
62850,97401,21763,46918,16017,75638,25159,12153,13006
62855,97407,21763,46923,16017,75643,25162,12156,13006
62860,97418,21765,46928,16018,75651,25164,12157,13007
62865,97422,21767,46930,16019,75655,25165,12158,13007
62870,97432,21768,46934,16020,75664,25167,12158,13009
62875,97438,21768,46936,16020,75668,25170,12158,13012
62880,97449,21772,46942,16023,75675,25172,12159,13013
62885,97453,21775,46943,16025,75678,25173,12159,13014
62890,97463,21777,46949,16027,75686,25175,12161,13014
62895,97469,21777,46952,16027,75692,25178,12163,13015
62900,97480,21778,46958,16028,75701,25180,12165,13015
62905,97484,21779,46959,16028,75705,25181,12166,13015
62910,97494,21779,46965,16028,75715,25183,12167,13016
62915,97500,21779,46968,16028,75720,25186,12169,13017
62920,97511,21780,46976,16028,75730,25188,12171,13017
62925,97515,21781,46977,16028,75734,25189,12171,13018
62930,97525,21781,46980,16028,75744,25191,12172,13019
62935,97531,21781,46981,16028,75750,25194,12173,13021
62940,97542,21782,46985,16028,75759,25196,12173,13023
62945,97546,21783,46987,16029,75763,25197,12173,13024
62950,97556,21783,46990,16029,75773,25199,12173,13026
62955,97562,21783,46994,16029,75778,25202,12175,13027
62960,97573,21784,47000,16029,75788,25204,12175,13029
62965,97577,21785,47004,16030,75792,25205,12176,13029
62970,97587,21785,47008,16030,75802,25207,12177,13030
62975,97593,21785,47009,16030,75808,25210,12178,13032
62980,97604,21786,47014,16030,75817,25212,12179,13033
62985,97608,21787,47016,16030,75821,25213,12179,13034
62990,97618,21787,47019,16030,75831,25214,12179,13035
62995,97624,21787,47023,16030,75836,25217,12180,13037
63000,97635,21789,47027,16031,75845,25219,12181,13038
63005,97639,21792,47030,16034,75847,25220,12181,13039
63010,97649,21794,47036,16036,75855,25221,12182,13039
63015,97655,21794,47039,16036,75860,25224,12183,13041
63020,97666,21797,47044,16039,75868,25226,12183,13043
63025,97670,21799,47045,16040,75871,25227,12183,13044
63030,97680,21801,47051,16042,75879,25228,12184,13044
63035,97686,21801,47054,16042,75884,25231,12186,13045
63040,97697,21804,47060,16044,75892,25233,12187,13046
63045,97701,21805,47061,16044,75896,25234,12188,13046
63050,97711,21807,47067,16046,75904,25235,12188,13047
63055,97717,21807,47069,16046,75909,25238,12189,13049
63060,97728,21810,47072,16048,75917,25240,12190,13050
63065,97732,21811,47073,16049,75921,25241,12190,13051
63070,97742,21812,47077,16049,75930,25242,12191,13051
63075,97748,21812,47080,16049,75934,25245,12192,13053
63080,97759,21816,47083,16052,75943,25247,12193,13054
63085,97763,21817,47086,16053,75946,25248,12194,13054
63090,97773,21819,47090,16055,75954,25249,12195,13054
63095,97779,21819,47092,16055,75959,25252,12196,13056
63100,97790,21821,47096,16056,75969,25254,12196,13058
63105,97794,21823,47097,16057,75971,25255,12196,13059
63110,97804,21824,47101,16057,75980,25257,12197,13060
63115,97810,21824,47104,16057,75985,25260,12198,13062
63120,97821,21827,47109,16059,75992,25262,12198,13064
63125,97825,21829,47112,16061,75996,25263,12199,13064
63130,97835,21829,47118,16061,76006,25265,12201,13064
63135,97841,21829,47123,16061,76011,25268,12204,13064
63140,97852,21830,47127,16061,76021,25270,12206,13064
63145,97856,21831,47129,16061,76025,25271,12207,13064
63150,97866,21831,47134,16061,76035,25273,12208,13065
63155,97872,21831,47139,16061,76041,25276,12210,13066
63160,97883,21832,47144,16061,76051,25278,12211,13067
63165,97887,21833,47148,16062,76054,25279,12212,13067
63170,97897,21833,47157,16062,76064,25281,12214,13067
63175,97903,21833,47159,16062,76070,25284,12215,13069
63180,97914,21834,47164,16063,76079,25286,12215,13071
63185,97918,21835,47166,16064,76083,25287,12215,13072
63190,97928,21835,47170,16064,76093,25289,12216,13073
63195,97934,21835,47176,16064,76099,25292,12219,13073
63200,97945,21836,47179,16064,76108,25294,12219,13075
63205,97949,21837,47180,16064,76112,25295,12219,13076
63210,97959,21837,47186,16064,76122,25297,12220,13077
63215,97965,21837,47190,16064,76128,25300,12221,13079
63220,97976,21838,47197,16065,76137,25302,12223,13079
63225,97980,21839,47200,16066,76141,25303,12224,13079
63230,97990,21840,47206,16066,76150,25305,12226,13079
63235,97996,21840,47208,16066,76156,25308,12228,13080
63240,98007,21841,47212,16066,76165,25310,12229,13081
63245,98011,21843,47213,16067,76168,25311,12229,13082
63250,98021,21844,47218,16067,76177,25312,12229,13083
63255,98027,21844,47218,16067,76183,25315,12229,13086
63260,98038,21845,47224,16067,76192,25317,12231,13086
63265,98042,21847,47226,16069,76195,25318,12232,13086
63270,98052,21848,47228,16070,76204,25319,12233,13086
63275,98058,21848,47231,16070,76209,25322,12234,13088
63280,98069,21850,47238,16071,76217,25324,12236,13088
63285,98073,21853,47241,16074,76220,25325,12237,13088
63290,98083,21855,47246,16076,76228,25326,12237,13089
63295,98089,21855,47250,16076,76232,25329,12238,13091
63300,98100,21858,47257,16078,76241,25331,12239,13092
63305,98104,21861,47259,16081,76243,25332,12239,13093
63310,98114,21862,47262,16081,76252,25333,12240,13093
63315,98120,21862,47266,16081,76256,25336,12242,13094
63320,98131,21866,47272,16084,76263,25338,12242,13096
63325,98135,21870,47275,16087,76265,25339,12243,13096
63330,98145,21872,47280,16088,76273,25340,12243,13097
63335,98151,21872,47282,16088,76279,25343,12245,13098
63340,98162,21874,47290,16090,76287,25345,12247,13098
63345,98166,21877,47293,16092,76289,25346,12248,13098
63350,98176,21879,47300,16094,76297,25348,12249,13099
63355,98182,21879,47301,16094,76303,25351,12249,13102
63360,98193,21880,47309,16095,76311,25353,12250,13103
63365,98197,21883,47310,16097,76314,25354,12250,13104
63370,98207,21883,47315,16097,76324,25356,12251,13105
63375,98213,21883,47318,16097,76329,25359,12252,13107
63380,98224,21884,47325,16097,76340,25361,12254,13107
63385,98228,21885,47325,16097,76343,25362,12254,13108
63390,98238,21885,47329,16097,76353,25364,12255,13109
63395,98244,21885,47330,16097,76359,25367,12256,13111
63400,98255,21886,47335,16097,76369,25369,12257,13112
63405,98259,21887,47337,16097,76372,25370,12257,13113
63410,98269,21887,47341,16097,76382,25372,12258,13114
63415,98275,21887,47343,16097,76388,25375,12260,13115
63420,98286,21888,47348,16098,76398,25377,12261,13116
63425,98290,21889,47349,16098,76401,25378,12262,13116
63430,98300,21889,47357,16098,76411,25380,12264,13116
63435,98306,21889,47361,16098,76417,25383,12266,13117
63440,98317,21890,47365,16099,76427,25385,12266,13119
63445,98321,21891,47365,16099,76430,25386,12266,13120
63450,98331,21891,47369,16099,76440,25388,12266,13122
63455,98337,21891,47372,16099,76446,25391,12268,13123
63460,98348,21892,47378,16099,76455,25393,12269,13124
63465,98352,21893,47380,16100,76459,25394,12269,13125
63470,98362,21894,47386,16101,76468,25396,12270,13126
63475,98368,21894,47389,16101,76473,25399,12271,13128
63480,98379,21897,47394,16104,76480,25401,12272,13129
63485,98383,21901,47398,16108,76482,25402,12273,13129
63490,98393,21903,47403,16110,76490,25403,12274,13129
63495,98399,21903,47408,16110,76495,25406,12276,13130
63500,98410,21905,47415,16112,76503,25408,12276,13132
63505,98414,21907,47417,16114,76507,25409,12276,13133
63510,98424,21908,47422,16114,76516,25410,12277,13133
63515,98430,21908,47422,16114,76522,25413,12277,13136
63520,98441,21909,47427,16115,76532,25415,12278,13137
63525,98445,21910,47430,16115,76535,25416,12279,13137
63530,98455,21911,47435,16115,76544,25417,12280,13137
63535,98461,21911,47438,16115,76549,25420,12281,13139
63540,98472,21913,47445,16116,76557,25422,12282,13140
63545,98476,21915,47447,16117,76561,25423,12283,13140
63550,98486,21916,47451,16117,76570,25424,12284,13140
63555,98492,21916,47453,16117,76576,25427,12285,13142
63560,98503,21917,47458,16118,76585,25429,12285,13144
63565,98507,21918,47461,16118,76589,25430,12286,13144
63570,98517,21919,47468,16119,76598,25431,12287,13144
63575,98523,21919,47470,16119,76603,25434,12288,13146
63580,98534,21921,47476,16120,76612,25436,12289,13147
63585,98538,21923,47477,16121,76615,25437,12290,13147
63590,98548,21924,47481,16121,76624,25439,12290,13149
63595,98554,21924,47484,16121,76628,25442,12291,13151
63600,98565,21928,47491,16125,76635,25444,12292,13152
63605,98569,21932,47493,16128,76637,25445,12293,13152
63610,98579,21934,47499,16130,76645,25447,12294,13153
63615,98585,21934,47502,16130,76649,25450,12295,13155
63620,98596,21937,47505,16132,76658,25452,12295,13157
63625,98600,21939,47505,16133,76661,25453,12295,13158
63630,98610,21942,47510,16135,76668,25455,12296,13159
63635,98616,21942,47512,16135,76674,25458,12298,13160
63640,98627,21944,47518,16137,76683,25460,12299,13161
63645,98631,21946,47519,16138,76685,25461,12299,13162
63650,98641,21948,47522,16140,76693,25463,12300,13163
63655,98647,21948,47525,16140,76698,25466,12302,13164
63660,98658,21949,47529,16140,76709,25468,12304,13164
63665,98662,21950,47531,16141,76712,25469,12304,13165
63670,98672,21950,47538,16141,76722,25471,12306,13165
63675,98678,21950,47540,16141,76728,25474,12308,13166
63680,98689,21951,47545,16141,76737,25476,12308,13168
63685,98693,21952,47547,16141,76741,25477,12308,13169
63690,98703,21952,47553,16141,76751,25479,12309,13170
63695,98709,21952,47557,16141,76757,25482,12311,13171
63700,98720,21953,47564,16142,76766,25484,12312,13172
63705,98724,21954,47565,16142,76770,25485,12313,13172
63710,98734,21954,47571,16142,76780,25487,12315,13172
63715,98740,21954,47573,16142,76786,25490,12316,13174
63720,98751,21955,47580,16142,76796,25492,12318,13174
63725,98755,21956,47581,16142,76799,25493,12318,13175
63730,98765,21956,47586,16142,76809,25494,12318,13176
63735,98771,21956,47587,16142,76815,25497,12319,13178
63740,98782,21957,47593,16143,76824,25499,12320,13179
63745,98786,21958,47594,16143,76828,25500,12320,13180
63750,98796,21958,47595,16143,76838,25501,12320,13181
63755,98802,21958,47599,16143,76844,25504,12323,13181
63760,98813,21960,47603,16144,76853,25506,12324,13182
63765,98817,21962,47605,16146,76855,25507,12324,13183
63770,98827,21965,47608,16148,76862,25508,12325,13183
63775,98833,21965,47611,16148,76866,25511,12326,13185
63780,98844,21968,47613,16150,76876,25513,12327,13186
63785,98848,21970,47615,16151,76878,25514,12328,13186
63790,98858,21972,47620,16153,76886,25515,12329,13186
63795,98864,21972,47625,16153,76890,25518,12331,13187
63800,98875,21975,47630,16156,76899,25520,12332,13188
63805,98879,21978,47633,16159,76901,25521,12332,13189
63810,98889,21980,47636,16160,76909,25522,12332,13190
63815,98895,21980,47639,16160,76914,25525,12333,13192
63820,98906,21983,47645,16162,76921,25527,12335,13192
63825,98910,21987,47647,16165,76923,25528,12335,13193
63830,98920,21989,47653,16166,76931,25530,12337,13193
63835,98926,21989,47655,16166,76937,25533,12339,13194
63840,98937,21990,47659,16167,76946,25535,12340,13195
63845,98941,21992,47662,16169,76949,25536,12340,13196
63850,98951,21992,47667,16169,76959,25538,12340,13198
63855,98957,21992,47669,16169,76965,25541,12341,13200
63860,98968,21993,47674,16169,76974,25543,12342,13201
63865,98972,21994,47674,16169,76978,25544,12342,13202
63870,98982,21994,47679,16169,76988,25546,12344,13202
63875,98988,21994,47683,16169,76993,25549,12346,13203
63880,98999,21995,47686,16169,77003,25551,12346,13205
63885,99003,21996,47687,16169,77007,25552,12346,13206
63890,99013,21996,47692,16169,77017,25554,12348,13206
63895,99019,21996,47692,16169,77023,25557,12348,13209
63900,99030,21997,47700,16170,77032,25559,12349,13210
63905,99034,21998,47703,16171,77036,25560,12349,13211
63910,99044,21998,47709,16171,77046,25562,12350,13212
63915,99050,21998,47711,16171,77052,25565,12350,13215
63920,99061,21999,47717,16171,77062,25567,12350,13217
63925,99065,22000,47719,16171,77065,25568,12351,13217
63930,99075,22000,47722,16171,77075,25570,12351,13219
63935,99081,22000,47724,16171,77081,25573,12353,13220
63940,99092,22001,47729,16171,77091,25575,12355,13220
63945,99096,22002,47730,16172,77094,25576,12355,13221
63950,99106,22003,47732,16172,77103,25578,12355,13223
63955,99112,22003,47733,16172,77109,25581,12356,13225
63960,99123,22004,47740,16173,77118,25583,12357,13226
63965,99127,22005,47741,16173,77122,25584,12358,13226
63970,99137,22006,47746,16173,77131,25585,12358,13227
63975,99143,22006,47749,16173,77137,25588,12360,13228
63980,99154,22007,47755,16173,77147,25590,12362,13228
63985,99158,22008,47758,16174,77150,25591,12362,13229
63990,99168,22009,47767,16174,77159,25592,12363,13229
63995,99174,22009,47769,16174,77165,25595,12363,13232
64000,99185,22010,47773,16174,77175,25597,12364,13233
64005,99189,22011,47774,16174,77178,25598,12364,13234
64010,99199,22013,47781,16176,77186,25599,12364,13235
64015,99205,22013,47785,16176,77191,25602,12366,13236
64020,99216,22016,47788,16178,77200,25604,12366,13238
64025,99220,22018,47791,16180,77202,25605,12366,13239
64030,99230,22021,47797,16182,77209,25606,12367,13239
64035,99236,22021,47802,16182,77214,25609,12370,13239
64040,99247,22023,47809,16184,77224,25611,12371,13240
64045,99251,22024,47810,16185,77227,25612,12371,13241
64050,99261,22026,47816,16187,77235,25613,12371,13242
64055,99267,22026,47819,16187,77240,25616,12373,13243
64060,99278,22029,47822,16189,77249,25618,12373,13245
64065,99282,22031,47824,16190,77251,25619,12373,13246
64070,99292,22034,47829,16193,77258,25621,12375,13246
64075,99298,22034,47833,16193,77262,25624,12377,13247
64080,99309,22038,47840,16197,77270,25626,12377,13249
64085,99313,22041,47843,16200,77272,25627,12377,13250
64090,99323,22043,47849,16201,77280,25629,12379,13250
64095,99329,22043,47854,16201,77284,25632,12382,13250
64100,99340,22047,47862,16204,77293,25634,12384,13250
64105,99344,22048,47863,16204,77296,25635,12384,13251
64110,99354,22049,47867,16205,77305,25637,12385,13252
64115,99360,22049,47870,16205,77311,25640,12387,13253
64120,99371,22050,47875,16205,77320,25642,12388,13254
64125,99375,22052,47876,16207,77323,25643,12388,13255
64130,99385,22054,47879,16208,77331,25645,12389,13256
64135,99391,22054,47883,16208,77336,25648,12392,13256
64140,99402,22056,47888,16209,77345,25650,12393,13257
64145,99406,22059,47890,16212,77347,25651,12393,13258
64150,99416,22059,47894,16212,77357,25653,12393,13260
64155,99422,22059,47896,16212,77363,25656,12394,13262
64160,99433,22060,47902,16212,77372,25658,12396,13262
64165,99437,22061,47904,16213,77376,25659,12397,13262
64170,99447,22061,47910,16213,77386,25661,12399,13262
64175,99453,22061,47912,16213,77392,25664,12401,13263
64180,99464,22062,47918,16213,77401,25666,12403,13263
64185,99468,22063,47921,16214,77405,25667,12403,13264
64190,99478,22063,47925,16214,77415,25669,12403,13266
64195,99484,22063,47929,16214,77420,25672,12406,13266
64200,99495,22064,47933,16215,77431,25674,12407,13267
64205,99499,22065,47934,16215,77434,25675,12407,13268
64210,99509,22065,47939,16215,77444,25676,12407,13269
64215,99515,22065,47943,16215,77450,25679,12408,13271
64220,99526,22066,47947,16215,77459,25681,12409,13272
64225,99530,22067,47948,16215,77463,25682,12410,13272
64230,99540,22067,47953,16215,77473,25683,12411,13272
64235,99546,22067,47956,16215,77479,25686,12413,13273
64240,99557,22068,47960,16215,77489,25688,12415,13273
64245,99561,22069,47962,16215,77492,25689,12415,13274
64250,99571,22069,47965,16215,77502,25690,12416,13274
64255,99577,22069,47969,16215,77508,25693,12418,13275
64260,99588,22070,47973,16215,77518,25695,12419,13276
64265,99592,22071,47976,16215,77521,25696,12420,13276
64270,99602,22072,47979,16215,77530,25697,12421,13276
64275,99608,22072,47981,16215,77535,25700,12422,13278
64280,99619,22074,47985,16216,77545,25702,12423,13279
64285,99623,22075,47986,16216,77548,25703,12423,13280
64290,99633,22076,47993,16216,77557,25704,12423,13281
64295,99639,22076,47995,16216,77563,25707,12424,13283
64300,99650,22077,48001,16216,77572,25709,12426,13283
64305,99654,22079,48002,16218,77575,25710,12426,13284
64310,99664,22080,48006,16218,77584,25712,12427,13285
64315,99670,22080,48010,16218,77589,25715,12429,13286
64320,99681,22082,48017,16220,77597,25717,12430,13287
64325,99685,22086,48019,16223,77599,25718,12430,13288
64330,99695,22087,48025,16224,77608,25720,12432,13288
64335,99701,22087,48026,16224,77613,25723,12432,13291
64340,99712,22090,48034,16227,77620,25725,12432,13293
64345,99716,22093,48037,16230,77623,25726,12433,13293
64350,99726,22096,48041,16233,77630,25728,12433,13295
64355,99732,22096,48044,16233,77635,25731,12434,13297
64360,99743,22099,48049,16235,77643,25733,12435,13298
64365,99747,22101,48050,16236,77646,25734,12435,13299
64370,99757,22102,48053,16236,77655,25736,12435,13301
64375,99763,22102,48057,16236,77660,25739,12438,13301
64380,99774,22105,48065,16238,77667,25741,12439,13302
64385,99778,22108,48068,16241,77670,25742,12440,13302
64390,99788,22110,48073,16243,77678,25744,12441,13303
64395,99794,22110,48074,16243,77684,25747,12442,13305
64400,99805,22111,48078,16244,77693,25749,12442,13307
64405,99809,22114,48081,16247,77695,25750,12443,13307
64410,99819,22116,48086,16249,77703,25752,12443,13309
64415,99825,22116,48089,16249,77707,25755,12443,13312
64420,99836,22120,48095,16252,77716,25757,12445,13312
64425,99840,22121,48097,16253,77719,25758,12445,13313
64430,99850,22121,48103,16253,77729,25760,12446,13314
64435,99856,22121,48105,16253,77735,25763,12448,13315
64440,99867,22122,48112,16254,77744,25765,12449,13316
64445,99871,22123,48114,16254,77748,25766,12450,13316
64450,99881,22123,48120,16254,77758,25768,12451,13317
64455,99887,22123,48122,16254,77764,25771,12453,13318
64460,99898,22124,48125,16254,77773,25773,12453,13320
64465,99902,22125,48127,16254,77777,25774,12453,13321
64470,99912,22125,48129,16254,77787,25776,12453,13323
64475,99918,22125,48130,16254,77793,25779,12454,13325
64480,99929,22126,48133,16255,77803,25781,12454,13327
64485,99933,22127,48133,16255,77806,25782,12454,13328
64490,99943,22127,48136,16255,77816,25784,12455,13329
64495,99949,22127,48137,16255,77822,25787,12456,13331
64500,99960,22128,48143,16256,77831,25789,12456,13333
64505,99964,22129,48146,16257,77835,25790,12457,13333
64510,99974,22129,48150,16257,77845,25791,12458,13333
64515,99980,22129,48152,16257,77850,25794,12458,13336
64520,99991,22130,48157,16257,77861,25796,12459,13337
64525,99995,22132,48160,16258,77863,25797,12460,13337
64530,100005,22134,48165,16259,77871,25798,12460,13338
64535,100011,22134,48167,16259,77876,25801,12461,13340
64540,100022,22137,48171,16261,77884,25803,12461,13342
64545,100026,22140,48173,16263,77886,25804,12461,13343
64550,100036,22142,48180,16265,77894,25805,12462,13343
64555,100042,22142,48183,16265,77899,25808,12464,13344
64560,100053,22144,48186,16266,77909,25810,12466,13344
64565,100057,22145,48186,16266,77912,25811,12466,13345
64570,100067,22147,48192,16267,77920,25812,12466,13346
64575,100073,22147,48193,16267,77926,25815,12467,13348
64580,100084,22149,48198,16269,77934,25817,12468,13349
64585,100088,22152,48200,16271,77936,25818,12469,13349
64590,100098,22154,48204,16272,77944,25819,12470,13349
64595,100104,22154,48208,16272,77949,25822,12472,13350
64600,100115,22157,48216,16275,77956,25824,12474,13350
64605,100119,22160,48218,16277,77959,25825,12475,13350
64610,100129,22162,48224,16278,77967,25827,12477,13350
64615,100135,22162,48228,16278,77972,25830,12479,13351
64620,100146,22164,48235,16279,77981,25832,12480,13352
64625,100150,22166,48237,16280,77984,25833,12480,13353
64630,100160,22166,48241,16280,77994,25835,12481,13354
64635,100166,22166,48244,16280,77999,25838,12482,13356
64640,100177,22167,48249,16280,78010,25840,12483,13357
64645,100181,22168,48252,16281,78013,25841,12483,13358
64650,100191,22168,48259,16281,78023,25843,12484,13359
64655,100197,22168,48263,16281,78028,25846,12486,13360
64660,100208,22169,48267,16282,78039,25848,12486,13362
64665,100212,22170,48268,16282,78042,25849,12486,13363
64670,100222,22170,48272,16282,78052,25851,12487,13364
64675,100228,22170,48274,16282,78058,25854,12488,13366
64680,100239,22171,48278,16282,78067,25856,12488,13368
64685,100243,22172,48278,16282,78071,25857,12488,13369
64690,100253,22172,48283,16282,78081,25859,12488,13371
64695,100259,22172,48286,16282,78087,25862,12489,13373
64700,100270,22173,48290,16282,78096,25864,12490,13374
64705,100274,22174,48291,16282,78100,25865,12491,13374
64710,100284,22174,48296,16282,78110,25867,12493,13374
64715,100290,22174,48299,16282,78116,25870,12495,13375
64720,100301,22175,48305,16283,78126,25872,12497,13375
64725,100305,22176,48309,16284,78129,25873,12498,13375
64730,100315,22177,48312,16285,78138,25874,12498,13376
64735,100321,22177,48316,16285,78143,25877,12499,13378
64740,100332,22179,48321,16286,78152,25879,12501,13378
64745,100336,22181,48323,16288,78155,25880,12501,13379
64750,100346,22182,48328,16289,78164,25881,12502,13379
64755,100352,22182,48329,16289,78170,25884,12503,13381
64760,100363,22183,48332,16290,78179,25886,12504,13382
64765,100367,22185,48333,16291,78182,25887,12504,13383
64770,100377,22186,48338,16292,78191,25888,12505,13383
64775,100383,22186,48339,16292,78197,25891,12506,13385
64780,100394,22187,48344,16293,78206,25893,12506,13387
64785,100398,22188,48345,16294,78210,25894,12506,13388
64790,100408,22189,48351,16294,78219,25895,12507,13388
64795,100414,22189,48355,16294,78224,25898,12509,13389
64800,100425,22192,48362,16297,78233,25900,12511,13389
64805,100429,22194,48364,16298,78235,25901,12512,13389
64810,100439,22196,48370,16300,78243,25902,12512,13390
64815,100445,22196,48374,16300,78248,25905,12514,13391
64820,100456,22199,48380,16303,78256,25907,12516,13391
64825,100460,22202,48381,16305,78258,25908,12516,13392
64830,100470,22203,48388,16306,78267,25909,12517,13392
64835,100476,22203,48389,16306,78272,25912,12517,13395
64840,100487,22205,48396,16308,78280,25914,12517,13397
64845,100491,22208,48398,16311,78283,25915,12517,13398
64850,100501,22209,48399,16311,78292,25917,12518,13399
64855,100507,22209,48404,16311,78297,25920,12521,13399
64860,100518,22211,48407,16312,78305,25922,12521,13401
64865,100522,22214,48410,16314,78308,25923,12522,13401
64870,100532,22216,48415,16315,78316,25925,12522,13403
64875,100538,22216,48418,16315,78321,25928,12524,13404
64880,100549,22219,48425,16317,78329,25930,12526,13404
64885,100553,22221,48428,16318,78332,25931,12527,13404
64890,100563,22223,48435,16320,78340,25933,12529,13404
64895,100569,22223,48438,16320,78344,25936,12530,13406
64900,100580,22227,48444,16324,78351,25938,12530,13408
64905,100584,22229,48446,16326,78355,25939,12531,13408
64910,100594,22229,48451,16326,78365,25941,12532,13409
64915,100600,22229,48454,16326,78371,25944,12535,13409
64920,100611,22230,48458,16327,78380,25946,12535,13411
64925,100615,22231,48459,16327,78384,25947,12535,13412
64930,100625,22231,48462,16327,78394,25949,12537,13412
64935,100631,22231,48465,16327,78400,25952,12540,13412
64940,100642,22232,48468,16328,78409,25954,12541,13413
64945,100646,22233,48469,16329,78413,25955,12541,13414
64950,100656,22233,48475,16329,78423,25957,12542,13415
64955,100662,22233,48478,16329,78428,25960,12543,13417
64960,100673,22234,48485,16330,78438,25962,12543,13419
64965,100677,22235,48487,16330,78442,25963,12544,13419
64970,100687,22235,48493,16330,78452,25965,12546,13419
64975,100693,22235,48495,16330,78458,25968,12546,13422
64980,100704,22236,48499,16331,78467,25970,12546,13424
64985,100708,22237,48500,16332,78471,25971,12546,13425
64990,100718,22237,48504,16332,78481,25973,12548,13425
64995,100724,22237,48506,16332,78487,25976,12549,13427
65000,100735,22238,48509,16332,78496,25978,12550,13428
65005,100739,22239,48511,16332,78500,25979,12551,13428
65010,100749,22242,48518,16334,78507,25981,12551,13430
65015,100755,22242,48519,16334,78513,25984,12552,13432
65020,100766,22243,48523,16334,78522,25986,12553,13433
65025,100770,22246,48524,16336,78524,25987,12553,13434
65030,100780,22249,48530,16338,78531,25989,12554,13435
65035,100786,22249,48531,16338,78537,25992,12555,13437
65040,100797,22250,48535,16338,78546,25994,12555,13439
65045,100801,22252,48537,16340,78549,25995,12556,13439
65050,100811,22253,48542,16341,78558,25996,12557,13439
65055,100817,22253,48544,16341,78563,25999,12558,13441
65060,100828,22255,48547,16342,78572,26001,12559,13442
65065,100832,22256,48548,16342,78576,26002,12559,13443
65070,100842,22258,48552,16343,78584,26003,12559,13444
65075,100848,22258,48555,16343,78589,26006,12560,13446
65080,100859,22260,48559,16344,78597,26008,12561,13447
65085,100863,22263,48562,16347,78600,26009,12562,13447
65090,100873,22265,48566,16348,78608,26010,12563,13447
65095,100879,22265,48567,16348,78614,26013,12564,13449
65100,100890,22267,48571,16349,78622,26015,12565,13450
65105,100894,22268,48573,16350,78626,26016,12566,13450
65110,100904,22270,48575,16351,78634,26017,12566,13451
65115,100910,22270,48578,16351,78640,26020,12568,13452
65120,100921,22272,48586,16352,78647,26022,12570,13452
65125,100925,22275,48588,16355,78650,26023,12570,13453
65130,100935,22277,48593,16356,78658,26024,12570,13454
65135,100941,22277,48596,16356,78664,26027,12572,13455
65140,100952,22279,48603,16357,78672,26029,12574,13455
65145,100956,22281,48606,16359,78675,26030,12575,13455
65150,100966,22283,48610,16361,78683,26032,12576,13456
65155,100972,22283,48613,16361,78688,26035,12577,13458
65160,100983,22286,48617,16363,78695,26037,12578,13459
65165,100987,22288,48619,16364,78699,26038,12579,13459
65170,100997,22288,48624,16364,78709,26040,12580,13460
65175,101003,22288,48627,16364,78714,26043,12581,13462
65180,101014,22289,48633,16365,78724,26045,12582,13463
65185,101018,22290,48636,16366,78728,26046,12583,13463
65190,101028,22290,48640,16366,78738,26048,12584,13464
65195,101034,22290,48645,16366,78743,26051,12586,13465
65200,101045,22291,48649,16367,78753,26053,12587,13466
65205,101049,22292,48652,16367,78757,26054,12588,13466
65210,101059,22292,48656,16367,78767,26056,12588,13468
65215,101065,22292,48657,16367,78773,26059,12588,13471
65220,101076,22293,48665,16368,78782,26061,12588,13473
65225,101080,22294,48665,16368,78786,26062,12588,13474
65230,101090,22294,48670,16368,78796,26064,12589,13475
65235,101096,22294,48671,16368,78802,26067,12590,13477
65240,101107,22295,48675,16368,78811,26069,12591,13478
65245,101111,22296,48677,16368,78815,26070,12592,13478
65250,101121,22296,48682,16368,78825,26072,12593,13479
65255,101127,22296,48683,16368,78831,26075,12594,13481
65260,101138,22297,48687,16368,78840,26077,12594,13483
65265,101142,22298,48690,16368,78844,26078,12595,13483
65270,101152,22299,48694,16368,78853,26080,12595,13485
65275,101158,22299,48695,16368,78859,26083,12596,13487
65280,101169,22300,48699,16368,78868,26085,12597,13488
65285,101173,22301,48700,16368,78872,26086,12597,13489
65290,101183,22302,48704,16368,78881,26087,12598,13489
65295,101189,22302,48708,16368,78886,26090,12600,13490
65300,101200,22304,48714,16369,78895,26092,12601,13491
65305,101204,22307,48716,16371,78897,26093,12601,13492
65310,101214,22309,48722,16372,78905,26094,12601,13493
65315,101220,22309,48726,16372,78910,26097,12603,13494
65320,101231,22312,48733,16375,78917,26099,12604,13495
65325,101235,22315,48735,16377,78920,26100,12605,13495
65330,101245,22317,48742,16379,78928,26101,12606,13495
65335,101251,22317,48746,16379,78933,26104,12608,13496
65340,101262,22319,48750,16381,78941,26106,12608,13498
65345,101266,22322,48753,16384,78944,26107,12608,13499
65350,101276,22323,48756,16385,78953,26108,12609,13499
65355,101282,22323,48759,16385,78958,26111,12611,13500
65360,101293,22325,48764,16387,78966,26113,12612,13501
65365,101297,22329,48766,16391,78968,26114,12612,13502
65370,101307,22331,48773,16393,78976,26115,12613,13502
65375,101313,22331,48776,16393,78980,26118,12613,13505
65380,101324,22335,48782,16397,78988,26120,12614,13506
65385,101328,22337,48785,16399,78991,26121,12614,13507
65390,101338,22339,48789,16401,78999,26123,12614,13509
65395,101344,22339,48793,16401,79004,26126,12616,13510
65400,101355,22340,48797,16401,79014,26128,12616,13512
65405,101359,22341,48799,16402,79018,26129,12616,13513
65410,101369,22341,48805,16402,79028,26131,12616,13515
65415,101375,22341,48808,16402,79034,26134,12618,13516
65420,101386,22342,48810,16402,79043,26136,12618,13518
65425,101390,22343,48811,16402,79047,26137,12618,13519
65430,101400,22343,48817,16402,79057,26139,12619,13520
65435,101406,22343,48818,16402,79062,26142,12619,13523
65440,101417,22344,48825,16402,79072,26144,12620,13524
65445,101421,22345,48827,16403,79076,26145,12620,13525
65450,101431,22345,48831,16403,79086,26147,12620,13527
65455,101437,22345,48833,16403,79092,26150,12621,13529
65460,101448,22346,48840,16404,79101,26152,12622,13530
65465,101452,22347,48842,16404,79105,26153,12622,13531
65470,101462,22347,48846,16404,79115,26155,12623,13532
65475,101468,22347,48848,16404,79120,26158,12624,13534
65480,101479,22348,48853,16404,79130,26160,12625,13535
65485,101483,22349,48854,16405,79134,26161,12625,13536
65490,101493,22349,48860,16405,79144,26163,12626,13537
65495,101499,22349,48865,16405,79149,26166,12629,13537
65500,101510,22351,48870,16407,79157,26168,12629,13539
65505,101514,22355,48872,16410,79159,26169,12630,13539
65510,101524,22357,48876,16412,79167,26171,12630,13541
65515,101530,22357,48881,16412,79171,26174,12632,13542
65520,101541,22360,48888,16415,79180,26176,12634,13542
65525,101545,22361,48889,16416,79184,26177,12634,13543
65530,101555,22362,48893,16416,79193,26178,12634,13544
65535,101561,22362,48896,16416,79199,26181,12636,13545
65540,101572,22363,48906,16417,79207,26183,12638,13545
65545,101576,22365,48909,16419,79211,26184,12638,13546
65550,101586,22366,48914,16420,79220,26185,12639,13546
65555,101592,22366,48915,16420,79226,26188,12640,13548
65560,101603,22367,48919,16420,79235,26190,12641,13549
65565,101607,22368,48920,16420,79239,26191,12641,13550
65570,101617,22369,48922,16420,79248,26192,12641,13551
65575,101623,22369,48925,16420,79253,26195,12642,13553
65580,101634,22371,48931,16421,79261,26197,12644,13553
65585,101638,22373,48931,16422,79265,26198,12644,13554
65590,101648,22374,48935,16422,79274,26199,12644,13555
65595,101654,22374,48939,16422,79280,26202,12646,13556
65600,101665,22375,48946,16422,79289,26204,12647,13557
65605,101669,22377,48948,16423,79292,26205,12648,13557
65610,101679,22378,48952,16424,79301,26206,12648,13558
65615,101685,22378,48954,16424,79307,26209,12649,13560
65620,101696,22379,48958,16425,79317,26211,12650,13561
65625,101700,22381,48961,16426,79319,26212,12651,13561
65630,101710,22383,48965,16427,79327,26214,12652,13562
65635,101716,22383,48970,16427,79331,26217,12654,13563
65640,101727,22386,48976,16429,79340,26219,12656,13563
65645,101731,22388,48978,16431,79343,26220,12656,13564
65650,101741,22391,48984,16434,79350,26222,12657,13565
65655,101747,22391,48987,16434,79356,26225,12659,13566
65660,101758,22393,48994,16436,79364,26227,12660,13567
65665,101762,22394,48994,16436,79368,26228,12660,13568
65670,101772,22395,48996,16437,79377,26230,12660,13570
65675,101778,22395,49000,16437,79383,26233,12663,13570
65680,101789,22396,49007,16437,79392,26235,12665,13570
65685,101793,22398,49009,16438,79395,26236,12665,13571
65690,101803,22399,49016,16439,79404,26238,12666,13572
65695,101809,22399,49020,16439,79410,26241,12669,13572
65700,101820,22400,49026,16440,79420,26243,12671,13572
65705,101824,22402,49028,16441,79422,26244,12671,13573
65710,101834,22403,49033,16442,79431,26246,12673,13573
65715,101840,22403,49034,16442,79437,26249,12674,13575
65720,101851,22404,49040,16443,79447,26251,12676,13575
65725,101855,22405,49043,16444,79450,26252,12677,13575
65730,101865,22406,49051,16444,79459,26254,12679,13575
65735,101871,22406,49054,16444,79465,26257,12680,13577
65740,101882,22407,49061,16445,79474,26259,12681,13578
65745,101886,22408,49061,16445,79478,26260,12681,13579
65750,101896,22409,49066,16446,79487,26261,12681,13580
65755,101902,22409,49069,16446,79491,26264,12681,13583
65760,101913,22412,49074,16448,79500,26266,12681,13585
65765,101917,22414,49076,16449,79503,26267,12682,13585
65770,101927,22417,49082,16452,79510,26268,12682,13586
65775,101933,22417,49084,16452,79515,26271,12682,13589
65780,101944,22419,49091,16453,79524,26273,12684,13589
65785,101948,22421,49093,16454,79527,26274,12685,13589
65790,101958,22423,49096,16455,79535,26275,12685,13590
65795,101964,22423,49099,16455,79541,26278,12687,13591
65800,101975,22424,49105,16455,79550,26280,12689,13591
65805,101979,22427,49108,16457,79552,26281,12690,13591
65810,101989,22429,49114,16459,79560,26282,12690,13592
65815,101995,22429,49117,16459,79565,26285,12692,13593
65820,102006,22432,49126,16462,79573,26287,12694,13593
65825,102010,22434,49128,16464,79576,26288,12694,13594
65830,102020,22435,49136,16465,79585,26289,12695,13594
65835,102026,22435,49138,16465,79590,26292,12696,13596
65840,102037,22437,49145,16467,79598,26294,12698,13596
65845,102041,22441,49148,16470,79600,26295,12699,13596
65850,102051,22442,49149,16470,79609,26296,12699,13597
65855,102057,22442,49150,16470,79615,26299,12699,13600
65860,102068,22443,49153,16470,79624,26301,12700,13601
65865,102072,22445,49154,16471,79627,26302,12701,13601
65870,102082,22446,49161,16472,79636,26304,12703,13601
65875,102088,22446,49162,16472,79642,26307,12703,13604
65880,102099,22447,49165,16473,79652,26309,12703,13606
65885,102103,22448,49165,16473,79655,26310,12703,13607
65890,102113,22449,49167,16473,79664,26312,12704,13608
65895,102119,22449,49169,16473,79670,26315,12705,13610
65900,102130,22451,49173,16474,79679,26317,12706,13611
65905,102134,22453,49175,16476,79681,26318,12706,13612
65910,102144,22456,49183,16478,79688,26320,12708,13612
65915,102150,22456,49185,16478,79692,26323,12708,13615
65920,102161,22458,49189,16480,79703,26325,12708,13617
65925,102165,22459,49191,16480,79706,26326,12709,13617
65930,102175,22459,49195,16480,79716,26328,12710,13618
65935,102181,22459,49197,16480,79721,26331,12710,13621
65940,102192,22460,49203,16481,79732,26333,12711,13622
65945,102196,22461,49204,16481,79735,26334,12711,13623
65950,102206,22461,49212,16481,79745,26336,12712,13624
65955,102212,22461,49213,16481,79751,26339,12712,13627
65960,102223,22462,49219,16482,79761,26341,12713,13628
65965,102227,22463,49221,16483,79764,26342,12713,13629
65970,102237,22463,49224,16483,79774,26344,12714,13630
65975,102243,22463,49225,16483,79780,26347,12715,13632
65980,102254,22464,49231,16483,79790,26349,12716,13633
65985,102258,22465,49232,16483,79793,26350,12716,13634
65990,102268,22465,49236,16483,79803,26352,12717,13635
65995,102274,22465,49237,16483,79809,26355,12718,13637
66000,102285,22466,49239,16484,79819,26357,12718,13639
66005,102289,22467,49241,16485,79822,26358,12719,13639
66010,102299,22467,49245,16485,79832,26359,12719,13640
66015,102305,22467,49247,16485,79837,26362,12719,13643
66020,102316,22468,49251,16485,79847,26364,12720,13644
66025,102320,22470,49251,16486,79850,26365,12720,13645
66030,102330,22472,49258,16487,79858,26366,12720,13646
66035,102336,22472,49260,16487,79864,26369,12722,13647
66040,102347,22474,49267,16488,79873,26371,12724,13647
66045,102351,22475,49269,16489,79876,26372,12724,13648
66050,102361,22477,49274,16491,79884,26373,12724,13649
66055,102367,22477,49277,16491,79889,26376,12725,13651
66060,102378,22480,49282,16494,79896,26378,12725,13653
66065,102382,22484,49284,16497,79898,26379,12725,13654
66070,102392,22485,49288,16497,79907,26380,12725,13655
66075,102398,22485,49291,16497,79913,26383,12728,13655
66080,102409,22487,49294,16498,79921,26385,12728,13657
66085,102413,22490,49297,16500,79923,26386,12729,13657
66090,102423,22492,49304,16502,79931,26387,12729,13658
66095,102429,22492,49309,16502,79935,26390,12731,13659
66100,102440,22496,49314,16505,79943,26392,12732,13660
66105,102444,22499,49315,16507,79945,26393,12732,13661
66110,102454,22501,49322,16509,79953,26395,12734,13661
66115,102460,22501,49325,16509,79957,26398,12735,13663
66120,102471,22505,49331,16512,79965,26400,12736,13664
66125,102475,22506,49333,16512,79969,26401,12737,13664
66130,102485,22506,49336,16512,79979,26403,12738,13665
66135,102491,22506,49339,16512,79985,26406,12740,13666
66140,102502,22507,49347,16513,79994,26408,12741,13667
66145,102506,22508,49347,16513,79998,26409,12741,13668
66150,102516,22508,49350,16513,80008,26411,12741,13670
66155,102522,22508,49351,16513,80014,26414,12742,13672
66160,102533,22509,49359,16514,80024,26416,12744,13672
66165,102537,22510,49362,16515,80027,26417,12745,13672
66170,102547,22510,49368,16515,80037,26419,12746,13673
66175,102553,22510,49370,16515,80043,26422,12748,13674
66180,102564,22511,49374,16516,80053,26424,12748,13676
66185,102568,22512,49376,16516,80056,26425,12749,13676
66190,102578,22512,49383,16516,80066,26427,12751,13676
66195,102584,22512,49384,16516,80072,26430,12752,13678
66200,102595,22513,49390,16517,80082,26432,12754,13678
66205,102599,22514,49391,16518,80085,26433,12754,13679
66210,102609,22514,49398,16518,80095,26435,12754,13681
66215,102615,22514,49400,16518,80101,26438,12754,13684
66220,102626,22515,49402,16518,80110,26440,12755,13685
66225,102630,22516,49402,16518,80114,26441,12755,13686
66230,102640,22519,49408,16521,80121,26443,12757,13686
66235,102646,22519,49410,16521,80127,26446,12759,13687
66240,102657,22520,49417,16522,80136,26448,12759,13689
66245,102661,22521,49420,16522,80140,26449,12760,13689
66250,102671,22522,49423,16523,80149,26450,12760,13690
66255,102677,22522,49429,16523,80154,26453,12763,13690
66260,102688,22523,49436,16524,80163,26455,12765,13690
66265,102692,22524,49438,16525,80168,26456,12765,13691
66270,102702,22525,49442,16526,80177,26457,12765,13692
66275,102708,22525,49444,16526,80183,26460,12767,13693
66280,102719,22525,49448,16526,80192,26462,12767,13695
66285,102723,22526,49450,16527,80197,26463,12768,13695
66290,102733,22527,49456,16528,80206,26464,12768,13696
66295,102739,22527,49457,16528,80212,26467,12769,13698
66300,102750,22527,49463,16528,80223,26469,12770,13699
66305,102754,22527,49465,16528,80227,26470,12770,13700
66310,102764,22528,49470,16528,80236,26471,12771,13700
66315,102770,22528,49473,16528,80242,26474,12772,13702
66320,102781,22528,49481,16528,80251,26476,12773,13703
66325,102785,22529,49484,16529,80256,26477,12774,13703
66330,102795,22530,49491,16530,80265,26478,12774,13704
66335,102801,22530,49492,16530,80271,26481,12775,13706
66340,102812,22530,49498,16530,80282,26483,12776,13707
66345,102816,22530,49499,16530,80286,26484,12776,13708
66350,102826,22532,49507,16532,80294,26486,12778,13708
66355,102832,22532,49508,16532,80300,26489,12779,13710
66360,102843,22532,49514,16532,80310,26491,12781,13710
66365,102847,22534,49517,16534,80313,26492,12782,13710
66370,102857,22536,49522,16536,80321,26494,12783,13711
66375,102863,22536,49528,16536,80325,26497,12786,13711
66380,102874,22539,49535,16539,80334,26499,12788,13711
66385,102878,22541,49538,16541,80337,26500,12788,13712
66390,102888,22544,49543,16543,80344,26502,12789,13713
66395,102894,22544,49546,16543,80348,26505,12790,13715
66400,102905,22547,49550,16546,80356,26507,12791,13716
66405,102909,22549,49551,16548,80360,26508,12791,13717
66410,102919,22552,49557,16551,80367,26510,12791,13719
66415,102925,22552,49560,16551,80372,26513,12793,13720
66420,102936,22553,49565,16552,80381,26515,12794,13721
66425,102940,22555,49567,16554,80385,26516,12795,13721
66430,102950,22557,49573,16556,80393,26518,12796,13722
66435,102956,22557,49574,16556,80399,26521,12796,13725
66440,102967,22557,49580,16556,80409,26523,12797,13726
66445,102971,22557,49583,16556,80414,26524,12798,13726
66450,102981,22557,49585,16556,80424,26526,12798,13728
66455,102987,22557,49589,16556,80429,26529,12799,13730
66460,102998,22557,49593,16556,80441,26531,12801,13730
66465,103002,22557,49593,16556,80445,26532,12801,13731
66470,103012,22557,49596,16556,80455,26534,12802,13732
66475,103018,22557,49600,16556,80460,26537,12803,13734
66480,103029,22557,49604,16556,80472,26539,12805,13734
66485,103033,22557,49604,16556,80476,26540,12805,13735
66490,103043,22557,49608,16556,80486,26541,12805,13736
66495,103049,22557,49614,16556,80491,26544,12808,13736
66500,103060,22557,49619,16556,80503,26546,12808,13738
66505,103064,22557,49622,16556,80507,26547,12808,13739
66510,103074,22557,49626,16556,80517,26548,12809,13739
66515,103080,22557,49630,16556,80523,26551,12811,13740
66520,103091,22557,49635,16556,80534,26553,12812,13741
66525,103095,22557,49637,16556,80538,26554,12812,13742
66530,103105,22557,49641,16556,80548,26555,12812,13743
66535,103111,22557,49645,16556,80553,26558,12814,13744
66540,103122,22559,49649,16558,80562,26560,12815,13745
66545,103126,22560,49650,16559,80566,26561,12815,13746
66550,103136,22562,49656,16561,80574,26562,12816,13746
66555,103142,22562,49659,16561,80579,26565,12817,13748
66560,103153,22564,49665,16563,80589,26567,12818,13749
66565,103157,22564,49667,16563,80593,26568,12818,13750
66570,103167,22565,49670,16564,80602,26569,12818,13751
66575,103173,22565,49674,16564,80606,26572,12820,13752
66580,103184,22568,49680,16567,80614,26574,12821,13753
66585,103188,22570,49681,16569,80618,26575,12821,13754
66590,103198,22572,49686,16570,80626,26577,12821,13756
66595,103204,22572,49689,16570,80632,26580,12822,13758
66600,103215,22572,49693,16570,80643,26582,12822,13760
66605,103219,22572,49694,16570,80647,26583,12823,13760
66610,103229,22573,49697,16571,80656,26585,12823,13762
66615,103235,22573,49702,16571,80661,26588,12825,13763
66620,103246,22574,49708,16572,80671,26590,12827,13763
66625,103250,22575,49711,16573,80675,26591,12828,13763
66630,103260,22576,49716,16573,80684,26593,12829,13764
66635,103266,22576,49720,16573,80689,26596,12830,13766
66640,103277,22577,49725,16574,80698,26598,12830,13768
66645,103281,22578,49727,16575,80703,26599,12830,13769
66650,103291,22579,49731,16575,80712,26601,12831,13770
66655,103297,22579,49734,16575,80718,26604,12832,13772
66660,103308,22579,49742,16575,80727,26606,12834,13772
66665,103312,22580,49744,16576,80732,26607,12834,13773
66670,103322,22581,49749,16577,80741,26609,12835,13774
66675,103328,22581,49753,16577,80746,26612,12837,13775
66680,103339,22582,49757,16578,80757,26614,12838,13776
66685,103343,22582,49759,16578,80761,26615,12838,13777
66690,103353,22583,49765,16579,80770,26617,12839,13778
66695,103359,22583,49767,16579,80775,26620,12839,13781
66700,103370,22585,49775,16581,80785,26622,12841,13781
66705,103374,22585,49777,16581,80789,26623,12842,13781
66710,103384,22588,49783,16584,80796,26625,12842,13783
66715,103390,22588,49785,16584,80801,26628,12843,13785
66720,103401,22590,49790,16586,80810,26630,12843,13787
66725,103405,22591,49791,16587,80814,26631,12844,13787
66730,103415,22594,49794,16589,80821,26633,12844,13789
66735,103421,22594,49797,16589,80826,26636,12845,13791
66740,103432,22595,49803,16590,80836,26638,12846,13792
66745,103436,22596,49805,16591,80840,26639,12846,13793
66750,103446,22598,49806,16592,80848,26641,12846,13795
66755,103452,22598,49809,16592,80854,26644,12847,13797
66760,103463,22598,49818,16592,80864,26646,12849,13797
66765,103467,22598,49821,16592,80869,26647,12850,13797
66770,103477,22598,49825,16592,80879,26649,12852,13797
66775,103483,22598,49828,16592,80884,26652,12854,13798
66780,103494,22598,49831,16592,80896,26654,12854,13800
66785,103498,22598,49834,16592,80900,26655,12855,13800
66790,103508,22598,49839,16592,80910,26656,12855,13801
66795,103514,22598,49841,16592,80916,26659,12857,13802
66800,103525,22598,49847,16592,80926,26661,12859,13802
66805,103529,22598,49850,16592,80931,26662,12860,13802
66810,103539,22598,49854,16592,80941,26663,12860,13803
66815,103545,22598,49855,16592,80947,26666,12861,13805
66820,103556,22598,49861,16592,80957,26668,12862,13806
66825,103560,22598,49862,16592,80962,26669,12862,13807
66830,103570,22598,49868,16592,80972,26670,12862,13808
66835,103576,22598,49871,16592,80977,26673,12863,13810
66840,103587,22598,49876,16592,80989,26675,12863,13812
66845,103591,22598,49879,16592,80993,26676,12864,13812
66850,103601,22598,49886,16592,81003,26677,12865,13812
66855,103607,22598,49889,16592,81008,26680,12867,13813
66860,103618,22600,49894,16594,81018,26682,12867,13815
66865,103622,22601,49896,16595,81021,26683,12868,13815
66870,103632,22603,49900,16597,81029,26684,12869,13815
66875,103638,22603,49903,16597,81034,26687,12870,13817
66880,103649,22605,49906,16599,81043,26689,12870,13819
66885,103653,22606,49908,16600,81047,26690,12870,13820
66890,103663,22608,49916,16602,81055,26691,12871,13820
66895,103669,22608,49917,16602,81061,26694,12872,13822
66900,103680,22608,49922,16602,81072,26696,12873,13823
66905,103684,22608,49923,16602,81076,26697,12873,13824
66910,103694,22609,49927,16603,81085,26699,12875,13824
66915,103700,22609,49929,16603,81091,26702,12877,13825
66920,103711,22610,49934,16604,81100,26704,12877,13827
66925,103715,22612,49936,16606,81103,26705,12878,13827
66930,103725,22614,49939,16607,81111,26707,12878,13829
66935,103731,22614,49943,16607,81116,26710,12880,13830
66940,103742,22616,49948,16609,81126,26712,12882,13830
66945,103746,22616,49950,16609,81130,26713,12882,13831
66950,103756,22619,49955,16611,81137,26715,12883,13832
66955,103762,22619,49957,16611,81142,26718,12884,13834
66960,103773,22621,49964,16613,81152,26720,12885,13835
66965,103777,22621,49966,16613,81156,26721,12886,13835
66970,103787,22622,49969,16613,81165,26723,12887,13836
66975,103793,22622,49974,16613,81170,26726,12889,13837
66980,103804,22623,49978,16614,81181,26728,12890,13838
66985,103808,22623,49980,16614,81185,26729,12891,13838
66990,103818,22624,49983,16615,81194,26731,12891,13840
66995,103824,22624,49986,16615,81200,26734,12893,13841
67000,103835,22624,49993,16615,81211,26736,12895,13841
67005,103839,22624,49995,16615,81215,26737,12896,13841
67010,103849,22625,50000,16616,81224,26739,12897,13842
67015,103855,22625,50004,16616,81229,26742,12899,13843
67020,103866,22626,50009,16617,81239,26744,12900,13844
67025,103870,22627,50009,16618,81243,26745,12900,13845
67030,103880,22628,50015,16619,81252,26746,12900,13846
67035,103886,22628,50018,16619,81257,26749,12902,13847
67040,103897,22629,50022,16620,81267,26751,12903,13848
67045,103901,22630,50024,16621,81271,26752,12903,13849
67050,103911,22631,50026,16621,81280,26753,12903,13850
67055,103917,22631,50028,16621,81285,26756,12903,13853
67060,103928,22632,50031,16622,81296,26758,12903,13855
67065,103932,22632,50033,16622,81300,26759,12904,13855
67070,103942,22634,50038,16623,81308,26760,12904,13856
67075,103948,22634,50044,16623,81312,26763,12907,13856
67080,103959,22637,50053,16626,81321,26765,12909,13856
67085,103963,22638,50055,16627,81325,26766,12910,13856
67090,103973,22639,50060,16628,81334,26767,12911,13856
67095,103979,22639,50060,16628,81340,26770,12911,13859
67100,103990,22640,50066,16629,81348,26772,12911,13861
67105,103994,22642,50067,16631,81352,26773,12911,13862
67110,104004,22644,50074,16632,81360,26774,12912,13862
67115,104010,22644,50077,16632,81366,26777,12913,13864
67120,104021,22644,50085,16632,81376,26779,12915,13864
67125,104025,22644,50087,16632,81381,26780,12915,13865
67130,104035,22644,50093,16632,81391,26782,12916,13866
67135,104041,22644,50096,16632,81397,26785,12917,13868
67140,104052,22644,50102,16632,81407,26787,12919,13868
67145,104056,22644,50103,16632,81412,26788,12919,13869
67150,104066,22644,50106,16632,81422,26790,12920,13870
67155,104072,22644,50108,16632,81428,26793,12921,13872
67160,104083,22644,50114,16632,81438,26795,12921,13874
67165,104087,22644,50116,16632,81443,26796,12921,13875
67170,104097,22644,50120,16632,81453,26798,12921,13877
67175,104103,22644,50124,16632,81459,26801,12923,13878
67180,104114,22644,50129,16632,81469,26803,12923,13880
67185,104118,22644,50131,16632,81474,26804,12923,13881
67190,104128,22644,50136,16632,81484,26806,12924,13882
67195,104134,22644,50137,16632,81490,26809,12925,13884
67200,104145,22644,50140,16632,81500,26811,12926,13885
67205,104149,22644,50142,16632,81505,26812,12926,13886
67210,104159,22644,50147,16632,81515,26814,12926,13888
67215,104165,22644,50151,16632,81519,26817,12927,13890
67220,104176,22647,50158,16635,81528,26819,12929,13890
67225,104180,22649,50161,16637,81531,26820,12930,13890
67230,104190,22650,50166,16637,81540,26822,12931,13891
67235,104196,22650,50167,16637,81546,26825,12932,13893
67240,104207,22651,50173,16638,81554,26827,12933,13894
67245,104211,22652,50174,16639,81559,26828,12934,13894
67250,104221,22654,50178,16640,81567,26830,12934,13896
67255,104227,22654,50180,16640,81573,26833,12936,13897
67260,104238,22654,50183,16640,81583,26835,12937,13898
67265,104242,22654,50185,16640,81588,26836,12937,13899
67270,104252,22656,50188,16641,81596,26838,12938,13900
67275,104258,22656,50191,16641,81601,26840,12939,13901
67280,104269,22658,50194,16643,81609,26842,12939,13903
67285,104273,22660,50196,16645,81613,26843,12940,13903
67290,104283,22662,50200,16646,81621,26845,12941,13904
67295,104289,22662,50204,16646,81625,26847,12942,13905
67300,104300,22664,50210,16648,81634,26849,12944,13905
67305,104304,22665,50211,16649,81639,26850,12944,13906
67310,104314,22666,50217,16649,81648,26852,12945,13907
67315,104320,22666,50218,16649,81654,26854,12945,13909
67320,104331,22666,50224,16649,81663,26856,12947,13909
67325,104335,22667,50227,16650,81668,26857,12947,13910
67330,104345,22668,50232,16651,81677,26858,12948,13910
67335,104351,22668,50234,16651,81682,26860,12948,13912
67340,104362,22669,50240,16652,81691,26862,12949,13913
67345,104366,22670,50242,16653,81696,26863,12950,13913
67350,104376,22671,50248,16653,81705,26864,12951,13913
67355,104382,22671,50251,16653,81710,26866,12952,13914
67360,104393,22672,50256,16654,81720,26868,12953,13915
67365,104397,22672,50258,16654,81725,26869,12954,13915
67370,104407,22673,50263,16655,81734,26870,12955,13915
67375,104413,22673,50266,16655,81740,26873,12957,13916
67380,104424,22673,50268,16655,81750,26875,12957,13918
67385,104428,22673,50270,16655,81755,26876,12958,13918
67390,104438,22674,50272,16655,81764,26877,12958,13919
67395,104444,22674,50274,16655,81769,26880,12959,13921
67400,104455,22675,50277,16656,81779,26882,12960,13922
67405,104459,22675,50279,16656,81784,26883,12960,13923
67410,104469,22677,50281,16657,81792,26884,12960,13924
67415,104475,22677,50283,16657,81798,26887,12961,13926
67420,104486,22677,50291,16657,81807,26889,12963,13926
67425,104490,22680,50292,16660,81810,26890,12963,13927
67430,104500,22682,50297,16662,81818,26892,12963,13929
67435,104506,22682,50301,16662,81823,26895,12965,13930
67440,104517,22683,50305,16663,81833,26897,12966,13931
67445,104521,22684,50308,16664,81837,26898,12967,13931
67450,104531,22687,50315,16667,81844,26900,12967,13933
67455,104537,22687,50318,16667,81850,26903,12969,13934
67460,104548,22688,50325,16668,81858,26905,12969,13936
67465,104552,22690,50326,16670,81862,26906,12969,13937
67470,104562,22690,50332,16670,81872,26908,12970,13938
67475,104568,22690,50336,16670,81877,26911,12973,13938
67480,104579,22690,50338,16670,81888,26913,12973,13940
67485,104583,22690,50341,16670,81893,26914,12974,13940
67490,104593,22690,50346,16670,81903,26916,12975,13941
67495,104599,22690,50347,16670,81909,26919,12976,13943
67500,104610,22690,50352,16670,81919,26921,12977,13944
67505,104614,22690,50353,16670,81924,26922,12978,13944
67510,104624,22690,50357,16670,81934,26924,12980,13944
67515,104630,22690,50359,16670,81940,26927,12982,13945
67520,104641,22690,50362,16670,81950,26929,12983,13946
67525,104645,22690,50365,16670,81955,26930,12983,13947
67530,104655,22690,50370,16670,81965,26932,12984,13948
67535,104661,22690,50374,16670,81970,26935,12985,13950
67540,104672,22690,50379,16670,81981,26937,12986,13951
67545,104676,22690,50382,16670,81986,26938,12986,13952
67550,104686,22690,50386,16670,81996,26939,12987,13952
67555,104692,22690,50390,16670,82001,26942,12989,13953
67560,104703,22690,50395,16670,82012,26944,12989,13955
67565,104707,22690,50398,16670,82017,26945,12990,13955
67570,104717,22691,50404,16671,82026,26946,12991,13955
67575,104723,22691,50406,16671,82032,26949,12992,13957
67580,104734,22691,50412,16671,82041,26951,12994,13957
67585,104738,22694,50415,16674,82044,26952,12995,13957
67590,104748,22696,50420,16676,82052,26953,12995,13958
67595,104754,22696,50424,16676,82056,26956,12996,13960
67600,104765,22698,50426,16678,82066,26958,12996,13962
67605,104769,22699,50428,16679,82070,26959,12997,13962
67610,104779,22701,50434,16681,82078,26960,12998,13962
67615,104785,22701,50437,16681,82083,26963,13000,13963
67620,104796,22703,50444,16683,82091,26965,13001,13964
67625,104800,22705,50446,16685,82095,26966,13002,13964
67630,104810,22706,50449,16686,82104,26967,13002,13965
67635,104816,22706,50451,16686,82108,26970,13002,13968
67640,104827,22708,50454,16688,82118,26972,13003,13969
67645,104831,22710,50456,16690,82121,26973,13003,13970
67650,104841,22711,50463,16691,82130,26974,13004,13970
67655,104847,22711,50467,16691,82134,26977,13006,13971
67660,104858,22714,50471,16694,82143,26979,13007,13972
67665,104862,22714,50473,16694,82148,26980,13008,13972
67670,104872,22715,50477,16694,82157,26982,13008,13974
67675,104878,22715,50480,16694,82162,26985,13010,13975
67680,104889,22717,50485,16696,82170,26987,13012,13975
67685,104893,22718,50486,16697,82175,26988,13012,13976
67690,104903,22718,50491,16697,82185,26990,13014,13976
67695,104909,22718,50493,16697,82191,26993,13015,13978
67700,104920,22718,50497,16697,82201,26995,13015,13980
67705,104924,22718,50498,16697,82206,26996,13015,13981
67710,104934,22718,50500,16697,82216,26998,13015,13983
67715,104940,22718,50502,16697,82222,27001,13016,13985
67720,104951,22718,50506,16697,82232,27003,13017,13986
67725,104955,22718,50508,16697,82237,27004,13018,13986
67730,104965,22718,50511,16697,82247,27006,13018,13988
67735,104971,22718,50514,16697,82253,27009,13020,13989
67740,104982,22718,50517,16697,82263,27011,13021,13990
67745,104986,22718,50520,16697,82268,27012,13022,13990
67750,104996,22718,50525,16697,82278,27014,13023,13991
67755,105002,22718,50528,16697,82284,27017,13025,13992
67760,105013,22718,50534,16697,82294,27019,13027,13992
67765,105017,22718,50536,16697,82299,27020,13027,13993
67770,105027,22718,50541,16697,82309,27022,13027,13995
67775,105033,22718,50542,16697,82315,27025,13028,13997
67780,105044,22718,50547,16697,82325,27027,13029,13998
67785,105048,22718,50549,16697,82330,27028,13030,13998
67790,105058,22719,50554,16698,82339,27030,13032,13998
67795,105064,22719,50556,16698,82345,27033,13033,14000
67800,105075,22720,50558,16699,82354,27035,13033,14002
67805,105079,22721,50562,16700,82358,27036,13034,14002
67810,105089,22722,50566,16701,82367,27038,13035,14003
67815,105095,22722,50570,16701,82373,27041,13038,14003
67820,105106,22722,50574,16701,82383,27043,13038,14005
67825,105110,22723,50578,16702,82387,27044,13039,14005
67830,105120,22724,50582,16702,82396,27045,13039,14006
67835,105126,22724,50584,16702,82402,27048,13040,14008
67840,105137,22724,50588,16702,82411,27050,13040,14010
67845,105141,22726,50591,16704,82415,27051,13041,14010
67850,105151,22729,50598,16706,82422,27052,13042,14010
67855,105157,22729,50600,16706,82427,27055,13043,14012
67860,105168,22730,50602,16707,82436,27057,13043,14014
67865,105172,22731,50602,16708,82441,27058,13043,14015
67870,105182,22733,50607,16710,82449,27059,13043,14016
67875,105188,22733,50610,16710,82455,27062,13045,14017
67880,105199,22734,50613,16711,82464,27064,13046,14018
67885,105203,22735,50614,16712,82468,27065,13046,14019
67890,105213,22737,50620,16714,82476,27066,13046,14020
67895,105219,22737,50621,16714,82481,27069,13046,14023
67900,105230,22739,50625,16716,82490,27071,13046,14025
67905,105234,22740,50627,16717,82494,27072,13047,14025
67910,105244,22742,50632,16719,82502,27073,13048,14025
67915,105250,22742,50637,16719,82507,27076,13051,14025
67920,105261,22743,50644,16720,82517,27078,13053,14025
67925,105265,22744,50645,16721,82521,27079,13053,14026
67930,105275,22746,50652,16722,82529,27081,13055,14026
67935,105281,22746,50654,16722,82535,27084,13057,14027
67940,105292,22746,50658,16722,82545,27086,13058,14028
67945,105296,22747,50659,16723,82549,27087,13058,14029
67950,105306,22749,50662,16725,82557,27089,13059,14030
67955,105312,22749,50663,16725,82562,27092,13059,14033
67960,105323,22750,50668,16726,82572,27094,13060,14034
67965,105327,22752,50670,16728,82575,27095,13061,14034
67970,105337,22753,50673,16728,82584,27097,13061,14036
67975,105343,22753,50677,16728,82589,27100,13063,14037
67980,105354,22754,50681,16729,82599,27102,13064,14038
67985,105358,22754,50683,16729,82604,27103,13065,14038
67990,105368,22754,50690,16729,82614,27104,13066,14038
67995,105374,22754,50694,16729,82620,27107,13067,14040
68000,105385,22754,50699,16729,82631,27109,13068,14041
68005,105389,22754,50700,16729,82635,27110,13069,14041
68010,105399,22754,50709,16729,82645,27111,13069,14042
68015,105405,22754,50713,16729,82651,27113,13070,14043
68020,105416,22754,50718,16729,82661,27115,13072,14043
68025,105420,22754,50721,16729,82666,27116,13073,14043
68030,105430,22754,50726,16729,82676,27117,13073,14044
68035,105436,22754,50730,16729,82682,27119,13075,14044
68040,105447,22754,50737,16729,82692,27121,13077,14044
68045,105451,22754,50740,16729,82697,27122,13077,14045
68050,105461,22754,50746,16729,82707,27123,13077,14046
68055,105467,22754,50749,16729,82713,27125,13079,14046
68060,105478,22754,50755,16729,82723,27127,13079,14048
68065,105482,22754,50759,16729,82728,27128,13080,14048
68070,105492,22754,50763,16729,82738,27129,13080,14049
68075,105498,22754,50765,16729,82744,27131,13081,14050
68080,105509,22754,50772,16729,82754,27133,13082,14051
68085,105513,22754,50773,16729,82759,27134,13083,14051
68090,105523,22755,50779,16729,82768,27135,13084,14051
68095,105529,22755,50782,16729,82773,27137,13085,14052
68100,105540,22757,50790,16731,82781,27139,13087,14052
68105,105544,22759,50790,16733,82785,27140,13087,14053
68110,105554,22761,50792,16734,82793,27141,13087,14054
68115,105560,22761,50794,16734,82799,27144,13088,14056
68120,105571,22761,50800,16734,82809,27146,13089,14057
68125,105575,22763,50802,16736,82812,27147,13090,14057
68130,105585,22765,50805,16737,82820,27148,13090,14058
68135,105591,22765,50807,16737,82826,27151,13091,14060
68140,105602,22765,50813,16737,82836,27153,13093,14060
68145,105606,22767,50814,16739,82839,27154,13093,14061
68150,105616,22769,50819,16740,82847,27155,13093,14062
68155,105622,22769,50823,16740,82852,27158,13095,14063
68160,105633,22770,50826,16741,82862,27160,13095,14065
68165,105637,22772,50828,16743,82865,27161,13096,14065
68170,105647,22774,50832,16744,82873,27162,13097,14065
68175,105653,22774,50837,16744,82877,27165,13099,14066
68180,105664,22777,50844,16747,82886,27167,13100,14067
68185,105668,22779,50848,16749,82889,27168,13101,14067
68190,105678,22781,50855,16751,82897,27169,13102,14067
68195,105684,22781,50857,16751,82903,27172,13104,14068
68200,105695,22781,50862,16751,82914,27174,13106,14068
68205,105699,22781,50863,16751,82918,27175,13106,14069
68210,105709,22781,50866,16751,82928,27176,13106,14070
68215,105715,22781,50870,16751,82934,27179,13109,14070
68220,105726,22781,50878,16751,82944,27181,13111,14070
68225,105730,22781,50880,16751,82949,27182,13112,14070
68230,105740,22781,50884,16751,82959,27183,13112,14071
68235,105746,22781,50887,16751,82964,27186,13113,14073
68240,105757,22781,50891,16751,82976,27188,13114,14074
68245,105761,22781,50893,16751,82980,27189,13114,14075
68250,105771,22781,50897,16751,82990,27190,13114,14076
68255,105777,22781,50899,16751,82996,27193,13115,14078
68260,105788,22781,50904,16751,83006,27195,13116,14079
68265,105792,22781,50906,16751,83011,27196,13117,14079
68270,105802,22781,50912,16751,83021,27197,13118,14079
68275,105808,22781,50915,16751,83026,27200,13119,14081
68280,105819,22781,50923,16751,83037,27202,13120,14082
68285,105823,22781,50926,16751,83042,27203,13121,14082
68290,105833,22781,50930,16751,83052,27204,13121,14083
68295,105839,22781,50933,16751,83058,27207,13123,14084
68300,105850,22782,50938,16752,83066,27209,13124,14085
68305,105854,22784,50939,16754,83070,27210,13125,14085
68310,105864,22786,50944,16755,83078,27211,13126,14085
68315,105870,22786,50945,16755,83084,27214,13127,14087
68320,105881,22786,50950,16755,83095,27216,13129,14087
68325,105885,22787,50954,16756,83098,27217,13130,14087
68330,105895,22788,50957,16757,83107,27218,13131,14087
68335,105901,22788,50960,16757,83112,27221,13132,14089
68340,105912,22789,50966,16758,83123,27223,13134,14089
68345,105916,22790,50969,16759,83126,27224,13135,14089
68350,105926,22792,50972,16760,83134,27225,13135,14090
68355,105932,22792,50977,16760,83139,27228,13138,14090
68360,105943,22794,50983,16762,83148,27230,13140,14090
68365,105947,22796,50986,16764,83151,27231,13140,14091
68370,105957,22797,50991,16764,83160,27232,13141,14091
68375,105963,22797,50995,16764,83165,27235,13143,14092
68380,105974,22798,51001,16765,83175,27237,13144,14093
68385,105978,22800,51002,16767,83178,27238,13144,14094
68390,105988,22801,51006,16767,83187,27239,13145,14094
68395,105994,22801,51010,16767,83192,27242,13147,14095
68400,106005,22803,51015,16769,83201,27244,13149,14095
68405,106009,22804,51016,16770,83205,27245,13149,14096
68410,106019,22806,51020,16772,83213,27246,13149,14097
68415,106025,22806,51023,16772,83218,27249,13151,14098
68420,106036,22807,51026,16773,83229,27251,13152,14099
68425,106040,22807,51028,16773,83233,27252,13153,14099
68430,106050,22808,51035,16774,83242,27253,13153,14100
68435,106056,22808,51037,16774,83247,27255,13154,14101
68440,106067,22810,51042,16776,83257,27257,13154,14103
68445,106071,22810,51044,16776,83261,27258,13155,14103
68450,106081,22813,51047,16778,83268,27259,13155,14104
68455,106087,22813,51049,16778,83273,27261,13156,14105
68460,106098,22814,51057,16779,83283,27263,13157,14106
68465,106102,22815,51059,16780,83287,27264,13158,14106
68470,106112,22815,51068,16780,83297,27265,13159,14106
68475,106118,22815,51071,16780,83303,27267,13161,14106
68480,106129,22815,51076,16780,83314,27269,13162,14107
68485,106133,22815,51077,16780,83318,27270,13162,14108
68490,106143,22815,51082,16780,83328,27271,13163,14108
68495,106149,22815,51086,16780,83334,27273,13164,14109
68500,106160,22815,51090,16780,83345,27275,13166,14109
68505,106164,22815,51090,16780,83349,27276,13166,14110
68510,106174,22815,51095,16780,83359,27277,13167,14110
68515,106180,22815,51097,16780,83365,27279,13167,14112
68520,106191,22815,51104,16780,83375,27281,13168,14113
68525,106195,22815,51105,16780,83380,27282,13168,14114
68530,106205,22815,51110,16780,83390,27283,13168,14115
68535,106211,22815,51113,16780,83396,27285,13169,14116
68540,106222,22815,51116,16780,83407,27287,13170,14117
68545,106226,22815,51120,16780,83411,27288,13171,14117
68550,106236,22815,51125,16780,83421,27289,13172,14117
68555,106242,22815,51128,16780,83427,27291,13173,14118
68560,106253,22815,51134,16780,83438,27293,13175,14118
68565,106257,22815,51136,16780,83442,27294,13175,14119
68570,106267,22816,51141,16781,83451,27295,13175,14120
68575,106273,22816,51147,16781,83455,27297,13177,14120
68580,106284,22819,51152,16784,83464,27299,13178,14121
68585,106288,22820,51154,16785,83468,27300,13179,14121
68590,106298,22822,51159,16787,83476,27301,13179,14122
68595,106304,22822,51164,16787,83480,27303,13180,14123
68600,106315,22824,51169,16789,83490,27305,13181,14124
68605,106319,22825,51170,16790,83494,27306,13182,14124
68610,106329,22826,51175,16791,83503,27307,13182,14125
68615,106335,22826,51177,16791,83509,27309,13183,14126
68620,106346,22826,51178,16791,83520,27311,13183,14128
68625,106350,22827,51181,16792,83523,27312,13184,14128
68630,106360,22828,51186,16793,83532,27313,13184,14129
68635,106366,22828,51188,16793,83538,27315,13185,14130
68640,106377,22829,51193,16794,83548,27317,13185,14132
68645,106381,22829,51193,16794,83552,27318,13185,14133
68650,106391,22830,51198,16795,83561,27320,13186,14134
68655,106397,22830,51201,16795,83566,27323,13188,14135
68660,106408,22831,51207,16796,83577,27325,13190,14135
68665,106412,22831,51208,16796,83581,27326,13190,14136
68670,106422,22832,51211,16796,83590,27328,13191,14137
68675,106428,22832,51215,16796,83595,27331,13193,14138
68680,106439,22833,51220,16797,83605,27333,13194,14139
68685,106443,22833,51220,16797,83610,27335,13195,14140
68690,106453,22834,51223,16798,83619,27336,13196,14140
68695,106459,22834,51225,16798,83625,27339,13197,14142
68700,106470,22835,51229,16799,83634,27341,13198,14143
68705,106474,22835,51229,16799,83639,27343,13199,14144
68710,106484,22836,51236,16800,83648,27345,13201,14144
68715,106490,22836,51238,16800,83653,27348,13201,14147
68720,106501,22838,51240,16802,83662,27350,13201,14149
68725,106505,22840,51242,16804,83665,27351,13202,14149
68730,106515,22841,51245,16804,83674,27353,13202,14151
68735,106521,22841,51249,16804,83679,27356,13204,14152
68740,106532,22843,51256,16806,83687,27358,13205,14153
68745,106536,22845,51258,16808,83691,27360,13207,14153
68750,106546,22846,51263,16808,83700,27362,13207,14155
68755,106552,22846,51264,16808,83706,27365,13207,14158
68760,106563,22846,51269,16808,83715,27367,13208,14159
68765,106567,22847,51270,16809,83720,27368,13208,14160
68770,106577,22848,51274,16810,83729,27369,13209,14160
68775,106583,22848,51279,16810,83734,27371,13210,14161
68780,106594,22850,51284,16812,83744,27373,13210,14163
68785,106598,22851,51287,16813,83747,27374,13211,14163
68790,106608,22852,51292,16813,83756,27375,13212,14163
68795,106614,22852,51293,16813,83762,27377,13212,14165
68800,106625,22853,51297,16814,83770,27379,13212,14167
68805,106629,22854,51299,16815,83775,27380,13212,14168
68810,106639,22855,51305,16816,83784,27381,13213,14168
68815,106645,22855,51309,16816,83789,27383,13213,14170
68820,106656,22857,51314,16818,83798,27385,13213,14172
68825,106660,22858,51316,16819,83802,27386,13213,14173
68830,106670,22859,51318,16819,83811,27387,13213,14174
68835,106676,22859,51321,16819,83816,27389,13214,14175
68840,106687,22861,51328,16821,83826,27391,13215,14176
68845,106691,22861,51330,16821,83830,27392,13215,14177
68850,106701,22861,51335,16821,83840,27393,13216,14177
68855,106707,22861,51338,16821,83846,27395,13217,14178
68860,106718,22861,51342,16821,83857,27397,13217,14180
68865,106722,22861,51345,16821,83861,27398,13217,14181
68870,106732,22861,51350,16821,83871,27399,13218,14181
68875,106738,22861,51353,16821,83877,27401,13218,14183
68880,106749,22861,51356,16821,83888,27403,13218,14185
68885,106753,22861,51357,16821,83892,27404,13218,14186
68890,106763,22861,51360,16821,83902,27405,13219,14186
68895,106769,22861,51362,16821,83908,27407,13220,14187
68900,106780,22861,51364,16821,83919,27409,13222,14187
68905,106784,22861,51366,16821,83923,27410,13222,14188
68910,106794,22861,51372,16821,83933,27411,13223,14188
68915,106800,22861,51375,16821,83939,27413,13225,14188
68920,106811,22861,51381,16821,83950,27415,13226,14189
68925,106815,22861,51382,16821,83954,27416,13227,14189
68930,106825,22861,51386,16821,83964,27417,13228,14189
68935,106831,22861,51388,16821,83970,27419,13228,14191
68940,106842,22861,51396,16821,83980,27421,13230,14191
68945,106846,22863,51398,16823,83983,27422,13230,14192
68950,106856,22864,51402,16824,83992,27423,13230,14193
68955,106862,22864,51405,16824,83998,27425,13231,14194
68960,106873,22864,51412,16824,84008,27427,13232,14195
68965,106877,22865,51413,16825,84012,27428,13232,14196
68970,106887,22866,51417,16826,84021,27429,13232,14197
68975,106893,22866,51419,16826,84027,27431,13233,14198
68980,106904,22866,51423,16826,84038,27433,13233,14200
68985,106908,22866,51425,16826,84042,27434,13233,14201
68990,106918,22867,51433,16827,84051,27435,13234,14201
68995,106924,22867,51438,16827,84056,27437,13236,14201
69000,106935,22869,51444,16829,84066,27439,13238,14201
69005,106939,22870,51446,16830,84069,27440,13238,14202
69010,106949,22871,51450,16831,84078,27441,13238,14203
69015,106955,22871,51454,16831,84083,27443,13240,14203
69020,106966,22873,51459,16833,84092,27445,13240,14205
69025,106970,22875,51463,16835,84095,27446,13241,14205
69030,106980,22876,51468,16835,84104,27447,13242,14205
69035,106986,22876,51469,16835,84110,27449,13243,14206
69040,106997,22876,51473,16835,84120,27451,13245,14206
69045,107001,22877,51475,16836,84124,27452,13246,14206
69050,107011,22878,51482,16837,84133,27453,13246,14207
69055,107017,22878,51484,16837,84139,27455,13247,14208
69060,107028,22879,51490,16838,84149,27457,13248,14209
69065,107032,22879,51493,16838,84153,27458,13249,14209
69070,107042,22880,51498,16839,84162,27459,13250,14209
69075,107048,22880,51500,16839,84167,27461,13251,14210
69080,107059,22882,51506,16841,84176,27463,13252,14211
69085,107063,22884,51509,16843,84179,27464,13253,14211
69090,107073,22885,51515,16844,84188,27465,13253,14212
69095,107079,22885,51518,16844,84194,27467,13253,14214
69100,107090,22886,51525,16845,84203,27469,13254,14215
69105,107094,22887,51528,16846,84207,27470,13255,14215
69110,107104,22888,51531,16846,84216,27471,13255,14216
69115,107110,22888,51535,16846,84222,27473,13257,14216
69120,107121,22888,51540,16846,84232,27475,13257,14218
69125,107125,22889,51541,16847,84236,27476,13258,14218
69130,107135,22890,51548,16848,84245,27477,13258,14219
69135,107141,22890,51550,16848,84250,27479,13258,14221
69140,107152,22891,51555,16849,84261,27481,13259,14222
69145,107156,22891,51557,16849,84265,27482,13260,14222
69150,107166,22892,51561,16850,84274,27483,13260,14223
69155,107172,22892,51566,16850,84279,27485,13262,14223
69160,107183,22894,51574,16852,84289,27487,13264,14223
69165,107187,22895,51576,16853,84292,27488,13265,14223
69170,107197,22896,51580,16853,84301,27489,13266,14223
69175,107203,22896,51585,16853,84306,27491,13268,14223
69180,107214,22897,51589,16854,84317,27493,13269,14224
69185,107218,22897,51591,16854,84321,27494,13269,14225
69190,107228,22898,51596,16855,84330,27495,13269,14226
69195,107234,22898,51598,16855,84336,27497,13269,14228
69200,107245,22899,51604,16856,84346,27499,13270,14229
69205,107249,22899,51605,16856,84350,27500,13270,14230
69210,107259,22900,51612,16857,84359,27501,13271,14230
69215,107265,22900,51615,16857,84365,27503,13273,14230
69220,107276,22900,51620,16857,84375,27505,13274,14231
69225,107280,22901,51621,16858,84379,27506,13274,14232
69230,107290,22902,51626,16858,84388,27507,13274,14233
69235,107296,22902,51628,16858,84393,27509,13274,14235
69240,107307,22904,51633,16860,84402,27511,13275,14236
69245,107311,22906,51634,16862,84405,27512,13275,14237
69250,107321,22907,51636,16862,84414,27513,13275,14238
69255,107327,22907,51640,16862,84419,27515,13276,14239
69260,107338,22908,51646,16863,84429,27517,13276,14241
69265,107342,22910,51647,16865,84432,27518,13276,14242
69270,107352,22911,51652,16866,84441,27519,13277,14242
69275,107358,22911,51655,16866,84446,27521,13278,14243
69280,107369,22913,51662,16868,84455,27523,13279,14244
69285,107373,22915,51665,16870,84458,27524,13280,14244
69290,107383,22916,51669,16870,84467,27525,13281,14244
69295,107389,22916,51674,16870,84472,27527,13283,14244
69300,107400,22918,51682,16872,84482,27529,13285,14244
69305,107404,22918,51684,16872,84486,27530,13286,14244
69310,107414,22918,51691,16872,84496,27531,13287,14244
69315,107420,22918,51692,16872,84502,27533,13287,14246
69320,107431,22918,51697,16872,84513,27535,13289,14246
69325,107435,22918,51700,16872,84517,27536,13290,14246
69330,107445,22918,51704,16872,84527,27537,13290,14247
69335,107451,22918,51707,16872,84533,27539,13291,14248
69340,107462,22918,51711,16872,84544,27541,13291,14250
69345,107466,22918,51711,16872,84548,27542,13291,14251
69350,107476,22918,51716,16872,84558,27543,13291,14252
69355,107482,22918,51719,16872,84564,27545,13292,14253
69360,107493,22918,51721,16872,84575,27547,13293,14254
69365,107497,22918,51723,16872,84579,27548,13294,14254
69370,107507,22918,51726,16872,84589,27549,13294,14255
69375,107513,22918,51727,16872,84595,27551,13294,14257
69380,107524,22918,51732,16872,84606,27553,13296,14257
69385,107528,22918,51734,16872,84610,27554,13296,14258
69390,107538,22918,51738,16872,84620,27555,13296,14259
69395,107544,22918,51742,16872,84626,27557,13297,14260
69400,107555,22918,51748,16872,84637,27559,13297,14262
69405,107559,22919,51749,16873,84640,27560,13297,14263
69410,107569,22920,51754,16874,84649,27561,13298,14263
69415,107575,22920,51758,16874,84655,27563,13300,14263
69420,107586,22921,51767,16875,84665,27565,13302,14263
69425,107590,22921,51769,16875,84669,27566,13302,14264
69430,107600,22922,51774,16876,84678,27566,13302,14264
69435,107606,22922,51777,16876,84684,27568,13303,14265
69440,107617,22923,51782,16877,84694,27570,13304,14266
69445,107621,22924,51783,16878,84697,27571,13304,14267
69450,107631,22925,51786,16879,84706,27571,13304,14267
69455,107637,22925,51791,16879,84712,27573,13306,14267
69460,107648,22925,51797,16879,84723,27575,13307,14268
69465,107652,22926,51799,16880,84726,27576,13307,14269
69470,107662,22927,51802,16880,84735,27576,13307,14269
69475,107668,22927,51805,16880,84741,27578,13307,14271
69480,107679,22928,51812,16881,84751,27580,13309,14271
69485,107683,22928,51814,16881,84755,27581,13310,14271
69490,107693,22929,51817,16881,84764,27581,13310,14271
69495,107699,22929,51819,16881,84770,27583,13310,14273
69500,107710,22930,51824,16882,84780,27585,13311,14274
69505,107714,22930,51824,16882,84784,27586,13311,14275
69510,107724,22931,51831,16883,84793,27586,13311,14275
69515,107730,22931,51834,16883,84799,27588,13312,14276
69520,107741,22931,51840,16883,84810,27589,13313,14276
69525,107745,22932,51843,16884,84813,27590,13314,14276
69530,107755,22933,51847,16885,84822,27591,13314,14277
69535,107761,22933,51848,16885,84828,27593,13314,14279
69540,107772,22933,51852,16885,84839,27594,13314,14280
69545,107776,22933,51853,16885,84843,27595,13314,14281
69550,107786,22934,51859,16885,84852,27596,13315,14281
69555,107792,22934,51862,16885,84858,27598,13316,14282
69560,107803,22935,51866,16886,84868,27599,13316,14283
69565,107807,22935,51868,16886,84872,27600,13317,14283
69570,107817,22936,51873,16886,84881,27601,13317,14284
69575,107823,22936,51877,16886,84887,27603,13319,14284
69580,107834,22936,51883,16886,84898,27604,13320,14284
69585,107838,22936,51884,16886,84902,27605,13320,14285
69590,107848,22937,51888,16886,84911,27606,13320,14286
69595,107854,22937,51889,16886,84917,27608,13320,14288
69600,107865,22938,51895,16887,84927,27609,13320,14289
69605,107869,22938,51895,16887,84931,27610,13320,14290
69610,107879,22939,51900,16888,84940,27611,13320,14291
69615,107885,22939,51902,16888,84946,27613,13321,14292
69620,107896,22939,51908,16888,84957,27614,13321,14293
69625,107900,22940,51910,16889,84960,27615,13322,14293
69630,107910,22941,51915,16889,84969,27616,13323,14293
69635,107916,22941,51919,16889,84975,27618,13324,14294
69640,107927,22941,51923,16889,84986,27619,13325,14294
69645,107931,22942,51924,16890,84989,27620,13325,14295
69650,107941,22943,51930,16891,84998,27621,13326,14295
69655,107947,22943,51933,16891,85004,27623,13328,14295
69660,107958,22944,51939,16892,85014,27624,13328,14296
69665,107962,22945,51941,16893,85017,27625,13328,14297
69670,107972,22946,51944,16894,85026,27625,13328,14297
69675,107978,22946,51948,16894,85032,27627,13330,14297
69680,107989,22947,51955,16895,85042,27628,13331,14297
69685,107993,22947,51956,16895,85046,27629,13331,14298
69690,108003,22948,51960,16895,85055,27629,13331,14298
69695,108009,22948,51964,16895,85061,27631,13331,14300
69700,108020,22948,51968,16895,85072,27632,13331,14301
69705,108024,22948,51969,16895,85076,27633,13332,14301
69710,108034,22949,51972,16895,85085,27633,13332,14301
69715,108040,22949,51976,16895,85091,27635,13333,14302
69720,108051,22949,51979,16895,85102,27636,13333,14303
69725,108055,22950,51980,16896,85105,27637,13333,14304
69730,108065,22951,51984,16897,85114,27637,13333,14304
69735,108071,22951,51987,16897,85120,27639,13334,14305
69740,108082,22951,51992,16897,85131,27640,13334,14306
69745,108086,22951,51993,16897,85135,27641,13335,14306
69750,108096,22952,51995,16897,85144,27641,13335,14306
69755,108102,22952,51997,16897,85150,27643,13336,14307
69760,108113,22952,52003,16897,85161,27644,13337,14307
69765,108117,22952,52004,16897,85165,27645,13337,14308
69770,108127,22953,52010,16897,85174,27646,13338,14308
69775,108133,22953,52012,16897,85180,27648,13339,14309
69780,108144,22954,52020,16898,85190,27649,13340,14309
69785,108148,22954,52021,16898,85194,27650,13341,14309
69790,108158,22955,52023,16898,85203,27651,13342,14309
69795,108164,22955,52026,16898,85209,27653,13343,14310
69800,108175,22956,52034,16899,85219,27654,13343,14311
69805,108179,22956,52035,16899,85223,27655,13344,14311
69810,108189,22957,52039,16900,85232,27656,13344,14312
69815,108195,22957,52042,16900,85238,27658,13344,14314
69820,108206,22957,52049,16900,85249,27659,13345,14314
69825,108210,22958,52052,16901,85252,27660,13345,14315
69830,108220,22959,52059,16901,85261,27661,13346,14315
69835,108226,22959,52064,16901,85267,27663,13348,14315
69840,108237,22960,52071,16902,85277,27664,13348,14316
69845,108241,22960,52073,16902,85281,27665,13349,14316
69850,108251,22961,52077,16903,85290,27666,13349,14317
69855,108257,22961,52081,16903,85296,27668,13350,14318
69860,108268,22962,52088,16904,85306,27669,13351,14318
69865,108272,22963,52090,16905,85309,27670,13352,14318
69870,108282,22964,52095,16906,85318,27671,13352,14319
69875,108288,22964,52098,16906,85324,27673,13354,14319
69880,108299,22964,52101,16906,85335,27674,13354,14320
69885,108303,22964,52103,16906,85339,27675,13355,14320
