Time,  Packets Generated,  Packets Reached,High Priority Packets Generated, High Priority Packets reached, Packet Dropped, Packet Dropped due to Faulty Node, High Prio Packet Dropped due to Faulty Node, Low Prio Packet Dropped due to Faulty Node 
5,1,1,1,1,0,0,0,0
10,6,3,5,2,3,3,3,0
15,8,3,6,2,4,4,4,0
20,16,7,10,3,8,8,6,2
25,20,10,11,5,10,10,6,4
30,30,15,16,7,15,15,9,6
35,36,15,19,7,19,19,11,8
40,47,20,23,10,26,26,13,13
45,51,23,27,12,28,28,15,13
50,61,28,30,14,33,33,16,17
55,67,28,32,14,37,37,18,19
60,78,33,36,15,44,44,21,23
65,82,36,37,15,45,45,22,23
70,92,42,43,18,50,50,25,25
75,98,42,44,18,54,54,26,28
80,109,47,50,21,59,59,28,31
85,113,52,54,24,60,60,29,31
90,123,58,59,27,65,65,32,33
95,129,58,63,27,69,69,35,34
100,140,63,68,30,74,74,37,37
105,144,68,70,32,75,75,38,37
110,154,74,75,35,80,80,40,40
115,160,74,79,35,84,84,44,40
120,171,79,85,37,89,89,46,43
125,175,84,88,40,90,90,47,43
130,185,90,94,44,93,93,50,43
135,191,91,95,44,96,96,50,46
140,202,99,101,47,100,100,52,48
145,206,104,104,50,101,101,53,48
150,216,110,107,53,104,104,53,51
155,222,111,110,53,107,107,54,53
160,233,119,113,56,112,111,55,56
165,237,123,115,59,113,112,56,56
170,247,127,120,61,118,115,58,57
175,253,127,123,61,123,118,59,59
180,264,133,131,66,128,122,62,60
185,268,137,132,69,130,123,63,60
190,278,142,137,72,134,126,64,62
195,284,143,138,73,137,129,64,65
200,295,148,144,77,143,132,66,66
205,299,150,145,78,148,133,66,67
210,309,155,151,82,152,136,68,68
215,315,155,156,82,156,139,70,69
220,326,162,161,88,160,142,71,71
225,330,166,163,91,163,143,72,71
230,340,170,170,94,168,146,75,71
235,346,170,172,94,173,149,76,73
240,357,175,177,97,179,152,78,74
245,361,178,178,99,182,153,79,74
250,371,182,183,101,187,156,80,76
255,377,183,186,102,192,159,83,76
260,388,188,193,106,196,162,84,78
265,392,190,194,107,202,163,84,79
270,402,192,200,109,209,166,87,79
275,408,192,200,109,215,169,87,82
280,419,195,205,111,221,172,88,84
285,423,196,206,111,227,173,89,84
290,433,198,210,113,234,176,90,86
295,439,198,212,113,239,179,91,88
300,450,201,218,115,246,182,92,90
305,454,202,221,116,252,183,93,90
310,464,204,223,117,259,186,94,92
315,470,204,225,117,265,189,95,94
320,481,207,227,118,273,192,95,97
325,485,208,228,119,277,193,95,98
330,495,210,231,120,284,196,97,99
335,501,210,234,120,289,199,98,101
340,512,213,241,122,296,202,101,101
345,516,214,242,122,302,203,102,101
350,526,216,245,123,308,206,102,104
355,532,216,247,123,314,209,102,107
360,543,219,252,124,321,212,103,109
365,547,222,253,127,325,213,103,110
370,557,224,255,128,331,216,103,113
375,563,225,257,129,337,219,104,115
380,574,229,261,132,343,222,104,118
385,578,232,264,135,345,223,105,118
390,588,236,270,139,351,226,107,119
395,594,236,274,139,355,229,109,120
400,605,243,281,146,361,232,111,121
405,609,245,283,148,363,233,111,122
410,619,248,286,150,369,236,112,124
415,625,249,290,151,375,239,114,125
420,636,250,296,152,384,242,116,126
425,640,251,297,153,389,243,116,127
430,650,252,302,154,396,246,117,129
435,656,252,306,154,401,249,118,131
440,667,254,312,156,412,252,120,132
445,671,255,315,157,415,253,121,132
450,681,257,322,159,422,256,121,135
455,687,257,325,159,430,259,122,137
460,698,260,333,162,435,262,123,139
465,702,260,335,162,441,263,124,139
470,712,261,340,163,450,266,125,141
475,718,261,344,163,457,269,128,141
480,729,262,350,164,465,272,129,143
485,733,263,353,165,470,273,130,143
490,743,263,357,165,479,276,132,144
495,749,263,360,165,486,279,134,145
500,760,265,365,167,494,282,135,147
505,764,265,368,167,499,283,136,147
510,774,266,374,168,507,286,138,148
515,780,266,375,168,513,289,138,151
520,791,268,380,170,521,292,140,152
525,795,269,381,171,526,293,140,153
530,805,270,384,172,534,296,140,156
535,811,270,385,172,541,299,141,158
540,822,272,389,173,549,302,142,160
545,826,272,390,173,554,303,143,160
550,836,274,392,174,561,306,144,162
555,842,274,396,174,566,309,146,163
560,853,278,401,177,575,312,148,164
565,857,278,402,177,579,313,149,164
570,867,281,407,180,585,316,150,166
575,873,281,410,180,591,319,151,168
580,884,283,417,182,600,322,153,169
585,888,284,418,183,604,323,153,170
590,898,287,422,185,610,326,154,172
595,904,287,425,185,617,329,156,173
600,915,290,431,187,624,332,158,174
605,919,291,433,188,628,333,158,175
610,929,293,437,190,635,336,158,178
615,935,293,440,190,641,339,160,179
620,946,297,446,194,647,342,161,181
625,950,300,448,197,649,343,161,182
630,960,305,454,202,653,346,161,185
635,966,306,458,203,658,349,164,185
640,977,311,461,207,665,352,164,188
645,981,312,462,208,668,353,164,189
650,991,316,467,212,674,356,166,190
655,997,316,471,212,679,359,168,191
660,1008,321,478,216,684,362,170,192
665,1012,322,479,217,690,363,170,193
670,1022,322,483,217,699,366,172,194
675,1028,322,486,217,705,369,173,196
680,1039,325,492,219,714,372,174,198
685,1043,325,494,219,718,373,174,199
690,1053,326,497,220,726,376,175,201
695,1059,326,501,220,732,379,176,203
700,1070,328,509,222,742,382,179,203
705,1074,328,511,222,746,383,179,204
710,1084,330,515,224,753,386,179,207
715,1090,330,515,224,760,389,179,210
720,1101,331,520,225,770,392,181,211
725,1105,332,523,226,773,393,182,211
730,1115,332,527,226,782,396,183,213
735,1121,332,533,226,788,399,186,213
740,1132,334,539,227,798,402,189,213
745,1136,335,543,228,801,403,190,213
750,1146,337,548,230,808,406,191,215
755,1152,337,551,230,814,409,192,217
760,1163,338,556,230,825,412,195,217
765,1167,339,560,231,828,413,196,217
770,1177,342,565,234,833,416,196,220
775,1183,343,567,235,840,419,198,221
780,1194,345,571,237,848,422,199,223
785,1198,347,573,239,851,423,200,223
790,1208,349,579,241,857,426,202,224
795,1214,349,581,241,864,429,202,227
800,1225,352,585,244,872,432,202,230
805,1229,353,587,245,876,433,202,231
810,1239,355,593,247,883,436,204,232
815,1245,355,594,247,889,439,204,235
820,1256,357,598,248,898,442,206,236
825,1260,358,600,249,902,443,207,236
830,1270,360,607,251,908,446,209,237
835,1276,360,609,251,915,449,210,239
840,1287,363,615,254,922,452,211,241
845,1291,363,616,254,928,453,211,242
850,1301,366,619,256,934,456,211,245
855,1307,366,622,256,940,459,212,247
860,1318,369,627,259,947,462,212,250
865,1322,370,628,260,952,463,213,250
870,1332,372,631,262,959,466,213,253
875,1338,372,634,262,965,469,215,254
880,1349,375,639,264,973,472,216,256
885,1353,375,640,264,978,473,216,257
890,1363,377,648,266,985,476,218,258
895,1369,377,650,266,992,479,219,260
900,1380,380,656,269,999,482,220,262
905,1384,382,659,271,1002,483,221,262
910,1394,383,662,271,1010,486,222,264
915,1400,383,665,271,1017,489,224,265
920,1411,386,671,274,1025,492,226,266
925,1415,387,673,275,1028,493,227,266
930,1425,388,678,276,1036,496,228,268
935,1431,388,682,276,1042,499,230,269
940,1442,392,687,279,1050,502,231,271
945,1446,393,689,280,1053,503,231,272
950,1456,395,693,281,1060,506,233,273
955,1462,395,697,281,1066,509,235,274
960,1473,398,701,283,1075,512,237,275
965,1477,398,701,283,1079,513,237,276
970,1487,401,706,286,1085,516,238,278
975,1493,401,710,286,1090,519,240,279
980,1504,407,717,292,1097,522,240,282
985,1508,409,720,294,1099,523,241,282
990,1518,413,726,298,1104,526,243,283
995,1524,413,727,298,1110,529,243,286
1000,1535,417,732,301,1117,532,245,287
1005,1539,419,735,303,1120,533,246,287
1010,1549,419,740,303,1128,536,246,290
1015,1555,419,743,303,1134,539,248,291
1020,1566,419,747,303,1146,542,250,292
1025,1570,419,750,303,1151,543,251,292
1030,1580,419,752,303,1160,546,252,294
1035,1586,419,754,303,1167,549,253,296
1040,1597,419,760,303,1176,552,254,298
1045,1601,419,763,303,1181,553,254,299
1050,1611,419,766,303,1190,556,255,301
1055,1617,419,769,303,1197,559,256,303
1060,1628,419,774,303,1209,562,258,304
1065,1632,419,777,303,1213,563,259,304
1070,1642,419,781,303,1221,566,261,305
1075,1648,419,785,303,1229,569,264,305
1080,1659,419,792,303,1238,572,266,306
1085,1663,419,794,303,1243,573,266,307
1090,1673,419,799,303,1252,576,268,308
1095,1679,419,803,303,1258,579,270,309
1100,1690,419,809,303,1269,582,271,311
1105,1694,419,809,303,1275,583,271,312
1110,1704,421,813,305,1282,586,271,315
1115,1710,421,816,305,1288,589,272,317
1120,1721,424,822,308,1296,592,273,319
1125,1725,424,824,308,1301,593,274,319
1130,1735,425,829,308,1309,596,277,319
1135,1741,425,832,308,1314,599,278,321
1140,1752,428,838,310,1322,602,280,322
1145,1756,429,839,311,1327,603,280,323
1150,1766,431,843,312,1334,606,281,325
1155,1772,431,844,312,1341,609,282,327
1160,1783,432,846,312,1351,612,283,329
1165,1787,432,847,312,1355,613,283,330
1170,1797,435,853,314,1361,616,284,332
1175,1803,435,856,314,1367,619,285,334
1180,1814,438,860,317,1376,622,287,335
1185,1818,439,864,318,1379,623,288,335
1190,1828,442,870,320,1385,626,289,337
1195,1834,442,874,320,1391,629,291,338
1200,1845,445,876,322,1399,632,291,341
1205,1849,446,879,323,1403,633,292,341
1210,1859,448,886,325,1410,636,295,341
1215,1865,448,888,325,1417,639,295,344
1220,1876,451,895,328,1425,642,297,345
1225,1880,451,895,328,1429,643,297,346
1230,1890,454,900,330,1435,646,299,347
1235,1896,454,902,330,1441,649,299,350
1240,1907,458,911,334,1448,652,302,350
1245,1911,460,914,336,1451,653,303,350
1250,1921,463,920,338,1456,656,305,351
1255,1927,464,925,339,1460,659,308,351
1260,1938,468,929,343,1468,662,309,353
1265,1942,471,932,346,1470,663,310,353
1270,1952,474,937,349,1477,666,312,354
1275,1958,475,940,350,1481,669,313,356
1280,1969,479,946,353,1487,672,315,357
1285,1973,482,947,356,1491,673,315,358
1290,1983,483,951,357,1500,676,316,360
1295,1989,483,953,357,1505,679,317,362
1300,2000,484,956,357,1515,682,318,364
1305,2004,484,958,357,1519,683,318,365
1310,2014,484,960,357,1529,686,318,368
1315,2020,484,963,357,1534,689,320,369
1320,2031,487,972,360,1542,692,323,369
1325,2035,487,972,360,1548,693,323,370
1330,2045,489,980,362,1555,696,326,370
1335,2051,489,983,362,1562,699,328,371
1340,2062,491,989,363,1568,702,329,373
1345,2066,491,991,363,1575,703,330,373
1350,2076,492,994,364,1584,706,330,376
1355,2082,492,998,364,1589,709,331,378
1360,2093,494,1006,366,1599,712,334,378
1365,2097,495,1009,367,1602,713,335,378
1370,2107,496,1014,368,1611,716,336,380
1375,2113,496,1016,368,1617,719,337,382
1380,2124,498,1022,369,1625,722,340,382
1385,2128,499,1024,370,1629,723,340,383
1390,2138,499,1027,370,1638,726,341,385
1395,2144,499,1030,370,1643,729,342,387
1400,2155,503,1034,373,1651,732,343,389
1405,2159,504,1037,374,1655,733,344,389
1410,2169,506,1043,376,1662,736,345,391
1415,2175,506,1047,376,1669,739,347,392
1420,2186,508,1051,378,1678,742,347,395
1425,2190,508,1052,378,1682,743,347,396
1430,2200,512,1060,382,1687,746,348,398
1435,2206,512,1064,382,1693,749,350,399
1440,2217,515,1069,385,1702,752,351,401
1445,2221,517,1072,387,1704,753,351,402
1450,2231,518,1077,387,1712,756,353,403
1455,2237,518,1077,387,1719,759,353,406
1460,2248,519,1086,388,1728,762,356,406
1465,2252,521,1090,390,1731,763,357,406
1470,2262,523,1093,392,1739,766,358,408
1475,2268,523,1096,392,1745,769,360,409
1480,2279,523,1100,392,1756,772,362,410
1485,2283,523,1103,392,1760,773,363,410
1490,2293,524,1107,392,1768,776,365,411
1495,2299,524,1110,392,1774,779,367,412
1500,2310,525,1114,393,1785,782,368,414
1505,2314,526,1115,394,1788,783,368,415
1510,2324,527,1118,394,1797,786,370,416
1515,2330,527,1121,394,1802,789,372,417
1520,2341,529,1128,396,1809,792,373,419
1525,2345,533,1131,400,1812,793,374,419
1530,2355,535,1134,401,1820,796,376,420
1535,2361,535,1137,401,1823,799,376,423
1540,2372,538,1143,404,1832,802,377,425
1545,2376,541,1146,407,1834,803,377,426
1550,2386,546,1153,412,1838,806,378,428
1555,2392,546,1154,412,1845,809,378,431
1560,2403,549,1161,415,1852,812,379,433
1565,2407,550,1163,416,1856,813,379,434
1570,2417,550,1169,416,1865,816,380,436
1575,2423,550,1173,416,1870,819,381,438
1580,2434,552,1179,418,1880,822,383,439
1585,2438,553,1180,419,1885,823,383,440
1590,2448,554,1181,420,1894,826,383,443
1595,2454,554,1184,420,1899,829,384,445
1600,2465,555,1188,420,1910,832,386,446
1605,2469,556,1190,421,1913,833,387,446
1610,2479,556,1192,421,1922,836,387,449
1615,2485,556,1195,421,1929,839,389,450
1620,2496,557,1200,421,1937,842,390,452
1625,2500,558,1203,422,1942,843,391,452
1630,2510,559,1210,423,1950,846,394,452
1635,2516,559,1213,423,1957,849,395,454
1640,2527,561,1216,425,1966,852,395,457
1645,2531,561,1218,425,1970,853,396,457
1650,2541,561,1221,425,1980,856,396,460
1655,2547,561,1224,425,1985,859,398,461
1660,2558,564,1230,427,1993,862,400,462
1665,2562,564,1233,427,1998,863,401,462
1670,2572,565,1239,428,2007,866,403,463
1675,2578,565,1242,428,2012,869,404,465
1680,2589,570,1248,432,2019,872,407,465
1685,2593,570,1249,432,2023,873,407,466
1690,2603,573,1253,434,2030,876,408,468
1695,2609,573,1256,434,2034,879,409,470
1700,2620,577,1263,437,2042,882,412,470
1705,2624,579,1264,439,2045,883,412,471
1710,2634,582,1271,442,2052,886,415,471
1715,2640,582,1273,442,2057,889,416,473
1720,2651,587,1280,446,2063,892,418,474
1725,2655,589,1282,448,2066,893,419,474
1730,2665,590,1284,448,2074,896,420,476
1735,2671,590,1286,448,2079,899,421,478
1740,2682,595,1290,453,2087,902,422,480
1745,2686,597,1293,455,2089,903,423,480
1750,2696,600,1297,457,2096,906,425,481
1755,2702,600,1299,457,2101,909,426,483
1760,2713,605,1303,462,2108,912,426,486
1765,2717,606,1304,463,2111,913,426,487
1770,2727,610,1310,467,2117,916,427,489
1775,2733,610,1313,467,2122,919,428,491
1780,2744,612,1319,469,2132,922,429,493
1785,2748,613,1322,470,2135,923,430,493
1790,2758,614,1325,470,2143,926,431,495
1795,2764,614,1328,470,2149,929,433,496
1800,2775,616,1334,472,2159,932,435,497
1805,2779,616,1337,472,2163,933,436,497
1810,2789,616,1343,472,2173,936,437,499
1815,2795,616,1347,472,2179,939,439,500
1820,2806,616,1352,472,2190,942,441,501
1825,2810,616,1353,472,2194,943,442,501
1830,2820,616,1358,472,2203,946,442,504
1835,2826,616,1361,472,2210,949,443,506
1840,2837,616,1367,472,2221,952,445,507
1845,2841,616,1369,472,2225,953,445,508
1850,2851,616,1376,472,2234,956,448,508
1855,2857,616,1378,472,2240,959,449,510
1860,2868,616,1382,472,2251,962,450,512
1865,2872,616,1384,472,2255,963,450,513
1870,2882,616,1391,472,2265,966,452,514
1875,2888,616,1393,472,2271,969,453,516
1880,2899,618,1399,473,2280,972,455,517
1885,2903,618,1401,473,2285,973,456,517
1890,2913,618,1404,473,2295,976,457,519
1895,2919,618,1407,473,2300,979,459,520
1900,2930,620,1413,475,2308,982,460,522
1905,2934,623,1415,478,2310,983,460,523
1910,2944,625,1416,479,2318,986,460,526
1915,2950,625,1420,479,2322,989,462,527
1920,2961,629,1424,483,2330,992,463,529
1925,2965,633,1427,487,2331,993,463,530
1930,2975,638,1434,492,2336,996,465,531
1935,2981,638,1437,492,2340,999,466,533
1940,2992,643,1443,496,2347,1002,469,533
1945,2996,645,1445,498,2350,1003,469,534
1950,3006,648,1450,500,2357,1006,470,536
1955,3012,648,1454,500,2363,1009,472,537
1960,3023,650,1458,501,2371,1012,473,539
1965,3027,651,1458,502,2376,1013,473,540
1970,3037,653,1461,503,2384,1016,474,542
1975,3043,653,1462,503,2389,1019,474,545
1980,3054,655,1466,505,2398,1022,476,546
1985,3058,656,1468,506,2402,1023,477,546
1990,3068,658,1472,507,2410,1026,478,548
1995,3074,658,1475,507,2415,1029,480,549
2000,3085,660,1478,508,2424,1032,481,551
2005,3089,661,1481,509,2428,1033,481,552
2010,3099,663,1487,511,2435,1036,483,553
2015,3105,663,1490,511,2441,1039,484,555
2020,3116,665,1497,512,2450,1042,487,555
2025,3120,666,1499,513,2454,1043,487,556
2030,3130,667,1502,513,2462,1046,488,558
2035,3136,667,1505,513,2469,1049,491,558
2040,3147,670,1510,515,2477,1052,492,560
2045,3151,670,1510,515,2481,1053,492,561
2050,3161,671,1513,516,2489,1056,493,563
2055,3167,671,1517,516,2495,1059,495,564
2060,3178,673,1518,517,2505,1062,496,566
2065,3182,675,1521,519,2507,1063,497,566
2070,3192,677,1527,521,2515,1066,499,567
2075,3198,677,1530,521,2521,1069,500,569
2080,3209,678,1532,521,2531,1072,500,572
2085,3213,680,1535,523,2533,1073,501,572
2090,3223,683,1541,525,2539,1076,503,573
2095,3229,683,1545,525,2545,1079,505,574
2100,3240,687,1551,529,2552,1082,506,576
2105,3244,689,1554,531,2555,1083,507,576
2110,3254,692,1560,533,2562,1086,510,576
2115,3260,692,1564,533,2568,1089,513,576
2120,3271,694,1570,535,2576,1092,514,578
2125,3275,696,1573,537,2579,1093,515,578
2130,3285,699,1577,539,2585,1096,516,580
2135,3291,699,1579,539,2591,1099,517,582
2140,3302,702,1584,541,2600,1102,517,585
2145,3306,703,1588,542,2602,1103,518,585
2150,3316,704,1594,543,2611,1106,519,587
2155,3322,704,1599,543,2616,1109,521,588
2160,3333,706,1605,544,2625,1112,523,589
2165,3337,706,1607,544,2631,1113,523,590
2170,3347,706,1613,544,2639,1116,524,592
2175,3353,706,1615,544,2644,1119,524,595
2180,3364,706,1623,544,2657,1122,526,596
2185,3368,706,1625,544,2661,1123,526,597
2190,3378,706,1634,544,2670,1126,528,598
2195,3384,706,1640,544,2676,1129,531,598
2200,3395,706,1646,544,2688,1132,532,600
2205,3399,706,1649,544,2693,1133,533,600
2210,3409,706,1654,544,2703,1136,534,602
2215,3415,706,1658,544,2708,1139,536,603
2220,3426,706,1663,544,2718,1142,537,605
2225,3430,706,1666,544,2724,1143,537,606
2230,3440,706,1669,544,2734,1146,538,608
2235,3446,706,1671,544,2740,1149,539,610
2240,3457,707,1676,545,2750,1152,540,612
2245,3461,707,1677,545,2754,1153,540,613
2250,3471,708,1679,545,2763,1156,541,615
2255,3477,708,1683,545,2769,1159,544,615
2260,3488,709,1689,546,2778,1162,546,616
2265,3492,710,1689,547,2782,1163,546,617
2270,3502,711,1693,547,2791,1166,548,618
2275,3508,711,1695,547,2797,1169,550,619
2280,3519,713,1701,548,2805,1172,552,620
2285,3523,715,1703,550,2808,1173,553,620
2290,3533,717,1705,551,2816,1176,554,622
2295,3539,717,1708,551,2822,1179,555,624
2300,3550,720,1713,553,2829,1182,556,626
2305,3554,722,1714,555,2832,1183,556,627
2310,3564,723,1716,555,2841,1186,557,629
2315,3570,723,1718,555,2847,1189,559,630
2320,3581,725,1723,557,2856,1192,559,633
2325,3585,726,1726,558,2859,1193,560,633
2330,3595,728,1728,559,2867,1196,561,635
2335,3601,728,1731,559,2871,1199,562,637
2340,3612,732,1737,563,2878,1202,564,638
2345,3616,734,1738,565,2882,1203,565,638
2350,3626,736,1743,566,2888,1206,567,639
2355,3632,737,1745,567,2893,1209,568,641
2360,3643,741,1751,571,2901,1212,571,641
2365,3647,743,1753,573,2904,1213,572,641
2370,3657,745,1758,575,2910,1216,573,643
2375,3663,746,1761,576,2915,1219,575,644
2380,3674,751,1767,581,2922,1222,577,645
2385,3678,754,1771,584,2923,1223,578,645
2390,3688,758,1775,588,2930,1226,579,647
2395,3694,758,1776,588,2936,1229,580,649
2400,3705,761,1781,591,2944,1232,581,651
2405,3709,762,1782,592,2947,1233,581,652
2410,3719,763,1788,593,2955,1236,583,653
2415,3725,763,1792,593,2961,1239,585,654
2420,3736,765,1797,594,2970,1242,587,655
2425,3740,766,1799,595,2974,1243,588,655
2430,3750,766,1801,595,2983,1246,588,658
2435,3756,766,1805,595,2989,1249,590,659
2440,3767,767,1809,595,2999,1252,592,660
2445,3771,767,1811,595,3004,1253,593,660
2450,3781,768,1816,596,3013,1256,596,660
2455,3787,768,1817,596,3019,1259,597,662
2460,3798,771,1823,599,3026,1262,598,664
2465,3802,771,1825,599,3030,1263,598,665
2470,3812,773,1832,601,3038,1266,599,667
2475,3818,773,1835,601,3045,1269,601,668
2480,3829,775,1842,602,3051,1272,602,670
2485,3833,775,1844,602,3058,1273,603,670
2490,3843,776,1851,603,3066,1276,605,671
2495,3849,776,1855,603,3071,1279,606,673
2500,3860,779,1862,606,3080,1282,608,674
2505,3864,779,1864,606,3085,1283,609,674
2510,3874,782,1870,609,3091,1286,611,675
2515,3880,782,1874,609,3097,1289,614,675
2520,3891,786,1880,613,3104,1292,616,676
2525,3895,788,1883,615,3107,1293,617,676
2530,3905,789,1885,615,3116,1296,618,678
2535,3911,789,1889,615,3122,1299,620,679
2540,3922,791,1894,616,3131,1302,622,680
2545,3926,791,1894,616,3135,1303,622,681
2550,3936,793,1896,617,3143,1306,623,683
2555,3942,793,1899,617,3149,1309,626,683
2560,3953,795,1906,618,3157,1312,629,683
2565,3957,797,1909,620,3160,1313,629,684
2570,3967,799,1914,622,3168,1316,629,687
2575,3973,799,1916,622,3174,1319,630,689
2580,3984,802,1921,624,3182,1322,632,690
2585,3988,802,1924,624,3186,1323,633,690
2590,3998,803,1928,625,3194,1326,634,692
2595,4004,803,1933,625,3199,1329,636,693
2600,4015,805,1938,627,3209,1332,638,694
2605,4019,807,1941,629,3212,1333,639,694
2610,4029,809,1948,630,3219,1336,641,695
2615,4035,809,1950,630,3226,1339,642,697
2620,4046,810,1956,631,3236,1342,644,698
2625,4050,811,1959,632,3239,1343,645,698
2630,4060,812,1962,633,3248,1346,647,699
2635,4066,812,1964,633,3253,1349,648,701
2640,4077,813,1971,634,3262,1352,650,702
2645,4081,816,1974,637,3264,1353,650,703
2650,4091,819,1976,640,3272,1356,650,706
2655,4097,819,1979,640,3276,1359,651,708
2660,4108,822,1982,643,3285,1362,651,711
2665,4112,824,1985,645,3287,1363,651,712
2670,4122,826,1991,647,3294,1366,652,714
2675,4128,826,1994,647,3300,1369,653,716
2680,4139,826,2001,647,3311,1372,655,717
2685,4143,826,2003,647,3317,1373,656,717
2690,4153,826,2006,647,3327,1376,658,718
2695,4159,826,2008,647,3333,1379,659,720
2700,4170,828,2012,649,3341,1382,660,722
2705,4174,829,2015,650,3345,1383,661,722
2710,4184,831,2020,652,3353,1386,663,723
2715,4190,831,2024,652,3358,1389,665,724
2720,4201,834,2031,655,3364,1392,666,726
2725,4205,834,2033,655,3370,1393,666,727
2730,4215,835,2037,656,3380,1396,667,729
2735,4221,835,2038,656,3386,1399,668,731
2740,4232,838,2043,659,3394,1402,669,733
2745,4236,839,2046,660,3396,1403,669,734
2750,4246,840,2051,661,3404,1406,669,737
2755,4252,840,2055,661,3411,1409,671,738
2760,4263,841,2059,661,3421,1412,673,739
2765,4267,842,2061,662,3425,1413,674,739
2770,4277,843,2067,663,3434,1416,677,739
2775,4283,843,2069,663,3439,1419,678,741
2780,4294,846,2073,666,3448,1422,679,743
2785,4298,846,2074,666,3452,1423,679,744
2790,4308,849,2083,669,3458,1426,681,745
2795,4314,849,2086,669,3464,1429,682,747
2800,4325,852,2092,671,3472,1432,684,748
2805,4329,853,2096,672,3476,1433,685,748
2810,4339,854,2100,673,3485,1436,686,750
2815,4345,854,2104,673,3490,1439,689,750
2820,4356,856,2110,675,3498,1442,690,752
2825,4360,857,2111,676,3503,1443,690,753
2830,4370,859,2116,678,3510,1446,690,756
2835,4376,859,2120,678,3516,1449,692,757
2840,4387,863,2125,682,3524,1452,694,758
2845,4391,863,2127,682,3528,1453,694,759
2850,4401,864,2130,682,3537,1456,696,760
2855,4407,864,2136,682,3542,1459,699,760
2860,4418,867,2142,684,3551,1462,701,761
2865,4422,868,2143,685,3554,1463,701,762
2870,4432,869,2145,685,3563,1466,702,764
2875,4438,869,2147,685,3569,1469,703,766
2880,4449,871,2154,687,3577,1472,705,767
2885,4453,874,2157,690,3579,1473,706,767
2890,4463,877,2163,692,3585,1476,707,769
2895,4469,877,2166,692,3592,1479,709,770
2900,4480,879,2170,693,3601,1482,711,771
2905,4484,879,2170,693,3605,1483,711,772
2910,4494,883,2178,697,3611,1486,714,772
2915,4500,883,2181,697,3616,1489,716,773
2920,4511,887,2188,700,3623,1492,718,774
2925,4515,889,2189,702,3626,1493,718,775
2930,4525,892,2195,704,3632,1496,721,775
2935,4531,893,2198,705,3636,1499,722,777
2940,4542,897,2203,708,3643,1502,724,778
2945,4546,899,2204,710,3647,1503,724,779
2950,4556,901,2212,712,3653,1506,726,780
2955,4562,902,2216,713,3658,1509,729,780
2960,4573,905,2222,716,3666,1512,731,781
2965,4577,907,2223,718,3670,1513,731,782
2970,4587,907,2227,718,3679,1516,731,785
2975,4593,907,2230,718,3685,1519,733,786
2980,4604,907,2235,718,3696,1522,735,787
2985,4608,907,2236,718,3701,1523,735,788
2990,4618,907,2240,718,3710,1526,736,790
2995,4624,907,2243,718,3715,1529,738,791
3000,4635,907,2249,718,3726,1532,739,793
3005,4639,907,2250,718,3731,1533,739,794
3010,4649,907,2256,718,3742,1536,741,795
3015,4655,907,2259,718,3747,1539,742,797
3020,4666,907,2263,718,3759,1542,744,798
3025,4670,907,2264,718,3763,1543,745,798
3030,4680,907,2269,718,3771,1546,747,799
3035,4686,907,2271,718,3777,1549,748,801
3040,4697,907,2278,718,3788,1552,748,804
3045,4701,908,2280,719,3793,1553,749,804
3050,4711,909,2284,720,3801,1556,751,805
3055,4717,909,2287,720,3807,1559,752,807
3060,4728,912,2295,723,3815,1562,755,807
3065,4732,913,2297,724,3819,1563,755,808
3070,4742,914,2302,725,3827,1566,757,809
3075,4748,914,2305,725,3833,1569,758,811
3080,4759,918,2309,728,3840,1572,759,813
3085,4763,919,2310,729,3844,1573,760,813
3090,4773,921,2315,731,3851,1576,761,815
3095,4779,921,2319,731,3857,1579,762,817
3100,4790,924,2325,734,3865,1582,763,819
3105,4794,926,2327,736,3868,1583,763,820
3110,4804,927,2329,736,3877,1586,763,823
3115,4810,927,2333,736,3882,1589,764,825
3120,4821,931,2339,740,3890,1592,765,827
3125,4825,931,2340,740,3894,1593,765,828
3130,4835,934,2346,742,3900,1596,767,829
3135,4841,934,2349,742,3907,1599,768,831
3140,4852,936,2355,744,3915,1602,770,832
3145,4856,937,2356,745,3919,1603,770,833
3150,4866,939,2360,746,3927,1606,772,834
3155,4872,939,2362,746,3933,1609,773,836
3160,4883,940,2364,746,3943,1612,773,839
3165,4887,942,2368,748,3945,1613,774,839
3170,4897,945,2373,750,3951,1616,776,840
3175,4903,945,2377,750,3955,1619,778,841
3180,4914,949,2382,753,3963,1622,781,841
3185,4918,952,2385,756,3965,1623,782,841
3190,4928,956,2390,760,3970,1626,782,844
3195,4934,957,2394,761,3974,1629,784,845
3200,4945,964,2402,768,3979,1632,786,846
3205,4949,966,2402,770,3983,1633,786,847
3210,4959,966,2404,770,3992,1636,787,849
3215,4965,966,2407,770,3998,1639,788,851
3220,4976,968,2412,772,4007,1642,789,853
3225,4980,968,2413,772,4011,1643,789,854
3230,4990,968,2418,772,4022,1646,792,854
3235,4996,968,2423,772,4026,1649,794,855
3240,5007,971,2429,774,4034,1652,795,857
3245,5011,972,2432,775,4039,1653,796,857
3250,5021,974,2440,777,4046,1656,798,858
3255,5027,974,2442,777,4053,1659,799,860
3260,5038,977,2448,779,4060,1662,801,861
3265,5042,978,2450,780,4064,1663,801,862
3270,5052,978,2453,780,4073,1666,802,864
3275,5058,978,2458,780,4080,1669,805,864
3280,5069,978,2463,780,4091,1672,807,865
3285,5073,978,2466,780,4095,1673,808,865
3290,5083,978,2469,780,4105,1676,808,868
3295,5089,978,2473,780,4111,1679,810,869
3300,5100,978,2476,780,4121,1682,810,872
3305,5104,978,2479,780,4126,1683,811,872
3310,5114,978,2483,780,4136,1686,811,875
3315,5120,978,2487,780,4142,1689,814,875
3320,5131,978,2492,780,4153,1692,815,877
3325,5135,978,2495,780,4157,1693,816,877
3330,5145,979,2501,780,4165,1696,817,879
3335,5151,979,2505,780,4171,1699,819,880
3340,5162,981,2509,782,4180,1702,820,882
3345,5166,982,2513,783,4184,1703,821,882
3350,5176,984,2520,784,4191,1706,823,883
3355,5182,984,2523,784,4197,1709,825,884
3360,5193,986,2528,786,4207,1712,826,886
3365,5197,987,2531,787,4210,1713,826,887
3370,5207,989,2535,789,4218,1716,828,888
3375,5213,989,2539,789,4223,1719,830,889
3380,5224,993,2543,792,4231,1722,831,891
3385,5228,994,2544,793,4234,1723,831,892
3390,5238,997,2549,796,4241,1726,832,894
3395,5244,997,2550,796,4246,1729,832,897
3400,5255,1002,2558,801,4252,1732,832,900
3405,5259,1004,2559,803,4255,1733,832,901
3410,5269,1009,2566,808,4260,1736,834,902
3415,5275,1009,2569,808,4265,1739,836,903
3420,5286,1013,2573,812,4272,1742,836,906
3425,5290,1015,2576,814,4274,1743,837,906
3430,5300,1019,2582,818,4279,1746,838,908
3435,5306,1020,2584,819,4284,1749,839,910
3440,5317,1023,2589,821,4293,1752,842,910
3445,5321,1024,2591,822,4296,1753,842,911
3450,5331,1025,2598,823,4304,1756,844,912
3455,5337,1025,2602,823,4310,1759,846,913
3460,5348,1026,2606,823,4322,1762,848,914
3465,5352,1026,2608,823,4325,1763,849,914
3470,5362,1027,2612,824,4334,1766,851,915
3475,5368,1027,2613,824,4340,1769,852,917
3480,5379,1028,2616,825,4351,1772,854,918
3485,5383,1029,2619,826,4353,1773,854,919
3490,5393,1029,2622,826,4362,1776,854,922
3495,5399,1029,2625,826,4369,1779,855,924
3500,5410,1030,2629,826,4379,1782,856,926
3505,5414,1030,2629,826,4384,1783,856,927
3510,5424,1031,2637,827,4392,1786,859,927
3515,5430,1031,2640,827,4399,1789,861,928
3520,5441,1033,2644,828,4408,1792,861,931
3525,5445,1034,2647,829,4411,1793,862,931
3530,5455,1035,2651,830,4419,1796,863,933
3535,5461,1035,2654,830,4426,1799,865,934
3540,5472,1037,2657,831,4435,1802,867,935
3545,5476,1037,2658,831,4439,1803,867,936
3550,5486,1039,2664,833,4446,1806,870,936
3555,5492,1039,2667,833,4451,1809,871,938
3560,5503,1043,2672,836,4458,1812,871,941
3565,5507,1045,2673,838,4462,1813,871,942
3570,5517,1046,2676,839,4471,1816,872,944
3575,5523,1046,2679,839,4476,1819,873,946
3580,5534,1049,2683,842,4484,1822,874,948
3585,5538,1051,2686,844,4487,1823,875,948
3590,5548,1053,2691,846,4495,1826,876,950
3595,5554,1053,2692,846,4501,1829,877,952
3600,5565,1056,2697,849,4508,1832,878,954
3605,5569,1059,2700,852,4510,1833,878,955
3610,5579,1062,2707,854,4516,1836,880,956
3615,5585,1062,2709,854,4522,1839,882,957
3620,5596,1064,2711,855,4531,1842,883,959
3625,5600,1067,2714,858,4533,1843,884,959
3630,5610,1069,2717,860,4541,1846,885,961
3635,5616,1069,2721,860,4545,1849,887,962
3640,5627,1074,2729,865,4550,1852,889,963
3645,5631,1078,2731,869,4553,1853,890,963
3650,5641,1081,2734,872,4560,1856,890,966
3655,5647,1081,2735,872,4565,1859,890,969
3660,5658,1084,2741,875,4570,1862,890,972
3665,5662,1085,2743,876,4577,1863,891,972
3670,5672,1085,2748,876,4586,1866,894,972
3675,5678,1085,2751,876,4593,1869,895,974
3680,5689,1085,2756,876,4604,1872,897,975
3685,5693,1085,2756,876,4608,1873,897,976
3690,5703,1085,2760,876,4617,1876,898,978
3695,5709,1085,2762,876,4624,1879,898,981
3700,5720,1085,2768,876,4635,1882,899,983
3705,5724,1085,2768,876,4639,1883,899,984
3710,5734,1085,2774,876,4649,1886,900,986
3715,5740,1085,2776,876,4655,1889,901,988
3720,5751,1085,2781,876,4666,1892,902,990
3725,5755,1085,2782,876,4670,1893,903,990
3730,5765,1085,2787,876,4679,1896,903,993
3735,5771,1085,2791,876,4686,1899,905,994
3740,5782,1085,2796,876,4696,1902,906,996
3745,5786,1085,2799,876,4701,1903,907,996
3750,5796,1085,2803,876,4710,1906,908,998
3755,5802,1085,2807,876,4716,1909,909,1000
3760,5813,1085,2812,876,4728,1912,911,1001
3765,5817,1085,2814,876,4732,1913,912,1001
3770,5827,1088,2821,878,4737,1916,914,1002
3775,5833,1089,2823,879,4742,1919,915,1004
3780,5844,1094,2829,883,4750,1922,917,1005
3785,5848,1095,2831,884,4753,1923,918,1005
3790,5858,1099,2836,888,4758,1926,919,1007
3795,5864,1099,2839,888,4764,1929,921,1008
3800,5875,1104,2850,893,4770,1932,924,1008
3805,5879,1105,2852,894,4774,1933,925,1008
3810,5889,1108,2857,897,4780,1936,927,1009
3815,5895,1108,2859,897,4786,1939,928,1011
3820,5906,1111,2864,900,4795,1942,929,1013
3825,5910,1113,2868,902,4797,1943,930,1013
3830,5920,1115,2870,903,4804,1946,931,1015
3835,5926,1115,2873,903,4810,1949,932,1017
3840,5937,1118,2879,906,4819,1952,934,1018
3845,5941,1118,2880,906,4823,1953,934,1019
3850,5951,1122,2885,910,4828,1956,934,1022
3855,5957,1122,2888,910,4834,1959,935,1024
3860,5968,1127,2897,914,4840,1962,937,1025
3865,5972,1128,2898,915,4844,1963,937,1026
3870,5982,1131,2903,918,4850,1966,938,1028
3875,5988,1131,2908,918,4855,1969,941,1028
3880,5999,1134,2916,921,4863,1972,944,1028
3885,6003,1134,2917,921,4869,1973,945,1028
3890,6013,1134,2921,921,4877,1976,946,1030
3895,6019,1134,2924,921,4884,1979,948,1031
3900,6030,1135,2928,922,4894,1982,949,1033
3905,6034,1136,2930,923,4898,1983,949,1034
3910,6044,1136,2934,923,4906,1986,951,1035
3915,6050,1136,2936,923,4914,1989,952,1037
3920,6061,1139,2944,926,4921,1992,954,1038
3925,6065,1139,2944,926,4926,1993,954,1039
3930,6075,1141,2950,928,4932,1996,954,1042
3935,6081,1141,2953,928,4940,1999,956,1043
3940,6092,1142,2955,928,4948,2002,956,1046
3945,6096,1142,2957,928,4954,2003,957,1046
3950,6106,1142,2960,928,4962,2006,957,1049
3955,6112,1142,2964,928,4969,2009,958,1051
3960,6123,1144,2968,929,4978,2012,960,1052
3965,6127,1145,2970,930,4982,2013,961,1052
3970,6137,1147,2978,932,4988,2016,964,1052
3975,6143,1147,2983,932,4995,2019,966,1053
3980,6154,1149,2988,934,5003,2022,967,1055
3985,6158,1150,2990,935,5008,2023,968,1055
3990,6168,1153,2996,938,5014,2026,969,1057
3995,6174,1153,2999,938,5019,2029,970,1059
4000,6185,1157,3004,941,5026,2032,971,1061
4005,6189,1158,3004,942,5031,2033,971,1062
4010,6199,1161,3013,945,5037,2036,974,1062
4015,6205,1161,3015,945,5044,2039,975,1064
4020,6216,1164,3021,947,5051,2042,975,1067
4025,6220,1165,3024,948,5055,2043,976,1067
4030,6230,1166,3029,949,5063,2046,978,1068
4035,6236,1166,3029,949,5070,2049,978,1071
4040,6247,1167,3037,950,5079,2052,979,1073
4045,6251,1168,3038,951,5083,2053,980,1073
4050,6261,1169,3040,951,5091,2056,981,1075
4055,6267,1169,3046,951,5097,2059,984,1075
4060,6278,1170,3051,952,5107,2062,987,1075
4065,6282,1172,3053,954,5110,2063,987,1076
4070,6292,1173,3055,954,5118,2066,988,1078
4075,6298,1173,3058,954,5125,2069,990,1079
4080,6309,1173,3066,954,5135,2072,991,1081
4085,6313,1175,3069,956,5138,2073,991,1082
4090,6323,1177,3075,957,5145,2076,992,1084
4095,6329,1177,3080,957,5150,2079,994,1085
4100,6340,1179,3083,959,5161,2082,995,1087
4105,6344,1180,3085,960,5164,2083,995,1088
4110,6354,1182,3091,961,5171,2086,996,1090
4115,6360,1182,3097,961,5176,2089,999,1090
4120,6371,1185,3102,964,5186,2092,1001,1091
4125,6375,1186,3104,965,5188,2093,1001,1092
4130,6385,1188,3108,967,5196,2096,1004,1092
4135,6391,1188,3111,967,5201,2099,1005,1094
4140,6402,1194,3117,973,5207,2102,1006,1096
4145,6406,1195,3119,974,5211,2103,1007,1096
4150,6416,1195,3123,974,5220,2106,1009,1097
4155,6422,1195,3126,974,5226,2109,1010,1099
4160,6433,1198,3130,977,5235,2112,1011,1101
4165,6437,1199,3132,978,5238,2113,1011,1102
4170,6447,1200,3137,979,5245,2116,1014,1102
4175,6453,1200,3138,979,5252,2119,1014,1105
4180,6464,1201,3141,980,5261,2122,1014,1108
4185,6468,1201,3143,980,5266,2123,1014,1109
4190,6478,1202,3149,981,5274,2126,1015,1111
4195,6484,1202,3151,981,5280,2129,1016,1113
4200,6495,1204,3155,982,5291,2132,1018,1114
4205,6499,1205,3159,983,5293,2133,1019,1114
4210,6509,1206,3166,984,5301,2136,1021,1115
4215,6515,1206,3169,984,5307,2139,1022,1117
4220,6526,1209,3175,986,5315,2142,1023,1119
4225,6530,1209,3176,986,5321,2143,1024,1119
4230,6540,1209,3179,986,5330,2146,1026,1120
4235,6546,1209,3181,986,5337,2149,1027,1122
4240,6557,1211,3187,988,5344,2152,1029,1123
4245,6561,1211,3189,988,5350,2153,1030,1123
4250,6571,1212,3191,989,5358,2156,1030,1126
4255,6577,1212,3196,989,5364,2159,1033,1126
4260,6588,1216,3202,992,5369,2162,1034,1128
4265,6592,1217,3203,993,5375,2163,1035,1128
4270,6602,1219,3208,994,5382,2166,1037,1129
4275,6608,1219,3209,994,5389,2169,1037,1132
4280,6619,1222,3216,997,5395,2172,1039,1133
4285,6623,1224,3219,999,5399,2173,1040,1133
4290,6633,1226,3220,1000,5407,2176,1040,1136
4295,6639,1226,3224,1000,5412,2179,1042,1137
4300,6650,1229,3228,1003,5420,2182,1043,1139
4305,6654,1230,3230,1004,5424,2183,1043,1140
4310,6664,1232,3234,1005,5431,2186,1045,1141
4315,6670,1232,3236,1005,5437,2189,1046,1143
4320,6681,1233,3239,1005,5448,2192,1048,1144
4325,6685,1235,3241,1007,5450,2193,1048,1145
4330,6695,1238,3249,1010,5457,2196,1050,1146
4335,6701,1238,3252,1010,5463,2199,1052,1147
4340,6712,1242,3256,1013,5470,2202,1052,1150
4345,6716,1243,3258,1014,5473,2203,1052,1151
4350,6726,1245,3261,1016,5480,2206,1052,1154
4355,6732,1245,3264,1016,5485,2209,1053,1156
4360,6743,1248,3270,1019,5494,2212,1054,1158
4365,6747,1249,3271,1020,5498,2213,1055,1158
4370,6757,1253,3279,1024,5503,2216,1057,1159
4375,6763,1253,3281,1024,5509,2219,1058,1161
4380,6774,1256,3285,1027,5517,2222,1058,1164
4385,6778,1256,3287,1027,5522,2223,1059,1164
4390,6788,1258,3295,1029,5529,2226,1061,1165
4395,6794,1258,3299,1029,5535,2229,1063,1166
4400,6805,1259,3305,1030,5545,2232,1065,1167
4405,6809,1260,3306,1031,5549,2233,1065,1168
4410,6819,1261,3312,1031,5557,2236,1067,1169
4415,6825,1261,3314,1031,5563,2239,1068,1171
4420,6836,1263,3322,1033,5572,2242,1070,1172
4425,6840,1264,3324,1034,5576,2243,1070,1173
4430,6850,1266,3328,1035,5583,2246,1072,1174
4435,6856,1266,3331,1035,5589,2249,1074,1175
4440,6867,1267,3338,1036,5599,2252,1076,1176
4445,6871,1268,3340,1037,5603,2253,1076,1177
4450,6881,1270,3343,1039,5611,2256,1076,1180
4455,6887,1270,3345,1039,5616,2259,1076,1183
4460,6898,1271,3350,1040,5626,2262,1078,1184
4465,6902,1273,3352,1042,5629,2263,1079,1184
4470,6912,1275,3356,1043,5637,2266,1081,1185
4475,6918,1275,3357,1043,5643,2269,1082,1187
4480,6929,1275,3363,1043,5653,2272,1084,1188
4485,6933,1277,3367,1045,5656,2273,1085,1188
4490,6943,1280,3372,1048,5662,2276,1086,1190
4495,6949,1280,3373,1048,5668,2279,1086,1193
4500,6960,1284,3378,1051,5676,2282,1087,1195
4505,6964,1284,3380,1051,5679,2283,1087,1196
4510,6974,1286,3384,1053,5688,2286,1088,1198
4515,6980,1286,3388,1053,5693,2289,1090,1199
4520,6991,1287,3393,1054,5704,2292,1093,1199
4525,6995,1287,3396,1054,5707,2293,1094,1199
4530,7005,1289,3401,1056,5716,2296,1095,1201
4535,7011,1289,3402,1056,5722,2299,1096,1203
4540,7022,1291,3409,1058,5730,2302,1098,1204
4545,7026,1291,3411,1058,5734,2303,1099,1204
4550,7036,1293,3415,1060,5743,2306,1100,1206
4555,7042,1293,3419,1060,5748,2309,1102,1207
4560,7053,1295,3422,1061,5756,2312,1102,1210
4565,7057,1296,3424,1062,5761,2313,1102,1211
4570,7067,1296,3427,1062,5771,2316,1103,1213
4575,7073,1296,3429,1062,5777,2319,1104,1215
4580,7084,1297,3432,1063,5787,2322,1106,1216
4585,7088,1297,3434,1063,5790,2323,1107,1216
4590,7098,1299,3439,1065,5798,2326,1108,1218
4595,7104,1299,3444,1065,5802,2329,1111,1218
4600,7115,1301,3449,1066,5813,2332,1113,1219
4605,7119,1301,3451,1066,5817,2333,1114,1219
4610,7129,1304,3456,1069,5823,2336,1114,1222
4615,7135,1305,3459,1070,5829,2339,1115,1224
4620,7146,1307,3464,1072,5838,2342,1117,1225
4625,7150,1309,3466,1074,5841,2343,1118,1225
4630,7160,1311,3472,1076,5848,2346,1121,1225
4635,7166,1311,3477,1076,5853,2349,1123,1226
4640,7177,1313,3480,1077,5862,2352,1124,1228
4645,7181,1315,3482,1079,5866,2353,1125,1228
4650,7191,1317,3488,1081,5874,2356,1128,1228
4655,7197,1317,3494,1081,5878,2359,1131,1228
4660,7208,1321,3499,1085,5885,2362,1131,1231
4665,7212,1322,3500,1086,5890,2363,1132,1231
4670,7222,1323,3503,1086,5898,2366,1132,1234
4675,7228,1323,3506,1086,5904,2369,1133,1236
4680,7239,1326,3511,1089,5911,2372,1134,1238
4685,7243,1328,3514,1091,5915,2373,1135,1238
4690,7253,1331,3519,1093,5922,2376,1137,1239
4695,7259,1331,3522,1093,5928,2379,1139,1240
4700,7270,1332,3527,1093,5937,2382,1141,1241
4705,7274,1333,3529,1094,5941,2383,1141,1242
4710,7284,1335,3536,1096,5948,2386,1142,1244
4715,7290,1335,3541,1096,5953,2389,1145,1244
4720,7301,1338,3546,1099,5961,2392,1145,1247
4725,7305,1339,3546,1100,5966,2393,1145,1248
4730,7315,1341,3552,1102,5974,2396,1147,1249
4735,7321,1341,3557,1102,5979,2399,1149,1250
4740,7332,1343,3561,1104,5988,2402,1151,1251
4745,7336,1346,3564,1107,5990,2403,1152,1251
4750,7346,1347,3570,1108,5998,2406,1153,1253
4755,7352,1347,3576,1108,6004,2409,1156,1253
4760,7363,1351,3584,1111,6011,2412,1158,1254
4765,7367,1353,3587,1113,6014,2413,1158,1255
4770,7377,1354,3593,1114,6023,2416,1161,1255
4775,7383,1354,3599,1114,6028,2419,1164,1255
4780,7394,1356,3605,1116,6037,2422,1166,1256
4785,7398,1357,3607,1117,6041,2423,1166,1257
4790,7408,1360,3612,1119,6048,2426,1168,1258
4795,7414,1360,3613,1119,6053,2429,1168,1261
4800,7425,1362,3621,1121,6062,2432,1171,1261
4805,7429,1363,3623,1122,6066,2433,1171,1262
4810,7439,1365,3631,1124,6073,2436,1173,1263
4815,7445,1365,3634,1124,6080,2439,1175,1264
4820,7456,1365,3640,1124,6091,2442,1176,1266
4825,7460,1365,3643,1124,6095,2443,1177,1266
4830,7470,1365,3648,1124,6104,2446,1179,1267
4835,7476,1365,3653,1124,6108,2449,1181,1268
4840,7487,1365,3660,1124,6121,2452,1184,1268
4845,7491,1365,3662,1124,6125,2453,1184,1269
4850,7501,1365,3665,1124,6136,2456,1185,1271
4855,7507,1365,3667,1124,6142,2459,1187,1272
4860,7518,1365,3672,1124,6151,2462,1188,1274
4865,7522,1365,3675,1124,6156,2463,1189,1274
4870,7532,1366,3677,1125,6165,2466,1189,1277
4875,7538,1366,3679,1125,6172,2469,1190,1279
4880,7549,1368,3681,1126,6180,2472,1190,1282
4885,7553,1368,3681,1126,6185,2473,1190,1283
4890,7563,1368,3684,1126,6194,2476,1192,1284
4895,7569,1368,3688,1126,6199,2479,1195,1284
4900,7580,1370,3692,1128,6209,2482,1195,1287
4905,7584,1370,3694,1128,6214,2483,1196,1287
4910,7594,1371,3697,1129,6223,2486,1197,1289
4915,7600,1371,3702,1129,6227,2489,1200,1289
4920,7611,1375,3708,1133,6234,2492,1202,1290
4925,7615,1378,3710,1136,6237,2493,1203,1290
4930,7625,1382,3715,1140,6242,2496,1203,1293
4935,7631,1383,3716,1141,6248,2499,1204,1295
4940,7642,1387,3723,1144,6254,2502,1207,1295
4945,7646,1389,3725,1146,6257,2503,1208,1295
4950,7656,1392,3728,1148,6264,2506,1209,1297
4955,7662,1392,3731,1148,6269,2509,1211,1298
4960,7673,1394,3736,1150,6276,2512,1212,1300
4965,7677,1399,3740,1155,6277,2513,1213,1300
4970,7687,1402,3746,1157,6284,2516,1216,1300
4975,7693,1402,3750,1157,6290,2519,1219,1300
4980,7704,1406,3760,1161,6295,2522,1222,1300
4985,7708,1407,3763,1162,6301,2523,1223,1300
4990,7718,1408,3770,1163,6309,2526,1226,1300
4995,7724,1408,3772,1163,6316,2529,1227,1302
5000,7735,1410,3778,1164,6325,2532,1230,1302
5005,7739,1410,3779,1164,6329,2533,1230,1303
5010,7749,1411,3784,1165,6338,2536,1231,1305
5015,7755,1411,3786,1165,6344,2539,1232,1307
5020,7766,1413,3793,1167,6352,2542,1234,1308
5025,7770,1413,3793,1167,6357,2543,1234,1309
5030,7780,1414,3798,1168,6366,2546,1236,1310
5035,7786,1414,3798,1168,6372,2549,1236,1313
5040,7797,1415,3802,1168,6382,2552,1238,1314
5045,7801,1415,3803,1168,6386,2553,1238,1315
5050,7811,1416,3807,1169,6395,2556,1239,1317
5055,7817,1416,3810,1169,6401,2559,1241,1318
5060,7828,1419,3818,1172,6409,2562,1243,1319
5065,7832,1420,3821,1173,6412,2563,1243,1320
5070,7842,1421,3824,1174,6421,2566,1244,1322
5075,7848,1421,3829,1174,6426,2569,1246,1323
5080,7859,1423,3837,1176,6435,2572,1248,1324
5085,7863,1424,3840,1177,6439,2573,1248,1325
5090,7873,1426,3842,1178,6446,2576,1248,1328
5095,7879,1426,3844,1178,6452,2579,1249,1330
5100,7890,1428,3849,1179,6462,2582,1252,1330
5105,7894,1430,3852,1181,6464,2583,1253,1330
5110,7904,1433,3857,1184,6470,2586,1253,1333
5115,7910,1433,3862,1184,6476,2589,1256,1333
5120,7921,1436,3866,1187,6485,2592,1257,1335
5125,7925,1436,3868,1187,6489,2593,1258,1335
5130,7935,1438,3872,1189,6497,2596,1259,1337
5135,7941,1438,3877,1189,6501,2599,1261,1338
5140,7952,1444,3881,1194,6508,2602,1261,1341
5145,7956,1445,3883,1195,6511,2603,1262,1341
5150,7966,1447,3886,1196,6519,2606,1263,1343
5155,7972,1447,3889,1196,6523,2609,1264,1345
5160,7983,1453,3895,1201,6529,2612,1265,1347
5165,7987,1454,3895,1202,6533,2613,1265,1348
5170,7997,1455,3900,1202,6542,2616,1267,1349
5175,8003,1455,3902,1202,6548,2619,1269,1350
5180,8014,1455,3904,1202,6558,2622,1269,1353
5185,8018,1457,3906,1204,6561,2623,1270,1353
5190,8028,1458,3911,1205,6568,2626,1271,1355
5195,8034,1459,3913,1206,6573,2629,1272,1357
5200,8045,1461,3917,1208,6581,2632,1272,1360
5205,8049,1464,3919,1211,6585,2633,1272,1361
5210,8059,1464,3922,1211,6594,2636,1273,1363
5215,8065,1464,3924,1211,6600,2639,1275,1364
5220,8076,1464,3931,1211,6609,2642,1277,1365
5225,8080,1464,3932,1211,6616,2643,1277,1366
5230,8090,1464,3935,1211,6626,2646,1278,1368
5235,8096,1464,3937,1211,6631,2649,1278,1371
5240,8107,1464,3945,1211,6641,2652,1281,1371
5245,8111,1464,3947,1211,6646,2653,1281,1372
5250,8121,1464,3953,1211,6657,2656,1283,1373
5255,8127,1464,3957,1211,6662,2659,1285,1374
5260,8138,1464,3963,1211,6672,2662,1286,1376
5265,8142,1464,3964,1211,6677,2663,1286,1377
5270,8152,1465,3970,1212,6686,2666,1288,1378
5275,8158,1465,3975,1212,6692,2669,1291,1378
5280,8169,1468,3981,1214,6700,2672,1293,1379
5285,8173,1469,3983,1215,6704,2673,1293,1380
5290,8183,1469,3988,1215,6714,2676,1295,1381
5295,8189,1469,3989,1215,6719,2679,1295,1384
5300,8200,1470,3994,1216,6730,2682,1296,1386
5305,8204,1470,3997,1216,6734,2683,1297,1386
5310,8214,1471,4003,1216,6743,2686,1299,1387
5315,8220,1471,4005,1216,6748,2689,1299,1390
5320,8231,1474,4009,1218,6755,2692,1299,1393
5325,8235,1476,4011,1220,6759,2693,1299,1394
5330,8245,1477,4014,1221,6767,2696,1299,1397
5335,8251,1477,4015,1221,6774,2699,1300,1399
5340,8262,1479,4022,1223,6781,2702,1302,1400
5345,8266,1480,4023,1224,6786,2703,1303,1400
5350,8276,1481,4028,1224,6794,2706,1305,1401
5355,8282,1481,4031,1224,6801,2709,1307,1402
5360,8293,1482,4035,1224,6811,2712,1308,1404
5365,8297,1483,4037,1225,6814,2713,1309,1404
5370,8307,1484,4044,1226,6823,2716,1312,1404
5375,8313,1484,4048,1226,6829,2719,1314,1405
5380,8324,1486,4052,1228,6838,2722,1315,1407
5385,8328,1487,4053,1229,6841,2723,1315,1408
5390,8338,1489,4056,1230,6848,2726,1315,1411
5395,8344,1489,4060,1230,6854,2729,1317,1412
5400,8355,1492,4065,1233,6863,2732,1318,1414
5405,8359,1493,4067,1234,6866,2733,1319,1414
5410,8369,1495,4070,1236,6874,2736,1320,1416
5415,8375,1495,4073,1236,6879,2739,1322,1417
5420,8386,1499,4079,1240,6886,2742,1324,1418
5425,8390,1502,4082,1243,6888,2743,1325,1418
5430,8400,1506,4087,1246,6893,2746,1326,1420
5435,8406,1506,4089,1246,6899,2749,1326,1423
5440,8417,1510,4094,1250,6906,2752,1326,1426
5445,8421,1513,4098,1253,6908,2753,1327,1426
5450,8431,1516,4104,1255,6914,2756,1330,1426
5455,8437,1516,4107,1255,6919,2759,1332,1427
5460,8448,1520,4112,1258,6925,2762,1333,1429
5465,8452,1524,4114,1262,6927,2763,1333,1430
5470,8462,1526,4119,1264,6936,2766,1335,1431
5475,8468,1526,4119,1264,6942,2769,1335,1434
5480,8479,1527,4124,1264,6950,2772,1337,1435
5485,8483,1528,4127,1265,6955,2773,1338,1435
5490,8493,1530,4134,1267,6961,2776,1339,1437
5495,8499,1530,4138,1267,6966,2779,1340,1439
5500,8510,1533,4143,1269,6975,2782,1341,1441
5505,8514,1534,4146,1270,6980,2783,1342,1441
5510,8524,1536,4150,1272,6986,2786,1342,1444
5515,8530,1536,4153,1272,6992,2789,1344,1445
5520,8541,1537,4159,1272,7002,2792,1347,1445
5525,8545,1538,4160,1273,7007,2793,1347,1446
5530,8555,1539,4165,1274,7015,2796,1349,1447
5535,8561,1539,4169,1274,7022,2799,1352,1447
5540,8572,1541,4175,1276,7030,2802,1355,1447
5545,8576,1542,4177,1277,7034,2803,1355,1448
5550,8586,1543,4182,1278,7042,2806,1356,1450
5555,8592,1543,4186,1278,7048,2809,1358,1451
5560,8603,1545,4194,1280,7057,2812,1361,1451
5565,8607,1545,4196,1280,7062,2813,1362,1451
5570,8617,1546,4201,1281,7071,2816,1364,1452
5575,8623,1546,4203,1281,7076,2819,1365,1454
5580,8634,1550,4212,1285,7082,2822,1367,1455
5585,8638,1551,4214,1286,7087,2823,1368,1455
5590,8648,1552,4218,1286,7095,2826,1369,1457
5595,8654,1552,4220,1286,7102,2829,1371,1458
5600,8665,1553,4226,1287,7112,2832,1373,1459
5605,8669,1553,4228,1287,7116,2833,1373,1460
5610,8679,1554,4235,1287,7124,2836,1376,1460
5615,8685,1554,4236,1287,7131,2839,1376,1463
5620,8696,1555,4242,1288,7141,2842,1378,1464
5625,8700,1556,4245,1289,7144,2843,1379,1464
5630,8710,1557,4249,1290,7153,2846,1379,1467
5635,8716,1557,4250,1290,7159,2849,1380,1469
5640,8727,1558,4252,1291,7169,2852,1381,1471
5645,8731,1558,4253,1291,7173,2853,1381,1472
5650,8741,1560,4258,1292,7180,2856,1382,1474
5655,8747,1560,4259,1292,7187,2859,1383,1476
5660,8758,1561,4266,1293,7197,2862,1385,1477
5665,8762,1561,4267,1293,7201,2863,1386,1477
5670,8772,1563,4272,1294,7208,2866,1389,1477
5675,8778,1563,4277,1294,7213,2869,1391,1478
5680,8789,1566,4282,1297,7223,2872,1392,1480
5685,8793,1566,4284,1297,7227,2873,1392,1481
5690,8803,1570,4288,1301,7233,2876,1392,1484
5695,8809,1570,4291,1301,7237,2879,1393,1486
5700,8820,1576,4298,1307,7242,2882,1394,1488
5705,8824,1578,4300,1309,7245,2883,1395,1488
5710,8834,1582,4305,1313,7250,2886,1395,1491
5715,8840,1583,4305,1314,7256,2889,1395,1494
5720,8851,1586,4311,1316,7262,2892,1397,1495
5725,8855,1588,4312,1318,7267,2893,1397,1496
5730,8865,1588,4314,1318,7277,2896,1398,1498
5735,8871,1588,4316,1318,7282,2899,1398,1501
5740,8882,1590,4322,1319,7290,2902,1400,1502
5745,8886,1590,4324,1319,7295,2903,1401,1502
5750,8896,1590,4327,1319,7305,2906,1401,1505
5755,8902,1590,4330,1319,7310,2909,1402,1507
5760,8913,1591,4335,1320,7321,2912,1405,1507
5765,8917,1592,4339,1321,7324,2913,1406,1507
5770,8927,1593,4345,1322,7334,2916,1409,1507
5775,8933,1593,4350,1322,7339,2919,1412,1507
5780,8944,1594,4353,1322,7349,2922,1413,1509
5785,8948,1594,4354,1322,7354,2923,1413,1510
5790,8958,1595,4359,1323,7363,2926,1413,1513
5795,8964,1595,4361,1323,7369,2929,1414,1515
5800,8975,1598,4365,1325,7375,2932,1414,1518
5805,8979,1598,4365,1325,7381,2933,1414,1519
5810,8989,1599,4369,1326,7390,2936,1415,1521
5815,8995,1599,4370,1326,7396,2939,1415,1524
5820,9006,1601,4377,1328,7404,2942,1417,1525
5825,9010,1601,4378,1328,7409,2943,1418,1525
5830,9020,1603,4383,1329,7416,2946,1421,1525
5835,9026,1603,4387,1329,7422,2949,1423,1526
5840,9037,1605,4391,1331,7432,2952,1425,1527
5845,9041,1606,4395,1332,7435,2953,1426,1527
5850,9051,1607,4401,1333,7443,2956,1429,1527
5855,9057,1607,4405,1333,7449,2959,1431,1528
5860,9068,1610,4410,1335,7456,2962,1433,1529
5865,9072,1611,4413,1336,7461,2963,1434,1529
5870,9082,1613,4420,1338,7468,2966,1436,1530
5875,9088,1613,4426,1338,7473,2969,1439,1530
5880,9099,1616,4430,1341,7482,2972,1439,1533
5885,9103,1619,4432,1344,7484,2973,1439,1534
5890,9113,1622,4439,1347,7490,2976,1441,1535
5895,9119,1622,4442,1347,7496,2979,1442,1537
5900,9130,1626,4450,1351,7503,2982,1444,1538
5905,9134,1629,4453,1354,7505,2983,1445,1538
5910,9144,1630,4456,1354,7513,2986,1446,1540
5915,9150,1630,4457,1354,7520,2989,1447,1542
5920,9161,1633,4463,1356,7527,2992,1448,1544
5925,9165,1635,4464,1358,7530,2993,1448,1545
5930,9175,1637,4469,1359,7537,2996,1451,1545
5935,9181,1637,4473,1359,7542,2999,1452,1547
5940,9192,1642,4477,1363,7550,3002,1453,1549
5945,9196,1643,4480,1364,7553,3003,1454,1549
5950,9206,1645,4483,1365,7560,3006,1455,1551
5955,9212,1645,4487,1365,7565,3009,1457,1552
5960,9223,1650,4491,1370,7572,3012,1457,1555
5965,9227,1653,4495,1373,7574,3013,1458,1555
5970,9237,1655,4500,1374,7581,3016,1461,1555
5975,9243,1655,4504,1374,7588,3019,1464,1555
5980,9254,1658,4511,1377,7595,3022,1465,1557
5985,9258,1661,4513,1380,7597,3023,1465,1558
5990,9268,1664,4517,1382,7603,3026,1466,1560
5995,9274,1664,4519,1382,7608,3029,1467,1562
6000,9285,1667,4525,1385,7617,3032,1468,1564
6005,9289,1667,4525,1385,7622,3033,1468,1565
6010,9299,1667,4528,1385,7630,3036,1468,1568
6015,9305,1667,4531,1385,7637,3039,1471,1568
6020,9316,1667,4537,1385,7647,3042,1473,1569
6025,9320,1667,4538,1385,7652,3043,1473,1570
6030,9330,1667,4542,1385,7663,3046,1474,1572
6035,9336,1667,4545,1385,7668,3049,1476,1573
6040,9347,1667,4550,1385,7678,3052,1477,1575
6045,9351,1667,4551,1385,7684,3053,1477,1576
6050,9361,1667,4556,1385,7693,3056,1478,1578
6055,9367,1667,4558,1385,7698,3059,1479,1580
6060,9378,1667,4562,1385,7711,3062,1481,1581
6065,9382,1667,4565,1385,7714,3063,1482,1581
6070,9392,1667,4570,1385,7725,3066,1484,1582
6075,9398,1667,4574,1385,7729,3069,1485,1584
6080,9409,1667,4578,1385,7740,3072,1486,1586
6085,9413,1667,4580,1385,7746,3073,1487,1586
6090,9423,1667,4584,1385,7755,3076,1489,1587
6095,9429,1667,4588,1385,7760,3079,1492,1587
6100,9440,1669,4595,1386,7769,3082,1495,1587
6105,9444,1670,4598,1387,7773,3083,1496,1587
6110,9454,1674,4604,1390,7780,3086,1497,1589
6115,9460,1674,4608,1390,7784,3089,1498,1591
6120,9471,1678,4615,1394,7791,3092,1500,1592
6125,9475,1679,4617,1395,7796,3093,1500,1593
6130,9485,1682,4622,1398,7803,3096,1501,1595
6135,9491,1682,4628,1398,7808,3099,1504,1595
6140,9502,1685,4634,1400,7816,3102,1507,1595
6145,9506,1686,4635,1401,7820,3103,1507,1596
6150,9516,1688,4640,1402,7827,3106,1508,1598
6155,9522,1688,4645,1402,7833,3109,1511,1598
6160,9533,1691,4652,1405,7841,3112,1514,1598
6165,9537,1692,4653,1406,7845,3113,1514,1599
6170,9547,1693,4657,1406,7854,3116,1516,1600
6175,9553,1693,4659,1406,7860,3119,1517,1602
6180,9564,1695,4666,1408,7868,3122,1520,1602
6185,9568,1697,4667,1410,7871,3123,1520,1603
6190,9578,1698,4672,1411,7879,3126,1521,1605
6195,9584,1698,4675,1411,7885,3129,1521,1608
6200,9595,1703,4684,1416,7891,3132,1523,1609
6205,9599,1705,4686,1418,7894,3133,1523,1610
6210,9609,1708,4693,1421,7900,3136,1525,1611
6215,9615,1708,4697,1421,7906,3139,1528,1611
6220,9626,1712,4702,1424,7914,3142,1530,1612
6225,9630,1713,4704,1425,7917,3143,1531,1612
6230,9640,1717,4710,1429,7923,3146,1533,1613
6235,9646,1717,4713,1429,7927,3149,1534,1615
6240,9657,1720,4721,1432,7933,3152,1537,1615
6245,9661,1726,4723,1438,7935,3153,1537,1616
6250,9671,1729,4730,1441,7941,3156,1540,1616
6255,9677,1729,4731,1441,7946,3159,1540,1619
6260,9688,1731,4736,1443,7956,3162,1540,1622
6265,9692,1732,4738,1444,7959,3163,1540,1623
6270,9702,1732,4743,1444,7969,3166,1542,1624
6275,9708,1732,4744,1444,7976,3169,1543,1626
6280,9719,1734,4751,1446,7985,3172,1546,1626
6285,9723,1734,4753,1446,7988,3173,1547,1626
6290,9733,1735,4758,1447,7996,3176,1548,1628
6295,9739,1735,4761,1447,8002,3179,1550,1629
6300,9750,1737,4769,1449,8011,3182,1553,1629
6305,9754,1737,4771,1449,8017,3183,1554,1629
6310,9764,1737,4776,1449,8025,3186,1557,1629
6315,9770,1737,4779,1449,8033,3189,1558,1631
6320,9781,1737,4783,1449,8043,3192,1559,1633
6325,9785,1737,4784,1449,8048,3193,1560,1633
6330,9795,1737,4790,1449,8057,3196,1562,1634
6335,9801,1737,4793,1449,8063,3199,1563,1636
6340,9812,1737,4795,1449,8074,3202,1564,1638
6345,9816,1737,4796,1449,8079,3203,1564,1639
6350,9826,1737,4799,1449,8088,3206,1564,1642
6355,9832,1737,4803,1449,8093,3209,1565,1644
6360,9843,1738,4809,1450,8104,3212,1566,1646
6365,9847,1739,4810,1451,8108,3213,1567,1646
6370,9857,1740,4815,1451,8116,3216,1568,1648
6375,9863,1740,4818,1451,8123,3219,1571,1648
6380,9874,1741,4825,1452,8132,3222,1571,1651
6385,9878,1743,4827,1454,8135,3223,1572,1651
6390,9888,1744,4834,1455,8144,3226,1574,1652
6395,9894,1744,4837,1455,8149,3229,1575,1654
6400,9905,1745,4843,1456,8159,3232,1577,1655
6405,9909,1747,4845,1458,8162,3233,1578,1655
6410,9919,1749,4851,1460,8169,3236,1579,1657
6415,9925,1749,4853,1460,8175,3239,1580,1659
6420,9936,1753,4859,1464,8183,3242,1582,1660
6425,9940,1754,4861,1465,8186,3243,1583,1660
6430,9950,1756,4865,1466,8193,3246,1585,1661
6435,9956,1756,4867,1466,8199,3249,1586,1663
6440,9967,1759,4871,1468,8208,3252,1588,1664
6445,9971,1760,4872,1469,8211,3253,1588,1665
6450,9981,1762,4875,1471,8219,3256,1589,1667
6455,9987,1762,4877,1471,8224,3259,1590,1669
6460,9998,1765,4879,1474,8233,3262,1590,1672
6465,10002,1765,4880,1474,8237,3263,1591,1672
6470,10012,1767,4885,1476,8245,3266,1593,1673
6475,10018,1767,4889,1476,8250,3269,1595,1674
6480,10029,1771,4896,1479,8257,3272,1597,1675
6485,10033,1774,4898,1482,8259,3273,1597,1676
6490,10043,1776,4901,1484,8267,3276,1598,1678
6495,10049,1776,4903,1484,8271,3279,1598,1681
6500,10060,1781,4909,1489,8278,3282,1599,1683
6505,10064,1782,4912,1490,8281,3283,1600,1683
6510,10074,1782,4916,1490,8292,3286,1601,1685
6515,10080,1782,4919,1490,8297,3289,1602,1687
6520,10091,1785,4926,1493,8306,3292,1603,1689
6525,10095,1785,4926,1493,8310,3293,1603,1690
6530,10105,1785,4929,1493,8320,3296,1604,1692
6535,10111,1785,4931,1493,8325,3299,1605,1694
6540,10122,1788,4940,1496,8331,3302,1607,1695
6545,10126,1789,4943,1497,8336,3303,1608,1695
6550,10136,1790,4950,1498,8345,3306,1611,1695
6555,10142,1790,4952,1498,8352,3309,1612,1697
6560,10153,1791,4957,1498,8362,3312,1615,1697
6565,10157,1791,4960,1498,8365,3313,1616,1697
6570,10167,1791,4964,1498,8374,3316,1617,1699
6575,10173,1791,4968,1498,8381,3319,1619,1700
6580,10184,1794,4971,1501,8390,3322,1619,1703
6585,10188,1795,4973,1502,8393,3323,1620,1703
6590,10198,1795,4978,1502,8402,3326,1622,1704
6595,10204,1795,4980,1502,8409,3329,1623,1706
6600,10215,1796,4985,1503,8418,3332,1625,1707
6605,10219,1796,4987,1503,8423,3333,1625,1708
6610,10229,1798,4991,1504,8431,3336,1627,1709
6615,10235,1798,4993,1504,8436,3339,1628,1711
6620,10246,1801,5001,1507,8442,3342,1630,1712
6625,10250,1803,5004,1509,8447,3343,1630,1713
6630,10260,1805,5007,1510,8454,3346,1630,1716
6635,10266,1805,5007,1510,8461,3349,1630,1719
6640,10277,1808,5013,1513,8469,3352,1631,1721
6645,10281,1808,5014,1513,8473,3353,1631,1722
6650,10291,1810,5019,1514,8481,3356,1633,1723
6655,10297,1810,5021,1514,8486,3359,1634,1725
6660,10308,1813,5026,1516,8494,3362,1635,1727
6665,10312,1813,5028,1516,8499,3363,1636,1727
6670,10322,1816,5037,1519,8505,3366,1639,1727
6675,10328,1816,5040,1519,8512,3369,1641,1728
6680,10339,1819,5045,1522,8520,3372,1642,1730
6685,10343,1821,5048,1524,8522,3373,1642,1731
6690,10353,1824,5053,1527,8529,3376,1643,1733
6695,10359,1824,5055,1527,8535,3379,1644,1735
6700,10370,1826,5060,1529,8543,3382,1645,1737
6705,10374,1827,5063,1530,8547,3383,1646,1737
6710,10384,1829,5072,1532,8554,3386,1649,1737
6715,10390,1829,5077,1532,8560,3389,1652,1737
6720,10401,1830,5085,1533,8570,3392,1655,1737
6725,10405,1831,5086,1534,8574,3393,1655,1738
6730,10415,1833,5091,1535,8582,3396,1657,1739
6735,10421,1833,5095,1535,8587,3399,1660,1739
6740,10432,1835,5102,1537,8597,3402,1662,1740
6745,10436,1835,5104,1537,8601,3403,1662,1741
6750,10446,1836,5106,1538,8609,3406,1662,1744
6755,10452,1836,5107,1538,8616,3409,1663,1746
6760,10463,1837,5113,1539,8625,3412,1663,1749
6765,10467,1839,5114,1541,8628,3413,1663,1750
6770,10477,1841,5119,1543,8635,3416,1664,1752
6775,10483,1842,5121,1544,8641,3419,1666,1753
6780,10494,1843,5126,1545,8649,3422,1667,1755
6785,10498,1845,5127,1547,8653,3423,1667,1756
6790,10508,1847,5133,1549,8660,3426,1669,1757
6795,10514,1847,5136,1549,8665,3429,1671,1758
6800,10525,1849,5140,1551,8676,3432,1673,1759
6805,10529,1851,5143,1553,8678,3433,1674,1759
6810,10539,1854,5149,1555,8684,3436,1677,1759
6815,10545,1855,5154,1556,8688,3439,1680,1759
6820,10556,1859,5161,1560,8695,3442,1683,1759
6825,10560,1863,5164,1564,8697,3443,1684,1759
6830,10570,1863,5168,1564,8707,3446,1686,1760
6835,10576,1863,5171,1564,8711,3449,1686,1763
6840,10587,1865,5176,1566,8720,3452,1686,1766
6845,10591,1865,5176,1566,8726,3453,1686,1767
6850,10601,1866,5178,1567,8734,3456,1686,1770
6855,10607,1866,5182,1567,8739,3459,1689,1770
6860,10618,1869,5188,1569,8748,3462,1691,1771
6865,10622,1870,5191,1570,8752,3463,1692,1771
6870,10632,1872,5199,1572,8758,3466,1694,1772
6875,10638,1872,5202,1572,8764,3469,1695,1774
6880,10649,1873,5204,1572,8776,3472,1697,1775
6885,10653,1873,5205,1572,8780,3473,1698,1775
6890,10663,1875,5209,1574,8786,3476,1698,1778
6895,10669,1875,5213,1574,8793,3479,1700,1779
6900,10680,1877,5218,1575,8802,3482,1701,1781
6905,10684,1877,5219,1575,8807,3483,1702,1781
6910,10694,1878,5224,1576,8815,3486,1703,1783
6915,10700,1878,5227,1576,8821,3489,1705,1784
6920,10711,1880,5234,1578,8830,3492,1707,1785
6925,10715,1880,5235,1578,8835,3493,1707,1786
6930,10725,1881,5240,1579,8843,3496,1709,1787
6935,10731,1881,5245,1579,8850,3499,1712,1787
6940,10742,1883,5250,1580,8858,3502,1714,1788
6945,10746,1884,5252,1581,8862,3503,1715,1788
6950,10756,1886,5255,1582,8870,3506,1716,1790
6955,10762,1886,5259,1582,8876,3509,1718,1791
6960,10773,1889,5264,1584,8884,3512,1719,1793
6965,10777,1889,5265,1584,8888,3513,1719,1794
6970,10787,1892,5272,1587,8895,3516,1721,1795
6975,10793,1892,5275,1587,8901,3519,1723,1796
6980,10804,1896,5282,1591,8907,3522,1724,1798
6985,10808,1898,5285,1593,8910,3523,1725,1798
6990,10818,1900,5291,1595,8917,3526,1726,1800
6995,10824,1900,5294,1595,8923,3529,1728,1801
7000,10835,1904,5300,1598,8931,3532,1730,1802
7005,10839,1905,5302,1599,8934,3533,1730,1803
7010,10849,1906,5303,1600,8943,3536,1730,1806
7015,10855,1906,5304,1600,8949,3539,1731,1808
7020,10866,1909,5311,1602,8956,3542,1732,1810
7025,10870,1911,5313,1604,8959,3543,1732,1811
7030,10880,1914,5317,1606,8966,3546,1733,1813
7035,10886,1914,5321,1606,8971,3549,1736,1813
7040,10897,1918,5328,1610,8977,3552,1738,1814
7045,10901,1922,5332,1614,8978,3553,1739,1814
7050,10911,1926,5336,1618,8985,3556,1740,1816
7055,10917,1926,5339,1618,8989,3559,1741,1818
7060,10928,1931,5346,1623,8995,3562,1743,1819
7065,10932,1933,5348,1625,8998,3563,1743,1820
7070,10942,1935,5354,1627,9006,3566,1745,1821
7075,10948,1935,5358,1627,9010,3569,1746,1823
7080,10959,1938,5367,1630,9018,3572,1747,1825
7085,10963,1938,5368,1630,9025,3573,1747,1826
7090,10973,1938,5373,1630,9034,3576,1748,1828
7095,10979,1938,5376,1630,9040,3579,1750,1829
7100,10990,1938,5381,1630,9051,3582,1751,1831
7105,10994,1938,5385,1630,9055,3583,1752,1831
7110,11004,1938,5392,1630,9064,3586,1755,1831
7115,11010,1938,5395,1630,9072,3589,1757,1832
7120,11021,1938,5401,1630,9081,3592,1759,1833
7125,11025,1938,5402,1630,9087,3593,1759,1834
7130,11035,1938,5409,1630,9097,3596,1761,1835
7135,11041,1938,5410,1630,9103,3599,1762,1837
7140,11052,1938,5415,1630,9113,3602,1764,1838
7145,11056,1938,5417,1630,9118,3603,1764,1839
7150,11066,1938,5422,1630,9127,3606,1766,1840
7155,11072,1938,5425,1630,9133,3609,1766,1843
7160,11083,1938,5429,1630,9145,3612,1767,1845
7165,11087,1938,5432,1630,9149,3613,1767,1846
7170,11097,1939,5436,1630,9157,3616,1768,1848
7175,11103,1939,5439,1630,9164,3619,1771,1848
7180,11114,1939,5444,1630,9173,3622,1773,1849
7185,11118,1940,5446,1631,9178,3623,1773,1850
7190,11128,1941,5452,1632,9186,3626,1775,1851
7195,11134,1941,5455,1632,9192,3629,1777,1852
7200,11145,1943,5461,1634,9201,3632,1779,1853
7205,11149,1945,5463,1636,9204,3633,1779,1854
7210,11159,1946,5467,1637,9213,3636,1781,1855
7215,11165,1946,5471,1637,9219,3639,1784,1855
7220,11176,1948,5474,1638,9228,3642,1785,1857
7225,11180,1949,5475,1639,9231,3643,1785,1858
7230,11190,1950,5480,1640,9240,3646,1786,1860
7235,11196,1950,5484,1640,9245,3649,1787,1862
7240,11207,1953,5489,1643,9253,3652,1788,1864
7245,11211,1956,5492,1646,9255,3653,1789,1864
7250,11221,1960,5499,1649,9260,3656,1791,1865
7255,11227,1960,5502,1649,9266,3659,1792,1867
7260,11238,1963,5509,1652,9274,3662,1794,1868
7265,11242,1965,5511,1654,9277,3663,1795,1868
7270,11252,1968,5517,1656,9283,3666,1797,1869
7275,11258,1968,5522,1656,9288,3669,1799,1870
7280,11269,1973,5529,1661,9296,3672,1800,1872
7285,11273,1973,5530,1661,9300,3673,1801,1872
7290,11283,1977,5535,1664,9305,3676,1802,1874
7295,11289,1977,5538,1664,9311,3679,1804,1875
7300,11300,1980,5542,1666,9319,3682,1805,1877
7305,11304,1982,5544,1668,9321,3683,1805,1878
7310,11314,1985,5549,1670,9328,3686,1806,1880
7315,11320,1985,5553,1670,9334,3689,1808,1881
7320,11331,1987,5557,1671,9343,3692,1809,1883
7325,11335,1987,5560,1671,9347,3693,1810,1883
7330,11345,1988,5563,1672,9357,3696,1811,1885
7335,11351,1988,5564,1672,9363,3699,1811,1888
7340,11362,1989,5567,1673,9373,3702,1811,1891
7345,11366,1990,5569,1674,9376,3703,1812,1891
7350,11376,1991,5573,1675,9385,3706,1812,1894
7355,11382,1991,5576,1675,9390,3709,1814,1895
7360,11393,1993,5581,1676,9399,3712,1815,1897
7365,11397,1993,5583,1676,9404,3713,1816,1897
7370,11407,1994,5586,1677,9412,3716,1816,1900
7375,11413,1994,5589,1677,9418,3719,1818,1901
7380,11424,1996,5593,1679,9428,3722,1819,1903
7385,11428,1996,5595,1679,9431,3723,1820,1903
7390,11438,1997,5599,1680,9440,3726,1821,1905
7395,11444,1997,5604,1680,9444,3729,1823,1906
7400,11455,1999,5607,1681,9455,3732,1824,1908
7405,11459,1999,5609,1681,9459,3733,1825,1908
7410,11469,2001,5616,1683,9466,3736,1827,1909
7415,11475,2002,5618,1684,9471,3739,1828,1911
7420,11486,2006,5623,1688,9479,3742,1829,1913
7425,11490,2007,5626,1689,9483,3743,1830,1913
7430,11500,2009,5630,1691,9491,3746,1832,1914
7435,11506,2009,5633,1691,9496,3749,1834,1915
7440,11517,2013,5636,1694,9504,3752,1834,1918
7445,11521,2013,5637,1694,9508,3753,1834,1919
7450,11531,2014,5641,1695,9517,3756,1836,1920
7455,11537,2014,5643,1695,9521,3759,1836,1923
7460,11548,2017,5644,1697,9531,3762,1836,1926
7465,11552,2018,5646,1698,9533,3763,1836,1927
7470,11562,2021,5651,1700,9540,3766,1837,1929
7475,11568,2021,5653,1700,9547,3769,1838,1931
7480,11579,2022,5656,1700,9555,3772,1839,1933
7485,11583,2023,5656,1701,9560,3773,1839,1934
7490,11593,2024,5660,1701,9568,3776,1840,1936
7495,11599,2024,5663,1701,9574,3779,1842,1937
7500,11610,2029,5668,1705,9580,3782,1843,1939
7505,11614,2030,5671,1706,9584,3783,1844,1939
7510,11624,2032,5675,1707,9592,3786,1846,1940
7515,11630,2032,5677,1707,9597,3789,1847,1942
7520,11641,2034,5683,1709,9605,3792,1849,1943
7525,11645,2035,5685,1710,9610,3793,1850,1943
7530,11655,2038,5690,1712,9617,3796,1852,1944
7535,11661,2038,5691,1712,9623,3799,1853,1946
7540,11672,2041,5697,1714,9631,3802,1855,1947
7545,11676,2041,5699,1714,9635,3803,1856,1947
7550,11686,2044,5704,1716,9642,3806,1857,1949
7555,11692,2044,5705,1716,9647,3809,1857,1952
7560,11703,2045,5707,1716,9657,3812,1858,1954
7565,11707,2046,5710,1717,9661,3813,1859,1954
7570,11717,2047,5718,1718,9669,3816,1861,1955
7575,11723,2047,5720,1718,9675,3819,1862,1957
7580,11734,2047,5725,1718,9686,3822,1863,1959
7585,11738,2048,5728,1719,9690,3823,1864,1959
7590,11748,2049,5734,1720,9699,3826,1867,1959
7595,11754,2049,5738,1720,9705,3829,1870,1959
7600,11765,2049,5744,1720,9716,3832,1872,1960
7605,11769,2049,5745,1720,9720,3833,1873,1960
7610,11779,2051,5749,1721,9728,3836,1874,1962
7615,11785,2051,5752,1721,9733,3839,1875,1964
7620,11796,2052,5756,1722,9744,3842,1876,1966
7625,11800,2053,5758,1723,9747,3843,1876,1967
7630,11810,2054,5759,1724,9756,3846,1876,1970
7635,11816,2054,5762,1724,9762,3849,1878,1971
7640,11827,2055,5768,1725,9772,3852,1880,1972
7645,11831,2056,5772,1726,9775,3853,1881,1972
7650,11841,2058,5776,1728,9782,3856,1881,1975
7655,11847,2058,5778,1728,9788,3859,1882,1977
7660,11858,2060,5783,1730,9797,3862,1884,1978
7665,11862,2062,5787,1732,9800,3863,1885,1978
7670,11872,2067,5793,1736,9805,3866,1886,1980
7675,11878,2067,5796,1736,9809,3869,1886,1983
7680,11889,2071,5803,1740,9817,3872,1887,1985
7685,11893,2073,5806,1742,9820,3873,1888,1985
7690,11903,2076,5813,1745,9825,3876,1890,1986
7695,11909,2077,5814,1746,9830,3879,1890,1989
7700,11920,2081,5823,1750,9835,3882,1893,1989
7705,11924,2084,5825,1753,9840,3883,1894,1989
7710,11934,2085,5830,1754,9848,3886,1894,1992
7715,11940,2085,5832,1754,9854,3889,1896,1993
7720,11951,2087,5837,1755,9863,3892,1899,1993
7725,11955,2087,5839,1755,9867,3893,1899,1994
7730,11965,2089,5845,1757,9874,3896,1900,1996
7735,11971,2089,5846,1757,9881,3899,1901,1998
7740,11982,2091,5851,1758,9888,3902,1901,2001
7745,11986,2091,5853,1758,9895,3903,1902,2001
7750,11996,2092,5857,1759,9904,3906,1902,2004
7755,12002,2092,5860,1759,9909,3909,1903,2006
7760,12013,2095,5866,1761,9917,3912,1904,2008
7765,12017,2095,5868,1761,9922,3913,1905,2008
7770,12027,2097,5874,1763,9928,3916,1906,2010
7775,12033,2097,5877,1763,9934,3919,1908,2011
7780,12044,2099,5883,1765,9942,3922,1909,2013
7785,12048,2100,5885,1766,9948,3923,1910,2013
7790,12058,2100,5889,1766,9957,3926,1912,2014
7795,12064,2100,5894,1766,9962,3929,1915,2014
7800,12075,2102,5899,1767,9970,3932,1915,2017
7805,12079,2102,5901,1767,9977,3933,1916,2017
7810,12089,2104,5907,1768,9984,3936,1919,2017
7815,12095,2104,5913,1768,9989,3939,1922,2017
7820,12106,2106,5917,1770,9999,3942,1922,2020
7825,12110,2108,5918,1772,10002,3943,1922,2021
7830,12120,2110,5923,1774,10009,3946,1924,2022
7835,12126,2110,5928,1774,10015,3949,1927,2022
7840,12137,2112,5936,1776,10023,3952,1929,2023
7845,12141,2113,5937,1777,10028,3953,1929,2024
7850,12151,2115,5940,1778,10036,3956,1930,2026
7855,12157,2115,5944,1778,10040,3959,1932,2027
7860,12168,2118,5949,1780,10049,3962,1934,2028
7865,12172,2120,5952,1782,10052,3963,1935,2028
7870,12182,2122,5955,1783,10060,3966,1936,2030
7875,12188,2122,5958,1783,10065,3969,1938,2031
7880,12199,2125,5960,1786,10074,3972,1938,2034
7885,12203,2125,5962,1786,10078,3973,1938,2035
7890,12213,2127,5966,1788,10086,3976,1939,2037
7895,12219,2127,5971,1788,10091,3979,1942,2037
7900,12230,2131,5978,1792,10099,3982,1945,2037
7905,12234,2131,5978,1792,10103,3983,1945,2038
7910,12244,2136,5986,1797,10107,3986,1946,2040
7915,12250,2136,5987,1797,10114,3989,1947,2042
7920,12261,2139,5992,1799,10121,3992,1949,2043
7925,12265,2140,5992,1800,10125,3993,1949,2044
7930,12275,2141,5994,1800,10134,3996,1951,2045
7935,12281,2141,5996,1800,10140,3999,1952,2047
7940,12292,2141,6001,1800,10151,4002,1955,2047
7945,12296,2142,6003,1801,10154,4003,1955,2048
7950,12306,2143,6005,1801,10163,4006,1957,2049
7955,12312,2143,6005,1801,10169,4009,1957,2052
7960,12323,2143,6010,1801,10180,4012,1960,2052
7965,12327,2144,6013,1802,10182,4013,1960,2053
7970,12337,2147,6017,1805,10189,4016,1961,2055
7975,12343,2148,6020,1806,10193,4019,1962,2057
7980,12354,2151,6024,1809,10202,4022,1962,2060
7985,12358,2152,6024,1810,10206,4023,1962,2061
7990,12368,2153,6028,1810,10214,4026,1963,2063
7995,12374,2153,6031,1810,10218,4029,1964,2065
8000,12385,2156,6032,1813,10228,4032,1964,2068
8005,12389,2157,6032,1814,10232,4033,1964,2069
8010,12399,2159,6036,1815,10239,4036,1965,2071
8015,12405,2160,6037,1816,10244,4039,1965,2074
8020,12416,2161,6042,1817,10254,4042,1966,2076
8025,12420,2161,6044,1817,10259,4043,1966,2077
8030,12430,2162,6048,1818,10267,4046,1967,2079
8035,12436,2162,6049,1818,10273,4049,1968,2081
8040,12447,2165,6054,1821,10282,4052,1969,2083
8045,12451,2165,6056,1821,10285,4053,1970,2083
8050,12461,2167,6064,1823,10293,4056,1972,2084
8055,12467,2167,6065,1823,10299,4059,1973,2086
8060,12478,2168,6066,1823,10310,4062,1974,2088
8065,12482,2169,6068,1824,10313,4063,1974,2089
8070,12492,2170,6075,1825,10322,4066,1977,2089
8075,12498,2170,6078,1825,10326,4069,1978,2091
8080,12509,2173,6083,1827,10335,4072,1979,2093
8085,12513,2173,6084,1827,10340,4073,1979,2094
8090,12523,2174,6087,1828,10348,4076,1980,2096
8095,12529,2174,6090,1828,10353,4079,1981,2098
8100,12540,2177,6096,1831,10362,4082,1982,2100
8105,12544,2177,6098,1831,10366,4083,1982,2101
8110,12554,2179,6102,1833,10375,4086,1982,2104
8115,12560,2179,6103,1833,10381,4089,1982,2107
8120,12571,2182,6109,1836,10387,4092,1982,2110
8125,12575,2182,6111,1836,10392,4093,1983,2110
8130,12585,2185,6117,1839,10399,4096,1984,2112
8135,12591,2185,6119,1839,10406,4099,1985,2114
8140,12602,2187,6125,1840,10411,4102,1986,2116
8145,12606,2189,6127,1842,10417,4103,1986,2117
8150,12616,2192,6133,1844,10424,4106,1988,2118
8155,12622,2192,6136,1844,10429,4109,1989,2120
8160,12633,2196,6143,1847,10436,4112,1990,2122
8165,12637,2197,6145,1848,10440,4113,1990,2123
8170,12647,2198,6149,1848,10449,4116,1992,2124
8175,12653,2198,6152,1848,10455,4119,1993,2126
8180,12664,2198,6155,1848,10465,4122,1994,2128
8185,12668,2199,6158,1849,10469,4123,1995,2128
8190,12678,2200,6163,1849,10477,4126,1997,2129
8195,12684,2200,6166,1849,10484,4129,1999,2130
8200,12695,2200,6171,1849,10495,4132,2000,2132
8205,12699,2201,6175,1850,10498,4133,2001,2132
8210,12709,2202,6176,1850,10507,4136,2002,2134
8215,12715,2202,6179,1850,10513,4139,2004,2135
8220,12726,2202,6181,1850,10524,4142,2004,2138
8225,12730,2203,6184,1851,10527,4143,2004,2139
8230,12740,2204,6188,1851,10536,4146,2005,2141
8235,12746,2204,6189,1851,10542,4149,2006,2143
8240,12757,2204,6190,1851,10553,4152,2006,2146
8245,12761,2205,6192,1852,10556,4153,2007,2146
8250,12771,2207,6198,1854,10564,4156,2009,2147
8255,12777,2207,6200,1854,10569,4159,2010,2149
8260,12788,2209,6206,1856,10579,4162,2012,2150
8265,12792,2210,6208,1857,10582,4163,2012,2151
8270,12802,2212,6213,1859,10590,4166,2014,2152
8275,12808,2212,6216,1859,10595,4169,2016,2153
8280,12819,2215,6220,1861,10602,4172,2017,2155
8285,12823,2218,6223,1864,10604,4173,2018,2155
8290,12833,2224,6230,1869,10608,4176,2020,2156
8295,12839,2224,6231,1869,10614,4179,2021,2158
8300,12850,2229,6239,1874,10619,4182,2023,2159
8305,12854,2232,6241,1877,10622,4183,2024,2159
8310,12864,2234,6246,1878,10629,4186,2027,2159
8315,12870,2234,6250,1878,10632,4189,2028,2161
8320,12881,2241,6256,1885,10639,4192,2030,2162
8325,12885,2243,6259,1887,10641,4193,2030,2163
8330,12895,2244,6262,1888,10650,4196,2031,2165
8335,12901,2244,6266,1888,10656,4199,2034,2165
8340,12912,2246,6271,1889,10664,4202,2035,2167
8345,12916,2247,6272,1890,10669,4203,2035,2168
8350,12926,2248,6275,1891,10678,4206,2036,2170
8355,12932,2248,6277,1891,10684,4209,2037,2172
8360,12943,2250,6283,1893,10691,4212,2038,2174
8365,12947,2251,6286,1894,10695,4213,2038,2175
8370,12957,2252,6291,1895,10704,4216,2040,2176
8375,12963,2252,6293,1895,10711,4219,2041,2178
8380,12974,2254,6301,1897,10717,4222,2043,2179
8385,12978,2255,6303,1898,10723,4223,2043,2180
8390,12988,2257,6310,1900,10731,4226,2045,2181
8395,12994,2257,6314,1900,10737,4229,2048,2181
8400,13005,2259,6321,1902,10744,4232,2049,2183
8405,13009,2259,6324,1902,10750,4233,2049,2184
8410,13019,2259,6328,1902,10760,4236,2049,2187
8415,13025,2259,6331,1902,10766,4239,2051,2188
8420,13036,2259,6339,1902,10776,4242,2052,2190
8425,13040,2259,6342,1902,10781,4243,2053,2190
8430,13050,2259,6347,1902,10790,4246,2055,2191
8435,13056,2259,6351,1902,10796,4249,2058,2191
8440,13067,2260,6358,1903,10805,4252,2060,2192
8445,13071,2261,6359,1904,10810,4253,2060,2193
8450,13081,2262,6363,1904,10819,4256,2062,2194
8455,13087,2262,6366,1904,10824,4259,2064,2195
8460,13098,2264,6368,1906,10833,4262,2064,2198
8465,13102,2265,6368,1907,10837,4263,2064,2199
8470,13112,2266,6373,1908,10846,4266,2066,2200
8475,13118,2266,6376,1908,10851,4269,2066,2203
8480,13129,2267,6382,1909,10861,4272,2069,2203
8485,13133,2268,6385,1910,10865,4273,2069,2204
8490,13143,2269,6387,1910,10874,4276,2070,2206
8495,13149,2269,6389,1910,10880,4279,2071,2208
8500,13160,2269,6394,1910,10891,4282,2072,2210
8505,13164,2269,6396,1910,10895,4283,2072,2211
8510,13174,2273,6401,1913,10900,4286,2073,2213
8515,13180,2273,6404,1913,10906,4289,2074,2215
8520,13191,2277,6410,1917,10913,4292,2076,2216
8525,13195,2280,6413,1920,10915,4293,2077,2216
8530,13205,2283,6416,1922,10922,4296,2078,2218
8535,13211,2283,6419,1922,10928,4299,2080,2219
8540,13222,2285,6423,1924,10937,4302,2080,2222
8545,13226,2286,6425,1925,10940,4303,2080,2223
8550,13236,2290,6432,1928,10944,4306,2082,2224
8555,13242,2291,6433,1929,10949,4309,2082,2227
8560,13253,2295,6440,1932,10955,4312,2085,2227
8565,13257,2299,6442,1936,10958,4313,2086,2227
8570,13267,2302,6445,1938,10964,4316,2086,2230
8575,13273,2303,6445,1939,10970,4319,2086,2233
8580,13284,2304,6449,1940,10977,4322,2086,2236
8585,13288,2308,6452,1944,10979,4323,2086,2237
8590,13298,2308,6456,1944,10989,4326,2089,2237
8595,13304,2308,6461,1944,10994,4329,2092,2237
8600,13315,2309,6465,1945,11005,4332,2093,2239
8605,13319,2310,6466,1946,11009,4333,2093,2240
8610,13329,2311,6474,1947,11016,4336,2096,2240
8615,13335,2311,6478,1947,11022,4339,2098,2241
8620,13346,2313,6486,1949,11031,4342,2101,2241
8625,13350,2314,6488,1950,11036,4343,2102,2241
8630,13360,2315,6491,1951,11045,4346,2104,2242
8635,13366,2315,6495,1951,11050,4349,2106,2243
8640,13377,2317,6501,1952,11059,4352,2108,2244
8645,13381,2317,6503,1952,11064,4353,2109,2244
8650,13391,2317,6506,1952,11073,4356,2110,2246
8655,13397,2317,6511,1952,11079,4359,2112,2247
8660,13408,2319,6517,1953,11088,4362,2112,2250
8665,13412,2319,6520,1953,11093,4363,2113,2250
8670,13422,2321,6528,1955,11100,4366,2115,2251
8675,13428,2321,6530,1955,11107,4369,2116,2253
8680,13439,2323,6536,1956,11116,4372,2118,2254
8685,13443,2324,6538,1957,11119,4373,2119,2254
8690,13453,2324,6541,1957,11129,4376,2120,2256
8695,13459,2324,6543,1957,11135,4379,2120,2259
8700,13470,2327,6550,1960,11143,4382,2122,2260
8705,13474,2328,6554,1961,11146,4383,2123,2260
8710,13484,2330,6556,1962,11154,4386,2124,2262
8715,13490,2330,6558,1962,11160,4389,2124,2265
8720,13501,2333,6563,1964,11168,4392,2126,2266
8725,13505,2334,6566,1965,11171,4393,2127,2266
8730,13515,2335,6571,1966,11180,4396,2130,2266
8735,13521,2335,6575,1966,11186,4399,2132,2267
8740,13532,2336,6582,1967,11195,4402,2134,2268
8745,13536,2338,6586,1969,11198,4403,2135,2268
8750,13546,2340,6590,1971,11206,4406,2136,2270
8755,13552,2340,6592,1971,11212,4409,2138,2271
8760,13563,2341,6598,1972,11221,4412,2140,2272
8765,13567,2343,6600,1974,11224,4413,2141,2272
8770,13577,2346,6606,1977,11229,4416,2142,2274
8775,13583,2347,6611,1978,11233,4419,2145,2274
8780,13594,2350,6616,1981,11243,4422,2147,2275
8785,13598,2352,6619,1983,11245,4423,2148,2275
8790,13608,2356,6623,1987,11252,4426,2149,2277
8795,13614,2356,6624,1987,11258,4429,2150,2279
8800,13625,2357,6628,1988,11267,4432,2151,2281
8805,13629,2359,6632,1990,11269,4433,2152,2281
8810,13639,2361,6634,1991,11278,4436,2153,2283
8815,13645,2361,6637,1991,11283,4439,2154,2285
8820,13656,2361,6642,1991,11295,4442,2155,2287
8825,13660,2361,6644,1991,11298,4443,2155,2288
8830,13670,2361,6649,1991,11308,4446,2157,2289
8835,13676,2361,6652,1991,11312,4449,2158,2291
8840,13687,2363,6658,1992,11321,4452,2158,2294
8845,13691,2363,6660,1992,11327,4453,2158,2295
8850,13701,2363,6664,1992,11338,4456,2159,2297
8855,13707,2363,6667,1992,11344,4459,2161,2298
8860,13718,2364,6669,1992,11354,4462,2163,2299
8865,13722,2364,6671,1992,11358,4463,2164,2299
8870,13732,2364,6673,1992,11368,4466,2165,2301
8875,13738,2364,6677,1992,11374,4469,2167,2302
8880,13749,2366,6683,1993,11380,4472,2168,2304
8885,13753,2366,6684,1993,11387,4473,2168,2305
8890,13763,2367,6686,1994,11395,4476,2168,2308
8895,13769,2367,6688,1994,11402,4479,2169,2310
8900,13780,2369,6693,1995,11410,4482,2169,2313
8905,13784,2370,6695,1996,11414,4483,2170,2313
8910,13794,2371,6701,1997,11423,4486,2173,2313
8915,13800,2371,6704,1997,11427,4489,2174,2315
8920,13811,2375,6710,2001,11436,4492,2176,2316
8925,13815,2376,6713,2002,11439,4493,2177,2316
8930,13825,2378,6719,2004,11446,4496,2178,2318
8935,13831,2378,6721,2004,11453,4499,2180,2319
8940,13842,2380,6727,2005,11460,4502,2182,2320
8945,13846,2381,6728,2006,11465,4503,2182,2321
8950,13856,2382,6731,2006,11473,4506,2184,2322
8955,13862,2382,6732,2006,11480,4509,2185,2324
8960,13873,2385,6736,2009,11488,4512,2186,2326
8965,13877,2386,6737,2010,11491,4513,2186,2327
8970,13887,2389,6741,2012,11498,4516,2188,2328
8975,13893,2389,6743,2012,11503,4519,2188,2331
8980,13904,2392,6746,2014,11512,4522,2188,2334
8985,13908,2393,6747,2015,11515,4523,2188,2335
8990,13918,2395,6753,2017,11522,4526,2190,2336
8995,13924,2396,6754,2018,11528,4529,2191,2338
9000,13935,2398,6758,2019,11536,4532,2193,2339
9005,13939,2400,6760,2021,11538,4533,2193,2340
9010,13949,2405,6766,2025,11543,4536,2195,2341
9015,13955,2406,6769,2026,11548,4539,2196,2343
9020,13966,2409,6772,2028,11556,4542,2196,2346
9025,13970,2411,6773,2030,11559,4543,2196,2347
9030,13980,2413,6777,2031,11567,4546,2198,2348
9035,13986,2413,6781,2031,11571,4549,2199,2350
9040,13997,2417,6787,2035,11580,4552,2201,2351
9045,14001,2417,6788,2035,11584,4553,2201,2352
9050,14011,2420,6791,2037,11590,4556,2201,2355
9055,14017,2420,6794,2037,11595,4559,2202,2357
9060,14028,2424,6799,2041,11604,4562,2204,2358
9065,14032,2424,6800,2041,11608,4563,2204,2359
9070,14042,2427,6802,2043,11614,4566,2204,2362
9075,14048,2427,6804,2043,11621,4569,2205,2364
9080,14059,2429,6810,2045,11629,4572,2207,2365
9085,14063,2431,6812,2047,11632,4573,2208,2365
9090,14073,2435,6820,2051,11637,4576,2211,2365
9095,14079,2435,6821,2051,11644,4579,2211,2368
9100,14090,2438,6829,2054,11651,4582,2212,2370
9105,14094,2441,6832,2057,11653,4583,2213,2370
9110,14104,2442,6836,2058,11661,4586,2215,2371
9115,14110,2442,6838,2058,11667,4589,2217,2372
9120,14121,2444,6843,2059,11674,4592,2219,2373
9125,14125,2446,6843,2061,11679,4593,2219,2374
9130,14135,2447,6848,2062,11686,4596,2219,2377
9135,14141,2447,6853,2062,11692,4599,2222,2377
9140,14152,2448,6856,2062,11703,4602,2224,2378
9145,14156,2448,6856,2062,11708,4603,2224,2379
9150,14166,2450,6862,2064,11715,4606,2225,2381
9155,14172,2450,6864,2064,11720,4609,2226,2383
9160,14183,2451,6868,2064,11731,4612,2228,2384
9165,14187,2451,6868,2064,11736,4613,2228,2385
9170,14197,2452,6873,2065,11744,4616,2230,2386
9175,14203,2452,6874,2065,11751,4619,2230,2389
9180,14214,2454,6878,2066,11759,4622,2231,2391
9185,14218,2455,6880,2067,11763,4623,2231,2392
9190,14228,2456,6886,2068,11770,4626,2233,2393
9195,14234,2456,6887,2068,11778,4629,2234,2395
9200,14245,2459,6895,2070,11784,4632,2236,2396
9205,14249,2460,6898,2071,11788,4633,2236,2397
9210,14259,2461,6902,2072,11797,4636,2238,2398
9215,14265,2461,6908,2072,11803,4639,2241,2398
9220,14276,2461,6914,2072,11814,4642,2242,2400
9225,14280,2461,6917,2072,11818,4643,2242,2401
9230,14290,2461,6924,2072,11828,4646,2245,2401
9235,14296,2461,6926,2072,11834,4649,2245,2404
9240,14307,2463,6930,2074,11843,4652,2247,2405
9245,14311,2463,6931,2074,11848,4653,2247,2406
9250,14321,2464,6937,2075,11856,4656,2248,2408
9255,14327,2464,6941,2075,11862,4659,2250,2409
9260,14338,2466,6947,2077,11872,4662,2251,2411
9265,14342,2466,6948,2077,11876,4663,2251,2412
9270,14352,2467,6953,2078,11884,4666,2253,2413
9275,14358,2467,6955,2078,11889,4669,2253,2416
9280,14369,2468,6956,2079,11901,4672,2253,2419
9285,14373,2468,6958,2079,11905,4673,2254,2419
9290,14383,2469,6964,2079,11913,4676,2256,2420
9295,14389,2469,6967,2079,11920,4679,2258,2421
9300,14400,2469,6972,2079,11931,4682,2261,2421
9305,14404,2470,6975,2080,11934,4683,2261,2422
9310,14414,2471,6977,2080,11942,4686,2261,2425
9315,14420,2471,6978,2080,11949,4689,2262,2427
9320,14431,2474,6985,2083,11957,4692,2263,2429
9325,14435,2475,6986,2084,11960,4693,2263,2430
9330,14445,2477,6992,2086,11967,4696,2266,2430
9335,14451,2477,6995,2086,11974,4699,2269,2430
9340,14462,2480,7001,2089,11981,4702,2270,2432
9345,14466,2483,7004,2092,11983,4703,2270,2433
9350,14476,2488,7010,2096,11987,4706,2270,2436
9355,14482,2488,7012,2096,11993,4709,2271,2438
9360,14493,2492,7015,2099,12001,4712,2272,2440
9365,14497,2493,7016,2100,12004,4713,2272,2441
9370,14507,2496,7021,2103,12010,4716,2274,2442
9375,14513,2496,7023,2103,12016,4719,2274,2445
9380,14524,2498,7028,2105,12026,4722,2277,2445
9385,14528,2499,7030,2106,12029,4723,2277,2446
9390,14538,2502,7034,2108,12035,4726,2279,2447
9395,14544,2502,7037,2108,12041,4729,2280,2449
9400,14555,2506,7044,2112,12048,4732,2282,2450
9405,14559,2509,7047,2115,12050,4733,2282,2451
9410,14569,2512,7051,2117,12056,4736,2283,2453
9415,14575,2512,7055,2117,12059,4739,2284,2455
9420,14586,2519,7062,2124,12066,4742,2287,2455
9425,14590,2521,7066,2126,12068,4743,2288,2455
9430,14600,2522,7071,2127,12077,4746,2290,2456
9435,14606,2522,7076,2127,12082,4749,2292,2457
9440,14617,2524,7079,2128,12093,4752,2293,2459
9445,14621,2524,7080,2128,12096,4753,2293,2460
9450,14631,2525,7083,2129,12105,4756,2293,2463
9455,14637,2525,7085,2129,12111,4759,2294,2465
9460,14648,2526,7090,2130,12121,4762,2295,2467
9465,14652,2526,7091,2130,12126,4763,2295,2468
9470,14662,2527,7097,2131,12133,4766,2297,2469
9475,14668,2527,7099,2131,12140,4769,2298,2471
9480,14679,2529,7103,2132,12149,4772,2299,2473
9485,14683,2530,7105,2133,12153,4773,2299,2474
9490,14693,2531,7109,2134,12161,4776,2300,2476
9495,14699,2531,7111,2134,12168,4779,2301,2478
9500,14710,2534,7119,2136,12173,4782,2303,2479
9505,14714,2534,7120,2136,12180,4783,2304,2479
9510,14724,2535,7124,2137,12188,4786,2306,2480
9515,14730,2535,7127,2137,12193,4789,2307,2482
9520,14741,2537,7134,2139,12201,4792,2309,2483
9525,14745,2537,7135,2139,12207,4793,2309,2484
9530,14755,2538,7140,2139,12216,4796,2311,2485
9535,14761,2538,7144,2139,12222,4799,2313,2486
9540,14772,2539,7150,2140,12231,4802,2314,2488
9545,14776,2540,7154,2141,12236,4803,2315,2488
9550,14786,2541,7161,2141,12244,4806,2317,2489
9555,14792,2541,7163,2141,12251,4809,2318,2491
9560,14803,2542,7170,2142,12261,4812,2320,2492
9565,14807,2542,7172,2142,12265,4813,2321,2492
9570,14817,2543,7177,2142,12273,4816,2324,2492
9575,14823,2543,7180,2142,12278,4819,2324,2495
9580,14834,2544,7185,2143,12288,4822,2324,2498
9585,14838,2545,7186,2144,12293,4823,2325,2498
9590,14848,2546,7188,2144,12302,4826,2326,2500
9595,14854,2546,7192,2144,12307,4829,2328,2501
9600,14865,2548,7198,2146,12316,4832,2330,2502
9605,14869,2549,7200,2147,12320,4833,2331,2502
9610,14879,2550,7201,2147,12329,4836,2331,2505
9615,14885,2550,7202,2147,12335,4839,2332,2507
9620,14896,2551,7209,2148,12344,4842,2335,2507
9625,14900,2552,7211,2149,12348,4843,2336,2507
9630,14910,2553,7216,2150,12357,4846,2337,2509
9635,14916,2553,7218,2150,12363,4849,2338,2511
9640,14927,2555,7220,2151,12372,4852,2339,2513
9645,14931,2556,7223,2152,12375,4853,2340,2513
9650,14941,2559,7228,2155,12382,4856,2341,2515
9655,14947,2559,7232,2155,12387,4859,2343,2516
9660,14958,2561,7237,2157,12396,4862,2345,2517
9665,14962,2563,7239,2159,12399,4863,2346,2517
9670,14972,2566,7243,2161,12405,4866,2346,2520
9675,14978,2566,7247,2161,12412,4869,2349,2520
9680,14989,2568,7253,2163,12421,4872,2351,2521
9685,14993,2569,7254,2164,12424,4873,2351,2522
9690,15003,2570,7256,2164,12433,4876,2352,2524
9695,15009,2570,7258,2164,12438,4879,2353,2526
9700,15020,2572,7263,2166,12447,4882,2355,2527
9705,15024,2574,7266,2168,12449,4883,2356,2527
9710,15034,2578,7271,2171,12454,4886,2357,2529
9715,15040,2579,7274,2172,12458,4889,2358,2531
9720,15051,2584,7280,2176,12465,4892,2361,2531
9725,15055,2585,7284,2177,12469,4893,2362,2531
9730,15065,2587,7288,2179,12477,4896,2363,2533
9735,15071,2587,7292,2179,12482,4899,2365,2534
9740,15082,2590,7298,2182,12491,4902,2365,2537
9745,15086,2590,7299,2182,12496,4903,2365,2538
9750,15096,2591,7303,2183,12505,4906,2366,2540
9755,15102,2591,7306,2183,12510,4909,2368,2541
9760,15113,2594,7313,2185,12517,4912,2370,2542
9765,15117,2595,7315,2186,12521,4913,2370,2543
9770,15127,2596,7321,2187,12530,4916,2373,2543
9775,15133,2596,7324,2187,12536,4919,2375,2544
9780,15144,2598,7331,2188,12543,4922,2378,2544
9785,15148,2599,7333,2189,12549,4923,2379,2544
9790,15158,2600,7339,2190,12558,4926,2381,2545
9795,15164,2600,7343,2190,12564,4929,2384,2545
9800,15175,2602,7349,2192,12572,4932,2385,2547
9805,15179,2602,7349,2192,12577,4933,2385,2548
9810,15189,2603,7353,2193,12586,4936,2386,2550
9815,15195,2603,7355,2193,12592,4939,2388,2551
9820,15206,2604,7356,2194,12602,4942,2388,2554
9825,15210,2605,7359,2195,12605,4943,2389,2554
9830,15220,2608,7366,2198,12612,4946,2391,2555
9835,15226,2608,7369,2198,12617,4949,2393,2556
9840,15237,2612,7373,2202,12624,4952,2393,2559
9845,15241,2613,7373,2203,12628,4953,2393,2560
9850,15251,2615,7380,2205,12635,4956,2396,2560
9855,15257,2615,7383,2205,12642,4959,2398,2561
9860,15268,2616,7386,2206,12651,4962,2399,2563
9865,15272,2616,7387,2206,12656,4963,2399,2564
9870,15282,2618,7391,2208,12664,4966,2400,2566
9875,15288,2618,7392,2208,12670,4969,2400,2569
9880,15299,2619,7395,2208,12679,4972,2402,2570
9885,15303,2621,7397,2210,12682,4973,2402,2571
9890,15313,2622,7404,2210,12690,4976,2405,2571
9895,15319,2622,7407,2210,12695,4979,2406,2573
9900,15330,2627,7413,2214,12702,4982,2407,2575
9905,15334,2630,7415,2217,12704,4983,2407,2576
9910,15344,2632,7420,2218,12711,4986,2409,2577
9915,15350,2632,7424,2218,12716,4989,2411,2578
9920,15361,2635,7431,2221,12724,4992,2413,2579
9925,15365,2638,7435,2224,12727,4993,2414,2579
9930,15375,2640,7439,2226,12735,4996,2416,2580
9935,15381,2640,7442,2226,12740,4999,2417,2582
9940,15392,2643,7448,2229,12748,5002,2419,2583
9945,15396,2644,7448,2230,12752,5003,2419,2584
9950,15406,2646,7454,2232,12759,5006,2420,2586
9955,15412,2646,7457,2232,12766,5009,2422,2587
9960,15423,2647,7459,2232,12776,5012,2423,2589
9965,15427,2649,7461,2234,12778,5013,2423,2590
9970,15437,2652,7464,2236,12784,5016,2423,2593
9975,15443,2652,7469,2236,12789,5019,2425,2594
9980,15454,2657,7473,2240,12797,5022,2426,2596
9985,15458,2658,7474,2241,12800,5023,2426,2597
9990,15468,2661,7478,2244,12807,5026,2427,2599
9995,15474,2661,7481,2244,12813,5029,2429,2600
10000,15485,2665,7488,2247,12819,5032,2431,2601
10005,15489,2666,7490,2248,12823,5033,2431,2602
10010,15499,2669,7495,2251,12830,5036,2433,2603
10015,15505,2669,7498,2251,12834,5039,2434,2605
10020,15516,2671,7504,2253,12845,5042,2436,2606
10025,15520,2671,7507,2253,12849,5043,2437,2606
10030,15530,2671,7511,2253,12859,5046,2439,2607
10035,15536,2671,7514,2253,12865,5049,2440,2609
10040,15547,2671,7520,2253,12876,5052,2441,2611
10045,15551,2671,7523,2253,12880,5053,2442,2611
10050,15561,2671,7527,2253,12890,5056,2444,2612
10055,15567,2671,7530,2253,12896,5059,2446,2613
10060,15578,2671,7537,2253,12907,5062,2446,2616
10065,15582,2671,7539,2253,12910,5063,2446,2617
10070,15592,2671,7544,2253,12921,5066,2448,2618
10075,15598,2671,7547,2253,12926,5069,2450,2619
10080,15609,2671,7554,2253,12938,5072,2452,2620
10085,15613,2671,7557,2253,12941,5073,2452,2621
10090,15623,2671,7563,2253,12951,5076,2455,2621
10095,15629,2671,7568,2253,12955,5079,2457,2622
10100,15640,2671,7576,2253,12967,5082,2460,2622
10105,15644,2671,7578,2253,12972,5083,2461,2622
10110,15654,2672,7583,2254,12981,5086,2462,2624
10115,15660,2672,7586,2254,12988,5089,2464,2625
10120,15671,2675,7594,2256,12995,5092,2467,2625
10125,15675,2678,7598,2259,12996,5093,2468,2625
10130,15685,2681,7603,2262,13003,5096,2470,2626
10135,15691,2681,7607,2262,13008,5099,2473,2626
10140,15702,2685,7610,2265,13016,5102,2474,2628
10145,15706,2686,7611,2266,13020,5103,2475,2628
10150,15716,2689,7616,2268,13026,5106,2477,2629
10155,15722,2690,7620,2269,13030,5109,2479,2630
10160,15733,2696,7626,2275,13036,5112,2480,2632
10165,15737,2698,7628,2277,13038,5113,2480,2633
10170,15747,2700,7633,2279,13046,5116,2481,2635
10175,15753,2700,7638,2279,13052,5119,2484,2635
10180,15764,2702,7643,2281,13059,5122,2485,2637
10185,15768,2702,7644,2281,13065,5123,2485,2638
10190,15778,2705,7649,2283,13072,5126,2485,2641
10195,15784,2705,7653,2283,13077,5129,2487,2642
10200,15795,2708,7658,2286,13085,5132,2488,2644
10205,15799,2710,7659,2288,13089,5133,2488,2645
10210,15809,2711,7661,2289,13098,5136,2489,2647
10215,15815,2711,7664,2289,13103,5139,2490,2649
10220,15826,2715,7673,2293,13110,5142,2493,2649
10225,15830,2716,7675,2294,13114,5143,2494,2649
10230,15840,2719,7680,2297,13121,5146,2495,2651
10235,15846,2719,7683,2297,13126,5149,2496,2653
10240,15857,2723,7689,2301,13134,5152,2497,2655
10245,15861,2724,7692,2302,13137,5153,2498,2655
10250,15871,2727,7699,2304,13143,5156,2500,2656
10255,15877,2727,7702,2304,13149,5159,2500,2659
10260,15888,2731,7705,2307,13157,5162,2501,2661
10265,15892,2731,7706,2307,13161,5163,2502,2661
10270,15902,2732,7710,2308,13169,5166,2502,2664
10275,15908,2732,7714,2308,13175,5169,2504,2665
10280,15919,2733,7718,2309,13186,5172,2505,2667
10285,15923,2733,7719,2309,13190,5173,2506,2667
10290,15933,2734,7722,2309,13198,5176,2508,2668
10295,15939,2734,7725,2309,13205,5179,2509,2670
10300,15950,2734,7730,2309,13215,5182,2510,2672
10305,15954,2735,7731,2310,13218,5183,2510,2673
10310,15964,2736,7736,2311,13227,5186,2512,2674
10315,15970,2736,7739,2311,13234,5189,2514,2675
10320,15981,2736,7747,2311,13243,5192,2515,2677
10325,15985,2736,7750,2311,13249,5193,2515,2678
10330,15995,2736,7758,2311,13259,5196,2518,2678
10335,16001,2736,7759,2311,13265,5199,2518,2681
10340,16012,2736,7767,2311,13276,5200,2519,2681
10345,16016,2736,7769,2311,13280,5201,2519,2682
10350,16026,2736,7776,2311,13289,5204,2521,2683
10355,16032,2736,7779,2311,13296,5207,2522,2685
10360,16043,2736,7783,2311,13307,5208,2522,2686
10365,16047,2736,7786,2311,13311,5209,2522,2687
10370,16057,2737,7793,2312,13319,5212,2524,2688
10375,16063,2737,7795,2312,13326,5215,2526,2689
10380,16074,2739,7800,2314,13334,5218,2526,2692
10385,16078,2740,7801,2315,13338,5221,2526,2695
10390,16088,2742,7808,2317,13344,5225,2528,2697
10395,16094,2742,7812,2317,13351,5230,2532,2698
10400,16105,2744,7818,2318,13360,5234,2535,2699
10405,16109,2745,7821,2319,13364,5237,2538,2699
10410,16119,2746,7825,2320,13372,5241,2540,2701
10415,16125,2746,7829,2320,13377,5245,2542,2703
10420,16136,2751,7839,2325,13383,5249,2546,2703
10425,16140,2753,7841,2327,13387,5252,2548,2704
10430,16150,2756,7847,2330,13393,5256,2549,2707
10435,16156,2756,7852,2330,13398,5261,2553,2708
10440,16167,2759,7857,2332,13406,5265,2556,2709
10445,16171,2759,7857,2332,13412,5267,2557,2710
10450,16181,2760,7861,2333,13421,5270,2559,2711
10455,16187,2760,7863,2333,13427,5273,2560,2713
10460,16198,2761,7866,2334,13435,5276,2561,2715
10465,16202,2764,7868,2337,13438,5277,2561,2716
10470,16212,2766,7873,2339,13446,5280,2561,2719
10475,16218,2766,7879,2339,13451,5283,2564,2719
10480,16229,2770,7884,2342,13459,5286,2566,2720
10485,16233,2771,7886,2343,13462,5287,2567,2720
10490,16243,2773,7890,2345,13470,5290,2568,2722
10495,16249,2773,7893,2345,13475,5293,2570,2723
10500,16260,2776,7899,2347,13483,5296,2571,2725
10505,16264,2778,7901,2349,13486,5297,2572,2725
10510,16274,2779,7904,2350,13495,5300,2573,2727
10515,16280,2779,7907,2350,13501,5303,2574,2729
10520,16291,2782,7912,2352,13509,5306,2576,2730
10525,16295,2784,7915,2354,13511,5307,2577,2730
10530,16305,2787,7920,2357,13518,5310,2577,2733
10535,16311,2787,7923,2357,13523,5313,2579,2734
10540,16322,2792,7930,2362,13530,5316,2581,2735
10545,16326,2793,7931,2363,13533,5317,2581,2736
10550,16336,2794,7937,2363,13542,5320,2583,2737
10555,16342,2794,7941,2363,13547,5323,2585,2738
10560,16353,2795,7944,2364,13557,5326,2586,2740
10565,16357,2796,7946,2365,13561,5327,2587,2740
10570,16367,2797,7951,2366,13570,5330,2588,2742
10575,16373,2797,7954,2366,13575,5333,2589,2744
10580,16384,2799,7959,2368,13585,5336,2590,2746
10585,16388,2800,7962,2369,13588,5337,2590,2747
10590,16398,2801,7967,2369,13597,5340,2592,2748
10595,16404,2801,7971,2369,13602,5343,2595,2748
10600,16415,2802,7977,2370,13613,5346,2598,2748
10605,16419,2803,7978,2371,13616,5347,2598,2749
10610,16429,2804,7985,2371,13625,5350,2601,2749
10615,16435,2804,7986,2371,13631,5353,2602,2751
10620,16446,2804,7990,2371,13642,5356,2603,2753
10625,16450,2805,7994,2372,13645,5357,2604,2753
10630,16460,2806,7998,2372,13654,5360,2606,2754
10635,16466,2806,8001,2372,13660,5363,2608,2755
10640,16477,2806,8007,2372,13671,5366,2610,2756
10645,16481,2807,8010,2373,13674,5367,2611,2756
10650,16491,2809,8013,2374,13682,5370,2611,2759
10655,16497,2809,8015,2374,13688,5373,2611,2762
10660,16508,2810,8019,2374,13697,5376,2613,2763
10665,16512,2812,8020,2376,13700,5377,2613,2764
10670,16522,2814,8027,2377,13708,5380,2616,2764
10675,16528,2814,8028,2377,13714,5383,2617,2766
10680,16539,2816,8032,2378,13723,5386,2618,2768
10685,16543,2816,8033,2378,13727,5387,2618,2769
10690,16553,2818,8040,2380,13735,5389,2619,2770
10695,16559,2818,8044,2380,13741,5392,2621,2771
10700,16570,2821,8048,2382,13749,5395,2621,2774
10705,16574,2823,8052,2384,13751,5396,2622,2774
10710,16584,2825,8054,2385,13759,5398,2622,2776
10715,16590,2825,8058,2385,13765,5401,2624,2777
10720,16601,2826,8060,2385,13775,5404,2625,2779
10725,16605,2827,8063,2386,13778,5405,2626,2779
10730,16615,2829,8068,2387,13786,5407,2626,2781
10735,16621,2829,8070,2387,13792,5410,2627,2783
10740,16632,2833,8075,2390,13799,5413,2628,2785
10745,16636,2834,8076,2391,13802,5414,2628,2786
10750,16646,2835,8082,2392,13811,5416,2629,2787
10755,16652,2835,8084,2392,13817,5419,2629,2790
10760,16663,2838,8090,2394,13825,5422,2632,2790
10765,16667,2839,8091,2395,13828,5423,2632,2791
10770,16677,2841,8096,2396,13836,5425,2634,2791
10775,16683,2841,8100,2396,13841,5428,2635,2793
10780,16694,2845,8105,2399,13849,5431,2637,2794
10785,16698,2845,8105,2399,13853,5432,2637,2795
10790,16708,2846,8108,2400,13862,5434,2638,2796
10795,16714,2846,8111,2400,13868,5437,2640,2797
10800,16725,2848,8114,2401,13876,5440,2641,2799
10805,16729,2849,8114,2402,13880,5441,2641,2800
10810,16739,2851,8118,2404,13888,5443,2641,2802
10815,16745,2851,8120,2404,13894,5446,2642,2804
10820,16756,2853,8125,2405,13902,5449,2644,2805
10825,16760,2856,8129,2408,13904,5450,2645,2805
10830,16770,2857,8131,2409,13913,5452,2645,2807
10835,16776,2857,8134,2409,13918,5455,2647,2808
10840,16787,2862,8139,2413,13924,5458,2648,2810
10845,16791,2863,8140,2414,13928,5459,2649,2810
10850,16801,2865,8145,2416,13936,5461,2650,2811
10855,16807,2865,8148,2416,13941,5464,2651,2813
10860,16818,2870,8154,2420,13948,5467,2653,2814
10865,16822,2870,8157,2420,13952,5468,2654,2814
10870,16832,2871,8162,2421,13961,5470,2655,2815
10875,16838,2871,8165,2421,13967,5473,2656,2817
10880,16849,2872,8169,2422,13977,5476,2658,2818
10885,16853,2873,8172,2423,13980,5477,2659,2818
10890,16863,2874,8175,2424,13989,5479,2659,2820
10895,16869,2874,8178,2424,13995,5482,2661,2821
10900,16880,2877,8183,2426,14003,5485,2662,2823
10905,16884,2877,8185,2426,14007,5486,2662,2824
10910,16894,2879,8191,2428,14015,5488,2664,2824
10915,16900,2879,8193,2428,14021,5491,2665,2826
10920,16911,2882,8200,2430,14029,5494,2667,2827
10925,16915,2882,8203,2430,14033,5495,2668,2827
10930,16925,2882,8208,2430,14043,5497,2669,2828
10935,16931,2882,8211,2430,14049,5500,2670,2830
10940,16942,2883,8215,2430,14059,5503,2671,2832
10945,16946,2883,8216,2430,14063,5504,2671,2833
10950,16956,2884,8221,2431,14072,5506,2672,2834
10955,16962,2884,8225,2431,14078,5509,2674,2835
10960,16973,2886,8229,2432,14087,5512,2675,2837
10965,16977,2886,8231,2432,14091,5513,2676,2837
10970,16987,2888,8236,2434,14099,5515,2677,2838
10975,16993,2888,8239,2434,14104,5518,2679,2839
10980,17004,2890,8244,2436,14114,5521,2681,2840
10985,17008,2891,8246,2437,14117,5522,2682,2840
10990,17018,2893,8251,2439,14125,5524,2683,2841
10995,17024,2893,8253,2439,14131,5527,2684,2843
11000,17035,2895,8258,2440,14139,5530,2686,2844
11005,17039,2896,8260,2441,14143,5531,2687,2844
11010,17049,2898,8266,2443,14151,5533,2688,2845
11015,17055,2898,8269,2443,14156,5536,2690,2846
11020,17066,2902,8276,2447,14164,5539,2691,2848
11025,17070,2902,8278,2447,14168,5540,2692,2848
11030,17080,2903,8284,2448,14177,5542,2693,2849
11035,17086,2903,8287,2448,14182,5545,2694,2851
11040,17097,2908,8293,2453,14189,5548,2695,2853
11045,17101,2909,8296,2454,14192,5549,2696,2853
11050,17111,2911,8302,2455,14200,5551,2698,2853
11055,17117,2911,8305,2455,14206,5554,2700,2854
11060,17128,2914,8310,2458,14213,5557,2701,2856
11065,17132,2915,8311,2459,14217,5558,2701,2857
11070,17142,2917,8315,2461,14225,5560,2701,2859
11075,17148,2917,8318,2461,14230,5563,2702,2861
11080,17159,2920,8322,2464,14239,5566,2703,2863
11085,17163,2921,8326,2465,14242,5567,2704,2863
11090,17173,2922,8333,2466,14251,5569,2705,2864
11095,17179,2922,8338,2466,14257,5572,2708,2864
11100,17190,2923,8343,2467,14266,5575,2710,2865
11105,17194,2925,8347,2469,14269,5576,2711,2865
11110,17204,2926,8350,2469,14278,5578,2712,2866
11115,17210,2926,8353,2469,14284,5581,2714,2867
11120,17221,2927,8356,2470,14294,5584,2716,2868
11125,17225,2928,8357,2471,14297,5585,2716,2869
11130,17235,2929,8362,2472,14306,5587,2718,2869
11135,17241,2929,8364,2472,14311,5590,2719,2871
11140,17252,2931,8369,2474,14321,5593,2721,2872
11145,17256,2931,8371,2474,14325,5594,2721,2873
11150,17266,2932,8372,2474,14334,5596,2722,2874
11155,17272,2932,8376,2474,14340,5599,2724,2875
11160,17283,2933,8380,2475,14350,5602,2724,2878
11165,17287,2933,8381,2475,14354,5603,2724,2879
11170,17297,2934,8386,2476,14363,5605,2725,2880
11175,17303,2934,8389,2476,14369,5608,2726,2882
11180,17314,2935,8394,2477,14378,5611,2727,2884
11185,17318,2937,8398,2479,14381,5612,2728,2884
11190,17328,2939,8404,2481,14389,5614,2729,2885
11195,17334,2939,8407,2481,14394,5617,2731,2886
11200,17345,2944,8411,2485,14401,5620,2731,2889
11205,17349,2945,8413,2486,14404,5621,2731,2890
11210,17359,2947,8417,2488,14412,5623,2731,2892
11215,17365,2947,8418,2488,14418,5626,2732,2894
11220,17376,2949,8421,2489,14427,5629,2734,2895
11225,17380,2949,8422,2489,14431,5630,2734,2896
11230,17390,2950,8425,2489,14440,5632,2734,2898
11235,17396,2950,8426,2489,14446,5635,2735,2900
11240,17407,2954,8432,2493,14453,5638,2736,2902
11245,17411,2954,8434,2493,14457,5639,2737,2902
11250,17421,2956,8441,2494,14465,5641,2739,2902
11255,17427,2956,8442,2494,14471,5644,2739,2905
11260,17438,2958,8448,2496,14479,5647,2739,2908
11265,17442,2960,8450,2498,14482,5648,2740,2908
11270,17452,2962,8455,2499,14490,5650,2740,2910
11275,17458,2962,8457,2499,14495,5653,2740,2913
11280,17469,2965,8461,2501,14503,5656,2741,2915
11285,17473,2967,8462,2503,14506,5657,2741,2916
11290,17483,2969,8469,2505,14514,5659,2743,2916
11295,17489,2969,8473,2505,14519,5662,2746,2916
11300,17500,2972,8476,2507,14528,5665,2747,2918
11305,17504,2974,8479,2509,14530,5666,2748,2918
11310,17514,2977,8485,2511,14537,5668,2749,2919
11315,17520,2977,8487,2511,14543,5671,2750,2921
11320,17531,2979,8490,2512,14552,5674,2751,2923
11325,17535,2981,8494,2514,14554,5675,2752,2923
11330,17545,2982,8499,2514,14563,5677,2753,2924
11335,17551,2982,8502,2514,14569,5680,2755,2925
11340,17562,2983,8506,2515,14579,5683,2756,2927
11345,17566,2985,8509,2517,14581,5684,2757,2927
11350,17576,2987,8515,2519,14589,5686,2758,2928
11355,17582,2987,8519,2519,14594,5689,2759,2930
11360,17593,2990,8523,2522,14603,5692,2761,2931
11365,17597,2991,8525,2523,14606,5693,2761,2932
11370,17607,2992,8532,2524,14615,5695,2763,2932
11375,17613,2992,8536,2524,14621,5698,2766,2932
11380,17624,2994,8539,2525,14629,5701,2766,2935
11385,17628,2995,8540,2526,14633,5702,2767,2935
11390,17638,2997,8545,2527,14641,5704,2769,2935
11395,17644,2997,8548,2527,14646,5707,2771,2936
11400,17655,3002,8556,2531,14652,5710,2773,2937
11405,17659,3004,8558,2533,14655,5711,2773,2938
11410,17669,3006,8562,2535,14663,5713,2773,2940
11415,17675,3006,8565,2535,14669,5716,2775,2941
11420,17686,3008,8571,2537,14677,5719,2777,2942
11425,17690,3009,8571,2538,14681,5720,2777,2943
11430,17700,3010,8574,2539,14690,5722,2779,2943
11435,17706,3010,8578,2539,14696,5725,2780,2945
11440,17717,3012,8583,2540,14705,5728,2782,2946
11445,17721,3012,8585,2540,14709,5729,2783,2946
11450,17731,3014,8590,2542,14717,5731,2784,2947
11455,17737,3014,8593,2542,14723,5734,2786,2948
11460,17748,3015,8597,2542,14733,5737,2787,2950
11465,17752,3015,8598,2542,14737,5738,2787,2951
11470,17762,3016,8603,2543,14746,5740,2788,2952
11475,17768,3016,8606,2543,14752,5743,2788,2955
11480,17779,3018,8611,2544,14761,5746,2789,2957
11485,17783,3018,8612,2544,14765,5747,2789,2958
11490,17793,3019,8617,2545,14774,5749,2790,2959
11495,17799,3019,8618,2545,14780,5752,2790,2962
11500,17810,3021,8624,2547,14789,5755,2793,2962
11505,17814,3021,8627,2547,14793,5756,2794,2962
11510,17824,3021,8631,2547,14803,5758,2794,2964
11515,17830,3021,8633,2547,14809,5761,2795,2966
11520,17841,3024,8638,2549,14817,5764,2796,2968
11525,17845,3026,8642,2551,14819,5765,2797,2968
11530,17855,3027,8646,2551,14828,5767,2797,2970
11535,17861,3027,8650,2551,14833,5770,2799,2971
11540,17872,3029,8655,2553,14843,5773,2801,2972
11545,17876,3029,8657,2553,14847,5774,2802,2972
11550,17886,3030,8663,2554,14856,5776,2802,2974
11555,17892,3030,8667,2554,14861,5779,2804,2975
11560,17903,3032,8674,2556,14870,5782,2806,2976
11565,17907,3033,8674,2557,14874,5783,2806,2977
11570,17917,3034,8678,2558,14883,5785,2806,2979
11575,17923,3034,8681,2558,14889,5788,2807,2981
11580,17934,3034,8688,2558,14899,5791,2809,2982
11585,17938,3036,8691,2560,14902,5792,2810,2982
11590,17948,3037,8695,2560,14911,5794,2812,2982
11595,17954,3037,8698,2560,14917,5797,2814,2983
11600,17965,3037,8705,2560,14927,5800,2816,2984
11605,17969,3038,8708,2561,14931,5801,2817,2984
11610,17979,3039,8713,2562,14940,5803,2817,2986
11615,17985,3039,8716,2562,14946,5806,2819,2987
11620,17996,3040,8723,2563,14955,5809,2820,2989
11625,18000,3041,8725,2564,14959,5810,2820,2990
11630,18010,3044,8730,2567,14966,5812,2822,2990
11635,18016,3044,8735,2567,14971,5815,2824,2991
11640,18027,3048,8743,2570,14978,5818,2827,2991
11645,18031,3050,8745,2572,14981,5819,2827,2992
11650,18041,3051,8750,2573,14990,5821,2829,2992
11655,18047,3051,8754,2573,14995,5824,2830,2994
11660,18058,3053,8759,2575,15004,5827,2832,2995
11665,18062,3055,8762,2577,15007,5828,2833,2995
11670,18072,3057,8769,2579,15015,5830,2834,2996
11675,18078,3057,8772,2579,15021,5833,2836,2997
11680,18089,3058,8774,2579,15030,5836,2836,3000
11685,18093,3059,8774,2580,15034,5837,2836,3001
11690,18103,3061,8777,2581,15042,5839,2837,3002
11695,18109,3061,8782,2581,15048,5842,2840,3002
11700,18120,3064,8786,2583,15056,5845,2841,3004
11705,18124,3065,8789,2584,15059,5846,2842,3004
11710,18134,3067,8793,2585,15067,5848,2842,3006
11715,18140,3067,8797,2585,15072,5851,2844,3007
11720,18151,3071,8802,2588,15080,5854,2845,3009
11725,18155,3072,8806,2589,15083,5855,2846,3009
11730,18165,3075,8809,2591,15090,5857,2846,3011
11735,18171,3075,8809,2591,15096,5860,2846,3014
11740,18182,3078,8815,2594,15103,5863,2847,3016
11745,18186,3080,8817,2596,15106,5864,2847,3017
11750,18196,3083,8823,2598,15113,5866,2848,3018
11755,18202,3083,8828,2598,15118,5869,2851,3018
11760,18213,3087,8832,2602,15126,5872,2851,3021
11765,18217,3088,8834,2603,15129,5873,2851,3022
11770,18227,3089,8840,2603,15138,5875,2851,3024
11775,18233,3089,8845,2603,15144,5878,2854,3024
11780,18244,3090,8850,2603,15154,5881,2857,3024
11785,18248,3092,8853,2605,15156,5882,2858,3024
11790,18258,3093,8858,2605,15165,5884,2858,3026
11795,18264,3093,8860,2605,15170,5887,2859,3028
11800,18275,3095,8867,2606,15179,5890,2861,3029
11805,18279,3097,8869,2608,15182,5891,2861,3030
11810,18289,3098,8872,2608,15191,5893,2862,3031
11815,18295,3098,8873,2608,15197,5896,2863,3033
11820,18306,3099,8878,2608,15206,5899,2865,3034
11825,18310,3100,8878,2609,15210,5900,2865,3035
11830,18320,3101,8884,2610,15219,5902,2867,3035
11835,18326,3101,8888,2610,15224,5905,2868,3037
11840,18337,3103,8893,2611,15234,5908,2869,3039
11845,18341,3105,8896,2613,15236,5909,2869,3040
11850,18351,3106,8900,2613,15245,5911,2870,3041
11855,18357,3106,8904,2613,15250,5914,2871,3043
11860,18368,3108,8910,2614,15259,5917,2872,3045
11865,18372,3110,8913,2616,15262,5918,2873,3045
11870,18382,3112,8918,2618,15270,5920,2875,3045
11875,18388,3112,8923,2618,15275,5923,2877,3046
11880,18399,3117,8930,2622,15281,5926,2879,3047
11885,18403,3119,8932,2624,15284,5927,2879,3048
11890,18413,3121,8938,2626,15292,5929,2880,3049
11895,18419,3121,8943,2626,15297,5932,2882,3050
11900,18430,3124,8950,2629,15306,5935,2885,3050
11905,18434,3125,8951,2630,15309,5936,2885,3051
11910,18444,3127,8956,2631,15317,5938,2886,3052
11915,18450,3127,8960,2631,15322,5941,2887,3054
11920,18461,3130,8967,2634,15330,5944,2889,3055
11925,18465,3132,8968,2636,15333,5945,2889,3056
11930,18475,3134,8971,2638,15341,5947,2889,3058
11935,18481,3134,8974,2638,15347,5950,2891,3059
11940,18492,3138,8978,2641,15354,5953,2892,3061
11945,18496,3138,8980,2641,15358,5954,2893,3061
11950,18506,3139,8985,2641,15367,5956,2894,3062
11955,18512,3139,8989,2641,15372,5959,2896,3063
11960,18523,3140,8993,2642,15382,5962,2897,3065
11965,18527,3141,8994,2643,15386,5963,2898,3065
11970,18537,3142,8999,2644,15395,5965,2900,3065
11975,18543,3142,9001,2644,15401,5968,2902,3066
11980,18554,3142,9005,2644,15412,5971,2904,3067
11985,18558,3143,9007,2645,15415,5972,2904,3068
11990,18568,3144,9014,2646,15424,5974,2904,3070
11995,18574,3144,9019,2646,15430,5977,2907,3070
12000,18585,3145,9025,2647,15439,5980,2909,3071
12005,18589,3146,9027,2648,15443,5981,2909,3072
12010,18599,3147,9032,2649,15452,5983,2910,3073
12015,18605,3147,9034,2649,15458,5986,2912,3074
12020,18616,3147,9038,2649,15468,5989,2913,3076
12025,18620,3149,9041,2651,15471,5990,2914,3076
12030,18630,3150,9044,2651,15480,5992,2916,3076
12035,18636,3150,9046,2651,15486,5995,2918,3077
12040,18647,3150,9053,2651,15496,5998,2920,3078
12045,18651,3151,9056,2652,15500,5999,2921,3078
12050,18661,3153,9060,2654,15508,6001,2921,3080
12055,18667,3153,9064,2654,15513,6004,2922,3082
12060,18678,3157,9072,2658,15521,6007,2925,3082
12065,18682,3157,9072,2658,15525,6008,2925,3083
12070,18692,3160,9076,2660,15532,6010,2925,3085
12075,18698,3160,9078,2660,15538,6013,2926,3087
12080,18709,3161,9082,2660,15548,6016,2928,3088
12085,18713,3161,9083,2660,15552,6017,2928,3089
12090,18723,3163,9088,2662,15560,6019,2929,3090
12095,18729,3163,9093,2662,15565,6022,2931,3091
12100,18740,3168,9101,2667,15571,6025,2933,3092
12105,18744,3171,9104,2670,15573,6026,2934,3092
12110,18754,3173,9109,2672,15581,6028,2935,3093
12115,18760,3173,9113,2672,15586,6031,2936,3095
12120,18771,3176,9115,2674,15595,6034,2937,3097
12125,18775,3177,9117,2675,15598,6035,2937,3098
12130,18785,3178,9119,2676,15607,6037,2937,3100
12135,18791,3178,9123,2676,15613,6040,2939,3101
12140,18802,3180,9132,2677,15622,6043,2942,3101
12145,18806,3180,9133,2677,15626,6044,2942,3102
12150,18816,3181,9137,2678,15635,6046,2944,3102
12155,18822,3181,9139,2678,15641,6049,2944,3105
12160,18833,3182,9142,2678,15651,6052,2946,3106
12165,18837,3182,9144,2678,15655,6053,2947,3106
12170,18847,3183,9152,2679,15664,6055,2948,3107
12175,18853,3183,9156,2679,15670,6058,2951,3107
12180,18864,3185,9162,2680,15679,6061,2953,3108
12185,18868,3186,9164,2681,15682,6062,2953,3109
12190,18878,3188,9172,2683,15690,6064,2955,3109
12195,18884,3188,9176,2683,15696,6067,2957,3110
12200,18895,3190,9179,2684,15705,6070,2958,3112
12205,18899,3190,9181,2684,15709,6071,2958,3113
12210,18909,3192,9189,2686,15717,6073,2960,3113
12215,18915,3192,9191,2686,15723,6076,2960,3116
12220,18926,3195,9195,2688,15731,6079,2961,3118
12225,18930,3196,9197,2689,15734,6080,2962,3118
12230,18940,3198,9201,2690,15742,6082,2963,3119
12235,18946,3198,9206,2690,15747,6085,2965,3120
12240,18957,3201,9209,2692,15756,6088,2966,3122
12245,18961,3202,9210,2693,15759,6089,2966,3123
12250,18971,3203,9217,2693,15768,6091,2968,3123
12255,18977,3203,9220,2693,15774,6094,2969,3125
12260,18988,3203,9226,2693,15784,6097,2971,3126
12265,18992,3204,9228,2694,15788,6098,2972,3126
12270,19002,3205,9230,2694,15797,6100,2972,3128
12275,19008,3205,9231,2694,15802,6103,2972,3131
12280,19019,3206,9236,2695,15813,6106,2973,3133
12285,19023,3206,9238,2695,15817,6107,2974,3133
12290,19033,3207,9243,2695,15826,6109,2975,3134
12295,19039,3207,9246,2695,15832,6112,2977,3135
12300,19050,3208,9252,2696,15842,6115,2979,3136
12305,19054,3209,9254,2697,15845,6116,2980,3136
12310,19064,3210,9256,2697,15854,6118,2980,3138
12315,19070,3210,9259,2697,15859,6121,2981,3140
12320,19081,3212,9266,2699,15868,6124,2983,3141
12325,19085,3213,9267,2700,15872,6125,2983,3142
12330,19095,3214,9276,2700,15881,6127,2985,3142
12335,19101,3214,9279,2700,15887,6130,2987,3143
12340,19112,3214,9283,2700,15898,6133,2988,3145
12345,19116,3214,9284,2700,15902,6134,2988,3146
12350,19126,3216,9292,2702,15910,6136,2990,3146
12355,19132,3216,9295,2702,15916,6139,2992,3147
12360,19143,3218,9302,2704,15924,6142,2995,3147
12365,19147,3219,9303,2705,15928,6143,2996,3147
12370,19157,3221,9306,2706,15936,6145,2997,3148
12375,19163,3221,9309,2706,15941,6148,2997,3151
12380,19174,3224,9312,2708,15950,6151,2998,3153
12385,19178,3225,9314,2709,15953,6152,2998,3154
12390,19188,3227,9321,2711,15961,6154,3000,3154
12395,19194,3227,9326,2711,15966,6157,3002,3155
12400,19205,3231,9333,2714,15973,6160,3004,3156
12405,19209,3232,9334,2715,15977,6161,3004,3157
12410,19219,3233,9339,2716,15986,6163,3005,3158
12415,19225,3233,9342,2716,15991,6166,3007,3159
12420,19236,3236,9346,2718,16000,6169,3008,3161
12425,19240,3236,9346,2718,16004,6170,3008,3162
12430,19250,3237,9350,2718,16013,6172,3008,3164
12435,19256,3237,9353,2718,16018,6175,3009,3166
12440,19267,3242,9358,2722,16025,6178,3011,3167
12445,19271,3243,9360,2723,16028,6179,3012,3167
12450,19281,3245,9365,2725,16036,6181,3012,3169
12455,19287,3245,9368,2725,16042,6184,3013,3171
12460,19298,3247,9371,2726,16050,6187,3014,3173
12465,19302,3250,9373,2729,16052,6188,3014,3174
12470,19312,3252,9377,2730,16060,6190,3015,3175
12475,19318,3252,9380,2730,16065,6193,3016,3177
12480,19329,3255,9385,2732,16073,6196,3018,3178
12485,19333,3257,9388,2734,16076,6197,3019,3178
12490,19343,3259,9394,2736,16084,6199,3021,3178
12495,19349,3259,9397,2736,16089,6202,3022,3180
12500,19360,3263,9402,2739,16097,6205,3023,3182
12505,19364,3263,9403,2739,16101,6206,3023,3183
12510,19374,3266,9409,2742,16108,6208,3023,3185
12515,19380,3266,9412,2742,16113,6211,3023,3188
12520,19391,3269,9417,2745,16121,6214,3024,3190
12525,19395,3270,9418,2746,16125,6215,3024,3191
12530,19405,3272,9423,2747,16133,6217,3025,3192
12535,19411,3272,9426,2747,16139,6220,3026,3194
12540,19422,3275,9433,2749,16146,6223,3029,3194
12545,19426,3277,9434,2751,16149,6224,3029,3195
12550,19436,3280,9439,2753,16156,6226,3030,3196
12555,19442,3280,9443,2753,16162,6229,3032,3197
12560,19453,3281,9449,2753,16171,6232,3034,3198
12565,19457,3283,9452,2755,16174,6233,3035,3198
12570,19467,3284,9456,2756,16183,6235,3035,3200
12575,19473,3284,9460,2756,16189,6238,3037,3201
12580,19484,3285,9464,2756,16199,6241,3038,3203
12585,19488,3286,9467,2757,16202,6242,3039,3203
12590,19498,3287,9472,2758,16211,6244,3040,3204
12595,19504,3287,9473,2758,16216,6247,3040,3207
12600,19515,3290,9478,2760,16224,6250,3040,3210
12605,19519,3293,9481,2763,16226,6251,3040,3211
12610,19529,3294,9487,2764,16235,6253,3040,3213
12615,19535,3294,9490,2764,16241,6256,3043,3213
12620,19546,3295,9496,2764,16250,6259,3045,3214
12625,19550,3298,9499,2767,16252,6260,3046,3214
12630,19560,3299,9502,2767,16261,6262,3048,3214
12635,19566,3299,9505,2767,16266,6265,3049,3216
12640,19577,3301,9510,2768,16275,6268,3051,3217
12645,19581,3303,9513,2770,16278,6269,3052,3217
12650,19591,3304,9517,2770,16287,6271,3052,3219
12655,19597,3304,9520,2770,16293,6274,3053,3221
12660,19608,3308,9525,2774,16300,6277,3053,3224
12665,19612,3308,9526,2774,16304,6278,3054,3224
12670,19622,3309,9529,2774,16313,6280,3055,3225
12675,19628,3309,9533,2774,16318,6283,3058,3225
12680,19639,3313,9540,2777,16325,6286,3060,3226
12685,19643,3315,9541,2779,16328,6287,3060,3227
12690,19653,3318,9544,2781,16335,6289,3061,3228
12695,19659,3318,9548,2781,16341,6292,3063,3229
12700,19670,3320,9554,2783,16349,6295,3064,3231
12705,19674,3322,9556,2785,16352,6296,3064,3232
12710,19684,3323,9559,2785,16361,6298,3064,3234
12715,19690,3323,9563,2785,16367,6301,3066,3235
12720,19701,3326,9570,2788,16375,6304,3068,3236
12725,19705,3326,9571,2788,16379,6305,3069,3236
12730,19715,3327,9577,2788,16388,6307,3071,3236
12735,19721,3327,9578,2788,16394,6310,3072,3238
12740,19732,3330,9585,2790,16401,6313,3073,3240
12745,19736,3332,9587,2792,16404,6314,3074,3240
12750,19746,3335,9595,2795,16411,6316,3076,3240
12755,19752,3335,9599,2795,16416,6319,3079,3240
12760,19763,3336,9604,2796,16426,6322,3080,3242
12765,19767,3337,9605,2797,16430,6323,3080,3243
12770,19777,3338,9610,2798,16439,6325,3081,3244
12775,19783,3338,9613,2798,16445,6328,3083,3245
12780,19794,3339,9617,2799,16454,6331,3084,3247
12785,19798,3340,9620,2800,16458,6332,3085,3247
12790,19808,3340,9627,2800,16468,6334,3087,3247
12795,19814,3340,9630,2800,16474,6337,3089,3248
12800,19825,3340,9634,2800,16485,6340,3090,3250
12805,19829,3340,9636,2800,16489,6341,3091,3250
12810,19839,3340,9641,2800,16499,6343,3093,3250
12815,19845,3340,9645,2800,16505,6346,3095,3251
12820,19856,3340,9651,2800,16516,6349,3096,3253
12825,19860,3340,9653,2800,16520,6350,3096,3254
12830,19870,3340,9659,2800,16530,6352,3097,3255
12835,19876,3340,9662,2800,16536,6355,3100,3255
12840,19887,3340,9666,2800,16547,6358,3101,3257
12845,19891,3340,9669,2800,16551,6359,3101,3258
12850,19901,3340,9674,2800,16561,6361,3103,3258
12855,19907,3340,9676,2800,16567,6364,3104,3260
12860,19918,3342,9680,2801,16576,6367,3105,3262
12865,19922,3343,9682,2802,16579,6368,3105,3263
12870,19932,3343,9686,2802,16589,6370,3106,3264
12875,19938,3343,9689,2802,16595,6373,3108,3265
12880,19949,3345,9693,2804,16604,6376,3110,3266
12885,19953,3346,9696,2805,16607,6377,3111,3266
12890,19963,3347,9698,2805,16616,6379,3111,3268
12895,19969,3347,9701,2805,16621,6382,3112,3270
12900,19980,3350,9707,2808,16630,6385,3114,3271
12905,19984,3350,9709,2808,16634,6386,3115,3271
12910,19994,3351,9711,2808,16643,6388,3115,3273
12915,20000,3351,9714,2808,16648,6391,3117,3274
12920,20011,3355,9720,2812,16655,6394,3118,3276
12925,20015,3357,9722,2814,16658,6395,3118,3277
12930,20025,3359,9728,2816,16666,6397,3119,3278
12935,20031,3359,9730,2816,16672,6400,3120,3280
12940,20042,3361,9735,2817,16680,6403,3122,3281
12945,20046,3362,9737,2818,16684,6404,3123,3281
12950,20056,3364,9743,2820,16692,6406,3125,3281
12955,20062,3364,9748,2820,16697,6409,3127,3282
12960,20073,3366,9754,2822,16707,6412,3130,3282
12965,20077,3367,9756,2823,16710,6413,3131,3282
12970,20087,3369,9762,2824,16718,6415,3132,3283
12975,20093,3369,9765,2824,16723,6418,3132,3286
12980,20104,3374,9772,2828,16729,6421,3134,3287
12985,20108,3376,9773,2830,16732,6422,3134,3288
12990,20118,3377,9774,2830,16741,6424,3134,3290
12995,20124,3377,9777,2830,16747,6427,3136,3291
13000,20135,3379,9781,2831,16755,6430,3137,3293
13005,20139,3381,9784,2833,16758,6431,3137,3294
13010,20149,3383,9787,2834,16766,6433,3138,3295
13015,20155,3383,9790,2834,16772,6436,3140,3296
13020,20166,3385,9794,2835,16781,6439,3142,3297
13025,20170,3385,9794,2835,16785,6440,3142,3298
13030,20180,3387,9799,2836,16793,6442,3143,3299
13035,20186,3387,9802,2836,16799,6445,3146,3299
13040,20197,3390,9808,2838,16806,6448,3147,3301
13045,20201,3392,9810,2840,16809,6449,3148,3301
13050,20211,3394,9814,2841,16817,6451,3150,3301
13055,20217,3394,9818,2841,16822,6454,3152,3302
13060,20228,3398,9822,2845,16830,6457,3153,3304
13065,20232,3398,9824,2845,16834,6458,3153,3305
13070,20242,3400,9829,2846,16842,6460,3154,3306
13075,20248,3400,9831,2846,16848,6463,3155,3308
13080,20259,3403,9836,2848,16855,6466,3157,3309
13085,20263,3404,9836,2849,16859,6467,3157,3310
13090,20273,3407,9841,2852,16866,6469,3158,3311
13095,20279,3407,9844,2852,16872,6472,3160,3312
13100,20290,3407,9846,2852,16883,6475,3161,3314
13105,20294,3407,9846,2852,16887,6476,3161,3315
13110,20304,3408,9851,2853,16896,6478,3162,3316
13115,20310,3408,9855,2853,16902,6481,3165,3316
13120,20321,3409,9858,2854,16912,6484,3165,3319
13125,20325,3409,9861,2854,16916,6485,3166,3319
13130,20335,3410,9867,2855,16925,6487,3168,3319
13135,20341,3410,9869,2855,16931,6490,3170,3320
13140,20352,3410,9873,2855,16941,6493,3171,3322
13145,20356,3412,9874,2857,16944,6494,3171,3323
13150,20366,3413,9879,2858,16953,6496,3172,3324
13155,20372,3413,9883,2858,16959,6499,3175,3324
13160,20383,3413,9890,2858,16969,6502,3178,3324
13165,20387,3415,9892,2860,16972,6503,3178,3325
13170,20397,3416,9899,2860,16981,6505,3180,3325
13175,20403,3416,9900,2860,16987,6508,3181,3327
13180,20414,3416,9906,2860,16997,6511,3184,3327
13185,20418,3417,9907,2861,17001,6512,3184,3328
13190,20428,3418,9912,2861,17010,6514,3185,3329
13195,20434,3418,9915,2861,17016,6517,3186,3331
13200,20445,3419,9920,2861,17025,6520,3188,3332
13205,20449,3421,9922,2863,17028,6521,3189,3332
13210,20459,3423,9924,2864,17036,6523,3189,3334
13215,20465,3423,9929,2864,17041,6526,3191,3335
13220,20476,3428,9934,2869,17048,6529,3191,3338
13225,20480,3429,9936,2870,17051,6530,3192,3338
13230,20490,3431,9941,2872,17059,6532,3193,3339
13235,20496,3431,9946,2872,17065,6535,3196,3339
13240,20507,3433,9951,2873,17074,6538,3198,3340
13245,20511,3434,9952,2874,17077,6539,3198,3341
13250,20521,3437,9958,2877,17084,6541,3198,3343
13255,20527,3437,9962,2877,17089,6544,3201,3343
13260,20538,3440,9964,2879,17098,6547,3201,3346
13265,20542,3441,9966,2880,17101,6548,3202,3346
13270,20552,3443,9972,2881,17109,6550,3203,3347
13275,20558,3443,9973,2881,17115,6553,3204,3349
13280,20569,3445,9978,2883,17124,6556,3207,3349
13285,20573,3446,9980,2884,17127,6557,3207,3350
13290,20583,3448,9984,2885,17135,6559,3208,3351
13295,20589,3448,9985,2885,17141,6562,3209,3353
13300,20600,3452,9992,2889,17148,6565,3210,3355
13305,20604,3454,9995,2891,17150,6566,3210,3356
13310,20614,3457,10005,2894,17157,6568,3212,3356
13315,20620,3457,10009,2894,17163,6571,3214,3357
13320,20631,3460,10016,2897,17171,6574,3216,3358
13325,20635,3461,10018,2898,17174,6575,3216,3359
13330,20645,3462,10021,2899,17183,6577,3217,3360
13335,20651,3462,10023,2899,17189,6580,3219,3361
13340,20662,3464,10029,2901,17197,6583,3221,3362
13345,20666,3465,10031,2902,17201,6584,3222,3362
13350,20676,3468,10036,2904,17208,6586,3222,3364
13355,20682,3468,10039,2904,17214,6589,3223,3366
13360,20693,3470,10043,2905,17222,6592,3224,3368
13365,20697,3472,10044,2907,17225,6593,3224,3369
13370,20707,3474,10049,2909,17233,6595,3225,3370
13375,20713,3474,10050,2909,17238,6598,3225,3373
13380,20724,3476,10054,2911,17248,6601,3227,3374
13385,20728,3476,10055,2911,17252,6602,3228,3374
13390,20738,3479,10062,2914,17259,6604,3229,3375
13395,20744,3479,10067,2914,17264,6607,3232,3375
13400,20755,3482,10070,2917,17272,6610,3232,3378
13405,20759,3484,10072,2919,17275,6611,3233,3378
13410,20769,3485,10078,2920,17284,6613,3233,3380
13415,20775,3485,10079,2920,17290,6616,3234,3382
13420,20786,3486,10083,2921,17300,6619,3235,3384
13425,20790,3486,10085,2921,17304,6620,3235,3385
13430,20800,3487,10091,2921,17313,6622,3236,3386
13435,20806,3487,10094,2921,17318,6625,3237,3388
13440,20817,3489,10101,2923,17328,6628,3239,3389
13445,20821,3489,10103,2923,17332,6629,3240,3389
13450,20831,3490,10108,2923,17341,6631,3242,3389
13455,20837,3490,10112,2923,17347,6634,3244,3390
13460,20848,3490,10119,2923,17357,6637,3245,3392
13465,20852,3491,10121,2924,17361,6638,3245,3393
13470,20862,3492,10126,2924,17370,6640,3246,3394
13475,20868,3492,10129,2924,17375,6643,3248,3395
13480,20879,3493,10133,2925,17385,6646,3248,3398
13485,20883,3494,10134,2926,17389,6647,3248,3399
13490,20893,3495,10138,2927,17398,6649,3249,3400
13495,20899,3495,10141,2927,17403,6652,3250,3402
13500,20910,3497,10149,2929,17413,6655,3253,3402
13505,20914,3497,10152,2929,17417,6656,3254,3402
13510,20924,3499,10155,2930,17425,6658,3256,3402
13515,20930,3499,10157,2930,17430,6661,3257,3404
13520,20941,3503,10163,2934,17437,6664,3258,3406
13525,20945,3504,10163,2935,17441,6665,3258,3407
13530,20955,3506,10168,2936,17449,6667,3259,3408
13535,20961,3506,10169,2936,17455,6670,3259,3411
13540,20972,3508,10175,2937,17464,6673,3262,3411
13545,20976,3509,10177,2938,17467,6674,3262,3412
13550,20986,3511,10181,2939,17475,6676,3262,3414
13555,20992,3511,10184,2939,17481,6679,3263,3416
13560,21003,3513,10189,2941,17490,6682,3265,3417
13565,21007,3515,10192,2943,17492,6683,3266,3417
13570,21017,3516,10193,2943,17501,6685,3266,3419
13575,21023,3516,10196,2943,17506,6688,3267,3421
13580,21034,3520,10200,2946,17514,6691,3268,3423
13585,21038,3521,10201,2947,17517,6692,3268,3424
13590,21048,3522,10207,2948,17526,6694,3270,3424
13595,21054,3522,10211,2948,17531,6697,3272,3425
13600,21065,3525,10216,2951,17540,6700,3273,3427
13605,21069,3525,10216,2951,17544,6701,3273,3428
13610,21079,3527,10221,2953,17552,6703,3274,3429
13615,21085,3527,10225,2953,17557,6706,3275,3431
13620,21096,3530,10230,2956,17566,6709,3278,3431
13625,21100,3530,10231,2956,17570,6710,3278,3432
13630,21110,3532,10235,2957,17578,6712,3278,3434
13635,21116,3532,10239,2957,17584,6715,3281,3434
13640,21127,3534,10244,2958,17592,6718,3284,3434
13645,21131,3536,10247,2960,17595,6719,3285,3434
13650,21141,3538,10252,2962,17603,6721,3285,3436
13655,21147,3538,10253,2962,17609,6724,3285,3439
13660,21158,3540,10259,2964,17617,6727,3287,3440
13665,21162,3542,10260,2966,17620,6728,3287,3441
13670,21172,3543,10263,2966,17629,6730,3288,3442
13675,21178,3543,10266,2966,17634,6733,3289,3444
13680,21189,3546,10272,2969,17643,6736,3290,3446
13685,21193,3546,10272,2969,17647,6737,3290,3447
13690,21203,3548,10276,2970,17655,6739,3291,3448
13695,21209,3548,10279,2970,17660,6742,3293,3449
13700,21220,3552,10286,2973,17667,6745,3295,3450
13705,21224,3554,10289,2975,17670,6746,3296,3450
13710,21234,3556,10296,2977,17678,6748,3297,3451
13715,21240,3556,10299,2977,17684,6751,3299,3452
13720,21251,3559,10306,2980,17691,6754,3300,3454
13725,21255,3561,10308,2982,17694,6755,3301,3454
13730,21265,3563,10314,2984,17702,6757,3302,3455
13735,21271,3563,10316,2984,17708,6760,3303,3457
13740,21282,3564,10317,2984,17718,6763,3304,3459
13745,21286,3565,10320,2985,17721,6764,3305,3459
13750,21296,3567,10327,2986,17729,6766,3306,3460
13755,21302,3567,10327,2986,17735,6769,3306,3463
13760,21313,3569,10333,2988,17744,6771,3308,3463
13765,21317,3569,10333,2988,17748,6772,3308,3464
13770,21327,3570,10335,2988,17757,6774,3308,3466
13775,21333,3570,10339,2988,17762,6777,3309,3468
13780,21344,3575,10346,2992,17768,6779,3310,3469
13785,21348,3577,10348,2994,17771,6780,3311,3469
13790,21358,3579,10351,2996,17779,6782,3312,3470
13795,21364,3579,10355,2996,17785,6785,3315,3470
13800,21375,3582,10360,2998,17793,6787,3315,3472
13805,21379,3583,10362,2999,17796,6788,3315,3473
13810,21389,3586,10367,3002,17803,6790,3316,3474
13815,21395,3586,10371,3002,17809,6793,3318,3475
13820,21406,3589,10377,3004,17816,6795,3319,3476
13825,21410,3590,10378,3005,17820,6796,3319,3477
13830,21420,3591,10382,3006,17829,6798,3319,3479
13835,21426,3591,10383,3006,17835,6801,3319,3482
13840,21437,3595,10391,3009,17841,6803,3321,3482
13845,21441,3596,10391,3010,17845,6804,3321,3483
13850,21451,3598,10398,3012,17853,6806,3322,3484
13855,21457,3598,10401,3012,17859,6809,3325,3484
13860,21468,3602,10409,3015,17865,6812,3327,3485
13865,21472,3604,10412,3017,17868,6813,3328,3485
13870,21482,3605,10419,3018,17877,6815,3329,3486
13875,21488,3605,10421,3018,17883,6818,3331,3487
13880,21499,3605,10424,3018,17894,6821,3332,3489
13885,21503,3606,10427,3019,17897,6822,3333,3489
13890,21513,3607,10429,3019,17906,6824,3334,3490
13895,21519,3607,10431,3019,17912,6827,3334,3493
13900,21530,3608,10438,3020,17922,6830,3336,3494
13905,21534,3609,10440,3021,17925,6831,3336,3495
13910,21544,3610,10443,3021,17934,6833,3337,3496
13915,21550,3610,10447,3021,17939,6836,3338,3498
13920,21561,3612,10452,3023,17949,6839,3339,3500
13925,21565,3612,10454,3023,17953,6840,3340,3500
13930,21575,3613,10462,3024,17962,6842,3342,3500
13935,21581,3613,10465,3024,17968,6845,3343,3502
13940,21592,3614,10472,3025,17978,6848,3344,3504
13945,21596,3614,10473,3025,17982,6849,3344,3505
13950,21606,3615,10479,3025,17991,6851,3346,3505
13955,21612,3615,10484,3025,17996,6854,3349,3505
13960,21623,3617,10490,3027,18006,6857,3350,3507
13965,21627,3617,10491,3027,18010,6858,3350,3508
13970,21637,3618,10494,3028,18019,6860,3350,3510
13975,21643,3618,10499,3028,18024,6863,3353,3510
13980,21654,3621,10506,3031,18032,6866,3355,3511
13985,21658,3623,10508,3033,18035,6867,3355,3512
13990,21668,3626,10514,3036,18042,6869,3357,3512
13995,21674,3626,10516,3036,18048,6872,3359,3513
14000,21685,3628,10521,3037,18056,6875,3360,3515
14005,21689,3630,10524,3039,18059,6876,3361,3515
14010,21699,3632,10528,3040,18067,6878,3362,3516
14015,21705,3632,10533,3040,18073,6881,3365,3516
14020,21716,3634,10537,3042,18082,6884,3366,3518
14025,21720,3636,10540,3044,18084,6885,3366,3519
14030,21730,3638,10543,3045,18092,6887,3367,3520
14035,21736,3638,10545,3045,18098,6890,3367,3523
14040,21747,3640,10550,3046,18107,6893,3369,3524
14045,21751,3640,10550,3046,18111,6894,3369,3525
14050,21761,3643,10556,3049,18118,6896,3371,3525
14055,21767,3643,10559,3049,18124,6899,3373,3526
14060,21778,3646,10565,3052,18131,6902,3375,3527
14065,21782,3648,10566,3054,18134,6903,3375,3528
14070,21792,3649,10570,3055,18143,6905,3375,3530
14075,21798,3649,10572,3055,18149,6908,3376,3532
14080,21809,3650,10575,3055,18158,6911,3378,3533
14085,21813,3651,10575,3056,18162,6912,3378,3534
14090,21823,3654,10581,3059,18169,6914,3378,3536
14095,21829,3654,10585,3059,18174,6917,3380,3537
14100,21840,3658,10593,3063,18181,6920,3382,3538
14105,21844,3661,10597,3066,18183,6921,3383,3538
14110,21854,3663,10603,3068,18191,6923,3384,3539
14115,21860,3663,10606,3068,18196,6926,3384,3542
14120,21871,3667,10612,3071,18204,6929,3386,3543
14125,21875,3667,10612,3071,18208,6930,3386,3544
14130,21885,3669,10619,3073,18216,6932,3387,3545
14135,21891,3669,10623,3073,18222,6935,3388,3547
14140,21902,3672,10629,3076,18230,6938,3389,3549
14145,21906,3672,10629,3076,18234,6939,3389,3550
14150,21916,3673,10635,3077,18243,6941,3391,3550
14155,21922,3673,10639,3077,18249,6944,3393,3551
14160,21933,3675,10645,3079,18258,6947,3395,3552
14165,21937,3676,10648,3080,18261,6948,3396,3552
14170,21947,3676,10653,3080,18271,6950,3397,3553
14175,21953,3676,10657,3080,18277,6953,3399,3554
14180,21964,3676,10661,3080,18288,6956,3402,3554
14185,21968,3676,10663,3080,18292,6957,3403,3554
14190,21978,3676,10667,3080,18302,6959,3404,3555
14195,21984,3676,10671,3080,18308,6962,3406,3556
14200,21995,3676,10675,3080,18319,6965,3406,3559
14205,21999,3676,10676,3080,18323,6966,3406,3560
14210,22009,3676,10681,3080,18333,6968,3408,3560
14215,22015,3676,10685,3080,18339,6971,3409,3562
14220,22026,3676,10689,3080,18350,6974,3411,3563
14225,22030,3676,10691,3080,18354,6975,3411,3564
14230,22040,3677,10695,3080,18363,6977,3411,3566
14235,22046,3677,10697,3080,18368,6980,3411,3569
14240,22057,3679,10703,3082,18377,6983,3412,3571
14245,22061,3681,10705,3084,18380,6984,3412,3572
14250,22071,3682,10709,3084,18389,6986,3412,3574
14255,22077,3682,10710,3084,18395,6989,3412,3577
14260,22088,3682,10715,3084,18406,6992,3414,3578
14265,22092,3682,10718,3084,18410,6993,3415,3578
14270,22102,3684,10721,3086,18418,6995,3415,3580
14275,22108,3684,10724,3086,18424,6998,3417,3581
14280,22119,3688,10731,3089,18430,7001,3418,3583
14285,22123,3690,10733,3091,18433,7002,3418,3584
14290,22133,3691,10736,3091,18442,7004,3420,3584
14295,22139,3691,10738,3091,18447,7007,3421,3586
14300,22150,3693,10741,3092,18457,7010,3423,3587
14305,22154,3694,10742,3093,18460,7011,3423,3588
14310,22164,3696,10747,3094,18468,7013,3423,3590
14315,22170,3696,10749,3094,18474,7016,3424,3592
14320,22181,3699,10754,3096,18481,7019,3425,3594
14325,22185,3701,10756,3098,18484,7020,3426,3594
14330,22195,3704,10759,3100,18491,7022,3426,3596
14335,22201,3704,10761,3100,18497,7025,3426,3599
14340,22212,3707,10768,3102,18505,7028,3428,3600
14345,22216,3707,10768,3102,18509,7029,3428,3601
14350,22226,3708,10772,3103,18518,7031,3429,3602
14355,22232,3708,10776,3103,18523,7034,3431,3603
14360,22243,3711,10779,3105,18532,7037,3432,3605
14365,22247,3712,10781,3106,18535,7038,3432,3606
14370,22257,3715,10785,3108,18542,7040,3433,3607
14375,22263,3715,10787,3108,18548,7043,3433,3610
14380,22274,3717,10793,3110,18556,7046,3434,3612
14385,22278,3718,10796,3111,18560,7047,3435,3612
14390,22288,3720,10801,3113,18568,7049,3437,3612
14395,22294,3720,10801,3113,18574,7052,3437,3615
14400,22305,3722,10805,3115,18582,7055,3438,3617
14405,22309,3725,10807,3118,18584,7056,3438,3618
14410,22319,3726,10812,3118,18593,7058,3439,3619
14415,22325,3726,10816,3118,18598,7061,3442,3619
14420,22336,3729,10821,3120,18607,7063,3444,3619
14425,22340,3729,10822,3120,18611,7064,3444,3620
14430,22350,3730,10826,3120,18620,7066,3444,3622
14435,22356,3730,10828,3120,18625,7069,3445,3624
14440,22367,3732,10832,3122,18635,7071,3445,3626
14445,22371,3733,10834,3123,18638,7072,3446,3626
14450,22381,3736,10841,3125,18645,7074,3447,3627
14455,22387,3736,10844,3125,18651,7077,3448,3629
14460,22398,3740,10852,3129,18657,7079,3449,3630
14465,22402,3742,10854,3131,18660,7080,3450,3630
14470,22412,3743,10859,3131,18669,7082,3451,3631
14475,22418,3743,10861,3131,18675,7085,3452,3633
14480,22429,3746,10867,3134,18682,7087,3453,3634
14485,22433,3747,10868,3135,18686,7088,3454,3634
14490,22443,3749,10873,3136,18694,7090,3454,3636
14495,22449,3749,10877,3136,18700,7093,3457,3636
14500,22460,3752,10882,3138,18707,7095,3459,3636
14505,22464,3754,10883,3140,18710,7096,3459,3637
14510,22474,3756,10888,3142,18718,7098,3459,3639
14515,22480,3756,10890,3142,18724,7101,3460,3641
14520,22491,3757,10894,3142,18733,7104,3461,3643
14525,22495,3759,10895,3144,18736,7105,3461,3644
14530,22505,3761,10899,3145,18744,7107,3461,3646
14535,22511,3761,10903,3145,18750,7110,3463,3647
14540,22522,3764,10908,3147,18757,7113,3465,3648
14545,22526,3765,10908,3148,18761,7114,3465,3649
14550,22536,3766,10912,3149,18770,7116,3466,3650
14555,22542,3766,10917,3149,18775,7119,3469,3650
14560,22553,3769,10923,3152,18784,7122,3472,3650
14565,22557,3769,10924,3152,18788,7123,3472,3651
14570,22567,3772,10930,3154,18795,7125,3473,3652
14575,22573,3772,10934,3154,18800,7128,3474,3654
14580,22584,3775,10940,3157,18808,7131,3475,3656
14585,22588,3778,10944,3160,18810,7132,3476,3656
14590,22598,3779,10947,3161,18819,7134,3476,3658
14595,22604,3779,10950,3161,18824,7137,3478,3659
14600,22615,3781,10953,3163,18833,7140,3478,3662
14605,22619,3783,10955,3165,18836,7141,3478,3663
14610,22629,3784,10962,3165,18845,7143,3479,3664
14615,22635,3784,10966,3165,18850,7146,3480,3666
14620,22646,3786,10972,3167,18859,7149,3482,3667
14625,22650,3787,10974,3168,18863,7150,3483,3667
14630,22660,3788,10976,3168,18872,7152,3483,3669
14635,22666,3788,10981,3168,18877,7155,3485,3670
14640,22677,3789,10987,3169,18887,7158,3487,3671
14645,22681,3790,10988,3170,18891,7159,3487,3672
14650,22691,3791,10993,3171,18900,7161,3487,3674
14655,22697,3791,10995,3171,18905,7164,3487,3677
14660,22708,3793,11001,3173,18915,7167,3488,3679
14665,22712,3793,11003,3173,18919,7168,3488,3680
14670,22722,3793,11007,3173,18929,7170,3488,3682
14675,22728,3793,11009,3173,18935,7173,3489,3684
14680,22739,3793,11015,3173,18946,7176,3490,3686
14685,22743,3793,11017,3173,18950,7177,3490,3687
14690,22753,3794,11022,3174,18959,7179,3491,3688
14695,22759,3794,11026,3174,18965,7182,3493,3689
14700,22770,3796,11032,3175,18974,7185,3495,3690
14705,22774,3796,11033,3175,18978,7186,3496,3690
14710,22784,3797,11037,3176,18987,7188,3497,3691
14715,22790,3797,11040,3176,18993,7191,3499,3692
14720,22801,3799,11046,3178,19002,7194,3501,3693
14725,22805,3800,11048,3179,19005,7195,3501,3694
14730,22815,3801,11053,3180,19014,7197,3502,3695
14735,22821,3801,11056,3180,19020,7200,3503,3697
14740,22832,3803,11062,3181,19029,7203,3504,3699
14745,22836,3804,11065,3182,19032,7204,3505,3699
14750,22846,3804,11067,3182,19042,7206,3506,3700
14755,22852,3804,11071,3182,19048,7209,3508,3701
14760,22863,3805,11078,3183,19058,7212,3511,3701
14765,22867,3806,11080,3184,19061,7213,3511,3702
14770,22877,3807,11086,3185,19070,7215,3513,3702
14775,22883,3807,11091,3185,19075,7218,3515,3703
14780,22894,3810,11096,3188,19083,7221,3516,3705
14785,22898,3812,11098,3190,19086,7222,3517,3705
14790,22908,3813,11104,3191,19095,7224,3519,3705
14795,22914,3813,11106,3191,19101,7227,3521,3706
14800,22925,3815,11112,3193,19109,7230,3523,3707
14805,22929,3817,11114,3195,19112,7231,3524,3707
14810,22939,3818,11120,3196,19121,7233,3526,3707
14815,22945,3818,11124,3196,19126,7236,3528,3708
14820,22956,3823,11131,3200,19133,7239,3530,3709
14825,22960,3825,11133,3202,19135,7240,3530,3710
14830,22970,3826,11135,3202,19144,7242,3531,3711
14835,22976,3826,11138,3202,19149,7245,3533,3712
14840,22987,3829,11145,3205,19157,7248,3535,3713
14845,22991,3832,11147,3208,19159,7249,3535,3714
14850,23001,3834,11151,3210,19167,7251,3535,3716
14855,23007,3834,11153,3210,19173,7254,3536,3718
14860,23018,3837,11161,3213,19180,7257,3538,3719
14865,23022,3840,11164,3216,19182,7258,3538,3720
14870,23032,3842,11168,3218,19190,7260,3538,3722
14875,23038,3842,11171,3218,19195,7263,3539,3724
14880,23049,3845,11175,3221,19204,7266,3539,3727
14885,23053,3846,11177,3222,19207,7267,3540,3727
14890,23063,3849,11182,3225,19214,7269,3541,3728
14895,23069,3849,11184,3225,19219,7272,3542,3730
14900,23080,3852,11190,3228,19228,7275,3544,3731
14905,23084,3852,11190,3228,19232,7276,3544,3732
14910,23094,3854,11196,3229,19240,7278,3545,3733
14915,23100,3854,11199,3229,19245,7281,3546,3735
14920,23111,3859,11207,3233,19252,7284,3548,3736
14925,23115,3859,11208,3233,19256,7285,3549,3736
14930,23125,3861,11213,3234,19264,7287,3549,3738
14935,23131,3861,11214,3234,19270,7290,3550,3740
14940,23142,3864,11219,3237,19277,7293,3551,3742
14945,23146,3866,11221,3239,19280,7294,3551,3743
14950,23156,3867,11226,3240,19289,7296,3552,3744
14955,23162,3867,11230,3240,19295,7299,3554,3745
14960,23173,3867,11234,3240,19305,7302,3555,3747
14965,23177,3868,11235,3241,19309,7303,3555,3748
14970,23187,3869,11238,3242,19318,7305,3555,3750
14975,23193,3869,11240,3242,19324,7308,3556,3752
14980,23204,3869,11243,3242,19335,7311,3557,3754
14985,23208,3869,11245,3242,19339,7312,3558,3754
14990,23218,3870,11252,3243,19348,7314,3559,3755
14995,23224,3870,11256,3243,19353,7317,3561,3756
15000,23235,3871,11259,3244,19364,7320,3562,3758
15005,23239,3871,11259,3244,19368,7321,3562,3759
15010,23249,3872,11261,3244,19377,7323,3563,3760
15015,23255,3872,11265,3244,19382,7326,3566,3760
15020,23266,3873,11273,3245,19392,7329,3569,3760
15025,23270,3874,11276,3246,19396,7330,3570,3760
15030,23280,3875,11282,3247,19405,7332,3572,3760
15035,23286,3875,11286,3247,19411,7335,3574,3761
15040,23297,3875,11291,3247,19421,7338,3576,3762
15045,23301,3876,11294,3248,19425,7339,3577,3762
15050,23311,3878,11296,3249,19433,7341,3577,3764
15055,23317,3878,11297,3249,19439,7344,3577,3767
15060,23328,3880,11304,3251,19447,7347,3579,3768
15065,23332,3882,11307,3253,19450,7348,3580,3768
15070,23342,3885,11312,3256,19457,7350,3580,3770
15075,23348,3885,11315,3256,19463,7353,3582,3771
15080,23359,3886,11319,3256,19473,7355,3584,3771
15085,23363,3887,11321,3257,19476,7356,3584,3772
15090,23373,3888,11324,3258,19485,7358,3585,3773
15095,23379,3888,11325,3258,19491,7361,3585,3776
15100,23390,3891,11331,3260,19499,7363,3586,3777
15105,23394,3891,11332,3260,19503,7364,3587,3777
15110,23404,3893,11335,3261,19511,7366,3588,3778
15115,23410,3893,11338,3261,19517,7369,3591,3778
15120,23421,3895,11345,3262,19525,7371,3593,3778
15125,23425,3897,11346,3264,19528,7372,3593,3779
15130,23435,3899,11353,3266,19536,7374,3594,3780
15135,23441,3899,11357,3266,19542,7377,3596,3781
15140,23452,3902,11363,3268,19549,7379,3598,3781
15145,23456,3903,11364,3269,19553,7380,3599,3781
15150,23466,3904,11367,3269,19562,7382,3600,3782
15155,23472,3904,11370,3269,19568,7385,3602,3783
15160,23483,3906,11376,3271,19577,7387,3603,3784
15165,23487,3907,11378,3272,19580,7388,3603,3785
15170,23497,3910,11384,3274,19587,7390,3604,3786
15175,23503,3910,11386,3274,19593,7393,3606,3787
15180,23514,3911,11392,3275,19602,7396,3607,3789
15185,23518,3914,11395,3278,19604,7397,3608,3789
15190,23528,3917,11400,3280,19611,7399,3609,3790
15195,23534,3917,11403,3280,19617,7402,3611,3791
15200,23545,3919,11409,3282,19625,7405,3613,3792
15205,23549,3922,11411,3285,19627,7406,3613,3793
15210,23559,3925,11418,3287,19634,7408,3615,3793
15215,23565,3925,11421,3287,19639,7411,3615,3796
15220,23576,3928,11424,3289,19648,7414,3616,3798
15225,23580,3929,11425,3290,19651,7415,3616,3799
15230,23590,3931,11430,3291,19659,7417,3618,3799
15235,23596,3931,11435,3291,19664,7420,3621,3799
15240,23607,3934,11439,3294,19673,7423,3622,3801
15245,23611,3934,11441,3294,19677,7424,3623,3801
15250,23621,3936,11446,3295,19685,7426,3624,3802
15255,23627,3936,11448,3295,19691,7429,3626,3803
15260,23638,3939,11454,3297,19699,7432,3627,3805
15265,23642,3941,11457,3299,19701,7433,3628,3805
15270,23652,3943,11462,3301,19709,7435,3628,3807
15275,23658,3943,11463,3301,19715,7438,3629,3809
15280,23669,3946,11468,3303,19722,7441,3631,3810
15285,23673,3949,11470,3306,19724,7442,3631,3811
15290,23683,3951,11473,3307,19732,7444,3631,3813
15295,23689,3951,11475,3307,19738,7447,3633,3814
15300,23700,3954,11481,3310,19746,7450,3634,3816
15305,23704,3954,11482,3310,19750,7451,3635,3816
15310,23714,3955,11488,3311,19759,7453,3635,3818
15315,23720,3955,11491,3311,19764,7456,3637,3819
15320,23731,3957,11495,3313,19774,7459,3637,3822
15325,23735,3957,11495,3313,19778,7460,3637,3823
15330,23745,3958,11500,3314,19787,7462,3638,3824
15335,23751,3958,11502,3314,19793,7465,3639,3826
15340,23762,3958,11506,3314,19804,7468,3639,3829
15345,23766,3958,11507,3314,19808,7469,3640,3829
15350,23776,3959,11508,3314,19817,7471,3640,3831
15355,23782,3959,11510,3314,19822,7474,3641,3833
15360,23793,3960,11514,3315,19833,7477,3643,3834
15365,23797,3961,11517,3316,19836,7478,3643,3835
15370,23807,3962,11521,3316,19845,7480,3643,3837
15375,23813,3962,11526,3316,19850,7483,3645,3838
15380,23824,3964,11534,3318,19860,7486,3647,3839
15385,23828,3964,11535,3318,19864,7487,3647,3840
15390,23838,3965,11543,3318,19873,7489,3649,3840
15395,23844,3965,11545,3318,19879,7492,3650,3842
15400,23855,3965,11551,3318,19889,7495,3652,3843
15405,23859,3967,11553,3320,19892,7496,3652,3844
15410,23869,3970,11559,3323,19899,7498,3654,3844
15415,23875,3970,11564,3323,19904,7501,3656,3845
15420,23886,3975,11571,3327,19910,7504,3658,3846
15425,23890,3976,11571,3328,19914,7505,3658,3847
15430,23900,3976,11575,3328,19924,7507,3658,3849
15435,23906,3976,11580,3328,19930,7510,3661,3849
15440,23917,3979,11586,3331,19938,7513,3663,3850
15445,23921,3980,11589,3332,19941,7514,3664,3850
15450,23931,3981,11594,3333,19950,7516,3665,3851
15455,23937,3981,11598,3333,19956,7519,3667,3852
15460,23948,3983,11604,3335,19965,7522,3669,3853
15465,23952,3983,11605,3335,19969,7523,3670,3853
15470,23962,3984,11609,3336,19978,7525,3671,3854
15475,23968,3984,11611,3336,19984,7528,3672,3856
15480,23979,3986,11615,3338,19993,7531,3673,3858
15485,23983,3986,11618,3338,19997,7532,3674,3858
15490,23993,3988,11626,3340,20005,7534,3675,3859
15495,23999,3988,11630,3340,20011,7537,3677,3860
15500,24010,3989,11634,3341,20021,7540,3679,3861
15505,24014,3989,11635,3341,20025,7541,3679,3862
15510,24024,3990,11641,3342,20034,7543,3681,3862
15515,24030,3990,11645,3342,20040,7546,3683,3863
15520,24041,3993,11653,3344,20048,7549,3685,3864
15525,24045,3994,11656,3345,20051,7550,3686,3864
15530,24055,3996,11659,3346,20059,7552,3686,3866
15535,24061,3996,11660,3346,20065,7555,3687,3868
15540,24072,3998,11664,3347,20074,7558,3689,3869
15545,24076,3999,11665,3348,20077,7559,3689,3870
15550,24086,4000,11670,3348,20086,7561,3690,3871
15555,24092,4000,11671,3348,20092,7564,3690,3874
15560,24103,4002,11677,3350,20101,7567,3692,3875
15565,24107,4003,11679,3351,20104,7568,3692,3876
15570,24117,4004,11684,3351,20113,7570,3693,3877
15575,24123,4004,11685,3351,20119,7573,3693,3880
15580,24134,4005,11690,3351,20129,7576,3696,3880
15585,24138,4005,11691,3351,20133,7577,3696,3881
15590,24148,4006,11695,3352,20142,7579,3697,3882
15595,24154,4006,11697,3352,20148,7582,3698,3884
15600,24165,4007,11700,3352,20157,7585,3698,3887
15605,24169,4008,11700,3353,20161,7586,3698,3888
15610,24179,4009,11707,3354,20170,7588,3700,3888
15615,24185,4009,11707,3354,20176,7591,3700,3891
15620,24196,4011,11715,3356,20184,7594,3702,3892
15625,24200,4013,11716,3358,20187,7595,3702,3893
15630,24210,4014,11720,3358,20196,7597,3703,3894
15635,24216,4014,11723,3358,20202,7600,3704,3896
15640,24227,4016,11728,3360,20211,7603,3705,3898
15645,24231,4017,11729,3361,20214,7604,3705,3899
15650,24241,4019,11732,3362,20222,7606,3706,3900
15655,24247,4019,11735,3362,20228,7609,3708,3901
15660,24258,4021,11741,3364,20237,7612,3710,3902
15665,24262,4021,11742,3364,20241,7613,3711,3902
15670,24272,4024,11748,3366,20248,7615,3712,3903
15675,24278,4024,11750,3366,20253,7618,3713,3905
15680,24289,4026,11754,3368,20262,7621,3714,3907
15685,24293,4027,11755,3369,20266,7622,3714,3908
15690,24303,4029,11763,3371,20274,7624,3716,3908
15695,24309,4029,11767,3371,20279,7627,3718,3909
15700,24320,4032,11771,3373,20287,7630,3719,3911
15705,24324,4034,11774,3375,20290,7631,3720,3911
15710,24334,4036,11781,3376,20298,7633,3722,3911
15715,24340,4036,11783,3376,20303,7636,3723,3913
15720,24351,4040,11788,3380,20311,7639,3723,3916
15725,24355,4040,11788,3380,20315,7640,3723,3917
15730,24365,4041,11794,3381,20324,7642,3724,3918
15735,24371,4041,11798,3381,20330,7645,3727,3918
15740,24382,4043,11806,3383,20338,7647,3728,3919
15745,24386,4045,11808,3385,20341,7648,3729,3919
15750,24396,4047,11814,3386,20349,7650,3731,3919
15755,24402,4047,11817,3386,20355,7653,3733,3920
15760,24413,4048,11819,3387,20365,7655,3733,3922
15765,24417,4049,11822,3388,20368,7656,3734,3922
15770,24427,4050,11824,3388,20377,7658,3735,3923
15775,24433,4050,11826,3388,20383,7661,3736,3925
15780,24444,4051,11831,3389,20393,7663,3738,3925
15785,24448,4052,11833,3390,20396,7664,3738,3926
15790,24458,4054,11836,3391,20404,7666,3738,3928
15795,24464,4054,11839,3391,20409,7669,3740,3929
15800,24475,4057,11846,3394,20417,7671,3741,3930
15805,24479,4058,11846,3395,20421,7672,3741,3931
15810,24489,4060,11850,3396,20429,7674,3742,3932
15815,24495,4060,11855,3396,20434,7677,3745,3932
15820,24506,4064,11863,3399,20441,7679,3746,3933
15825,24510,4066,11864,3401,20444,7680,3746,3934
15830,24520,4068,11869,3403,20452,7682,3747,3935
15835,24526,4068,11873,3403,20457,7685,3748,3937
15840,24537,4072,11878,3406,20464,7688,3748,3940
15845,24541,4075,11880,3409,20466,7689,3748,3941
15850,24551,4078,11886,3412,20473,7691,3749,3942
15855,24557,4078,11889,3412,20478,7694,3750,3944
15860,24568,4081,11892,3415,20487,7697,3751,3946
15865,24572,4082,11895,3416,20490,7698,3752,3946
15870,24582,4085,11899,3418,20497,7700,3753,3947
15875,24588,4085,11901,3418,20503,7703,3755,3948
15880,24599,4087,11905,3420,20511,7706,3755,3951
15885,24603,4089,11907,3422,20514,7707,3756,3951
15890,24613,4091,11911,3423,20522,7709,3758,3951
15895,24619,4091,11914,3423,20528,7712,3759,3953
15900,24630,4093,11918,3424,20536,7715,3761,3954
15905,24634,4094,11918,3425,20540,7716,3761,3955
15910,24644,4095,11922,3425,20549,7718,3761,3957
15915,24650,4095,11927,3425,20554,7721,3763,3958
15920,24661,4096,11931,3426,20565,7724,3765,3959
15925,24665,4096,11931,3426,20569,7725,3765,3960
15930,24675,4097,11935,3426,20578,7727,3766,3961
15935,24681,4097,11937,3426,20583,7730,3766,3964
15940,24692,4099,11941,3428,20593,7733,3768,3965
15945,24696,4099,11944,3428,20597,7734,3769,3965
15950,24706,4100,11951,3429,20606,7736,3769,3967
15955,24712,4100,11954,3429,20611,7739,3771,3968
15960,24723,4102,11961,3431,20620,7742,3774,3968
15965,24727,4104,11963,3433,20623,7743,3774,3969
15970,24737,4105,11968,3433,20632,7745,3776,3969
15975,24743,4105,11970,3433,20638,7748,3778,3970
15980,24754,4105,11977,3433,20648,7751,3781,3970
15985,24758,4106,11979,3434,20652,7752,3782,3970
15990,24768,4107,11982,3435,20661,7754,3782,3972
15995,24774,4107,11984,3435,20666,7757,3782,3975
16000,24785,4109,11991,3437,20676,7760,3785,3975
16005,24789,4110,11995,3438,20679,7761,3786,3975
16010,24799,4112,11999,3440,20687,7763,3786,3977
16015,24805,4112,12002,3440,20692,7766,3788,3978
16020,24816,4116,12009,3444,20699,7769,3790,3979
16025,24820,4118,12012,3446,20702,7770,3791,3979
16030,24830,4119,12017,3446,20711,7772,3792,3980
16035,24836,4119,12021,3446,20716,7775,3793,3982
16040,24847,4122,12026,3448,20724,7778,3794,3984
16045,24851,4125,12030,3451,20726,7779,3795,3984
16050,24861,4126,12033,3451,20735,7781,3796,3985
16055,24867,4126,12037,3451,20740,7784,3797,3987
16060,24878,4130,12041,3455,20748,7787,3797,3990
16065,24882,4130,12041,3455,20752,7788,3797,3991
16070,24892,4132,12046,3456,20760,7790,3799,3991
16075,24898,4132,12046,3456,20766,7793,3799,3994
16080,24909,4135,12054,3459,20773,7796,3800,3996
16085,24913,4136,12056,3460,20777,7797,3801,3996
16090,24923,4136,12059,3460,20787,7799,3802,3997
16095,24929,4136,12061,3460,20793,7802,3803,3999
16100,24940,4137,12066,3461,20803,7805,3806,3999
16105,24944,4137,12067,3461,20807,7806,3807,3999
16110,24954,4138,12073,3462,20816,7808,3808,4000
16115,24960,4138,12076,3462,20822,7811,3810,4001
16120,24971,4140,12081,3464,20831,7814,3811,4003
16125,24975,4140,12082,3464,20835,7815,3811,4004
16130,24985,4141,12084,3465,20844,7817,3812,4005
16135,24991,4141,12087,3465,20850,7820,3814,4006
16140,25002,4143,12089,3466,20859,7823,3814,4009
16145,25006,4144,12090,3467,20862,7824,3814,4010
16150,25016,4144,12091,3467,20872,7826,3815,4011
16155,25022,4144,12093,3467,20878,7829,3817,4012
16160,25033,4146,12098,3469,20887,7832,3818,4014
16165,25037,4147,12100,3470,20890,7833,3818,4015
16170,25047,4148,12106,3471,20899,7835,3819,4016
16175,25053,4148,12108,3471,20905,7838,3820,4018
16180,25064,4150,12113,3473,20914,7841,3820,4021
16185,25068,4150,12114,3473,20918,7842,3820,4022
16190,25078,4152,12119,3474,20926,7844,3822,4022
16195,25084,4152,12123,3474,20932,7847,3824,4023
16200,25095,4154,12128,3475,20941,7850,3827,4023
16205,25099,4154,12130,3475,20945,7851,3828,4023
16210,25109,4156,12135,3476,20953,7853,3830,4023
16215,25115,4156,12138,3476,20959,7856,3832,4024
16220,25126,4160,12146,3480,20965,7859,3834,4025
16225,25130,4162,12147,3482,20968,7860,3834,4026
16230,25140,4163,12151,3483,20977,7862,3834,4028
16235,25146,4163,12154,3483,20983,7865,3835,4030
16240,25157,4166,12159,3485,20990,7868,3837,4031
16245,25161,4169,12162,3488,20992,7869,3837,4032
16250,25171,4171,12168,3489,21000,7871,3839,4032
16255,25177,4171,12172,3489,21006,7874,3841,4033
16260,25188,4173,12176,3491,21015,7877,3841,4036
16265,25192,4173,12177,3491,21019,7878,3842,4036
16270,25202,4175,12181,3493,21027,7880,3844,4036
16275,25208,4175,12184,3493,21032,7883,3846,4037
16280,25219,4177,12189,3495,21041,7886,3848,4038
16285,25223,4180,12192,3498,21043,7887,3848,4039
16290,25233,4181,12197,3499,21052,7889,3849,4040
16295,25239,4181,12198,3499,21058,7892,3849,4043
16300,25250,4183,12205,3501,21066,7895,3851,4044
16305,25254,4185,12206,3503,21069,7896,3851,4045
16310,25264,4186,12211,3504,21078,7898,3853,4045
16315,25270,4186,12213,3504,21083,7901,3854,4047
16320,25281,4190,12219,3507,21091,7904,3856,4048
16325,25285,4190,12219,3507,21095,7905,3856,4049
16330,25295,4191,12222,3507,21104,7907,3857,4050
16335,25301,4191,12223,3507,21110,7910,3858,4052
16340,25312,4193,12227,3509,21119,7913,3859,4054
16345,25316,4194,12231,3510,21122,7914,3860,4054
16350,25326,4196,12234,3512,21130,7916,3860,4056
16355,25332,4196,12236,3512,21136,7919,3861,4058
16360,25343,4199,12243,3514,21143,7922,3863,4059
16365,25347,4200,12243,3515,21147,7923,3863,4060
16370,25357,4202,12249,3517,21155,7925,3864,4061
16375,25363,4202,12251,3517,21161,7928,3866,4062
16380,25374,4204,12256,3518,21169,7931,3868,4063
16385,25378,4205,12256,3519,21173,7932,3868,4064
16390,25388,4207,12261,3521,21181,7934,3869,4065
16395,25394,4207,12263,3521,21187,7937,3870,4067
16400,25405,4209,12268,3522,21195,7939,3871,4068
16405,25409,4211,12271,3524,21198,7940,3872,4068
16410,25419,4212,12274,3524,21207,7942,3872,4070
16415,25425,4212,12275,3524,21213,7945,3873,4072
16420,25436,4213,12280,3525,21222,7947,3875,4072
16425,25440,4214,12281,3526,21226,7948,3875,4073
16430,25450,4215,12284,3527,21235,7950,3875,4075
16435,25456,4215,12287,3527,21240,7953,3877,4076
16440,25467,4216,12290,3528,21251,7955,3878,4077
16445,25471,4217,12293,3529,21254,7956,3879,4077
16450,25481,4218,12300,3530,21263,7958,3880,4078
16455,25487,4218,12300,3530,21269,7961,3880,4081
16460,25498,4218,12305,3530,21280,7963,3882,4081
16465,25502,4218,12306,3530,21284,7964,3882,4082
16470,25512,4219,12312,3530,21293,7966,3883,4083
16475,25518,4219,12314,3530,21298,7969,3884,4085
16480,25529,4221,12319,3532,21308,7971,3884,4087
16485,25533,4221,12322,3532,21312,7972,3885,4087
16490,25543,4222,12326,3533,21321,7974,3886,4088
16495,25549,4222,12328,3533,21327,7977,3888,4089
16500,25560,4223,12333,3534,21336,7980,3890,4090
16505,25564,4225,12334,3536,21339,7981,3890,4091
16510,25574,4227,12338,3537,21347,7983,3891,4092
16515,25580,4227,12339,3537,21353,7986,3892,4094
16520,25591,4230,12347,3540,21360,7989,3894,4095
16525,25595,4233,12349,3543,21362,7990,3894,4096
16530,25605,4234,12353,3544,21371,7992,3895,4097
16535,25611,4234,12357,3544,21377,7995,3898,4097
16540,25622,4236,12362,3546,21386,7998,3900,4098
16545,25626,4237,12364,3547,21389,7999,3900,4099
16550,25636,4239,12371,3549,21397,8001,3901,4100
16555,25642,4239,12375,3549,21403,8004,3903,4101
16560,25653,4242,12381,3551,21410,8007,3905,4102
16565,25657,4244,12384,3553,21413,8008,3906,4102
16570,25667,4246,12389,3554,21421,8010,3907,4103
16575,25673,4246,12392,3554,21426,8013,3909,4104
16580,25684,4250,12400,3558,21434,8016,3911,4105
16585,25688,4251,12403,3559,21437,8017,3912,4105
16590,25698,4254,12407,3561,21444,8019,3913,4106
16595,25704,4254,12411,3561,21450,8022,3915,4107
16600,25715,4257,12418,3564,21458,8025,3917,4108
16605,25719,4257,12419,3564,21462,8026,3917,4109
16610,25729,4259,12424,3565,21470,8028,3918,4110
16615,25735,4259,12427,3565,21475,8031,3919,4112
16620,25746,4261,12428,3566,21485,8034,3919,4115
16625,25750,4261,12429,3566,21489,8035,3920,4115
16630,25760,4263,12433,3567,21497,8037,3921,4116
16635,25766,4263,12436,3567,21503,8040,3924,4116
16640,25777,4266,12441,3570,21511,8043,3925,4118
16645,25781,4267,12444,3571,21514,8044,3926,4118
16650,25791,4270,12451,3573,21521,8046,3927,4119
16655,25797,4270,12454,3573,21526,8049,3927,4122
16660,25808,4273,12462,3576,21534,8052,3930,4122
16665,25812,4275,12465,3578,21537,8053,3931,4122
16670,25822,4277,12468,3579,21545,8055,3932,4123
16675,25828,4277,12470,3579,21550,8058,3932,4126
16680,25839,4282,12477,3583,21556,8061,3933,4128
16685,25843,4283,12478,3584,21560,8062,3933,4129
16690,25853,4285,12483,3585,21568,8064,3934,4130
16695,25859,4285,12486,3585,21573,8067,3935,4132
16700,25870,4288,12490,3588,21582,8070,3936,4134
16705,25874,4289,12492,3589,21585,8071,3936,4135
16710,25884,4291,12494,3590,21593,8073,3936,4137
16715,25890,4291,12497,3590,21598,8076,3937,4139
16720,25901,4294,12502,3592,21607,8079,3939,4140
16725,25905,4295,12504,3593,21610,8080,3939,4141
16730,25915,4298,12508,3595,21617,8082,3939,4143
16735,25921,4298,12512,3595,21622,8085,3941,4144
16740,25932,4300,12518,3597,21632,8088,3942,4146
16745,25936,4300,12519,3597,21636,8089,3943,4146
16750,25946,4301,12523,3597,21645,8091,3944,4147
16755,25952,4301,12526,3597,21651,8094,3947,4147
16760,25963,4302,12532,3598,21660,8097,3947,4150
16765,25967,4303,12534,3599,21664,8098,3947,4151
16770,25977,4304,12538,3600,21673,8100,3949,4151
16775,25983,4304,12542,3600,21679,8103,3951,4152
16780,25994,4304,12546,3600,21689,8106,3952,4154
16785,25998,4306,12550,3602,21692,8107,3953,4154
16790,26008,4307,12553,3602,21701,8109,3954,4155
16795,26014,4307,12558,3602,21706,8112,3957,4155
16800,26025,4309,12564,3604,21715,8115,3960,4155
16805,26029,4310,12565,3605,21719,8116,3961,4155
16810,26039,4311,12571,3606,21728,8118,3962,4156
16815,26045,4311,12575,3606,21733,8121,3964,4157
16820,26056,4313,12582,3608,21742,8124,3966,4158
16825,26060,4314,12583,3609,21746,8125,3966,4159
16830,26070,4315,12587,3609,21755,8127,3966,4161
16835,26076,4315,12590,3609,21761,8130,3969,4161
16840,26087,4317,12594,3610,21769,8133,3970,4163
16845,26091,4320,12597,3613,21771,8134,3970,4164
16850,26101,4323,12601,3615,21778,8136,3970,4166
16855,26107,4323,12604,3615,21783,8139,3971,4168
16860,26118,4326,12608,3618,21792,8142,3971,4171
16865,26122,4327,12609,3619,21795,8143,3971,4172
16870,26132,4330,12613,3621,21802,8145,3972,4173
16875,26138,4330,12614,3621,21807,8148,3972,4176
16880,26149,4333,12619,3623,21816,8151,3974,4177
16885,26153,4334,12621,3624,21819,8152,3974,4178
16890,26163,4335,12625,3625,21828,8154,3975,4179
16895,26169,4335,12627,3625,21834,8157,3975,4182
16900,26180,4337,12633,3626,21843,8160,3977,4183
16905,26184,4337,12635,3626,21847,8161,3978,4183
16910,26194,4339,12641,3628,21855,8163,3978,4185
16915,26200,4339,12646,3628,21861,8166,3980,4186
16920,26211,4341,12652,3630,21870,8169,3981,4188
16925,26215,4342,12656,3631,21873,8170,3982,4188
16930,26225,4343,12661,3632,21882,8172,3982,4190
16935,26231,4343,12664,3632,21888,8175,3983,4192
16940,26242,4345,12671,3633,21897,8178,3985,4193
16945,26246,4345,12673,3633,21901,8179,3985,4194
16950,26256,4346,12677,3634,21910,8181,3986,4195
16955,26262,4346,12680,3634,21916,8184,3987,4197
16960,26273,4348,12687,3636,21925,8187,3989,4198
16965,26277,4349,12688,3637,21928,8188,3989,4199
16970,26287,4351,12693,3639,21936,8190,3989,4201
16975,26293,4351,12696,3639,21942,8193,3990,4203
16980,26304,4354,12703,3642,21950,8196,3992,4204
16985,26308,4354,12704,3642,21954,8197,3993,4204
16990,26318,4355,12709,3643,21963,8199,3993,4206
16995,26324,4355,12711,3643,21969,8202,3995,4207
17000,26335,4355,12718,3643,21980,8205,3998,4207
17005,26339,4355,12720,3643,21984,8206,3999,4207
17010,26349,4356,12725,3643,21993,8208,3999,4209
17015,26355,4356,12729,3643,21999,8211,4002,4209
17020,26366,4356,12733,3643,22009,8214,4004,4210
17025,26370,4357,12735,3644,22013,8215,4005,4210
17030,26380,4358,12739,3645,22022,8217,4005,4212
17035,26386,4358,12741,3645,22028,8220,4007,4213
17040,26397,4358,12746,3645,22039,8223,4008,4215
17045,26401,4358,12749,3645,22043,8224,4009,4215
17050,26411,4359,12755,3646,22052,8226,4010,4216
17055,26417,4359,12758,3646,22057,8229,4011,4218
17060,26428,4361,12765,3648,22066,8231,4013,4218
17065,26432,4362,12768,3649,22070,8232,4014,4218
17070,26442,4363,12771,3650,22079,8234,4014,4220
17075,26448,4363,12774,3650,22084,8237,4015,4222
17080,26459,4364,12781,3651,22094,8239,4017,4222
17085,26463,4365,12781,3652,22098,8240,4017,4223
17090,26473,4368,12785,3654,22105,8242,4018,4224
17095,26479,4368,12789,3654,22110,8245,4020,4225
17100,26490,4371,12795,3657,22119,8247,4020,4227
17105,26494,4372,12798,3658,22122,8248,4021,4227
17110,26504,4374,12802,3660,22130,8250,4021,4229
17115,26510,4374,12806,3660,22135,8253,4024,4229
17120,26521,4378,12809,3663,22143,8255,4025,4230
17125,26525,4380,12811,3665,22145,8256,4025,4231
17130,26535,4383,12819,3668,22152,8258,4026,4232
17135,26541,4383,12820,3668,22158,8261,4027,4234
17140,26552,4387,12828,3672,22165,8263,4029,4234
17145,26556,4387,12829,3672,22169,8264,4029,4235
17150,26566,4389,12832,3673,22177,8266,4029,4237
17155,26572,4389,12835,3673,22183,8269,4031,4238
17160,26583,4391,12839,3675,22192,8272,4031,4241
17165,26587,4393,12841,3677,22194,8273,4031,4242
17170,26597,4395,12847,3679,22202,8275,4031,4244
17175,26603,4395,12849,3679,22208,8278,4032,4246
17180,26614,4397,12854,3681,22216,8281,4034,4247
17185,26618,4399,12857,3683,22219,8282,4035,4247
17190,26628,4402,12863,3685,22226,8284,4035,4249
17195,26634,4402,12864,3685,22232,8287,4036,4251
17200,26645,4404,12870,3687,22240,8290,4038,4252
17205,26649,4406,12872,3689,22243,8291,4038,4253
17210,26659,4408,12876,3690,22251,8293,4039,4254
17215,26665,4408,12879,3690,22256,8296,4041,4255
17220,26676,4412,12885,3693,22263,8299,4042,4257
17225,26680,4414,12888,3695,22266,8300,4043,4257
17230,26690,4415,12892,3696,22275,8302,4044,4258
17235,26696,4415,12894,3696,22281,8305,4046,4259
17240,26707,4416,12900,3697,22291,8308,4047,4261
17245,26711,4416,12901,3697,22295,8309,4048,4261
17250,26721,4417,12907,3698,22304,8311,4049,4262
17255,26727,4417,12909,3698,22309,8314,4049,4265
17260,26738,4419,12915,3700,22319,8317,4052,4265
17265,26742,4419,12918,3700,22323,8318,4053,4265
17270,26752,4420,12923,3700,22332,8320,4053,4267
17275,26758,4420,12925,3700,22337,8323,4054,4269
17280,26769,4422,12934,3702,22346,8326,4056,4270
17285,26773,4424,12937,3704,22349,8327,4056,4271
17290,26783,4425,12942,3704,22358,8329,4057,4272
17295,26789,4425,12944,3704,22364,8332,4058,4274
17300,26800,4425,12952,3704,22374,8335,4061,4274
17305,26804,4427,12954,3706,22377,8336,4061,4275
17310,26814,4428,12960,3707,22386,8338,4062,4276
17315,26820,4428,12960,3707,22392,8341,4062,4279
17320,26831,4428,12967,3707,22402,8344,4064,4280
17325,26835,4429,12970,3708,22406,8345,4065,4280
17330,26845,4432,12979,3710,22413,8347,4067,4280
17335,26851,4432,12984,3710,22418,8350,4070,4280
17340,26862,4436,12991,3714,22425,8353,4072,4281
17345,26866,4437,12993,3715,22429,8354,4073,4281
17350,26876,4439,12997,3717,22437,8356,4074,4282
17355,26882,4439,12999,3717,22443,8359,4074,4285
17360,26893,4441,13002,3718,22452,8362,4076,4286
17365,26897,4441,13003,3718,22456,8363,4076,4287
17370,26907,4443,13009,3719,22464,8365,4077,4288
17375,26913,4443,13012,3719,22469,8368,4078,4290
17380,26924,4446,13017,3721,22478,8371,4080,4291
17385,26928,4447,13018,3722,22481,8372,4080,4292
17390,26938,4450,13024,3724,22488,8374,4081,4293
17395,26944,4450,13026,3724,22494,8377,4082,4295
17400,26955,4453,13034,3726,22501,8380,4084,4296
17405,26959,4455,13036,3728,22504,8381,4085,4296
17410,26969,4457,13041,3729,22512,8383,4086,4297
17415,26975,4457,13043,3729,22518,8386,4087,4299
17420,26986,4460,13049,3732,22526,8389,4088,4301
17425,26990,4461,13051,3733,22529,8390,4089,4301
17430,27000,4462,13056,3733,22538,8392,4091,4301
17435,27006,4462,13060,3733,22543,8395,4093,4302
17440,27017,4466,13065,3736,22551,8398,4094,4304
17445,27021,4467,13068,3737,22554,8399,4095,4304
17450,27031,4468,13071,3738,22563,8401,4095,4306
17455,27037,4468,13076,3738,22569,8404,4098,4306
17460,27048,4470,13084,3740,22577,8407,4101,4306
17465,27052,4472,13085,3742,22580,8408,4101,4307
17470,27062,4474,13093,3744,22588,8410,4102,4308
17475,27068,4474,13096,3744,22594,8413,4104,4309
17480,27079,4478,13103,3747,22601,8416,4106,4310
17485,27083,4479,13104,3748,22604,8417,4106,4311
17490,27093,4481,13108,3749,22612,8419,4107,4312
17495,27099,4481,13113,3749,22617,8422,4110,4312
17500,27110,4485,13120,3752,22624,8425,4112,4313
17505,27114,4488,13123,3755,22626,8426,4113,4313
17510,27124,4490,13128,3757,22634,8428,4114,4314
17515,27130,4490,13131,3757,22640,8431,4116,4315
17520,27141,4492,13138,3759,22648,8434,4118,4316
17525,27145,4493,13139,3760,22652,8435,4118,4317
17530,27155,4496,13144,3762,22659,8437,4120,4317
17535,27161,4496,13146,3762,22664,8440,4121,4319
17540,27172,4498,13154,3764,22673,8443,4122,4321
17545,27176,4500,13157,3766,22676,8444,4123,4321
17550,27186,4501,13158,3766,22685,8446,4123,4323
17555,27192,4501,13160,3766,22691,8449,4124,4325
17560,27203,4502,13163,3767,22701,8452,4125,4327
17565,27207,4503,13167,3768,22704,8453,4126,4327
17570,27217,4504,13172,3769,22713,8455,4126,4329
17575,27223,4504,13173,3769,22719,8458,4126,4332
17580,27234,4504,13182,3769,22729,8461,4128,4333
17585,27238,4505,13184,3770,22733,8462,4128,4334
17590,27248,4505,13189,3770,22743,8464,4129,4335
17595,27254,4505,13192,3770,22749,8467,4130,4337
17600,27265,4505,13199,3770,22760,8470,4132,4338
17605,27269,4505,13201,3770,22764,8471,4133,4338
17610,27279,4505,13207,3770,22774,8473,4134,4339
17615,27285,4505,13212,3770,22780,8476,4137,4339
17620,27296,4505,13215,3770,22791,8479,4137,4342
17625,27300,4505,13218,3770,22795,8480,4137,4343
17630,27310,4505,13223,3770,22805,8482,4139,4343
17635,27316,4505,13225,3770,22811,8485,4140,4345
17640,27327,4507,13229,3772,22820,8488,4141,4347
17645,27331,4508,13231,3773,22823,8489,4141,4348
17650,27341,4509,13235,3774,22832,8491,4142,4349
17655,27347,4509,13237,3774,22838,8494,4143,4351
17660,27358,4512,13242,3776,22846,8497,4144,4353
17665,27362,4512,13244,3776,22850,8498,4145,4353
17670,27372,4513,13249,3777,22859,8500,4145,4355
17675,27378,4513,13254,3777,22865,8503,4147,4356
17680,27389,4514,13258,3778,22875,8506,4148,4358
17685,27393,4515,13259,3779,22878,8507,4148,4359
17690,27403,4517,13264,3781,22886,8509,4149,4360
17695,27409,4517,13267,3781,22891,8512,4150,4362
17700,27420,4519,13269,3783,22901,8515,4151,4364
17705,27424,4520,13270,3784,22904,8516,4151,4365
17710,27434,4521,13275,3785,22913,8518,4152,4366
17715,27440,4521,13279,3785,22918,8521,4154,4367
17720,27451,4524,13283,3787,22926,8523,4154,4369
17725,27455,4525,13284,3788,22930,8524,4155,4369
17730,27465,4527,13286,3789,22938,8526,4155,4371
17735,27471,4527,13290,3789,22943,8529,4157,4372
17740,27482,4531,13294,3792,22951,8531,4158,4373
17745,27486,4532,13295,3793,22954,8532,4158,4374
17750,27496,4533,13301,3794,22963,8534,4159,4375
17755,27502,4533,13304,3794,22969,8537,4161,4376
17760,27513,4535,13310,3795,22977,8539,4162,4377
17765,27517,4537,13313,3797,22980,8540,4163,4377
17770,27527,4538,13316,3798,22989,8542,4164,4378
17775,27533,4538,13318,3798,22995,8545,4165,4380
17780,27544,4540,13322,3799,23003,8547,4165,4382
17785,27548,4542,13324,3801,23006,8548,4165,4383
17790,27558,4544,13329,3802,23014,8550,4165,4385
17795,27564,4544,13332,3802,23020,8553,4166,4387
17800,27575,4545,13334,3803,23030,8555,4166,4389
17805,27579,4545,13335,3803,23034,8556,4166,4390
17810,27589,4547,13340,3804,23042,8558,4167,4391
17815,27595,4547,13342,3804,23047,8561,4168,4393
17820,27606,4550,13347,3807,23056,8564,4170,4394
17825,27610,4550,13347,3807,23060,8565,4170,4395
17830,27620,4551,13351,3808,23069,8567,4172,4395
17835,27626,4551,13353,3808,23075,8570,4174,4396
17840,27637,4552,13355,3809,23085,8573,4175,4398
17845,27641,4553,13356,3810,23088,8574,4175,4399
17850,27651,4554,13362,3811,23097,8576,4177,4399
17855,27657,4554,13365,3811,23103,8579,4178,4401
17860,27668,4557,13370,3813,23111,8582,4180,4402
17865,27672,4559,13374,3815,23113,8583,4181,4402
17870,27682,4561,13378,3816,23121,8585,4183,4402
17875,27688,4561,13384,3816,23126,8588,4186,4402
17880,27699,4563,13387,3817,23136,8591,4188,4403
17885,27703,4564,13388,3818,23139,8592,4188,4404
17890,27713,4566,13392,3820,23147,8594,4188,4406
17895,27719,4566,13394,3820,23153,8597,4190,4407
17900,27730,4569,13396,3822,23161,8600,4190,4410
17905,27734,4570,13399,3823,23164,8601,4191,4410
17910,27744,4571,13402,3823,23173,8603,4193,4410
17915,27750,4571,13406,3823,23178,8606,4194,4412
17920,27761,4573,13408,3824,23188,8609,4194,4415
17925,27765,4574,13411,3825,23191,8610,4195,4415
17930,27775,4577,13420,3828,23198,8612,4196,4416
17935,27781,4577,13425,3828,23203,8615,4199,4416
17940,27792,4580,13427,3830,23212,8618,4200,4418
17945,27796,4581,13430,3831,23215,8619,4201,4418
17950,27806,4582,13431,3831,23224,8621,4201,4420
17955,27812,4582,13434,3831,23229,8624,4202,4422
17960,27823,4587,13439,3835,23235,8627,4202,4425
17965,27827,4588,13440,3836,23239,8628,4203,4425
17970,27837,4590,13447,3837,23247,8630,4205,4425
17975,27843,4590,13449,3837,23253,8633,4207,4426
17980,27854,4592,13454,3839,23261,8636,4208,4428
17985,27858,4593,13456,3840,23265,8637,4209,4428
17990,27868,4595,13460,3841,23273,8639,4210,4429
17995,27874,4595,13462,3841,23279,8642,4211,4431
18000,27885,4598,13469,3843,23286,8645,4213,4432
18005,27889,4600,13471,3845,23289,8646,4214,4432
18010,27899,4603,13479,3848,23296,8648,4215,4433
18015,27905,4603,13481,3848,23301,8651,4216,4435
18020,27916,4608,13488,3852,23307,8654,4218,4436
18025,27920,4610,13490,3854,23310,8655,4218,4437
18030,27930,4612,13494,3855,23318,8657,4219,4438
18035,27936,4612,13498,3855,23324,8660,4221,4439
18040,27947,4615,13503,3858,23331,8663,4222,4441
18045,27951,4617,13505,3860,23334,8664,4223,4441
18050,27961,4619,13510,3862,23342,8666,4224,4442
18055,27967,4619,13513,3862,23348,8669,4226,4443
18060,27978,4620,13520,3863,23357,8672,4227,4445
18065,27982,4622,13521,3865,23360,8673,4227,4446
18070,27992,4623,13525,3866,23369,8675,4228,4447
18075,27998,4623,13526,3866,23375,8678,4228,4450
18080,28009,4623,13531,3866,23386,8681,4230,4451
18085,28013,4623,13532,3866,23390,8682,4230,4452
18090,28023,4624,13538,3867,23399,8684,4231,4453
18095,28029,4624,13540,3867,23405,8687,4232,4455
18100,28040,4624,13545,3867,23415,8690,4232,4458
18105,28044,4626,13549,3869,23418,8691,4233,4458
18110,28054,4627,13555,3869,23427,8693,4234,4459
18115,28060,4627,13557,3869,23433,8696,4236,4460
18120,28071,4627,13561,3869,23444,8699,4237,4462
18125,28075,4628,13562,3870,23447,8700,4237,4463
18130,28085,4629,13565,3871,23456,8702,4238,4464
18135,28091,4629,13568,3871,23461,8705,4240,4465
18140,28102,4630,13574,3872,23471,8708,4242,4466
18145,28106,4631,13576,3873,23475,8709,4243,4466
18150,28116,4632,13578,3873,23484,8711,4244,4467
18155,28122,4632,13579,3873,23490,8714,4245,4469
18160,28133,4633,13584,3874,23499,8717,4247,4470
18165,28137,4636,13586,3877,23501,8718,4247,4471
18170,28147,4639,13591,3879,23508,8720,4248,4472
18175,28153,4639,13594,3879,23513,8723,4249,4474
18180,28164,4643,13599,3882,23521,8726,4250,4476
18185,28168,4643,13600,3882,23525,8727,4250,4477
18190,28178,4646,13604,3884,23532,8729,4251,4478
18195,28184,4646,13606,3884,23537,8732,4251,4481
18200,28195,4651,13617,3889,23543,8735,4254,4481
18205,28199,4654,13619,3892,23545,8736,4254,4482
18210,28209,4656,13624,3893,23553,8738,4255,4483
18215,28215,4656,13625,3893,23559,8741,4255,4486
18220,28226,4657,13628,3894,23568,8744,4256,4488
18225,28230,4659,13630,3896,23571,8745,4256,4489
18230,28240,4662,13636,3899,23578,8747,4257,4490
18235,28246,4662,13641,3899,23583,8750,4259,4491
18240,28257,4666,13645,3903,23591,8753,4259,4494
18245,28261,4666,13645,3903,23595,8754,4259,4495
18250,28271,4666,13649,3903,23605,8756,4259,4497
18255,28277,4666,13653,3903,23611,8759,4261,4498
18260,28288,4667,13660,3904,23621,8762,4264,4498
18265,28292,4667,13661,3904,23625,8763,4264,4499
18270,28302,4667,13668,3904,23635,8765,4266,4499
18275,28308,4667,13671,3904,23641,8768,4268,4500
18280,28319,4668,13674,3904,23651,8771,4270,4501
18285,28323,4669,13676,3905,23654,8772,4270,4502
18290,28333,4669,13679,3905,23664,8774,4271,4503
18295,28339,4669,13679,3905,23670,8777,4271,4506
18300,28350,4670,13683,3905,23680,8780,4273,4507
18305,28354,4670,13684,3905,23684,8781,4273,4508
18310,28364,4670,13688,3905,23694,8783,4273,4510
18315,28370,4670,13690,3905,23700,8786,4274,4512
18320,28381,4671,13696,3905,23710,8789,4276,4513
18325,28385,4671,13697,3905,23714,8790,4277,4513
18330,28395,4671,13700,3905,23724,8792,4277,4515
18335,28401,4671,13703,3905,23730,8795,4278,4517
18340,28412,4672,13708,3905,23740,8798,4279,4519
18345,28416,4672,13710,3905,23744,8799,4280,4519
18350,28426,4673,13714,3906,23753,8801,4281,4520
18355,28432,4673,13717,3906,23759,8804,4283,4521
18360,28443,4676,13723,3908,23766,8807,4284,4523
18365,28447,4677,13725,3909,23770,8808,4285,4523
18370,28457,4678,13731,3910,23779,8810,4287,4523
18375,28463,4678,13734,3910,23785,8813,4289,4524
18380,28474,4680,13740,3911,23794,8815,4290,4525
18385,28478,4680,13742,3911,23798,8816,4291,4525
18390,28488,4681,13745,3911,23807,8818,4292,4526
18395,28494,4681,13748,3911,23812,8821,4294,4527
18400,28505,4686,13754,3916,23819,8823,4295,4528
18405,28509,4687,13756,3917,23822,8824,4296,4528
18410,28519,4690,13763,3920,23829,8826,4298,4528
18415,28525,4690,13766,3920,23835,8829,4300,4529
18420,28536,4694,13773,3924,23841,8831,4302,4529
18425,28540,4697,13776,3927,23843,8832,4302,4530
18430,28550,4699,13779,3929,23851,8834,4302,4532
18435,28556,4699,13783,3929,23856,8837,4303,4534
18440,28567,4703,13787,3932,23864,8839,4303,4536
18445,28571,4703,13788,3932,23868,8840,4303,4537
18450,28581,4704,13791,3932,23877,8842,4304,4538
18455,28587,4704,13793,3932,23883,8845,4305,4540
18460,28598,4706,13798,3934,23892,8847,4307,4540
18465,28602,4707,13801,3935,23895,8848,4308,4540
18470,28612,4709,13807,3936,23903,8850,4309,4541
18475,28618,4709,13811,3936,23908,8853,4311,4542
18480,28629,4713,13816,3940,23915,8856,4312,4544
18485,28633,4715,13817,3942,23918,8857,4312,4545
18490,28643,4717,13820,3944,23926,8859,4312,4547
18495,28649,4717,13823,3944,23931,8862,4313,4549
18500,28660,4719,13825,3945,23941,8865,4314,4551
18505,28664,4720,13827,3946,23944,8866,4315,4551
18510,28674,4722,13831,3948,23952,8868,4315,4553
18515,28680,4722,13835,3948,23957,8871,4316,4555
18520,28691,4724,13840,3950,23967,8874,4319,4555
18525,28695,4725,13842,3951,23970,8875,4319,4556
18530,28705,4727,13847,3953,23978,8877,4321,4556
18535,28711,4727,13851,3953,23984,8880,4323,4557
18540,28722,4730,13857,3956,23992,8883,4324,4559
18545,28726,4732,13861,3958,23994,8884,4325,4559
18550,28736,4733,13867,3959,24003,8886,4326,4560
18555,28742,4733,13870,3959,24009,8889,4328,4561
18560,28753,4735,13874,3960,24018,8892,4331,4561
18565,28757,4737,13877,3962,24020,8893,4332,4561
18570,28767,4739,13882,3963,24028,8895,4332,4563
18575,28773,4739,13885,3963,24034,8898,4334,4564
18580,28784,4742,13890,3965,24042,8901,4335,4566
18585,28788,4744,13893,3967,24044,8902,4335,4567
18590,28798,4746,13899,3969,24052,8904,4337,4567
18595,28804,4746,13902,3969,24058,8907,4339,4568
18600,28815,4748,13906,3970,24066,8910,4340,4570
18605,28819,4750,13907,3972,24069,8911,4340,4571
18610,28829,4753,13913,3975,24076,8913,4341,4572
18615,28835,4753,13915,3975,24082,8916,4343,4573
18620,28846,4753,13918,3975,24093,8919,4344,4575
18625,28850,4754,13920,3976,24096,8920,4345,4575
18630,28860,4755,13923,3977,24105,8922,4346,4576
18635,28866,4755,13928,3977,24111,8925,4349,4576
18640,28877,4755,13935,3977,24121,8928,4351,4577
18645,28881,4756,13935,3978,24125,8929,4351,4578
18650,28891,4757,13939,3978,24134,8931,4351,4580
18655,28897,4757,13940,3978,24139,8934,4351,4583
18660,28908,4758,13945,3979,24149,8937,4351,4586
18665,28912,4760,13947,3981,24152,8938,4352,4586
18670,28922,4761,13951,3981,24161,8940,4353,4587
18675,28928,4761,13954,3981,24167,8943,4354,4589
18680,28939,4761,13960,3981,24178,8946,4356,4590
18685,28943,4761,13961,3981,24182,8947,4357,4590
18690,28953,4762,13968,3982,24191,8949,4358,4591
18695,28959,4762,13971,3982,24196,8952,4359,4593
18700,28970,4763,13976,3983,24207,8955,4362,4593
18705,28974,4764,13977,3984,24210,8956,4362,4594
18710,28984,4765,13979,3984,24219,8958,4363,4595
18715,28990,4765,13983,3984,24224,8961,4364,4597
18720,29001,4768,13986,3987,24233,8964,4365,4599
18725,29005,4768,13987,3987,24237,8965,4365,4600
18730,29015,4770,13990,3988,24245,8967,4365,4602
18735,29021,4770,13992,3988,24250,8970,4365,4605
18740,29032,4773,13995,3990,24259,8973,4366,4607
18745,29036,4773,13995,3990,24263,8974,4366,4608
18750,29046,4774,13998,3990,24272,8976,4367,4609
18755,29052,4774,14003,3990,24277,8979,4369,4610
18760,29063,4778,14010,3994,24285,8982,4372,4610
18765,29067,4780,14012,3996,24287,8983,4372,4611
18770,29077,4782,14017,3998,24295,8985,4372,4613
18775,29083,4782,14019,3998,24301,8988,4373,4615
18780,29094,4785,14024,4001,24308,8991,4373,4618
18785,29098,4786,14024,4002,24312,8992,4373,4619
18790,29108,4787,14030,4003,24321,8994,4374,4620
18795,29114,4787,14035,4003,24326,8997,4376,4621
18800,29125,4790,14041,4006,24334,9000,4377,4623
18805,29129,4792,14044,4008,24337,9001,4378,4623
18810,29139,4794,14048,4010,24345,9003,4378,4625
18815,29145,4794,14051,4010,24350,9006,4379,4627
18820,29156,4797,14054,4012,24359,9009,4381,4628
18825,29160,4799,14057,4014,24361,9010,4382,4628
18830,29170,4800,14062,4015,24370,9012,4382,4630
18835,29176,4800,14067,4015,24375,9015,4385,4630
18840,29187,4804,14072,4018,24383,9018,4386,4632
18845,29191,4804,14073,4018,24387,9019,4386,4633
18850,29201,4807,14080,4021,24394,9021,4387,4634
18855,29207,4807,14081,4021,24399,9024,4387,4637
18860,29218,4812,14091,4026,24405,9027,4390,4637
18865,29222,4814,14093,4028,24408,9028,4390,4638
18870,29232,4815,14100,4029,24417,9030,4391,4639
18875,29238,4815,14103,4029,24423,9033,4393,4640
18880,29249,4819,14108,4032,24430,9036,4395,4641
18885,29253,4821,14111,4034,24432,9037,4396,4641
18890,29263,4823,14115,4035,24440,9039,4396,4643
18895,29269,4823,14118,4035,24446,9042,4398,4644
18900,29280,4827,14125,4039,24453,9045,4401,4644
18905,29284,4827,14128,4039,24457,9046,4402,4644
18910,29294,4829,14131,4041,24465,9048,4402,4646
18915,29300,4829,14135,4041,24471,9051,4404,4647
18920,29311,4831,14139,4043,24480,9054,4404,4650
18925,29315,4832,14140,4044,24483,9055,4404,4651
18930,29325,4833,14145,4045,24492,9057,4405,4652
18935,29331,4833,14148,4045,24498,9060,4407,4653
18940,29342,4835,14152,4046,24507,9063,4407,4656
18945,29346,4835,14154,4046,24511,9064,4407,4657
18950,29356,4835,14157,4046,24521,9066,4407,4659
18955,29362,4835,14159,4046,24527,9069,4408,4661
18960,29373,4835,14167,4046,24538,9072,4410,4662
18965,29377,4835,14167,4046,24542,9073,4410,4663
18970,29387,4835,14171,4046,24552,9075,4411,4664
18975,29393,4835,14174,4046,24558,9078,4412,4666
18980,29404,4835,14179,4046,24569,9081,4414,4667
18985,29408,4835,14180,4046,24573,9082,4414,4668
18990,29418,4835,14184,4046,24583,9084,4415,4669
18995,29424,4835,14187,4046,24589,9087,4416,4671
19000,29435,4835,14194,4046,24600,9090,4418,4672
19005,29439,4835,14197,4046,24604,9091,4419,4672
19010,29449,4836,14202,4047,24613,9093,4420,4673
19015,29455,4836,14206,4047,24619,9096,4422,4674
19020,29466,4837,14213,4048,24629,9099,4424,4675
19025,29470,4837,14214,4048,24633,9100,4425,4675
19030,29480,4838,14219,4048,24642,9102,4426,4676
19035,29486,4838,14222,4048,24647,9105,4427,4678
19040,29497,4839,14227,4049,24657,9107,4428,4679
19045,29501,4840,14229,4050,24661,9108,4429,4679
19050,29511,4842,14236,4052,24669,9110,4431,4679
19055,29517,4842,14238,4052,24675,9113,4431,4682
19060,29528,4846,14248,4056,24682,9115,4433,4682
19065,29532,4847,14251,4057,24685,9116,4433,4683
19070,29542,4849,14257,4058,24693,9118,4435,4683
19075,29548,4849,14257,4058,24699,9121,4435,4686
19080,29559,4852,14265,4061,24707,9123,4436,4687
19085,29563,4852,14266,4061,24711,9124,4437,4687
19090,29573,4854,14270,4062,24719,9126,4438,4688
19095,29579,4854,14273,4062,24725,9129,4440,4689
19100,29590,4857,14277,4065,24733,9131,4440,4691
19105,29594,4857,14279,4065,24737,9132,4441,4691
19110,29604,4859,14284,4067,24745,9134,4441,4693
19115,29610,4859,14288,4067,24750,9137,4443,4694
19120,29621,4862,14292,4069,24758,9139,4443,4696
19125,29625,4864,14293,4071,24761,9140,4443,4697
19130,29635,4867,14299,4073,24768,9142,4444,4698
19135,29641,4867,14303,4073,24773,9145,4446,4699
19140,29652,4872,14309,4077,24779,9148,4448,4700
19145,29656,4875,14313,4080,24781,9149,4449,4700
19150,29666,4877,14320,4081,24789,9151,4451,4700
19155,29672,4877,14324,4081,24794,9154,4453,4701
19160,29683,4881,14330,4084,24802,9157,4455,4702
19165,29687,4881,14330,4084,24806,9158,4455,4703
19170,29697,4883,14336,4086,24814,9160,4456,4704
19175,29703,4883,14339,4086,24820,9163,4458,4705
19180,29714,4885,14343,4087,24829,9166,4459,4707
19185,29718,4886,14345,4088,24832,9167,4460,4707
19190,29728,4887,14350,4088,24841,9169,4462,4707
19195,29734,4887,14352,4088,24847,9172,4462,4710
19200,29745,4890,14359,4091,24854,9175,4464,4711
19205,29749,4891,14359,4092,24858,9176,4464,4712
19210,29759,4892,14367,4093,24867,9178,4466,4712
19215,29765,4892,14370,4093,24872,9181,4467,4714
19220,29776,4894,14376,4095,24881,9184,4468,4716
19225,29780,4896,14380,4097,24884,9185,4469,4716
19230,29790,4897,14386,4098,24893,9187,4471,4716
19235,29796,4897,14389,4098,24898,9190,4472,4718
19240,29807,4898,14396,4099,24908,9193,4474,4719
19245,29811,4899,14396,4100,24912,9194,4474,4720
19250,29821,4900,14401,4100,24921,9196,4476,4720
19255,29827,4900,14404,4100,24926,9199,4477,4722
19260,29838,4901,14411,4101,24937,9202,4479,4723
19265,29842,4902,14415,4102,24940,9203,4480,4723
19270,29852,4903,14419,4102,24949,9205,4481,4724
19275,29858,4903,14421,4102,24955,9208,4483,4725
19280,29869,4904,14426,4103,24964,9211,4483,4728
19285,29873,4905,14428,4104,24968,9212,4484,4728
19290,29883,4906,14430,4104,24977,9214,4484,4730
19295,29889,4906,14434,4104,24982,9217,4485,4732
19300,29900,4907,14440,4105,24993,9220,4487,4733
19305,29904,4908,14441,4106,24996,9221,4487,4734
19310,29914,4910,14447,4108,25004,9223,4489,4734
19315,29920,4910,14451,4108,25009,9226,4491,4735
19320,29931,4915,14456,4112,25015,9229,4492,4737
19325,29935,4917,14457,4114,25018,9230,4492,4738
19330,29945,4919,14461,4115,25026,9232,4493,4739
19335,29951,4919,14464,4115,25031,9235,4494,4741
19340,29962,4923,14472,4119,25039,9238,4496,4742
19345,29966,4925,14474,4121,25041,9239,4496,4743
19350,29976,4926,14478,4121,25050,9241,4497,4744
19355,29982,4926,14482,4121,25056,9244,4500,4744
19360,29993,4929,14487,4124,25064,9247,4501,4746
19365,29997,4931,14490,4126,25066,9248,4502,4746
19370,30007,4934,14496,4128,25073,9250,4503,4747
19375,30013,4934,14500,4128,25078,9253,4505,4748
19380,30024,4937,14506,4130,25086,9256,4507,4749
19385,30028,4940,14508,4133,25088,9257,4507,4750
19390,30038,4943,14515,4136,25095,9259,4508,4751
19395,30044,4943,14516,4136,25101,9262,4509,4753
19400,30055,4945,14518,4137,25109,9265,4509,4756
19405,30059,4948,14521,4140,25111,9266,4509,4757
19410,30069,4949,14527,4141,25120,9268,4509,4759
19415,30075,4949,14529,4141,25126,9271,4510,4761
19420,30086,4951,14533,4142,25134,9274,4510,4764
19425,30090,4952,14534,4143,25138,9275,4510,4765
19430,30100,4954,14541,4145,25146,9277,4511,4766
19435,30106,4954,14545,4145,25152,9280,4514,4766
19440,30117,4958,14552,4148,25159,9283,4516,4767
19445,30121,4958,14552,4148,25163,9284,4516,4768
19450,30131,4960,14555,4149,25171,9286,4517,4769
19455,30137,4960,14558,4149,25176,9289,4519,4770
19460,30148,4963,14563,4151,25185,9292,4521,4771
19465,30152,4964,14565,4152,25188,9293,4521,4772
19470,30162,4966,14567,4153,25196,9295,4521,4774
19475,30168,4966,14569,4153,25201,9298,4521,4777
19480,30179,4969,14574,4155,25210,9301,4524,4777
19485,30183,4971,14577,4157,25212,9302,4525,4777
19490,30193,4972,14582,4158,25221,9304,4525,4779
19495,30199,4972,14586,4158,25226,9307,4527,4780
19500,30210,4974,14591,4160,25236,9310,4530,4780
19505,30214,4974,14592,4160,25240,9311,4530,4781
19510,30224,4974,14595,4160,25250,9313,4531,4782
19515,30230,4974,14597,4160,25256,9316,4531,4785
19520,30241,4974,14604,4160,25267,9319,4533,4786
19525,30245,4974,14605,4160,25271,9320,4534,4786
19530,30255,4974,14611,4160,25281,9322,4535,4787
19535,30261,4974,14614,4160,25287,9325,4537,4788
19540,30272,4974,14617,4160,25298,9328,4537,4791
19545,30276,4974,14620,4160,25302,9329,4538,4791
19550,30286,4974,14624,4160,25312,9331,4540,4791
19555,30292,4974,14627,4160,25318,9334,4541,4793
19560,30303,4974,14631,4160,25329,9337,4541,4796
19565,30307,4974,14632,4160,25333,9338,4542,4796
19570,30317,4974,14637,4160,25343,9340,4543,4797
19575,30323,4974,14640,4160,25349,9343,4545,4798
19580,30334,4974,14647,4160,25360,9346,4546,4800
19585,30338,4974,14650,4160,25364,9347,4547,4800
19590,30348,4974,14652,4160,25374,9349,4547,4802
19595,30354,4974,14655,4160,25380,9352,4548,4804
19600,30365,4977,14662,4163,25388,9355,4550,4805
19605,30369,4977,14662,4163,25392,9356,4550,4806
19610,30379,4978,14667,4164,25401,9358,4552,4806
19615,30385,4978,14670,4164,25406,9361,4553,4808
19620,30396,4982,14676,4167,25413,9364,4555,4809
19625,30400,4983,14677,4168,25417,9365,4555,4810
19630,30410,4985,14683,4169,25425,9367,4556,4811
19635,30416,4985,14686,4169,25430,9370,4557,4813
19640,30427,4988,14693,4172,25438,9373,4559,4814
19645,30431,4990,14695,4174,25441,9374,4560,4814
19650,30441,4992,14700,4175,25449,9376,4562,4814
19655,30447,4992,14702,4175,25454,9379,4562,4817
19660,30458,4996,14707,4178,25462,9382,4563,4819
19665,30462,4996,14707,4178,25466,9383,4563,4820
19670,30472,4997,14711,4178,25475,9385,4564,4821
19675,30478,4997,14714,4178,25480,9388,4565,4823
19680,30489,5000,14720,4181,25488,9391,4566,4825
19685,30493,5001,14722,4182,25492,9392,4567,4825
19690,30503,5004,14727,4184,25499,9394,4568,4826
19695,30509,5004,14730,4184,25504,9397,4569,4828
19700,30520,5006,14733,4185,25513,9399,4569,4830
19705,30524,5008,14736,4187,25516,9400,4569,4831
19710,30534,5010,14742,4189,25524,9402,4570,4832
19715,30540,5010,14744,4189,25530,9405,4572,4833
19720,30551,5013,14748,4191,25538,9407,4573,4834
19725,30555,5013,14750,4191,25542,9408,4574,4834
19730,30565,5014,14755,4192,25551,9410,4575,4835
19735,30571,5014,14760,4192,25556,9413,4577,4836
19740,30582,5019,14768,4197,25563,9415,4578,4837
19745,30586,5021,14772,4199,25565,9416,4579,4837
19750,30596,5024,14779,4202,25572,9418,4580,4838
19755,30602,5024,14783,4202,25577,9421,4582,4839
19760,30613,5028,14789,4206,25584,9423,4583,4840
19765,30617,5029,14791,4207,25588,9424,4584,4840
19770,30627,5031,14796,4208,25596,9426,4585,4841
19775,30633,5031,14799,4208,25601,9429,4586,4843
19780,30644,5035,14805,4212,25608,9431,4587,4844
19785,30648,5036,14807,4213,25612,9432,4588,4844
19790,30658,5039,14812,4215,25619,9434,4589,4845
19795,30664,5039,14816,4215,25624,9437,4590,4847
19800,30675,5042,14823,4218,25633,9440,4592,4848
19805,30679,5043,14826,4219,25636,9441,4593,4848
19810,30689,5044,14831,4219,25645,9443,4594,4849
19815,30695,5044,14835,4219,25651,9446,4596,4850
19820,30706,5045,14840,4219,25661,9449,4598,4851
19825,30710,5046,14842,4220,25664,9450,4599,4851
19830,30720,5047,14843,4220,25673,9452,4599,4853
19835,30726,5047,14845,4220,25679,9455,4601,4854
19840,30737,5048,14850,4221,25688,9458,4602,4856
19845,30741,5049,14851,4222,25692,9459,4602,4857
19850,30751,5050,14853,4222,25701,9461,4603,4858
19855,30757,5050,14856,4222,25707,9464,4604,4860
19860,30768,5052,14866,4224,25715,9467,4606,4861
19865,30772,5054,14868,4226,25718,9468,4607,4861
19870,30782,5055,14871,4226,25727,9470,4608,4862
19875,30788,5055,14876,4226,25732,9473,4611,4862
19880,30799,5058,14882,4228,25741,9476,4613,4863
19885,30803,5059,14884,4229,25744,9477,4614,4863
19890,30813,5060,14889,4229,25753,9479,4615,4864
19895,30819,5060,14893,4229,25759,9482,4617,4865
19900,30830,5062,14898,4230,25768,9485,4618,4867
19905,30834,5062,14899,4230,25772,9486,4618,4868
19910,30844,5064,14904,4232,25780,9488,4618,4870
19915,30850,5064,14907,4232,25786,9491,4621,4870
19920,30861,5066,14911,4233,25795,9494,4623,4871
19925,30865,5068,14914,4235,25797,9495,4623,4872
19930,30875,5070,14918,4236,25805,9497,4625,4872
19935,30881,5070,14920,4236,25810,9500,4625,4875
19940,30892,5073,14924,4239,25819,9503,4627,4876
19945,30896,5074,14927,4240,25822,9504,4628,4876
19950,30906,5077,14932,4242,25829,9506,4630,4876
19955,30912,5077,14934,4242,25835,9509,4631,4878
19960,30923,5080,14942,4245,25843,9512,4634,4878
19965,30927,5080,14943,4245,25847,9513,4634,4879
19970,30937,5082,14950,4247,25855,9515,4634,4881
19975,30943,5082,14953,4247,25860,9518,4635,4883
19980,30954,5084,14956,4249,25869,9521,4635,4886
19985,30958,5086,14959,4251,25872,9522,4636,4886
19990,30968,5088,14962,4252,25880,9524,4636,4888
19995,30974,5088,14966,4252,25885,9527,4638,4889
20000,30985,5092,14971,4255,25893,9530,4641,4889
20005,30989,5094,14975,4257,25895,9531,4642,4889
20010,30999,5097,14982,4260,25902,9533,4642,4891
20015,31005,5097,14985,4260,25907,9536,4644,4892
20020,31016,5102,14993,4265,25914,9539,4645,4894
20025,31020,5103,14996,4266,25917,9540,4646,4894
20030,31030,5105,15000,4268,25925,9542,4646,4896
20035,31036,5105,15002,4268,25931,9545,4647,4898
20040,31047,5105,15007,4268,25942,9548,4648,4900
20045,31051,5105,15008,4268,25946,9549,4648,4901
20050,31061,5105,15013,4268,25956,9551,4650,4901
20055,31067,5105,15017,4268,25962,9554,4652,4902
20060,31078,5105,15020,4268,25973,9557,4652,4905
20065,31082,5105,15023,4268,25977,9558,4652,4906
20070,31092,5105,15027,4268,25987,9560,4653,4907
20075,31098,5105,15029,4268,25993,9563,4654,4909
20080,31109,5105,15034,4268,26004,9566,4656,4910
20085,31113,5105,15037,4268,26008,9567,4656,4911
20090,31123,5105,15040,4268,26018,9569,4657,4912
20095,31129,5105,15044,4268,26024,9572,4659,4913
20100,31140,5105,15048,4268,26035,9575,4660,4915
20105,31144,5105,15049,4268,26039,9576,4660,4916
20110,31154,5105,15054,4268,26049,9578,4661,4917
20115,31160,5105,15058,4268,26055,9581,4663,4918
20120,31171,5105,15060,4268,26066,9584,4664,4920
20125,31175,5105,15060,4268,26070,9585,4664,4921
20130,31185,5106,15064,4268,26079,9587,4665,4922
20135,31191,5106,15065,4268,26085,9590,4665,4925
20140,31202,5109,15071,4271,26092,9593,4666,4927
20145,31206,5110,15072,4272,26096,9594,4666,4928
20150,31216,5111,15073,4272,26105,9596,4666,4930
20155,31222,5111,15074,4272,26111,9599,4667,4932
20160,31233,5113,15079,4273,26119,9602,4669,4933
20165,31237,5114,15080,4274,26123,9603,4669,4934
20170,31247,5117,15087,4277,26130,9605,4670,4935
20175,31253,5117,15091,4277,26135,9608,4672,4936
20180,31264,5120,15098,4280,26143,9611,4674,4937
20185,31268,5122,15100,4282,26146,9612,4675,4937
20190,31278,5124,15106,4283,26154,9614,4676,4938
20195,31284,5124,15109,4283,26159,9617,4677,4940
20200,31295,5128,15117,4287,26167,9620,4679,4941
20205,31299,5129,15118,4288,26170,9621,4679,4942
20210,31309,5131,15123,4289,26178,9623,4681,4942
20215,31315,5131,15125,4289,26183,9626,4682,4944
20220,31326,5134,15131,4292,26191,9629,4683,4946
20225,31330,5136,15132,4294,26194,9630,4683,4947
20230,31340,5138,15138,4295,26202,9632,4685,4947
20235,31346,5138,15139,4295,26208,9635,4686,4949
20240,31357,5141,15145,4297,26215,9638,4688,4950
20245,31361,5144,15148,4300,26217,9639,4688,4951
20250,31371,5146,15152,4301,26225,9641,4688,4953
20255,31377,5146,15155,4301,26230,9644,4689,4955
20260,31388,5148,15157,4302,26239,9647,4690,4957
20265,31392,5149,15159,4303,26243,9648,4691,4957
20270,31402,5152,15166,4306,26250,9650,4692,4958
20275,31408,5152,15170,4306,26255,9653,4694,4959
20280,31419,5154,15173,4307,26265,9656,4695,4961
20285,31423,5154,15173,4307,26269,9657,4695,4962
20290,31433,5155,15177,4307,26278,9659,4695,4964
20295,31439,5155,15180,4307,26284,9662,4697,4965
20300,31450,5159,15186,4311,26291,9665,4698,4967
20305,31454,5159,15187,4311,26295,9666,4699,4967
20310,31464,5161,15193,4312,26303,9668,4701,4967
20315,31470,5161,15199,4312,26308,9671,4704,4967
20320,31481,5166,15206,4317,26314,9674,4705,4969
20325,31485,5167,15206,4318,26318,9675,4705,4970
20330,31495,5168,15210,4318,26327,9677,4705,4972
20335,31501,5168,15214,4318,26332,9680,4706,4974
20340,31512,5171,15218,4321,26340,9683,4706,4977
20345,31516,5173,15220,4323,26343,9684,4706,4978
20350,31526,5176,15225,4325,26350,9686,4707,4979
20355,31532,5176,15227,4325,26355,9689,4708,4981
20360,31543,5180,15232,4329,26363,9691,4709,4982
20365,31547,5180,15233,4329,26367,9692,4709,4983
20370,31557,5182,15238,4331,26375,9694,4710,4984
20375,31563,5182,15240,4331,26380,9697,4710,4987
20380,31574,5186,15244,4334,26388,9699,4711,4988
20385,31578,5187,15245,4335,26391,9700,4711,4989
20390,31588,5188,15250,4336,26400,9702,4712,4990
20395,31594,5188,15253,4336,26405,9705,4713,4992
20400,31605,5190,15262,4338,26414,9707,4714,4993
20405,31609,5192,15265,4340,26417,9708,4715,4993
20410,31619,5193,15269,4340,26426,9710,4717,4993
20415,31625,5193,15271,4340,26431,9713,4717,4996
20420,31636,5194,15274,4341,26441,9715,4718,4997
20425,31640,5195,15275,4342,26445,9716,4718,4998
20430,31650,5196,15279,4343,26454,9718,4719,4999
20435,31656,5196,15281,4343,26460,9721,4719,5002
20440,31667,5197,15287,4344,26469,9723,4720,5003
20445,31671,5198,15289,4345,26473,9724,4721,5003
20450,31681,5199,15295,4346,26482,9726,4723,5003
20455,31687,5199,15296,4346,26488,9729,4724,5005
20460,31698,5200,15300,4347,26498,9732,4727,5005
20465,31702,5200,15302,4347,26502,9733,4727,5006
20470,31712,5201,15308,4347,26511,9735,4729,5006
20475,31718,5201,15312,4347,26517,9738,4731,5007
20480,31729,5202,15320,4348,26526,9741,4733,5008
20485,31733,5204,15323,4350,26529,9742,4733,5009
20490,31743,5207,15328,4352,26536,9744,4734,5010
20495,31749,5207,15332,4352,26542,9747,4736,5011
20500,31760,5209,15336,4354,26551,9750,4737,5013
20505,31764,5210,15337,4355,26554,9751,4737,5014
20510,31774,5212,15344,4357,26562,9753,4737,5016
20515,31780,5212,15348,4357,26568,9756,4740,5016
20520,31791,5214,15351,4359,26577,9759,4741,5018
20525,31795,5215,15352,4360,26580,9760,4741,5019
20530,31805,5216,15355,4360,26589,9762,4741,5021
20535,31811,5216,15358,4360,26594,9765,4742,5023
20540,31822,5219,15363,4362,26602,9768,4743,5025
20545,31826,5221,15365,4364,26605,9769,4743,5026
20550,31836,5223,15371,4366,26613,9771,4744,5027
20555,31842,5223,15374,4366,26618,9774,4746,5028
20560,31853,5226,15380,4368,26627,9777,4748,5029
20565,31857,5226,15380,4368,26631,9778,4748,5030
20570,31867,5227,15382,4368,26640,9780,4748,5032
20575,31873,5227,15387,4368,26645,9783,4750,5033
20580,31884,5232,15391,4372,26651,9786,4750,5036
20585,31888,5233,15393,4373,26655,9787,4751,5036
20590,31898,5234,15399,4374,26664,9789,4751,5038
20595,31904,5234,15402,4374,26670,9792,4752,5040
20600,31915,5236,15409,4376,26679,9795,4755,5040
20605,31919,5236,15411,4376,26683,9796,4756,5040
20610,31929,5237,15416,4377,26692,9798,4758,5040
20615,31935,5237,15418,4377,26698,9801,4759,5042
20620,31946,5238,15424,4377,26708,9804,4761,5043
20625,31950,5239,15428,4378,26711,9805,4762,5043
20630,31960,5239,15433,4378,26721,9807,4764,5043
20635,31966,5239,15434,4378,26727,9810,4764,5046
20640,31977,5241,15442,4379,26736,9813,4767,5046
20645,31981,5242,15444,4380,26739,9814,4767,5047
20650,31991,5244,15448,4382,26747,9816,4768,5048
20655,31997,5244,15452,4382,26753,9819,4770,5049
20660,32008,5245,15457,4382,26763,9822,4773,5049
20665,32012,5245,15458,4382,26767,9823,4773,5050
20670,32022,5245,15461,4382,26777,9825,4774,5051
20675,32028,5245,15465,4382,26783,9828,4775,5053
20680,32039,5246,15471,4382,26793,9831,4776,5055
20685,32043,5247,15472,4383,26796,9832,4776,5056
20690,32053,5248,15477,4384,26805,9834,4776,5058
20695,32059,5248,15481,4384,26811,9837,4778,5059
20700,32070,5250,15489,4385,26819,9840,4780,5060
20705,32074,5252,15491,4387,26822,9841,4781,5060
20710,32084,5253,15495,4388,26831,9843,4781,5062
20715,32090,5253,15500,4388,26836,9846,4784,5062
20720,32101,5255,15504,4389,26845,9849,4785,5064
20725,32105,5256,15506,4390,26849,9850,4786,5064
20730,32115,5257,15511,4390,26858,9852,4786,5066
20735,32121,5257,15512,4390,26863,9855,4786,5069
20740,32132,5259,15515,4391,26873,9858,4788,5070
20745,32136,5261,15517,4393,26875,9859,4788,5071
20750,32146,5262,15524,4394,26884,9861,4790,5071
20755,32152,5262,15529,4394,26889,9864,4793,5071
20760,32163,5265,15533,4396,26897,9867,4793,5074
20765,32167,5266,15533,4397,26901,9868,4793,5075
20770,32177,5267,15538,4397,26910,9870,4794,5076
20775,32183,5267,15541,4397,26916,9873,4796,5077
20780,32194,5269,15545,4398,26924,9876,4797,5079
20785,32198,5271,15547,4400,26927,9877,4798,5079
20790,32208,5273,15552,4401,26935,9879,4799,5080
20795,32214,5273,15555,4401,26941,9882,4801,5081
20800,32225,5275,15561,4403,26950,9885,4803,5082
20805,32229,5275,15561,4403,26954,9886,4803,5083
20810,32239,5277,15566,4405,26962,9888,4803,5085
20815,32245,5277,15570,4405,26967,9891,4805,5086
20820,32256,5282,15576,4409,26974,9894,4807,5087
20825,32260,5283,15579,4410,26977,9895,4808,5087
20830,32270,5286,15586,4413,26984,9897,4809,5088
20835,32276,5286,15588,4413,26989,9900,4809,5091
20840,32287,5291,15596,4418,26996,9903,4811,5092
20845,32291,5291,15597,4418,27000,9904,4811,5093
20850,32301,5292,15602,4418,27009,9906,4813,5093
20855,32307,5292,15604,4418,27015,9909,4815,5094
20860,32318,5294,15609,4420,27024,9912,4816,5096
20865,32322,5294,15609,4420,27028,9913,4816,5097
20870,32332,5296,15613,4421,27036,9915,4817,5098
20875,32338,5296,15615,4421,27041,9918,4818,5100
20880,32349,5299,15620,4424,27049,9921,4820,5101
20885,32353,5301,15623,4426,27052,9922,4821,5101
20890,32363,5302,15626,4426,27061,9924,4822,5102
20895,32369,5302,15628,4426,27067,9927,4822,5105
20900,32380,5305,15633,4429,27075,9930,4822,5108
20905,32384,5305,15634,4429,27079,9931,4823,5108
20910,32394,5308,15641,4431,27086,9933,4825,5108
20915,32400,5308,15644,4431,27091,9936,4826,5110
20920,32411,5311,15652,4434,27100,9939,4829,5110
20925,32415,5311,15654,4434,27104,9940,4830,5110
20930,32425,5314,15661,4437,27111,9942,4832,5110
20935,32431,5314,15664,4437,27117,9945,4833,5112
20940,32442,5317,15668,4439,27125,9948,4834,5114
20945,32446,5319,15671,4441,27127,9949,4834,5115
20950,32456,5322,15677,4443,27134,9951,4835,5116
20955,32462,5322,15680,4443,27139,9954,4835,5119
20960,32473,5325,15687,4445,27147,9957,4837,5120
20965,32477,5326,15690,4446,27151,9958,4838,5120
20970,32487,5328,15694,4448,27159,9960,4838,5122
20975,32493,5328,15698,4448,27165,9963,4840,5123
20980,32504,5331,15705,4451,27173,9966,4842,5124
20985,32508,5332,15708,4452,27176,9967,4843,5124
20990,32518,5335,15715,4455,27183,9969,4844,5125
20995,32524,5335,15718,4455,27189,9972,4845,5127
21000,32535,5339,15727,4459,27196,9975,4848,5127
21005,32539,5339,15728,4459,27200,9976,4848,5128
21010,32549,5342,15735,4461,27207,9978,4850,5128
21015,32555,5342,15740,4461,27212,9981,4852,5129
21020,32566,5346,15744,4464,27219,9983,4853,5130
21025,32570,5347,15745,4465,27223,9984,4854,5130
21030,32580,5348,15746,4465,27232,9986,4854,5132
21035,32586,5348,15747,4465,27238,9989,4854,5135
21040,32597,5348,15751,4465,27248,9991,4856,5135
21045,32601,5349,15753,4466,27252,9992,4856,5136
21050,32611,5350,15756,4466,27261,9994,4857,5137
21055,32617,5350,15760,4466,27266,9997,4858,5139
21060,32628,5351,15764,4467,27277,9999,4859,5140
21065,32632,5352,15766,4468,27280,10000,4859,5141
21070,32642,5353,15771,4469,27289,10002,4860,5142
21075,32648,5353,15773,4469,27295,10005,4862,5143
21080,32659,5353,15777,4469,27306,10007,4863,5144
21085,32663,5354,15779,4470,27309,10008,4864,5144
21090,32673,5355,15783,4471,27318,10010,4865,5145
21095,32679,5355,15786,4471,27324,10013,4867,5146
21100,32690,5355,15791,4471,27335,10015,4868,5147
21105,32694,5355,15792,4471,27339,10016,4868,5148
21110,32704,5356,15795,4472,27348,10018,4868,5150
21115,32710,5356,15796,4472,27354,10021,4869,5152
21120,32721,5356,15802,4472,27364,10024,4871,5153
21125,32725,5357,15805,4473,27368,10025,4872,5153
21130,32735,5359,15811,4475,27376,10027,4873,5154
21135,32741,5359,15812,4475,27382,10030,4874,5156
21140,32752,5361,15816,4476,27390,10033,4875,5158
21145,32756,5362,15817,4477,27394,10034,4876,5158
21150,32766,5364,15824,4479,27402,10036,4877,5159
21155,32772,5364,15827,4479,27408,10039,4879,5160
21160,32783,5368,15832,4482,27415,10042,4880,5162
21165,32787,5370,15835,4484,27417,10043,4880,5163
21170,32797,5372,15839,4485,27425,10045,4881,5164
21175,32803,5372,15844,4485,27430,10048,4883,5165
21180,32814,5374,15850,4487,27439,10051,4886,5165
21185,32818,5377,15852,4490,27441,10052,4886,5166
21190,32828,5379,15857,4491,27449,10054,4887,5167
21195,32834,5379,15862,4491,27455,10057,4890,5167
21200,32845,5381,15867,4493,27464,10060,4893,5167
21205,32849,5381,15869,4493,27468,10061,4894,5167
21210,32859,5383,15872,4495,27476,10063,4894,5169
21215,32865,5383,15876,4495,27482,10066,4896,5170
21220,32876,5386,15882,4497,27490,10069,4897,5172
21225,32880,5387,15884,4498,27493,10070,4897,5173
21230,32890,5388,15889,4499,27502,10072,4898,5174
21235,32896,5388,15892,4499,27508,10075,4901,5174
21240,32907,5389,15896,4499,27518,10078,4903,5175
21245,32911,5390,15897,4500,27521,10079,4903,5176
21250,32921,5391,15901,4500,27530,10081,4905,5176
21255,32927,5391,15902,4500,27535,10084,4905,5179
21260,32938,5395,15909,4503,27542,10087,4908,5179
21265,32942,5396,15910,4504,27546,10088,4908,5180
21270,32952,5398,15918,4506,27554,10090,4910,5180
21275,32958,5398,15921,4506,27559,10093,4911,5182
21280,32969,5400,15925,4508,27569,10096,4913,5183
21285,32973,5402,15929,4510,27571,10097,4914,5183
21290,32983,5404,15938,4512,27579,10099,4916,5183
21295,32989,5404,15939,4512,27585,10102,4916,5186
21300,33000,5407,15945,4515,27593,10105,4916,5189
21305,33004,5408,15947,4516,27596,10106,4917,5189
21310,33014,5410,15949,4518,27604,10108,4917,5191
21315,33020,5410,15950,4518,27610,10111,4918,5193
21320,33031,5412,15955,4520,27619,10114,4919,5195
21325,33035,5413,15958,4521,27622,10115,4920,5195
21330,33045,5415,15962,4522,27630,10117,4921,5196
21335,33051,5415,15965,4522,27635,10120,4923,5197
21340,33062,5420,15973,4527,27642,10123,4925,5198
21345,33066,5421,15974,4528,27645,10124,4925,5199
21350,33076,5423,15980,4530,27653,10126,4927,5199
21355,33082,5423,15982,4530,27658,10129,4927,5202
21360,33093,5425,15987,4532,27667,10132,4928,5204
21365,33097,5428,15990,4535,27669,10133,4928,5205
21370,33107,5430,15994,4537,27677,10135,4929,5206
21375,33113,5430,15999,4537,27683,10138,4932,5206
21380,33124,5432,16003,4538,27692,10141,4934,5207
21385,33128,5432,16005,4538,27696,10142,4934,5208
21390,33138,5432,16009,4538,27706,10144,4935,5209
21395,33144,5432,16015,4538,27712,10147,4938,5209
21400,33155,5433,16017,4538,27722,10150,4940,5210
21405,33159,5433,16019,4538,27726,10151,4941,5210
21410,33169,5434,16024,4539,27735,10153,4942,5211
21415,33175,5434,16025,4539,27741,10156,4943,5213
21420,33186,5436,16028,4541,27750,10159,4943,5216
21425,33190,5436,16030,4541,27754,10160,4944,5216
21430,33200,5438,16037,4543,27762,10162,4946,5216
21435,33206,5438,16041,4543,27768,10165,4949,5216
21440,33217,5439,16045,4543,27778,10168,4951,5217
21445,33221,5440,16047,4544,27781,10169,4952,5217
21450,33231,5441,16051,4545,27790,10171,4953,5218
21455,33237,5441,16056,4545,27796,10174,4956,5218
21460,33248,5444,16061,4547,27804,10177,4958,5219
21465,33252,5444,16062,4547,27808,10178,4958,5220
21470,33262,5446,16064,4548,27816,10180,4958,5222
21475,33268,5446,16066,4548,27822,10183,4960,5223
21480,33279,5448,16073,4549,27830,10186,4962,5224
21485,33283,5450,16076,4551,27833,10187,4963,5224
21490,33293,5451,16080,4552,27842,10189,4963,5226
21495,33299,5451,16085,4552,27847,10192,4965,5227
21500,33310,5452,16090,4553,27857,10195,4967,5228
21505,33314,5453,16092,4554,27861,10196,4968,5228
21510,33324,5454,16097,4554,27870,10198,4970,5228
21515,33330,5454,16100,4554,27875,10201,4971,5230
21520,33341,5455,16103,4555,27886,10204,4973,5231
21525,33345,5456,16106,4556,27889,10205,4973,5232
21530,33355,5457,16113,4557,27898,10207,4974,5233
21535,33361,5457,16115,4557,27904,10210,4975,5235
21540,33372,5458,16119,4558,27914,10213,4976,5237
21545,33376,5458,16121,4558,27918,10214,4977,5237
21550,33386,5459,16127,4558,27927,10216,4978,5238
21555,33392,5459,16131,4558,27933,10219,4980,5239
21560,33403,5460,16136,4559,27942,10222,4980,5242
21565,33407,5462,16140,4561,27945,10223,4981,5242
21570,33417,5463,16146,4562,27954,10225,4982,5243
21575,33423,5463,16149,4562,27960,10228,4984,5244
21580,33434,5464,16155,4563,27970,10231,4986,5245
21585,33438,5464,16156,4563,27974,10232,4987,5245
21590,33448,5465,16162,4563,27983,10234,4989,5245
21595,33454,5465,16166,4563,27989,10237,4991,5246
21600,33465,5468,16175,4566,27996,10240,4993,5247
21605,33469,5471,16179,4569,27998,10241,4994,5247
21610,33479,5473,16186,4571,28006,10243,4995,5248
21615,33485,5473,16189,4571,28011,10246,4996,5250
21620,33496,5477,16195,4575,28019,10249,4998,5251
21625,33500,5477,16196,4575,28023,10250,4998,5252
21630,33510,5479,16201,4576,28031,10252,4998,5254
21635,33516,5479,16204,4576,28037,10255,5000,5255
21640,33527,5482,16212,4579,28044,10258,5003,5255
21645,33531,5483,16215,4580,28048,10259,5004,5255
21650,33541,5485,16220,4581,28056,10261,5005,5256
21655,33547,5485,16222,4581,28062,10264,5006,5258
21660,33558,5486,16224,4582,28072,10267,5007,5260
21665,33562,5486,16225,4582,28076,10268,5007,5261
21670,33572,5488,16232,4583,28084,10270,5008,5262
21675,33578,5488,16235,4583,28089,10273,5010,5263
21680,33589,5492,16240,4586,28097,10275,5010,5265
21685,33593,5492,16241,4586,28101,10276,5010,5266
21690,33603,5495,16250,4589,28108,10278,5011,5267
21695,33609,5495,16252,4589,28113,10281,5012,5269
21700,33620,5498,16257,4592,28122,10283,5013,5270
21705,33624,5498,16259,4592,28126,10284,5013,5271
21710,33634,5500,16263,4593,28134,10286,5013,5273
21715,33640,5500,16266,4593,28140,10289,5015,5274
21720,33651,5503,16271,4595,28148,10291,5016,5275
21725,33655,5505,16274,4597,28150,10292,5016,5276
21730,33665,5507,16279,4598,28158,10294,5017,5277
21735,33671,5507,16281,4598,28163,10297,5018,5279
21740,33682,5511,16287,4602,28170,10299,5019,5280
21745,33686,5513,16290,4604,28173,10300,5020,5280
21750,33696,5515,16296,4606,28181,10302,5022,5280
21755,33702,5515,16299,4606,28187,10305,5024,5281
21760,33713,5517,16304,4607,28195,10307,5025,5282
21765,33717,5519,16306,4609,28198,10308,5025,5283
21770,33727,5521,16308,4611,28206,10310,5025,5285
21775,33733,5521,16312,4611,28212,10313,5028,5285
21780,33744,5524,16319,4614,28219,10316,5029,5287
21785,33748,5526,16321,4616,28222,10317,5030,5287
21790,33758,5527,16325,4616,28231,10319,5031,5288
21795,33764,5527,16327,4616,28237,10322,5032,5290
21800,33775,5530,16335,4619,28244,10325,5033,5292
21805,33779,5531,16336,4620,28248,10326,5034,5292
21810,33789,5532,16339,4620,28257,10328,5034,5294
21815,33795,5532,16341,4620,28262,10331,5034,5297
21820,33806,5536,16348,4623,28269,10334,5037,5297
21825,33810,5538,16350,4625,28272,10335,5038,5297
21830,33820,5539,16357,4625,28281,10337,5040,5297
21835,33826,5539,16358,4625,28287,10340,5041,5299
21840,33837,5541,16364,4626,28295,10343,5044,5299
21845,33841,5543,16367,4628,28298,10344,5045,5299
21850,33851,5544,16373,4629,28307,10346,5046,5300
21855,33857,5544,16376,4629,28313,10349,5048,5301
21860,33868,5545,16383,4630,28322,10352,5050,5302
21865,33872,5547,16385,4632,28325,10353,5050,5303
21870,33882,5548,16388,4632,28334,10355,5050,5305
21875,33888,5548,16391,4632,28340,10358,5052,5306
21880,33899,5548,16396,4632,28350,10361,5055,5306
21885,33903,5549,16397,4633,28354,10362,5055,5307
21890,33913,5550,16402,4633,28363,10364,5057,5307
21895,33919,5550,16406,4633,28368,10367,5059,5308
21900,33930,5551,16411,4634,28378,10370,5060,5310
21905,33934,5553,16413,4636,28381,10371,5060,5311
21910,33944,5554,16419,4637,28390,10373,5062,5311
21915,33950,5554,16421,4637,28396,10376,5063,5313
21920,33961,5555,16429,4638,28405,10379,5065,5314
21925,33965,5556,16431,4639,28409,10380,5066,5314
21930,33975,5557,16434,4640,28418,10382,5067,5315
21935,33981,5557,16436,4640,28424,10385,5068,5317
21940,33992,5557,16442,4640,28434,10388,5069,5319
21945,33996,5559,16444,4642,28437,10389,5070,5319
21950,34006,5560,16449,4642,28446,10391,5072,5319
21955,34012,5560,16453,4642,28451,10394,5073,5321
21960,34023,5563,16457,4645,28460,10397,5074,5323
21965,34027,5563,16458,4645,28464,10398,5074,5324
21970,34037,5564,16461,4645,28473,10400,5075,5325
21975,34043,5564,16464,4645,28479,10403,5077,5326
21980,34054,5565,16468,4645,28489,10406,5079,5327
21985,34058,5567,16470,4647,28491,10407,5079,5328
21990,34068,5569,16476,4649,28499,10409,5080,5329
21995,34074,5569,16479,4649,28505,10412,5083,5329
22000,34085,5571,16482,4650,28513,10415,5084,5331
22005,34089,5573,16484,4652,28516,10416,5085,5331
22010,34099,5575,16489,4653,28524,10418,5087,5331
22015,34105,5575,16494,4653,28530,10421,5090,5331
22020,34116,5578,16499,4655,28537,10424,5091,5333
22025,34120,5580,16501,4657,28540,10425,5092,5333
22030,34130,5582,16505,4658,28548,10427,5093,5334
22035,34136,5582,16510,4658,28553,10430,5096,5334
22040,34147,5587,16518,4663,28560,10433,5098,5335
22045,34151,5588,16521,4664,28563,10434,5099,5335
22050,34161,5590,16526,4665,28571,10436,5100,5336
22055,34167,5590,16529,4665,28576,10439,5101,5338
22060,34178,5594,16535,4668,28584,10442,5103,5339
22065,34182,5595,16538,4669,28587,10443,5103,5340
22070,34192,5595,16543,4669,28597,10445,5104,5341
22075,34198,5595,16546,4669,28603,10448,5106,5342
22080,34209,5597,16551,4671,28612,10451,5106,5345
22085,34213,5597,16552,4671,28616,10452,5106,5346
22090,34223,5599,16560,4673,28624,10454,5108,5346
22095,34229,5599,16563,4673,28630,10457,5109,5348
22100,34240,5600,16570,4674,28640,10460,5112,5348
22105,34244,5601,16572,4675,28643,10461,5112,5349
22110,34254,5601,16577,4675,28653,10463,5113,5350
22115,34260,5601,16580,4675,28659,10466,5114,5352
22120,34271,5603,16588,4677,28668,10469,5117,5352
22125,34275,5603,16589,4677,28672,10470,5118,5352
22130,34285,5604,16594,4678,28681,10472,5119,5353
22135,34291,5604,16595,4678,28687,10475,5120,5355
22140,34302,5606,16601,4680,28696,10478,5121,5357
22145,34306,5607,16605,4681,28699,10479,5122,5357
22150,34316,5608,16606,4682,28708,10481,5122,5359
22155,34322,5608,16608,4682,28714,10484,5123,5361
22160,34333,5610,16613,4683,28723,10487,5125,5362
22165,34337,5610,16614,4683,28727,10488,5126,5362
22170,34347,5613,16623,4685,28734,10490,5128,5362
22175,34353,5613,16625,4685,28739,10493,5129,5364
22180,34364,5616,16629,4688,28747,10496,5130,5366
22185,34368,5619,16631,4691,28749,10497,5130,5367
22190,34378,5621,16635,4692,28757,10499,5130,5369
22195,34384,5621,16639,4692,28763,10502,5132,5370
22200,34395,5624,16645,4695,28770,10505,5133,5372
22205,34399,5627,16648,4698,28772,10506,5134,5372
22210,34409,5628,16650,4698,28781,10508,5135,5373
22215,34415,5628,16654,4698,28787,10511,5137,5374
22220,34426,5629,16660,4699,28796,10514,5139,5375
22225,34430,5631,16663,4701,28799,10515,5139,5376
22230,34440,5632,16670,4701,28808,10517,5141,5376
22235,34446,5632,16671,4701,28814,10520,5142,5378
22240,34457,5632,16677,4701,28825,10523,5145,5378
22245,34461,5633,16680,4702,28828,10524,5146,5378
22250,34471,5634,16684,4703,28837,10526,5146,5380
22255,34477,5634,16688,4703,28842,10529,5147,5382
22260,34488,5636,16695,4705,28851,10532,5148,5384
22265,34492,5637,16697,4706,28855,10533,5149,5384
22270,34502,5638,16701,4707,28864,10535,5150,5385
22275,34508,5638,16704,4707,28869,10538,5151,5387
22280,34519,5639,16710,4708,28879,10541,5152,5389
22285,34523,5640,16712,4709,28883,10542,5152,5390
22290,34533,5641,16716,4709,28892,10544,5153,5391
22295,34539,5641,16720,4709,28897,10547,5156,5391
22300,34550,5642,16726,4710,28908,10550,5157,5393
22305,34554,5642,16727,4710,28912,10551,5157,5394
22310,34564,5643,16731,4710,28921,10553,5158,5395
22315,34570,5643,16733,4710,28926,10556,5159,5397
22320,34581,5647,16738,4713,28934,10559,5161,5398
22325,34585,5648,16740,4714,28937,10560,5161,5399
22330,34595,5649,16745,4715,28946,10562,5162,5400
22335,34601,5649,16746,4715,28951,10565,5162,5403
22340,34612,5652,16750,4717,28960,10567,5164,5403
22345,34616,5652,16752,4717,28964,10568,5165,5403
22350,34626,5653,16758,4717,28973,10570,5166,5404
22355,34632,5653,16760,4717,28978,10573,5166,5407
22360,34643,5657,16765,4720,28985,10575,5167,5408
22365,34647,5659,16768,4722,28988,10576,5168,5408
22370,34657,5662,16775,4725,28995,10578,5170,5408
22375,34663,5662,16778,4725,29000,10581,5172,5409
22380,34674,5665,16784,4727,29008,10583,5174,5409
22385,34678,5666,16785,4728,29012,10584,5174,5410
22390,34688,5668,16789,4729,29020,10586,5175,5411
22395,34694,5668,16792,4729,29025,10589,5176,5413
22400,34705,5670,16797,4730,29034,10591,5176,5415
22405,34709,5671,16799,4731,29038,10592,5177,5415
22410,34719,5672,16803,4732,29047,10594,5178,5416
22415,34725,5672,16805,4732,29052,10597,5179,5418
22420,34736,5676,16811,4735,29060,10599,5180,5419
22425,34740,5676,16812,4735,29064,10600,5181,5419
22430,34750,5678,16816,4737,29072,10602,5182,5420
22435,34756,5678,16819,4737,29078,10605,5184,5421
22440,34767,5679,16823,4737,29087,10608,5186,5422
22445,34771,5680,16824,4738,29091,10609,5186,5423
22450,34781,5682,16830,4740,29099,10611,5187,5424
22455,34787,5682,16831,4740,29105,10614,5188,5426
22460,34798,5685,16836,4743,29112,10617,5189,5428
22465,34802,5687,16839,4745,29115,10618,5190,5428
22470,34812,5688,16843,4745,29124,10620,5192,5428
22475,34818,5688,16848,4745,29129,10623,5195,5428
22480,34829,5692,16853,4749,29137,10626,5196,5430
22485,34833,5694,16857,4751,29139,10627,5197,5430
22490,34843,5697,16863,4753,29146,10629,5199,5430
22495,34849,5697,16866,4753,29152,10632,5201,5431
22500,34860,5700,16872,4755,29160,10635,5203,5432
22505,34864,5701,16875,4756,29163,10636,5204,5432
22510,34874,5702,16878,4756,29172,10638,5205,5433
22515,34880,5702,16879,4756,29178,10641,5205,5436
22520,34891,5703,16882,4756,29187,10644,5207,5437
22525,34895,5704,16883,4757,29191,10645,5208,5437
22530,34905,5706,16888,4759,29199,10647,5209,5438
22535,34911,5706,16892,4759,29205,10650,5212,5438
22540,34922,5707,16896,4760,29214,10653,5213,5440
22545,34926,5709,16897,4762,29217,10654,5213,5441
22550,34936,5712,16904,4765,29224,10656,5213,5443
22555,34942,5712,16907,4765,29230,10659,5214,5445
22560,34953,5713,16911,4766,29239,10662,5215,5447
22565,34957,5716,16914,4769,29241,10663,5215,5448
22570,34967,5717,16918,4770,29250,10665,5216,5449
22575,34973,5717,16920,4770,29256,10668,5217,5451
22580,34984,5719,16923,4771,29265,10671,5217,5454
22585,34988,5720,16925,4772,29268,10672,5218,5454
22590,34998,5723,16931,4775,29275,10674,5219,5455
22595,35004,5723,16934,4775,29281,10677,5220,5457
22600,35015,5726,16939,4777,29288,10680,5220,5460
22605,35019,5727,16940,4778,29292,10681,5220,5461
22610,35029,5729,16946,4780,29300,10683,5220,5463
22615,35035,5729,16949,4780,29305,10686,5220,5466
22620,35046,5732,16953,4783,29314,10689,5222,5467
22625,35050,5732,16954,4783,29318,10690,5223,5467
22630,35060,5734,16958,4785,29326,10692,5225,5467
22635,35066,5734,16961,4785,29331,10695,5226,5469
22640,35077,5739,16972,4790,29338,10698,5229,5469
22645,35081,5739,16975,4790,29342,10699,5230,5469
22650,35091,5739,16978,4790,29352,10701,5230,5471
22655,35097,5739,16982,4790,29358,10704,5232,5472
22660,35108,5741,16987,4792,29367,10707,5235,5472
22665,35112,5741,16988,4792,29371,10708,5235,5473
22670,35122,5741,16991,4792,29381,10710,5236,5474
22675,35128,5741,16994,4792,29387,10713,5237,5476
22680,35139,5743,16998,4793,29396,10716,5239,5477
22685,35143,5744,17002,4794,29399,10717,5240,5477
22690,35153,5745,17006,4795,29408,10719,5241,5478
22695,35159,5745,17010,4795,29414,10722,5242,5480
22700,35170,5748,17017,4798,29422,10725,5242,5483
22705,35174,5749,17020,4799,29425,10726,5243,5483
22710,35184,5750,17024,4800,29434,10728,5244,5484
22715,35190,5750,17027,4800,29440,10731,5246,5485
22720,35201,5752,17035,4801,29449,10734,5248,5486
22725,35205,5752,17037,4801,29453,10735,5249,5486
22730,35215,5752,17040,4801,29463,10737,5249,5488
22735,35221,5752,17041,4801,29469,10740,5250,5490
22740,35232,5752,17047,4801,29480,10743,5252,5491
22745,35236,5753,17049,4802,29483,10744,5252,5492
22750,35246,5754,17054,4803,29492,10746,5253,5493
22755,35252,5754,17059,4803,29497,10749,5255,5494
22760,35263,5755,17062,4804,29508,10752,5256,5496
22765,35267,5756,17065,4805,29511,10753,5257,5496
22770,35277,5757,17069,4805,29520,10755,5258,5497
22775,35283,5757,17070,4805,29526,10758,5258,5500
22780,35294,5758,17076,4806,29536,10761,5259,5502
22785,35298,5758,17077,4806,29540,10762,5259,5503
22790,35308,5759,17081,4806,29549,10764,5260,5504
22795,35314,5759,17085,4806,29554,10767,5262,5505
22800,35325,5761,17091,4808,29563,10770,5263,5507
22805,35329,5762,17091,4809,29567,10771,5263,5508
22810,35339,5763,17096,4810,29576,10773,5264,5509
22815,35345,5763,17098,4810,29582,10776,5266,5510
22820,35356,5763,17099,4810,29592,10779,5266,5513
22825,35360,5765,17100,4812,29595,10780,5266,5514
22830,35370,5768,17109,4815,29602,10782,5267,5515
22835,35376,5768,17112,4815,29607,10785,5269,5516
22840,35387,5771,17117,4818,29616,10788,5271,5517
22845,35391,5772,17119,4819,29619,10789,5271,5518
22850,35401,5773,17125,4820,29628,10791,5272,5519
22855,35407,5773,17129,4820,29634,10794,5275,5519
22860,35418,5775,17134,4822,29642,10797,5277,5520
22865,35422,5778,17137,4825,29644,10798,5278,5520
22870,35432,5779,17141,4826,29653,10800,5280,5520
22875,35438,5779,17144,4826,29658,10803,5281,5522
22880,35449,5782,17148,4828,29666,10806,5281,5525
22885,35453,5783,17148,4829,29670,10807,5281,5526
22890,35463,5786,17153,4832,29677,10809,5281,5528
22895,35469,5786,17156,4832,29682,10812,5283,5529
22900,35480,5791,17164,4837,29689,10815,5285,5530
22905,35484,5792,17166,4838,29692,10816,5285,5531
22910,35494,5794,17169,4839,29700,10818,5285,5533
22915,35500,5794,17174,4839,29705,10821,5287,5534
22920,35511,5799,17182,4844,29712,10824,5288,5536
22925,35515,5800,17184,4845,29715,10825,5288,5537
22930,35525,5802,17187,4846,29723,10827,5288,5539
22935,35531,5802,17190,4846,29728,10830,5289,5541
22940,35542,5805,17195,4849,29737,10833,5292,5541
22945,35546,5805,17197,4849,29741,10834,5293,5541
22950,35556,5806,17202,4849,29750,10836,5295,5541
22955,35562,5806,17205,4849,29755,10839,5296,5543
22960,35573,5809,17211,4852,29763,10842,5297,5545
22965,35577,5810,17211,4853,29767,10843,5297,5546
22970,35587,5812,17217,4855,29775,10845,5298,5547
22975,35593,5812,17221,4855,29780,10848,5299,5549
22980,35604,5816,17227,4858,29787,10851,5301,5550
22985,35608,5817,17229,4859,29791,10852,5302,5550
22990,35618,5819,17235,4861,29799,10854,5304,5550
22995,35624,5819,17238,4861,29804,10857,5305,5552
23000,35635,5821,17240,4862,29814,10859,5306,5553
23005,35639,5821,17243,4862,29818,10860,5307,5553
23010,35649,5823,17247,4863,29826,10862,5308,5554
23015,35655,5823,17249,4863,29832,10865,5308,5557
23020,35666,5826,17256,4865,29840,10867,5310,5557
23025,35670,5826,17257,4865,29844,10868,5311,5557
23030,35680,5828,17262,4867,29852,10870,5312,5558
23035,35686,5828,17263,4867,29858,10873,5312,5561
23040,35697,5830,17270,4869,29866,10875,5312,5563
23045,35701,5831,17270,4870,29870,10876,5312,5564
23050,35711,5833,17274,4871,29878,10878,5312,5566
23055,35717,5833,17277,4871,29884,10881,5314,5567
23060,35728,5834,17282,4872,29893,10883,5315,5568
23065,35732,5836,17284,4874,29896,10884,5315,5569
23070,35742,5838,17290,4875,29904,10886,5316,5570
23075,35748,5838,17295,4875,29909,10889,5318,5571
23080,35759,5840,17301,4877,29919,10891,5320,5571
23085,35763,5840,17302,4877,29923,10892,5321,5571
23090,35773,5842,17305,4878,29931,10894,5322,5572
23095,35779,5842,17310,4878,29936,10897,5324,5573
23100,35790,5846,17317,4882,29944,10900,5326,5574
23105,35794,5847,17320,4883,29947,10901,5327,5574
23110,35804,5849,17326,4885,29955,10903,5328,5575
23115,35810,5849,17326,4885,29961,10906,5328,5578
23120,35821,5851,17330,4886,29969,10909,5328,5581
23125,35825,5853,17331,4888,29972,10910,5328,5582
23130,35835,5855,17338,4890,29980,10912,5329,5583
23135,35841,5855,17341,4890,29986,10915,5330,5585
23140,35852,5857,17346,4891,29994,10918,5331,5587
23145,35856,5859,17347,4893,29997,10919,5331,5588
23150,35866,5861,17353,4895,30005,10921,5333,5588
23155,35872,5861,17358,4895,30011,10924,5336,5588
23160,35883,5865,17363,4898,30017,10927,5337,5590
23165,35887,5867,17366,4900,30020,10928,5338,5590
23170,35897,5868,17372,4901,30029,10930,5339,5591
23175,35903,5868,17376,4901,30034,10933,5341,5592
23180,35914,5869,17380,4902,30044,10936,5341,5595
23185,35918,5870,17381,4903,30048,10937,5341,5596
23190,35928,5871,17384,4903,30057,10939,5342,5597
23195,35934,5871,17388,4903,30063,10942,5344,5598
23200,35945,5872,17395,4904,30072,10945,5346,5599
23205,35949,5873,17396,4905,30076,10946,5346,5600
23210,35959,5874,17403,4906,30085,10948,5347,5601
23215,35965,5874,17407,4906,30091,10951,5350,5601
23220,35976,5874,17413,4906,30102,10954,5351,5603
23225,35980,5875,17416,4907,30105,10955,5352,5603
23230,35990,5876,17421,4907,30114,10957,5353,5604
23235,35996,5876,17424,4907,30119,10960,5354,5606
23240,36007,5878,17430,4909,30129,10963,5356,5607
23245,36011,5879,17433,4910,30132,10964,5357,5607
23250,36021,5880,17436,4910,30141,10966,5358,5608
23255,36027,5880,17439,4910,30147,10969,5359,5610
23260,36038,5880,17444,4910,30157,10972,5360,5612
23265,36042,5881,17446,4911,30161,10973,5361,5612
23270,36052,5883,17451,4913,30169,10975,5361,5614
23275,36058,5883,17455,4913,30175,10978,5363,5615
23280,36069,5885,17460,4915,30184,10981,5365,5616
23285,36073,5887,17464,4917,30186,10982,5366,5616
23290,36083,5889,17469,4918,30194,10984,5367,5617
23295,36089,5889,17473,4918,30200,10987,5369,5618
23300,36100,5893,17479,4921,30207,10990,5371,5619
23305,36104,5894,17480,4922,30210,10991,5371,5620
23310,36114,5896,17488,4924,30218,10993,5373,5620
23315,36120,5896,17491,4924,30223,10996,5374,5622
23320,36131,5900,17496,4927,30231,10999,5375,5624
23325,36135,5901,17499,4928,30234,11000,5376,5624
23330,36145,5903,17505,4930,30242,11002,5377,5625
23335,36151,5903,17508,4930,30248,11005,5378,5627
23340,36162,5906,17514,4933,30256,11008,5378,5630
23345,36166,5907,17515,4934,30259,11009,5378,5631
23350,36176,5908,17517,4935,30268,11011,5378,5633
23355,36182,5908,17517,4935,30274,11014,5378,5636
23360,36193,5910,17523,4937,30283,11017,5378,5639
23365,36197,5911,17526,4938,30286,11018,5379,5639
23370,36207,5912,17530,4939,30295,11020,5379,5641
23375,36213,5912,17534,4939,30301,11023,5382,5641
23380,36224,5914,17541,4941,30310,11026,5383,5643
23385,36228,5914,17543,4941,30314,11027,5384,5643
23390,36238,5915,17548,4942,30323,11029,5385,5644
23395,36244,5915,17552,4942,30329,11032,5388,5644
23400,36255,5917,17557,4943,30338,11035,5390,5645
23405,36259,5918,17558,4944,30341,11036,5390,5646
23410,36269,5918,17566,4944,30351,11038,5392,5646
23415,36275,5918,17569,4944,30357,11041,5393,5648
23420,36286,5918,17577,4944,30368,11044,5395,5649
23425,36290,5919,17580,4945,30371,11045,5396,5649
23430,36300,5920,17583,4945,30380,11047,5396,5651
23435,36306,5920,17588,4945,30385,11050,5398,5652
23440,36317,5921,17590,4946,30396,11053,5398,5655
23445,36321,5922,17592,4947,30399,11054,5399,5655
23450,36331,5923,17597,4947,30408,11056,5399,5657
23455,36337,5923,17600,4947,30413,11059,5401,5658
23460,36348,5924,17602,4948,30424,11062,5402,5660
23465,36352,5925,17605,4949,30427,11063,5402,5661
23470,36362,5926,17609,4949,30436,11065,5403,5662
23475,36368,5926,17612,4949,30441,11068,5403,5665
23480,36379,5928,17618,4951,30451,11071,5405,5666
23485,36383,5929,17621,4952,30454,11072,5405,5667
23490,36393,5930,17628,4953,30463,11074,5406,5668
23495,36399,5930,17629,4953,30468,11077,5406,5671
23500,36410,5931,17634,4954,30479,11080,5408,5672
23505,36414,5931,17636,4954,30483,11081,5408,5673
23510,36424,5934,17642,4957,30490,11083,5409,5674
23515,36430,5934,17646,4957,30495,11086,5411,5675
23520,36441,5937,17650,4959,30504,11089,5412,5677
23525,36445,5937,17651,4959,30508,11090,5413,5677
23530,36455,5939,17653,4960,30516,11092,5414,5678
23535,36461,5939,17654,4960,30522,11095,5414,5681
23540,36472,5942,17660,4963,30530,11098,5416,5682
23545,36476,5943,17662,4964,30533,11099,5417,5682
23550,36486,5945,17666,4965,30541,11101,5419,5682
23555,36492,5945,17669,4965,30547,11104,5421,5683
23560,36503,5948,17674,4968,30555,11107,5422,5685
23565,36507,5950,17677,4970,30557,11108,5422,5686
23570,36517,5952,17682,4972,30565,11110,5423,5687
23575,36523,5952,17686,4972,30570,11113,5425,5688
23580,36534,5954,17691,4973,30580,11116,5428,5688
23585,36538,5956,17693,4975,30582,11117,5428,5689
23590,36548,5959,17696,4978,30589,11119,5428,5691
23595,36554,5959,17699,4978,30594,11122,5430,5692
23600,36565,5962,17704,4980,30602,11125,5431,5694
23605,36569,5963,17704,4981,30606,11126,5431,5695
23610,36579,5965,17709,4983,30614,11128,5432,5696
23615,36585,5965,17711,4983,30620,11131,5433,5698
23620,36596,5968,17717,4986,30628,11134,5433,5701
23625,36600,5969,17720,4987,30631,11135,5433,5702
23630,36610,5971,17724,4989,30639,11137,5435,5702
23635,36616,5971,17727,4989,30644,11140,5437,5703
23640,36627,5973,17730,4990,30653,11143,5438,5705
23645,36631,5975,17731,4992,30656,11144,5438,5706
23650,36641,5976,17733,4993,30665,11146,5438,5708
23655,36647,5976,17737,4993,30670,11149,5440,5709
23660,36658,5980,17743,4997,30677,11151,5441,5710
23665,36662,5981,17745,4998,30681,11152,5441,5711
23670,36672,5983,17748,5000,30689,11154,5441,5713
23675,36678,5983,17751,5000,30695,11157,5444,5713
23680,36689,5986,17758,5002,30702,11159,5445,5714
23685,36693,5987,17759,5003,30706,11160,5445,5715
23690,36703,5990,17765,5006,30713,11162,5445,5717
23695,36709,5990,17768,5006,30718,11165,5447,5718
23700,36720,5993,17771,5008,30727,11167,5448,5719
23705,36724,5993,17772,5008,30731,11168,5448,5720
23710,36734,5995,17777,5009,30739,11170,5449,5721
23715,36740,5995,17779,5009,30745,11173,5451,5722
23720,36751,5999,17786,5013,30752,11175,5451,5724
23725,36755,5999,17788,5013,30756,11176,5452,5724
23730,36765,6001,17792,5014,30764,11178,5452,5726
23735,36771,6001,17795,5014,30769,11181,5453,5728
23740,36782,6005,17799,5017,30777,11183,5454,5729
23745,36786,6007,17803,5019,30779,11184,5455,5729
23750,36796,6008,17810,5020,30788,11186,5457,5729
23755,36802,6008,17814,5020,30793,11189,5458,5731
23760,36813,6009,17817,5021,30804,11192,5460,5732
23765,36817,6009,17820,5021,30808,11193,5461,5732
23770,36827,6010,17824,5022,30817,11195,5462,5733
23775,36833,6010,17826,5022,30822,11198,5462,5736
23780,36844,6011,17829,5023,30832,11201,5463,5738
23785,36848,6012,17831,5024,30836,11202,5464,5738
23790,36858,6013,17837,5025,30845,11204,5465,5739
23795,36864,6013,17839,5025,30851,11207,5467,5740
23800,36875,6013,17844,5025,30862,11210,5469,5741
23805,36879,6014,17845,5026,30865,11211,5469,5742
23810,36889,6015,17849,5027,30874,11213,5469,5744
23815,36895,6015,17853,5027,30879,11216,5470,5746
23820,36906,6016,17859,5028,30889,11219,5472,5747
23825,36910,6017,17860,5029,30893,11220,5472,5748
23830,36920,6018,17866,5030,30902,11222,5473,5749
23835,36926,6018,17869,5030,30907,11225,5473,5752
23840,36937,6019,17871,5031,30917,11228,5473,5755
23845,36941,6020,17871,5032,30921,11229,5473,5756
23850,36951,6021,17876,5033,30930,11231,5474,5757
23855,36957,6021,17879,5033,30935,11234,5476,5758
23860,36968,6025,17885,5037,30943,11237,5479,5758
23865,36972,6026,17887,5038,30946,11238,5480,5758
23870,36982,6027,17890,5039,30955,11240,5481,5759
23875,36988,6027,17892,5039,30961,11243,5482,5761
23880,36999,6029,17897,5041,30970,11246,5484,5762
23885,37003,6030,17898,5042,30973,11247,5484,5763
23890,37013,6032,17905,5044,30981,11249,5484,5765
23895,37019,6032,17907,5044,30987,11252,5485,5767
23900,37030,6034,17914,5046,30995,11255,5488,5767
23905,37034,6037,17918,5049,30997,11256,5489,5767
23910,37044,6038,17920,5050,31006,11258,5490,5768
23915,37050,6038,17923,5050,31011,11261,5490,5771
23920,37061,6042,17930,5053,31019,11264,5493,5771
23925,37065,6044,17933,5055,31021,11265,5494,5771
23930,37075,6046,17940,5057,31029,11267,5496,5771
23935,37081,6046,17942,5057,31035,11270,5497,5773
23940,37092,6049,17947,5059,31043,11273,5499,5774
23945,37096,6049,17949,5059,31047,11274,5499,5775
23950,37106,6050,17954,5060,31056,11276,5500,5776
23955,37112,6050,17955,5060,31062,11279,5501,5778
23960,37123,6052,17962,5062,31071,11282,5503,5779
23965,37127,6052,17962,5062,31075,11283,5503,5780
23970,37137,6053,17966,5063,31084,11285,5504,5781
23975,37143,6053,17969,5063,31090,11288,5506,5782
23980,37154,6054,17976,5063,31100,11291,5509,5782
23985,37158,6054,17977,5063,31104,11292,5510,5782
23990,37168,6056,17980,5065,31112,11294,5510,5784
23995,37174,6056,17982,5065,31118,11297,5511,5786
24000,37185,6057,17986,5066,31128,11300,5513,5787
24005,37189,6058,17988,5067,31131,11301,5513,5788
24010,37199,6058,17991,5067,31141,11303,5514,5789
24015,37205,6058,17993,5067,31147,11306,5515,5791
24020,37216,6059,17996,5067,31157,11309,5515,5794
24025,37220,6059,17996,5067,31161,11310,5515,5795
24030,37230,6060,18001,5068,31170,11312,5517,5795
24035,37236,6060,18005,5068,31176,11315,5519,5796
24040,37247,6062,18011,5070,31185,11318,5520,5798
24045,37251,6062,18012,5070,31189,11319,5521,5798
24050,37261,6064,18016,5071,31197,11321,5522,5799
24055,37267,6064,18020,5071,31202,11324,5524,5800
24060,37278,6069,18025,5075,31208,11327,5525,5802
24065,37282,6071,18028,5077,31211,11328,5526,5802
24070,37292,6073,18033,5079,31219,11330,5527,5803
24075,37298,6073,18037,5079,31224,11333,5530,5803
24080,37309,6077,18045,5083,31232,11336,5532,5804
24085,37313,6077,18047,5083,31236,11337,5533,5804
24090,37323,6079,18053,5084,31244,11339,5535,5804
24095,37329,6079,18055,5084,31250,11342,5536,5806
24100,37340,6082,18061,5086,31257,11345,5538,5807
24105,37344,6085,18065,5089,31259,11346,5539,5807
24110,37354,6087,18071,5091,31267,11348,5541,5807
24115,37360,6087,18074,5091,31272,11351,5542,5809
24120,37371,6091,18081,5095,31280,11354,5545,5809
24125,37375,6093,18084,5097,31282,11355,5545,5810
24130,37385,6095,18091,5099,31290,11357,5546,5811
24135,37391,6095,18091,5099,31296,11360,5546,5814
24140,37402,6098,18099,5102,31303,11363,5548,5815
24145,37406,6099,18101,5103,31307,11364,5548,5816
24150,37416,6100,18106,5104,31316,11366,5548,5818
24155,37422,6100,18107,5104,31322,11369,5548,5821
24160,37433,6101,18114,5105,31331,11372,5549,5823
24165,37437,6103,18116,5107,31334,11373,5550,5823
24170,37447,6104,18120,5108,31343,11375,5551,5824
24175,37453,6104,18124,5108,31348,11378,5553,5825
24180,37464,6106,18129,5110,31358,11381,5554,5827
24185,37468,6106,18129,5110,31362,11382,5554,5828
24190,37478,6107,18133,5110,31371,11384,5554,5830
24195,37484,6107,18135,5110,31376,11387,5554,5833
24200,37495,6108,18137,5111,31387,11390,5556,5834
24205,37499,6109,18138,5112,31390,11391,5556,5835
24210,37509,6110,18140,5113,31399,11393,5557,5836
24215,37515,6110,18142,5113,31405,11396,5558,5838
24220,37526,6111,18147,5114,31415,11399,5559,5840
24225,37530,6111,18148,5114,31419,11400,5559,5841
24230,37540,6112,18154,5114,31428,11402,5560,5842
24235,37546,6112,18158,5114,31433,11405,5562,5843
24240,37557,6113,18165,5115,31444,11408,5565,5843
24245,37561,6114,18169,5116,31447,11409,5566,5843
24250,37571,6115,18172,5116,31456,11411,5567,5844
24255,37577,6115,18175,5116,31461,11414,5568,5846
24260,37588,6120,18182,5121,31468,11417,5570,5847
24265,37592,6121,18186,5122,31471,11418,5571,5847
24270,37602,6123,18190,5123,31479,11420,5572,5848
24275,37608,6123,18193,5123,31484,11423,5573,5850
24280,37619,6126,18197,5126,31493,11426,5573,5853
24285,37623,6127,18199,5127,31496,11427,5573,5854
24290,37633,6128,18203,5127,31505,11429,5574,5855
24295,37639,6128,18206,5127,31510,11432,5576,5856
24300,37650,6130,18209,5129,31520,11435,5577,5858
24305,37654,6130,18212,5129,31524,11436,5578,5858
24310,37664,6132,18219,5131,31532,11438,5580,5858
24315,37670,6132,18220,5131,31538,11441,5581,5860
24320,37681,6135,18227,5134,31545,11443,5582,5861
24325,37685,6136,18228,5135,31549,11444,5582,5862
24330,37695,6138,18233,5137,31557,11446,5582,5864
24335,37701,6138,18236,5137,31562,11449,5583,5866
24340,37712,6140,18239,5138,31572,11451,5584,5867
24345,37716,6141,18240,5139,31575,11452,5584,5868
24350,37726,6144,18247,5141,31582,11454,5585,5869
24355,37732,6144,18250,5141,31587,11457,5586,5871
24360,37743,6149,18257,5145,31593,11459,5588,5871
24365,37747,6151,18258,5147,31596,11460,5588,5872
24370,37757,6154,18264,5150,31603,11462,5588,5874
24375,37763,6154,18265,5150,31609,11465,5589,5876
24380,37774,6156,18272,5152,31617,11467,5591,5876
24385,37778,6159,18276,5155,31619,11468,5592,5876
24390,37788,6160,18280,5155,31628,11470,5592,5878
24395,37794,6160,18284,5155,31634,11473,5594,5879
24400,37805,6162,18288,5156,31642,11475,5594,5881
24405,37809,6164,18290,5158,31645,11476,5594,5882
24410,37819,6166,18293,5159,31653,11478,5594,5884
24415,37825,6166,18296,5159,31658,11481,5595,5886
24420,37836,6169,18304,5162,31667,11484,5598,5886
24425,37840,6170,18305,5163,31670,11485,5598,5887
24430,37850,6172,18310,5165,31678,11487,5599,5888
24435,37856,6172,18313,5165,31683,11490,5599,5891
24440,37867,6175,18316,5167,31692,11493,5599,5894
24445,37871,6176,18318,5168,31695,11494,5600,5894
24450,37881,6178,18324,5170,31703,11496,5601,5895
24455,37887,6178,18327,5170,31709,11499,5602,5897
24460,37898,6179,18331,5170,31718,11502,5603,5899
24465,37902,6181,18333,5172,31721,11503,5604,5899
24470,37912,6183,18338,5173,31729,11505,5604,5901
24475,37918,6183,18342,5173,31735,11508,5607,5901
24480,37929,6185,18348,5174,31743,11511,5610,5901
24485,37933,6186,18349,5175,31747,11512,5610,5902
24490,37943,6189,18354,5177,31754,11514,5612,5902
24495,37949,6189,18356,5177,31760,11517,5613,5904
24500,37960,6192,18361,5179,31768,11520,5614,5906
24505,37964,6192,18363,5179,31772,11521,5615,5906
24510,37974,6193,18368,5179,31781,11523,5617,5906
24515,37980,6193,18371,5179,31786,11526,5618,5908
24520,37991,6194,18378,5180,31796,11529,5621,5908
24525,37995,6195,18378,5181,31800,11530,5621,5909
24530,38005,6196,18384,5181,31809,11532,5623,5909
24535,38011,6196,18386,5181,31815,11535,5624,5911
24540,38022,6196,18392,5181,31826,11538,5626,5912
24545,38026,6197,18396,5182,31829,11539,5627,5912
24550,38036,6198,18403,5183,31838,11541,5628,5913
24555,38042,6198,18407,5183,31843,11544,5630,5914
24560,38053,6199,18411,5184,31854,11547,5630,5917
24565,38057,6200,18415,5185,31857,11548,5631,5917
24570,38067,6201,18419,5185,31866,11550,5631,5919
24575,38073,6201,18420,5185,31871,11553,5631,5922
24580,38084,6203,18429,5187,31880,11556,5634,5922
24585,38088,6205,18432,5189,31883,11557,5635,5922
24590,38098,6205,18436,5189,31893,11559,5635,5924
24595,38104,6205,18438,5189,31899,11562,5635,5927
24600,38115,6205,18446,5189,31910,11565,5637,5928
24605,38119,6205,18447,5189,31914,11566,5637,5929
24610,38129,6206,18453,5190,31923,11568,5638,5930
24615,38135,6206,18455,5190,31929,11571,5638,5933
24620,38146,6209,18460,5192,31937,11574,5639,5935
24625,38150,6209,18462,5192,31941,11575,5640,5935
24630,38160,6209,18466,5192,31951,11577,5642,5935
24635,38166,6209,18472,5192,31957,11580,5645,5935
24640,38177,6212,18477,5194,31965,11583,5647,5936
24645,38181,6212,18477,5194,31969,11584,5647,5937
24650,38191,6213,18482,5195,31978,11586,5648,5938
24655,38197,6213,18484,5195,31984,11589,5649,5940
24660,38208,6214,18489,5195,31994,11592,5652,5940
24665,38212,6214,18490,5195,31998,11593,5653,5940
24670,38222,6215,18494,5196,32007,11595,5654,5941
24675,38228,6215,18497,5196,32013,11598,5656,5942
24680,38239,6217,18503,5198,32022,11601,5659,5942
24685,38243,6218,18506,5199,32025,11602,5660,5942
24690,38253,6219,18510,5199,32034,11604,5661,5943
24695,38259,6219,18514,5199,32040,11607,5664,5943
24700,38270,6221,18518,5201,32049,11610,5666,5944
24705,38274,6222,18520,5202,32052,11611,5666,5945
24710,38284,6225,18526,5205,32059,11613,5666,5947
24715,38290,6225,18528,5205,32065,11616,5668,5948
24720,38301,6227,18533,5206,32073,11619,5668,5951
24725,38305,6228,18533,5207,32077,11620,5668,5952
24730,38315,6231,18539,5209,32084,11622,5669,5953
24735,38321,6231,18542,5209,32089,11625,5669,5956
24740,38332,6235,18547,5213,32097,11628,5669,5959
24745,38336,6236,18548,5214,32100,11629,5669,5960
24750,38346,6238,18554,5215,32108,11631,5670,5961
24755,38352,6238,18557,5215,32113,11634,5672,5962
24760,38363,6242,18561,5218,32121,11637,5674,5963
24765,38367,6243,18563,5219,32124,11638,5675,5963
24770,38377,6244,18568,5219,32133,11640,5677,5963
24775,38383,6244,18572,5219,32138,11643,5680,5963
24780,38394,6247,18577,5221,32147,11646,5682,5964
24785,38398,6247,18578,5221,32151,11647,5683,5964
24790,38408,6249,18583,5223,32159,11649,5684,5965
24795,38414,6249,18585,5223,32165,11652,5686,5966
24800,38425,6252,18591,5226,32172,11655,5686,5969
24805,38429,6254,18592,5228,32175,11656,5686,5970
24810,38439,6256,18597,5229,32183,11658,5687,5971
24815,38445,6256,18601,5229,32188,11661,5689,5972
24820,38456,6261,18608,5234,32195,11664,5691,5973
24825,38460,6261,18608,5234,32199,11665,5691,5974
24830,38470,6263,18611,5235,32207,11667,5691,5976
24835,38476,6263,18612,5235,32213,11670,5692,5978
24840,38487,6265,18614,5236,32221,11673,5692,5981
24845,38491,6266,18614,5237,32225,11674,5692,5982
24850,38501,6269,18621,5239,32232,11676,5694,5982
24855,38507,6269,18623,5239,32238,11679,5695,5984
24860,38518,6271,18629,5240,32246,11682,5695,5987
24865,38522,6274,18631,5243,32248,11683,5695,5988
24870,38532,6275,18636,5244,32257,11685,5695,5990
24875,38538,6275,18638,5244,32263,11688,5696,5992
24880,38549,6276,18642,5245,32272,11691,5697,5994
24885,38553,6278,18645,5247,32275,11692,5698,5994
24890,38563,6279,18650,5247,32284,11694,5700,5994
24895,38569,6279,18653,5247,32289,11697,5702,5995
24900,38580,6282,18658,5250,32297,11700,5703,5997
24905,38584,6284,18659,5252,32300,11701,5703,5998
24910,38594,6285,18664,5253,32309,11703,5704,5999
24915,38600,6285,18668,5253,32314,11706,5706,6000
24920,38611,6287,18671,5255,32324,11709,5706,6003
24925,38615,6288,18673,5256,32327,11710,5707,6003
24930,38625,6289,18680,5256,32336,11712,5709,6003
24935,38631,6289,18682,5256,32341,11715,5710,6005
24940,38642,6292,18687,5258,32350,11718,5711,6007
24945,38646,6292,18687,5258,32354,11719,5711,6008
24950,38656,6293,18693,5258,32363,11721,5712,6009
24955,38662,6293,18697,5258,32369,11724,5715,6009
24960,38673,6295,18700,5259,32377,11727,5715,6012
24965,38677,6297,18703,5261,32380,11728,5715,6013
24970,38687,6298,18705,5262,32389,11730,5716,6014
24975,38693,6298,18707,5262,32394,11733,5716,6017
24980,38704,6301,18711,5265,32403,11735,5718,6017
24985,38708,6301,18712,5265,32407,11736,5718,6018
24990,38718,6304,18717,5267,32414,11738,5719,6019
24995,38724,6304,18722,5267,32420,11741,5722,6019
25000,38735,6307,18730,5270,32427,11743,5723,6020
25005,38739,6308,18732,5271,32431,11744,5724,6020
25010,38749,6311,18738,5274,32438,11746,5724,6022
25015,38755,6311,18741,5274,32443,11749,5725,6024
25020,38766,6316,18749,5279,32450,11751,5727,6024
25025,38770,6317,18751,5280,32453,11752,5728,6024
25030,38780,6318,18756,5280,32462,11754,5729,6025
25035,38786,6318,18758,5280,32467,11757,5729,6028
25040,38797,6319,18760,5281,32478,11759,5729,6030
25045,38801,6320,18762,5282,32481,11760,5729,6031
25050,38811,6321,18766,5282,32490,11762,5731,6031
25055,38817,6321,18770,5282,32496,11765,5733,6032
25060,38828,6321,18774,5282,32507,11767,5734,6033
25065,38832,6322,18777,5283,32510,11768,5735,6033
25070,38842,6323,18783,5284,32519,11770,5736,6034
25075,38848,6323,18786,5284,32524,11773,5736,6037
25080,38859,6324,18794,5285,32534,11776,5739,6037
25085,38863,6325,18796,5286,32538,11777,5739,6038
25090,38873,6326,18804,5287,32547,11779,5739,6040
25095,38879,6326,18807,5287,32553,11782,5740,6042
25100,38890,6327,18813,5288,32562,11785,5741,6044
25105,38894,6329,18816,5290,32565,11786,5742,6044
25110,38904,6330,18822,5290,32574,11788,5742,6046
25115,38910,6330,18822,5290,32580,11791,5742,6049
25120,38921,6330,18827,5290,32590,11794,5744,6050
25125,38925,6331,18828,5291,32594,11795,5744,6051
25130,38935,6334,18834,5293,32601,11797,5745,6052
25135,38941,6334,18837,5293,32606,11800,5747,6053
25140,38952,6339,18845,5297,32612,11803,5749,6054
25145,38956,6341,18846,5299,32615,11804,5749,6055
25150,38966,6344,18851,5301,32622,11806,5749,6057
25155,38972,6344,18855,5301,32627,11809,5751,6058
25160,38983,6346,18859,5303,32636,11812,5751,6061
25165,38987,6348,18861,5305,32639,11813,5751,6062
25170,38997,6351,18868,5307,32646,11815,5753,6062
25175,39003,6351,18870,5307,32652,11818,5754,6064
25180,39014,6352,18872,5308,32662,11821,5754,6067
25185,39018,6354,18875,5310,32664,11822,5755,6067
25190,39028,6357,18881,5313,32671,11824,5755,6069
25195,39034,6357,18886,5313,32676,11827,5757,6070
25200,39045,6361,18895,5317,32683,11830,5760,6070
25205,39049,6363,18896,5319,32686,11831,5760,6071
25210,39059,6364,18900,5320,32695,11833,5762,6071
25215,39065,6364,18902,5320,32701,11836,5764,6072
25220,39076,6366,18908,5322,32710,11839,5765,6074
25225,39080,6367,18911,5323,32713,11840,5766,6074
25230,39090,6368,18915,5324,32722,11842,5767,6075
25235,39096,6368,18919,5324,32728,11845,5769,6076
25240,39107,6369,18923,5325,32738,11848,5770,6078
25245,39111,6369,18924,5325,32742,11849,5771,6078
25250,39121,6370,18929,5326,32751,11851,5771,6080
25255,39127,6370,18931,5326,32757,11854,5772,6082
25260,39138,6372,18938,5328,32766,11857,5773,6084
25265,39142,6373,18940,5329,32769,11858,5773,6085
25270,39152,6374,18942,5330,32778,11860,5773,6087
25275,39158,6374,18947,5330,32784,11863,5776,6087
25280,39169,6376,18953,5331,32793,11866,5779,6087
25285,39173,6377,18955,5332,32796,11867,5779,6088
25290,39183,6377,18961,5332,32806,11869,5780,6089
25295,39189,6377,18964,5332,32812,11872,5781,6091
25300,39200,6379,18971,5334,32821,11875,5782,6093
25305,39204,6380,18973,5335,32824,11876,5783,6093
25310,39214,6381,18979,5336,32833,11878,5784,6094
25315,39220,6381,18983,5336,32838,11881,5786,6095
25320,39231,6385,18988,5339,32846,11884,5786,6098
25325,39235,6386,18990,5340,32849,11885,5786,6099
25330,39245,6387,18994,5340,32858,11887,5786,6101
25335,39251,6387,18996,5340,32863,11890,5787,6103
25340,39262,6388,19000,5341,32873,11893,5789,6104
25345,39266,6389,19000,5342,32877,11894,5789,6105
25350,39276,6390,19007,5343,32886,11896,5790,6106
25355,39282,6390,19009,5343,32892,11899,5791,6108
25360,39293,6390,19015,5343,32903,11902,5793,6109
25365,39297,6391,19018,5344,32906,11903,5794,6109
25370,39307,6392,19023,5345,32915,11905,5794,6111
25375,39313,6392,19026,5345,32921,11908,5796,6112
25380,39324,6393,19033,5346,32931,11911,5797,6114
25385,39328,6393,19036,5346,32935,11912,5798,6114
25390,39338,6394,19042,5347,32944,11914,5800,6114
25395,39344,6394,19046,5347,32950,11917,5802,6115
25400,39355,6395,19054,5348,32959,11920,5803,6117
25405,39359,6397,19058,5350,32962,11921,5804,6117
25410,39369,6398,19063,5351,32971,11923,5804,6119
25415,39375,6398,19066,5351,32976,11926,5806,6120
25420,39386,6399,19070,5352,32987,11929,5808,6121
25425,39390,6400,19072,5353,32990,11930,5809,6121
25430,39400,6403,19075,5355,32997,11932,5809,6123
25435,39406,6403,19079,5355,33002,11935,5811,6124
25440,39417,6406,19083,5357,33011,11938,5813,6125
25445,39421,6407,19085,5358,33014,11939,5814,6125
25450,39431,6409,19090,5359,33022,11941,5814,6127
25455,39437,6409,19092,5359,33028,11944,5815,6129
25460,39448,6412,19096,5362,33036,11947,5816,6131
25465,39452,6414,19098,5364,33038,11948,5816,6132
25470,39462,6416,19102,5365,33046,11950,5817,6133
25475,39468,6416,19108,5365,33051,11953,5820,6133
25480,39479,6420,19113,5369,33059,11956,5821,6135
25485,39483,6420,19114,5369,33063,11957,5822,6135
25490,39493,6422,19120,5370,33071,11959,5823,6136
25495,39499,6422,19125,5370,33076,11962,5826,6136
25500,39510,6426,19133,5374,33083,11965,5828,6137
25505,39514,6427,19134,5375,33087,11966,5829,6137
25510,39524,6429,19139,5377,33095,11968,5830,6138
25515,39530,6429,19144,5377,33100,11971,5832,6139
25520,39541,6433,19150,5381,33108,11974,5834,6140
25525,39545,6433,19152,5381,33112,11975,5835,6140
25530,39555,6434,19158,5382,33121,11977,5837,6140
25535,39561,6434,19162,5382,33126,11980,5840,6140
25540,39572,6437,19165,5385,33135,11983,5841,6142
25545,39576,6438,19167,5386,33138,11984,5841,6143
25550,39586,6439,19170,5386,33147,11986,5842,6144
25555,39592,6439,19172,5386,33153,11989,5844,6145
25560,39603,6441,19177,5388,33162,11992,5846,6146
25565,39607,6443,19179,5390,33164,11993,5846,6147
25570,39617,6446,19186,5392,33171,11995,5847,6148
25575,39623,6446,19191,5392,33177,11998,5850,6148
25580,39634,6447,19194,5393,33187,12001,5850,6151
25585,39638,6448,19196,5394,33190,12002,5850,6152
25590,39648,6451,19203,5397,33197,12004,5850,6154
25595,39654,6451,19206,5397,33203,12007,5851,6156
25600,39665,6454,19213,5399,33210,12010,5852,6158
25605,39669,6456,19215,5401,33213,12011,5852,6159
25610,39679,6458,19217,5403,33221,12013,5852,6161
25615,39685,6458,19221,5403,33226,12016,5853,6163
25620,39696,6462,19227,5406,33234,12019,5856,6163
25625,39700,6462,19229,5406,33238,12020,5856,6164
25630,39710,6463,19235,5407,33247,12022,5858,6164
25635,39716,6463,19237,5407,33252,12025,5859,6166
25640,39727,6465,19243,5409,33261,12027,5860,6167
25645,39731,6466,19246,5410,33265,12028,5861,6167
25650,39741,6467,19252,5410,33274,12030,5863,6167
25655,39747,6467,19255,5410,33279,12033,5864,6169
25660,39758,6468,19259,5411,33289,12035,5865,6170
25665,39762,6469,19260,5412,33293,12036,5865,6171
25670,39772,6470,19263,5412,33302,12038,5866,6172
25675,39778,6470,19265,5412,33308,12041,5867,6174
25680,39789,6470,19267,5412,33319,12043,5867,6176
25685,39793,6471,19268,5413,33322,12044,5867,6177
25690,39803,6472,19275,5413,33331,12046,5868,6178
25695,39809,6472,19277,5413,33337,12049,5869,6180
25700,39820,6472,19286,5413,33347,12051,5871,6180
25705,39824,6473,19287,5414,33351,12052,5871,6181
25710,39834,6474,19295,5415,33360,12054,5872,6182
25715,39840,6474,19297,5415,33366,12057,5874,6183
25720,39851,6474,19300,5415,33377,12059,5874,6185
25725,39855,6474,19302,5415,33381,12060,5875,6185
25730,39865,6477,19307,5417,33388,12062,5876,6186
25735,39871,6477,19307,5417,33394,12065,5876,6189
25740,39882,6478,19311,5418,33403,12068,5877,6191
25745,39886,6480,19314,5420,33406,12069,5878,6191
25750,39896,6481,19320,5420,33415,12071,5880,6191
25755,39902,6481,19325,5420,33420,12074,5883,6191
25760,39913,6483,19327,5421,33430,12077,5884,6193
25765,39917,6484,19329,5422,33433,12078,5885,6193
25770,39927,6485,19332,5422,33442,12080,5886,6194
25775,39933,6485,19335,5422,33447,12083,5887,6196
25780,39944,6487,19338,5423,33457,12086,5888,6198
25785,39948,6489,19340,5425,33459,12087,5888,6199
25790,39958,6490,19343,5425,33468,12089,5889,6200
25795,39964,6490,19346,5425,33474,12092,5890,6202
25800,39975,6491,19350,5425,33483,12095,5892,6203
25805,39979,6493,19352,5427,33486,12096,5892,6204
25810,39989,6494,19354,5428,33495,12098,5892,6206
25815,39995,6494,19357,5428,33500,12101,5893,6208
25820,40006,6496,19361,5429,33509,12104,5894,6210
25825,40010,6498,19363,5431,33512,12105,5895,6210
25830,40020,6499,19368,5431,33521,12107,5895,6212
25835,40026,6499,19369,5431,33526,12110,5895,6215
25840,40037,6502,19375,5434,33535,12113,5896,6217
25845,40041,6504,19378,5436,33537,12114,5897,6217
25850,40051,6506,19385,5438,33545,12116,5899,6217
25855,40057,6506,19391,5438,33550,12119,5902,6217
25860,40068,6510,19399,5442,33557,12122,5903,6219
25865,40072,6512,19402,5444,33560,12123,5904,6219
25870,40082,6513,19406,5444,33569,12125,5905,6220
25875,40088,6513,19407,5444,33575,12128,5905,6223
25880,40099,6514,19409,5444,33585,12131,5905,6226
25885,40103,6514,19411,5444,33589,12132,5906,6226
25890,40113,6516,19415,5445,33597,12134,5906,6228
25895,40119,6516,19418,5445,33602,12137,5907,6230
25900,40130,6520,19425,5448,33610,12140,5909,6231
25905,40134,6522,19428,5450,33612,12141,5910,6231
25910,40144,6524,19433,5452,33620,12143,5910,6233
25915,40150,6524,19435,5452,33625,12146,5911,6235
25920,40161,6527,19441,5455,33634,12149,5913,6236
25925,40165,6527,19442,5455,33638,12150,5914,6236
25930,40175,6529,19446,5456,33646,12152,5914,6238
25935,40181,6529,19449,5456,33651,12155,5914,6241
25940,40192,6533,19456,5460,33658,12158,5915,6243
25945,40196,6534,19456,5461,33662,12159,5915,6244
25950,40206,6536,19459,5463,33670,12161,5916,6245
25955,40212,6536,19462,5463,33675,12164,5917,6247
25960,40223,6539,19464,5465,33684,12167,5917,6250
25965,40227,6541,19467,5467,33686,12168,5918,6250
25970,40237,6543,19470,5468,33694,12170,5919,6251
25975,40243,6543,19474,5468,33699,12173,5921,6252
25980,40254,6546,19481,5471,33708,12176,5924,6252
25985,40258,6547,19482,5472,33711,12177,5924,6253
25990,40268,6549,19487,5474,33719,12179,5925,6254
25995,40274,6549,19490,5474,33725,12182,5925,6257
26000,40285,6550,19494,5474,33735,12185,5928,6257
26005,40289,6550,19496,5474,33739,12186,5928,6258
26010,40299,6551,19499,5475,33748,12188,5929,6259
26015,40305,6551,19504,5475,33754,12191,5932,6259
26020,40316,6554,19511,5478,33762,12194,5934,6260
26025,40320,6554,19512,5478,33766,12195,5934,6261
26030,40330,6554,19517,5478,33776,12197,5935,6262
26035,40336,6554,19519,5478,33782,12200,5935,6265
26040,40347,6556,19524,5479,33791,12203,5937,6266
26045,40351,6557,19528,5480,33794,12204,5938,6266
26050,40361,6558,19535,5481,33803,12206,5940,6266
26055,40367,6558,19537,5481,33809,12209,5940,6269
26060,40378,6559,19538,5481,33819,12212,5940,6272
26065,40382,6559,19538,5481,33823,12213,5940,6273
26070,40392,6561,19544,5483,33831,12215,5941,6274
26075,40398,6561,19547,5483,33837,12218,5943,6275
26080,40409,6564,19553,5485,33845,12221,5944,6277
26085,40413,6564,19554,5485,33849,12222,5945,6277
26090,40423,6565,19557,5486,33858,12224,5946,6278
26095,40429,6565,19560,5486,33864,12227,5948,6279
26100,40440,6568,19563,5488,33872,12230,5948,6282
26105,40444,6569,19564,5489,33875,12231,5948,6283
26110,40454,6570,19570,5490,33884,12233,5950,6283
26115,40460,6570,19573,5490,33890,12236,5952,6284
26120,40471,6573,19582,5493,33897,12239,5954,6285
26125,40475,6575,19583,5495,33900,12240,5954,6286
26130,40485,6576,19587,5496,33909,12242,5954,6288
26135,40491,6576,19592,5496,33914,12245,5957,6288
26140,40502,6580,19598,5499,33921,12248,5958,6290
26145,40506,6581,19598,5500,33925,12249,5958,6291
26150,40516,6582,19603,5501,33934,12251,5959,6292
26155,40522,6582,19605,5501,33940,12254,5960,6294
26160,40533,6584,19609,5502,33948,12257,5960,6297
26165,40537,6585,19610,5503,33952,12258,5961,6297
26170,40547,6586,19611,5503,33961,12260,5961,6299
26175,40553,6586,19615,5503,33966,12263,5963,6300
26180,40564,6589,19619,5505,33974,12266,5963,6303
26185,40568,6592,19621,5508,33976,12267,5963,6304
26190,40578,6594,19628,5510,33984,12269,5964,6305
26195,40584,6594,19631,5510,33990,12272,5966,6306
26200,40595,6595,19635,5511,33999,12275,5967,6308
26205,40599,6597,19637,5513,34002,12276,5968,6308
26210,40609,6600,19642,5515,34009,12278,5969,6309
26215,40615,6600,19644,5515,34014,12281,5970,6311
26220,40626,6605,19650,5519,34021,12284,5972,6312
26225,40630,6606,19653,5520,34024,12285,5973,6312
26230,40640,6607,19655,5520,34033,12287,5973,6314
26235,40646,6607,19657,5520,34039,12290,5974,6316
26240,40657,6607,19664,5520,34049,12293,5975,6318
26245,40661,6608,19664,5521,34053,12294,5975,6319
26250,40671,6609,19667,5521,34062,12296,5976,6320
26255,40677,6609,19669,5521,34068,12299,5977,6322
26260,40688,6610,19672,5522,34078,12302,5978,6324
26265,40692,6610,19675,5522,34082,12303,5979,6324
26270,40702,6611,19679,5522,34091,12305,5979,6326
26275,40708,6611,19681,5522,34097,12308,5980,6328
26280,40719,6611,19683,5522,34108,12311,5981,6330
26285,40723,6611,19686,5522,34112,12312,5982,6330
26290,40733,6612,19691,5522,34121,12314,5983,6331
26295,40739,6612,19693,5522,34126,12317,5983,6334
26300,40750,6614,19699,5524,34136,12319,5983,6336
26305,40754,6614,19700,5524,34140,12320,5983,6337
26310,40764,6615,19705,5525,34149,12322,5984,6338
26315,40770,6615,19708,5525,34154,12325,5984,6341
26320,40781,6617,19714,5527,34163,12327,5985,6342
26325,40785,6618,19716,5528,34167,12328,5986,6342
26330,40795,6621,19725,5531,34174,12330,5987,6343
26335,40801,6621,19727,5531,34180,12333,5989,6344
26340,40812,6624,19730,5533,34188,12335,5989,6346
26345,40816,6625,19732,5534,34191,12336,5990,6346
26350,40826,6627,19736,5535,34199,12338,5991,6347
26355,40832,6627,19737,5535,34205,12341,5992,6349
26360,40843,6629,19742,5537,34213,12343,5993,6350
26365,40847,6632,19746,5540,34215,12344,5994,6350
26370,40857,6635,19752,5542,34222,12346,5994,6352
26375,40863,6635,19757,5542,34227,12349,5996,6353
26380,40874,6637,19761,5543,34237,12351,5997,6354
26385,40878,6638,19763,5544,34240,12352,5998,6354
26390,40888,6640,19768,5546,34248,12354,5999,6355
26395,40894,6640,19772,5546,34253,12357,6001,6356
26400,40905,6643,19776,5548,34261,12360,6002,6358
26405,40909,6645,19778,5550,34264,12361,6003,6358
26410,40919,6647,19784,5552,34272,12363,6004,6359
26415,40925,6647,19788,5552,34277,12366,6005,6361
26420,40936,6650,19792,5554,34285,12369,6006,6363
26425,40940,6653,19796,5557,34287,12370,6007,6363
26430,40950,6655,19802,5559,34295,12372,6008,6364
26435,40956,6655,19804,5559,34301,12375,6009,6366
26440,40967,6657,19807,5560,34310,12378,6009,6369
26445,40971,6658,19808,5561,34313,12379,6009,6370
26450,40981,6660,19812,5563,34321,12381,6010,6371
26455,40987,6660,19815,5563,34326,12384,6011,6373
26460,40998,6665,19822,5568,34333,12387,6011,6376
26465,41002,6666,19824,5569,34336,12388,6011,6377
26470,41012,6668,19829,5571,34344,12390,6012,6378
26475,41018,6668,19831,5571,34349,12393,6013,6380
26480,41029,6673,19839,5575,34356,12396,6015,6381
26485,41033,6674,19842,5576,34359,12397,6015,6382
26490,41043,6675,19849,5577,34368,12399,6016,6383
26495,41049,6675,19852,5577,34374,12402,6018,6384
26500,41060,6677,19859,5579,34383,12405,6020,6385
26505,41064,6678,19863,5580,34386,12406,6021,6385
26510,41074,6679,19867,5581,34395,12408,6022,6386
26515,41080,6679,19870,5581,34401,12411,6024,6387
26520,41091,6681,19877,5583,34410,12414,6025,6389
26525,41095,6681,19880,5583,34414,12415,6026,6389
26530,41105,6681,19883,5583,34424,12417,6027,6390
26535,41111,6681,19886,5583,34430,12420,6029,6391
26540,41122,6681,19894,5583,34441,12423,6031,6392
26545,41126,6681,19897,5583,34445,12424,6031,6393
26550,41136,6681,19902,5583,34455,12426,6032,6394
26555,41142,6681,19905,5583,34461,12429,6033,6396
26560,41153,6681,19911,5583,34472,12432,6034,6398
26565,41157,6681,19912,5583,34476,12433,6034,6399
26570,41167,6681,19918,5583,34486,12435,6034,6401
26575,41173,6681,19923,5583,34492,12438,6036,6402
26580,41184,6681,19932,5583,34503,12441,6039,6402
26585,41188,6681,19935,5583,34507,12442,6040,6402
26590,41198,6682,19943,5584,34516,12444,6042,6402
26595,41204,6682,19944,5584,34522,12447,6043,6404
26600,41215,6682,19948,5584,34533,12450,6044,6406
26605,41219,6683,19951,5585,34536,12451,6044,6407
26610,41229,6684,19956,5585,34545,12453,6045,6408
26615,41235,6684,19960,5585,34551,12456,6048,6408
26620,41246,6684,19963,5585,34562,12459,6049,6410
26625,41250,6684,19964,5585,34566,12460,6049,6411
26630,41260,6685,19970,5586,34575,12462,6050,6412
26635,41266,6685,19973,5586,34580,12465,6052,6413
26640,41277,6688,19979,5588,34588,12468,6054,6414
26645,41281,6690,19980,5590,34591,12469,6054,6415
26650,41291,6693,19987,5592,34598,12471,6055,6416
26655,41297,6693,19989,5592,34604,12474,6057,6417
26660,41308,6695,19993,5593,34613,12477,6058,6419
26665,41312,6696,19995,5594,34616,12478,6058,6420
26670,41322,6698,19998,5596,34624,12480,6058,6422
26675,41328,6698,20000,5596,34629,12483,6059,6424
26680,41339,6703,20009,5601,34635,12486,6061,6425
26685,41343,6704,20011,5602,34639,12487,6062,6425
26690,41353,6705,20015,5603,34648,12489,6063,6426
26695,41359,6705,20018,5603,34654,12492,6066,6426
26700,41370,6707,20024,5605,34662,12495,6067,6428
26705,41374,6708,20026,5606,34666,12496,6068,6428
26710,41384,6711,20032,5608,34673,12498,6069,6429
26715,41390,6711,20033,5608,34679,12501,6069,6432
26720,41401,6713,20036,5610,34688,12504,6070,6434
26725,41405,6714,20037,5611,34691,12505,6070,6435
26730,41415,6715,20040,5612,34700,12507,6071,6436
26735,41421,6715,20045,5612,34705,12510,6073,6437
26740,41432,6719,20048,5615,34713,12513,6074,6439
26745,41436,6720,20050,5616,34716,12514,6075,6439
26750,41446,6722,20052,5617,34724,12516,6075,6441
26755,41452,6722,20056,5617,34730,12519,6078,6441
26760,41463,6723,20058,5617,34740,12522,6080,6442
26765,41467,6723,20058,5617,34744,12523,6080,6443
26770,41477,6726,20061,5619,34751,12525,6080,6445
26775,41483,6726,20064,5619,34756,12528,6082,6446
26780,41494,6729,20067,5622,34764,12531,6082,6449
26785,41498,6732,20070,5625,34766,12532,6082,6450
26790,41508,6735,20076,5627,34773,12534,6083,6451
26795,41514,6735,20078,5627,34779,12537,6084,6453
26800,41525,6739,20084,5630,34785,12540,6084,6456
26805,41529,6741,20086,5632,34788,12541,6084,6457
26810,41539,6744,20091,5634,34795,12543,6084,6459
26815,41545,6744,20094,5634,34800,12546,6085,6461
26820,41556,6746,20099,5636,34809,12549,6086,6463
26825,41560,6748,20102,5638,34812,12550,6087,6463
26830,41570,6750,20107,5640,34820,12552,6088,6464
26835,41576,6750,20109,5640,34826,12555,6089,6466
26840,41587,6752,20116,5642,34834,12558,6091,6467
26845,41591,6755,20120,5645,34836,12559,6092,6467
26850,41601,6757,20127,5646,34844,12561,6094,6467
26855,41607,6757,20131,5646,34850,12564,6096,6468
26860,41618,6759,20137,5648,34858,12567,6097,6470
26865,41622,6761,20139,5650,34861,12568,6098,6470
26870,41632,6762,20144,5651,34870,12570,6099,6471
26875,41638,6762,20146,5651,34876,12573,6099,6474
26880,41649,6765,20151,5654,34884,12576,6100,6476
26885,41653,6766,20153,5655,34887,12577,6100,6477
26890,41663,6767,20158,5655,34896,12579,6102,6477
26895,41669,6767,20160,5655,34902,12582,6102,6480
26900,41680,6767,20167,5655,34912,12585,6104,6481
26905,41684,6768,20169,5656,34916,12586,6104,6482
26910,41694,6769,20173,5657,34925,12588,6105,6483
26915,41700,6769,20176,5657,34931,12591,6106,6485
26920,41711,6769,20184,5657,34941,12594,6108,6486
26925,41715,6770,20186,5658,34945,12595,6108,6487
26930,41725,6771,20191,5658,34954,12597,6109,6488
26935,41731,6771,20195,5658,34960,12600,6112,6488
26940,41742,6772,20202,5659,34970,12603,6115,6488
26945,41746,6772,20204,5659,34974,12604,6115,6489
26950,41756,6773,20209,5660,34983,12606,6117,6489
26955,41762,6773,20213,5660,34989,12609,6119,6490
26960,41773,6774,20218,5661,34999,12611,6119,6492
26965,41777,6774,20219,5661,35003,12612,6120,6492
26970,41787,6775,20223,5662,35012,12614,6121,6493
26975,41793,6775,20226,5662,35017,12617,6123,6494
26980,41804,6776,20228,5663,35028,12619,6123,6496
26985,41808,6776,20232,5663,35032,12620,6124,6496
26990,41818,6777,20236,5664,35041,12622,6124,6498
26995,41824,6777,20238,5664,35046,12625,6124,6501
27000,41835,6780,20243,5666,35054,12627,6125,6502
27005,41839,6782,20246,5668,35057,12628,6126,6502
27010,41849,6783,20250,5668,35066,12630,6127,6503
27015,41855,6783,20253,5668,35072,12633,6129,6504
27020,41866,6786,20259,5671,35080,12635,6130,6505
27025,41870,6786,20261,5671,35084,12636,6131,6505
27030,41880,6787,20265,5672,35093,12638,6132,6506
27035,41886,6787,20267,5672,35098,12641,6133,6508
27040,41897,6791,20274,5676,35105,12643,6135,6508
27045,41901,6793,20275,5678,35108,12644,6135,6509
27050,41911,6795,20280,5679,35116,12646,6136,6510
27055,41917,6795,20283,5679,35121,12649,6137,6512
27060,41928,6799,20289,5683,35128,12652,6137,6515
27065,41932,6800,20290,5684,35132,12653,6138,6515
27070,41942,6802,20295,5685,35140,12655,6139,6516
27075,41948,6802,20297,5685,35145,12658,6140,6518
27080,41959,6805,20301,5688,35154,12661,6141,6520
27085,41963,6805,20302,5688,35158,12662,6141,6521
27090,41973,6806,20306,5688,35167,12664,6143,6521
27095,41979,6806,20309,5688,35173,12667,6144,6523
27100,41990,6809,20316,5691,35180,12670,6144,6526
27105,41994,6811,20317,5693,35183,12671,6144,6527
27110,42004,6813,20323,5695,35191,12673,6144,6529
27115,42010,6813,20327,5695,35196,12676,6146,6530
27120,42021,6816,20330,5697,35205,12679,6147,6532
27125,42025,6818,20332,5699,35207,12680,6147,6533
27130,42035,6820,20336,5700,35215,12682,6148,6534
27135,42041,6820,20338,5700,35221,12685,6148,6537
27140,42052,6822,20343,5702,35229,12688,6148,6540
27145,42056,6824,20344,5704,35232,12689,6148,6541
27150,42066,6826,20351,5706,35240,12691,6150,6541
27155,42072,6826,20354,5706,35246,12694,6152,6542
27160,42083,6828,20358,5708,35255,12697,6154,6543
27165,42087,6829,20359,5709,35258,12698,6154,6544
27170,42097,6830,20364,5710,35267,12700,6156,6544
27175,42103,6830,20366,5710,35272,12703,6156,6547
27180,42114,6834,20372,5714,35280,12706,6157,6549
27185,42118,6835,20374,5715,35283,12707,6157,6550
27190,42128,6837,20377,5717,35291,12709,6157,6552
27195,42134,6837,20381,5717,35297,12712,6159,6553
27200,42145,6839,20387,5719,35305,12715,6161,6554
27205,42149,6840,20388,5720,35309,12716,6161,6555
27210,42159,6842,20393,5721,35317,12718,6161,6557
27215,42165,6842,20396,5721,35323,12721,6162,6559
27220,42176,6845,20402,5723,35330,12724,6163,6561
27225,42180,6848,20406,5726,35332,12725,6164,6561
27230,42190,6851,20413,5729,35339,12727,6166,6561
27235,42196,6851,20415,5729,35345,12730,6168,6562
27240,42207,6853,20420,5731,35353,12733,6169,6564
27245,42211,6856,20424,5734,35355,12734,6170,6564
27250,42221,6858,20430,5736,35363,12736,6172,6564
27255,42227,6858,20432,5736,35369,12739,6174,6565
27260,42238,6860,20440,5738,35378,12742,6176,6566
27265,42242,6860,20443,5738,35382,12743,6177,6566
27270,42252,6861,20447,5739,35391,12745,6178,6567
27275,42258,6861,20450,5739,35397,12748,6179,6569
27280,42269,6863,20452,5740,35406,12751,6179,6572
27285,42273,6864,20455,5741,35409,12752,6180,6572
27290,42283,6866,20461,5743,35417,12754,6181,6573
27295,42289,6866,20464,5743,35423,12757,6182,6575
27300,42300,6868,20470,5745,35432,12760,6183,6577
27305,42304,6868,20471,5745,35436,12761,6183,6578
27310,42314,6868,20475,5745,35446,12763,6184,6579
27315,42320,6868,20478,5745,35452,12766,6185,6581
27320,42331,6868,20484,5745,35463,12769,6186,6583
27325,42335,6868,20486,5745,35467,12770,6187,6583
27330,42345,6868,20493,5745,35477,12772,6187,6585
27335,42351,6868,20494,5745,35483,12775,6188,6587
27340,42362,6868,20499,5745,35494,12778,6190,6588
27345,42366,6868,20501,5745,35498,12779,6190,6589
27350,42376,6869,20505,5746,35507,12781,6191,6590
27355,42382,6869,20508,5746,35512,12784,6192,6592
27360,42393,6870,20512,5747,35522,12787,6193,6594
27365,42397,6871,20513,5748,35526,12788,6193,6595
27370,42407,6872,20519,5749,35535,12790,6194,6596
27375,42413,6872,20522,5749,35540,12793,6196,6597
27380,42424,6874,20527,5751,35549,12796,6197,6599
27385,42428,6875,20527,5752,35553,12797,6197,6600
27390,42438,6876,20531,5753,35562,12799,6197,6602
27395,42444,6876,20534,5753,35567,12802,6197,6605
27400,42455,6878,20543,5755,35576,12805,6200,6605
27405,42459,6879,20544,5756,35580,12806,6201,6605
27410,42469,6881,20550,5757,35588,12808,6203,6605
27415,42475,6881,20552,5757,35594,12811,6204,6607
27420,42486,6883,20556,5759,35603,12814,6205,6609
27425,42490,6884,20557,5760,35606,12815,6205,6610
27430,42500,6886,20562,5761,35614,12817,6205,6612
27435,42506,6886,20565,5761,35620,12820,6207,6613
27440,42517,6887,20570,5762,35629,12823,6210,6613
27445,42521,6890,20572,5765,35631,12824,6210,6614
27450,42531,6892,20579,5767,35639,12826,6212,6614
27455,42537,6892,20583,5767,35644,12829,6214,6615
27460,42548,6894,20589,5769,35653,12832,6216,6616
27465,42552,6895,20591,5770,35657,12833,6217,6616
27470,42562,6897,20594,5772,35665,12835,6217,6618
27475,42568,6897,20598,5772,35670,12838,6219,6619
27480,42579,6901,20605,5775,35677,12841,6220,6621
27485,42583,6904,20608,5778,35679,12842,6220,6622
27490,42593,6905,20614,5779,35688,12844,6221,6623
27495,42599,6905,20618,5779,35693,12847,6223,6624
27500,42610,6908,20620,5782,35702,12850,6223,6627
27505,42614,6908,20621,5782,35706,12851,6223,6628
27510,42624,6909,20623,5782,35715,12853,6224,6629
27515,42630,6909,20625,5782,35720,12856,6225,6631
27520,42641,6911,20632,5783,35729,12859,6228,6631
27525,42645,6914,20635,5786,35731,12860,6229,6631
27530,42655,6915,20639,5786,35740,12862,6231,6631
27535,42661,6915,20643,5786,35745,12865,6232,6633
27540,42672,6918,20649,5789,35753,12868,6234,6634
27545,42676,6920,20651,5791,35756,12869,6235,6634
27550,42686,6922,20653,5792,35764,12871,6236,6635
27555,42692,6922,20656,5792,35770,12874,6237,6637
27560,42703,6924,20659,5793,35779,12877,6238,6639
27565,42707,6924,20662,5793,35783,12878,6239,6639
27570,42717,6926,20668,5795,35791,12880,6240,6640
27575,42723,6926,20669,5795,35797,12883,6240,6643
27580,42734,6930,20676,5798,35804,12886,6242,6644
27585,42738,6931,20679,5799,35807,12887,6242,6645
27590,42748,6934,20685,5802,35814,12889,6243,6646
27595,42754,6934,20687,5802,35820,12892,6245,6647
27600,42765,6935,20691,5802,35829,12895,6247,6648
27605,42769,6937,20693,5804,35832,12896,6247,6649
27610,42779,6939,20698,5805,35840,12898,6249,6649
27615,42785,6939,20700,5805,35845,12901,6250,6651
27620,42796,6942,20707,5808,35854,12903,6252,6651
27625,42800,6942,20708,5808,35858,12904,6253,6651
27630,42810,6944,20712,5809,35866,12906,6254,6652
27635,42816,6944,20717,5809,35871,12909,6257,6652
27640,42827,6946,20723,5811,35880,12911,6258,6653
27645,42831,6947,20725,5812,35884,12912,6258,6654
27650,42841,6950,20729,5814,35891,12914,6259,6655
27655,42847,6950,20733,5814,35896,12917,6261,6656
27660,42858,6955,20741,5819,35902,12919,6263,6656
27665,42862,6957,20742,5821,35905,12920,6263,6657
27670,42872,6959,20750,5823,35913,12922,6265,6657
27675,42878,6959,20752,5823,35919,12925,6266,6659
27680,42889,6962,20757,5826,35926,12927,6266,6661
27685,42893,6963,20757,5827,35930,12928,6266,6662
27690,42903,6965,20760,5828,35938,12930,6266,6664
27695,42909,6965,20762,5828,35944,12933,6268,6665
27700,42920,6967,20767,5829,35952,12935,6268,6667
27705,42924,6969,20768,5831,35955,12936,6268,6668
27710,42934,6972,20774,5834,35962,12938,6269,6669
27715,42940,6972,20776,5834,35968,12941,6270,6671
27720,42951,6975,20782,5837,35976,12944,6272,6672
27725,42955,6976,20784,5838,35979,12945,6273,6672
27730,42965,6977,20790,5839,35988,12947,6274,6673
27735,42971,6977,20792,5839,35994,12950,6275,6675
27740,42982,6977,20794,5839,36004,12953,6275,6678
27745,42986,6978,20794,5840,36008,12954,6275,6679
27750,42996,6979,20797,5840,36017,12956,6277,6679
27755,43002,6979,20800,5840,36022,12959,6279,6680
27760,43013,6980,20805,5841,36032,12962,6281,6681
27765,43017,6981,20807,5842,36036,12963,6282,6681
27770,43027,6982,20814,5842,36045,12965,6284,6681
27775,43033,6982,20817,5842,36051,12968,6285,6683
27780,43044,6982,20823,5842,36061,12971,6287,6684
27785,43048,6984,20824,5844,36064,12972,6287,6685
27790,43058,6985,20827,5844,36073,12974,6288,6686
27795,43064,6985,20829,5844,36079,12977,6289,6688
27800,43075,6985,20833,5844,36090,12980,6289,6691
27805,43079,6986,20836,5845,36093,12981,6290,6691
27810,43089,6987,20841,5846,36102,12983,6292,6691
27815,43095,6987,20845,5846,36108,12986,6295,6691
27820,43106,6987,20848,5846,36118,12989,6296,6693
27825,43110,6989,20851,5848,36121,12990,6297,6693
27830,43120,6990,20853,5848,36130,12992,6297,6695
27835,43126,6990,20854,5848,36136,12995,6297,6698
27840,43137,6992,20858,5849,36145,12998,6298,6700
27845,43141,6993,20860,5850,36148,12999,6298,6701
27850,43151,6994,20864,5851,36157,13001,6299,6702
27855,43157,6994,20867,5851,36163,13004,6300,6704
27860,43168,6995,20869,5852,36173,13007,6301,6706
27865,43172,6996,20872,5853,36176,13008,6302,6706
27870,43182,6997,20879,5854,36185,13010,6304,6706
27875,43188,6997,20881,5854,36191,13013,6305,6708
27880,43199,6998,20887,5855,36201,13016,6307,6709
27885,43203,6998,20889,5855,36205,13017,6308,6709
27890,43213,6999,20894,5856,36214,13019,6309,6710
27895,43219,6999,20898,5856,36220,13022,6311,6711
27900,43230,7000,20900,5857,36230,13025,6311,6714
27905,43234,7000,20901,5857,36234,13026,6311,6715
27910,43244,7000,20903,5857,36244,13028,6312,6716
27915,43250,7000,20905,5857,36250,13031,6313,6718
27920,43261,7002,20911,5858,36259,13034,6315,6719
27925,43265,7003,20913,5859,36262,13035,6316,6719
27930,43275,7004,20919,5860,36271,13037,6318,6719
27935,43281,7004,20924,5860,36277,13040,6320,6720
27940,43292,7005,20928,5860,36287,13043,6322,6721
27945,43296,7006,20930,5861,36290,13044,6323,6721
27950,43306,7008,20938,5863,36298,13046,6324,6722
27955,43312,7008,20939,5863,36304,13049,6325,6724
27960,43323,7012,20945,5866,36311,13052,6327,6725
27965,43327,7013,20946,5867,36314,13053,6327,6726
27970,43337,7015,20951,5869,36322,13055,6328,6727
27975,43343,7015,20955,5869,36328,13058,6330,6728
27980,43354,7017,20960,5870,36337,13061,6332,6729
27985,43358,7017,20961,5870,36341,13062,6333,6729
27990,43368,7018,20964,5870,36350,13064,6333,6731
27995,43374,7018,20966,5870,36356,13067,6334,6733
28000,43385,7020,20972,5871,36364,13070,6337,6733
28005,43389,7021,20972,5872,36368,13071,6337,6734
28010,43399,7022,20975,5873,36377,13073,6337,6736
28015,43405,7022,20976,5873,36382,13076,6337,6739
28020,43416,7026,20982,5876,36390,13079,6339,6740
28025,43420,7027,20983,5877,36393,13080,6339,6741
28030,43430,7029,20989,5879,36401,13082,6339,6743
28035,43436,7029,20995,5879,36406,13085,6342,6743
28040,43447,7031,21000,5880,36415,13088,6344,6744
28045,43451,7032,21002,5881,36419,13089,6345,6744
28050,43461,7034,21007,5882,36427,13091,6345,6746
28055,43467,7034,21009,5882,36433,13094,6347,6747
28060,43478,7037,21014,5885,36441,13097,6349,6748
28065,43482,7038,21015,5886,36444,13098,6349,6749
28070,43492,7039,21018,5887,36453,13100,6349,6751
28075,43498,7039,21020,5887,36459,13103,6350,6753
28080,43509,7041,21028,5889,36467,13106,6353,6753
28085,43513,7043,21030,5891,36470,13107,6354,6753
28090,43523,7046,21037,5893,36477,13109,6355,6754
28095,43529,7046,21041,5893,36482,13112,6358,6754
28100,43540,7048,21045,5894,36491,13115,6360,6755
28105,43544,7049,21047,5895,36495,13116,6361,6755
28110,43554,7051,21051,5897,36503,13118,6363,6755
28115,43560,7051,21055,5897,36508,13121,6364,6757
28120,43571,7056,21062,5901,36515,13124,6366,6758
28125,43575,7057,21065,5902,36518,13125,6367,6758
28130,43585,7058,21070,5903,36527,13127,6369,6758
28135,43591,7058,21071,5903,36533,13130,6370,6760
28140,43602,7060,21074,5905,36541,13133,6370,6763
28145,43606,7063,21077,5908,36543,13134,6371,6763
28150,43616,7065,21082,5910,36551,13136,6371,6765
28155,43622,7065,21086,5910,36557,13139,6374,6765
28160,43633,7069,21094,5913,36563,13142,6376,6766
28165,43637,7072,21096,5916,36565,13143,6376,6767
28170,43647,7074,21102,5918,36573,13145,6377,6768
28175,43653,7074,21106,5918,36578,13148,6379,6769
28180,43664,7078,21113,5922,36585,13151,6381,6770
28185,43668,7080,21115,5924,36588,13152,6382,6770
28190,43678,7081,21119,5924,36597,13154,6383,6771
28195,43684,7081,21121,5924,36602,13157,6383,6774
28200,43695,7085,21129,5928,36610,13160,6386,6774
28205,43699,7085,21130,5928,36614,13161,6387,6774
28210,43709,7088,21135,5930,36621,13163,6387,6776
28215,43715,7088,21136,5930,36627,13166,6387,6779
28220,43726,7089,21140,5930,36636,13169,6387,6782
28225,43730,7090,21141,5931,36640,13170,6387,6783
28230,43740,7093,21145,5933,36647,13172,6388,6784
28235,43746,7093,21149,5933,36652,13175,6391,6784
28240,43757,7096,21154,5935,36661,13178,6393,6785
28245,43761,7097,21157,5936,36664,13179,6394,6785
28250,43771,7099,21161,5938,36672,13181,6394,6787
28255,43777,7099,21165,5938,36677,13184,6396,6788
28260,43788,7101,21169,5939,36686,13187,6398,6789
28265,43792,7102,21172,5940,36690,13188,6399,6789
28270,43802,7103,21178,5941,36699,13190,6400,6790
28275,43808,7103,21181,5941,36705,13193,6401,6792
28280,43819,7103,21188,5941,36716,13195,6401,6794
28285,43823,7103,21191,5941,36720,13196,6401,6795
28290,43833,7104,21195,5941,36729,13198,6401,6797
28295,43839,7104,21197,5941,36735,13201,6403,6798
28300,43850,7105,21203,5942,36745,13203,6404,6799
28305,43854,7105,21205,5942,36749,13204,6404,6800
28310,43864,7106,21208,5942,36758,13206,6405,6801
28315,43870,7106,21209,5942,36764,13209,6406,6803
28320,43881,7107,21216,5943,36773,13211,6407,6804
28325,43885,7108,21217,5944,36777,13212,6408,6804
28330,43895,7109,21223,5944,36786,13214,6410,6804
28335,43901,7109,21225,5944,36792,13217,6411,6806
28340,43912,7109,21227,5944,36802,13219,6412,6807
28345,43916,7110,21228,5945,36806,13220,6412,6808
28350,43926,7111,21231,5945,36815,13222,6412,6810
28355,43932,7111,21232,5945,36821,13225,6412,6813
28360,43943,7112,21235,5946,36831,13227,6412,6815
28365,43947,7113,21236,5947,36834,13228,6412,6816
28370,43957,7115,21241,5949,36842,13230,6414,6816
28375,43963,7115,21244,5949,36848,13233,6415,6818
28380,43974,7116,21249,5950,36857,13236,6416,6820
28385,43978,7118,21250,5952,36860,13237,6416,6821
28390,43988,7120,21257,5954,36868,13239,6417,6822
28395,43994,7120,21260,5954,36873,13242,6418,6824
28400,44005,7124,21266,5958,36881,13245,6419,6826
28405,44009,7124,21267,5958,36885,13246,6419,6827
28410,44019,7126,21271,5959,36893,13248,6419,6829
28415,44025,7126,21274,5959,36899,13251,6421,6830
28420,44036,7129,21280,5962,36907,13254,6423,6831
28425,44040,7130,21282,5963,36910,13255,6423,6832
28430,44050,7133,21287,5965,36917,13257,6423,6834
28435,44056,7133,21290,5965,36923,13260,6425,6835
28440,44067,7135,21294,5966,36932,13263,6426,6837
28445,44071,7136,21297,5967,36935,13264,6427,6837
28450,44081,7137,21301,5968,36944,13266,6428,6838
28455,44087,7137,21303,5968,36950,13269,6430,6839
28460,44098,7138,21307,5969,36960,13272,6431,6841
28465,44102,7140,21311,5971,36962,13273,6432,6841
28470,44112,7141,21316,5972,36971,13275,6433,6842
28475,44118,7141,21320,5972,36976,13278,6435,6843
28480,44129,7144,21325,5974,36985,13281,6436,6845
28485,44133,7144,21327,5974,36989,13282,6437,6845
28490,44143,7145,21333,5975,36998,13284,6438,6846
28495,44149,7145,21337,5975,37004,13287,6441,6846
28500,44160,7147,21343,5976,37012,13290,6442,6848
28505,44164,7150,21347,5979,37014,13291,6443,6848
28510,44174,7151,21353,5980,37023,13293,6444,6849
28515,44180,7151,21355,5980,37029,13296,6446,6850
28520,44191,7152,21362,5981,37038,13299,6448,6851
28525,44195,7154,21364,5983,37041,13300,6449,6851
28530,44205,7155,21370,5984,37050,13302,6451,6851
28535,44211,7155,21374,5984,37055,13305,6453,6852
28540,44222,7157,21379,5986,37064,13308,6455,6853
28545,44226,7159,21381,5988,37067,13309,6455,6854
28550,44236,7161,21383,5989,37075,13311,6455,6856
28555,44242,7161,21386,5989,37081,13314,6457,6857
28560,44253,7163,21390,5990,37090,13317,6459,6858
28565,44257,7165,21394,5992,37092,13318,6460,6858
28570,44267,7166,21400,5993,37101,13320,6461,6859
28575,44273,7166,21402,5993,37107,13323,6462,6861
28580,44284,7170,21409,5996,37113,13326,6463,6863
28585,44288,7173,21413,5999,37115,13327,6464,6863
28590,44298,7174,21414,5999,37124,13329,6464,6865
28595,44304,7174,21418,5999,37129,13332,6466,6866
28600,44315,7178,21421,6002,37136,13335,6466,6869
28605,44319,7180,21424,6004,37139,13336,6467,6869
28610,44329,7182,21429,6005,37147,13338,6468,6870
28615,44335,7182,21431,6005,37152,13341,6469,6872
28620,44346,7186,21436,6008,37160,13344,6470,6874
28625,44350,7186,21439,6008,37164,13345,6471,6874
28630,44360,7187,21444,6009,37173,13347,6472,6875
28635,44366,7187,21448,6009,37179,13350,6473,6877
28640,44377,7189,21455,6011,37188,13353,6474,6879
28645,44381,7190,21458,6012,37191,13354,6475,6879
28650,44391,7191,21465,6013,37200,13356,6476,6880
28655,44397,7191,21470,6013,37206,13359,6478,6881
28660,44408,7193,21477,6015,37215,13362,6480,6882
28665,44412,7193,21478,6015,37219,13363,6481,6882
28670,44422,7195,21484,6017,37227,13365,6481,6884
28675,44428,7195,21486,6017,37233,13368,6483,6885
28680,44439,7197,21490,6019,37242,13371,6483,6888
28685,44443,7198,21493,6020,37245,13372,6484,6888
28690,44453,7200,21500,6022,37253,13374,6485,6889
28695,44459,7200,21503,6022,37259,13377,6487,6890
28700,44470,7201,21508,6023,37269,13380,6489,6891
28705,44474,7201,21510,6023,37273,13381,6489,6892
28710,44484,7203,21514,6025,37281,13383,6490,6893
28715,44490,7203,21517,6025,37287,13386,6492,6894
28720,44501,7204,21521,6026,37297,13389,6492,6897
28725,44505,7205,21524,6027,37300,13390,6492,6898
28730,44515,7206,21529,6028,37309,13392,6493,6899
28735,44521,7206,21533,6028,37314,13395,6495,6900
28740,44532,7209,21540,6031,37323,13398,6498,6900
28745,44536,7209,21541,6031,37327,13399,6499,6900
28750,44546,7210,21545,6032,37336,13401,6500,6901
28755,44552,7210,21548,6032,37342,13404,6501,6903
28760,44563,7212,21552,6033,37351,13407,6503,6904
28765,44567,7213,21553,6034,37354,13408,6503,6905
28770,44577,7215,21557,6035,37362,13410,6504,6906
28775,44583,7215,21560,6035,37368,13413,6506,6907
28780,44594,7217,21565,6036,37376,13416,6508,6908
28785,44598,7220,21568,6039,37378,13417,6509,6908
28790,44608,7222,21575,6041,37386,13419,6510,6909
28795,44614,7222,21577,6041,37392,13422,6512,6910
28800,44625,7222,21577,6041,37403,13425,6512,6913
28805,44629,7223,21580,6042,37406,13426,6513,6913
28810,44639,7224,21587,6043,37415,13428,6513,6915
28815,44645,7224,21590,6043,37421,13431,6515,6916
28820,44656,7224,21593,6043,37431,13434,6516,6918
28825,44660,7225,21595,6044,37435,13435,6516,6919
28830,44670,7226,21599,6044,37444,13437,6516,6921
28835,44676,7226,21602,6044,37450,13440,6517,6923
28840,44687,7227,21605,6045,37460,13443,6517,6926
28845,44691,7228,21608,6046,37463,13444,6517,6927
28850,44701,7229,21612,6047,37472,13446,6518,6928
28855,44707,7229,21615,6047,37478,13449,6520,6929
28860,44718,7230,21620,6048,37488,13452,6521,6931
28865,44722,7230,21621,6048,37492,13453,6521,6932
28870,44732,7231,21626,6048,37501,13455,6522,6933
28875,44738,7231,21629,6048,37506,13458,6523,6935
28880,44749,7232,21632,6049,37517,13461,6525,6936
28885,44753,7232,21634,6049,37521,13462,6525,6937
28890,44763,7233,21635,6049,37530,13464,6525,6939
28895,44769,7233,21640,6049,37535,13467,6527,6940
28900,44780,7237,21644,6052,37543,13470,6527,6943
28905,44784,7237,21646,6052,37547,13471,6527,6944
28910,44794,7239,21649,6054,37555,13473,6527,6946
28915,44800,7239,21650,6054,37561,13476,6527,6949
28920,44811,7242,21656,6056,37569,13479,6528,6951
28925,44815,7243,21657,6057,37572,13480,6528,6952
28930,44825,7245,21661,6059,37580,13482,6528,6954
28935,44831,7245,21664,6059,37586,13485,6530,6955
28940,44842,7247,21669,6060,37595,13487,6532,6955
28945,44846,7248,21671,6061,37598,13488,6533,6955
28950,44856,7249,21673,6062,37607,13490,6533,6957
28955,44862,7249,21674,6062,37613,13493,6534,6959
28960,44873,7252,21680,6064,37620,13495,6535,6960
28965,44877,7254,21682,6066,37623,13496,6536,6960
28970,44887,7256,21689,6068,37631,13498,6537,6961
28975,44893,7256,21692,6068,37637,13501,6539,6962
28980,44904,7257,21696,6068,37647,13503,6541,6962
28985,44908,7258,21697,6069,37650,13504,6541,6963
28990,44918,7260,21701,6071,37658,13506,6541,6965
28995,44924,7260,21706,6071,37663,13509,6543,6966
29000,44935,7264,21711,6074,37671,13511,6543,6968
29005,44939,7266,21715,6076,37673,13512,6544,6968
29010,44949,7269,21721,6078,37680,13514,6546,6968
29015,44955,7269,21726,6078,37686,13517,6549,6968
29020,44966,7273,21730,6081,37693,13519,6550,6969
29025,44970,7274,21733,6082,37696,13520,6551,6969
29030,44980,7275,21740,6083,37705,13522,6553,6969
29035,44986,7275,21742,6083,37710,13525,6554,6971
29040,44997,7280,21750,6087,37716,13528,6556,6972
29045,45001,7282,21751,6089,37719,13529,6556,6973
29050,45011,7285,21759,6092,37726,13531,6557,6974
29055,45017,7285,21763,6092,37731,13534,6559,6975
29060,45028,7288,21766,6094,37740,13537,6561,6976
29065,45032,7289,21767,6095,37743,13538,6561,6977
29070,45042,7292,21771,6097,37750,13540,6562,6978
29075,45048,7292,21774,6097,37755,13543,6563,6980
29080,45059,7294,21777,6098,37765,13546,6564,6982
29085,45063,7295,21778,6099,37768,13547,6564,6983
29090,45073,7296,21781,6099,37777,13549,6565,6984
29095,45079,7296,21783,6099,37783,13552,6567,6985
29100,45090,7300,21789,6103,37790,13555,6568,6987
29105,45094,7301,21791,6104,37793,13556,6568,6988
29110,45104,7302,21796,6104,37802,13558,6570,6988
29115,45110,7302,21799,6104,37808,13561,6571,6990
29120,45121,7302,21804,6104,37818,13564,6572,6992
29125,45125,7303,21806,6105,37822,13565,6572,6993
29130,45135,7304,21811,6105,37831,13567,6572,6995
29135,45141,7304,21812,6105,37837,13570,6573,6997
29140,45152,7304,21817,6105,37847,13573,6575,6998
29145,45156,7305,21817,6106,37851,13574,6575,6999
29150,45166,7306,21822,6107,37860,13576,6577,6999
29155,45172,7306,21825,6107,37865,13579,6578,7001
29160,45183,7307,21832,6108,37876,13582,6581,7001
29165,45187,7308,21835,6109,37879,13583,6582,7001
29170,45197,7309,21837,6109,37888,13585,6583,7002
29175,45203,7309,21839,6109,37894,13588,6585,7003
29180,45214,7310,21846,6110,37903,13591,6587,7004
29185,45218,7312,21849,6112,37906,13592,6587,7005
29190,45228,7313,21854,6112,37915,13594,6588,7006
29195,45234,7313,21857,6112,37921,13597,6590,7007
29200,45245,7314,21864,6113,37931,13600,6591,7009
29205,45249,7315,21865,6114,37934,13601,6591,7010
29210,45259,7316,21868,6115,37943,13603,6591,7012
29215,45265,7316,21870,6115,37949,13606,6593,7013
29220,45276,7319,21877,6117,37956,13609,6594,7015
29225,45280,7322,21880,6120,37958,13610,6595,7015
29230,45290,7324,21883,6121,37966,13612,6596,7016
29235,45296,7324,21884,6121,37972,13615,6597,7018
29240,45307,7326,21889,6122,37981,13618,6599,7019
29245,45311,7326,21890,6122,37985,13619,6599,7020
29250,45321,7327,21893,6122,37994,13621,6600,7021
29255,45327,7327,21896,6122,37999,13624,6601,7023
29260,45338,7330,21903,6125,38008,13627,6603,7024
29265,45342,7332,21905,6127,38010,13628,6603,7025
29270,45352,7335,21914,6130,38017,13630,6604,7026
29275,45358,7335,21918,6130,38022,13633,6606,7027
29280,45369,7338,21921,6133,38031,13636,6607,7029
29285,45373,7339,21923,6134,38034,13637,6608,7029
29290,45383,7342,21929,6137,38041,13639,6608,7031
29295,45389,7342,21931,6137,38047,13642,6610,7032
29300,45400,7345,21937,6140,38054,13645,6611,7034
29305,45404,7348,21939,6143,38056,13646,6611,7035
29310,45414,7350,21946,6145,38064,13648,6613,7035
29315,45420,7350,21948,6145,38069,13651,6613,7038
29320,45431,7353,21955,6148,38077,13654,6615,7039
29325,45435,7355,21958,6150,38080,13655,6616,7039
29330,45445,7357,21961,6152,38088,13657,6617,7040
29335,45451,7357,21963,6152,38093,13660,6618,7042
29340,45462,7361,21967,6155,38101,13663,6619,7044
29345,45466,7362,21969,6156,38104,13664,6619,7045
29350,45476,7363,21972,6156,38113,13666,6619,7047
29355,45482,7363,21974,6156,38119,13669,6620,7049
29360,45493,7367,21980,6159,38126,13672,6621,7051
29365,45497,7368,21982,6160,38129,13673,6622,7051
29370,45507,7369,21988,6161,38138,13675,6624,7051
29375,45513,7369,21990,6161,38144,13678,6624,7054
29380,45524,7373,21996,6164,38150,13681,6625,7056
29385,45528,7375,21997,6166,38153,13682,6625,7057
29390,45538,7376,22001,6167,38162,13684,6626,7058
29395,45544,7376,22006,6167,38168,13687,6629,7058
29400,45555,7377,22011,6168,38178,13690,6631,7059
29405,45559,7378,22014,6169,38181,13691,6632,7059
29410,45569,7379,22019,6170,38190,13693,6634,7059
29415,45575,7379,22023,6170,38196,13696,6636,7060
29420,45586,7381,22030,6171,38205,13699,6639,7060
29425,45590,7381,22032,6171,38209,13700,6640,7060
29430,45600,7383,22038,6173,38217,13702,6642,7060
29435,45606,7383,22042,6173,38223,13705,6645,7060
29440,45617,7383,22048,6173,38234,13708,6647,7061
29445,45621,7383,22051,6173,38238,13709,6647,7062
29450,45631,7383,22056,6173,38248,13711,6647,7064
29455,45637,7383,22060,6173,38254,13714,6649,7065
29460,45648,7383,22065,6173,38265,13717,6651,7066
29465,45652,7383,22065,6173,38269,13718,6651,7067
29470,45662,7383,22069,6173,38279,13720,6651,7069
29475,45668,7383,22073,6173,38285,13723,6654,7069
29480,45679,7383,22076,6173,38296,13726,6654,7072
29485,45683,7383,22077,6173,38300,13727,6654,7073
29490,45693,7384,22081,6174,38309,13729,6655,7074
29495,45699,7384,22084,6174,38315,13732,6657,7075
29500,45710,7385,22088,6175,38325,13735,6658,7077
29505,45714,7386,22092,6176,38328,13736,6659,7077
29510,45724,7387,22096,6176,38337,13738,6659,7079
29515,45730,7387,22100,6176,38342,13741,6661,7080
29520,45741,7388,22103,6177,38352,13744,6661,7083
29525,45745,7389,22106,6178,38356,13745,6662,7083
29530,45755,7390,22108,6178,38365,13747,6662,7085
29535,45761,7390,22110,6178,38371,13750,6664,7086
29540,45772,7393,22117,6180,38378,13753,6666,7087
29545,45776,7395,22121,6182,38381,13754,6667,7087
29550,45786,7396,22126,6182,38390,13756,6669,7087
29555,45792,7396,22130,6182,38395,13759,6671,7088
29560,45803,7400,22135,6186,38402,13762,6671,7091
29565,45807,7402,22138,6188,38405,13763,6672,7091
29570,45817,7404,22142,6189,38413,13765,6673,7092
29575,45823,7404,22146,6189,38419,13768,6676,7092
29580,45834,7405,22149,6189,38428,13771,6677,7094
29585,45838,7407,22153,6191,38431,13772,6678,7094
29590,45848,7409,22159,6193,38439,13774,6679,7095
29595,45854,7409,22162,6193,38444,13777,6680,7097
29600,45865,7413,22169,6197,38451,13779,6680,7099
29605,45869,7415,22171,6199,38454,13780,6680,7100
29610,45879,7417,22178,6201,38462,13782,6681,7101
29615,45885,7417,22181,6201,38468,13785,6683,7102
29620,45896,7420,22188,6203,38476,13787,6685,7102
29625,45900,7420,22190,6203,38480,13788,6686,7102
29630,45910,7421,22197,6204,38489,13790,6688,7102
29635,45916,7421,22199,6204,38495,13793,6689,7104
29640,45927,7424,22206,6207,38502,13795,6689,7106
29645,45931,7427,22208,6210,38504,13796,6689,7107
29650,45941,7429,22212,6212,38512,13798,6689,7109
29655,45947,7429,22217,6212,38517,13801,6692,7109
29660,45958,7433,22225,6216,38524,13803,6693,7110
29665,45962,7434,22225,6217,38528,13804,6693,7111
29670,45972,7435,22229,6217,38537,13806,6694,7112
29675,45978,7435,22232,6217,38542,13809,6695,7114
29680,45989,7438,22236,6219,38550,13811,6697,7114
29685,45993,7440,22239,6221,38553,13812,6698,7114
29690,46003,7443,22245,6223,38560,13814,6700,7114
29695,46009,7443,22246,6223,38566,13817,6700,7117
29700,46020,7445,22251,6225,38574,13820,6701,7119
29705,46024,7447,22254,6227,38577,13821,6702,7119
29710,46034,7449,22260,6228,38585,13823,6704,7119
29715,46040,7449,22261,6228,38591,13826,6704,7122
29720,46051,7451,22266,6229,38599,13829,6705,7124
29725,46055,7453,22267,6231,38602,13830,6705,7125
29730,46065,7455,22271,6232,38610,13832,6705,7127
29735,46071,7455,22274,6232,38615,13835,6706,7129
29740,46082,7457,22276,6233,38624,13838,6707,7131
29745,46086,7458,22278,6234,38628,13839,6708,7131
29750,46096,7459,22283,6235,38637,13841,6708,7133
29755,46102,7459,22286,6235,38643,13844,6709,7135
29760,46113,7462,22294,6238,38650,13847,6711,7136
29765,46117,7464,22297,6240,38653,13848,6712,7136
29770,46127,7466,22299,6241,38661,13850,6712,7138
29775,46133,7466,22304,6241,38666,13853,6714,7139
29780,46144,7470,22308,6244,38674,13856,6716,7140
29785,46148,7472,22310,6246,38676,13857,6716,7141
29790,46158,7474,22315,6248,38684,13859,6717,7142
29795,46164,7474,22318,6248,38689,13862,6718,7144
29800,46175,7478,22321,6251,38697,13865,6719,7146
29805,46179,7479,22324,6252,38700,13866,6720,7146
29810,46189,7480,22330,6253,38709,13868,6721,7147
29815,46195,7480,22335,6253,38714,13871,6723,7148
29820,46206,7482,22343,6255,38724,13874,6725,7149
29825,46210,7482,22344,6255,38728,13875,6726,7149
29830,46220,7483,22349,6256,38737,13877,6727,7150
29835,46226,7483,22350,6256,38743,13880,6728,7152
29840,46237,7484,22357,6257,38753,13883,6729,7154
29845,46241,7485,22361,6258,38756,13884,6730,7154
29850,46251,7486,22366,6259,38765,13886,6731,7155
29855,46257,7486,22369,6259,38771,13889,6733,7156
29860,46268,7487,22374,6260,38781,13892,6734,7158
29865,46272,7487,22376,6260,38785,13893,6735,7158
29870,46282,7488,22381,6260,38794,13895,6736,7159
29875,46288,7488,22384,6260,38800,13898,6738,7160
29880,46299,7489,22391,6261,38810,13901,6740,7161
29885,46303,7489,22393,6261,38814,13902,6741,7161
29890,46313,7490,22398,6262,38823,13904,6742,7162
29895,46319,7490,22401,6262,38829,13907,6744,7163
29900,46330,7490,22408,6262,38839,13910,6746,7164
29905,46334,7492,22410,6264,38842,13911,6747,7164
29910,46344,7495,22417,6266,38849,13913,6749,7164
29915,46350,7495,22418,6266,38855,13916,6750,7166
29920,46361,7497,22424,6268,38864,13919,6752,7167
29925,46365,7498,22426,6269,38867,13920,6753,7167
29930,46375,7500,22430,6270,38875,13922,6754,7168
29935,46381,7500,22433,6270,38881,13925,6755,7170
29940,46392,7502,22437,6272,38890,13928,6756,7172
29945,46396,7503,22440,6273,38893,13929,6757,7172
29950,46406,7504,22444,6273,38902,13931,6758,7173
29955,46412,7504,22446,6273,38908,13934,6760,7174
29960,46423,7506,22451,6274,38917,13937,6762,7175
29965,46427,7507,22453,6275,38920,13938,6762,7176
29970,46437,7508,22460,6276,38929,13940,6763,7177
29975,46443,7508,22463,6276,38934,13943,6765,7178
29980,46454,7511,22472,6279,38942,13946,6767,7179
29985,46458,7512,22472,6280,38946,13947,6767,7180
29990,46468,7512,22476,6280,38956,13949,6767,7182
29995,46474,7512,22478,6280,38962,13952,6768,7184
30000,46485,7513,22480,6281,38972,13955,6768,7187
30005,46489,7513,22483,6281,38976,13956,6769,7187
30010,46499,7513,22489,6281,38986,13958,6771,7187
30015,46505,7513,22490,6281,38992,13961,6771,7190
30020,46516,7514,22496,6282,39002,13964,6772,7192
30025,46520,7514,22498,6282,39006,13965,6772,7193
30030,46530,7514,22503,6282,39016,13967,6773,7194
30035,46536,7514,22505,6282,39022,13970,6774,7196
30040,46547,7515,22509,6282,39032,13973,6777,7196
30045,46551,7515,22510,6282,39036,13974,6778,7196
30050,46561,7517,22517,6284,39044,13976,6780,7196
30055,46567,7517,22519,6284,39050,13979,6780,7199
30060,46578,7518,22524,6285,39060,13982,6782,7200
30065,46582,7518,22526,6285,39064,13983,6783,7200
30070,46592,7520,22533,6287,39072,13985,6784,7201
30075,46598,7520,22536,6287,39078,13988,6785,7203
30080,46609,7521,22540,6288,39088,13991,6786,7205
30085,46613,7522,22543,6289,39091,13992,6787,7205
30090,46623,7523,22545,6289,39100,13994,6787,7207
30095,46629,7523,22549,6289,39105,13997,6789,7208
30100,46640,7527,22553,6292,39113,14000,6790,7210
30105,46644,7528,22555,6293,39116,14001,6790,7211
30110,46654,7530,22561,6295,39124,14003,6791,7212
30115,46660,7530,22563,6295,39129,14006,6791,7215
30120,46671,7534,22571,6299,39136,14009,6794,7215
30125,46675,7535,22572,6300,39140,14010,6794,7216
30130,46685,7536,22577,6300,39149,14012,6796,7216
30135,46691,7536,22580,6300,39154,14015,6796,7219
30140,46702,7540,22587,6304,39161,14018,6798,7220
30145,46706,7542,22588,6306,39164,14019,6798,7221
30150,46716,7544,22595,6308,39172,14021,6800,7221
30155,46722,7544,22597,6308,39178,14024,6801,7223
30160,46733,7547,22602,6310,39185,14027,6803,7224
30165,46737,7550,22605,6313,39187,14028,6804,7224
30170,46747,7551,22610,6313,39196,14030,6805,7225
30175,46753,7551,22612,6313,39202,14033,6806,7227
30180,46764,7555,22617,6316,39209,14036,6807,7229
30185,46768,7556,22619,6317,39212,14037,6807,7230
30190,46778,7559,22628,6320,39219,14039,6809,7230
30195,46784,7559,22630,6320,39225,14042,6810,7232
30200,46795,7562,22636,6322,39232,14045,6811,7234
30205,46799,7563,22637,6323,39236,14046,6811,7235
30210,46809,7565,22640,6324,39244,14048,6812,7236
30215,46815,7565,22641,6324,39250,14051,6813,7238
30220,46826,7566,22644,6324,39259,14054,6813,7241
30225,46830,7567,22646,6325,39263,14055,6813,7242
30230,46840,7569,22651,6326,39271,14057,6814,7243
30235,46846,7569,22652,6326,39277,14060,6815,7245
30240,46857,7571,22659,6328,39285,14063,6817,7246
30245,46861,7572,22662,6329,39289,14064,6818,7246
30250,46871,7575,22666,6332,39296,14066,6818,7248
30255,46877,7575,22668,6332,39301,14069,6819,7250
30260,46888,7579,22673,6335,39308,14071,6820,7251
30265,46892,7580,22675,6336,39312,14072,6821,7251
30270,46902,7583,22680,6339,39319,14074,6822,7252
30275,46908,7583,22684,6339,39324,14077,6824,7253
30280,46919,7585,22688,6341,39334,14079,6825,7254
30285,46923,7586,22691,6342,39337,14080,6826,7254
30290,46933,7588,22697,6343,39345,14082,6826,7256
30295,46939,7588,22702,6343,39351,14085,6829,7256
30300,46950,7589,22706,6344,39360,14087,6830,7257
30305,46954,7592,22710,6347,39362,14088,6831,7257
30310,46964,7593,22715,6347,39371,14090,6833,7257
30315,46970,7593,22720,6347,39376,14093,6835,7258
30320,46981,7598,22725,6351,39383,14095,6836,7259
30325,46985,7600,22728,6353,39385,14096,6837,7259
30330,46995,7602,22732,6354,39393,14098,6838,7260
30335,47001,7602,22736,6354,39398,14101,6840,7261
30340,47012,7606,22742,6358,39406,14103,6841,7262
30345,47016,7606,22742,6358,39410,14104,6841,7263
30350,47026,7607,22747,6358,39419,14106,6842,7264
30355,47032,7607,22748,6358,39425,14109,6842,7267
30360,47043,7608,22751,6359,39434,14112,6842,7270
30365,47047,7609,22752,6360,39438,14113,6842,7271
30370,47057,7610,22758,6361,39447,14115,6843,7272
30375,47063,7610,22762,6361,39452,14118,6845,7273
30380,47074,7614,22767,6364,39460,14121,6847,7274
30385,47078,7615,22769,6365,39463,14122,6847,7275
30390,47088,7617,22773,6366,39471,14124,6848,7276
30395,47094,7617,22777,6366,39477,14127,6851,7276
30400,47105,7619,22781,6367,39486,14130,6854,7276
30405,47109,7621,22784,6369,39488,14131,6855,7276
30410,47119,7623,22790,6371,39496,14133,6856,7277
30415,47125,7623,22792,6371,39501,14136,6856,7280
30420,47136,7627,22797,6374,39508,14139,6856,7283
30425,47140,7628,22797,6375,39512,14140,6856,7284
30430,47150,7629,22802,6375,39521,14142,6856,7286
30435,47156,7629,22805,6375,39527,14145,6857,7288
30440,47167,7629,22807,6375,39538,14148,6858,7290
30445,47171,7629,22809,6375,39542,14149,6858,7291
30450,47181,7630,22812,6376,39551,14151,6858,7293
30455,47187,7630,22814,6376,39557,14154,6859,7295
30460,47198,7631,22820,6377,39567,14157,6860,7297
30465,47202,7631,22821,6377,39571,14158,6860,7298
30470,47212,7632,22828,6378,39580,14160,6860,7300
30475,47218,7632,22834,6378,39585,14163,6863,7300
30480,47229,7634,22839,6380,39594,14166,6865,7301
30485,47233,7636,22841,6382,39597,14167,6865,7302
30490,47243,7637,22849,6383,39606,14169,6867,7302
30495,47249,7637,22850,6383,39612,14172,6868,7304
30500,47260,7638,22855,6384,39621,14175,6869,7306
30505,47264,7639,22855,6385,39625,14176,6869,7307
30510,47274,7640,22859,6386,39634,14178,6869,7309
30515,47280,7640,22860,6386,39639,14181,6869,7312
30520,47291,7642,22866,6388,39648,14184,6870,7314
30525,47295,7643,22867,6389,39652,14185,6871,7314
30530,47305,7645,22872,6390,39660,14187,6873,7314
30535,47311,7645,22874,6390,39665,14190,6873,7317
30540,47322,7649,22879,6393,39673,14193,6874,7319
30545,47326,7649,22881,6393,39677,14194,6875,7319
30550,47336,7649,22886,6393,39687,14196,6877,7319
30555,47342,7649,22889,6393,39693,14199,6879,7320
30560,47353,7652,22894,6395,39701,14202,6880,7322
30565,47357,7653,22896,6396,39704,14203,6880,7323
30570,47367,7655,22901,6398,39712,14205,6882,7323
30575,47373,7655,22902,6398,39718,14208,6882,7326
30580,47384,7656,22907,6399,39728,14211,6883,7328
30585,47388,7657,22909,6400,39731,14212,6883,7329
30590,47398,7659,22915,6402,39739,14214,6884,7330
30595,47404,7659,22916,6402,39745,14217,6884,7333
30600,47415,7661,22920,6403,39754,14220,6886,7334
30605,47419,7661,22921,6403,39758,14221,6887,7334
30610,47429,7663,22925,6405,39766,14223,6887,7336
30615,47435,7663,22925,6405,39772,14226,6887,7339
30620,47446,7665,22929,6406,39781,14229,6890,7339
30625,47450,7665,22930,6406,39785,14230,6890,7340
30630,47460,7666,22934,6407,39794,14232,6891,7341
30635,47466,7666,22938,6407,39800,14235,6893,7342
30640,47477,7667,22942,6408,39810,14238,6894,7344
30645,47481,7667,22944,6408,39814,14239,6895,7344
30650,47491,7669,22949,6409,39822,14241,6896,7345
30655,47497,7669,22954,6409,39827,14244,6898,7346
30660,47508,7672,22959,6412,39835,14247,6900,7347
30665,47512,7674,22960,6414,39838,14248,6900,7348
30670,47522,7675,22961,6414,39847,14250,6900,7350
30675,47528,7675,22962,6414,39853,14253,6901,7352
30680,47539,7677,22965,6416,39862,14256,6902,7354
30685,47543,7679,22968,6418,39864,14257,6903,7354
30690,47553,7681,22970,6419,39872,14259,6904,7355
30695,47559,7681,22973,6419,39878,14262,6906,7356
30700,47570,7682,22976,6420,39888,14265,6907,7358
30705,47574,7684,22978,6422,39890,14266,6907,7359
30710,47584,7686,22985,6424,39898,14268,6909,7359
30715,47590,7686,22987,6424,39903,14271,6910,7361
30720,47601,7689,22994,6427,39911,14274,6913,7361
30725,47605,7692,22997,6430,39913,14275,6914,7361
30730,47615,7694,23003,6431,39921,14277,6916,7361
30735,47621,7694,23005,6431,39927,14280,6918,7362
30740,47632,7697,23011,6433,39934,14283,6921,7362
30745,47636,7700,23014,6436,39936,14284,6922,7362
30750,47646,7703,23019,6438,39943,14286,6923,7363
30755,47652,7703,23021,6438,39948,14289,6924,7365
30760,47663,7706,23026,6441,39957,14292,6925,7367
30765,47667,7707,23028,6442,39960,14293,6926,7367
30770,47677,7709,23034,6443,39968,14295,6927,7368
30775,47683,7709,23038,6443,39974,14298,6930,7368
30780,47694,7711,23044,6445,39983,14301,6933,7368
30785,47698,7712,23046,6446,39986,14302,6933,7369
30790,47708,7714,23052,6448,39994,14304,6934,7370
30795,47714,7714,23057,6448,39999,14307,6936,7371
30800,47725,7717,23062,6450,40007,14310,6937,7373
30805,47729,7720,23066,6453,40009,14311,6938,7373
30810,47739,7721,23071,6453,40018,14313,6939,7374
30815,47745,7721,23075,6453,40023,14316,6940,7376
30820,47756,7724,23081,6456,40031,14319,6940,7379
30825,47760,7726,23083,6458,40034,14320,6941,7379
30830,47770,7727,23088,6459,40043,14322,6941,7381
30835,47776,7727,23091,6459,40049,14325,6943,7382
30840,47787,7729,23096,6461,40057,14328,6944,7384
30845,47791,7731,23098,6463,40060,14329,6944,7385
30850,47801,7734,23104,6466,40067,14331,6944,7387
30855,47807,7734,23107,6466,40073,14334,6947,7387
30860,47818,7736,23112,6468,40082,14337,6949,7388
30865,47822,7736,23114,6468,40086,14338,6950,7388
30870,47832,7737,23121,6469,40095,14340,6951,7389
30875,47838,7737,23124,6469,40101,14343,6953,7390
30880,47849,7737,23130,6469,40112,14346,6955,7391
30885,47853,7737,23131,6469,40116,14347,6955,7392
30890,47863,7738,23136,6469,40125,14349,6955,7394
30895,47869,7738,23139,6469,40131,14352,6957,7395
30900,47880,7739,23143,6470,40141,14355,6958,7397
30905,47884,7739,23143,6470,40145,14356,6958,7398
30910,47894,7740,23146,6470,40154,14358,6959,7399
30915,47900,7740,23148,6470,40159,14361,6959,7402
30920,47911,7741,23149,6471,40170,14363,6959,7404
30925,47915,7741,23151,6471,40174,14364,6960,7404
30930,47925,7742,23156,6471,40183,14366,6961,7405
30935,47931,7742,23158,6471,40189,14369,6963,7406
30940,47942,7743,23166,6472,40199,14371,6965,7406
30945,47946,7743,23168,6472,40203,14372,6966,7406
30950,47956,7744,23174,6472,40212,14374,6968,7406
30955,47962,7744,23177,6472,40217,14377,6968,7409
30960,47973,7746,23180,6474,40227,14379,6969,7410
30965,47977,7746,23182,6474,40231,14380,6969,7411
30970,47987,7748,23188,6476,40239,14382,6970,7412
30975,47993,7748,23191,6476,40245,14385,6972,7413
30980,48004,7749,23195,6477,40254,14387,6972,7415
30985,48008,7751,23197,6479,40257,14388,6972,7416
30990,48018,7753,23202,6481,40265,14390,6972,7418
30995,48024,7753,23206,6481,40271,14393,6975,7418
31000,48035,7755,23209,6482,40280,14395,6975,7420
31005,48039,7757,23213,6484,40282,14396,6976,7420
31010,48049,7759,23219,6486,40290,14398,6978,7420
31015,48055,7759,23221,6486,40295,14401,6979,7422
31020,48066,7763,23226,6490,40303,14404,6980,7424
31025,48070,7764,23229,6491,40306,14405,6981,7424
31030,48080,7765,23234,6491,40315,14407,6982,7425
31035,48086,7765,23235,6491,40321,14410,6983,7427
31040,48097,7766,23241,6491,40330,14413,6985,7428
31045,48101,7768,23243,6493,40333,14414,6986,7428
31050,48111,7769,23248,6493,40342,14416,6987,7429
31055,48117,7769,23251,6493,40348,14419,6989,7430
31060,48128,7770,23256,6494,40357,14422,6991,7431
31065,48132,7773,23259,6497,40359,14423,6992,7431
31070,48142,7774,23265,6497,40368,14425,6992,7433
31075,48148,7774,23270,6497,40373,14428,6995,7433
31080,48159,7777,23277,6500,40381,14431,6996,7435
31085,48163,7778,23278,6501,40385,14432,6996,7436
31090,48173,7779,23286,6502,40394,14434,6997,7437
31095,48179,7779,23288,6502,40400,14437,6998,7439
31100,48190,7780,23291,6503,40410,14440,6999,7441
31105,48194,7781,23294,6504,40413,14441,7000,7441
31110,48204,7782,23296,6504,40422,14443,7000,7443
31115,48210,7782,23297,6504,40428,14446,7001,7445
31120,48221,7784,23302,6505,40436,14449,7002,7447
31125,48225,7785,23303,6506,40440,14450,7002,7448
31130,48235,7787,23307,6507,40448,14452,7003,7449
31135,48241,7787,23312,6507,40453,14455,7005,7450
31140,48252,7790,23317,6510,40461,14458,7005,7453
31145,48256,7792,23319,6512,40464,14459,7005,7454
31150,48266,7794,23323,6513,40472,14461,7005,7456
31155,48272,7794,23329,6513,40477,14464,7008,7456
31160,48283,7798,23333,6516,40485,14467,7009,7458
31165,48287,7798,23336,6516,40489,14468,7010,7458
31170,48297,7800,23339,6518,40497,14470,7011,7459
31175,48303,7800,23342,6518,40503,14473,7013,7460
31180,48314,7803,23348,6520,40511,14476,7014,7462
31185,48318,7803,23350,6520,40515,14477,7015,7462
31190,48328,7804,23354,6521,40524,14479,7017,7462
31195,48334,7804,23357,6521,40530,14482,7019,7463
31200,48345,7806,23364,6522,40539,14485,7022,7463
31205,48349,7806,23366,6522,40543,14486,7022,7464
31210,48359,7807,23372,6523,40552,14488,7023,7465
31215,48365,7807,23373,6523,40558,14491,7024,7467
31220,48376,7808,23376,6524,40568,14494,7025,7469
31225,48380,7808,23377,6524,40572,14495,7025,7470
31230,48390,7809,23382,6525,40581,14497,7025,7472
31235,48396,7809,23384,6525,40587,14500,7025,7475
31240,48407,7811,23389,6527,40596,14503,7027,7476
31245,48411,7811,23389,6527,40600,14504,7027,7477
31250,48421,7812,23396,6528,40609,14506,7029,7477
31255,48427,7812,23399,6528,40615,14509,7030,7479
31260,48438,7814,23404,6529,40624,14512,7033,7479
31265,48442,7815,23405,6530,40627,14513,7033,7480
31270,48452,7818,23411,6533,40634,14515,7033,7482
31275,48458,7818,23415,6533,40639,14518,7035,7483
31280,48469,7822,23420,6536,40647,14521,7036,7485
31285,48473,7823,23422,6537,40650,14522,7037,7485
31290,48483,7825,23427,6538,40658,14524,7039,7485
31295,48489,7825,23430,6538,40664,14527,7041,7486
31300,48500,7827,23436,6540,40673,14530,7042,7488
31305,48504,7828,23438,6541,40676,14531,7042,7489
31310,48514,7830,23442,6543,40684,14533,7042,7491
31315,48520,7830,23445,6543,40690,14536,7044,7492
31320,48531,7832,23451,6545,40699,14539,7046,7493
31325,48535,7833,23454,6546,40702,14540,7047,7493
31330,48545,7835,23459,6547,40710,14542,7049,7493
31335,48551,7835,23461,6547,40716,14545,7051,7494
31340,48562,7839,23467,6551,40723,14548,7052,7496
31345,48566,7841,23470,6553,40725,14549,7053,7496
31350,48576,7843,23472,6554,40733,14551,7053,7498
31355,48582,7843,23473,6554,40739,14554,7054,7500
31360,48593,7846,23477,6556,40747,14557,7056,7501
31365,48597,7847,23479,6557,40750,14558,7057,7501
31370,48607,7848,23482,6558,40759,14560,7057,7503
31375,48613,7848,23486,6558,40764,14563,7059,7504
31380,48624,7853,23493,6563,40770,14566,7060,7506
31385,48628,7854,23495,6564,40774,14567,7061,7506
31390,48638,7855,23501,6565,40783,14569,7062,7507
31395,48644,7855,23504,6565,40788,14572,7062,7510
31400,48655,7856,23509,6566,40799,14575,7064,7511
31405,48659,7857,23512,6567,40802,14576,7065,7511
31410,48669,7858,23515,6567,40811,14578,7067,7511
31415,48675,7858,23519,6567,40817,14581,7069,7512
31420,48686,7859,23527,6568,40826,14584,7072,7512
31425,48690,7860,23528,6569,40830,14585,7072,7513
31430,48700,7861,23533,6570,40839,14587,7073,7514
31435,48706,7861,23536,6570,40845,14590,7075,7515
31440,48717,7861,23541,6570,40856,14593,7077,7516
31445,48721,7861,23542,6570,40860,14594,7077,7517
31450,48731,7862,23549,6571,40869,14596,7078,7518
31455,48737,7862,23553,6571,40874,14599,7080,7519
31460,48748,7863,23560,6572,40884,14602,7082,7520
31465,48752,7865,23562,6574,40887,14603,7082,7521
31470,48762,7866,23566,6574,40896,14605,7083,7522
31475,48768,7866,23569,6574,40901,14608,7084,7524
31480,48779,7867,23574,6575,40912,14611,7085,7526
31485,48783,7867,23577,6575,40916,14612,7086,7526
31490,48793,7869,23579,6576,40924,14614,7086,7528
31495,48799,7869,23580,6576,40930,14617,7087,7530
31500,48810,7871,23584,6577,40938,14620,7088,7532
31505,48814,7874,23587,6580,40940,14621,7088,7533
31510,48824,7875,23593,6581,40949,14623,7089,7534
31515,48830,7875,23597,6581,40954,14626,7090,7536
31520,48841,7878,23602,6584,40962,14629,7091,7538
31525,48845,7879,23604,6585,40966,14630,7092,7538
31530,48855,7880,23607,6585,40975,14632,7093,7539
31535,48861,7880,23608,6585,40981,14635,7093,7542
31540,48872,7881,23610,6585,40991,14638,7094,7544
31545,48876,7881,23611,6585,40995,14639,7094,7545
31550,48886,7883,23617,6587,41003,14641,7096,7545
31555,48892,7883,23619,6587,41008,14644,7096,7548
31560,48903,7886,23623,6589,41016,14647,7097,7550
31565,48907,7887,23623,6590,41020,14648,7097,7551
31570,48917,7889,23627,6591,41028,14650,7098,7552
31575,48923,7889,23629,6591,41033,14653,7099,7554
31580,48934,7893,23638,6595,41040,14655,7100,7555
31585,48938,7894,23641,6596,41044,14656,7101,7555
31590,48948,7895,23642,6596,41053,14658,7101,7557
31595,48954,7895,23646,6596,41059,14661,7103,7558
31600,48965,7898,23651,6599,41066,14663,7103,7560
31605,48969,7900,23653,6601,41069,14664,7103,7561
31610,48979,7902,23656,6602,41077,14666,7104,7562
31615,48985,7902,23657,6602,41082,14669,7104,7565
31620,48996,7904,23661,6603,41091,14671,7104,7567
31625,49000,7906,23662,6605,41094,14672,7104,7568
31630,49010,7909,23671,6607,41101,14674,7106,7568
31635,49016,7909,23676,6607,41106,14677,7109,7568
31640,49027,7913,23681,6611,41113,14679,7110,7569
31645,49031,7915,23683,6613,41116,14680,7111,7569
31650,49041,7916,23687,6614,41125,14682,7113,7569
31655,49047,7916,23692,6614,41130,14685,7115,7570
31660,49058,7920,23700,6618,41137,14687,7116,7571
31665,49062,7922,23702,6620,41140,14688,7117,7571
31670,49072,7923,23706,6621,41149,14690,7117,7573
31675,49078,7923,23708,6621,41154,14693,7117,7576
31680,49089,7927,23715,6625,41161,14696,7119,7577
31685,49093,7929,23717,6627,41164,14697,7119,7578
31690,49103,7930,23724,6628,41173,14699,7121,7578
31695,49109,7930,23727,6628,41179,14702,7123,7579
31700,49120,7934,23733,6631,41186,14705,7125,7580
31705,49124,7935,23734,6632,41189,14706,7125,7581
31710,49134,7936,23739,6633,41198,14708,7126,7582
31715,49140,7936,23743,6633,41204,14711,7128,7583
31720,49151,7938,23748,6634,41212,14714,7129,7585
31725,49155,7940,23750,6636,41215,14715,7129,7586
31730,49165,7943,23759,6639,41222,14717,7131,7586
31735,49171,7943,23762,6639,41227,14720,7133,7587
31740,49182,7945,23764,6640,41236,14723,7134,7589
31745,49186,7947,23767,6642,41239,14724,7135,7589
31750,49196,7947,23770,6642,41249,14726,7135,7591
31755,49202,7947,23771,6642,41255,14729,7135,7594
31760,49213,7949,23776,6644,41264,14732,7136,7596
31765,49217,7949,23778,6644,41268,14733,7137,7596
31770,49227,7951,23785,6646,41276,14735,7137,7598
31775,49233,7951,23789,6646,41282,14738,7139,7599
31780,49244,7954,23796,6649,41290,14741,7140,7601
31785,49248,7954,23797,6649,41294,14742,7140,7602
31790,49258,7954,23801,6649,41304,14744,7142,7602
31795,49264,7954,23805,6649,41310,14747,7145,7602
31800,49275,7956,23811,6651,41319,14750,7148,7602
31805,49279,7956,23813,6651,41323,14751,7148,7603
31810,49289,7956,23816,6651,41333,14753,7149,7604
31815,49295,7956,23820,6651,41339,14756,7151,7605
31820,49306,7957,23823,6651,41349,14759,7153,7606
31825,49310,7958,23825,6652,41352,14760,7154,7606
31830,49320,7958,23829,6652,41362,14762,7155,7607
31835,49326,7958,23833,6652,41368,14765,7157,7608
31840,49337,7959,23835,6652,41378,14768,7158,7610
31845,49341,7959,23837,6652,41382,14769,7159,7610
31850,49351,7960,23841,6652,41391,14771,7161,7610
31855,49357,7960,23845,6652,41396,14774,7163,7611
31860,49368,7964,23850,6655,41404,14777,7164,7613
31865,49372,7965,23853,6656,41407,14778,7165,7613
31870,49382,7967,23860,6658,41415,14780,7166,7614
31875,49388,7967,23863,6658,41420,14783,7167,7616
31880,49399,7969,23869,6660,41430,14786,7170,7616
31885,49403,7969,23870,6660,41434,14787,7170,7617
31890,49413,7972,23876,6662,41441,14789,7171,7618
31895,49419,7972,23881,6662,41446,14792,7173,7619
31900,49430,7976,23884,6665,41454,14795,7173,7622
31905,49434,7977,23886,6666,41457,14796,7174,7622
31910,49444,7979,23892,6668,41465,14798,7176,7622
31915,49450,7979,23894,6668,41470,14801,7177,7624
31920,49461,7983,23899,6671,41477,14804,7178,7626
31925,49465,7986,23901,6674,41479,14805,7178,7627
31930,49475,7987,23904,6675,41488,14807,7178,7629
31935,49481,7987,23908,6675,41493,14810,7179,7631
31940,49492,7990,23912,6677,41502,14813,7180,7633
31945,49496,7991,23913,6678,41505,14814,7180,7634
31950,49506,7993,23919,6679,41513,14816,7181,7635
31955,49512,7993,23922,6679,41519,14819,7183,7636
31960,49523,7995,23928,6681,41528,14822,7185,7637
31965,49527,7996,23930,6682,41531,14823,7186,7637
31970,49537,7997,23931,6682,41540,14825,7187,7638
31975,49543,7997,23937,6682,41545,14828,7190,7638
31980,49554,8001,23942,6685,41552,14831,7191,7640
31985,49558,8003,23944,6687,41555,14832,7192,7640
31990,49568,8004,23947,6687,41564,14834,7193,7641
31995,49574,8004,23949,6687,41569,14837,7194,7643
32000,49585,8006,23954,6689,41579,14840,7196,7644
32005,49589,8006,23956,6689,41583,14841,7197,7644
32010,49599,8009,23964,6692,41590,14843,7198,7645
32015,49605,8009,23967,6692,41596,14846,7199,7647
32020,49616,8011,23971,6694,41605,14849,7200,7649
32025,49620,8011,23973,6694,41609,14850,7201,7649
32030,49630,8013,23978,6696,41617,14852,7201,7651
32035,49636,8013,23982,6696,41623,14855,7204,7651
32040,49647,8015,23985,6697,41632,14858,7205,7653
32045,49651,8016,23988,6698,41635,14859,7206,7653
32050,49661,8018,23993,6699,41643,14861,7207,7654
32055,49667,8018,23997,6699,41649,14864,7209,7655
32060,49678,8021,24004,6702,41656,14867,7210,7657
32065,49682,8024,24006,6705,41658,14868,7210,7658
32070,49692,8026,24011,6707,41666,14870,7211,7659
32075,49698,8026,24014,6707,41672,14873,7213,7660
32080,49709,8029,24022,6710,41680,14876,7215,7661
32085,49713,8030,24023,6711,41683,14877,7215,7662
32090,49723,8031,24027,6711,41692,14879,7216,7663
32095,49729,8031,24030,6711,41698,14882,7217,7665
32100,49740,8034,24035,6713,41705,14885,7218,7667
32105,49744,8036,24036,6715,41708,14886,7218,7668
32110,49754,8038,24040,6717,41716,14888,7219,7669
32115,49760,8038,24042,6717,41721,14891,7219,7672
32120,49771,8042,24045,6720,41729,14894,7219,7675
32125,49775,8044,24048,6722,41731,14895,7220,7675
32130,49785,8046,24053,6724,41739,14897,7221,7676
32135,49791,8046,24057,6724,41745,14900,7224,7676
32140,49802,8048,24063,6726,41753,14903,7226,7677
32145,49806,8050,24065,6728,41756,14904,7227,7677
32150,49816,8051,24068,6728,41765,14906,7227,7679
32155,49822,8051,24071,6728,41770,14909,7228,7681
32160,49833,8053,24076,6730,41780,14912,7228,7684
32165,49837,8053,24079,6730,41784,14913,7229,7684
32170,49847,8053,24083,6730,41794,14915,7230,7685
32175,49853,8053,24086,6730,41800,14918,7231,7687
32180,49864,8053,24087,6730,41811,14921,7231,7690
32185,49868,8053,24088,6730,41815,14922,7232,7690
32190,49878,8053,24092,6730,41825,14924,7232,7692
32195,49884,8053,24096,6730,41831,14927,7233,7694
32200,49895,8053,24102,6730,41842,14930,7233,7697
32205,49899,8053,24103,6730,41846,14931,7233,7698
32210,49909,8053,24107,6730,41856,14933,7234,7699
32215,49915,8053,24109,6730,41862,14936,7235,7701
32220,49926,8053,24117,6730,41873,14939,7236,7703
32225,49930,8053,24118,6730,41877,14940,7237,7703
32230,49940,8053,24124,6730,41887,14942,7238,7704
32235,49946,8053,24127,6730,41893,14945,7240,7705
32240,49957,8053,24134,6730,41904,14947,7241,7706
32245,49961,8053,24138,6730,41908,14948,7242,7706
32250,49971,8054,24142,6731,41917,14950,7243,7707
32255,49977,8054,24145,6731,41923,14953,7244,7709
32260,49988,8056,24150,6732,41932,14955,7245,7710
32265,49992,8056,24151,6732,41936,14956,7246,7710
32270,50002,8057,24153,6732,41945,14958,7246,7712
32275,50008,8057,24159,6732,41950,14961,7249,7712
32280,50019,8059,24163,6733,41960,14963,7249,7714
32285,50023,8059,24164,6733,41964,14964,7250,7714
32290,50033,8061,24168,6735,41972,14966,7250,7716
32295,50039,8061,24169,6735,41978,14969,7251,7718
32300,50050,8063,24173,6736,41987,14971,7253,7718
32305,50054,8063,24174,6736,41991,14972,7254,7718
32310,50064,8066,24179,6739,41998,14974,7255,7719
32315,50070,8066,24181,6739,42004,14977,7256,7721
32320,50081,8069,24185,6741,42012,14979,7257,7722
32325,50085,8069,24187,6741,42016,14980,7258,7722
32330,50095,8071,24190,6742,42024,14982,7258,7724
32335,50101,8071,24192,6742,42030,14985,7259,7726
32340,50112,8073,24196,6744,42038,14988,7260,7728
32345,50116,8075,24197,6746,42041,14989,7260,7729
32350,50126,8077,24202,6747,42049,14991,7262,7729
32355,50132,8077,24206,6747,42054,14994,7264,7730
32360,50143,8081,24213,6751,42062,14997,7266,7731
32365,50147,8082,24215,6752,42065,14998,7267,7731
32370,50157,8084,24219,6753,42073,15000,7268,7732
32375,50163,8084,24223,6753,42079,15003,7270,7733
32380,50174,8086,24227,6755,42087,15006,7270,7736
32385,50178,8087,24228,6756,42091,15007,7271,7736
32390,50188,8089,24231,6757,42099,15009,7271,7738
32395,50194,8089,24234,6757,42105,15012,7272,7740
32400,50205,8091,24239,6759,42114,15015,7273,7742
32405,50209,8092,24241,6760,42117,15016,7274,7742
32410,50219,8093,24243,6760,42126,15018,7276,7742
32415,50225,8093,24248,6760,42131,15021,7279,7742
32420,50236,8096,24254,6763,42139,15024,7279,7745
32425,50240,8098,24257,6765,42142,15025,7280,7745
32430,50250,8100,24264,6767,42150,15027,7282,7745
32435,50256,8100,24268,6767,42156,15030,7284,7746
32440,50267,8102,24274,6769,42165,15033,7285,7748
32445,50271,8103,24276,6770,42168,15034,7285,7749
32450,50281,8105,24282,6771,42176,15036,7286,7750
32455,50287,8105,24285,6771,42182,15039,7288,7751
32460,50298,8108,24289,6773,42189,15042,7289,7753
32465,50302,8110,24290,6775,42192,15043,7289,7754
32470,50312,8113,24297,6778,42199,15045,7291,7754
32475,50318,8113,24300,6778,42204,15048,7292,7756
32480,50329,8116,24304,6781,42213,15051,7294,7757
32485,50333,8117,24307,6782,42216,15052,7295,7757
32490,50343,8118,24312,6783,42225,15054,7296,7758
32495,50349,8118,24313,6783,42231,15057,7296,7761
32500,50360,8121,24320,6786,42239,15060,7298,7762
32505,50364,8122,24323,6787,42242,15061,7299,7762
32510,50374,8123,24328,6787,42251,15063,7300,7763
32515,50380,8123,24331,6787,42257,15066,7302,7764
32520,50391,8125,24336,6789,42265,15069,7302,7767
32525,50395,8127,24339,6791,42268,15070,7303,7767
32530,50405,8128,24342,6791,42277,15072,7303,7769
32535,50411,8128,24346,6791,42282,15075,7305,7770
32540,50422,8133,24352,6796,42289,15078,7307,7771
32545,50426,8133,24354,6796,42293,15079,7308,7771
32550,50436,8135,24360,6798,42301,15081,7310,7771
32555,50442,8135,24363,6798,42307,15084,7312,7772
32560,50453,8137,24369,6799,42315,15087,7313,7774
32565,50457,8138,24371,6800,42319,15088,7314,7774
32570,50467,8139,24376,6800,42328,15090,7315,7775
32575,50473,8139,24380,6800,42334,15093,7317,7776
32580,50484,8141,24384,6801,42343,15096,7318,7778
32585,50488,8142,24386,6802,42346,15097,7319,7778
32590,50498,8144,24390,6803,42354,15099,7321,7778
32595,50504,8144,24394,6803,42360,15102,7323,7779
32600,50515,8145,24397,6804,42369,15105,7324,7781
32605,50519,8146,24397,6805,42373,15106,7324,7782
32610,50529,8148,24402,6806,42381,15108,7325,7783
32615,50535,8148,24403,6806,42386,15111,7325,7786
32620,50546,8152,24408,6809,42394,15114,7327,7787
32625,50550,8153,24410,6810,42397,15115,7327,7788
32630,50560,8156,24413,6812,42404,15117,7327,7790
32635,50566,8156,24416,6812,42410,15120,7329,7791
32640,50577,8158,24419,6814,42418,15123,7329,7794
32645,50581,8160,24421,6816,42421,15124,7330,7794
32650,50591,8163,24425,6818,42428,15126,7330,7796
32655,50597,8163,24429,6818,42434,15129,7333,7796
32660,50608,8164,24436,6819,42444,15132,7335,7797
32665,50612,8165,24440,6820,42447,15133,7336,7797
32670,50622,8166,24445,6821,42456,15135,7338,7797
32675,50628,8166,24447,6821,42462,15138,7339,7799
32680,50639,8166,24450,6821,42473,15141,7342,7799
32685,50643,8167,24452,6822,42476,15142,7342,7800
32690,50653,8168,24457,6823,42485,15144,7343,7801
32695,50659,8168,24459,6823,42490,15147,7343,7804
32700,50670,8170,24466,6825,42500,15150,7345,7805
32705,50674,8171,24468,6826,42503,15151,7345,7806
32710,50684,8172,24474,6826,42512,15153,7347,7806
32715,50690,8172,24477,6826,42517,15156,7349,7807
32720,50701,8173,24481,6827,42527,15159,7351,7808
32725,50705,8175,24483,6829,42530,15160,7351,7809
32730,50715,8176,24489,6829,42539,15162,7353,7809
32735,50721,8176,24494,6829,42544,15165,7355,7810
32740,50732,8178,24501,6831,42554,15168,7358,7810
32745,50736,8178,24503,6831,42558,15169,7358,7811
32750,50746,8179,24509,6831,42567,15171,7359,7812
32755,50752,8179,24511,6831,42573,15174,7360,7814
32760,50763,8180,24514,6832,42583,15177,7361,7816
32765,50767,8180,24515,6832,42587,15178,7361,7817
32770,50777,8183,24519,6834,42594,15180,7361,7819
32775,50783,8183,24521,6834,42600,15183,7361,7822
32780,50794,8185,24526,6836,42608,15186,7362,7824
32785,50798,8187,24528,6838,42611,15187,7363,7824
32790,50808,8189,24535,6840,42619,15189,7365,7824
32795,50814,8189,24540,6840,42625,15192,7368,7824
32800,50825,8192,24546,6842,42633,15195,7370,7825
32805,50829,8193,24549,6843,42636,15196,7371,7825
32810,50839,8195,24553,6844,42644,15198,7372,7826
32815,50845,8195,24557,6844,42649,15201,7374,7827
32820,50856,8198,24562,6846,42658,15204,7377,7827
32825,50860,8199,24565,6847,42661,15205,7378,7827
32830,50870,8200,24569,6847,42670,15207,7380,7827
32835,50876,8200,24573,6847,42676,15210,7382,7828
32840,50887,8203,24579,6850,42683,15213,7384,7829
32845,50891,8206,24581,6853,42685,15214,7384,7830
32850,50901,8209,24585,6855,42692,15216,7384,7832
32855,50907,8209,24587,6855,42698,15219,7384,7835
32860,50918,8211,24590,6856,42707,15222,7385,7837
32865,50922,8211,24590,6856,42711,15223,7385,7838
32870,50932,8214,24597,6859,42718,15225,7386,7839
32875,50938,8214,24598,6859,42724,15228,7386,7842
32880,50949,8218,24602,6862,42731,15231,7387,7844
32885,50953,8219,24604,6863,42734,15232,7388,7844
32890,50963,8220,24608,6864,42743,15234,7389,7845
32895,50969,8220,24613,6864,42748,15237,7391,7846
32900,50980,8224,24618,6868,42755,15239,7391,7848
32905,50984,8226,24621,6870,42758,15240,7391,7849
32910,50994,8229,24625,6872,42765,15242,7391,7851
32915,51000,8229,24630,6872,42770,15245,7393,7852
32920,51011,8231,24633,6874,42780,15247,7393,7854
32925,51015,8231,24634,6874,42784,15248,7393,7855
32930,51025,8233,24640,6876,42792,15250,7394,7856
32935,51031,8233,24641,6876,42798,15253,7395,7858
32940,51042,8235,24646,6877,42806,15255,7396,7859
32945,51046,8237,24649,6879,42809,15256,7396,7860
32950,51056,8238,24655,6880,42818,15258,7398,7860
32955,51062,8238,24658,6880,42824,15261,7400,7861
32960,51073,8242,24664,6884,42831,15263,7401,7862
32965,51077,8243,24666,6885,42834,15264,7402,7862
32970,51087,8245,24673,6886,42842,15266,7404,7862
32975,51093,8245,24675,6886,42848,15269,7404,7865
32980,51104,8247,24680,6887,42856,15271,7405,7866
32985,51108,8249,24682,6889,42859,15272,7405,7867
32990,51118,8252,24687,6891,42866,15274,7406,7868
32995,51124,8252,24689,6891,42871,15277,7406,7871
33000,51135,8253,24692,6892,42881,15280,7406,7874
33005,51139,8254,24692,6893,42885,15281,7406,7875
33010,51149,8255,24699,6894,42894,15283,7407,7876
33015,51155,8255,24702,6894,42900,15286,7409,7877
33020,51166,8255,24709,6894,42910,15289,7410,7879
33025,51170,8257,24713,6896,42913,15290,7411,7879
33030,51180,8258,24717,6897,42922,15292,7411,7881
33035,51186,8258,24719,6897,42928,15295,7412,7883
33040,51197,8259,24725,6898,42937,15298,7413,7885
33045,51201,8260,24726,6899,42941,15299,7414,7885
33050,51211,8261,24733,6900,42950,15301,7415,7886
33055,51217,8261,24736,6900,42955,15304,7416,7888
33060,51228,8262,24740,6901,42965,15307,7418,7889
33065,51232,8263,24741,6902,42969,15308,7418,7890
33070,51242,8264,24746,6902,42978,15310,7419,7891
33075,51248,8264,24749,6902,42984,15313,7421,7892
33080,51259,8264,24752,6902,42994,15316,7422,7894
33085,51263,8266,24756,6904,42997,15317,7423,7894
33090,51273,8267,24760,6905,43006,15319,7423,7896
33095,51279,8267,24765,6905,43011,15322,7425,7897
33100,51290,8271,24770,6908,43019,15325,7427,7898
33105,51294,8271,24771,6908,43023,15326,7427,7899
33110,51304,8272,24778,6909,43032,15328,7429,7899
33115,51310,8272,24781,6909,43038,15331,7431,7900
33120,51321,8274,24787,6911,43046,15334,7431,7903
33125,51325,8277,24790,6914,43048,15335,7432,7903
33130,51335,8279,24794,6915,43056,15337,7433,7904
33135,51341,8279,24798,6915,43062,15340,7435,7905
33140,51352,8280,24800,6916,43072,15343,7435,7908
33145,51356,8282,24803,6918,43074,15344,7436,7908
33150,51366,8284,24809,6919,43082,15346,7438,7908
33155,51372,8284,24810,6919,43088,15349,7439,7910
33160,51383,8286,24815,6920,43097,15352,7441,7911
33165,51387,8286,24816,6920,43101,15353,7442,7911
33170,51397,8289,24821,6923,43108,15355,7444,7911
33175,51403,8289,24822,6923,43114,15358,7445,7913
33180,51414,8291,24827,6925,43123,15361,7447,7914
33185,51418,8292,24829,6926,43126,15362,7447,7915
33190,51428,8295,24837,6929,43133,15364,7447,7917
33195,51434,8295,24841,6929,43139,15367,7450,7917
33200,51445,8297,24847,6930,43148,15370,7453,7917
33205,51449,8298,24848,6931,43151,15371,7453,7918
33210,51459,8299,24852,6931,43160,15373,7454,7919
33215,51465,8299,24854,6931,43166,15376,7455,7921
33220,51476,8301,24858,6933,43175,15379,7455,7924
33225,51480,8302,24860,6934,43178,15380,7455,7925
33230,51490,8304,24866,6936,43186,15382,7456,7926
33235,51496,8304,24867,6936,43192,15385,7457,7928
33240,51507,8308,24872,6939,43199,15388,7458,7930
33245,51511,8308,24873,6939,43203,15389,7458,7931
33250,51521,8310,24876,6940,43211,15391,7459,7932
33255,51527,8310,24877,6940,43217,15394,7460,7934
33260,51538,8313,24883,6943,43225,15397,7460,7937
33265,51542,8314,24886,6944,43228,15398,7461,7937
33270,51552,8315,24888,6944,43237,15400,7462,7938
33275,51558,8315,24892,6944,43243,15403,7465,7938
33280,51569,8317,24898,6946,43252,15406,7467,7939
33285,51573,8318,24900,6947,43255,15407,7467,7940
33290,51583,8321,24903,6949,43262,15409,7467,7942
33295,51589,8321,24907,6949,43267,15412,7468,7944
33300,51600,8325,24914,6953,43275,15415,7469,7946
33305,51604,8326,24916,6954,43278,15416,7470,7946
33310,51614,8328,24919,6955,43286,15418,7470,7948
33315,51620,8328,24921,6955,43291,15421,7471,7950
33320,51631,8332,24925,6958,43298,15424,7471,7953
33325,51635,8334,24926,6960,43301,15425,7471,7954
33330,51645,8335,24931,6960,43310,15427,7471,7956
33335,51651,8335,24934,6960,43315,15430,7473,7957
33340,51662,8336,24940,6961,43325,15433,7474,7959
33345,51666,8337,24941,6962,43329,15434,7474,7960
33350,51676,8338,24945,6962,43338,15436,7475,7961
33355,51682,8338,24948,6962,43344,15439,7476,7963
33360,51693,8339,24953,6963,43354,15442,7478,7964
33365,51697,8339,24956,6963,43358,15443,7479,7964
33370,51707,8340,24959,6963,43367,15445,7480,7965
33375,51713,8340,24961,6963,43373,15448,7481,7967
33380,51724,8340,24966,6963,43384,15451,7483,7968
33385,51728,8341,24969,6964,43387,15452,7484,7968
33390,51738,8342,24974,6964,43396,15454,7486,7968
33395,51744,8342,24977,6964,43402,15457,7487,7970
33400,51755,8342,24982,6964,43413,15460,7488,7972
33405,51759,8343,24984,6965,43416,15461,7489,7972
33410,51769,8344,24992,6966,43425,15463,7490,7973
33415,51775,8344,24995,6966,43430,15466,7492,7974
33420,51786,8345,25000,6967,43441,15469,7493,7976
33425,51790,8346,25002,6968,43444,15470,7493,7977
33430,51800,8347,25008,6969,43453,15472,7494,7978
33435,51806,8347,25009,6969,43458,15475,7494,7981
33440,51817,8349,25014,6971,43467,15478,7495,7983
33445,51821,8351,25016,6973,43470,15479,7495,7984
33450,51831,8352,25023,6974,43479,15481,7496,7985
33455,51837,8352,25028,6974,43485,15484,7499,7985
33460,51848,8354,25036,6975,43494,15487,7502,7985
33465,51852,8355,25038,6976,43497,15488,7502,7986
33470,51862,8356,25043,6976,43506,15490,7503,7987
33475,51868,8356,25045,6976,43512,15493,7503,7990
33480,51879,8357,25048,6976,43522,15496,7504,7992
33485,51883,8359,25050,6978,43524,15497,7504,7993
33490,51893,8360,25053,6978,43533,15499,7504,7995
33495,51899,8360,25057,6978,43539,15502,7507,7995
33500,51910,8361,25061,6978,43549,15505,7507,7998
33505,51914,8363,25064,6980,43551,15506,7507,7999
33510,51924,8364,25068,6981,43560,15508,7508,8000
33515,51930,8364,25072,6981,43565,15511,7510,8001
33520,51941,8367,25075,6983,43574,15514,7510,8004
33525,51945,8369,25077,6985,43576,15515,7510,8005
33530,51955,8370,25083,6985,43585,15517,7512,8005
33535,51961,8370,25085,6985,43591,15520,7513,8007
33540,51972,8373,25092,6988,43598,15523,7514,8009
33545,51976,8374,25094,6989,43602,15524,7514,8010
33550,51986,8374,25099,6989,43612,15526,7515,8011
33555,51992,8374,25101,6989,43618,15529,7515,8014
33560,52003,8376,25105,6991,43627,15531,7516,8015
33565,52007,8376,25106,6991,43631,15532,7517,8015
33570,52017,8377,25112,6992,43640,15534,7518,8016
33575,52023,8377,25116,6992,43646,15537,7519,8018
33580,52034,8379,25120,6993,43655,15539,7520,8019
33585,52038,8379,25122,6993,43659,15540,7521,8019
33590,52048,8380,25129,6994,43668,15542,7522,8020
33595,52054,8380,25133,6994,43674,15545,7525,8020
33600,52065,8381,25138,6995,43684,15547,7525,8022
33605,52069,8382,25140,6996,43687,15548,7526,8022
33610,52079,8383,25148,6997,43696,15550,7528,8022
33615,52085,8383,25151,6997,43702,15553,7530,8023
33620,52096,8385,25154,6998,43711,15555,7531,8024
33625,52100,8385,25155,6998,43715,15556,7532,8024
33630,52110,8386,25158,6999,43724,15558,7533,8025
33635,52116,8386,25159,6999,43730,15561,7533,8028
33640,52127,8388,25162,7000,43739,15563,7533,8030
33645,52131,8388,25163,7000,43743,15564,7534,8030
33650,52141,8390,25167,7001,43751,15566,7535,8031
33655,52147,8390,25170,7001,43757,15569,7537,8032
33660,52158,8393,25176,7003,43764,15572,7538,8034
33665,52162,8394,25177,7004,43768,15573,7539,8034
33670,52172,8397,25182,7007,43775,15575,7540,8035
33675,52178,8397,25185,7007,43780,15578,7541,8037
33680,52189,8401,25190,7011,43788,15581,7542,8039
33685,52193,8402,25192,7012,43791,15582,7543,8039
33690,52203,8403,25196,7013,43800,15584,7544,8040
33695,52209,8403,25198,7013,43806,15587,7546,8041
33700,52220,8406,25204,7016,43814,15590,7547,8043
33705,52224,8408,25208,7018,43816,15591,7548,8043
33710,52234,8410,25216,7019,43824,15593,7550,8043
33715,52240,8410,25218,7019,43830,15596,7552,8044
33720,52251,8411,25221,7020,43840,15599,7554,8045
33725,52255,8412,25224,7021,43843,15600,7555,8045
33730,52265,8415,25231,7023,43850,15602,7556,8046
33735,52271,8415,25232,7023,43856,15605,7557,8048
33740,52282,8418,25241,7026,43864,15608,7560,8048
33745,52286,8419,25243,7027,43867,15609,7560,8049
33750,52296,8422,25250,7029,43874,15611,7561,8050
33755,52302,8422,25255,7029,43879,15614,7563,8051
33760,52313,8425,25261,7032,43888,15617,7565,8052
33765,52317,8425,25262,7032,43892,15618,7566,8052
33770,52327,8428,25266,7034,43899,15620,7567,8053
33775,52333,8428,25269,7034,43904,15623,7568,8055
33780,52344,8431,25272,7036,43913,15626,7569,8057
33785,52348,8433,25274,7038,43915,15627,7569,8058
33790,52358,8436,25280,7040,43922,15629,7569,8060
33795,52364,8436,25281,7040,43928,15632,7570,8062
33800,52375,8440,25286,7043,43935,15635,7571,8064
33805,52379,8442,25288,7045,43937,15636,7571,8065
33810,52389,8443,25293,7045,43946,15638,7573,8065
33815,52395,8443,25296,7045,43952,15641,7575,8066
33820,52406,8444,25301,7046,43962,15644,7576,8068
33825,52410,8445,25303,7047,43965,15645,7576,8069
33830,52420,8446,25307,7047,43974,15647,7576,8071
33835,52426,8446,25309,7047,43980,15650,7578,8072
33840,52437,8446,25314,7047,43990,15653,7580,8073
33845,52441,8447,25314,7048,43994,15654,7580,8074
33850,52451,8448,25318,7048,44003,15656,7581,8075
33855,52457,8448,25321,7048,44008,15659,7582,8077
33860,52468,8449,25327,7049,44018,15662,7584,8078
33865,52472,8450,25328,7050,44022,15663,7584,8079
33870,52482,8451,25334,7051,44031,15665,7586,8079
33875,52488,8451,25336,7051,44037,15668,7586,8082
33880,52499,8452,25343,7052,44046,15671,7587,8084
33885,52503,8453,25344,7053,44050,15672,7587,8085
33890,52513,8454,25347,7054,44059,15674,7587,8087
33895,52519,8454,25350,7054,44065,15677,7588,8089
33900,52530,8454,25357,7054,44075,15680,7589,8091
33905,52534,8455,25358,7055,44079,15681,7589,8092
33910,52544,8456,25359,7055,44088,15683,7590,8093
33915,52550,8456,25361,7055,44094,15686,7591,8095
33920,52561,8458,25366,7056,44103,15689,7593,8096
33925,52565,8458,25367,7056,44107,15690,7593,8097
33930,52575,8461,25373,7058,44114,15692,7593,8099
33935,52581,8461,25373,7058,44120,15695,7593,8102
33940,52592,8464,25379,7061,44128,15698,7594,8104
33945,52596,8465,25381,7062,44131,15699,7595,8104
33950,52606,8468,25387,7064,44138,15701,7596,8105
33955,52612,8468,25390,7064,44144,15704,7597,8107
33960,52623,8471,25395,7067,44152,15707,7598,8109
33965,52627,8472,25397,7068,44155,15708,7599,8109
33970,52637,8473,25403,7069,44164,15710,7600,8110
33975,52643,8473,25403,7069,44170,15713,7600,8113
33980,52654,8474,25406,7069,44180,15716,7600,8116
33985,52658,8474,25406,7069,44184,15717,7600,8117
33990,52668,8475,25412,7069,44193,15719,7600,8119
33995,52674,8475,25415,7069,44199,15722,7601,8121
34000,52685,8477,25420,7071,44207,15725,7601,8124
34005,52689,8479,25421,7073,44210,15726,7601,8125
34010,52699,8480,25426,7074,44219,15728,7602,8126
34015,52705,8480,25427,7074,44225,15731,7603,8128
34020,52716,8481,25431,7074,44235,15734,7604,8130
34025,52720,8481,25431,7074,44239,15735,7604,8131
34030,52730,8482,25435,7075,44248,15737,7604,8133
34035,52736,8482,25437,7075,44254,15740,7605,8135
34040,52747,8483,25444,7075,44263,15743,7607,8136
34045,52751,8485,25446,7077,44266,15744,7607,8137
34050,52761,8486,25453,7078,44275,15746,7608,8138
34055,52767,8486,25456,7078,44281,15749,7609,8140
34060,52778,8488,25461,7079,44290,15752,7610,8142
34065,52782,8488,25463,7079,44294,15753,7611,8142
34070,52792,8490,25467,7080,44302,15755,7612,8143
34075,52798,8490,25472,7080,44307,15758,7615,8143
34080,52809,8493,25477,7083,44315,15761,7616,8145
34085,52813,8495,25480,7085,44318,15762,7617,8145
34090,52823,8496,25483,7085,44327,15764,7617,8147
34095,52829,8496,25485,7085,44332,15767,7617,8150
34100,52840,8500,25492,7089,44339,15770,7620,8150
34105,52844,8503,25495,7092,44341,15771,7621,8150
34110,52854,8505,25499,7094,44349,15773,7622,8151
34115,52860,8505,25502,7094,44354,15776,7624,8152
34120,52871,8509,25507,7098,44361,15779,7624,8155
34125,52875,8511,25509,7100,44364,15780,7624,8156
34130,52885,8514,25515,7102,44371,15782,7624,8158
34135,52891,8514,25519,7102,44376,15785,7625,8160
34140,52902,8518,25525,7106,44384,15788,7626,8162
34145,52906,8520,25529,7108,44386,15789,7627,8162
34150,52916,8521,25531,7108,44395,15791,7627,8164
34155,52922,8521,25535,7108,44401,15794,7629,8165
34160,52933,8523,25538,7109,44410,15797,7630,8167
34165,52937,8524,25539,7110,44413,15798,7630,8168
34170,52947,8526,25545,7111,44421,15800,7630,8170
34175,52953,8526,25548,7111,44427,15803,7631,8172
34180,52964,8529,25553,7113,44434,15806,7631,8175
34185,52968,8530,25553,7114,44438,15807,7631,8176
34190,52978,8532,25557,7115,44446,15809,7633,8176
34195,52984,8532,25560,7115,44452,15812,7635,8177
34200,52995,8534,25566,7117,44460,15815,7637,8178
34205,52999,8536,25568,7119,44463,15816,7637,8179
34210,53009,8539,25575,7122,44470,15818,7637,8181
34215,53015,8539,25576,7122,44475,15821,7637,8184
34220,53026,8543,25583,7126,44482,15823,7638,8185
34225,53030,8545,25586,7128,44485,15824,7638,8186
34230,53040,8546,25593,7128,44494,15826,7639,8187
34235,53046,8546,25597,7128,44499,15829,7642,8187
34240,53057,8547,25603,7129,44510,15831,7642,8189
34245,53061,8547,25605,7129,44514,15832,7643,8189
34250,53071,8548,25609,7130,44523,15834,7643,8191
34255,53077,8548,25611,7130,44529,15837,7645,8192
34260,53088,8549,25616,7131,44538,15839,7646,8193
34265,53092,8550,25619,7132,44542,15840,7646,8194
34270,53102,8551,25623,7132,44551,15842,7647,8195
34275,53108,8551,25628,7132,44556,15845,7649,8196
34280,53119,8552,25632,7133,44567,15847,7650,8197
34285,53123,8552,25634,7133,44571,15848,7650,8198
34290,53133,8553,25638,7134,44580,15850,7651,8199
34295,53139,8553,25640,7134,44586,15853,7651,8202
34300,53150,8553,25644,7134,44597,15855,7652,8203
34305,53154,8553,25644,7134,44601,15856,7652,8204
34310,53164,8554,25650,7135,44610,15858,7653,8205
34315,53170,8554,25652,7135,44616,15861,7655,8206
34320,53181,8555,25657,7136,44625,15864,7655,8209
34325,53185,8556,25658,7137,44629,15865,7655,8210
34330,53195,8558,25660,7138,44637,15867,7655,8212
34335,53201,8558,25665,7138,44643,15870,7658,8212
34340,53212,8559,25671,7139,44652,15873,7660,8213
34345,53216,8562,25675,7142,44654,15874,7661,8213
34350,53226,8565,25681,7145,44661,15876,7661,8215
34355,53232,8565,25684,7145,44667,15879,7663,8216
34360,53243,8568,25690,7148,44675,15882,7664,8218
34365,53247,8568,25692,7148,44679,15883,7665,8218
34370,53257,8570,25698,7150,44687,15885,7666,8219
34375,53263,8570,25700,7150,44693,15888,7667,8221
34380,53274,8573,25706,7152,44701,15891,7669,8222
34385,53278,8573,25708,7152,44705,15892,7670,8222
34390,53288,8575,25711,7153,44713,15894,7671,8223
34395,53294,8575,25713,7153,44719,15897,7672,8225
34400,53305,8577,25718,7154,44728,15900,7674,8226
34405,53309,8579,25722,7156,44730,15901,7675,8226
34410,53319,8580,25726,7157,44739,15903,7676,8227
34415,53325,8580,25730,7157,44745,15906,7678,8228
34420,53336,8583,25737,7160,44753,15909,7680,8229
34425,53340,8584,25739,7161,44756,15910,7681,8229
34430,53350,8587,25746,7163,44763,15912,7682,8230
34435,53356,8587,25748,7163,44769,15915,7684,8231
34440,53367,8590,25753,7165,44777,15918,7686,8232
34445,53371,8591,25756,7166,44780,15919,7687,8232
34450,53381,8593,25759,7168,44788,15921,7687,8234
34455,53387,8593,25761,7168,44794,15924,7689,8235
34460,53398,8596,25763,7170,44802,15927,7689,8238
34465,53402,8597,25766,7171,44805,15928,7690,8238
34470,53412,8600,25770,7173,44812,15930,7692,8238
34475,53418,8600,25772,7173,44818,15933,7694,8239
34480,53429,8601,25774,7173,44828,15936,7695,8241
34485,53433,8601,25774,7173,44832,15937,7695,8242
34490,53443,8604,25781,7176,44839,15939,7697,8242
34495,53449,8604,25785,7176,44844,15942,7699,8243
34500,53460,8606,25790,7177,44853,15945,7701,8244
34505,53464,8608,25791,7179,44856,15946,7701,8245
34510,53474,8610,25796,7181,44864,15948,7702,8246
34515,53480,8610,25800,7181,44869,15951,7704,8247
34520,53491,8614,25808,7184,44876,15954,7706,8248
34525,53495,8617,25810,7187,44878,15955,7706,8249
34530,53505,8618,25816,7188,44887,15957,7707,8250
34535,53511,8618,25820,7188,44892,15960,7708,8252
34540,53522,8619,25825,7189,44903,15963,7710,8253
34545,53526,8620,25827,7190,44906,15964,7710,8254
34550,53536,8621,25831,7190,44915,15966,7712,8254
34555,53542,8621,25833,7190,44921,15969,7713,8256
34560,53553,8622,25840,7191,44931,15972,7715,8257
34565,53557,8622,25842,7191,44935,15973,7716,8257
34570,53567,8623,25849,7192,44944,15975,7717,8258
34575,53573,8623,25852,7192,44950,15978,7718,8260
34580,53584,8623,25857,7192,44961,15981,7719,8262
34585,53588,8624,25858,7193,44964,15982,7719,8263
34590,53598,8625,25860,7194,44973,15984,7719,8265
34595,53604,8625,25861,7194,44979,15987,7720,8267
34600,53615,8625,25868,7194,44989,15990,7722,8268
34605,53619,8626,25869,7195,44993,15991,7722,8269
34610,53629,8627,25871,7195,45002,15993,7724,8269
34615,53635,8627,25872,7195,45008,15996,7724,8272
34620,53646,8628,25882,7196,45018,15999,7727,8272
34625,53650,8629,25886,7197,45021,16000,7728,8272
34630,53660,8630,25890,7198,45030,16002,7728,8274
34635,53666,8630,25893,7198,45035,16005,7728,8277
34640,53677,8634,25899,7201,45043,16008,7730,8278
34645,53681,8635,25901,7202,45046,16009,7730,8279
34650,53691,8637,25907,7204,45054,16011,7731,8280
34655,53697,8637,25912,7204,45059,16014,7733,8281
34660,53708,8640,25916,7206,45068,16017,7733,8284
34665,53712,8641,25918,7207,45071,16018,7734,8284
34670,53722,8643,25925,7209,45079,16020,7735,8285
34675,53728,8643,25929,7209,45084,16023,7737,8286
34680,53739,8647,25936,7212,45091,16026,7739,8287
34685,53743,8649,25939,7214,45094,16027,7740,8287
34690,53753,8651,25945,7216,45102,16029,7741,8288
34695,53759,8651,25948,7216,45108,16032,7743,8289
34700,53770,8654,25953,7219,45116,16035,7745,8290
34705,53774,8655,25956,7220,45119,16036,7746,8290
34710,53784,8658,25963,7222,45126,16038,7747,8291
34715,53790,8658,25964,7222,45132,16041,7748,8293
34720,53801,8661,25969,7224,45139,16044,7749,8295
34725,53805,8664,25972,7227,45141,16045,7750,8295
34730,53815,8665,25978,7228,45150,16047,7751,8296
34735,53821,8665,25980,7228,45155,16050,7752,8298
34740,53832,8669,25984,7231,45163,16053,7753,8300
34745,53836,8669,25984,7231,45167,16054,7753,8301
34750,53846,8671,25990,7232,45175,16056,7755,8301
34755,53852,8671,25991,7232,45181,16059,7755,8304
34760,53863,8674,25999,7234,45188,16062,7757,8305
34765,53867,8675,26001,7235,45192,16063,7758,8305
34770,53877,8678,26005,7238,45199,16065,7758,8307
34775,53883,8678,26008,7238,45205,16068,7760,8308
34780,53894,8682,26014,7242,45212,16071,7761,8310
34785,53898,8683,26015,7243,45215,16072,7761,8311
34790,53908,8685,26018,7244,45223,16074,7761,8313
34795,53914,8685,26020,7244,45229,16077,7763,8314
34800,53925,8687,26025,7245,45237,16080,7765,8315
34805,53929,8688,26025,7246,45241,16081,7765,8316
34810,53939,8690,26030,7247,45249,16083,7767,8316
34815,53945,8690,26032,7247,45255,16086,7768,8318
34820,53956,8692,26037,7248,45264,16089,7770,8319
34825,53960,8693,26040,7249,45267,16090,7771,8319
34830,53970,8695,26042,7250,45275,16092,7772,8320
34835,53976,8695,26042,7250,45281,16095,7772,8323
34840,53987,8697,26047,7252,45290,16098,7775,8323
34845,53991,8698,26049,7253,45293,16099,7775,8324
34850,54001,8701,26054,7255,45300,16101,7775,8326
34855,54007,8701,26056,7255,45306,16104,7777,8327
34860,54018,8703,26062,7256,45314,16107,7780,8327
34865,54022,8705,26064,7258,45317,16108,7781,8327
34870,54032,8706,26066,7258,45326,16110,7781,8329
34875,54038,8706,26069,7258,45331,16113,7783,8330
34880,54049,8710,26074,7261,45338,16115,7784,8331
34885,54053,8712,26077,7263,45341,16116,7784,8332
34890,54063,8713,26083,7263,45350,16118,7786,8332
34895,54069,8713,26085,7263,45356,16121,7786,8335
34900,54080,8716,26092,7266,45364,16123,7787,8336
34905,54084,8716,26094,7266,45368,16124,7788,8336
34910,54094,8718,26100,7268,45376,16126,7789,8337
34915,54100,8718,26103,7268,45381,16129,7790,8339
34920,54111,8721,26107,7270,45390,16131,7792,8339
34925,54115,8721,26110,7270,45394,16132,7793,8339
34930,54125,8722,26117,7270,45403,16134,7795,8339
34935,54131,8722,26117,7270,45409,16137,7795,8342
34940,54142,8722,26122,7270,45420,16139,7795,8344
34945,54146,8722,26124,7270,45424,16140,7796,8344
34950,54156,8723,26129,7270,45433,16142,7796,8346
34955,54162,8723,26133,7270,45438,16145,7797,8348
34960,54173,8724,26139,7271,45448,16147,7799,8348
34965,54177,8725,26141,7272,45452,16148,7799,8349
34970,54187,8726,26143,7272,45461,16150,7800,8350
34975,54193,8726,26146,7272,45466,16153,7800,8353
34980,54204,8727,26152,7273,45477,16156,7803,8353
34985,54208,8728,26154,7274,45480,16157,7803,8354
34990,54218,8729,26160,7275,45489,16159,7803,8356
34995,54224,8729,26164,7275,45494,16162,7806,8356
35000,54235,8730,26167,7276,45505,16165,7806,8359
35005,54239,8730,26168,7276,45509,16166,7807,8359
35010,54249,8731,26173,7277,45518,16168,7808,8360
35015,54255,8731,26175,7277,45524,16171,7809,8362
35020,54266,8731,26181,7277,45534,16174,7810,8364
35025,54270,8732,26182,7278,45538,16175,7811,8364
35030,54280,8735,26187,7280,45545,16177,7812,8365
35035,54286,8735,26191,7280,45550,16180,7814,8366
35040,54297,8737,26193,7281,45560,16183,7814,8369
35045,54301,8739,26196,7283,45562,16184,7814,8370
35050,54311,8741,26199,7284,45570,16186,7814,8372
35055,54317,8741,26202,7284,45576,16189,7816,8373
35060,54328,8744,26207,7286,45584,16192,7816,8376
35065,54332,8744,26208,7286,45588,16193,7816,8377
35070,54342,8747,26214,7288,45595,16195,7817,8378
35075,54348,8747,26217,7288,45600,16198,7817,8381
35080,54359,8751,26223,7292,45608,16201,7819,8382
35085,54363,8751,26224,7292,45612,16202,7819,8383
35090,54373,8752,26226,7292,45621,16204,7820,8384
35095,54379,8752,26230,7292,45627,16207,7822,8385
35100,54390,8754,26234,7293,45635,16210,7824,8386
35105,54394,8755,26234,7294,45639,16211,7824,8387
35110,54404,8757,26240,7296,45647,16213,7826,8387
35115,54410,8757,26243,7296,45653,16216,7829,8387
35120,54421,8758,26246,7296,45662,16219,7830,8389
35125,54425,8760,26247,7298,45665,16220,7830,8390
35130,54435,8761,26250,7298,45674,16222,7832,8390
35135,54441,8761,26253,7298,45679,16225,7833,8392
35140,54452,8765,26260,7302,45686,16228,7836,8392
35145,54456,8768,26263,7305,45688,16229,7836,8393
35150,54466,8770,26269,7306,45696,16231,7838,8393
35155,54472,8770,26271,7306,45701,16234,7839,8395
35160,54483,8773,26280,7309,45709,16237,7842,8395
35165,54487,8775,26281,7311,45712,16238,7842,8396
35170,54497,8776,26283,7311,45721,16240,7843,8397
35175,54503,8776,26286,7311,45726,16243,7844,8399
35180,54514,8779,26291,7313,45734,16246,7845,8401
35185,54518,8781,26294,7315,45737,16247,7846,8401
35190,54528,8784,26300,7318,45744,16249,7847,8402
35195,54534,8784,26303,7318,45750,16252,7849,8403
35200,54545,8785,26305,7318,45760,16255,7850,8405
35205,54549,8786,26306,7319,45763,16256,7850,8406
35210,54559,8788,26309,7321,45771,16258,7851,8407
35215,54565,8788,26313,7321,45776,16261,7853,8408
35220,54576,8790,26316,7323,45785,16264,7854,8410
35225,54580,8792,26317,7325,45788,16265,7854,8411
35230,54590,8794,26324,7327,45796,16267,7856,8411
35235,54596,8794,26327,7327,45802,16270,7858,8412
35240,54607,8797,26332,7329,45810,16273,7858,8415
35245,54611,8797,26333,7329,45814,16274,7859,8415
35250,54621,8797,26336,7329,45824,16276,7860,8416
35255,54627,8797,26339,7329,45830,16279,7862,8417
35260,54638,8799,26343,7331,45839,16282,7862,8420
35265,54642,8800,26346,7332,45842,16283,7863,8420
35270,54652,8800,26349,7332,45852,16285,7864,8421
35275,54658,8800,26353,7332,45858,16288,7866,8422
35280,54669,8802,26359,7334,45867,16291,7866,8425
35285,54673,8802,26361,7334,45871,16292,7866,8426
35290,54683,8803,26366,7335,45880,16294,7867,8427
35295,54689,8803,26372,7335,45886,16297,7870,8427
35300,54700,8804,26375,7335,45896,16300,7872,8428
35305,54704,8805,26377,7336,45899,16301,7872,8429
35310,54714,8807,26382,7338,45907,16303,7872,8431
35315,54720,8807,26383,7338,45913,16306,7872,8434
35320,54731,8810,26388,7341,45921,16309,7873,8436
35325,54735,8811,26391,7342,45924,16310,7874,8436
35330,54745,8812,26395,7342,45933,16312,7876,8436
35335,54751,8812,26397,7342,45939,16315,7876,8439
35340,54762,8816,26403,7345,45946,16318,7878,8440
35345,54766,8816,26405,7345,45950,16319,7879,8440
35350,54776,8817,26408,7345,45959,16321,7881,8440
35355,54782,8817,26410,7345,45964,16324,7882,8442
35360,54793,8819,26415,7347,45974,16327,7883,8444
35365,54797,8819,26415,7347,45978,16328,7883,8445
35370,54807,8820,26418,7347,45987,16330,7884,8446
35375,54813,8820,26420,7347,45993,16333,7885,8448
35380,54824,8820,26427,7347,46003,16336,7887,8449
35385,54828,8822,26429,7349,46006,16337,7887,8450
35390,54838,8823,26434,7349,46015,16339,7888,8451
35395,54844,8823,26436,7349,46021,16342,7889,8453
35400,54855,8823,26442,7349,46031,16345,7891,8454
35405,54859,8825,26445,7351,46034,16346,7892,8454
35410,54869,8826,26450,7352,46043,16348,7894,8454
35415,54875,8826,26454,7352,46048,16351,7896,8455
35420,54886,8828,26460,7354,46057,16354,7896,8458
35425,54890,8830,26463,7356,46060,16355,7897,8458
35430,54900,8831,26468,7357,46069,16357,7898,8459
35435,54906,8831,26472,7357,46075,16360,7900,8460
35440,54917,8832,26478,7358,46084,16363,7902,8461
35445,54921,8834,26479,7360,46087,16364,7902,8462
35450,54931,8836,26481,7361,46095,16366,7903,8463
35455,54937,8836,26483,7361,46101,16369,7904,8465
35460,54948,8837,26486,7361,46110,16372,7905,8467
35465,54952,8840,26490,7364,46112,16373,7906,8467
35470,54962,8843,26497,7367,46119,16375,7908,8467
35475,54968,8843,26503,7367,46124,16378,7911,8467
35480,54979,8848,26510,7371,46131,16381,7913,8468
35485,54983,8848,26510,7371,46135,16382,7913,8469
35490,54993,8850,26515,7373,46143,16384,7915,8469
35495,54999,8850,26520,7373,46149,16387,7918,8469
35500,55010,8853,26525,7375,46156,16390,7919,8471
35505,55014,8855,26528,7377,46159,16391,7920,8471
35510,55024,8857,26533,7379,46167,16393,7921,8472
35515,55030,8857,26535,7379,46173,16396,7921,8475
35520,55041,8861,26542,7383,46179,16399,7923,8476
35525,55045,8864,26545,7386,46181,16400,7923,8477
35530,55055,8865,26548,7386,46190,16402,7923,8479
35535,55061,8865,26553,7386,46195,16405,7926,8479
35540,55072,8867,26560,7388,46204,16407,7927,8480
35545,55076,8868,26561,7389,46208,16408,7927,8481
35550,55086,8869,26567,7389,46217,16410,7927,8483
35555,55092,8869,26570,7389,46223,16413,7929,8484
35560,55103,8870,26576,7389,46233,16415,7931,8484
35565,55107,8870,26578,7389,46237,16416,7932,8484
35570,55117,8871,26583,7389,46246,16418,7933,8485
35575,55123,8871,26584,7389,46252,16421,7934,8487
35580,55134,8872,26588,7389,46261,16423,7935,8488
35585,55138,8873,26589,7390,46265,16424,7935,8489
35590,55148,8874,26596,7391,46274,16426,7936,8490
35595,55154,8874,26599,7391,46280,16429,7937,8492
35600,55165,8876,26602,7393,46289,16431,7937,8494
35605,55169,8877,26603,7394,46292,16432,7937,8495
35610,55179,8878,26607,7395,46301,16434,7937,8497
35615,55185,8878,26608,7395,46306,16437,7937,8500
35620,55196,8881,26616,7397,46314,16439,7939,8500
35625,55200,8882,26618,7398,46318,16440,7940,8500
35630,55210,8883,26620,7398,46327,16442,7941,8501
35635,55216,8883,26623,7398,46333,16445,7942,8503
35640,55227,8886,26628,7400,46341,16448,7944,8504
35645,55231,8887,26629,7401,46344,16449,7944,8505
35650,55241,8889,26632,7402,46352,16451,7945,8506
35655,55247,8889,26634,7402,46358,16454,7946,8508
35660,55258,8892,26638,7404,46365,16457,7947,8510
35665,55262,8893,26638,7405,46369,16458,7947,8511
35670,55272,8895,26645,7407,46377,16460,7949,8511
35675,55278,8895,26647,7407,46382,16463,7950,8513
35680,55289,8899,26657,7411,46389,16466,7953,8513
35685,55293,8901,26660,7413,46392,16467,7954,8513
35690,55303,8902,26664,7414,46401,16469,7954,8515
35695,55309,8902,26668,7414,46407,16472,7955,8517
35700,55320,8903,26672,7415,46417,16475,7957,8518
35705,55324,8904,26675,7416,46420,16476,7957,8519
35710,55334,8905,26678,7417,46429,16478,7958,8520
35715,55340,8905,26682,7417,46435,16481,7959,8522
35720,55351,8907,26687,7418,46444,16484,7959,8525
35725,55355,8908,26688,7419,46447,16485,7959,8526
35730,55365,8909,26690,7420,46456,16487,7959,8528
35735,55371,8909,26692,7420,46462,16490,7960,8530
35740,55382,8912,26698,7422,46470,16493,7962,8531
35745,55386,8912,26699,7422,46474,16494,7962,8532
35750,55396,8913,26703,7423,46483,16496,7962,8534
35755,55402,8913,26707,7423,46489,16499,7964,8535
35760,55413,8915,26710,7424,46498,16502,7965,8537
35765,55417,8916,26713,7425,46501,16503,7966,8537
35770,55427,8918,26719,7427,46509,16505,7967,8538
35775,55433,8918,26724,7427,46515,16508,7970,8538
35780,55444,8920,26731,7428,46524,16511,7972,8539
35785,55448,8920,26732,7428,46528,16512,7973,8539
35790,55458,8922,26737,7430,46536,16514,7974,8540
35795,55464,8922,26740,7430,46541,16517,7975,8542
35800,55475,8926,26745,7434,46549,16520,7975,8545
35805,55479,8927,26747,7435,46552,16521,7976,8545
35810,55489,8929,26753,7436,46560,16523,7978,8545
35815,55495,8929,26755,7436,46566,16526,7980,8546
35820,55506,8932,26763,7439,46573,16529,7982,8547
35825,55510,8935,26765,7442,46575,16530,7982,8548
35830,55520,8937,26767,7443,46583,16532,7982,8550
35835,55526,8937,26769,7443,46588,16535,7982,8553
35840,55537,8941,26774,7446,46596,16538,7982,8556
35845,55541,8942,26778,7447,46599,16539,7983,8556
35850,55551,8943,26781,7447,46608,16541,7983,8558
35855,55557,8943,26784,7447,46614,16544,7984,8560
35860,55568,8944,26788,7448,46624,16547,7985,8562
35865,55572,8945,26790,7449,46627,16548,7985,8563
35870,55582,8946,26794,7449,46636,16550,7985,8565
35875,55588,8946,26796,7449,46642,16553,7986,8567
35880,55599,8946,26801,7449,46652,16556,7987,8569
35885,55603,8948,26804,7451,46655,16557,7987,8570
35890,55613,8949,26810,7452,46664,16559,7988,8571
35895,55619,8949,26814,7452,46669,16562,7989,8573
35900,55630,8950,26818,7453,46680,16565,7990,8575
35905,55634,8951,26820,7454,46683,16566,7991,8575
35910,55644,8952,26824,7454,46692,16568,7993,8575
35915,55650,8952,26826,7454,46698,16571,7994,8577
35920,55661,8953,26831,7455,46708,16574,7995,8579
35925,55665,8954,26833,7456,46711,16575,7996,8579
35930,55675,8955,26837,7456,46720,16577,7997,8580
35935,55681,8955,26837,7456,46726,16580,7997,8583
35940,55692,8956,26842,7457,46736,16583,7998,8585
35945,55696,8956,26844,7457,46740,16584,7999,8585
35950,55706,8957,26847,7457,46749,16586,8000,8586
35955,55712,8957,26849,7457,46754,16589,8000,8589
35960,55723,8961,26854,7460,46762,16592,8001,8591
35965,55727,8961,26855,7460,46766,16593,8002,8591
35970,55737,8962,26858,7460,46775,16595,8002,8593
35975,55743,8962,26862,7460,46781,16598,8004,8594
35980,55754,8964,26866,7461,46789,16601,8005,8596
35985,55758,8967,26869,7464,46791,16602,8006,8596
35990,55768,8969,26874,7465,46799,16604,8007,8597
35995,55774,8969,26879,7465,46804,16607,8010,8597
36000,55785,8973,26884,7469,46812,16610,8010,8600
36005,55789,8974,26886,7470,46815,16611,8011,8600
36010,55799,8977,26891,7472,46822,16613,8013,8600
36015,55805,8977,26894,7472,46828,16616,8014,8602
36020,55816,8979,26899,7473,46836,16619,8017,8602
36025,55820,8981,26901,7475,46839,16620,8017,8603
36030,55830,8984,26907,7477,46846,16622,8018,8604
36035,55836,8984,26910,7477,46852,16625,8019,8606
36040,55847,8986,26914,7479,46861,16628,8019,8609
36045,55851,8987,26915,7480,46864,16629,8019,8610
36050,55861,8989,26920,7481,46872,16631,8020,8611
36055,55867,8989,26922,7481,46878,16634,8021,8613
36060,55878,8991,26928,7482,46887,16637,8024,8613
36065,55882,8992,26931,7483,46890,16638,8025,8613
36070,55892,8994,26935,7485,46898,16640,8026,8614
36075,55898,8994,26939,7485,46903,16643,8028,8615
36080,55909,8999,26947,7490,46909,16646,8030,8616
36085,55913,9000,26947,7491,46913,16647,8030,8617
36090,55923,9002,26950,7492,46921,16649,8030,8619
36095,55929,9002,26951,7492,46927,16652,8031,8621
36100,55940,9004,26956,7493,46936,16655,8033,8622
36105,55944,9005,26957,7494,46939,16656,8033,8623
36110,55954,9007,26963,7496,46947,16658,8034,8624
36115,55960,9007,26966,7496,46953,16661,8036,8625
36120,55971,9008,26970,7496,46963,16664,8038,8626
36125,55975,9009,26971,7497,46966,16665,8038,8627
36130,55985,9011,26975,7498,46974,16667,8038,8629
36135,55991,9011,26979,7498,46979,16670,8040,8630
36140,56002,9015,26983,7501,46987,16673,8041,8632
36145,56006,9016,26985,7502,46990,16674,8042,8632
36150,56016,9017,26987,7502,46999,16676,8042,8634
36155,56022,9017,26990,7502,47005,16679,8044,8635
36160,56033,9019,26994,7504,47013,16682,8044,8638
36165,56037,9020,26996,7505,47017,16683,8045,8638
36170,56047,9021,26998,7505,47026,16685,8045,8640
36175,56053,9021,27000,7505,47031,16688,8046,8642
36180,56064,9023,27003,7507,47041,16691,8048,8643
36185,56068,9024,27005,7508,47044,16692,8048,8644
36190,56078,9026,27009,7510,47052,16694,8049,8645
36195,56084,9026,27014,7510,47057,16697,8051,8646
36200,56095,9029,27018,7512,47066,16699,8052,8647
36205,56099,9030,27020,7513,47069,16700,8052,8648
36210,56109,9033,27026,7516,47076,16702,8052,8650
36215,56115,9033,27029,7516,47082,16705,8053,8652
36220,56126,9036,27034,7518,47090,16707,8053,8654
36225,56130,9037,27036,7519,47093,16708,8053,8655
36230,56140,9038,27037,7519,47102,16710,8053,8657
36235,56146,9038,27038,7519,47108,16713,8054,8659
36240,56157,9041,27042,7521,47116,16715,8056,8659
36245,56161,9042,27045,7522,47119,16716,8057,8659
36250,56171,9045,27050,7524,47126,16718,8058,8660
36255,56177,9045,27053,7524,47131,16721,8060,8661
36260,56188,9047,27059,7526,47140,16723,8060,8663
36265,56192,9049,27062,7528,47143,16724,8061,8663
36270,56202,9051,27068,7530,47151,16726,8062,8664
36275,56208,9051,27072,7530,47156,16729,8064,8665
36280,56219,9055,27076,7533,47164,16731,8065,8666
36285,56223,9055,27078,7533,47168,16732,8065,8667
36290,56233,9057,27082,7534,47176,16734,8066,8668
36295,56239,9057,27086,7534,47181,16737,8068,8669
36300,56250,9061,27091,7537,47188,16740,8069,8671
36305,56254,9063,27095,7539,47191,16741,8070,8671
36310,56264,9063,27101,7539,47201,16743,8071,8672
36315,56270,9063,27104,7539,47207,16746,8073,8673
36320,56281,9063,27110,7539,47218,16749,8075,8674
36325,56285,9063,27111,7539,47222,16750,8075,8675
36330,56295,9063,27114,7539,47232,16752,8075,8677
36335,56301,9063,27116,7539,47238,16755,8077,8678
36340,56312,9063,27119,7539,47249,16758,8077,8681
36345,56316,9063,27122,7539,47253,16759,8078,8681
36350,56326,9063,27127,7539,47263,16761,8079,8682
36355,56332,9063,27129,7539,47269,16764,8080,8684
36360,56343,9063,27136,7539,47280,16767,8081,8686
36365,56347,9063,27137,7539,47284,16768,8082,8686
36370,56357,9063,27143,7539,47294,16770,8083,8687
36375,56363,9063,27145,7539,47300,16773,8084,8689
36380,56374,9063,27150,7539,47311,16776,8085,8691
36385,56378,9063,27151,7539,47315,16777,8086,8691
36390,56388,9063,27156,7539,47325,16779,8088,8691
36395,56394,9063,27160,7539,47331,16782,8091,8691
36400,56405,9063,27165,7539,47342,16785,8093,8692
36405,56409,9063,27167,7539,47346,16786,8093,8693
36410,56419,9065,27172,7541,47354,16788,8094,8694
36415,56425,9065,27176,7541,47359,16791,8095,8696
36420,56436,9070,27183,7545,47366,16794,8097,8697
36425,56440,9071,27186,7546,47369,16795,8098,8697
36430,56450,9073,27193,7547,47377,16797,8100,8697
36435,56456,9073,27195,7547,47383,16800,8101,8699
36440,56467,9076,27204,7550,47390,16803,8104,8699
36445,56471,9077,27205,7551,47394,16804,8104,8700
36450,56481,9080,27210,7554,47401,16806,8105,8701
36455,56487,9080,27211,7554,47407,16809,8106,8703
36460,56498,9082,27215,7556,47416,16812,8106,8706
36465,56502,9083,27218,7557,47419,16813,8107,8706
36470,56512,9085,27224,7558,47427,16815,8108,8707
36475,56518,9085,27227,7558,47432,16818,8109,8709
36480,56529,9088,27235,7561,47440,16821,8112,8709
36485,56533,9089,27236,7562,47444,16822,8113,8709
36490,56543,9092,27241,7564,47451,16824,8114,8710
36495,56549,9092,27244,7564,47457,16827,8116,8711
36500,56560,9094,27248,7565,47466,16830,8118,8712
36505,56564,9095,27250,7566,47469,16831,8118,8713
36510,56574,9096,27255,7566,47478,16833,8120,8713
36515,56580,9096,27258,7566,47484,16836,8122,8714
36520,56591,9097,27265,7567,47493,16839,8125,8714
36525,56595,9099,27267,7569,47496,16840,8125,8715
36530,56605,9100,27273,7570,47505,16842,8126,8716
36535,56611,9100,27277,7570,47511,16845,8128,8717
36540,56622,9101,27282,7570,47520,16848,8129,8719
36545,56626,9102,27283,7571,47524,16849,8129,8720
36550,56636,9103,27289,7572,47533,16851,8130,8721
36555,56642,9103,27293,7572,47539,16854,8133,8721
36560,56653,9104,27295,7572,47549,16857,8133,8724
36565,56657,9104,27297,7572,47553,16858,8134,8724
36570,56667,9105,27303,7572,47562,16860,8135,8725
36575,56673,9105,27309,7572,47567,16863,8138,8725
36580,56684,9108,27317,7575,47576,16866,8140,8726
36585,56688,9109,27318,7576,47579,16867,8140,8727
36590,56698,9110,27325,7577,47588,16869,8141,8728
36595,56704,9110,27326,7577,47593,16872,8141,8731
36600,56715,9114,27331,7581,47601,16875,8142,8733
36605,56719,9114,27332,7581,47605,16876,8143,8733
36610,56729,9115,27336,7582,47614,16878,8144,8734
36615,56735,9115,27337,7582,47620,16881,8145,8736
36620,56746,9118,27344,7584,47627,16884,8147,8737
36625,56750,9121,27346,7587,47629,16885,8147,8738
36630,56760,9123,27350,7588,47637,16887,8148,8739
36635,56766,9123,27353,7588,47643,16890,8151,8739
36640,56777,9126,27359,7590,47651,16893,8153,8740
36645,56781,9127,27361,7591,47654,16894,8153,8741
36650,56791,9129,27368,7593,47662,16896,8155,8741
36655,56797,9129,27369,7593,47668,16899,8156,8743
36660,56808,9132,27375,7596,47675,16902,8157,8745
36665,56812,9134,27376,7598,47678,16903,8157,8746
36670,56822,9137,27382,7600,47685,16905,8158,8747
36675,56828,9137,27382,7600,47691,16908,8158,8750
36680,56839,9139,27389,7602,47700,16911,8160,8751
36685,56843,9140,27391,7603,47703,16912,8161,8751
36690,56853,9142,27395,7605,47711,16914,8161,8753
36695,56859,9142,27398,7605,47717,16917,8163,8754
36700,56870,9145,27405,7608,47724,16920,8165,8755
36705,56874,9147,27407,7610,47727,16921,8166,8755
36710,56884,9149,27411,7611,47735,16923,8166,8757
36715,56890,9149,27413,7611,47741,16926,8167,8759
36720,56901,9150,27417,7611,47751,16929,8170,8759
36725,56905,9151,27418,7612,47754,16930,8170,8760
36730,56915,9152,27425,7613,47763,16932,8171,8761
36735,56921,9152,27426,7613,47769,16935,8171,8764
36740,56932,9155,27431,7615,47776,16938,8171,8767
36745,56936,9156,27431,7616,47780,16939,8171,8768
36750,56946,9157,27434,7616,47789,16941,8172,8769
36755,56952,9157,27437,7616,47794,16944,8174,8770
36760,56963,9160,27442,7619,47802,16947,8175,8772
36765,56967,9162,27444,7621,47805,16948,8175,8773
36770,56977,9164,27450,7623,47813,16950,8176,8774
36775,56983,9164,27451,7623,47819,16953,8176,8777
36780,56994,9167,27453,7625,47827,16956,8176,8780
36785,56998,9168,27455,7626,47830,16957,8177,8780
36790,57008,9170,27458,7627,47838,16959,8177,8782
36795,57014,9170,27461,7627,47844,16962,8179,8783
36800,57025,9172,27465,7629,47852,16965,8179,8786
36805,57029,9174,27466,7631,47855,16966,8179,8787
36810,57039,9176,27470,7633,47863,16968,8179,8789
36815,57045,9176,27472,7633,47869,16971,8181,8790
36820,57056,9180,27480,7637,47876,16974,8183,8791
36825,57060,9182,27482,7639,47878,16975,8183,8792
36830,57070,9184,27486,7640,47886,16977,8184,8793
36835,57076,9184,27488,7640,47892,16980,8185,8795
36840,57087,9186,27492,7642,47901,16983,8186,8797
36845,57091,9187,27494,7643,47904,16984,8186,8798
36850,57101,9188,27500,7644,47913,16986,8187,8799
36855,57107,9188,27503,7644,47918,16989,8188,8801
36860,57118,9190,27508,7646,47928,16991,8189,8802
36865,57122,9190,27510,7646,47932,16992,8190,8802
36870,57132,9191,27517,7646,47941,16994,8191,8803
36875,57138,9191,27518,7646,47946,16997,8191,8806
36880,57149,9193,27523,7648,47956,16999,8192,8807
36885,57153,9193,27523,7648,47960,17000,8192,8808
36890,57163,9194,27530,7649,47969,17002,8194,8808
36895,57169,9194,27531,7649,47975,17005,8195,8810
36900,57180,9194,27533,7649,47986,17007,8196,8811
36905,57184,9194,27534,7649,47990,17008,8196,8812
36910,57194,9195,27539,7649,47999,17010,8198,8812
36915,57200,9195,27541,7649,48005,17013,8199,8814
36920,57211,9195,27546,7649,48016,17015,8200,8815
36925,57215,9195,27548,7649,48020,17016,8200,8816
36930,57225,9196,27552,7650,48029,17018,8201,8817
36935,57231,9196,27555,7650,48035,17021,8203,8818
36940,57242,9197,27564,7651,48044,17023,8204,8819
36945,57246,9198,27566,7652,48048,17024,8205,8819
36950,57256,9200,27571,7654,48056,17026,8206,8820
36955,57262,9200,27573,7654,48062,17029,8207,8822
36960,57273,9201,27577,7655,48072,17032,8208,8824
36965,57277,9202,27580,7656,48075,17033,8209,8824
36970,57287,9205,27585,7658,48082,17035,8211,8824
36975,57293,9205,27589,7658,48087,17038,8213,8825
36980,57304,9207,27596,7660,48096,17041,8216,8825
36985,57308,9208,27597,7661,48100,17042,8217,8825
36990,57318,9211,27601,7663,48107,17044,8217,8827
36995,57324,9211,27603,7663,48113,17047,8218,8829
37000,57335,9213,27606,7664,48122,17050,8219,8831
37005,57339,9215,27609,7666,48124,17051,8220,8831
37010,57349,9217,27613,7667,48132,17053,8221,8832
37015,57355,9217,27616,7667,48137,17056,8222,8834
37020,57366,9221,27621,7671,48145,17059,8222,8837
37025,57370,9223,27624,7673,48147,17060,8222,8838
37030,57380,9226,27628,7675,48154,17062,8222,8840
37035,57386,9226,27632,7675,48160,17065,8224,8841
37040,57397,9229,27637,7677,48168,17068,8225,8843
37045,57401,9230,27639,7678,48171,17069,8226,8843
37050,57411,9232,27644,7679,48179,17071,8227,8844
37055,57417,9232,27648,7679,48184,17074,8228,8846
37060,57428,9234,27652,7681,48194,17077,8229,8848
37065,57432,9234,27653,7681,48198,17078,8230,8848
37070,57442,9236,27657,7682,48206,17080,8230,8850
37075,57448,9236,27658,7682,48212,17083,8230,8853
37080,57459,9239,27666,7685,48220,17086,8233,8853
37085,57463,9241,27669,7687,48222,17087,8233,8854
37090,57473,9243,27676,7689,48230,17089,8235,8854
37095,57479,9243,27680,7689,48236,17092,8237,8855
37100,57490,9246,27685,7691,48244,17095,8238,8857
37105,57494,9246,27685,7691,48248,17096,8238,8858
37110,57504,9248,27690,7693,48256,17098,8240,8858
37115,57510,9248,27693,7693,48262,17101,8242,8859
37120,57521,9250,27694,7694,48271,17104,8242,8862
37125,57525,9251,27695,7695,48274,17105,8242,8863
37130,57535,9254,27699,7697,48281,17107,8243,8864
37135,57541,9254,27701,7697,48286,17110,8244,8866
37140,57552,9256,27705,7699,48296,17113,8244,8869
37145,57556,9256,27707,7699,48300,17114,8245,8869
37150,57566,9258,27712,7700,48308,17116,8246,8870
37155,57572,9258,27715,7700,48313,17119,8246,8873
37160,57583,9262,27721,7704,48321,17122,8247,8875
37165,57587,9264,27724,7706,48323,17123,8247,8876
37170,57597,9266,27728,7707,48331,17125,8248,8877
37175,57603,9266,27730,7707,48336,17128,8249,8879
37180,57614,9270,27737,7710,48344,17131,8251,8880
37185,57618,9270,27737,7710,48348,17132,8251,8881
37190,57628,9271,27740,7710,48357,17134,8252,8882
37195,57634,9271,27743,7710,48362,17137,8253,8884
37200,57645,9273,27744,7711,48372,17140,8254,8886
37205,57649,9273,27744,7711,48376,17141,8254,8887
37210,57659,9275,27748,7713,48384,17143,8254,8889
37215,57665,9275,27752,7713,48390,17146,8257,8889
37220,57676,9277,27758,7715,48398,17149,8257,8892
37225,57680,9279,27759,7717,48401,17150,8257,8893
37230,57690,9282,27766,7720,48408,17152,8257,8895
37235,57696,9282,27771,7720,48413,17155,8259,8896
37240,57707,9285,27775,7722,48422,17158,8259,8899
37245,57711,9286,27777,7723,48425,17159,8259,8900
37250,57721,9288,27782,7724,48433,17161,8259,8902
37255,57727,9288,27785,7724,48439,17164,8261,8903
37260,57738,9290,27791,7726,48448,17167,8262,8905
37265,57742,9291,27793,7727,48451,17168,8262,8906
37270,57752,9292,27795,7728,48460,17170,8262,8908
37275,57758,9292,27800,7728,48466,17173,8265,8908
37280,57769,9292,27803,7728,48476,17176,8266,8910
37285,57773,9293,27804,7729,48480,17177,8266,8911
37290,57783,9294,27809,7729,48489,17179,8267,8912
37295,57789,9294,27812,7729,48494,17182,8268,8914
37300,57800,9295,27818,7730,48505,17185,8269,8916
37305,57804,9296,27819,7731,48508,17186,8269,8917
37310,57814,9297,27826,7732,48517,17188,8271,8917
37315,57820,9297,27829,7732,48522,17191,8272,8919
37320,57831,9299,27834,7734,48531,17194,8273,8921
37325,57835,9300,27835,7735,48535,17195,8273,8922
37330,57845,9301,27839,7735,48544,17197,8274,8923
37335,57851,9301,27842,7735,48549,17200,8275,8925
37340,57862,9303,27846,7737,48559,17203,8277,8926
37345,57866,9304,27848,7738,48562,17204,8277,8927
37350,57876,9305,27855,7739,48571,17206,8278,8928
37355,57882,9305,27858,7739,48576,17209,8279,8930
37360,57893,9307,27864,7741,48586,17212,8280,8932
37365,57897,9307,27866,7741,48590,17213,8280,8933
37370,57907,9308,27869,7742,48599,17215,8281,8934
37375,57913,9308,27873,7742,48605,17218,8283,8935
37380,57924,9310,27877,7743,48614,17221,8285,8936
37385,57928,9310,27878,7743,48618,17222,8285,8937
37390,57938,9311,27884,7744,48627,17224,8287,8937
37395,57944,9311,27887,7744,48633,17227,8289,8938
37400,57955,9313,27891,7745,48642,17230,8290,8940
37405,57959,9313,27891,7745,48646,17231,8290,8941
37410,57969,9315,27897,7747,48654,17233,8291,8942
37415,57975,9315,27899,7747,48660,17236,8292,8944
37420,57986,9317,27904,7748,48669,17239,8293,8946
37425,57990,9317,27907,7748,48673,17240,8294,8946
37430,58000,9318,27912,7749,48682,17242,8295,8947
37435,58006,9318,27915,7749,48688,17245,8297,8948
37440,58017,9320,27923,7751,48697,17248,8299,8949
37445,58021,9321,27927,7752,48700,17249,8300,8949
37450,58031,9321,27933,7752,48710,17251,8302,8949
37455,58037,9321,27937,7752,48716,17254,8305,8949
37460,58048,9322,27941,7752,48726,17257,8305,8952
37465,58052,9323,27945,7753,48729,17258,8306,8952
37470,58062,9324,27949,7753,48738,17260,8307,8953
37475,58068,9324,27954,7753,48743,17263,8309,8954
37480,58079,9326,27960,7754,48752,17266,8311,8955
37485,58083,9328,27961,7756,48755,17267,8311,8956
37490,58093,9329,27966,7757,48764,17269,8312,8957
37495,58099,9329,27968,7757,48769,17272,8312,8960
37500,58110,9331,27971,7758,48779,17275,8313,8962
37505,58114,9333,27974,7760,48781,17276,8314,8962
37510,58124,9334,27978,7761,48790,17278,8314,8964
37515,58130,9334,27981,7761,48795,17281,8316,8965
37520,58141,9336,27985,7763,48805,17283,8317,8966
37525,58145,9336,27985,7763,48809,17284,8317,8967
37530,58155,9337,27990,7763,48818,17286,8318,8968
37535,58161,9337,27992,7763,48824,17289,8319,8970
37540,58172,9339,27997,7765,48833,17291,8321,8970
37545,58176,9339,27999,7765,48837,17292,8321,8971
37550,58186,9342,28004,7767,48844,17294,8321,8973
37555,58192,9342,28008,7767,48849,17297,8323,8974
37560,58203,9346,28015,7771,48856,17299,8323,8976
37565,58207,9348,28017,7773,48859,17300,8323,8977
37570,58217,9350,28023,7774,48867,17302,8324,8978
37575,58223,9350,28027,7774,48872,17305,8326,8979
37580,58234,9353,28032,7776,48881,17307,8327,8980
37585,58238,9354,28033,7777,48884,17308,8327,8981
37590,58248,9356,28037,7778,48892,17310,8328,8982
37595,58254,9356,28043,7778,48897,17313,8331,8982
37600,58265,9359,28049,7781,48906,17315,8331,8984
37605,58269,9359,28050,7781,48910,17316,8331,8985
37610,58279,9360,28057,7782,48919,17318,8333,8985
37615,58285,9360,28061,7782,48924,17321,8335,8986
37620,58296,9365,28069,7787,48931,17324,8337,8987
37625,58300,9365,28070,7787,48935,17325,8338,8987
37630,58310,9366,28075,7788,48944,17327,8339,8988
37635,58316,9366,28079,7788,48949,17330,8341,8989
37640,58327,9368,28082,7789,48958,17333,8342,8991
37645,58331,9371,28086,7792,48960,17334,8343,8991
37650,58341,9374,28090,7794,48967,17336,8343,8993
37655,58347,9374,28095,7794,48972,17339,8346,8993
37660,58358,9379,28104,7799,48978,17342,8347,8995
37665,58362,9380,28106,7800,48982,17343,8348,8995
37670,58372,9383,28111,7802,48989,17345,8349,8996
37675,58378,9383,28114,7802,48995,17348,8351,8997
37680,58389,9385,28119,7804,49004,17351,8353,8998
37685,58393,9385,28120,7804,49008,17352,8353,8999
37690,58403,9386,28124,7805,49017,17354,8354,9000
37695,58409,9386,28126,7805,49023,17357,8355,9002
37700,58420,9390,28132,7808,49030,17360,8356,9004
37705,58424,9390,28133,7808,49034,17361,8356,9005
37710,58434,9393,28141,7811,49041,17363,8357,9006
37715,58440,9393,28143,7811,49046,17366,8357,9009
37720,58451,9397,28149,7815,49053,17369,8359,9010
37725,58455,9399,28151,7817,49056,17370,8360,9010
37730,58465,9400,28155,7818,49065,17372,8361,9011
37735,58471,9400,28157,7818,49071,17375,8362,9013
37740,58482,9402,28161,7819,49079,17378,8363,9015
37745,58486,9405,28164,7822,49081,17379,8364,9015
37750,58496,9407,28173,7824,49089,17381,8366,9015
37755,58502,9407,28176,7824,49094,17384,8367,9017
37760,58513,9410,28181,7827,49103,17387,8368,9019
37765,58517,9412,28184,7829,49105,17388,8369,9019
37770,58527,9414,28188,7830,49113,17390,8370,9020
37775,58533,9414,28190,7830,49119,17393,8371,9022
37780,58544,9418,28196,7834,49126,17396,8373,9023
37785,58548,9418,28198,7834,49130,17397,8374,9023
37790,58558,9420,28205,7836,49138,17399,8376,9023
37795,58564,9420,28209,7836,49143,17402,8378,9024
37800,58575,9425,28214,7840,49150,17405,8378,9027
37805,58579,9425,28215,7840,49154,17406,8378,9028
37810,58589,9426,28218,7841,49163,17408,8378,9030
37815,58595,9426,28220,7841,49169,17411,8380,9031
37820,58606,9427,28225,7842,49179,17414,8380,9034
37825,58610,9427,28226,7842,49183,17415,8380,9035
37830,58620,9428,28232,7842,49192,17417,8382,9035
37835,58626,9428,28234,7842,49198,17420,8383,9037
37840,58637,9428,28239,7842,49208,17423,8384,9039
37845,58641,9429,28239,7843,49212,17424,8384,9040
37850,58651,9430,28246,7844,49221,17426,8386,9040
37855,58657,9430,28249,7844,49227,17429,8388,9041
37860,58668,9431,28252,7845,49236,17432,8388,9044
37865,58672,9432,28253,7846,49240,17433,8388,9045
37870,58682,9433,28256,7846,49249,17435,8390,9045
37875,58688,9433,28258,7846,49255,17438,8391,9047
37880,58699,9434,28265,7847,49265,17441,8393,9048
37885,58703,9435,28266,7848,49268,17442,8393,9049
37890,58713,9436,28272,7848,49277,17444,8395,9049
37895,58719,9436,28276,7848,49282,17447,8397,9050
37900,58730,9437,28281,7849,49293,17450,8399,9051
37905,58734,9437,28284,7849,49297,17451,8400,9051
37910,58744,9439,28287,7851,49305,17453,8400,9053
37915,58750,9439,28288,7851,49311,17456,8401,9055
37920,58761,9440,28291,7852,49321,17459,8403,9056
37925,58765,9441,28293,7853,49324,17460,8404,9056
37930,58775,9443,28295,7854,49332,17462,8405,9057
37935,58781,9443,28299,7854,49337,17465,8407,9058
37940,58792,9447,28305,7857,49344,17468,8409,9059
37945,58796,9450,28308,7860,49346,17469,8410,9059
37950,58806,9451,28313,7860,49355,17471,8412,9059
37955,58812,9451,28316,7860,49361,17474,8413,9061
37960,58823,9453,28320,7862,49369,17477,8413,9064
37965,58827,9455,28321,7864,49372,17478,8413,9065
37970,58837,9457,28325,7866,49380,17480,8413,9067
37975,58843,9457,28329,7866,49385,17483,8415,9068
37980,58854,9461,28334,7870,49392,17486,8416,9070
37985,58858,9462,28335,7871,49396,17487,8416,9071
37990,58868,9464,28341,7873,49404,17489,8416,9073
37995,58874,9464,28344,7873,49410,17492,8419,9073
38000,58885,9466,28350,7875,49419,17495,8420,9075
38005,58889,9467,28354,7876,49422,17496,8421,9075
38010,58899,9467,28359,7876,49432,17498,8423,9075
38015,58905,9467,28362,7876,49438,17501,8424,9077
38020,58916,9469,28369,7877,49447,17504,8426,9078
38025,58920,9470,28370,7878,49450,17505,8426,9079
38030,58930,9470,28374,7878,49460,17507,8428,9079
38035,58936,9470,28377,7878,49466,17510,8430,9080
38040,58947,9472,28384,7880,49475,17513,8430,9083
38045,58951,9472,28385,7880,49479,17514,8430,9084
38050,58961,9473,28387,7881,49488,17516,8430,9086
38055,58967,9473,28390,7881,49494,17519,8432,9087
38060,58978,9474,28396,7881,49504,17522,8434,9088
38065,58982,9475,28398,7882,49507,17523,8435,9088
38070,58992,9475,28402,7882,49517,17525,8436,9089
38075,58998,9475,28407,7882,49523,17528,8438,9090
38080,59009,9477,28411,7884,49532,17531,8438,9093
38085,59013,9477,28413,7884,49536,17532,8439,9093
38090,59023,9479,28420,7886,49544,17534,8441,9093
38095,59029,9479,28421,7886,49550,17537,8442,9095
38100,59040,9480,28426,7887,49560,17540,8443,9097
38105,59044,9482,28429,7889,49562,17541,8444,9097
38110,59054,9484,28431,7890,49570,17543,8445,9098
38115,59060,9484,28433,7890,49575,17546,8445,9101
38120,59071,9487,28438,7892,49583,17549,8446,9103
38125,59075,9489,28440,7894,49586,17550,8447,9103
38130,59085,9491,28444,7896,49594,17552,8448,9104
38135,59091,9491,28450,7896,49599,17555,8451,9104
38140,59102,9495,28457,7900,49607,17558,8453,9105
38145,59106,9495,28458,7900,49611,17559,8453,9106
38150,59116,9497,28462,7901,49619,17561,8453,9108
38155,59122,9497,28464,7901,49624,17564,8454,9110
38160,59133,9501,28473,7905,49631,17567,8456,9111
38165,59137,9503,28474,7907,49634,17568,8456,9112
38170,59147,9504,28477,7907,49643,17570,8456,9114
38175,59153,9504,28481,7907,49648,17573,8458,9115
38180,59164,9507,28484,7910,49657,17575,8458,9117
38185,59168,9508,28485,7911,49660,17576,8458,9118
38190,59178,9510,28490,7912,49668,17578,8460,9118
38195,59184,9510,28491,7912,49674,17581,8460,9121
38200,59195,9514,28497,7915,49680,17583,8462,9121
38205,59199,9516,28501,7917,49683,17584,8463,9121
38210,59209,9517,28503,7917,49692,17586,8463,9123
38215,59215,9517,28505,7917,49698,17589,8464,9125
38220,59226,9518,28509,7918,49707,17591,8464,9127
38225,59230,9520,28512,7920,49710,17592,8465,9127
38230,59240,9521,28516,7920,49719,17594,8466,9128
38235,59246,9521,28516,7920,49725,17597,8466,9131
38240,59257,9522,28524,7921,49735,17599,8467,9132
38245,59261,9522,28525,7921,49739,17600,8468,9132
38250,59271,9523,28530,7921,49748,17602,8468,9134
38255,59277,9523,28531,7921,49754,17605,8468,9137
38260,59288,9524,28534,7922,49764,17607,8469,9138
38265,59292,9524,28537,7922,49768,17608,8470,9138
38270,59302,9525,28542,7922,49777,17610,8471,9139
38275,59308,9525,28547,7922,49782,17613,8474,9139
38280,59319,9526,28551,7923,49793,17616,8475,9141
38285,59323,9526,28553,7923,49797,17617,8476,9141
38290,59333,9527,28560,7924,49806,17619,8478,9141
38295,59339,9527,28563,7924,49812,17622,8479,9143
38300,59350,9527,28568,7924,49822,17625,8479,9146
38305,59354,9529,28570,7926,49825,17626,8480,9146
38310,59364,9530,28573,7926,49834,17628,8481,9147
38315,59370,9530,28576,7926,49840,17631,8482,9149
38320,59381,9530,28580,7926,49850,17634,8483,9151
38325,59385,9531,28580,7927,49854,17635,8483,9152
38330,59395,9532,28585,7927,49863,17637,8484,9153
38335,59401,9532,28587,7927,49868,17640,8484,9156
38340,59412,9537,28593,7932,49875,17643,8485,9158
38345,59416,9538,28594,7933,49878,17644,8485,9159
38350,59426,9540,28599,7934,49886,17646,8487,9159
38355,59432,9540,28603,7934,49891,17649,8489,9160
38360,59443,9544,28608,7937,49899,17652,8490,9162
38365,59447,9546,28612,7939,49901,17653,8491,9162
38370,59457,9547,28614,7939,49910,17655,8491,9164
38375,59463,9547,28616,7939,49916,17658,8493,9165
38380,59474,9549,28622,7941,49924,17661,8495,9166
38385,59478,9552,28626,7944,49926,17662,8496,9166
38390,59488,9554,28631,7946,49934,17664,8497,9167
38395,59494,9554,28634,7946,49939,17667,8498,9169
38400,59505,9558,28638,7949,49946,17670,8499,9171
38405,59509,9560,28641,7951,49949,17671,8500,9171
38410,59519,9563,28648,7954,49956,17673,8501,9172
38415,59525,9563,28649,7954,49962,17676,8502,9174
38420,59536,9567,28656,7957,49969,17679,8505,9174
38425,59540,9569,28658,7959,49971,17680,8505,9175
38430,59550,9571,28662,7961,49979,17682,8507,9175
38435,59556,9571,28666,7961,49984,17685,8508,9177
38440,59567,9574,28674,7964,49992,17688,8511,9177
38445,59571,9577,28678,7967,49994,17689,8512,9177
38450,59581,9578,28682,7968,50003,17691,8513,9178
38455,59587,9578,28686,7968,50009,17694,8515,9179
38460,59598,9581,28691,7971,50017,17697,8517,9180
38465,59602,9583,28694,7973,50019,17698,8518,9180
38470,59612,9586,28699,7975,50026,17700,8518,9182
38475,59618,9586,28703,7975,50031,17703,8519,9184
38480,59629,9591,28710,7980,50038,17706,8521,9185
38485,59633,9591,28714,7980,50042,17707,8522,9185
38490,59643,9591,28718,7980,50052,17709,8522,9187
38495,59649,9591,28721,7980,50058,17712,8523,9189
38500,59660,9591,28726,7980,50069,17715,8525,9190
38505,59664,9591,28729,7980,50073,17716,8526,9190
38510,59674,9591,28735,7980,50083,17718,8527,9191
38515,59680,9591,28737,7980,50089,17721,8528,9193
38520,59691,9591,28743,7980,50100,17724,8530,9194
38525,59695,9591,28743,7980,50104,17725,8530,9195
38530,59705,9591,28749,7980,50114,17727,8531,9196
38535,59711,9591,28751,7980,50120,17730,8532,9198
38540,59722,9591,28760,7980,50131,17733,8534,9199
38545,59726,9591,28763,7980,50135,17734,8534,9200
38550,59736,9591,28767,7980,50145,17736,8534,9202
38555,59742,9591,28771,7980,50151,17739,8537,9202
38560,59753,9591,28773,7980,50162,17742,8537,9205
38565,59757,9591,28776,7980,50166,17743,8538,9205
38570,59767,9591,28780,7980,50176,17745,8539,9206
38575,59773,9591,28785,7980,50182,17748,8541,9207
38580,59784,9591,28788,7980,50193,17751,8542,9209
38585,59788,9591,28790,7980,50197,17752,8542,9210
38590,59798,9594,28797,7983,50204,17754,8544,9210
38595,59804,9594,28800,7983,50210,17757,8545,9212
38600,59815,9595,28803,7984,50220,17760,8547,9213
38605,59819,9597,28806,7986,50222,17761,8547,9214
38610,59829,9598,28810,7986,50231,17763,8548,9215
38615,59835,9598,28812,7986,50236,17766,8549,9217
38620,59846,9603,28820,7991,50243,17769,8551,9218
38625,59850,9604,28821,7992,50246,17770,8551,9219
38630,59860,9606,28825,7993,50254,17772,8552,9220
38635,59866,9606,28827,7993,50259,17775,8553,9222
38640,59877,9609,28832,7996,50268,17778,8555,9223
38645,59881,9610,28834,7997,50271,17779,8556,9223
38650,59891,9611,28834,7997,50280,17781,8556,9225
38655,59897,9611,28836,7997,50286,17784,8558,9226
38660,59908,9613,28841,7998,50294,17787,8560,9227
38665,59912,9614,28842,7999,50298,17788,8560,9228
38670,59922,9617,28846,8001,50305,17790,8561,9229
38675,59928,9617,28852,8001,50310,17793,8564,9229
38680,59939,9619,28855,8003,50320,17796,8565,9231
38685,59943,9620,28857,8004,50323,17797,8565,9232
38690,59953,9621,28859,8004,50332,17799,8565,9234
38695,59959,9621,28861,8004,50338,17802,8565,9237
38700,59970,9624,28866,8007,50345,17805,8566,9239
38705,59974,9626,28868,8009,50348,17806,8566,9240
38710,59984,9629,28876,8012,50355,17808,8567,9241
38715,59990,9629,28879,8012,50360,17811,8568,9243
38720,60001,9631,28882,8013,50370,17814,8570,9244
38725,60005,9632,28884,8014,50373,17815,8571,9244
38730,60015,9634,28889,8016,50381,17817,8572,9245
38735,60021,9634,28893,8016,50386,17820,8575,9245
38740,60032,9637,28897,8018,50395,17823,8577,9246
38745,60036,9639,28901,8020,50397,17824,8578,9246
38750,60046,9641,28907,8022,50405,17826,8580,9246
38755,60052,9641,28910,8022,50410,17829,8582,9247
38760,60063,9644,28917,8025,50419,17832,8584,9248
38765,60067,9645,28919,8026,50422,17833,8584,9249
38770,60077,9646,28923,8027,50431,17835,8586,9249
38775,60083,9646,28924,8027,50437,17838,8587,9251
38780,60094,9648,28930,8029,50445,17841,8589,9252
38785,60098,9649,28932,8030,50449,17842,8590,9252
38790,60108,9652,28942,8033,50456,17844,8592,9252
38795,60114,9652,28942,8033,50462,17847,8592,9255
38800,60125,9655,28946,8035,50470,17850,8593,9257
38805,60129,9655,28946,8035,50474,17851,8593,9258
38810,60139,9658,28953,8038,50481,17853,8594,9259
38815,60145,9658,28955,8038,50487,17856,8594,9262
38820,60156,9661,28962,8040,50495,17859,8597,9262
38825,60160,9662,28965,8041,50498,17860,8597,9263
38830,60170,9663,28969,8041,50507,17862,8598,9264
38835,60176,9663,28969,8041,50513,17865,8598,9267
38840,60187,9663,28973,8041,50524,17867,8600,9267
38845,60191,9663,28976,8041,50528,17868,8601,9267
38850,60201,9664,28982,8042,50537,17870,8603,9267
38855,60207,9664,28984,8042,50543,17873,8604,9269
38860,60218,9664,28990,8042,50553,17875,8605,9270
38865,60222,9665,28992,8043,50557,17876,8606,9270
38870,60232,9666,28998,8044,50566,17878,8607,9271
38875,60238,9666,29002,8044,50571,17881,8609,9272
38880,60249,9667,29008,8045,50581,17883,8609,9274
38885,60253,9668,29009,8046,50585,17884,8609,9275
38890,60263,9669,29011,8047,50594,17886,8609,9277
38895,60269,9669,29012,8047,50600,17889,8610,9279
38900,60280,9669,29017,8047,50610,17891,8611,9280
38905,60284,9670,29019,8048,50614,17892,8611,9281
38910,60294,9671,29024,8048,50623,17894,8612,9282
38915,60300,9671,29028,8048,50629,17897,8614,9283
38920,60311,9672,29033,8049,50639,17899,8616,9283
38925,60315,9672,29036,8049,50643,17900,8617,9283
38930,60325,9674,29042,8051,50651,17902,8618,9284
38935,60331,9674,29044,8051,50656,17905,8619,9286
38940,60342,9677,29051,8054,50664,17908,8622,9286
38945,60346,9679,29053,8056,50667,17909,8622,9287
38950,60356,9681,29059,8057,50675,17911,8623,9288
38955,60362,9681,29062,8057,50681,17914,8625,9289
38960,60373,9683,29069,8059,50690,17917,8627,9290
38965,60377,9683,29069,8059,50694,17918,8627,9291
38970,60387,9685,29073,8060,50702,17920,8627,9293
38975,60393,9685,29076,8060,50708,17923,8629,9294
38980,60404,9688,29082,8062,50716,17926,8631,9295
38985,60408,9690,29085,8064,50718,17927,8631,9296
38990,60418,9692,29088,8065,50726,17929,8631,9298
38995,60424,9692,29092,8065,50731,17932,8633,9299
39000,60435,9696,29097,8068,50738,17935,8635,9300
39005,60439,9699,29101,8071,50740,17936,8636,9300
39010,60449,9701,29105,8072,50748,17938,8636,9302
39015,60455,9701,29110,8072,50754,17941,8639,9302
39020,60466,9703,29113,8073,50763,17944,8641,9303
39025,60470,9705,29115,8075,50765,17945,8641,9304
39030,60480,9706,29120,8075,50774,17947,8641,9306
39035,60486,9706,29122,8075,50779,17950,8641,9309
39040,60497,9709,29127,8077,50788,17953,8642,9311
39045,60501,9709,29129,8077,50792,17954,8643,9311
39050,60511,9711,29135,8078,50800,17956,8645,9311
39055,60517,9711,29140,8078,50805,17959,8647,9312
39060,60528,9715,29147,8081,50813,17962,8650,9312
39065,60532,9716,29149,8082,50816,17963,8651,9312
39070,60542,9717,29153,8083,50825,17965,8653,9312
39075,60548,9717,29156,8083,50830,17968,8654,9314
39080,60559,9720,29162,8086,50838,17971,8656,9315
39085,60563,9722,29164,8088,50841,17972,8657,9315
39090,60573,9724,29169,8089,50849,17974,8658,9316
39095,60579,9724,29171,8089,50855,17977,8660,9317
39100,60590,9725,29174,8090,50864,17980,8661,9319
39105,60594,9727,29175,8092,50867,17981,8661,9320
39110,60604,9729,29179,8094,50875,17983,8661,9322
39115,60610,9729,29182,8094,50881,17986,8663,9323
39120,60621,9732,29186,8096,50889,17989,8663,9326
39125,60625,9734,29189,8098,50891,17990,8663,9327
39130,60635,9736,29193,8099,50899,17992,8664,9328
39135,60641,9736,29197,8099,50905,17995,8667,9328
39140,60652,9738,29202,8100,50914,17998,8669,9329
39145,60656,9740,29206,8102,50916,17999,8670,9329
39150,60666,9743,29212,8105,50923,18001,8670,9331
39155,60672,9743,29215,8105,50929,18004,8672,9332
39160,60683,9745,29221,8107,50937,18007,8673,9334
39165,60687,9747,29223,8109,50940,18008,8674,9334
39170,60697,9750,29230,8112,50947,18010,8675,9335
39175,60703,9750,29233,8112,50952,18013,8676,9337
39180,60714,9753,29237,8114,50961,18016,8677,9339
39185,60718,9754,29239,8115,50964,18017,8678,9339
39190,60728,9755,29247,8116,50973,18019,8680,9339
39195,60734,9755,29251,8116,50979,18022,8683,9339
39200,60745,9755,29255,8116,50990,18025,8684,9341
39205,60749,9755,29257,8116,50994,18026,8685,9341
39210,60759,9756,29262,8117,51003,18028,8686,9342
39215,60765,9756,29267,8117,51009,18031,8689,9342
39220,60776,9757,29274,8118,51018,18034,8691,9343
39225,60780,9759,29277,8120,51021,18035,8692,9343
39230,60790,9760,29282,8120,51030,18037,8692,9345
39235,60796,9760,29283,8120,51036,18040,8693,9347
39240,60807,9761,29290,8121,51046,18043,8695,9348
39245,60811,9762,29293,8122,51049,18044,8696,9348
39250,60821,9763,29300,8123,51058,18046,8698,9348
39255,60827,9763,29303,8123,51063,18049,8700,9349
39260,60838,9764,29306,8124,51074,18052,8701,9351
39265,60842,9765,29307,8125,51077,18053,8701,9352
39270,60852,9766,29313,8126,51086,18055,8702,9353
39275,60858,9766,29317,8126,51091,18058,8704,9354
39280,60869,9767,29320,8127,51101,18061,8705,9356
39285,60873,9769,29323,8129,51104,18062,8706,9356
39290,60883,9770,29326,8129,51113,18064,8707,9357
39295,60889,9770,29328,8129,51119,18067,8709,9358
39300,60900,9772,29336,8131,51127,18070,8712,9358
39305,60904,9774,29337,8133,51130,18071,8712,9359
39310,60914,9775,29341,8133,51139,18073,8712,9361
39315,60920,9775,29343,8133,51144,18076,8713,9363
39320,60931,9777,29348,8135,51154,18079,8715,9364
39325,60935,9777,29348,8135,51158,18080,8715,9365
39330,60945,9778,29351,8135,51167,18082,8715,9367
39335,60951,9778,29354,8135,51172,18085,8715,9370
39340,60962,9781,29360,8138,51180,18088,8717,9371
39345,60966,9784,29364,8141,51182,18089,8718,9371
39350,60976,9785,29369,8142,51191,18091,8719,9372
39355,60982,9785,29371,8142,51197,18094,8720,9374
39360,60993,9787,29377,8143,51205,18097,8721,9376
39365,60997,9788,29380,8144,51209,18098,8722,9376
39370,61007,9788,29383,8144,51219,18100,8723,9377
39375,61013,9788,29386,8144,51225,18103,8725,9378
39380,61024,9790,29391,8145,51234,18106,8726,9380
39385,61028,9790,29392,8145,51238,18107,8726,9381
39390,61038,9791,29396,8146,51247,18109,8728,9381
39395,61044,9791,29399,8146,51253,18112,8730,9382
39400,61055,9793,29403,8147,51262,18115,8730,9385
39405,61059,9793,29403,8147,51266,18116,8730,9386
39410,61069,9795,29408,8149,51274,18118,8731,9387
39415,61075,9795,29412,8149,51280,18121,8734,9387
39420,61086,9796,29415,8149,51290,18124,8735,9389
39425,61090,9796,29418,8149,51294,18125,8736,9389
39430,61100,9798,29424,8151,51302,18127,8737,9390
39435,61106,9798,29424,8151,51308,18130,8737,9393
39440,61117,9799,29431,8152,51318,18133,8740,9393
39445,61121,9799,29432,8152,51322,18134,8741,9393
39450,61131,9799,29436,8152,51332,18136,8741,9395
39455,61137,9799,29437,8152,51338,18139,8742,9397
39460,61148,9801,29441,8153,51347,18142,8743,9399
39465,61152,9802,29445,8154,51350,18143,8744,9399
39470,61162,9804,29449,8155,51358,18145,8745,9400
39475,61168,9804,29451,8155,51363,18148,8746,9402
39480,61179,9808,29457,8158,51371,18151,8747,9404
39485,61183,9808,29459,8158,51375,18152,8748,9404
39490,61193,9810,29463,8159,51383,18154,8749,9405
39495,61199,9810,29464,8159,51389,18157,8749,9408
39500,61210,9813,29470,8162,51397,18159,8749,9410
39505,61214,9813,29470,8162,51401,18160,8749,9411
39510,61224,9815,29476,8163,51409,18162,8750,9412
39515,61230,9815,29478,8163,51415,18165,8751,9414
39520,61241,9817,29482,8164,51423,18167,8752,9415
39525,61245,9818,29484,8165,51427,18168,8753,9415
39530,61255,9819,29487,8165,51436,18170,8754,9416
39535,61261,9819,29492,8165,51441,18173,8757,9416
39540,61272,9822,29496,8167,51449,18175,8758,9417
39545,61276,9823,29496,8168,51453,18176,8758,9418
39550,61286,9826,29503,8170,51460,18178,8760,9418
39555,61292,9826,29507,8170,51465,18181,8762,9419
39560,61303,9829,29513,8173,51473,18183,8762,9421
39565,61307,9831,29515,8175,51476,18184,8762,9422
39570,61317,9833,29521,8177,51484,18186,8763,9423
39575,61323,9833,29525,8177,51489,18189,8764,9425
39580,61334,9837,29531,8180,51497,18191,8765,9426
39585,61338,9838,29533,8181,51500,18192,8766,9426
39590,61348,9840,29541,8183,51508,18194,8768,9426
39595,61354,9840,29542,8183,51514,18197,8769,9428
39600,61365,9841,29546,8184,51524,18200,8771,9429
39605,61369,9841,29547,8184,51528,18201,8772,9429
39610,61379,9842,29550,8185,51537,18203,8772,9431
39615,61385,9842,29553,8185,51542,18206,8774,9432
39620,61396,9847,29561,8189,51548,18209,8776,9433
39625,61400,9849,29564,8191,51551,18210,8777,9433
39630,61410,9852,29569,8194,51558,18212,8778,9434
39635,61416,9852,29570,8194,51564,18215,8779,9436
39640,61427,9854,29577,8196,51572,18218,8781,9437
39645,61431,9855,29577,8197,51576,18219,8781,9438
39650,61441,9856,29581,8198,51585,18221,8781,9440
39655,61447,9856,29584,8198,51590,18224,8783,9441
39660,61458,9860,29590,8201,51597,18227,8784,9443
39665,61462,9862,29592,8203,51600,18228,8784,9444
39670,61472,9865,29598,8206,51607,18230,8785,9445
39675,61478,9865,29601,8206,51612,18233,8786,9447
39680,61489,9867,29603,8207,51622,18236,8788,9448
39685,61493,9867,29604,8207,51626,18237,8789,9448
39690,61503,9869,29610,8208,51634,18239,8790,9449
39695,61509,9869,29616,8208,51639,18242,8793,9449
39700,61520,9874,29621,8212,51645,18245,8794,9451
39705,61524,9875,29623,8213,51649,18246,8795,9451
39710,61534,9878,29628,8216,51656,18248,8796,9452
39715,61540,9878,29632,8216,51661,18251,8798,9453
39720,61551,9880,29636,8217,51670,18254,8799,9455
39725,61555,9883,29639,8220,51672,18255,8799,9456
39730,61565,9885,29645,8222,51680,18257,8800,9457
39735,61571,9885,29648,8222,51686,18260,8802,9458
39740,61582,9887,29654,8224,51694,18263,8804,9459
39745,61586,9888,29655,8225,51698,18264,8805,9459
39750,61596,9890,29662,8227,51706,18266,8807,9459
39755,61602,9890,29663,8227,51712,18269,8808,9461
39760,61613,9893,29669,8230,51720,18272,8809,9463
39765,61617,9893,29670,8230,51724,18273,8810,9463
39770,61627,9894,29674,8231,51733,18275,8811,9464
39775,61633,9894,29678,8231,51738,18278,8812,9466
39780,61644,9898,29684,8235,51745,18281,8813,9468
39785,61648,9900,29685,8237,51748,18282,8813,9469
39790,61658,9901,29692,8237,51757,18284,8814,9470
39795,61664,9901,29694,8237,51763,18287,8815,9472
39800,61675,9901,29697,8237,51774,18290,8817,9473
39805,61679,9901,29699,8237,51778,18291,8817,9474
39810,61689,9902,29705,8238,51787,18293,8818,9475
39815,61695,9902,29707,8238,51792,18296,8818,9478
39820,61706,9903,29713,8239,51802,18299,8819,9480
39825,61710,9904,29713,8240,51806,18300,8819,9481
39830,61720,9905,29717,8240,51815,18302,8820,9482
39835,61726,9905,29722,8240,51820,18305,8822,9483
39840,61737,9906,29726,8241,51831,18308,8823,9485
39845,61741,9906,29729,8241,51835,18309,8824,9485
39850,61751,9907,29732,8242,51844,18311,8824,9487
39855,61757,9907,29736,8242,51849,18314,8826,9488
39860,61768,9908,29742,8243,51859,18317,8828,9489
39865,61772,9909,29743,8244,51863,18318,8828,9490
39870,61782,9910,29747,8244,51872,18320,8829,9491
39875,61788,9910,29751,8244,51877,18323,8831,9492
39880,61799,9912,29758,8246,51886,18326,8833,9493
39885,61803,9913,29759,8247,51890,18327,8834,9493
39890,61813,9915,29763,8248,51898,18329,8835,9494
39895,61819,9915,29767,8248,51903,18332,8837,9495
39900,61830,9918,29769,8250,51912,18335,8838,9497
39905,61834,9918,29769,8250,51916,18336,8838,9498
39910,61844,9920,29775,8252,51924,18338,8840,9498
39915,61850,9920,29777,8252,51929,18341,8841,9500
39920,61861,9923,29783,8255,51937,18344,8843,9501
39925,61865,9924,29783,8256,51941,18345,8843,9502
39930,61875,9926,29789,8258,51949,18347,8844,9503
39935,61881,9926,29791,8258,51954,18350,8844,9506
39940,61892,9929,29795,8260,51962,18353,8845,9508
39945,61896,9931,29797,8262,51965,18354,8845,9509
39950,61906,9934,29803,8264,51972,18356,8847,9509
39955,61912,9934,29803,8264,51978,18359,8847,9512
39960,61923,9936,29809,8266,51987,18362,8850,9512
39965,61927,9937,29810,8267,51990,18363,8850,9513
39970,61937,9939,29816,8269,51998,18365,8852,9513
39975,61943,9939,29820,8269,52003,18368,8854,9514
39980,61954,9941,29826,8270,52012,18371,8857,9514
39985,61958,9944,29828,8273,52014,18372,8857,9515
39990,61968,9947,29836,8276,52021,18374,8858,9516
39995,61974,9947,29840,8276,52027,18377,8861,9516
40000,61985,9948,29844,8277,52037,18380,8863,9517
40005,61989,9949,29846,8278,52040,18381,8863,9518
40010,61999,9950,29848,8279,52049,18383,8863,9520
40015,62005,9950,29852,8279,52054,18386,8865,9521
40020,62016,9953,29859,8282,52062,18389,8866,9523
40025,62020,9955,29861,8284,52065,18390,8866,9524
40030,62030,9955,29863,8284,52075,18392,8867,9525
40035,62036,9955,29866,8284,52081,18395,8870,9525
40040,62047,9958,29872,8286,52089,18398,8871,9527
40045,62051,9958,29873,8286,52093,18399,8871,9528
40050,62061,9959,29880,8287,52102,18401,8872,9529
40055,62067,9959,29884,8287,52108,18404,8873,9531
40060,62078,9962,29890,8290,52116,18407,8874,9533
40065,62082,9962,29892,8290,52120,18408,8875,9533
40070,62092,9964,29898,8292,52128,18410,8877,9533
40075,62098,9964,29902,8292,52134,18413,8879,9534
40080,62109,9966,29908,8293,52143,18416,8881,9535
40085,62113,9967,29910,8294,52146,18417,8881,9536
40090,62123,9969,29915,8296,52154,18419,8881,9538
40095,62129,9969,29918,8296,52160,18422,8882,9540
40100,62140,9971,29926,8298,52169,18425,8885,9540
40105,62144,9972,29928,8299,52172,18426,8885,9541
40110,62154,9973,29932,8300,52181,18428,8887,9541
40115,62160,9973,29933,8300,52187,18431,8888,9543
40120,62171,9975,29938,8302,52196,18434,8888,9546
40125,62175,9975,29939,8302,52200,18435,8888,9547
40130,62185,9977,29943,8303,52208,18437,8889,9548
40135,62191,9977,29946,8303,52213,18440,8890,9550
40140,62202,9981,29951,8307,52221,18443,8891,9552
40145,62206,9982,29953,8308,52224,18444,8892,9552
40150,62216,9983,29959,8308,52233,18446,8893,9553
40155,62222,9983,29963,8308,52238,18449,8895,9554
40160,62233,9984,29965,8309,52249,18451,8896,9555
40165,62237,9984,29968,8309,52253,18452,8896,9556
40170,62247,9985,29971,8310,52262,18454,8896,9558
40175,62253,9985,29973,8310,52268,18457,8897,9560
40180,62264,9986,29979,8311,52278,18459,8898,9561
40185,62268,9986,29979,8311,52282,18460,8898,9562
40190,62278,9987,29982,8312,52291,18462,8899,9563
40195,62284,9987,29987,8312,52296,18465,8901,9564
40200,62295,9989,29990,8314,52306,18467,8901,9566
40205,62299,9989,29991,8314,52310,18468,8901,9567
40210,62309,9990,29998,8314,52319,18470,8902,9568
40215,62315,9990,30001,8314,52324,18473,8903,9570
40220,62326,9991,30005,8315,52335,18475,8903,9572
40225,62330,9991,30006,8315,52339,18476,8903,9573
40230,62340,9992,30012,8315,52348,18478,8905,9573
40235,62346,9992,30013,8315,52353,18481,8905,9576
40240,62357,9993,30019,8316,52363,18483,8906,9577
40245,62361,9994,30021,8317,52367,18484,8907,9577
40250,62371,9995,30026,8317,52376,18486,8908,9578
40255,62377,9995,30028,8317,52381,18489,8908,9581
40260,62388,9997,30033,8318,52390,18492,8911,9581
40265,62392,9998,30033,8319,52394,18493,8911,9582
40270,62402,10001,30040,8321,52401,18495,8913,9582
40275,62408,10001,30042,8321,52407,18498,8914,9584
40280,62419,10004,30047,8323,52414,18501,8915,9586
40285,62423,10005,30047,8324,52418,18502,8915,9587
40290,62433,10006,30052,8324,52427,18504,8917,9587
40295,62439,10006,30055,8324,52433,18507,8918,9589
40300,62450,10010,30061,8327,52439,18510,8919,9591
40305,62454,10012,30062,8329,52442,18511,8919,9592
40310,62464,10014,30066,8330,52450,18513,8920,9593
40315,62470,10014,30067,8330,52456,18516,8920,9596
40320,62481,10017,30073,8333,52463,18519,8920,9599
40325,62485,10019,30074,8335,52466,18520,8920,9600
40330,62495,10022,30083,8337,52473,18522,8922,9600
40335,62501,10022,30085,8337,52478,18525,8922,9603
40340,62512,10025,30090,8339,52486,18528,8923,9605
40345,62516,10026,30091,8340,52490,18529,8924,9605
40350,62526,10028,30095,8342,52498,18531,8925,9606
40355,62532,10028,30100,8342,52504,18534,8928,9606
40360,62543,10031,30106,8344,52511,18537,8930,9607
40365,62547,10033,30108,8346,52514,18538,8930,9608
40370,62557,10036,30115,8349,52521,18540,8932,9608
40375,62563,10036,30119,8349,52526,18543,8934,9609
40380,62574,10039,30123,8352,52534,18546,8934,9612
40385,62578,10042,30125,8355,52536,18547,8934,9613
40390,62588,10043,30130,8356,52545,18549,8934,9615
40395,62594,10043,30131,8356,52551,18552,8935,9617
40400,62605,10045,30136,8358,52560,18555,8937,9618
40405,62609,10046,30138,8359,52563,18556,8937,9619
40410,62619,10048,30141,8361,52571,18558,8937,9621
40415,62625,10048,30143,8361,52577,18561,8938,9623
40420,62636,10050,30147,8362,52585,18564,8940,9624
40425,62640,10052,30150,8364,52588,18565,8941,9624
40430,62650,10054,30154,8365,52596,18567,8942,9625
40435,62656,10054,30156,8365,52601,18570,8943,9627
40440,62667,10059,30161,8370,52608,18573,8944,9629
40445,62671,10060,30163,8371,52611,18574,8944,9630
40450,62681,10061,30166,8371,52620,18576,8945,9631
40455,62687,10061,30170,8371,52625,18579,8946,9633
40460,62698,10065,30177,8375,52632,18582,8947,9635
40465,62702,10067,30179,8377,52635,18583,8948,9635
40470,62712,10069,30187,8379,52643,18585,8949,9636
40475,62718,10069,30190,8379,52649,18588,8951,9637
40480,62729,10070,30195,8379,52659,18591,8952,9639
40485,62733,10071,30197,8380,52662,18592,8952,9640
40490,62743,10072,30201,8381,52671,18594,8953,9641
40495,62749,10072,30205,8381,52677,18597,8955,9642
40500,62760,10074,30211,8383,52686,18600,8957,9643
40505,62764,10074,30212,8383,52690,18601,8957,9644
40510,62774,10076,30216,8385,52698,18603,8958,9645
40515,62780,10076,30217,8385,52704,18606,8959,9647
40520,62791,10078,30222,8387,52713,18609,8961,9648
40525,62795,10078,30225,8387,52717,18610,8961,9649
40530,62805,10078,30229,8387,52727,18612,8962,9650
40535,62811,10078,30231,8387,52733,18615,8964,9651
40540,62822,10078,30236,8387,52744,18618,8966,9652
40545,62826,10078,30237,8387,52748,18619,8966,9653
40550,62836,10078,30242,8387,52758,18621,8967,9654
40555,62842,10078,30243,8387,52764,18624,8967,9657
40560,62853,10078,30249,8387,52775,18627,8969,9658
40565,62857,10078,30253,8387,52779,18628,8970,9658
40570,62867,10079,30257,8387,52788,18630,8971,9659
40575,62873,10079,30260,8387,52793,18633,8972,9661
40580,62884,10080,30264,8388,52803,18636,8974,9662
40585,62888,10081,30264,8389,52807,18637,8974,9663
40590,62898,10082,30267,8389,52816,18639,8975,9664
40595,62904,10082,30270,8389,52821,18642,8976,9666
40600,62915,10084,30274,8391,52830,18645,8976,9669
40605,62919,10085,30276,8392,52834,18646,8977,9669
40610,62929,10086,30279,8392,52843,18648,8977,9671
40615,62935,10086,30283,8392,52848,18651,8978,9673
40620,62946,10087,30285,8393,52859,18654,8978,9676
40625,62950,10087,30287,8393,52863,18655,8979,9676
40630,62960,10089,30292,8394,52871,18657,8980,9677
40635,62966,10089,30294,8394,52876,18660,8980,9680
40640,62977,10092,30300,8397,52884,18663,8981,9682
40645,62981,10094,30303,8399,52887,18664,8982,9682
40650,62991,10096,30309,8401,52895,18666,8983,9683
40655,62997,10096,30313,8401,52900,18669,8985,9684
40660,63008,10099,30317,8404,52908,18672,8986,9686
40665,63012,10100,30319,8405,52912,18673,8987,9686
40670,63022,10102,30322,8407,52920,18675,8987,9688
40675,63028,10102,30325,8407,52925,18678,8988,9690
40680,63039,10105,30331,8409,52933,18681,8990,9691
40685,63043,10107,30333,8411,52936,18682,8991,9691
40690,63053,10108,30336,8411,52945,18684,8992,9692
40695,63059,10108,30340,8411,52951,18687,8994,9693
40700,63070,10111,30347,8414,52958,18690,8995,9695
40705,63074,10113,30349,8416,52961,18691,8996,9695
40710,63084,10114,30353,8417,52970,18693,8996,9697
40715,63090,10114,30354,8417,52976,18696,8997,9699
40720,63101,10117,30362,8420,52983,18699,8999,9700
40725,63105,10119,30364,8422,52986,18700,8999,9701
40730,63115,10121,30370,8423,52994,18702,9000,9702
40735,63121,10121,30372,8423,52999,18705,9001,9704
40740,63132,10124,30378,8426,53007,18708,9004,9704
40745,63136,10125,30379,8427,53011,18709,9005,9704
40750,63146,10128,30383,8430,53018,18711,9006,9705
40755,63152,10128,30387,8430,53024,18714,9008,9706
40760,63163,10131,30397,8433,53031,18717,9011,9706
40765,63167,10133,30400,8435,53034,18718,9012,9706
40770,63177,10134,30405,8436,53043,18720,9013,9707
40775,63183,10134,30407,8436,53048,18723,9013,9710
40780,63194,10137,30413,8439,53056,18726,9015,9711
40785,63198,10139,30415,8441,53059,18727,9015,9712
40790,63208,10140,30418,8442,53068,18729,9015,9714
40795,63214,10140,30418,8442,53074,18732,9015,9717
40800,63225,10143,30421,8444,53082,18735,9015,9720
40805,63229,10144,30423,8445,53085,18736,9015,9721
40810,63239,10146,30428,8447,53093,18738,9017,9721
40815,63245,10146,30429,8447,53099,18741,9018,9723
40820,63256,10149,30437,8450,53106,18743,9020,9723
40825,63260,10150,30438,8451,53110,18744,9021,9723
40830,63270,10153,30442,8454,53117,18746,9022,9724
40835,63276,10153,30444,8454,53122,18749,9023,9726
40840,63287,10156,30447,8456,53131,18751,9024,9727
40845,63291,10156,30449,8456,53135,18752,9025,9727
40850,63301,10158,30454,8458,53143,18754,9026,9728
40855,63307,10158,30456,8458,53149,18757,9027,9730
40860,63318,10160,30461,8459,53158,18759,9028,9731
40865,63322,10161,30464,8460,53161,18760,9029,9731
40870,63332,10163,30469,8461,53169,18762,9030,9732
40875,63338,10163,30472,8461,53174,18765,9032,9733
40880,63349,10166,30477,8463,53183,18767,9033,9734
40885,63353,10166,30479,8463,53187,18768,9034,9734
40890,63363,10168,30482,8465,53195,18770,9034,9736
40895,63369,10168,30484,8465,53201,18773,9034,9739
40900,63380,10171,30490,8467,53208,18775,9034,9741
40905,63384,10172,30492,8468,53212,18776,9034,9742
40910,63394,10174,30497,8469,53220,18778,9035,9743
40915,63400,10174,30501,8469,53225,18781,9037,9744
40920,63411,10179,30507,8473,53232,18784,9038,9746
40925,63415,10180,30509,8474,53235,18785,9039,9746
40930,63425,10181,30514,8474,53244,18787,9041,9746
40935,63431,10181,30517,8474,53249,18790,9043,9747
40940,63442,10185,30521,8477,53256,18793,9043,9750
40945,63446,10187,30524,8479,53259,18794,9044,9750
40950,63456,10190,30530,8481,53266,18796,9046,9750
40955,63462,10190,30534,8481,53271,18799,9049,9750
40960,63473,10194,30537,8484,53279,18802,9050,9752
40965,63477,10195,30538,8485,53282,18803,9050,9753
40970,63487,10198,30543,8488,53289,18805,9050,9755
40975,63493,10198,30547,8488,53294,18808,9052,9756
40980,63504,10201,30554,8491,53302,18811,9054,9757
40985,63508,10202,30556,8492,53306,18812,9054,9758
40990,63518,10202,30564,8492,53316,18814,9055,9759
40995,63524,10202,30566,8492,53322,18817,9056,9761
41000,63535,10202,30567,8492,53333,18820,9057,9763
41005,63539,10202,30570,8492,53337,18821,9058,9763
41010,63549,10202,30573,8492,53347,18823,9058,9765
41015,63555,10202,30577,8492,53353,18826,9061,9765
41020,63566,10202,30583,8492,53364,18829,9063,9766
41025,63570,10202,30585,8492,53368,18830,9063,9767
41030,63580,10202,30590,8492,53378,18832,9065,9767
41035,63586,10202,30593,8492,53384,18835,9066,9769
41040,63597,10202,30597,8492,53395,18838,9066,9772
41045,63601,10202,30599,8492,53399,18839,9066,9773
41050,63611,10202,30607,8492,53409,18841,9068,9773
41055,63617,10202,30610,8492,53415,18844,9069,9775
41060,63628,10202,30613,8492,53426,18847,9070,9777
41065,63632,10202,30615,8492,53430,18848,9071,9777
41070,63642,10202,30619,8492,53440,18850,9072,9778
41075,63648,10202,30620,8492,53446,18853,9073,9780
41080,63659,10202,30623,8492,53457,18856,9073,9783
41085,63663,10202,30624,8492,53461,18857,9073,9784
41090,63673,10204,30630,8494,53469,18859,9074,9785
41095,63679,10204,30634,8494,53474,18862,9076,9786
41100,63690,10207,30639,8497,53483,18865,9078,9787
41105,63694,10208,30640,8498,53486,18866,9078,9788
41110,63704,10211,30645,8500,53493,18868,9079,9789
41115,63710,10211,30647,8500,53499,18871,9080,9791
41120,63721,10213,30651,8501,53507,18874,9081,9793
41125,63725,10214,30652,8502,53511,18875,9082,9793
41130,63735,10217,30661,8505,53518,18877,9084,9793
41135,63741,10217,30662,8505,53524,18880,9085,9795
41140,63752,10219,30667,8507,53532,18883,9087,9796
41145,63756,10221,30670,8509,53535,18884,9088,9796
41150,63766,10224,30677,8512,53542,18886,9089,9797
41155,63772,10224,30680,8512,53547,18889,9089,9800
41160,63783,10227,30686,8515,53555,18892,9092,9800
41165,63787,10228,30688,8516,53559,18893,9093,9800
41170,63797,10230,30693,8518,53567,18895,9093,9802
41175,63803,10230,30694,8518,53572,18898,9093,9805
41180,63814,10233,30699,8520,53580,18901,9095,9806
41185,63818,10235,30702,8522,53583,18902,9096,9806
41190,63828,10237,30707,8524,53591,18904,9096,9808
41195,63834,10237,30712,8524,53596,18907,9099,9808
41200,63845,10240,30718,8527,53605,18910,9100,9810
41205,63849,10241,30721,8528,53608,18911,9101,9810
41210,63859,10242,30724,8528,53617,18913,9102,9811
41215,63865,10242,30725,8528,53622,18916,9102,9814
41220,63876,10246,30732,8531,53629,18919,9103,9816
41225,63880,10248,30735,8533,53632,18920,9104,9816
41230,63890,10250,30738,8535,53640,18922,9104,9818
41235,63896,10250,30741,8535,53646,18925,9106,9819
41240,63907,10253,30747,8537,53653,18928,9108,9820
41245,63911,10255,30749,8539,53656,18929,9108,9821
41250,63921,10256,30754,8539,53665,18931,9109,9822
41255,63927,10256,30756,8539,53671,18934,9110,9824
41260,63938,10259,30763,8541,53678,18937,9113,9824
41265,63942,10261,30765,8543,53681,18938,9113,9825
41270,63952,10263,30771,8545,53689,18940,9115,9825
41275,63958,10263,30773,8545,53694,18943,9116,9827
41280,63969,10266,30780,8548,53703,18946,9118,9828
41285,63973,10267,30782,8549,53706,18947,9118,9829
41290,63983,10270,30787,8552,53713,18949,9118,9831
41295,63989,10270,30789,8552,53719,18952,9119,9833
41300,64000,10271,30792,8552,53729,18955,9121,9834
41305,64004,10273,30796,8554,53731,18956,9122,9834
41310,64014,10275,30802,8555,53739,18958,9123,9835
41315,64020,10275,30804,8555,53745,18961,9124,9837
41320,64031,10276,30812,8556,53755,18964,9127,9837
41325,64035,10277,30815,8557,53758,18965,9127,9838
41330,64045,10278,30820,8558,53767,18967,9128,9839
41335,64051,10278,30821,8558,53773,18970,9128,9842
41340,64062,10279,30825,8559,53782,18973,9128,9845
41345,64066,10280,30827,8560,53786,18974,9128,9846
41350,64076,10281,30834,8561,53795,18976,9129,9847
41355,64082,10281,30837,8561,53801,18979,9131,9848
41360,64093,10282,30844,8562,53810,18982,9134,9848
41365,64097,10284,30846,8564,53813,18983,9135,9848
41370,64107,10285,30851,8565,53822,18985,9136,9849
41375,64113,10285,30853,8565,53828,18988,9136,9852
41380,64124,10285,30859,8565,53838,18991,9137,9854
41385,64128,10286,30862,8566,53842,18992,9138,9854
41390,64138,10287,30869,8567,53851,18994,9139,9855
41395,64144,10287,30871,8567,53857,18997,9141,9856
41400,64155,10288,30879,8568,53866,19000,9143,9857
41405,64159,10289,30880,8569,53870,19001,9143,9858
41410,64169,10290,30884,8570,53879,19003,9145,9858
41415,64175,10290,30887,8570,53885,19006,9147,9859
41420,64186,10292,30894,8572,53893,19009,9149,9860
41425,64190,10294,30897,8574,53896,19010,9150,9860
41430,64200,10297,30901,8576,53903,19012,9151,9861
41435,64206,10297,30904,8576,53909,19015,9152,9863
41440,64217,10299,30909,8578,53918,19018,9154,9864
41445,64221,10300,30911,8579,53921,19019,9154,9865
41450,64231,10301,30915,8579,53930,19021,9156,9865
41455,64237,10301,30916,8579,53936,19024,9156,9868
41460,64248,10305,30922,8583,53943,19027,9157,9870
41465,64252,10307,30924,8585,53945,19028,9157,9871
41470,64262,10308,30928,8586,53954,19030,9158,9872
41475,64268,10308,30929,8586,53960,19033,9158,9875
41480,64279,10311,30934,8588,53967,19035,9159,9876
41485,64283,10312,30935,8589,53971,19036,9159,9877
41490,64293,10313,30940,8590,53980,19038,9159,9879
41495,64299,10313,30944,8590,53985,19041,9160,9881
41500,64310,10318,30951,8595,53991,19043,9161,9882
41505,64314,10319,30953,8596,53995,19044,9162,9882
41510,64324,10321,30958,8598,54003,19046,9163,9883
41515,64330,10321,30961,8598,54008,19049,9163,9886
41520,64341,10323,30964,8599,54018,19051,9164,9887
41525,64345,10324,30967,8600,54021,19052,9165,9887
41530,64355,10326,30973,8602,54029,19054,9165,9889
41535,64361,10326,30975,8602,54035,19057,9166,9891
41540,64372,10328,30981,8603,54043,19059,9167,9892
41545,64376,10329,30983,8604,54047,19060,9168,9892
41550,64386,10331,30988,8606,54055,19062,9169,9893
41555,64392,10331,30990,8606,54061,19065,9170,9895
41560,64403,10333,30995,8608,54069,19067,9170,9897
41565,64407,10335,30998,8610,54072,19068,9170,9898
41570,64417,10337,31003,8612,54080,19070,9171,9899
41575,64423,10337,31006,8612,54086,19073,9172,9901
41580,64434,10340,31013,8615,54093,19076,9173,9903
41585,64438,10342,31014,8617,54096,19077,9173,9904
41590,64448,10344,31019,8619,54104,19079,9174,9905
41595,64454,10344,31023,8619,54109,19082,9175,9907
41600,64465,10348,31029,8623,54117,19085,9178,9907
41605,64469,10350,31032,8625,54119,19086,9179,9907
41610,64479,10352,31037,8626,54127,19088,9180,9908
41615,64485,10352,31040,8626,54132,19091,9181,9910
41620,64496,10356,31045,8629,54140,19094,9182,9912
41625,64500,10357,31047,8630,54143,19095,9183,9912
41630,64510,10359,31053,8632,54151,19097,9185,9912
41635,64516,10359,31056,8632,54157,19100,9186,9914
41640,64527,10361,31060,8633,54166,19103,9187,9916
41645,64531,10362,31064,8634,54169,19104,9188,9916
41650,64541,10362,31071,8634,54179,19106,9188,9918
41655,64547,10362,31074,8634,54185,19109,9190,9919
41660,64558,10362,31078,8634,54196,19112,9192,9920
41665,64562,10362,31081,8634,54200,19113,9193,9920
41670,64572,10362,31086,8634,54210,19115,9194,9921
41675,64578,10362,31090,8634,54216,19118,9196,9922
41680,64589,10362,31097,8634,54227,19121,9198,9923
41685,64593,10362,31098,8634,54231,19122,9199,9923
41690,64603,10362,31100,8634,54241,19124,9199,9925
41695,64609,10362,31102,8634,54247,19127,9200,9927
41700,64620,10362,31106,8634,54258,19130,9201,9929
41705,64624,10362,31108,8634,54262,19131,9201,9930
41710,64634,10362,31114,8634,54272,19133,9203,9930
41715,64640,10362,31116,8634,54278,19136,9204,9932
41720,64651,10362,31123,8634,54289,19139,9206,9933
41725,64655,10362,31125,8634,54293,19140,9207,9933
41730,64665,10363,31130,8635,54302,19142,9208,9934
41735,64671,10363,31132,8635,54308,19145,9209,9936
41740,64682,10363,31138,8635,54318,19148,9211,9937
41745,64686,10365,31141,8637,54321,19149,9211,9938
41750,64696,10368,31149,8640,54328,19151,9212,9939
41755,64702,10368,31150,8640,54334,19154,9213,9941
41760,64713,10372,31159,8644,54340,19157,9215,9942
41765,64717,10373,31160,8645,54344,19158,9215,9943
41770,64727,10376,31166,8648,54351,19160,9217,9943
41775,64733,10376,31171,8648,54357,19163,9220,9943
41780,64744,10379,31179,8651,54365,19166,9223,9943
41785,64748,10379,31181,8651,54369,19167,9224,9943
41790,64758,10381,31185,8652,54377,19169,9225,9944
41795,64764,10381,31188,8652,54383,19172,9227,9945
41800,64775,10383,31194,8654,54392,19175,9229,9946
41805,64779,10383,31195,8654,54396,19176,9229,9947
41810,64789,10384,31198,8655,54405,19178,9229,9949
41815,64795,10384,31200,8655,54411,19181,9231,9950
41820,64806,10385,31204,8655,54420,19184,9232,9952
41825,64810,10388,31207,8658,54422,19185,9233,9952
41830,64820,10391,31213,8661,54429,19187,9234,9953
41835,64826,10391,31218,8661,54435,19190,9237,9953
41840,64837,10395,31222,8664,54442,19193,9238,9955
41845,64841,10396,31224,8665,54445,19194,9239,9955
41850,64851,10397,31231,8666,54454,19196,9241,9955
41855,64857,10397,31233,8666,54460,19199,9242,9957
41860,64868,10400,31239,8668,54467,19202,9243,9959
41865,64872,10401,31240,8669,54471,19203,9244,9959
41870,64882,10403,31245,8671,54479,19205,9245,9960
41875,64888,10403,31247,8671,54485,19208,9246,9962
41880,64899,10406,31254,8673,54492,19211,9249,9962
41885,64903,10409,31257,8676,54494,19212,9250,9962
41890,64913,10411,31264,8678,54502,19214,9252,9962
41895,64919,10411,31268,8678,54508,19217,9254,9963
41900,64930,10413,31274,8680,54516,19220,9255,9965
41905,64934,10414,31275,8681,54520,19221,9255,9966
41910,64944,10415,31279,8682,54529,19223,9256,9967
41915,64950,10415,31282,8682,54535,19226,9258,9968
41920,64961,10418,31286,8684,54542,19229,9258,9971
41925,64965,10420,31287,8686,54545,19230,9258,9972
41930,64975,10423,31291,8689,54552,19232,9258,9974
41935,64981,10423,31295,8689,54557,19235,9260,9975
41940,64992,10426,31300,8692,54566,19238,9262,9976
41945,64996,10426,31302,8692,54570,19239,9263,9976
41950,65006,10428,31308,8694,54578,19241,9265,9976
41955,65012,10428,31311,8694,54584,19244,9267,9977
41960,65023,10430,31316,8696,54593,19247,9269,9978
41965,65027,10431,31318,8697,54596,19248,9269,9979
41970,65037,10432,31322,8697,54605,19250,9270,9980
41975,65043,10432,31325,8697,54610,19253,9271,9982
41980,65054,10434,31330,8699,54619,19256,9273,9983
41985,65058,10436,31331,8701,54622,19257,9273,9984
41990,65068,10438,31335,8703,54630,19259,9274,9985
41995,65074,10438,31337,8703,54635,19262,9274,9988
42000,65085,10440,31339,8705,54644,19265,9274,9991
42005,65089,10442,31340,8707,54647,19266,9274,9992
42010,65099,10444,31345,8708,54655,19268,9275,9993
42015,65105,10444,31348,8708,54661,19271,9277,9994
42020,65116,10445,31350,8709,54671,19274,9278,9996
42025,65120,10447,31354,8711,54673,19275,9279,9996
42030,65130,10449,31360,8713,54681,19277,9281,9996
42035,65136,10449,31362,8713,54687,19280,9282,9998
42040,65147,10452,31368,8715,54694,19283,9283,10000
42045,65151,10453,31369,8716,54698,19284,9283,10001
42050,65161,10454,31375,8716,54707,19286,9284,10002
42055,65167,10454,31378,8716,54712,19289,9286,10003
42060,65178,10456,31382,8717,54722,19292,9288,10004
42065,65182,10457,31383,8718,54725,19293,9288,10005
42070,65192,10460,31388,8720,54732,19295,9288,10007
42075,65198,10460,31391,8720,54737,19298,9289,10009
42080,65209,10465,31396,8724,54744,19301,9289,10012
42085,65213,10466,31399,8725,54747,19302,9290,10012
42090,65223,10467,31403,8725,54756,19304,9290,10014
42095,65229,10467,31407,8725,54761,19307,9292,10015
42100,65240,10469,31412,8727,54770,19310,9293,10017
42105,65244,10470,31415,8728,54774,19311,9294,10017
42110,65254,10471,31422,8729,54783,19313,9295,10018
42115,65260,10471,31422,8729,54789,19316,9295,10021
42120,65271,10471,31426,8729,54799,19319,9296,10023
42125,65275,10472,31427,8730,54803,19320,9296,10024
42130,65285,10473,31434,8730,54812,19322,9298,10024
42135,65291,10473,31440,8730,54817,19325,9301,10024
42140,65302,10475,31445,8732,54826,19327,9301,10026
42145,65306,10476,31448,8733,54830,19328,9302,10026
42150,65316,10477,31453,8733,54839,19330,9302,10028
42155,65322,10477,31457,8733,54845,19333,9305,10028
42160,65333,10478,31462,8734,54855,19335,9307,10028
42165,65337,10478,31462,8734,54859,19336,9307,10029
42170,65347,10479,31466,8734,54868,19338,9308,10030
42175,65353,10479,31468,8734,54874,19341,9310,10031
42180,65364,10479,31472,8734,54885,19343,9310,10033
42185,65368,10479,31474,8734,54889,19344,9310,10034
42190,65378,10481,31479,8736,54897,19346,9311,10035
42195,65384,10481,31483,8736,54903,19349,9313,10036
42200,65395,10484,31490,8739,54910,19351,9314,10037
42205,65399,10485,31491,8740,54914,19352,9314,10038
42210,65409,10487,31498,8742,54922,19354,9315,10039
42215,65415,10487,31503,8742,54927,19357,9317,10040
42220,65426,10490,31509,8744,54935,19359,9318,10041
42225,65430,10491,31511,8745,54939,19360,9318,10042
42230,65440,10494,31518,8747,54946,19362,9319,10043
42235,65446,10494,31522,8747,54952,19365,9322,10043
42240,65457,10496,31526,8748,54960,19368,9323,10045
42245,65461,10497,31526,8749,54964,19369,9323,10046
42250,65471,10500,31533,8751,54971,19371,9325,10046
42255,65477,10500,31536,8751,54976,19374,9326,10048
42260,65488,10502,31540,8753,54986,19377,9327,10050
42265,65492,10503,31542,8754,54989,19378,9327,10051
42270,65502,10504,31545,8754,54998,19380,9327,10053
42275,65508,10504,31548,8754,55003,19383,9328,10055
42280,65519,10506,31552,8755,55012,19386,9329,10057
42285,65523,10508,31555,8757,55015,19387,9330,10057
42290,65533,10509,31560,8757,55024,19389,9330,10059
42295,65539,10509,31562,8757,55030,19392,9331,10061
42300,65550,10510,31567,8757,55040,19395,9334,10061
42305,65554,10512,31570,8759,55042,19396,9335,10061
42310,65564,10513,31575,8759,55051,19398,9336,10062
42315,65570,10513,31579,8759,55056,19401,9338,10063
42320,65581,10515,31583,8761,55066,19404,9339,10065
42325,65585,10516,31585,8762,55069,19405,9339,10066
42330,65595,10517,31591,8763,55078,19407,9340,10067
42335,65601,10517,31595,8763,55083,19410,9341,10069
42340,65612,10520,31603,8766,55091,19413,9343,10070
42345,65616,10521,31604,8767,55095,19414,9344,10070
42350,65626,10522,31608,8767,55104,19416,9344,10072
42355,65632,10522,31611,8767,55109,19419,9345,10074
42360,65643,10527,31618,8771,55116,19422,9348,10074
42365,65647,10528,31620,8772,55119,19423,9348,10075
42370,65657,10531,31625,8775,55126,19425,9350,10075
42375,65663,10531,31627,8775,55131,19428,9350,10078
42380,65674,10535,31633,8779,55139,19431,9351,10080
42385,65678,10535,31635,8779,55143,19432,9352,10080
42390,65688,10538,31641,8782,55150,19434,9353,10081
42395,65694,10538,31645,8782,55155,19437,9355,10082
42400,65705,10541,31650,8785,55163,19440,9356,10084
42405,65709,10544,31653,8788,55165,19441,9356,10085
42410,65719,10545,31659,8789,55174,19443,9358,10085
42415,65725,10545,31661,8789,55180,19446,9360,10086
42420,65736,10547,31663,8790,55189,19449,9360,10089
42425,65740,10549,31665,8792,55191,19450,9360,10090
42430,65750,10550,31667,8792,55200,19452,9361,10091
42435,65756,10550,31671,8792,55206,19455,9364,10091
42440,65767,10553,31676,8795,55214,19458,9365,10093
42445,65771,10554,31679,8796,55217,19459,9366,10093
42450,65781,10556,31683,8797,55225,19461,9368,10093
42455,65787,10556,31687,8797,55230,19464,9370,10094
42460,65798,10559,31692,8799,55239,19467,9371,10096
42465,65802,10559,31695,8799,55243,19468,9372,10096
42470,65812,10561,31702,8801,55251,19470,9374,10096
42475,65818,10561,31705,8801,55257,19473,9374,10099
42480,65829,10564,31708,8803,55265,19476,9374,10102
42485,65833,10565,31710,8804,55268,19477,9375,10102
42490,65843,10567,31716,8806,55276,19479,9376,10103
42495,65849,10567,31717,8806,55282,19482,9376,10106
42500,65860,10569,31723,8807,55291,19485,9378,10107
42505,65864,10570,31727,8808,55294,19486,9379,10107
42510,65874,10572,31733,8810,55302,19488,9380,10108
42515,65880,10572,31738,8810,55308,19491,9383,10108
42520,65891,10574,31744,8811,55317,19494,9384,10110
42525,65895,10574,31746,8811,55321,19495,9385,10110
42530,65905,10574,31752,8811,55331,19497,9385,10112
42535,65911,10574,31752,8811,55337,19500,9385,10115
42540,65922,10574,31756,8811,55348,19503,9386,10117
42545,65926,10574,31757,8811,55352,19504,9386,10118
42550,65936,10574,31757,8811,55362,19506,9386,10120
42555,65942,10574,31758,8811,55368,19509,9386,10123
42560,65953,10574,31767,8811,55379,19512,9389,10123
42565,65957,10574,31770,8811,55383,19513,9390,10123
42570,65967,10575,31773,8811,55392,19515,9390,10125
42575,65973,10575,31779,8811,55397,19518,9393,10125
42580,65984,10576,31785,8812,55407,19521,9394,10127
42585,65988,10577,31787,8813,55411,19522,9395,10127
42590,65998,10578,31792,8813,55420,19524,9395,10129
42595,66004,10578,31793,8813,55426,19527,9395,10132
42600,66015,10579,31799,8814,55436,19530,9397,10133
42605,66019,10579,31800,8814,55440,19531,9398,10133
42610,66029,10580,31805,8815,55449,19533,9400,10133
42615,66035,10580,31808,8815,55454,19536,9401,10135
42620,66046,10581,31813,8816,55464,19539,9402,10137
42625,66050,10583,31816,8818,55467,19540,9403,10137
42630,66060,10585,31821,8820,55475,19542,9404,10138
42635,66066,10585,31824,8820,55480,19545,9406,10139
42640,66077,10588,31827,8822,55489,19548,9407,10141
42645,66081,10589,31828,8823,55492,19549,9407,10142
42650,66091,10591,31833,8825,55500,19551,9407,10144
42655,66097,10591,31837,8825,55505,19554,9409,10145
42660,66108,10594,31844,8828,55514,19557,9412,10145
42665,66112,10595,31847,8829,55517,19558,9413,10145
42670,66122,10598,31850,8831,55524,19560,9413,10147
42675,66128,10598,31852,8831,55530,19563,9414,10149
42680,66139,10601,31859,8834,55537,19566,9416,10150
42685,66143,10602,31860,8835,55541,19567,9417,10150
42690,66153,10604,31866,8836,55549,19569,9418,10151
42695,66159,10604,31869,8836,55555,19572,9420,10152
42700,66170,10605,31871,8837,55565,19575,9421,10154
42705,66174,10606,31873,8838,55568,19576,9422,10154
42710,66184,10607,31876,8839,55577,19578,9423,10155
42715,66190,10607,31878,8839,55582,19581,9423,10158
42720,66201,10610,31882,8842,55591,19584,9424,10160
42725,66205,10611,31883,8843,55594,19585,9424,10161
42730,66215,10613,31887,8845,55602,19587,9424,10163
42735,66221,10613,31890,8845,55608,19590,9426,10164
42740,66232,10615,31895,8846,55617,19593,9429,10164
42745,66236,10616,31897,8847,55620,19594,9430,10164
42750,66246,10618,31903,8849,55628,19596,9432,10164
42755,66252,10618,31905,8849,55634,19599,9433,10166
42760,66263,10620,31912,8851,55643,19602,9436,10166
42765,66267,10621,31913,8852,55646,19603,9436,10167
42770,66277,10624,31920,8854,55653,19605,9437,10168
42775,66283,10624,31924,8854,55658,19608,9438,10170
42780,66294,10628,31929,8857,55666,19611,9439,10172
42785,66298,10629,31932,8858,55669,19612,9440,10172
42790,66308,10630,31937,8858,55678,19614,9441,10173
42795,66314,10630,31941,8858,55683,19617,9442,10175
42800,66325,10633,31946,8860,55691,19619,9443,10176
42805,66329,10635,31948,8862,55694,19620,9443,10177
42810,66339,10637,31951,8863,55702,19622,9445,10177
42815,66345,10637,31953,8863,55707,19625,9446,10179
42820,66356,10640,31956,8865,55716,19627,9447,10180
42825,66360,10641,31957,8866,55719,19628,9447,10181
42830,66370,10643,31963,8867,55727,19630,9448,10182
42835,66376,10643,31966,8867,55732,19633,9449,10184
42840,66387,10646,31970,8870,55741,19635,9450,10185
42845,66391,10647,31972,8871,55744,19636,9450,10186
42850,66401,10648,31977,8872,55753,19638,9451,10187
42855,66407,10648,31978,8872,55759,19641,9451,10190
42860,66418,10648,31983,8872,55769,19643,9453,10190
42865,66422,10649,31985,8873,55773,19644,9453,10191
42870,66432,10650,31989,8873,55782,19646,9454,10192
42875,66438,10650,31992,8873,55788,19649,9455,10194
42880,66449,10651,31999,8874,55797,19651,9456,10195
42885,66453,10652,32000,8875,55801,19652,9457,10195
42890,66463,10653,32004,8875,55810,19654,9458,10196
42895,66469,10653,32007,8875,55816,19657,9460,10197
42900,66480,10654,32014,8876,55825,19660,9462,10198
42905,66484,10655,32017,8877,55829,19661,9463,10198
42910,66494,10656,32021,8877,55838,19663,9464,10199
42915,66500,10656,32021,8877,55844,19666,9464,10202
42920,66511,10657,32029,8878,55853,19669,9466,10203
42925,66515,10659,32032,8880,55856,19670,9467,10203
42930,66525,10660,32036,8881,55865,19672,9467,10205
42935,66531,10660,32038,8881,55871,19675,9468,10207
42940,66542,10661,32042,8882,55880,19678,9470,10208
42945,66546,10662,32042,8883,55884,19679,9470,10209
42950,66556,10665,32046,8886,55891,19681,9470,10211
42955,66562,10665,32048,8886,55897,19684,9471,10213
42960,66573,10669,32053,8889,55903,19687,9472,10215
42965,66577,10671,32056,8891,55906,19688,9473,10215
42970,66587,10674,32061,8893,55913,19690,9474,10216
42975,66593,10674,32064,8893,55918,19693,9476,10217
42980,66604,10678,32069,8896,55925,19696,9477,10219
42985,66608,10681,32071,8899,55927,19697,9477,10220
42990,66618,10684,32076,8901,55934,19699,9478,10221
42995,66624,10684,32079,8901,55939,19702,9479,10223
43000,66635,10688,32084,8905,55947,19705,9481,10224
43005,66639,10689,32087,8906,55950,19706,9482,10224
43010,66649,10690,32091,8907,55959,19708,9483,10225
43015,66655,10690,32095,8907,55964,19711,9485,10226
43020,66666,10694,32100,8910,55971,19714,9486,10228
43025,66670,10696,32101,8912,55974,19715,9486,10229
43030,66680,10697,32106,8912,55983,19717,9487,10230
43035,66686,10697,32111,8912,55988,19720,9490,10230
43040,66697,10700,32119,8915,55996,19723,9492,10231
43045,66701,10701,32120,8916,56000,19724,9492,10232
43050,66711,10702,32127,8917,56009,19726,9493,10233
43055,66717,10702,32129,8917,56015,19729,9495,10234
43060,66728,10704,32135,8918,56023,19732,9496,10236
43065,66732,10705,32135,8919,56027,19733,9496,10237
43070,66742,10706,32140,8920,56036,19735,9497,10238
43075,66748,10706,32144,8920,56041,19738,9499,10239
43080,66759,10708,32146,8922,56051,19741,9500,10241
43085,66763,10710,32148,8924,56053,19742,9500,10242
43090,66773,10711,32153,8924,56062,19744,9501,10243
43095,66779,10711,32157,8924,56067,19747,9503,10244
43100,66790,10713,32161,8925,56077,19750,9505,10245
43105,66794,10714,32163,8926,56080,19751,9505,10246
43110,66804,10715,32170,8927,56089,19753,9507,10246
43115,66810,10715,32173,8927,56094,19756,9508,10248
43120,66821,10717,32178,8928,56103,19759,9510,10249
43125,66825,10719,32179,8930,56106,19760,9510,10250
43130,66835,10720,32184,8931,56115,19762,9512,10250
43135,66841,10720,32189,8931,56120,19765,9515,10250
43140,66852,10725,32195,8935,56127,19768,9516,10252
43145,66856,10725,32197,8935,56131,19769,9516,10253
43150,66866,10727,32203,8937,56139,19771,9516,10255
43155,66872,10727,32206,8937,56145,19774,9517,10257
43160,66883,10728,32210,8938,56155,19777,9518,10259
43165,66887,10729,32212,8939,56158,19778,9519,10259
43170,66897,10729,32217,8939,56168,19780,9520,10260
43175,66903,10729,32221,8939,56174,19783,9522,10261
43180,66914,10730,32222,8939,56184,19786,9523,10263
43185,66918,10731,32224,8940,56187,19787,9524,10263
43190,66928,10732,32230,8941,56196,19789,9526,10263
43195,66934,10732,32232,8941,56202,19792,9527,10265
43200,66945,10735,32240,8944,56210,19795,9528,10267
43205,66949,10735,32241,8944,56214,19796,9528,10268
43210,66959,10735,32243,8944,56224,19798,9528,10270
43215,66965,10735,32246,8944,56230,19801,9529,10272
43220,66976,10738,32255,8946,56238,19804,9532,10272
43225,66980,10739,32257,8947,56241,19805,9533,10272
43230,66990,10740,32261,8948,56250,19807,9533,10274
43235,66996,10740,32263,8948,56256,19810,9533,10277
43240,67007,10742,32272,8950,56265,19813,9536,10277
43245,67011,10742,32273,8950,56269,19814,9536,10278
43250,67021,10745,32277,8952,56276,19816,9537,10279
43255,67027,10745,32280,8952,56281,19819,9538,10281
43260,67038,10750,32288,8956,56288,19822,9540,10282
43265,67042,10750,32290,8956,56292,19823,9541,10282
43270,67052,10753,32296,8959,56299,19825,9542,10283
43275,67058,10753,32300,8959,56305,19828,9544,10284
43280,67069,10755,32305,8961,56313,19831,9546,10285
43285,67073,10757,32308,8963,56316,19832,9546,10286
43290,67083,10758,32312,8964,56325,19834,9546,10288
43295,67089,10758,32315,8964,56330,19837,9547,10290
43300,67100,10760,32322,8966,56340,19840,9549,10291
43305,67104,10760,32323,8966,56344,19841,9550,10291
43310,67114,10761,32328,8967,56353,19843,9550,10293
43315,67120,10761,32329,8967,56359,19846,9551,10295
43320,67131,10761,32332,8967,56370,19849,9552,10297
43325,67135,10762,32333,8968,56373,19850,9552,10298
43330,67145,10763,32342,8969,56382,19852,9554,10298
43335,67151,10763,32345,8969,56388,19855,9557,10298
43340,67162,10763,32351,8969,56399,19858,9559,10299
43345,67166,10764,32354,8970,56402,19859,9559,10300
43350,67176,10765,32361,8971,56411,19861,9560,10301
43355,67182,10765,32364,8971,56416,19864,9562,10302
43360,67193,10767,32370,8973,56426,19867,9564,10303
43365,67197,10767,32372,8973,56430,19868,9565,10303
43370,67207,10768,32377,8973,56439,19870,9566,10304
43375,67213,10768,32378,8973,56445,19873,9567,10306
43380,67224,10768,32383,8973,56456,19876,9569,10307
43385,67228,10768,32384,8973,56460,19877,9569,10308
43390,67238,10770,32389,8975,56468,19879,9570,10309
43395,67244,10770,32391,8975,56474,19882,9571,10311
43400,67255,10772,32394,8977,56483,19885,9572,10313
43405,67259,10774,32398,8979,56485,19886,9573,10313
43410,67269,10777,32405,8982,56492,19888,9574,10314
43415,67275,10777,32406,8982,56498,19891,9574,10317
43420,67286,10778,32408,8982,56508,19894,9575,10319
43425,67290,10779,32410,8983,56511,19895,9576,10319
43430,67300,10782,32418,8986,56518,19897,9576,10321
43435,67306,10782,32422,8986,56524,19900,9579,10321
43440,67317,10784,32427,8988,56532,19903,9580,10323
43445,67321,10786,32429,8990,56535,19904,9580,10324
43450,67331,10789,32434,8992,56542,19906,9582,10324
43455,67337,10789,32437,8992,56547,19909,9584,10325
43460,67348,10794,32444,8997,56554,19911,9584,10327
43465,67352,10794,32447,8997,56558,19912,9585,10327
43470,67362,10795,32449,8997,56567,19914,9585,10329
43475,67368,10795,32453,8997,56572,19917,9587,10330
43480,67379,10797,32457,8998,56582,19919,9589,10330
43485,67383,10797,32457,8998,56586,19920,9589,10331
43490,67393,10798,32463,8999,56595,19922,9590,10332
43495,67399,10798,32466,8999,56600,19925,9592,10333
43500,67410,10802,32471,9002,56608,19927,9592,10335
43505,67414,10802,32472,9002,56612,19928,9592,10336
43510,67424,10804,32477,9004,56620,19930,9593,10337
43515,67430,10804,32479,9004,56625,19933,9593,10340
43520,67441,10809,32486,9008,56631,19935,9594,10341
43525,67445,10810,32487,9009,56635,19936,9595,10341
43530,67455,10812,32492,9010,56643,19938,9596,10342
43535,67461,10812,32495,9010,56649,19941,9598,10343
43540,67472,10813,32500,9010,56658,19943,9599,10344
43545,67476,10814,32502,9011,56662,19944,9600,10344
43550,67486,10816,32507,9012,56670,19946,9602,10344
43555,67492,10816,32511,9012,56675,19949,9604,10345
43560,67503,10818,32514,9013,56685,19952,9606,10346
43565,67507,10819,32515,9014,56688,19953,9606,10347
43570,67517,10821,32520,9015,56696,19955,9608,10347
43575,67523,10821,32523,9015,56702,19958,9610,10348
43580,67534,10822,32528,9016,56712,19961,9613,10348
43585,67538,10823,32530,9017,56715,19962,9613,10349
43590,67548,10825,32534,9018,56723,19964,9614,10350
43595,67554,10825,32537,9018,56728,19967,9615,10352
43600,67565,10829,32544,9021,56735,19970,9617,10353
43605,67569,10832,32546,9024,56737,19971,9617,10354
43610,67579,10834,32552,9025,56745,19973,9619,10354
43615,67585,10834,32556,9025,56750,19976,9622,10354
43620,67596,10839,32564,9030,56756,19979,9624,10355
43625,67600,10841,32565,9032,56759,19980,9624,10356
43630,67610,10843,32572,9034,56767,19982,9626,10356
43635,67616,10843,32576,9034,56772,19985,9628,10357
43640,67627,10848,32582,9039,56778,19988,9628,10360
43645,67631,10851,32586,9042,56780,19989,9629,10360
43650,67641,10852,32589,9042,56789,19991,9629,10362
43655,67647,10852,32593,9042,56794,19994,9632,10362
43660,67658,10853,32596,9043,56805,19997,9634,10363
43665,67662,10853,32597,9043,56809,19998,9635,10363
43670,67672,10854,32601,9044,56818,20000,9636,10364
43675,67678,10854,32605,9044,56823,20003,9638,10365
43680,67689,10856,32610,9046,56833,20006,9640,10366
43685,67693,10856,32612,9046,56837,20007,9641,10366
43690,67703,10857,32612,9046,56846,20009,9641,10368
43695,67709,10857,32615,9046,56851,20012,9642,10370
43700,67720,10859,32618,9048,56860,20015,9642,10373
43705,67724,10860,32620,9049,56864,20016,9643,10373
43710,67734,10861,32627,9050,56873,20018,9645,10373
43715,67740,10861,32632,9050,56878,20021,9647,10374
43720,67751,10863,32636,9052,56888,20024,9647,10377
43725,67755,10863,32638,9052,56892,20025,9648,10377
43730,67765,10864,32642,9052,56901,20027,9650,10377
43735,67771,10864,32645,9052,56907,20030,9651,10379
43740,67782,10864,32649,9052,56917,20033,9652,10381
43745,67786,10866,32651,9054,56920,20034,9652,10382
43750,67796,10867,32656,9055,56929,20036,9653,10383
43755,67802,10867,32659,9055,56935,20039,9655,10384
43760,67813,10870,32664,9057,56942,20042,9656,10386
43765,67817,10871,32665,9058,56946,20043,9657,10386
43770,67827,10873,32668,9060,56954,20045,9657,10388
43775,67833,10873,32672,9060,56960,20048,9660,10388
43780,67844,10874,32675,9060,56970,20051,9662,10389
43785,67848,10875,32678,9061,56973,20052,9663,10389
43790,67858,10876,32681,9062,56982,20054,9663,10391
43795,67864,10876,32684,9062,56987,20057,9663,10394
43800,67875,10879,32687,9065,56996,20060,9663,10397
43805,67879,10880,32690,9066,56999,20061,9664,10397
43810,67889,10882,32696,9068,57007,20063,9664,10399
43815,67895,10882,32698,9068,57013,20066,9665,10401
43820,67906,10885,32707,9071,57021,20069,9668,10401
43825,67910,10886,32709,9072,57024,20070,9668,10402
43830,67920,10888,32715,9074,57032,20072,9670,10402
43835,67926,10888,32718,9074,57038,20075,9671,10404
43840,67937,10890,32725,9076,57047,20078,9673,10405
43845,67941,10890,32726,9076,57051,20079,9674,10405
43850,67951,10890,32727,9076,57061,20081,9674,10407
43855,67957,10890,32730,9076,57067,20084,9675,10409
43860,67968,10891,32735,9076,57077,20087,9677,10410
43865,67972,10891,32736,9076,57081,20088,9677,10411
43870,67982,10892,32742,9077,57090,20090,9677,10413
43875,67988,10892,32745,9077,57096,20093,9679,10414
43880,67999,10894,32752,9078,57105,20096,9681,10415
43885,68003,10895,32754,9079,57108,20097,9682,10415
43890,68013,10896,32759,9080,57117,20099,9683,10416
43895,68019,10896,32764,9080,57123,20102,9686,10416
43900,68030,10898,32768,9082,57132,20105,9687,10418
43905,68034,10899,32770,9083,57135,20106,9687,10419
43910,68044,10900,32775,9084,57144,20108,9687,10421
43915,68050,10900,32777,9084,57150,20111,9689,10422
43920,68061,10903,32782,9086,57157,20114,9690,10424
43925,68065,10906,32784,9089,57159,20115,9690,10425
43930,68075,10909,32790,9091,57166,20117,9692,10425
43935,68081,10909,32792,9091,57171,20120,9692,10428
43940,68092,10911,32795,9093,57181,20123,9692,10431
43945,68096,10912,32797,9094,57184,20124,9692,10432
43950,68106,10913,32799,9094,57193,20126,9692,10434
43955,68112,10913,32802,9094,57198,20129,9693,10436
43960,68123,10918,32808,9099,57205,20132,9694,10438
43965,68127,10919,32811,9100,57208,20133,9695,10438
43970,68137,10921,32815,9101,57216,20135,9697,10438
43975,68143,10921,32817,9101,57221,20138,9697,10441
43980,68154,10924,32820,9103,57230,20141,9697,10444
43985,68158,10925,32822,9104,57233,20142,9698,10444
43990,68168,10926,32827,9104,57242,20144,9699,10445
43995,68174,10926,32832,9104,57247,20147,9702,10445
44000,68185,10931,32841,9109,57253,20150,9705,10445
44005,68189,10933,32842,9111,57256,20151,9705,10446
44010,68199,10935,32845,9112,57264,20153,9706,10447
44015,68205,10935,32846,9112,57270,20156,9707,10449
44020,68216,10937,32850,9113,57279,20159,9708,10451
44025,68220,10937,32852,9113,57283,20160,9709,10451
44030,68230,10939,32859,9115,57291,20162,9711,10451
44035,68236,10939,32860,9115,57297,20165,9711,10454
44040,68247,10942,32865,9118,57305,20168,9712,10456
44045,68251,10943,32868,9119,57308,20169,9713,10456
44050,68261,10944,32875,9120,57317,20171,9715,10456
44055,68267,10944,32877,9120,57322,20174,9716,10458
44060,68278,10946,32883,9122,57331,20177,9718,10459
44065,68282,10948,32884,9124,57334,20178,9718,10460
44070,68292,10949,32887,9124,57343,20180,9718,10462
44075,68298,10949,32888,9124,57349,20183,9719,10464
44080,68309,10949,32894,9124,57360,20186,9722,10464
44085,68313,10950,32896,9125,57363,20187,9722,10465
44090,68323,10951,32901,9125,57372,20189,9723,10466
44095,68329,10951,32903,9125,57377,20192,9723,10469
44100,68340,10953,32907,9127,57387,20195,9724,10471
44105,68344,10953,32909,9127,57391,20196,9725,10471
44110,68354,10954,32914,9128,57400,20198,9726,10472
44115,68360,10954,32916,9128,57405,20201,9727,10474
44120,68371,10955,32918,9129,57415,20203,9727,10476
44125,68375,10956,32920,9130,57419,20204,9728,10476
44130,68385,10957,32925,9130,57428,20206,9729,10477
44135,68391,10957,32927,9130,57433,20209,9730,10479
44140,68402,10958,32933,9131,57444,20211,9731,10480
44145,68406,10958,32936,9131,57448,20212,9732,10480
44150,68416,10960,32940,9132,57456,20214,9733,10481
44155,68422,10960,32941,9132,57462,20217,9734,10483
44160,68433,10962,32947,9134,57471,20219,9735,10484
44165,68437,10963,32951,9135,57474,20220,9736,10484
44170,68447,10965,32957,9137,57482,20222,9737,10485
44175,68453,10965,32961,9137,57487,20225,9738,10487
44180,68464,10968,32966,9140,57496,20227,9739,10488
44185,68468,10969,32968,9141,57499,20228,9739,10489
44190,68478,10972,32975,9144,57506,20230,9739,10491
44195,68484,10972,32978,9144,57511,20233,9741,10492
44200,68495,10975,32983,9147,57519,20235,9742,10493
44205,68499,10977,32984,9149,57522,20236,9742,10494
44210,68509,10979,32990,9151,57530,20238,9744,10494
44215,68515,10979,32994,9151,57535,20241,9747,10494
44220,68526,10981,32999,9152,57544,20244,9749,10495
44225,68530,10983,33001,9154,57547,20245,9750,10495
44230,68540,10985,33003,9155,57555,20247,9750,10497
44235,68546,10985,33006,9155,57560,20250,9751,10499
44240,68557,10989,33011,9158,57567,20253,9751,10502
44245,68561,10991,33012,9160,57570,20254,9751,10503
44250,68571,10993,33018,9161,57578,20256,9752,10504
44255,68577,10993,33019,9161,57584,20259,9753,10506
44260,68588,10994,33024,9162,57593,20262,9756,10506
44265,68592,10995,33024,9163,57597,20263,9756,10507
44270,68602,10996,33027,9163,57606,20265,9757,10508
44275,68608,10996,33031,9163,57611,20268,9758,10510
44280,68619,10999,33037,9166,57620,20271,9760,10511
44285,68623,10999,33039,9166,57624,20272,9761,10511
44290,68633,11001,33043,9167,57632,20274,9762,10512
44295,68639,11001,33047,9167,57638,20277,9765,10512
44300,68650,11003,33052,9168,57647,20280,9766,10514
44305,68654,11005,33055,9170,57649,20281,9767,10514
44310,68664,11007,33058,9171,57657,20283,9768,10515
44315,68670,11007,33063,9171,57663,20286,9771,10515
44320,68681,11010,33066,9173,57671,20289,9771,10518
44325,68685,11011,33068,9174,57674,20290,9771,10519
44330,68695,11012,33073,9175,57683,20292,9773,10519
44335,68701,11012,33077,9175,57689,20295,9776,10519
44340,68712,11015,33084,9177,57697,20298,9779,10519
44345,68716,11017,33088,9179,57699,20299,9780,10519
44350,68726,11019,33092,9180,57707,20301,9782,10519
44355,68732,11019,33097,9180,57712,20304,9785,10519
44360,68743,11022,33100,9183,57721,20307,9785,10522
44365,68747,11024,33103,9185,57723,20308,9785,10523
44370,68757,11027,33109,9188,57730,20310,9787,10523
44375,68763,11027,33112,9188,57735,20313,9788,10525
44380,68774,11031,33117,9191,57742,20316,9788,10528
44385,68778,11032,33119,9192,57746,20317,9789,10528
44390,68788,11033,33121,9192,57755,20319,9789,10530
44395,68794,11033,33123,9192,57760,20322,9790,10532
44400,68805,11034,33129,9193,57771,20325,9792,10533
44405,68809,11034,33131,9193,57775,20326,9793,10533
44410,68819,11035,33136,9193,57784,20328,9794,10534
44415,68825,11035,33138,9193,57790,20331,9796,10535
44420,68836,11035,33144,9193,57801,20334,9797,10537
44425,68840,11035,33146,9193,57805,20335,9798,10537
44430,68850,11036,33150,9194,57814,20337,9798,10539
44435,68856,11036,33152,9194,57820,20340,9799,10541
44440,68867,11037,33157,9195,57829,20343,9800,10543
44445,68871,11038,33159,9196,57833,20344,9800,10544
44450,68881,11039,33162,9197,57842,20346,9801,10545
44455,68887,11039,33165,9197,57847,20349,9802,10547
44460,68898,11041,33170,9199,57856,20352,9804,10548
44465,68902,11043,33172,9201,57859,20353,9804,10549
44470,68912,11043,33178,9201,57869,20355,9805,10550
44475,68918,11043,33180,9201,57875,20358,9807,10551
44480,68929,11043,33185,9201,57886,20361,9808,10553
44485,68933,11043,33187,9201,57890,20362,9809,10553
44490,68943,11043,33191,9201,57900,20364,9810,10554
44495,68949,11043,33193,9201,57906,20367,9810,10557
44500,68960,11045,33198,9203,57915,20370,9812,10558
44505,68964,11045,33199,9203,57919,20371,9812,10559
44510,68974,11045,33201,9203,57929,20373,9812,10561
44515,68980,11045,33202,9203,57935,20376,9812,10564
44520,68991,11046,33210,9203,57945,20379,9815,10564
44525,68995,11046,33212,9203,57949,20380,9815,10565
44530,69005,11048,33216,9205,57957,20382,9815,10567
44535,69011,11048,33217,9205,57963,20385,9816,10569
44540,69022,11050,33221,9206,57972,20388,9816,10572
44545,69026,11051,33223,9207,57975,20389,9816,10573
44550,69036,11051,33224,9207,57985,20391,9816,10575
44555,69042,11051,33227,9207,57991,20394,9817,10577
44560,69053,11053,33232,9208,58000,20397,9819,10578
44565,69057,11053,33235,9208,58004,20398,9820,10578
44570,69067,11055,33238,9210,58012,20400,9820,10580
44575,69073,11055,33240,9210,58018,20403,9821,10582
44580,69084,11057,33243,9212,58027,20406,9822,10584
44585,69088,11057,33245,9212,58031,20407,9823,10584
44590,69098,11058,33249,9213,58040,20409,9824,10585
44595,69104,11058,33251,9213,58045,20412,9825,10587
44600,69115,11060,33256,9215,58054,20415,9827,10588
44605,69119,11062,33258,9217,58057,20416,9828,10588
44610,69129,11063,33261,9217,58066,20418,9830,10588
44615,69135,11063,33264,9217,58071,20421,9831,10590
44620,69146,11067,33273,9221,58078,20424,9833,10591
44625,69150,11070,33276,9224,58080,20425,9833,10592
44630,69160,11072,33282,9226,58088,20427,9833,10594
44635,69166,11072,33286,9226,58093,20430,9834,10596
44640,69177,11075,33290,9228,58101,20433,9835,10598
44645,69181,11076,33290,9229,58105,20434,9835,10599
44650,69191,11078,33294,9231,58113,20436,9836,10600
44655,69197,11078,33297,9231,58118,20439,9837,10602
44660,69208,11082,33302,9234,58126,20442,9839,10603
44665,69212,11083,33304,9235,58129,20443,9839,10604
44670,69222,11086,33309,9237,58136,20445,9841,10604
44675,69228,11086,33314,9237,58142,20448,9844,10604
44680,69239,11089,33321,9240,58149,20451,9845,10606
44685,69243,11091,33324,9242,58152,20452,9846,10606
44690,69253,11093,33327,9244,58160,20454,9846,10608
44695,69259,11093,33329,9244,58166,20457,9847,10610
44700,69270,11094,33335,9244,58176,20460,9850,10610
44705,69274,11095,33336,9245,58179,20461,9850,10611
44710,69284,11097,33339,9246,58187,20463,9850,10613
44715,69290,11097,33340,9246,58192,20466,9850,10616
44720,69301,11100,33346,9248,58200,20469,9852,10617
44725,69305,11101,33346,9249,58204,20470,9852,10618
44730,69315,11103,33351,9250,58212,20472,9853,10619
44735,69321,11103,33353,9250,58217,20475,9853,10622
44740,69332,11107,33359,9254,58224,20478,9854,10624
44745,69336,11110,33362,9257,58226,20479,9854,10625
44750,69346,11112,33368,9258,58234,20481,9856,10625
44755,69352,11112,33371,9258,58239,20484,9857,10627
44760,69363,11115,33376,9260,58247,20487,9859,10628
44765,69367,11118,33379,9263,58249,20488,9860,10628
44770,69377,11120,33383,9265,58257,20490,9862,10628
44775,69383,11120,33384,9265,58262,20493,9862,10631
44780,69394,11122,33388,9266,58271,20495,9863,10632
44785,69398,11124,33391,9268,58274,20496,9864,10632
44790,69408,11126,33396,9270,58282,20498,9866,10632
44795,69414,11126,33399,9270,58288,20501,9868,10633
44800,69425,11127,33401,9271,58298,20503,9869,10634
44805,69429,11128,33402,9272,58301,20504,9869,10635
44810,69439,11130,33407,9274,58309,20506,9869,10637
44815,69445,11130,33411,9274,58315,20509,9871,10638
44820,69456,11134,33417,9277,58321,20511,9872,10639
44825,69460,11135,33417,9278,58325,20512,9872,10640
44830,69470,11137,33421,9279,58333,20514,9873,10641
44835,69476,11137,33423,9279,58339,20517,9875,10642
44840,69487,11139,33428,9280,58348,20519,9876,10643
44845,69491,11139,33430,9280,58352,20520,9876,10644
44850,69501,11142,33436,9282,58359,20522,9877,10645
44855,69507,11142,33441,9282,58364,20525,9879,10646
44860,69518,11145,33448,9285,58373,20527,9881,10646
44865,69522,11145,33450,9285,58377,20528,9882,10646
44870,69532,11146,33454,9286,58386,20530,9883,10647
44875,69538,11146,33456,9286,58392,20533,9884,10649
44880,69549,11147,33458,9286,58401,20536,9884,10652
44885,69553,11149,33459,9288,58404,20537,9884,10653
44890,69563,11151,33467,9290,58412,20539,9886,10653
44895,69569,11151,33470,9290,58417,20542,9887,10655
44900,69580,11153,33475,9292,58426,20545,9889,10656
44905,69584,11155,33476,9294,58429,20546,9889,10657
44910,69594,11157,33481,9296,58437,20548,9889,10659
44915,69600,11157,33483,9296,58442,20551,9890,10661
44920,69611,11159,33484,9297,58452,20554,9891,10663
44925,69615,11160,33486,9298,58455,20555,9891,10664
44930,69625,11162,33490,9299,58463,20557,9891,10666
44935,69631,11162,33493,9299,58469,20560,9892,10668
44940,69642,11164,33498,9301,58478,20563,9893,10670
44945,69646,11165,33502,9302,58481,20564,9894,10670
44950,69656,11166,33505,9302,58490,20566,9895,10671
44955,69662,11166,33508,9302,58496,20569,9896,10673
44960,69673,11166,33513,9302,58507,20572,9897,10675
44965,69677,11167,33516,9303,58510,20573,9897,10676
44970,69687,11168,33521,9304,58519,20575,9897,10678
44975,69693,11168,33524,9304,58524,20578,9899,10679
44980,69704,11169,33528,9305,58535,20581,9900,10681
44985,69708,11170,33531,9306,58538,20582,9900,10682
44990,69718,11171,33536,9307,58547,20584,9900,10684
44995,69724,11171,33538,9307,58553,20587,9902,10685
45000,69735,11172,33545,9308,58562,20590,9904,10686
45005,69739,11173,33546,9309,58566,20591,9905,10686
45010,69749,11174,33550,9309,58575,20593,9906,10687
45015,69755,11174,33553,9309,58581,20596,9909,10687
45020,69766,11175,33559,9310,58591,20599,9911,10688
45025,69770,11175,33559,9310,58595,20600,9911,10689
45030,69780,11176,33566,9311,58604,20602,9913,10689
45035,69786,11176,33570,9311,58609,20605,9915,10690
45040,69797,11177,33574,9312,58620,20608,9916,10692
45045,69801,11177,33576,9312,58624,20609,9916,10693
45050,69811,11179,33581,9313,58632,20611,9916,10695
45055,69817,11179,33584,9313,58638,20614,9917,10697
45060,69828,11181,33589,9315,58647,20617,9918,10699
45065,69832,11182,33590,9316,58650,20618,9918,10700
45070,69842,11183,33592,9316,58659,20620,9919,10701
45075,69848,11183,33596,9316,58665,20623,9922,10701
45080,69859,11187,33603,9320,58672,20626,9923,10703
45085,69863,11187,33604,9320,58676,20627,9923,10704
45090,69873,11189,33607,9321,58684,20629,9924,10705
45095,69879,11189,33612,9321,58690,20632,9927,10705
45100,69890,11191,33614,9322,58699,20635,9927,10708
45105,69894,11192,33617,9323,58702,20636,9928,10708
45110,69904,11195,33625,9326,58709,20638,9930,10708
45115,69910,11195,33629,9326,58715,20641,9932,10709
45120,69921,11197,33634,9328,58724,20644,9933,10711
45125,69925,11199,33636,9330,58726,20645,9933,10712
45130,69935,11200,33640,9330,58735,20647,9934,10713
45135,69941,11200,33644,9330,58741,20650,9936,10714
45140,69952,11202,33651,9332,58749,20653,9939,10714
45145,69956,11204,33653,9334,58752,20654,9939,10715
45150,69966,11205,33656,9335,58761,20656,9940,10716
45155,69972,11205,33661,9335,58766,20659,9942,10717
45160,69983,11210,33667,9339,58772,20662,9943,10719
45165,69987,11213,33671,9342,58774,20663,9944,10719
45170,69997,11216,33677,9344,58781,20665,9944,10721
45175,70003,11216,33681,9344,58786,20668,9946,10722
45180,70014,11220,33686,9347,58794,20671,9948,10723
45185,70018,11220,33687,9347,58798,20672,9948,10724
45190,70028,11221,33690,9347,58807,20674,9950,10724
45195,70034,11221,33693,9347,58813,20677,9952,10725
45200,70045,11222,33698,9347,58822,20680,9954,10726
45205,70049,11225,33702,9350,58824,20681,9955,10726
45210,70059,11227,33707,9352,58832,20683,9955,10728
45215,70065,11227,33711,9352,58837,20686,9957,10729
45220,70076,11230,33717,9355,58845,20689,9959,10730
45225,70080,11232,33718,9357,58848,20690,9959,10731
45230,70090,11233,33722,9358,58857,20692,9961,10731
45235,70096,11233,33725,9358,58862,20695,9962,10733
45240,70107,11238,33733,9362,58869,20698,9964,10734
45245,70111,11239,33735,9363,58872,20699,9965,10734
45250,70121,11240,33738,9364,58881,20701,9967,10734
45255,70127,11240,33739,9364,58887,20704,9967,10737
45260,70138,11243,33746,9366,58895,20707,9968,10739
45265,70142,11244,33748,9367,58898,20708,9968,10740
45270,70152,11244,33753,9367,58908,20710,9969,10741
45275,70158,11244,33756,9367,58914,20713,9969,10744
45280,70169,11244,33763,9367,58925,20716,9972,10744
45285,70173,11244,33765,9367,58929,20717,9972,10745
45290,70183,11244,33770,9367,58939,20719,9973,10746
45295,70189,11244,33771,9367,58945,20722,9974,10748
45300,70200,11244,33775,9367,58956,20725,9976,10749
45305,70204,11244,33777,9367,58960,20726,9976,10750
45310,70214,11244,33781,9367,58970,20728,9977,10751
45315,70220,11244,33783,9367,58976,20731,9977,10754
45320,70231,11244,33790,9367,58987,20734,9980,10754
45325,70235,11244,33791,9367,58991,20735,9981,10754
45330,70245,11244,33797,9367,59001,20737,9982,10755
45335,70251,11244,33799,9367,59007,20740,9983,10757
45340,70262,11244,33805,9367,59018,20743,9983,10760
45345,70266,11244,33805,9367,59022,20744,9983,10761
45350,70276,11245,33807,9367,59031,20746,9983,10763
45355,70282,11245,33810,9367,59037,20749,9985,10764
45360,70293,11246,33814,9368,59046,20752,9987,10765
45365,70297,11248,33815,9370,59049,20753,9987,10766
45370,70307,11249,33819,9371,59058,20755,9988,10767
45375,70313,11249,33821,9371,59064,20758,9990,10768
45380,70324,11252,33827,9373,59072,20761,9993,10768
45385,70328,11254,33829,9375,59074,20762,9993,10769
45390,70338,11256,33834,9377,59082,20764,9994,10770
45395,70344,11256,33835,9377,59087,20767,9994,10773
45400,70355,11258,33839,9378,59096,20770,9996,10774
45405,70359,11260,33841,9380,59099,20771,9997,10774
45410,70369,11261,33846,9381,59108,20773,9998,10775
45415,70375,11261,33851,9381,59113,20776,10001,10775
45420,70386,11264,33856,9384,59122,20779,10001,10778
45425,70390,11264,33858,9384,59126,20780,10002,10778
45430,70400,11267,33862,9387,59133,20782,10002,10780
45435,70406,11267,33865,9387,59139,20785,10005,10780
45440,70417,11270,33869,9389,59146,20787,10005,10782
45445,70421,11272,33872,9391,59149,20788,10006,10782
45450,70431,11273,33875,9391,59158,20790,10007,10783
45455,70437,11273,33877,9391,59163,20793,10008,10785
45460,70448,11277,33884,9395,59170,20795,10009,10786
45465,70452,11279,33887,9397,59173,20796,10009,10787
45470,70462,11280,33891,9398,59182,20798,10009,10789
45475,70468,11280,33892,9398,59187,20801,10009,10792
45480,70479,11284,33899,9401,59194,20803,10010,10793
45485,70483,11285,33899,9402,59198,20804,10010,10794
45490,70493,11288,33906,9404,59205,20806,10012,10794
45495,70499,11288,33909,9404,59211,20809,10013,10796
45500,70510,11289,33912,9404,59221,20811,10015,10796
45505,70514,11290,33914,9405,59224,20812,10015,10797
45510,70524,11291,33918,9406,59233,20814,10015,10799
45515,70530,11291,33921,9406,59238,20817,10016,10801
45520,70541,11295,33929,9409,59245,20819,10017,10802
45525,70545,11297,33931,9411,59248,20820,10018,10802
45530,70555,11299,33936,9412,59256,20822,10019,10803
45535,70561,11299,33940,9412,59261,20825,10021,10804
45540,70572,11303,33945,9416,59269,20828,10021,10807
45545,70576,11304,33946,9417,59272,20829,10021,10808
45550,70586,11306,33951,9419,59280,20831,10021,10810
45555,70592,11306,33954,9419,59286,20834,10022,10812
45560,70603,11309,33961,9422,59294,20837,10024,10813
45565,70607,11310,33962,9423,59297,20838,10024,10814
45570,70617,11313,33968,9426,59304,20840,10025,10815
45575,70623,11313,33971,9426,59310,20843,10027,10816
45580,70634,11315,33975,9428,59318,20846,10028,10818
45585,70638,11316,33975,9429,59322,20847,10028,10819
45590,70648,11318,33980,9430,59330,20849,10030,10819
45595,70654,11318,33981,9430,59336,20852,10031,10821
45600,70665,11320,33986,9431,59344,20855,10033,10822
45605,70669,11322,33987,9433,59347,20856,10033,10823
45610,70679,11324,33991,9434,59355,20858,10034,10824
45615,70685,11324,33993,9434,59361,20861,10036,10825
45620,70696,11326,33998,9436,59369,20864,10037,10827
45625,70700,11329,34000,9439,59371,20865,10037,10828
45630,70710,11330,34006,9439,59380,20867,10038,10829
45635,70716,11330,34008,9439,59386,20870,10039,10831
45640,70727,11332,34011,9440,59394,20873,10040,10833
45645,70731,11334,34014,9442,59397,20874,10041,10833
45650,70741,11336,34017,9443,59405,20876,10042,10834
45655,70747,11336,34019,9443,59410,20879,10043,10836
45660,70758,11339,34023,9445,59419,20882,10046,10836
45665,70762,11340,34026,9446,59422,20883,10047,10836
45670,70772,11341,34031,9447,59431,20885,10048,10837
45675,70778,11341,34035,9447,59437,20888,10050,10838
45680,70789,11342,34041,9448,59446,20891,10051,10840
45685,70793,11343,34043,9449,59450,20892,10052,10840
45690,70803,11344,34044,9449,59459,20894,10052,10842
45695,70809,11344,34048,9449,59464,20897,10054,10843
45700,70820,11346,34054,9451,59473,20900,10055,10845
45705,70824,11348,34057,9453,59476,20901,10055,10846
45710,70834,11349,34063,9453,59485,20903,10057,10846
45715,70840,11349,34066,9453,59490,20906,10058,10848
45720,70851,11351,34073,9455,59500,20909,10059,10850
45725,70855,11351,34076,9455,59504,20910,10060,10850
45730,70865,11351,34082,9455,59514,20912,10062,10850
45735,70871,11351,34085,9455,59520,20915,10063,10852
45740,70882,11351,34090,9455,59531,20918,10065,10853
45745,70886,11351,34094,9455,59535,20919,10066,10853
45750,70896,11351,34098,9455,59545,20921,10067,10854
45755,70902,11351,34101,9455,59551,20924,10069,10855
45760,70913,11351,34104,9455,59562,20927,10070,10857
45765,70917,11351,34106,9455,59566,20928,10070,10858
45770,70927,11351,34110,9455,59576,20930,10071,10859
45775,70933,11351,34114,9455,59582,20933,10073,10860
45780,70944,11354,34122,9457,59590,20936,10075,10861
45785,70948,11354,34123,9457,59594,20937,10075,10862
45790,70958,11354,34128,9457,59604,20939,10077,10862
45795,70964,11354,34129,9457,59610,20942,10078,10864
45800,70975,11356,34136,9459,59619,20945,10080,10865
45805,70979,11357,34139,9460,59622,20946,10080,10866
45810,70989,11358,34144,9461,59631,20948,10080,10868
45815,70995,11358,34147,9461,59637,20951,10082,10869
45820,71006,11360,34153,9463,59646,20954,10083,10871
45825,71010,11361,34154,9464,59649,20955,10083,10872
45830,71020,11362,34157,9464,59658,20957,10084,10873
45835,71026,11362,34160,9464,59664,20960,10086,10874
45840,71037,11364,34164,9465,59673,20963,10089,10874
45845,71041,11365,34167,9466,59676,20964,10090,10874
45850,71051,11368,34173,9469,59683,20966,10090,10876
45855,71057,11368,34176,9469,59689,20969,10092,10877
45860,71068,11371,34180,9472,59697,20972,10092,10880
45865,71072,11372,34182,9473,59700,20973,10093,10880
45870,71082,11373,34187,9473,59709,20975,10094,10881
45875,71088,11373,34188,9473,59715,20978,10094,10884
45880,71099,11375,34192,9474,59723,20981,10096,10885
45885,71103,11376,34194,9475,59727,20982,10097,10885
45890,71113,11377,34198,9475,59736,20984,10098,10886
45895,71119,11377,34201,9475,59742,20987,10100,10887
45900,71130,11379,34206,9477,59751,20990,10102,10888
45905,71134,11381,34209,9479,59753,20991,10103,10888
45910,71144,11383,34217,9481,59761,20993,10105,10888
45915,71150,11383,34221,9481,59766,20996,10106,10890
45920,71161,11387,34228,9484,59773,20999,10109,10890
45925,71165,11390,34231,9487,59775,21000,10110,10890
45930,71175,11393,34236,9489,59782,21002,10112,10890
45935,71181,11393,34238,9489,59788,21005,10114,10891
45940,71192,11395,34242,9490,59796,21008,10115,10893
45945,71196,11396,34244,9491,59800,21009,10116,10893
45950,71206,11399,34250,9493,59807,21011,10117,10894
45955,71212,11399,34255,9493,59812,21014,10120,10894
45960,71223,11402,34261,9496,59820,21017,10122,10895
45965,71227,11403,34262,9497,59824,21018,10123,10895
45970,71237,11405,34265,9498,59832,21020,10123,10897
45975,71243,11405,34266,9498,59838,21023,10124,10899
45980,71254,11407,34273,9499,59846,21026,10126,10900
45985,71258,11410,34277,9502,59848,21027,10127,10900
45990,71268,11413,34283,9505,59855,21029,10128,10901
45995,71274,11413,34286,9505,59860,21032,10129,10903
46000,71285,11418,34293,9509,59867,21035,10130,10905
46005,71289,11420,34296,9511,59869,21036,10130,10906
46010,71299,11421,34300,9511,59878,21038,10131,10907
46015,71305,11421,34302,9511,59884,21041,10133,10908
46020,71316,11423,34308,9512,59892,21044,10136,10908
46025,71320,11424,34308,9513,59896,21045,10136,10909
46030,71330,11425,34313,9514,59905,21047,10136,10911
46035,71336,11425,34317,9514,59911,21050,10139,10911
46040,71347,11425,34321,9514,59922,21053,10139,10914
46045,71351,11426,34324,9515,59925,21054,10140,10914
46050,71361,11427,34331,9516,59934,21056,10141,10915
46055,71367,11427,34334,9516,59940,21059,10143,10916
46060,71378,11427,34339,9516,59950,21062,10145,10917
46065,71382,11429,34341,9518,59953,21063,10145,10918
46070,71392,11430,34344,9518,59962,21065,10145,10920
46075,71398,11430,34348,9518,59967,21068,10146,10922
46080,71409,11431,34351,9519,59977,21071,10147,10924
46085,71413,11432,34352,9520,59981,21072,10147,10925
46090,71423,11433,34354,9520,59990,21074,10149,10925
46095,71429,11433,34355,9520,59996,21077,10149,10928
46100,71440,11434,34361,9521,60006,21079,10150,10929
46105,71444,11434,34363,9521,60010,21080,10150,10930
46110,71454,11435,34367,9522,60019,21082,10151,10931
46115,71460,11435,34371,9522,60025,21085,10154,10931
46120,71471,11436,34376,9523,60035,21087,10156,10931
46125,71475,11436,34377,9523,60039,21088,10156,10932
46130,71485,11438,34382,9524,60047,21090,10157,10933
46135,71491,11438,34385,9524,60052,21093,10158,10935
46140,71502,11441,34391,9527,60060,21095,10159,10936
46145,71506,11442,34393,9528,60064,21096,10159,10937
46150,71516,11444,34398,9529,60072,21098,10161,10937
46155,71522,11444,34402,9529,60078,21101,10164,10937
46160,71533,11446,34409,9530,60086,21103,10166,10937
46165,71537,11447,34411,9531,60090,21104,10167,10937
46170,71547,11448,34413,9531,60099,21106,10168,10938
46175,71553,11448,34414,9531,60105,21109,10169,10940
46180,71564,11452,34424,9535,60111,21111,10170,10941
46185,71568,11454,34426,9537,60114,21112,10170,10942
46190,71578,11455,34430,9537,60123,21114,10171,10943
46195,71584,11455,34431,9537,60129,21117,10172,10945
46200,71595,11458,34435,9539,60137,21120,10173,10947
46205,71599,11458,34437,9539,60141,21121,10174,10947
46210,71609,11460,34445,9541,60149,21123,10176,10947
46215,71615,11460,34450,9541,60154,21126,10179,10947
46220,71626,11464,34456,9545,60161,21129,10179,10950
46225,71630,11465,34457,9546,60165,21130,10180,10950
46230,71640,11466,34460,9546,60174,21132,10181,10951
46235,71646,11466,34461,9546,60180,21135,10182,10953
46240,71657,11469,34467,9549,60188,21138,10183,10955
46245,71661,11471,34470,9551,60190,21139,10184,10955
46250,71671,11472,34473,9551,60199,21141,10184,10957
46255,71677,11472,34475,9551,60204,21144,10185,10959
46260,71688,11476,34481,9555,60212,21147,10186,10961
46265,71692,11477,34483,9556,60215,21148,10187,10961
46270,71702,11479,34486,9558,60223,21150,10187,10963
46275,71708,11479,34489,9558,60229,21153,10189,10964
46280,71719,11481,34494,9559,60238,21156,10191,10965
46285,71723,11483,34497,9561,60240,21157,10192,10965
46290,71733,11486,34500,9563,60247,21159,10193,10966
46295,71739,11486,34501,9563,60253,21162,10194,10968
46300,71750,11489,34506,9566,60261,21165,10196,10969
46305,71754,11490,34507,9567,60264,21166,10196,10970
46310,71764,11492,34510,9568,60272,21168,10196,10972
46315,71770,11492,34513,9568,60278,21171,10198,10973
46320,71781,11495,34519,9571,60285,21174,10198,10976
46325,71785,11498,34522,9574,60287,21175,10199,10976
46330,71795,11501,34527,9576,60294,21177,10199,10978
46335,71801,11501,34529,9576,60300,21180,10200,10980
46340,71812,11503,34532,9577,60309,21183,10201,10982
46345,71816,11503,34534,9577,60313,21184,10202,10982
46350,71826,11505,34540,9579,60321,21186,10203,10983
46355,71832,11505,34542,9579,60326,21189,10204,10985
46360,71843,11508,34549,9581,60334,21192,10206,10986
46365,71847,11510,34550,9583,60337,21193,10206,10987
46370,71857,11511,34554,9583,60346,21195,10208,10987
46375,71863,11511,34556,9583,60351,21198,10208,10990
46380,71874,11515,34562,9587,60359,21201,10210,10991
46385,71878,11516,34565,9588,60362,21202,10210,10992
46390,71888,11517,34569,9589,60371,21204,10210,10994
46395,71894,11517,34573,9589,60377,21207,10212,10995
46400,71905,11517,34579,9589,60388,21210,10213,10997
46405,71909,11518,34580,9590,60391,21211,10213,10998
46410,71919,11519,34585,9590,60400,21213,10214,10999
46415,71925,11519,34587,9590,60406,21216,10215,11001
46420,71936,11520,34594,9591,60416,21219,10216,11003
46425,71940,11520,34595,9591,60420,21220,10216,11004
46430,71950,11521,34599,9591,60429,21222,10218,11004
46435,71956,11521,34602,9591,60435,21225,10220,11005
46440,71967,11521,34608,9591,60445,21228,10221,11007
46445,71971,11523,34611,9593,60448,21229,10222,11007
46450,71981,11524,34618,9594,60457,21231,10223,11008
46455,71987,11524,34621,9594,60462,21234,10225,11009
46460,71998,11525,34623,9595,60472,21237,10225,11012
46465,72002,11527,34624,9597,60475,21238,10225,11013
46470,72012,11528,34628,9598,60484,21240,10226,11014
46475,72018,11528,34630,9598,60490,21243,10228,11015
46480,72029,11529,34634,9599,60500,21246,10228,11018
46485,72033,11530,34635,9600,60503,21247,10228,11019
46490,72043,11532,34641,9602,60511,21249,10229,11020
46495,72049,11532,34643,9602,60517,21252,10231,11021
46500,72060,11535,34647,9604,60525,21255,10232,11023
46505,72064,11536,34649,9605,60528,21256,10233,11023
46510,72074,11537,34652,9605,60537,21258,10234,11024
46515,72080,11537,34655,9605,60542,21261,10234,11027
46520,72091,11541,34663,9609,60550,21264,10236,11028
46525,72095,11541,34664,9609,60554,21265,10237,11028
46530,72105,11543,34670,9611,60562,21267,10237,11030
46535,72111,11543,34671,9611,60568,21270,10238,11032
46540,72122,11544,34677,9611,60578,21273,10239,11034
46545,72126,11544,34680,9611,60582,21274,10240,11034
46550,72136,11544,34684,9611,60592,21276,10241,11035
46555,72142,11544,34685,9611,60598,21279,10241,11038
46560,72153,11546,34689,9613,60607,21282,10241,11041
46565,72157,11547,34693,9614,60610,21283,10242,11041
46570,72167,11548,34698,9615,60619,21285,10243,11042
46575,72173,11548,34700,9615,60625,21288,10243,11045
46580,72184,11550,34707,9617,60634,21291,10245,11046
46585,72188,11550,34708,9617,60638,21292,10245,11047
46590,72198,11552,34714,9619,60646,21294,10247,11047
46595,72204,11552,34717,9619,60652,21297,10248,11049
46600,72215,11555,34722,9621,60660,21300,10250,11050
46605,72219,11556,34723,9622,60663,21301,10250,11051
46610,72229,11558,34728,9624,60671,21303,10251,11052
46615,72235,11558,34730,9624,60677,21306,10252,11054
46620,72246,11560,34736,9626,60686,21309,10255,11054
46625,72250,11560,34738,9626,60690,21310,10256,11054
46630,72260,11563,34744,9628,60697,21312,10257,11055
46635,72266,11563,34747,9628,60703,21315,10259,11056
46640,72277,11565,34752,9630,60711,21318,10259,11059
46645,72281,11568,34755,9633,60713,21319,10260,11059
46650,72291,11569,34758,9633,60722,21321,10261,11060
46655,72297,11569,34763,9633,60727,21324,10263,11061
46660,72308,11573,34770,9636,60734,21327,10265,11062
46665,72312,11576,34774,9639,60736,21328,10266,11062
46670,72322,11578,34782,9641,60744,21330,10268,11062
46675,72328,11578,34783,9641,60750,21333,10268,11065
46680,72339,11580,34788,9643,60759,21336,10269,11067
46685,72343,11580,34788,9643,60763,21337,10269,11068
46690,72353,11582,34793,9645,60771,21339,10270,11069
46695,72359,11582,34794,9645,60777,21342,10271,11071
46700,72370,11583,34799,9646,60786,21345,10272,11073
46705,72374,11586,34803,9649,60788,21346,10273,11073
46710,72384,11589,34810,9652,60795,21348,10274,11074
46715,72390,11589,34813,9652,60800,21351,10276,11075
46720,72401,11590,34818,9653,60811,21354,10277,11077
46725,72405,11590,34820,9653,60815,21355,10278,11077
46730,72415,11591,34825,9653,60824,21357,10278,11079
46735,72421,11591,34828,9653,60829,21360,10280,11080
46740,72432,11593,34834,9655,60839,21363,10281,11082
46745,72436,11593,34835,9655,60843,21364,10282,11082
46750,72446,11594,34840,9655,60852,21366,10284,11082
46755,72452,11594,34842,9655,60857,21369,10285,11084
46760,72463,11596,34849,9657,60866,21371,10286,11085
46765,72467,11597,34851,9658,60870,21372,10287,11085
46770,72477,11598,34858,9659,60879,21374,10288,11086
46775,72483,11598,34862,9659,60884,21377,10291,11086
46780,72494,11600,34867,9661,60894,21379,10291,11088
46785,72498,11600,34869,9661,60898,21380,10292,11088
46790,72508,11601,34874,9661,60907,21382,10293,11089
46795,72514,11601,34878,9661,60912,21385,10294,11091
46800,72525,11603,34886,9663,60922,21387,10296,11091
46805,72529,11603,34888,9663,60926,21388,10296,11092
46810,72539,11604,34894,9663,60935,21390,10298,11092
46815,72545,11604,34896,9663,60940,21393,10299,11094
46820,72556,11607,34902,9665,60948,21395,10301,11094
46825,72560,11608,34904,9666,60952,21396,10302,11094
46830,72570,11609,34907,9667,60961,21398,10302,11096
46835,72576,11609,34911,9667,60966,21401,10305,11096
46840,72587,11611,34914,9668,60975,21403,10305,11098
46845,72591,11612,34915,9669,60979,21404,10306,11098
46850,72601,11613,34919,9670,60988,21406,10307,11099
46855,72607,11613,34923,9670,60994,21409,10309,11100
46860,72618,11615,34927,9672,61003,21412,10310,11102
46865,72622,11616,34928,9673,61006,21413,10310,11103
46870,72632,11619,34931,9675,61013,21415,10310,11105
46875,72638,11619,34935,9675,61018,21418,10311,11107
46880,72649,11624,34942,9680,61024,21421,10313,11108
46885,72653,11627,34944,9683,61026,21422,10313,11109
46890,72663,11630,34949,9685,61033,21424,10314,11110
46895,72669,11630,34953,9685,61038,21427,10316,11111
46900,72680,11633,34955,9687,61047,21430,10317,11113
46905,72684,11635,34958,9689,61049,21431,10317,11114
46910,72694,11637,34965,9691,61057,21433,10319,11114
46915,72700,11637,34969,9691,61062,21436,10322,11114
46920,72711,11642,34976,9695,61068,21439,10324,11115
46925,72715,11643,34978,9696,61072,21440,10324,11116
46930,72725,11645,34985,9698,61080,21442,10325,11117
46935,72731,11645,34988,9698,61086,21445,10326,11119
46940,72742,11647,34996,9700,61095,21448,10328,11120
46945,72746,11648,34999,9701,61098,21449,10329,11120
46950,72756,11650,35004,9703,61106,21451,10329,11122
46955,72762,11650,35006,9703,61112,21454,10329,11125
46960,72773,11652,35012,9705,61121,21457,10330,11127
46965,72777,11652,35015,9705,61125,21458,10331,11127
46970,72787,11654,35024,9707,61133,21460,10333,11127
46975,72793,11654,35027,9707,61139,21463,10335,11128
46980,72804,11656,35034,9708,61148,21466,10336,11130
46985,72808,11657,35037,9709,61151,21467,10336,11131
46990,72818,11658,35040,9710,61160,21469,10337,11132
46995,72824,11658,35042,9710,61166,21472,10338,11134
47000,72835,11660,35048,9712,61175,21475,10339,11136
47005,72839,11660,35051,9712,61179,21476,10339,11137
47010,72849,11660,35056,9712,61189,21478,10340,11138
47015,72855,11660,35058,9712,61195,21481,10341,11140
47020,72866,11660,35063,9712,61206,21484,10341,11143
47025,72870,11660,35065,9712,61210,21485,10341,11144
47030,72880,11661,35070,9713,61219,21487,10341,11146
47035,72886,11661,35071,9713,61224,21490,10341,11149
47040,72897,11662,35077,9714,61235,21493,10343,11150
47045,72901,11662,35079,9714,61239,21494,10343,11151
47050,72911,11663,35084,9714,61248,21496,10344,11152
47055,72917,11663,35088,9714,61253,21499,10346,11153
47060,72928,11665,35096,9716,61262,21502,10348,11154
47065,72932,11667,35098,9718,61265,21503,10349,11154
47070,72942,11668,35101,9718,61274,21505,10350,11155
47075,72948,11668,35103,9718,61280,21508,10351,11157
47080,72959,11668,35107,9718,61290,21511,10351,11160
47085,72963,11670,35109,9720,61293,21512,10352,11160
47090,72973,11671,35111,9720,61302,21514,10353,11161
47095,72979,11671,35116,9720,61307,21517,10355,11162
47100,72990,11673,35122,9722,61316,21520,10356,11164
47105,72994,11674,35123,9723,61320,21521,10356,11165
47110,73004,11676,35129,9724,61328,21523,10358,11165
47115,73010,11676,35129,9724,61334,21526,10358,11168
47120,73021,11677,35135,9725,61343,21529,10360,11169
47125,73025,11679,35136,9727,61346,21530,10360,11170
47130,73035,11681,35140,9728,61354,21532,10361,11171
47135,73041,11681,35144,9728,61360,21535,10363,11172
47140,73052,11682,35152,9729,61369,21538,10366,11172
47145,73056,11684,35155,9731,61372,21539,10367,11172
47150,73066,11687,35159,9734,61379,21541,10367,11174
47155,73072,11687,35162,9734,61385,21544,10368,11176
47160,73083,11689,35165,9736,61394,21547,10368,11179
47165,73087,11689,35165,9736,61398,21548,10368,11180
47170,73097,11692,35172,9738,61405,21550,10369,11181
47175,73103,11692,35174,9738,61411,21553,10370,11183
47180,73114,11694,35179,9739,61419,21556,10371,11185
47185,73118,11695,35180,9740,61423,21557,10372,11185
47190,73128,11698,35186,9743,61430,21559,10373,11186
47195,73134,11698,35189,9743,61435,21562,10374,11188
47200,73145,11701,35194,9746,61444,21565,10375,11190
47205,73149,11701,35196,9746,61448,21566,10376,11190
47210,73159,11703,35200,9748,61456,21568,10377,11191
47215,73165,11703,35204,9748,61462,21571,10379,11192
47220,73176,11707,35211,9752,61468,21574,10381,11193
47225,73180,11709,35213,9754,61471,21575,10382,11193
47230,73190,11710,35216,9754,61480,21577,10382,11195
47235,73196,11710,35219,9754,61486,21580,10384,11196
47240,73207,11712,35226,9756,61494,21583,10385,11198
47245,73211,11714,35227,9758,61497,21584,10385,11199
47250,73221,11715,35231,9758,61506,21586,10386,11200
47255,73227,11715,35234,9758,61512,21589,10387,11202
47260,73238,11716,35239,9759,61521,21592,10389,11203
47265,73242,11718,35241,9761,61524,21593,10389,11204
47270,73252,11719,35247,9762,61533,21595,10391,11204
47275,73258,11719,35248,9762,61539,21598,10391,11207
47280,73269,11720,35254,9762,61548,21601,10392,11209
47285,73273,11722,35256,9764,61551,21602,10392,11210
47290,73283,11723,35262,9765,61560,21604,10392,11212
47295,73289,11723,35265,9765,61565,21607,10393,11214
47300,73300,11725,35268,9766,61574,21610,10393,11217
47305,73304,11726,35270,9767,61578,21611,10394,11217
47310,73314,11727,35276,9767,61587,21613,10396,11217
47315,73320,11727,35279,9767,61593,21616,10398,11218
47320,73331,11729,35283,9768,61601,21619,10398,11221
47325,73335,11731,35286,9770,61604,21620,10399,11221
47330,73345,11732,35292,9771,61613,21622,10401,11221
47335,73351,11732,35294,9771,61619,21625,10402,11223
47340,73362,11734,35301,9773,61628,21628,10404,11224
47345,73366,11735,35303,9774,61631,21629,10404,11225
47350,73376,11736,35307,9775,61640,21631,10405,11226
47355,73382,11736,35308,9775,61646,21634,10406,11228
47360,73393,11740,35316,9779,61652,21637,10409,11228
47365,73397,11742,35318,9781,61655,21638,10409,11229
47370,73407,11744,35321,9783,61663,21640,10409,11231
47375,73413,11744,35324,9783,61669,21643,10411,11232
47380,73424,11745,35328,9783,61678,21646,10412,11234
47385,73428,11746,35329,9784,61682,21647,10413,11234
47390,73438,11747,35333,9784,61691,21649,10414,11235
47395,73444,11747,35338,9784,61697,21652,10417,11235
47400,73455,11749,35343,9786,61706,21655,10418,11237
47405,73459,11749,35345,9786,61710,21656,10419,11237
47410,73469,11752,35350,9788,61717,21658,10421,11237
47415,73475,11752,35354,9788,61722,21661,10422,11239
47420,73486,11755,35359,9790,61730,21663,10423,11240
47425,73490,11757,35362,9792,61733,21664,10424,11240
47430,73500,11758,35367,9793,61742,21666,10425,11241
47435,73506,11758,35371,9793,61747,21669,10428,11241
47440,73517,11761,35376,9796,61755,21671,10428,11243
47445,73521,11762,35378,9797,61759,21672,10429,11243
47450,73531,11764,35382,9799,61767,21674,10429,11245
47455,73537,11764,35386,9799,61773,21677,10431,11246
47460,73548,11768,35396,9803,61779,21679,10433,11246
47465,73552,11770,35399,9805,61782,21680,10434,11246
47470,73562,11773,35404,9808,61789,21682,10435,11247
47475,73568,11773,35405,9808,61795,21685,10436,11249
47480,73579,11776,35412,9811,61802,21687,10436,11251
47485,73583,11778,35414,9813,61805,21688,10436,11252
47490,73593,11781,35419,9815,61812,21690,10437,11253
47495,73599,11781,35422,9815,61818,21693,10439,11254
47500,73610,11783,35428,9817,61827,21695,10440,11255
47505,73614,11783,35430,9817,61831,21696,10441,11255
47510,73624,11785,35436,9819,61839,21698,10442,11256
47515,73630,11785,35438,9819,61845,21701,10443,11258
47520,73641,11789,35446,9823,61851,21704,10445,11259
47525,73645,11792,35449,9826,61853,21705,10445,11260
47530,73655,11794,35452,9827,61861,21707,10446,11261
47535,73661,11794,35457,9827,61867,21710,10449,11261
47540,73672,11797,35463,9829,61875,21713,10451,11262
47545,73676,11798,35465,9830,61878,21714,10452,11262
47550,73686,11799,35471,9831,61887,21716,10452,11264
47555,73692,11799,35471,9831,61893,21719,10452,11267
47560,73703,11800,35475,9832,61903,21722,10454,11268
47565,73707,11801,35476,9833,61906,21723,10454,11269
47570,73717,11802,35480,9834,61915,21725,10455,11270
47575,73723,11802,35482,9834,61921,21728,10456,11272
47580,73734,11802,35487,9834,61931,21731,10458,11273
47585,73738,11804,35490,9836,61934,21732,10459,11273
47590,73748,11805,35493,9837,61943,21734,10459,11275
47595,73754,11805,35498,9837,61948,21737,10461,11276
47600,73765,11806,35501,9838,61959,21740,10461,11279
47605,73769,11806,35502,9838,61963,21741,10462,11279
47610,73779,11807,35505,9838,61972,21743,10464,11279
47615,73785,11807,35508,9838,61978,21746,10465,11281
47620,73796,11808,35514,9839,61987,21749,10467,11282
47625,73800,11809,35517,9840,61991,21750,10468,11282
47630,73810,11810,35523,9841,62000,21752,10469,11283
47635,73816,11810,35526,9841,62006,21755,10471,11284
47640,73827,11810,35531,9841,62016,21758,10473,11285
47645,73831,11813,35535,9844,62018,21759,10474,11285
47650,73841,11815,35539,9845,62026,21761,10475,11286
47655,73847,11815,35542,9845,62032,21764,10476,11288
47660,73858,11817,35546,9847,62040,21767,10477,11290
47665,73862,11818,35546,9848,62044,21768,10477,11291
47670,73872,11819,35548,9849,62053,21770,10477,11293
47675,73878,11819,35553,9849,62058,21773,10479,11294
47680,73889,11823,35561,9853,62066,21776,10481,11295
47685,73893,11824,35563,9854,62069,21777,10481,11296
47690,73903,11826,35566,9855,62077,21779,10482,11297
47695,73909,11826,35570,9855,62082,21782,10484,11298
47700,73920,11829,35575,9858,62090,21785,10485,11300
47705,73924,11831,35577,9860,62093,21786,10486,11300
47710,73934,11832,35583,9861,62102,21788,10488,11300
47715,73940,11832,35585,9861,62108,21791,10489,11302
47720,73951,11835,35589,9863,62116,21794,10490,11304
47725,73955,11836,35590,9864,62119,21795,10490,11305
47730,73965,11836,35594,9864,62129,21797,10490,11307
47735,73971,11836,35596,9864,62135,21800,10492,11308
47740,73982,11838,35601,9865,62144,21803,10493,11310
47745,73986,11839,35604,9866,62147,21804,10494,11310
47750,73996,11841,35610,9868,62155,21806,10495,11311
47755,74002,11841,35614,9868,62161,21809,10497,11312
47760,74013,11843,35617,9869,62170,21812,10497,11315
47765,74017,11844,35619,9870,62173,21813,10498,11315
47770,74027,11846,35625,9872,62181,21815,10500,11315
47775,74033,11846,35629,9872,62187,21818,10502,11316
47780,74044,11847,35636,9873,62197,21821,10505,11316
47785,74048,11848,35638,9874,62200,21822,10505,11317
47790,74058,11848,35641,9874,62210,21824,10506,11318
47795,74064,11848,35644,9874,62216,21827,10507,11320
47800,74075,11851,35651,9877,62224,21830,10508,11322
47805,74079,11852,35653,9878,62227,21831,10508,11323
47810,74089,11854,35660,9880,62235,21833,10509,11324
47815,74095,11854,35660,9880,62241,21836,10509,11327
47820,74106,11857,35665,9883,62249,21839,10511,11328
47825,74110,11858,35666,9884,62252,21840,10511,11329
47830,74120,11859,35671,9885,62261,21842,10513,11329
47835,74126,11859,35674,9885,62266,21845,10513,11332
47840,74137,11860,35677,9886,62276,21848,10514,11334
47845,74141,11861,35678,9887,62280,21849,10514,11335
47850,74151,11862,35683,9888,62289,21851,10515,11336
47855,74157,11862,35686,9888,62295,21854,10516,11338
47860,74168,11862,35693,9888,62305,21857,10518,11339
47865,74172,11864,35695,9890,62308,21858,10518,11340
47870,74182,11865,35700,9891,62317,21860,10519,11341
47875,74188,11865,35704,9891,62322,21863,10520,11343
47880,74199,11866,35709,9892,62332,21866,10521,11345
47885,74203,11867,35710,9893,62336,21867,10521,11346
47890,74213,11868,35712,9893,62345,21869,10522,11347
47895,74219,11868,35716,9893,62351,21872,10524,11348
47900,74230,11868,35719,9893,62362,21875,10525,11350
47905,74234,11869,35721,9894,62365,21876,10525,11351
47910,74244,11870,35726,9894,62374,21878,10526,11352
47915,74250,11870,35726,9894,62380,21881,10526,11355
47920,74261,11870,35732,9894,62390,21884,10527,11357
47925,74265,11871,35733,9895,62394,21885,10527,11358
47930,74275,11873,35738,9897,62402,21887,10528,11359
47935,74281,11873,35740,9897,62408,21890,10529,11361
47940,74292,11876,35746,9899,62416,21893,10531,11362
47945,74296,11877,35748,9900,62419,21894,10531,11363
47950,74306,11878,35749,9900,62428,21896,10531,11365
47955,74312,11878,35750,9900,62433,21899,10531,11368
47960,74323,11883,35756,9904,62439,21902,10532,11370
47965,74327,11885,35757,9906,62442,21903,10532,11371
47970,74337,11888,35761,9908,62449,21905,10532,11373
47975,74343,11888,35764,9908,62454,21908,10534,11374
47980,74354,11893,35771,9912,62460,21911,10536,11375
47985,74358,11895,35774,9914,62463,21912,10537,11375
47990,74368,11898,35780,9916,62470,21914,10539,11375
47995,74374,11898,35784,9916,62475,21917,10540,11377
48000,74385,11902,35791,9919,62483,21920,10542,11378
48005,74389,11903,35793,9920,62486,21921,10542,11379
48010,74399,11905,35796,9922,62494,21923,10542,11381
48015,74405,11905,35800,9922,62500,21926,10544,11382
48020,74416,11909,35805,9926,62506,21929,10544,11385
48025,74420,11912,35807,9929,62508,21930,10544,11386
48030,74430,11914,35812,9930,62516,21932,10545,11387
48035,74436,11914,35816,9930,62522,21935,10548,11387
48040,74447,11918,35822,9933,62528,21938,10549,11389
48045,74451,11921,35825,9936,62530,21939,10550,11389
48050,74461,11923,35833,9938,62538,21941,10552,11389
48055,74467,11923,35835,9938,62544,21944,10553,11391
48060,74478,11925,35840,9939,62552,21947,10554,11393
48065,74482,11927,35844,9941,62555,21948,10555,11393
48070,74492,11928,35851,9942,62564,21950,10555,11395
48075,74498,11928,35852,9942,62570,21953,10556,11397
48080,74509,11928,35857,9942,62580,21955,10558,11397
48085,74513,11929,35859,9943,62584,21956,10559,11397
48090,74523,11930,35867,9944,62593,21958,10561,11397
48095,74529,11930,35869,9944,62598,21961,10561,11400
48100,74540,11931,35874,9945,62608,21963,10562,11401
48105,74544,11932,35877,9946,62612,21964,10562,11402
48110,74554,11933,35880,9946,62621,21966,10562,11404
48115,74560,11933,35882,9946,62627,21969,10564,11405
48120,74571,11933,35886,9946,62638,21971,10565,11406
48125,74575,11933,35888,9946,62642,21972,10566,11406
48130,74585,11934,35893,9947,62651,21974,10568,11406
48135,74591,11934,35896,9947,62657,21977,10570,11407
48140,74602,11934,35900,9947,62668,21979,10571,11408
48145,74606,11934,35900,9947,62672,21980,10571,11409
48150,74616,11935,35906,9947,62681,21982,10572,11410
48155,74622,11935,35908,9947,62687,21985,10573,11412
48160,74633,11936,35913,9948,62697,21987,10574,11413
48165,74637,11937,35916,9949,62700,21988,10575,11413
48170,74647,11938,35919,9949,62709,21990,10576,11414
48175,74653,11938,35922,9949,62715,21993,10578,11415
48180,74664,11941,35929,9951,62723,21996,10581,11415
48185,74668,11942,35932,9952,62726,21997,10582,11415
48190,74678,11943,35937,9953,62735,21999,10584,11415
48195,74684,11943,35941,9953,62740,22002,10586,11416
48200,74695,11946,35945,9955,62749,22005,10587,11418
48205,74699,11948,35949,9957,62751,22006,10588,11418
48210,74709,11950,35954,9958,62759,22008,10589,11419
48215,74715,11950,35958,9958,62764,22011,10590,11421
48220,74726,11954,35964,9962,62772,22014,10592,11422
48225,74730,11954,35965,9962,62776,22015,10593,11422
48230,74740,11956,35971,9963,62784,22017,10594,11423
48235,74746,11956,35973,9963,62790,22020,10594,11426
48240,74757,11958,35977,9964,62798,22023,10596,11427
48245,74761,11961,35979,9967,62800,22024,10596,11428
48250,74771,11962,35984,9968,62809,22026,10597,11429
48255,74777,11962,35987,9968,62814,22029,10599,11430
48260,74788,11966,35991,9972,62822,22032,10600,11432
48265,74792,11966,35993,9972,62826,22033,10601,11432
48270,74802,11968,35999,9974,62834,22035,10603,11432
48275,74808,11968,36002,9974,62839,22038,10604,11434
48280,74819,11972,36008,9978,62846,22041,10605,11436
48285,74823,11974,36010,9980,62849,22042,10606,11436
48290,74833,11976,36015,9981,62857,22044,10607,11437
48295,74839,11976,36018,9981,62863,22047,10609,11438
48300,74850,11979,36021,9984,62871,22050,10609,11441
48305,74854,11980,36022,9985,62874,22051,10609,11442
48310,74864,11982,36028,9987,62882,22053,10609,11444
48315,74870,11982,36031,9987,62887,22056,10611,11445
48320,74881,11986,36037,9991,62895,22059,10612,11447
48325,74885,11987,36040,9992,62898,22060,10613,11447
48330,74895,11987,36042,9992,62908,22062,10614,11448
48335,74901,11987,36043,9992,62914,22065,10615,11450
48340,74912,11989,36047,9993,62923,22068,10616,11452
48345,74916,11989,36050,9993,62927,22069,10617,11452
48350,74926,11990,36057,9994,62936,22071,10617,11454
48355,74932,11990,36061,9994,62942,22074,10620,11454
48360,74943,11993,36065,9996,62950,22077,10622,11455
48365,74947,11994,36068,9997,62953,22078,10622,11456
48370,74957,11996,36074,9999,62961,22080,10622,11458
48375,74963,11996,36077,9999,62967,22083,10623,11460
48380,74974,11998,36083,10000,62976,22086,10625,11461
48385,74978,11998,36085,10000,62980,22087,10626,11461
48390,74988,11999,36090,10001,62989,22089,10626,11463
48395,74994,11999,36091,10001,62995,22092,10626,11466
48400,75005,12000,36096,10001,63005,22095,10628,11467
48405,75009,12001,36098,10002,63008,22096,10628,11468
48410,75019,12002,36104,10003,63017,22098,10629,11469
48415,75025,12002,36107,10003,63023,22101,10632,11469
48420,75036,12004,36112,10004,63032,22104,10634,11470
48425,75040,12005,36114,10005,63035,22105,10634,11471
48430,75050,12005,36119,10005,63045,22107,10636,11471
48435,75056,12005,36123,10005,63050,22110,10637,11473
48440,75067,12007,36130,10007,63060,22113,10638,11475
48445,75071,12007,36130,10007,63064,22114,10638,11476
48450,75081,12008,36134,10007,63073,22116,10639,11477
48455,75087,12008,36137,10007,63079,22119,10640,11479
48460,75098,12009,36144,10008,63088,22122,10642,11480
48465,75102,12010,36146,10009,63092,22123,10642,11481
48470,75112,12011,36151,10010,63101,22125,10642,11483
48475,75118,12011,36153,10010,63106,22128,10642,11486
48480,75129,12012,36157,10011,63117,22131,10644,11487
48485,75133,12013,36158,10012,63120,22132,10644,11488
48490,75143,12014,36163,10012,63129,22134,10644,11490
48495,75149,12014,36167,10012,63135,22137,10647,11490
48500,75160,12014,36173,10012,63145,22140,10648,11492
48505,75164,12016,36175,10014,63148,22141,10648,11493
48510,75174,12017,36177,10015,63157,22143,10648,11495
48515,75180,12017,36180,10015,63162,22146,10650,11496
48520,75191,12019,36187,10017,63171,22149,10652,11497
48525,75195,12021,36189,10019,63174,22150,10652,11498
48530,75205,12023,36194,10021,63182,22152,10652,11500
48535,75211,12023,36197,10021,63188,22155,10654,11501
48540,75222,12026,36203,10024,63196,22158,10656,11502
48545,75226,12027,36205,10025,63199,22159,10656,11503
48550,75236,12028,36208,10025,63208,22161,10656,11505
48555,75242,12028,36212,10025,63214,22164,10658,11506
48560,75253,12030,36217,10027,63223,22167,10659,11508
48565,75257,12030,36218,10027,63227,22168,10660,11508
48570,75267,12032,36222,10028,63235,22170,10661,11509
48575,75273,12032,36227,10028,63241,22173,10664,11509
48580,75284,12036,36236,10031,63247,22176,10666,11510
48585,75288,12039,36240,10034,63249,22177,10667,11510
48590,75298,12041,36246,10036,63257,22179,10668,11511
48595,75304,12041,36249,10036,63262,22182,10670,11512
48600,75315,12045,36252,10039,63270,22185,10671,11514
48605,75319,12047,36255,10041,63272,22186,10672,11514
48610,75329,12050,36261,10043,63279,22188,10674,11514
48615,75335,12050,36266,10043,63284,22191,10676,11515
48620,75346,12053,36271,10046,63293,22194,10677,11517
48625,75350,12055,36274,10048,63295,22195,10678,11517
48630,75360,12057,36279,10049,63303,22197,10679,11518
48635,75366,12057,36283,10049,63308,22200,10681,11519
48640,75377,12060,36290,10051,63316,22203,10683,11520
48645,75381,12062,36291,10053,63319,22204,10683,11521
48650,75391,12064,36297,10055,63327,22206,10684,11522
48655,75397,12064,36299,10055,63333,22209,10685,11524
48660,75408,12067,36304,10057,63341,22212,10687,11525
48665,75412,12067,36306,10057,63345,22213,10688,11525
48670,75422,12068,36310,10058,63354,22215,10689,11526
48675,75428,12068,36312,10058,63359,22218,10690,11528
48680,75439,12071,36318,10060,63367,22221,10691,11530
48685,75443,12073,36321,10062,63370,22222,10692,11530
48690,75453,12074,36325,10062,63379,22224,10693,11531
48695,75459,12074,36327,10062,63385,22227,10695,11532
48700,75470,12075,36332,10062,63395,22230,10696,11534
48705,75474,12076,36334,10063,63398,22231,10696,11535
48710,75484,12077,36337,10063,63407,22233,10697,11536
48715,75490,12077,36338,10063,63413,22236,10698,11538
48720,75501,12079,36347,10065,63421,22239,10700,11539
48725,75505,12080,36347,10066,63425,22240,10700,11540
48730,75515,12081,36351,10066,63434,22242,10700,11542
48735,75521,12081,36353,10066,63439,22245,10700,11545
48740,75532,12083,36357,10067,63449,22247,10701,11546
48745,75536,12083,36358,10067,63453,22248,10701,11547
48750,75546,12084,36365,10068,63462,22250,10702,11548
48755,75552,12084,36368,10068,63468,22253,10704,11549
48760,75563,12086,36373,10069,63477,22255,10705,11550
48765,75567,12087,36377,10070,63480,22256,10706,11550
48770,75577,12090,36383,10073,63487,22258,10707,11551
48775,75583,12090,36386,10073,63492,22261,10707,11554
48780,75594,12094,36390,10077,63500,22263,10707,11556
48785,75598,12094,36393,10077,63504,22264,10708,11556
48790,75608,12097,36398,10079,63511,22266,10709,11557
48795,75614,12097,36399,10079,63517,22269,10709,11560
48800,75625,12099,36406,10080,63525,22271,10710,11561
48805,75629,12101,36407,10082,63528,22272,10710,11562
48810,75639,12103,36412,10084,63536,22274,10711,11563
48815,75645,12103,36415,10084,63542,22277,10713,11564
48820,75656,12104,36420,10085,63551,22279,10714,11565
48825,75660,12105,36421,10086,63555,22280,10715,11565
48830,75670,12106,36424,10086,63564,22282,10717,11565
48835,75676,12106,36428,10086,63569,22285,10719,11566
48840,75687,12110,36434,10089,63576,22288,10721,11567
48845,75691,12113,36436,10092,63578,22289,10721,11568
48850,75701,12115,36440,10093,63586,22291,10721,11570
48855,75707,12115,36440,10093,63592,22294,10721,11573
48860,75718,12118,36443,10095,63600,22297,10722,11575
48865,75722,12120,36447,10097,63602,22298,10723,11575
48870,75732,12122,36452,10098,63610,22300,10724,11576
48875,75738,12122,36456,10098,63615,22303,10726,11577
48880,75749,12126,36461,10102,63622,22306,10727,11579
48885,75753,12129,36464,10105,63624,22307,10727,11580
48890,75763,12131,36468,10107,63632,22309,10727,11582
48895,75769,12131,36470,10107,63638,22312,10728,11584
48900,75780,12133,36477,10109,63647,22315,10730,11585
48905,75784,12133,36480,10109,63651,22316,10730,11586
48910,75794,12133,36486,10109,63661,22318,10731,11587
48915,75800,12133,36489,10109,63667,22321,10733,11588
48920,75811,12133,36496,10109,63678,22324,10735,11589
48925,75815,12133,36498,10109,63682,22325,10736,11589
48930,75825,12133,36503,10109,63692,22327,10737,11590
48935,75831,12133,36506,10109,63698,22330,10739,11591
48940,75842,12133,36508,10109,63709,22333,10739,11594
48945,75846,12133,36509,10109,63713,22334,10740,11594
48950,75856,12133,36514,10109,63723,22336,10740,11596
48955,75862,12133,36516,10109,63729,22339,10741,11598
48960,75873,12133,36523,10109,63740,22342,10743,11599
48965,75877,12133,36524,10109,63744,22343,10744,11599
48970,75887,12133,36527,10109,63754,22345,10745,11600
48975,75893,12133,36529,10109,63760,22348,10746,11602
48980,75904,12133,36533,10109,63771,22351,10748,11603
48985,75908,12133,36535,10109,63775,22352,10748,11604
48990,75918,12134,36539,10110,63784,22354,10748,11606
48995,75924,12134,36541,10110,63789,22357,10749,11608
49000,75935,12136,36544,10112,63799,22360,10749,11611
49005,75939,12138,36547,10114,63801,22361,10749,11612
49010,75949,12141,36552,10116,63808,22363,10750,11613
49015,75955,12141,36555,10116,63813,22366,10751,11615
49020,75966,12144,36558,10118,63822,22369,10752,11617
49025,75970,12144,36560,10118,63826,22370,10753,11617
49030,75980,12146,36565,10120,63834,22372,10754,11618
49035,75986,12146,36568,10120,63840,22375,10755,11620
49040,75997,12150,36575,10124,63846,22378,10756,11622
49045,76001,12153,36578,10127,63848,22379,10757,11622
49050,76011,12156,36583,10130,63855,22381,10758,11623
49055,76017,12156,36584,10130,63861,22384,10759,11625
49060,76028,12158,36588,10131,63870,22387,10761,11626
49065,76032,12159,36589,10132,63873,22388,10761,11627
49070,76042,12160,36591,10132,63882,22390,10761,11629
49075,76048,12160,36592,10132,63888,22393,10762,11631
49080,76059,12162,36596,10133,63897,22396,10764,11632
49085,76063,12163,36597,10134,63900,22397,10764,11633
49090,76073,12165,36601,10135,63908,22399,10765,11634
49095,76079,12165,36604,10135,63913,22402,10765,11637
49100,76090,12168,36608,10138,63922,22405,10766,11639
49105,76094,12168,36610,10138,63926,22406,10767,11639
49110,76104,12169,36615,10138,63935,22408,10768,11640
49115,76110,12169,36619,10138,63941,22411,10770,11641
49120,76121,12171,36625,10139,63949,22414,10772,11642
49125,76125,12173,36628,10141,63952,22415,10773,11642
49130,76135,12174,36630,10141,63961,22417,10773,11644
49135,76141,12174,36633,10141,63967,22420,10774,11646
49140,76152,12177,36640,10144,63974,22423,10775,11648
49145,76156,12179,36642,10146,63977,22424,10776,11648
49150,76166,12180,36647,10147,63986,22426,10777,11649
49155,76172,12180,36649,10147,63991,22429,10777,11652
49160,76183,12183,36656,10150,63999,22432,10779,11653
49165,76187,12185,36658,10152,64002,22433,10779,11654
49170,76197,12186,36663,10153,64011,22435,10780,11655
49175,76203,12186,36665,10153,64017,22438,10781,11657
49180,76214,12188,36670,10155,64026,22441,10783,11658
49185,76218,12188,36670,10155,64030,22442,10783,11659
49190,76228,12189,36675,10156,64039,22444,10785,11659
49195,76234,12189,36680,10156,64044,22447,10787,11660
49200,76245,12192,36687,10158,64053,22450,10790,11660
49205,76249,12193,36689,10159,64056,22451,10790,11661
49210,76259,12195,36694,10161,64064,22453,10792,11661
49215,76265,12195,36698,10161,64070,22456,10794,11662
49220,76276,12196,36703,10162,64080,22459,10796,11663
49225,76280,12197,36705,10163,64083,22460,10797,11663
49230,76290,12198,36709,10163,64092,22462,10799,11663
49235,76296,12198,36710,10163,64098,22465,10799,11666
49240,76307,12201,36714,10166,64106,22468,10799,11669
49245,76311,12202,36715,10167,64109,22469,10799,11670
49250,76321,12204,36717,10168,64117,22471,10799,11672
49255,76327,12204,36721,10168,64122,22474,10801,11673
49260,76338,12208,36726,10171,64129,22477,10802,11675
49265,76342,12210,36728,10173,64132,22478,10803,11675
49270,76352,12213,36735,10176,64139,22480,10804,11676
49275,76358,12213,36737,10176,64145,22483,10805,11678
49280,76369,12216,36744,10178,64152,22486,10807,11679
49285,76373,12219,36747,10181,64154,22487,10808,11679
49290,76383,12221,36752,10183,64162,22489,10810,11679
49295,76389,12221,36755,10183,64167,22492,10810,11682
49300,76400,12225,36759,10187,64175,22495,10810,11685
49305,76404,12226,36761,10188,64178,22496,10810,11686
49310,76414,12227,36764,10189,64187,22498,10811,11687
49315,76420,12227,36764,10189,64193,22501,10811,11690
49320,76431,12229,36768,10190,64202,22504,10813,11691
49325,76435,12229,36769,10190,64206,22505,10813,11692
49330,76445,12232,36776,10193,64213,22507,10813,11694
49335,76451,12232,36778,10193,64219,22510,10814,11696
49340,76462,12234,36781,10194,64228,22513,10815,11698
49345,76466,12235,36783,10195,64231,22514,10815,11699
49350,76476,12237,36788,10196,64239,22516,10816,11700
49355,76482,12237,36792,10196,64244,22519,10818,11701
49360,76493,12241,36799,10199,64251,22522,10820,11702
49365,76497,12243,36800,10201,64254,22523,10820,11703
49370,76507,12246,36806,10203,64261,22525,10821,11704
49375,76513,12246,36809,10203,64266,22528,10822,11706
49380,76524,12250,36816,10207,64273,22531,10824,11707
49385,76528,12251,36819,10208,64277,22532,10825,11707
49390,76538,12251,36824,10208,64287,22534,10825,11709
49395,76544,12251,36827,10208,64293,22537,10826,11711
49400,76555,12251,36833,10208,64304,22539,10827,11712
49405,76559,12251,36834,10208,64308,22540,10827,11713
49410,76569,12251,36838,10208,64318,22542,10828,11714
49415,76575,12251,36842,10208,64324,22545,10829,11716
49420,76586,12251,36848,10208,64335,22547,10831,11716
49425,76590,12251,36851,10208,64339,22548,10832,11716
49430,76600,12251,36854,10208,64349,22550,10832,11718
49435,76606,12251,36856,10208,64355,22553,10833,11720
49440,76617,12251,36857,10208,64366,22555,10833,11722
49445,76621,12251,36859,10208,64370,22556,10834,11722
49450,76631,12251,36861,10208,64380,22558,10834,11724
49455,76637,12251,36863,10208,64386,22561,10835,11726
49460,76648,12251,36870,10208,64397,22563,10836,11727
49465,76652,12251,36871,10208,64401,22564,10836,11728
49470,76662,12251,36878,10208,64411,22566,10837,11729
49475,76668,12251,36881,10208,64417,22569,10839,11730
49480,76679,12251,36884,10208,64428,22571,10840,11731
49485,76683,12251,36888,10208,64432,22572,10841,11731
49490,76693,12254,36894,10210,64439,22574,10842,11732
49495,76699,12254,36896,10210,64444,22577,10842,11735
49500,76710,12258,36900,10213,64452,22580,10842,11738
49505,76714,12259,36902,10214,64455,22581,10842,11739
49510,76724,12261,36906,10215,64463,22583,10842,11741
49515,76730,12261,36910,10215,64468,22586,10843,11743
49520,76741,12264,36916,10217,64476,22589,10844,11745
49525,76745,12265,36919,10218,64480,22590,10845,11745
49530,76755,12268,36924,10220,64487,22592,10847,11745
49535,76761,12268,36927,10220,64493,22595,10849,11746
49540,76772,12270,36931,10222,64501,22598,10849,11749
49545,76776,12271,36934,10223,64505,22599,10850,11749
49550,76786,12274,36938,10225,64512,22601,10852,11749
49555,76792,12274,36943,10225,64517,22604,10855,11749
49560,76803,12279,36951,10230,64523,22607,10857,11750
49565,76807,12282,36953,10233,64525,22608,10857,11751
49570,76817,12283,36959,10234,64534,22610,10857,11753
49575,76823,12283,36963,10234,64539,22613,10859,11754
49580,76834,12285,36967,10235,64549,22616,10860,11756
49585,76838,12286,36970,10236,64552,22617,10861,11756
49590,76848,12287,36975,10237,64561,22619,10862,11757
49595,76854,12287,36980,10237,64566,22622,10864,11758
49600,76865,12289,36986,10238,64576,22625,10866,11759
49605,76869,12289,36986,10238,64580,22626,10866,11760
49610,76879,12290,36993,10239,64589,22628,10867,11761
49615,76885,12290,36996,10239,64595,22631,10869,11762
49620,76896,12291,37001,10240,64604,22634,10871,11763
49625,76900,12292,37003,10241,64608,22635,10872,11763
49630,76910,12293,37009,10241,64617,22637,10874,11763
49635,76916,12293,37011,10241,64623,22640,10876,11764
49640,76927,12294,37012,10241,64633,22643,10877,11766
49645,76931,12295,37015,10242,64636,22644,10878,11766
49650,76941,12296,37020,10242,64645,22646,10878,11768
49655,76947,12296,37024,10242,64650,22649,10881,11768
49660,76958,12299,37029,10245,64658,22652,10882,11770
49665,76962,12300,37031,10246,64662,22653,10883,11770
49670,76972,12302,37035,10248,64670,22655,10883,11772
49675,76978,12302,37037,10248,64676,22658,10884,11774
49680,76989,12304,37043,10249,64684,22661,10887,11774
49685,76993,12307,37047,10252,64686,22662,10888,11774
49690,77003,12308,37050,10252,64695,22664,10889,11775
49695,77009,12308,37052,10252,64701,22667,10891,11776
49700,77020,12311,37058,10255,64709,22670,10891,11779
49705,77024,12312,37060,10256,64712,22671,10892,11779
49710,77034,12314,37066,10257,64720,22673,10893,11780
49715,77040,12314,37068,10257,64726,22676,10894,11782
49720,77051,12317,37073,10260,64733,22679,10895,11784
49725,77055,12318,37073,10261,64737,22680,10895,11785
49730,77065,12319,37076,10262,64746,22682,10895,11787
49735,77071,12319,37077,10262,64752,22685,10896,11789
49740,77082,12320,37083,10263,64761,22688,10899,11789
49745,77086,12322,37084,10265,64764,22689,10899,11790
49750,77096,12323,37090,10266,64773,22691,10901,11790
49755,77102,12323,37094,10266,64778,22694,10902,11792
49760,77113,12326,37099,10268,64786,22697,10903,11794
49765,77117,12328,37101,10270,64789,22698,10904,11794
49770,77127,12330,37106,10271,64797,22700,10905,11795
49775,77133,12330,37108,10271,64802,22703,10906,11797
49780,77144,12334,37113,10274,64810,22706,10908,11798
49785,77148,12334,37115,10274,64814,22707,10909,11798
49790,77158,12336,37120,10275,64822,22709,10910,11799
49795,77164,12336,37122,10275,64828,22712,10911,11801
49800,77175,12339,37128,10278,64836,22715,10912,11803
49805,77179,12341,37132,10280,64838,22716,10913,11803
49810,77189,12342,37135,10281,64847,22718,10914,11804
49815,77195,12342,37137,10281,64852,22721,10915,11806
49820,77206,12345,37141,10284,64861,22724,10916,11808
49825,77210,12346,37143,10285,64864,22725,10916,11809
49830,77220,12348,37145,10286,64872,22727,10916,11811
49835,77226,12348,37146,10286,64878,22730,10917,11813
49840,77237,12350,37151,10288,64887,22733,10918,11815
49845,77241,12350,37152,10288,64891,22734,10919,11815
49850,77251,12352,37157,10289,64899,22736,10920,11816
49855,77257,12352,37158,10289,64905,22739,10921,11818
49860,77268,12354,37161,10291,64914,22742,10921,11821
49865,77272,12354,37162,10291,64918,22743,10922,11821
49870,77282,12355,37166,10291,64927,22745,10922,11823
49875,77288,12355,37169,10291,64933,22748,10924,11824
49880,77299,12357,37173,10293,64941,22751,10924,11827
49885,77303,12358,37173,10294,64945,22752,10924,11828
49890,77313,12361,37179,10296,64952,22754,10924,11830
49895,77319,12361,37182,10296,64958,22757,10925,11832
49900,77330,12365,37190,10300,64964,22760,10927,11833
49905,77334,12366,37191,10301,64968,22761,10928,11833
49910,77344,12369,37196,10304,64975,22763,10929,11834
49915,77350,12369,37198,10304,64981,22766,10930,11836
49920,77361,12371,37203,10305,64990,22769,10933,11836
49925,77365,12373,37206,10307,64992,22770,10933,11837
49930,77375,12374,37209,10308,65001,22772,10933,11839
49935,77381,12374,37213,10308,65006,22775,10936,11839
49940,77392,12377,37215,10310,65014,22778,10936,11842
49945,77396,12379,37218,10312,65017,22779,10937,11842
49950,77406,12382,37223,10314,65024,22781,10937,11844
49955,77412,12382,37228,10314,65029,22784,10939,11845
49960,77423,12386,37234,10317,65037,22787,10941,11846
49965,77427,12387,37236,10318,65040,22788,10941,11847
49970,77437,12390,37241,10321,65047,22790,10941,11849
49975,77443,12390,37243,10321,65053,22793,10943,11850
49980,77454,12390,37248,10321,65063,22796,10944,11852
49985,77458,12391,37250,10322,65067,22797,10944,11853
49990,77468,12392,37257,10322,65076,22799,10946,11853
49995,77474,12392,37258,10322,65082,22802,10947,11855
50000,77485,12392,37263,10322,65092,22805,10948,11857
50005,77489,12393,37264,10323,65096,22806,10948,11858
50010,77499,12394,37265,10324,65105,22808,10948,11860
50015,77505,12394,37269,10324,65110,22811,10951,11860
50020,77516,12395,37271,10325,65121,22814,10952,11862
50025,77520,12395,37273,10325,65125,22815,10953,11862
50030,77530,12396,37279,10326,65134,22817,10954,11863
50035,77536,12396,37285,10326,65139,22820,10957,11863
50040,77547,12398,37294,10328,65148,22823,10958,11865
50045,77551,12400,37296,10330,65151,22824,10958,11866
50050,77561,12401,37300,10330,65160,22826,10959,11867
50055,77567,12401,37303,10330,65166,22829,10961,11868
50060,77578,12401,37309,10330,65177,22831,10963,11868
50065,77582,12402,37311,10331,65180,22832,10964,11868
50070,77592,12403,37316,10331,65189,22834,10965,11869
50075,77598,12403,37318,10331,65195,22837,10966,11871
50080,77609,12406,37327,10334,65202,22839,10967,11872
50085,77613,12409,37331,10337,65204,22840,10968,11872
50090,77623,12411,37339,10338,65212,22842,10970,11872
50095,77629,12411,37341,10338,65217,22845,10970,11875
50100,77640,12416,37350,10343,65223,22847,10971,11876
50105,77644,12418,37354,10345,65226,22848,10972,11876
50110,77654,12418,37359,10345,65236,22850,10974,11876
50115,77660,12418,37362,10345,65242,22853,10976,11877
50120,77671,12420,37367,10346,65251,22855,10978,11877
50125,77675,12420,37367,10346,65255,22856,10978,11878
50130,77685,12420,37371,10346,65265,22858,10979,11879
50135,77691,12420,37375,10346,65271,22861,10981,11880
50140,77702,12421,37381,10347,65281,22863,10982,11881
50145,77706,12422,37382,10348,65284,22864,10982,11882
50150,77716,12423,37388,10349,65293,22866,10983,11883
50155,77722,12423,37392,10349,65299,22869,10985,11884
50160,77733,12425,37395,10350,65308,22872,10986,11886
50165,77737,12426,37399,10351,65311,22873,10987,11886
50170,77747,12427,37404,10352,65320,22875,10989,11886
50175,77753,12427,37410,10352,65326,22878,10992,11886
50180,77764,12428,37414,10353,65336,22881,10994,11887
50185,77768,12429,37417,10354,65339,22882,10994,11888
50190,77778,12431,37423,10356,65347,22884,10994,11890
50195,77784,12431,37427,10356,65353,22887,10996,11891
50200,77795,12434,37436,10358,65361,22890,10999,11891
50205,77799,12434,37439,10358,65365,22891,11000,11891
50210,77809,12436,37443,10359,65373,22893,11001,11892
50215,77815,12436,37445,10359,65379,22896,11002,11894
50220,77826,12438,37449,10360,65388,22899,11004,11895
50225,77830,12438,37450,10360,65392,22900,11005,11895
50230,77840,12440,37457,10361,65400,22902,11006,11896
50235,77846,12440,37461,10361,65405,22905,11008,11897
50240,77857,12443,37463,10363,65414,22908,11009,11899
50245,77861,12443,37463,10363,65418,22909,11009,11900
50250,77871,12445,37468,10365,65426,22911,11009,11902
50255,77877,12445,37471,10365,65432,22914,11011,11903
50260,77888,12447,37475,10366,65440,22917,11012,11905
50265,77892,12448,37476,10367,65444,22918,11012,11906
50270,77902,12449,37477,10367,65453,22920,11012,11908
50275,77908,12449,37480,10367,65458,22923,11013,11910
50280,77919,12451,37485,10368,65468,22926,11015,11911
50285,77923,12452,37487,10369,65471,22927,11015,11912
50290,77933,12453,37488,10369,65480,22929,11016,11913
50295,77939,12453,37489,10369,65486,22932,11017,11915
50300,77950,12455,37492,10371,65494,22935,11017,11918
50305,77954,12457,37493,10373,65497,22936,11017,11919
50310,77964,12460,37500,10376,65504,22938,11018,11920
50315,77970,12460,37502,10376,65510,22941,11019,11922
50320,77981,12463,37506,10379,65518,22944,11020,11924
50325,77985,12463,37506,10379,65522,22945,11020,11925
50330,77995,12465,37511,10381,65530,22947,11020,11927
50335,78001,12465,37514,10381,65536,22950,11021,11929
50340,78012,12468,37519,10384,65544,22953,11022,11931
50345,78016,12469,37521,10385,65547,22954,11022,11932
50350,78026,12470,37526,10385,65556,22956,11023,11933
50355,78032,12470,37528,10385,65562,22959,11024,11935
50360,78043,12471,37533,10386,65571,22962,11025,11937
50365,78047,12472,37535,10387,65575,22963,11026,11937
50370,78057,12473,37539,10387,65584,22965,11027,11938
50375,78063,12473,37541,10387,65590,22968,11028,11940
50380,78074,12473,37546,10387,65600,22971,11030,11941
50385,78078,12474,37547,10388,65604,22972,11030,11942
50390,78088,12475,37549,10389,65613,22974,11030,11944
50395,78094,12475,37554,10389,65618,22977,11032,11945
50400,78105,12476,37559,10390,65629,22980,11034,11946
50405,78109,12476,37560,10390,65633,22981,11035,11946
50410,78119,12477,37567,10391,65642,22983,11037,11946
50415,78125,12477,37568,10391,65648,22986,11038,11948
50420,78136,12477,37571,10391,65658,22989,11038,11951
50425,78140,12479,37575,10393,65661,22990,11039,11951
50430,78150,12480,37579,10393,65670,22992,11040,11952
50435,78156,12480,37583,10393,65675,22995,11042,11953
50440,78167,12481,37587,10394,65686,22998,11044,11954
50445,78171,12481,37589,10394,65690,22999,11044,11955
50450,78181,12484,37596,10397,65697,23001,11046,11955
50455,78187,12484,37601,10397,65702,23004,11049,11955
50460,78198,12487,37606,10400,65710,23007,11050,11957
50465,78202,12488,37608,10401,65714,23008,11051,11957
50470,78212,12490,37611,10403,65722,23010,11051,11959
50475,78218,12490,37614,10403,65728,23013,11053,11960
50480,78229,12492,37620,10404,65736,23016,11055,11961
50485,78233,12495,37623,10407,65738,23017,11056,11961
50490,78243,12497,37629,10409,65746,23019,11058,11961
50495,78249,12497,37634,10409,65752,23022,11061,11961
50500,78260,12500,37640,10411,65759,23025,11063,11962
50505,78264,12502,37642,10413,65762,23026,11063,11963
50510,78274,12504,37646,10415,65770,23028,11063,11965
50515,78280,12504,37647,10415,65776,23031,11063,11968
50520,78291,12505,37649,10415,65786,23034,11063,11971
50525,78295,12506,37651,10416,65789,23035,11064,11971
50530,78305,12508,37656,10418,65797,23037,11065,11972
50535,78311,12508,37659,10418,65802,23040,11066,11974
50540,78322,12512,37668,10422,65809,23043,11069,11974
50545,78326,12515,37672,10425,65811,23044,11070,11974
50550,78336,12518,37679,10428,65818,23046,11071,11975
50555,78342,12518,37682,10428,65823,23049,11072,11977
50560,78353,12521,37689,10430,65831,23052,11075,11977
50565,78357,12524,37692,10433,65833,23053,11076,11977
50570,78367,12526,37698,10434,65841,23055,11078,11977
50575,78373,12526,37702,10434,65846,23058,11080,11978
50580,78384,12530,37707,10437,65854,23061,11081,11980
50585,78388,12532,37709,10439,65856,23062,11081,11981
50590,78398,12534,37715,10441,65864,23064,11083,11981
50595,78404,12534,37716,10441,65870,23067,11084,11983
50600,78415,12536,37719,10442,65879,23070,11085,11985
50605,78419,12536,37719,10442,65883,23071,11085,11986
50610,78429,12538,37724,10444,65891,23073,11086,11987
50615,78435,12538,37727,10444,65897,23076,11087,11989
50620,78446,12540,37731,10445,65905,23079,11088,11991
50625,78450,12542,37732,10447,65908,23080,11088,11992
50630,78460,12545,37737,10449,65915,23082,11089,11993
50635,78466,12545,37739,10449,65921,23085,11090,11995
50640,78477,12548,37743,10451,65929,23088,11092,11996
50645,78481,12550,37746,10453,65931,23089,11093,11996
50650,78491,12551,37749,10453,65940,23091,11094,11997
50655,78497,12551,37753,10453,65946,23094,11096,11998
50660,78508,12554,37759,10455,65953,23097,11098,11999
50665,78512,12555,37761,10456,65957,23098,11099,11999
50670,78522,12557,37765,10458,65965,23100,11099,12001
50675,78528,12557,37767,10458,65970,23103,11100,12003
50680,78539,12561,37770,10461,65978,23106,11101,12005
50685,78543,12562,37772,10462,65981,23107,11101,12006
50690,78553,12564,37776,10463,65989,23109,11102,12007
50695,78559,12564,37778,10463,65995,23112,11104,12008
50700,78570,12564,37783,10463,66005,23115,11105,12010
50705,78574,12565,37784,10464,66009,23116,11105,12011
50710,78584,12566,37789,10465,66018,23118,11107,12011
50715,78590,12566,37791,10465,66024,23121,11108,12013
50720,78601,12567,37795,10466,66034,23123,11109,12014
50725,78605,12567,37797,10466,66038,23124,11109,12015
50730,78615,12568,37803,10467,66047,23126,11110,12016
50735,78621,12568,37806,10467,66053,23129,11113,12016
50740,78632,12569,37811,10468,66063,23131,11115,12016
50745,78636,12570,37814,10469,66066,23132,11116,12016
50750,78646,12571,37819,10470,66075,23134,11117,12017
50755,78652,12571,37821,10470,66081,23137,11118,12019
50760,78663,12572,37826,10471,66090,23139,11118,12021
50765,78667,12573,37828,10472,66094,23140,11119,12021
50770,78677,12574,37834,10473,66103,23142,11120,12022
50775,78683,12574,37837,10473,66109,23145,11122,12023
50780,78694,12574,37840,10473,66120,23147,11123,12024
50785,78698,12575,37842,10474,66123,23148,11123,12025
50790,78708,12576,37845,10474,66132,23150,11124,12026
50795,78714,12576,37847,10474,66137,23153,11124,12029
50800,78725,12579,37851,10476,66146,23155,11124,12031
50805,78729,12579,37853,10476,66150,23156,11125,12031
50810,78739,12582,37857,10479,66157,23158,11125,12033
50815,78745,12582,37860,10479,66163,23161,11127,12034
50820,78756,12585,37867,10481,66170,23164,11129,12035
50825,78760,12587,37870,10483,66173,23165,11130,12035
50830,78770,12588,37876,10484,66182,23167,11131,12036
50835,78776,12588,37878,10484,66188,23170,11131,12039
50840,78787,12590,37885,10486,66196,23173,11133,12040
50845,78791,12592,37888,10488,66199,23174,11133,12041
50850,78801,12594,37893,10489,66207,23176,11134,12042
50855,78807,12594,37896,10489,66212,23179,11136,12043
50860,78818,12598,37902,10492,66219,23182,11137,12045
50865,78822,12600,37905,10494,66222,23183,11138,12045
50870,78832,12601,37908,10494,66231,23185,11139,12046
50875,78838,12601,37910,10494,66237,23188,11140,12048
50880,78849,12604,37915,10497,66244,23191,11140,12051
50885,78853,12605,37916,10498,66248,23192,11141,12051
50890,78863,12606,37920,10499,66257,23194,11142,12052
50895,78869,12606,37921,10499,66263,23197,11143,12054
50900,78880,12609,37926,10501,66271,23200,11146,12054
50905,78884,12610,37928,10502,66274,23201,11147,12054
50910,78894,12611,37934,10502,66283,23203,11149,12054
50915,78900,12611,37938,10502,66288,23206,11151,12055
50920,78911,12614,37943,10504,66297,23209,11153,12056
50925,78915,12614,37945,10504,66301,23210,11154,12056
50930,78925,12616,37948,10505,66309,23212,11154,12058
50935,78931,12616,37949,10505,66314,23215,11154,12061
50940,78942,12619,37953,10507,66322,23218,11154,12064
50945,78946,12620,37955,10508,66326,23219,11155,12064
50950,78956,12622,37960,10510,66334,23221,11156,12065
50955,78962,12622,37965,10510,66340,23224,11159,12065
50960,78973,12624,37971,10511,66349,23227,11161,12066
50965,78977,12624,37974,10511,66353,23228,11162,12066
50970,78987,12626,37979,10513,66361,23230,11163,12067
50975,78993,12626,37983,10513,66367,23233,11165,12068
50980,79004,12628,37990,10514,66376,23236,11168,12068
50985,79008,12629,37993,10515,66379,23237,11168,12069
50990,79018,12630,37999,10516,66388,23239,11169,12070
50995,79024,12630,38001,10516,66394,23242,11170,12072
51000,79035,12632,38006,10517,66403,23245,11171,12074
51005,79039,12632,38008,10517,66407,23246,11172,12074
51010,79049,12632,38011,10517,66417,23248,11173,12075
51015,79055,12632,38016,10517,66423,23251,11176,12075
51020,79066,12635,38020,10519,66431,23254,11177,12077
51025,79070,12636,38022,10520,66434,23255,11177,12078
51030,79080,12638,38027,10522,66442,23257,11178,12079
51035,79086,12638,38032,10522,66448,23260,11180,12080
51040,79097,12641,38036,10524,66456,23263,11180,12083
51045,79101,12641,38036,10524,66460,23264,11180,12084
51050,79111,12644,38044,10527,66467,23266,11181,12085
51055,79117,12644,38047,10527,66472,23269,11182,12087
51060,79128,12648,38051,10530,66480,23272,11183,12089
51065,79132,12649,38055,10531,66483,23273,11184,12089
51070,79142,12650,38059,10531,66492,23275,11185,12090
51075,79148,12650,38062,10531,66498,23278,11187,12091
51080,79159,12651,38065,10532,66508,23281,11188,12093
51085,79163,12651,38067,10532,66512,23282,11189,12093
51090,79173,12652,38073,10533,66521,23284,11191,12093
51095,79179,12652,38077,10533,66526,23287,11192,12095
51100,79190,12654,38082,10535,66536,23290,11192,12098
51105,79194,12655,38086,10536,66539,23291,11193,12098
51110,79204,12656,38091,10537,66548,23293,11193,12100
51115,79210,12656,38094,10537,66553,23296,11193,12103
51120,79221,12658,38097,10539,66562,23299,11193,12106
51125,79225,12659,38099,10540,66566,23300,11194,12106
51130,79235,12660,38105,10540,66575,23302,11195,12107
51135,79241,12660,38108,10540,66580,23305,11197,12108
51140,79252,12661,38110,10541,66591,23308,11197,12111
51145,79256,12661,38113,10541,66595,23309,11198,12111
51150,79266,12662,38119,10542,66604,23311,11198,12113
51155,79272,12662,38122,10542,66609,23314,11199,12115
51160,79283,12663,38126,10543,66620,23317,11202,12115
51165,79287,12663,38129,10543,66624,23318,11203,12115
51170,79297,12664,38134,10543,66633,23320,11203,12117
51175,79303,12664,38134,10543,66639,23323,11203,12120
51180,79314,12665,38141,10543,66648,23326,11205,12121
51185,79318,12666,38142,10544,66652,23327,11206,12121
51190,79328,12667,38145,10544,66661,23329,11207,12122
51195,79334,12667,38148,10544,66666,23332,11208,12124
51200,79345,12669,38152,10546,66676,23335,11210,12125
51205,79349,12671,38154,10548,66678,23336,11210,12126
51210,79359,12672,38161,10549,66687,23338,11212,12126
51215,79365,12672,38163,10549,66693,23341,11213,12128
51220,79376,12674,38169,10550,66701,23344,11215,12129
51225,79380,12677,38173,10553,66703,23345,11216,12129
51230,79390,12678,38179,10554,66712,23347,11218,12129
51235,79396,12678,38183,10554,66717,23350,11221,12129
51240,79407,12680,38186,10555,66727,23353,11223,12130
51245,79411,12681,38188,10556,66730,23354,11223,12131
51250,79421,12683,38192,10557,66738,23356,11224,12132
51255,79427,12683,38197,10557,66744,23359,11227,12132
51260,79438,12685,38202,10558,66753,23362,11230,12132
51265,79442,12687,38205,10560,66755,23363,11231,12132
51270,79452,12689,38210,10562,66763,23365,11232,12133
51275,79458,12689,38212,10562,66769,23368,11234,12134
51280,79469,12691,38216,10563,66777,23371,11236,12135
51285,79473,12693,38219,10565,66780,23372,11237,12135
51290,79483,12694,38223,10565,66789,23374,11238,12136
51295,79489,12694,38226,10565,66794,23377,11240,12137
51300,79500,12696,38231,10567,66804,23380,11242,12138
51305,79504,12696,38232,10567,66808,23381,11243,12138
51310,79514,12698,38237,10568,66816,23383,11244,12139
51315,79520,12698,38239,10568,66822,23386,11245,12141
51320,79531,12700,38242,10570,66831,23389,11246,12143
51325,79535,12700,38243,10570,66835,23390,11246,12144
51330,79545,12702,38248,10571,66843,23392,11246,12146
51335,79551,12702,38252,10571,66848,23395,11248,12147
51340,79562,12706,38259,10574,66855,23398,11251,12147
51345,79566,12707,38259,10575,66859,23399,11251,12148
51350,79576,12709,38262,10576,66867,23401,11252,12149
51355,79582,12709,38266,10576,66872,23404,11254,12150
51360,79593,12711,38270,10578,66882,23407,11256,12151
51365,79597,12712,38271,10579,66885,23408,11256,12152
51370,79607,12713,38276,10579,66894,23410,11258,12152
51375,79613,12713,38276,10579,66900,23413,11258,12155
51380,79624,12715,38283,10581,66908,23415,11259,12156
51385,79628,12716,38284,10582,66912,23416,11260,12156
51390,79638,12718,38288,10583,66920,23418,11261,12157
51395,79644,12718,38290,10583,66926,23421,11263,12158
51400,79655,12721,38298,10585,66933,23423,11264,12159
51405,79659,12723,38300,10587,66936,23424,11265,12159
51410,79669,12725,38305,10588,66944,23426,11266,12160
51415,79675,12725,38308,10588,66949,23429,11268,12161
51420,79686,12729,38312,10592,66957,23431,11269,12162
51425,79690,12730,38314,10593,66960,23432,11270,12162
51430,79700,12733,38318,10595,66967,23434,11270,12164
51435,79706,12733,38319,10595,66973,23437,11270,12167
51440,79717,12737,38326,10599,66980,23439,11270,12169
51445,79721,12738,38327,10600,66983,23440,11270,12170
51450,79731,12740,38333,10602,66991,23442,11271,12171
51455,79737,12740,38336,10602,66997,23445,11273,12172
51460,79748,12744,38341,10605,67004,23447,11273,12174
51465,79752,12746,38344,10607,67006,23448,11273,12175
51470,79762,12748,38352,10609,67014,23450,11274,12176
51475,79768,12748,38356,10609,67019,23453,11276,12177
51480,79779,12753,38362,10613,67026,23456,11277,12179
51485,79783,12755,38365,10615,67028,23457,11278,12179
51490,79793,12757,38372,10617,67036,23459,11278,12181
51495,79799,12757,38375,10617,67041,23462,11279,12183
51500,79810,12760,38382,10619,67049,23465,11281,12184
51505,79814,12762,38383,10621,67052,23466,11281,12185
51510,79824,12765,38387,10624,67059,23468,11281,12187
51515,79830,12765,38389,10624,67065,23471,11283,12188
51520,79841,12766,38392,10625,67075,23474,11284,12190
51525,79845,12766,38394,10625,67079,23475,11285,12190
51530,79855,12768,38398,10627,67087,23477,11286,12191
51535,79861,12768,38400,10627,67093,23480,11287,12193
51540,79872,12771,38405,10629,67100,23483,11289,12194
51545,79876,12773,38407,10631,67103,23484,11290,12194
51550,79886,12774,38412,10631,67112,23486,11292,12194
51555,79892,12774,38416,10631,67117,23489,11294,12195
51560,79903,12776,38419,10633,67127,23492,11294,12198
51565,79907,12776,38421,10633,67131,23493,11294,12199
51570,79917,12777,38425,10633,67140,23495,11294,12201
51575,79923,12777,38428,10633,67146,23498,11296,12202
51580,79934,12778,38434,10634,67156,23501,11297,12204
51585,79938,12778,38437,10634,67160,23502,11298,12204
51590,79948,12779,38441,10634,67169,23504,11300,12204
51595,79954,12779,38443,10634,67175,23507,11302,12205
51600,79965,12780,38447,10635,67185,23510,11302,12208
51605,79969,12780,38449,10635,67189,23511,11302,12209
51610,79979,12781,38452,10636,67198,23513,11302,12211
51615,79985,12781,38455,10636,67204,23516,11304,12212
51620,79996,12782,38460,10637,67214,23519,11305,12214
51625,80000,12782,38462,10637,67218,23520,11306,12214
51630,80010,12783,38467,10637,67227,23522,11307,12215
51635,80016,12783,38470,10637,67233,23525,11309,12216
51640,80027,12783,38476,10637,67243,23528,11310,12218
51645,80031,12784,38477,10638,67247,23529,11310,12219
51650,80041,12786,38481,10640,67255,23531,11311,12220
51655,80047,12786,38482,10640,67261,23534,11312,12222
51660,80058,12788,38487,10642,67270,23537,11315,12222
51665,80062,12789,38488,10643,67273,23538,11315,12223
51670,80072,12792,38492,10645,67280,23540,11315,12225
51675,80078,12792,38496,10645,67285,23543,11317,12226
51680,80089,12796,38502,10649,67292,23546,11318,12228
51685,80093,12797,38502,10650,67296,23547,11318,12229
51690,80103,12800,38510,10653,67303,23549,11319,12230
51695,80109,12800,38512,10653,67308,23552,11320,12232
51700,80120,12803,38516,10655,67316,23555,11320,12235
51705,80124,12804,38516,10656,67320,23556,11320,12236
51710,80134,12806,38521,10657,67328,23558,11322,12236
51715,80140,12806,38525,10657,67333,23561,11324,12237
51720,80151,12810,38529,10660,67341,23564,11325,12239
51725,80155,12811,38531,10661,67344,23565,11326,12239
51730,80165,12814,38536,10664,67351,23567,11327,12240
51735,80171,12814,38540,10664,67356,23570,11329,12241
51740,80182,12816,38545,10665,67365,23573,11331,12242
51745,80186,12818,38548,10667,67368,23574,11332,12242
51750,80196,12818,38552,10667,67378,23576,11332,12244
51755,80202,12818,38555,10667,67384,23579,11334,12245
51760,80213,12820,38561,10668,67393,23582,11335,12247
51765,80217,12821,38565,10669,67396,23583,11336,12247
51770,80227,12821,38568,10669,67406,23585,11338,12247
51775,80233,12821,38572,10669,67412,23588,11340,12248
51780,80244,12824,38579,10671,67420,23591,11342,12249
51785,80248,12825,38580,10672,67423,23592,11342,12250
51790,80258,12825,38584,10672,67433,23594,11344,12250
51795,80264,12825,38589,10672,67439,23597,11346,12251
51800,80275,12826,38596,10673,67449,23600,11349,12251
51805,80279,12827,38598,10674,67452,23601,11350,12251
51810,80289,12828,38602,10675,67461,23603,11351,12252
51815,80295,12828,38603,10675,67467,23606,11351,12255
51820,80306,12830,38610,10677,67476,23609,11352,12257
51825,80310,12831,38612,10678,67479,23610,11353,12257
51830,80320,12832,38619,10679,67488,23612,11354,12258
51835,80326,12832,38621,10679,67494,23615,11356,12259
51840,80337,12834,38627,10681,67503,23618,11358,12260
51845,80341,12834,38628,10681,67507,23619,11358,12261
51850,80351,12835,38631,10681,67516,23621,11359,12262
51855,80357,12835,38635,10681,67521,23624,11362,12262
51860,80368,12837,38641,10683,67531,23627,11364,12263
51865,80372,12838,38644,10684,67534,23628,11365,12263
51870,80382,12839,38648,10684,67543,23630,11366,12264
51875,80388,12839,38652,10684,67549,23633,11369,12264
51880,80399,12839,38658,10684,67559,23636,11370,12266
51885,80403,12841,38660,10686,67562,23637,11371,12266
51890,80413,12842,38667,10687,67571,23639,11372,12267
51895,80419,12842,38669,10687,67577,23642,11373,12269
51900,80430,12842,38671,10687,67588,23645,11373,12272
51905,80434,12843,38674,10688,67591,23646,11374,12272
51910,80444,12844,38679,10688,67600,23648,11375,12273
51915,80450,12844,38682,10688,67605,23651,11377,12274
51920,80461,12846,38688,10690,67614,23654,11378,12276
51925,80465,12848,38690,10692,67617,23655,11378,12277
51930,80475,12849,38695,10693,67626,23657,11379,12278
51935,80481,12849,38698,10693,67631,23660,11381,12279
51940,80492,12850,38701,10694,67641,23663,11382,12281
51945,80496,12852,38703,10696,67644,23664,11382,12282
51950,80506,12855,38712,10699,67651,23666,11383,12283
51955,80512,12855,38714,10699,67657,23669,11384,12285
51960,80523,12856,38717,10699,67666,23672,11384,12288
51965,80527,12857,38718,10700,67670,23673,11384,12289
51970,80537,12858,38724,10701,67679,23675,11386,12289
51975,80543,12858,38726,10701,67684,23678,11386,12292
51980,80554,12861,38730,10703,67693,23681,11387,12294
51985,80558,12862,38732,10704,67696,23682,11388,12294
51990,80568,12864,38737,10705,67704,23684,11389,12295
51995,80574,12864,38741,10705,67709,23687,11391,12296
52000,80585,12867,38743,10708,67718,23690,11391,12299
52005,80589,12869,38745,10710,67720,23691,11391,12300
52010,80599,12871,38750,10711,67728,23693,11392,12301
52015,80605,12871,38754,10711,67733,23696,11393,12303
52020,80616,12874,38758,10714,67742,23699,11394,12305
52025,80620,12875,38759,10715,67745,23700,11394,12306
52030,80630,12877,38761,10716,67753,23702,11395,12307
52035,80636,12877,38764,10716,67759,23705,11398,12307
52040,80647,12881,38770,10720,67765,23707,11398,12309
52045,80651,12883,38772,10722,67768,23708,11399,12309
52050,80661,12884,38778,10723,67777,23710,11400,12310
52055,80667,12884,38781,10723,67783,23713,11403,12310
52060,80678,12887,38787,10726,67791,23715,11404,12311
52065,80682,12888,38790,10727,67794,23716,11405,12311
52070,80692,12890,38795,10728,67802,23718,11406,12312
52075,80698,12890,38799,10728,67807,23721,11408,12313
52080,80709,12892,38805,10730,67816,23723,11409,12314
52085,80713,12894,38806,10732,67819,23724,11409,12315
52090,80723,12895,38810,10732,67828,23726,11411,12315
52095,80729,12895,38813,10732,67834,23729,11412,12317
52100,80740,12899,38819,10735,67841,23731,11414,12317
52105,80744,12899,38821,10735,67845,23732,11415,12317
52110,80754,12901,38828,10737,67853,23734,11416,12318
52115,80760,12901,38831,10737,67858,23737,11418,12319
52120,80771,12904,38835,10739,67866,23739,11419,12320
52125,80775,12907,38837,10742,67868,23740,11419,12321
52130,80785,12908,38842,10742,67877,23742,11420,12322
52135,80791,12908,38847,10742,67882,23745,11423,12322
52140,80802,12911,38854,10745,67890,23748,11425,12323
52145,80806,12913,38855,10747,67893,23749,11425,12324
52150,80816,12914,38858,10747,67902,23751,11426,12325
52155,80822,12914,38861,10747,67907,23754,11427,12327
52160,80833,12918,38867,10750,67914,23757,11429,12328
52165,80837,12920,38870,10752,67917,23758,11430,12328
52170,80847,12922,38877,10754,67925,23760,11432,12328
52175,80853,12922,38880,10754,67931,23763,11434,12329
52180,80864,12924,38885,10756,67939,23766,11436,12330
52185,80868,12926,38887,10758,67942,23767,11436,12331
52190,80878,12927,38890,10758,67951,23769,11436,12333
52195,80884,12927,38892,10758,67956,23772,11437,12335
52200,80895,12931,38899,10761,67964,23775,11440,12335
52205,80899,12932,38900,10762,67967,23776,11440,12336
52210,80909,12933,38906,10763,67976,23778,11442,12336
52215,80915,12933,38912,10763,67982,23781,11445,12336
52220,80926,12936,38917,10765,67990,23784,11445,12339
52225,80930,12937,38919,10766,67993,23785,11445,12340
52230,80940,12937,38925,10766,68003,23787,11445,12342
52235,80946,12937,38927,10766,68009,23790,11445,12345
52240,80957,12937,38934,10766,68020,23793,11447,12346
52245,80961,12937,38936,10766,68024,23794,11447,12347
52250,80971,12937,38943,10766,68034,23796,11449,12347
52255,80977,12937,38945,10766,68040,23799,11451,12348
52260,80988,12937,38949,10766,68051,23802,11452,12350
52265,80992,12937,38950,10766,68055,23803,11452,12351
52270,81002,12937,38954,10766,68065,23805,11454,12351
52275,81008,12937,38958,10766,68071,23808,11456,12352
52280,81019,12937,38963,10766,68082,23811,11457,12354
52285,81023,12937,38965,10766,68086,23812,11457,12355
52290,81033,12937,38970,10766,68096,23814,11457,12357
52295,81039,12937,38973,10766,68102,23817,11459,12358
52300,81050,12937,38978,10766,68113,23820,11461,12359
52305,81054,12937,38981,10766,68117,23821,11462,12359
52310,81064,12938,38986,10766,68126,23823,11462,12361
52315,81070,12938,38990,10766,68132,23826,11464,12362
52320,81081,12938,38993,10766,68143,23829,11465,12364
52325,81085,12938,38994,10766,68147,23830,11465,12365
52330,81095,12940,38997,10767,68155,23832,11465,12367
52335,81101,12940,39001,10767,68161,23835,11468,12367
52340,81112,12941,39001,10767,68171,23838,11468,12370
52345,81116,12942,39004,10768,68174,23839,11468,12371
52350,81126,12944,39011,10770,68182,23841,11468,12373
52355,81132,12944,39013,10770,68187,23844,11469,12375
52360,81143,12949,39020,10774,68194,23847,11471,12376
52365,81147,12949,39021,10774,68198,23848,11471,12377
52370,81157,12951,39027,10775,68206,23850,11473,12377
52375,81163,12951,39028,10775,68212,23853,11473,12380
52380,81174,12953,39033,10777,68221,23856,11475,12381
52385,81178,12955,39035,10779,68223,23857,11475,12382
52390,81188,12958,39039,10781,68230,23859,11477,12382
52395,81194,12958,39044,10781,68236,23862,11480,12382
52400,81205,12962,39049,10784,68243,23865,11482,12383
52405,81209,12962,39050,10784,68247,23866,11483,12383
52410,81219,12964,39056,10786,68255,23868,11484,12384
52415,81225,12964,39062,10786,68260,23871,11487,12384
52420,81236,12968,39067,10789,68268,23874,11489,12385
52425,81240,12969,39070,10790,68271,23875,11490,12385
52430,81250,12971,39072,10791,68279,23877,11490,12387
52435,81256,12971,39077,10791,68284,23880,11493,12387
52440,81267,12973,39080,10792,68293,23883,11494,12389
52445,81271,12974,39082,10793,68297,23884,11495,12389
52450,81281,12976,39088,10795,68305,23886,11496,12390
52455,81287,12976,39091,10795,68311,23889,11498,12391
52460,81298,12978,39094,10796,68319,23892,11498,12394
52465,81302,12979,39094,10797,68323,23893,11498,12395
52470,81312,12981,39097,10798,68331,23895,11498,12397
52475,81318,12981,39099,10798,68336,23898,11498,12400
52480,81329,12983,39104,10800,68346,23901,11500,12401
52485,81333,12983,39105,10800,68350,23902,11501,12401
52490,81343,12985,39111,10802,68358,23904,11502,12402
52495,81349,12985,39113,10802,68364,23907,11503,12404
52500,81360,12988,39121,10805,68371,23910,11505,12405
52505,81364,12991,39124,10808,68373,23911,11505,12406
52510,81374,12994,39127,10810,68380,23913,11505,12408
52515,81380,12994,39129,10810,68386,23916,11506,12410
52520,81391,12996,39137,10812,68394,23919,11509,12410
52525,81395,12998,39138,10814,68397,23920,11509,12411
52530,81405,13001,39144,10817,68404,23922,11510,12412
52535,81411,13001,39147,10817,68410,23925,11512,12413
52540,81422,13005,39154,10820,68416,23928,11514,12414
52545,81426,13007,39156,10822,68419,23929,11515,12414
52550,81436,13009,39161,10823,68427,23931,11516,12415
52555,81442,13009,39163,10823,68433,23934,11517,12417
52560,81453,13011,39167,10824,68442,23937,11518,12419
52565,81457,13011,39168,10824,68446,23938,11519,12419
52570,81467,13012,39175,10825,68455,23940,11519,12421
52575,81473,13012,39179,10825,68460,23943,11521,12422
52580,81484,13013,39182,10826,68471,23946,11523,12423
52585,81488,13014,39184,10827,68474,23947,11523,12424
52590,81498,13015,39187,10827,68483,23949,11523,12426
52595,81504,13015,39189,10827,68489,23952,11525,12427
52600,81515,13016,39194,10828,68498,23955,11526,12429
52605,81519,13017,39195,10829,68502,23956,11527,12429
52610,81529,13018,39200,10830,68511,23958,11528,12430
52615,81535,13018,39202,10830,68516,23961,11528,12433
52620,81546,13020,39210,10832,68525,23964,11530,12434
52625,81550,13022,39213,10834,68528,23965,11531,12434
52630,81560,13023,39218,10835,68537,23967,11531,12436
52635,81566,13023,39223,10835,68542,23970,11534,12436
52640,81577,13025,39229,10837,68551,23973,11536,12437
52645,81581,13026,39230,10838,68555,23974,11536,12438
52650,81591,13027,39238,10839,68564,23976,11537,12439
52655,81597,13027,39241,10839,68570,23979,11539,12440
52660,81608,13028,39247,10840,68580,23982,11541,12441
52665,81612,13028,39249,10840,68584,23983,11542,12441
52670,81622,13029,39254,10840,68593,23985,11543,12442
52675,81628,13029,39255,10840,68599,23988,11543,12445
52680,81639,13032,39261,10842,68607,23991,11544,12447
52685,81643,13034,39265,10844,68609,23992,11545,12447
52690,81653,13035,39268,10844,68618,23994,11547,12447
52695,81659,13035,39272,10844,68624,23997,11549,12448
52700,81670,13038,39275,10846,68632,23999,11549,12450
52705,81674,13040,39279,10848,68634,24000,11550,12450
52710,81684,13043,39285,10850,68641,24002,11551,12451
52715,81690,13043,39285,10850,68647,24005,11551,12454
52720,81701,13046,39292,10852,68654,24007,11552,12455
52725,81705,13048,39294,10854,68657,24008,11552,12456
52730,81715,13050,39300,10856,68665,24010,11553,12457
52735,81721,13050,39304,10856,68670,24013,11555,12458
52740,81732,13055,39312,10861,68676,24015,11555,12460
52745,81736,13058,39316,10864,68678,24016,11556,12460
52750,81746,13061,39322,10867,68685,24018,11556,12462
52755,81752,13061,39325,10867,68690,24021,11557,12464
52760,81763,13065,39332,10871,68697,24023,11558,12465
52765,81767,13067,39333,10873,68700,24024,11558,12466
52770,81777,13069,39336,10875,68708,24026,11558,12468
52775,81783,13069,39340,10875,68713,24029,11560,12469
52780,81794,13072,39342,10877,68722,24031,11561,12470
52785,81798,13073,39344,10878,68725,24032,11561,12471
52790,81808,13076,39350,10880,68732,24034,11562,12472
52795,81814,13076,39351,10880,68738,24037,11563,12474
52800,81825,13079,39358,10882,68745,24040,11565,12475
52805,81829,13080,39359,10883,68749,24041,11566,12475
52810,81839,13081,39364,10884,68758,24043,11568,12475
52815,81845,13081,39367,10884,68764,24046,11569,12477
52820,81856,13083,39374,10886,68773,24049,11570,12479
52825,81860,13083,39376,10886,68777,24050,11571,12479
52830,81870,13085,39382,10888,68785,24052,11572,12480
52835,81876,13085,39384,10888,68791,24055,11573,12482
52840,81887,13087,39387,10889,68800,24058,11574,12484
52845,81891,13087,39387,10889,68804,24059,11574,12485
52850,81901,13087,39394,10889,68814,24061,11575,12486
52855,81907,13087,39396,10889,68820,24064,11577,12487
52860,81918,13087,39402,10889,68831,24067,11579,12488
52865,81922,13087,39405,10889,68835,24068,11580,12488
52870,81932,13087,39411,10889,68845,24070,11582,12488
52875,81938,13087,39413,10889,68851,24073,11584,12489
52880,81949,13087,39420,10889,68862,24076,11587,12489
52885,81953,13087,39423,10889,68866,24077,11588,12489
52890,81963,13087,39430,10889,68876,24079,11589,12490
52895,81969,13087,39432,10889,68882,24082,11589,12493
52900,81980,13087,39435,10889,68893,24085,11591,12494
52905,81984,13087,39436,10889,68897,24086,11591,12495
52910,81994,13088,39443,10890,68906,24088,11592,12496
52915,82000,13088,39444,10890,68912,24091,11593,12498
52920,82011,13088,39449,10890,68923,24094,11595,12499
52925,82015,13089,39451,10891,68926,24095,11596,12499
52930,82025,13090,39456,10891,68935,24097,11597,12500
52935,82031,13090,39460,10891,68940,24100,11598,12502
52940,82042,13091,39465,10892,68950,24103,11599,12504
52945,82046,13093,39467,10894,68953,24104,11599,12505
52950,82056,13094,39473,10895,68962,24106,11601,12505
52955,82062,13094,39478,10895,68968,24109,11604,12505
52960,82073,13096,39483,10896,68976,24112,11605,12507
52965,82077,13098,39486,10898,68979,24113,11606,12507
52970,82087,13101,39492,10901,68986,24115,11607,12508
52975,82093,13101,39498,10901,68991,24118,11610,12508
52980,82104,13103,39499,10902,69001,24121,11610,12511
52985,82108,13105,39503,10904,69003,24122,11611,12511
52990,82118,13106,39508,10905,69012,24124,11613,12511
52995,82124,13106,39513,10905,69017,24127,11616,12511
53000,82135,13108,39518,10906,69026,24130,11617,12513
53005,82139,13109,39519,10907,69030,24131,11617,12514
53010,82149,13111,39522,10908,69038,24133,11618,12515
53015,82155,13111,39528,10908,69043,24136,11621,12515
53020,82166,13115,39535,10912,69051,24139,11622,12517
53025,82170,13115,39536,10912,69055,24140,11622,12518
53030,82180,13117,39541,10913,69063,24142,11623,12519
53035,82186,13117,39543,10913,69069,24145,11625,12520
53040,82197,13118,39547,10913,69079,24148,11627,12521
53045,82201,13118,39550,10913,69083,24149,11628,12521
53050,82211,13120,39554,10914,69091,24151,11629,12522
53055,82217,13120,39557,10914,69097,24154,11631,12523
53060,82228,13122,39561,10915,69106,24157,11632,12525
53065,82232,13122,39563,10915,69110,24158,11633,12525
53070,82242,13125,39569,10917,69117,24160,11635,12525
53075,82248,13125,39570,10917,69123,24163,11636,12527
53080,82259,13128,39578,10920,69130,24166,11638,12528
53085,82263,13130,39580,10922,69133,24167,11638,12529
53090,82273,13131,39584,10923,69142,24169,11639,12530
53095,82279,13131,39587,10923,69147,24172,11641,12531
53100,82290,13136,39595,10927,69154,24175,11644,12531
53105,82294,13137,39597,10928,69157,24176,11645,12531
53110,82304,13140,39604,10931,69164,24178,11646,12532
53115,82310,13140,39609,10931,69169,24181,11648,12533
53120,82321,13144,39615,10934,69176,24184,11648,12536
53125,82325,13146,39618,10936,69179,24185,11649,12536
53130,82335,13147,39621,10936,69188,24187,11650,12537
53135,82341,13147,39625,10936,69193,24190,11651,12539
53140,82352,13150,39629,10939,69202,24193,11653,12540
53145,82356,13151,39631,10940,69205,24194,11653,12541
53150,82366,13153,39636,10941,69213,24196,11655,12541
53155,82372,13153,39639,10941,69218,24199,11657,12542
53160,82383,13158,39645,10945,69225,24202,11659,12543
53165,82387,13159,39646,10946,69228,24203,11659,12544
53170,82397,13162,39652,10949,69235,24205,11661,12544
53175,82403,13162,39653,10949,69241,24208,11662,12546
53180,82414,13164,39660,10951,69249,24211,11664,12547
53185,82418,13165,39661,10952,69253,24212,11664,12548
53190,82428,13167,39664,10953,69261,24214,11665,12549
53195,82434,13167,39665,10953,69267,24217,11666,12551
53200,82445,13170,39672,10955,69275,24220,11668,12552
53205,82449,13172,39675,10957,69277,24221,11668,12553
53210,82459,13174,39681,10959,69285,24223,11670,12553
53215,82465,13174,39686,10959,69291,24226,11673,12553
53220,82476,13176,39691,10960,69299,24229,11673,12556
53225,82480,13177,39693,10961,69303,24230,11674,12556
53230,82490,13180,39699,10964,69310,24232,11675,12557
53235,82496,13180,39700,10964,69316,24235,11676,12559
53240,82507,13183,39705,10966,69324,24238,11678,12560
53245,82511,13184,39707,10967,69327,24239,11679,12560
53250,82521,13186,39713,10968,69335,24241,11681,12560
53255,82527,13186,39715,10968,69341,24244,11682,12562
53260,82538,13189,39719,10970,69349,24247,11684,12563
53265,82542,13189,39719,10970,69353,24248,11684,12564
53270,82552,13190,39726,10971,69362,24250,11685,12565
53275,82558,13190,39729,10971,69367,24253,11686,12567
53280,82569,13192,39736,10973,69376,24256,11687,12569
53285,82573,13194,39738,10975,69379,24257,11687,12570
53290,82583,13195,39743,10976,69388,24259,11688,12571
53295,82589,13195,39747,10976,69393,24262,11689,12573
53300,82600,13197,39750,10978,69402,24265,11689,12576
53305,82604,13199,39753,10980,69405,24266,11690,12576
53310,82614,13199,39755,10980,69415,24268,11690,12578
53315,82620,13199,39759,10980,69421,24271,11691,12580
53320,82631,13199,39763,10980,69432,24274,11692,12582
53325,82635,13199,39765,10980,69436,24275,11693,12582
53330,82645,13199,39770,10980,69446,24277,11695,12582
53335,82651,13199,39773,10980,69452,24280,11696,12584
53340,82662,13199,39778,10980,69463,24283,11697,12586
53345,82666,13199,39782,10980,69467,24284,11698,12586
53350,82676,13199,39788,10980,69477,24286,11700,12586
53355,82682,13199,39790,10980,69483,24289,11701,12588
53360,82693,13199,39797,10980,69494,24291,11702,12589
53365,82697,13199,39797,10980,69498,24292,11702,12590
53370,82707,13200,39802,10981,69507,24294,11703,12591
53375,82713,13200,39805,10981,69513,24297,11704,12593
53380,82724,13201,39810,10981,69523,24299,11706,12593
53385,82728,13201,39812,10981,69527,24300,11706,12594
53390,82738,13203,39818,10983,69535,24302,11707,12595
53395,82744,13203,39820,10983,69541,24305,11707,12598
53400,82755,13205,39822,10984,69550,24307,11708,12599
53405,82759,13206,39825,10985,69553,24308,11708,12600
53410,82769,13208,39830,10986,69561,24310,11708,12602
53415,82775,13208,39833,10986,69566,24313,11710,12603
53420,82786,13212,39840,10989,69573,24315,11711,12604
53425,82790,13214,39843,10991,69576,24316,11712,12604
53430,82800,13216,39845,10992,69584,24318,11713,12605
53435,82806,13216,39849,10992,69590,24321,11716,12605
53440,82817,13218,39854,10993,69598,24323,11717,12606
53445,82821,13221,39858,10996,69600,24324,11718,12606
53450,82831,13224,39864,10999,69607,24326,11719,12607
53455,82837,13224,39867,10999,69613,24329,11720,12609
53460,82848,13226,39871,11001,69622,24332,11722,12610
53465,82852,13228,39873,11003,69624,24333,11722,12611
53470,82862,13231,39878,11005,69631,24335,11723,12612
53475,82868,13231,39883,11005,69636,24338,11726,12612
53480,82879,13234,39888,11007,69645,24341,11727,12614
53485,82883,13236,39891,11009,69647,24342,11728,12614
53490,82893,13239,39897,11012,69654,24344,11728,12616
53495,82899,13239,39900,11012,69660,24347,11729,12618
53500,82910,13241,39905,11014,69669,24350,11730,12620
53505,82914,13241,39905,11014,69673,24351,11730,12621
53510,82924,13244,39912,11016,69680,24353,11731,12622
53515,82930,13244,39914,11016,69686,24356,11732,12624
53520,82941,13246,39918,11017,69694,24359,11732,12627
53525,82945,13248,39921,11019,69697,24360,11733,12627
53530,82955,13250,39927,11020,69705,24362,11734,12628
53535,82961,13250,39931,11020,69710,24365,11736,12629
53540,82972,13253,39936,11022,69718,24368,11738,12630
53545,82976,13254,39937,11023,69722,24369,11738,12631
53550,82986,13257,39944,11025,69729,24371,11739,12632
53555,82992,13257,39945,11025,69735,24374,11739,12635
53560,83003,13259,39949,11026,69744,24377,11740,12637
53565,83007,13261,39953,11028,69746,24378,11741,12637
53570,83017,13262,39956,11029,69755,24380,11741,12639
53575,83023,13262,39958,11029,69761,24383,11742,12641
53580,83034,13264,39965,11030,69769,24386,11745,12641
53585,83038,13266,39968,11032,69772,24387,11746,12641
53590,83048,13267,39970,11032,69781,24389,11746,12643
53595,83054,13267,39974,11032,69786,24392,11748,12644
53600,83065,13269,39982,11034,69795,24395,11750,12645
53605,83069,13271,39984,11036,69798,24396,11750,12646
53610,83079,13272,39988,11037,69807,24398,11751,12647
53615,83085,13272,39992,11037,69813,24401,11753,12648
53620,83096,13273,39998,11038,69822,24404,11754,12650
53625,83100,13274,40000,11039,69826,24405,11755,12650
53630,83110,13275,40007,11040,69835,24407,11756,12651
53635,83116,13275,40010,11040,69840,24410,11757,12653
53640,83127,13277,40015,11042,69850,24413,11759,12654
53645,83131,13277,40016,11042,69854,24414,11759,12655
53650,83141,13278,40018,11042,69863,24416,11759,12657
53655,83147,13278,40019,11042,69869,24419,11759,12660
53660,83158,13278,40022,11042,69880,24422,11761,12661
53665,83162,13278,40024,11042,69884,24423,11762,12661
53670,83172,13279,40028,11042,69893,24425,11763,12662
53675,83178,13279,40032,11042,69899,24428,11765,12663
53680,83189,13279,40038,11042,69909,24431,11767,12664
53685,83193,13280,40041,11043,69913,24432,11767,12665
53690,83203,13282,40047,11044,69921,24434,11768,12666
53695,83209,13282,40050,11044,69927,24437,11769,12668
53700,83220,13285,40055,11046,69934,24440,11771,12669
53705,83224,13287,40058,11048,69937,24441,11771,12670
53710,83234,13288,40063,11048,69946,24443,11773,12670
53715,83240,13288,40065,11048,69952,24446,11773,12673
53720,83251,13291,40072,11051,69959,24449,11775,12674
53725,83255,13292,40073,11052,69963,24450,11775,12675
53730,83265,13294,40079,11053,69971,24452,11776,12676
53735,83271,13294,40082,11053,69977,24455,11779,12676
53740,83282,13296,40087,11055,69986,24458,11780,12678
53745,83286,13296,40088,11055,69990,24459,11781,12678
53750,83296,13299,40092,11057,69997,24461,11781,12680
53755,83302,13299,40097,11057,70002,24464,11783,12681
53760,83313,13303,40104,11061,70009,24467,11783,12684
53765,83317,13306,40107,11064,70011,24468,11784,12684
53770,83327,13307,40109,11064,70020,24470,11785,12685
53775,83333,13307,40112,11064,70025,24473,11787,12686
53780,83344,13311,40117,11067,70033,24476,11788,12688
53785,83348,13312,40119,11068,70036,24477,11789,12688
53790,83358,13314,40125,11070,70044,24479,11791,12688
53795,83364,13314,40129,11070,70050,24482,11793,12689
53800,83375,13315,40131,11071,70060,24485,11794,12691
53805,83379,13316,40134,11072,70063,24486,11795,12691
53810,83389,13318,40139,11073,70071,24488,11796,12692
53815,83395,13318,40142,11073,70077,24491,11798,12693
53820,83406,13321,40148,11076,70084,24494,11800,12694
53825,83410,13323,40151,11078,70087,24495,11801,12694
53830,83420,13324,40154,11079,70096,24497,11802,12695
53835,83426,13324,40157,11079,70101,24500,11804,12696
53840,83437,13326,40162,11081,70111,24503,11805,12698
53845,83441,13327,40165,11082,70114,24504,11806,12698
53850,83451,13328,40168,11082,70123,24506,11807,12699
53855,83457,13328,40171,11082,70128,24509,11808,12701
53860,83468,13330,40174,11084,70138,24512,11809,12703
53865,83472,13331,40176,11085,70141,24513,11809,12704
53870,83482,13333,40181,11086,70149,24515,11811,12704
53875,83488,13333,40184,11086,70155,24518,11813,12705
53880,83499,13336,40187,11088,70163,24521,11814,12707
53885,83503,13337,40188,11089,70166,24522,11814,12708
53890,83513,13339,40193,11090,70174,24524,11816,12708
53895,83519,13339,40196,11090,70179,24527,11817,12710
53900,83530,13343,40203,11093,70186,24530,11818,12712
53905,83534,13345,40204,11095,70189,24531,11818,12713
53910,83544,13347,40211,11096,70197,24533,11819,12714
53915,83550,13347,40213,11096,70202,24536,11820,12716
53920,83561,13352,40220,11101,70209,24539,11821,12718
53925,83565,13353,40223,11102,70212,24540,11822,12718
53930,83575,13354,40227,11103,70221,24542,11823,12719
53935,83581,13354,40228,11103,70227,24545,11823,12722
53940,83592,13356,40232,11105,70236,24548,11825,12723
53945,83596,13358,40234,11107,70238,24549,11825,12724
53950,83606,13360,40240,11109,70246,24551,11826,12725
53955,83612,13360,40243,11109,70252,24554,11829,12725
53960,83623,13363,40249,11112,70260,24557,11831,12726
53965,83627,13364,40252,11113,70263,24558,11832,12726
53970,83637,13366,40258,11115,70271,24560,11833,12727
53975,83643,13366,40260,11115,70277,24563,11835,12728
53980,83654,13369,40264,11118,70284,24566,11835,12731
53985,83658,13371,40266,11120,70287,24567,11835,12732
53990,83668,13372,40271,11121,70296,24569,11837,12732
53995,83674,13372,40275,11121,70302,24572,11839,12733
54000,83685,13374,40282,11122,70311,24575,11841,12734
54005,83689,13374,40283,11122,70315,24576,11841,12735
54010,83699,13374,40288,11122,70325,24578,11843,12735
54015,83705,13374,40292,11122,70331,24581,11845,12736
54020,83716,13374,40298,11122,70342,24583,11846,12737
54025,83720,13374,40301,11122,70346,24584,11847,12737
54030,83730,13374,40305,11122,70356,24586,11847,12739
54035,83736,13374,40309,11122,70362,24589,11849,12740
54040,83747,13374,40311,11122,70373,24591,11850,12741
54045,83751,13374,40314,11122,70377,24592,11850,12742
54050,83761,13374,40317,11122,70387,24594,11850,12744
54055,83767,13374,40319,11122,70393,24597,11850,12747
54060,83778,13374,40321,11122,70404,24599,11851,12748
54065,83782,13374,40325,11122,70408,24600,11852,12748
54070,83792,13374,40327,11122,70418,24602,11852,12750
54075,83798,13374,40329,11122,70424,24605,11853,12752
54080,83809,13374,40333,11122,70435,24607,11853,12754
54085,83813,13374,40334,11122,70439,24608,11853,12755
54090,83823,13374,40341,11122,70449,24610,11855,12755
54095,83829,13374,40343,11122,70455,24613,11855,12758
54100,83840,13374,40347,11122,70466,24615,11856,12759
54105,83844,13376,40349,11124,70468,24616,11856,12760
54110,83854,13377,40353,11124,70477,24618,11858,12760
54115,83860,13377,40354,11124,70483,24621,11859,12762
54120,83871,13380,40359,11126,70490,24624,11860,12764
54125,83875,13382,40362,11128,70493,24625,11861,12764
54130,83885,13385,40368,11131,70500,24627,11862,12765
54135,83891,13385,40373,11131,70505,24630,11864,12766
54140,83902,13387,40376,11133,70515,24633,11864,12769
54145,83906,13388,40377,11134,70518,24634,11864,12770
54150,83916,13390,40383,11136,70526,24636,11865,12771
54155,83922,13390,40386,11136,70532,24639,11866,12773
54160,83933,13391,40389,11136,70541,24642,11867,12775
54165,83937,13392,40391,11137,70545,24643,11868,12775
54170,83947,13393,40395,11137,70554,24645,11870,12775
54175,83953,13393,40400,11137,70559,24648,11873,12775
54180,83964,13397,40408,11141,70566,24651,11875,12776
54185,83968,13399,40410,11143,70569,24652,11875,12777
54190,83978,13400,40413,11144,70578,24654,11876,12778
54195,83984,13400,40416,11144,70584,24657,11879,12778
54200,83995,13404,40424,11148,70590,24660,11880,12780
54205,83999,13406,40426,11150,70593,24661,11880,12781
54210,84009,13407,40430,11150,70602,24663,11880,12783
54215,84015,13407,40433,11150,70607,24666,11880,12786
54220,84026,13411,40440,11154,70615,24669,11882,12787
54225,84030,13411,40441,11154,70619,24670,11883,12787
54230,84040,13414,40448,11156,70626,24672,11884,12788
54235,84046,13414,40449,11156,70632,24675,11885,12790
54240,84057,13416,40453,11157,70641,24678,11886,12792
54245,84061,13416,40453,11157,70645,24679,11886,12793
54250,84071,13419,40460,11159,70652,24681,11887,12794
54255,84077,13419,40463,11159,70658,24684,11889,12795
54260,84088,13422,40470,11162,70665,24687,11890,12797
54265,84092,13424,40473,11164,70668,24688,11891,12797
54270,84102,13426,40477,11165,70676,24690,11892,12798
54275,84108,13426,40478,11165,70682,24693,11893,12800
54280,84119,13428,40482,11166,70690,24696,11894,12802
54285,84123,13430,40484,11168,70693,24697,11895,12802
54290,84133,13431,40490,11169,70702,24699,11896,12803
54295,84139,13431,40493,11169,70707,24702,11897,12805
54300,84150,13433,40495,11170,70717,24705,11898,12807
54305,84154,13434,40498,11171,70720,24706,11899,12807
54310,84164,13437,40504,11174,70727,24708,11900,12808
54315,84170,13437,40509,11174,70732,24711,11903,12808
54320,84181,13441,40516,11177,70740,24714,11906,12808
54325,84185,13442,40518,11178,70743,24715,11906,12809
54330,84195,13444,40525,11179,70751,24717,11907,12810
54335,84201,13444,40527,11179,70756,24720,11907,12813
54340,84212,13448,40533,11182,70763,24723,11908,12815
54345,84216,13451,40537,11185,70765,24724,11909,12815
54350,84226,13452,40540,11186,70774,24726,11910,12816
54355,84232,13452,40542,11186,70779,24729,11910,12819
54360,84243,13454,40545,11187,70789,24732,11912,12820
54365,84247,13454,40547,11187,70793,24733,11913,12820
54370,84257,13456,40554,11189,70801,24735,11914,12821
54375,84263,13456,40558,11189,70806,24738,11916,12822
54380,84274,13459,40563,11191,70815,24741,11918,12823
54385,84278,13459,40564,11191,70819,24742,11918,12824
54390,84288,13462,40571,11193,70826,24744,11919,12825
54395,84294,13462,40575,11193,70831,24747,11920,12827
54400,84305,13466,40581,11197,70839,24750,11921,12829
54405,84309,13466,40583,11197,70843,24751,11922,12829
54410,84319,13468,40587,11199,70851,24753,11923,12830
54415,84325,13468,40591,11199,70856,24756,11925,12831
54420,84336,13470,40594,11201,70866,24759,11926,12833
54425,84340,13471,40596,11202,70869,24760,11926,12834
54430,84350,13474,40601,11204,70876,24762,11927,12835
54435,84356,13474,40604,11204,70881,24765,11928,12837
54440,84367,13477,40608,11206,70889,24768,11928,12840
54445,84371,13478,40609,11207,70893,24769,11928,12841
54450,84381,13479,40614,11208,70902,24771,11929,12842
54455,84387,13479,40616,11208,70908,24774,11930,12844
54460,84398,13479,40621,11208,70918,24777,11932,12845
54465,84402,13480,40621,11209,70922,24778,11932,12846
54470,84412,13481,40627,11210,70931,24780,11934,12846
54475,84418,13481,40631,11210,70936,24783,11936,12847
54480,84429,13483,40638,11212,70946,24786,11937,12849
54485,84433,13483,40640,11212,70950,24787,11938,12849
54490,84443,13484,40643,11213,70959,24789,11938,12851
54495,84449,13484,40646,11213,70964,24792,11939,12853
54500,84460,13486,40653,11215,70973,24795,11941,12854
54505,84464,13488,40657,11217,70976,24796,11942,12854
54510,84474,13489,40664,11218,70985,24798,11943,12855
54515,84480,13489,40667,11218,70990,24801,11945,12856
54520,84491,13490,40671,11219,71000,24804,11947,12857
54525,84495,13491,40672,11220,71004,24805,11947,12858
54530,84505,13492,40677,11220,71013,24807,11949,12858
54535,84511,13492,40678,11220,71019,24810,11950,12860
54540,84522,13493,40684,11221,71028,24813,11952,12861
54545,84526,13494,40684,11222,71032,24814,11952,12862
54550,84536,13495,40686,11222,71041,24816,11952,12864
54555,84542,13495,40690,11222,71047,24819,11954,12865
54560,84553,13498,40696,11225,71054,24822,11955,12867
54565,84557,13500,40698,11227,71057,24823,11955,12868
54570,84567,13501,40701,11227,71066,24825,11956,12869
54575,84573,13501,40706,11227,71071,24828,11958,12870
54580,84584,13505,40712,11231,71078,24831,11959,12872
54585,84588,13507,40713,11233,71081,24832,11959,12873
54590,84598,13508,40720,11234,71090,24834,11959,12875
54595,84604,13508,40722,11234,71096,24837,11960,12877
54600,84615,13510,40728,11235,71105,24840,11961,12879
54605,84619,13511,40731,11236,71108,24841,11962,12879
54610,84629,13513,40737,11238,71116,24843,11963,12880
54615,84635,13513,40739,11238,71122,24846,11964,12882
54620,84646,13515,40742,11239,71131,24849,11966,12883
54625,84650,13515,40743,11239,71135,24850,11966,12884
54630,84660,13516,40746,11240,71144,24852,11967,12885
54635,84666,13516,40749,11240,71150,24855,11969,12886
54640,84677,13519,40754,11242,71158,24858,11971,12887
54645,84681,13520,40757,11243,71161,24859,11972,12887
54650,84691,13521,40762,11244,71170,24861,11973,12888
54655,84697,13521,40767,11244,71176,24864,11976,12888
54660,84708,13524,40777,11247,71184,24867,11979,12888
54665,84712,13524,40778,11247,71188,24868,11979,12889
54670,84722,13525,40785,11248,71197,24870,11980,12890
54675,84728,13525,40787,11248,71203,24873,11981,12892
54680,84739,13527,40791,11249,71212,24875,11981,12894
54685,84743,13528,40794,11250,71215,24876,11982,12894
54690,84753,13530,40800,11252,71223,24878,11983,12895
54695,84759,13530,40803,11252,71229,24881,11984,12897
54700,84770,13534,40808,11255,71236,24883,11984,12899
54705,84774,13535,40811,11256,71239,24884,11985,12899
54710,84784,13537,40818,11258,71247,24886,11986,12900
54715,84790,13537,40820,11258,71252,24889,11986,12903
54720,84801,13542,40828,11262,71258,24891,11987,12904
54725,84805,13543,40829,11263,71262,24892,11987,12905
54730,84815,13544,40834,11264,71271,24894,11989,12905
54735,84821,13544,40836,11264,71276,24897,11990,12907
54740,84832,13546,40842,11266,71286,24899,11991,12908
54745,84836,13547,40844,11267,71289,24900,11991,12909
54750,84846,13548,40848,11267,71298,24902,11993,12909
54755,84852,13548,40850,11267,71304,24905,11994,12911
54760,84863,13549,40854,11268,71314,24907,11994,12913
54765,84867,13549,40855,11268,71318,24908,11995,12913
54770,84877,13550,40857,11268,71327,24910,11995,12915
54775,84883,13550,40859,11268,71333,24913,11996,12917
54780,84894,13551,40864,11269,71343,24916,11997,12919
54785,84898,13552,40866,11270,71346,24917,11997,12920
54790,84908,13553,40869,11270,71355,24919,11997,12922
54795,84914,13553,40872,11270,71360,24922,11999,12923
54800,84925,13555,40877,11272,71369,24925,12001,12924
54805,84929,13557,40878,11274,71372,24926,12001,12925
54810,84939,13558,40882,11274,71381,24928,12001,12927
54815,84945,13558,40885,11274,71386,24931,12002,12929
54820,84956,13559,40889,11275,71397,24934,12003,12931
54825,84960,13560,40890,11276,71400,24935,12003,12932
54830,84970,13561,40894,11276,71409,24937,12004,12933
54835,84976,13561,40896,11276,71414,24940,12005,12935
54840,84987,13564,40902,11278,71423,24943,12008,12935
54845,84991,13564,40903,11278,71427,24944,12008,12936
54850,85001,13566,40906,11279,71435,24946,12008,12938
54855,85007,13566,40910,11279,71440,24949,12011,12938
54860,85018,13568,40915,11280,71449,24952,12013,12939
54865,85022,13571,40918,11283,71451,24953,12013,12940
54870,85032,13573,40923,11284,71459,24955,12015,12940
54875,85038,13573,40925,11284,71464,24958,12015,12943
54880,85049,13576,40931,11287,71473,24961,12018,12943
54885,85053,13577,40933,11288,71476,24962,12018,12944
54890,85063,13578,40937,11288,71485,24964,12019,12945
54895,85069,13578,40941,11288,71490,24967,12020,12947
54900,85080,13583,40950,11293,71496,24970,12023,12947
54905,85084,13586,40953,11296,71498,24971,12023,12948
54910,85094,13588,40958,11297,71506,24973,12024,12949
54915,85100,13588,40960,11297,71512,24976,12026,12950
54920,85111,13589,40964,11297,71522,24979,12028,12951
54925,85115,13589,40966,11297,71526,24980,12029,12951
54930,85125,13590,40968,11298,71535,24982,12030,12952
54935,85131,13590,40971,11298,71541,24985,12031,12954
54940,85142,13591,40977,11299,71550,24988,12033,12955
54945,85146,13593,40979,11301,71553,24989,12034,12955
54950,85156,13595,40982,11302,71561,24991,12034,12957
54955,85162,13595,40984,11302,71566,24994,12035,12959
54960,85173,13599,40991,11306,71573,24997,12037,12960
54965,85177,13602,40994,11309,71575,24998,12037,12961
54970,85187,13604,40999,11311,71583,25000,12038,12962
54975,85193,13604,41002,11311,71588,25003,12039,12964
54980,85204,13609,41008,11315,71595,25006,12041,12965
54985,85208,13609,41009,11315,71599,25007,12041,12966
54990,85218,13609,41015,11315,71609,25009,12042,12967
54995,85224,13609,41019,11315,71615,25012,12045,12967
55000,85235,13612,41027,11317,71623,25015,12047,12968
55005,85239,13613,41029,11318,71626,25016,12047,12969
55010,85249,13614,41035,11319,71635,25018,12047,12971
55015,85255,13614,41037,11319,71641,25021,12048,12973
55020,85266,13617,41043,11322,71649,25024,12048,12976
55025,85270,13618,41045,11323,71652,25025,12049,12976
55030,85280,13618,41047,11323,71662,25027,12049,12978
55035,85286,13618,41049,11323,71668,25030,12050,12980
55040,85297,13620,41056,11325,71677,25033,12053,12980
55045,85301,13620,41057,11325,71681,25034,12053,12981
55050,85311,13622,41063,11327,71689,25036,12054,12982
55055,85317,13622,41066,11327,71695,25039,12055,12984
55060,85328,13625,41075,11330,71703,25042,12058,12984
55065,85332,13626,41077,11331,71706,25043,12058,12985
55070,85342,13627,41083,11332,71715,25045,12060,12985
55075,85348,13627,41087,11332,71721,25048,12063,12985
55080,85359,13629,41094,11333,71730,25051,12066,12985
55085,85363,13629,41097,11333,71734,25052,12067,12985
55090,85373,13630,41101,11333,71743,25054,12068,12986
55095,85379,13630,41106,11333,71748,25057,12070,12987
55100,85390,13631,41111,11334,71758,25060,12071,12989
55105,85394,13632,41112,11335,71762,25061,12072,12989
55110,85404,13633,41119,11336,71771,25063,12073,12990
55115,85410,13633,41119,11336,71777,25066,12073,12993
55120,85421,13633,41124,11336,71787,25069,12074,12995
55125,85425,13634,41125,11337,71791,25070,12074,12996
55130,85435,13635,41128,11337,71800,25072,12075,12997
55135,85441,13635,41131,11337,71805,25075,12077,12998
55140,85452,13636,41135,11338,71815,25078,12080,12998
55145,85456,13637,41138,11339,71819,25079,12081,12998
55150,85466,13638,41142,11340,71828,25081,12081,13000
55155,85472,13638,41144,11340,71834,25084,12083,13001
55160,85483,13639,41149,11341,71844,25087,12085,13002
55165,85487,13639,41152,11341,71848,25088,12086,13002
55170,85497,13640,41155,11341,71857,25090,12087,13003
55175,85503,13640,41159,11341,71862,25093,12089,13004
55180,85514,13641,41162,11342,71872,25096,12089,13007
55185,85518,13643,41164,11344,71875,25097,12090,13007
55190,85528,13646,41167,11346,71882,25099,12090,13009
55195,85534,13646,41169,11346,71888,25102,12091,13011
55200,85545,13649,41173,11348,71896,25105,12092,13013
55205,85549,13650,41174,11349,71899,25106,12092,13014
55210,85559,13651,41178,11349,71908,25108,12093,13015
55215,85565,13651,41181,11349,71914,25111,12095,13016
55220,85576,13652,41182,11349,71924,25114,12096,13018
55225,85580,13654,41185,11351,71926,25115,12096,13019
55230,85590,13655,41189,11352,71935,25117,12096,13021
55235,85596,13655,41192,11352,71940,25120,12098,13022
55240,85607,13657,41195,11354,71950,25123,12098,13025
55245,85611,13658,41196,11355,71953,25124,12098,13026
55250,85621,13659,41199,11355,71962,25126,12100,13026
55255,85627,13659,41202,11355,71967,25129,12102,13027
55260,85638,13662,41207,11357,71976,25132,12104,13028
55265,85642,13663,41209,11358,71979,25133,12104,13029
55270,85652,13664,41213,11358,71988,25135,12104,13031
55275,85658,13664,41217,11358,71993,25138,12105,13033
55280,85669,13666,41223,11359,72002,25141,12106,13035
55285,85673,13669,41226,11362,72004,25142,12107,13035
55290,85683,13670,41231,11363,72013,25144,12107,13037
55295,85689,13670,41235,11363,72019,25147,12110,13037
55300,85700,13671,41240,11364,72028,25150,12111,13039
55305,85704,13673,41242,11366,72031,25151,12111,13040
55310,85714,13676,41247,11368,72038,25153,12112,13041
55315,85720,13676,41248,11368,72044,25156,12112,13044
55320,85731,13679,41253,11370,72052,25159,12114,13045
55325,85735,13680,41254,11371,72055,25160,12114,13046
55330,85745,13682,41262,11373,72063,25162,12115,13047
55335,85751,13682,41265,11373,72068,25165,12116,13049
55340,85762,13684,41268,11374,72077,25167,12116,13051
55345,85766,13685,41268,11375,72081,25168,12116,13052
55350,85776,13688,41275,11377,72088,25170,12117,13053
55355,85782,13688,41279,11377,72093,25173,12119,13054
55360,85793,13691,41284,11379,72101,25175,12121,13054
55365,85797,13693,41285,11381,72104,25176,12121,13055
55370,85807,13694,41289,11381,72113,25178,12122,13056
55375,85813,13694,41293,11381,72118,25181,12124,13057
55380,85824,13697,41297,11384,72126,25183,12124,13059
55385,85828,13699,41299,11386,72129,25184,12125,13059
55390,85838,13700,41302,11386,72138,25186,12126,13060
55395,85844,13700,41304,11386,72144,25189,12127,13062
55400,85855,13703,41309,11389,72152,25191,12128,13063
55405,85859,13704,41311,11390,72155,25192,12128,13064
55410,85869,13705,41314,11390,72164,25194,12129,13065
55415,85875,13705,41317,11390,72170,25197,12131,13066
55420,85886,13707,41321,11391,72179,25199,12132,13067
55425,85890,13709,41325,11393,72181,25200,12133,13067
55430,85900,13710,41327,11393,72190,25202,12134,13068
55435,85906,13710,41330,11393,72196,25205,12135,13070
55440,85917,13714,41333,11396,72203,25208,12135,13073
55445,85921,13715,41335,11397,72206,25209,12136,13073
55450,85931,13717,41339,11399,72214,25211,12137,13074
55455,85937,13717,41342,11399,72220,25214,12138,13076
55460,85948,13721,41350,11403,72226,25217,12139,13078
55465,85952,13722,41350,11404,72230,25218,12139,13079
55470,85962,13723,41354,11405,72239,25220,12140,13080
55475,85968,13723,41357,11405,72244,25223,12142,13081
55480,85979,13726,41360,11407,72253,25226,12143,13083
55485,85983,13727,41362,11408,72256,25227,12143,13084
55490,85993,13728,41366,11409,72265,25229,12144,13085
55495,85999,13728,41370,11409,72270,25232,12146,13086
55500,86010,13733,41377,11414,72277,25235,12147,13088
55505,86014,13734,41379,11415,72280,25236,12148,13088
55510,86024,13735,41383,11415,72289,25238,12149,13089
55515,86030,13735,41388,11415,72294,25241,12151,13090
55520,86041,13738,41392,11417,72303,25244,12152,13092
55525,86045,13740,41395,11419,72305,25245,12152,13093
55530,86055,13742,41400,11420,72313,25247,12153,13094
55535,86061,13742,41405,11420,72318,25250,12155,13095
55540,86072,13746,41412,11423,72325,25253,12158,13095
55545,86076,13749,41415,11426,72327,25254,12159,13095
55550,86086,13750,41419,11427,72336,25256,12160,13096
55555,86092,13750,41422,11427,72342,25259,12161,13098
55560,86103,13753,41429,11429,72350,25262,12163,13099
55565,86107,13754,41431,11430,72353,25263,12163,13100
55570,86117,13755,41435,11431,72362,25265,12163,13102
55575,86123,13755,41439,11431,72368,25268,12164,13104
55580,86134,13756,41443,11431,72378,25271,12165,13106
55585,86138,13756,41444,11431,72382,25272,12165,13107
55590,86148,13756,41448,11431,72392,25274,12165,13109
55595,86154,13756,41450,11431,72398,25277,12167,13110
55600,86165,13757,41452,11431,72408,25280,12169,13111
55605,86169,13758,41453,11432,72411,25281,12169,13112
55610,86179,13759,41457,11433,72420,25283,12169,13114
55615,86185,13759,41460,11433,72426,25286,12171,13115
55620,86196,13761,41466,11435,72435,25289,12173,13116
55625,86200,13761,41467,11435,72439,25290,12174,13116
55630,86210,13761,41470,11435,72449,25292,12175,13117
55635,86216,13761,41475,11435,72455,25295,12178,13117
55640,86227,13764,41484,11438,72463,25298,12179,13119
55645,86231,13765,41488,11439,72466,25299,12180,13119
55650,86241,13765,41493,11439,72476,25301,12182,13119
55655,86247,13765,41495,11439,72482,25304,12182,13122
55660,86258,13768,41501,11441,72489,25307,12183,13124
55665,86262,13770,41503,11443,72492,25308,12183,13125
55670,86272,13771,41507,11443,72501,25310,12184,13126
55675,86278,13771,41510,11443,72507,25313,12186,13127
55680,86289,13773,41514,11444,72516,25316,12188,13128
55685,86293,13775,41518,11446,72518,25317,12189,13128
55690,86303,13776,41523,11446,72527,25319,12190,13129
55695,86309,13776,41527,11446,72533,25322,12192,13130
55700,86320,13776,41532,11446,72543,25325,12193,13132
55705,86324,13778,41534,11448,72546,25326,12194,13132
55710,86334,13779,41537,11448,72555,25328,12194,13134
55715,86340,13779,41543,11448,72560,25331,12197,13134
55720,86351,13781,41548,11450,72569,25334,12198,13136
55725,86355,13782,41548,11451,72573,25335,12198,13137
55730,86365,13783,41555,11452,72582,25337,12200,13137
55735,86371,13783,41558,11452,72588,25340,12203,13137
55740,86382,13783,41562,11452,72599,25343,12204,13139
55745,86386,13783,41563,11452,72603,25344,12204,13140
55750,86396,13784,41569,11453,72612,25346,12206,13140
55755,86402,13784,41572,11453,72617,25349,12208,13141
55760,86413,13785,41577,11454,72628,25352,12210,13142
55765,86417,13786,41580,11455,72631,25353,12211,13142
55770,86427,13787,41585,11456,72640,25355,12212,13143
55775,86433,13787,41589,11456,72645,25358,12214,13144
55780,86444,13789,41595,11458,72655,25361,12215,13146
55785,86448,13790,41596,11459,72658,25362,12215,13147
55790,86458,13792,41599,11461,72666,25364,12215,13149
55795,86464,13792,41600,11461,72672,25367,12215,13152
55800,86475,13794,41604,11462,72680,25370,12217,13153
55805,86479,13796,41606,11464,72683,25371,12218,13153
55810,86489,13797,41607,11464,72692,25373,12218,13155
55815,86495,13797,41609,11464,72697,25376,12219,13157
55820,86506,13800,41613,11467,72705,25379,12219,13160
55825,86510,13802,41614,11469,72708,25380,12219,13161
55830,86520,13804,41621,11471,72716,25382,12221,13161
55835,86526,13804,41622,11471,72722,25385,12221,13164
55840,86537,13808,41627,11474,72729,25388,12221,13167
55845,86541,13809,41630,11475,72732,25389,12222,13167
55850,86551,13811,41633,11477,72740,25391,12223,13168
55855,86557,13811,41637,11477,72745,25394,12225,13169
55860,86568,13815,41643,11480,72752,25397,12227,13170
55865,86572,13817,41646,11482,72755,25398,12228,13170
55870,86582,13818,41649,11482,72764,25400,12229,13171
55875,86588,13818,41651,11482,72770,25403,12230,13173
55880,86599,13822,41655,11485,72777,25406,12231,13175
55885,86603,13822,41657,11485,72781,25407,12232,13175
55890,86613,13824,41663,11487,72789,25409,12232,13177
55895,86619,13824,41667,11487,72794,25412,12234,13178
55900,86630,13827,41675,11490,72802,25415,12237,13178
55905,86634,13829,41678,11492,72805,25416,12237,13179
55910,86644,13832,41683,11495,72812,25418,12238,13180
55915,86650,13832,41687,11495,72818,25421,12240,13181
55920,86661,13833,41689,11495,72828,25424,12241,13183
55925,86665,13834,41692,11496,72831,25425,12242,13183
55930,86675,13835,41695,11496,72840,25427,12242,13185
55935,86681,13835,41698,11496,72846,25430,12245,13185
55940,86692,13837,41702,11497,72855,25433,12247,13186
55945,86696,13838,41704,11498,72858,25434,12247,13187
55950,86706,13840,41709,11500,72866,25436,12247,13189
55955,86712,13840,41712,11500,72871,25439,12248,13191
55960,86723,13845,41720,11505,72878,25442,12250,13192
55965,86727,13845,41720,11505,72882,25443,12250,13193
55970,86737,13847,41723,11506,72890,25445,12250,13195
55975,86743,13847,41726,11506,72895,25448,12252,13196
55980,86754,13851,41733,11510,72903,25451,12254,13197
55985,86758,13853,41735,11512,72905,25452,12254,13198
55990,86768,13854,41740,11513,72914,25454,12254,13200
55995,86774,13854,41744,11513,72920,25457,12256,13201
56000,86785,13855,41751,11514,72929,25459,12257,13202
56005,86789,13856,41753,11515,72933,25460,12258,13202
56010,86799,13857,41758,11515,72942,25462,12258,13204
56015,86805,13857,41759,11515,72948,25465,12259,13206
56020,86816,13858,41762,11516,72958,25467,12260,13207
56025,86820,13859,41764,11517,72961,25468,12260,13208
56030,86830,13860,41770,11517,72970,25470,12261,13209
56035,86836,13860,41774,11517,72975,25473,12263,13210
56040,86847,13861,41780,11518,72985,25475,12264,13211
56045,86851,13862,41782,11519,72989,25476,12265,13211
56050,86861,13863,41785,11519,72998,25478,12266,13212
56055,86867,13863,41789,11519,73003,25481,12267,13214
56060,86878,13865,41793,11521,73013,25483,12268,13215
56065,86882,13866,41796,11522,73016,25484,12269,13215
56070,86892,13867,41799,11523,73025,25486,12269,13217
56075,86898,13867,41801,11523,73031,25489,12270,13219
56080,86909,13868,41807,11524,73041,25491,12270,13221
56085,86913,13868,41809,11524,73045,25492,12270,13222
56090,86923,13870,41813,11525,73053,25494,12271,13223
56095,86929,13870,41816,11525,73059,25497,12273,13224
56100,86940,13874,41825,11528,73065,25500,12275,13225
56105,86944,13876,41826,11530,73068,25501,12275,13226
56110,86954,13879,41832,11532,73075,25503,12276,13227
56115,86960,13879,41835,11532,73081,25506,12279,13227
56120,86971,13881,41837,11533,73090,25509,12280,13229
56125,86975,13883,41840,11535,73092,25510,12281,13229
56130,86985,13885,41844,11536,73100,25512,12282,13230
56135,86991,13885,41845,11536,73106,25515,12282,13233
56140,87002,13888,41852,11538,73114,25518,12284,13234
56145,87006,13890,41854,11540,73116,25519,12284,13235
56150,87016,13892,41859,11541,73124,25521,12286,13235
56155,87022,13892,41863,11541,73129,25524,12288,13236
56160,87033,13897,41870,11545,73135,25527,12289,13238
56165,87037,13899,41873,11547,73138,25528,12290,13238
56170,87047,13900,41876,11548,73147,25530,12291,13239
56175,87053,13900,41879,11548,73153,25533,12293,13240
56180,87064,13903,41884,11551,73161,25536,12293,13243
56185,87068,13904,41885,11552,73164,25537,12293,13244
56190,87078,13905,41890,11552,73173,25539,12294,13245
56195,87084,13905,41893,11552,73178,25542,12295,13247
56200,87095,13908,41896,11554,73187,25545,12296,13249
56205,87099,13909,41900,11555,73190,25546,12297,13249
56210,87109,13910,41905,11556,73199,25548,12299,13249
56215,87115,13910,41909,11556,73205,25551,12302,13249
56220,87126,13912,41914,11557,73214,25554,12305,13249
56225,87130,13913,41918,11558,73217,25555,12306,13249
56230,87140,13914,41923,11559,73226,25557,12307,13250
56235,87146,13914,41927,11559,73232,25560,12309,13251
56240,87157,13915,41930,11560,73242,25563,12311,13252
56245,87161,13916,41934,11561,73245,25564,12312,13252
56250,87171,13918,41938,11563,73253,25566,12312,13254
56255,87177,13918,41940,11563,73259,25569,12313,13256
56260,87188,13920,41947,11565,73268,25572,12314,13258
56265,87192,13920,41950,11565,73272,25573,12314,13259
56270,87202,13920,41954,11565,73282,25575,12314,13261
56275,87208,13920,41956,11565,73288,25578,12315,13263
56280,87219,13920,41960,11565,73299,25581,12318,13263
56285,87223,13920,41962,11565,73303,25582,12319,13263
56290,87233,13920,41967,11565,73313,25584,12321,13263
56295,87239,13920,41970,11565,73319,25587,12324,13263
56300,87250,13920,41977,11565,73330,25590,12326,13264
56305,87254,13921,41979,11566,73333,25591,12327,13264
56310,87264,13922,41985,11566,73342,25593,12329,13264
56315,87270,13922,41987,11566,73347,25596,12329,13267
56320,87281,13923,41993,11567,73357,25599,12330,13269
56325,87285,13925,41995,11569,73360,25600,12330,13270
56330,87295,13926,42004,11569,73369,25602,12332,13270
56335,87301,13926,42005,11569,73375,25605,12333,13272
56340,87312,13926,42010,11569,73385,25608,12334,13274
56345,87316,13927,42011,11570,73389,25609,12334,13275
56350,87326,13928,42017,11571,73398,25611,12336,13275
56355,87332,13928,42021,11571,73404,25614,12338,13276
56360,87343,13928,42028,11571,73414,25617,12340,13277
56365,87347,13930,42032,11573,73417,25618,12341,13277
56370,87357,13932,42034,11574,73425,25620,12341,13279
56375,87363,13932,42036,11574,73431,25623,12342,13281
56380,87374,13935,42045,11576,73438,25626,12345,13281
56385,87378,13936,42045,11577,73442,25627,12345,13282
56390,87388,13939,42051,11580,73449,25629,12345,13284
56395,87394,13939,42053,11580,73455,25632,12346,13286
56400,87405,13941,42057,11582,73464,25635,12347,13288
56405,87409,13942,42058,11583,73467,25636,12347,13289
56410,87419,13945,42065,11585,73474,25638,12348,13290
56415,87425,13945,42069,11585,73480,25641,12350,13291
56420,87436,13947,42076,11587,73489,25644,12353,13291
56425,87440,13947,42077,11587,73493,25645,12354,13291
56430,87450,13949,42081,11588,73501,25647,12355,13292
56435,87456,13949,42083,11588,73507,25650,12356,13294
56440,87467,13953,42089,11592,73513,25653,12356,13297
56445,87471,13955,42091,11594,73516,25654,12357,13297
56450,87481,13956,42095,11595,73525,25656,12359,13297
56455,87487,13956,42099,11595,73530,25659,12360,13299
56460,87498,13960,42105,11598,73537,25662,12362,13300
56465,87502,13962,42108,11600,73540,25663,12363,13300
56470,87512,13963,42112,11601,73549,25665,12364,13301
56475,87518,13963,42114,11601,73554,25668,12364,13304
56480,87529,13966,42119,11603,73563,25671,12366,13305
56485,87533,13966,42122,11603,73567,25672,12367,13305
56490,87543,13969,42130,11606,73574,25674,12369,13305
56495,87549,13969,42135,11606,73580,25677,12372,13305
56500,87560,13973,42140,11610,73586,25680,12372,13308
56505,87564,13975,42142,11612,73589,25681,12373,13308
56510,87574,13977,42147,11613,73597,25683,12374,13309
56515,87580,13977,42152,11613,73603,25686,12377,13309
56520,87591,13979,42157,11614,73612,25689,12379,13310
56525,87595,13979,42157,11614,73616,25690,12379,13311
56530,87605,13980,42162,11615,73625,25692,12379,13313
56535,87611,13980,42166,11615,73631,25695,12381,13314
56540,87622,13983,42170,11617,73639,25698,12383,13315
56545,87626,13983,42172,11617,73643,25699,12384,13315
56550,87636,13986,42179,11619,73650,25701,12385,13316
56555,87642,13986,42180,11619,73656,25704,12386,13318
56560,87653,13987,42183,11620,73665,25707,12387,13320
56565,87657,13988,42184,11621,73669,25708,12387,13321
56570,87667,13991,42191,11624,73676,25710,12388,13322
56575,87673,13991,42195,11624,73682,25713,12391,13322
56580,87684,13994,42201,11627,73689,25716,12393,13323
56585,87688,13996,42203,11629,73692,25717,12393,13324
56590,87698,13999,42208,11632,73699,25719,12394,13325
56595,87704,13999,42209,11632,73705,25722,12395,13327
56600,87715,14002,42214,11634,73713,25725,12396,13329
56605,87719,14004,42217,11636,73715,25726,12397,13329
56610,87729,14007,42221,11638,73722,25728,12398,13330
56615,87735,14007,42225,11638,73727,25731,12400,13331
56620,87746,14008,42229,11639,73737,25734,12400,13334
56625,87750,14010,42231,11641,73740,25735,12400,13335
56630,87760,14011,42238,11642,73749,25737,12402,13335
56635,87766,14011,42242,11642,73755,25740,12404,13336
56640,87777,14011,42250,11642,73765,25743,12407,13336
56645,87781,14012,42251,11643,73769,25744,12407,13337
56650,87791,14013,42257,11644,73778,25746,12409,13337
56655,87797,14013,42261,11644,73783,25749,12410,13339
56660,87808,14014,42267,11645,73793,25751,12411,13340
56665,87812,14016,42271,11647,73796,25752,12412,13340
56670,87822,14017,42277,11648,73805,25754,12414,13340
56675,87828,14017,42279,11648,73811,25757,12416,13341
56680,87839,14017,42287,11648,73821,25759,12418,13341
56685,87843,14018,42289,11649,73825,25760,12418,13342
56690,87853,14019,42294,11650,73834,25762,12419,13343
56695,87859,14019,42297,11650,73839,25765,12421,13344
56700,87870,14021,42301,11652,73848,25767,12421,13346
56705,87874,14023,42304,11654,73851,25768,12422,13346
56710,87884,14024,42309,11654,73860,25770,12423,13347
56715,87890,14024,42312,11654,73865,25773,12423,13350
56720,87901,14027,42317,11656,73874,25775,12424,13351
56725,87905,14028,42318,11657,73877,25776,12424,13352
56730,87915,14029,42322,11657,73886,25778,12425,13353
56735,87921,14029,42323,11657,73892,25781,12425,13356
56740,87932,14031,42328,11658,73900,25783,12425,13358
56745,87936,14033,42329,11660,73903,25784,12425,13359
56750,87946,14034,42335,11660,73912,25786,12426,13360
56755,87952,14034,42336,11660,73918,25789,12427,13362
56760,87963,14036,42341,11661,73926,25792,12427,13365
56765,87967,14039,42344,11664,73928,25793,12428,13365
56770,87977,14039,42350,11664,73938,25795,12429,13366
56775,87983,14039,42355,11664,73944,25798,12431,13367
56780,87994,14040,42361,11664,73954,25801,12431,13370
56785,87998,14041,42363,11665,73957,25802,12431,13371
56790,88008,14041,42369,11665,73967,25804,12432,13372
56795,88014,14041,42369,11665,73973,25807,12432,13375
56800,88025,14042,42373,11665,73983,25810,12434,13376
56805,88029,14043,42374,11666,73986,25811,12434,13377
56810,88039,14044,42380,11667,73995,25813,12435,13378
56815,88045,14044,42382,11667,74001,25816,12437,13379
56820,88056,14046,42388,11668,74010,25819,12438,13381
56825,88060,14047,42390,11669,74013,25820,12438,13382
56830,88070,14048,42395,11670,74022,25822,12439,13383
56835,88076,14048,42397,11670,74028,25825,12440,13385
56840,88087,14051,42401,11672,74036,25828,12441,13387
56845,88091,14051,42402,11672,74040,25829,12441,13388
56850,88101,14053,42407,11674,74048,25831,12441,13390
56855,88107,14053,42409,11674,74054,25834,12443,13391
56860,88118,14055,42416,11675,74063,25837,12446,13391
56865,88122,14056,42420,11676,74066,25838,12447,13391
56870,88132,14058,42425,11678,74074,25840,12448,13392
56875,88138,14058,42425,11678,74080,25843,12448,13395
56880,88149,14060,42426,11679,74089,25846,12448,13398
56885,88153,14060,42427,11679,74093,25847,12449,13398
56890,88163,14062,42431,11680,74101,25849,12449,13400
56895,88169,14062,42436,11680,74106,25852,12452,13400
56900,88180,14065,42442,11682,74115,25855,12455,13400
56905,88184,14065,42444,11682,74119,25856,12456,13400
56910,88194,14067,42448,11683,74127,25858,12456,13402
56915,88200,14067,42450,11683,74132,25861,12456,13405
56920,88211,14071,42456,11687,74140,25864,12457,13407
56925,88215,14071,42457,11687,74144,25865,12457,13408
56930,88225,14073,42461,11688,74152,25867,12459,13408
56935,88231,14073,42463,11688,74157,25870,12460,13410
56940,88242,14076,42467,11690,74166,25873,12461,13412
56945,88246,14077,42470,11691,74169,25874,12462,13412
56950,88256,14079,42476,11692,74177,25876,12463,13413
56955,88262,14079,42478,11692,74183,25879,12464,13415
56960,88273,14082,42483,11694,74191,25882,12466,13416
56965,88277,14082,42484,11694,74195,25883,12467,13416
56970,88287,14083,42485,11694,74204,25885,12467,13418
56975,88293,14083,42490,11694,74209,25888,12469,13419
56980,88304,14088,42496,11698,74215,25891,12470,13421
56985,88308,14089,42496,11699,74219,25892,12470,13422
56990,88318,14092,42505,11701,74226,25894,12472,13422
56995,88324,14092,42507,11701,74232,25897,12474,13423
57000,88335,14094,42513,11703,74241,25900,12477,13423
57005,88339,14095,42516,11704,74244,25901,12478,13423
57010,88349,14098,42521,11706,74251,25903,12478,13425
57015,88355,14098,42523,11706,74257,25906,12479,13427
57020,88366,14101,42531,11709,74264,25909,12481,13428
57025,88370,14103,42533,11711,74267,25910,12482,13428
57030,88380,14106,42540,11714,74274,25912,12484,13428
57035,88386,14106,42545,11714,74279,25915,12487,13428
57040,88397,14109,42548,11716,74287,25918,12488,13430
57045,88401,14110,42549,11717,74291,25919,12488,13431
57050,88411,14111,42553,11718,74300,25921,12490,13431
57055,88417,14111,42554,11718,74306,25924,12490,13434
57060,88428,14113,42560,11720,74314,25927,12492,13435
57065,88432,14115,42562,11722,74317,25928,12492,13436
57070,88442,14117,42565,11723,74325,25930,12493,13437
57075,88448,14117,42567,11723,74330,25933,12494,13439
57080,88459,14120,42571,11726,74338,25936,12494,13442
57085,88463,14123,42574,11729,74340,25937,12494,13443
57090,88473,14124,42578,11729,74349,25939,12494,13445
57095,88479,14124,42583,11729,74355,25942,12497,13445
57100,88490,14125,42588,11730,74365,25945,12497,13448
57105,88494,14126,42590,11731,74368,25946,12497,13449
57110,88504,14127,42595,11732,74377,25948,12498,13450
57115,88510,14127,42598,11732,74382,25951,12499,13452
57120,88521,14129,42603,11734,74392,25954,12500,13454
57125,88525,14130,42606,11735,74395,25955,12501,13454
57130,88535,14131,42612,11736,74404,25957,12503,13454
57135,88541,14131,42616,11736,74409,25960,12505,13455
57140,88552,14132,42620,11737,74419,25963,12505,13458
57145,88556,14133,42622,11738,74423,25964,12505,13459
57150,88566,14134,42626,11739,74432,25966,12505,13461
57155,88572,14134,42629,11739,74438,25969,12508,13461
57160,88583,14135,42635,11740,74447,25972,12509,13463
57165,88587,14136,42637,11741,74451,25973,12510,13463
57170,88597,14137,42641,11741,74460,25975,12511,13464
57175,88603,14137,42643,11741,74465,25978,12512,13466
57180,88614,14138,42649,11742,74475,25981,12514,13467
57185,88618,14139,42650,11743,74479,25982,12514,13468
57190,88628,14141,42656,11744,74487,25984,12516,13468
57195,88634,14141,42660,11744,74492,25987,12518,13469
57200,88645,14144,42665,11746,74500,25990,12519,13471
57205,88649,14145,42666,11747,74504,25991,12520,13471
57210,88659,14147,42670,11748,74512,25993,12520,13473
57215,88665,14147,42673,11748,74518,25996,12523,13473
57220,88676,14149,42677,11749,74527,25999,12524,13475
57225,88680,14149,42678,11749,74531,26000,12524,13476
57230,88690,14152,42682,11751,74538,26002,12525,13477
57235,88696,14152,42683,11751,74544,26005,12526,13479
57240,88707,14155,42690,11753,74552,26008,12528,13480
57245,88711,14156,42692,11754,74555,26009,12528,13481
57250,88721,14158,42697,11755,74563,26011,12528,13483
57255,88727,14158,42702,11755,74568,26014,12530,13484
57260,88738,14162,42708,11758,74576,26017,12532,13485
57265,88742,14162,42709,11758,74580,26018,12532,13486
57270,88752,14164,42716,11759,74588,26020,12534,13486
57275,88758,14164,42719,11759,74593,26023,12534,13489
57280,88769,14168,42725,11763,74600,26026,12535,13491
57285,88773,14170,42727,11765,74603,26027,12536,13491
57290,88783,14171,42730,11766,74612,26029,12536,13493
57295,88789,14171,42731,11766,74618,26032,12537,13495
57300,88800,14174,42735,11768,74626,26035,12538,13497
57305,88804,14174,42735,11768,74630,26036,12538,13498
57310,88814,14175,42741,11769,74639,26038,12539,13499
57315,88820,14175,42744,11769,74645,26041,12541,13500
57320,88831,14177,42752,11771,74654,26043,12543,13500
57325,88835,14177,42755,11771,74658,26044,12544,13500
57330,88845,14178,42759,11772,74667,26046,12546,13500
57335,88851,14178,42760,11772,74673,26049,12547,13502
57340,88862,14179,42762,11772,74683,26051,12548,13503
57345,88866,14180,42765,11773,74686,26052,12549,13503
57350,88876,14181,42771,11774,74695,26054,12551,13503
57355,88882,14181,42774,11774,74701,26057,12553,13504
57360,88893,14184,42780,11777,74709,26059,12554,13505
57365,88897,14184,42780,11777,74713,26060,12554,13506
57370,88907,14185,42786,11778,74722,26062,12555,13507
57375,88913,14185,42789,11778,74728,26065,12558,13507
57380,88924,14188,42794,11780,74736,26067,12558,13509
57385,88928,14189,42796,11781,74739,26068,12559,13509
57390,88938,14190,42800,11782,74748,26070,12560,13510
57395,88944,14190,42803,11782,74753,26073,12561,13512
57400,88955,14193,42808,11784,74762,26075,12563,13512
57405,88959,14193,42809,11784,74766,26076,12563,13513
57410,88969,14196,42814,11787,74773,26078,12564,13514
57415,88975,14196,42818,11787,74779,26081,12567,13514
57420,88986,14198,42820,11788,74788,26084,12567,13517
57425,88990,14199,42822,11789,74791,26085,12567,13518
57430,89000,14200,42827,11789,74800,26087,12568,13519
57435,89006,14200,42829,11789,74806,26090,12569,13521
57440,89017,14200,42834,11789,74816,26093,12571,13522
57445,89021,14201,42836,11790,74820,26094,12572,13522
57450,89031,14202,42840,11790,74829,26096,12574,13522
57455,89037,14202,42842,11790,74835,26099,12574,13525
57460,89048,14203,42851,11791,74845,26102,12576,13526
57465,89052,14203,42853,11791,74849,26103,12576,13527
57470,89062,14204,42859,11792,74858,26105,12578,13527
57475,89068,14204,42862,11792,74863,26108,12580,13528
57480,89079,14205,42866,11793,74874,26111,12581,13530
57485,89083,14205,42866,11793,74878,26112,12581,13531
57490,89093,14206,42870,11794,74887,26114,12582,13532
57495,89099,14206,42873,11794,74892,26117,12584,13533
57500,89110,14208,42878,11796,74901,26120,12585,13535
57505,89114,14209,42879,11797,74905,26121,12585,13536
57510,89124,14210,42885,11798,74914,26123,12587,13536
57515,89130,14210,42887,11798,74920,26126,12588,13538
57520,89141,14210,42892,11798,74931,26129,12590,13539
57525,89145,14211,42894,11799,74934,26130,12590,13540
57530,89155,14212,42900,11800,74943,26132,12591,13541
57535,89161,14212,42903,11800,74948,26135,12592,13543
57540,89172,14215,42906,11802,74957,26138,12594,13544
57545,89176,14217,42910,11804,74959,26139,12595,13544
57550,89186,14218,42915,11805,74968,26141,12595,13546
57555,89192,14218,42919,11805,74973,26144,12596,13548
57560,89203,14220,42925,11807,74982,26147,12598,13549
57565,89207,14223,42928,11810,74984,26148,12598,13550
57570,89217,14224,42931,11810,74993,26150,12598,13552
57575,89223,14224,42936,11810,74998,26153,12600,13553
57580,89234,14227,42942,11813,75006,26156,12602,13554
57585,89238,14230,42945,11816,75008,26157,12603,13554
57590,89248,14231,42949,11817,75017,26159,12603,13556
57595,89254,14231,42954,11817,75023,26162,12606,13556
57600,89265,14233,42959,11819,75032,26165,12607,13558
57605,89269,14233,42961,11819,75036,26166,12608,13558
57610,89279,14234,42964,11820,75045,26168,12608,13560
57615,89285,14234,42967,11820,75050,26171,12609,13562
57620,89296,14237,42972,11823,75059,26174,12610,13564
57625,89300,14239,42974,11825,75061,26175,12610,13565
57630,89310,14240,42977,11826,75070,26177,12610,13567
57635,89316,14240,42980,11826,75075,26180,12611,13569
57640,89327,14242,42984,11827,75085,26183,12612,13571
57645,89331,14242,42985,11827,75089,26184,12612,13572
57650,89341,14243,42989,11827,75098,26186,12612,13574
57655,89347,14243,42992,11827,75103,26189,12613,13576
57660,89358,14246,42995,11829,75112,26192,12614,13578
57665,89362,14247,42997,11830,75115,26193,12615,13578
57670,89372,14248,43000,11830,75124,26195,12615,13580
57675,89378,14248,43004,11830,75129,26198,12618,13580
57680,89389,14252,43009,11833,75137,26201,12619,13582
57685,89393,14252,43010,11833,75141,26202,12619,13583
57690,89403,14253,43016,11834,75150,26204,12620,13584
57695,89409,14253,43018,11834,75155,26207,12620,13587
57700,89420,14256,43023,11836,75163,26210,12621,13589
57705,89424,14257,43024,11837,75167,26211,12621,13590
57710,89434,14258,43029,11837,75176,26213,12622,13591
57715,89440,14258,43031,11837,75182,26216,12623,13593
57720,89451,14259,43035,11838,75191,26219,12623,13596
57725,89455,14261,43038,11840,75194,26220,12624,13596
57730,89465,14262,43041,11840,75203,26222,12625,13597
57735,89471,14262,43045,11840,75209,26225,12627,13598
57740,89482,14264,43050,11842,75218,26228,12628,13600
57745,89486,14265,43052,11843,75221,26229,12629,13600
57750,89496,14266,43057,11844,75230,26231,12630,13601
57755,89502,14266,43062,11844,75235,26234,12633,13601
57760,89513,14270,43071,11847,75242,26237,12636,13601
57765,89517,14272,43074,11849,75245,26238,12637,13601
57770,89527,14273,43079,11850,75254,26240,12638,13602
57775,89533,14273,43082,11850,75259,26243,12638,13605
57780,89544,14277,43090,11854,75267,26246,12639,13607
57785,89548,14279,43094,11856,75269,26247,12640,13607
57790,89558,14280,43100,11857,75278,26249,12640,13609
57795,89564,14280,43102,11857,75283,26252,12641,13611
57800,89575,14284,43108,11860,75291,26255,12643,13612
57805,89579,14285,43110,11861,75294,26256,12643,13613
57810,89589,14286,43115,11861,75303,26258,12645,13613
57815,89595,14286,43119,11861,75309,26261,12648,13613
57820,89606,14288,43126,11863,75317,26264,12649,13615
57825,89610,14290,43129,11865,75320,26265,12650,13615
57830,89620,14291,43135,11865,75329,26267,12651,13616
57835,89626,14291,43138,11865,75335,26270,12653,13617
57840,89637,14293,43142,11867,75343,26273,12653,13620
57845,89641,14295,43144,11869,75346,26274,12653,13621
57850,89651,14296,43148,11869,75355,26276,12654,13622
57855,89657,14296,43152,11869,75361,26279,12656,13623
57860,89668,14297,43158,11869,75370,26282,12658,13624
57865,89672,14299,43160,11871,75373,26283,12658,13625
57870,89682,14300,43165,11871,75382,26285,12659,13626
57875,89688,14300,43167,11871,75387,26288,12659,13629
57880,89699,14303,43172,11873,75395,26291,12661,13630
57885,89703,14304,43174,11874,75399,26292,12661,13631
57890,89713,14305,43176,11874,75408,26294,12661,13633
57895,89719,14305,43180,11874,75414,26297,12663,13634
57900,89730,14307,43186,11875,75423,26300,12666,13634
57905,89734,14307,43187,11875,75427,26301,12666,13635
57910,89744,14308,43193,11875,75436,26303,12668,13635
57915,89750,14308,43194,11875,75442,26306,12668,13638
57920,89761,14310,43201,11876,75450,26309,12671,13638
57925,89765,14311,43203,11877,75454,26310,12672,13638
57930,89775,14312,43209,11877,75463,26312,12674,13638
57935,89781,14312,43211,11877,75469,26315,12675,13640
57940,89792,14314,43221,11879,75477,26318,12678,13640
57945,89796,14315,43223,11880,75481,26319,12679,13640
57950,89806,14316,43228,11881,75490,26321,12679,13642
57955,89812,14316,43232,11881,75495,26324,12681,13643
57960,89823,14318,43237,11883,75505,26327,12683,13644
57965,89827,14318,43238,11883,75509,26328,12684,13644
57970,89837,14319,43243,11884,75518,26330,12685,13645
57975,89843,14319,43243,11884,75524,26333,12685,13648
57980,89854,14322,43247,11886,75532,26335,12685,13650
57985,89858,14324,43250,11888,75534,26336,12686,13650
57990,89868,14325,43257,11889,75543,26338,12688,13650
57995,89874,14325,43259,11889,75548,26341,12688,13653
58000,89885,14329,43266,11892,75555,26343,12689,13654
58005,89889,14330,43266,11893,75559,26344,12689,13655
58010,89899,14331,43268,11893,75568,26346,12690,13656
58015,89905,14331,43273,11893,75573,26349,12693,13656
58020,89916,14334,43279,11895,75582,26351,12694,13657
58025,89920,14335,43281,11896,75585,26352,12694,13658
58030,89930,14336,43286,11897,75594,26354,12695,13659
58035,89936,14336,43290,11897,75599,26357,12697,13660
58040,89947,14340,43298,11901,75607,26359,12699,13660
58045,89951,14340,43299,11901,75611,26360,12699,13661
58050,89961,14340,43303,11901,75621,26362,12699,13663
58055,89967,14340,43307,11901,75627,26365,12701,13664
58060,89978,14341,43310,11901,75637,26367,12702,13665
58065,89982,14341,43312,11901,75641,26368,12703,13665
58070,89992,14341,43314,11901,75651,26370,12703,13667
58075,89998,14341,43316,11901,75657,26373,12704,13669
58080,90009,14343,43325,11903,75666,26376,12707,13669
58085,90013,14343,43326,11903,75670,26377,12708,13669
58090,90023,14343,43333,11903,75680,26379,12710,13669
58095,90029,14343,43337,11903,75686,26382,12712,13670
58100,90040,14344,43340,11903,75696,26385,12712,13673
58105,90044,14344,43342,11903,75700,26386,12713,13673
58110,90054,14344,43346,11903,75710,26388,12714,13674
58115,90060,14344,43348,11903,75716,26391,12715,13676
58120,90071,14345,43353,11904,75726,26394,12716,13678
58125,90075,14346,43355,11905,75729,26395,12717,13678
58130,90085,14346,43360,11905,75739,26397,12719,13678
58135,90091,14346,43364,11905,75745,26400,12721,13679
58140,90102,14348,43370,11907,75754,26403,12722,13681
58145,90106,14350,43372,11909,75756,26404,12722,13682
58150,90116,14351,43379,11910,75765,26406,12724,13682
58155,90122,14351,43382,11910,75771,26409,12727,13682
58160,90133,14352,43387,11910,75781,26412,12730,13682
58165,90137,14353,43389,11911,75784,26413,12731,13682
58170,90147,14354,43396,11912,75793,26415,12733,13682
58175,90153,14354,43401,11912,75798,26418,12736,13682
58180,90164,14357,43406,11915,75806,26421,12737,13684
58185,90168,14359,43407,11917,75809,26422,12737,13685
58190,90178,14360,43409,11917,75818,26424,12737,13687
58195,90184,14360,43412,11917,75823,26427,12739,13688
58200,90195,14363,43417,11920,75831,26430,12740,13690
58205,90199,14365,43419,11922,75834,26431,12740,13691
58210,90209,14366,43422,11922,75843,26433,12740,13693
58215,90215,14366,43423,11922,75849,26436,12741,13695
58220,90226,14368,43427,11924,75857,26439,12742,13697
58225,90230,14369,43429,11925,75861,26440,12743,13697
58230,90240,14370,43432,11926,75870,26442,12744,13698
58235,90246,14370,43433,11926,75876,26445,12744,13701
58240,90257,14371,43435,11926,75886,26448,12744,13704
58245,90261,14371,43437,11926,75890,26449,12745,13704
58250,90271,14372,43440,11926,75899,26451,12745,13706
58255,90277,14372,43445,11926,75905,26454,12748,13706
58260,90288,14375,43450,11928,75912,26457,12748,13709
58265,90292,14376,43451,11929,75916,26458,12748,13710
58270,90302,14377,43457,11929,75925,26460,12750,13710
58275,90308,14377,43460,11929,75931,26463,12753,13710
58280,90319,14379,43464,11930,75940,26466,12754,13712
58285,90323,14380,43467,11931,75943,26467,12755,13712
58290,90333,14381,43473,11931,75952,26469,12757,13712
58295,90339,14381,43475,11931,75958,26472,12759,13713
58300,90350,14383,43482,11933,75966,26475,12760,13715
58305,90354,14384,43482,11934,75970,26476,12760,13716
58310,90364,14385,43485,11934,75979,26478,12760,13718
58315,90370,14385,43487,11934,75984,26481,12761,13720
58320,90381,14388,43490,11936,75993,26484,12762,13722
58325,90385,14388,43490,11936,75997,26485,12762,13723
58330,90395,14389,43496,11936,76006,26487,12764,13723
58335,90401,14389,43498,11936,76012,26489,12765,13724
58340,90412,14390,43502,11936,76021,26492,12765,13727
58345,90416,14392,43505,11938,76024,26493,12766,13727
58350,90426,14393,43512,11939,76033,26495,12768,13727
58355,90432,14393,43516,11939,76039,26497,12770,13727
58360,90443,14395,43521,11941,76047,26500,12771,13729
58365,90447,14397,43524,11943,76050,26501,12772,13729
58370,90457,14398,43530,11944,76059,26503,12774,13729
58375,90463,14398,43531,11944,76065,26505,12774,13731
58380,90474,14401,43538,11947,76073,26508,12774,13734
58385,90478,14402,43540,11948,76076,26509,12774,13735
58390,90488,14403,43545,11949,76085,26510,12774,13736
58395,90494,14403,43549,11949,76090,26512,12776,13736
58400,90505,14406,43555,11952,76098,26515,12778,13737
58405,90509,14408,43558,11954,76101,26516,12779,13737
58410,90519,14409,43563,11954,76110,26517,12779,13738
58415,90525,14409,43566,11954,76115,26519,12779,13740
58420,90536,14412,43571,11957,76124,26522,12780,13742
58425,90540,14413,43574,11958,76127,26523,12781,13742
58430,90550,14414,43581,11959,76136,26524,12781,13743
58435,90556,14414,43583,11959,76141,26527,12781,13746
58440,90567,14416,43587,11960,76150,26530,12782,13748
58445,90571,14417,43588,11961,76154,26531,12783,13748
58450,90581,14418,43594,11962,76163,26532,12784,13748
58455,90587,14418,43596,11962,76169,26535,12785,13750
58460,90598,14420,43600,11964,76178,26538,12787,13751
58465,90602,14421,43601,11965,76181,26539,12787,13752
58470,90612,14422,43604,11965,76190,26540,12788,13752
58475,90618,14422,43606,11965,76196,26543,12789,13754
58480,90629,14424,43612,11966,76204,26546,12791,13755
58485,90633,14426,43613,11968,76207,26547,12791,13756
58490,90643,14427,43617,11968,76216,26549,12792,13757
58495,90649,14427,43620,11968,76222,26552,12794,13758
58500,90660,14429,43627,11970,76231,26555,12795,13760
58505,90664,14430,43629,11971,76234,26556,12796,13760
58510,90674,14431,43637,11972,76243,26558,12798,13760
58515,90680,14431,43639,11972,76249,26561,12799,13762
58520,90691,14433,43643,11974,76258,26564,12800,13764
58525,90695,14434,43645,11975,76261,26565,12800,13765
58530,90705,14435,43649,11976,76270,26567,12800,13767
58535,90711,14435,43652,11976,76276,26570,12801,13769
58540,90722,14437,43659,11978,76284,26573,12802,13771
58545,90726,14438,43661,11979,76288,26574,12803,13771
58550,90736,14439,43666,11980,76297,26576,12804,13772
58555,90742,14439,43670,11980,76303,26579,12806,13773
58560,90753,14441,43673,11981,76312,26582,12807,13775
58565,90757,14442,43674,11982,76315,26583,12807,13776
58570,90767,14443,43678,11982,76324,26585,12807,13778
58575,90773,14443,43681,11982,76329,26587,12807,13780
58580,90784,14446,43686,11985,76338,26590,12809,13781
58585,90788,14447,43688,11986,76341,26591,12809,13782
58590,90798,14448,43692,11987,76350,26593,12810,13783
58595,90804,14448,43695,11987,76355,26595,12811,13784
58600,90815,14450,43700,11989,76364,26598,12811,13787
58605,90819,14452,43702,11991,76367,26599,12811,13788
58610,90829,14453,43707,11991,76376,26601,12811,13790
58615,90835,14453,43711,11991,76381,26603,12811,13792
58620,90846,14457,43716,11995,76389,26606,12812,13794
58625,90850,14458,43717,11996,76392,26607,12812,13795
58630,90860,14459,43718,11996,76401,26608,12812,13796
58635,90866,14459,43721,11996,76407,26610,12814,13796
58640,90877,14460,43725,11996,76416,26612,12814,13798
58645,90881,14461,43726,11997,76420,26613,12814,13799
58650,90891,14462,43731,11998,76429,26614,12815,13799
58655,90897,14462,43733,11998,76434,26616,12815,13801
58660,90908,14465,43740,12001,76442,26618,12816,13802
58665,90912,14468,43743,12004,76444,26619,12817,13802
58670,90922,14469,43744,12004,76453,26620,12817,13803
58675,90928,14469,43746,12004,76459,26623,12819,13804
58680,90939,14472,43755,12007,76466,26625,12820,13805
58685,90943,14474,43756,12009,76469,26626,12820,13806
58690,90953,14475,43761,12009,76478,26627,12820,13807
58695,90959,14475,43764,12009,76484,26630,12823,13807
58700,90970,14477,43770,12011,76493,26632,12823,13809
58705,90974,14478,43772,12012,76496,26633,12823,13810
58710,90984,14479,43775,12013,76505,26634,12823,13811
58715,90990,14479,43776,12013,76511,26637,12824,13813
58720,91001,14481,43783,12015,76520,26639,12826,13813
58725,91005,14481,43784,12015,76524,26640,12826,13814
58730,91015,14482,43788,12015,76533,26641,12827,13814
58735,91021,14482,43791,12015,76538,26644,12828,13816
58740,91032,14484,43795,12016,76547,26647,12830,13817
58745,91036,14486,43798,12018,76550,26648,12831,13817
58750,91046,14487,43804,12019,76559,26650,12832,13818
58755,91052,14487,43806,12019,76565,26653,12834,13819
58760,91063,14490,43813,12021,76572,26656,12835,13821
58765,91067,14491,43815,12022,76576,26657,12836,13821
58770,91077,14492,43820,12023,76585,26659,12837,13822
58775,91083,14492,43825,12023,76590,26662,12839,13823
58780,91094,14495,43831,12025,76598,26665,12841,13824
58785,91098,14497,43832,12027,76601,26665,12841,13824
58790,91108,14498,43837,12027,76610,26667,12842,13825
58795,91114,14498,43838,12027,76616,26670,12842,13828
58800,91125,14500,43844,12028,76624,26673,12845,13828
58805,91129,14502,43847,12030,76627,26673,12845,13828
58810,91139,14503,43851,12031,76636,26675,12845,13830
58815,91145,14503,43856,12031,76641,26677,12847,13830
58820,91156,14505,43862,12033,76650,26680,12849,13831
58825,91160,14507,43864,12035,76653,26680,12849,13831
58830,91170,14508,43866,12035,76662,26682,12850,13832
58835,91176,14508,43869,12035,76668,26684,12852,13832
58840,91187,14509,43873,12036,76677,26687,12853,13834
58845,91191,14512,43877,12039,76679,26687,12853,13834
58850,91201,14513,43880,12040,76688,26689,12853,13836
58855,91207,14513,43885,12040,76693,26691,12855,13836
58860,91218,14517,43892,12043,76700,26694,12858,13836
58865,91222,14518,43893,12044,76704,26694,12858,13836
58870,91232,14518,43896,12044,76714,26696,12858,13838
58875,91238,14518,43901,12044,76720,26698,12859,13839
58880,91249,14519,43907,12045,76730,26701,12861,13840
58885,91253,14520,43910,12046,76733,26701,12861,13840
58890,91263,14520,43917,12046,76743,26702,12862,13840
58895,91269,14520,43923,12046,76749,26704,12864,13840
58900,91280,14522,43931,12048,76758,26707,12866,13841
58905,91284,14523,43933,12049,76761,26707,12866,13841
58910,91294,14523,43939,12049,76771,26708,12867,13841
58915,91300,14523,43942,12049,76777,26711,12869,13842
58920,91311,14524,43946,12050,76787,26714,12871,13843
58925,91315,14525,43948,12051,76790,26714,12871,13843
58930,91325,14525,43955,12051,76800,26715,12872,13843
58935,91331,14525,43958,12051,76806,26718,12874,13844
58940,91342,14527,43965,12053,76815,26721,12875,13846
58945,91346,14528,43967,12054,76818,26721,12875,13846
58950,91356,14528,43970,12054,76828,26722,12875,13847
58955,91362,14528,43974,12054,76834,26725,12877,13848
58960,91373,14529,43979,12054,76844,26728,12878,13850
58965,91377,14529,43980,12054,76848,26728,12878,13850
58970,91387,14530,43986,12055,76857,26729,12879,13850
58975,91393,14530,43989,12055,76863,26732,12880,13852
58980,91404,14532,43995,12057,76872,26735,12882,13853
58985,91408,14532,43995,12057,76876,26735,12882,13853
58990,91418,14533,44001,12058,76885,26737,12882,13855
58995,91424,14533,44003,12058,76890,26740,12882,13858
59000,91435,14535,44007,12059,76899,26743,12883,13860
59005,91439,14537,44009,12061,76902,26743,12883,13860
59010,91449,14538,44012,12061,76911,26745,12884,13861
59015,91455,14538,44014,12061,76917,26748,12884,13864
59020,91466,14539,44019,12062,76926,26751,12886,13865
59025,91470,14542,44022,12065,76928,26751,12886,13865
59030,91480,14543,44030,12066,76937,26753,12888,13865
59035,91486,14543,44035,12066,76942,26756,12890,13866
59040,91497,14545,44041,12068,76951,26759,12892,13867
59045,91501,14547,44042,12070,76954,26759,12892,13867
59050,91511,14548,44047,12071,76963,26761,12894,13867
59055,91517,14548,44049,12071,76969,26763,12896,13867
59060,91528,14549,44054,12072,76979,26766,12897,13869
59065,91532,14550,44056,12073,76982,26766,12897,13869
59070,91542,14551,44061,12074,76991,26768,12898,13870
59075,91548,14551,44065,12074,76997,26770,12900,13870
59080,91559,14554,44072,12077,77005,26773,12902,13871
59085,91563,14555,44074,12078,77008,26773,12902,13871
59090,91573,14556,44078,12079,77017,26775,12903,13872
59095,91579,14556,44080,12079,77023,26777,12904,13873
59100,91590,14557,44084,12079,77032,26780,12905,13875
59105,91594,14559,44085,12081,77035,26780,12905,13875
59110,91604,14560,44091,12082,77044,26782,12906,13876
59115,91610,14560,44094,12082,77049,26784,12907,13877
59120,91621,14563,44100,12084,77057,26787,12909,13878
59125,91625,14565,44101,12086,77060,26787,12909,13878
59130,91635,14566,44105,12086,77069,26788,12910,13878
59135,91641,14566,44109,12086,77074,26790,12911,13879
59140,91652,14568,44114,12088,77083,26793,12913,13880
59145,91656,14571,44116,12091,77085,26793,12913,13880
59150,91666,14572,44120,12092,77094,26794,12913,13881
59155,91672,14572,44124,12092,77099,26797,12916,13881
59160,91683,14575,44128,12094,77108,26800,12918,13882
59165,91687,14576,44129,12095,77111,26800,12918,13882
59170,91697,14577,44136,12096,77120,26801,12919,13882
59175,91703,14577,44140,12096,77125,26804,12921,13883
59180,91714,14579,44141,12097,77135,26807,12921,13886
59185,91718,14580,44142,12098,77138,26807,12921,13886
59190,91728,14581,44144,12098,77147,26808,12921,13887
59195,91734,14581,44146,12098,77152,26811,12921,13890
59200,91745,14584,44154,12101,77160,26814,12924,13890
59205,91749,14586,44157,12103,77163,26814,12924,13890
59210,91759,14587,44162,12103,77172,26815,12925,13890
59215,91765,14587,44165,12103,77177,26818,12927,13891
59220,91776,14591,44172,12107,77184,26821,12928,13893
59225,91780,14592,44174,12108,77188,26821,12928,13893
59230,91790,14593,44178,12109,77197,26823,12928,13895
59235,91796,14593,44182,12109,77202,26826,12929,13897
59240,91807,14597,44188,12113,77210,26829,12930,13899
59245,91811,14598,44190,12114,77213,26829,12930,13899
59250,91821,14599,44197,12114,77222,26831,12931,13900
59255,91827,14599,44202,12114,77228,26834,12934,13900
59260,91838,14601,44205,12115,77237,26837,12935,13902
59265,91842,14602,44208,12116,77240,26837,12935,13902
59270,91852,14603,44211,12117,77249,26839,12935,13904
59275,91858,14603,44212,12117,77255,26842,12936,13906
59280,91869,14604,44215,12117,77265,26845,12938,13907
59285,91873,14605,44217,12118,77268,26845,12938,13907
59290,91883,14606,44222,12118,77277,26847,12939,13908
59295,91889,14606,44225,12118,77283,26849,12940,13909
59300,91900,14607,44229,12118,77292,26851,12942,13909
59305,91904,14610,44233,12121,77294,26851,12942,13909
59310,91914,14611,44239,12122,77303,26853,12943,13910
59315,91920,14611,44245,12122,77308,26855,12945,13910
59320,91931,14613,44247,12123,77318,26857,12946,13911
59325,91935,14615,44250,12125,77320,26857,12946,13911
59330,91945,14616,44255,12125,77329,26859,12948,13911
59335,91951,14616,44257,12125,77335,26861,12949,13912
59340,91962,14617,44262,12125,77344,26863,12950,13913
59345,91966,14618,44263,12126,77348,26863,12950,13913
59350,91976,14619,44268,12127,77357,26865,12951,13914
59355,91982,14619,44271,12127,77362,26867,12952,13915
59360,91993,14622,44275,12129,77371,26869,12953,13916
59365,91997,14622,44275,12129,77375,26869,12953,13916
59370,92007,14623,44280,12130,77384,26870,12953,13917
59375,92013,14623,44284,12130,77390,26872,12954,13918
59380,92024,14626,44288,12133,77398,26874,12955,13919
59385,92028,14626,44289,12133,77402,26874,12955,13919
59390,92038,14627,44295,12133,77411,26875,12956,13919
59395,92044,14627,44300,12133,77416,26878,12958,13920
59400,92055,14630,44304,12136,77425,26881,12959,13922
59405,92059,14631,44305,12137,77428,26881,12959,13922
59410,92069,14632,44309,12137,77437,26882,12959,13923
59415,92075,14632,44310,12137,77442,26885,12959,13926
59420,92086,14634,44315,12139,77452,26888,12960,13928
59425,92090,14635,44317,12140,77455,26888,12960,13928
59430,92100,14636,44321,12141,77464,26889,12960,13929
59435,92106,14636,44321,12141,77470,26892,12960,13932
59440,92117,14638,44327,12143,77479,26895,12961,13934
59445,92121,14639,44329,12144,77482,26895,12961,13934
59450,92131,14640,44333,12144,77491,26896,12961,13935
59455,92137,14640,44336,12144,77497,26899,12963,13936
59460,92148,14641,44340,12145,77506,26902,12964,13938
59465,92152,14642,44340,12146,77510,26902,12964,13938
59470,92162,14643,44343,12146,77519,26903,12965,13938
59475,92168,14643,44346,12146,77525,26906,12967,13939
59480,92179,14645,44352,12148,77534,26909,12969,13940
59485,92183,14647,44356,12150,77536,26909,12969,13940
59490,92193,14648,44361,12150,77545,26911,12970,13941
59495,92199,14648,44363,12150,77551,26914,12971,13943
59500,92210,14650,44369,12152,77559,26917,12972,13945
59505,92214,14651,44371,12153,77563,26917,12972,13945
59510,92224,14652,44374,12153,77572,26919,12972,13947
59515,92230,14652,44375,12153,77577,26922,12972,13950
59520,92241,14655,44380,12155,77585,26925,12973,13952
59525,92245,14656,44380,12156,77589,26925,12973,13952
59530,92255,14657,44384,12157,77598,26927,12974,13953
59535,92261,14657,44384,12157,77604,26929,12974,13955
59540,92272,14659,44390,12159,77613,26932,12976,13956
59545,92276,14660,44393,12160,77616,26932,12976,13956
59550,92286,14661,44396,12160,77625,26934,12977,13957
59555,92292,14661,44398,12160,77631,26936,12978,13958
59560,92303,14664,44405,12162,77639,26939,12981,13958
59565,92307,14666,44409,12164,77641,26939,12981,13958
59570,92317,14667,44416,12164,77650,26941,12983,13958
59575,92323,14667,44418,12164,77656,26943,12983,13960
59580,92334,14669,44423,12165,77665,26945,12984,13961
59585,92338,14670,44425,12166,77668,26945,12984,13961
59590,92348,14671,44429,12166,77677,26947,12985,13962
59595,92354,14671,44432,12166,77682,26949,12986,13963
59600,92365,14674,44436,12168,77690,26951,12987,13964
59605,92369,14676,44439,12170,77693,26951,12987,13964
59610,92379,14677,44444,12170,77702,26953,12989,13964
59615,92385,14677,44446,12170,77708,26955,12989,13966
59620,92396,14680,44452,12172,77716,26957,12990,13967
59625,92400,14681,44453,12173,77719,26957,12990,13967
59630,92410,14682,44459,12174,77728,26959,12991,13968
59635,92416,14682,44462,12174,77734,26962,12992,13970
59640,92427,14683,44465,12174,77744,26964,12993,13971
59645,92431,14684,44466,12175,77747,26964,12993,13971
59650,92441,14685,44470,12175,77756,26965,12993,13972
59655,92447,14685,44473,12175,77761,26968,12994,13974
59660,92458,14688,44477,12177,77770,26970,12994,13976
59665,92462,14688,44478,12177,77774,26970,12994,13976
59670,92472,14689,44481,12178,77783,26971,12994,13977
59675,92478,14689,44483,12178,77789,26974,12994,13980
59680,92489,14691,44488,12179,77798,26976,12996,13980
59685,92493,14692,44491,12180,77801,26976,12996,13980
59690,92503,14693,44496,12180,77810,26977,12996,13981
59695,92509,14693,44500,12180,77815,26980,12997,13983
59700,92520,14696,44507,12182,77823,26982,12999,13983
59705,92524,14698,44510,12184,77826,26982,12999,13983
59710,92534,14698,44514,12184,77836,26983,12999,13984
59715,92540,14698,44514,12184,77842,26986,12999,13987
59720,92551,14700,44520,12185,77851,26988,13000,13988
59725,92555,14701,44522,12186,77854,26988,13000,13988
59730,92565,14701,44528,12186,77864,26989,13000,13989
59735,92571,14701,44532,12186,77870,26992,13003,13989
59740,92582,14703,44538,12187,77879,26994,13003,13991
59745,92586,14703,44538,12187,77883,26994,13003,13991
59750,92596,14703,44543,12187,77893,26996,13003,13993
59755,92602,14703,44545,12187,77899,26999,13004,13995
59760,92613,14705,44550,12189,77908,27001,13005,13996
59765,92617,14705,44552,12189,77912,27001,13005,13996
59770,92627,14705,44558,12189,77922,27003,13006,13997
59775,92633,14705,44559,12189,77928,27005,13006,13999
59780,92644,14706,44561,12189,77938,27007,13007,14000
59785,92648,14706,44561,12189,77942,27007,13007,14000
59790,92658,14706,44564,12189,77952,27009,13007,14002
59795,92664,14706,44566,12189,77958,27011,13008,14003
59800,92675,14708,44574,12191,77967,27013,13008,14005
59805,92679,14708,44575,12191,77971,27013,13008,14005
59810,92689,14709,44580,12192,77980,27015,13010,14005
59815,92695,14709,44583,12192,77985,27017,13011,14006
59820,92706,14712,44587,12194,77993,27019,13011,14008
59825,92710,14714,44588,12196,77996,27019,13011,14008
59830,92720,14715,44592,12197,78005,27021,13012,14009
59835,92726,14715,44593,12197,78011,27023,13013,14010
59840,92737,14717,44597,12198,78019,27025,13013,14012
59845,92741,14718,44599,12199,78023,27025,13013,14012
59850,92751,14719,44604,12199,78032,27027,13014,14013
59855,92757,14719,44606,12199,78037,27029,13014,14015
59860,92768,14722,44611,12202,78046,27031,13014,14017
59865,92772,14723,44612,12203,78049,27031,13014,14017
59870,92782,14724,44617,12204,78058,27033,13015,14018
59875,92788,14724,44621,12204,78063,27036,13018,14018
59880,92799,14727,44625,12206,78072,27038,13020,14018
59885,92803,14727,44626,12206,78076,27038,13020,14018
59890,92813,14728,44629,12206,78085,27039,13020,14019
59895,92819,14728,44630,12206,78091,27042,13020,14022
59900,92830,14730,44637,12208,78100,27044,13022,14022
59905,92834,14731,44639,12209,78103,27044,13022,14022
59910,92844,14732,44645,12210,78112,27045,13023,14022
59915,92850,14732,44646,12210,78118,27048,13023,14025
59920,92861,14734,44650,12211,78127,27050,13023,14027
59925,92865,14735,44651,12212,78130,27050,13023,14027
59930,92875,14736,44655,12213,78139,27051,13023,14028
59935,92881,14736,44659,12213,78145,27054,13025,14029
59940,92892,14738,44663,12215,78154,27056,13026,14030
59945,92896,14738,44666,12215,78158,27056,13026,14030
59950,92906,14739,44670,12216,78167,27057,13027,14030
59955,92912,14739,44674,12216,78173,27060,13029,14031
59960,92923,14740,44678,12216,78183,27062,13029,14033
59965,92927,14741,44680,12217,78186,27062,13029,14033
59970,92937,14742,44681,12218,78195,27063,13029,14034
59975,92943,14742,44686,12218,78200,27066,13032,14034
59980,92954,14744,44691,12220,78210,27068,13033,14035
59985,92958,14744,44694,12220,78214,27068,13033,14035
59990,92968,14745,44701,12221,78223,27069,13034,14035
59995,92974,14745,44703,12221,78229,27072,13035,14037
60000,92985,14746,44705,12221,78239,27074,13036,14038
60005,92989,14747,44707,12222,78242,27074,13036,14038
60010,92999,14748,44710,12222,78251,27076,13036,14040
60015,93005,14748,44712,12222,78257,27079,13037,14042
60020,93016,14749,44716,12222,78267,27081,13037,14044
60025,93020,14750,44717,12222,78270,27081,13037,14044
60030,93030,14751,44722,12222,78279,27083,13039,14044
60035,93036,14751,44723,12222,78285,27086,13039,14047
60040,93047,14752,44728,12222,78294,27088,13040,14048
60045,93051,14754,44729,12223,78297,27088,13040,14048
60050,93061,14755,44735,12223,78306,27090,13041,14049
60055,93067,14755,44738,12223,78312,27093,13043,14050
60060,93078,14757,44744,12225,78321,27095,13044,14051
60065,93082,14758,44745,12225,78324,27095,13044,14051
60070,93092,14759,44751,12226,78333,27097,13045,14052
60075,93098,14759,44756,12226,78338,27100,13048,14052
60080,93109,14762,44762,12229,78347,27102,13049,14053
60085,93113,14763,44763,12229,78350,27102,13049,14053
60090,93123,14764,44769,12230,78359,27104,13051,14053
60095,93129,14764,44772,12230,78364,27106,13051,14055
60100,93140,14766,44777,12231,78374,27108,13053,14055
60105,93144,14767,44778,12231,78377,27108,13053,14055
60110,93154,14768,44780,12232,78386,27110,13054,14056
60115,93160,14768,44783,12232,78392,27112,13056,14056
60120,93171,14770,44791,12233,78400,27114,13057,14057
60125,93175,14772,44793,12234,78403,27114,13057,14057
60130,93185,14773,44798,12234,78412,27115,13057,14058
60135,93191,14773,44799,12234,78417,27117,13057,14060
60140,93202,14775,44805,12235,78426,27119,13059,14060
60145,93206,14777,44808,12237,78429,27119,13059,14060
60150,93216,14778,44812,12237,78438,27120,13059,14061
60155,93222,14778,44814,12237,78443,27122,13060,14062
60160,93233,14780,44819,12238,78452,27124,13060,14064
60165,93237,14782,44821,12240,78455,27124,13060,14064
60170,93247,14783,44824,12241,78464,27125,13060,14065
60175,93253,14783,44828,12241,78470,27127,13061,14066
60180,93264,14785,44835,12243,78478,27129,13062,14067
60185,93268,14787,44837,12244,78481,27129,13062,14067
60190,93278,14788,44842,12245,78490,27130,13062,14068
60195,93284,14788,44845,12245,78496,27133,13064,14069
60200,93295,14789,44851,12246,78505,27135,13065,14070
60205,93299,14791,44854,12248,78508,27135,13065,14070
60210,93309,14792,44859,12248,78517,27136,13066,14070
60215,93315,14792,44863,12248,78523,27139,13069,14070
60220,93326,14793,44868,12248,78533,27141,13070,14071
60225,93330,14794,44870,12248,78536,27141,13070,14071
60230,93340,14795,44874,12249,78545,27142,13070,14072
60235,93346,14795,44875,12249,78551,27145,13070,14075
60240,93357,14797,44883,12251,78560,27147,13071,14076
60245,93361,14798,44886,12251,78563,27147,13071,14076
60250,93371,14799,44889,12251,78572,27149,13072,14077
60255,93377,14799,44893,12251,78577,27152,13074,14078
60260,93388,14801,44899,12253,78586,27154,13074,14080
60265,93392,14803,44900,12255,78589,27154,13074,14080
60270,93402,14804,44907,12256,78598,27156,13076,14080
60275,93408,14804,44911,12256,78603,27159,13078,14081
60280,93419,14807,44918,12258,78611,27161,13079,14082
60285,93423,14809,44920,12260,78614,27161,13079,14082
60290,93433,14810,44923,12260,78623,27163,13080,14083
60295,93439,14810,44925,12260,78628,27166,13081,14085
60300,93450,14812,44929,12261,78638,27168,13081,14087
60305,93454,14813,44932,12262,78641,27168,13081,14087
60310,93464,14814,44938,12263,78650,27170,13083,14087
60315,93470,14814,44943,12263,78655,27173,13085,14088
60320,93481,14816,44950,12265,78664,27175,13086,14089
60325,93485,14818,44953,12267,78667,27175,13086,14089
60330,93495,14819,44957,12268,78676,27177,13087,14090
60335,93501,14819,44959,12268,78681,27180,13088,14092
60340,93512,14822,44967,12271,78690,27182,13090,14092
60345,93516,14823,44969,12272,78693,27182,13090,14092
60350,93526,14824,44973,12273,78702,27184,13090,14094
60355,93532,14824,44977,12273,78707,27187,13092,14095
60360,93543,14827,44985,12276,78716,27189,13094,14095
60365,93547,14828,44988,12277,78719,27189,13094,14095
60370,93557,14829,44994,12278,78728,27191,13095,14096
60375,93563,14829,44997,12278,78733,27194,13096,14098
60380,93574,14832,45002,12280,78742,27196,13097,14099
60385,93578,14833,45005,12280,78745,27196,13097,14099
60390,93588,14834,45009,12280,78754,27198,13098,14100
60395,93594,14834,45013,12280,78760,27201,13101,14100
60400,93605,14836,45019,12282,78769,27203,13102,14101
60405,93609,14837,45020,12282,78772,27203,13102,14101
60410,93619,14838,45025,12282,78781,27205,13103,14102
60415,93625,14838,45028,12282,78786,27208,13104,14104
60420,93636,14841,45033,12284,78795,27210,13105,14105
60425,93640,14842,45034,12285,78798,27210,13105,14105
60430,93650,14843,45037,12285,78807,27212,13105,14107
60435,93656,14843,45039,12285,78813,27214,13105,14109
60440,93667,14845,45045,12287,78821,27216,13105,14111
60445,93671,14847,45048,12289,78824,27216,13105,14111
60450,93681,14848,45053,12289,78833,27218,13106,14112
60455,93687,14848,45058,12289,78838,27220,13108,14112
60460,93698,14850,45063,12291,78848,27222,13109,14113
60465,93702,14851,45065,12291,78851,27222,13109,14113
60470,93712,14852,45070,12291,78860,27224,13110,14114
60475,93718,14852,45072,12291,78865,27226,13111,14115
60480,93729,14854,45078,12293,78874,27228,13111,14117
60485,93733,14856,45081,12295,78877,27228,13111,14117
60490,93743,14857,45085,12296,78886,27229,13112,14117
60495,93749,14857,45089,12296,78891,27231,13113,14118
60500,93760,14860,45095,12299,78899,27233,13113,14120
60505,93764,14862,45097,12300,78902,27233,13113,14120
60510,93774,14863,45101,12300,78911,27234,13113,14121
60515,93780,14863,45103,12300,78916,27236,13114,14122
60520,93791,14865,45107,12301,78926,27238,13114,14124
60525,93795,14866,45110,12302,78929,27238,13114,14124
60530,93805,14867,45117,12302,78938,27239,13115,14124
60535,93811,14867,45120,12302,78944,27242,13116,14126
60540,93822,14869,45126,12304,78952,27244,13116,14128
60545,93826,14871,45128,12306,78955,27244,13116,14128
60550,93836,14872,45132,12307,78964,27245,13116,14129
60555,93842,14872,45134,12307,78970,27248,13117,14131
60560,93853,14873,45136,12307,78980,27250,13117,14133
60565,93857,14874,45137,12308,78983,27250,13117,14133
60570,93867,14875,45142,12308,78992,27251,13118,14133
60575,93873,14875,45147,12308,78997,27254,13121,14133
60580,93884,14878,45155,12311,79005,27256,13122,14134
60585,93888,14880,45157,12312,79008,27256,13122,14134
60590,93898,14881,45165,12313,79017,27258,13123,14135
60595,93904,14881,45170,12313,79022,27261,13125,14136
60600,93915,14884,45173,12315,79031,27263,13125,14138
60605,93919,14885,45173,12315,79034,27263,13125,14138
60610,93929,14886,45180,12316,79043,27265,13127,14138
60615,93935,14886,45184,12316,79049,27268,13129,14139
60620,93946,14887,45189,12316,79059,27270,13129,14141
60625,93950,14888,45191,12316,79062,27270,13129,14141
60630,93960,14889,45195,12317,79071,27272,13129,14143
60635,93966,14889,45198,12317,79077,27275,13132,14143
60640,93977,14890,45204,12318,79086,27277,13133,14144
60645,93981,14892,45206,12320,79089,27277,13133,14144
60650,93991,14893,45211,12320,79098,27279,13134,14145
60655,93997,14893,45214,12320,79104,27282,13136,14146
60660,94008,14895,45221,12322,79113,27284,13137,14147
60665,94012,14896,45223,12322,79116,27284,13137,14147
60670,94022,14897,45227,12323,79125,27286,13137,14149
60675,94028,14897,45230,12323,79131,27289,13138,14151
60680,94039,14899,45237,12324,79140,27291,13140,14151
60685,94043,14900,45239,12324,79143,27291,13140,14151
60690,94053,14901,45242,12324,79152,27293,13140,14153
60695,94059,14901,45243,12324,79157,27296,13140,14156
60700,94070,14904,45250,12326,79165,27298,13141,14157
60705,94074,14906,45252,12328,79168,27298,13141,14157
60710,94084,14907,45258,12329,79177,27300,13141,14159
60715,94090,14907,45260,12329,79183,27303,13143,14160
60720,94101,14908,45267,12330,79192,27305,13144,14161
60725,94105,14910,45270,12332,79195,27305,13144,14161
60730,94115,14911,45275,12333,79204,27307,13144,14163
60735,94121,14911,45278,12333,79210,27310,13146,14164
60740,94132,14912,45283,12334,79219,27312,13147,14165
60745,94136,14914,45284,12335,79222,27312,13147,14165
60750,94146,14915,45289,12336,79231,27314,13148,14166
60755,94152,14915,45293,12336,79236,27317,13150,14167
60760,94163,14918,45297,12339,79244,27319,13150,14169
60765,94167,14920,45301,12341,79247,27319,13150,14169
60770,94177,14921,45304,12342,79256,27321,13151,14170
60775,94183,14921,45307,12342,79261,27323,13152,14171
60780,94194,14924,45314,12344,79269,27325,13154,14171
60785,94198,14926,45315,12345,79272,27325,13154,14171
60790,94208,14927,45319,12346,79281,27326,13154,14172
60795,94214,14927,45321,12346,79287,27328,13156,14172
60800,94225,14929,45327,12347,79295,27330,13156,14174
60805,94229,14931,45328,12349,79298,27330,13156,14174
60810,94239,14932,45333,12350,79307,27331,13156,14175
60815,94245,14932,45335,12350,79313,27333,13156,14177
60820,94256,14933,45341,12351,79323,27335,13156,14179
60825,94260,14934,45343,12352,79326,27335,13156,14179
60830,94270,14935,45351,12353,79335,27336,13157,14179
60835,94276,14935,45354,12353,79341,27338,13159,14179
60840,94287,14937,45357,12354,79350,27340,13159,14181
60845,94291,14938,45359,12355,79353,27340,13159,14181
60850,94301,14939,45365,12356,79362,27341,13160,14181
60855,94307,14939,45368,12356,79368,27343,13161,14182
60860,94318,14941,45376,12358,79376,27345,13162,14183
60865,94322,14943,45378,12360,79379,27345,13162,14183
60870,94332,14944,45383,12361,79388,27346,13162,14184
60875,94338,14944,45388,12361,79393,27349,13165,14184
60880,94349,14946,45393,12363,79403,27351,13166,14185
60885,94353,14947,45394,12363,79406,27351,13166,14185
60890,94363,14948,45400,12363,79415,27353,13167,14186
60895,94369,14948,45402,12363,79421,27356,13168,14188
60900,94380,14949,45406,12363,79431,27358,13169,14189
60905,94384,14950,45408,12363,79434,27358,13169,14189
60910,94394,14951,45413,12363,79443,27360,13169,14191
60915,94400,14951,45418,12363,79449,27363,13172,14191
60920,94411,14952,45422,12363,79459,27365,13173,14192
60925,94415,14953,45424,12363,79462,27365,13173,14192
60930,94425,14954,45429,12363,79471,27367,13174,14193
60935,94431,14954,45432,12363,79476,27370,13176,14194
60940,94442,14956,45436,12364,79486,27372,13176,14196
60945,94446,14957,45439,12364,79489,27372,13176,14196
60950,94456,14958,45448,12365,79498,27374,13178,14196
60955,94462,14958,45452,12365,79503,27377,13180,14197
60960,94473,14960,45457,12366,79512,27379,13180,14199
60965,94477,14962,45460,12368,79515,27379,13180,14199
60970,94487,14963,45463,12368,79524,27381,13181,14200
60975,94493,14963,45468,12368,79530,27384,13184,14200
60980,94504,14964,45469,12368,79540,27386,13184,14202
60985,94508,14965,45472,12368,79543,27386,13184,14202
60990,94518,14966,45473,12368,79552,27388,13184,14204
60995,94524,14966,45476,12368,79558,27391,13186,14205
61000,94535,14967,45484,12369,79567,27393,13188,14205
61005,94539,14969,45487,12370,79570,27393,13188,14205
61010,94549,14970,45491,12371,79579,27395,13189,14206
61015,94555,14970,45493,12371,79585,27398,13190,14208
61020,94566,14971,45500,12371,79595,27400,13192,14208
61025,94570,14972,45500,12371,79598,27400,13192,14208
61030,94580,14973,45505,12371,79607,27402,13193,14209
61035,94586,14973,45508,12371,79613,27405,13195,14210
61040,94597,14974,45516,12371,79622,27407,13197,14210
61045,94601,14976,45519,12373,79625,27407,13197,14210
61050,94611,14977,45523,12373,79634,27409,13198,14211
61055,94617,14977,45527,12373,79639,27412,13200,14212
61060,94628,14979,45528,12374,79649,27414,13200,14214
61065,94632,14980,45529,12374,79652,27414,13200,14214
61070,94642,14981,45534,12374,79661,27416,13201,14215
61075,94648,14981,45539,12374,79667,27419,13204,14215
61080,94659,14982,45544,12374,79677,27421,13205,14216
61085,94663,14983,45548,12375,79680,27421,13205,14216
61090,94673,14984,45551,12376,79689,27423,13206,14217
61095,94679,14984,45554,12376,79694,27425,13207,14218
61100,94690,14986,45560,12378,79704,27427,13209,14218
61105,94694,14987,45561,12379,79707,27427,13209,14218
61110,94704,14988,45566,12379,79716,27429,13210,14219
61115,94710,14988,45568,12379,79722,27431,13211,14220
61120,94721,14989,45572,12379,79731,27433,13213,14220
61125,94725,14991,45574,12380,79734,27433,13213,14220
61130,94735,14992,45579,12381,79743,27434,13213,14221
61135,94741,14992,45582,12381,79748,27436,13213,14223
61140,94752,14994,45589,12382,79757,27438,13214,14224
61145,94756,14996,45592,12384,79760,27438,13214,14224
61150,94766,14997,45597,12384,79769,27439,13215,14224
61155,94772,14997,45599,12384,79775,27441,13216,14225
61160,94783,14998,45604,12385,79785,27443,13217,14226
61165,94787,14999,45606,12386,79788,27443,13217,14226
61170,94797,15000,45613,12387,79797,27444,13218,14226
61175,94803,15000,45617,12387,79802,27446,13219,14227
61180,94814,15002,45621,12388,79812,27448,13220,14228
61185,94818,15003,45623,12388,79815,27448,13220,14228
61190,94828,15004,45630,12389,79824,27449,13221,14228
61195,94834,15004,45634,12389,79829,27452,13223,14229
61200,94845,15006,45641,12391,79838,27454,13223,14231
61205,94849,15008,45643,12392,79841,27454,13223,14231
61210,94859,15009,45645,12392,79850,27455,13223,14232
61215,94865,15009,45648,12392,79856,27458,13224,14234
61220,94876,15010,45653,12392,79866,27460,13226,14234
61225,94880,15011,45654,12392,79869,27460,13226,14234
61230,94890,15012,45658,12393,79878,27462,13227,14235
61235,94896,15012,45664,12393,79883,27465,13230,14235
61240,94907,15014,45669,12394,79892,27467,13231,14236
61245,94911,15016,45672,12396,79895,27467,13231,14236
61250,94921,15017,45679,12396,79904,27469,13233,14236
61255,94927,15017,45681,12396,79910,27472,13233,14239
61260,94938,15018,45687,12396,79920,27474,13234,14240
61265,94942,15019,45690,12397,79923,27474,13234,14240
61270,94952,15020,45696,12398,79932,27476,13236,14240
61275,94958,15020,45699,12398,79938,27479,13237,14242
61280,94969,15021,45706,12399,79948,27481,13238,14243
61285,94973,15022,45708,12399,79951,27481,13238,14243
61290,94983,15023,45714,12400,79960,27483,13240,14243
61295,94989,15023,45720,12400,79965,27486,13243,14243
61300,95000,15025,45726,12402,79975,27488,13243,14245
61305,95004,15026,45728,12402,79978,27488,13243,14245
61310,95014,15027,45732,12403,79987,27490,13244,14246
61315,95020,15027,45735,12403,79993,27493,13245,14248
61320,95031,15028,45737,12404,80002,27495,13245,14250
61325,95035,15030,45739,12406,80005,27495,13245,14250
61330,95045,15031,45746,12407,80014,27497,13247,14250
61335,95051,15031,45750,12407,80019,27500,13249,14251
61340,95062,15033,45757,12409,80029,27502,13251,14251
61345,95066,15034,45758,12409,80032,27502,13251,14251
61350,95076,15035,45766,12409,80041,27504,13253,14251
61355,95082,15035,45768,12409,80047,27507,13255,14252
61360,95093,15036,45774,12410,80056,27509,13256,14253
61365,95097,15038,45775,12411,80059,27509,13256,14253
61370,95107,15039,45780,12412,80068,27511,13257,14254
61375,95113,15039,45785,12412,80073,27514,13260,14254
61380,95124,15041,45789,12413,80082,27516,13260,14256
61385,95128,15043,45791,12414,80085,27516,13260,14256
61390,95138,15044,45794,12414,80094,27518,13261,14257
61395,95144,15044,45797,12414,80100,27521,13262,14259
61400,95155,15045,45802,12415,80110,27523,13263,14260
61405,95159,15046,45804,12415,80113,27523,13263,14260
61410,95169,15047,45809,12415,80122,27525,13264,14261
61415,95175,15047,45811,12415,80128,27528,13265,14263
61420,95186,15048,45815,12416,80138,27530,13265,14265
61425,95190,15049,45816,12417,80141,27530,13265,14265
61430,95200,15050,45818,12417,80150,27532,13265,14267
61435,95206,15050,45820,12417,80155,27534,13265,14269
61440,95217,15052,45826,12418,80164,27536,13266,14270
61445,95221,15054,45827,12420,80167,27536,13266,14270
61450,95231,15055,45830,12420,80176,27537,13266,14271
61455,95237,15055,45832,12420,80182,27539,13266,14273
61460,95248,15056,45837,12421,80192,27541,13266,14275
61465,95252,15057,45838,12422,80195,27541,13266,14275
61470,95262,15058,45847,12423,80204,27542,13267,14275
61475,95268,15058,45850,12423,80209,27544,13267,14277
61480,95279,15060,45854,12425,80219,27546,13268,14278
61485,95283,15061,45856,12426,80222,27546,13268,14278
61490,95293,15062,45863,12427,80231,27547,13268,14279
61495,95299,15062,45867,12427,80237,27549,13270,14279
61500,95310,15063,45875,12428,80246,27551,13271,14280
61505,95314,15065,45878,12430,80249,27551,13271,14280
61510,95324,15066,45881,12430,80258,27552,13272,14280
61515,95330,15066,45883,12430,80263,27554,13272,14282
61520,95341,15068,45888,12431,80273,27556,13272,14284
61525,95345,15069,45889,12431,80276,27556,13272,14284
61530,95355,15070,45892,12431,80285,27557,13273,14284
61535,95361,15070,45895,12431,80291,27560,13274,14286
61540,95372,15071,45898,12431,80301,27562,13275,14287
61545,95376,15072,45899,12431,80304,27562,13275,14287
61550,95386,15073,45905,12432,80313,27564,13276,14288
61555,95392,15073,45907,12432,80318,27567,13277,14290
61560,95403,15075,45914,12434,80327,27569,13278,14291
61565,95407,15077,45917,12436,80330,27569,13278,14291
61570,95417,15078,45921,12436,80339,27571,13279,14292
61575,95423,15078,45923,12436,80345,27574,13280,14294
61580,95434,15079,45930,12437,80354,27576,13281,14295
61585,95438,15081,45933,12439,80357,27576,13281,14295
61590,95448,15082,45937,12439,80366,27578,13282,14296
61595,95454,15082,45939,12439,80372,27581,13283,14298
61600,95465,15083,45948,12439,80381,27583,13285,14298
61605,95469,15085,45952,12441,80384,27583,13285,14298
61610,95479,15086,45959,12442,80393,27585,13287,14298
61615,95485,15086,45963,12442,80399,27588,13289,14299
61620,95496,15087,45967,12443,80409,27590,13291,14299
61625,95500,15088,45969,12443,80412,27590,13291,14299
61630,95510,15089,45973,12443,80421,27592,13292,14300
61635,95516,15089,45977,12443,80426,27595,13293,14302
61640,95527,15091,45981,12444,80436,27597,13293,14304
61645,95531,15092,45983,12445,80439,27597,13293,14304
61650,95541,15093,45987,12446,80448,27599,13293,14306
61655,95547,15093,45990,12446,80453,27602,13294,14308
61660,95558,15095,45995,12447,80462,27604,13296,14308
61665,95562,15097,45997,12448,80465,27604,13296,14308
61670,95572,15098,46003,12448,80474,27606,13298,14308
61675,95578,15098,46006,12448,80480,27608,13299,14309
61680,95589,15099,46011,12448,80489,27610,13300,14310
61685,95593,15101,46013,12449,80492,27610,13300,14310
61690,95603,15102,46019,12449,80501,27611,13301,14310
61695,95609,15102,46022,12449,80506,27613,13303,14310
61700,95620,15104,46028,12450,80515,27615,13305,14310
61705,95624,15106,46031,12451,80518,27615,13305,14310
61710,95634,15107,46036,12452,80527,27616,13306,14310
61715,95640,15107,46036,12452,80533,27618,13306,14312
61720,95651,15108,46043,12453,80542,27620,13307,14313
61725,95655,15110,46046,12455,80545,27620,13307,14313
61730,95665,15111,46050,12455,80554,27621,13308,14313
61735,95671,15111,46055,12455,80559,27623,13310,14313
61740,95682,15113,46063,12456,80568,27625,13312,14313
61745,95686,15115,46065,12457,80571,27625,13312,14313
61750,95696,15116,46069,12457,80580,27626,13312,14314
61755,95702,15116,46072,12457,80586,27628,13313,14315
61760,95713,15117,46078,12458,80595,27630,13314,14316
61765,95717,15119,46081,12459,80598,27630,13314,14316
61770,95727,15120,46085,12459,80607,27631,13315,14316
61775,95733,15120,46088,12459,80613,27634,13317,14317
61780,95744,15121,46093,12459,80623,27636,13319,14317
61785,95748,15122,46095,12460,80626,27636,13319,14317
61790,95758,15123,46100,12461,80635,27638,13320,14318
61795,95764,15123,46104,12461,80640,27641,13322,14319
61800,95775,15125,46112,12463,80649,27643,13324,14319
61805,95779,15127,46115,12465,80652,27643,13324,14319
61810,95789,15128,46118,12466,80661,27645,13324,14321
61815,95795,15128,46121,12466,80667,27648,13326,14322
61820,95806,15129,46128,12466,80676,27650,13327,14323
61825,95810,15131,46130,12468,80679,27650,13327,14323
61830,95820,15132,46136,12468,80688,27652,13328,14324
61835,95826,15132,46140,12468,80693,27655,13330,14325
61840,95837,15134,46146,12470,80703,27657,13331,14326
61845,95841,15135,46147,12470,80706,27657,13331,14326
61850,95851,15136,46153,12471,80715,27659,13333,14326
61855,95857,15136,46157,12471,80720,27662,13334,14328
61860,95868,15138,46160,12472,80729,27664,13335,14329
61865,95872,15140,46162,12474,80732,27664,13335,14329
61870,95882,15141,46167,12474,80741,27666,13336,14330
61875,95888,15141,46171,12474,80746,27669,13338,14331
61880,95899,15143,46176,12476,80756,27671,13340,14331
61885,95903,15144,46180,12477,80759,27671,13340,14331
61890,95913,15145,46186,12478,80768,27673,13341,14332
61895,95919,15145,46189,12478,80774,27676,13343,14333
61900,95930,15146,46193,12478,80783,27678,13343,14335
61905,95934,15148,46195,12480,80786,27678,13343,14335
61910,95944,15149,46200,12481,80795,27680,13343,14337
61915,95950,15149,46201,12481,80800,27683,13343,14340
61920,95961,15151,46206,12483,80810,27685,13344,14341
61925,95965,15152,46208,12483,80813,27685,13344,14341
61930,95975,15153,46214,12484,80822,27686,13344,14342
61935,95981,15153,46216,12484,80828,27688,13345,14343
61940,95992,15154,46219,12484,80837,27690,13346,14344
61945,95996,15156,46220,12485,80840,27690,13346,14344
61950,96006,15157,46224,12485,80849,27691,13346,14345
61955,96012,15157,46226,12485,80855,27693,13347,14346
61960,96023,15158,46232,12485,80865,27695,13349,14346
61965,96027,15159,46233,12485,80868,27695,13349,14346
61970,96037,15160,46235,12486,80877,27696,13350,14346
61975,96043,15160,46237,12486,80882,27698,13350,14348
61980,96054,15162,46245,12488,80891,27700,13352,14348
61985,96058,15164,46246,12490,80894,27700,13352,14348
61990,96068,15165,46253,12491,80903,27701,13352,14349
61995,96074,15165,46254,12491,80909,27703,13352,14351
62000,96085,15166,46259,12491,80919,27705,13353,14352
62005,96089,15167,46261,12492,80922,27705,13353,14352
62010,96099,15168,46269,12493,80931,27706,13354,14352
62015,96105,15168,46271,12493,80936,27708,13355,14353
62020,96116,15170,46278,12495,80945,27710,13355,14355
62025,96120,15172,46279,12496,80948,27710,13355,14355
62030,96130,15173,46284,12496,80957,27711,13355,14356
62035,96136,15173,46286,12496,80963,27714,13356,14358
62040,96147,15174,46291,12496,80972,27716,13357,14359
62045,96151,15176,46292,12497,80975,27716,13357,14359
62050,96161,15177,46295,12497,80984,27718,13358,14360
62055,96167,15177,46299,12497,80989,27721,13359,14362
62060,96178,15179,46305,12498,80998,27723,13360,14363
62065,96182,15181,46307,12500,81001,27723,13360,14363
62070,96192,15182,46312,12501,81010,27725,13361,14364
62075,96198,15182,46317,12501,81016,27728,13364,14364
62080,96209,15183,46320,12501,81026,27730,13365,14365
62085,96213,15184,46322,12501,81029,27730,13365,14365
62090,96223,15185,46328,12501,81038,27732,13366,14366
62095,96229,15185,46330,12501,81044,27735,13367,14368
62100,96240,15186,46332,12501,81054,27737,13367,14370
62105,96244,15187,46334,12501,81057,27737,13367,14370
62110,96254,15188,46339,12502,81066,27739,13368,14371
62115,96260,15188,46342,12502,81072,27742,13370,14372
62120,96271,15189,46347,12503,81081,27744,13370,14374
62125,96275,15191,46349,12505,81084,27744,13370,14374
62130,96285,15192,46351,12505,81093,27746,13371,14375
62135,96291,15192,46353,12505,81099,27749,13373,14376
62140,96302,15193,46358,12505,81108,27751,13374,14377
62145,96306,15195,46361,12507,81111,27751,13374,14377
62150,96316,15196,46365,12507,81120,27753,13374,14379
62155,96322,15196,46368,12507,81125,27756,13375,14381
62160,96333,15198,46374,12509,81134,27758,13376,14382
62165,96337,15200,46377,12511,81137,27758,13376,14382
62170,96347,15201,46380,12511,81146,27760,13376,14384
62175,96353,15201,46383,12511,81151,27763,13377,14386
62180,96364,15203,46388,12512,81161,27765,13378,14387
62185,96368,15204,46390,12513,81164,27765,13378,14387
62190,96378,15205,46394,12513,81173,27767,13380,14387
62195,96384,15205,46396,12513,81178,27770,13381,14389
62200,96395,15207,46401,12515,81187,27772,13381,14391
62205,96399,15209,46404,12517,81190,27772,13381,14391
62210,96409,15210,46407,12518,81199,27774,13382,14392
62215,96415,15210,46410,12518,81205,27777,13384,14393
62220,96426,15211,46417,12519,81215,27779,13386,14393
62225,96430,15212,46418,12519,81218,27779,13386,14393
62230,96440,15213,46424,12519,81227,27780,13387,14393
62235,96446,15213,46426,12519,81233,27782,13387,14395
62240,96457,15214,46435,12520,81242,27784,13388,14396
62245,96461,15216,46438,12521,81245,27784,13388,14396
62250,96471,15217,46443,12522,81254,27785,13388,14397
62255,96477,15217,46444,12522,81260,27787,13388,14399
62260,96488,15218,46449,12522,81270,27789,13389,14400
62265,96492,15219,46452,12523,81273,27789,13389,14400
62270,96502,15220,46457,12523,81282,27790,13389,14401
62275,96508,15220,46459,12523,81287,27792,13390,14402
62280,96519,15222,46465,12524,81296,27794,13391,14403
62285,96523,15224,46468,12526,81299,27794,13391,14403
62290,96533,15225,46471,12526,81308,27795,13391,14404
62295,96539,15225,46475,12526,81313,27797,13392,14405
62300,96550,15227,46481,12527,81322,27799,13394,14405
62305,96554,15229,46484,12528,81325,27799,13394,14405
62310,96564,15230,46488,12529,81334,27800,13395,14405
62315,96570,15230,46492,12529,81339,27802,13396,14406
62320,96581,15232,46498,12531,81349,27804,13397,14407
62325,96585,15233,46500,12531,81352,27804,13397,14407
62330,96595,15234,46505,12532,81361,27806,13398,14408
62335,96601,15234,46507,12532,81367,27809,13399,14410
62340,96612,15235,46516,12533,81376,27811,13400,14411
62345,96616,15237,46518,12535,81379,27811,13400,14411
62350,96626,15238,46522,12535,81388,27813,13400,14413
62355,96632,15238,46525,12535,81393,27816,13401,14415
62360,96643,15240,46532,12537,81402,27818,13403,14415
62365,96647,15242,46534,12539,81405,27818,13403,14415
62370,96657,15243,46540,12539,81414,27820,13404,14416
62375,96663,15243,46545,12539,81420,27823,13407,14416
62380,96674,15244,46550,12539,81430,27825,13409,14416
62385,96678,15245,46553,12540,81433,27825,13409,14416
62390,96688,15246,46560,12541,81442,27827,13410,14417
62395,96694,15246,46565,12541,81448,27830,13413,14417
62400,96705,15247,46571,12542,81457,27832,13414,14418
62405,96709,15249,46572,12543,81460,27832,13414,14418
62410,96719,15250,46577,12543,81469,27834,13414,14420
62415,96725,15250,46582,12543,81475,27837,13417,14420
62420,96736,15251,46586,12543,81485,27839,13418,14421
62425,96740,15252,46586,12543,81488,27839,13418,14421
62430,96750,15253,46590,12543,81497,27841,13419,14422
62435,96756,15253,46592,12543,81502,27844,13420,14424
62440,96767,15255,46595,12544,81512,27846,13421,14425
62445,96771,15256,46596,12544,81515,27846,13421,14425
62450,96781,15257,46599,12545,81524,27848,13421,14427
62455,96787,15257,46601,12545,81530,27851,13422,14429
62460,96798,15258,46605,12546,81540,27853,13422,14431
62465,96802,15259,46607,12547,81543,27853,13422,14431
62470,96812,15260,46613,12548,81552,27855,13422,14433
62475,96818,15260,46616,12548,81558,27858,13424,14434
62480,96829,15261,46620,12548,81567,27860,13425,14435
62485,96833,15263,46622,12550,81570,27860,13425,14435
62490,96843,15264,46627,12551,81579,27862,13426,14436
62495,96849,15264,46630,12551,81585,27865,13428,14437
62500,96860,15265,46633,12551,81595,27867,13428,14439
62505,96864,15266,46635,12551,81598,27867,13428,14439
62510,96874,15267,46641,12552,81607,27869,13428,14441
62515,96880,15267,46644,12552,81613,27872,13430,14442
62520,96891,15268,46651,12552,81623,27874,13431,14443
62525,96895,15269,46653,12552,81626,27874,13431,14443
62530,96905,15270,46658,12552,81635,27876,13431,14445
62535,96911,15270,46661,12552,81641,27879,13432,14447
62540,96922,15271,46670,12552,81650,27881,13434,14447
62545,96926,15273,46673,12553,81653,27881,13434,14447
62550,96936,15274,46679,12554,81662,27882,13435,14447
62555,96942,15274,46681,12554,81667,27884,13435,14449
62560,96953,15276,46687,12556,81676,27886,13435,14451
62565,96957,15278,46688,12557,81679,27886,13435,14451
62570,96967,15279,46696,12558,81688,27887,13436,14451
62575,96973,15279,46700,12558,81694,27889,13437,14452
62580,96984,15280,46705,12559,81704,27891,13438,14453
62585,96988,15281,46707,12559,81707,27891,13438,14453
62590,96998,15282,46711,12559,81716,27892,13438,14454
62595,97004,15282,46714,12559,81722,27894,13439,14455
62600,97015,15283,46718,12559,81731,27896,13441,14455
62605,97019,15285,46721,12561,81734,27896,13441,14455
62610,97029,15286,46725,12561,81743,27897,13442,14455
62615,97035,15286,46728,12561,81748,27899,13443,14456
62620,97046,15288,46732,12563,81758,27901,13445,14456
62625,97050,15289,46733,12564,81761,27901,13445,14456
62630,97060,15290,46741,12565,81770,27902,13445,14457
62635,97066,15290,46743,12565,81776,27904,13446,14458
62640,97077,15291,46750,12566,81786,27906,13447,14459
62645,97081,15292,46753,12567,81789,27906,13447,14459
62650,97091,15293,46755,12567,81798,27907,13447,14460
62655,97097,15293,46759,12567,81804,27910,13449,14461
62660,97108,15294,46765,12567,81814,27912,13451,14461
62665,97112,15295,46768,12568,81817,27912,13451,14461
62670,97122,15296,46771,12568,81826,27914,13453,14461
62675,97128,15296,46776,12568,81831,27917,13456,14461
62680,97139,15298,46780,12570,81840,27919,13457,14462
62685,97143,15300,46782,12570,81843,27919,13457,14462
62690,97153,15301,46787,12570,81852,27921,13458,14463
62695,97159,15301,46791,12570,81857,27924,13460,14464
62700,97170,15303,46795,12572,81866,27926,13461,14465
62705,97174,15305,46799,12573,81869,27926,13461,14465
62710,97184,15306,46803,12573,81878,27928,13461,14467
62715,97190,15306,46804,12573,81883,27931,13462,14469
62720,97201,15308,46809,12574,81892,27933,13462,14471
62725,97205,15310,46811,12574,81895,27933,13462,14471
62730,97215,15311,46818,12574,81904,27935,13464,14471
62735,97221,15311,46821,12574,81909,27938,13466,14472
62740,97232,15313,46826,12575,81918,27940,13467,14473
62745,97236,15315,46830,12576,81921,27940,13467,14473
62750,97246,15316,46835,12576,81930,27942,13468,14474
62755,97252,15316,46836,12576,81935,27945,13468,14477
62760,97263,15318,46842,12577,81944,27947,13469,14478
62765,97267,15320,46843,12578,81947,27947,13469,14478
62770,97277,15321,46847,12578,81956,27949,13470,14479
62775,97283,15321,46851,12578,81961,27952,13472,14480
62780,97294,15323,46856,12578,81970,27954,13474,14480
62785,97298,15325,46858,12578,81973,27954,13474,14480
62790,97308,15326,46861,12579,81982,27956,13474,14482
62795,97314,15326,46863,12579,81987,27959,13474,14485
62800,97325,15328,46869,12580,81996,27961,13476,14485
62805,97329,15330,46872,12582,81999,27961,13476,14485
62810,97339,15331,46877,12582,82008,27963,13476,14487
62815,97345,15331,46880,12582,82013,27966,13478,14488
62820,97356,15333,46886,12583,82022,27968,13480,14488
62825,97360,15335,46889,12585,82025,27968,13480,14488
62830,97370,15336,46895,12586,82034,27970,13481,14489
62835,97376,15336,46901,12586,82039,27973,13484,14489
62840,97387,15338,46907,12587,82048,27975,13486,14489
62845,97391,15340,46911,12589,82051,27975,13486,14489
62850,97401,15341,46918,12589,82060,27977,13488,14489
62855,97407,15341,46923,12589,82065,27980,13491,14489
62860,97418,15343,46928,12590,82074,27982,13491,14491
62865,97422,15345,46930,12591,82077,27982,13491,14491
62870,97432,15346,46934,12592,82086,27984,13491,14493
62875,97438,15346,46936,12592,82091,27987,13491,14496
62880,97449,15348,46942,12593,82100,27989,13493,14496
62885,97453,15350,46943,12594,82103,27989,13493,14496
62890,97463,15351,46949,12595,82112,27991,13494,14497
62895,97469,15351,46952,12595,82117,27993,13495,14498
62900,97480,15353,46958,12596,82126,27995,13497,14498
62905,97484,15355,46959,12596,82129,27995,13497,14498
62910,97494,15356,46965,12597,82138,27996,13498,14498
62915,97500,15356,46968,12597,82143,27998,13499,14499
62920,97511,15358,46976,12597,82152,28000,13501,14499
62925,97515,15360,46977,12598,82155,28000,13501,14499
62930,97525,15361,46980,12598,82164,28001,13501,14500
62935,97531,15361,46981,12598,82169,28003,13502,14501
62940,97542,15363,46985,12598,82178,28005,13503,14502
62945,97546,15365,46987,12599,82181,28005,13503,14502
62950,97556,15366,46990,12599,82190,28006,13504,14502
62955,97562,15366,46994,12599,82195,28008,13505,14503
62960,97573,15368,47000,12599,82204,28010,13505,14505
62965,97577,15370,47004,12601,82207,28010,13505,14505
62970,97587,15371,47008,12602,82216,28011,13506,14505
62975,97593,15371,47009,12602,82221,28013,13507,14506
62980,97604,15373,47014,12602,82230,28015,13508,14507
62985,97608,15375,47016,12602,82233,28015,13508,14507
62990,97618,15376,47019,12602,82242,28016,13508,14508
62995,97624,15376,47023,12602,82247,28019,13509,14510
63000,97635,15378,47027,12603,82256,28021,13510,14511
63005,97639,15380,47030,12604,82259,28021,13510,14511
63010,97649,15381,47036,12605,82268,28022,13511,14511
63015,97655,15381,47039,12605,82273,28025,13512,14513
63020,97666,15383,47044,12607,82282,28027,13513,14514
63025,97670,15385,47045,12607,82285,28027,13513,14514
63030,97680,15386,47051,12608,82294,28029,13513,14516
63035,97686,15386,47054,12608,82299,28032,13515,14517
63040,97697,15388,47060,12609,82308,28034,13516,14518
63045,97701,15390,47061,12609,82311,28034,13516,14518
63050,97711,15391,47067,12610,82320,28036,13517,14519
63055,97717,15391,47069,12610,82325,28039,13518,14521
63060,97728,15393,47072,12611,82334,28041,13519,14522
63065,97732,15395,47073,12612,82337,28041,13519,14522
63070,97742,15396,47077,12612,82346,28043,13520,14523
63075,97748,15396,47080,12612,82351,28046,13521,14525
63080,97759,15398,47083,12613,82360,28048,13523,14525
63085,97763,15400,47086,12614,82363,28048,13523,14525
63090,97773,15401,47090,12615,82372,28050,13523,14527
63095,97779,15401,47092,12615,82377,28053,13524,14529
63100,97790,15403,47096,12616,82386,28055,13524,14531
63105,97794,15405,47097,12616,82389,28055,13524,14531
63110,97804,15406,47101,12616,82398,28057,13524,14533
63115,97810,15406,47104,12616,82403,28060,13525,14535
63120,97821,15408,47109,12617,82412,28062,13526,14536
63125,97825,15410,47112,12619,82415,28062,13526,14536
63130,97835,15411,47118,12620,82424,28064,13527,14537
63135,97841,15411,47123,12620,82429,28067,13530,14537
63140,97852,15413,47127,12620,82438,28069,13531,14538
63145,97856,15415,47129,12620,82441,28069,13531,14538
63150,97866,15416,47134,12620,82450,28071,13532,14539
63155,97872,15416,47139,12620,82455,28074,13534,14540
63160,97883,15418,47144,12621,82464,28076,13536,14540
63165,97887,15420,47148,12623,82467,28076,13536,14540
63170,97897,15421,47157,12624,82476,28078,13538,14540
63175,97903,15421,47159,12624,82481,28081,13539,14542
63180,97914,15423,47164,12625,82490,28083,13539,14544
63185,97918,15425,47166,12627,82493,28083,13539,14544
63190,97928,15426,47170,12628,82502,28085,13541,14544
63195,97934,15426,47176,12628,82507,28088,13544,14544
63200,97945,15428,47179,12629,82516,28090,13545,14545
63205,97949,15430,47180,12629,82519,28090,13545,14545
63210,97959,15431,47186,12630,82528,28092,13546,14546
63215,97965,15431,47190,12630,82533,28095,13547,14548
63220,97976,15433,47197,12632,82542,28097,13548,14549
63225,97980,15435,47200,12634,82545,28097,13548,14549
63230,97990,15436,47206,12634,82554,28099,13550,14549
63235,97996,15436,47208,12634,82559,28101,13552,14549
63240,98007,15438,47212,12634,82568,28103,13553,14550
63245,98011,15440,47213,12635,82571,28103,13553,14550
63250,98021,15441,47218,12635,82580,28105,13554,14551
63255,98027,15441,47218,12635,82585,28107,13554,14553
63260,98038,15443,47224,12635,82594,28109,13555,14554
63265,98042,15445,47226,12636,82597,28109,13555,14554
63270,98052,15446,47228,12637,82606,28110,13555,14555
63275,98058,15446,47231,12637,82611,28112,13556,14556
63280,98069,15448,47238,12637,82620,28114,13557,14557
63285,98073,15450,47241,12639,82623,28114,13557,14557
63290,98083,15451,47246,12640,82632,28115,13558,14557
63295,98089,15451,47250,12640,82637,28117,13559,14558
63300,98100,15453,47257,12641,82646,28119,13559,14560
63305,98104,15455,47259,12642,82649,28119,13559,14560
63310,98114,15456,47262,12642,82658,28120,13559,14561
63315,98120,15456,47266,12642,82663,28122,13561,14561
63320,98131,15458,47272,12643,82672,28124,13562,14562
63325,98135,15460,47275,12644,82675,28124,13562,14562
63330,98145,15461,47280,12644,82684,28125,13563,14562
63335,98151,15461,47282,12644,82689,28128,13565,14563
63340,98162,15463,47290,12645,82698,28130,13567,14563
63345,98166,15465,47293,12645,82701,28130,13567,14563
63350,98176,15466,47300,12646,82710,28131,13568,14563
63355,98182,15466,47301,12646,82715,28134,13568,14566
63360,98193,15468,47309,12647,82724,28136,13569,14567
63365,98197,15470,47310,12648,82727,28136,13569,14567
63370,98207,15471,47315,12648,82736,28137,13570,14567
63375,98213,15471,47318,12648,82741,28140,13571,14569
63380,98224,15473,47325,12648,82750,28142,13573,14569
63385,98228,15475,47325,12649,82753,28142,13573,14569
63390,98238,15476,47329,12649,82762,28144,13573,14571
63395,98244,15476,47330,12649,82767,28147,13574,14573
63400,98255,15478,47335,12649,82776,28149,13575,14574
63405,98259,15480,47337,12649,82779,28149,13575,14574
63410,98269,15481,47341,12649,82788,28151,13577,14574
63415,98275,15481,47343,12649,82793,28154,13579,14575
63420,98286,15483,47348,12650,82802,28156,13579,14577
63425,98290,15485,47349,12651,82805,28156,13579,14577
63430,98300,15486,47357,12652,82814,28158,13581,14577
63435,98306,15486,47361,12652,82819,28161,13583,14578
63440,98317,15488,47365,12654,82828,28163,13583,14580
63445,98321,15490,47365,12654,82831,28163,13583,14580
63450,98331,15491,47369,12654,82840,28165,13584,14581
63455,98337,15491,47372,12654,82845,28168,13586,14582
63460,98348,15493,47378,12654,82854,28170,13587,14583
63465,98352,15495,47380,12655,82857,28170,13587,14583
63470,98362,15496,47386,12656,82866,28172,13588,14584
63475,98368,15496,47389,12656,82871,28175,13589,14586
63480,98379,15498,47394,12657,82880,28177,13590,14587
63485,98383,15500,47398,12659,82883,28177,13590,14587
63490,98393,15501,47403,12660,82892,28179,13590,14589
63495,98399,15501,47408,12660,82897,28181,13591,14590
63500,98410,15503,47415,12662,82906,28183,13592,14591
63505,98414,15505,47417,12664,82909,28183,13592,14591
63510,98424,15506,47422,12664,82918,28185,13592,14593
63515,98430,15506,47422,12664,82923,28187,13592,14595
63520,98441,15508,47427,12665,82932,28189,13593,14596
63525,98445,15510,47430,12665,82935,28189,13593,14596
63530,98455,15511,47435,12665,82944,28191,13593,14598
63535,98461,15511,47438,12665,82949,28193,13593,14600
63540,98472,15513,47445,12666,82958,28195,13594,14601
63545,98476,15515,47447,12667,82961,28195,13594,14601
63550,98486,15516,47451,12667,82970,28197,13594,14603
63555,98492,15516,47453,12667,82975,28199,13595,14604
63560,98503,15518,47458,12668,82984,28201,13595,14606
63565,98507,15520,47461,12668,82987,28201,13595,14606
63570,98517,15521,47468,12669,82996,28203,13597,14606
63575,98523,15521,47470,12669,83001,28205,13597,14608
63580,98534,15523,47476,12670,83010,28207,13598,14609
63585,98538,15525,47477,12671,83013,28207,13598,14609
63590,98548,15526,47481,12671,83022,28209,13599,14610
63595,98554,15526,47484,12671,83027,28212,13600,14612
63600,98565,15528,47491,12673,83036,28214,13602,14612
63605,98569,15530,47493,12674,83039,28214,13602,14612
63610,98579,15531,47499,12675,83048,28216,13604,14612
63615,98585,15531,47502,12675,83053,28219,13605,14614
63620,98596,15533,47505,12676,83062,28221,13605,14616
63625,98600,15535,47505,12677,83065,28221,13605,14616
63630,98610,15536,47510,12677,83074,28222,13606,14616
63635,98616,15536,47512,12677,83079,28225,13608,14617
63640,98627,15538,47518,12678,83088,28227,13609,14618
63645,98631,15540,47519,12678,83091,28227,13609,14618
63650,98641,15541,47522,12679,83100,28228,13609,14619
63655,98647,15541,47525,12679,83105,28231,13611,14620
63660,98658,15543,47529,12679,83114,28233,13612,14621
63665,98662,15545,47531,12680,83117,28233,13612,14621
63670,98672,15546,47538,12681,83126,28234,13613,14621
63675,98678,15546,47540,12681,83132,28237,13615,14622
63680,98689,15547,47545,12681,83141,28239,13615,14624
63685,98693,15549,47547,12682,83144,28239,13615,14624
63690,98703,15550,47553,12683,83153,28240,13615,14625
63695,98709,15550,47557,12683,83158,28243,13617,14626
63700,98720,15552,47564,12685,83168,28245,13618,14627
63705,98724,15553,47565,12685,83171,28245,13618,14627
63710,98734,15554,47571,12686,83180,28246,13618,14628
63715,98740,15554,47573,12686,83185,28249,13619,14630
63720,98751,15556,47580,12687,83194,28251,13620,14631
63725,98755,15558,47581,12688,83197,28251,13620,14631
63730,98765,15559,47586,12689,83206,28253,13621,14632
63735,98771,15559,47587,12689,83212,28255,13621,14634
63740,98782,15560,47593,12690,83222,28257,13622,14635
63745,98786,15561,47594,12690,83225,28257,13622,14635
63750,98796,15562,47595,12691,83234,28259,13622,14637
63755,98802,15562,47599,12691,83240,28261,13624,14637
63760,98813,15563,47603,12691,83250,28263,13626,14637
63765,98817,15564,47605,12692,83253,28263,13626,14637
63770,98827,15565,47608,12692,83262,28265,13626,14639
63775,98833,15565,47611,12692,83267,28267,13627,14640
63780,98844,15567,47613,12693,83277,28269,13628,14641
63785,98848,15568,47615,12693,83280,28269,13628,14641
63790,98858,15569,47620,12694,83289,28271,13630,14641
63795,98864,15569,47625,12694,83294,28273,13631,14642
63800,98875,15571,47630,12696,83303,28275,13632,14643
63805,98879,15573,47633,12698,83306,28275,13632,14643
63810,98889,15574,47636,12698,83315,28277,13633,14644
63815,98895,15574,47639,12698,83320,28279,13634,14645
63820,98906,15576,47645,12699,83329,28281,13636,14645
63825,98910,15578,47647,12700,83332,28281,13636,14645
63830,98920,15579,47653,12700,83341,28283,13638,14645
63835,98926,15579,47655,12700,83347,28286,13640,14646
63840,98937,15580,47659,12701,83356,28288,13640,14648
63845,98941,15582,47662,12703,83359,28288,13640,14648
63850,98951,15583,47667,12704,83368,28290,13641,14649
63855,98957,15583,47669,12704,83374,28293,13642,14651
63860,98968,15584,47674,12704,83384,28295,13643,14652
63865,98972,15585,47674,12704,83387,28295,13643,14652
63870,98982,15586,47679,12705,83396,28297,13644,14653
63875,98988,15586,47683,12705,83402,28300,13646,14654
63880,98999,15587,47686,12705,83412,28302,13647,14655
63885,99003,15588,47687,12705,83415,28302,13647,14655
63890,99013,15589,47692,12705,83424,28304,13648,14656
63895,99019,15589,47692,12705,83430,28307,13648,14659
63900,99030,15590,47700,12706,83440,28309,13650,14659
63905,99034,15591,47703,12707,83443,28309,13650,14659
63910,99044,15592,47709,12707,83452,28311,13651,14660
63915,99050,15592,47711,12707,83457,28314,13651,14663
63920,99061,15594,47717,12708,83467,28316,13652,14664
63925,99065,15595,47719,12708,83470,28316,13652,14664
63930,99075,15596,47722,12709,83479,28318,13652,14666
63935,99081,15596,47724,12709,83485,28321,13654,14667
63940,99092,15597,47729,12709,83494,28323,13655,14668
63945,99096,15599,47730,12711,83497,28323,13655,14668
63950,99106,15600,47732,12711,83506,28325,13655,14670
63955,99112,15600,47733,12711,83512,28328,13656,14672
63960,99123,15601,47740,12712,83522,28330,13657,14673
63965,99127,15602,47741,12712,83525,28330,13657,14673
63970,99137,15603,47746,12712,83534,28331,13657,14674
63975,99143,15603,47749,12712,83540,28334,13659,14675
63980,99154,15604,47755,12712,83550,28336,13661,14675
63985,99158,15605,47758,12713,83553,28336,13661,14675
63990,99168,15606,47767,12713,83562,28337,13662,14675
63995,99174,15606,47769,12713,83568,28340,13662,14678
64000,99185,15607,47773,12713,83578,28342,13662,14680
64005,99189,15608,47774,12713,83581,28342,13662,14680
64010,99199,15609,47781,12714,83590,28343,13663,14680
64015,99205,15609,47785,12714,83595,28346,13665,14681
64020,99216,15611,47788,12715,83605,28348,13666,14682
64025,99220,15612,47791,12716,83608,28348,13666,14682
64030,99230,15613,47797,12716,83617,28349,13666,14683
64035,99236,15613,47802,12716,83622,28351,13668,14683
64040,99247,15615,47809,12718,83632,28353,13669,14684
64045,99251,15616,47810,12719,83635,28353,13669,14684
64050,99261,15617,47816,12720,83644,28354,13670,14684
64055,99267,15617,47819,12720,83649,28356,13671,14685
64060,99278,15619,47822,12721,83659,28358,13672,14686
64065,99282,15620,47824,12721,83662,28358,13672,14686
64070,99292,15621,47829,12722,83671,28360,13673,14687
64075,99298,15621,47833,12722,83676,28362,13674,14688
64080,99309,15623,47840,12724,83685,28364,13675,14689
64085,99313,15625,47843,12726,83688,28364,13675,14689
64090,99323,15626,47849,12726,83697,28366,13677,14689
64095,99329,15626,47854,12726,83702,28368,13679,14689
64100,99340,15628,47862,12727,83712,28370,13681,14689
64105,99344,15629,47863,12727,83715,28370,13681,14689
64110,99354,15630,47867,12728,83724,28372,13683,14689
64115,99360,15630,47870,12728,83730,28374,13684,14690
64120,99371,15631,47875,12728,83740,28376,13684,14692
64125,99375,15632,47876,12729,83743,28376,13684,14692
64130,99385,15633,47879,12729,83752,28378,13684,14694
64135,99391,15633,47883,12729,83758,28381,13687,14694
64140,99402,15634,47888,12729,83768,28383,13688,14695
64145,99406,15635,47890,12730,83771,28383,13688,14695
64150,99416,15636,47894,12730,83780,28385,13689,14696
64155,99422,15636,47896,12730,83786,28388,13690,14698
64160,99433,15637,47902,12730,83796,28390,13692,14698
64165,99437,15638,47904,12731,83799,28390,13692,14698
64170,99447,15639,47910,12732,83808,28392,13693,14699
64175,99453,15639,47912,12732,83814,28395,13695,14700
64180,99464,15640,47918,12732,83824,28397,13697,14700
64185,99468,15641,47921,12733,83827,28397,13697,14700
64190,99478,15642,47925,12734,83836,28399,13697,14702
64195,99484,15642,47929,12734,83842,28402,13700,14702
64200,99495,15643,47933,12735,83852,28404,13700,14704
64205,99499,15644,47934,12735,83855,28404,13700,14704
64210,99509,15645,47939,12736,83864,28405,13700,14705
64215,99515,15645,47943,12736,83869,28408,13701,14707
64220,99526,15647,47947,12737,83879,28410,13701,14709
64225,99530,15648,47948,12737,83882,28410,13701,14709
64230,99540,15649,47953,12737,83891,28411,13701,14710
64235,99546,15649,47956,12737,83896,28414,13703,14711
64240,99557,15651,47960,12738,83906,28416,13704,14712
64245,99561,15652,47962,12738,83909,28416,13704,14712
64250,99571,15653,47965,12738,83918,28417,13704,14713
64255,99577,15653,47969,12738,83924,28420,13706,14714
64260,99588,15654,47973,12738,83934,28422,13707,14715
64265,99592,15655,47976,12738,83937,28422,13707,14715
64270,99602,15656,47979,12738,83946,28423,13707,14716
64275,99608,15656,47981,12738,83951,28426,13708,14718
64280,99619,15658,47985,12739,83961,28428,13709,14719
64285,99623,15659,47986,12739,83964,28428,13709,14719
64290,99633,15660,47993,12739,83973,28429,13709,14720
64295,99639,15660,47995,12739,83979,28432,13710,14722
64300,99650,15661,48001,12739,83988,28434,13711,14723
64305,99654,15663,48002,12741,83991,28434,13711,14723
64310,99664,15664,48006,12741,84000,28436,13712,14724
64315,99670,15664,48010,12741,84005,28439,13714,14725
64320,99681,15666,48017,12743,84014,28441,13714,14727
64325,99685,15668,48019,12744,84017,28441,13714,14727
64330,99695,15669,48025,12745,84026,28443,13716,14727
64335,99701,15669,48026,12745,84031,28446,13716,14730
64340,99712,15671,48034,12747,84040,28448,13717,14731
64345,99716,15673,48037,12749,84043,28448,13717,14731
64350,99726,15674,48041,12750,84052,28450,13717,14733
64355,99732,15674,48044,12750,84057,28452,13718,14734
64360,99743,15676,48049,12751,84067,28454,13720,14734
64365,99747,15677,48050,12751,84070,28454,13720,14734
64370,99757,15678,48053,12751,84079,28456,13721,14735
64375,99763,15678,48057,12751,84084,28458,13723,14735
64380,99774,15680,48065,12752,84093,28460,13724,14736
64385,99778,15682,48068,12754,84096,28460,13724,14736
64390,99788,15683,48073,12755,84105,28462,13724,14738
64395,99794,15683,48074,12755,84111,28464,13724,14740
64400,99805,15684,48078,12756,84120,28466,13724,14742
64405,99809,15686,48081,12758,84123,28466,13724,14742
64410,99819,15687,48086,12759,84132,28468,13725,14743
64415,99825,15687,48089,12759,84137,28470,13725,14745
64420,99836,15689,48095,12760,84146,28472,13727,14745
64425,99840,15691,48097,12762,84149,28472,13727,14745
64430,99850,15692,48103,12763,84158,28474,13729,14745
64435,99856,15692,48105,12763,84164,28476,13731,14745
64440,99867,15693,48112,12764,84173,28478,13731,14747
64445,99871,15695,48114,12765,84176,28478,13731,14747
64450,99881,15696,48120,12766,84185,28479,13732,14747
64455,99887,15696,48122,12766,84191,28482,13734,14748
64460,99898,15697,48125,12766,84201,28484,13734,14750
64465,99902,15698,48127,12766,84204,28484,13734,14750
64470,99912,15699,48129,12766,84213,28485,13734,14751
64475,99918,15699,48130,12766,84219,28488,13735,14753
64480,99929,15700,48133,12767,84229,28490,13735,14755
64485,99933,15701,48133,12767,84232,28490,13735,14755
64490,99943,15702,48136,12767,84241,28491,13735,14756
64495,99949,15702,48137,12767,84247,28494,13736,14758
64500,99960,15703,48143,12768,84256,28496,13737,14759
64505,99964,15705,48146,12770,84259,28496,13737,14759
64510,99974,15706,48150,12770,84268,28497,13738,14759
64515,99980,15706,48152,12770,84274,28500,13738,14762
64520,99991,15707,48157,12770,84283,28502,13738,14764
64525,99995,15709,48160,12771,84286,28502,13738,14764
64530,100005,15710,48165,12771,84295,28503,13739,14764
64535,100011,15710,48167,12771,84300,28506,13740,14766
64540,100022,15712,48171,12772,84309,28508,13741,14767
64545,100026,15714,48173,12773,84312,28508,13741,14767
64550,100036,15715,48180,12774,84321,28509,13742,14767
64555,100042,15715,48183,12774,84326,28512,13744,14768
64560,100053,15717,48186,12775,84336,28514,13745,14769
64565,100057,15718,48186,12775,84339,28514,13745,14769
64570,100067,15719,48192,12775,84348,28516,13747,14769
64575,100073,15719,48193,12775,84354,28519,13748,14771
64580,100084,15720,48198,12776,84364,28521,13750,14771
64585,100088,15721,48200,12776,84367,28521,13750,14771
64590,100098,15722,48204,12776,84376,28523,13751,14772
64595,100104,15722,48208,12776,84381,28526,13753,14773
64600,100115,15724,48216,12778,84390,28528,13755,14773
64605,100119,15726,48218,12779,84393,28528,13755,14773
64610,100129,15727,48224,12779,84402,28530,13757,14773
64615,100135,15727,48228,12779,84408,28533,13759,14774
64620,100146,15728,48235,12779,84417,28535,13760,14775
64625,100150,15730,48237,12780,84420,28535,13760,14775
64630,100160,15731,48241,12780,84429,28537,13760,14777
64635,100166,15731,48244,12780,84434,28540,13761,14779
64640,100177,15733,48249,12781,84443,28542,13762,14780
64645,100181,15735,48252,12783,84446,28542,13762,14780
64650,100191,15736,48259,12784,84455,28544,13762,14782
64655,100197,15736,48263,12784,84460,28547,13764,14783
64660,100208,15738,48267,12786,84470,28549,13764,14785
64665,100212,15739,48268,12786,84473,28549,13764,14785
64670,100222,15740,48272,12786,84482,28551,13765,14786
64675,100228,15740,48274,12786,84487,28554,13766,14788
64680,100239,15742,48278,12787,84497,28556,13767,14789
64685,100243,15743,48278,12787,84500,28556,13767,14789
64690,100253,15744,48283,12788,84509,28558,13767,14791
64695,100259,15744,48286,12788,84515,28560,13768,14792
64700,100270,15745,48290,12788,84524,28562,13768,14794
64705,100274,15747,48291,12789,84527,28562,13768,14794
64710,100284,15748,48296,12790,84536,28564,13770,14794
64715,100290,15748,48299,12790,84542,28566,13771,14795
64720,100301,15749,48305,12791,84551,28568,13773,14795
64725,100305,15751,48309,12792,84554,28568,13773,14795
64730,100315,15752,48312,12793,84563,28570,13773,14797
64735,100321,15752,48316,12793,84568,28572,13774,14798
64740,100332,15754,48321,12794,84577,28574,13775,14799
64745,100336,15756,48323,12796,84580,28574,13775,14799
64750,100346,15757,48328,12797,84589,28575,13775,14800
64755,100352,15757,48329,12797,84594,28577,13776,14801
64760,100363,15759,48332,12798,84603,28579,13777,14802
64765,100367,15761,48333,12799,84606,28579,13777,14802
64770,100377,15762,48338,12800,84615,28580,13777,14803
64775,100383,15762,48339,12800,84620,28582,13778,14804
64780,100394,15764,48344,12801,84629,28584,13779,14805
64785,100398,15766,48345,12802,84632,28584,13779,14805
64790,100408,15767,48351,12802,84641,28585,13780,14805
64795,100414,15767,48355,12802,84646,28588,13782,14806
64800,100425,15769,48362,12804,84655,28590,13784,14806
64805,100429,15771,48364,12804,84658,28590,13784,14806
64810,100439,15772,48370,12805,84667,28591,13785,14806
64815,100445,15772,48374,12805,84672,28594,13787,14807
64820,100456,15774,48380,12806,84681,28596,13789,14807
64825,100460,15776,48381,12807,84684,28596,13789,14807
64830,100470,15777,48388,12808,84693,28597,13790,14807
64835,100476,15777,48389,12808,84698,28600,13790,14810
64840,100487,15779,48396,12809,84707,28602,13790,14812
64845,100491,15781,48398,12811,84710,28602,13790,14812
64850,100501,15782,48399,12811,84719,28603,13790,14813
64855,100507,15782,48404,12811,84724,28606,13793,14813
64860,100518,15784,48407,12811,84733,28608,13793,14815
64865,100522,15786,48410,12812,84736,28608,13793,14815
64870,100532,15787,48415,12812,84745,28610,13793,14817
64875,100538,15787,48418,12812,84750,28613,13795,14818
64880,100549,15789,48425,12813,84759,28615,13797,14818
64885,100553,15791,48428,12813,84762,28615,13797,14818
64890,100563,15792,48435,12814,84771,28617,13798,14819
64895,100569,15792,48438,12814,84776,28620,13799,14821
64900,100580,15794,48444,12816,84785,28622,13800,14822
64905,100584,15796,48446,12818,84788,28622,13800,14822
64910,100594,15797,48451,12819,84797,28624,13802,14822
64915,100600,15797,48454,12819,84802,28627,13805,14822
64920,100611,15799,48458,12820,84811,28629,13806,14823
64925,100615,15801,48459,12820,84814,28629,13806,14823
64930,100625,15802,48462,12821,84823,28631,13807,14824
64935,100631,15802,48465,12821,84828,28634,13810,14824
64940,100642,15804,48468,12822,84837,28636,13811,14825
64945,100646,15806,48469,12823,84840,28636,13811,14825
64950,100656,15807,48475,12823,84849,28638,13813,14825
64955,100662,15807,48478,12823,84854,28641,13814,14827
64960,100673,15809,48485,12825,84863,28643,13815,14828
64965,100677,15811,48487,12826,84866,28643,13815,14828
64970,100687,15812,48493,12827,84875,28645,13817,14828
64975,100693,15812,48495,12827,84880,28648,13817,14831
64980,100704,15814,48499,12829,84889,28650,13817,14833
64985,100708,15816,48500,12830,84892,28650,13817,14833
64990,100718,15817,48504,12831,84901,28652,13818,14834
64995,100724,15817,48506,12831,84906,28655,13819,14836
65000,100735,15819,48509,12831,84915,28657,13819,14838
65005,100739,15821,48511,12831,84918,28657,13819,14838
65010,100749,15822,48518,12831,84927,28659,13820,14839
65015,100755,15822,48519,12831,84932,28662,13821,14841
65020,100766,15824,48523,12831,84941,28664,13821,14843
65025,100770,15826,48524,12831,84944,28664,13821,14843
65030,100780,15827,48530,12831,84953,28666,13821,14845
65035,100786,15827,48531,12831,84958,28669,13822,14847
65040,100797,15829,48535,12831,84967,28671,13822,14849
65045,100801,15831,48537,12832,84970,28671,13822,14849
65050,100811,15832,48542,12833,84979,28673,13822,14851
65055,100817,15832,48544,12833,84984,28675,13823,14852
65060,100828,15834,48547,12834,84993,28677,13823,14854
65065,100832,15836,48548,12834,84996,28677,13823,14854
65070,100842,15837,48552,12834,85005,28679,13824,14855
65075,100848,15837,48555,12834,85010,28681,13825,14856
65080,100859,15839,48559,12835,85019,28683,13825,14858
65085,100863,15841,48562,12837,85022,28683,13825,14858
65090,100873,15842,48566,12837,85031,28685,13825,14860
65095,100879,15842,48567,12837,85036,28687,13826,14861
65100,100890,15844,48571,12837,85045,28689,13828,14861
65105,100894,15846,48573,12838,85048,28689,13828,14861
65110,100904,15847,48575,12838,85057,28690,13828,14862
65115,100910,15847,48578,12838,85062,28692,13830,14862
65120,100921,15849,48586,12838,85071,28694,13832,14862
65125,100925,15851,48588,12840,85074,28694,13832,14862
65130,100935,15852,48593,12840,85083,28695,13833,14862
65135,100941,15852,48596,12840,85088,28697,13835,14862
65140,100952,15854,48603,12840,85097,28699,13837,14862
65145,100956,15856,48606,12841,85100,28699,13837,14862
65150,100966,15857,48610,12842,85109,28700,13837,14863
65155,100972,15857,48613,12842,85114,28703,13838,14865
65160,100983,15859,48617,12843,85123,28705,13840,14865
65165,100987,15861,48619,12844,85126,28705,13840,14865
65170,100997,15862,48624,12844,85135,28706,13840,14866
65175,101003,15862,48627,12844,85140,28709,13841,14868
65180,101014,15864,48633,12846,85149,28711,13841,14870
65185,101018,15866,48636,12848,85152,28711,13841,14870
65190,101028,15867,48640,12848,85161,28712,13842,14870
65195,101034,15867,48645,12848,85166,28715,13844,14871
65200,101045,15869,48649,12850,85175,28717,13845,14872
65205,101049,15871,48652,12850,85178,28717,13845,14872
65210,101059,15872,48656,12851,85187,28719,13846,14873
65215,101065,15872,48657,12851,85192,28722,13846,14876
65220,101076,15874,48665,12853,85201,28724,13847,14877
65225,101080,15876,48665,12854,85204,28724,13847,14877
65230,101090,15877,48670,12854,85213,28726,13848,14878
65235,101096,15877,48671,12854,85218,28729,13849,14880
65240,101107,15879,48675,12854,85227,28731,13851,14880
65245,101111,15881,48677,12854,85230,28731,13851,14880
65250,101121,15882,48682,12854,85239,28733,13851,14882
65255,101127,15882,48683,12854,85244,28736,13852,14884
65260,101138,15884,48687,12854,85253,28738,13852,14886
65265,101142,15886,48690,12854,85256,28738,13852,14886
65270,101152,15887,48694,12854,85265,28740,13852,14888
65275,101158,15887,48695,12854,85270,28743,13853,14890
65280,101169,15889,48699,12854,85279,28745,13855,14890
65285,101173,15891,48700,12854,85282,28745,13855,14890
65290,101183,15892,48704,12854,85291,28747,13857,14890
65295,101189,15892,48708,12854,85296,28750,13859,14891
65300,101200,15894,48714,12855,85305,28752,13861,14891
65305,101204,15896,48716,12855,85308,28752,13861,14891
65310,101214,15897,48722,12855,85317,28754,13862,14892
65315,101220,15897,48726,12855,85322,28757,13864,14893
65320,101231,15899,48733,12856,85331,28759,13866,14893
65325,101235,15901,48735,12857,85334,28759,13866,14893
65330,101245,15902,48742,12858,85343,28761,13867,14894
65335,101251,15902,48746,12858,85348,28764,13869,14895
65340,101262,15904,48750,12860,85357,28766,13869,14897
65345,101266,15906,48753,12862,85360,28766,13869,14897
65350,101276,15907,48756,12863,85369,28768,13869,14899
65355,101282,15907,48759,12863,85374,28771,13871,14900
65360,101293,15909,48764,12865,85383,28773,13871,14902
65365,101297,15911,48766,12867,85386,28773,13871,14902
65370,101307,15912,48773,12868,85395,28775,13873,14902
65375,101313,15912,48776,12868,85400,28778,13873,14905
65380,101324,15914,48782,12870,85409,28780,13874,14906
65385,101328,15916,48785,12871,85412,28780,13874,14906
65390,101338,15917,48789,12872,85421,28782,13874,14908
65395,101344,15917,48793,12872,85426,28784,13876,14908
65400,101355,15919,48797,12873,85435,28786,13876,14910
65405,101359,15921,48799,12875,85438,28786,13876,14910
65410,101369,15922,48805,12875,85447,28787,13876,14911
65415,101375,15922,48808,12875,85452,28789,13877,14912
65420,101386,15924,48810,12876,85461,28791,13877,14914
65425,101390,15926,48811,12876,85464,28791,13877,14914
65430,101400,15927,48817,12877,85473,28792,13877,14915
65435,101406,15927,48818,12877,85478,28794,13877,14917
65440,101417,15929,48825,12877,85487,28796,13879,14917
65445,101421,15931,48827,12878,85490,28796,13879,14917
65450,101431,15932,48831,12878,85499,28797,13879,14918
65455,101437,15932,48833,12878,85504,28799,13879,14920
65460,101448,15934,48840,12879,85513,28801,13880,14921
65465,101452,15936,48842,12880,85516,28801,13880,14921
65470,101462,15937,48846,12881,85525,28802,13880,14922
65475,101468,15937,48848,12881,85530,28804,13881,14923
65480,101479,15939,48853,12881,85539,28806,13881,14925
65485,101483,15941,48854,12882,85542,28806,13881,14925
65490,101493,15942,48860,12882,85551,28807,13882,14925
65495,101499,15942,48865,12882,85556,28810,13885,14925
65500,101510,15944,48870,12883,85565,28812,13885,14927
65505,101514,15946,48872,12884,85568,28812,13885,14927
65510,101524,15947,48876,12885,85577,28814,13886,14928
65515,101530,15947,48881,12885,85582,28817,13888,14929
65520,101541,15949,48888,12887,85591,28819,13889,14930
65525,101545,15951,48889,12888,85594,28819,13889,14930
65530,101555,15952,48893,12888,85603,28821,13890,14931
65535,101561,15952,48896,12888,85608,28824,13892,14932
65540,101572,15954,48906,12889,85617,28826,13894,14932
65545,101576,15956,48909,12891,85620,28826,13894,14932
65550,101586,15957,48914,12892,85629,28828,13894,14934
65555,101592,15957,48915,12892,85634,28831,13895,14936
65560,101603,15959,48919,12892,85643,28833,13897,14936
65565,101607,15961,48920,12892,85646,28833,13897,14936
65570,101617,15962,48922,12892,85655,28835,13897,14938
65575,101623,15962,48925,12892,85660,28838,13898,14940
65580,101634,15964,48931,12893,85669,28840,13899,14941
65585,101638,15966,48931,12894,85672,28840,13899,14941
65590,101648,15967,48935,12894,85681,28842,13899,14943
65595,101654,15967,48939,12894,85686,28845,13901,14944
65600,101665,15969,48946,12894,85695,28847,13903,14944
65605,101669,15971,48948,12895,85698,28847,13903,14944
65610,101679,15972,48952,12896,85707,28849,13904,14945
65615,101685,15972,48954,12896,85712,28852,13905,14947
65620,101696,15974,48958,12897,85721,28854,13906,14948
65625,101700,15976,48961,12897,85724,28854,13906,14948
65630,101710,15977,48965,12897,85733,28856,13907,14949
65635,101716,15977,48970,12897,85738,28859,13909,14950
65640,101727,15979,48976,12898,85747,28861,13910,14951
65645,101731,15981,48978,12899,85750,28861,13910,14951
65650,101741,15982,48984,12900,85759,28862,13910,14952
65655,101747,15982,48987,12900,85764,28864,13911,14953
65660,101758,15984,48994,12901,85773,28866,13913,14953
65665,101762,15986,48994,12901,85776,28866,13913,14953
65670,101772,15987,48996,12902,85785,28867,13913,14954
65675,101778,15987,49000,12902,85790,28869,13915,14954
65680,101789,15989,49007,12902,85799,28871,13916,14955
65685,101793,15991,49009,12902,85802,28871,13916,14955
65690,101803,15992,49016,12903,85811,28872,13917,14955
65695,101809,15992,49020,12903,85816,28874,13919,14955
65700,101820,15994,49026,12904,85825,28876,13920,14956
65705,101824,15996,49028,12904,85828,28876,13920,14956
65710,101834,15997,49033,12905,85837,28877,13920,14957
65715,101840,15997,49034,12905,85843,28879,13921,14958
65720,101851,15998,49040,12906,85853,28881,13922,14959
65725,101855,15999,49043,12907,85856,28881,13922,14959
65730,101865,16000,49051,12907,85865,28882,13923,14959
65735,101871,16000,49054,12907,85871,28884,13923,14961
65740,101882,16001,49061,12908,85881,28886,13923,14963
65745,101886,16002,49061,12908,85884,28886,13923,14963
65750,101896,16003,49066,12909,85893,28887,13924,14963
65755,101902,16003,49069,12909,85898,28890,13924,14966
65760,101913,16005,49074,12910,85908,28892,13924,14968
65765,101917,16006,49076,12910,85911,28892,13924,14968
65770,101927,16007,49082,12911,85920,28894,13924,14970
65775,101933,16007,49084,12911,85925,28897,13924,14973
65780,101944,16009,49091,12912,85934,28899,13925,14974
65785,101948,16011,49093,12913,85937,28899,13925,14974
65790,101958,16012,49096,12913,85946,28901,13925,14976
65795,101964,16012,49099,12913,85952,28904,13927,14977
65800,101975,16013,49105,12913,85961,28906,13928,14978
65805,101979,16015,49108,12914,85964,28906,13928,14978
65810,101989,16016,49114,12915,85973,28908,13929,14979
65815,101995,16016,49117,12915,85979,28911,13931,14980
65820,102006,16017,49126,12916,85988,28913,13933,14980
65825,102010,16019,49128,12918,85991,28913,13933,14980
65830,102020,16020,49136,12919,86000,28915,13935,14980
65835,102026,16020,49138,12919,86005,28918,13936,14982
65840,102037,16022,49145,12921,86014,28920,13937,14983
65845,102041,16024,49148,12922,86017,28920,13937,14983
65850,102051,16025,49149,12922,86026,28922,13938,14984
65855,102057,16025,49150,12922,86032,28925,13938,14987
65860,102068,16026,49153,12922,86042,28927,13938,14989
65865,102072,16027,49154,12922,86045,28927,13938,14989
65870,102082,16028,49161,12923,86054,28929,13940,14989
65875,102088,16028,49162,12923,86060,28932,13940,14992
65880,102099,16029,49165,12924,86070,28934,13940,14994
65885,102103,16030,49165,12924,86073,28934,13940,14994
65890,102113,16031,49167,12924,86082,28936,13940,14996
65895,102119,16031,49169,12924,86088,28938,13941,14997
65900,102130,16032,49173,12924,86098,28940,13942,14998
65905,102134,16033,49175,12925,86101,28940,13942,14998
65910,102144,16034,49183,12925,86110,28941,13943,14998
65915,102150,16034,49185,12925,86115,28943,13943,15000
65920,102161,16036,49189,12927,86124,28945,13943,15002
65925,102165,16038,49191,12928,86127,28945,13943,15002
65930,102175,16039,49195,12929,86136,28946,13944,15002
65935,102181,16039,49197,12929,86142,28948,13944,15004
65940,102192,16040,49203,12930,86152,28950,13946,15004
65945,102196,16041,49204,12930,86155,28950,13946,15004
65950,102206,16042,49212,12931,86164,28951,13947,15004
65955,102212,16042,49213,12931,86170,28953,13947,15006
65960,102223,16043,49219,12932,86180,28955,13948,15007
65965,102227,16044,49221,12933,86183,28955,13948,15007
65970,102237,16044,49224,12933,86193,28956,13949,15007
65975,102243,16044,49225,12933,86199,28958,13950,15008
65980,102254,16045,49231,12933,86209,28960,13952,15008
65985,102258,16046,49232,12933,86212,28960,13952,15008
65990,102268,16046,49236,12933,86222,28961,13953,15008
65995,102274,16046,49237,12933,86228,28964,13954,15010
66000,102285,16047,49239,12934,86238,28966,13954,15012
66005,102289,16048,49241,12935,86241,28966,13954,15012
66010,102299,16048,49245,12935,86251,28968,13955,15013
66015,102305,16048,49247,12935,86257,28971,13955,15016
66020,102316,16049,49251,12935,86267,28972,13955,15017
66025,102320,16050,49251,12935,86270,28972,13955,15017
66030,102330,16050,49258,12935,86280,28974,13957,15017
66035,102336,16050,49260,12935,86286,28977,13959,15018
66040,102347,16051,49267,12935,86296,28978,13960,15018
66045,102351,16052,49269,12936,86299,28978,13960,15018
66050,102361,16052,49274,12936,86309,28980,13960,15020
66055,102367,16052,49277,12936,86315,28983,13961,15022
66060,102378,16053,49282,12937,86325,28984,13961,15023
66065,102382,16054,49284,12937,86328,28984,13961,15023
66070,102392,16054,49288,12937,86338,28986,13962,15024
66075,102398,16054,49291,12937,86344,28989,13965,15024
66080,102409,16055,49294,12937,86354,28990,13965,15025
66085,102413,16056,49297,12937,86357,28990,13965,15025
66090,102423,16056,49304,12937,86367,28992,13967,15025
66095,102429,16056,49309,12937,86373,28995,13969,15026
66100,102440,16057,49314,12937,86383,28996,13970,15026
66105,102444,16058,49315,12937,86386,28996,13970,15026
66110,102454,16058,49322,12937,86396,28998,13971,15027
66115,102460,16058,49325,12937,86402,29001,13972,15029
66120,102471,16059,49331,12937,86412,29002,13973,15029
66125,102475,16060,49333,12937,86415,29002,13973,15029
66130,102485,16060,49336,12937,86425,29004,13973,15031
66135,102491,16060,49339,12937,86431,29007,13975,15032
66140,102502,16061,49347,12938,86441,29008,13976,15032
66145,102506,16062,49347,12938,86444,29008,13976,15032
66150,102516,16062,49350,12938,86454,29009,13976,15033
66155,102522,16062,49351,12938,86460,29011,13976,15035
66160,102533,16063,49359,12939,86470,29012,13977,15035
66165,102537,16064,49362,12940,86473,29012,13977,15035
66170,102547,16064,49368,12940,86483,29013,13977,15036
66175,102553,16064,49370,12940,86489,29015,13978,15037
66180,102564,16065,49374,12941,86499,29016,13978,15038
66185,102568,16066,49376,12941,86502,29016,13978,15038
66190,102578,16066,49383,12941,86512,29017,13979,15038
66195,102584,16066,49384,12941,86518,29019,13980,15039
66200,102595,16067,49390,12942,86528,29020,13981,15039
66205,102599,16068,49391,12943,86531,29020,13981,15039
66210,102609,16068,49398,12943,86541,29021,13982,15039
66215,102615,16068,49400,12943,86547,29023,13982,15041
66220,102626,16069,49402,12943,86557,29024,13983,15041
66225,102630,16070,49402,12943,86560,29024,13983,15041
66230,102640,16070,49408,12943,86570,29025,13983,15042
66235,102646,16070,49410,12943,86576,29027,13984,15043
66240,102657,16071,49417,12944,86586,29028,13984,15044
66245,102661,16072,49420,12944,86589,29028,13984,15044
66250,102671,16072,49423,12944,86599,29029,13984,15045
66255,102677,16072,49429,12944,86605,29032,13987,15045
66260,102688,16073,49436,12945,86615,29033,13988,15045
66265,102692,16074,49438,12946,86618,29033,13988,15045
66270,102702,16074,49442,12946,86628,29035,13989,15046
66275,102708,16074,49444,12946,86634,29038,13991,15047
66280,102719,16075,49448,12946,86644,29039,13991,15048
66285,102723,16076,49450,12947,86647,29039,13991,15048
66290,102733,16076,49456,12947,86657,29041,13992,15049
66295,102739,16076,49457,12947,86663,29044,13993,15051
66300,102750,16077,49463,12948,86673,29045,13994,15051
66305,102754,16078,49465,12948,86676,29045,13994,15051
66310,102764,16078,49470,12948,86686,29047,13995,15052
66315,102770,16078,49473,12948,86692,29050,13996,15054
66320,102781,16079,49481,12949,86702,29051,13996,15055
66325,102785,16080,49484,12949,86705,29051,13996,15055
66330,102795,16080,49491,12949,86715,29053,13998,15055
66335,102801,16080,49492,12949,86721,29056,13999,15057
66340,102812,16081,49498,12950,86731,29057,14000,15057
66345,102816,16082,49499,12950,86734,29057,14000,15057
66350,102826,16082,49507,12950,86744,29059,14002,15057
66355,102832,16082,49508,12950,86750,29062,14003,15059
66360,102843,16083,49514,12951,86760,29063,14004,15059
66365,102847,16084,49517,12952,86763,29063,14004,15059
66370,102857,16084,49522,12952,86773,29065,14005,15060
66375,102863,16084,49528,12952,86779,29068,14008,15060
66380,102874,16085,49535,12953,86789,29069,14009,15060
66385,102878,16086,49538,12954,86792,29069,14009,15060
66390,102888,16086,49543,12954,86802,29071,14010,15061
66395,102894,16086,49546,12954,86808,29074,14011,15063
66400,102905,16087,49550,12954,86818,29075,14011,15064
66405,102909,16088,49551,12954,86821,29075,14011,15064
66410,102919,16088,49557,12954,86831,29077,14011,15066
66415,102925,16088,49560,12954,86837,29080,14013,15067
66420,102936,16089,49565,12955,86847,29081,14014,15067
66425,102940,16090,49567,12956,86850,29081,14014,15067
66430,102950,16090,49573,12956,86860,29083,14016,15067
66435,102956,16090,49574,12956,86866,29086,14016,15070
66440,102967,16091,49580,12956,86876,29087,14017,15070
66445,102971,16092,49583,12956,86879,29087,14017,15070
66450,102981,16092,49585,12956,86889,29089,14017,15072
66455,102987,16092,49589,12956,86895,29092,14018,15074
66460,102998,16093,49593,12956,86905,29093,14019,15074
66465,103002,16094,49593,12956,86908,29093,14019,15074
66470,103012,16094,49596,12956,86918,29095,14020,15075
66475,103018,16094,49600,12956,86924,29097,14021,15076
66480,103029,16095,49604,12956,86934,29098,14022,15076
66485,103033,16096,49604,12956,86937,29098,14022,15076
66490,103043,16096,49608,12956,86947,29100,14022,15078
66495,103049,16096,49614,12956,86953,29101,14023,15078
66500,103060,16097,49619,12957,86963,29102,14023,15079
66505,103064,16098,49622,12958,86966,29102,14023,15079
66510,103074,16098,49626,12958,86976,29103,14024,15079
66515,103080,16098,49630,12958,86982,29104,14024,15080
66520,103091,16099,49635,12959,86992,29105,14025,15080
66525,103095,16100,49637,12960,86995,29105,14025,15080
66530,103105,16100,49641,12960,87005,29106,14026,15080
66535,103111,16100,49645,12960,87011,29107,14026,15081
66540,103122,16101,49649,12960,87021,29108,14026,15082
66545,103126,16102,49650,12961,87024,29108,14026,15082
66550,103136,16102,49656,12961,87034,29109,14026,15083
66555,103142,16102,49659,12961,87040,29110,14026,15084
66560,103153,16103,49665,12961,87050,29111,14026,15085
66565,103157,16104,49667,12962,87053,29111,14026,15085
66570,103167,16104,49670,12962,87063,29112,14027,15085
66575,103173,16104,49674,12962,87069,29114,14029,15085
66580,103184,16105,49680,12963,87079,29115,14030,15085
66585,103188,16106,49681,12964,87082,29115,14030,15085
66590,103198,16106,49686,12964,87092,29116,14031,15085
66595,103204,16106,49689,12964,87098,29119,14032,15087
66600,103215,16107,49693,12965,87108,29120,14032,15088
66605,103219,16108,49694,12965,87111,29120,14032,15088
66610,103229,16108,49697,12965,87121,29121,14033,15088
66615,103235,16108,49702,12965,87127,29124,14035,15089
66620,103246,16109,49708,12966,87137,29125,14036,15089
66625,103250,16110,49711,12967,87140,29125,14036,15089
66630,103260,16110,49716,12967,87150,29127,14038,15089
66635,103266,16110,49720,12967,87156,29129,14039,15090
66640,103277,16111,49725,12968,87166,29130,14039,15091
66645,103281,16112,49727,12969,87169,29130,14039,15091
66650,103291,16112,49731,12969,87179,29132,14041,15091
66655,103297,16112,49734,12969,87185,29134,14042,15092
66660,103308,16113,49742,12969,87195,29135,14043,15092
66665,103312,16114,49744,12969,87198,29135,14043,15092
66670,103322,16114,49749,12969,87208,29137,14044,15093
66675,103328,16114,49753,12969,87214,29139,14045,15094
66680,103339,16115,49757,12969,87224,29140,14045,15095
66685,103343,16116,49759,12970,87227,29140,14045,15095
66690,103353,16116,49765,12970,87237,29142,14046,15096
66695,103359,16116,49767,12970,87243,29144,14046,15098
66700,103370,16117,49775,12970,87253,29145,14047,15098
66705,103374,16118,49777,12970,87256,29145,14047,15098
66710,103384,16118,49783,12970,87266,29147,14047,15100
66715,103390,16118,49785,12970,87272,29149,14047,15102
66720,103401,16119,49790,12970,87282,29150,14047,15103
66725,103405,16120,49791,12970,87285,29150,14047,15103
66730,103415,16120,49794,12970,87295,29152,14048,15104
66735,103421,16120,49797,12970,87301,29155,14049,15106
66740,103432,16121,49803,12971,87311,29156,14050,15106
66745,103436,16122,49805,12972,87314,29156,14050,15106
66750,103446,16122,49806,12972,87324,29158,14050,15108
66755,103452,16122,49809,12972,87330,29161,14051,15110
66760,103463,16123,49818,12973,87340,29162,14052,15110
66765,103467,16124,49821,12973,87343,29162,14052,15110
66770,103477,16124,49825,12973,87353,29164,14053,15111
66775,103483,16124,49828,12973,87359,29167,14055,15112
66780,103494,16125,49831,12973,87369,29168,14055,15113
66785,103498,16126,49834,12973,87372,29168,14055,15113
66790,103508,16126,49839,12973,87382,29170,14056,15114
66795,103514,16126,49841,12973,87388,29173,14058,15115
66800,103525,16127,49847,12974,87398,29174,14059,15115
66805,103529,16128,49850,12974,87401,29174,14059,15115
66810,103539,16128,49854,12974,87411,29176,14060,15116
66815,103545,16128,49855,12974,87417,29178,14061,15117
66820,103556,16129,49861,12974,87427,29179,14061,15118
66825,103560,16130,49862,12975,87430,29179,14061,15118
66830,103570,16130,49868,12975,87440,29181,14062,15119
66835,103576,16130,49871,12975,87446,29182,14063,15119
66840,103587,16131,49876,12976,87456,29183,14063,15120
66845,103591,16132,49879,12977,87459,29183,14063,15120
66850,103601,16132,49886,12977,87469,29185,14064,15121
66855,103607,16132,49889,12977,87475,29186,14065,15121
66860,103618,16133,49894,12978,87485,29187,14065,15122
66865,103622,16134,49896,12978,87488,29187,14065,15122
66870,103632,16134,49900,12978,87498,29188,14065,15123
66875,103638,16134,49903,12978,87504,29189,14066,15123
66880,103649,16135,49906,12978,87514,29190,14066,15124
66885,103653,16136,49908,12979,87517,29190,14066,15124
66890,103663,16136,49916,12979,87527,29191,14067,15124
66895,103669,16136,49917,12979,87533,29192,14067,15125
66900,103680,16137,49922,12980,87543,29193,14067,15126
66905,103684,16138,49923,12981,87546,29193,14067,15126
66910,103694,16138,49927,12981,87556,29194,14067,15127
66915,103700,16138,49929,12981,87562,29196,14068,15128
66920,103711,16139,49934,12982,87572,29197,14068,15129
66925,103715,16140,49936,12982,87575,29197,14068,15129
66930,103725,16140,49939,12982,87585,29198,14068,15130
66935,103731,16140,49943,12982,87591,29201,14070,15131
66940,103742,16141,49948,12982,87601,29202,14071,15131
66945,103746,16142,49950,12983,87604,29202,14071,15131
66950,103756,16142,49955,12983,87614,29203,14071,15132
66955,103762,16142,49957,12983,87620,29206,14072,15134
66960,103773,16143,49964,12984,87630,29207,14072,15135
66965,103777,16144,49966,12984,87633,29207,14072,15135
66970,103787,16144,49969,12984,87643,29208,14072,15136
66975,103793,16144,49974,12984,87649,29211,14074,15137
66980,103804,16145,49978,12985,87659,29212,14075,15137
66985,103808,16146,49980,12985,87662,29212,14075,15137
66990,103818,16146,49983,12985,87672,29214,14076,15138
66995,103824,16146,49986,12985,87678,29217,14078,15139
67000,103835,16147,49993,12986,87688,29218,14079,15139
67005,103839,16148,49995,12987,87691,29218,14079,15139
67010,103849,16148,50000,12987,87701,29220,14080,15140
67015,103855,16148,50004,12987,87707,29223,14082,15141
67020,103866,16149,50009,12988,87717,29224,14083,15141
67025,103870,16150,50009,12988,87720,29224,14083,15141
67030,103880,16150,50015,12988,87730,29226,14085,15141
67035,103886,16150,50018,12988,87736,29228,14086,15142
67040,103897,16151,50022,12988,87746,29229,14087,15142
67045,103901,16152,50024,12989,87749,29229,14087,15142
67050,103911,16152,50026,12989,87759,29231,14087,15144
67055,103917,16152,50028,12989,87765,29233,14087,15146
67060,103928,16153,50031,12990,87775,29234,14087,15147
67065,103932,16154,50033,12990,87778,29234,14087,15147
67070,103942,16154,50038,12990,87788,29236,14089,15147
67075,103948,16154,50044,12990,87794,29237,14090,15147
67080,103959,16155,50053,12991,87804,29238,14091,15147
67085,103963,16156,50055,12992,87807,29238,14091,15147
67090,103973,16156,50060,12992,87817,29240,14091,15149
67095,103979,16156,50060,12992,87823,29241,14091,15150
67100,103990,16157,50066,12992,87833,29242,14091,15151
67105,103994,16158,50067,12992,87836,29242,14091,15151
67110,104004,16158,50074,12992,87846,29244,14093,15151
67115,104010,16158,50077,12992,87852,29245,14093,15152
67120,104021,16159,50085,12993,87862,29246,14094,15152
67125,104025,16160,50087,12993,87865,29246,14094,15152
67130,104035,16160,50093,12993,87875,29248,14095,15153
67135,104041,16160,50096,12993,87881,29250,14095,15155
67140,104052,16161,50102,12993,87891,29251,14096,15155
67145,104056,16162,50103,12993,87894,29251,14096,15155
67150,104066,16162,50106,12993,87904,29253,14097,15156
67155,104072,16162,50108,12993,87910,29255,14097,15158
67160,104083,16163,50114,12993,87920,29256,14097,15159
67165,104087,16164,50116,12994,87923,29256,14097,15159
67170,104097,16164,50120,12994,87933,29258,14098,15160
67175,104103,16164,50124,12994,87939,29260,14100,15160
67180,104114,16165,50129,12995,87949,29261,14100,15161
67185,104118,16166,50131,12995,87952,29261,14100,15161
67190,104128,16166,50136,12995,87962,29263,14101,15162
67195,104134,16166,50137,12995,87968,29265,14101,15164
67200,104145,16167,50140,12995,87978,29266,14102,15164
67205,104149,16168,50142,12995,87981,29266,14102,15164
67210,104159,16168,50147,12995,87991,29268,14102,15166
67215,104165,16168,50151,12995,87997,29270,14103,15167
67220,104176,16169,50158,12995,88007,29271,14104,15167
67225,104180,16170,50161,12996,88010,29271,14104,15167
67230,104190,16170,50166,12996,88020,29273,14105,15168
67235,104196,16170,50167,12996,88026,29275,14105,15170
67240,104207,16171,50173,12997,88036,29276,14105,15171
67245,104211,16172,50174,12997,88039,29276,14105,15171
67250,104221,16172,50178,12997,88049,29278,14106,15172
67255,104227,16172,50180,12997,88055,29280,14107,15173
67260,104238,16173,50183,12997,88065,29281,14107,15174
67265,104242,16174,50185,12998,88068,29281,14107,15174
67270,104252,16174,50188,12998,88078,29283,14107,15176
67275,104258,16174,50191,12998,88084,29284,14108,15176
67280,104269,16175,50194,12998,88094,29285,14108,15177
67285,104273,16176,50196,12999,88097,29285,14108,15177
67290,104283,16176,50200,12999,88107,29287,14109,15178
67295,104289,16176,50204,12999,88113,29288,14109,15179
67300,104300,16177,50210,12999,88123,29289,14110,15179
67305,104304,16178,50211,12999,88126,29289,14110,15179
67310,104314,16178,50217,12999,88136,29291,14111,15180
67315,104320,16178,50218,12999,88142,29292,14111,15181
67320,104331,16179,50224,12999,88152,29293,14112,15181
67325,104335,16180,50227,13000,88155,29293,14112,15181
67330,104345,16180,50232,13000,88165,29295,14113,15182
67335,104351,16180,50234,13000,88171,29296,14113,15183
67340,104362,16181,50240,13001,88181,29297,14114,15183
67345,104366,16182,50242,13001,88184,29297,14114,15183
67350,104376,16182,50248,13001,88194,29299,14116,15183
67355,104382,16182,50251,13001,88200,29300,14116,15184
67360,104393,16183,50256,13002,88210,29301,14117,15184
67365,104397,16184,50258,13002,88213,29301,14117,15184
67370,104407,16184,50263,13002,88223,29303,14118,15185
67375,104413,16184,50266,13002,88229,29305,14120,15185
67380,104424,16185,50268,13002,88239,29306,14120,15186
67385,104428,16186,50270,13002,88242,29306,14120,15186
67390,104438,16186,50272,13002,88252,29308,14121,15187
67395,104444,16186,50274,13002,88258,29310,14122,15188
67400,104455,16187,50277,13003,88268,29311,14123,15188
67405,104459,16188,50279,13004,88271,29311,14123,15188
67410,104469,16188,50281,13004,88281,29313,14124,15189
67415,104475,16188,50283,13004,88287,29315,14125,15190
67420,104486,16189,50291,13005,88297,29316,14126,15190
67425,104490,16190,50292,13005,88300,29316,14126,15190
67430,104500,16190,50297,13005,88310,29318,14127,15191
67435,104506,16190,50301,13005,88316,29320,14128,15192
67440,104517,16191,50305,13006,88326,29321,14129,15192
67445,104521,16192,50308,13007,88329,29321,14129,15192
67450,104531,16192,50315,13007,88339,29323,14130,15193
67455,104537,16192,50318,13007,88345,29325,14131,15194
67460,104548,16193,50325,13008,88355,29326,14131,15195
67465,104552,16194,50326,13009,88358,29326,14131,15195
67470,104562,16194,50332,13009,88368,29328,14131,15197
67475,104568,16194,50336,13009,88374,29329,14132,15197
67480,104579,16195,50338,13009,88384,29330,14132,15198
67485,104583,16196,50341,13010,88387,29330,14132,15198
67490,104593,16196,50346,13010,88397,29332,14133,15199
67495,104599,16196,50347,13010,88403,29333,14134,15199
67500,104610,16197,50352,13011,88413,29334,14134,15200
67505,104614,16198,50353,13011,88416,29334,14134,15200
67510,104624,16198,50357,13011,88426,29336,14135,15201
67515,104630,16198,50359,13011,88432,29337,14135,15202
67520,104641,16199,50362,13011,88442,29338,14136,15202
67525,104645,16200,50365,13012,88445,29338,14136,15202
67530,104655,16200,50370,13012,88455,29340,14137,15203
67535,104661,16200,50374,13012,88461,29341,14138,15203
67540,104672,16201,50379,13012,88471,29342,14139,15203
67545,104676,16202,50382,13013,88474,29342,14139,15203
67550,104686,16202,50386,13013,88484,29344,14139,15205
67555,104692,16202,50390,13013,88490,29345,14140,15205
67560,104703,16203,50395,13014,88500,29346,14140,15206
67565,104707,16204,50398,13015,88503,29346,14140,15206
67570,104717,16204,50404,13015,88513,29348,14141,15207
67575,104723,16204,50406,13015,88519,29350,14141,15209
67580,104734,16205,50412,13015,88529,29351,14142,15209
67585,104738,16206,50415,13016,88532,29351,14142,15209
67590,104748,16206,50420,13016,88542,29353,14144,15209
67595,104754,16206,50424,13016,88548,29355,14144,15211
67600,104765,16207,50426,13016,88558,29356,14144,15212
67605,104769,16208,50428,13017,88561,29356,14144,15212
67610,104779,16208,50434,13017,88571,29358,14145,15213
67615,104785,16208,50437,13017,88577,29360,14146,15214
67620,104796,16209,50444,13018,88587,29361,14146,15215
67625,104800,16210,50446,13018,88590,29361,14146,15215
67630,104810,16210,50449,13018,88600,29363,14147,15216
67635,104816,16210,50451,13018,88606,29365,14147,15218
67640,104827,16211,50454,13018,88616,29366,14147,15219
67645,104831,16212,50456,13018,88619,29366,14147,15219
67650,104841,16212,50463,13018,88629,29368,14149,15219
67655,104847,16212,50467,13018,88635,29370,14150,15220
67660,104858,16213,50471,13019,88645,29371,14151,15220
67665,104862,16214,50473,13019,88648,29371,14151,15220
67670,104872,16214,50477,13019,88658,29373,14152,15221
67675,104878,16214,50480,13019,88664,29375,14153,15222
67680,104889,16215,50485,13019,88674,29376,14154,15222
67685,104893,16216,50486,13019,88677,29376,14154,15222
67690,104903,16216,50491,13019,88687,29378,14156,15222
67695,104909,16216,50493,13019,88693,29380,14157,15223
67700,104920,16217,50497,13020,88703,29381,14157,15224
67705,104924,16218,50498,13020,88706,29381,14157,15224
67710,104934,16218,50500,13020,88716,29383,14158,15225
67715,104940,16218,50502,13020,88722,29385,14158,15227
67720,104951,16219,50506,13021,88732,29386,14159,15227
67725,104955,16220,50508,13021,88735,29386,14159,15227
67730,104965,16220,50511,13021,88745,29388,14159,15229
67735,104971,16220,50514,13021,88751,29389,14160,15229
67740,104982,16221,50517,13021,88761,29390,14160,15230
67745,104986,16222,50520,13021,88764,29390,14160,15230
67750,104996,16222,50525,13021,88774,29392,14162,15230
67755,105002,16222,50528,13021,88780,29393,14163,15230
67760,105013,16223,50534,13022,88790,29394,14164,15230
67765,105017,16224,50536,13023,88793,29394,14164,15230
67770,105027,16224,50541,13023,88803,29396,14164,15232
67775,105033,16224,50542,13023,88809,29397,14164,15233
67780,105044,16225,50547,13023,88819,29398,14164,15234
67785,105048,16226,50549,13023,88822,29398,14164,15234
67790,105058,16226,50554,13023,88832,29400,14165,15235
67795,105064,16226,50556,13023,88838,29401,14166,15235
67800,105075,16227,50558,13023,88848,29402,14166,15236
67805,105079,16228,50562,13024,88851,29402,14166,15236
67810,105089,16228,50566,13024,88861,29404,14168,15236
67815,105095,16228,50570,13024,88867,29405,14169,15236
67820,105106,16229,50574,13024,88877,29406,14169,15237
67825,105110,16230,50578,13025,88880,29406,14169,15237
67830,105120,16230,50582,13025,88890,29408,14171,15237
67835,105126,16230,50584,13025,88896,29410,14171,15239
67840,105137,16231,50588,13026,88906,29411,14171,15240
67845,105141,16232,50591,13027,88909,29411,14171,15240
67850,105151,16232,50598,13027,88919,29413,14173,15240
67855,105157,16232,50600,13027,88925,29415,14173,15242
67860,105168,16233,50602,13027,88935,29416,14173,15243
67865,105172,16234,50602,13027,88938,29416,14173,15243
67870,105182,16234,50607,13027,88948,29418,14174,15244
67875,105188,16234,50610,13027,88954,29420,14175,15245
67880,105199,16235,50613,13027,88964,29421,14176,15245
67885,105203,16236,50614,13027,88967,29421,14176,15245
67890,105213,16236,50620,13027,88977,29423,14177,15246
67895,105219,16236,50621,13027,88983,29425,14177,15248
67900,105230,16237,50625,13028,88993,29426,14177,15249
67905,105234,16238,50627,13028,88996,29426,14177,15249
67910,105244,16238,50632,13028,89006,29428,14179,15249
67915,105250,16238,50637,13028,89012,29430,14181,15249
67920,105261,16239,50644,13028,89022,29431,14182,15249
67925,105265,16240,50645,13029,89025,29431,14182,15249
67930,105275,16240,50652,13029,89035,29433,14184,15249
67935,105281,16240,50654,13029,89041,29435,14185,15250
67940,105292,16241,50658,13030,89051,29436,14186,15250
67945,105296,16242,50659,13030,89054,29436,14186,15250
67950,105306,16242,50662,13030,89064,29438,14187,15251
67955,105312,16242,50663,13030,89070,29440,14187,15253
67960,105323,16243,50668,13030,89080,29441,14188,15253
67965,105327,16244,50670,13030,89083,29441,14188,15253
67970,105337,16244,50673,13030,89093,29443,14189,15254
67975,105343,16244,50677,13030,89099,29445,14190,15255
67980,105354,16245,50681,13030,89109,29446,14191,15255
67985,105358,16246,50683,13030,89112,29446,14191,15255
67990,105368,16246,50690,13030,89122,29448,14193,15255
67995,105374,16246,50694,13030,89128,29450,14193,15257
68000,105385,16247,50699,13031,89138,29451,14194,15257
68005,105389,16248,50700,13031,89141,29451,14194,15257
68010,105399,16248,50709,13031,89151,29453,14196,15257
68015,105405,16248,50713,13031,89157,29454,14196,15258
68020,105416,16249,50718,13031,89167,29455,14197,15258
68025,105420,16250,50721,13032,89170,29455,14197,15258
68030,105430,16250,50726,13032,89180,29457,14199,15258
68035,105436,16250,50730,13032,89186,29458,14200,15258
68040,105447,16251,50737,13032,89196,29459,14201,15258
68045,105451,16252,50740,13033,89199,29459,14201,15258
68050,105461,16252,50746,13033,89209,29461,14203,15258
68055,105467,16252,50749,13033,89215,29462,14204,15258
68060,105478,16253,50755,13034,89225,29463,14204,15259
68065,105482,16254,50759,13035,89228,29463,14204,15259
68070,105492,16254,50763,13035,89238,29465,14204,15261
68075,105498,16254,50765,13035,89244,29466,14205,15261
68080,105509,16255,50772,13036,89254,29467,14206,15261
68085,105513,16256,50773,13036,89257,29467,14206,15261
68090,105523,16256,50779,13036,89267,29469,14208,15261
68095,105529,16256,50782,13036,89273,29470,14209,15261
68100,105540,16257,50790,13036,89283,29471,14210,15261
68105,105544,16258,50790,13036,89286,29471,14210,15261
68110,105554,16258,50792,13036,89296,29473,14211,15262
68115,105560,16258,50794,13036,89302,29475,14212,15263
68120,105571,16259,50800,13036,89312,29476,14213,15263
68125,105575,16260,50802,13036,89315,29476,14213,15263
68130,105585,16260,50805,13036,89325,29478,14214,15264
68135,105591,16260,50807,13036,89331,29480,14214,15266
68140,105602,16261,50813,13036,89341,29481,14215,15266
68145,105606,16262,50814,13036,89344,29481,14215,15266
68150,105616,16262,50819,13036,89354,29483,14216,15267
68155,105622,16262,50823,13036,89360,29485,14217,15268
68160,105633,16263,50826,13036,89370,29486,14217,15269
68165,105637,16263,50828,13036,89374,29486,14217,15269
68170,105647,16263,50832,13036,89384,29488,14218,15270
68175,105653,16263,50837,13036,89390,29490,14219,15271
68180,105664,16263,50844,13036,89401,29491,14220,15271
68185,105668,16263,50848,13036,89405,29491,14220,15271
68190,105678,16263,50855,13036,89415,29493,14220,15273
68195,105684,16263,50857,13036,89421,29495,14221,15274
68200,105695,16263,50862,13036,89432,29496,14222,15274
68205,105699,16263,50863,13036,89436,29496,14222,15274
68210,105709,16263,50866,13036,89446,29498,14222,15276
68215,105715,16263,50870,13036,89452,29500,14224,15276
68220,105726,16263,50878,13036,89463,29501,14225,15276
68225,105730,16263,50880,13036,89467,29501,14225,15276
68230,105740,16263,50884,13036,89477,29503,14225,15278
68235,105746,16263,50887,13036,89483,29505,14225,15280
68240,105757,16263,50891,13036,89494,29506,14226,15280
68245,105761,16263,50893,13036,89498,29506,14226,15280
68250,105771,16263,50897,13036,89508,29508,14228,15280
68255,105777,16263,50899,13036,89514,29510,14228,15282
68260,105788,16263,50904,13036,89525,29511,14228,15283
68265,105792,16263,50906,13036,89529,29511,14228,15283
68270,105802,16263,50912,13036,89539,29513,14229,15284
68275,105808,16263,50915,13036,89545,29514,14229,15285
68280,105819,16263,50923,13036,89556,29515,14229,15286
68285,105823,16263,50926,13036,89560,29515,14229,15286
68290,105833,16263,50930,13036,89570,29517,14229,15288
68295,105839,16263,50933,13036,89576,29518,14229,15289
68300,105850,16263,50938,13036,89587,29519,14230,15289
68305,105854,16263,50939,13036,89591,29519,14230,15289
68310,105864,16263,50944,13036,89601,29521,14231,15290
68315,105870,16263,50945,13036,89607,29522,14232,15290
68320,105881,16263,50950,13036,89618,29523,14233,15290
68325,105885,16263,50954,13036,89622,29523,14233,15290
68330,105895,16263,50957,13036,89632,29525,14233,15292
68335,105901,16263,50960,13036,89638,29526,14233,15293
68340,105912,16263,50966,13036,89649,29527,14234,15293
68345,105916,16263,50969,13036,89653,29527,14234,15293
68350,105926,16263,50972,13036,89663,29529,14235,15294
68355,105932,16263,50977,13036,89669,29530,14236,15294
68360,105943,16263,50983,13036,89680,29531,14237,15294
68365,105947,16263,50986,13036,89684,29531,14237,15294
68370,105957,16263,50991,13036,89694,29533,14239,15294
68375,105963,16263,50995,13036,89700,29535,14240,15295
68380,105974,16263,51001,13036,89711,29536,14240,15296
68385,105978,16263,51002,13036,89715,29536,14240,15296
68390,105988,16263,51006,13036,89725,29538,14241,15297
68395,105994,16263,51010,13036,89731,29540,14242,15298
68400,106005,16263,51015,13036,89742,29541,14243,15298
68405,106009,16263,51016,13036,89746,29541,14243,15298
68410,106019,16263,51020,13036,89756,29543,14243,15300
68415,106025,16263,51023,13036,89762,29545,14244,15301
68420,106036,16263,51026,13036,89773,29546,14245,15301
68425,106040,16263,51028,13036,89777,29546,14245,15301
68430,106050,16263,51035,13036,89787,29547,14246,15301
68435,106056,16263,51037,13036,89793,29549,14247,15302
68440,106067,16263,51042,13036,89804,29550,14247,15303
68445,106071,16263,51044,13036,89808,29550,14247,15303
68450,106081,16263,51047,13036,89818,29551,14247,15304
68455,106087,16263,51049,13036,89824,29553,14248,15305
68460,106098,16263,51057,13036,89835,29554,14248,15306
68465,106102,16263,51059,13036,89839,29554,14248,15306
68470,106112,16263,51068,13036,89849,29555,14249,15306
68475,106118,16263,51071,13036,89855,29557,14251,15306
68480,106129,16263,51076,13036,89866,29558,14251,15307
68485,106133,16263,51077,13036,89870,29558,14251,15307
68490,106143,16263,51082,13036,89880,29559,14251,15308
68495,106149,16263,51086,13036,89886,29561,14252,15309
68500,106160,16263,51090,13036,89897,29562,14253,15309
68505,106164,16263,51090,13036,89901,29562,14253,15309
68510,106174,16263,51095,13036,89911,29563,14253,15310
68515,106180,16263,51097,13036,89917,29565,14253,15312
68520,106191,16263,51104,13036,89928,29566,14253,15313
68525,106195,16263,51105,13036,89932,29566,14253,15313
68530,106205,16263,51110,13036,89942,29567,14253,15314
68535,106211,16263,51113,13036,89948,29569,14254,15315
68540,106222,16263,51116,13036,89959,29570,14255,15315
68545,106226,16263,51120,13036,89963,29570,14255,15315
68550,106236,16263,51125,13036,89973,29571,14255,15316
68555,106242,16263,51128,13036,89979,29572,14256,15316
68560,106253,16263,51134,13036,89990,29573,14257,15316
68565,106257,16263,51136,13036,89994,29573,14257,15316
68570,106267,16263,51141,13036,90004,29574,14257,15317
68575,106273,16263,51147,13036,90010,29575,14258,15317
68580,106284,16263,51152,13036,90021,29576,14259,15317
68585,106288,16263,51154,13036,90025,29576,14259,15317
68590,106298,16263,51159,13036,90035,29577,14259,15318
68595,106304,16263,51164,13036,90041,29578,14259,15319
68600,106315,16263,51169,13036,90052,29579,14259,15320
68605,106319,16263,51170,13036,90056,29579,14259,15320
68610,106329,16263,51175,13036,90066,29580,14260,15320
68615,106335,16263,51177,13036,90072,29581,14260,15321
68620,106346,16263,51178,13036,90083,29582,14260,15322
68625,106350,16263,51181,13036,90087,29582,14260,15322
68630,106360,16263,51186,13036,90097,29583,14261,15322
68635,106366,16263,51188,13036,90103,29584,14262,15322
68640,106377,16263,51193,13036,90114,29585,14262,15323
68645,106381,16263,51193,13036,90118,29585,14262,15323
68650,106391,16263,51198,13036,90128,29586,14263,15323
68655,106397,16263,51201,13036,90134,29588,14265,15323
68660,106408,16263,51207,13036,90145,29589,14266,15323
68665,106412,16263,51208,13036,90149,29589,14266,15323
68670,106422,16263,51211,13036,90159,29590,14266,15324
68675,106428,16263,51215,13036,90165,29592,14267,15325
68680,106439,16263,51220,13036,90176,29593,14268,15325
68685,106443,16263,51220,13036,90180,29593,14268,15325
68690,106453,16263,51223,13036,90190,29594,14268,15326
68695,106459,16263,51225,13036,90196,29596,14269,15327
68700,106470,16263,51229,13036,90207,29597,14270,15327
68705,106474,16263,51229,13036,90211,29597,14270,15327
68710,106484,16263,51236,13036,90221,29598,14271,15327
68715,106490,16263,51238,13036,90227,29600,14271,15329
68720,106501,16263,51240,13036,90238,29601,14271,15330
68725,106505,16263,51242,13036,90242,29601,14271,15330
68730,106515,16263,51245,13036,90252,29602,14271,15331
68735,106521,16263,51249,13036,90258,29604,14272,15332
68740,106532,16263,51256,13036,90269,29605,14272,15333
68745,106536,16263,51258,13036,90273,29605,14272,15333
68750,106546,16263,51263,13036,90283,29606,14273,15333
68755,106552,16263,51264,13036,90289,29608,14273,15335
68760,106563,16263,51269,13036,90300,29609,14273,15336
68765,106567,16263,51270,13036,90304,29609,14273,15336
68770,106577,16263,51274,13036,90314,29610,14273,15337
68775,106583,16263,51279,13036,90320,29612,14274,15338
68780,106594,16263,51284,13036,90331,29613,14274,15339
68785,106598,16263,51287,13036,90335,29613,14274,15339
68790,106608,16263,51292,13036,90345,29614,14274,15340
68795,106614,16263,51293,13036,90351,29616,14274,15342
68800,106625,16263,51297,13036,90362,29617,14274,15343
68805,106629,16263,51299,13036,90366,29617,14274,15343
68810,106639,16263,51305,13036,90376,29618,14274,15344
68815,106645,16263,51309,13036,90382,29620,14274,15346
68820,106656,16263,51314,13036,90393,29621,14274,15347
68825,106660,16263,51316,13036,90397,29621,14274,15347
68830,106670,16263,51318,13036,90407,29622,14274,15348
68835,106676,16263,51321,13036,90413,29624,14275,15349
68840,106687,16263,51328,13036,90424,29625,14276,15349
68845,106691,16263,51330,13036,90428,29625,14276,15349
68850,106701,16263,51335,13036,90438,29626,14277,15349
68855,106707,16263,51338,13036,90444,29628,14278,15350
68860,106718,16263,51342,13036,90455,29629,14278,15351
68865,106722,16263,51345,13036,90459,29629,14278,15351
68870,106732,16263,51350,13036,90469,29630,14278,15352
68875,106738,16263,51353,13036,90475,29631,14278,15353
68880,106749,16263,51356,13036,90486,29632,14278,15354
68885,106753,16263,51357,13036,90490,29632,14278,15354
68890,106763,16263,51360,13036,90500,29633,14278,15355
68895,106769,16263,51362,13036,90506,29634,14279,15355
68900,106780,16263,51364,13036,90517,29635,14280,15355
68905,106784,16263,51366,13036,90521,29635,14280,15355
68910,106794,16263,51372,13036,90531,29636,14280,15356
68915,106800,16263,51375,13036,90537,29637,14281,15356
68920,106811,16263,51381,13036,90548,29638,14282,15356
68925,106815,16263,51382,13036,90552,29638,14282,15356
68930,106825,16263,51386,13036,90562,29639,14282,15357
68935,106831,16263,51388,13036,90568,29640,14282,15358
68940,106842,16263,51396,13036,90579,29641,14283,15358
68945,106846,16263,51398,13036,90583,29641,14283,15358
68950,106856,16263,51402,13036,90593,29642,14283,15359
68955,106862,16263,51405,13036,90599,29643,14284,15359
68960,106873,16263,51412,13036,90610,29644,14285,15359
68965,106877,16263,51413,13036,90614,29644,14285,15359
68970,106887,16263,51417,13036,90624,29645,14286,15359
68975,106893,16263,51419,13036,90630,29647,14287,15360
68980,106904,16263,51423,13036,90641,29648,14287,15361
68985,106908,16263,51425,13036,90645,29648,14287,15361
68990,106918,16263,51433,13036,90655,29649,14288,15361
68995,106924,16263,51438,13036,90661,29651,14290,15361
69000,106935,16263,51444,13036,90672,29652,14291,15361
69005,106939,16263,51446,13036,90676,29652,14291,15361
69010,106949,16263,51450,13036,90686,29653,14292,15361
69015,106955,16263,51454,13036,90692,29655,14294,15361
69020,106966,16263,51459,13036,90703,29656,14294,15362
69025,106970,16263,51463,13036,90707,29656,14294,15362
69030,106980,16263,51468,13036,90717,29657,14294,15363
69035,106986,16263,51469,13036,90723,29659,14295,15364
69040,106997,16263,51473,13036,90734,29660,14296,15364
69045,107001,16263,51475,13036,90738,29660,14296,15364
69050,107011,16263,51482,13036,90748,29661,14297,15364
69055,107017,16263,51484,13036,90754,29663,14298,15365
69060,107028,16263,51490,13036,90765,29664,14298,15366
69065,107032,16263,51493,13036,90769,29664,14298,15366
69070,107042,16263,51498,13036,90779,29665,14299,15366
69075,107048,16263,51500,13036,90785,29667,14300,15367
69080,107059,16263,51506,13036,90796,29668,14301,15367
69085,107063,16263,51509,13036,90800,29668,14301,15367
69090,107073,16263,51515,13036,90810,29669,14301,15368
69095,107079,16263,51518,13036,90816,29671,14301,15370
69100,107090,16263,51525,13036,90827,29672,14302,15370
69105,107094,16263,51528,13036,90831,29672,14302,15370
69110,107104,16263,51531,13036,90841,29673,14303,15370
69115,107110,16263,51535,13036,90847,29675,14305,15370
69120,107121,16263,51540,13036,90858,29676,14305,15371
69125,107125,16263,51541,13036,90862,29676,14305,15371
69130,107135,16263,51548,13036,90872,29677,14306,15371
69135,107141,16263,51550,13036,90878,29679,14306,15373
69140,107152,16263,51555,13036,90889,29680,14306,15374
69145,107156,16263,51557,13036,90893,29680,14306,15374
69150,107166,16263,51561,13036,90903,29681,14306,15375
69155,107172,16263,51566,13036,90909,29683,14308,15375
69160,107183,16263,51574,13036,90920,29684,14309,15375
69165,107187,16263,51576,13036,90924,29684,14309,15375
69170,107197,16263,51580,13036,90934,29685,14310,15375
69175,107203,16263,51585,13036,90940,29687,14312,15375
69180,107214,16263,51589,13036,90951,29688,14313,15375
69185,107218,16263,51591,13036,90955,29688,14313,15375
69190,107228,16263,51596,13036,90965,29689,14313,15376
69195,107234,16263,51598,13036,90971,29690,14313,15377
69200,107245,16263,51604,13036,90982,29691,14314,15377
69205,107249,16263,51605,13036,90986,29691,14314,15377
69210,107259,16263,51612,13036,90996,29692,14315,15377
69215,107265,16263,51615,13036,91002,29693,14316,15377
69220,107276,16263,51620,13036,91013,29694,14316,15378
69225,107280,16263,51621,13036,91017,29694,14316,15378
69230,107290,16263,51626,13036,91027,29695,14317,15378
69235,107296,16263,51628,13036,91033,29696,14317,15379
69240,107307,16263,51633,13036,91044,29697,14317,15380
69245,107311,16263,51634,13036,91048,29697,14317,15380
69250,107321,16263,51636,13036,91058,29698,14317,15381
69255,107327,16263,51640,13036,91064,29699,14318,15381
69260,107338,16263,51646,13036,91075,29700,14318,15382
69265,107342,16263,51647,13036,91079,29700,14318,15382
69270,107352,16263,51652,13036,91089,29701,14318,15383
69275,107358,16263,51655,13036,91095,29702,14319,15383
69280,107369,16263,51662,13036,91106,29703,14320,15383
69285,107373,16263,51665,13036,91110,29703,14320,15383
69290,107383,16263,51669,13036,91120,29704,14320,15384
69295,107389,16263,51674,13036,91126,29706,14322,15384
69300,107400,16263,51682,13036,91137,29707,14323,15384
69305,107404,16263,51684,13036,91141,29707,14323,15384
69310,107414,16263,51691,13036,91151,29708,14324,15384
69315,107420,16263,51692,13036,91157,29710,14324,15386
69320,107431,16263,51697,13036,91168,29711,14325,15386
69325,107435,16263,51700,13036,91172,29711,14325,15386
69330,107445,16263,51704,13036,91182,29712,14325,15387
69335,107451,16263,51707,13036,91188,29714,14326,15388
69340,107462,16263,51711,13036,91199,29715,14326,15389
69345,107466,16263,51711,13036,91203,29715,14326,15389
69350,107476,16263,51716,13036,91213,29716,14326,15390
69355,107482,16263,51719,13036,91219,29718,14327,15391
69360,107493,16263,51721,13036,91230,29719,14328,15391
69365,107497,16263,51723,13036,91234,29719,14328,15391
69370,107507,16263,51726,13036,91244,29720,14328,15392
69375,107513,16263,51727,13036,91250,29722,14328,15394
69380,107524,16263,51732,13036,91261,29723,14329,15394
69385,107528,16263,51734,13036,91265,29723,14329,15394
69390,107538,16263,51738,13036,91275,29724,14330,15394
69395,107544,16263,51742,13036,91281,29726,14331,15395
69400,107555,16263,51748,13036,91292,29727,14331,15396
69405,107559,16263,51749,13036,91296,29727,14331,15396
69410,107569,16263,51754,13036,91306,29728,14332,15396
69415,107575,16263,51758,13036,91312,29730,14334,15396
69420,107586,16263,51767,13036,91323,29731,14335,15396
69425,107590,16263,51769,13036,91327,29731,14335,15396
69430,107600,16263,51774,13036,91337,29732,14335,15397
69435,107606,16263,51777,13036,91343,29734,14336,15398
69440,107617,16263,51782,13036,91354,29735,14337,15398
69445,107621,16263,51783,13036,91358,29735,14337,15398
69450,107631,16263,51786,13036,91368,29736,14337,15399
69455,107637,16263,51791,13036,91374,29737,14338,15399
69460,107648,16263,51797,13036,91385,29738,14339,15399
69465,107652,16263,51799,13036,91389,29738,14339,15399
69470,107662,16263,51802,13036,91399,29739,14340,15399
69475,107668,16263,51805,13036,91405,29740,14340,15400
69480,107679,16263,51812,13036,91416,29741,14341,15400
69485,107683,16263,51814,13036,91420,29741,14341,15400
69490,107693,16263,51817,13036,91430,29742,14341,15401
69495,107699,16263,51819,13036,91436,29743,14341,15402
69500,107710,16263,51824,13036,91447,29744,14342,15402
69505,107714,16263,51824,13036,91451,29744,14342,15402
69510,107724,16263,51831,13036,91461,29745,14342,15403
69515,107730,16263,51834,13036,91467,29746,14342,15404
69520,107741,16263,51840,13036,91478,29747,14343,15404
69525,107745,16263,51843,13036,91482,29747,14343,15404
69530,107755,16263,51847,13036,91492,29748,14343,15405
69535,107761,16263,51848,13036,91498,29749,14343,15406
69540,107772,16263,51852,13036,91509,29750,14343,15407
69545,107776,16263,51853,13036,91513,29750,14343,15407
69550,107786,16263,51859,13036,91523,29751,14343,15408
69555,107792,16263,51862,13036,91529,29752,14344,15408
69560,107803,16263,51866,13036,91540,29753,14345,15408
69565,107807,16263,51868,13036,91544,29753,14345,15408
69570,107817,16263,51873,13036,91554,29754,14345,15409
69575,107823,16263,51877,13036,91560,29755,14346,15409
69580,107834,16263,51883,13036,91571,29756,14347,15409
69585,107838,16263,51884,13036,91575,29756,14347,15409
69590,107848,16263,51888,13036,91585,29757,14347,15410
69595,107854,16263,51889,13036,91591,29758,14347,15411
69600,107865,16263,51895,13036,91602,29759,14347,15412
69605,107869,16263,51895,13036,91606,29759,14347,15412
69610,107879,16263,51900,13036,91616,29760,14347,15413
69615,107885,16263,51902,13036,91622,29761,14348,15413
69620,107896,16263,51908,13036,91633,29762,14349,15413
69625,107900,16263,51910,13036,91637,29762,14349,15413
69630,107910,16263,51915,13036,91647,29763,14350,15413
69635,107916,16263,51919,13036,91653,29764,14351,15413
69640,107927,16263,51923,13036,91664,29765,14352,15413
69645,107931,16263,51924,13036,91668,29765,14352,15413
69650,107941,16263,51930,13036,91678,29766,14353,15413
69655,107947,16263,51933,13036,91684,29767,14354,15413
69660,107958,16263,51939,13036,91695,29768,14355,15413
69665,107962,16263,51941,13036,91699,29768,14355,15413
69670,107972,16263,51944,13036,91709,29769,14355,15414
69675,107978,16263,51948,13036,91715,29770,14356,15414
69680,107989,16263,51955,13036,91726,29771,14356,15415
69685,107993,16263,51956,13036,91730,29771,14356,15415
69690,108003,16263,51960,13036,91740,29772,14357,15415
69695,108009,16263,51964,13036,91746,29773,14357,15416
69700,108020,16263,51968,13036,91757,29774,14357,15417
69705,108024,16263,51969,13036,91761,29774,14357,15417
69710,108034,16263,51972,13036,91771,29775,14357,15418
69715,108040,16263,51976,13036,91777,29776,14358,15418
69720,108051,16263,51979,13036,91788,29777,14358,15419
69725,108055,16263,51980,13036,91792,29777,14358,15419
69730,108065,16263,51984,13036,91802,29778,14358,15420
69735,108071,16263,51987,13036,91808,29779,14358,15421
69740,108082,16263,51992,13036,91819,29780,14358,15422
69745,108086,16263,51993,13036,91823,29780,14358,15422
69750,108096,16263,51995,13036,91833,29781,14358,15423
69755,108102,16263,51997,13036,91839,29782,14358,15424
69760,108113,16263,52003,13036,91850,29783,14358,15425
69765,108117,16263,52004,13036,91854,29783,14358,15425
69770,108127,16263,52010,13036,91864,29784,14359,15425
69775,108133,16263,52012,13036,91870,29785,14360,15425
69780,108144,16263,52020,13036,91881,29786,14361,15425
69785,108148,16263,52021,13036,91885,29786,14361,15425
69790,108158,16263,52023,13036,91895,29787,14362,15425
69795,108164,16263,52026,13036,91901,29788,14363,15425
69800,108175,16263,52034,13036,91912,29789,14364,15425
69805,108179,16263,52035,13036,91916,29789,14364,15425
69810,108189,16263,52039,13036,91926,29790,14364,15426
69815,108195,16263,52042,13036,91932,29791,14364,15427
69820,108206,16263,52049,13036,91943,29792,14365,15427
69825,108210,16263,52052,13036,91947,29792,14365,15427
69830,108220,16263,52059,13036,91957,29793,14366,15427
69835,108226,16263,52064,13036,91963,29794,14367,15427
69840,108237,16263,52071,13036,91974,29795,14367,15428
69845,108241,16263,52073,13036,91978,29795,14367,15428
69850,108251,16263,52077,13036,91988,29796,14368,15428
69855,108257,16263,52081,13036,91994,29797,14368,15429
69860,108268,16263,52088,13036,92005,29798,14369,15429
69865,108272,16263,52090,13036,92009,29798,14369,15429
69870,108282,16263,52095,13036,92019,29799,14369,15430
69875,108288,16263,52098,13036,92025,29800,14370,15430
69880,108299,16263,52101,13036,92036,29801,14370,15431
69885,108303,16263,52103,13036,92040,29801,14370,15431
69890,108313,16263,52108,13036,92050,29802,14371,15431
69895,108319,16263,52112,13036,92056,29803,14372,15431
69900,108330,16263,52115,13036,92067,29804,14372,15432
69905,108334,16263,52117,13036,92071,29804,14372,15432
69910,108344,16263,52123,13036,92081,29805,14372,15433
69915,108350,16263,52125,13036,92087,29806,14372,15434
69920,108361,16263,52128,13036,92098,29807,14372,15435
69925,108365,16263,52128,13036,92102,29807,14372,15435
69930,108375,16263,52134,13036,92112,29808,14372,15436
69935,108381,16263,52135,13036,92118,29809,14372,15437
69940,108392,16263,52141,13036,92129,29810,14372,15438
69945,108396,16263,52143,13036,92133,29810,14372,15438
69950,108406,16263,52147,13036,92143,29811,14372,15439
69955,108412,16263,52151,13036,92149,29812,14373,15439
69960,108423,16263,52155,13036,92160,29813,14374,15439
69965,108427,16263,52156,13036,92164,29813,14374,15439
69970,108437,16263,52159,13036,92174,29814,14374,15440
69975,108443,16263,52162,13036,92180,29815,14374,15441
69980,108454,16263,52168,13036,92191,29816,14375,15441
69985,108458,16263,52169,13036,92195,29816,14375,15441
69990,108468,16263,52175,13036,92205,29817,14375,15442
69995,108474,16263,52180,13036,92211,29818,14376,15442
70000,108485,16263,52188,13036,92222,29819,14377,15442
70005,108489,16263,52191,13036,92226,29819,14377,15442
70010,108499,16263,52194,13036,92236,29820,14377,15443
70015,108505,16263,52198,13036,92242,29821,14377,15444
70020,108516,16263,52204,13036,92253,29822,14378,15444
70025,108520,16263,52206,13036,92257,29822,14378,15444
70030,108530,16263,52208,13036,92267,29823,14379,15444
70035,108536,16263,52209,13036,92273,29824,14379,15445
70040,108547,16263,52211,13036,92284,29825,14379,15446
70045,108551,16263,52213,13036,92288,29825,14379,15446
70050,108561,16263,52217,13036,92298,29826,14379,15447
70055,108567,16263,52221,13036,92304,29827,14380,15447
70060,108578,16263,52227,13036,92315,29828,14380,15448
70065,108582,16263,52230,13036,92319,29828,14380,15448
70070,108592,16263,52235,13036,92329,29829,14380,15449
70075,108598,16263,52238,13036,92335,29830,14381,15449
70080,108609,16263,52242,13036,92346,29831,14381,15450
70085,108613,16263,52245,13036,92350,29831,14381,15450
70090,108623,16263,52251,13036,92360,29832,14381,15451
70095,108629,16263,52252,13036,92366,29833,14381,15452
70100,108640,16263,52259,13036,92377,29834,14382,15452
70105,108644,16263,52261,13036,92381,29834,14382,15452
70110,108654,16263,52268,13036,92391,29835,14383,15452
70115,108660,16263,52270,13036,92397,29836,14384,15452
70120,108671,16263,52275,13036,92408,29837,14384,15453
70125,108675,16263,52277,13036,92412,29837,14384,15453
70130,108685,16263,52282,13036,92422,29838,14385,15453
70135,108691,16263,52285,13036,92428,29839,14385,15454
70140,108702,16263,52292,13036,92439,29840,14386,15454
70145,108706,16263,52293,13036,92443,29840,14386,15454
70150,108716,16263,52300,13036,92453,29841,14387,15454
70155,108722,16263,52301,13036,92459,29842,14387,15455
70160,108733,16263,52307,13036,92470,29843,14388,15455
70165,108737,16263,52310,13036,92474,29843,14388,15455
70170,108747,16263,52316,13036,92484,29844,14388,15456
70175,108753,16263,52318,13036,92490,29845,14388,15457
70180,108764,16263,52324,13036,92501,29846,14389,15457
70185,108768,16263,52328,13036,92505,29846,14389,15457
70190,108778,16263,52333,13036,92515,29847,14390,15457
70195,108784,16263,52338,13036,92521,29848,14391,15457
70200,108795,16263,52343,13036,92532,29849,14391,15458
70205,108799,16263,52344,13036,92536,29849,14391,15458
70210,108809,16263,52349,13036,92546,29850,14392,15458
70215,108815,16263,52352,13036,92552,29851,14392,15459
70220,108826,16263,52361,13036,92563,29852,14393,15459
70225,108830,16263,52363,13036,92567,29852,14393,15459
70230,108840,16263,52369,13036,92577,29853,14394,15459
70235,108846,16263,52373,13036,92583,29854,14395,15459
70240,108857,16263,52377,13036,92594,29855,14395,15460
70245,108861,16263,52380,13036,92598,29855,14395,15460
70250,108871,16263,52385,13036,92608,29856,14396,15460
70255,108877,16263,52389,13036,92614,29857,14396,15461
70260,108888,16263,52393,13036,92625,29858,14396,15462
70265,108892,16263,52396,13036,92629,29858,14396,15462
70270,108902,16263,52397,13036,92639,29859,14396,15463
70275,108908,16263,52402,13036,92645,29860,14397,15463
70280,108919,16263,52408,13036,92656,29861,14398,15463
70285,108923,16263,52408,13036,92660,29861,14398,15463
70290,108933,16263,52412,13036,92670,29862,14398,15464
70295,108939,16263,52415,13036,92676,29863,14399,15464
70300,108950,16263,52421,13036,92687,29864,14399,15465
70305,108954,16263,52422,13036,92691,29864,14399,15465
70310,108964,16263,52428,13036,92701,29865,14399,15466
70315,108970,16263,52429,13036,92707,29866,14399,15467
70320,108981,16263,52435,13036,92718,29867,14400,15467
70325,108985,16263,52437,13036,92722,29867,14400,15467
70330,108995,16263,52440,13036,92732,29868,14400,15468
70335,109001,16263,52442,13036,92738,29869,14400,15469
70340,109012,16263,52448,13036,92749,29870,14400,15470
70345,109016,16263,52448,13036,92753,29870,14400,15470
70350,109026,16263,52451,13036,92763,29871,14400,15471
70355,109032,16263,52454,13036,92769,29872,14401,15471
70360,109043,16263,52462,13036,92780,29872,14401,15471
70365,109047,16263,52463,13036,92784,29872,14401,15471
70370,109057,16263,52465,13036,92794,29873,14401,15472
70375,109063,16263,52466,13036,92800,29874,14401,15473
70380,109074,16263,52472,13036,92811,29874,14401,15473
70385,109078,16263,52472,13036,92815,29874,14401,15473
70390,109088,16263,52480,13036,92825,29875,14402,15473
70395,109094,16263,52481,13036,92831,29876,14402,15474
70400,109105,16263,52487,13036,92842,29876,14402,15474
70405,109109,16263,52489,13036,92846,29876,14402,15474
70410,109119,16263,52496,13036,92856,29877,14403,15474
70415,109125,16263,52499,13036,92862,29878,14404,15474
70420,109136,16263,52503,13036,92873,29878,14404,15474
70425,109140,16263,52505,13036,92877,29878,14404,15474
70430,109150,16263,52510,13036,92887,29879,14404,15475
70435,109156,16263,52515,13036,92893,29880,14404,15476
70440,109167,16263,52521,13036,92904,29880,14404,15476
70445,109171,16263,52525,13036,92908,29880,14404,15476
70450,109181,16263,52528,13036,92918,29881,14404,15477
70455,109187,16263,52531,13036,92924,29882,14404,15478
70460,109198,16263,52538,13036,92935,29882,14404,15478
70465,109202,16263,52541,13036,92939,29882,14404,15478
70470,109212,16263,52544,13036,92949,29883,14404,15479
70475,109218,16263,52546,13036,92955,29884,14405,15479
70480,109229,16263,52554,13036,92966,29884,14405,15479
70485,109233,16263,52557,13036,92970,29884,14405,15479
70490,109243,16263,52561,13036,92980,29885,14406,15479
70495,109249,16263,52564,13036,92986,29886,14407,15479
70500,109260,16263,52568,13036,92997,29886,14407,15479
70505,109264,16263,52570,13036,93001,29886,14407,15479
70510,109274,16263,52574,13036,93011,29887,14407,15480
70515,109280,16263,52578,13036,93017,29888,14408,15480
70520,109291,16263,52580,13036,93028,29888,14408,15480
70525,109295,16263,52583,13036,93032,29888,14408,15480
70530,109305,16263,52587,13036,93042,29889,14408,15481
70535,109311,16263,52588,13036,93048,29890,14408,15482
70540,109322,16263,52594,13036,93059,29890,14408,15482
70545,109326,16263,52594,13036,93063,29890,14408,15482
70550,109336,16263,52597,13036,93073,29891,14408,15483
70555,109342,16263,52597,13036,93079,29892,14408,15484
70560,109353,16263,52601,13036,93090,29892,14408,15484
70565,109357,16263,52603,13036,93094,29892,14408,15484
70570,109367,16263,52606,13036,93104,29893,14408,15485
70575,109373,16263,52610,13036,93110,29894,14409,15485
70580,109384,16263,52617,13036,93121,29894,14409,15485
70585,109388,16263,52620,13036,93125,29894,14409,15485
70590,109398,16263,52624,13036,93135,29895,14410,15485
70595,109404,16263,52626,13036,93141,29896,14410,15486
70600,109415,16263,52630,13036,93152,29896,14410,15486
70605,109419,16263,52634,13036,93156,29896,14410,15486
70610,109429,16263,52638,13036,93166,29897,14411,15486
70615,109435,16263,52641,13036,93172,29898,14412,15486
70620,109446,16263,52646,13036,93183,29898,14412,15486
70625,109450,16263,52647,13036,93187,29898,14412,15486
70630,109460,16263,52651,13036,93197,29899,14413,15486
70635,109466,16263,52654,13036,93203,29900,14413,15487
70640,109477,16263,52658,13036,93214,29900,14413,15487
70645,109481,16263,52659,13036,93218,29900,14413,15487
70650,109491,16263,52661,13036,93228,29901,14413,15488
70655,109497,16263,52664,13036,93234,29902,14413,15489
70660,109508,16263,52671,13036,93245,29902,14413,15489
70665,109512,16263,52673,13036,93249,29902,14413,15489
70670,109522,16263,52678,13036,93259,29903,14414,15489
70675,109528,16263,52684,13036,93265,29904,14415,15489
70680,109539,16263,52689,13036,93276,29904,14415,15489
70685,109543,16263,52690,13036,93280,29904,14415,15489
70690,109553,16263,52693,13036,93290,29905,14415,15490
70695,109559,16263,52697,13036,93296,29906,14415,15491
70700,109570,16263,52704,13036,93307,29906,14415,15491
70705,109574,16263,52706,13036,93311,29906,14415,15491
70709,109583,16263,52712,13036,93320,29907,14416,15491
