Time,  Packets Generated,  Packets Reached,High Priority Packets Generated, High Priority Packets reached, Packet Dropped, Packet Dropped due to Faulty Node, High Prio Packet Dropped due to Faulty Node, Low Prio Packet Dropped due to Faulty Node 
5,1,1,1,1,0,0,0,0
10,6,5,5,4,0,0,0,0
15,9,8,7,6,0,0,0,0
20,22,16,12,9,1,1,1,0
25,28,24,15,12,2,2,1,1
30,46,37,22,19,3,3,2,1
35,56,48,29,24,4,4,3,1
40,77,65,36,30,5,5,3,2
45,87,77,40,34,6,6,3,3
50,108,94,49,42,7,7,4,3
55,118,106,56,50,8,8,5,3
60,139,123,68,58,9,9,5,4
65,149,134,73,65,11,9,5,4
70,170,148,85,74,15,10,6,4
75,180,160,91,82,17,10,6,4
80,201,174,100,91,20,11,7,4
85,211,184,106,96,24,11,7,4
90,232,194,112,99,29,12,7,5
95,242,205,117,106,32,12,7,5
100,263,218,130,114,38,13,8,5
105,273,229,134,121,39,13,8,5
110,294,238,144,128,51,14,9,5
115,304,245,149,133,53,14,9,5
120,325,258,160,143,62,15,10,5
125,335,266,166,150,67,15,10,5
130,356,275,177,158,75,16,10,6
135,366,282,181,163,82,16,10,6
140,387,289,193,170,93,17,10,7
145,397,294,197,175,100,17,10,7
150,418,300,204,180,115,18,11,7
155,428,304,208,184,122,18,11,7
160,449,309,217,188,137,19,12,7
165,459,313,222,192,144,19,12,7
170,480,317,227,195,162,20,12,8
175,490,318,230,196,171,20,12,8
180,511,318,240,196,191,21,13,8
185,521,319,242,197,202,21,13,8
190,542,320,251,198,222,22,13,9
195,552,320,254,198,232,22,13,9
200,573,323,261,200,250,23,13,10
205,583,323,268,200,259,23,13,10
210,604,328,281,203,276,24,14,10
215,614,328,283,203,286,24,14,10
220,635,331,296,206,304,25,15,10
225,645,331,299,206,314,25,15,10
230,666,333,312,208,333,26,16,10
235,676,335,319,210,340,26,16,10
240,697,338,332,213,359,27,17,10
245,707,340,336,214,367,27,17,10
250,728,342,349,216,386,27,17,10
255,738,344,356,218,394,27,17,10
260,759,345,364,218,414,27,17,10
265,769,347,372,219,422,27,17,10
270,790,348,380,220,441,27,17,10
275,800,350,382,221,450,27,17,10
280,821,352,389,223,468,27,17,10
285,831,354,391,224,477,27,17,10
290,852,356,400,225,495,27,17,10
295,862,359,407,227,503,27,17,10
300,883,362,416,228,519,28,18,10
305,893,364,419,230,529,28,18,10
310,914,369,431,235,544,29,18,11
315,924,370,436,236,554,29,18,11
320,945,371,446,236,574,30,19,11
325,955,371,451,236,584,30,19,11
330,976,372,460,236,604,31,19,12
335,986,372,465,236,614,31,19,12
340,1007,373,477,236,634,32,19,13
345,1017,373,482,236,644,32,19,13
350,1038,376,492,238,661,33,19,14
355,1048,376,496,238,672,33,19,14
360,1069,379,509,240,688,34,20,14
365,1079,379,513,240,698,34,20,14
370,1100,383,520,243,717,35,21,14
375,1110,383,525,243,726,35,21,14
380,1131,387,539,246,744,36,21,15
385,1141,387,546,246,752,36,21,15
390,1162,392,556,251,769,37,21,16
395,1172,393,563,252,778,37,21,16
400,1193,396,571,254,797,37,21,16
405,1203,396,575,254,807,37,21,16
410,1224,398,585,255,826,37,21,16
415,1234,398,591,255,836,37,21,16
420,1255,400,597,255,855,37,21,16
425,1265,400,604,255,865,37,21,16
430,1286,403,615,257,883,37,21,16
435,1296,403,617,257,893,37,21,16
440,1317,405,627,259,912,37,21,16
445,1327,405,629,259,922,37,21,16
450,1348,407,638,261,941,37,21,16
455,1358,407,645,261,951,37,21,16
460,1379,408,656,261,971,37,21,16
465,1389,409,660,261,979,37,21,16
470,1410,414,671,265,996,37,21,16
475,1420,416,676,266,1004,37,21,16
480,1441,419,686,268,1021,37,21,16
485,1451,421,691,270,1030,37,21,16
490,1472,422,701,270,1049,38,21,17
495,1482,423,703,271,1059,38,21,17
500,1503,425,716,272,1078,39,22,17
505,1513,425,725,272,1088,39,22,17
510,1534,426,732,272,1108,40,22,18
515,1544,426,738,272,1118,40,22,18
520,1565,427,747,273,1138,41,22,19
525,1575,427,751,273,1148,41,22,19
530,1596,430,760,274,1165,42,23,19
535,1606,430,765,274,1174,42,23,19
540,1627,432,774,275,1194,43,24,19
545,1637,433,778,276,1204,43,24,19
550,1658,435,792,278,1223,43,24,19
555,1668,436,796,279,1232,43,24,19
560,1689,438,808,280,1251,43,24,19
565,1699,439,812,280,1260,43,24,19
570,1720,442,822,282,1278,43,24,19
575,1730,443,826,282,1287,43,24,19
580,1751,445,837,283,1306,43,24,19
585,1761,446,841,283,1315,43,24,19
590,1782,448,845,284,1334,43,24,19
595,1792,449,850,284,1343,43,24,19
600,1813,451,860,285,1362,43,24,19
605,1823,452,868,286,1370,43,24,19
610,1844,454,876,287,1390,43,24,19
615,1854,454,882,287,1399,43,24,19
620,1875,456,895,288,1419,43,24,19
625,1885,456,897,288,1429,43,24,19
630,1906,457,911,289,1449,43,24,19
635,1916,457,916,289,1458,43,24,19
640,1937,459,929,290,1478,43,24,19
645,1947,459,935,290,1488,43,24,19
650,1968,463,946,293,1505,43,24,19
655,1978,463,951,293,1515,43,24,19
660,1999,465,956,293,1534,43,24,19
665,2009,467,959,294,1540,43,24,19
670,2030,473,971,298,1556,44,25,19
675,2040,474,976,298,1566,44,25,19
680,2061,475,988,299,1586,44,25,19
685,2071,476,994,299,1595,44,25,19
690,2092,477,1005,299,1615,44,25,19
695,2102,478,1012,300,1624,44,25,19
700,2123,480,1021,302,1643,44,25,19
705,2133,481,1026,303,1652,44,25,19
710,2154,483,1034,304,1671,44,25,19
715,2164,484,1039,305,1680,44,25,19
720,2185,485,1050,306,1700,44,25,19
725,2195,485,1056,306,1710,44,25,19
730,2216,486,1069,307,1730,44,25,19
735,2226,486,1073,307,1740,44,25,19
740,2247,487,1085,308,1760,44,25,19
745,2257,487,1092,308,1770,44,25,19
750,2278,488,1100,308,1790,44,25,19
755,2288,488,1104,308,1800,44,25,19
760,2309,489,1114,308,1820,44,25,19
765,2319,489,1117,308,1830,44,25,19
770,2340,493,1127,311,1845,44,25,19
775,2350,496,1133,314,1854,44,25,19
780,2371,502,1142,318,1866,45,26,19
785,2381,504,1149,320,1876,45,26,19
790,2402,506,1160,321,1896,45,26,19
795,2412,507,1166,322,1904,45,26,19
800,2433,509,1178,324,1924,45,26,19
805,2443,510,1181,325,1933,45,26,19
810,2464,511,1188,326,1953,45,26,19
815,2474,512,1191,327,1962,45,26,19
820,2495,513,1199,327,1982,45,26,19
825,2505,514,1205,328,1991,45,26,19
830,2526,515,1215,328,2011,45,26,19
835,2536,516,1220,328,2020,45,26,19
840,2557,517,1229,329,2040,45,26,19
845,2567,520,1237,331,2046,45,26,19
850,2588,522,1248,333,2063,45,26,19
855,2598,526,1251,336,2072,45,26,19
860,2619,527,1263,337,2088,45,26,19
865,2629,533,1268,342,2095,45,26,19
870,2650,535,1280,344,2112,45,26,19
875,2660,539,1282,348,2121,45,26,19
880,2681,540,1290,348,2140,45,26,19
885,2691,542,1294,350,2148,45,26,19
890,2712,546,1303,352,2165,45,26,19
895,2722,548,1308,354,2174,45,26,19
900,2743,552,1318,357,2190,46,26,20
905,2753,553,1323,358,2200,46,26,20
910,2774,555,1334,358,2219,46,26,20
915,2784,555,1340,358,2228,46,26,20
920,2805,557,1352,360,2248,46,26,20
925,2815,557,1355,360,2258,46,26,20
930,2836,559,1367,362,2277,46,26,20
935,2846,559,1372,362,2287,46,26,20
940,2867,561,1381,364,2306,46,26,20
945,2877,561,1388,364,2316,46,26,20
950,2898,563,1398,366,2335,46,26,20
955,2908,563,1403,366,2345,46,26,20
960,2929,565,1412,366,2364,46,26,20
965,2939,565,1415,366,2374,46,26,20
970,2960,567,1423,366,2393,46,26,20
975,2970,568,1430,367,2402,46,26,20
980,2991,570,1443,368,2421,46,26,20
985,3001,570,1448,368,2431,46,26,20
990,3022,572,1457,370,2450,46,26,20
995,3032,573,1459,371,2459,46,26,20
1000,3053,575,1466,372,2478,46,26,20
1005,3063,576,1472,373,2486,46,26,20
1010,3084,582,1478,376,2501,46,26,20
1015,3094,586,1485,380,2505,46,26,20
1020,3115,593,1496,385,2519,46,26,20
1025,3125,597,1501,389,2528,46,26,20
1030,3146,598,1509,390,2548,46,26,20
1035,3156,599,1511,390,2557,46,26,20
1040,3177,600,1518,390,2577,46,26,20
1045,3187,601,1524,391,2586,46,26,20
1050,3208,602,1531,391,2606,46,26,20
1055,3218,603,1538,392,2615,46,26,20
1060,3239,604,1551,393,2635,46,26,20
1065,3249,605,1557,394,2644,46,26,20
1070,3270,606,1569,395,2664,46,26,20
1075,3280,607,1574,395,2673,46,26,20
1080,3301,608,1583,395,2693,46,26,20
1085,3311,611,1591,398,2700,46,26,20
1090,3332,616,1604,403,2715,47,26,21
1095,3342,619,1609,406,2723,47,26,21
1100,3363,626,1623,413,2736,48,27,21
1105,3373,628,1629,415,2745,48,27,21
1110,3394,634,1646,421,2760,49,28,21
1115,3404,636,1651,423,2768,49,28,21
1120,3425,639,1662,425,2786,50,28,22
1125,3435,641,1668,427,2793,50,28,22
1130,3456,645,1675,430,2809,51,29,22
1135,3466,649,1678,433,2816,51,29,22
1140,3487,654,1688,436,2829,52,29,23
1145,3497,657,1692,439,2840,52,29,23
1150,3518,658,1701,439,2860,52,29,23
1155,3528,658,1705,439,2870,52,29,23
1160,3549,660,1712,440,2889,52,29,23
1165,3559,660,1714,440,2899,52,29,23
1170,3580,661,1722,440,2919,52,29,23
1175,3590,661,1727,440,2929,52,29,23
1180,3611,663,1736,442,2948,52,29,23
1185,3621,663,1739,442,2958,52,29,23
1190,3642,665,1751,444,2977,52,29,23
1195,3652,665,1756,444,2987,52,29,23
1200,3673,666,1767,444,3007,52,29,23
1205,3683,666,1773,444,3017,52,29,23
1210,3704,666,1781,444,3038,52,29,23
1215,3714,666,1786,444,3048,52,29,23
1220,3735,666,1797,444,3069,52,29,23
1225,3745,666,1800,444,3079,52,29,23
1230,3766,666,1809,444,3100,52,29,23
1235,3776,666,1813,444,3110,52,29,23
1240,3797,666,1823,444,3131,52,29,23
1245,3807,666,1829,444,3141,52,29,23
1250,3828,668,1841,446,3159,52,29,23
1255,3838,669,1846,446,3168,52,29,23
1260,3859,673,1861,450,3181,52,29,23
1265,3869,679,1867,455,3190,52,29,23
1270,3890,681,1880,456,3209,52,29,23
1275,3900,682,1883,457,3218,52,29,23
1280,3921,684,1893,459,3237,52,29,23
1285,3931,685,1894,459,3246,52,29,23
1290,3952,687,1905,460,3265,52,29,23
1295,3962,688,1912,461,3274,52,29,23
1300,3983,689,1920,462,3294,52,29,23
1305,3993,690,1925,463,3303,52,29,23
1310,4014,693,1938,464,3321,52,29,23
1315,4024,694,1943,464,3330,52,29,23
1320,4045,697,1956,466,3348,52,29,23
1325,4055,699,1961,468,3356,52,29,23
1330,4076,704,1971,470,3371,53,30,23
1335,4086,706,1976,472,3380,53,30,23
1340,4107,709,1982,473,3398,54,30,24
1345,4117,710,1988,474,3407,54,30,24
1350,4138,712,2000,476,3426,55,31,24
1355,4148,713,2005,476,3435,55,31,24
1360,4169,715,2012,477,3454,56,32,24
1365,4179,716,2017,478,3463,56,32,24
1370,4200,720,2030,481,3478,57,33,24
1375,4210,723,2035,483,3487,57,33,24
1380,4231,725,2043,484,3506,57,33,24
1385,4241,725,2048,484,3516,57,33,24
1390,4262,728,2059,487,3534,57,33,24
1395,4272,728,2063,487,3544,57,33,24
1400,4293,730,2073,488,3563,57,33,24
1405,4303,730,2079,488,3573,57,33,24
1410,4324,733,2092,491,3591,57,33,24
1415,4334,733,2099,491,3601,57,33,24
1420,4355,735,2109,491,3620,57,33,24
1425,4365,735,2113,491,3630,57,33,24
1430,4386,738,2125,494,3648,57,33,24
1435,4396,738,2128,494,3658,57,33,24
1440,4417,743,2141,498,3674,57,33,24
1445,4427,743,2144,498,3684,57,33,24
1450,4448,744,2153,498,3704,57,33,24
1455,4458,744,2160,498,3714,57,33,24
1460,4479,745,2170,499,3734,57,33,24
1465,4489,745,2174,499,3743,57,33,24
1470,4510,747,2188,501,3763,57,33,24
1475,4520,747,2192,501,3772,57,33,24
1480,4541,749,2202,503,3792,57,33,24
1485,4551,749,2208,503,3801,57,33,24
1490,4572,752,2221,506,3816,57,33,24
1495,4582,758,2225,511,3823,57,33,24
1500,4603,761,2235,514,3837,57,33,24
1505,4613,764,2238,517,3849,57,33,24
1510,4634,766,2248,517,3868,57,33,24
1515,4644,766,2255,517,3878,57,33,24
1520,4665,768,2263,517,3897,57,33,24
1525,4675,768,2266,517,3907,57,33,24
1530,4696,770,2278,518,3926,57,33,24
1535,4706,770,2280,518,3936,57,33,24
1540,4727,772,2295,519,3955,57,33,24
1545,4737,772,2297,519,3965,57,33,24
1550,4758,776,2309,523,3982,58,33,25
1555,4768,777,2312,524,3991,58,33,25
1560,4789,781,2324,527,4008,59,34,25
1565,4799,783,2328,529,4016,59,34,25
1570,4820,784,2338,529,4036,60,35,25
1575,4830,785,2343,529,4045,60,35,25
1580,4851,786,2355,530,4065,60,35,25
1585,4861,787,2358,530,4074,60,35,25
1590,4882,788,2364,530,4094,60,35,25
1595,4892,789,2371,531,4103,60,35,25
1600,4913,790,2382,532,4123,60,35,25
1605,4923,791,2387,532,4131,60,35,25
1610,4944,792,2401,532,4152,60,35,25
1615,4954,793,2403,532,4161,60,35,25
1620,4975,794,2411,532,4181,60,35,25
1625,4985,794,2416,532,4191,60,35,25
1630,5006,796,2428,533,4210,60,35,25
1635,5016,796,2436,533,4220,60,35,25
1640,5037,797,2447,534,4240,60,35,25
1645,5047,797,2450,534,4250,60,35,25
1650,5068,799,2462,536,4269,60,35,25
1655,5078,799,2469,536,4279,60,35,25
1660,5099,801,2476,537,4298,60,35,25
1665,5109,801,2481,537,4308,60,35,25
1670,5130,805,2491,540,4325,60,35,25
1675,5140,806,2498,541,4333,60,35,25
1680,5161,810,2509,545,4351,60,35,25
1685,5171,811,2515,546,4359,60,35,25
1690,5192,815,2527,550,4377,60,35,25
1695,5202,815,2534,550,4387,60,35,25
1700,5223,817,2542,550,4406,60,35,25
1705,5233,818,2546,551,4414,60,35,25
1710,5254,822,2557,555,4432,60,35,25
1715,5264,822,2563,555,4441,60,35,25
1720,5285,826,2573,558,4459,60,35,25
1725,5295,827,2579,559,4467,60,35,25
1730,5316,834,2588,565,4480,61,35,26
1735,5326,838,2595,569,4484,61,35,26
1740,5347,844,2606,574,4499,62,35,27
1745,5357,847,2609,576,4510,62,35,27
1750,5378,848,2616,576,4530,62,35,27
1755,5388,849,2620,577,4538,62,35,27
1760,5409,851,2628,579,4558,62,35,27
1765,5419,852,2634,579,4567,62,35,27
1770,5440,853,2644,579,4587,62,35,27
1775,5450,854,2650,580,4596,62,35,27
1780,5471,856,2657,580,4615,62,35,27
1785,5481,857,2660,580,4624,62,35,27
1790,5502,859,2671,580,4643,63,35,28
1795,5512,860,2675,581,4652,63,35,28
1800,5533,863,2683,583,4670,64,36,28
1805,5543,863,2689,583,4680,64,36,28
1810,5564,865,2697,583,4699,64,36,28
1815,5574,865,2703,583,4709,64,36,28
1820,5595,867,2711,584,4728,64,36,28
1825,5605,867,2716,584,4738,64,36,28
1830,5626,869,2728,585,4757,64,36,28
1835,5636,869,2733,585,4767,64,36,28
1840,5657,871,2740,586,4786,64,36,28
1845,5667,871,2745,586,4796,64,36,28
1850,5688,874,2756,588,4814,64,36,28
1855,5698,874,2757,588,4824,64,36,28
1860,5719,877,2767,590,4842,64,36,28
1865,5729,877,2771,590,4852,64,36,28
1870,5750,879,2780,592,4871,64,36,28
1875,5760,879,2784,592,4881,64,36,28
1880,5781,882,2795,595,4899,64,36,28
1885,5791,882,2801,595,4909,64,36,28
1890,5812,885,2812,596,4927,64,36,28
1895,5822,885,2817,596,4937,64,36,28
1900,5843,887,2828,598,4956,64,36,28
1905,5853,887,2834,598,4965,64,36,28
1910,5874,892,2849,603,4980,65,37,28
1915,5884,895,2855,605,4987,65,37,28
1920,5905,901,2863,609,5002,66,38,28
1925,5915,905,2870,613,5010,66,38,28
1930,5936,908,2878,615,5027,66,38,28
1935,5946,911,2883,617,5035,66,38,28
1940,5967,913,2896,619,5053,66,38,28
1945,5977,916,2901,621,5061,66,38,28
1950,5998,918,2916,622,5080,66,38,28
1955,6008,919,2919,623,5089,66,38,28
1960,6029,920,2927,624,5109,66,38,28
1965,6039,920,2932,624,5119,66,38,28
1970,6060,921,2944,625,5139,66,38,28
1975,6070,921,2947,625,5149,66,38,28
1980,6091,922,2954,626,5169,66,38,28
1985,6101,922,2958,626,5178,66,38,28
1990,6122,925,2968,629,5197,66,38,28
1995,6132,925,2973,629,5207,66,38,28
2000,6153,926,2988,629,5227,66,38,28
2005,6163,926,2993,629,5237,66,38,28
2010,6184,928,3004,630,5256,66,38,28
2015,6194,928,3008,630,5266,66,38,28
2020,6215,931,3020,632,5284,66,38,28
2025,6225,931,3027,632,5294,66,38,28
2030,6246,933,3036,632,5313,66,38,28
2035,6256,933,3039,632,5323,66,38,28
2040,6277,935,3051,633,5342,66,38,28
2045,6287,935,3053,633,5352,66,38,28
2050,6308,937,3065,635,5370,66,38,28
2055,6318,940,3072,638,5378,66,38,28
2060,6339,942,3082,640,5397,66,38,28
2065,6349,944,3087,642,5405,66,38,28
2070,6370,946,3102,644,5424,66,38,28
2075,6380,947,3106,644,5433,66,38,28
2080,6401,947,3117,644,5454,66,38,28
2085,6411,948,3121,645,5463,66,38,28
2090,6432,950,3130,646,5482,66,38,28
2095,6442,951,3134,647,5491,66,38,28
2100,6463,952,3141,648,5511,66,38,28
2105,6473,953,3146,648,5520,66,38,28
2110,6494,954,3155,649,5540,67,38,29
2115,6504,956,3163,651,5547,67,38,29
2120,6525,958,3175,653,5566,68,38,30
2125,6535,961,3176,655,5574,68,38,30
2130,6556,962,3187,656,5593,69,39,30
2135,6566,965,3191,658,5600,69,39,30
2140,6587,967,3201,659,5620,70,39,31
2145,6597,969,3206,660,5628,70,39,31
2150,6618,971,3215,661,5646,71,40,31
2155,6628,974,3219,664,5654,71,40,31
2160,6649,978,3228,667,5671,72,41,31
2165,6659,979,3231,667,5680,72,41,31
2170,6680,981,3239,668,5699,72,41,31
2175,6690,982,3246,669,5708,72,41,31
2180,6711,984,3255,670,5726,72,41,31
2185,6721,987,3260,673,5734,72,41,31
2190,6742,989,3269,673,5752,72,41,31
2195,6752,992,3275,675,5760,72,41,31
2200,6773,995,3284,677,5777,72,41,31
2205,6783,998,3291,680,5785,72,41,31
2210,6804,1001,3305,683,5803,72,41,31
2215,6814,1002,3308,683,5812,72,41,31
2220,6835,1004,3321,684,5831,72,41,31
2225,6845,1004,3325,684,5841,72,41,31
2230,6866,1006,3338,685,5860,73,42,31
2235,6876,1006,3342,685,5870,73,42,31
2240,6897,1007,3349,686,5890,74,43,31
2245,6907,1008,3353,687,5899,74,43,31
2250,6928,1009,3362,687,5919,75,44,31
2255,6938,1010,3369,688,5928,75,44,31
2260,6959,1011,3378,688,5948,76,44,32
2265,6969,1011,3382,688,5958,76,44,32
2270,6990,1013,3393,689,5977,77,45,32
2275,7000,1014,3399,690,5986,77,45,32
2280,7021,1015,3408,691,6006,77,45,32
2285,7031,1015,3414,691,6016,77,45,32
2290,7052,1016,3422,691,6036,77,45,32
2295,7062,1016,3426,691,6046,77,45,32
2300,7083,1016,3432,691,6067,77,45,32
2305,7093,1016,3437,691,6077,77,45,32
2310,7114,1016,3449,691,6098,77,45,32
2315,7124,1016,3453,691,6108,77,45,32
2320,7145,1016,3464,691,6129,77,45,32
2325,7155,1016,3468,691,6139,77,45,32
2330,7176,1018,3479,693,6158,77,45,32
2335,7186,1020,3486,695,6165,77,45,32
2340,7207,1028,3499,701,6177,77,45,32
2345,7217,1029,3502,701,6188,77,45,32
2350,7238,1030,3511,701,6208,77,45,32
2355,7248,1031,3517,702,6217,77,45,32
2360,7269,1032,3526,702,6237,77,45,32
2365,7279,1033,3533,703,6246,77,45,32
2370,7300,1034,3546,703,6266,77,45,32
2375,7310,1035,3550,703,6275,77,45,32
2380,7331,1036,3561,704,6295,77,45,32
2385,7341,1037,3567,705,6304,77,45,32
2390,7362,1038,3583,706,6324,77,45,32
2395,7372,1039,3590,707,6333,77,45,32
2400,7393,1040,3605,708,6353,77,45,32
2405,7403,1041,3609,709,6362,77,45,32
2410,7424,1042,3621,710,6381,77,45,32
2415,7434,1044,3628,712,6390,77,45,32
2420,7455,1045,3639,713,6409,77,45,32
2425,7465,1047,3644,714,6418,77,45,32
2430,7486,1048,3659,715,6438,77,45,32
2435,7496,1049,3664,716,6447,77,45,32
2440,7517,1050,3671,717,6467,77,45,32
2445,7527,1051,3675,718,6476,77,45,32
2450,7548,1054,3680,720,6494,77,45,32
2455,7558,1056,3681,721,6502,77,45,32
2460,7579,1064,3692,726,6515,77,45,32
2465,7589,1065,3695,726,6524,77,45,32
2470,7610,1070,3707,729,6539,77,45,32
2475,7620,1072,3713,731,6548,77,45,32
2480,7641,1073,3722,732,6568,77,45,32
2485,7651,1075,3727,734,6576,77,45,32
2490,7672,1076,3736,734,6596,77,45,32
2495,7682,1077,3743,735,6605,77,45,32
2500,7703,1079,3760,736,6624,77,45,32
2505,7713,1080,3766,736,6632,77,45,32
2510,7734,1082,3777,737,6652,77,45,32
2515,7744,1084,3781,738,6658,77,45,32
2520,7765,1087,3793,741,6676,77,45,32
2525,7775,1089,3795,743,6685,77,45,32
2530,7796,1092,3802,745,6704,78,45,33
2535,7806,1092,3804,745,6713,78,45,33
2540,7827,1096,3818,749,6731,79,46,33
2545,7837,1096,3822,749,6741,79,46,33
2550,7858,1099,3836,752,6759,80,47,33
2555,7868,1099,3841,752,6769,80,47,33
2560,7889,1101,3849,752,6788,81,47,34
2565,7899,1102,3855,753,6797,81,47,34
2570,7920,1104,3865,754,6816,82,48,34
2575,7930,1105,3870,755,6825,82,48,34
2580,7951,1108,3880,757,6843,83,48,35
2585,7961,1109,3884,758,6852,83,48,35
2590,7982,1110,3895,759,6872,83,48,35
2595,7992,1111,3897,759,6881,83,48,35
2600,8013,1113,3903,761,6900,83,48,35
2605,8023,1114,3908,761,6909,83,48,35
2610,8044,1115,3916,761,6929,83,48,35
2615,8054,1116,3920,762,6938,83,48,35
2620,8075,1117,3930,762,6958,83,48,35
2625,8085,1118,3934,762,6967,83,48,35
2630,8106,1120,3944,763,6986,83,48,35
2635,8116,1121,3951,764,6995,83,48,35
2640,8137,1124,3962,766,7013,83,48,35
2645,8147,1125,3967,766,7022,83,48,35
2650,8168,1127,3980,768,7041,83,48,35
2655,8178,1128,3986,769,7050,83,48,35
2660,8199,1130,3994,771,7069,83,48,35
2665,8209,1131,4001,771,7078,83,48,35
2670,8230,1133,4009,772,7097,83,48,35
2675,8240,1134,4013,773,7106,83,48,35
2680,8261,1136,4021,773,7125,83,48,35
2685,8271,1137,4024,773,7134,83,48,35
2690,8292,1140,4034,774,7151,84,48,36
2695,8302,1145,4041,779,7155,84,48,36
2700,8323,1150,4052,782,7169,85,49,36
2705,8333,1154,4055,786,7179,85,49,36
2710,8354,1157,4064,787,7197,85,49,36
2715,8364,1157,4069,787,7207,85,49,36
2720,8385,1160,4079,789,7225,85,49,36
2725,8395,1160,4085,789,7235,85,49,36
2730,8416,1161,4093,789,7255,85,49,36
2735,8426,1161,4100,789,7265,85,49,36
2740,8447,1162,4111,789,7285,85,49,36
2745,8457,1162,4117,789,7295,85,49,36
2750,8478,1163,4123,790,7315,85,49,36
2755,8488,1163,4131,790,7325,85,49,36
2760,8509,1164,4142,790,7345,85,49,36
2765,8519,1166,4147,792,7353,85,49,36
2770,8540,1169,4158,795,7371,85,49,36
2775,8550,1170,4161,796,7380,85,49,36
2780,8571,1173,4175,799,7398,85,49,36
2785,8581,1174,4180,800,7407,85,49,36
2790,8602,1177,4193,803,7425,85,49,36
2795,8612,1178,4199,803,7434,85,49,36
2800,8633,1179,4211,804,7454,85,49,36
2805,8643,1179,4216,804,7464,85,49,36
2810,8664,1181,4226,806,7481,85,49,36
2815,8674,1183,4231,808,7487,85,49,36
2820,8695,1189,4242,813,7500,85,49,36
2825,8705,1191,4247,815,7514,85,49,36
2830,8726,1193,4252,817,7533,85,49,36
2835,8736,1193,4256,817,7543,85,49,36
2840,8757,1195,4265,818,7561,85,49,36
2845,8767,1198,4269,821,7569,85,49,36
2850,8788,1200,4282,821,7588,85,49,36
2855,8798,1200,4287,821,7598,85,49,36
2860,8819,1202,4298,822,7617,85,49,36
2865,8829,1202,4302,822,7627,85,49,36
2870,8850,1204,4310,824,7646,85,49,36
2875,8860,1205,4313,825,7655,85,49,36
2880,8881,1207,4321,825,7674,85,49,36
2885,8891,1207,4326,825,7684,85,49,36
2890,8912,1207,4335,825,7705,85,49,36
2895,8922,1207,4343,825,7715,85,49,36
2900,8943,1207,4353,825,7736,85,49,36
2905,8953,1207,4357,825,7746,85,49,36
2910,8974,1207,4364,825,7767,85,49,36
2915,8984,1207,4368,825,7777,85,49,36
2920,9005,1207,4377,825,7798,85,49,36
2925,9015,1207,4379,825,7808,85,49,36
2930,9036,1208,4390,826,7828,85,49,36
2935,9046,1210,4398,828,7836,85,49,36
2940,9067,1210,4410,828,7857,85,49,36
2945,9077,1211,4415,828,7866,85,49,36
2950,9098,1213,4429,830,7884,85,49,36
2955,9108,1215,4436,832,7893,85,49,36
2960,9129,1215,4449,832,7914,85,49,36
2965,9139,1215,4453,832,7924,85,49,36
2970,9160,1215,4462,832,7945,85,49,36
2975,9170,1215,4465,832,7955,85,49,36
2980,9191,1215,4476,832,7976,85,49,36
2985,9201,1215,4481,832,7986,85,49,36
2990,9222,1218,4491,832,8004,85,49,36
2995,9232,1219,4497,833,8013,85,49,36
3000,9253,1222,4510,834,8031,85,49,36
3005,9263,1223,4516,835,8040,85,49,36
3010,9284,1227,4524,836,8057,85,49,36
3015,9294,1227,4526,836,8067,85,49,36
3020,9315,1230,4536,837,8085,85,49,36
3025,9325,1230,4542,837,8095,85,49,36
3030,9346,1233,4550,837,8113,85,49,36
3035,9356,1233,4553,837,8123,85,49,36
3040,9377,1237,4562,839,8140,85,49,36
3045,9387,1238,4568,840,8149,85,49,36
3050,9408,1242,4577,843,8166,85,49,36
3055,9418,1243,4581,844,8175,85,49,36
3060,9439,1246,4595,846,8193,85,49,36
3065,9449,1246,4601,846,8203,85,49,36
3070,9470,1249,4615,848,8221,85,49,36
3075,9480,1249,4621,848,8231,85,49,36
3080,9501,1252,4634,851,8249,85,49,36
3085,9511,1252,4637,851,8259,85,49,36
3090,9532,1254,4652,853,8278,85,49,36
3095,9542,1254,4655,853,8288,85,49,36
3100,9563,1256,4665,854,8307,85,49,36
3105,9573,1256,4670,854,8316,85,49,36
3110,9594,1262,4684,859,8332,85,49,36
3115,9604,1264,4690,861,8340,85,49,36
3120,9625,1268,4702,865,8356,85,49,36
3125,9635,1270,4708,867,8365,85,49,36
3130,9656,1274,4720,870,8381,85,49,36
3135,9666,1275,4726,871,8391,85,49,36
3140,9687,1277,4735,872,8410,85,49,36
3145,9697,1277,4740,872,8420,85,49,36
3150,9718,1278,4751,873,8440,85,49,36
3155,9728,1279,4754,874,8449,85,49,36
3160,9749,1280,4768,875,8469,85,49,36
3165,9759,1281,4772,876,8478,85,49,36
3170,9780,1282,4783,877,8498,85,49,36
3175,9790,1283,4787,878,8507,85,49,36
3180,9811,1284,4795,879,8527,85,49,36
3185,9821,1285,4797,880,8536,85,49,36
3190,9842,1287,4808,882,8555,85,49,36
3195,9852,1289,4812,883,8563,85,49,36
3200,9873,1290,4824,884,8583,85,49,36
3205,9883,1291,4830,884,8592,85,49,36
3210,9904,1291,4843,884,8613,85,49,36
3215,9914,1292,4848,884,8622,85,49,36
3220,9935,1293,4858,885,8642,85,49,36
3225,9945,1295,4863,886,8650,85,49,36
3230,9966,1299,4871,889,8667,85,49,36
3235,9976,1299,4874,889,8677,85,49,36
3240,9997,1303,4879,891,8694,85,49,36
3245,10007,1303,4883,891,8703,85,49,36
3250,10028,1309,4895,896,8719,85,49,36
3255,10038,1309,4900,896,8729,85,49,36
3260,10059,1313,4908,898,8746,85,49,36
3265,10069,1313,4915,898,8756,85,49,36
3270,10090,1318,4926,901,8772,85,49,36
3275,10100,1318,4928,901,8781,85,49,36
3280,10121,1324,4939,905,8797,85,49,36
3285,10131,1324,4947,905,8806,85,49,36
3290,10152,1329,4957,908,8822,86,49,37
3295,10162,1330,4961,909,8831,86,49,37
3300,10183,1335,4971,913,8848,87,50,37
3305,10193,1335,4976,913,8858,87,50,37
3310,10214,1335,4985,913,8879,88,51,37
3315,10224,1335,4989,913,8889,88,51,37
3320,10245,1335,5000,913,8910,88,51,37
3325,10255,1335,5006,913,8920,88,51,37
3330,10276,1335,5012,913,8941,88,51,37
3335,10286,1336,5016,913,8950,88,51,37
3340,10307,1336,5025,913,8971,88,51,37
3345,10317,1337,5033,913,8980,88,51,37
3350,10338,1337,5044,913,9001,88,51,37
3355,10348,1338,5052,914,9010,88,51,37
3360,10369,1338,5060,914,9031,88,51,37
3365,10379,1340,5068,916,9039,88,51,37
3370,10400,1344,5085,919,9056,89,52,37
3375,10410,1346,5089,920,9064,89,52,37
3380,10431,1350,5102,923,9081,90,53,37
3385,10441,1351,5105,924,9090,90,53,37
3390,10462,1353,5113,924,9108,91,54,37
3395,10472,1355,5116,925,9117,91,54,37
3400,10493,1358,5126,927,9135,92,54,38
3405,10503,1359,5130,928,9144,92,54,38
3410,10524,1363,5140,931,9160,93,55,38
3415,10534,1365,5146,933,9168,93,55,38
3420,10555,1370,5160,937,9182,93,55,38
3425,10565,1373,5167,940,9192,93,55,38
3430,10586,1374,5175,940,9212,93,55,38
3435,10596,1374,5177,940,9222,93,55,38
3440,10617,1375,5188,940,9242,93,55,38
3445,10627,1375,5195,940,9252,93,55,38
3450,10648,1376,5204,941,9272,93,55,38
3455,10658,1376,5206,941,9282,93,55,38
3460,10679,1377,5218,942,9302,93,55,38
3465,10689,1377,5223,942,9312,93,55,38
3470,10710,1378,5234,942,9332,93,55,38
3475,10720,1378,5236,942,9342,93,55,38
3480,10741,1379,5249,943,9362,93,55,38
3485,10751,1380,5254,944,9371,93,55,38
3490,10772,1383,5263,945,9389,93,55,38
3495,10782,1383,5268,945,9399,93,55,38
3500,10803,1385,5282,947,9418,93,55,38
3505,10813,1385,5288,947,9428,93,55,38
3510,10834,1387,5299,949,9447,93,55,38
3515,10844,1387,5303,949,9457,93,55,38
3520,10865,1389,5310,949,9476,93,55,38
3525,10875,1391,5316,950,9484,93,55,38
3530,10896,1393,5328,952,9502,94,56,38
3535,10906,1396,5334,955,9510,94,56,38
3540,10927,1399,5346,956,9527,95,57,38
3545,10937,1401,5351,957,9536,95,57,38
3550,10958,1403,5366,958,9555,95,57,38
3555,10968,1404,5370,959,9564,95,57,38
3560,10989,1406,5381,960,9583,95,57,38
3565,10999,1407,5388,961,9592,95,57,38
3570,11020,1410,5400,964,9610,95,57,38
3575,11030,1411,5406,964,9619,95,57,38
3580,11051,1413,5415,965,9638,95,57,38
3585,11061,1414,5419,965,9647,95,57,38
3590,11082,1417,5429,966,9664,95,57,38
3595,11092,1419,5433,968,9672,95,57,38
3600,11113,1424,5444,972,9689,95,57,38
3605,11123,1425,5449,973,9698,95,57,38
3610,11144,1427,5461,974,9716,95,57,38
3615,11154,1429,5466,976,9725,95,57,38
3620,11175,1431,5474,976,9744,95,57,38
3625,11185,1432,5477,976,9753,95,57,38
3630,11206,1434,5489,978,9772,95,57,38
3635,11216,1436,5494,980,9780,95,57,38
3640,11237,1438,5509,982,9798,95,57,38
3645,11247,1441,5514,984,9805,95,57,38
3650,11268,1444,5528,986,9822,95,57,38
3655,11278,1449,5533,990,9828,95,57,38
3660,11299,1451,5541,991,9846,95,57,38
3665,11309,1452,5545,992,9857,95,57,38
3670,11330,1453,5556,993,9877,95,57,38
3675,11340,1454,5561,994,9886,95,57,38
3680,11361,1455,5567,995,9906,95,57,38
3685,11371,1455,5572,995,9916,95,57,38
3690,11392,1456,5580,995,9936,95,57,38
3695,11402,1457,5585,996,9945,95,57,38
3700,11423,1458,5593,996,9965,95,57,38
3705,11433,1458,5596,996,9975,95,57,38
3710,11454,1461,5607,998,9993,95,57,38
3715,11464,1461,5612,998,10002,95,57,38
3720,11485,1464,5623,1000,10021,95,57,38
3725,11495,1464,5629,1000,10031,95,57,38
3730,11516,1467,5636,1001,10049,96,57,39
3735,11526,1467,5640,1001,10059,96,57,39
3740,11547,1469,5644,1001,10078,97,57,40
3745,11557,1469,5649,1001,10088,97,57,40
3750,11578,1473,5655,1003,10105,98,57,41
3755,11588,1473,5658,1003,10115,98,57,41
3760,11609,1476,5667,1005,10133,99,57,42
3765,11619,1477,5673,1006,10142,99,57,42
3770,11640,1480,5683,1008,10159,100,58,42
3775,11650,1480,5687,1008,10170,100,58,42
3780,11671,1483,5696,1009,10183,100,58,42
3785,11681,1490,5701,1015,10191,100,58,42
3790,11702,1493,5707,1018,10209,100,58,42
3795,11712,1494,5714,1018,10218,100,58,42
3800,11733,1497,5724,1020,10236,100,58,42
3805,11743,1499,5731,1022,10244,100,58,42
3810,11764,1502,5743,1023,10262,100,58,42
3815,11774,1504,5748,1024,10270,100,58,42
3820,11795,1508,5755,1026,10287,100,58,42
3825,11805,1510,5759,1028,10295,100,58,42
3830,11826,1513,5767,1029,10313,100,58,42
3835,11836,1515,5775,1031,10321,100,58,42
3840,11857,1517,5783,1032,10340,100,58,42
3845,11867,1518,5791,1033,10348,100,58,42
3850,11888,1519,5802,1034,10367,100,58,42
3855,11898,1522,5808,1036,10374,100,58,42
3860,11919,1525,5822,1039,10394,100,58,42
3865,11929,1525,5828,1039,10404,100,58,42
3870,11950,1525,5836,1039,10425,100,58,42
3875,11960,1525,5841,1039,10435,100,58,42
3880,11981,1525,5850,1039,10456,100,58,42
3885,11991,1525,5857,1039,10466,100,58,42
3890,12012,1525,5866,1039,10487,101,58,43
3895,12022,1525,5870,1039,10497,101,58,43
3900,12043,1525,5882,1039,10518,102,59,43
3905,12053,1526,5886,1040,10527,102,59,43
3910,12074,1526,5898,1040,10548,103,59,44
3915,12084,1528,5904,1041,10556,103,59,44
3920,12105,1528,5916,1041,10577,104,60,44
3925,12115,1529,5919,1042,10586,104,60,44
3930,12136,1529,5935,1042,10606,105,61,44
3935,12146,1531,5939,1043,10615,105,61,44
3940,12167,1531,5948,1043,10634,106,61,45
3945,12177,1534,5953,1046,10643,106,61,45
3950,12198,1537,5960,1048,10660,107,62,45
3955,12208,1541,5966,1051,10666,107,62,45
3960,12229,1548,5977,1056,10680,108,63,45
3965,12239,1550,5982,1058,10688,108,63,45
3970,12260,1554,5992,1062,10706,108,63,45
3975,12270,1554,5992,1062,10716,108,63,45
3980,12291,1557,6001,1063,10733,108,63,45
3985,12301,1558,6003,1064,10743,108,63,45
3990,12322,1561,6010,1065,10761,108,63,45
3995,12332,1561,6015,1065,10771,108,63,45
4000,12353,1564,6024,1066,10789,108,63,45
4005,12363,1564,6025,1066,10799,108,63,45
4010,12384,1567,6032,1067,10817,108,63,45
4015,12394,1567,6034,1067,10826,108,63,45
4020,12415,1571,6041,1069,10844,108,63,45
4025,12425,1572,6045,1070,10853,108,63,45
4030,12446,1575,6054,1071,10869,108,63,45
4035,12456,1577,6061,1073,10879,108,63,45
4040,12477,1580,6066,1074,10897,108,63,45
4045,12487,1580,6073,1074,10907,108,63,45
4050,12508,1583,6083,1074,10925,108,63,45
4055,12518,1583,6084,1074,10935,108,63,45
4060,12539,1586,6095,1076,10953,108,63,45
4065,12549,1588,6101,1077,10961,108,63,45
4070,12570,1594,6108,1081,10976,109,64,45
4075,12580,1597,6113,1083,10981,109,64,45
4080,12601,1604,6124,1089,10995,109,64,45
4085,12611,1606,6130,1091,11005,109,64,45
4090,12632,1607,6142,1092,11025,109,64,45
4095,12642,1608,6147,1093,11034,109,64,45
4100,12663,1608,6154,1093,11055,109,64,45
4105,12673,1609,6160,1094,11064,109,64,45
4110,12694,1609,6170,1094,11085,109,64,45
4115,12704,1610,6175,1095,11094,109,64,45
4120,12725,1611,6180,1096,11114,109,64,45
4125,12735,1612,6186,1097,11123,109,64,45
4130,12756,1612,6190,1097,11144,109,64,45
4135,12766,1613,6195,1097,11153,109,64,45
4140,12787,1613,6205,1097,11174,109,64,45
4145,12797,1615,6210,1098,11181,109,64,45
4150,12818,1618,6220,1101,11200,109,64,45
4155,12828,1619,6227,1102,11209,109,64,45
4160,12849,1620,6238,1103,11229,109,64,45
4165,12859,1622,6243,1105,11237,109,64,45
4170,12880,1625,6256,1107,11255,109,64,45
4175,12890,1626,6260,1108,11264,109,64,45
4180,12911,1629,6270,1111,11282,110,64,46
4185,12921,1631,6274,1113,11289,110,64,46
4190,12942,1637,6282,1118,11305,111,65,46
4195,12952,1640,6287,1121,11311,111,65,46
4200,12973,1648,6300,1129,11323,112,66,46
4205,12983,1650,6308,1131,11333,112,66,46
4210,13004,1651,6321,1131,11353,113,67,46
4215,13014,1651,6326,1131,11363,113,67,46
4220,13035,1652,6338,1131,11383,113,67,46
4225,13045,1652,6344,1131,11393,113,67,46
4230,13066,1653,6358,1131,11413,113,67,46
4235,13076,1653,6361,1131,11423,113,67,46
4240,13097,1654,6368,1131,11443,113,67,46
4245,13107,1654,6371,1131,11453,113,67,46
4250,13128,1655,6382,1132,11473,113,67,46
4255,13138,1655,6386,1132,11483,113,67,46
4260,13159,1656,6393,1132,11503,113,67,46
4265,13169,1658,6398,1134,11511,113,67,46
4270,13190,1663,6410,1137,11527,113,67,46
4275,13200,1665,6415,1139,11534,113,67,46
4280,13221,1671,6422,1143,11550,113,67,46
4285,13231,1673,6428,1145,11557,113,67,46
4290,13252,1677,6439,1149,11575,113,67,46
4295,13262,1679,6444,1150,11582,113,67,46
4300,13283,1680,6448,1151,11603,113,67,46
4305,13293,1682,6453,1153,11611,113,67,46
4310,13314,1685,6464,1155,11629,113,67,46
4315,13324,1687,6469,1157,11637,113,67,46
4320,13345,1689,6486,1159,11654,113,67,46
4325,13355,1691,6490,1161,11664,113,67,46
4330,13376,1692,6501,1161,11684,113,67,46
4335,13386,1692,6504,1161,11694,113,67,46
4340,13407,1694,6516,1162,11713,113,67,46
4345,13417,1694,6524,1162,11723,113,67,46
4350,13438,1695,6536,1163,11743,113,67,46
4355,13448,1695,6539,1163,11753,113,67,46
4360,13469,1697,6549,1164,11772,113,67,46
4365,13479,1697,6555,1164,11782,113,67,46
4370,13500,1699,6563,1165,11801,113,67,46
4375,13510,1699,6568,1165,11811,113,67,46
4380,13531,1701,6581,1167,11830,113,67,46
4385,13541,1701,6589,1167,11840,113,67,46
4390,13562,1703,6598,1168,11859,113,67,46
4395,13572,1703,6604,1168,11868,113,67,46
4400,13593,1707,6616,1171,11886,113,67,46
4405,13603,1707,6622,1171,11895,113,67,46
4410,13624,1711,6628,1172,11913,113,67,46
4415,13634,1711,6634,1172,11923,113,67,46
4420,13655,1715,6642,1174,11940,113,67,46
4425,13665,1715,6647,1174,11950,113,67,46
4430,13686,1720,6657,1176,11966,113,67,46
4435,13696,1721,6662,1177,11974,113,67,46
4440,13717,1725,6669,1180,11992,113,67,46
4445,13727,1726,6673,1180,12001,113,67,46
4450,13748,1730,6682,1182,12017,113,67,46
4455,13758,1732,6684,1183,12026,113,67,46
4460,13779,1735,6692,1184,12043,113,67,46
4465,13789,1737,6699,1186,12052,113,67,46
4470,13810,1739,6709,1186,12071,113,67,46
4475,13820,1740,6716,1187,12080,113,67,46
4480,13841,1743,6727,1190,12097,113,67,46
4485,13851,1745,6729,1191,12106,113,67,46
4490,13872,1747,6736,1191,12125,113,67,46
4495,13882,1748,6740,1191,12134,113,67,46
4500,13903,1750,6746,1191,12152,114,67,47
4505,13913,1752,6751,1193,12161,114,67,47
4510,13934,1754,6757,1195,12180,114,67,47
4515,13944,1755,6763,1196,12189,114,67,47
4520,13965,1757,6771,1197,12208,114,67,47
4525,13975,1758,6775,1198,12217,114,67,47
4530,13996,1760,6786,1199,12236,114,67,47
4535,14006,1761,6790,1199,12245,114,67,47
4540,14027,1763,6799,1200,12264,114,67,47
4545,14037,1764,6801,1200,12273,114,67,47
4550,14058,1767,6809,1202,12291,114,67,47
4555,14068,1771,6816,1206,12295,114,67,47
4560,14089,1777,6828,1210,12304,114,67,47
4565,14099,1782,6834,1215,12317,114,67,47
4570,14120,1783,6842,1215,12337,114,67,47
4575,14130,1783,6846,1215,12347,114,67,47
4580,14151,1784,6856,1215,12367,114,67,47
4585,14161,1784,6859,1215,12377,114,67,47
4590,14182,1785,6868,1216,12397,114,67,47
4595,14192,1785,6870,1216,12407,114,67,47
4600,14213,1786,6878,1217,12427,114,67,47
4605,14223,1786,6884,1217,12437,114,67,47
4610,14244,1787,6895,1217,12457,114,67,47
4615,14254,1787,6899,1217,12467,114,67,47
4620,14275,1788,6914,1218,12487,114,67,47
4625,14285,1788,6921,1218,12497,114,67,47
4630,14306,1791,6929,1219,12515,114,67,47
4635,14316,1791,6933,1219,12525,114,67,47
4640,14337,1794,6946,1222,12543,114,67,47
4645,14347,1794,6951,1222,12553,114,67,47
4650,14368,1796,6956,1223,12572,114,67,47
4655,14378,1796,6959,1223,12582,114,67,47
4660,14399,1799,6971,1226,12600,114,67,47
4665,14409,1799,6976,1226,12610,114,67,47
4670,14430,1803,6984,1228,12625,114,67,47
4675,14440,1809,6989,1233,12630,114,67,47
4680,14461,1814,7001,1236,12642,114,67,47
4685,14471,1817,7007,1239,12654,114,67,47
4690,14492,1818,7015,1240,12674,115,67,48
4695,14502,1818,7019,1240,12684,115,67,48
4700,14523,1819,7028,1241,12704,116,68,48
4705,14533,1819,7032,1241,12714,116,68,48
4710,14554,1820,7044,1242,12734,117,69,48
4715,14564,1820,7049,1242,12744,117,69,48
4720,14585,1821,7062,1243,12764,118,70,48
4725,14595,1821,7070,1243,12774,118,70,48
4730,14616,1822,7079,1243,12794,118,70,48
4735,14626,1822,7081,1243,12804,118,70,48
4740,14647,1823,7090,1243,12824,118,70,48
4745,14657,1823,7095,1243,12834,118,70,48
4750,14678,1824,7103,1243,12854,118,70,48
4755,14688,1824,7108,1243,12864,118,70,48
4760,14709,1825,7118,1244,12884,118,70,48
4765,14719,1825,7121,1244,12894,118,70,48
4770,14740,1826,7133,1244,12914,118,70,48
4775,14750,1826,7137,1244,12924,118,70,48
4780,14771,1827,7150,1244,12944,118,70,48
4785,14781,1827,7158,1244,12953,118,70,48
4790,14802,1833,7169,1248,12965,118,70,48
4795,14812,1841,7173,1256,12971,118,70,48
4800,14833,1849,7184,1263,12981,118,70,48
4805,14843,1851,7186,1264,12992,118,70,48
4810,14864,1852,7197,1265,13012,118,70,48
4815,14874,1853,7201,1266,13021,118,70,48
4820,14895,1853,7209,1266,13042,118,70,48
4825,14905,1854,7214,1266,13051,118,70,48
4830,14926,1854,7220,1266,13072,118,70,48
4835,14936,1855,7226,1267,13081,118,70,48
4840,14957,1855,7236,1267,13102,118,70,48
4845,14967,1856,7241,1268,13111,118,70,48
4850,14988,1856,7253,1268,13132,118,70,48
4855,14998,1857,7255,1268,13141,118,70,48
4860,15019,1857,7263,1268,13162,118,70,48
4865,15029,1858,7268,1269,13171,118,70,48
4870,15050,1858,7280,1269,13192,118,70,48
4875,15060,1859,7285,1270,13201,118,70,48
4880,15081,1859,7297,1270,13222,118,70,48
4885,15091,1860,7301,1270,13231,118,70,48
4890,15112,1860,7313,1270,13252,118,70,48
4895,15122,1861,7317,1271,13261,118,70,48
4900,15143,1861,7330,1271,13282,118,70,48
4905,15153,1863,7337,1273,13290,118,70,48
4910,15174,1867,7349,1275,13302,119,71,48
4915,15184,1874,7352,1281,13308,119,71,48
4920,15205,1880,7356,1285,13324,120,72,48
4925,15215,1882,7363,1287,13333,120,72,48
4930,15236,1884,7373,1288,13352,120,72,48
4935,15246,1884,7375,1288,13362,120,72,48
4940,15267,1886,7386,1290,13381,120,72,48
4945,15277,1886,7390,1290,13391,120,72,48
4950,15298,1888,7395,1291,13410,120,72,48
4955,15308,1888,7400,1291,13420,120,72,48
4960,15329,1890,7413,1292,13439,120,72,48
4965,15339,1890,7417,1292,13449,120,72,48
4970,15360,1892,7430,1292,13468,120,72,48
4975,15370,1893,7437,1293,13477,120,72,48
4980,15391,1895,7448,1293,13496,120,72,48
4985,15401,1895,7451,1293,13506,120,72,48
4990,15422,1897,7458,1294,13525,120,72,48
4995,15432,1898,7463,1295,13534,120,72,48
5000,15453,1900,7473,1295,13553,120,72,48
5005,15463,1900,7476,1295,13563,120,72,48
5010,15484,1902,7488,1296,13582,120,72,48
5015,15494,1902,7494,1296,13592,120,72,48
5020,15515,1904,7504,1296,13611,120,72,48
5025,15525,1905,7509,1297,13619,120,72,48
5030,15546,1910,7520,1300,13631,121,72,49
5035,15556,1917,7525,1306,13637,121,72,49
5040,15577,1925,7536,1312,13647,122,73,49
5045,15587,1929,7542,1315,13658,122,73,49
5050,15608,1929,7554,1315,13679,122,73,49
5055,15618,1930,7560,1316,13688,122,73,49
5060,15639,1930,7576,1316,13709,122,73,49
5065,15649,1931,7581,1316,13718,122,73,49
5070,15670,1931,7593,1316,13739,122,73,49
5075,15680,1932,7601,1317,13748,122,73,49
5080,15701,1932,7610,1317,13769,122,73,49
5085,15711,1933,7614,1317,13778,122,73,49
5090,15732,1933,7626,1317,13799,122,73,49
5095,15742,1934,7631,1318,13808,122,73,49
5100,15763,1934,7642,1318,13829,122,73,49
5105,15773,1935,7646,1318,13838,122,73,49
5110,15794,1937,7658,1320,13857,122,73,49
5115,15804,1938,7661,1321,13866,122,73,49
5120,15825,1941,7672,1323,13884,122,73,49
5125,15835,1942,7678,1323,13893,122,73,49
5130,15856,1945,7689,1325,13911,122,73,49
5135,15866,1946,7694,1326,13920,122,73,49
5140,15887,1949,7705,1329,13938,122,73,49
5145,15897,1950,7708,1329,13947,122,73,49
5150,15918,1955,7717,1332,13963,122,73,49
5155,15928,1957,7720,1333,13971,122,73,49
5160,15949,1961,7729,1334,13983,123,73,50
5165,15959,1966,7733,1338,13992,123,73,50
5170,15980,1969,7746,1341,14010,123,73,50
5175,15990,1971,7755,1343,14018,123,73,50
5180,16011,1974,7766,1346,14036,123,73,50
5185,16021,1976,7772,1348,14044,123,73,50
5190,16042,1979,7783,1350,14063,123,73,50
5195,16052,1980,7791,1351,14071,123,73,50
5200,16073,1983,7799,1352,14090,123,73,50
5205,16083,1984,7804,1353,14098,123,73,50
5210,16104,1988,7818,1356,14115,123,73,50
5215,16114,1990,7824,1358,14123,123,73,50
5220,16135,1994,7838,1361,14140,123,73,50
5225,16145,1996,7844,1363,14149,123,73,50
5230,16166,1999,7857,1366,14167,123,73,50
5235,16176,1999,7860,1366,14177,123,73,50
5240,16197,2001,7866,1367,14196,123,73,50
5245,16207,2001,7871,1367,14206,123,73,50
5250,16228,2002,7884,1368,14226,123,73,50
5255,16238,2002,7887,1368,14236,123,73,50
5260,16259,2004,7898,1370,14255,123,73,50
5265,16269,2005,7902,1371,14264,123,73,50
5270,16290,2007,7912,1372,14283,124,73,51
5275,16300,2007,7918,1372,14293,124,73,51
5280,16321,2008,7930,1373,14312,125,74,51
5285,16331,2010,7935,1375,14321,125,74,51
5290,16352,2012,7944,1377,14338,125,74,51
5295,16362,2015,7948,1379,14347,125,74,51
5300,16383,2017,7958,1381,14366,125,74,51
5305,16393,2017,7964,1381,14376,125,74,51
5310,16414,2018,7977,1382,14396,125,74,51
5315,16424,2018,7981,1382,14406,125,74,51
5320,16445,2019,7989,1383,14426,125,74,51
5325,16455,2019,7996,1383,14436,125,74,51
5330,16476,2021,8007,1384,14455,125,74,51
5335,16486,2021,8012,1384,14465,125,74,51
5340,16507,2023,8018,1385,14484,125,74,51
5345,16517,2025,8023,1386,14492,125,74,51
5350,16538,2028,8032,1388,14510,125,74,51
5355,16548,2029,8038,1388,14519,125,74,51
5360,16569,2034,8047,1391,14535,125,74,51
5365,16579,2036,8053,1393,14543,125,74,51
5370,16600,2040,8059,1396,14560,125,74,51
5375,16610,2042,8065,1397,14568,125,74,51
5380,16631,2046,8075,1401,14585,125,74,51
5385,16641,2047,8079,1402,14594,125,74,51
5390,16662,2051,8090,1405,14609,125,74,51
5395,16672,2054,8092,1407,14618,125,74,51
5400,16693,2059,8105,1412,14633,125,74,51
5405,16703,2059,8107,1412,14644,125,74,51
5410,16724,2061,8114,1413,14663,125,74,51
5415,16734,2061,8117,1413,14673,125,74,51
5420,16755,2064,8125,1414,14690,125,74,51
5425,16765,2065,8130,1415,14700,125,74,51
5430,16786,2067,8139,1416,14718,125,74,51
5435,16796,2068,8142,1417,14728,125,74,51
5440,16817,2072,8153,1421,14744,125,74,51
5445,16827,2073,8160,1422,14754,125,74,51
5450,16848,2076,8169,1424,14772,125,74,51
5455,16858,2076,8174,1424,14782,125,74,51
5460,16879,2081,8183,1428,14796,125,74,51
5465,16889,2082,8188,1429,14807,125,74,51
5470,16910,2086,8199,1432,14823,125,74,51
5475,16920,2088,8206,1434,14832,125,74,51
5480,16941,2092,8215,1437,14849,125,74,51
5485,16951,2092,8218,1437,14859,125,74,51
5490,16972,2093,8228,1437,14879,125,74,51
5495,16982,2093,8234,1437,14889,125,74,51
5500,17003,2094,8243,1438,14909,125,74,51
5505,17013,2094,8250,1438,14919,125,74,51
5510,17034,2095,8258,1439,14939,125,74,51
5515,17044,2096,8263,1439,14948,125,74,51
5520,17065,2097,8275,1440,14968,125,74,51
5525,17075,2099,8282,1441,14976,125,74,51
5530,17096,2102,8293,1442,14993,125,74,51
5535,17106,2104,8299,1444,15002,125,74,51
5540,17127,2107,8310,1445,15020,125,74,51
5545,17137,2107,8313,1445,15030,125,74,51
5550,17158,2109,8321,1447,15049,125,74,51
5555,17168,2109,8329,1447,15059,125,74,51
5560,17189,2112,8343,1450,15077,125,74,51
5565,17199,2112,8348,1450,15087,125,74,51
5570,17220,2115,8356,1451,15105,125,74,51
5575,17230,2115,8360,1451,15115,125,74,51
5580,17251,2117,8368,1452,15134,125,74,51
5585,17261,2118,8371,1453,15143,125,74,51
5590,17282,2119,8380,1453,15163,126,75,51
5595,17292,2119,8383,1453,15172,126,75,51
5600,17313,2121,8393,1454,15192,127,75,52
5605,17323,2122,8401,1455,15201,127,75,52
5610,17344,2123,8411,1455,15221,128,75,53
5615,17354,2123,8416,1455,15231,128,75,53
5620,17375,2124,8421,1456,15251,129,75,54
5625,17385,2124,8424,1456,15261,129,75,54
5630,17406,2125,8432,1457,15281,130,76,54
5635,17416,2126,8437,1458,15289,130,76,54
5640,17437,2128,8447,1459,15308,131,77,54
5645,17447,2131,8453,1462,15316,131,77,54
5650,17468,2133,8461,1464,15335,131,77,54
5655,17478,2134,8465,1464,15344,131,77,54
5660,17499,2135,8476,1465,15364,131,77,54
5665,17509,2136,8482,1466,15373,131,77,54
5670,17530,2137,8490,1466,15393,131,77,54
5675,17540,2138,8497,1467,15402,131,77,54
5680,17561,2140,8505,1468,15421,131,77,54
5685,17571,2142,8512,1470,15429,131,77,54
5690,17592,2144,8523,1472,15446,131,77,54
5695,17602,2148,8528,1476,15453,131,77,54
5700,17623,2152,8538,1480,15470,131,77,54
5705,17633,2152,8541,1480,15481,131,77,54
5710,17654,2153,8556,1481,15501,131,77,54
5715,17664,2153,8561,1481,15511,131,77,54
5720,17685,2154,8571,1482,15531,131,77,54
5725,17695,2154,8571,1482,15541,131,77,54
5730,17716,2155,8583,1482,15561,131,77,54
5735,17726,2155,8588,1482,15571,131,77,54
5740,17747,2156,8597,1482,15591,131,77,54
5745,17757,2156,8602,1482,15601,131,77,54
5750,17778,2160,8610,1483,15618,132,77,55
5755,17788,2160,8615,1483,15626,132,77,55
5760,17809,2165,8623,1486,15644,133,78,55
5765,17819,2167,8629,1487,15652,133,78,55
5770,17840,2171,8637,1489,15668,133,78,55
5775,17850,2173,8644,1491,15677,133,78,55
5780,17871,2175,8654,1492,15696,133,78,55
5785,17881,2175,8660,1492,15706,133,78,55
5790,17902,2179,8673,1495,15723,133,78,55
5795,17912,2179,8678,1495,15733,133,78,55
5800,17933,2183,8687,1498,15750,133,78,55
5805,17943,2183,8692,1498,15760,133,78,55
5810,17964,2186,8704,1499,15778,133,78,55
5815,17974,2186,8711,1499,15788,133,78,55
5820,17995,2189,8723,1500,15805,133,78,55
5825,18005,2190,8727,1501,15815,133,78,55
5830,18026,2193,8742,1503,15833,134,78,56
5835,18036,2194,8747,1504,15842,134,78,56
5840,18057,2197,8759,1505,15860,134,78,56
5845,18067,2197,8765,1505,15870,134,78,56
5850,18088,2200,8774,1508,15888,134,78,56
5855,18098,2200,8776,1508,15898,134,78,56
5860,18119,2203,8785,1509,15916,134,78,56
5865,18129,2204,8792,1510,15924,134,78,56
5870,18150,2208,8801,1512,15941,134,78,56
5875,18160,2209,8808,1513,15950,134,78,56
5880,18181,2210,8814,1513,15969,134,78,56
5885,18191,2211,8820,1514,15980,134,78,56
5890,18212,2211,8832,1514,16001,135,79,56
5895,18222,2211,8837,1514,16011,135,79,56
5900,18243,2211,8849,1514,16032,136,79,57
5905,18253,2211,8856,1514,16042,136,79,57
5910,18274,2211,8866,1514,16063,137,79,58
5915,18284,2211,8871,1514,16073,137,79,58
5920,18305,2211,8878,1514,16094,138,79,59
5925,18315,2211,8881,1514,16104,138,79,59
5930,18336,2211,8892,1514,16125,139,79,60
5935,18346,2211,8898,1514,16135,139,79,60
5940,18367,2211,8910,1514,16155,140,79,61
5945,18377,2212,8915,1515,16165,140,79,61
5950,18398,2216,8929,1518,16180,140,79,61
5955,18408,2219,8935,1521,16189,140,79,61
5960,18429,2224,8949,1525,16203,140,79,61
5965,18439,2228,8954,1529,16211,140,79,61
5970,18460,2232,8966,1532,16228,140,79,61
5975,18470,2233,8971,1533,16237,140,79,61
5980,18491,2236,8978,1534,16255,140,79,61
5985,18501,2237,8981,1535,16264,140,79,61
5990,18522,2242,8993,1540,16280,140,79,61
5995,18532,2243,8997,1540,16289,140,79,61
6000,18553,2246,9004,1541,16307,140,79,61
6005,18563,2248,9011,1542,16315,140,79,61
6010,18584,2250,9025,1544,16334,140,79,61
6015,18594,2251,9030,1545,16343,140,79,61
6020,18615,2252,9038,1545,16363,140,79,61
6025,18625,2253,9042,1545,16372,140,79,61
6030,18646,2255,9052,1546,16391,140,79,61
6035,18656,2257,9059,1548,16399,140,79,61
6040,18677,2259,9071,1550,16418,140,79,61
6045,18687,2261,9075,1551,16426,140,79,61
6050,18708,2262,9081,1552,16446,141,79,62
6055,18718,2264,9085,1553,16454,141,79,62
6060,18739,2266,9100,1555,16472,142,80,62
6065,18749,2269,9106,1558,16480,142,80,62
6070,18770,2272,9115,1561,16498,143,80,63
6075,18780,2272,9118,1561,16508,143,80,63
6080,18801,2278,9131,1565,16521,144,80,64
6085,18811,2281,9135,1568,16529,144,80,64
6090,18832,2286,9142,1571,16546,145,80,65
6095,18842,2288,9149,1573,16553,145,80,65
6100,18863,2294,9161,1578,16568,146,80,66
6105,18873,2296,9168,1580,16575,146,80,66
6110,18894,2300,9179,1583,16592,147,80,67
6115,18904,2302,9186,1585,16601,147,80,67
6120,18925,2305,9194,1587,16620,148,80,68
6125,18935,2306,9199,1588,16629,148,80,68
6130,18956,2306,9209,1588,16650,148,80,68
6135,18966,2307,9212,1589,16659,148,80,68
6140,18987,2307,9226,1589,16679,148,80,68
6145,18997,2309,9229,1590,16688,148,80,68
6150,19018,2309,9236,1590,16708,148,80,68
6155,19028,2312,9240,1593,16716,148,80,68
6160,19049,2312,9252,1593,16736,148,80,68
6165,19059,2314,9254,1594,16745,148,80,68
6170,19080,2314,9266,1594,16766,148,80,68
6175,19090,2315,9271,1594,16775,148,80,68
6180,19111,2315,9283,1594,16796,148,80,68
6185,19121,2316,9288,1594,16805,148,80,68
6190,19142,2316,9301,1594,16826,148,80,68
6195,19152,2317,9304,1594,16835,148,80,68
6200,19173,2317,9311,1594,16856,148,80,68
6205,19183,2318,9318,1595,16865,148,80,68
6210,19204,2319,9333,1596,16885,148,80,68
6215,19214,2320,9336,1596,16894,148,80,68
6220,19235,2323,9346,1598,16912,148,80,68
6225,19245,2324,9349,1598,16921,148,80,68
6230,19266,2329,9358,1601,16935,148,80,68
6235,19276,2333,9364,1604,16943,148,80,68
6240,19297,2338,9371,1607,16959,148,80,68
6245,19307,2339,9374,1608,16968,148,80,68
6250,19328,2341,9384,1609,16987,148,80,68
6255,19338,2342,9391,1609,16996,148,80,68
6260,19359,2345,9401,1610,17014,148,80,68
6265,19369,2347,9407,1611,17022,148,80,68
6270,19390,2350,9416,1613,17040,148,80,68
6275,19400,2351,9421,1613,17049,148,80,68
6280,19421,2355,9433,1616,17066,148,80,68
6285,19431,2356,9436,1617,17075,148,80,68
6290,19452,2360,9449,1620,17091,148,80,68
6295,19462,2363,9454,1622,17099,148,80,68
6300,19483,2366,9463,1623,17116,149,80,69
6305,19493,2367,9471,1624,17126,149,80,69
6310,19514,2367,9478,1624,17147,150,80,70
6315,19524,2367,9485,1624,17157,150,80,70
6320,19545,2367,9496,1624,17178,151,80,71
6325,19555,2367,9500,1624,17188,151,80,71
6330,19576,2367,9509,1624,17209,151,80,71
6335,19586,2367,9515,1624,17219,151,80,71
6340,19607,2367,9524,1624,17240,151,80,71
6345,19617,2367,9528,1624,17250,151,80,71
6350,19638,2368,9539,1624,17270,151,80,71
6355,19648,2368,9542,1624,17280,151,80,71
6360,19669,2369,9553,1625,17299,151,80,71
6365,19679,2369,9558,1625,17310,151,80,71
6370,19700,2370,9569,1625,17330,151,80,71
6375,19710,2370,9573,1625,17340,151,80,71
6380,19731,2371,9584,1625,17360,151,80,71
6385,19741,2371,9591,1625,17370,151,80,71
6390,19762,2372,9604,1626,17390,151,80,71
6395,19772,2372,9608,1626,17400,151,80,71
6400,19793,2373,9616,1626,17420,151,80,71
6405,19803,2373,9622,1626,17430,151,80,71
6410,19824,2376,9634,1629,17448,151,80,71
6415,19834,2376,9637,1629,17458,151,80,71
6420,19855,2380,9650,1632,17474,151,80,71
6425,19865,2381,9657,1633,17484,151,80,71
6430,19886,2386,9666,1637,17500,151,80,71
6435,19896,2386,9670,1637,17510,151,80,71
6440,19917,2391,9679,1642,17526,151,80,71
6445,19927,2391,9684,1642,17536,151,80,71
6450,19948,2397,9693,1647,17551,151,80,71
6455,19958,2398,9697,1648,17560,151,80,71
6460,19979,2405,9706,1653,17574,151,80,71
6465,19989,2406,9709,1654,17583,151,80,71
6470,20010,2413,9719,1659,17597,151,80,71
6475,20020,2415,9726,1661,17605,151,80,71
6480,20041,2418,9735,1663,17622,151,80,71
6485,20051,2420,9738,1664,17631,151,80,71
6490,20072,2423,9753,1667,17649,151,80,71
6495,20082,2424,9759,1668,17658,151,80,71
6500,20103,2426,9772,1669,17677,151,80,71
6505,20113,2427,9774,1670,17686,151,80,71
6510,20134,2429,9781,1671,17705,151,80,71
6515,20144,2430,9786,1672,17714,151,80,71
6520,20165,2432,9793,1673,17733,151,80,71
6525,20175,2433,9796,1673,17741,151,80,71
6530,20196,2438,9807,1678,17758,151,80,71
6535,20206,2439,9811,1679,17767,151,80,71
6540,20227,2442,9822,1681,17785,152,81,71
6545,20237,2443,9828,1681,17793,152,81,71
6550,20258,2446,9836,1683,17812,153,81,72
6555,20268,2447,9839,1683,17821,153,81,72
6560,20289,2448,9846,1683,17841,154,82,72
6565,20299,2449,9848,1683,17850,154,82,72
6570,20320,2450,9858,1683,17870,155,82,73
6575,20330,2451,9864,1684,17878,155,82,73
6580,20351,2453,9873,1685,17897,156,83,73
6585,20361,2455,9876,1686,17905,156,83,73
6590,20382,2458,9890,1688,17923,157,83,74
6595,20392,2461,9895,1691,17929,157,83,74
6600,20413,2464,9906,1693,17945,158,83,75
6605,20423,2468,9909,1697,17955,158,83,75
6610,20444,2469,9920,1698,17975,159,83,76
6615,20454,2470,9924,1698,17984,159,83,76
6620,20475,2471,9934,1698,18004,159,83,76
6625,20485,2472,9939,1698,18013,159,83,76
6630,20506,2474,9950,1699,18032,159,83,76
6635,20516,2475,9956,1699,18041,159,83,76
6640,20537,2477,9964,1701,18060,159,83,76
6645,20547,2478,9968,1702,18069,159,83,76
6650,20568,2480,9978,1704,18088,159,83,76
6655,20578,2481,9982,1705,18097,159,83,76
6660,20599,2483,9991,1707,18116,159,83,76
6665,20609,2484,10000,1708,18123,159,83,76
6670,20630,2490,10016,1714,18139,159,83,76
6675,20640,2491,10019,1715,18149,159,83,76
6680,20661,2494,10028,1717,18167,159,83,76
6685,20671,2494,10034,1717,18177,159,83,76
6690,20692,2497,10043,1719,18195,159,83,76
6695,20702,2497,10047,1719,18205,159,83,76
6700,20723,2499,10053,1720,18224,159,83,76
6705,20733,2500,10059,1721,18233,159,83,76
6710,20754,2503,10070,1723,18251,159,83,76
6715,20764,2503,10076,1723,18261,159,83,76
6720,20785,2507,10082,1725,18278,160,83,77
6725,20795,2507,10088,1725,18287,160,83,77
6730,20816,2509,10100,1726,18307,160,83,77
6735,20826,2509,10105,1726,18317,160,83,77
6740,20847,2509,10118,1726,18338,160,83,77
6745,20857,2509,10124,1726,18348,160,83,77
6750,20878,2509,10133,1726,18369,160,83,77
6755,20888,2509,10136,1726,18379,160,83,77
6760,20909,2509,10149,1726,18400,160,83,77
6765,20919,2509,10152,1726,18410,160,83,77
6770,20940,2509,10162,1726,18431,160,83,77
6775,20950,2510,10165,1726,18440,160,83,77
6780,20971,2510,10174,1726,18461,160,83,77
6785,20981,2511,10179,1726,18470,160,83,77
6790,21002,2513,10189,1727,18489,160,83,77
6795,21012,2514,10193,1728,18498,160,83,77
6800,21033,2516,10200,1729,18517,160,83,77
6805,21043,2517,10204,1730,18526,160,83,77
6810,21064,2519,10215,1731,18545,160,83,77
6815,21074,2520,10218,1731,18554,160,83,77
6820,21095,2523,10230,1733,18572,160,83,77
6825,21105,2524,10234,1733,18581,160,83,77
6830,21126,2527,10244,1735,18599,161,83,78
6835,21136,2529,10250,1737,18607,161,83,78
6840,21157,2532,10259,1740,18623,162,84,78
6845,21167,2535,10262,1743,18632,162,84,78
6850,21188,2537,10271,1744,18651,162,84,78
6855,21198,2538,10273,1744,18660,162,84,78
6860,21219,2539,10286,1745,18680,162,84,78
6865,21229,2540,10293,1746,18689,162,84,78
6870,21250,2542,10306,1748,18707,162,84,78
6875,21260,2545,10312,1751,18715,162,84,78
6880,21281,2546,10317,1751,18735,162,84,78
6885,21291,2548,10324,1752,18743,162,84,78
6890,21312,2549,10333,1753,18763,162,84,78
6895,21322,2550,10334,1753,18772,162,84,78
6900,21343,2552,10345,1755,18791,162,84,78
6905,21353,2553,10350,1755,18800,162,84,78
6910,21374,2554,10359,1756,18820,162,84,78
6915,21384,2554,10365,1756,18830,162,84,78
6920,21405,2554,10377,1756,18850,162,84,78
6925,21415,2554,10381,1756,18861,162,84,78
6930,21436,2554,10390,1756,18881,162,84,78
6935,21446,2554,10394,1756,18892,162,84,78
6940,21467,2554,10408,1756,18913,162,84,78
6945,21477,2554,10417,1756,18923,162,84,78
6950,21498,2556,10424,1758,18942,162,84,78
6955,21508,2556,10427,1758,18952,162,84,78
6960,21529,2558,10437,1760,18970,162,84,78
6965,21539,2560,10440,1761,18979,162,84,78
6970,21560,2565,10452,1766,18995,162,84,78
6975,21570,2567,10459,1767,19003,162,84,78
6980,21591,2570,10471,1769,19021,162,84,78
6985,21601,2571,10475,1769,19030,162,84,78
6990,21622,2573,10490,1770,19049,162,84,78
6995,21632,2574,10494,1770,19058,162,84,78
7000,21653,2576,10505,1770,19077,162,84,78
7005,21663,2577,10511,1771,19086,162,84,78
7010,21684,2580,10520,1773,19104,162,84,78
7015,21694,2582,10527,1775,19112,162,84,78
7020,21715,2587,10536,1778,19128,163,85,78
7025,21725,2588,10541,1779,19137,163,85,78
7030,21746,2591,10550,1782,19154,163,85,78
7035,21756,2593,10553,1783,19163,163,85,78
7040,21777,2595,10565,1785,19182,163,85,78
7045,21787,2596,10569,1785,19191,163,85,78
7050,21808,2597,10575,1785,19211,163,85,78
7055,21818,2598,10579,1785,19220,163,85,78
7060,21839,2600,10593,1786,19237,163,85,78
7065,21849,2602,10600,1788,19247,163,85,78
7070,21870,2604,10611,1789,19265,163,85,78
7075,21880,2606,10615,1790,19274,163,85,78
7080,21901,2607,10628,1790,19292,163,85,78
7085,21911,2610,10631,1793,19301,163,85,78
7090,21932,2612,10644,1794,19320,163,85,78
7095,21942,2612,10651,1794,19330,163,85,78
7100,21963,2613,10661,1795,19350,163,85,78
7105,21973,2613,10665,1795,19360,163,85,78
7110,21994,2614,10674,1795,19380,163,85,78
7115,22004,2614,10678,1795,19390,163,85,78
7120,22025,2615,10689,1796,19410,163,85,78
7125,22035,2615,10693,1796,19420,163,85,78
7130,22056,2619,10703,1798,19436,164,85,79
7135,22066,2621,10707,1800,19445,164,85,79
7140,22087,2624,10714,1801,19462,165,85,80
7145,22097,2625,10720,1802,19472,165,85,80
7150,22118,2626,10730,1803,19492,165,85,80
7155,22128,2626,10734,1803,19502,165,85,80
7160,22149,2627,10741,1803,19522,165,85,80
7165,22159,2627,10746,1803,19532,165,85,80
7170,22180,2628,10754,1803,19552,165,85,80
7175,22190,2628,10757,1803,19562,165,85,80
7180,22211,2629,10767,1804,19582,165,85,80
7185,22221,2629,10771,1804,19592,165,85,80
7190,22242,2630,10779,1804,19612,165,85,80
7195,22252,2630,10783,1804,19621,165,85,80
7200,22273,2631,10793,1805,19642,165,85,80
7205,22283,2632,10798,1806,19651,165,85,80
7210,22304,2633,10805,1806,19671,165,85,80
7215,22314,2633,10809,1806,19681,165,85,80
7220,22335,2634,10821,1807,19701,165,85,80
7225,22345,2634,10825,1807,19711,165,85,80
7230,22366,2635,10831,1808,19731,165,85,80
7235,22376,2635,10838,1808,19741,165,85,80
7240,22397,2637,10851,1809,19760,165,85,80
7245,22407,2637,10856,1809,19770,165,85,80
7250,22428,2639,10867,1811,19789,166,86,80
7255,22438,2640,10872,1811,19798,166,86,80
7260,22459,2641,10882,1811,19818,167,86,81
7265,22469,2642,10887,1811,19827,167,86,81
7270,22490,2643,10893,1811,19845,168,86,82
7275,22500,2647,10898,1814,19853,168,86,82
7280,22521,2649,10908,1815,19871,169,86,83
7285,22531,2651,10909,1816,19880,169,86,83
7290,22552,2652,10923,1816,19898,170,87,83
7295,22562,2655,10927,1818,19907,170,87,83
7300,22583,2655,10940,1818,19928,171,88,83
7305,22593,2656,10946,1819,19937,171,88,83
7310,22614,2657,10952,1819,19957,172,88,84
7315,22624,2658,10959,1820,19965,172,88,84
7320,22645,2660,10972,1822,19985,173,88,85
7325,22655,2661,10976,1823,19993,173,88,85
7330,22676,2665,10987,1826,20009,173,88,85
7335,22686,2668,10992,1828,20018,173,88,85
7340,22707,2671,11000,1829,20035,173,88,85
7345,22717,2673,11005,1830,20044,173,88,85
7350,22738,2675,11014,1831,20062,173,88,85
7355,22748,2677,11019,1833,20071,173,88,85
7360,22769,2680,11032,1836,20087,173,88,85
7365,22779,2683,11036,1838,20096,173,88,85
7370,22800,2685,11046,1838,20113,173,88,85
7375,22810,2689,11050,1842,20120,173,88,85
7380,22831,2692,11061,1844,20137,173,88,85
7385,22841,2695,11066,1847,20146,173,88,85
7390,22862,2698,11078,1849,20164,173,88,85
7395,22872,2699,11083,1849,20173,173,88,85
7400,22893,2702,11095,1851,20191,173,88,85
7405,22903,2703,11101,1852,20200,173,88,85
7410,22924,2706,11112,1853,20218,173,88,85
7415,22934,2707,11116,1854,20226,173,88,85
7420,22955,2711,11131,1857,20244,173,88,85
7425,22965,2712,11133,1858,20253,173,88,85
7430,22986,2716,11144,1861,20270,174,89,85
7435,22996,2718,11151,1863,20278,174,89,85
7440,23017,2721,11160,1864,20295,175,90,85
7445,23027,2723,11167,1866,20304,175,90,85
7450,23048,2724,11175,1866,20324,175,90,85
7455,23058,2724,11180,1866,20334,175,90,85
7460,23079,2725,11189,1867,20354,175,90,85
7465,23089,2726,11193,1868,20363,175,90,85
7470,23110,2727,11206,1868,20383,175,90,85
7475,23120,2728,11210,1869,20392,175,90,85
7480,23141,2729,11219,1870,20412,175,90,85
7485,23151,2729,11224,1870,20422,175,90,85
7490,23172,2731,11234,1870,20441,175,90,85
7495,23182,2731,11238,1870,20451,175,90,85
7500,23203,2733,11242,1870,20470,175,90,85
7505,23213,2735,11249,1872,20476,175,90,85
7510,23234,2740,11258,1877,20493,175,90,85
7515,23244,2742,11259,1878,20502,175,90,85
7520,23265,2747,11273,1882,20515,175,90,85
7525,23275,2749,11278,1883,20526,175,90,85
7530,23296,2752,11291,1885,20544,175,90,85
7535,23306,2752,11296,1885,20554,175,90,85
7540,23327,2755,11304,1886,20572,175,90,85
7545,23337,2755,11310,1886,20582,175,90,85
7550,23358,2758,11319,1888,20600,175,90,85
7555,23368,2758,11322,1888,20610,175,90,85
7560,23389,2764,11330,1892,20625,175,90,85
7565,23399,2765,11333,1892,20634,175,90,85
7570,23420,2768,11344,1895,20652,175,90,85
7575,23430,2770,11350,1896,20660,175,90,85
7580,23451,2771,11363,1897,20680,175,90,85
7585,23461,2772,11365,1897,20689,175,90,85
7590,23482,2775,11376,1900,20707,175,90,85
7595,23492,2776,11380,1900,20716,175,90,85
7600,23513,2779,11391,1902,20734,175,90,85
7605,23523,2779,11397,1902,20744,175,90,85
7610,23544,2780,11408,1903,20764,175,90,85
7615,23554,2780,11413,1903,20774,175,90,85
7620,23575,2781,11423,1904,20794,175,90,85
7625,23585,2781,11427,1904,20804,175,90,85
7630,23606,2782,11439,1904,20824,175,90,85
7635,23616,2782,11443,1904,20832,175,90,85
7640,23637,2785,11453,1906,20850,175,90,85
7645,23647,2788,11460,1909,20859,175,90,85
7650,23668,2789,11468,1909,20879,175,90,85
7655,23678,2789,11473,1909,20889,175,90,85
7660,23699,2790,11481,1909,20909,175,90,85
7665,23709,2790,11485,1909,20919,175,90,85
7670,23730,2792,11495,1911,20937,175,90,85
7675,23740,2793,11499,1912,20947,175,90,85
7680,23761,2795,11505,1912,20966,175,90,85
7685,23771,2798,11508,1914,20973,175,90,85
7690,23792,2800,11513,1914,20992,175,90,85
7695,23802,2802,11519,1916,21000,175,90,85
7700,23823,2806,11533,1920,21016,175,90,85
7705,23833,2810,11538,1924,21023,175,90,85
7710,23854,2812,11550,1926,21041,175,90,85
7715,23864,2815,11556,1928,21049,175,90,85
7720,23885,2820,11571,1932,21064,175,90,85
7725,23895,2822,11573,1933,21073,175,90,85
7730,23916,2828,11586,1938,21088,175,90,85
7735,23926,2829,11592,1939,21097,175,90,85
7740,23947,2833,11604,1942,21114,175,90,85
7745,23957,2834,11607,1942,21123,175,90,85
7750,23978,2836,11615,1944,21141,175,90,85
7755,23988,2838,11623,1945,21148,175,90,85
7760,24009,2842,11634,1948,21167,175,90,85
7765,24019,2843,11638,1948,21174,175,90,85
7770,24040,2847,11652,1951,21192,175,90,85
7775,24050,2850,11657,1954,21200,175,90,85
7780,24071,2851,11664,1955,21219,175,90,85
7785,24081,2854,11667,1957,21226,175,90,85
7790,24102,2857,11677,1959,21245,175,90,85
7795,24112,2859,11681,1960,21252,175,90,85
7800,24133,2862,11689,1963,21271,175,90,85
7805,24143,2863,11693,1963,21280,175,90,85
7810,24164,2865,11700,1965,21299,176,90,86
7815,24174,2866,11703,1965,21308,176,90,86
7820,24195,2867,11715,1966,21328,177,91,86
7825,24205,2868,11717,1966,21337,177,91,86
7830,24226,2869,11727,1967,21357,178,92,86
7835,24236,2870,11729,1967,21366,178,92,86
7840,24257,2871,11740,1968,21385,179,93,86
7845,24267,2873,11745,1969,21394,179,93,86
7850,24288,2874,11754,1970,21413,180,94,86
7855,24298,2877,11759,1972,21421,180,94,86
7860,24319,2879,11771,1973,21438,181,94,87
7865,24329,2880,11776,1974,21449,181,94,87
7870,24350,2882,11787,1976,21468,181,94,87
7875,24360,2882,11792,1976,21478,181,94,87
7880,24381,2885,11805,1978,21496,181,94,87
7885,24391,2885,11810,1978,21506,181,94,87
7890,24412,2887,11819,1979,21525,181,94,87
7895,24422,2887,11822,1979,21535,181,94,87
7900,24443,2889,11831,1980,21554,181,94,87
7905,24453,2889,11835,1980,21564,181,94,87
7910,24474,2893,11845,1982,21581,181,94,87
7915,24484,2893,11847,1982,21591,181,94,87
7920,24505,2898,11862,1985,21606,181,94,87
7925,24515,2901,11866,1987,21614,181,94,87
7930,24536,2906,11877,1991,21629,181,94,87
7935,24546,2909,11884,1994,21637,181,94,87
7940,24567,2913,11892,1996,21654,181,94,87
7945,24577,2914,11897,1997,21663,181,94,87
7950,24598,2917,11904,1998,21681,181,94,87
7955,24608,2919,11908,2000,21689,181,94,87
7960,24629,2923,11918,2002,21706,181,94,87
7965,24639,2924,11920,2002,21715,181,94,87
7970,24660,2928,11931,2004,21731,181,94,87
7975,24670,2930,11933,2005,21740,181,94,87
7980,24691,2933,11941,2007,21757,181,94,87
7985,24701,2934,11949,2008,21767,181,94,87
7990,24722,2938,11961,2012,21784,181,94,87
7995,24732,2938,11966,2012,21794,181,94,87
8000,24753,2942,11977,2014,21810,181,94,87
8005,24763,2943,11981,2015,21820,181,94,87
8010,24784,2947,11990,2018,21837,181,94,87
8015,24794,2947,11998,2018,21847,181,94,87
8020,24815,2950,12009,2020,21864,181,94,87
8025,24825,2951,12014,2021,21874,181,94,87
8030,24846,2954,12026,2023,21892,182,94,88
8035,24856,2955,12031,2024,21901,182,94,88
8040,24877,2959,12041,2026,21918,183,95,88
8045,24887,2959,12042,2026,21928,183,95,88
8050,24908,2960,12053,2026,21948,183,95,88
8055,24918,2960,12058,2026,21956,183,95,88
8060,24939,2963,12066,2029,21976,183,95,88
8065,24949,2963,12069,2029,21986,183,95,88
8070,24970,2965,12081,2031,22005,183,95,88
8075,24980,2966,12083,2032,22014,183,95,88
8080,25001,2967,12088,2032,22034,183,95,88
8085,25011,2967,12090,2032,22044,183,95,88
8090,25032,2968,12097,2032,22064,183,95,88
8095,25042,2969,12103,2033,22071,183,95,88
8100,25063,2974,12112,2037,22089,183,95,88
8105,25073,2975,12116,2037,22098,183,95,88
8110,25094,2978,12128,2039,22116,183,95,88
8115,25104,2979,12131,2039,22125,183,95,88
8120,25125,2982,12145,2041,22143,183,95,88
8125,25135,2984,12150,2042,22151,183,95,88
8130,25156,2986,12159,2043,22170,183,95,88
8135,25166,2988,12166,2045,22178,183,95,88
8140,25187,2990,12175,2046,22197,183,95,88
8145,25197,2991,12178,2046,22206,183,95,88
8150,25218,2994,12189,2048,22224,183,95,88
8155,25228,2995,12195,2049,22232,183,95,88
8160,25249,2997,12204,2051,22251,183,95,88
8165,25259,2998,12208,2052,22261,183,95,88
8170,25280,3002,12219,2055,22277,183,95,88
8175,25290,3003,12220,2056,22287,183,95,88
8180,25311,3004,12227,2056,22307,183,95,88
8185,25321,3004,12232,2056,22317,183,95,88
8190,25342,3005,12242,2056,22337,183,95,88
8195,25352,3005,12246,2056,22347,183,95,88
8200,25373,3006,12255,2056,22367,183,95,88
8205,25383,3006,12259,2056,22377,183,95,88
8210,25404,3007,12267,2056,22396,183,95,88
8215,25414,3007,12273,2056,22407,183,95,88
8220,25435,3008,12280,2056,22426,183,95,88
8225,25445,3010,12282,2057,22435,183,95,88
8230,25466,3013,12290,2059,22452,183,95,88
8235,25476,3015,12297,2061,22461,183,95,88
8240,25497,3016,12304,2062,22480,183,95,88
8245,25507,3019,12309,2065,22488,183,95,88
8250,25528,3021,12319,2067,22506,183,95,88
8255,25538,3023,12323,2069,22515,183,95,88
8260,25559,3025,12333,2071,22534,183,95,88
8265,25569,3025,12336,2071,22544,183,95,88
8270,25590,3028,12347,2073,22561,183,95,88
8275,25600,3030,12351,2075,22570,183,95,88
8280,25621,3035,12362,2078,22586,183,95,88
8285,25631,3036,12369,2079,22594,183,95,88
8290,25652,3041,12381,2083,22611,183,95,88
8295,25662,3041,12387,2083,22620,183,95,88
8300,25683,3044,12399,2085,22639,183,95,88
8305,25693,3044,12404,2085,22649,183,95,88
8310,25714,3047,12418,2088,22667,183,95,88
8315,25724,3047,12420,2088,22677,183,95,88
8320,25745,3050,12427,2090,22695,183,95,88
8325,25755,3050,12432,2090,22704,183,95,88
8330,25776,3053,12440,2091,22723,183,95,88
8335,25786,3053,12447,2091,22733,183,95,88
8340,25807,3056,12462,2094,22751,183,95,88
8345,25817,3056,12466,2094,22761,183,95,88
8350,25838,3058,12476,2094,22780,184,95,89
8355,25848,3058,12481,2094,22789,184,95,89
8360,25869,3061,12489,2095,22808,185,96,89
8365,25879,3062,12494,2096,22817,185,96,89
8370,25900,3065,12501,2098,22835,185,96,89
8375,25910,3066,12506,2099,22843,185,96,89
8380,25931,3070,12517,2103,22861,185,96,89
8385,25941,3071,12521,2103,22869,185,96,89
8390,25962,3075,12531,2105,22887,185,96,89
8395,25972,3077,12536,2107,22895,185,96,89
8400,25993,3082,12546,2109,22910,185,96,89
8405,26003,3084,12552,2111,22919,185,96,89
8410,26024,3086,12564,2112,22938,185,96,89
8415,26034,3087,12569,2112,22947,185,96,89
8420,26055,3088,12582,2112,22967,185,96,89
8425,26065,3089,12585,2112,22976,185,96,89
8430,26086,3090,12594,2113,22996,185,96,89
8435,26096,3091,12600,2114,23005,185,96,89
8440,26117,3093,12608,2115,23024,185,96,89
8445,26127,3094,12611,2115,23033,185,96,89
8450,26148,3095,12619,2115,23053,185,96,89
8455,26158,3096,12624,2116,23062,185,96,89
8460,26179,3098,12632,2117,23081,185,96,89
8465,26189,3099,12638,2117,23090,185,96,89
8470,26210,3102,12651,2120,23108,185,96,89
8475,26220,3103,12659,2121,23117,185,96,89
8480,26241,3106,12670,2123,23135,185,96,89
8485,26251,3107,12675,2123,23144,185,96,89
8490,26272,3109,12687,2124,23163,185,96,89
8495,26282,3110,12691,2125,23172,185,96,89
8500,26303,3113,12702,2128,23190,185,96,89
8505,26313,3115,12708,2129,23197,185,96,89
8510,26334,3120,12717,2133,23214,185,96,89
8515,26344,3123,12724,2135,23219,185,96,89
8520,26365,3129,12733,2139,23235,185,96,89
8525,26375,3130,12736,2140,23245,185,96,89
8530,26396,3131,12745,2140,23264,185,96,89
8535,26406,3132,12752,2141,23274,185,96,89
8540,26427,3133,12765,2142,23294,185,96,89
8545,26437,3133,12771,2142,23303,185,96,89
8550,26458,3135,12780,2144,23322,185,96,89
8555,26468,3136,12783,2145,23331,185,96,89
8560,26489,3138,12794,2146,23350,185,96,89
8565,26499,3139,12801,2147,23360,185,96,89
8570,26520,3140,12809,2147,23380,185,96,89
8575,26530,3140,12816,2147,23389,185,96,89
8580,26551,3142,12828,2149,23408,185,96,89
8585,26561,3143,12830,2150,23418,185,96,89
8590,26582,3143,12838,2150,23439,186,97,89
8595,26592,3143,12845,2150,23449,186,97,89
8600,26613,3143,12854,2150,23470,187,98,89
8605,26623,3143,12860,2150,23480,187,98,89
8610,26644,3143,12869,2150,23501,188,99,89
8615,26654,3143,12875,2150,23511,188,99,89
8620,26675,3143,12884,2150,23532,189,99,90
8625,26685,3143,12890,2150,23542,189,99,90
8630,26706,3146,12899,2151,23559,190,100,90
8635,26716,3150,12904,2154,23566,190,100,90
8640,26737,3154,12915,2157,23581,191,101,90
8645,26747,3156,12920,2159,23591,191,101,90
8650,26768,3157,12933,2160,23611,191,101,90
8655,26778,3157,12938,2160,23621,191,101,90
8660,26799,3159,12951,2162,23640,191,101,90
8665,26809,3159,12957,2162,23650,191,101,90
8670,26830,3160,12967,2163,23670,191,101,90
8675,26840,3160,12974,2163,23680,191,101,90
8680,26861,3161,12990,2164,23700,191,101,90
8685,26871,3161,12996,2164,23710,191,101,90
8690,26892,3163,13002,2165,23729,191,101,90
8695,26902,3163,13007,2165,23739,191,101,90
8700,26923,3164,13016,2165,23759,191,101,90
8705,26933,3166,13022,2166,23767,191,101,90
8710,26954,3168,13033,2167,23786,191,101,90
8715,26964,3170,13038,2169,23794,191,101,90
8720,26985,3171,13049,2169,23814,191,101,90
8725,26995,3172,13053,2170,23823,191,101,90
8730,27016,3175,13064,2172,23841,191,101,90
8735,27026,3177,13069,2174,23849,191,101,90
8740,27047,3180,13083,2177,23867,191,101,90
8745,27057,3182,13090,2179,23874,191,101,90
8750,27078,3188,13103,2184,23887,191,101,90
8755,27088,3194,13106,2189,23894,191,101,90
8760,27109,3201,13120,2195,23907,192,101,91
8765,27119,3202,13125,2196,23917,192,101,91
8770,27140,3202,13137,2196,23938,192,101,91
8775,27150,3202,13140,2196,23948,192,101,91
8780,27171,3202,13153,2196,23969,192,101,91
8785,27181,3202,13158,2196,23979,192,101,91
8790,27202,3202,13163,2196,24000,192,101,91
8795,27212,3202,13169,2196,24010,192,101,91
8800,27233,3202,13181,2196,24031,192,101,91
8805,27243,3202,13187,2196,24041,192,101,91
8810,27264,3203,13198,2196,24061,192,101,91
8815,27274,3203,13203,2196,24071,192,101,91
8820,27295,3204,13215,2197,24091,192,101,91
8825,27305,3204,13220,2197,24101,192,101,91
8830,27326,3206,13229,2197,24120,192,101,91
8835,27336,3206,13232,2197,24130,192,101,91
8840,27357,3208,13241,2199,24149,192,101,91
8845,27367,3208,13248,2199,24159,192,101,91
8850,27388,3210,13258,2200,24178,192,101,91
8855,27398,3210,13263,2200,24188,192,101,91
8860,27419,3212,13269,2200,24207,192,101,91
8865,27429,3213,13273,2201,24216,192,101,91
8870,27450,3217,13283,2203,24233,192,101,91
8875,27460,3218,13286,2203,24242,192,101,91
8880,27481,3224,13293,2207,24255,192,101,91
8885,27491,3226,13298,2209,24265,192,101,91
8890,27512,3228,13309,2210,24284,192,101,91
8895,27522,3228,13315,2210,24294,192,101,91
8900,27543,3231,13322,2211,24312,192,101,91
8905,27553,3231,13327,2211,24322,192,101,91
8910,27574,3234,13333,2212,24340,192,101,91
8915,27584,3234,13337,2212,24350,192,101,91
8920,27605,3236,13347,2214,24369,192,101,91
8925,27615,3236,13348,2214,24379,192,101,91
8930,27636,3238,13355,2214,24398,192,101,91
8935,27646,3238,13359,2214,24408,192,101,91
8940,27667,3241,13370,2215,24426,192,101,91
8945,27677,3241,13375,2215,24436,192,101,91
8950,27698,3244,13386,2217,24454,192,101,91
8955,27708,3244,13390,2217,24464,192,101,91
8960,27729,3246,13396,2218,24483,192,101,91
8965,27739,3246,13400,2218,24493,192,101,91
8970,27760,3249,13407,2219,24511,192,101,91
8975,27770,3249,13416,2219,24521,192,101,91
8980,27791,3251,13427,2220,24540,192,101,91
8985,27801,3251,13430,2220,24550,192,101,91
8990,27822,3257,13438,2223,24564,192,101,91
8995,27832,3260,13442,2225,24572,192,101,91
9000,27853,3265,13454,2229,24586,192,101,91
9005,27863,3269,13457,2232,24594,192,101,91
9010,27884,3270,13468,2233,24614,192,101,91
9015,27894,3271,13475,2233,24622,192,101,91
9020,27915,3273,13487,2235,24642,192,101,91
9025,27925,3274,13491,2235,24650,192,101,91
9030,27946,3276,13503,2237,24670,192,101,91
9035,27956,3277,13508,2238,24679,192,101,91
9040,27977,3278,13519,2238,24699,192,101,91
9045,27987,3279,13522,2238,24708,192,101,91
9050,28008,3280,13531,2239,24728,192,101,91
9055,28018,3281,13536,2240,24737,192,101,91
9060,28039,3282,13544,2240,24757,192,101,91
9065,28049,3283,13552,2241,24765,192,101,91
9070,28070,3285,13561,2243,24785,192,101,91
9075,28080,3286,13564,2243,24794,192,101,91
9080,28101,3287,13574,2243,24814,192,101,91
9085,28111,3288,13577,2244,24823,192,101,91
9090,28132,3289,13584,2244,24843,192,101,91
9095,28142,3290,13588,2245,24852,192,101,91
9100,28163,3291,13598,2245,24872,192,101,91
9105,28173,3292,13602,2245,24881,192,101,91
9110,28194,3297,13616,2249,24895,192,101,91
9115,28204,3301,13621,2253,24903,192,101,91
9120,28225,3304,13628,2255,24921,192,101,91
9125,28235,3304,13634,2255,24931,192,101,91
9130,28256,3306,13645,2256,24950,192,101,91
9135,28266,3306,13647,2256,24960,192,101,91
9140,28287,3307,13660,2257,24980,192,101,91
9145,28297,3307,13665,2257,24990,192,101,91
9150,28318,3308,13674,2257,25010,192,101,91
9155,28328,3308,13677,2257,25020,192,101,91
9160,28349,3309,13682,2257,25040,192,101,91
9165,28359,3309,13687,2257,25050,192,101,91
9170,28380,3310,13695,2257,25070,192,101,91
9175,28390,3310,13700,2257,25080,192,101,91
9180,28411,3311,13708,2257,25100,192,101,91
9185,28421,3311,13711,2257,25110,192,101,91
9190,28442,3312,13723,2258,25130,192,101,91
9195,28452,3312,13727,2258,25140,192,101,91
9200,28473,3313,13739,2258,25160,192,101,91
9205,28483,3313,13744,2258,25170,192,101,91
9210,28504,3314,13753,2259,25190,192,101,91
9215,28514,3314,13760,2259,25200,192,101,91
9220,28535,3315,13773,2260,25220,192,101,91
9225,28545,3315,13778,2260,25230,192,101,91
9230,28566,3320,13786,2263,25245,192,101,91
9235,28576,3324,13790,2266,25251,192,101,91
9240,28597,3329,13797,2269,25267,192,101,91
9245,28607,3331,13804,2270,25276,192,101,91
9250,28628,3333,13816,2271,25295,192,101,91
9255,28638,3334,13819,2271,25304,192,101,91
9260,28659,3336,13824,2272,25323,192,101,91
9265,28669,3337,13830,2273,25332,192,101,91
9270,28690,3339,13840,2274,25350,192,101,91
9275,28700,3341,13845,2276,25359,192,101,91
9280,28721,3343,13856,2276,25377,192,101,91
9285,28731,3345,13864,2278,25386,192,101,91
9290,28752,3347,13874,2279,25405,192,101,91
9295,28762,3348,13880,2280,25414,192,101,91
9300,28783,3351,13889,2282,25432,192,101,91
9305,28793,3352,13896,2283,25441,192,101,91
9310,28814,3353,13905,2284,25461,192,101,91
9315,28824,3354,13909,2285,25470,192,101,91
9320,28845,3355,13917,2286,25490,192,101,91
9325,28855,3356,13922,2286,25499,192,101,91
9330,28876,3357,13935,2286,25519,192,101,91
9335,28886,3358,13937,2286,25528,192,101,91
9340,28907,3359,13944,2286,25548,192,101,91
9345,28917,3361,13949,2287,25555,192,101,91
9350,28938,3366,13959,2291,25572,192,101,91
9355,28948,3369,13964,2293,25578,192,101,91
9360,28969,3375,13976,2299,25594,192,101,91
9365,28979,3375,13977,2299,25604,192,101,91
9370,29000,3378,13986,2302,25622,192,101,91
9375,29010,3378,13989,2302,25632,192,101,91
9380,29031,3380,13994,2303,25651,192,101,91
9385,29041,3380,13996,2303,25661,192,101,91
9390,29062,3383,14009,2305,25679,192,101,91
9395,29072,3383,14014,2305,25689,192,101,91
9400,29093,3385,14023,2306,25708,192,101,91
9405,29103,3385,14027,2306,25718,192,101,91
9410,29124,3388,14041,2307,25736,192,101,91
9415,29134,3388,14048,2307,25745,192,101,91
9420,29155,3391,14054,2308,25764,192,101,91
9425,29165,3392,14061,2309,25772,192,101,91
9430,29186,3394,14072,2311,25792,192,101,91
9435,29196,3395,14076,2311,25800,192,101,91
9440,29217,3397,14091,2313,25819,192,101,91
9445,29227,3399,14097,2315,25827,192,101,91
9450,29248,3401,14108,2316,25847,192,101,91
9455,29258,3402,14113,2317,25856,192,101,91
9460,29279,3403,14125,2318,25876,192,101,91
9465,29289,3404,14130,2318,25885,192,101,91
9470,29310,3407,14138,2320,25903,192,101,91
9475,29320,3408,14142,2321,25911,192,101,91
9480,29341,3410,14151,2322,25931,192,101,91
9485,29351,3411,14155,2323,25940,192,101,91
9490,29372,3412,14166,2323,25960,192,101,91
9495,29382,3413,14169,2323,25969,192,101,91
9500,29403,3414,14178,2324,25989,192,101,91
9505,29413,3415,14181,2324,25998,192,101,91
9510,29434,3416,14193,2325,26018,192,101,91
9515,29444,3418,14200,2326,26026,192,101,91
9520,29465,3419,14212,2326,26046,192,101,91
9525,29475,3420,14216,2326,26055,192,101,91
9530,29496,3424,14227,2329,26072,192,101,91
9535,29506,3425,14232,2330,26081,192,101,91
9540,29527,3428,14247,2333,26098,192,101,91
9545,29537,3430,14255,2335,26107,192,101,91
9550,29558,3433,14264,2336,26123,192,101,91
9555,29568,3435,14268,2338,26133,192,101,91
9560,29589,3438,14277,2338,26151,192,101,91
9565,29599,3438,14282,2338,26161,192,101,91
9570,29620,3441,14292,2339,26179,192,101,91
9575,29630,3441,14297,2339,26189,192,101,91
9580,29651,3444,14309,2340,26207,192,101,91
9585,29661,3444,14316,2340,26216,192,101,91
9590,29682,3448,14329,2343,26233,192,101,91
9595,29692,3449,14332,2344,26242,192,101,91
9600,29713,3453,14343,2347,26259,192,101,91
9605,29723,3454,14347,2348,26269,192,101,91
9610,29744,3457,14359,2349,26287,192,101,91
9615,29754,3457,14362,2349,26297,192,101,91
9620,29775,3459,14376,2351,26316,192,101,91
9625,29785,3459,14383,2351,26326,192,101,91
9630,29806,3461,14396,2352,26345,192,101,91
9635,29816,3461,14398,2352,26355,192,101,91
9640,29837,3464,14410,2354,26373,192,101,91
9645,29847,3464,14418,2354,26383,192,101,91
9650,29868,3467,14425,2355,26401,192,101,91
9655,29878,3469,14429,2357,26409,192,101,91
9660,29899,3473,14440,2359,26426,192,101,91
9665,29909,3474,14444,2359,26435,192,101,91
9670,29930,3476,14456,2361,26453,192,101,91
9675,29940,3479,14459,2364,26461,192,101,91
9680,29961,3480,14471,2364,26481,192,101,91
9685,29971,3481,14475,2365,26490,192,101,91
9690,29992,3482,14487,2366,26510,192,101,91
9695,30002,3483,14493,2367,26518,192,101,91
9700,30023,3485,14506,2368,26538,192,101,91
9705,30033,3486,14512,2369,26547,192,101,91
9710,30054,3487,14518,2370,26567,192,101,91
9715,30064,3488,14525,2371,26575,192,101,91
9720,30085,3490,14532,2373,26595,192,101,91
9725,30095,3491,14538,2373,26604,192,101,91
9730,30116,3491,14551,2373,26625,192,101,91
9735,30126,3492,14553,2373,26634,192,101,91
9740,30147,3492,14562,2373,26655,192,101,91
9745,30157,3493,14566,2373,26664,192,101,91
9750,30178,3493,14574,2373,26685,192,101,91
9755,30188,3494,14580,2374,26694,192,101,91
9760,30209,3494,14591,2374,26715,192,101,91
9765,30219,3495,14593,2374,26724,192,101,91
9770,30240,3496,14604,2375,26744,192,101,91
9775,30250,3497,14607,2375,26753,192,101,91
9780,30271,3500,14616,2377,26771,192,101,91
9785,30281,3500,14621,2377,26781,192,101,91
9790,30302,3503,14631,2377,26799,192,101,91
9795,30312,3503,14635,2377,26809,192,101,91
9800,30333,3506,14646,2378,26827,192,101,91
9805,30343,3506,14651,2378,26837,192,101,91
9810,30364,3509,14661,2380,26855,192,101,91
9815,30374,3509,14664,2380,26865,192,101,91
9820,30395,3512,14675,2382,26883,192,101,91
9825,30405,3512,14679,2382,26893,192,101,91
9830,30426,3515,14692,2385,26911,192,101,91
9835,30436,3515,14698,2385,26921,192,101,91
9840,30457,3519,14706,2387,26937,192,101,91
9845,30467,3520,14708,2388,26947,192,101,91
9850,30488,3522,14720,2388,26966,192,101,91
9855,30498,3522,14724,2388,26976,192,101,91
9860,30519,3524,14732,2389,26995,192,101,91
9865,30529,3524,14740,2389,27005,192,101,91
9870,30550,3526,14747,2389,27024,192,101,91
9875,30560,3526,14753,2389,27034,192,101,91
9880,30581,3528,14767,2390,27053,192,101,91
9885,30591,3528,14775,2390,27063,192,101,91
9890,30612,3530,14788,2391,27082,192,101,91
9895,30622,3532,14793,2392,27090,192,101,91
9900,30643,3536,14805,2396,27106,192,101,91
9905,30653,3538,14809,2397,27114,192,101,91
9910,30674,3542,14822,2400,27132,192,101,91
9915,30684,3545,14829,2403,27138,192,101,91
9920,30705,3547,14840,2405,27158,192,101,91
9925,30715,3548,14843,2405,27167,192,101,91
9930,30736,3549,14850,2405,27187,192,101,91
9935,30746,3550,14851,2405,27196,192,101,91
9940,30767,3551,14865,2406,27216,192,101,91
9945,30777,3552,14870,2407,27224,192,101,91
9950,30798,3555,14882,2410,27243,192,101,91
9955,30808,3556,14887,2410,27252,192,101,91
9960,30829,3557,14898,2410,27272,192,101,91
9965,30839,3558,14902,2410,27281,192,101,91
9970,30860,3559,14911,2411,27300,192,101,91
9975,30870,3561,14916,2413,27309,192,101,91
9980,30891,3562,14924,2414,27329,192,101,91
9985,30901,3563,14929,2415,27338,192,101,91
9990,30922,3565,14942,2417,27356,192,101,91
9995,30932,3567,14947,2418,27365,192,101,91
10000,30953,3569,14956,2419,27384,192,101,91
10005,30963,3570,14961,2419,27393,192,101,91
10010,30984,3572,14971,2421,27412,192,101,91
10015,30994,3573,14979,2422,27421,192,101,91
10020,31015,3577,14992,2426,27437,192,101,91
10025,31025,3578,14998,2427,27447,192,101,91
10030,31046,3580,15007,2429,27466,192,101,91
10035,31056,3580,15010,2429,27476,192,101,91
10040,31077,3582,15020,2430,27495,192,101,91
10045,31087,3582,15025,2430,27505,192,101,91
10050,31108,3584,15033,2431,27524,192,101,91
10055,31118,3584,15038,2431,27534,192,101,91
10060,31139,3586,15047,2432,27553,192,101,91
10065,31149,3586,15052,2432,27563,192,101,91
10070,31170,3589,15060,2434,27581,192,101,91
10075,31180,3589,15063,2434,27591,192,101,91
10080,31201,3591,15070,2434,27610,192,101,91
10085,31211,3592,15073,2434,27619,192,101,91
10090,31232,3596,15078,2436,27636,192,101,91
10095,31242,3597,15084,2436,27644,192,101,91
10100,31263,3602,15097,2440,27661,192,101,91
10105,31273,3603,15102,2440,27669,192,101,91
10110,31294,3609,15116,2446,27685,192,101,91
10115,31304,3610,15120,2447,27694,192,101,91
10120,31325,3613,15130,2447,27712,192,101,91
10125,31335,3614,15135,2448,27721,192,101,91
10130,31356,3617,15145,2449,27738,192,101,91
10135,31366,3619,15149,2451,27747,192,101,91
10140,31387,3623,15157,2455,27764,192,101,91
10145,31397,3624,15163,2455,27773,192,101,91
10150,31418,3626,15172,2457,27792,192,101,91
10155,31428,3627,15175,2457,27801,192,101,91
10160,31449,3629,15185,2459,27820,192,101,91
10165,31459,3630,15188,2459,27829,192,101,91
10170,31480,3632,15206,2461,27848,192,101,91
10175,31490,3633,15208,2461,27857,192,101,91
10180,31511,3633,15217,2461,27878,192,101,91
10185,31521,3634,15222,2462,27887,192,101,91
10190,31542,3634,15231,2462,27908,192,101,91
10195,31552,3635,15236,2462,27917,192,101,91
10200,31573,3635,15244,2462,27938,192,101,91
10205,31583,3636,15248,2463,27947,192,101,91
10210,31604,3638,15262,2463,27966,192,101,91
10215,31614,3640,15266,2464,27974,192,101,91
10220,31635,3642,15274,2464,27993,192,101,91
10225,31645,3643,15277,2464,28002,192,101,91
10230,31666,3646,15287,2465,28020,192,101,91
10235,31676,3648,15292,2467,28028,192,101,91
10240,31697,3651,15300,2469,28046,192,101,91
10245,31707,3652,15303,2470,28055,192,101,91
10250,31728,3657,15320,2475,28070,192,101,91
10255,31738,3659,15325,2477,28079,192,101,91
10260,31759,3664,15335,2480,28094,192,101,91
10265,31769,3666,15342,2482,28103,192,101,91
10270,31790,3669,15351,2483,28121,192,101,91
10275,31800,3669,15354,2483,28131,192,101,91
10280,31821,3671,15362,2483,28150,192,101,91
10285,31831,3671,15369,2483,28160,192,101,91
10290,31852,3673,15379,2484,28179,192,101,91
10295,31862,3673,15381,2484,28189,192,101,91
10300,31883,3675,15391,2484,28208,192,101,91
10305,31893,3675,15396,2484,28217,192,101,91
10310,31914,3678,15408,2487,28236,192,101,91
10315,31924,3678,15412,2487,28246,192,101,91
10320,31945,3680,15423,2489,28265,192,101,91
10325,31955,3680,15430,2489,28274,192,101,91
10330,31976,3683,15441,2491,28293,192,101,91
10335,31986,3683,15445,2491,28303,192,101,91
10340,32007,3685,15456,2493,28322,192,101,91
10345,32017,3685,15458,2493,28332,192,101,91
10350,32038,3687,15470,2494,28351,192,101,91
10355,32048,3687,15476,2494,28360,192,101,91
10360,32069,3690,15488,2496,28379,192,101,91
10365,32079,3690,15495,2496,28388,192,101,91
10370,32100,3695,15503,2499,28404,192,101,91
10375,32110,3697,15509,2500,28412,192,101,91
10380,32131,3701,15514,2503,28429,192,101,91
10385,32141,3703,15519,2505,28438,192,101,91
10390,32162,3703,15532,2505,28459,192,101,91
10395,32172,3703,15536,2505,28469,192,101,91
10400,32193,3703,15544,2505,28490,192,101,91
10405,32203,3703,15550,2505,28500,192,101,91
10410,32224,3703,15561,2505,28521,192,101,91
10415,32234,3703,15564,2505,28531,192,101,91
10420,32255,3703,15576,2505,28552,192,101,91
10425,32265,3703,15582,2505,28562,192,101,91
10430,32286,3703,15595,2505,28583,192,101,91
10435,32296,3703,15599,2505,28593,192,101,91
10440,32317,3703,15608,2505,28614,192,101,91
10445,32327,3703,15612,2505,28624,192,101,91
10450,32348,3703,15620,2505,28645,192,101,91
10455,32358,3703,15624,2505,28655,192,101,91
10460,32379,3703,15633,2505,28676,192,101,91
10465,32389,3703,15637,2505,28686,192,101,91
10470,32410,3703,15651,2505,28707,192,101,91
10475,32420,3703,15657,2505,28717,192,101,91
10480,32441,3703,15668,2505,28738,192,101,91
10485,32451,3703,15673,2505,28748,192,101,91
10490,32472,3707,15686,2509,28765,192,101,91
10495,32482,3709,15693,2510,28772,192,101,91
10500,32503,3716,15704,2515,28787,192,101,91
10505,32513,3717,15711,2516,28796,192,101,91
10510,32534,3722,15726,2521,28812,192,101,91
10515,32544,3723,15731,2521,28821,192,101,91
10520,32565,3725,15744,2522,28840,192,101,91
10525,32575,3726,15746,2522,28849,192,101,91
10530,32596,3728,15751,2523,28868,192,101,91
10535,32606,3729,15755,2524,28877,192,101,91
10540,32627,3731,15764,2524,28896,192,101,91
10545,32637,3732,15768,2525,28905,192,101,91
10550,32658,3734,15776,2527,28924,192,101,91
10555,32668,3735,15782,2527,28933,192,101,91
10560,32689,3737,15791,2528,28952,192,101,91
10565,32699,3738,15794,2529,28961,192,101,91
10570,32720,3740,15802,2530,28980,192,101,91
10575,32730,3741,15809,2531,28989,192,101,91
10580,32751,3743,15816,2532,29008,192,101,91
10585,32761,3744,15821,2532,29017,192,101,91
10590,32782,3746,15832,2533,29036,192,101,91
10595,32792,3747,15836,2534,29045,192,101,91
10600,32813,3749,15850,2536,29064,192,101,91
10605,32823,3750,15854,2537,29073,192,101,91
10610,32844,3754,15867,2541,29089,192,101,91
10615,32854,3757,15871,2543,29097,192,101,91
10620,32875,3764,15881,2548,29109,192,101,91
10625,32885,3766,15886,2550,29119,192,101,91
10630,32906,3766,15895,2550,29140,192,101,91
10635,32916,3766,15898,2550,29150,192,101,91
10640,32937,3766,15908,2550,29171,192,101,91
10645,32947,3766,15913,2550,29181,192,101,91
10650,32968,3766,15924,2550,29202,192,101,91
10655,32978,3766,15933,2550,29212,192,101,91
10660,32999,3766,15944,2550,29233,192,101,91
10665,33009,3766,15949,2550,29243,192,101,91
10670,33030,3766,15954,2550,29264,192,101,91
10675,33040,3766,15959,2550,29274,192,101,91
10680,33061,3766,15972,2550,29295,192,101,91
10685,33071,3766,15977,2550,29305,192,101,91
10690,33092,3767,15987,2550,29325,192,101,91
10695,33102,3767,15991,2550,29335,192,101,91
10700,33123,3768,16002,2551,29355,192,101,91
10705,33133,3768,16007,2551,29365,192,101,91
10710,33154,3769,16017,2552,29385,192,101,91
10715,33164,3769,16021,2552,29394,192,101,91
10720,33185,3771,16028,2553,29414,192,101,91
10725,33195,3771,16034,2553,29423,192,101,91
10730,33216,3775,16044,2556,29440,192,101,91
10735,33226,3778,16049,2559,29448,192,101,91
10740,33247,3783,16061,2562,29462,192,101,91
10745,33257,3785,16063,2564,29472,192,101,91
10750,33278,3788,16072,2564,29490,192,101,91
10755,33288,3788,16079,2564,29500,192,101,91
10760,33309,3791,16089,2566,29518,192,101,91
10765,33319,3791,16094,2566,29528,192,101,91
10770,33340,3794,16103,2568,29546,192,101,91
10775,33350,3794,16111,2568,29556,192,101,91
10780,33371,3797,16119,2569,29574,192,101,91
10785,33381,3797,16124,2569,29584,192,101,91
10790,33402,3800,16136,2571,29602,192,101,91
10795,33412,3800,16143,2571,29612,192,101,91
10800,33433,3803,16154,2573,29630,192,101,91
10805,33443,3803,16159,2573,29640,192,101,91
10810,33464,3806,16174,2575,29658,192,101,91
10815,33474,3806,16183,2575,29668,192,101,91
10820,33495,3809,16194,2577,29686,192,101,91
10825,33505,3809,16198,2577,29696,192,101,91
10830,33526,3812,16211,2580,29714,192,101,91
10835,33536,3812,16218,2580,29724,192,101,91
10840,33557,3815,16224,2580,29742,192,101,91
10845,33567,3815,16229,2580,29751,192,101,91
10850,33588,3821,16239,2584,29765,192,101,91
10855,33598,3825,16246,2587,29772,192,101,91
10860,33619,3832,16257,2593,29786,192,101,91
10865,33629,3834,16262,2594,29795,192,101,91
10870,33650,3834,16271,2594,29814,192,101,91
10875,33660,3838,16277,2598,29822,192,101,91
10880,33681,3838,16287,2598,29843,192,101,91
10885,33691,3838,16293,2598,29853,192,101,91
10890,33712,3838,16303,2598,29874,192,101,91
10895,33722,3838,16308,2598,29884,192,101,91
10900,33743,3838,16318,2598,29905,192,101,91
10905,33753,3838,16323,2598,29915,192,101,91
10910,33774,3838,16334,2598,29936,192,101,91
10915,33784,3838,16337,2598,29946,192,101,91
10920,33805,3838,16348,2598,29967,192,101,91
10925,33815,3838,16353,2598,29976,192,101,91
10930,33836,3840,16364,2600,29996,192,101,91
10935,33846,3840,16370,2600,30006,192,101,91
10940,33867,3840,16383,2600,30027,192,101,91
10945,33877,3840,16387,2600,30037,192,101,91
10950,33898,3840,16396,2600,30058,192,101,91
10955,33908,3840,16398,2600,30068,192,101,91
10960,33929,3840,16411,2600,30089,192,101,91
10965,33939,3840,16416,2600,30099,192,101,91
10970,33960,3842,16428,2600,30118,192,101,91
10975,33970,3843,16433,2601,30127,192,101,91
10980,33991,3846,16441,2602,30145,192,101,91
10985,34001,3850,16447,2605,30151,192,101,91
10990,34022,3853,16456,2606,30169,192,101,91
10995,34032,3855,16459,2607,30177,192,101,91
11000,34053,3858,16467,2608,30194,192,101,91
11005,34063,3862,16472,2612,30201,192,101,91
11010,34084,3864,16482,2614,30220,192,101,91
11015,34094,3865,16484,2614,30229,192,101,91
11020,34115,3867,16499,2616,30248,192,101,91
11025,34125,3868,16503,2617,30257,192,101,91
11030,34146,3870,16517,2617,30276,192,101,91
11035,34156,3871,16525,2617,30285,192,101,91
11040,34177,3874,16535,2618,30303,192,101,91
11045,34187,3875,16541,2619,30311,192,101,91
11050,34208,3880,16551,2622,30327,192,101,91
11055,34218,3882,16556,2623,30335,192,101,91
11060,34239,3888,16569,2629,30350,192,101,91
11065,34249,3890,16574,2631,30359,192,101,91
11070,34270,3895,16587,2635,30375,192,101,91
11075,34280,3896,16591,2635,30384,192,101,91
11080,34301,3898,16601,2637,30402,192,101,91
11085,34311,3900,16605,2639,30411,192,101,91
11090,34332,3901,16613,2640,30431,192,101,91
11095,34342,3902,16618,2640,30439,192,101,91
11100,34363,3904,16629,2642,30459,192,101,91
11105,34373,3905,16633,2643,30468,192,101,91
11110,34394,3907,16645,2645,30487,192,101,91
11115,34404,3908,16648,2646,30496,192,101,91
11120,34425,3908,16660,2646,30516,192,101,91
11125,34435,3910,16666,2648,30525,192,101,91
11130,34456,3911,16677,2649,30545,192,101,91
11135,34466,3912,16682,2649,30554,192,101,91
11140,34487,3913,16694,2650,30574,192,101,91
11145,34497,3915,16700,2652,30582,192,101,91
11150,34518,3916,16709,2653,30601,192,101,91
11155,34528,3919,16713,2655,30609,192,101,91
11160,34549,3922,16725,2658,30625,192,101,91
11165,34559,3924,16729,2660,30635,192,101,91
11170,34580,3925,16737,2660,30655,192,101,91
11175,34590,3925,16743,2660,30665,192,101,91
11180,34611,3927,16749,2661,30684,192,101,91
11185,34621,3928,16755,2662,30693,192,101,91
11190,34642,3930,16764,2663,30712,192,101,91
11195,34652,3931,16771,2664,30721,192,101,91
11200,34673,3933,16784,2665,30740,192,101,91
11205,34683,3933,16786,2665,30750,192,101,91
11210,34704,3940,16796,2670,30763,192,101,91
11215,34714,3941,16801,2671,30773,192,101,91
11220,34735,3945,16811,2672,30789,192,101,91
11225,34745,3946,16813,2673,30799,192,101,91
11230,34766,3952,16823,2679,30814,192,101,91
11235,34776,3952,16829,2679,30824,192,101,91
11240,34797,3955,16836,2680,30842,192,101,91
11245,34807,3955,16840,2680,30852,192,101,91
11250,34828,3959,16852,2682,30869,192,101,91
11255,34838,3959,16859,2682,30879,192,101,91
11260,34859,3962,16871,2685,30896,192,101,91
11265,34869,3963,16877,2686,30906,192,101,91
11270,34890,3966,16882,2687,30924,192,101,91
11275,34900,3967,16886,2687,30933,192,101,91
11280,34921,3970,16895,2689,30951,192,101,91
11285,34931,3973,16901,2691,30958,192,101,91
11290,34952,3975,16911,2693,30977,192,101,91
11295,34962,3976,16916,2694,30986,192,101,91
11300,34983,3978,16923,2695,31005,192,101,91
11305,34993,3979,16929,2695,31014,192,101,91
11310,35014,3981,16938,2696,31033,192,101,91
11315,35024,3982,16944,2696,31042,192,101,91
11320,35045,3984,16953,2697,31061,192,101,91
11325,35055,3986,16955,2698,31069,192,101,91
11330,35076,3988,16971,2699,31088,192,101,91
11335,35086,3990,16978,2700,31095,192,101,91
11340,35107,3995,16987,2703,31112,192,101,91
11345,35117,3996,16990,2703,31121,192,101,91
11350,35138,3998,16997,2704,31140,192,101,91
11355,35148,3999,17003,2705,31149,192,101,91
11360,35169,4003,17016,2708,31166,192,101,91
11365,35179,4004,17022,2709,31175,192,101,91
11370,35200,4007,17034,2711,31192,192,101,91
11375,35210,4009,17038,2713,31201,192,101,91
11380,35231,4012,17047,2716,31218,192,101,91
11385,35241,4014,17051,2717,31227,192,101,91
11390,35262,4015,17062,2717,31247,192,101,91
11395,35272,4017,17068,2718,31255,192,101,91
11400,35293,4020,17075,2720,31273,192,101,91
11405,35303,4020,17079,2720,31283,192,101,91
11410,35324,4020,17091,2720,31304,192,101,91
11415,35334,4020,17094,2720,31314,192,101,91
11420,35355,4020,17099,2720,31335,192,101,91
11425,35365,4020,17105,2720,31345,192,101,91
11430,35386,4020,17117,2720,31366,192,101,91
11435,35396,4020,17123,2720,31376,192,101,91
11440,35417,4020,17134,2720,31397,192,101,91
11445,35427,4020,17139,2720,31407,192,101,91
11450,35448,4021,17147,2720,31427,192,101,91
11455,35458,4021,17152,2720,31437,192,101,91
11460,35479,4022,17164,2720,31457,192,101,91
11465,35489,4023,17168,2721,31466,192,101,91
11470,35510,4025,17181,2721,31484,192,101,91
11475,35520,4028,17186,2723,31492,192,101,91
11480,35541,4030,17195,2724,31510,192,101,91
11485,35551,4032,17200,2725,31519,192,101,91
11490,35572,4034,17210,2725,31537,192,101,91
11495,35582,4037,17214,2727,31545,192,101,91
11500,35603,4039,17227,2728,31564,192,101,91
11505,35613,4040,17230,2728,31573,192,101,91
11510,35634,4042,17240,2730,31592,192,101,91
11515,35644,4043,17245,2730,31601,192,101,91
11520,35665,4045,17255,2730,31619,192,101,91
11525,35675,4047,17260,2731,31628,192,101,91
11530,35696,4049,17269,2732,31647,192,101,91
11535,35706,4050,17272,2732,31656,192,101,91
11540,35727,4052,17281,2734,31675,192,101,91
11545,35737,4053,17287,2735,31684,192,101,91
11550,35758,4056,17300,2737,31702,192,101,91
11555,35768,4057,17303,2737,31711,192,101,91
11560,35789,4059,17316,2738,31730,192,101,91
11565,35799,4060,17324,2738,31738,192,101,91
11570,35820,4064,17329,2740,31755,192,101,91
11575,35830,4067,17335,2743,31763,192,101,91
11580,35851,4073,17345,2748,31778,192,101,91
11585,35861,4073,17351,2748,31788,192,101,91
11590,35882,4073,17363,2748,31809,192,101,91
11595,35892,4073,17369,2748,31819,192,101,91
11600,35913,4073,17380,2748,31840,192,101,91
11605,35923,4073,17382,2748,31850,192,101,91
11610,35944,4073,17395,2748,31871,192,101,91
11615,35954,4073,17401,2748,31881,192,101,91
11620,35975,4073,17412,2748,31902,192,101,91
11625,35985,4073,17418,2748,31912,192,101,91
11630,36006,4073,17430,2748,31933,192,101,91
11635,36016,4073,17435,2748,31943,192,101,91
11640,36037,4073,17443,2748,31964,192,101,91
11645,36047,4074,17448,2749,31973,192,101,91
11650,36068,4077,17460,2752,31991,192,101,91
11655,36078,4078,17466,2753,32000,192,101,91
11660,36099,4082,17478,2756,32017,192,101,91
11665,36109,4083,17485,2756,32026,192,101,91
11670,36130,4086,17496,2758,32044,192,101,91
11675,36140,4087,17502,2759,32053,192,101,91
11680,36161,4091,17514,2763,32070,192,101,91
11685,36171,4091,17516,2763,32080,192,101,91
11690,36192,4096,17522,2766,32096,192,101,91
11695,36202,4096,17527,2766,32106,192,101,91
11700,36223,4101,17540,2770,32121,192,101,91
11705,36233,4102,17546,2771,32131,192,101,91
11710,36254,4104,17556,2773,32150,192,101,91
11715,36264,4104,17562,2773,32160,192,101,91
11720,36285,4106,17576,2774,32179,192,101,91
11725,36295,4106,17581,2774,32189,192,101,91
11730,36316,4108,17590,2774,32208,192,101,91
11735,36326,4108,17594,2774,32218,192,101,91
11740,36347,4110,17601,2776,32237,192,101,91
11745,36357,4110,17606,2776,32247,192,101,91
11750,36378,4112,17617,2778,32266,192,101,91
11755,36388,4112,17624,2778,32276,192,101,91
11760,36409,4114,17633,2780,32295,192,101,91
11765,36419,4116,17639,2782,32303,192,101,91
11770,36440,4119,17649,2783,32321,192,101,91
11775,36450,4121,17651,2784,32329,192,101,91
11780,36471,4123,17660,2785,32348,192,101,91
11785,36481,4124,17663,2785,32357,192,101,91
11790,36502,4127,17674,2786,32373,192,101,91
11795,36512,4130,17678,2789,32382,192,101,91
11800,36533,4134,17690,2793,32398,192,101,91
11805,36543,4137,17695,2796,32406,192,101,91
11810,36564,4144,17703,2802,32420,192,101,91
11815,36574,4146,17707,2803,32428,192,101,91
11820,36595,4151,17716,2805,32442,192,101,91
11825,36605,4154,17722,2808,32451,192,101,91
11830,36626,4155,17730,2808,32471,192,101,91
11835,36636,4156,17732,2809,32480,192,101,91
11840,36657,4157,17743,2809,32500,192,101,91
11845,36667,4158,17748,2809,32509,192,101,91
11850,36688,4159,17757,2809,32529,192,101,91
11855,36698,4160,17763,2809,32538,192,101,91
11860,36719,4161,17770,2810,32558,192,101,91
11865,36729,4162,17774,2810,32567,192,101,91
11870,36750,4163,17785,2811,32587,192,101,91
11875,36760,4164,17790,2811,32596,192,101,91
11880,36781,4165,17799,2812,32616,192,101,91
11885,36791,4167,17807,2814,32624,192,101,91
11890,36812,4170,17817,2816,32642,192,101,91
11895,36822,4172,17822,2818,32650,192,101,91
11900,36843,4174,17829,2819,32669,192,101,91
11905,36853,4175,17833,2819,32678,192,101,91
11910,36874,4176,17844,2820,32698,192,101,91
11915,36884,4177,17848,2820,32707,192,101,91
11920,36905,4179,17858,2822,32726,192,101,91
11925,36915,4181,17863,2823,32734,192,101,91
11930,36936,4184,17870,2824,32752,192,101,91
11935,36946,4186,17875,2825,32760,192,101,91
11940,36967,4190,17885,2828,32777,192,101,91
11945,36977,4190,17889,2828,32787,192,101,91
11950,36998,4192,17896,2829,32806,192,101,91
11955,37008,4193,17903,2830,32815,192,101,91
11960,37029,4195,17913,2832,32834,192,101,91
11965,37039,4195,17919,2832,32844,192,101,91
11970,37060,4199,17930,2835,32861,192,101,91
11975,37070,4199,17936,2835,32871,192,101,91
11980,37091,4202,17946,2837,32889,192,101,91
11985,37101,4202,17951,2837,32899,192,101,91
11990,37122,4206,17962,2840,32916,192,101,91
11995,37132,4206,17964,2840,32925,192,101,91
12000,37153,4210,17975,2843,32943,192,101,91
12005,37163,4211,17979,2844,32952,192,101,91
12010,37184,4212,17986,2845,32972,192,101,91
12015,37194,4212,17990,2845,32982,192,101,91
12020,37215,4213,17995,2845,33002,192,101,91
12025,37225,4213,17999,2845,33012,192,101,91
12030,37246,4215,18010,2846,33031,192,101,91
12035,37256,4215,18013,2846,33041,192,101,91
12040,37277,4217,18025,2848,33060,192,101,91
12045,37287,4218,18032,2849,33069,192,101,91
12050,37308,4220,18044,2850,33087,192,101,91
12055,37318,4222,18050,2851,33096,192,101,91
12060,37339,4225,18061,2853,33113,192,101,91
12065,37349,4227,18067,2855,33122,192,101,91
12070,37370,4228,18081,2856,33142,192,101,91
12075,37380,4230,18087,2858,33150,192,101,91
12080,37401,4230,18098,2858,33171,192,101,91
12085,37411,4232,18103,2860,33179,192,101,91
12090,37432,4232,18114,2860,33200,192,101,91
12095,37442,4233,18119,2860,33209,192,101,91
12100,37463,4234,18129,2861,33229,192,101,91
12105,37473,4236,18132,2862,33236,192,101,91
12110,37494,4238,18137,2863,33256,192,101,91
12115,37504,4238,18139,2863,33266,192,101,91
12120,37525,4240,18146,2864,33285,192,101,91
12125,37535,4241,18151,2865,33294,192,101,91
12130,37556,4245,18165,2869,33311,192,101,91
12135,37566,4245,18170,2869,33321,192,101,91
12140,37587,4246,18182,2869,33341,192,101,91
12145,37597,4246,18188,2869,33351,192,101,91
12150,37618,4247,18197,2869,33371,192,101,91
12155,37628,4247,18201,2869,33381,192,101,91
12160,37649,4248,18208,2870,33401,192,101,91
12165,37659,4249,18215,2871,33410,192,101,91
12170,37680,4251,18227,2872,33429,192,101,91
12175,37690,4251,18232,2872,33439,192,101,91
12180,37711,4253,18238,2873,33458,192,101,91
12185,37721,4255,18243,2875,33465,192,101,91
12190,37742,4260,18257,2880,33481,192,101,91
12195,37752,4262,18262,2882,33489,192,101,91
12200,37773,4266,18272,2885,33507,192,101,91
12205,37783,4267,18279,2886,33515,192,101,91
12210,37804,4271,18287,2888,33532,192,101,91
12215,37814,4274,18292,2891,33540,192,101,91
12220,37835,4278,18303,2893,33557,192,101,91
12225,37845,4280,18307,2895,33565,192,101,91
12230,37866,4284,18315,2897,33582,192,101,91
12235,37876,4286,18322,2899,33589,192,101,91
12240,37897,4292,18330,2902,33605,192,101,91
12245,37907,4293,18335,2903,33614,192,101,91
12250,37928,4294,18347,2904,33634,192,101,91
12255,37938,4294,18351,2904,33644,192,101,91
12260,37959,4298,18360,2908,33661,192,101,91
12265,37969,4298,18366,2908,33671,192,101,91
12270,37990,4301,18377,2910,33688,192,101,91
12275,38000,4302,18381,2911,33698,192,101,91
12280,38021,4305,18391,2913,33716,192,101,91
12285,38031,4305,18400,2913,33726,192,101,91
12290,38052,4307,18410,2914,33744,192,101,91
12295,38062,4308,18417,2915,33754,192,101,91
12300,38083,4309,18429,2916,33774,192,101,91
12305,38093,4310,18434,2917,33783,192,101,91
12310,38114,4312,18445,2919,33802,192,101,91
12315,38124,4312,18451,2919,33812,192,101,91
12320,38145,4314,18459,2921,33831,192,101,91
12325,38155,4315,18463,2922,33840,192,101,91
12330,38176,4317,18477,2924,33859,192,101,91
12335,38186,4317,18481,2924,33869,192,101,91
12340,38207,4318,18489,2924,33889,192,101,91
12345,38217,4319,18492,2925,33898,192,101,91
12350,38238,4323,18503,2928,33914,192,101,91
12355,38248,4326,18507,2931,33922,192,101,91
12360,38269,4330,18518,2935,33939,192,101,91
12365,38279,4331,18524,2935,33948,192,101,91
12370,38300,4334,18532,2937,33966,192,101,91
12375,38310,4336,18536,2938,33974,192,101,91
12380,38331,4339,18546,2940,33992,192,101,91
12385,38341,4342,18552,2943,33999,192,101,91
12390,38362,4345,18561,2945,34016,192,101,91
12395,38372,4348,18566,2948,34024,192,101,91
12400,38393,4352,18576,2951,34040,192,101,91
12405,38403,4356,18581,2954,34047,192,101,91
12410,38424,4360,18590,2956,34064,192,101,91
12415,38434,4363,18595,2959,34070,192,101,91
12420,38455,4365,18608,2961,34090,192,101,91
12425,38465,4366,18609,2961,34099,192,101,91
12430,38486,4367,18614,2962,34119,192,101,91
12435,38496,4368,18617,2962,34127,192,101,91
12440,38517,4370,18629,2964,34147,192,101,91
12445,38527,4371,18635,2965,34155,192,101,91
12450,38548,4373,18642,2966,34175,192,101,91
12455,38558,4375,18647,2967,34182,192,101,91
12460,38579,4377,18658,2968,34202,192,101,91
12465,38589,4378,18662,2968,34211,192,101,91
12470,38610,4379,18670,2968,34231,192,101,91
12475,38620,4381,18676,2970,34238,192,101,91
12480,38641,4383,18686,2972,34257,192,101,91
12485,38651,4384,18689,2973,34267,192,101,91
12490,38672,4385,18699,2974,34287,192,101,91
12495,38682,4385,18704,2974,34297,192,101,91
12500,38703,4385,18711,2974,34318,192,101,91
12505,38713,4385,18715,2974,34328,192,101,91
12510,38734,4385,18729,2974,34349,192,101,91
12515,38744,4385,18736,2974,34359,192,101,91
12520,38765,4385,18749,2974,34380,192,101,91
12525,38775,4385,18754,2974,34389,192,101,91
12530,38796,4387,18760,2975,34408,192,101,91
12535,38806,4388,18763,2976,34418,192,101,91
12540,38827,4389,18774,2977,34437,192,101,91
12545,38837,4392,18780,2980,34445,192,101,91
12550,38858,4396,18794,2984,34462,192,101,91
12555,38868,4398,18801,2986,34470,192,101,91
12560,38889,4402,18813,2989,34487,192,101,91
12565,38899,4404,18820,2990,34495,192,101,91
12570,38920,4407,18827,2991,34513,192,101,91
12575,38930,4409,18831,2993,34521,192,101,91
12580,38951,4413,18844,2996,34538,192,101,91
12585,38961,4414,18849,2996,34547,192,101,91
12590,38982,4419,18858,2999,34563,192,101,91
12595,38992,4422,18865,3002,34570,192,101,91
12600,39013,4425,18871,3003,34588,192,101,91
12605,39023,4426,18878,3004,34597,192,101,91
12610,39044,4430,18894,3008,34614,192,101,91
12615,39054,4430,18896,3008,34624,192,101,91
12620,39075,4432,18907,3010,34643,192,101,91
12625,39085,4433,18913,3011,34652,192,101,91
12630,39106,4436,18922,3013,34670,192,101,91
12635,39116,4437,18927,3014,34679,192,101,91
12640,39137,4440,18937,3017,34697,192,101,91
12645,39147,4440,18942,3017,34707,192,101,91
12650,39168,4441,18952,3018,34727,192,101,91
12655,39178,4441,18958,3018,34736,192,101,91
12660,39199,4443,18970,3019,34755,192,101,91
12665,39209,4446,18976,3022,34763,192,101,91
12670,39230,4447,18987,3023,34783,192,101,91
12675,39240,4448,18992,3023,34792,192,101,91
12680,39261,4449,19000,3023,34812,192,101,91
12685,39271,4450,19004,3023,34821,192,101,91
12690,39292,4451,19014,3023,34841,192,101,91
12695,39302,4453,19021,3025,34849,192,101,91
12700,39323,4454,19033,3026,34869,192,101,91
12705,39333,4456,19038,3028,34877,192,101,91
12710,39354,4458,19053,3029,34896,192,101,91
12715,39364,4459,19061,3030,34905,192,101,91
12720,39385,4460,19069,3031,34925,192,101,91
12725,39395,4461,19074,3031,34934,192,101,91
12730,39416,4464,19083,3034,34952,192,101,91
12735,39426,4465,19087,3035,34961,192,101,91
12740,39447,4467,19096,3036,34980,192,101,91
12745,39457,4468,19099,3037,34989,192,101,91
12750,39478,4471,19113,3038,35007,192,101,91
12755,39488,4472,19118,3038,35016,192,101,91
12760,39509,4475,19132,3040,35034,192,101,91
12765,39519,4476,19137,3040,35043,192,101,91
12770,39540,4479,19149,3043,35060,192,101,91
12775,39550,4482,19155,3045,35068,192,101,91
12780,39571,4484,19165,3045,35086,192,101,91
12785,39581,4487,19169,3048,35094,192,101,91
12790,39602,4490,19177,3050,35112,192,101,91
12795,39612,4491,19182,3051,35121,192,101,91
12800,39633,4494,19193,3053,35139,192,101,91
12805,39643,4495,19201,3054,35148,192,101,91
12810,39664,4498,19212,3056,35166,192,101,91
12815,39674,4499,19216,3057,35175,192,101,91
12820,39695,4502,19227,3060,35193,192,101,91
12825,39705,4502,19231,3060,35203,192,101,91
12830,39726,4505,19242,3062,35221,192,101,91
12835,39736,4507,19249,3064,35228,192,101,91
12840,39757,4513,19259,3069,35243,192,101,91
12845,39767,4515,19261,3070,35251,192,101,91
12850,39788,4517,19267,3071,35271,192,101,91
12855,39798,4517,19271,3071,35281,192,101,91
12860,39819,4518,19285,3072,35301,192,101,91
12865,39829,4518,19291,3072,35310,192,101,91
12870,39850,4520,19300,3074,35330,192,101,91
12875,39860,4521,19304,3075,35338,192,101,91
12880,39881,4523,19311,3077,35358,192,101,91
12885,39891,4524,19316,3078,35366,192,101,91
12890,39912,4527,19327,3081,35385,192,101,91
12895,39922,4528,19329,3082,35394,192,101,91
12900,39943,4530,19338,3084,35413,192,101,91
12905,39953,4530,19342,3084,35423,192,101,91
12910,39974,4530,19350,3084,35444,192,101,91
12915,39984,4530,19354,3084,35454,192,101,91
12920,40005,4530,19360,3084,35475,192,101,91
12925,40015,4530,19366,3084,35485,192,101,91
12930,40036,4530,19374,3084,35506,192,101,91
12935,40046,4530,19380,3084,35516,192,101,91
12940,40067,4530,19398,3084,35537,192,101,91
12945,40077,4530,19403,3084,35547,192,101,91
12950,40098,4530,19408,3084,35568,192,101,91
12955,40108,4531,19413,3084,35577,192,101,91
12960,40129,4533,19424,3086,35596,192,101,91
12965,40139,4534,19432,3087,35605,192,101,91
12970,40160,4538,19441,3089,35621,192,101,91
12975,40170,4539,19444,3090,35631,192,101,91
12980,40191,4543,19456,3093,35648,192,101,91
12985,40201,4543,19457,3093,35658,192,101,91
12990,40222,4545,19464,3094,35677,192,101,91
12995,40232,4545,19468,3094,35687,192,101,91
13000,40253,4549,19481,3097,35704,192,101,91
13005,40263,4549,19484,3097,35714,192,101,91
13010,40284,4554,19494,3102,35730,192,101,91
13015,40294,4554,19496,3102,35740,192,101,91
13020,40315,4558,19511,3105,35757,192,101,91
13025,40325,4558,19514,3105,35767,192,101,91
13030,40346,4560,19524,3107,35786,192,101,91
13035,40356,4560,19531,3107,35796,192,101,91
13040,40377,4562,19538,3108,35815,192,101,91
13045,40387,4562,19541,3108,35825,192,101,91
13050,40408,4564,19552,3109,35844,192,101,91
13055,40418,4564,19556,3109,35854,192,101,91
13060,40439,4566,19563,3110,35873,192,101,91
13065,40449,4566,19567,3110,35882,192,101,91
13070,40470,4569,19581,3113,35901,192,101,91
13075,40480,4570,19587,3114,35909,192,101,91
13080,40501,4574,19598,3118,35926,192,101,91
13085,40511,4575,19601,3119,35936,192,101,91
13090,40532,4576,19609,3120,35956,192,101,91
13095,40542,4577,19611,3121,35965,192,101,91
13100,40563,4578,19619,3121,35985,192,101,91
13105,40573,4578,19625,3121,35995,192,101,91
13110,40594,4579,19635,3122,36015,192,101,91
13115,40604,4580,19639,3123,36024,192,101,91
13120,40625,4581,19650,3124,36044,192,101,91
13125,40635,4582,19654,3125,36053,192,101,91
13130,40656,4583,19664,3125,36073,192,101,91
13135,40666,4583,19665,3125,36083,192,101,91
13140,40687,4584,19672,3126,36103,192,101,91
13145,40697,4584,19677,3126,36113,192,101,91
13150,40718,4588,19682,3129,36130,192,101,91
13155,40728,4588,19689,3129,36140,192,101,91
13160,40749,4592,19698,3131,36157,192,101,91
13165,40759,4592,19703,3131,36167,192,101,91
13170,40780,4595,19714,3132,36185,192,101,91
13175,40790,4595,19721,3132,36195,192,101,91
13180,40811,4597,19730,3133,36214,192,101,91
13185,40821,4597,19733,3133,36224,192,101,91
13190,40842,4599,19742,3135,36243,192,101,91
13195,40852,4601,19749,3137,36251,192,101,91
13200,40873,4605,19760,3141,36267,192,101,91
13205,40883,4607,19765,3143,36276,192,101,91
13210,40904,4607,19775,3143,36296,192,101,91
13215,40914,4609,19781,3144,36305,192,101,91
13220,40935,4609,19791,3144,36326,192,101,91
13225,40945,4609,19800,3144,36336,192,101,91
13230,40966,4609,19806,3144,36357,192,101,91
13235,40976,4609,19811,3144,36367,192,101,91
13240,40997,4609,19821,3144,36388,192,101,91
13245,41007,4609,19828,3144,36398,192,101,91
13250,41028,4609,19838,3144,36419,192,101,91
13255,41038,4609,19847,3144,36429,192,101,91
13260,41059,4610,19858,3144,36449,192,101,91
13265,41069,4613,19864,3147,36456,192,101,91
13270,41090,4617,19876,3150,36472,192,101,91
13275,41100,4620,19881,3153,36480,192,101,91
13280,41121,4622,19893,3154,36499,192,101,91
13285,41131,4623,19900,3155,36507,192,101,91
13290,41152,4626,19911,3157,36526,192,101,91
13295,41162,4626,19916,3157,36535,192,101,91
13300,41183,4630,19931,3160,36552,192,101,91
13305,41193,4633,19939,3163,36559,192,101,91
13310,41214,4636,19948,3165,36578,192,101,91
13315,41224,4636,19954,3165,36588,192,101,91
13320,41245,4637,19962,3165,36608,192,101,91
13325,41255,4637,19967,3165,36618,192,101,91
13330,41276,4638,19978,3165,36638,192,101,91
13335,41286,4638,19983,3165,36648,192,101,91
13340,41307,4639,19993,3166,36668,192,101,91
13345,41317,4639,19997,3166,36678,192,101,91
13350,41338,4640,20008,3167,36698,192,101,91
13355,41348,4640,20014,3167,36708,192,101,91
13360,41369,4641,20023,3167,36728,192,101,91
13365,41379,4641,20028,3167,36738,192,101,91
13370,41400,4643,20036,3169,36757,192,101,91
13375,41410,4644,20039,3169,36766,192,101,91
13380,41431,4648,20048,3172,36783,192,101,91
13385,41441,4650,20051,3174,36791,192,101,91
13390,41462,4652,20058,3175,36810,192,101,91
13395,41472,4653,20060,3175,36819,192,101,91
13400,41493,4655,20067,3175,36838,192,101,91
13405,41503,4656,20072,3176,36847,192,101,91
13410,41524,4661,20084,3180,36863,192,101,91
13415,41534,4662,20089,3181,36872,192,101,91
13420,41555,4665,20098,3183,36890,192,101,91
13425,41565,4668,20106,3185,36896,192,101,91
13430,41586,4673,20115,3189,36913,192,101,91
13435,41596,4675,20123,3191,36920,192,101,91
13440,41617,4680,20136,3194,36937,192,101,91
13445,41627,4683,20142,3196,36944,192,101,91
13450,41648,4686,20150,3197,36962,192,101,91
13455,41658,4687,20154,3198,36971,192,101,91
13460,41679,4688,20166,3198,36990,192,101,91
13465,41689,4690,20172,3199,36998,192,101,91
13470,41710,4692,20183,3200,37016,192,101,91
13475,41720,4695,20188,3203,37025,192,101,91
13480,41741,4696,20201,3204,37045,192,101,91
13485,41751,4697,20207,3205,37053,192,101,91
13490,41772,4699,20217,3206,37072,192,101,91
13495,41782,4701,20221,3207,37081,192,101,91
13500,41803,4704,20227,3209,37099,192,101,91
13505,41813,4704,20234,3209,37109,192,101,91
13510,41834,4705,20242,3210,37129,192,101,91
13515,41844,4705,20249,3210,37139,192,101,91
13520,41865,4706,20259,3210,37159,192,101,91
13525,41875,4706,20264,3210,37169,192,101,91
13530,41896,4707,20273,3210,37189,192,101,91
13535,41906,4707,20277,3210,37199,192,101,91
13540,41927,4708,20288,3210,37219,192,101,91
13545,41937,4709,20291,3211,37228,192,101,91
13550,41958,4710,20301,3212,37248,192,101,91
13555,41968,4710,20303,3212,37258,192,101,91
13560,41989,4712,20315,3212,37277,192,101,91
13565,41999,4713,20322,3213,37285,192,101,91
13570,42020,4717,20330,3215,37303,192,101,91
13575,42030,4717,20334,3215,37312,192,101,91
13580,42051,4721,20342,3218,37330,192,101,91
13585,42061,4722,20347,3219,37338,192,101,91
13590,42082,4725,20358,3221,37357,192,101,91
13595,42092,4725,20362,3221,37366,192,101,91
13600,42113,4728,20371,3222,37385,192,101,91
13605,42123,4729,20376,3223,37394,192,101,91
13610,42144,4731,20387,3224,37412,192,101,91
13615,42154,4733,20390,3225,37421,192,101,91
13620,42175,4735,20401,3227,37439,192,101,91
13625,42185,4737,20409,3229,37448,192,101,91
13630,42206,4737,20420,3229,37469,192,101,91
13635,42216,4738,20427,3230,37478,192,101,91
13640,42237,4738,20439,3230,37499,192,101,91
13645,42247,4739,20445,3230,37508,192,101,91
13650,42268,4739,20452,3230,37529,192,101,91
13655,42278,4740,20459,3231,37538,192,101,91
13660,42299,4740,20469,3231,37559,192,101,91
13665,42309,4741,20472,3231,37568,192,101,91
13670,42330,4741,20483,3231,37589,192,101,91
13675,42340,4742,20490,3232,37598,192,101,91
13680,42361,4742,20499,3232,37619,192,101,91
13685,42371,4743,20503,3232,37628,192,101,91
13690,42392,4745,20512,3233,37647,192,101,91
13695,42402,4746,20516,3233,37655,192,101,91
13700,42423,4749,20527,3236,37674,192,101,91
13705,42433,4750,20530,3236,37683,192,101,91
13710,42454,4751,20543,3236,37703,192,101,91
13715,42464,4753,20546,3237,37710,192,101,91
13720,42485,4755,20556,3238,37730,192,101,91
13725,42495,4756,20559,3238,37739,192,101,91
13730,42516,4760,20570,3242,37756,192,101,91
13735,42526,4762,20575,3244,37763,192,101,91
13740,42547,4768,20588,3249,37779,192,101,91
13745,42557,4768,20594,3249,37789,192,101,91
13750,42578,4770,20604,3250,37808,192,101,91
13755,42588,4770,20611,3250,37818,192,101,91
13760,42609,4772,20620,3251,37837,192,101,91
13765,42619,4772,20622,3251,37847,192,101,91
13770,42640,4773,20631,3252,37867,192,101,91
13775,42650,4773,20636,3252,37877,192,101,91
13780,42671,4774,20649,3253,37897,192,101,91
13785,42681,4774,20651,3253,37907,192,101,91
13790,42702,4775,20658,3253,37927,192,101,91
13795,42712,4775,20665,3253,37937,192,101,91
13800,42733,4776,20675,3253,37957,192,101,91
13805,42743,4776,20682,3253,37967,192,101,91
13810,42764,4778,20691,3255,37986,192,101,91
13815,42774,4778,20694,3255,37996,192,101,91
13820,42795,4780,20706,3257,38015,192,101,91
13825,42805,4780,20710,3257,38025,192,101,91
13830,42826,4782,20722,3258,38044,192,101,91
13835,42836,4782,20727,3258,38054,192,101,91
13840,42857,4784,20740,3260,38073,192,101,91
13845,42867,4784,20746,3260,38082,192,101,91
13850,42888,4789,20756,3263,38099,192,101,91
13855,42898,4791,20759,3264,38107,192,101,91
13860,42919,4797,20767,3268,38121,192,101,91
13865,42929,4799,20771,3269,38130,192,101,91
13870,42950,4799,20782,3269,38150,192,101,91
13875,42960,4801,20788,3271,38159,192,101,91
13880,42981,4802,20794,3272,38178,192,101,91
13885,42991,4804,20795,3273,38187,192,101,91
13890,43012,4804,20805,3273,38208,192,101,91
13895,43022,4805,20809,3274,38217,192,101,91
13900,43043,4805,20822,3274,38238,192,101,91
13905,43053,4806,20825,3274,38247,192,101,91
13910,43074,4806,20832,3274,38268,192,101,91
13915,43084,4807,20838,3274,38277,192,101,91
13920,43105,4808,20848,3275,38297,192,101,91
13925,43115,4809,20853,3276,38306,192,101,91
13930,43136,4809,20857,3276,38327,192,101,91
13935,43146,4810,20861,3276,38336,192,101,91
13940,43167,4810,20869,3276,38357,192,101,91
13945,43177,4811,20875,3277,38366,192,101,91
13950,43198,4811,20886,3277,38387,192,101,91
13955,43208,4812,20891,3277,38396,192,101,91
13960,43229,4812,20900,3277,38417,192,101,91
13965,43239,4813,20902,3277,38426,192,101,91
13970,43260,4816,20910,3278,38443,192,101,91
13975,43270,4819,20915,3281,38450,192,101,91
13980,43291,4825,20927,3287,38466,192,101,91
13985,43301,4826,20934,3288,38475,192,101,91
13990,43322,4827,20945,3289,38495,192,101,91
13995,43332,4827,20948,3289,38505,192,101,91
14000,43353,4828,20959,3290,38525,192,101,91
14005,43363,4828,20964,3290,38535,192,101,91
14010,43384,4829,20971,3291,38555,192,101,91
14015,43394,4829,20974,3291,38565,192,101,91
14020,43415,4830,20981,3292,38585,192,101,91
14025,43425,4830,20986,3292,38595,192,101,91
14030,43446,4831,21000,3293,38615,192,101,91
14035,43456,4831,21006,3293,38625,192,101,91
14040,43477,4832,21014,3294,38645,192,101,91
14045,43487,4832,21016,3294,38655,192,101,91
14050,43508,4833,21027,3295,38675,192,101,91
14055,43518,4833,21034,3295,38685,192,101,91
14060,43539,4834,21044,3295,38705,192,101,91
14065,43549,4834,21048,3295,38715,192,101,91
14070,43570,4835,21061,3296,38735,192,101,91
14075,43580,4835,21066,3296,38745,192,101,91
14080,43601,4836,21074,3296,38765,192,101,91
14085,43611,4837,21079,3297,38774,192,101,91
14090,43632,4843,21094,3303,38788,192,101,91
14095,43642,4845,21100,3305,38797,192,101,91
14100,43663,4849,21112,3308,38814,192,101,91
14105,43673,4850,21116,3309,38823,192,101,91
14110,43694,4851,21129,3309,38843,192,101,91
14115,43704,4851,21133,3309,38853,192,101,91
14120,43725,4852,21139,3310,38873,192,101,91
14125,43735,4852,21143,3310,38883,192,101,91
14130,43756,4853,21153,3311,38903,192,101,91
14135,43766,4853,21161,3311,38913,192,101,91
14140,43787,4854,21168,3311,38933,192,101,91
14145,43797,4854,21175,3311,38943,192,101,91
14150,43818,4855,21187,3312,38963,192,101,91
14155,43828,4855,21193,3312,38973,192,101,91
14160,43849,4856,21202,3313,38993,192,101,91
14165,43859,4856,21207,3313,39003,192,101,91
14170,43880,4857,21216,3313,39023,192,101,91
14175,43890,4857,21219,3313,39033,192,101,91
14180,43911,4858,21227,3314,39053,192,101,91
14185,43921,4858,21229,3314,39063,192,101,91
14190,43942,4859,21235,3315,39083,192,101,91
14195,43952,4859,21238,3315,39093,192,101,91
14200,43973,4860,21248,3316,39113,192,101,91
14205,43983,4860,21253,3316,39123,192,101,91
14210,44004,4863,21266,3319,39140,192,101,91
14215,44014,4865,21268,3320,39149,192,101,91
14220,44035,4871,21280,3326,39163,192,101,91
14225,44045,4874,21285,3329,39171,192,101,91
14230,44066,4877,21293,3330,39189,192,101,91
14235,44076,4878,21300,3331,39198,192,101,91
14240,44097,4880,21307,3331,39217,192,101,91
14245,44107,4880,21313,3331,39227,192,101,91
14250,44128,4882,21325,3333,39246,192,101,91
14255,44138,4882,21330,3333,39255,192,101,91
14260,44159,4884,21342,3334,39275,192,101,91
14265,44169,4884,21350,3334,39285,192,101,91
14270,44190,4886,21362,3336,39304,192,101,91
14275,44200,4886,21368,3336,39313,192,101,91
14280,44221,4889,21379,3338,39332,192,101,91
14285,44231,4890,21382,3339,39341,192,101,91
14290,44252,4892,21389,3341,39359,192,101,91
14295,44262,4894,21397,3343,39368,192,101,91
14300,44283,4896,21408,3344,39387,192,101,91
14305,44293,4897,21414,3345,39396,192,101,91
14310,44314,4898,21421,3345,39416,192,101,91
14315,44324,4899,21427,3345,39424,192,101,91
14320,44345,4901,21435,3346,39444,192,101,91
14325,44355,4902,21442,3346,39453,192,101,91
14330,44376,4905,21454,3348,39470,192,101,91
14335,44386,4908,21461,3351,39478,192,101,91
14340,44407,4912,21476,3355,39495,192,101,91
14345,44417,4913,21482,3356,39504,192,101,91
14350,44438,4915,21490,3357,39523,192,101,91
14355,44448,4916,21497,3358,39532,192,101,91
14360,44469,4918,21507,3359,39550,192,101,91
14365,44479,4920,21512,3361,39559,192,101,91
14370,44500,4923,21521,3363,39577,192,101,91
14375,44510,4923,21527,3363,39587,192,101,91
14380,44531,4925,21539,3364,39605,192,101,91
14385,44541,4928,21543,3367,39613,192,101,91
14390,44562,4932,21552,3369,39630,192,101,91
14395,44572,4932,21554,3369,39640,192,101,91
14400,44593,4935,21564,3372,39658,192,101,91
14405,44603,4936,21572,3373,39667,192,101,91
14410,44624,4938,21577,3374,39686,192,101,91
14415,44634,4938,21585,3374,39696,192,101,91
14420,44655,4941,21593,3377,39714,192,101,91
14425,44665,4941,21598,3377,39724,192,101,91
14430,44686,4944,21605,3379,39742,192,101,91
14435,44696,4944,21610,3379,39752,192,101,91
14440,44717,4946,21619,3380,39771,192,101,91
14445,44727,4946,21624,3380,39780,192,101,91
14450,44748,4951,21632,3383,39797,192,101,91
14455,44758,4952,21634,3383,39806,192,101,91
14460,44779,4956,21643,3385,39821,192,101,91
14465,44789,4958,21648,3387,39830,192,101,91
14470,44810,4960,21655,3388,39850,192,101,91
14475,44820,4960,21659,3388,39859,192,101,91
14480,44841,4962,21669,3390,39879,192,101,91
14485,44851,4962,21673,3390,39889,192,101,91
14490,44872,4963,21680,3391,39909,192,101,91
14495,44882,4963,21686,3391,39918,192,101,91
14500,44903,4965,21695,3393,39938,192,101,91
14505,44913,4965,21699,3393,39948,192,101,91
14510,44934,4967,21711,3394,39967,192,101,91
14515,44944,4967,21718,3394,39976,192,101,91
14520,44965,4969,21730,3396,39996,192,101,91
14525,44975,4969,21736,3396,40005,192,101,91
14530,44996,4974,21749,3399,40022,192,101,91
14535,45006,4975,21756,3400,40031,192,101,91
14540,45027,4976,21766,3401,40051,192,101,91
14545,45037,4976,21768,3401,40061,192,101,91
14550,45058,4978,21776,3403,40080,192,101,91
14555,45068,4978,21778,3403,40090,192,101,91
14560,45089,4980,21789,3404,40109,192,101,91
14565,45099,4980,21792,3404,40119,192,101,91
14570,45120,4983,21804,3406,40137,192,101,91
14575,45130,4985,21809,3408,40145,192,101,91
14580,45151,4988,21817,3411,40161,192,101,91
14585,45161,4991,21820,3413,40170,192,101,91
14590,45182,4993,21831,3414,40189,192,101,91
14595,45192,4993,21836,3414,40199,192,101,91
14600,45213,4994,21846,3414,40219,192,101,91
14605,45223,4994,21852,3414,40229,192,101,91
14610,45244,4995,21864,3414,40249,192,101,91
14615,45254,4995,21868,3414,40259,192,101,91
14620,45275,4996,21876,3414,40279,192,101,91
14625,45285,4996,21881,3414,40289,192,101,91
14630,45306,4997,21889,3414,40309,192,101,91
14635,45316,4997,21891,3414,40319,192,101,91
14640,45337,4998,21902,3415,40339,192,101,91
14645,45347,4998,21910,3415,40349,192,101,91
14650,45368,5001,21921,3417,40367,192,101,91
14655,45378,5002,21928,3418,40376,192,101,91
14660,45399,5005,21937,3420,40394,192,101,91
14665,45409,5005,21943,3420,40404,192,101,91
14670,45430,5007,21955,3420,40423,192,101,91
14675,45440,5008,21959,3421,40432,192,101,91
14680,45461,5010,21966,3421,40451,192,101,91
14685,45471,5010,21971,3421,40461,192,101,91
14690,45492,5014,21979,3425,40478,192,101,91
14695,45502,5018,21986,3428,40484,192,101,91
14700,45523,5020,21996,3429,40502,192,101,91
14705,45533,5022,21999,3430,40511,192,101,91
14710,45554,5026,22010,3433,40527,192,101,91
14715,45564,5029,22015,3436,40535,192,101,91
14720,45585,5030,22029,3437,40554,192,101,91
14725,45595,5031,22034,3438,40564,192,101,91
14730,45616,5033,22048,3440,40583,192,101,91
14735,45626,5033,22055,3440,40593,192,101,91
14740,45647,5035,22065,3442,40612,192,101,91
14745,45657,5035,22067,3442,40622,192,101,91
14750,45678,5035,22075,3442,40643,192,101,91
14755,45688,5035,22080,3442,40653,192,101,91
14760,45709,5035,22087,3442,40674,192,101,91
14765,45719,5035,22094,3442,40684,192,101,91
14770,45740,5035,22103,3442,40705,192,101,91
14775,45750,5035,22108,3442,40715,192,101,91
14780,45771,5035,22116,3442,40736,192,101,91
14785,45781,5035,22123,3442,40746,192,101,91
14790,45802,5035,22134,3442,40767,192,101,91
14795,45812,5035,22139,3442,40777,192,101,91
14800,45833,5035,22149,3442,40798,192,101,91
14805,45843,5035,22155,3442,40808,192,101,91
14810,45864,5037,22168,3443,40827,192,101,91
14815,45874,5037,22176,3443,40837,192,101,91
14820,45895,5042,22187,3448,40852,192,101,91
14825,45905,5045,22193,3450,40860,192,101,91
14830,45926,5048,22205,3451,40876,192,101,91
14835,45936,5052,22211,3455,40884,192,101,91
14840,45957,5055,22224,3455,40900,192,101,91
14845,45967,5059,22227,3458,40908,192,101,91
14850,45988,5064,22236,3462,40924,192,101,91
14855,45998,5065,22241,3462,40933,192,101,91
14860,46019,5069,22251,3465,40950,192,101,91
14865,46029,5070,22257,3465,40959,192,101,91
14870,46050,5074,22265,3467,40976,192,101,91
14875,46060,5076,22270,3469,40984,192,101,91
14880,46081,5080,22276,3471,41001,192,101,91
14885,46091,5080,22281,3471,41011,192,101,91
14890,46112,5084,22293,3475,41028,192,101,91
14895,46122,5084,22298,3475,41038,192,101,91
14900,46143,5088,22308,3478,41055,192,101,91
14905,46153,5088,22313,3478,41065,192,101,91
14910,46174,5092,22321,3480,41082,192,101,91
14915,46184,5092,22327,3480,41092,192,101,91
14920,46205,5094,22342,3481,41111,192,101,91
14925,46215,5094,22347,3481,41121,192,101,91
14930,46236,5095,22356,3481,41141,192,101,91
14935,46246,5096,22363,3482,41150,192,101,91
14940,46267,5098,22373,3484,41169,192,101,91
14945,46277,5099,22378,3485,41178,192,101,91
14950,46298,5100,22390,3486,41198,192,101,91
14955,46308,5101,22396,3486,41207,192,101,91
14960,46329,5101,22407,3486,41228,192,101,91
14965,46339,5102,22413,3486,41237,192,101,91
14970,46360,5102,22423,3486,41258,192,101,91
14975,46370,5103,22428,3487,41267,192,101,91
14980,46391,5103,22437,3487,41288,192,101,91
14985,46401,5104,22443,3487,41297,192,101,91
14990,46422,5105,22450,3487,41317,192,101,91
14995,46432,5107,22457,3488,41325,192,101,91
15000,46453,5109,22471,3489,41344,192,101,91
15005,46463,5110,22475,3489,41353,192,101,91
15010,46484,5113,22480,3491,41371,192,101,91
15015,46494,5114,22486,3491,41380,192,101,91
15020,46515,5116,22495,3492,41399,192,101,91
15025,46525,5117,22501,3492,41408,192,101,91
15030,46546,5119,22509,3493,41427,192,101,91
15035,46556,5120,22512,3493,41436,192,101,91
15040,46577,5122,22523,3495,41455,192,101,91
15045,46587,5123,22529,3495,41464,192,101,91
15050,46608,5127,22540,3498,41481,192,101,91
15055,46618,5128,22544,3499,41490,192,101,91
15060,46639,5134,22552,3503,41505,192,101,91
15065,46649,5134,22559,3503,41515,192,101,91
15070,46670,5138,22571,3505,41532,192,101,91
15075,46680,5138,22574,3505,41542,192,101,91
15080,46701,5142,22587,3507,41559,192,101,91
15085,46711,5142,22591,3507,41569,192,101,91
15090,46732,5145,22602,3509,41587,192,101,91
15095,46742,5145,22607,3509,41597,192,101,91
15100,46763,5148,22617,3510,41615,192,101,91
15105,46773,5148,22624,3510,41624,192,101,91
15110,46794,5153,22635,3514,41641,192,101,91
15115,46804,5154,22639,3515,41650,192,101,91
15120,46825,5157,22643,3515,41668,192,101,91
15125,46835,5159,22648,3516,41675,192,101,91
15130,46856,5163,22658,3519,41692,192,101,91
15135,46866,5165,22664,3520,41701,192,101,91
15140,46887,5167,22673,3522,41720,192,101,91
15145,46897,5168,22677,3522,41729,192,101,91
15150,46918,5170,22687,3523,41748,192,101,91
15155,46928,5171,22694,3524,41757,192,101,91
15160,46949,5171,22706,3524,41778,192,101,91
15165,46959,5172,22712,3525,41787,192,101,91
15170,46980,5172,22724,3525,41808,192,101,91
15175,46990,5173,22730,3526,41817,192,101,91
15180,47011,5173,22741,3526,41838,192,101,91
15185,47021,5174,22744,3526,41846,192,101,91
15190,47042,5177,22751,3529,41865,192,101,91
15195,47052,5178,22755,3529,41874,192,101,91
15200,47073,5181,22766,3532,41892,192,101,91
15205,47083,5182,22769,3533,41901,192,101,91
15210,47104,5183,22781,3534,41921,192,101,91
15215,47114,5184,22787,3535,41930,192,101,91
15220,47135,5186,22797,3536,41949,192,101,91
15225,47145,5187,22799,3536,41958,192,101,91
15230,47166,5188,22807,3537,41978,192,101,91
15235,47176,5189,22812,3538,41986,192,101,91
15240,47197,5194,22819,3541,42003,192,101,91
15245,47207,5194,22826,3541,42013,192,101,91
15250,47228,5198,22839,3545,42030,192,101,91
15255,47238,5198,22844,3545,42040,192,101,91
15260,47259,5201,22855,3547,42058,192,101,91
15265,47269,5201,22857,3547,42068,192,101,91
15270,47290,5204,22865,3548,42086,192,101,91
15275,47300,5204,22870,3548,42096,192,101,91
15280,47321,5207,22879,3549,42114,192,101,91
15285,47331,5207,22882,3549,42124,192,101,91
15290,47352,5211,22893,3551,42141,192,101,91
15295,47362,5211,22898,3551,42151,192,101,91
15300,47383,5214,22906,3552,42169,192,101,91
15305,47393,5214,22912,3552,42179,192,101,91
15310,47414,5217,22920,3554,42197,192,101,91
15315,47424,5218,22923,3555,42206,192,101,91
15320,47445,5221,22929,3558,42224,192,101,91
15325,47455,5221,22931,3558,42234,192,101,91
15330,47476,5225,22941,3560,42251,192,101,91
15335,47486,5226,22946,3561,42260,192,101,91
15340,47507,5231,22959,3565,42276,192,101,91
15345,47517,5232,22961,3566,42285,192,101,91
15350,47538,5235,22965,3566,42303,192,101,91
15355,47548,5237,22968,3568,42311,192,101,91
15360,47569,5241,22975,3570,42328,192,101,91
15365,47579,5243,22982,3572,42336,192,101,91
15370,47600,5244,22994,3572,42356,192,101,91
15375,47610,5245,23000,3573,42365,192,101,91
15380,47631,5247,23011,3574,42384,192,101,91
15385,47641,5248,23017,3575,42393,192,101,91
15390,47662,5251,23025,3578,42411,192,101,91
15395,47672,5252,23030,3579,42420,192,101,91
15400,47693,5253,23044,3580,42440,192,101,91
15405,47703,5254,23049,3580,42449,192,101,91
15410,47724,5254,23062,3580,42470,192,101,91
15415,47734,5255,23069,3581,42479,192,101,91
15420,47755,5255,23080,3581,42500,192,101,91
15425,47765,5256,23087,3581,42509,192,101,91
15430,47786,5256,23096,3581,42530,192,101,91
15435,47796,5257,23102,3582,42539,192,101,91
15440,47817,5257,23112,3582,42560,192,101,91
15445,47827,5258,23118,3582,42569,192,101,91
15450,47848,5258,23130,3582,42589,192,101,91
15455,47858,5261,23134,3585,42597,192,101,91
15460,47879,5261,23142,3585,42618,192,101,91
15465,47889,5262,23144,3585,42627,192,101,91
15470,47910,5264,23149,3586,42646,192,101,91
15475,47920,5267,23154,3588,42652,192,101,91
15480,47941,5271,23165,3591,42669,192,101,91
15485,47951,5274,23171,3594,42676,192,101,91
15490,47972,5278,23180,3596,42694,192,101,91
15495,47982,5278,23184,3596,42704,192,101,91
15500,48003,5280,23195,3597,42722,192,101,91
15505,48013,5281,23200,3598,42732,192,101,91
15510,48034,5283,23209,3599,42751,192,101,91
15515,48044,5283,23216,3599,42761,192,101,91
15520,48065,5285,23225,3599,42780,192,101,91
15525,48075,5286,23232,3600,42789,192,101,91
15530,48096,5288,23240,3600,42808,192,101,91
15535,48106,5289,23246,3601,42817,192,101,91
15540,48127,5291,23256,3602,42836,192,101,91
15545,48137,5292,23263,3603,42845,192,101,91
15550,48158,5295,23276,3605,42863,192,101,91
15555,48168,5296,23282,3605,42872,192,101,91
15560,48189,5300,23291,3608,42889,192,101,91
15565,48199,5301,23295,3608,42898,192,101,91
15570,48220,5304,23302,3609,42916,192,101,91
15575,48230,5305,23305,3609,42925,192,101,91
15580,48251,5309,23316,3610,42942,192,101,91
15585,48261,5310,23323,3610,42951,192,101,91
15590,48282,5315,23333,3612,42966,192,101,91
15595,48292,5317,23337,3613,42975,192,101,91
15600,48313,5320,23348,3614,42992,192,101,91
15605,48323,5321,23352,3615,43002,192,101,91
15610,48344,5322,23363,3615,43022,192,101,91
15615,48354,5322,23370,3615,43032,192,101,91
15620,48375,5324,23376,3616,43051,192,101,91
15625,48385,5324,23380,3616,43061,192,101,91
15630,48406,5325,23388,3616,43081,192,101,91
15635,48416,5325,23391,3616,43091,192,101,91
15640,48437,5326,23403,3617,43111,192,101,91
15645,48447,5326,23409,3617,43121,192,101,91
15650,48468,5329,23420,3620,43139,192,101,91
15655,48478,5329,23424,3620,43149,192,101,91
15660,48499,5332,23435,3622,43167,192,101,91
15665,48509,5333,23440,3623,43176,192,101,91
15670,48530,5333,23450,3623,43197,192,101,91
15675,48540,5333,23456,3623,43207,192,101,91
15680,48561,5333,23467,3623,43228,192,101,91
15685,48571,5333,23471,3623,43238,192,101,91
15690,48592,5333,23477,3623,43259,192,101,91
15695,48602,5333,23482,3623,43269,192,101,91
15700,48623,5333,23493,3623,43290,192,101,91
15705,48633,5333,23497,3623,43300,192,101,91
15710,48654,5335,23509,3625,43319,192,101,91
15715,48664,5335,23513,3625,43329,192,101,91
15720,48685,5337,23527,3626,43348,192,101,91
15725,48695,5337,23530,3626,43358,192,101,91
15730,48716,5339,23540,3627,43377,192,101,91
15735,48726,5339,23546,3627,43387,192,101,91
15740,48747,5341,23560,3629,43406,192,101,91
15745,48757,5341,23563,3629,43416,192,101,91
15750,48778,5343,23573,3631,43435,192,101,91
15755,48788,5343,23578,3631,43445,192,101,91
15760,48809,5343,23584,3631,43466,192,101,91
15765,48819,5343,23590,3631,43476,192,101,91
15770,48840,5345,23601,3633,43495,192,101,91
15775,48850,5348,23605,3635,43502,192,101,91
15780,48871,5349,23609,3636,43522,192,101,91
15785,48881,5349,23614,3636,43532,192,101,91
15790,48902,5350,23622,3636,43552,192,101,91
15795,48912,5350,23624,3636,43562,192,101,91
15800,48933,5351,23637,3636,43582,192,101,91
15805,48943,5351,23642,3636,43592,192,101,91
15810,48964,5352,23651,3636,43612,192,101,91
15815,48974,5352,23655,3636,43622,192,101,91
15820,48995,5353,23661,3636,43642,192,101,91
15825,49005,5353,23666,3636,43652,192,101,91
15830,49026,5356,23681,3639,43670,192,101,91
15835,49036,5357,23685,3640,43679,192,101,91
15840,49057,5360,23699,3642,43697,192,101,91
15845,49067,5361,23705,3643,43706,192,101,91
15850,49088,5362,23715,3644,43726,192,101,91
15855,49098,5362,23721,3644,43736,192,101,91
15860,49119,5365,23733,3646,43754,192,101,91
15865,49129,5365,23738,3646,43764,192,101,91
15870,49150,5367,23747,3646,43783,192,101,91
15875,49160,5367,23754,3646,43793,192,101,91
15880,49181,5369,23764,3647,43812,192,101,91
15885,49191,5370,23770,3648,43821,192,101,91
15890,49212,5372,23775,3648,43840,192,101,91
15895,49222,5374,23782,3649,43848,192,101,91
15900,49243,5378,23795,3652,43864,192,101,91
15905,49253,5379,23797,3653,43874,192,101,91
15910,49274,5382,23811,3655,43892,192,101,91
15915,49284,5382,23815,3655,43902,192,101,91
15920,49305,5386,23823,3657,43919,192,101,91
15925,49315,5386,23827,3657,43929,192,101,91
15930,49336,5390,23835,3658,43946,192,101,91
15935,49346,5390,23839,3658,43956,192,101,91
15940,49367,5395,23849,3660,43972,192,101,91
15945,49377,5396,23856,3661,43981,192,101,91
15950,49398,5399,23868,3664,43999,192,101,91
15955,49408,5400,23873,3665,44008,192,101,91
15960,49429,5405,23883,3669,44024,192,101,91
15965,49439,5407,23888,3670,44032,192,101,91
15970,49460,5409,23899,3671,44051,192,101,91
15975,49470,5410,23902,3672,44060,192,101,91
15980,49491,5412,23911,3672,44079,192,101,91
15985,49501,5413,23917,3672,44087,192,101,91
15990,49522,5416,23928,3674,44106,192,101,91
15995,49532,5417,23930,3674,44115,192,101,91
16000,49553,5419,23942,3674,44134,192,101,91
16005,49563,5420,23946,3674,44143,192,101,91
16010,49584,5423,23953,3676,44161,192,101,91
16015,49594,5425,23960,3677,44169,192,101,91
16020,49615,5428,23971,3679,44187,192,101,91
16025,49625,5429,23976,3679,44196,192,101,91
16030,49646,5431,23984,3680,44215,192,101,91
16035,49656,5433,23991,3682,44223,192,101,91
16040,49677,5436,24004,3684,44241,192,101,91
16045,49687,5437,24008,3685,44250,192,101,91
16050,49708,5441,24021,3689,44267,192,101,91
16055,49718,5442,24024,3690,44276,192,101,91
16060,49739,5445,24035,3692,44294,192,101,91
16065,49749,5447,24038,3693,44302,192,101,91
16070,49770,5451,24045,3696,44319,192,101,91
16075,49780,5452,24051,3697,44328,192,101,91
16080,49801,5457,24063,3701,44344,192,101,91
16085,49811,5458,24067,3702,44353,192,101,91
16090,49832,5460,24076,3703,44372,192,101,91
16095,49842,5461,24081,3704,44381,192,101,91
16100,49863,5462,24086,3704,44401,192,101,91
16105,49873,5462,24092,3704,44411,192,101,91
16110,49894,5462,24101,3704,44432,192,101,91
16115,49904,5462,24104,3704,44442,192,101,91
16120,49925,5462,24116,3704,44463,192,101,91
16125,49935,5462,24121,3704,44473,192,101,91
16130,49956,5464,24133,3706,44492,192,101,91
16135,49966,5464,24140,3706,44502,192,101,91
16140,49987,5465,24150,3706,44522,192,101,91
16145,49997,5465,24152,3706,44532,192,101,91
16150,50018,5469,24162,3708,44549,192,101,91
16155,50028,5469,24166,3708,44559,192,101,91
16160,50049,5471,24173,3710,44578,192,101,91
16165,50059,5471,24177,3710,44588,192,101,91
16170,50080,5474,24185,3711,44606,192,101,91
16175,50090,5474,24188,3711,44616,192,101,91
16180,50111,5477,24196,3713,44634,192,101,91
16185,50121,5477,24199,3713,44644,192,101,91
16190,50142,5482,24212,3717,44659,192,101,91
16195,50152,5484,24216,3719,44668,192,101,91
16200,50173,5489,24226,3723,44684,192,101,91
16205,50183,5491,24229,3724,44692,192,101,91
16210,50204,5493,24238,3726,44711,192,101,91
16215,50214,5495,24241,3727,44719,192,101,91
16220,50235,5497,24253,3728,44738,192,101,91
16225,50245,5499,24260,3730,44746,192,101,91
16230,50266,5501,24273,3731,44765,192,101,91
16235,50276,5503,24280,3733,44773,192,101,91
16240,50297,5504,24289,3733,44793,192,101,91
16245,50307,5505,24293,3734,44802,192,101,91
16250,50328,5506,24304,3735,44822,192,101,91
16255,50338,5507,24310,3735,44831,192,101,91
16260,50359,5508,24319,3735,44851,192,101,91
16265,50369,5509,24325,3736,44860,192,101,91
16270,50390,5510,24335,3736,44880,192,101,91
16275,50400,5511,24341,3737,44889,192,101,91
16280,50421,5512,24352,3737,44909,192,101,91
16285,50431,5513,24357,3737,44918,192,101,91
16290,50452,5514,24368,3737,44938,192,101,91
16295,50462,5515,24373,3737,44947,192,101,91
16300,50483,5516,24383,3737,44967,192,101,91
16305,50493,5517,24386,3738,44976,192,101,91
16310,50514,5522,24397,3742,44992,192,101,91
16315,50524,5523,24399,3742,45001,192,101,91
16320,50545,5528,24408,3746,45016,192,101,91
16325,50555,5529,24411,3747,45026,192,101,91
16330,50576,5529,24419,3747,45047,192,101,91
16335,50586,5529,24424,3747,45057,192,101,91
16340,50607,5529,24435,3747,45078,192,101,91
16345,50617,5529,24443,3747,45088,192,101,91
16350,50638,5529,24450,3747,45109,192,101,91
16355,50648,5529,24455,3747,45119,192,101,91
16360,50669,5529,24466,3747,45140,192,101,91
16365,50679,5529,24470,3747,45150,192,101,91
16370,50700,5529,24481,3747,45171,192,101,91
16375,50710,5529,24486,3747,45181,192,101,91
16380,50731,5529,24500,3747,45202,192,101,91
16385,50741,5529,24505,3747,45212,192,101,91
16390,50762,5529,24513,3747,45233,192,101,91
16395,50772,5529,24516,3747,45243,192,101,91
16400,50793,5529,24525,3747,45264,192,101,91
16405,50803,5529,24531,3747,45274,192,101,91
16410,50824,5529,24546,3747,45295,192,101,91
16415,50834,5529,24552,3747,45305,192,101,91
16420,50855,5529,24562,3747,45326,192,101,91
16425,50865,5530,24567,3748,45335,192,101,91
16430,50886,5534,24579,3749,45351,192,101,91
16435,50896,5536,24583,3751,45359,192,101,91
16440,50917,5541,24590,3756,45375,192,101,91
16445,50927,5543,24594,3757,45384,192,101,91
16450,50948,5545,24602,3758,45403,192,101,91
16455,50958,5546,24606,3758,45412,192,101,91
16460,50979,5548,24618,3758,45431,192,101,91
16465,50989,5549,24623,3759,45440,192,101,91
16470,51010,5551,24633,3760,45459,192,101,91
16475,51020,5552,24638,3760,45468,192,101,91
16480,51041,5555,24646,3762,45486,192,101,91
16485,51051,5556,24652,3763,45495,192,101,91
16490,51072,5559,24663,3765,45513,192,101,91
16495,51082,5561,24668,3767,45521,192,101,91
16500,51103,5563,24679,3768,45540,192,101,91
16505,51113,5564,24684,3769,45549,192,101,91
16510,51134,5566,24692,3770,45568,192,101,91
16515,51144,5567,24696,3770,45577,192,101,91
16520,51165,5569,24708,3771,45596,192,101,91
16525,51175,5570,24717,3772,45605,192,101,91
16530,51196,5572,24725,3773,45624,192,101,91
16535,51206,5573,24730,3773,45633,192,101,91
16540,51227,5575,24740,3775,45652,192,101,91
16545,51237,5577,24743,3776,45660,192,101,91
16550,51258,5582,24752,3780,45676,192,101,91
16555,51268,5585,24760,3783,45683,192,101,91
16560,51289,5591,24769,3786,45698,192,101,91
16565,51299,5591,24774,3786,45708,192,101,91
16570,51320,5591,24786,3786,45729,192,101,91
16575,51330,5591,24791,3786,45739,192,101,91
16580,51351,5591,24800,3786,45760,192,101,91
16585,51361,5591,24805,3786,45770,192,101,91
16590,51382,5591,24815,3786,45791,192,101,91
16595,51392,5591,24818,3786,45801,192,101,91
16600,51413,5591,24827,3786,45822,192,101,91
16605,51423,5591,24834,3786,45832,192,101,91
16610,51444,5591,24847,3786,45853,192,101,91
16615,51454,5591,24850,3786,45863,192,101,91
16620,51475,5591,24858,3786,45884,192,101,91
16625,51485,5593,24863,3788,45892,192,101,91
16630,51506,5594,24871,3788,45912,192,101,91
16635,51516,5596,24874,3789,45920,192,101,91
16640,51537,5599,24882,3791,45938,192,101,91
16645,51547,5601,24887,3792,45946,192,101,91
16650,51568,5604,24897,3795,45964,192,101,91
16655,51578,5606,24902,3796,45972,192,101,91
16660,51599,5608,24913,3798,45990,192,101,91
16665,51609,5611,24917,3801,45998,192,101,91
16670,51630,5615,24925,3804,46014,192,101,91
16675,51640,5618,24929,3807,46021,192,101,91
16680,51661,5622,24939,3809,46037,192,101,91
16685,51671,5624,24943,3811,46047,192,101,91
16690,51692,5626,24953,3812,46066,192,101,91
16695,51702,5626,24957,3812,46076,192,101,91
16700,51723,5628,24966,3813,46095,192,101,91
16705,51733,5628,24971,3813,46105,192,101,91
16710,51754,5630,24982,3814,46124,192,101,91
16715,51764,5630,24989,3814,46134,192,101,91
16720,51785,5632,24999,3815,46153,192,101,91
16725,51795,5632,25006,3815,46163,192,101,91
16730,51816,5634,25013,3815,46182,192,101,91
16735,51826,5634,25020,3815,46192,192,101,91
16740,51847,5636,25036,3817,46211,192,101,91
16745,51857,5636,25041,3817,46221,192,101,91
16750,51878,5638,25048,3818,46240,192,101,91
16755,51888,5638,25052,3818,46250,192,101,91
16760,51909,5640,25060,3819,46269,192,101,91
16765,51919,5640,25066,3819,46279,192,101,91
16770,51940,5642,25074,3820,46298,192,101,91
16775,51950,5642,25079,3820,46308,192,101,91
16780,51971,5644,25091,3821,46327,192,101,91
16785,51981,5644,25097,3821,46337,192,101,91
16790,52002,5648,25105,3824,46353,192,101,91
16795,52012,5650,25109,3826,46362,192,101,91
16800,52033,5654,25120,3829,46379,192,101,91
16805,52043,5654,25127,3829,46389,192,101,91
16810,52064,5657,25137,3830,46407,192,101,91
16815,52074,5657,25144,3830,46417,192,101,91
16820,52095,5661,25154,3834,46434,192,101,91
16825,52105,5661,25156,3834,46444,192,101,91
16830,52126,5664,25161,3836,46462,192,101,91
16835,52136,5664,25165,3836,46472,192,101,91
16840,52157,5666,25175,3837,46491,192,101,91
16845,52167,5666,25179,3837,46501,192,101,91
16850,52188,5667,25189,3837,46521,192,101,91
16855,52198,5667,25194,3837,46531,192,101,91
16860,52219,5669,25203,3839,46550,192,101,91
16865,52229,5669,25211,3839,46560,192,101,91
16870,52250,5670,25221,3839,46580,192,101,91
16875,52260,5670,25227,3839,46590,192,101,91
16880,52281,5671,25240,3840,46610,192,101,91
16885,52291,5671,25246,3840,46620,192,101,91
16890,52312,5672,25261,3840,46640,192,101,91
16895,52322,5672,25264,3840,46650,192,101,91
16900,52343,5673,25271,3841,46670,192,101,91
16905,52353,5674,25277,3842,46678,192,101,91
16910,52374,5679,25286,3846,46695,192,101,91
16915,52384,5680,25289,3847,46703,192,101,91
16920,52405,5685,25300,3850,46719,192,101,91
16925,52415,5687,25306,3851,46727,192,101,91
16930,52436,5690,25314,3853,46746,192,101,91
16935,52446,5691,25315,3853,46754,192,101,91
16940,52467,5694,25326,3855,46773,192,101,91
16945,52477,5695,25331,3856,46782,192,101,91
16950,52498,5697,25342,3857,46801,192,101,91
16955,52508,5698,25346,3858,46810,192,101,91
16960,52529,5700,25356,3859,46829,192,101,91
16965,52539,5701,25358,3860,46838,192,101,91
16970,52560,5703,25365,3860,46857,192,101,91
16975,52570,5704,25370,3860,46866,192,101,91
16980,52591,5706,25379,3862,46885,192,101,91
16985,52601,5707,25384,3863,46894,192,101,91
16990,52622,5709,25394,3865,46913,192,101,91
16995,52632,5710,25401,3866,46922,192,101,91
17000,52653,5712,25406,3867,46941,192,101,91
17005,52663,5713,25410,3867,46950,192,101,91
17010,52684,5715,25420,3868,46969,192,101,91
17015,52694,5716,25424,3869,46978,192,101,91
17020,52715,5718,25430,3870,46997,192,101,91
17025,52725,5719,25434,3870,47006,192,101,91
17030,52746,5723,25443,3873,47021,192,101,91
17035,52756,5728,25450,3878,47028,192,101,91
17040,52777,5734,25461,3882,47040,192,101,91
17045,52787,5737,25464,3885,47050,192,101,91
17050,52808,5738,25477,3886,47070,192,101,91
17055,52818,5738,25482,3886,47080,192,101,91
17060,52839,5739,25492,3887,47100,192,101,91
17065,52849,5739,25498,3887,47110,192,101,91
17070,52870,5740,25507,3887,47130,192,101,91
17075,52880,5740,25512,3887,47140,192,101,91
17080,52901,5741,25524,3887,47160,192,101,91
17085,52911,5741,25530,3887,47170,192,101,91
17090,52932,5742,25538,3888,47190,192,101,91
17095,52942,5742,25543,3888,47199,192,101,91
17100,52963,5744,25552,3889,47219,192,101,91
17105,52973,5745,25554,3889,47228,192,101,91
17110,52994,5748,25566,3891,47245,192,101,91
17115,53004,5750,25573,3893,47253,192,101,91
17120,53025,5753,25582,3895,47272,192,101,91
17125,53035,5753,25589,3895,47282,192,101,91
17130,53056,5755,25602,3896,47301,192,101,91
17135,53066,5755,25607,3896,47311,192,101,91
17140,53087,5757,25616,3897,47330,192,101,91
17145,53097,5757,25622,3897,47339,192,101,91
17150,53118,5763,25632,3901,47355,192,101,91
17155,53128,5763,25636,3901,47364,192,101,91
17160,53149,5769,25643,3905,47379,192,101,91
17165,53159,5772,25648,3907,47387,192,101,91
17170,53180,5773,25657,3908,47406,192,101,91
17175,53190,5775,25658,3910,47415,192,101,91
17180,53211,5776,25670,3911,47435,192,101,91
17185,53221,5779,25678,3914,47442,192,101,91
17190,53242,5780,25689,3915,47461,192,101,91
17195,53252,5784,25694,3918,47468,192,101,91
17200,53273,5785,25705,3919,47487,192,101,91
17205,53283,5789,25709,3922,47494,192,101,91
17210,53304,5790,25717,3922,47514,192,101,91
17215,53314,5791,25725,3923,47523,192,101,91
17220,53335,5792,25737,3923,47543,192,101,91
17225,53345,5793,25743,3924,47552,192,101,91
17230,53366,5794,25753,3925,47572,192,101,91
17235,53376,5795,25758,3926,47581,192,101,91
17240,53397,5796,25763,3926,47601,192,101,91
17245,53407,5796,25767,3926,47611,192,101,91
17250,53428,5797,25773,3926,47631,192,101,91
17255,53438,5797,25777,3926,47641,192,101,91
17260,53459,5798,25789,3927,47661,192,101,91
17265,53469,5798,25795,3927,47671,192,101,91
17270,53490,5801,25807,3929,47689,192,101,91
17275,53500,5802,25815,3930,47697,192,101,91
17280,53521,5808,25824,3934,47713,192,101,91
17285,53531,5809,25828,3935,47722,192,101,91
17290,53552,5811,25839,3936,47741,192,101,91
17295,53562,5812,25846,3936,47750,192,101,91
17300,53583,5814,25856,3938,47769,192,101,91
17305,53593,5815,25859,3938,47778,192,101,91
17310,53614,5816,25868,3939,47798,192,101,91
17315,53624,5817,25869,3940,47807,192,101,91
17320,53645,5818,25881,3940,47827,192,101,91
17325,53655,5819,25890,3941,47836,192,101,91
17330,53676,5821,25898,3942,47855,192,101,91
17335,53686,5822,25903,3943,47864,192,101,91
17340,53707,5824,25915,3945,47883,192,101,91
17345,53717,5825,25922,3946,47892,192,101,91
17350,53738,5826,25935,3946,47912,192,101,91
17355,53748,5827,25941,3946,47921,192,101,91
17360,53769,5829,25953,3948,47940,192,101,91
17365,53779,5830,25960,3949,47949,192,101,91
17370,53800,5831,25968,3950,47969,192,101,91
17375,53810,5832,25975,3951,47978,192,101,91
17380,53831,5833,25984,3951,47998,192,101,91
17385,53841,5834,25986,3951,48007,192,101,91
17390,53862,5838,25998,3954,48024,192,101,91
17395,53872,5840,26003,3955,48032,192,101,91
17400,53893,5845,26014,3959,48047,192,101,91
17405,53903,5846,26017,3960,48057,192,101,91
17410,53924,5847,26025,3961,48077,192,101,91
17415,53934,5847,26028,3961,48087,192,101,91
17420,53955,5848,26037,3961,48107,192,101,91
17425,53965,5848,26041,3961,48117,192,101,91
17430,53986,5849,26047,3961,48137,192,101,91
17435,53996,5849,26052,3961,48147,192,101,91
17440,54017,5850,26062,3962,48167,192,101,91
17445,54027,5850,26066,3962,48177,192,101,91
17450,54048,5851,26074,3962,48197,192,101,91
17455,54058,5851,26079,3962,48207,192,101,91
17460,54079,5852,26091,3963,48227,192,101,91
17465,54089,5852,26098,3963,48237,192,101,91
17470,54110,5853,26107,3964,48257,192,101,91
17475,54120,5853,26113,3964,48267,192,101,91
17480,54141,5854,26121,3965,48287,192,101,91
17485,54151,5854,26126,3965,48297,192,101,91
17490,54172,5855,26139,3966,48317,192,101,91
17495,54182,5855,26141,3966,48327,192,101,91
17500,54203,5856,26152,3967,48347,192,101,91
17505,54213,5856,26158,3967,48357,192,101,91
17510,54234,5861,26167,3970,48372,192,101,91
17515,54244,5863,26169,3972,48381,192,101,91
17520,54265,5867,26180,3975,48398,192,101,91
17525,54275,5868,26184,3975,48406,192,101,91
17530,54296,5871,26193,3977,48425,192,101,91
17535,54306,5872,26198,3978,48434,192,101,91
17540,54327,5874,26206,3979,48453,192,101,91
17545,54337,5876,26210,3980,48461,192,101,91
17550,54358,5877,26223,3981,48481,192,101,91
17555,54368,5878,26224,3981,48490,192,101,91
17560,54389,5880,26234,3983,48509,192,101,91
17565,54399,5881,26237,3983,48517,192,101,91
17570,54420,5883,26246,3985,48537,192,101,91
17575,54430,5884,26247,3986,48546,192,101,91
17580,54451,5884,26260,3986,48567,192,101,91
17585,54461,5885,26264,3987,48576,192,101,91
17590,54482,5886,26279,3988,48595,192,101,91
17595,54492,5888,26281,3989,48604,192,101,91
17600,54513,5891,26290,3991,48622,192,101,91
17605,54523,5892,26297,3991,48631,192,101,91
17610,54544,5894,26304,3993,48650,192,101,91
17615,54554,5895,26307,3993,48659,192,101,91
17620,54575,5897,26316,3995,48678,192,101,91
17625,54585,5898,26320,3996,48686,192,101,91
17630,54606,5902,26331,4000,48702,192,101,91
17635,54616,5907,26334,4004,48709,192,101,91
17640,54637,5912,26342,4008,48724,192,101,91
17645,54647,5915,26347,4011,48732,192,101,91
17650,54668,5916,26358,4012,48752,192,101,91
17655,54678,5918,26364,4013,48760,192,101,91
17660,54699,5918,26375,4013,48781,192,101,91
17665,54709,5919,26380,4014,48790,192,101,91
17670,54730,5920,26388,4015,48810,192,101,91
17675,54740,5921,26392,4016,48819,192,101,91
17680,54761,5922,26403,4017,48839,192,101,91
17685,54771,5923,26406,4017,48848,192,101,91
17690,54792,5924,26415,4018,48868,192,101,91
17695,54802,5925,26416,4018,48877,192,101,91
17700,54823,5925,26427,4018,48898,192,101,91
17705,54833,5925,26431,4018,48908,192,101,91
17710,54854,5928,26442,4020,48926,192,101,91
17715,54864,5928,26447,4020,48936,192,101,91
17720,54885,5931,26460,4021,48954,192,101,91
17725,54895,5931,26466,4021,48964,192,101,91
17730,54916,5935,26478,4023,48981,192,101,91
17735,54926,5935,26479,4023,48991,192,101,91
17740,54947,5938,26486,4025,49009,192,101,91
17745,54957,5938,26493,4025,49019,192,101,91
17750,54978,5942,26509,4028,49036,192,101,91
17755,54988,5942,26512,4028,49046,192,101,91
17760,55009,5946,26525,4029,49063,192,101,91
17765,55019,5946,26531,4029,49073,192,101,91
17770,55040,5949,26542,4030,49091,192,101,91
17775,55050,5949,26547,4030,49100,192,101,91
17780,55071,5952,26559,4032,49119,192,101,91
17785,55081,5952,26564,4032,49128,192,101,91
17790,55102,5956,26575,4036,49146,192,101,91
17795,55112,5956,26580,4036,49155,192,101,91
17800,55133,5959,26588,4038,49174,192,101,91
17805,55143,5959,26593,4038,49183,192,101,91
17810,55164,5963,26602,4040,49201,192,101,91
17815,55174,5963,26605,4040,49210,192,101,91
17820,55195,5966,26615,4043,49229,192,101,91
17825,55205,5968,26619,4044,49237,192,101,91
17830,55226,5968,26628,4044,49258,192,101,91
17835,55236,5970,26631,4045,49266,192,101,91
17840,55257,5970,26638,4045,49287,192,101,91
17845,55267,5971,26640,4045,49296,192,101,91
17850,55288,5971,26656,4045,49317,192,101,91
17855,55298,5973,26664,4047,49325,192,101,91
17860,55319,5974,26672,4048,49345,192,101,91
17865,55329,5975,26676,4049,49353,192,101,91
17870,55350,5979,26686,4052,49370,192,101,91
17875,55360,5982,26689,4055,49378,192,101,91
17880,55381,5985,26698,4057,49395,192,101,91
17885,55391,5986,26701,4058,49405,192,101,91
17890,55412,5989,26710,4060,49423,192,101,91
17895,55422,5990,26716,4061,49432,192,101,91
17900,55443,5993,26730,4064,49450,192,101,91
17905,55453,5994,26735,4065,49459,192,101,91
17910,55474,5997,26744,4066,49477,192,101,91
17915,55484,5998,26749,4067,49486,192,101,91
17920,55505,6002,26762,4070,49503,192,101,91
17925,55515,6002,26765,4070,49513,192,101,91
17930,55536,6006,26773,4073,49530,192,101,91
17935,55546,6007,26779,4074,49539,192,101,91
17940,55567,6010,26788,4076,49557,192,101,91
17945,55577,6010,26792,4076,49567,192,101,91
17950,55598,6012,26801,4078,49586,192,101,91
17955,55608,6012,26808,4078,49596,192,101,91
17960,55629,6014,26818,4079,49615,192,101,91
17965,55639,6014,26820,4079,49625,192,101,91
17970,55660,6016,26831,4080,49644,192,101,91
17975,55670,6016,26835,4080,49653,192,101,91
17980,55691,6019,26842,4081,49672,192,101,91
17985,55701,6019,26845,4081,49682,192,101,91
17990,55722,6022,26854,4082,49699,192,101,91
17995,55732,6025,26856,4084,49707,192,101,91
18000,55753,6028,26866,4086,49724,192,101,91
18005,55763,6030,26873,4088,49732,192,101,91
18010,55784,6035,26883,4090,49749,192,101,91
18015,55794,6036,26888,4091,49758,192,101,91
18020,55815,6039,26899,4094,49776,192,101,91
18025,55825,6039,26904,4094,49786,192,101,91
18030,55846,6043,26913,4097,49803,192,101,91
18035,55856,6043,26916,4097,49813,192,101,91
18040,55877,6045,26927,4099,49832,192,101,91
18045,55887,6045,26933,4099,49842,192,101,91
18050,55908,6046,26947,4100,49862,192,101,91
18055,55918,6046,26950,4100,49872,192,101,91
18060,55939,6047,26955,4101,49892,192,101,91
18065,55949,6047,26960,4101,49901,192,101,91
18070,55970,6050,26970,4103,49920,192,101,91
18075,55980,6050,26972,4103,49930,192,101,91
18080,56001,6051,26982,4104,49950,192,101,91
18085,56011,6051,26986,4104,49960,192,101,91
18090,56032,6052,26993,4105,49980,192,101,91
18095,56042,6052,26996,4105,49990,192,101,91
18100,56063,6053,27003,4106,50010,192,101,91
18105,56073,6053,27008,4106,50020,192,101,91
18110,56094,6054,27017,4106,50039,192,101,91
18115,56104,6056,27023,4108,50048,192,101,91
18120,56125,6059,27034,4111,50065,192,101,91
18125,56135,6061,27037,4113,50074,192,101,91
18130,56156,6064,27042,4115,50092,192,101,91
18135,56166,6064,27047,4115,50102,192,101,91
18140,56187,6066,27058,4117,50121,192,101,91
18145,56197,6066,27065,4117,50131,192,101,91
18150,56218,6068,27076,4118,50150,192,101,91
18155,56228,6068,27080,4118,50160,192,101,91
18160,56249,6070,27091,4119,50179,192,101,91
18165,56259,6070,27098,4119,50189,192,101,91
18170,56280,6072,27109,4121,50208,192,101,91
18175,56290,6072,27113,4121,50218,192,101,91
18180,56311,6074,27119,4122,50237,192,101,91
18185,56321,6075,27124,4123,50246,192,101,91
18190,56342,6079,27135,4126,50263,192,101,91
18195,56352,6079,27140,4126,50273,192,101,91
18200,56373,6082,27149,4129,50291,192,101,91
18205,56383,6082,27153,4129,50301,192,101,91
18210,56404,6084,27165,4131,50320,192,101,91
18215,56414,6084,27169,4131,50330,192,101,91
18220,56435,6087,27182,4134,50348,192,101,91
18225,56445,6087,27189,4134,50358,192,101,91
18230,56466,6090,27203,4136,50376,192,101,91
18235,56476,6091,27207,4136,50385,192,101,91
18240,56497,6094,27214,4138,50403,192,101,91
18245,56507,6096,27220,4139,50411,192,101,91
18250,56528,6100,27234,4143,50427,192,101,91
18255,56538,6103,27239,4145,50434,192,101,91
18260,56559,6108,27248,4149,50450,192,101,91
18265,56569,6110,27252,4150,50459,192,101,91
18270,56590,6113,27264,4152,50477,192,101,91
18275,56600,6114,27269,4153,50486,192,101,91
18280,56621,6117,27281,4156,50504,192,101,91
18285,56631,6118,27286,4156,50512,192,101,91
18290,56652,6123,27295,4160,50529,192,101,91
18295,56662,6124,27299,4160,50537,192,101,91
18300,56683,6131,27316,4167,50552,192,101,91
18305,56693,6132,27321,4167,50560,192,101,91
18310,56714,6135,27331,4170,50577,192,101,91
18315,56724,6138,27334,4172,50586,192,101,91
18320,56745,6139,27344,4173,50606,192,101,91
18325,56755,6139,27349,4173,50615,192,101,91
18330,56776,6141,27359,4174,50635,192,101,91
18335,56786,6141,27363,4174,50645,192,101,91
18340,56807,6142,27375,4175,50665,192,101,91
18345,56817,6142,27379,4175,50674,192,101,91
18350,56838,6144,27388,4176,50694,192,101,91
18355,56848,6145,27394,4177,50703,192,101,91
18360,56869,6146,27405,4177,50723,192,101,91
18365,56879,6146,27409,4177,50733,192,101,91
18370,56900,6147,27416,4178,50753,192,101,91
18375,56910,6147,27422,4178,50763,192,101,91
18380,56931,6150,27431,4180,50781,192,101,91
18385,56941,6150,27432,4180,50791,192,101,91
18390,56962,6152,27442,4181,50810,192,101,91
18395,56972,6152,27448,4181,50820,192,101,91
18400,56993,6153,27453,4181,50840,192,101,91
18405,57003,6153,27458,4181,50850,192,101,91
18410,57024,6155,27465,4181,50869,192,101,91
18415,57034,6155,27468,4181,50878,192,101,91
18420,57055,6159,27480,4184,50895,192,101,91
18425,57065,6160,27484,4185,50904,192,101,91
18430,57086,6162,27492,4187,50924,192,101,91
18435,57096,6162,27498,4187,50933,192,101,91
18440,57117,6164,27508,4188,50953,192,101,91
18445,57127,6164,27513,4188,50962,192,101,91
18450,57148,6166,27522,4190,50982,192,101,91
18455,57158,6166,27526,4190,50991,192,101,91
18460,57179,6168,27533,4191,51011,192,101,91
18465,57189,6168,27536,4191,51021,192,101,91
18470,57210,6169,27545,4192,51041,192,101,91
18475,57220,6169,27550,4192,51050,192,101,91
18480,57241,6172,27563,4195,51069,192,101,91
18485,57251,6172,27570,4195,51079,192,101,91
18490,57272,6175,27576,4196,51096,192,101,91
18495,57282,6176,27581,4197,51106,192,101,91
18500,57303,6180,27596,4201,51122,192,101,91
18505,57313,6181,27599,4202,51132,192,101,91
18510,57334,6184,27606,4205,51149,192,101,91
18515,57344,6185,27609,4206,51159,192,101,91
18520,57365,6188,27620,4208,51176,192,101,91
18525,57375,6190,27626,4210,51185,192,101,91
18530,57396,6193,27636,4212,51202,192,101,91
18535,57406,6195,27641,4213,51211,192,101,91
18540,57427,6199,27652,4217,51227,192,101,91
18545,57437,6201,27656,4218,51236,192,101,91
18550,57458,6203,27665,4219,51254,192,101,91
18555,57468,6205,27672,4221,51263,192,101,91
18560,57489,6208,27684,4223,51281,192,101,91
18565,57499,6209,27686,4223,51290,192,101,91
18570,57520,6212,27694,4225,51308,192,101,91
18575,57530,6213,27696,4226,51317,192,101,91
18580,57551,6216,27704,4228,51335,192,101,91
18585,57561,6218,27709,4229,51343,192,101,91
18590,57582,6221,27721,4231,51360,192,101,91
18595,57592,6223,27725,4233,51369,192,101,91
18600,57613,6226,27736,4235,51386,192,101,91
18605,57623,6229,27739,4237,51394,192,101,91
18610,57644,6230,27744,4237,51414,192,101,91
18615,57654,6230,27748,4237,51424,192,101,91
18620,57675,6231,27757,4237,51444,192,101,91
18625,57685,6231,27763,4237,51453,192,101,91
18630,57706,6234,27774,4240,51472,192,101,91
18635,57716,6234,27780,4240,51481,192,101,91
18640,57737,6237,27790,4242,51500,192,101,91
18645,57747,6237,27795,4242,51510,192,101,91
18650,57768,6239,27802,4243,51529,192,101,91
18655,57778,6239,27806,4243,51539,192,101,91
18660,57799,6240,27817,4244,51559,192,101,91
18665,57809,6240,27822,4244,51569,192,101,91
18670,57830,6242,27834,4246,51588,192,101,91
18675,57840,6242,27836,4246,51598,192,101,91
18680,57861,6242,27846,4246,51619,192,101,91
18685,57871,6242,27852,4246,51629,192,101,91
18690,57892,6242,27863,4246,51650,192,101,91
18695,57902,6242,27867,4246,51660,192,101,91
18700,57923,6242,27877,4246,51681,192,101,91
18705,57933,6242,27881,4246,51691,192,101,91
18710,57954,6245,27890,4248,51709,192,101,91
18715,57964,6247,27894,4249,51717,192,101,91
18720,57985,6251,27903,4252,51734,192,101,91
18725,57995,6251,27909,4252,51744,192,101,91
18730,58016,6256,27922,4255,51760,192,101,91
18735,58026,6256,27930,4255,51770,192,101,91
18740,58047,6261,27940,4258,51786,192,101,91
18745,58057,6262,27945,4259,51795,192,101,91
18750,58078,6267,27959,4264,51811,192,101,91
18755,58088,6267,27964,4264,51821,192,101,91
18760,58109,6270,27970,4265,51839,192,101,91
18765,58119,6271,27977,4266,51848,192,101,91
18770,58140,6275,27984,4268,51865,192,101,91
18775,58150,6275,27988,4268,51875,192,101,91
18780,58171,6279,27997,4270,51892,192,101,91
18785,58181,6279,28002,4270,51902,192,101,91
18790,58202,6282,28015,4271,51920,192,101,91
18795,58212,6282,28019,4271,51930,192,101,91
18800,58233,6285,28031,4273,51948,192,101,91
18805,58243,6285,28035,4273,51958,192,101,91
18810,58264,6289,28048,4274,51975,192,101,91
18815,58274,6289,28053,4274,51985,192,101,91
18820,58295,6294,28069,4278,52000,192,101,91
18825,58305,6296,28073,4280,52009,192,101,91
18830,58326,6300,28082,4281,52026,192,101,91
18835,58336,6302,28088,4283,52034,192,101,91
18840,58357,6307,28103,4286,52048,192,101,91
18845,58367,6309,28109,4288,52058,192,101,91
18850,58388,6309,28118,4288,52079,192,101,91
18855,58398,6309,28122,4288,52089,192,101,91
18860,58419,6309,28132,4288,52110,192,101,91
18865,58429,6309,28137,4288,52120,192,101,91
18870,58450,6309,28149,4288,52141,192,101,91
18875,58460,6309,28154,4288,52151,192,101,91
18880,58481,6309,28161,4288,52172,192,101,91
18885,58491,6309,28168,4288,52182,192,101,91
18890,58512,6309,28180,4288,52203,192,101,91
18895,58522,6309,28186,4288,52213,192,101,91
18900,58543,6309,28196,4288,52234,192,101,91
18905,58553,6309,28200,4288,52244,192,101,91
18910,58574,6311,28213,4290,52263,192,101,91
18915,58584,6311,28217,4290,52273,192,101,91
18920,58605,6312,28224,4290,52293,192,101,91
18925,58615,6312,28229,4290,52303,192,101,91
18930,58636,6313,28239,4290,52323,192,101,91
18935,58646,6313,28243,4290,52333,192,101,91
18940,58667,6314,28252,4290,52353,192,101,91
18945,58677,6314,28253,4290,52363,192,101,91
18950,58698,6317,28264,4292,52380,192,101,91
18955,58708,6321,28269,4295,52387,192,101,91
18960,58729,6326,28280,4299,52401,192,101,91
18965,58739,6329,28286,4302,52410,192,101,91
18970,58760,6331,28291,4302,52429,192,101,91
18975,58770,6332,28294,4303,52438,192,101,91
18980,58791,6334,28304,4304,52457,192,101,91
18985,58801,6334,28310,4304,52466,192,101,91
18990,58822,6337,28320,4306,52485,192,101,91
18995,58832,6337,28323,4306,52495,192,101,91
19000,58853,6338,28334,4306,52515,192,101,91
19005,58863,6338,28339,4306,52524,192,101,91
19010,58884,6340,28349,4308,52544,192,101,91
19015,58894,6340,28356,4308,52554,192,101,91
19020,58915,6341,28368,4308,52574,192,101,91
19025,58925,6341,28372,4308,52584,192,101,91
19030,58946,6342,28383,4308,52604,192,101,91
19035,58956,6342,28386,4308,52614,192,101,91
19040,58977,6343,28395,4309,52634,192,101,91
19045,58987,6343,28400,4309,52644,192,101,91
19050,59008,6344,28411,4309,52664,192,101,91
19055,59018,6344,28416,4309,52674,192,101,91
19060,59039,6345,28425,4310,52694,192,101,91
19065,59049,6345,28429,4310,52704,192,101,91
19070,59070,6347,28437,4312,52723,192,101,91
19075,59080,6349,28442,4314,52731,192,101,91
19080,59101,6354,28456,4317,52746,192,101,91
19085,59111,6355,28460,4318,52756,192,101,91
19090,59132,6357,28472,4319,52775,192,101,91
19095,59142,6357,28476,4319,52784,192,101,91
19100,59163,6360,28483,4321,52803,192,101,91
19105,59173,6360,28486,4321,52813,192,101,91
19110,59194,6363,28497,4323,52831,192,101,91
19115,59204,6364,28503,4324,52839,192,101,91
19120,59225,6367,28509,4325,52858,192,101,91
19125,59235,6368,28514,4326,52866,192,101,91
19130,59256,6371,28523,4328,52885,192,101,91
19135,59266,6372,28528,4329,52893,192,101,91
19140,59287,6375,28534,4331,52912,192,101,91
19145,59297,6376,28539,4331,52921,192,101,91
19150,59318,6381,28550,4335,52937,192,101,91
19155,59328,6382,28557,4336,52946,192,101,91
19160,59349,6388,28568,4339,52960,192,101,91
19165,59359,6390,28571,4340,52969,192,101,91
19170,59380,6395,28580,4342,52985,192,101,91
19175,59390,6396,28583,4342,52994,192,101,91
19180,59411,6401,28593,4345,53010,192,101,91
19185,59421,6402,28596,4345,53019,192,101,91
19190,59442,6406,28607,4346,53035,192,101,91
19195,59452,6409,28613,4349,53043,192,101,91
19200,59473,6413,28622,4351,53058,192,101,91
19205,59483,6415,28628,4353,53067,192,101,91
19210,59504,6418,28638,4356,53086,192,101,91
19215,59514,6418,28645,4356,53095,192,101,91
19220,59535,6421,28656,4358,53114,192,101,91
19225,59545,6421,28660,4358,53124,192,101,91
19230,59566,6423,28673,4358,53143,192,101,91
19235,59576,6423,28680,4358,53152,192,101,91
19240,59597,6426,28691,4360,53171,192,101,91
19245,59607,6427,28696,4361,53180,192,101,91
19250,59628,6429,28710,4363,53199,192,101,91
19255,59638,6430,28717,4364,53207,192,101,91
19260,59659,6433,28726,4366,53226,192,101,91
19265,59669,6433,28732,4366,53236,192,101,91
19270,59690,6435,28742,4367,53255,192,101,91
19275,59700,6435,28747,4367,53265,192,101,91
19280,59721,6438,28759,4369,53283,192,101,91
19285,59731,6438,28766,4369,53293,192,101,91
19290,59752,6440,28773,4369,53312,192,101,91
19295,59762,6440,28778,4369,53322,192,101,91
19300,59783,6443,28788,4371,53340,192,101,91
19305,59793,6443,28793,4371,53350,192,101,91
19310,59814,6446,28803,4374,53368,192,101,91
19315,59824,6447,28808,4375,53377,192,101,91
19320,59845,6450,28819,4376,53394,192,101,91
19325,59855,6451,28823,4377,53404,192,101,91
19330,59876,6452,28831,4378,53424,192,101,91
19335,59886,6452,28834,4378,53434,192,101,91
19340,59907,6453,28840,4378,53454,192,101,91
19345,59917,6453,28844,4378,53464,192,101,91
19350,59938,6455,28854,4379,53483,192,101,91
19355,59948,6455,28859,4379,53493,192,101,91
19360,59969,6457,28866,4380,53512,192,101,91
19365,59979,6457,28872,4380,53522,192,101,91
19370,60000,6459,28882,4382,53541,192,101,91
19375,60010,6459,28886,4382,53551,192,101,91
19380,60031,6460,28897,4383,53571,192,101,91
19385,60041,6460,28903,4383,53581,192,101,91
19390,60062,6460,28916,4383,53602,192,101,91
19395,60072,6460,28921,4383,53612,192,101,91
19400,60093,6460,28930,4383,53633,192,101,91
19405,60103,6460,28937,4383,53643,192,101,91
19410,60124,6460,28946,4383,53664,192,101,91
19415,60134,6460,28950,4383,53674,192,101,91
19420,60155,6460,28962,4383,53695,192,101,91
19425,60165,6460,28968,4383,53705,192,101,91
19430,60186,6462,28973,4384,53723,192,101,91
19435,60196,6464,28977,4386,53732,192,101,91
19440,60217,6466,28989,4387,53750,192,101,91
19445,60227,6468,28996,4389,53758,192,101,91
19450,60248,6473,29007,4392,53775,192,101,91
19455,60258,6473,29011,4392,53785,192,101,91
19460,60279,6476,29016,4392,53803,192,101,91
19465,60289,6476,29021,4392,53812,192,101,91
19470,60310,6483,29033,4398,53827,192,101,91
19475,60320,6483,29040,4398,53836,192,101,91
19480,60341,6487,29050,4400,53854,192,101,91
19485,60351,6487,29056,4400,53863,192,101,91
19490,60372,6492,29068,4404,53880,192,101,91
19495,60382,6492,29071,4404,53890,192,101,91
19500,60403,6495,29082,4406,53908,192,101,91
19505,60413,6495,29086,4406,53918,192,101,91
19510,60434,6496,29097,4407,53938,192,101,91
19515,60444,6496,29103,4407,53948,192,101,91
19520,60465,6497,29113,4408,53968,192,101,91
19525,60475,6497,29118,4408,53978,192,101,91
19530,60496,6498,29126,4409,53998,192,101,91
19535,60506,6498,29132,4409,54008,192,101,91
19540,60527,6499,29147,4409,54028,192,101,91
19545,60537,6499,29151,4409,54038,192,101,91
19550,60558,6500,29162,4409,54058,192,101,91
19555,60568,6501,29166,4410,54067,192,101,91
19560,60589,6502,29174,4411,54087,192,101,91
19565,60599,6503,29177,4412,54096,192,101,91
19570,60620,6507,29186,4415,54113,192,101,91
19575,60630,6508,29190,4416,54122,192,101,91
19580,60651,6509,29201,4417,54142,192,101,91
19585,60661,6511,29210,4419,54149,192,101,91
19590,60682,6513,29220,4421,54169,192,101,91
19595,60692,6514,29226,4422,54178,192,101,91
19600,60713,6515,29236,4422,54198,192,101,91
19605,60723,6516,29242,4423,54207,192,101,91
19610,60744,6517,29255,4423,54227,192,101,91
19615,60754,6518,29259,4424,54236,192,101,91
19620,60775,6519,29273,4424,54255,192,101,91
19625,60785,6521,29280,4425,54264,192,101,91
19630,60806,6523,29290,4427,54281,192,101,91
19635,60816,6526,29298,4429,54290,192,101,91
19640,60837,6527,29305,4429,54310,192,101,91
19645,60847,6528,29310,4429,54319,192,101,91
19650,60868,6529,29320,4429,54339,192,101,91
19655,60878,6530,29324,4430,54348,192,101,91
19660,60899,6531,29335,4431,54367,192,101,91
19665,60909,6533,29340,4433,54376,192,101,91
19670,60930,6535,29348,4434,54395,192,101,91
19675,60940,6536,29349,4434,54404,192,101,91
19680,60961,6537,29360,4434,54423,192,101,91
19685,60971,6538,29366,4435,54433,192,101,91
19690,60992,6541,29377,4438,54451,192,101,91
19695,61002,6541,29382,4438,54461,192,101,91
19700,61023,6544,29390,4438,54479,192,101,91
19705,61033,6544,29393,4438,54489,192,101,91
19710,61054,6547,29403,4439,54507,192,101,91
19715,61064,6547,29406,4439,54516,192,101,91
19720,61085,6551,29414,4441,54534,192,101,91
19725,61095,6551,29421,4441,54543,192,101,91
19730,61116,6555,29430,4444,54561,192,101,91
19735,61126,6556,29435,4445,54569,192,101,91
19740,61147,6560,29441,4446,54587,192,101,91
19745,61157,6562,29446,4448,54595,192,101,91
19750,61178,6564,29456,4449,54613,192,101,91
19755,61188,6568,29461,4452,54620,192,101,91
19760,61209,6570,29469,4452,54638,192,101,91
19765,61219,6572,29472,4454,54647,192,101,91
19770,61240,6574,29482,4456,54666,192,101,91
19775,61250,6574,29486,4456,54676,192,101,91
19780,61271,6576,29496,4456,54695,192,101,91
19785,61281,6576,29499,4456,54705,192,101,91
19790,61302,6578,29513,4458,54724,192,101,91
19795,61312,6578,29518,4458,54734,192,101,91
19800,61333,6581,29531,4460,54751,192,101,91
19805,61343,6583,29537,4462,54760,192,101,91
19810,61364,6585,29546,4464,54779,192,101,91
19815,61374,6586,29550,4464,54788,192,101,91
19820,61395,6588,29561,4465,54807,192,101,91
19825,61405,6589,29567,4465,54816,192,101,91
19830,61426,6590,29577,4465,54836,192,101,91
19835,61436,6591,29580,4465,54845,192,101,91
19840,61457,6593,29590,4467,54864,192,101,91
19845,61467,6594,29595,4468,54873,192,101,91
19850,61488,6595,29603,4469,54893,192,101,91
19855,61498,6597,29608,4470,54901,192,101,91
19860,61519,6600,29621,4472,54919,192,101,91
19865,61529,6600,29625,4472,54929,192,101,91
19870,61550,6602,29635,4474,54948,192,101,91
19875,61560,6603,29641,4475,54957,192,101,91
19880,61581,6604,29653,4476,54977,192,101,91
19885,61591,6605,29659,4477,54986,192,101,91
19890,61612,6606,29668,4477,55006,192,101,91
19895,61622,6607,29673,4478,55015,192,101,91
19900,61643,6608,29684,4478,55035,192,101,91
19905,61653,6608,29689,4478,55045,192,101,91
19910,61674,6609,29696,4479,55065,192,101,91
19915,61684,6610,29703,4480,55074,192,101,91
19920,61705,6613,29712,4481,55092,192,101,91
19925,61715,6614,29716,4481,55100,192,101,91
19930,61736,6618,29726,4483,55118,192,101,91
19935,61746,6620,29732,4485,55126,192,101,91
19940,61767,6623,29741,4487,55144,192,101,91
19945,61777,6624,29746,4488,55153,192,101,91
19950,61798,6626,29758,4489,55172,192,101,91
19955,61808,6628,29762,4490,55179,192,101,91
19960,61829,6631,29769,4491,55198,192,101,91
19965,61839,6632,29772,4491,55207,192,101,91
19970,61860,6634,29783,4492,55226,192,101,91
19975,61870,6635,29788,4492,55234,192,101,91
19980,61891,6638,29795,4493,55253,192,101,91
19985,61901,6640,29799,4495,55261,192,101,91
19990,61922,6643,29808,4497,55279,192,101,91
19995,61932,6645,29813,4498,55287,192,101,91
20000,61953,6647,29825,4500,55305,192,101,91
20005,61963,6650,29833,4503,55313,192,101,91
20010,61984,6652,29843,4505,55332,192,101,91
20015,61994,6654,29848,4507,55340,192,101,91
20020,62015,6657,29858,4508,55357,192,101,91
20025,62025,6660,29861,4511,55365,192,101,91
20030,62046,6665,29871,4514,55378,192,101,91
20035,62056,6670,29876,4518,55386,192,101,91
20040,62077,6675,29890,4523,55401,192,101,91
20045,62087,6676,29895,4524,55411,192,101,91
20050,62108,6678,29907,4525,55430,192,101,91
20055,62118,6678,29914,4525,55440,192,101,91
20060,62139,6681,29925,4527,55458,192,101,91
20065,62149,6681,29929,4527,55468,192,101,91
20070,62170,6683,29938,4528,55487,192,101,91
20075,62180,6683,29941,4528,55497,192,101,91
20080,62201,6686,29950,4529,55515,192,101,91
20085,62211,6686,29955,4529,55525,192,101,91
20090,62232,6688,29965,4531,55544,192,101,91
20095,62242,6688,29969,4531,55554,192,101,91
20100,62263,6691,29978,4533,55572,192,101,91
20105,62273,6692,29981,4534,55581,192,101,91
20110,62294,6696,29990,4536,55598,192,101,91
20115,62304,6697,29995,4537,55606,192,101,91
20120,62325,6704,30005,4542,55621,192,101,91
20125,62335,6704,30010,4542,55630,192,101,91
20130,62356,6708,30018,4545,55648,192,101,91
20135,62366,6709,30023,4546,55656,192,101,91
20140,62387,6713,30033,4549,55674,192,101,91
20145,62397,6713,30035,4549,55683,192,101,91
20150,62418,6715,30047,4551,55702,192,101,91
20155,62428,6717,30048,4552,55711,192,101,91
20160,62449,6717,30061,4552,55732,192,101,91
20165,62459,6718,30064,4553,55741,192,101,91
20170,62480,6718,30072,4553,55762,192,101,91
20175,62490,6719,30078,4554,55771,192,101,91
20180,62511,6719,30090,4554,55792,192,101,91
20185,62521,6720,30093,4554,55801,192,101,91
20190,62542,6720,30106,4554,55822,192,101,91
20195,62552,6721,30111,4554,55831,192,101,91
20200,62573,6721,30123,4554,55852,192,101,91
20205,62583,6722,30129,4555,55861,192,101,91
20210,62604,6723,30135,4556,55881,192,101,91
20215,62614,6724,30141,4556,55890,192,101,91
20220,62635,6725,30147,4556,55910,192,101,91
20225,62645,6726,30152,4556,55919,192,101,91
20230,62666,6728,30161,4556,55938,192,101,91
20235,62676,6729,30165,4557,55947,192,101,91
20240,62697,6732,30177,4558,55965,192,101,91
20245,62707,6733,30183,4559,55974,192,101,91
20250,62728,6735,30194,4560,55993,192,101,91
20255,62738,6736,30198,4561,56002,192,101,91
20260,62759,6741,30211,4565,56018,192,101,91
20265,62769,6742,30213,4565,56027,192,101,91
20270,62790,6747,30222,4569,56042,192,101,91
20275,62800,6749,30226,4571,56051,192,101,91
20280,62821,6755,30236,4577,56066,192,101,91
20285,62831,6755,30239,4577,56075,192,101,91
20290,62852,6759,30249,4580,56093,192,101,91
20295,62862,6759,30255,4580,56102,192,101,91
20300,62883,6762,30264,4581,56121,192,101,91
20305,62893,6762,30265,4581,56131,192,101,91
20310,62914,6764,30274,4581,56150,192,101,91
20315,62924,6764,30277,4581,56160,192,101,91
20320,62945,6766,30285,4582,56179,192,101,91
20325,62955,6766,30289,4582,56189,192,101,91
20330,62976,6768,30300,4583,56208,192,101,91
20335,62986,6769,30306,4584,56217,192,101,91
20340,63007,6771,30317,4585,56236,192,101,91
20345,63017,6771,30321,4585,56246,192,101,91
20350,63038,6773,30331,4586,56265,192,101,91
20355,63048,6773,30335,4586,56274,192,101,91
20360,63069,6777,30346,4588,56292,192,101,91
20365,63079,6777,30351,4588,56302,192,101,91
20370,63100,6779,30361,4589,56321,192,101,91
20375,63110,6779,30367,4589,56330,192,101,91
20380,63131,6782,30378,4591,56349,192,101,91
20385,63141,6783,30381,4591,56358,192,101,91
20390,63162,6787,30396,4595,56375,192,101,91
20395,63172,6790,30403,4598,56382,192,101,91
20400,63193,6794,30413,4601,56399,192,101,91
20405,63203,6795,30417,4601,56408,192,101,91
20410,63224,6797,30421,4602,56427,192,101,91
20415,63234,6798,30425,4602,56436,192,101,91
20420,63255,6799,30437,4603,56454,192,101,91
20425,63265,6802,30440,4605,56463,192,101,91
20430,63286,6802,30447,4605,56484,192,101,91
20435,63296,6803,30452,4605,56493,192,101,91
20440,63317,6803,30461,4605,56514,192,101,91
20445,63327,6804,30467,4606,56523,192,101,91
20450,63348,6805,30476,4606,56543,192,101,91
20455,63358,6806,30482,4606,56552,192,101,91
20460,63379,6807,30489,4606,56572,192,101,91
20465,63389,6808,30493,4606,56580,192,101,91
20470,63410,6812,30506,4610,56597,192,101,91
20475,63420,6814,30510,4611,56606,192,101,91
20480,63441,6815,30521,4612,56625,192,101,91
20485,63451,6817,30526,4614,56634,192,101,91
20490,63472,6818,30537,4614,56653,192,101,91
20495,63482,6820,30541,4615,56662,192,101,91
20500,63503,6821,30554,4616,56682,192,101,91
20505,63513,6823,30560,4618,56690,192,101,91
20510,63534,6824,30567,4619,56710,192,101,91
20515,63544,6825,30571,4620,56719,192,101,91
20520,63565,6829,30583,4623,56735,192,101,91
20525,63575,6830,30586,4624,56745,192,101,91
20530,63596,6834,30596,4627,56762,192,101,91
20535,63606,6835,30602,4628,56771,192,101,91
20540,63627,6838,30612,4630,56789,192,101,91
20545,63637,6839,30616,4631,56798,192,101,91
20550,63658,6843,30623,4633,56815,192,101,91
20555,63668,6843,30627,4633,56825,192,101,91
20560,63689,6846,30639,4634,56843,192,101,91
20565,63699,6846,30642,4634,56853,192,101,91
20570,63720,6850,30651,4637,56870,192,101,91
20575,63730,6851,30657,4638,56878,192,101,91
20580,63751,6856,30667,4641,56895,192,101,91
20585,63761,6857,30674,4641,56904,192,101,91
20590,63782,6860,30686,4644,56922,192,101,91
20595,63792,6861,30692,4644,56931,192,101,91
20600,63813,6862,30698,4644,56951,192,101,91
20605,63823,6863,30705,4645,56960,192,101,91
20610,63844,6865,30717,4647,56979,192,101,91
20615,63854,6866,30722,4648,56988,192,101,91
20620,63875,6867,30731,4648,57008,192,101,91
20625,63885,6868,30737,4648,57017,192,101,91
20630,63906,6872,30747,4651,57033,192,101,91
20635,63916,6874,30751,4653,57042,192,101,91
20640,63937,6877,30762,4655,57059,192,101,91
20645,63947,6878,30767,4656,57069,192,101,91
20650,63968,6880,30779,4658,57088,192,101,91
20655,63978,6880,30786,4658,57097,192,101,91
20660,63999,6882,30792,4659,57117,192,101,91
20665,64009,6882,30799,4659,57126,192,101,91
20670,64030,6885,30811,4662,57145,192,101,91
20675,64040,6885,30818,4662,57155,192,101,91
20680,64061,6886,30825,4662,57175,192,101,91
20685,64071,6886,30831,4662,57184,192,101,91
20690,64092,6889,30843,4665,57203,192,101,91
20695,64102,6889,30848,4665,57213,192,101,91
20700,64123,6893,30859,4668,57230,192,101,91
20705,64133,6893,30866,4668,57240,192,101,91
20710,64154,6894,30878,4668,57260,192,101,91
20715,64164,6894,30882,4668,57270,192,101,91
20720,64185,6895,30894,4668,57290,192,101,91
20725,64195,6895,30899,4668,57300,192,101,91
20730,64216,6896,30909,4668,57320,192,101,91
20735,64226,6896,30912,4668,57330,192,101,91
20740,64247,6897,30922,4668,57350,192,101,91
20745,64257,6897,30926,4668,57360,192,101,91
20750,64278,6900,30934,4669,57378,192,101,91
20755,64288,6902,30938,4670,57386,192,101,91
20760,64309,6906,30951,4673,57403,192,101,91
20765,64319,6907,30957,4674,57412,192,101,91
20770,64340,6910,30964,4675,57430,192,101,91
20775,64350,6911,30971,4676,57439,192,101,91
20780,64371,6913,30980,4677,57458,192,101,91
20785,64381,6915,30985,4679,57466,192,101,91
20790,64402,6918,30994,4682,57484,192,101,91
20795,64412,6919,31001,4683,57493,192,101,91
20800,64433,6922,31013,4685,57511,192,101,91
20805,64443,6922,31016,4685,57521,192,101,91
20810,64464,6925,31029,4687,57539,192,101,91
20815,64474,6925,31034,4687,57549,192,101,91
20820,64495,6927,31045,4689,57568,192,101,91
20825,64505,6927,31048,4689,57578,192,101,91
20830,64526,6928,31060,4690,57598,192,101,91
20835,64536,6928,31068,4690,57608,192,101,91
20840,64557,6929,31078,4691,57628,192,101,91
20845,64567,6929,31083,4691,57638,192,101,91
20850,64588,6930,31097,4692,57658,192,101,91
20855,64598,6930,31100,4692,57668,192,101,91
20860,64619,6931,31106,4692,57688,192,101,91
20865,64629,6931,31110,4692,57698,192,101,91
20870,64650,6936,31122,4697,57714,192,101,91
20875,64660,6938,31127,4698,57722,192,101,91
20880,64681,6941,31138,4701,57740,192,101,91
20885,64691,6943,31146,4703,57747,192,101,91
20890,64712,6947,31158,4707,57764,192,101,91
20895,64722,6949,31163,4709,57772,192,101,91
20900,64743,6954,31179,4713,57788,192,101,91
20905,64753,6956,31183,4715,57797,192,101,91
20910,64774,6959,31194,4716,57815,192,101,91
20915,64784,6959,31198,4716,57824,192,101,91
20920,64805,6962,31203,4717,57843,192,101,91
20925,64815,6963,31209,4718,57852,192,101,91
20930,64836,6965,31222,4720,57871,192,101,91
20935,64846,6966,31228,4721,57880,192,101,91
20940,64867,6968,31238,4721,57899,192,101,91
20945,64877,6968,31243,4721,57909,192,101,91
20950,64898,6970,31254,4721,57928,192,101,91
20955,64908,6970,31261,4721,57938,192,101,91
20960,64929,6972,31273,4722,57957,192,101,91
20965,64939,6972,31278,4722,57967,192,101,91
20970,64960,6974,31285,4722,57986,192,101,91
20975,64970,6974,31290,4722,57996,192,101,91
20980,64991,6976,31300,4723,58015,192,101,91
20985,65001,6976,31304,4723,58025,192,101,91
20990,65022,6981,31315,4727,58041,192,101,91
20995,65032,6982,31319,4727,58050,192,101,91
21000,65053,6986,31329,4730,58067,192,101,91
21005,65063,6986,31333,4730,58077,192,101,91
21010,65084,6989,31339,4731,58095,192,101,91
21015,65094,6989,31343,4731,58104,192,101,91
21020,65115,6994,31350,4734,58121,192,101,91
21025,65125,6995,31357,4735,58130,192,101,91
21030,65146,6998,31367,4737,58148,192,101,91
21035,65156,6998,31372,4737,58157,192,101,91
21040,65177,7001,31381,4739,58176,192,101,91
21045,65187,7001,31385,4739,58186,192,101,91
21050,65208,7004,31395,4741,58204,192,101,91
21055,65218,7005,31403,4742,58212,192,101,91
21060,65239,7008,31412,4745,58231,192,101,91
21065,65249,7008,31420,4745,58241,192,101,91
21070,65270,7008,31426,4745,58262,192,101,91
21075,65280,7008,31429,4745,58272,192,101,91
21080,65301,7008,31445,4745,58293,192,101,91
21085,65311,7008,31452,4745,58303,192,101,91
21090,65332,7008,31462,4745,58324,192,101,91
21095,65342,7008,31464,4745,58334,192,101,91
21100,65363,7008,31471,4745,58355,192,101,91
21105,65373,7009,31477,4746,58364,192,101,91
21110,65394,7010,31490,4746,58384,192,101,91
21115,65404,7011,31496,4746,58393,192,101,91
21120,65425,7013,31508,4747,58411,192,101,91
21125,65435,7015,31514,4748,58420,192,101,91
21130,65456,7017,31525,4750,58439,192,101,91
21135,65466,7018,31529,4750,58448,192,101,91
21140,65487,7019,31540,4751,58468,192,101,91
21145,65497,7020,31543,4752,58477,192,101,91
21150,65518,7022,31551,4753,58496,192,101,91
21155,65528,7023,31558,4754,58505,192,101,91
21160,65549,7024,31566,4754,58525,192,101,91
21165,65559,7026,31572,4756,58533,192,101,91
21170,65580,7029,31582,4758,58551,192,101,91
21175,65590,7030,31588,4759,58560,192,101,91
21180,65611,7033,31603,4761,58578,192,101,91
21185,65621,7035,31605,4762,58586,192,101,91
21190,65642,7038,31618,4765,58603,192,101,91
21195,65652,7040,31622,4767,58612,192,101,91
21200,65673,7044,31633,4769,58628,192,101,91
21205,65683,7047,31638,4771,58636,192,101,91
21210,65704,7051,31650,4774,58653,192,101,91
21215,65714,7052,31656,4775,58662,192,101,91
21220,65735,7056,31663,4777,58679,192,101,91
21225,65745,7057,31665,4778,58688,192,101,91
21230,65766,7060,31676,4780,58706,192,101,91
21235,65776,7061,31680,4780,58715,192,101,91
21240,65797,7065,31691,4782,58731,192,101,91
21245,65807,7066,31697,4783,58740,192,101,91
21250,65828,7069,31708,4785,58759,192,101,91
21255,65838,7069,31713,4785,58768,192,101,91
21260,65859,7071,31722,4786,58788,192,101,91
21265,65869,7071,31730,4786,58798,192,101,91
21270,65890,7072,31743,4787,58818,192,101,91
21275,65900,7072,31749,4787,58828,192,101,91
21280,65921,7073,31756,4788,58848,192,101,91
21285,65931,7073,31757,4788,58858,192,101,91
21290,65952,7074,31766,4788,58878,192,101,91
21295,65962,7074,31772,4788,58887,192,101,91
21300,65983,7076,31784,4790,58907,192,101,91
21305,65993,7079,31790,4792,58914,192,101,91
21310,66014,7082,31798,4795,58932,192,101,91
21315,66024,7085,31802,4797,58939,192,101,91
21320,66045,7090,31812,4800,58955,192,101,91
21325,66055,7092,31820,4801,58963,192,101,91
21330,66076,7093,31827,4801,58983,192,101,91
21335,66086,7094,31832,4802,58992,192,101,91
21340,66107,7096,31843,4803,59011,192,101,91
21345,66117,7098,31849,4805,59019,192,101,91
21350,66138,7101,31859,4808,59036,192,101,91
21355,66148,7104,31863,4810,59044,192,101,91
21360,66169,7105,31871,4811,59064,192,101,91
21365,66179,7105,31874,4811,59074,192,101,91
21370,66200,7106,31881,4811,59094,192,101,91
21375,66210,7106,31886,4811,59104,192,101,91
21380,66231,7107,31894,4812,59124,192,101,91
21385,66241,7107,31900,4812,59134,192,101,91
21390,66262,7108,31911,4813,59154,192,101,91
21395,66272,7108,31916,4813,59164,192,101,91
21400,66293,7109,31929,4813,59184,192,101,91
21405,66303,7109,31935,4813,59194,192,101,91
21410,66324,7110,31946,4813,59214,192,101,91
21415,66334,7110,31948,4813,59224,192,101,91
21420,66355,7111,31956,4813,59244,192,101,91
21425,66365,7111,31959,4813,59254,192,101,91
21430,66386,7114,31970,4816,59271,192,101,91
21435,66396,7115,31974,4817,59281,192,101,91
21440,66417,7119,31983,4820,59298,192,101,91
21445,66427,7119,31986,4820,59308,192,101,91
21450,66448,7125,31998,4824,59322,192,101,91
21455,66458,7126,32003,4825,59332,192,101,91
21460,66479,7130,32013,4827,59349,192,101,91
21465,66489,7131,32019,4828,59358,192,101,91
21470,66510,7134,32028,4830,59375,192,101,91
21475,66520,7137,32035,4833,59383,192,101,91
21480,66541,7141,32042,4836,59400,192,101,91
21485,66551,7141,32045,4836,59409,192,101,91
21490,66572,7144,32053,4838,59428,192,101,91
21495,66582,7145,32058,4839,59437,192,101,91
21500,66603,7147,32069,4841,59456,192,101,91
21505,66613,7147,32073,4841,59466,192,101,91
21510,66634,7149,32084,4842,59485,192,101,91
21515,66644,7150,32090,4843,59493,192,101,91
21520,66665,7153,32100,4844,59512,192,101,91
21525,66675,7153,32103,4844,59522,192,101,91
21530,66696,7155,32119,4845,59541,192,101,91
21535,66706,7155,32124,4845,59550,192,101,91
21540,66727,7158,32135,4847,59569,192,101,91
21545,66737,7158,32138,4847,59578,192,101,91
21550,66758,7160,32146,4848,59598,192,101,91
21555,66768,7160,32151,4848,59608,192,101,91
21560,66789,7161,32161,4849,59628,192,101,91
21565,66799,7161,32167,4849,59638,192,101,91
21570,66820,7162,32178,4849,59658,192,101,91
21575,66830,7162,32182,4849,59668,192,101,91
21580,66851,7163,32195,4849,59688,192,101,91
21585,66861,7163,32201,4849,59697,192,101,91
21590,66882,7167,32209,4853,59715,192,101,91
21595,66892,7170,32215,4856,59721,192,101,91
21600,66913,7174,32222,4859,59739,192,101,91
21605,66923,7175,32226,4860,59748,192,101,91
21610,66944,7177,32239,4861,59767,192,101,91
21615,66954,7178,32243,4861,59776,192,101,91
21620,66975,7181,32254,4863,59794,192,101,91
21625,66985,7182,32260,4864,59803,192,101,91
21630,67006,7184,32271,4866,59822,192,101,91
21635,67016,7185,32274,4866,59831,192,101,91
21640,67037,7187,32287,4868,59850,192,101,91
21645,67047,7188,32294,4868,59859,192,101,91
21650,67068,7190,32305,4870,59878,192,101,91
21655,67078,7191,32312,4871,59887,192,101,91
21660,67099,7193,32322,4871,59906,192,101,91
21665,67109,7194,32327,4871,59915,192,101,91
21670,67130,7196,32332,4871,59934,192,101,91
21675,67140,7197,32338,4871,59943,192,101,91
21680,67161,7199,32350,4872,59962,192,101,91
21685,67171,7200,32358,4873,59971,192,101,91
21690,67192,7202,32370,4875,59990,192,101,91
21695,67202,7203,32375,4875,59999,192,101,91
21700,67223,7205,32382,4876,60018,192,101,91
21705,67233,7206,32386,4877,60027,192,101,91
21710,67254,7210,32394,4879,60044,192,101,91
21715,67264,7211,32402,4880,60052,192,101,91
21720,67285,7215,32408,4883,60070,192,101,91
21725,67295,7215,32415,4883,60080,192,101,91
21730,67316,7216,32426,4884,60100,192,101,91
21735,67326,7216,32430,4884,60110,192,101,91
21740,67347,7217,32444,4884,60130,192,101,91
21745,67357,7217,32449,4884,60140,192,101,91
21750,67378,7218,32456,4884,60160,192,101,91
21755,67388,7218,32461,4884,60170,192,101,91
21760,67409,7219,32470,4885,60190,192,101,91
21765,67419,7219,32476,4885,60200,192,101,91
21770,67440,7220,32485,4885,60220,192,101,91
21775,67450,7220,32489,4885,60230,192,101,91
21780,67471,7221,32499,4886,60250,192,101,91
21785,67481,7221,32504,4886,60260,192,101,91
21790,67502,7222,32514,4886,60280,192,101,91
21795,67512,7222,32516,4886,60290,192,101,91
21800,67533,7223,32528,4887,60310,192,101,91
21805,67543,7223,32532,4887,60320,192,101,91
21810,67564,7224,32543,4888,60340,192,101,91
21815,67574,7224,32550,4888,60350,192,101,91
21820,67595,7225,32563,4888,60370,192,101,91
21825,67605,7225,32568,4888,60380,192,101,91
21830,67626,7230,32582,4892,60396,192,101,91
21835,67636,7233,32589,4895,60402,192,101,91
21840,67657,7238,32596,4898,60417,192,101,91
21845,67667,7241,32598,4900,60426,192,101,91
21850,67688,7243,32610,4901,60445,192,101,91
21855,67698,7244,32612,4902,60454,192,101,91
21860,67719,7246,32618,4903,60473,192,101,91
21865,67729,7247,32623,4904,60482,192,101,91
21870,67750,7249,32636,4906,60501,192,101,91
21875,67760,7250,32640,4906,60510,192,101,91
21880,67781,7252,32648,4907,60529,192,101,91
21885,67791,7254,32654,4909,60537,192,101,91
21890,67812,7256,32663,4910,60556,192,101,91
21895,67822,7257,32667,4910,60565,192,101,91
21900,67843,7258,32675,4910,60585,192,101,91
21905,67853,7258,32681,4910,60595,192,101,91
21910,67874,7260,32687,4911,60614,192,101,91
21915,67884,7260,32694,4911,60624,192,101,91
21920,67905,7260,32706,4911,60645,192,101,91
21925,67915,7260,32711,4911,60655,192,101,91
21930,67936,7260,32724,4911,60676,192,101,91
21935,67946,7260,32726,4911,60686,192,101,91
21940,67967,7260,32734,4911,60707,192,101,91
21945,67977,7260,32739,4911,60716,192,101,91
21950,67998,7263,32751,4914,60735,192,101,91
21955,68008,7263,32757,4914,60745,192,101,91
21960,68029,7265,32768,4915,60764,192,101,91
21965,68039,7266,32773,4916,60773,192,101,91
21970,68060,7270,32781,4919,60789,192,101,91
21975,68070,7272,32786,4921,60798,192,101,91
21980,68091,7275,32794,4923,60816,192,101,91
21985,68101,7276,32798,4923,60825,192,101,91
21990,68122,7279,32808,4924,60842,192,101,91
21995,68132,7281,32812,4926,60851,192,101,91
22000,68153,7284,32819,4927,60869,192,101,91
22005,68163,7286,32825,4928,60877,192,101,91
22010,68184,7290,32841,4930,60893,192,101,91
22015,68194,7292,32843,4932,60902,192,101,91
22020,68215,7295,32849,4933,60919,192,101,91
22025,68225,7297,32856,4935,60928,192,101,91
22030,68246,7298,32865,4936,60948,192,101,91
22035,68256,7298,32871,4936,60958,192,101,91
22040,68277,7299,32883,4937,60978,192,101,91
22045,68287,7299,32886,4937,60988,192,101,91
22050,68308,7300,32893,4938,61008,192,101,91
22055,68318,7300,32898,4938,61018,192,101,91
22060,68339,7302,32907,4939,61037,192,101,91
22065,68349,7302,32913,4939,61047,192,101,91
22070,68370,7303,32918,4939,61067,192,101,91
22075,68380,7303,32923,4939,61077,192,101,91
22080,68401,7304,32933,4939,61097,192,101,91
22085,68411,7305,32938,4940,61105,192,101,91
22090,68432,7309,32947,4944,61123,192,101,91
22095,68442,7310,32954,4945,61132,192,101,91
22100,68463,7313,32966,4947,61150,192,101,91
22105,68473,7314,32972,4948,61158,192,101,91
22110,68494,7317,32983,4950,61177,192,101,91
22115,68504,7318,32986,4951,61185,192,101,91
22120,68525,7322,32999,4955,61203,192,101,91
22125,68535,7323,33003,4956,61212,192,101,91
22130,68556,7327,33010,4958,61229,192,101,91
22135,68566,7328,33015,4958,61237,192,101,91
22140,68587,7331,33024,4960,61256,192,101,91
22145,68597,7332,33025,4960,61265,192,101,91
22150,68618,7332,33036,4960,61286,192,101,91
22155,68628,7333,33040,4960,61295,192,101,91
22160,68649,7334,33051,4961,61315,192,101,91
22165,68659,7335,33056,4962,61324,192,101,91
22170,68680,7336,33066,4963,61344,192,101,91
22175,68690,7337,33070,4964,61353,192,101,91
22180,68711,7338,33084,4965,61373,192,101,91
22185,68721,7339,33089,4966,61382,192,101,91
22190,68742,7342,33100,4969,61400,192,101,91
22195,68752,7343,33106,4970,61408,192,101,91
22200,68773,7346,33116,4972,61426,192,101,91
22205,68783,7347,33121,4973,61436,192,101,91
22210,68804,7349,33129,4973,61455,192,101,91
22215,68814,7349,33133,4973,61465,192,101,91
22220,68835,7351,33144,4974,61484,192,101,91
22225,68845,7351,33149,4974,61494,192,101,91
22230,68866,7353,33156,4975,61513,192,101,91
22235,68876,7353,33160,4975,61523,192,101,91
22240,68897,7355,33170,4976,61542,192,101,91
22245,68907,7355,33176,4976,61552,192,101,91
22250,68928,7359,33185,4978,61568,192,101,91
22255,68938,7360,33188,4979,61578,192,101,91
22260,68959,7364,33198,4981,61595,192,101,91
22265,68969,7364,33201,4981,61604,192,101,91
22270,68990,7367,33209,4983,61623,192,101,91
22275,69000,7367,33214,4983,61633,192,101,91
22280,69021,7369,33221,4983,61652,192,101,91
22285,69031,7369,33223,4983,61662,192,101,91
22290,69052,7371,33232,4984,61681,192,101,91
22295,69062,7372,33237,4985,61690,192,101,91
22300,69083,7374,33243,4985,61709,192,101,91
22305,69093,7375,33247,4986,61718,192,101,91
22310,69114,7377,33256,4987,61737,192,101,91
22315,69124,7378,33259,4988,61746,192,101,91
22320,69145,7380,33272,4988,61765,192,101,91
22325,69155,7381,33280,4989,61774,192,101,91
22330,69176,7383,33289,4991,61793,192,101,91
22335,69186,7384,33292,4991,61802,192,101,91
22340,69207,7385,33301,4991,61822,192,101,91
22345,69217,7386,33306,4991,61831,192,101,91
22350,69238,7387,33320,4991,61851,192,101,91
22355,69248,7388,33325,4992,61860,192,101,91
22360,69269,7389,33334,4993,61880,192,101,91
22365,69279,7390,33339,4993,61889,192,101,91
22370,69300,7391,33346,4993,61909,192,101,91
22375,69310,7392,33348,4993,61918,192,101,91
22380,69331,7393,33358,4994,61938,192,101,91
22385,69341,7394,33364,4995,61947,192,101,91
22390,69362,7395,33375,4996,61967,192,101,91
22395,69372,7396,33381,4997,61976,192,101,91
22400,69393,7397,33388,4997,61996,192,101,91
22405,69403,7398,33394,4998,62005,192,101,91
22410,69424,7399,33401,4998,62025,192,101,91
22415,69434,7400,33406,4999,62034,192,101,91
22420,69455,7401,33416,4999,62054,192,101,91
22425,69465,7402,33417,4999,62063,192,101,91
22430,69486,7405,33427,5002,62081,192,101,91
22435,69496,7407,33434,5003,62089,192,101,91
22440,69517,7412,33447,5008,62105,192,101,91
22445,69527,7412,33452,5008,62115,192,101,91
22450,69548,7412,33458,5008,62136,192,101,91
22455,69558,7412,33463,5008,62146,192,101,91
22460,69579,7412,33474,5008,62167,192,101,91
22465,69589,7412,33479,5008,62177,192,101,91
22470,69610,7412,33484,5008,62198,192,101,91
22475,69620,7412,33488,5008,62208,192,101,91
22480,69641,7412,33498,5008,62229,192,101,91
22485,69651,7412,33503,5008,62239,192,101,91
22490,69672,7412,33512,5008,62260,192,101,91
22495,69682,7412,33519,5008,62270,192,101,91
22500,69703,7412,33528,5008,62291,192,101,91
22505,69713,7412,33535,5008,62301,192,101,91
22510,69734,7412,33544,5008,62322,192,101,91
22515,69744,7412,33547,5008,62332,192,101,91
22520,69765,7412,33559,5008,62353,192,101,91
22525,69775,7412,33562,5008,62363,192,101,91
22530,69796,7412,33573,5008,62384,192,101,91
22535,69806,7412,33578,5008,62394,192,101,91
22540,69827,7412,33588,5008,62415,192,101,91
22545,69837,7413,33591,5008,62424,192,101,91
22550,69858,7418,33603,5010,62438,192,101,91
22555,69868,7421,33604,5012,62447,192,101,91
22560,69889,7427,33614,5016,62461,192,101,91
22565,69899,7429,33621,5018,62470,192,101,91
22570,69920,7431,33634,5019,62489,192,101,91
22575,69930,7432,33638,5020,62498,192,101,91
22580,69951,7434,33650,5021,62517,192,101,91
22585,69961,7435,33654,5022,62526,192,101,91
22590,69982,7437,33667,5022,62545,192,101,91
22595,69992,7438,33674,5023,62554,192,101,91
22600,70013,7440,33685,5025,62573,192,101,91
22605,70023,7441,33688,5025,62582,192,101,91
22610,70044,7443,33697,5026,62601,192,101,91
22615,70054,7444,33705,5027,62610,192,101,91
22620,70075,7446,33716,5029,62629,192,101,91
22625,70085,7447,33719,5029,62638,192,101,91
22630,70106,7449,33732,5030,62657,192,101,91
22635,70116,7450,33736,5031,62666,192,101,91
22640,70137,7452,33745,5031,62685,192,101,91
22645,70147,7453,33751,5032,62694,192,101,91
22650,70168,7455,33762,5034,62713,192,101,91
22655,70178,7456,33767,5034,62722,192,101,91
22660,70199,7458,33775,5035,62741,192,101,91
22665,70209,7459,33779,5035,62750,192,101,91
22670,70230,7462,33789,5037,62765,192,101,91
22675,70240,7467,33794,5041,62772,192,101,91
22680,70261,7472,33804,5044,62787,192,101,91
22685,70271,7474,33806,5046,62797,192,101,91
22690,70292,7477,33814,5048,62815,192,101,91
22695,70302,7477,33817,5048,62825,192,101,91
22700,70323,7478,33826,5049,62844,192,101,91
22705,70333,7478,33830,5049,62855,192,101,91
22710,70354,7479,33839,5050,62875,192,101,91
22715,70364,7479,33844,5050,62885,192,101,91
22720,70385,7481,33855,5051,62904,192,101,91
22725,70395,7481,33860,5051,62914,192,101,91
22730,70416,7483,33869,5052,62933,192,101,91
22735,70426,7483,33873,5052,62943,192,101,91
22740,70447,7484,33883,5052,62963,192,101,91
22745,70457,7486,33890,5054,62971,192,101,91
22750,70478,7489,33899,5056,62989,192,101,91
22755,70488,7490,33902,5056,62998,192,101,91
22760,70509,7491,33911,5057,63018,192,101,91
22765,70519,7492,33917,5058,63027,192,101,91
22770,70540,7493,33928,5058,63047,192,101,91
22775,70550,7494,33934,5059,63056,192,101,91
22780,70571,7495,33945,5059,63076,192,101,91
22785,70581,7496,33950,5060,63085,192,101,91
22790,70602,7497,33960,5060,63105,192,101,91
22795,70612,7498,33966,5060,63114,192,101,91
22800,70633,7500,33975,5061,63133,192,101,91
22805,70643,7501,33977,5061,63142,192,101,91
22810,70664,7502,33986,5062,63162,192,101,91
22815,70674,7503,33989,5063,63171,192,101,91
22820,70695,7504,33997,5063,63191,192,101,91
22825,70705,7505,34003,5064,63200,192,101,91
22830,70726,7506,34011,5064,63220,192,101,91
22835,70736,7507,34015,5064,63229,192,101,91
22840,70757,7508,34023,5065,63249,192,101,91
22845,70767,7509,34028,5066,63258,192,101,91
22850,70788,7510,34040,5067,63277,192,101,91
22855,70798,7512,34043,5068,63286,192,101,91
22860,70819,7514,34053,5069,63305,192,101,91
22865,70829,7514,34059,5069,63315,192,101,91
22870,70850,7515,34072,5069,63335,192,101,91
22875,70860,7515,34078,5069,63345,192,101,91
22880,70881,7516,34090,5070,63365,192,101,91
22885,70891,7516,34095,5070,63375,192,101,91
22890,70912,7517,34104,5070,63395,192,101,91
22895,70922,7517,34108,5070,63405,192,101,91
22900,70943,7518,34122,5070,63425,192,101,91
22905,70953,7518,34124,5070,63435,192,101,91
22910,70974,7520,34135,5071,63454,192,101,91
22915,70984,7520,34142,5071,63463,192,101,91
22920,71005,7523,34152,5073,63482,192,101,91
22925,71015,7523,34155,5073,63492,192,101,91
22930,71036,7525,34164,5073,63511,192,101,91
22935,71046,7526,34170,5074,63520,192,101,91
22940,71067,7528,34180,5076,63539,192,101,91
22945,71077,7529,34185,5077,63548,192,101,91
22950,71098,7532,34192,5079,63566,192,101,91
22955,71108,7532,34196,5079,63576,192,101,91
22960,71129,7534,34206,5079,63595,192,101,91
22965,71139,7535,34213,5080,63604,192,101,91
22970,71160,7540,34228,5084,63620,192,101,91
22975,71170,7541,34232,5085,63629,192,101,91
22980,71191,7547,34242,5089,63643,192,101,91
22985,71201,7548,34247,5090,63652,192,101,91
22990,71222,7551,34261,5091,63671,192,101,91
22995,71232,7551,34265,5091,63681,192,101,91
23000,71253,7552,34272,5092,63701,192,101,91
23005,71263,7552,34280,5092,63711,192,101,91
23010,71284,7553,34292,5092,63731,192,101,91
23015,71294,7553,34297,5092,63741,192,101,91
23020,71315,7554,34307,5093,63761,192,101,91
23025,71325,7554,34311,5093,63771,192,101,91
23030,71346,7555,34320,5093,63791,192,101,91
23035,71356,7555,34327,5093,63801,192,101,91
23040,71377,7556,34339,5094,63821,192,101,91
23045,71387,7556,34343,5094,63830,192,101,91
23050,71408,7559,34351,5096,63849,192,101,91
23055,71418,7559,34352,5096,63859,192,101,91
23060,71439,7561,34361,5097,63878,192,101,91
23065,71449,7561,34364,5097,63888,192,101,91
23070,71470,7563,34376,5099,63907,192,101,91
23075,71480,7563,34379,5099,63917,192,101,91
23080,71501,7565,34390,5100,63936,192,101,91
23085,71511,7565,34394,5100,63946,192,101,91
23090,71532,7570,34409,5105,63960,192,101,91
23095,71542,7574,34412,5108,63967,192,101,91
23100,71563,7579,34423,5111,63981,192,101,91
23105,71573,7582,34427,5114,63991,192,101,91
23110,71594,7584,34434,5115,64010,192,101,91
23115,71604,7584,34440,5115,64020,192,101,91
23120,71625,7587,34455,5118,64038,192,101,91
23125,71635,7587,34458,5118,64048,192,101,91
23130,71656,7589,34466,5118,64067,192,101,91
23135,71666,7589,34471,5118,64077,192,101,91
23140,71687,7591,34480,5119,64096,192,101,91
23145,71697,7591,34485,5119,64106,192,101,91
23150,71718,7594,34493,5121,64124,192,101,91
23155,71728,7594,34498,5121,64134,192,101,91
23160,71749,7596,34506,5122,64153,192,101,91
23165,71759,7596,34508,5122,64163,192,101,91
23170,71780,7597,34518,5123,64183,192,101,91
23175,71790,7597,34524,5123,64193,192,101,91
23180,71811,7598,34532,5124,64213,192,101,91
23185,71821,7598,34537,5124,64223,192,101,91
23190,71842,7599,34548,5125,64243,192,101,91
23195,71852,7599,34551,5125,64253,192,101,91
23200,71873,7600,34562,5125,64273,192,101,91
23205,71883,7600,34568,5125,64283,192,101,91
23210,71904,7605,34578,5128,64298,192,101,91
23215,71914,7608,34583,5130,64306,192,101,91
23220,71935,7611,34593,5131,64322,192,101,91
23225,71945,7614,34596,5134,64331,192,101,91
23230,71966,7618,34607,5136,64348,192,101,91
23235,71976,7619,34614,5137,64357,192,101,91
23240,71997,7622,34623,5139,64375,192,101,91
23245,72007,7622,34626,5139,64385,192,101,91
23250,72028,7625,34633,5140,64403,192,101,91
23255,72038,7625,34638,5140,64413,192,101,91
23260,72059,7628,34646,5142,64431,192,101,91
23265,72069,7628,34650,5142,64441,192,101,91
23270,72090,7631,34662,5144,64459,192,101,91
23275,72100,7631,34667,5144,64469,192,101,91
23280,72121,7634,34676,5147,64487,192,101,91
23285,72131,7634,34682,5147,64496,192,101,91
23290,72152,7636,34689,5148,64516,192,101,91
23295,72162,7636,34695,5148,64526,192,101,91
23300,72183,7636,34707,5148,64547,192,101,91
23305,72193,7636,34711,5148,64557,192,101,91
23310,72214,7636,34722,5148,64578,192,101,91
23315,72224,7636,34726,5148,64588,192,101,91
23320,72245,7636,34736,5148,64609,192,101,91
23325,72255,7636,34741,5148,64619,192,101,91
23330,72276,7636,34751,5148,64640,192,101,91
23335,72286,7637,34757,5149,64649,192,101,91
23340,72307,7637,34770,5149,64670,192,101,91
23345,72317,7638,34778,5150,64679,192,101,91
23350,72338,7640,34788,5151,64697,192,101,91
23355,72348,7642,34792,5152,64706,192,101,91
23360,72369,7643,34799,5152,64726,192,101,91
23365,72379,7644,34807,5153,64735,192,101,91
23370,72400,7644,34817,5153,64756,192,101,91
23375,72410,7646,34823,5154,64764,192,101,91
23380,72431,7646,34834,5154,64785,192,101,91
23385,72441,7647,34837,5154,64794,192,101,91
23390,72462,7648,34849,5155,64814,192,101,91
23395,72472,7650,34855,5157,64821,192,101,91
23400,72493,7653,34866,5159,64840,192,101,91
23405,72503,7655,34872,5160,64848,192,101,91
23410,72524,7657,34885,5162,64866,192,101,91
23415,72534,7660,34891,5164,64874,192,101,91
23420,72555,7661,34901,5165,64894,192,101,91
23425,72565,7663,34906,5166,64902,192,101,91
23430,72586,7665,34913,5167,64921,192,101,91
23435,72596,7667,34917,5168,64929,192,101,91
23440,72617,7668,34927,5168,64949,192,101,91
23445,72627,7669,34929,5169,64958,192,101,91
23450,72648,7671,34942,5170,64976,192,101,91
23455,72658,7673,34946,5172,64985,192,101,91
23460,72679,7675,34955,5173,65004,192,101,91
23465,72689,7675,34962,5173,65014,192,101,91
23470,72710,7680,34976,5177,65030,192,101,91
23475,72720,7680,34982,5177,65040,192,101,91
23480,72741,7684,34995,5181,65057,192,101,91
23485,72751,7684,35001,5181,65067,192,101,91
23490,72772,7687,35011,5183,65085,192,101,91
23495,72782,7688,35020,5184,65094,192,101,91
23500,72803,7692,35033,5186,65111,192,101,91
23505,72813,7692,35037,5186,65121,192,101,91
23510,72834,7695,35047,5188,65139,192,101,91
23515,72844,7696,35053,5189,65148,192,101,91
23520,72865,7700,35062,5191,65165,192,101,91
23525,72875,7700,35069,5191,65175,192,101,91
23530,72896,7701,35076,5192,65195,192,101,91
23535,72906,7701,35082,5192,65205,192,101,91
23540,72927,7702,35095,5193,65225,192,101,91
23545,72937,7702,35100,5193,65235,192,101,91
23550,72958,7703,35107,5193,65255,192,101,91
23555,72968,7703,35110,5193,65265,192,101,91
23560,72989,7704,35121,5193,65285,192,101,91
23565,72999,7704,35126,5193,65295,192,101,91
23570,73020,7705,35134,5193,65315,192,101,91
23575,73030,7705,35136,5193,65325,192,101,91
23580,73051,7706,35151,5194,65345,192,101,91
23585,73061,7707,35158,5195,65354,192,101,91
23590,73082,7709,35165,5197,65372,192,101,91
23595,73092,7710,35168,5198,65382,192,101,91
23600,73113,7711,35178,5199,65401,192,101,91
23605,73123,7712,35184,5200,65411,192,101,91
23610,73144,7714,35194,5202,65429,192,101,91
23615,73154,7715,35198,5203,65439,192,101,91
23620,73175,7717,35211,5204,65458,192,101,91
23625,73185,7717,35215,5204,65468,192,101,91
23630,73206,7721,35225,5206,65484,192,101,91
23635,73216,7724,35228,5208,65492,192,101,91
23640,73237,7726,35238,5210,65510,192,101,91
23645,73247,7729,35244,5212,65518,192,101,91
23650,73268,7730,35254,5212,65536,192,101,91
23655,73278,7733,35260,5215,65544,192,101,91
23660,73299,7735,35268,5217,65564,192,101,91
23665,73309,7736,35272,5218,65573,192,101,91
23670,73330,7737,35282,5219,65593,192,101,91
23675,73340,7737,35288,5219,65603,192,101,91
23680,73361,7738,35300,5220,65623,192,101,91
23685,73371,7738,35305,5220,65633,192,101,91
23690,73392,7739,35316,5221,65653,192,101,91
23695,73402,7739,35320,5221,65663,192,101,91
23700,73423,7740,35327,5221,65683,192,101,91
23705,73433,7740,35330,5221,65693,192,101,91
23710,73454,7741,35342,5222,65713,192,101,91
23715,73464,7741,35347,5222,65723,192,101,91
23720,73485,7742,35359,5222,65743,192,101,91
23725,73495,7742,35365,5222,65753,192,101,91
23730,73516,7743,35376,5223,65773,192,101,91
23735,73526,7743,35381,5223,65783,192,101,91
23740,73547,7744,35395,5223,65803,192,101,91
23745,73557,7744,35401,5223,65813,192,101,91
23750,73578,7746,35411,5224,65831,192,101,91
23755,73588,7748,35416,5226,65840,192,101,91
23760,73609,7752,35427,5228,65856,192,101,91
23765,73619,7756,35434,5231,65863,192,101,91
23770,73640,7759,35446,5233,65881,192,101,91
23775,73650,7761,35450,5235,65889,192,101,91
23780,73671,7764,35462,5237,65907,192,101,91
23785,73681,7766,35469,5238,65915,192,101,91
23790,73702,7768,35475,5239,65934,192,101,91
23795,73712,7770,35478,5240,65942,192,101,91
23800,73733,7772,35487,5240,65961,192,101,91
23805,73743,7773,35492,5240,65970,192,101,91
23810,73764,7776,35500,5241,65988,192,101,91
23815,73774,7777,35503,5241,65997,192,101,91
23820,73795,7779,35514,5242,66016,192,101,91
23825,73805,7780,35520,5243,66025,192,101,91
23830,73826,7781,35531,5243,66045,192,101,91
23835,73836,7782,35537,5244,66054,192,101,91
23840,73857,7783,35546,5245,66074,192,101,91
23845,73867,7784,35548,5245,66083,192,101,91
23850,73888,7785,35560,5245,66103,192,101,91
23855,73898,7786,35565,5246,66112,192,101,91
23860,73919,7787,35574,5246,66132,192,101,91
23865,73929,7788,35579,5246,66141,192,101,91
23870,73950,7791,35588,5249,66159,192,101,91
23875,73960,7793,35593,5251,66166,192,101,91
23880,73981,7797,35601,5254,66184,192,101,91
23885,73991,7798,35606,5255,66193,192,101,91
23890,74012,7798,35617,5255,66214,192,101,91
23895,74022,7799,35621,5256,66223,192,101,91
23900,74043,7799,35636,5256,66244,192,101,91
23905,74053,7800,35638,5257,66253,192,101,91
23910,74074,7800,35650,5257,66274,192,101,91
23915,74084,7801,35657,5258,66283,192,101,91
23920,74105,7801,35665,5258,66304,192,101,91
23925,74115,7802,35668,5258,66313,192,101,91
23930,74136,7802,35677,5258,66334,192,101,91
23935,74146,7803,35679,5259,66343,192,101,91
23940,74167,7803,35692,5259,66364,192,101,91
23945,74177,7804,35698,5259,66373,192,101,91
23950,74198,7804,35708,5259,66394,192,101,91
23955,74208,7805,35711,5260,66403,192,101,91
23960,74229,7805,35719,5260,66424,192,101,91
23965,74239,7806,35722,5260,66433,192,101,91
23970,74260,7806,35732,5260,66454,192,101,91
23975,74270,7807,35737,5260,66463,192,101,91
23980,74291,7807,35746,5260,66484,192,101,91
23985,74301,7808,35748,5261,66493,192,101,91
23990,74322,7814,35756,5264,66508,192,101,91
23995,74332,7816,35759,5266,66516,192,101,91
24000,74353,7822,35771,5270,66528,192,101,91
24005,74363,7825,35776,5273,66538,192,101,91
24010,74384,7825,35790,5273,66559,192,101,91
24015,74394,7825,35796,5273,66569,192,101,91
24020,74415,7825,35805,5273,66590,192,101,91
24025,74425,7825,35810,5273,66600,192,101,91
24030,74446,7825,35821,5273,66621,192,101,91
24035,74456,7825,35829,5273,66631,192,101,91
24040,74477,7825,35840,5273,66652,192,101,91
24045,74487,7825,35848,5273,66662,192,101,91
24050,74508,7825,35857,5273,66683,192,101,91
24055,74518,7825,35863,5273,66693,192,101,91
24060,74539,7825,35873,5273,66714,192,101,91
24065,74549,7827,35879,5275,66722,192,101,91
24070,74570,7830,35886,5276,66740,192,101,91
24075,74580,7831,35890,5277,66749,192,101,91
24080,74601,7835,35899,5280,66766,192,101,91
24085,74611,7837,35903,5281,66774,192,101,91
24090,74632,7841,35912,5284,66791,192,101,91
24095,74642,7843,35916,5286,66799,192,101,91
24100,74663,7846,35928,5288,66817,192,101,91
24105,74673,7848,35933,5290,66825,192,101,91
24110,74694,7851,35944,5292,66843,192,101,91
24115,74704,7853,35952,5294,66850,192,101,91
24120,74725,7858,35963,5298,66867,192,101,91
24125,74735,7859,35967,5298,66876,192,101,91
24130,74756,7859,35977,5298,66897,192,101,91
24135,74766,7860,35982,5299,66906,192,101,91
24140,74787,7860,35991,5299,66927,192,101,91
24145,74797,7861,35995,5299,66936,192,101,91
24150,74818,7861,36008,5299,66957,192,101,91
24155,74828,7862,36012,5299,66966,192,101,91
24160,74849,7862,36021,5299,66987,192,101,91
24165,74859,7863,36026,5299,66996,192,101,91
24170,74880,7863,36036,5299,67017,192,101,91
24175,74890,7864,36041,5299,67026,192,101,91
24180,74911,7864,36047,5299,67045,192,101,91
24185,74921,7866,36055,5301,67055,192,101,91
24190,74942,7866,36065,5301,67076,192,101,91
24195,74952,7866,36072,5301,67086,192,101,91
24200,74973,7866,36082,5301,67107,192,101,91
24205,74983,7866,36087,5301,67117,192,101,91
24210,75004,7866,36096,5301,67138,192,101,91
24215,75014,7866,36100,5301,67148,192,101,91
24220,75035,7866,36112,5301,67169,192,101,91
24225,75045,7866,36115,5301,67178,192,101,91
24230,75066,7869,36129,5304,67197,192,101,91
24235,75076,7869,36131,5304,67207,192,101,91
24240,75097,7871,36143,5306,67226,192,101,91
24245,75107,7871,36150,5306,67236,192,101,91
24250,75128,7871,36157,5306,67257,192,101,91
24255,75138,7871,36161,5306,67267,192,101,91
24260,75159,7871,36173,5306,67288,192,101,91
24265,75169,7871,36177,5306,67298,192,101,91
24270,75190,7871,36187,5306,67319,192,101,91
24275,75200,7871,36193,5306,67329,192,101,91
24280,75221,7871,36202,5306,67350,192,101,91
24285,75231,7871,36207,5306,67360,192,101,91
24290,75252,7876,36216,5309,67376,192,101,91
24295,75262,7878,36220,5310,67384,192,101,91
24300,75283,7884,36235,5315,67396,192,101,91
24305,75293,7887,36243,5318,67405,192,101,91
24310,75314,7891,36252,5322,67423,192,101,91
24315,75324,7891,36258,5322,67433,192,101,91
24320,75345,7895,36270,5325,67450,192,101,91
24325,75355,7895,36276,5325,67460,192,101,91
24330,75376,7899,36289,5329,67477,192,101,91
24335,75386,7899,36294,5329,67487,192,101,91
24340,75407,7902,36304,5331,67505,192,101,91
24345,75417,7903,36308,5332,67514,192,101,91
24350,75438,7906,36317,5334,67532,192,101,91
24355,75448,7907,36322,5335,67541,192,101,91
24360,75469,7910,36331,5336,67559,192,101,91
24365,75479,7911,36336,5336,67567,192,101,91
24370,75500,7916,36346,5339,67584,192,101,91
24375,75510,7917,36350,5339,67592,192,101,91
24380,75531,7921,36356,5341,67609,192,101,91
24385,75541,7923,36362,5342,67618,192,101,91
24390,75562,7927,36373,5344,67634,192,101,91
24395,75572,7929,36381,5346,67642,192,101,91
24400,75593,7933,36389,5348,67660,192,101,91
24405,75603,7935,36395,5349,67668,192,101,91
24410,75624,7940,36405,5354,67683,192,101,91
24415,75634,7944,36409,5358,67690,192,101,91
24420,75655,7951,36419,5364,67704,192,101,91
24425,75665,7951,36422,5364,67713,192,101,91
24430,75686,7953,36434,5365,67733,192,101,91
24435,75696,7953,36439,5365,67742,192,101,91
24440,75717,7955,36443,5367,67762,192,101,91
24445,75727,7955,36449,5367,67772,192,101,91
24450,75748,7956,36461,5368,67792,192,101,91
24455,75758,7956,36466,5368,67802,192,101,91
24460,75779,7957,36476,5368,67822,192,101,91
24465,75789,7957,36483,5368,67831,192,101,91
24470,75810,7959,36496,5370,67851,192,101,91
24475,75820,7959,36500,5370,67860,192,101,91
24480,75841,7961,36508,5372,67880,192,101,91
24485,75851,7961,36512,5372,67890,192,101,91
24490,75872,7961,36522,5372,67911,192,101,91
24495,75882,7961,36525,5372,67921,192,101,91
24500,75903,7961,36533,5372,67942,192,101,91
24505,75913,7961,36538,5372,67952,192,101,91
24510,75934,7961,36544,5372,67973,192,101,91
24515,75944,7961,36548,5372,67983,192,101,91
24520,75965,7961,36558,5372,68004,192,101,91
24525,75975,7962,36562,5372,68013,192,101,91
24530,75996,7967,36575,5376,68029,192,101,91
24535,76006,7968,36580,5377,68038,192,101,91
24540,76027,7972,36588,5380,68054,192,101,91
24545,76037,7974,36590,5381,68063,192,101,91
24550,76058,7976,36595,5382,68082,192,101,91
24555,76068,7977,36599,5382,68091,192,101,91
24560,76089,7979,36608,5384,68110,192,101,91
24565,76099,7980,36612,5384,68119,192,101,91
24570,76120,7982,36625,5385,68138,192,101,91
24575,76130,7983,36630,5386,68147,192,101,91
24580,76151,7985,36639,5386,68166,192,101,91
24585,76161,7986,36644,5386,68175,192,101,91
24590,76182,7989,36655,5387,68193,192,101,91
24595,76192,7990,36660,5387,68201,192,101,91
24600,76213,7994,36670,5390,68219,192,101,91
24605,76223,7995,36672,5390,68228,192,101,91
24610,76244,7997,36686,5391,68247,192,101,91
24615,76254,7998,36690,5391,68256,192,101,91
24620,76275,8000,36703,5392,68275,192,101,91
24625,76285,8001,36706,5392,68284,192,101,91
24630,76306,8003,36713,5392,68303,192,101,91
24635,76316,8004,36716,5393,68312,192,101,91
24640,76337,8006,36726,5395,68331,192,101,91
24645,76347,8007,36732,5396,68340,192,101,91
24650,76368,8011,36744,5400,68357,192,101,91
24655,76378,8012,36750,5401,68366,192,101,91
24660,76399,8014,36758,5401,68384,192,101,91
24665,76409,8015,36763,5402,68394,192,101,91
24670,76430,8015,36768,5402,68415,192,101,91
24675,76440,8015,36773,5402,68425,192,101,91
24680,76461,8015,36781,5402,68446,192,101,91
24685,76471,8015,36785,5402,68456,192,101,91
24690,76492,8015,36798,5402,68477,192,101,91
24695,76502,8015,36803,5402,68487,192,101,91
24700,76523,8015,36816,5402,68508,192,101,91
24705,76533,8015,36822,5402,68518,192,101,91
24710,76554,8016,36832,5402,68538,192,101,91
24715,76564,8016,36836,5402,68548,192,101,91
24720,76585,8017,36847,5402,68568,192,101,91
24725,76595,8020,36852,5405,68575,192,101,91
24730,76616,8021,36857,5405,68595,192,101,91
24735,76626,8022,36860,5406,68604,192,101,91
24740,76647,8023,36869,5406,68624,192,101,91
24745,76657,8023,36875,5406,68634,192,101,91
24750,76678,8024,36884,5407,68654,192,101,91
24755,76688,8025,36891,5408,68663,192,101,91
24760,76709,8026,36900,5409,68683,192,101,91
24765,76719,8026,36904,5409,68693,192,101,91
24770,76740,8029,36915,5411,68711,192,101,91
24775,76750,8031,36920,5413,68719,192,101,91
24780,76771,8036,36931,5416,68734,192,101,91
24785,76781,8037,36935,5417,68744,192,101,91
24790,76802,8040,36951,5419,68762,192,101,91
24795,76812,8040,36957,5419,68772,192,101,91
24800,76833,8042,36966,5420,68791,192,101,91
24805,76843,8042,36972,5420,68801,192,101,91
24810,76864,8045,36985,5423,68819,192,101,91
24815,76874,8045,36990,5423,68829,192,101,91
24820,76895,8047,37001,5425,68848,192,101,91
24825,76905,8047,37006,5425,68858,192,101,91
24830,76926,8049,37012,5426,68877,192,101,91
24835,76936,8049,37018,5426,68887,192,101,91
24840,76957,8051,37028,5427,68906,192,101,91
24845,76967,8054,37033,5429,68913,192,101,91
24850,76988,8057,37042,5431,68931,192,101,91
24855,76998,8058,37049,5432,68940,192,101,91
24860,77019,8061,37057,5432,68958,192,101,91
24865,77029,8062,37063,5433,68967,192,101,91
24870,77050,8065,37073,5435,68985,192,101,91
24875,77060,8065,37075,5435,68995,192,101,91
24880,77081,8068,37083,5437,69013,192,101,91
24885,77091,8068,37086,5437,69022,192,101,91
24890,77112,8072,37098,5439,69040,192,101,91
24895,77122,8072,37104,5439,69049,192,101,91
24900,77143,8076,37113,5440,69067,192,101,91
24905,77153,8078,37118,5441,69075,192,101,91
24910,77174,8080,37128,5443,69094,192,101,91
24915,77184,8081,37133,5444,69103,192,101,91
24920,77205,8082,37140,5444,69123,192,101,91
24925,77215,8084,37143,5445,69131,192,101,91
24930,77236,8085,37150,5445,69151,192,101,91
24935,77246,8087,37154,5446,69159,192,101,91
24940,77267,8088,37161,5447,69179,192,101,91
24945,77277,8089,37164,5447,69188,192,101,91
24950,77298,8090,37172,5448,69208,192,101,91
24955,77308,8092,37176,5449,69216,192,101,91
24960,77329,8094,37190,5451,69235,192,101,91
24965,77339,8095,37194,5451,69244,192,101,91
24970,77360,8097,37202,5452,69261,192,101,91
24975,77370,8100,37208,5455,69270,192,101,91
24980,77391,8103,37215,5456,69287,192,101,91
24985,77401,8105,37220,5457,69296,192,101,91
24990,77422,8109,37234,5461,69312,192,101,91
24995,77432,8111,37239,5463,69321,192,101,91
25000,77453,8114,37247,5465,69339,192,101,91
25005,77463,8115,37254,5466,69347,192,101,91
25010,77484,8119,37262,5468,69364,192,101,91
25015,77494,8121,37265,5470,69373,192,101,91
25020,77515,8125,37271,5471,69390,192,101,91
25025,77525,8125,37276,5471,69400,192,101,91
25030,77546,8125,37293,5471,69421,192,101,91
25035,77556,8125,37297,5471,69431,192,101,91
25040,77577,8125,37309,5471,69452,192,101,91
25045,77587,8125,37313,5471,69462,192,101,91
25050,77608,8125,37326,5471,69483,192,101,91
25055,77618,8125,37334,5471,69493,192,101,91
25060,77639,8125,37349,5471,69514,192,101,91
25065,77649,8125,37356,5471,69524,192,101,91
25070,77670,8125,37367,5471,69545,192,101,91
25075,77680,8125,37369,5471,69555,192,101,91
25080,77701,8125,37381,5471,69576,192,101,91
25085,77711,8125,37384,5471,69586,192,101,91
25090,77732,8125,37395,5471,69607,192,101,91
25095,77742,8125,37400,5471,69617,192,101,91
25100,77763,8125,37414,5471,69638,192,101,91
25105,77773,8125,37420,5471,69648,192,101,91
25110,77794,8125,37436,5471,69669,192,101,91
25115,77804,8125,37441,5471,69679,192,101,91
25120,77825,8125,37449,5471,69700,192,101,91
25125,77835,8125,37454,5471,69710,192,101,91
25130,77856,8130,37463,5474,69726,192,101,91
25135,77866,8132,37467,5475,69734,192,101,91
25140,77887,8137,37475,5478,69750,192,101,91
25145,77897,8138,37477,5478,69759,192,101,91
25150,77918,8140,37484,5479,69778,192,101,91
25155,77928,8142,37487,5481,69786,192,101,91
25160,77949,8143,37492,5481,69806,192,101,91
25165,77959,8144,37497,5482,69815,192,101,91
25170,77980,8145,37506,5483,69835,192,101,91
25175,77990,8146,37510,5483,69844,192,101,91
25180,78011,8148,37518,5484,69863,192,101,91
25185,78021,8150,37523,5486,69871,192,101,91
25190,78042,8151,37533,5487,69890,192,101,91
25195,78052,8153,37536,5489,69899,192,101,91
25200,78073,8154,37546,5490,69918,192,101,91
25205,78083,8156,37549,5491,69927,192,101,91
25210,78104,8156,37559,5491,69948,192,101,91
25215,78114,8157,37563,5491,69957,192,101,91
25220,78135,8157,37571,5491,69978,192,101,91
25225,78145,8158,37576,5492,69987,192,101,91
25230,78166,8158,37586,5492,70008,192,101,91
25235,78176,8160,37592,5494,70016,192,101,91
25240,78197,8160,37605,5494,70037,192,101,91
25245,78207,8162,37609,5495,70045,192,101,91
25250,78228,8164,37620,5496,70064,192,101,91
25255,78238,8166,37627,5498,70071,192,101,91
25260,78259,8172,37639,5503,70087,192,101,91
25265,78269,8172,37644,5503,70097,192,101,91
25270,78290,8174,37648,5504,70116,192,101,91
25275,78300,8174,37655,5504,70126,192,101,91
25280,78321,8177,37667,5506,70144,192,101,91
25285,78331,8177,37676,5506,70154,192,101,91
25290,78352,8180,37688,5509,70172,192,101,91
25295,78362,8180,37695,5509,70182,192,101,91
25300,78383,8183,37706,5510,70200,192,101,91
25305,78393,8183,37712,5510,70210,192,101,91
25310,78414,8185,37719,5511,70229,192,101,91
25315,78424,8185,37721,5511,70239,192,101,91
25320,78445,8188,37731,5514,70257,192,101,91
25325,78455,8188,37734,5514,70267,192,101,91
25330,78476,8189,37743,5515,70287,192,101,91
25335,78486,8189,37748,5515,70297,192,101,91
25340,78507,8190,37759,5515,70317,192,101,91
25345,78517,8190,37764,5515,70327,192,101,91
25350,78538,8191,37770,5515,70347,192,101,91
25355,78548,8191,37774,5515,70357,192,101,91
25360,78569,8192,37782,5516,70377,192,101,91
25365,78579,8192,37786,5516,70387,192,101,91
25370,78600,8194,37794,5517,70406,192,101,91
25375,78610,8197,37801,5520,70413,192,101,91
25380,78631,8201,37811,5523,70429,192,101,91
25385,78641,8202,37816,5524,70439,192,101,91
25390,78662,8203,37825,5524,70459,192,101,91
25395,78672,8203,37831,5524,70469,192,101,91
25400,78693,8204,37840,5525,70489,192,101,91
25405,78703,8204,37843,5525,70499,192,101,91
25410,78724,8205,37851,5525,70519,192,101,91
25415,78734,8205,37856,5525,70529,192,101,91
25420,78755,8206,37866,5525,70549,192,101,91
25425,78765,8206,37874,5525,70559,192,101,91
25430,78786,8207,37885,5525,70579,192,101,91
25435,78796,8207,37891,5525,70589,192,101,91
25440,78817,8208,37901,5526,70609,192,101,91
25445,78827,8211,37906,5529,70616,192,101,91
25450,78848,8212,37915,5529,70635,192,101,91
25455,78858,8215,37919,5531,70643,192,101,91
25460,78879,8217,37926,5532,70662,192,101,91
25465,78889,8219,37931,5534,70670,192,101,91
25470,78910,8221,37942,5536,70689,192,101,91
25475,78920,8223,37946,5537,70697,192,101,91
25480,78941,8224,37953,5537,70717,192,101,91
25485,78951,8225,37958,5538,70725,192,101,91
25490,78972,8231,37971,5542,70741,192,101,91
25495,78982,8232,37977,5543,70749,192,101,91
25500,79003,8239,37989,5549,70763,192,101,91
25505,79013,8241,37995,5551,70772,192,101,91
25510,79034,8242,38005,5552,70792,192,101,91
25515,79044,8242,38010,5552,70802,192,101,91
25520,79065,8243,38020,5552,70822,192,101,91
25525,79075,8243,38024,5552,70832,192,101,91
25530,79096,8244,38035,5553,70852,192,101,91
25535,79106,8244,38040,5553,70862,192,101,91
25540,79127,8245,38051,5554,70882,192,101,91
25545,79137,8245,38057,5554,70892,192,101,91
25550,79158,8246,38065,5555,70912,192,101,91
25555,79168,8246,38071,5555,70922,192,101,91
25560,79189,8247,38082,5555,70942,192,101,91
25565,79199,8247,38090,5555,70952,192,101,91
25570,79220,8248,38096,5555,70972,192,101,91
25575,79230,8248,38102,5555,70982,192,101,91
25580,79251,8249,38109,5555,71002,192,101,91
25585,79261,8249,38116,5555,71012,192,101,91
25590,79282,8250,38126,5556,71032,192,101,91
25595,79292,8251,38132,5557,71041,192,101,91
25600,79313,8252,38140,5557,71061,192,101,91
25605,79323,8253,38144,5557,71070,192,101,91
25610,79344,8254,38152,5557,71090,192,101,91
25615,79354,8256,38158,5559,71098,192,101,91
25620,79375,8260,38169,5563,71114,192,101,91
25625,79385,8262,38177,5565,71123,192,101,91
25630,79406,8264,38186,5565,71142,192,101,91
25635,79416,8264,38190,5565,71152,192,101,91
25640,79437,8265,38202,5566,71172,192,101,91
25645,79447,8265,38207,5566,71182,192,101,91
25650,79468,8266,38216,5567,71202,192,101,91
25655,79478,8266,38221,5567,71212,192,101,91
25660,79499,8267,38230,5568,71232,192,101,91
25665,79509,8267,38235,5568,71242,192,101,91
25670,79530,8268,38242,5568,71262,192,101,91
25675,79540,8268,38247,5568,71272,192,101,91
25680,79561,8269,38259,5569,71292,192,101,91
25685,79571,8269,38259,5569,71302,192,101,91
25690,79592,8270,38269,5569,71322,192,101,91
25695,79602,8270,38273,5569,71332,192,101,91
25700,79623,8271,38282,5570,71352,192,101,91
25705,79633,8271,38285,5570,71362,192,101,91
25710,79654,8272,38297,5570,71382,192,101,91
25715,79664,8272,38301,5570,71392,192,101,91
25720,79685,8273,38312,5570,71412,192,101,91
25725,79695,8273,38317,5570,71422,192,101,91
25730,79716,8276,38326,5572,71438,192,101,91
25735,79726,8279,38331,5575,71446,192,101,91
25740,79747,8285,38341,5579,71460,192,101,91
25745,79757,8288,38349,5582,71469,192,101,91
25750,79778,8291,38361,5585,71487,192,101,91
25755,79788,8292,38370,5586,71496,192,101,91
25760,79809,8295,38381,5589,71514,192,101,91
25765,79819,8296,38386,5589,71523,192,101,91
25770,79840,8298,38392,5590,71542,192,101,91
25775,79850,8299,38396,5590,71551,192,101,91
25780,79871,8301,38405,5592,71570,192,101,91
25785,79881,8302,38409,5592,71579,192,101,91
25790,79902,8304,38418,5593,71598,192,101,91
25795,79912,8305,38423,5594,71607,192,101,91
25800,79933,8307,38433,5595,71626,192,101,91
25805,79943,8307,38438,5595,71636,192,101,91
25810,79964,8308,38446,5596,71656,192,101,91
25815,79974,8308,38451,5596,71666,192,101,91
25820,79995,8309,38460,5596,71686,192,101,91
25825,80005,8309,38464,5596,71696,192,101,91
25830,80026,8310,38475,5597,71716,192,101,91
25835,80036,8310,38478,5597,71726,192,101,91
25840,80057,8311,38487,5597,71746,192,101,91
25845,80067,8311,38491,5597,71755,192,101,91
25850,80088,8315,38502,5599,71773,192,101,91
25855,80098,8315,38507,5599,71782,192,101,91
25860,80119,8319,38515,5601,71799,192,101,91
25865,80129,8322,38519,5603,71807,192,101,91
25870,80150,8324,38528,5604,71826,192,101,91
25875,80160,8326,38534,5606,71834,192,101,91
25880,80181,8329,38544,5609,71851,192,101,91
25885,80191,8332,38551,5612,71859,192,101,91
25890,80212,8333,38560,5612,71879,192,101,91
25895,80222,8335,38565,5614,71887,192,101,91
25900,80243,8336,38579,5614,71906,192,101,91
25905,80253,8338,38582,5616,71915,192,101,91
25910,80274,8339,38596,5617,71934,192,101,91
25915,80284,8341,38599,5619,71943,192,101,91
25920,80305,8342,38609,5619,71962,192,101,91
25925,80315,8343,38616,5620,71972,192,101,91
25930,80336,8344,38627,5621,71992,192,101,91
25935,80346,8344,38629,5621,72002,192,101,91
25940,80367,8345,38641,5621,72022,192,101,91
25945,80377,8345,38645,5621,72032,192,101,91
25950,80398,8346,38657,5621,72052,192,101,91
25955,80408,8346,38663,5621,72062,192,101,91
25960,80429,8347,38671,5621,72082,192,101,91
25965,80439,8347,38675,5621,72091,192,101,91
25970,80460,8350,38688,5623,72109,192,101,91
25975,80470,8351,38693,5624,72118,192,101,91
25980,80491,8355,38701,5627,72136,192,101,91
25985,80501,8355,38708,5627,72146,192,101,91
25990,80522,8356,38717,5628,72166,192,101,91
25995,80532,8356,38720,5628,72176,192,101,91
26000,80553,8357,38730,5628,72196,192,101,91
26005,80563,8357,38736,5628,72206,192,101,91
26010,80584,8358,38743,5628,72226,192,101,91
26015,80594,8358,38747,5628,72236,192,101,91
26020,80615,8360,38758,5630,72255,192,101,91
26025,80625,8360,38759,5630,72265,192,101,91
26030,80646,8361,38770,5631,72285,192,101,91
26035,80656,8361,38776,5631,72295,192,101,91
26040,80677,8362,38787,5631,72315,192,101,91
26045,80687,8364,38793,5633,72323,192,101,91
26050,80708,8367,38805,5635,72341,192,101,91
26055,80718,8369,38807,5637,72349,192,101,91
26060,80739,8372,38819,5639,72366,192,101,91
26065,80749,8374,38825,5640,72375,192,101,91
26070,80770,8374,38835,5640,72396,192,101,91
26075,80780,8374,38839,5640,72406,192,101,91
26080,80801,8374,38853,5640,72427,192,101,91
26085,80811,8374,38857,5640,72437,192,101,91
26090,80832,8376,38867,5640,72456,192,101,91
26095,80842,8377,38872,5641,72465,192,101,91
26100,80863,8379,38885,5642,72484,192,101,91
26105,80873,8379,38889,5642,72494,192,101,91
26110,80894,8381,38899,5643,72513,192,101,91
26115,80904,8381,38903,5643,72523,192,101,91
26120,80925,8383,38916,5643,72542,192,101,91
26125,80935,8383,38922,5643,72552,192,101,91
26130,80956,8385,38933,5644,72571,192,101,91
26135,80966,8385,38940,5644,72581,192,101,91
26140,80987,8387,38948,5646,72600,192,101,91
26145,80997,8387,38951,5646,72610,192,101,91
26150,81018,8389,38962,5646,72629,192,101,91
26155,81028,8389,38969,5646,72639,192,101,91
26160,81049,8391,38977,5647,72658,192,101,91
26165,81059,8393,38984,5649,72666,192,101,91
26170,81080,8398,38993,5653,72682,192,101,91
26175,81090,8399,38996,5653,72691,192,101,91
26180,81111,8403,39001,5654,72708,192,101,91
26185,81121,8404,39009,5655,72717,192,101,91
26190,81142,8410,39020,5659,72731,192,101,91
26195,81152,8412,39024,5660,72740,192,101,91
26200,81173,8415,39033,5662,72757,192,101,91
26205,81183,8417,39036,5664,72766,192,101,91
26210,81204,8423,39049,5669,72781,192,101,91
26215,81214,8425,39054,5670,72788,192,101,91
26220,81235,8431,39066,5674,72804,192,101,91
26225,81245,8432,39072,5675,72813,192,101,91
26230,81266,8433,39080,5675,72833,192,101,91
26235,81276,8433,39086,5675,72843,192,101,91
26240,81297,8434,39094,5675,72863,192,101,91
26245,81307,8434,39095,5675,72873,192,101,91
26250,81328,8435,39103,5675,72893,192,101,91
26255,81338,8435,39110,5675,72903,192,101,91
26260,81359,8436,39120,5675,72923,192,101,91
26265,81369,8436,39125,5675,72933,192,101,91
26270,81390,8437,39136,5676,72953,192,101,91
26275,81400,8437,39142,5676,72963,192,101,91
26280,81421,8438,39153,5677,72983,192,101,91
26285,81431,8438,39157,5677,72993,192,101,91
26290,81452,8439,39167,5678,73013,192,101,91
26295,81462,8439,39172,5678,73023,192,101,91
26300,81483,8440,39181,5679,73043,192,101,91
26305,81493,8440,39186,5679,73053,192,101,91
26310,81514,8441,39193,5679,73073,192,101,91
26315,81524,8441,39197,5679,73083,192,101,91
26320,81545,8442,39209,5680,73103,192,101,91
26325,81555,8443,39216,5681,73112,192,101,91
26330,81576,8448,39229,5686,73128,192,101,91
26335,81586,8450,39234,5688,73136,192,101,91
26340,81607,8455,39246,5693,73151,192,101,91
26345,81617,8458,39251,5695,73159,192,101,91
26350,81638,8460,39260,5697,73178,192,101,91
26355,81648,8462,39266,5699,73186,192,101,91
26360,81669,8464,39275,5699,73205,192,101,91
26365,81679,8465,39282,5700,73214,192,101,91
26370,81700,8467,39291,5701,73233,192,101,91
26375,81710,8469,39297,5703,73241,192,101,91
26380,81731,8471,39311,5704,73260,192,101,91
26385,81741,8473,39321,5706,73268,192,101,91
26390,81762,8475,39331,5707,73287,192,101,91
26395,81772,8477,39336,5708,73295,192,101,91
26400,81793,8479,39342,5708,73314,192,101,91
26405,81803,8480,39347,5709,73323,192,101,91
26410,81824,8482,39357,5711,73342,192,101,91
26415,81834,8484,39360,5712,73350,192,101,91
26420,81855,8486,39373,5712,73369,192,101,91
26425,81865,8488,39378,5713,73377,192,101,91
26430,81886,8490,39387,5714,73395,192,101,91
26435,81896,8492,39390,5715,73404,192,101,91
26440,81917,8494,39401,5717,73423,192,101,91
26445,81927,8497,39407,5720,73430,192,101,91
26450,81948,8502,39419,5725,73445,192,101,91
26455,81958,8506,39427,5729,73451,192,101,91
26460,81979,8511,39434,5734,73467,192,101,91
26465,81989,8512,39439,5735,73477,192,101,91
26470,82010,8513,39449,5736,73497,192,101,91
26475,82020,8513,39453,5736,73507,192,101,91
26480,82041,8515,39465,5738,73526,192,101,91
26485,82051,8515,39469,5738,73536,192,101,91
26490,82072,8517,39482,5740,73555,192,101,91
26495,82082,8517,39489,5740,73565,192,101,91
26500,82103,8519,39499,5742,73584,192,101,91
26505,82113,8519,39505,5742,73594,192,101,91
26510,82134,8521,39517,5743,73613,192,101,91
26515,82144,8521,39521,5743,73623,192,101,91
26520,82165,8522,39534,5743,73643,192,101,91
26525,82175,8522,39538,5743,73653,192,101,91
26530,82196,8523,39546,5744,73673,192,101,91
26535,82206,8523,39551,5744,73683,192,101,91
26540,82227,8524,39560,5745,73703,192,101,91
26545,82237,8524,39565,5745,73713,192,101,91
26550,82258,8525,39577,5746,73733,192,101,91
26555,82268,8525,39582,5746,73743,192,101,91
26560,82289,8526,39594,5746,73763,192,101,91
26565,82299,8527,39601,5747,73772,192,101,91
26570,82320,8530,39614,5749,73790,192,101,91
26575,82330,8532,39619,5751,73797,192,101,91
26580,82351,8537,39629,5754,73814,192,101,91
26585,82361,8537,39633,5754,73824,192,101,91
26590,82382,8537,39645,5754,73845,192,101,91
26595,82392,8537,39648,5754,73855,192,101,91
26600,82413,8537,39659,5754,73876,192,101,91
26605,82423,8537,39662,5754,73886,192,101,91
26610,82444,8537,39671,5754,73907,192,101,91
26615,82454,8537,39678,5754,73917,192,101,91
26620,82475,8537,39690,5754,73938,192,101,91
26625,82485,8537,39696,5754,73948,192,101,91
26630,82506,8537,39705,5754,73969,192,101,91
26635,82516,8537,39709,5754,73979,192,101,91
26640,82537,8537,39719,5754,74000,192,101,91
26645,82547,8537,39723,5754,74010,192,101,91
26650,82568,8537,39735,5754,74031,192,101,91
26655,82578,8537,39741,5754,74041,192,101,91
26660,82599,8537,39750,5754,74062,192,101,91
26665,82609,8537,39753,5754,74072,192,101,91
26670,82630,8537,39763,5754,74093,192,101,91
26675,82640,8537,39768,5754,74103,192,101,91
26680,82661,8537,39777,5754,74124,192,101,91
26685,82671,8537,39785,5754,74134,192,101,91
26690,82692,8541,39796,5757,74150,192,101,91
26695,82702,8544,39800,5759,74158,192,101,91
26700,82723,8549,39810,5763,74173,192,101,91
26705,82733,8551,39815,5764,74182,192,101,91
26710,82754,8555,39822,5768,74198,192,101,91
26715,82764,8557,39828,5770,74207,192,101,91
26720,82785,8559,39839,5771,74225,192,101,91
26725,82795,8561,39843,5773,74234,192,101,91
26730,82816,8563,39854,5774,74253,192,101,91
26735,82826,8564,39861,5775,74262,192,101,91
26740,82847,8567,39871,5777,74280,192,101,91
26745,82857,8568,39875,5778,74289,192,101,91
26750,82878,8570,39887,5779,74307,192,101,91
26755,82888,8572,39894,5781,74316,192,101,91
26760,82909,8575,39904,5784,74334,192,101,91
26765,82919,8576,39908,5784,74343,192,101,91
26770,82940,8578,39917,5785,74362,192,101,91
26775,82950,8579,39924,5785,74371,192,101,91
26780,82971,8582,39936,5788,74389,192,101,91
26785,82981,8583,39941,5788,74398,192,101,91
26790,83002,8586,39949,5790,74416,192,101,91
26795,83012,8587,39954,5791,74425,192,101,91
26800,83033,8589,39965,5792,74444,192,101,91
26805,83043,8590,39969,5793,74453,192,101,91
26810,83064,8594,39981,5796,74470,192,101,91
26815,83074,8596,39986,5797,74478,192,101,91
26820,83095,8601,39997,5800,74494,192,101,91
26825,83105,8602,40003,5801,74502,192,101,91
26830,83126,8604,40015,5803,74522,192,101,91
26835,83136,8604,40017,5803,74532,192,101,91
26840,83157,8605,40022,5803,74552,192,101,91
26845,83167,8606,40026,5804,74560,192,101,91
26850,83188,8608,40038,5806,74580,192,101,91
26855,83198,8608,40043,5806,74589,192,101,91
26860,83219,8610,40055,5808,74609,192,101,91
26865,83229,8610,40060,5808,74619,192,101,91
26870,83250,8611,40072,5809,74639,192,101,91
26875,83260,8611,40077,5809,74648,192,101,91
26880,83281,8613,40087,5811,74668,192,101,91
26885,83291,8613,40090,5811,74678,192,101,91
26890,83312,8614,40103,5812,74698,192,101,91
26895,83322,8614,40108,5812,74707,192,101,91
26900,83343,8616,40116,5813,74727,192,101,91
26905,83353,8616,40123,5813,74736,192,101,91
26910,83374,8618,40131,5814,74756,192,101,91
26915,83384,8618,40135,5814,74766,192,101,91
26920,83405,8619,40148,5815,74786,192,101,91
26925,83415,8619,40153,5815,74796,192,101,91
26930,83436,8622,40161,5816,74812,192,101,91
26935,83446,8627,40167,5820,74819,192,101,91
26940,83467,8632,40173,5822,74835,192,101,91
26945,83477,8632,40179,5822,74845,192,101,91
26950,83498,8634,40187,5822,74864,192,101,91
26955,83508,8634,40190,5822,74874,192,101,91
26960,83529,8636,40202,5822,74893,192,101,91
26965,83539,8636,40207,5822,74903,192,101,91
26970,83560,8638,40220,5823,74922,192,101,91
26975,83570,8638,40224,5823,74932,192,101,91
26980,83591,8640,40232,5823,74951,192,101,91
26985,83601,8640,40237,5823,74961,192,101,91
26990,83622,8642,40249,5823,74980,192,101,91
26995,83632,8642,40256,5823,74990,192,101,91
27000,83653,8644,40264,5823,75009,192,101,91
27005,83663,8644,40267,5823,75019,192,101,91
27010,83684,8647,40281,5826,75037,192,101,91
27015,83694,8647,40284,5826,75047,192,101,91
27020,83715,8650,40297,5827,75065,192,101,91
27025,83725,8650,40304,5827,75075,192,101,91
27030,83746,8652,40311,5828,75094,192,101,91
27035,83756,8652,40315,5828,75104,192,101,91
27040,83777,8655,40320,5830,75122,192,101,91
27045,83787,8657,40326,5832,75129,192,101,91
27050,83808,8665,40333,5838,75143,192,101,91
27055,83818,8667,40337,5839,75150,192,101,91
27060,83839,8672,40347,5843,75165,192,101,91
27065,83849,8674,40349,5845,75175,192,101,91
27070,83870,8675,40358,5846,75195,192,101,91
27075,83880,8675,40365,5846,75205,192,101,91
27080,83901,8676,40375,5847,75225,192,101,91
27085,83911,8676,40380,5847,75235,192,101,91
27090,83932,8677,40389,5848,75255,192,101,91
27095,83942,8677,40392,5848,75264,192,101,91
27100,83963,8679,40408,5849,75284,192,101,91
27105,83973,8679,40412,5849,75294,192,101,91
27110,83994,8680,40424,5849,75314,192,101,91
27115,84004,8680,40428,5849,75323,192,101,91
27120,84025,8682,40439,5851,75343,192,101,91
27125,84035,8682,40445,5851,75352,192,101,91
27130,84056,8684,40453,5853,75372,192,101,91
27135,84066,8684,40456,5853,75381,192,101,91
27140,84087,8686,40469,5855,75401,192,101,91
27145,84097,8686,40476,5855,75411,192,101,91
27150,84118,8687,40481,5855,75431,192,101,91
27155,84128,8687,40487,5855,75441,192,101,91
27160,84149,8688,40495,5856,75461,192,101,91
27165,84159,8688,40501,5856,75471,192,101,91
27170,84180,8693,40516,5860,75485,192,101,91
27175,84190,8696,40521,5862,75492,192,101,91
27180,84211,8703,40532,5868,75507,192,101,91
27185,84221,8706,40539,5871,75515,192,101,91
27190,84242,8707,40545,5872,75535,192,101,91
27195,84252,8707,40551,5872,75545,192,101,91
27200,84273,8708,40562,5873,75565,192,101,91
27205,84283,8708,40567,5873,75575,192,101,91
27210,84304,8709,40581,5874,75595,192,101,91
27215,84314,8709,40585,5874,75605,192,101,91
27220,84335,8710,40594,5874,75625,192,101,91
27225,84345,8710,40599,5874,75635,192,101,91
27230,84366,8711,40607,5874,75655,192,101,91
27235,84376,8711,40611,5874,75665,192,101,91
27240,84397,8712,40620,5874,75685,192,101,91
27245,84407,8713,40623,5874,75694,192,101,91
27250,84428,8716,40637,5876,75710,192,101,91
27255,84438,8719,40642,5878,75719,192,101,91
27260,84459,8721,40652,5879,75738,192,101,91
27265,84469,8722,40660,5880,75747,192,101,91
27270,84490,8724,40670,5882,75766,192,101,91
27275,84500,8725,40674,5883,75775,192,101,91
27280,84521,8727,40683,5883,75794,192,101,91
27285,84531,8728,40685,5883,75803,192,101,91
27290,84552,8731,40696,5884,75821,192,101,91
27295,84562,8732,40699,5885,75830,192,101,91
27300,84583,8735,40712,5885,75848,192,101,91
27305,84593,8736,40717,5885,75856,192,101,91
27310,84614,8738,40727,5887,75876,192,101,91
27315,84624,8741,40735,5890,75882,192,101,91
27320,84645,8743,40742,5891,75902,192,101,91
27325,84655,8744,40744,5891,75911,192,101,91
27330,84676,8744,40754,5891,75932,192,101,91
27335,84686,8745,40759,5892,75941,192,101,91
27340,84707,8745,40776,5892,75962,192,101,91
27345,84717,8746,40781,5892,75971,192,101,91
27350,84738,8746,40790,5892,75992,192,101,91
27355,84748,8747,40796,5893,76001,192,101,91
27360,84769,8747,40808,5893,76021,192,101,91
27365,84779,8748,40816,5894,76030,192,101,91
27370,84800,8750,40828,5896,76050,192,101,91
27375,84810,8750,40832,5896,76060,192,101,91
27380,84831,8750,40842,5896,76081,192,101,91
27385,84841,8750,40845,5896,76091,192,101,91
27390,84862,8750,40853,5896,76112,192,101,91
27395,84872,8750,40855,5896,76122,192,101,91
27400,84893,8750,40863,5896,76143,192,101,91
27405,84903,8750,40867,5896,76153,192,101,91
27410,84924,8752,40876,5897,76172,192,101,91
27415,84934,8752,40881,5897,76182,192,101,91
27420,84955,8754,40888,5898,76201,192,101,91
27425,84965,8755,40892,5898,76210,192,101,91
27430,84986,8758,40901,5900,76228,192,101,91
27435,84996,8759,40906,5900,76237,192,101,91
27440,85017,8762,40914,5901,76255,192,101,91
27445,85027,8763,40920,5902,76263,192,101,91
27450,85048,8767,40931,5904,76281,192,101,91
27455,85058,8768,40935,5904,76290,192,101,91
27460,85079,8772,40950,5906,76307,192,101,91
27465,85089,8773,40956,5907,76316,192,101,91
27470,85110,8776,40964,5909,76334,192,101,91
27475,85120,8777,40967,5909,76343,192,101,91
27480,85141,8781,40976,5910,76359,192,101,91
27485,85151,8783,40982,5912,76367,192,101,91
27490,85172,8786,40991,5913,76386,192,101,91
27495,85182,8786,40997,5913,76396,192,101,91
27500,85203,8788,41008,5914,76415,192,101,91
27505,85213,8788,41012,5914,76424,192,101,91
27510,85234,8791,41026,5916,76443,192,101,91
27515,85244,8791,41033,5916,76452,192,101,91
27520,85265,8794,41043,5919,76471,192,101,91
27525,85275,8795,41047,5920,76479,192,101,91
27530,85296,8798,41055,5921,76498,192,101,91
27535,85306,8798,41060,5921,76507,192,101,91
27540,85327,8801,41074,5924,76526,192,101,91
27545,85337,8803,41079,5926,76534,192,101,91
27550,85358,8808,41093,5930,76549,192,101,91
27555,85368,8811,41097,5933,76557,192,101,91
27560,85389,8815,41111,5937,76573,192,101,91
27565,85399,8817,41116,5938,76582,192,101,91
27570,85420,8821,41123,5941,76599,192,101,91
27575,85430,8823,41126,5942,76607,192,101,91
27580,85451,8826,41135,5943,76625,192,101,91
27585,85461,8827,41141,5944,76634,192,101,91
27590,85482,8830,41149,5946,76652,192,101,91
27595,85492,8831,41153,5947,76661,192,101,91
27600,85513,8835,41161,5949,76678,192,101,91
27605,85523,8836,41166,5950,76687,192,101,91
27610,85544,8837,41173,5950,76707,192,101,91
27615,85554,8838,41176,5951,76716,192,101,91
27620,85575,8839,41182,5951,76736,192,101,91
27625,85585,8840,41187,5952,76745,192,101,91
27630,85606,8842,41195,5953,76764,192,101,91
27635,85616,8843,41196,5953,76773,192,101,91
27640,85637,8844,41207,5954,76793,192,101,91
27645,85647,8845,41212,5954,76801,192,101,91
27650,85668,8848,41222,5956,76819,192,101,91
27655,85678,8850,41229,5958,76827,192,101,91
27660,85699,8852,41239,5959,76847,192,101,91
27665,85709,8852,41244,5959,76857,192,101,91
27670,85730,8853,41253,5960,76877,192,101,91
27675,85740,8853,41258,5960,76887,192,101,91
27680,85761,8855,41268,5962,76906,192,101,91
27685,85771,8855,41271,5962,76916,192,101,91
27690,85792,8856,41284,5963,76936,192,101,91
27695,85802,8856,41287,5963,76946,192,101,91
27700,85823,8858,41297,5964,76965,192,101,91
27705,85833,8858,41299,5964,76975,192,101,91
27710,85854,8861,41309,5967,76993,192,101,91
27715,85864,8861,41313,5967,77003,192,101,91
27720,85885,8864,41321,5968,77020,192,101,91
27725,85895,8865,41326,5969,77030,192,101,91
27730,85916,8867,41333,5969,77049,192,101,91
27735,85926,8867,41338,5969,77059,192,101,91
27740,85947,8868,41350,5969,77079,192,101,91
27745,85957,8868,41352,5969,77089,192,101,91
27750,85978,8869,41360,5969,77109,192,101,91
27755,85988,8869,41364,5969,77119,192,101,91
27760,86009,8870,41376,5969,77139,192,101,91
27765,86019,8870,41381,5969,77148,192,101,91
27770,86040,8875,41392,5972,77165,192,101,91
27775,86050,8876,41397,5973,77173,192,101,91
27780,86071,8882,41412,5978,77187,192,101,91
27785,86081,8885,41417,5981,77196,192,101,91
27790,86102,8888,41428,5981,77214,192,101,91
27795,86112,8888,41434,5981,77224,192,101,91
27800,86133,8891,41442,5982,77242,192,101,91
27805,86143,8891,41447,5982,77252,192,101,91
27810,86164,8894,41452,5984,77270,192,101,91
27815,86174,8894,41455,5984,77280,192,101,91
27820,86195,8897,41466,5986,77298,192,101,91
27825,86205,8898,41469,5987,77307,192,101,91
27830,86226,8901,41483,5987,77325,192,101,91
27835,86236,8902,41489,5988,77334,192,101,91
27840,86257,8905,41501,5989,77352,192,101,91
27845,86267,8905,41505,5989,77362,192,101,91
27850,86288,8908,41514,5989,77380,192,101,91
27855,86298,8908,41521,5989,77390,192,101,91
27860,86319,8911,41532,5991,77408,192,101,91
27865,86329,8911,41536,5991,77418,192,101,91
27870,86350,8914,41547,5993,77436,192,101,91
27875,86360,8914,41551,5993,77446,192,101,91
27880,86381,8917,41561,5995,77464,192,101,91
27885,86391,8917,41566,5995,77474,192,101,91
27890,86412,8922,41577,5997,77488,192,101,91
27895,86422,8925,41583,5999,77497,192,101,91
27900,86443,8930,41594,6002,77511,192,101,91
27905,86453,8932,41598,6004,77521,192,101,91
27910,86474,8933,41604,6004,77541,192,101,91
27915,86484,8933,41606,6004,77551,192,101,91
27920,86505,8934,41612,6004,77571,192,101,91
27925,86515,8934,41617,6004,77581,192,101,91
27930,86536,8935,41627,6004,77601,192,101,91
27935,86546,8935,41632,6004,77611,192,101,91
27940,86567,8936,41642,6004,77631,192,101,91
27945,86577,8936,41648,6004,77640,192,101,91
27950,86598,8938,41655,6005,77660,192,101,91
27955,86608,8938,41662,6005,77669,192,101,91
27960,86629,8940,41674,6007,77689,192,101,91
27965,86639,8941,41681,6008,77698,192,101,91
27970,86660,8943,41689,6010,77717,192,101,91
27975,86670,8944,41694,6010,77726,192,101,91
27980,86691,8945,41702,6010,77744,192,101,91
27985,86701,8948,41707,6012,77753,192,101,91
27990,86722,8951,41720,6014,77770,192,101,91
27995,86732,8953,41720,6015,77779,192,101,91
28000,86753,8955,41733,6017,77796,192,101,91
28005,86763,8958,41739,6020,77805,192,101,91
28010,86784,8961,41750,6022,77823,192,101,91
28015,86794,8963,41756,6023,77831,192,101,91
28020,86815,8966,41762,6026,77849,192,101,91
28025,86825,8967,41767,6027,77858,192,101,91
28030,86846,8968,41780,6027,77878,192,101,91
28035,86856,8969,41784,6027,77887,192,101,91
28040,86877,8970,41792,6027,77907,192,101,91
28045,86887,8971,41799,6028,77916,192,101,91
28050,86908,8972,41807,6028,77936,192,101,91
28055,86918,8973,41811,6029,77945,192,101,91
28060,86939,8974,41824,6029,77965,192,101,91
28065,86949,8975,41829,6030,77974,192,101,91
28070,86970,8977,41837,6032,77993,192,101,91
28075,86980,8978,41842,6033,78002,192,101,91
28080,87001,8981,41851,6034,78019,192,101,91
28085,87011,8983,41855,6036,78028,192,101,91
28090,87032,8987,41869,6038,78045,192,101,91
28095,87042,8988,41874,6039,78054,192,101,91
28100,87063,8992,41883,6041,78071,192,101,91
28105,87073,8994,41887,6043,78079,192,101,91
28110,87094,8997,41896,6044,78097,192,101,91
28115,87104,8998,41902,6045,78106,192,101,91
28120,87125,9002,41914,6048,78123,192,101,91
28125,87135,9002,41920,6048,78133,192,101,91
28130,87156,9006,41930,6050,78150,192,101,91
28135,87166,9007,41937,6051,78159,192,101,91
28140,87187,9010,41946,6052,78177,192,101,91
28145,87197,9010,41952,6052,78187,192,101,91
28150,87218,9010,41960,6052,78208,192,101,91
28155,87228,9010,41963,6052,78218,192,101,91
28160,87249,9010,41977,6052,78239,192,101,91
28165,87259,9010,41981,6052,78249,192,101,91
28170,87280,9010,41993,6052,78270,192,101,91
28175,87290,9010,41999,6052,78280,192,101,91
28180,87311,9010,42009,6052,78301,192,101,91
28185,87321,9010,42014,6052,78311,192,101,91
28190,87342,9010,42027,6052,78332,192,101,91
28195,87352,9010,42032,6052,78342,192,101,91
28200,87373,9010,42044,6052,78363,192,101,91
28205,87383,9010,42048,6052,78373,192,101,91
28210,87404,9010,42056,6052,78394,192,101,91
28215,87414,9010,42061,6052,78404,192,101,91
28220,87435,9010,42075,6052,78425,192,101,91
28225,87445,9010,42079,6052,78435,192,101,91
28230,87466,9010,42089,6052,78456,192,101,91
28235,87476,9010,42092,6052,78466,192,101,91
28240,87497,9010,42105,6052,78487,192,101,91
28245,87507,9010,42110,6052,78497,192,101,91
28250,87528,9013,42118,6054,78515,192,101,91
28255,87538,9015,42126,6055,78523,192,101,91
28260,87559,9020,42140,6058,78538,192,101,91
28265,87569,9021,42146,6059,78548,192,101,91
28270,87590,9024,42156,6060,78566,192,101,91
28275,87600,9024,42161,6060,78576,192,101,91
28280,87621,9027,42170,6062,78594,192,101,91
28285,87631,9027,42176,6062,78604,192,101,91
28290,87652,9029,42183,6063,78623,192,101,91
28295,87662,9029,42188,6063,78633,192,101,91
28300,87683,9032,42201,6066,78651,192,101,91
28305,87693,9032,42206,6066,78661,192,101,91
28310,87714,9034,42214,6067,78680,192,101,91
28315,87724,9034,42219,6067,78690,192,101,91
28320,87745,9037,42228,6069,78708,192,101,91
28325,87755,9039,42234,6071,78716,192,101,91
28330,87776,9041,42250,6073,78733,192,101,91
28335,87786,9044,42253,6075,78742,192,101,91
28340,87807,9046,42266,6077,78760,192,101,91
28345,87817,9049,42273,6080,78768,192,101,91
28350,87838,9051,42286,6082,78786,192,101,91
28355,87848,9052,42291,6083,78796,192,101,91
28360,87869,9055,42301,6086,78814,192,101,91
28365,87879,9055,42307,6086,78824,192,101,91
28370,87900,9058,42317,6088,78842,192,101,91
28375,87910,9058,42320,6088,78851,192,101,91
28380,87931,9062,42328,6091,78869,192,101,91
28385,87941,9062,42332,6091,78878,192,101,91
28390,87962,9065,42340,6093,78897,192,101,91
28395,87972,9065,42347,6093,78907,192,101,91
28400,87993,9068,42360,6095,78925,192,101,91
28405,88003,9068,42366,6095,78935,192,101,91
28410,88024,9070,42373,6097,78954,192,101,91
28415,88034,9070,42377,6097,78964,192,101,91
28420,88055,9072,42388,6098,78983,192,101,91
28425,88065,9072,42391,6098,78993,192,101,91
28430,88086,9074,42401,6100,79012,192,101,91
28435,88096,9074,42405,6100,79022,192,101,91
28440,88117,9076,42415,6102,79041,192,101,91
28445,88127,9076,42423,6102,79051,192,101,91
28450,88148,9077,42426,6102,79071,192,101,91
28455,88158,9077,42430,6102,79081,192,101,91
28460,88179,9078,42441,6102,79100,192,101,91
28465,88189,9080,42446,6103,79109,192,101,91
28470,88210,9083,42455,6106,79127,192,101,91
28475,88220,9085,42458,6107,79135,192,101,91
28480,88241,9087,42466,6109,79153,192,101,91
28485,88251,9091,42473,6112,79160,192,101,91
28490,88272,9093,42483,6113,79178,192,101,91
28495,88282,9096,42484,6115,79186,192,101,91
28500,88303,9099,42495,6118,79203,192,101,91
28505,88313,9100,42500,6119,79212,192,101,91
28510,88334,9102,42513,6121,79232,192,101,91
28515,88344,9102,42519,6121,79242,192,101,91
28520,88365,9103,42530,6122,79262,192,101,91
28525,88375,9103,42536,6122,79271,192,101,91
28530,88396,9105,42548,6123,79291,192,101,91
28535,88406,9105,42551,6123,79301,192,101,91
28540,88427,9106,42559,6123,79321,192,101,91
28545,88437,9106,42564,6123,79331,192,101,91
28550,88458,9108,42571,6123,79350,192,101,91
28555,88468,9108,42576,6123,79359,192,101,91
28560,88489,9112,42587,6126,79377,192,101,91
28565,88499,9114,42592,6127,79385,192,101,91
28570,88520,9116,42602,6128,79403,192,101,91
28575,88530,9119,42609,6130,79411,192,101,91
28580,88551,9121,42620,6131,79430,192,101,91
28585,88561,9122,42625,6132,79439,192,101,91
28590,88582,9125,42635,6133,79457,192,101,91
28595,88592,9126,42638,6133,79466,192,101,91
28600,88613,9128,42648,6135,79485,192,101,91
28605,88623,9130,42652,6137,79493,192,101,91
28610,88644,9137,42665,6143,79505,192,101,91
28615,88654,9141,42668,6146,79513,192,101,91
28620,88675,9146,42677,6149,79527,192,101,91
28625,88685,9148,42679,6151,79537,192,101,91
28630,88706,9149,42689,6152,79557,192,101,91
28635,88716,9149,42696,6152,79567,192,101,91
28640,88737,9151,42708,6153,79586,192,101,91
28645,88747,9151,42711,6153,79596,192,101,91
28650,88768,9153,42725,6155,79615,192,101,91
28655,88778,9153,42729,6155,79625,192,101,91
28660,88799,9154,42735,6156,79645,192,101,91
28665,88809,9154,42737,6156,79655,192,101,91
28670,88830,9156,42751,6158,79674,192,101,91
28675,88840,9156,42756,6158,79684,192,101,91
28680,88861,9157,42762,6158,79704,192,101,91
28685,88871,9157,42768,6158,79714,192,101,91
28690,88892,9159,42779,6159,79733,192,101,91
28695,88902,9159,42783,6159,79743,192,101,91
28700,88923,9160,42794,6159,79763,192,101,91
28705,88933,9160,42797,6159,79773,192,101,91
28710,88954,9162,42807,6161,79792,192,101,91
28715,88964,9162,42811,6161,79802,192,101,91
28720,88985,9163,42819,6162,79822,192,101,91
28725,88995,9163,42825,6162,79832,192,101,91
28730,89016,9168,42834,6166,79847,192,101,91
28735,89026,9169,42837,6167,79857,192,101,91
28740,89047,9175,42850,6170,79869,192,101,91
28745,89057,9179,42855,6174,79877,192,101,91
28750,89078,9181,42866,6175,79897,192,101,91
28755,89088,9182,42869,6175,79905,192,101,91
28760,89109,9184,42877,6177,79925,192,101,91
28765,89119,9185,42881,6177,79934,192,101,91
28770,89140,9186,42891,6178,79954,192,101,91
28775,89150,9187,42897,6179,79963,192,101,91
28780,89171,9188,42906,6179,79983,192,101,91
28785,89181,9189,42913,6180,79992,192,101,91
28790,89202,9190,42924,6180,80012,192,101,91
28795,89212,9191,42930,6181,80021,192,101,91
28800,89233,9192,42942,6182,80041,192,101,91
28805,89243,9193,42949,6183,80050,192,101,91
28810,89264,9194,42959,6183,80070,192,101,91
28815,89274,9195,42963,6183,80079,192,101,91
28820,89295,9196,42972,6183,80099,192,101,91
28825,89305,9197,42976,6184,80108,192,101,91
28830,89326,9198,42984,6184,80128,192,101,91
28835,89336,9199,42989,6184,80137,192,101,91
28840,89357,9200,42995,6184,80157,192,101,91
28845,89367,9202,42999,6186,80165,192,101,91
28850,89388,9206,43009,6189,80180,192,101,91
28855,89398,9210,43013,6192,80188,192,101,91
28860,89419,9213,43022,6193,80204,192,101,91
28865,89429,9216,43026,6196,80213,192,101,91
28870,89450,9218,43035,6198,80232,192,101,91
28875,89460,9219,43039,6199,80241,192,101,91
28880,89481,9222,43050,6201,80259,192,101,91
28885,89491,9222,43054,6201,80269,192,101,91
28890,89512,9224,43070,6203,80287,192,101,91
28895,89522,9225,43078,6204,80297,192,101,91
28900,89543,9227,43089,6205,80316,192,101,91
28905,89553,9227,43099,6205,80326,192,101,91
28910,89574,9228,43107,6205,80346,192,101,91
28915,89584,9228,43112,6205,80356,192,101,91
28920,89605,9230,43126,6206,80375,192,101,91
28925,89615,9230,43131,6206,80385,192,101,91
28930,89636,9232,43142,6208,80404,192,101,91
28935,89646,9232,43146,6208,80414,192,101,91
28940,89667,9232,43157,6208,80435,192,101,91
28945,89677,9232,43163,6208,80445,192,101,91
28950,89698,9232,43172,6208,80466,192,101,91
28955,89708,9232,43175,6208,80476,192,101,91
28960,89729,9232,43186,6208,80497,192,101,91
28965,89739,9232,43189,6208,80507,192,101,91
28970,89760,9232,43201,6208,80528,192,101,91
28975,89770,9233,43205,6208,80537,192,101,91
28980,89791,9235,43220,6210,80554,192,101,91
28985,89801,9240,43226,6214,80561,192,101,91
28990,89822,9244,43236,6217,80578,192,101,91
28995,89832,9246,43242,6218,80585,192,101,91
29000,89853,9249,43247,6219,80604,192,101,91
29005,89863,9249,43253,6219,80614,192,101,91
29010,89884,9251,43265,6221,80633,192,101,91
29015,89894,9251,43267,6221,80643,192,101,91
29020,89915,9253,43278,6221,80662,192,101,91
29025,89925,9253,43283,6221,80672,192,101,91
29030,89946,9255,43297,6222,80691,192,101,91
29035,89956,9255,43303,6222,80701,192,101,91
29040,89977,9257,43310,6222,80720,192,101,91
29045,89987,9258,43313,6223,80729,192,101,91
29050,90008,9260,43325,6225,80748,192,101,91
29055,90018,9261,43329,6226,80757,192,101,91
29060,90039,9264,43340,6227,80775,192,101,91
29065,90049,9265,43345,6228,80784,192,101,91
29070,90070,9267,43353,6228,80803,192,101,91
29075,90080,9267,43356,6228,80813,192,101,91
29080,90101,9270,43369,6230,80831,192,101,91
29085,90111,9270,43375,6230,80841,192,101,91
29090,90132,9273,43387,6232,80859,192,101,91
29095,90142,9273,43392,6232,80869,192,101,91
29100,90163,9277,43406,6235,80886,192,101,91
29105,90173,9278,43409,6235,80895,192,101,91
29110,90194,9283,43417,6237,80911,192,101,91
29115,90204,9284,43420,6238,80920,192,101,91
29120,90225,9288,43427,6240,80937,192,101,91
29125,90235,9289,43431,6240,80946,192,101,91
29130,90256,9291,43434,6240,80965,192,101,91
29135,90266,9293,43439,6241,80973,192,101,91
29140,90287,9296,43450,6243,80991,192,101,91
29145,90297,9298,43454,6244,80999,192,101,91
29150,90318,9302,43464,6247,81016,192,101,91
29155,90328,9303,43470,6248,81025,192,101,91
29160,90349,9306,43481,6250,81043,192,101,91
29165,90359,9306,43484,6250,81053,192,101,91
29170,90380,9307,43490,6251,81073,192,101,91
29175,90390,9307,43492,6251,81083,192,101,91
29180,90411,9308,43501,6252,81103,192,101,91
29185,90421,9308,43508,6252,81113,192,101,91
29190,90442,9309,43521,6253,81133,192,101,91
29195,90452,9309,43526,6253,81143,192,101,91
29200,90473,9310,43537,6254,81163,192,101,91
29205,90483,9310,43544,6254,81173,192,101,91
29210,90504,9311,43555,6254,81193,192,101,91
29215,90514,9311,43560,6254,81203,192,101,91
29220,90535,9312,43570,6255,81223,192,101,91
29225,90545,9312,43578,6255,81232,192,101,91
29230,90566,9315,43587,6258,81251,192,101,91
29235,90576,9315,43591,6258,81260,192,101,91
29240,90597,9318,43600,6260,81279,192,101,91
29245,90607,9318,43601,6260,81289,192,101,91
29250,90628,9320,43612,6261,81308,192,101,91
29255,90638,9320,43614,6261,81318,192,101,91
29260,90659,9322,43626,6262,81337,192,101,91
29265,90669,9323,43633,6263,81345,192,101,91
29270,90690,9329,43643,6268,81361,192,101,91
29275,90700,9330,43647,6269,81369,192,101,91
29280,90721,9337,43658,6275,81383,192,101,91
29285,90731,9338,43663,6276,81393,192,101,91
29290,90752,9338,43673,6276,81414,192,101,91
29295,90762,9338,43677,6276,81424,192,101,91
29300,90783,9338,43686,6276,81445,192,101,91
29305,90793,9338,43689,6276,81455,192,101,91
29310,90814,9338,43699,6276,81476,192,101,91
29315,90824,9338,43704,6276,81486,192,101,91
29320,90845,9338,43716,6276,81507,192,101,91
29325,90855,9338,43718,6276,81517,192,101,91
29330,90876,9338,43724,6276,81538,192,101,91
29335,90886,9338,43728,6276,81548,192,101,91
29340,90907,9338,43740,6276,81569,192,101,91
29345,90917,9338,43743,6276,81579,192,101,91
29350,90938,9338,43755,6276,81600,192,101,91
29355,90948,9338,43758,6276,81610,192,101,91
29360,90969,9338,43769,6276,81631,192,101,91
29365,90979,9338,43775,6276,81641,192,101,91
29370,91000,9338,43782,6276,81662,192,101,91
29375,91010,9338,43786,6276,81672,192,101,91
29380,91031,9338,43794,6276,81693,192,101,91
29385,91041,9338,43801,6276,81702,192,101,91
29390,91062,9343,43812,6281,81717,192,101,91
29395,91072,9348,43818,6285,81724,192,101,91
29400,91093,9354,43830,6289,81737,192,101,91
29405,91103,9356,43834,6291,81747,192,101,91
29410,91124,9359,43844,6293,81765,192,101,91
29415,91134,9359,43850,6293,81775,192,101,91
29420,91155,9363,43861,6294,81792,192,101,91
29425,91165,9363,43865,6294,81802,192,101,91
29430,91186,9366,43873,6294,81820,192,101,91
29435,91196,9366,43879,6294,81830,192,101,91
29440,91217,9370,43892,6296,81847,192,101,91
29445,91227,9370,43895,6296,81857,192,101,91
29450,91248,9374,43907,6298,81874,192,101,91
29455,91258,9374,43913,6298,81884,192,101,91
29460,91279,9378,43930,6300,81901,192,101,91
29465,91289,9380,43936,6302,81909,192,101,91
29470,91310,9385,43946,6306,81925,192,101,91
29475,91320,9386,43951,6307,81934,192,101,91
29480,91341,9392,43965,6312,81948,192,101,91
29485,91351,9394,43967,6314,81957,192,101,91
29490,91372,9400,43978,6319,81972,192,101,91
29495,91382,9402,43983,6320,81980,192,101,91
29500,91403,9407,43994,6325,81996,192,101,91
29505,91413,9409,43998,6326,82004,192,101,91
29510,91434,9412,44006,6328,82022,192,101,91
29515,91444,9413,44011,6329,82030,192,101,91
29520,91465,9417,44019,6332,82048,192,101,91
29525,91475,9417,44025,6332,82058,192,101,91
29530,91496,9417,44041,6332,82079,192,101,91
29535,91506,9417,44044,6332,82089,192,101,91
29540,91527,9417,44053,6332,82110,192,101,91
29545,91537,9417,44059,6332,82120,192,101,91
29550,91558,9417,44072,6332,82141,192,101,91
29555,91568,9417,44076,6332,82151,192,101,91
29560,91589,9417,44083,6332,82172,192,101,91
29565,91599,9417,44089,6332,82182,192,101,91
29570,91620,9417,44099,6332,82203,192,101,91
29575,91630,9417,44103,6332,82213,192,101,91
29580,91651,9417,44114,6332,82234,192,101,91
29585,91661,9417,44119,6332,82244,192,101,91
29590,91682,9418,44128,6333,82264,192,101,91
29595,91692,9418,44132,6333,82274,192,101,91
29600,91713,9420,44141,6334,82293,192,101,91
29605,91723,9420,44144,6334,82303,192,101,91
29610,91744,9424,44154,6337,82320,192,101,91
29615,91754,9424,44159,6337,82330,192,101,91
29620,91775,9428,44172,6339,82347,192,101,91
29625,91785,9430,44176,6340,82355,192,101,91
29630,91806,9435,44188,6344,82369,192,101,91
29635,91816,9439,44194,6348,82376,192,101,91
29640,91837,9446,44204,6354,82390,192,101,91
29645,91847,9447,44210,6355,82400,192,101,91
29650,91868,9448,44215,6355,82420,192,101,91
29655,91878,9448,44219,6355,82430,192,101,91
29660,91899,9450,44229,6356,82449,192,101,91
29665,91909,9450,44237,6356,82459,192,101,91
29670,91930,9452,44247,6357,82478,192,101,91
29675,91940,9452,44250,6357,82488,192,101,91
29680,91961,9454,44262,6359,82507,192,101,91
29685,91971,9454,44266,6359,82517,192,101,91
29690,91992,9456,44274,6360,82536,192,101,91
29695,92002,9456,44279,6360,82546,192,101,91
29700,92023,9458,44288,6361,82565,192,101,91
29705,92033,9458,44291,6361,82575,192,101,91
29710,92054,9460,44303,6362,82594,192,101,91
29715,92064,9460,44307,6362,82604,192,101,91
29720,92085,9461,44314,6362,82624,192,101,91
29725,92095,9461,44321,6362,82634,192,101,91
29730,92116,9462,44326,6362,82654,192,101,91
29735,92126,9462,44332,6362,82664,192,101,91
29740,92147,9464,44340,6363,82683,192,101,91
29745,92157,9464,44341,6363,82692,192,101,91
29750,92178,9470,44351,6367,82708,192,101,91
29755,92188,9473,44357,6370,82715,192,101,91
29760,92209,9478,44369,6374,82729,192,101,91
29765,92219,9481,44373,6376,82738,192,101,91
29770,92240,9481,44379,6376,82759,192,101,91
29775,92250,9482,44382,6376,82768,192,101,91
29780,92271,9482,44390,6376,82789,192,101,91
29785,92281,9483,44394,6376,82798,192,101,91
29790,92302,9483,44405,6376,82819,192,101,91
29795,92312,9484,44412,6377,82828,192,101,91
29800,92333,9484,44423,6377,82849,192,101,91
29805,92343,9485,44427,6378,82858,192,101,91
29810,92364,9485,44436,6378,82879,192,101,91
29815,92374,9486,44441,6379,82888,192,101,91
29820,92395,9486,44451,6379,82909,192,101,91
29825,92405,9487,44457,6380,82918,192,101,91
29830,92426,9487,44464,6380,82939,192,101,91
29835,92436,9488,44467,6381,82948,192,101,91
29840,92457,9488,44476,6381,82969,192,101,91
29845,92467,9489,44480,6381,82978,192,101,91
29850,92488,9489,44487,6381,82999,192,101,91
29855,92498,9490,44495,6382,83008,192,101,91
29860,92519,9490,44507,6382,83029,192,101,91
29865,92529,9492,44513,6384,83037,192,101,91
29870,92550,9496,44520,6387,83052,192,101,91
29875,92560,9501,44526,6392,83058,192,101,91
29880,92581,9508,44538,6396,83072,192,101,91
29885,92591,9509,44542,6397,83081,192,101,91
29890,92612,9512,44550,6399,83100,192,101,91
29895,92622,9512,44555,6399,83109,192,101,91
29900,92643,9515,44561,6402,83128,192,101,91
29905,92653,9515,44563,6402,83137,192,101,91
29910,92674,9519,44573,6404,83154,192,101,91
29915,92684,9521,44576,6406,83163,192,101,91
29920,92705,9522,44586,6407,83183,192,101,91
29925,92715,9522,44591,6407,83193,192,101,91
29930,92736,9522,44596,6407,83214,192,101,91
29935,92746,9522,44603,6407,83224,192,101,91
29940,92767,9522,44611,6407,83245,192,101,91
29945,92777,9523,44613,6408,83254,192,101,91
29950,92798,9524,44625,6409,83274,192,101,91
29955,92808,9525,44627,6409,83283,192,101,91
29960,92829,9525,44637,6409,83304,192,101,91
29965,92839,9526,44643,6410,83313,192,101,91
29970,92860,9526,44649,6410,83334,192,101,91
29975,92870,9527,44652,6411,83343,192,101,91
29980,92891,9527,44662,6411,83364,192,101,91
29985,92901,9528,44668,6411,83373,192,101,91
29990,92922,9529,44677,6412,83393,192,101,91
29995,92932,9530,44681,6413,83402,192,101,91
30000,92953,9531,44690,6413,83422,192,101,91
30005,92963,9533,44699,6415,83430,192,101,91
30010,92984,9538,44705,6419,83446,192,101,91
30015,92994,9538,44710,6419,83456,192,101,91
30020,93015,9543,44716,6421,83471,192,101,91
30025,93025,9545,44719,6423,83479,192,101,91
30030,93046,9551,44728,6428,83495,192,101,91
30035,93056,9552,44732,6429,83504,192,101,91
30040,93077,9557,44744,6432,83519,192,101,91
30045,93087,9558,44749,6433,83529,192,101,91
30050,93108,9559,44762,6433,83549,192,101,91
30055,93118,9559,44766,6433,83559,192,101,91
30060,93139,9560,44776,6434,83579,192,101,91
30065,93149,9560,44779,6434,83589,192,101,91
30070,93170,9561,44791,6434,83609,192,101,91
30075,93180,9561,44796,6434,83619,192,101,91
30080,93201,9562,44804,6435,83639,192,101,91
30085,93211,9562,44811,6435,83648,192,101,91
30090,93232,9564,44818,6436,83668,192,101,91
30095,93242,9564,44823,6436,83677,192,101,91
30100,93263,9566,44835,6438,83697,192,101,91
30105,93273,9566,44841,6438,83707,192,101,91
30110,93294,9567,44851,6439,83727,192,101,91
30115,93304,9568,44857,6440,83736,192,101,91
30120,93325,9570,44867,6442,83755,192,101,91
30125,93335,9572,44872,6443,83763,192,101,91
30130,93356,9575,44882,6446,83780,192,101,91
30135,93366,9578,44887,6448,83788,192,101,91
30140,93387,9582,44899,6451,83804,192,101,91
30145,93397,9584,44905,6453,83813,192,101,91
30150,93418,9588,44918,6454,83829,192,101,91
30155,93428,9591,44921,6457,83837,192,101,91
30160,93449,9595,44929,6460,83853,192,101,91
30165,93459,9598,44935,6463,83861,192,101,91
30170,93480,9602,44949,6466,83878,192,101,91
30175,93490,9605,44955,6469,83885,192,101,91
30180,93511,9608,44966,6470,83902,192,101,91
30185,93521,9610,44972,6472,83911,192,101,91
30190,93542,9612,44984,6473,83930,192,101,91
30195,93552,9612,44991,6473,83939,192,101,91
30200,93573,9615,45001,6476,83958,192,101,91
30205,93583,9615,45007,6476,83968,192,101,91
30210,93604,9615,45019,6476,83989,192,101,91
30215,93614,9615,45023,6476,83999,192,101,91
30220,93635,9615,45032,6476,84020,192,101,91
30225,93645,9615,45035,6476,84030,192,101,91
30230,93666,9615,45045,6476,84051,192,101,91
30235,93676,9615,45050,6476,84061,192,101,91
30240,93697,9615,45062,6476,84082,192,101,91
30245,93707,9615,45067,6476,84092,192,101,91
30250,93728,9616,45077,6476,84112,192,101,91
30255,93738,9616,45083,6476,84122,192,101,91
30260,93759,9617,45095,6476,84142,192,101,91
30265,93769,9617,45098,6476,84152,192,101,91
30270,93790,9618,45106,6477,84172,192,101,91
30275,93800,9618,45113,6477,84182,192,101,91
30280,93821,9621,45126,6480,84200,192,101,91
30285,93831,9621,45130,6480,84210,192,101,91
30290,93852,9623,45135,6480,84228,192,101,91
30295,93862,9626,45139,6483,84236,192,101,91
30300,93883,9633,45155,6489,84248,192,101,91
30305,93893,9636,45161,6492,84257,192,101,91
30310,93914,9638,45173,6493,84276,192,101,91
30315,93924,9638,45176,6493,84286,192,101,91
30320,93945,9640,45189,6494,84305,192,101,91
30325,93955,9641,45194,6495,84314,192,101,91
30330,93976,9643,45204,6495,84333,192,101,91
30335,93986,9643,45208,6495,84343,192,101,91
30340,94007,9645,45220,6496,84362,192,101,91
30345,94017,9646,45226,6497,84371,192,101,91
30350,94038,9648,45236,6499,84390,192,101,91
30355,94048,9648,45241,6499,84400,192,101,91
30360,94069,9650,45249,6500,84419,192,101,91
30365,94079,9651,45256,6501,84428,192,101,91
30370,94100,9654,45266,6504,84446,192,101,91
30375,94110,9655,45273,6505,84455,192,101,91
30380,94131,9658,45282,6507,84473,192,101,91
30385,94141,9659,45286,6507,84482,192,101,91
30390,94162,9663,45297,6510,84499,192,101,91
30395,94172,9664,45303,6511,84508,192,101,91
30400,94193,9667,45313,6512,84526,192,101,91
30405,94203,9668,45318,6512,84535,192,101,91
30410,94224,9671,45326,6513,84552,192,101,91
30415,94234,9673,45331,6515,84560,192,101,91
30420,94255,9677,45340,6517,84576,192,101,91
30425,94265,9679,45346,6519,84586,192,101,91
30430,94286,9679,45357,6519,84607,192,101,91
30435,94296,9679,45362,6519,84617,192,101,91
30440,94317,9679,45375,6519,84638,192,101,91
30445,94327,9679,45382,6519,84648,192,101,91
30450,94348,9679,45393,6519,84669,192,101,91
30455,94358,9679,45397,6519,84679,192,101,91
30460,94379,9679,45406,6519,84700,192,101,91
30465,94389,9679,45411,6519,84710,192,101,91
30470,94410,9679,45422,6519,84731,192,101,91
30475,94420,9679,45426,6519,84741,192,101,91
30480,94441,9679,45435,6519,84762,192,101,91
30485,94451,9681,45443,6520,84770,192,101,91
30490,94472,9684,45456,6523,84787,192,101,91
30495,94482,9687,45460,6526,84795,192,101,91
30500,94503,9688,45468,6526,84815,192,101,91
30505,94513,9690,45472,6527,84823,192,101,91
30510,94534,9693,45484,6529,84841,192,101,91
30515,94544,9694,45490,6529,84850,192,101,91
30520,94565,9696,45499,6530,84869,192,101,91
30525,94575,9698,45502,6531,84876,192,101,91
30530,94596,9704,45516,6536,84891,192,101,91
30535,94606,9706,45520,6538,84899,192,101,91
30540,94627,9709,45528,6540,84917,192,101,91
30545,94637,9710,45532,6541,84927,192,101,91
30550,94658,9710,45543,6541,84948,192,101,91
30555,94668,9710,45550,6541,84958,192,101,91
30560,94689,9710,45559,6541,84979,192,101,91
30565,94699,9710,45563,6541,84989,192,101,91
30570,94720,9710,45572,6541,85010,192,101,91
30575,94730,9710,45578,6541,85020,192,101,91
30580,94751,9710,45588,6541,85041,192,101,91
30585,94761,9710,45595,6541,85051,192,101,91
30590,94782,9710,45604,6541,85072,192,101,91
30595,94792,9710,45609,6541,85082,192,101,91
30600,94813,9710,45621,6541,85103,192,101,91
30605,94823,9710,45626,6541,85113,192,101,91
30610,94844,9712,45640,6542,85132,192,101,91
30615,94854,9712,45644,6542,85142,192,101,91
30620,94875,9715,45653,6545,85160,192,101,91
30625,94885,9715,45656,6545,85170,192,101,91
30630,94906,9717,45668,6546,85189,192,101,91
30635,94916,9717,45674,6546,85198,192,101,91
30640,94937,9721,45686,6549,85216,192,101,91
30645,94947,9721,45694,6549,85225,192,101,91
30650,94968,9728,45705,6553,85240,192,101,91
30655,94978,9730,45710,6554,85248,192,101,91
30660,94999,9737,45726,6560,85259,192,101,91
30665,95009,9741,45729,6563,85268,192,101,91
30670,95030,9743,45737,6565,85287,192,101,91
30675,95040,9745,45742,6567,85295,192,101,91
30680,95061,9747,45757,6568,85314,192,101,91
30685,95071,9748,45761,6568,85323,192,101,91
30690,95092,9751,45773,6571,85341,192,101,91
30695,95102,9753,45778,6572,85349,192,101,91
30700,95123,9755,45788,6573,85368,192,101,91
30705,95133,9757,45792,6574,85376,192,101,91
30710,95154,9759,45802,6575,85395,192,101,91
30715,95164,9760,45806,6575,85404,192,101,91
30720,95185,9762,45814,6576,85423,192,101,91
30725,95195,9764,45817,6578,85431,192,101,91
30730,95216,9766,45825,6579,85450,192,101,91
30735,95226,9768,45827,6581,85458,192,101,91
30740,95247,9770,45837,6583,85477,192,101,91
30745,95257,9771,45842,6584,85486,192,101,91
30750,95278,9773,45854,6586,85505,192,101,91
30755,95288,9774,45860,6587,85514,192,101,91
30760,95309,9777,45874,6589,85532,192,101,91
30765,95319,9779,45879,6591,85539,192,101,91
30770,95340,9783,45887,6592,85557,192,101,91
30775,95350,9785,45889,6593,85565,192,101,91
30780,95371,9789,45898,6595,85581,192,101,91
30785,95381,9790,45902,6596,85591,192,101,91
30790,95402,9790,45913,6596,85612,192,101,91
30795,95412,9790,45919,6596,85622,192,101,91
30800,95433,9790,45929,6596,85643,192,101,91
30805,95443,9790,45935,6596,85653,192,101,91
30810,95464,9790,45947,6596,85674,192,101,91
30815,95474,9790,45956,6596,85684,192,101,91
30820,95495,9790,45967,6596,85705,192,101,91
30825,95505,9790,45970,6596,85715,192,101,91
30830,95526,9790,45980,6596,85736,192,101,91
30835,95536,9790,45985,6596,85746,192,101,91
30840,95557,9790,45995,6596,85767,192,101,91
30845,95567,9790,45998,6596,85777,192,101,91
30850,95588,9790,46011,6596,85798,192,101,91
30855,95598,9790,46015,6596,85808,192,101,91
30860,95619,9790,46028,6596,85829,192,101,91
30865,95629,9790,46033,6596,85839,192,101,91
30870,95650,9790,46042,6596,85860,192,101,91
30875,95660,9790,46048,6596,85870,192,101,91
30880,95681,9790,46062,6596,85891,192,101,91
30885,95691,9790,46067,6596,85901,192,101,91
30890,95712,9794,46077,6598,85917,192,101,91
30895,95722,9798,46083,6601,85924,192,101,91
30900,95743,9805,46093,6607,85937,192,101,91
30905,95753,9806,46099,6608,85947,192,101,91
30910,95774,9808,46112,6609,85966,192,101,91
30915,95784,9808,46117,6609,85976,192,101,91
30920,95805,9810,46127,6609,85995,192,101,91
30925,95815,9810,46133,6609,86005,192,101,91
30930,95836,9812,46145,6611,86024,192,101,91
30935,95846,9812,46149,6611,86034,192,101,91
30940,95867,9814,46160,6611,86053,192,101,91
30945,95877,9814,46164,6611,86063,192,101,91
30950,95898,9816,46176,6613,86082,192,101,91
30955,95908,9816,46184,6613,86092,192,101,91
30960,95929,9818,46192,6614,86111,192,101,91
30965,95939,9819,46198,6615,86120,192,101,91
30970,95960,9821,46206,6616,86139,192,101,91
30975,95970,9823,46212,6617,86147,192,101,91
30980,95991,9826,46219,6618,86165,192,101,91
30985,96001,9827,46221,6618,86174,192,101,91
30990,96022,9829,46232,6620,86193,192,101,91
30995,96032,9830,46234,6620,86202,192,101,91
31000,96053,9832,46244,6621,86221,192,101,91
31005,96063,9834,46251,6623,86229,192,101,91
31010,96084,9839,46259,6627,86244,192,101,91
31015,96094,9842,46264,6630,86252,192,101,91
31020,96115,9848,46277,6635,86265,192,101,91
31025,96125,9851,46282,6638,86274,192,101,91
31030,96146,9853,46291,6639,86293,192,101,91
31035,96156,9853,46294,6639,86303,192,101,91
31040,96177,9856,46305,6640,86321,192,101,91
31045,96187,9856,46309,6640,86331,192,101,91
31050,96208,9858,46319,6642,86350,192,101,91
31055,96218,9858,46325,6642,86360,192,101,91
31060,96239,9859,46332,6643,86380,192,101,91
31065,96249,9859,46336,6643,86390,192,101,91
31070,96270,9860,46346,6644,86410,192,101,91
31075,96280,9860,46350,6644,86420,192,101,91
31080,96301,9861,46358,6644,86440,192,101,91
31085,96311,9862,46362,6645,86449,192,101,91
31090,96332,9865,46373,6647,86467,192,101,91
31095,96342,9866,46378,6648,86475,192,101,91
31100,96363,9869,46388,6651,86494,192,101,91
31105,96373,9870,46391,6652,86503,192,101,91
31110,96394,9872,46401,6652,86522,192,101,91
31115,96404,9874,46406,6654,86529,192,101,91
31120,96425,9878,46417,6657,86547,192,101,91
31125,96435,9879,46421,6657,86555,192,101,91
31130,96456,9884,46434,6661,86572,192,101,91
31135,96466,9886,46441,6662,86580,192,101,91
31140,96487,9890,46448,6665,86596,192,101,91
31145,96497,9893,46454,6668,86604,192,101,91
31150,96518,9895,46465,6669,86623,192,101,91
31155,96528,9897,46469,6671,86631,192,101,91
31160,96549,9899,46481,6671,86650,192,101,91
31165,96559,9900,46486,6671,86659,192,101,91
31170,96580,9901,46498,6671,86679,192,101,91
31175,96590,9902,46502,6671,86688,192,101,91
31180,96611,9903,46515,6672,86708,192,101,91
31185,96621,9904,46520,6673,86717,192,101,91
31190,96642,9905,46531,6673,86737,192,101,91
31195,96652,9906,46538,6674,86746,192,101,91
31200,96673,9907,46549,6675,86766,192,101,91
31205,96683,9907,46557,6675,86776,192,101,91
31210,96704,9911,46571,6677,86793,192,101,91
31215,96714,9911,46574,6677,86803,192,101,91
31220,96735,9915,46586,6681,86820,192,101,91
31225,96745,9915,46587,6681,86830,192,101,91
31230,96766,9918,46595,6682,86848,192,101,91
31235,96776,9918,46599,6682,86858,192,101,91
31240,96797,9921,46604,6682,86876,192,101,91
31245,96807,9921,46610,6682,86885,192,101,91
31250,96828,9925,46620,6686,86903,192,101,91
31255,96838,9925,46625,6686,86913,192,101,91
31260,96859,9928,46632,6687,86931,192,101,91
31265,96869,9928,46639,6687,86940,192,101,91
31270,96890,9931,46650,6688,86959,192,101,91
31275,96900,9931,46655,6688,86969,192,101,91
31280,96921,9933,46670,6690,86988,192,101,91
31285,96931,9933,46677,6690,86997,192,101,91
31290,96952,9936,46686,6691,87016,192,101,91
31295,96962,9936,46692,6691,87025,192,101,91
31300,96983,9939,46705,6694,87044,192,101,91
31305,96993,9939,46709,6694,87053,192,101,91
31310,97014,9943,46718,6697,87071,192,101,91
31315,97024,9945,46723,6699,87079,192,101,91
31320,97045,9948,46732,6701,87097,192,101,91
31325,97055,9950,46738,6703,87105,192,101,91
31330,97076,9952,46750,6705,87123,192,101,91
31335,97086,9954,46754,6707,87132,192,101,91
31340,97107,9958,46765,6710,87149,192,101,91
31345,97117,9959,46768,6711,87158,192,101,91
31350,97138,9962,46779,6713,87176,192,101,91
31355,97148,9963,46786,6713,87185,192,101,91
31360,97169,9966,46795,6715,87203,192,101,91
31365,97179,9967,46801,6716,87212,192,101,91
31370,97200,9970,46809,6718,87229,192,101,91
31375,97210,9972,46813,6719,87237,192,101,91
31380,97231,9975,46826,6722,87256,192,101,91
31385,97241,9977,46833,6724,87264,192,101,91
31390,97262,9978,46841,6725,87284,192,101,91
31395,97272,9979,46845,6726,87293,192,101,91
31400,97293,9981,46856,6727,87312,192,101,91
31405,97303,9982,46859,6727,87321,192,101,91
31410,97324,9983,46869,6728,87341,192,101,91
31415,97334,9984,46875,6729,87350,192,101,91
31420,97355,9986,46885,6731,87369,192,101,91
31425,97365,9987,46891,6732,87378,192,101,91
31430,97386,9990,46906,6735,87396,192,101,91
31435,97396,9991,46914,6736,87405,192,101,91
31440,97417,9994,46927,6738,87423,192,101,91
31445,97427,9995,46933,6739,87432,192,101,91
31450,97448,10000,46942,6742,87448,192,101,91
31455,97458,10000,46947,6742,87458,192,101,91
31460,97479,10004,46958,6745,87474,192,101,91
31465,97489,10005,46961,6746,87484,192,101,91
31470,97510,10009,46976,6750,87500,192,101,91
31475,97520,10010,46978,6751,87510,192,101,91
31480,97541,10013,46984,6752,87528,192,101,91
31485,97551,10014,46987,6753,87537,192,101,91
31490,97572,10019,46999,6757,87553,192,101,91
31495,97582,10020,47006,6758,87562,192,101,91
31500,97603,10022,47013,6759,87581,192,101,91
31505,97613,10022,47018,6759,87591,192,101,91
31510,97634,10023,47026,6759,87611,192,101,91
31515,97644,10023,47033,6759,87621,192,101,91
31520,97665,10025,47043,6760,87640,192,101,91
31525,97675,10025,47048,6760,87649,192,101,91
31530,97696,10028,47060,6762,87668,192,101,91
31535,97706,10028,47064,6762,87678,192,101,91
31540,97727,10029,47072,6762,87698,192,101,91
31545,97737,10029,47074,6762,87708,192,101,91
31550,97758,10030,47083,6763,87728,192,101,91
31555,97768,10032,47089,6765,87735,192,101,91
31560,97789,10034,47096,6766,87754,192,101,91
31565,97799,10036,47099,6767,87763,192,101,91
31570,97820,10037,47108,6767,87783,192,101,91
31575,97830,10039,47116,6769,87791,192,101,91
31580,97851,10040,47126,6770,87811,192,101,91
31585,97861,10042,47132,6771,87819,192,101,91
31590,97882,10044,47144,6773,87838,192,101,91
31595,97892,10045,47153,6774,87847,192,101,91
31600,97913,10049,47163,6777,87864,192,101,91
31605,97923,10051,47167,6779,87872,192,101,91
31610,97944,10055,47178,6780,87889,192,101,91
31615,97954,10057,47183,6781,87897,192,101,91
31620,97975,10061,47196,6784,87913,192,101,91
31625,97985,10064,47203,6787,87920,192,101,91
31630,98006,10067,47212,6789,87939,192,101,91
31635,98016,10068,47216,6789,87948,192,101,91
31640,98037,10070,47223,6790,87967,192,101,91
31645,98047,10072,47228,6792,87975,192,101,91
31650,98068,10074,47237,6792,87994,192,101,91
31655,98078,10076,47244,6794,88002,192,101,91
31660,98099,10078,47256,6794,88021,192,101,91
31665,98109,10079,47260,6795,88030,192,101,91
31670,98130,10081,47271,6796,88049,192,101,91
31675,98140,10082,47276,6796,88058,192,101,91
31680,98161,10084,47289,6797,88075,192,101,91
31685,98171,10086,47296,6799,88085,192,101,91
31690,98192,10090,47308,6803,88102,192,101,91
31695,98202,10090,47314,6803,88112,192,101,91
31700,98223,10093,47325,6804,88129,192,101,91
31705,98233,10094,47328,6805,88139,192,101,91
31710,98254,10099,47335,6808,88154,192,101,91
31715,98264,10100,47339,6809,88164,192,101,91
31720,98285,10103,47348,6809,88181,192,101,91
31725,98295,10104,47353,6810,88191,192,101,91
31730,98316,10108,47365,6812,88208,192,101,91
31735,98326,10108,47366,6812,88218,192,101,91
31740,98347,10112,47377,6815,88234,192,101,91
31745,98357,10114,47383,6817,88243,192,101,91
31750,98378,10114,47393,6817,88264,192,101,91
31755,98388,10114,47402,6817,88274,192,101,91
31760,98409,10114,47414,6817,88295,192,101,91
31765,98419,10114,47421,6817,88305,192,101,91
31770,98440,10114,47427,6817,88326,192,101,91
31775,98450,10114,47433,6817,88336,192,101,91
31780,98471,10114,47444,6817,88357,192,101,91
31785,98481,10114,47450,6817,88367,192,101,91
31790,98502,10114,47457,6817,88388,192,101,91
31795,98512,10114,47464,6817,88398,192,101,91
31800,98533,10114,47476,6817,88419,192,101,91
31805,98543,10114,47478,6817,88429,192,101,91
31810,98564,10116,47490,6819,88448,192,101,91
31815,98574,10117,47496,6820,88457,192,101,91
31820,98595,10119,47505,6821,88476,192,101,91
31825,98605,10119,47508,6821,88486,192,101,91
31830,98626,10122,47518,6822,88503,192,101,91
31835,98636,10123,47522,6823,88513,192,101,91
31840,98657,10126,47529,6825,88530,192,101,91
31845,98667,10127,47533,6826,88540,192,101,91
31850,98688,10130,47544,6828,88557,192,101,91
31855,98698,10134,47552,6831,88564,192,101,91
31860,98719,10137,47563,6832,88580,192,101,91
31865,98729,10141,47568,6835,88588,192,101,91
31870,98750,10143,47580,6836,88607,192,101,91
31875,98760,10144,47584,6836,88616,192,101,91
31880,98781,10146,47592,6837,88635,192,101,91
31885,98791,10147,47595,6837,88644,192,101,91
31890,98812,10149,47603,6838,88663,192,101,91
31895,98822,10150,47608,6839,88672,192,101,91
31900,98843,10152,47613,6840,88691,192,101,91
31905,98853,10153,47618,6840,88700,192,101,91
31910,98874,10156,47630,6842,88718,192,101,91
31915,98884,10157,47634,6843,88727,192,101,91
31920,98905,10159,47644,6844,88746,192,101,91
31925,98915,10160,47650,6844,88755,192,101,91
31930,98936,10162,47659,6845,88774,192,101,91
31935,98946,10163,47664,6846,88783,192,101,91
31940,98967,10164,47673,6847,88803,192,101,91
31945,98977,10165,47676,6847,88812,192,101,91
31950,98998,10166,47685,6848,88832,192,101,91
31955,99008,10167,47690,6848,88841,192,101,91
31960,99029,10168,47699,6849,88861,192,101,91
31965,99039,10169,47707,6850,88870,192,101,91
31970,99060,10170,47717,6851,88889,192,101,91
31975,99070,10172,47720,6852,88898,192,101,91
31980,99091,10173,47729,6853,88918,192,101,91
31985,99101,10173,47732,6853,88928,192,101,91
31990,99122,10175,47739,6854,88947,192,101,91
31995,99132,10175,47743,6854,88957,192,101,91
32000,99153,10176,47755,6854,88977,192,101,91
32005,99163,10176,47762,6854,88987,192,101,91
32010,99184,10178,47773,6856,89006,192,101,91
32015,99194,10178,47777,6856,89016,192,101,91
32020,99215,10179,47788,6856,89036,192,101,91
32025,99225,10179,47795,6856,89045,192,101,91
32030,99246,10183,47809,6860,89063,192,101,91
32035,99256,10183,47813,6860,89073,192,101,91
32040,99277,10185,47822,6860,89092,192,101,91
32045,99287,10186,47828,6860,89101,192,101,91
32050,99308,10189,47840,6861,89118,192,101,91
32055,99318,10191,47846,6863,89127,192,101,91
32060,99339,10196,47862,6867,89141,192,101,91
32065,99349,10199,47864,6869,89150,192,101,91
32070,99370,10202,47874,6871,89167,192,101,91
32075,99380,10205,47878,6874,89175,192,101,91
32080,99401,10210,47887,6878,89190,192,101,91
32085,99411,10213,47892,6881,89198,192,101,91
32090,99432,10217,47901,6884,89214,192,101,91
32095,99442,10220,47907,6887,89222,192,101,91
32100,99463,10224,47917,6890,89238,192,101,91
32105,99473,10225,47925,6891,89248,192,101,91
32110,99494,10226,47933,6891,89268,192,101,91
32115,99504,10226,47937,6891,89278,192,101,91
32120,99525,10227,47946,6892,89298,192,101,91
32125,99535,10227,47951,6892,89308,192,101,91
32130,99556,10228,47960,6893,89328,192,101,91
32135,99566,10228,47964,6893,89338,192,101,91
32140,99587,10229,47973,6893,89358,192,101,91
32145,99597,10229,47979,6893,89368,192,101,91
32150,99618,10233,47985,6895,89385,192,101,91
32155,99628,10233,47989,6895,89395,192,101,91
32160,99649,10235,48001,6897,89414,192,101,91
32165,99659,10235,48003,6897,89424,192,101,91
32170,99680,10238,48016,6898,89442,192,101,91
32175,99690,10238,48022,6898,89452,192,101,91
32180,99711,10240,48033,6898,89471,192,101,91
32185,99721,10240,48040,6898,89481,192,101,91
32190,99742,10242,48048,6899,89500,192,101,91
32195,99752,10242,48051,6899,89510,192,101,91
32200,99773,10244,48064,6899,89529,192,101,91
32205,99783,10245,48071,6900,89538,192,101,91
32210,99804,10249,48078,6903,89555,192,101,91
32215,99814,10250,48084,6904,89564,192,101,91
32220,99835,10254,48095,6908,89581,192,101,91
32225,99845,10255,48099,6909,89590,192,101,91
32230,99866,10259,48111,6911,89607,192,101,91
32235,99876,10260,48117,6911,89616,192,101,91
32240,99897,10264,48124,6914,89633,192,101,91
32245,99907,10265,48128,6914,89642,192,101,91
32250,99928,10269,48133,6915,89659,192,101,91
32255,99938,10270,48134,6915,89668,192,101,91
32260,99959,10273,48142,6916,89686,192,101,91
32265,99969,10275,48148,6918,89694,192,101,91
32270,99990,10280,48157,6920,89709,192,101,91
32275,100000,10282,48161,6921,89718,192,101,91
32280,100021,10286,48171,6924,89735,192,101,91
32285,100031,10287,48176,6924,89744,192,101,91
32290,100052,10288,48186,6925,89763,192,101,91
32295,100062,10290,48188,6926,89772,192,101,91
32300,100083,10290,48197,6926,89793,192,101,91
32305,100093,10292,48203,6927,89801,192,101,91
32310,100114,10292,48215,6927,89822,192,101,91
32315,100124,10294,48220,6928,89830,192,101,91
32320,100145,10295,48235,6929,89849,192,101,91
32325,100155,10297,48238,6930,89858,192,101,91
32330,100176,10297,48249,6930,89879,192,101,91
32335,100186,10297,48257,6930,89889,192,101,91
32340,100207,10297,48267,6930,89910,192,101,91
32345,100217,10297,48270,6930,89920,192,101,91
32350,100238,10298,48277,6930,89940,192,101,91
32355,100248,10298,48282,6930,89950,192,101,91
32360,100269,10300,48289,6931,89969,192,101,91
32365,100279,10300,48294,6931,89979,192,101,91
32370,100300,10302,48305,6932,89998,192,101,91
32375,100310,10302,48311,6932,90008,192,101,91
32380,100331,10304,48321,6934,90027,192,101,91
32385,100341,10304,48327,6934,90037,192,101,91
32390,100362,10306,48332,6935,90056,192,101,91
32395,100372,10307,48337,6936,90065,192,101,91
32400,100393,10312,48343,6939,90081,192,101,91
32405,100403,10314,48347,6941,90089,192,101,91
32410,100424,10315,48362,6942,90109,192,101,91
32415,100434,10316,48367,6942,90118,192,101,91
32420,100455,10317,48380,6943,90138,192,101,91
32425,100465,10318,48383,6943,90147,192,101,91
32430,100486,10319,48395,6944,90167,192,101,91
32435,100496,10321,48398,6946,90175,192,101,91
32440,100517,10322,48407,6946,90195,192,101,91
32445,100527,10323,48412,6946,90204,192,101,91
32450,100548,10324,48425,6947,90224,192,101,91
32455,100558,10325,48432,6947,90233,192,101,91
32460,100579,10326,48444,6947,90253,192,101,91
32465,100589,10327,48449,6948,90262,192,101,91
32470,100610,10328,48457,6948,90282,192,101,91
32475,100620,10330,48461,6949,90290,192,101,91
32480,100641,10331,48468,6949,90310,192,101,91
32485,100651,10332,48471,6950,90319,192,101,91
32490,100672,10333,48485,6950,90339,192,101,91
32495,100682,10334,48490,6950,90348,192,101,91
32500,100703,10335,48498,6950,90368,192,101,91
32505,100713,10337,48502,6952,90376,192,101,91
32510,100734,10340,48508,6953,90394,192,101,91
32515,100744,10343,48514,6955,90400,192,101,91
32520,100765,10349,48522,6960,90414,192,101,91
32525,100775,10351,48528,6962,90424,192,101,91
32530,100796,10351,48534,6962,90445,192,101,91
32535,100806,10351,48540,6962,90455,192,101,91
32540,100827,10351,48547,6962,90476,192,101,91
32545,100837,10351,48550,6962,90486,192,101,91
32550,100858,10351,48559,6962,90507,192,101,91
32555,100868,10351,48565,6962,90517,192,101,91
32560,100889,10351,48571,6962,90538,192,101,91
32565,100899,10351,48574,6962,90548,192,101,91
32570,100920,10351,48586,6962,90569,192,101,91
32575,100930,10351,48589,6962,90579,192,101,91
32580,100951,10351,48602,6962,90600,192,101,91
32585,100961,10351,48609,6962,90610,192,101,91
32590,100982,10351,48617,6962,90631,192,101,91
32595,100992,10351,48620,6962,90641,192,101,91
32600,101013,10351,48632,6962,90662,192,101,91
32605,101023,10351,48637,6962,90672,192,101,91
32610,101044,10351,48649,6962,90693,192,101,91
32615,101054,10351,48654,6962,90703,192,101,91
32620,101075,10351,48664,6962,90724,192,101,91
32625,101085,10351,48667,6962,90734,192,101,91
32630,101106,10355,48675,6965,90750,192,101,91
32635,101116,10359,48680,6968,90756,192,101,91
32640,101137,10364,48686,6972,90771,192,101,91
32645,101147,10367,48692,6975,90780,192,101,91
32650,101168,10369,48699,6976,90799,192,101,91
32655,101178,10369,48701,6976,90809,192,101,91
32660,101199,10371,48713,6977,90828,192,101,91
32665,101209,10372,48718,6978,90837,192,101,91
32670,101230,10374,48732,6980,90856,192,101,91
32675,101240,10375,48738,6981,90865,192,101,91
32680,101261,10377,48750,6982,90884,192,101,91
32685,101271,10377,48755,6982,90894,192,101,91
32690,101292,10378,48763,6982,90914,192,101,91
32695,101302,10378,48769,6982,90924,192,101,91
32700,101323,10379,48782,6982,90944,192,101,91
32705,101333,10380,48788,6983,90953,192,101,91
32710,101354,10382,48796,6984,90972,192,101,91
32715,101364,10384,48802,6986,90980,192,101,91
32720,101385,10386,48809,6987,90999,192,101,91
32725,101395,10388,48815,6988,91007,192,101,91
32730,101416,10389,48824,6989,91026,192,101,91
32735,101426,10391,48828,6991,91035,192,101,91
32740,101447,10392,48840,6992,91055,192,101,91
32745,101457,10392,48843,6992,91065,192,101,91
32750,101478,10394,48852,6993,91084,192,101,91
32755,101488,10394,48857,6993,91093,192,101,91
32760,101509,10398,48869,6996,91111,192,101,91
32765,101519,10398,48874,6996,91121,192,101,91
32770,101540,10400,48887,6997,91140,192,101,91
32775,101550,10400,48892,6997,91150,192,101,91
32780,101571,10401,48905,6997,91170,192,101,91
32785,101581,10401,48912,6997,91180,192,101,91
32790,101602,10402,48919,6998,91200,192,101,91
32795,101612,10402,48922,6998,91210,192,101,91
32800,101633,10403,48930,6998,91230,192,101,91
32805,101643,10403,48933,6998,91240,192,101,91
32810,101664,10405,48946,7000,91259,192,101,91
32815,101674,10405,48950,7000,91269,192,101,91
32820,101695,10407,48958,7001,91288,192,101,91
32825,101705,10407,48963,7001,91298,192,101,91
32830,101726,10409,48975,7002,91317,192,101,91
32835,101736,10409,48983,7002,91327,192,101,91
32840,101757,10411,48993,7003,91346,192,101,91
32845,101767,10412,48995,7003,91355,192,101,91
32850,101788,10412,49006,7003,91376,192,101,91
32855,101798,10413,49012,7003,91385,192,101,91
32860,101819,10413,49026,7003,91406,192,101,91
32865,101829,10414,49031,7003,91415,192,101,91
32870,101850,10417,49040,7005,91432,192,101,91
32875,101860,10420,49046,7008,91440,192,101,91
32880,101881,10423,49060,7010,91456,192,101,91
32885,101891,10425,49062,7012,91466,192,101,91
32890,101912,10427,49073,7013,91485,192,101,91
32895,101922,10428,49079,7014,91494,192,101,91
32900,101943,10430,49091,7016,91513,192,101,91
32905,101953,10430,49094,7016,91523,192,101,91
32910,101974,10432,49105,7017,91542,192,101,91
32915,101984,10432,49110,7017,91552,192,101,91
32920,102005,10434,49126,7019,91571,192,101,91
32925,102015,10434,49131,7019,91581,192,101,91
32930,102036,10436,49144,7021,91600,192,101,91
32935,102046,10436,49148,7021,91610,192,101,91
32940,102067,10438,49152,7021,91629,192,101,91
32945,102077,10438,49157,7021,91639,192,101,91
32950,102098,10440,49165,7022,91658,192,101,91
32955,102108,10440,49167,7022,91668,192,101,91
32960,102129,10442,49173,7022,91687,192,101,91
32965,102139,10442,49179,7022,91697,192,101,91
32970,102160,10444,49189,7022,91716,192,101,91
32975,102170,10444,49193,7022,91726,192,101,91
32980,102191,10446,49203,7023,91745,192,101,91
32985,102201,10446,49207,7023,91754,192,101,91
32990,102222,10451,49219,7028,91770,192,101,91
32995,102232,10454,49223,7031,91778,192,101,91
33000,102253,10459,49231,7034,91793,192,101,91
33005,102263,10460,49233,7035,91803,192,101,91
33010,102284,10461,49239,7035,91823,192,101,91
33015,102294,10461,49243,7035,91833,192,101,91
33020,102315,10463,49250,7036,91852,192,101,91
33025,102325,10463,49253,7036,91862,192,101,91
33030,102346,10464,49267,7037,91882,192,101,91
33035,102356,10464,49272,7037,91892,192,101,91
33040,102377,10465,49281,7038,91912,192,101,91
33045,102387,10465,49285,7038,91922,192,101,91
33050,102408,10466,49294,7039,91942,192,101,91
33055,102418,10466,49300,7039,91952,192,101,91
33060,102439,10467,49314,7039,91972,192,101,91
33065,102449,10467,49319,7039,91982,192,101,91
33070,102470,10468,49330,7040,92002,192,101,91
33075,102480,10468,49335,7040,92012,192,101,91
33080,102501,10469,49346,7041,92032,192,101,91
33085,102511,10469,49349,7041,92042,192,101,91
33090,102532,10470,49359,7041,92062,192,101,91
33095,102542,10470,49366,7041,92072,192,101,91
33100,102563,10471,49374,7041,92092,192,101,91
33105,102573,10471,49380,7041,92101,192,101,91
33110,102594,10475,49390,7044,92119,192,101,91
33115,102604,10476,49395,7045,92127,192,101,91
33120,102625,10480,49401,7048,92145,192,101,91
33125,102635,10480,49406,7048,92155,192,101,91
33130,102656,10480,49416,7048,92176,192,101,91
33135,102666,10480,49422,7048,92186,192,101,91
33140,102687,10480,49435,7048,92207,192,101,91
33145,102697,10480,49440,7048,92217,192,101,91
33150,102718,10480,49447,7048,92238,192,101,91
33155,102728,10480,49452,7048,92248,192,101,91
33160,102749,10480,49463,7048,92269,192,101,91
33165,102759,10480,49468,7048,92279,192,101,91
33170,102780,10480,49480,7048,92300,192,101,91
33175,102790,10480,49488,7048,92310,192,101,91
33180,102811,10480,49498,7048,92331,192,101,91
33185,102821,10480,49503,7048,92341,192,101,91
33190,102842,10480,49514,7048,92362,192,101,91
33195,102852,10480,49520,7048,92372,192,101,91
33200,102873,10480,49534,7048,92393,192,101,91
33205,102883,10480,49540,7048,92403,192,101,91
33210,102904,10480,49549,7048,92424,192,101,91
33215,102914,10480,49555,7048,92434,192,101,91
33220,102935,10480,49564,7048,92455,192,101,91
33225,102945,10480,49570,7048,92464,192,101,91
33230,102966,10485,49579,7051,92481,192,101,91
33235,102976,10488,49584,7053,92487,192,101,91
33240,102997,10494,49593,7058,92502,192,101,91
33245,103007,10496,49595,7059,92511,192,101,91
33250,103028,10498,49604,7060,92529,192,101,91
33255,103038,10500,49606,7061,92537,192,101,91
33260,103059,10503,49619,7063,92556,192,101,91
33265,103069,10504,49624,7064,92565,192,101,91
33270,103090,10506,49635,7065,92584,192,101,91
33275,103100,10507,49638,7066,92593,192,101,91
33280,103121,10509,49649,7066,92612,192,101,91
33285,103131,10510,49654,7067,92621,192,101,91
33290,103152,10512,49665,7067,92640,192,101,91
33295,103162,10513,49668,7068,92649,192,101,91
33300,103183,10515,49679,7069,92668,192,101,91
33305,103193,10516,49684,7070,92677,192,101,91
33310,103214,10518,49693,7071,92696,192,101,91
33315,103224,10519,49695,7071,92705,192,101,91
33320,103245,10521,49708,7072,92724,192,101,91
33325,103255,10522,49712,7073,92733,192,101,91
33330,103276,10524,49724,7074,92752,192,101,91
33335,103286,10525,49729,7075,92761,192,101,91
33340,103307,10527,49741,7076,92780,192,101,91
33345,103317,10528,49746,7076,92789,192,101,91
33350,103338,10531,49757,7077,92807,192,101,91
33355,103348,10533,49763,7079,92815,192,101,91
33360,103369,10538,49775,7083,92828,192,101,91
33365,103379,10542,49780,7087,92836,192,101,91
33370,103400,10544,49789,7089,92856,192,101,91
33375,103410,10545,49793,7090,92864,192,101,91
33380,103431,10548,49803,7092,92883,192,101,91
33385,103441,10548,49806,7092,92893,192,101,91
33390,103462,10548,49817,7092,92914,192,101,91
33395,103472,10548,49823,7092,92924,192,101,91
33400,103493,10548,49831,7092,92945,192,101,91
33405,103503,10548,49837,7092,92955,192,101,91
33410,103524,10548,49846,7092,92976,192,101,91
33415,103534,10548,49853,7092,92986,192,101,91
33420,103555,10548,49860,7092,93007,192,101,91
33425,103565,10548,49865,7092,93017,192,101,91
33430,103586,10548,49876,7092,93038,192,101,91
33435,103596,10548,49883,7092,93048,192,101,91
33440,103617,10548,49894,7092,93069,192,101,91
33445,103627,10548,49899,7092,93079,192,101,91
33450,103648,10548,49906,7092,93100,192,101,91
33455,103658,10548,49912,7092,93110,192,101,91
33460,103679,10548,49922,7092,93131,192,101,91
33465,103689,10548,49925,7092,93141,192,101,91
33470,103710,10550,49934,7093,93160,192,101,91
33475,103720,10551,49938,7093,93169,192,101,91
33480,103741,10554,49948,7095,93187,192,101,91
33485,103751,10555,49953,7096,93196,192,101,91
33490,103772,10558,49964,7097,93214,192,101,91
33495,103782,10558,49967,7097,93224,192,101,91
33500,103803,10562,49978,7100,93241,192,101,91
33505,103813,10562,49981,7100,93251,192,101,91
33510,103834,10565,49993,7101,93269,192,101,91
33515,103844,10566,49997,7102,93278,192,101,91
33520,103865,10570,50009,7106,93295,192,101,91
33525,103875,10570,50012,7106,93305,192,101,91
33530,103896,10573,50022,7108,93323,192,101,91
33535,103906,10573,50025,7108,93333,192,101,91
33540,103927,10577,50031,7109,93350,192,101,91
33545,103937,10577,50034,7109,93360,192,101,91
33550,103958,10580,50053,7112,93378,192,101,91
33555,103968,10580,50057,7112,93388,192,101,91
33560,103989,10581,50065,7112,93408,192,101,91
33565,103999,10581,50070,7112,93417,192,101,91
33570,104020,10583,50084,7114,93437,192,101,91
33575,104030,10583,50090,7114,93446,192,101,91
33580,104051,10585,50101,7116,93466,192,101,91
33585,104061,10585,50104,7116,93476,192,101,91
33590,104082,10586,50113,7116,93496,192,101,91
33595,104092,10587,50118,7117,93505,192,101,91
33600,104113,10589,50129,7118,93523,192,101,91
33605,104123,10591,50134,7119,93532,192,101,91
33610,104144,10591,50140,7119,93553,192,101,91
33615,104154,10592,50146,7119,93562,192,101,91
33620,104175,10592,50157,7119,93583,192,101,91
33625,104185,10593,50163,7120,93592,192,101,91
33630,104206,10593,50173,7120,93613,192,101,91
33635,104216,10594,50176,7120,93622,192,101,91
33640,104237,10594,50183,7120,93643,192,101,91
33645,104247,10595,50188,7121,93652,192,101,91
33650,104268,10596,50193,7121,93672,192,101,91
33655,104278,10598,50197,7123,93680,192,101,91
33660,104299,10599,50209,7123,93700,192,101,91
33665,104309,10600,50213,7123,93709,192,101,91
33670,104330,10602,50224,7125,93728,192,101,91
33675,104340,10603,50231,7126,93737,192,101,91
33680,104361,10604,50240,7126,93757,192,101,91
33685,104371,10605,50245,7126,93765,192,101,91
33690,104392,10608,50256,7128,93784,192,101,91
33695,104402,10609,50261,7128,93792,192,101,91
33700,104423,10611,50267,7129,93812,192,101,91
33705,104433,10612,50271,7129,93820,192,101,91
33710,104454,10616,50277,7131,93838,192,101,91
33715,104464,10617,50280,7132,93847,192,101,91
33720,104485,10621,50290,7134,93863,192,101,91
33725,104495,10623,50295,7136,93872,192,101,91
33730,104516,10626,50304,7138,93890,192,101,91
33735,104526,10627,50311,7139,93899,192,101,91
33740,104547,10630,50324,7141,93917,192,101,91
33745,104557,10631,50330,7142,93926,192,101,91
33750,104578,10634,50338,7144,93944,192,101,91
33755,104588,10634,50343,7144,93954,192,101,91
33760,104609,10637,50352,7146,93972,192,101,91
33765,104619,10637,50356,7146,93982,192,101,91
33770,104640,10640,50362,7147,94000,192,101,91
33775,104650,10640,50367,7147,94010,192,101,91
33780,104671,10643,50379,7149,94028,192,101,91
33785,104681,10643,50384,7149,94038,192,101,91
33790,104702,10646,50395,7150,94056,192,101,91
33795,104712,10647,50400,7151,94065,192,101,91
33800,104733,10650,50411,7154,94083,192,101,91
33805,104743,10651,50417,7155,94092,192,101,91
33810,104764,10654,50425,7156,94110,192,101,91
33815,104774,10655,50431,7157,94119,192,101,91
33820,104795,10658,50444,7158,94137,192,101,91
33825,104805,10659,50447,7159,94146,192,101,91
33830,104826,10663,50453,7161,94163,192,101,91
33835,104836,10664,50459,7161,94172,192,101,91
33840,104857,10669,50471,7166,94188,192,101,91
33845,104867,10670,50474,7166,94197,192,101,91
33850,104888,10672,50485,7167,94216,192,101,91
33855,104898,10673,50488,7167,94225,192,101,91
33860,104919,10673,50497,7167,94246,192,101,91
33865,104929,10674,50499,7167,94255,192,101,91
33870,104950,10674,50506,7167,94276,192,101,91
33875,104960,10675,50509,7167,94285,192,101,91
33880,104981,10675,50517,7167,94306,192,101,91
33885,104991,10676,50522,7167,94315,192,101,91
33890,105012,10676,50534,7167,94335,192,101,91
33895,105022,10678,50538,7169,94344,192,101,91
33900,105043,10678,50547,7169,94364,192,101,91
33905,105053,10680,50551,7170,94373,192,101,91
33910,105074,10680,50558,7170,94394,192,101,91
33915,105084,10681,50563,7171,94403,192,101,91
33920,105105,10681,50574,7171,94424,192,101,91
33925,105115,10682,50578,7172,94433,192,101,91
33930,105136,10682,50588,7172,94454,192,101,91
33935,105146,10683,50594,7173,94463,192,101,91
33940,105167,10683,50602,7173,94484,192,101,91
33945,105177,10684,50605,7173,94493,192,101,91
33950,105198,10685,50613,7174,94513,192,101,91
33955,105208,10686,50616,7174,94521,192,101,91
33960,105229,10691,50625,7178,94537,192,101,91
33965,105239,10693,50630,7179,94546,192,101,91
33970,105260,10696,50643,7180,94564,192,101,91
33975,105270,10697,50647,7181,94573,192,101,91
33980,105291,10700,50657,7184,94591,192,101,91
33985,105301,10701,50661,7184,94600,192,101,91
33990,105322,10704,50667,7185,94618,192,101,91
33995,105332,10705,50670,7185,94627,192,101,91
34000,105353,10708,50680,7187,94645,192,101,91
34005,105363,10709,50686,7187,94654,192,101,91
34010,105384,10712,50699,7189,94672,192,101,91
34015,105394,10713,50704,7189,94681,192,101,91
34020,105415,10716,50717,7192,94699,192,101,91
34025,105425,10717,50723,7193,94708,192,101,91
34030,105446,10720,50736,7195,94726,192,101,91
34035,105456,10721,50742,7196,94735,192,101,91
34040,105477,10724,50754,7197,94753,192,101,91
34045,105487,10725,50761,7198,94762,192,101,91
34050,105508,10728,50771,7201,94780,192,101,91
34055,105518,10729,50775,7201,94789,192,101,91
34060,105539,10732,50789,7203,94807,192,101,91
34065,105549,10733,50791,7203,94815,192,101,91
34070,105570,10738,50799,7206,94830,192,101,91
34075,105580,10743,50803,7210,94836,192,101,91
34080,105601,10748,50813,7213,94852,192,101,91
34085,105611,10749,50816,7214,94862,192,101,91
34090,105632,10749,50826,7214,94883,192,101,91
34095,105642,10749,50830,7214,94893,192,101,91
34100,105663,10749,50843,7214,94914,192,101,91
34105,105673,10749,50852,7214,94924,192,101,91
34110,105694,10749,50862,7214,94945,192,101,91
34115,105704,10749,50866,7214,94955,192,101,91
34120,105725,10749,50877,7214,94976,192,101,91
34125,105735,10749,50882,7214,94986,192,101,91
34130,105756,10749,50891,7214,95007,192,101,91
34135,105766,10749,50894,7214,95017,192,101,91
34140,105787,10749,50903,7214,95038,192,101,91
34145,105797,10750,50910,7214,95047,192,101,91
34150,105818,10750,50922,7214,95068,192,101,91
34155,105828,10751,50928,7214,95077,192,101,91
34160,105849,10751,50937,7214,95098,192,101,91
34165,105859,10752,50941,7214,95107,192,101,91
34170,105880,10753,50950,7215,95127,192,101,91
34175,105890,10754,50957,7216,95136,192,101,91
34180,105911,10754,50966,7216,95157,192,101,91
34185,105921,10755,50970,7216,95166,192,101,91
34190,105942,10760,50983,7219,95182,192,101,91
34195,105952,10761,50987,7220,95191,192,101,91
34200,105973,10765,51001,7222,95208,192,101,91
34205,105983,10766,51003,7222,95217,192,101,91
34210,106004,10769,51015,7225,95235,192,101,91
34215,106014,10770,51019,7226,95244,192,101,91
34220,106035,10773,51026,7228,95262,192,101,91
34225,106045,10774,51030,7229,95271,192,101,91
34230,106066,10777,51042,7231,95289,192,101,91
34235,106076,10778,51046,7231,95298,192,101,91
34240,106097,10781,51057,7232,95316,192,101,91
34245,106107,10782,51063,7232,95325,192,101,91
34250,106128,10785,51076,7234,95343,192,101,91
34255,106138,10786,51080,7234,95352,192,101,91
34260,106159,10789,51090,7236,95370,192,101,91
34265,106169,10790,51093,7236,95379,192,101,91
34270,106190,10793,51103,7238,95396,192,101,91
34275,106200,10795,51109,7239,95405,192,101,91
34280,106221,10798,51116,7241,95423,192,101,91
34285,106231,10799,51123,7242,95432,192,101,91
34290,106252,10802,51134,7244,95449,192,101,91
34295,106262,10804,51138,7246,95458,192,101,91
34300,106283,10807,51152,7249,95476,192,101,91
34305,106293,10808,51157,7250,95484,192,101,91
34310,106314,10813,51168,7252,95501,192,101,91
34315,106324,10815,51173,7253,95508,192,101,91
34320,106345,10819,51178,7254,95526,192,101,91
34325,106355,10819,51184,7254,95536,192,101,91
34330,106376,10820,51193,7254,95556,192,101,91
34335,106386,10820,51195,7254,95566,192,101,91
34340,106407,10821,51207,7255,95586,192,101,91
34345,106417,10821,51209,7255,95596,192,101,91
34350,106438,10823,51219,7256,95615,192,101,91
34355,106448,10823,51223,7256,95625,192,101,91
34360,106469,10824,51228,7256,95645,192,101,91
34365,106479,10824,51233,7256,95655,192,101,91
34370,106500,10825,51240,7256,95675,192,101,91
34375,106510,10825,51243,7256,95685,192,101,91
34380,106531,10827,51255,7257,95704,192,101,91
34385,106541,10827,51260,7257,95714,192,101,91
34390,106562,10828,51268,7258,95734,192,101,91
34395,106572,10828,51273,7258,95744,192,101,91
34400,106593,10830,51284,7259,95763,192,101,91
34405,106603,10830,51290,7259,95773,192,101,91
34410,106624,10831,51296,7259,95793,192,101,91
34415,106634,10831,51302,7259,95803,192,101,91
34420,106655,10833,51314,7261,95822,192,101,91
34425,106665,10833,51317,7261,95832,192,101,91
34430,106686,10837,51327,7263,95849,192,101,91
34435,106696,10839,51332,7265,95857,192,101,91
34440,106717,10843,51341,7267,95874,192,101,91
34445,106727,10844,51348,7268,95883,192,101,91
34450,106748,10846,51355,7269,95902,192,101,91
34455,106758,10847,51358,7269,95911,192,101,91
34460,106779,10849,51364,7270,95930,192,101,91
34465,106789,10850,51369,7271,95939,192,101,91
34470,106810,10852,51381,7273,95958,192,101,91
34475,106820,10854,51384,7274,95966,192,101,91
34480,106841,10856,51396,7276,95985,192,101,91
34485,106851,10857,51400,7277,95994,192,101,91
34490,106872,10859,51412,7279,96013,192,101,91
34495,106882,10860,51414,7280,96022,192,101,91
34500,106903,10862,51422,7281,96041,192,101,91
34505,106913,10863,51429,7282,96050,192,101,91
34510,106934,10865,51444,7284,96069,192,101,91
34515,106944,10866,51447,7284,96078,192,101,91
34520,106965,10868,51458,7285,96097,192,101,91
34525,106975,10869,51466,7286,96106,192,101,91
34530,106996,10871,51473,7288,96125,192,101,91
34535,107006,10872,51477,7288,96134,192,101,91
34540,107027,10874,51489,7289,96153,192,101,91
34545,107037,10875,51497,7290,96162,192,101,91
34550,107058,10879,51506,7293,96179,192,101,91
34555,107068,10880,51512,7293,96187,192,101,91
34560,107089,10884,51524,7297,96205,192,101,91
34565,107099,10885,51529,7298,96214,192,101,91
34570,107120,10887,51539,7300,96233,192,101,91
34575,107130,10888,51545,7301,96242,192,101,91
34580,107151,10890,51554,7303,96261,192,101,91
34585,107161,10891,51560,7304,96270,192,101,91
34590,107182,10893,51573,7305,96289,192,101,91
34595,107192,10893,51577,7305,96299,192,101,91
34600,107213,10895,51589,7307,96318,192,101,91
34605,107223,10895,51595,7307,96328,192,101,91
34610,107244,10895,51604,7307,96349,192,101,91
34615,107254,10895,51608,7307,96359,192,101,91
34620,107275,10895,51620,7307,96380,192,101,91
34625,107285,10895,51622,7307,96390,192,101,91
34630,107306,10895,51633,7307,96411,192,101,91
34635,107316,10895,51634,7307,96421,192,101,91
34640,107337,10895,51645,7307,96442,192,101,91
34645,107347,10895,51650,7307,96452,192,101,91
34650,107368,10895,51661,7307,96473,192,101,91
34655,107378,10895,51667,7307,96483,192,101,91
34660,107399,10895,51682,7307,96504,192,101,91
34665,107409,10895,51689,7307,96514,192,101,91
34670,107430,10898,51697,7309,96531,192,101,91
34675,107440,10899,51703,7310,96540,192,101,91
34680,107461,10903,51711,7312,96557,192,101,91
34685,107471,10905,51715,7313,96566,192,101,91
34690,107492,10907,51721,7314,96585,192,101,91
34695,107502,10908,51724,7314,96594,192,101,91
34700,107523,10910,51731,7315,96613,192,101,91
34705,107533,10912,51736,7317,96621,192,101,91
34710,107554,10914,51747,7318,96640,192,101,91
34715,107564,10916,51752,7319,96648,192,101,91
34720,107585,10918,51766,7320,96667,192,101,91
34725,107595,10920,51773,7322,96675,192,101,91
34730,107616,10922,51782,7323,96694,192,101,91
34735,107626,10923,51785,7323,96703,192,101,91
34740,107647,10925,51797,7325,96722,192,101,91
34745,107657,10925,51800,7325,96732,192,101,91
34750,107678,10927,51812,7326,96751,192,101,91
34755,107688,10927,51816,7326,96761,192,101,91
34760,107709,10929,51824,7328,96780,192,101,91
34765,107719,10929,51827,7328,96790,192,101,91
34770,107740,10931,51840,7330,96809,192,101,91
34775,107750,10931,51845,7330,96819,192,101,91
34780,107771,10933,51852,7330,96838,192,101,91
34785,107781,10933,51856,7330,96848,192,101,91
34790,107802,10936,51866,7332,96866,192,101,91
34795,107812,10937,51870,7333,96874,192,101,91
34800,107833,10941,51883,7337,96891,192,101,91
34805,107843,10942,51886,7338,96901,192,101,91
34810,107864,10943,51895,7338,96921,192,101,91
34815,107874,10943,51899,7338,96931,192,101,91
34820,107895,10944,51907,7338,96951,192,101,91
34825,107905,10944,51913,7338,96961,192,101,91
34830,107926,10945,51923,7338,96981,192,101,91
34835,107936,10945,51927,7338,96991,192,101,91
34840,107957,10946,51939,7338,97011,192,101,91
34845,107967,10946,51944,7338,97021,192,101,91
34850,107988,10947,51955,7338,97041,192,101,91
34855,107998,10948,51957,7338,97050,192,101,91
34860,108019,10949,51968,7339,97070,192,101,91
34865,108029,10950,51970,7339,97079,192,101,91
34870,108050,10953,51979,7340,97097,192,101,91
34875,108060,10954,51983,7340,97105,192,101,91
34880,108081,10959,51992,7343,97122,192,101,91
34885,108091,10960,51994,7343,97131,192,101,91
34890,108112,10962,52002,7344,97150,192,101,91
34895,108122,10964,52007,7345,97158,192,101,91
34900,108143,10968,52019,7348,97175,192,101,91
34905,108153,10970,52022,7349,97183,192,101,91
34910,108174,10973,52033,7350,97200,192,101,91
34915,108184,10977,52036,7353,97207,192,101,91
34920,108205,10980,52049,7356,97225,192,101,91
34925,108215,10981,52055,7357,97234,192,101,91
34930,108236,10983,52070,7359,97253,192,101,91
34935,108246,10985,52075,7360,97261,192,101,91
34940,108267,10987,52088,7361,97280,192,101,91
34945,108277,10988,52093,7361,97289,192,101,91
34950,108298,10989,52100,7362,97309,192,101,91
34955,108308,10991,52105,7363,97317,192,101,91
34960,108329,10993,52115,7364,97336,192,101,91
34965,108339,10994,52120,7365,97345,192,101,91
34970,108360,10995,52128,7366,97365,192,101,91
34975,108370,10996,52132,7366,97374,192,101,91
34980,108391,10997,52141,7366,97394,192,101,91
34985,108401,10998,52145,7366,97403,192,101,91
34990,108422,10999,52155,7367,97423,192,101,91
34995,108432,11000,52159,7368,97432,192,101,91
35000,108453,11002,52167,7369,97451,192,101,91
35005,108463,11004,52174,7371,97459,192,101,91
35010,108484,11006,52187,7373,97478,192,101,91
35015,108494,11008,52193,7375,97486,192,101,91
35020,108515,11012,52203,7378,97503,192,101,91
35025,108525,11013,52206,7379,97512,192,101,91
35030,108546,11016,52211,7380,97530,192,101,91
35035,108556,11018,52214,7381,97537,192,101,91
35040,108577,11025,52227,7386,97551,192,101,91
35045,108587,11026,52234,7387,97561,192,101,91
35050,108608,11028,52241,7387,97580,192,101,91
35055,108618,11028,52249,7387,97590,192,101,91
35060,108639,11030,52258,7389,97609,192,101,91
35065,108649,11030,52264,7389,97619,192,101,91
35070,108670,11032,52275,7389,97638,192,101,91
35075,108680,11032,52279,7389,97648,192,101,91
35080,108701,11034,52292,7391,97667,192,101,91
35085,108711,11034,52296,7391,97677,192,101,91
35090,108732,11036,52307,7393,97696,192,101,91
35095,108742,11036,52314,7393,97706,192,101,91
35100,108763,11038,52324,7395,97725,192,101,91
35105,108773,11039,52330,7396,97734,192,101,91
35110,108794,11043,52342,7398,97751,192,101,91
35115,108804,11045,52346,7399,97759,192,101,91
35120,108825,11047,52360,7400,97777,192,101,91
35125,108835,11050,52365,7403,97785,192,101,91
35130,108856,11053,52377,7404,97803,192,101,91
35135,108866,11054,52382,7405,97812,192,101,91
35140,108887,11056,52393,7405,97831,192,101,91
35145,108897,11056,52397,7405,97840,192,101,91
35150,108918,11060,52408,7408,97858,192,101,91
35155,108928,11061,52412,7409,97866,192,101,91
35160,108949,11065,52420,7411,97883,192,101,91
35165,108959,11069,52426,7414,97890,192,101,91
35170,108980,11071,52434,7415,97909,192,101,91
35175,108990,11074,52438,7418,97916,192,101,91
35180,109011,11076,52448,7420,97935,192,101,91
35185,109021,11077,52448,7420,97944,192,101,91
35190,109042,11079,52461,7422,97963,192,101,91
35195,109052,11082,52465,7424,97970,192,101,91
35200,109073,11084,52472,7424,97989,192,101,91
35205,109083,11085,52477,7424,97998,192,101,91
35210,109104,11087,52487,7424,98017,192,101,91
35215,109114,11088,52493,7425,98026,192,101,91
35220,109135,11090,52503,7426,98045,192,101,91
35225,109145,11091,52508,7427,98054,192,101,91
35230,109166,11093,52520,7428,98073,192,101,91
35235,109176,11094,52526,7429,98082,192,101,91
35240,109197,11096,52538,7429,98101,192,101,91
35245,109207,11097,52544,7430,98110,192,101,91
35250,109228,11099,52554,7430,98129,192,101,91
35255,109238,11100,52559,7431,98138,192,101,91
35260,109259,11102,52567,7432,98157,192,101,91
35265,109269,11103,52571,7432,98166,192,101,91
35270,109290,11108,52580,7435,98182,192,101,91
35275,109300,11109,52586,7435,98191,192,101,91
35280,109321,11114,52593,7439,98206,192,101,91
35285,109331,11115,52595,7440,98216,192,101,91
35290,109352,11116,52601,7440,98236,192,101,91
35295,109362,11116,52606,7440,98245,192,101,91
35300,109383,11118,52617,7441,98265,192,101,91
35305,109393,11118,52621,7441,98274,192,101,91
35310,109414,11120,52630,7442,98294,192,101,91
35315,109424,11120,52636,7442,98303,192,101,91
35320,109445,11122,52645,7444,98323,192,101,91
35325,109455,11122,52648,7444,98333,192,101,91
35330,109476,11123,52657,7444,98353,192,101,91
35335,109486,11123,52660,7444,98363,192,101,91
35340,109507,11124,52670,7444,98383,192,101,91
35345,109517,11126,52677,7446,98391,192,101,91
35350,109538,11127,52689,7447,98410,192,101,91
35355,109548,11129,52691,7449,98419,192,101,91
35360,109569,11129,52703,7449,98440,192,101,91
35365,109579,11129,52711,7449,98450,192,101,91
35370,109600,11129,52725,7449,98471,192,101,91
35375,109610,11129,52729,7449,98481,192,101,91
35380,109631,11129,52737,7449,98502,192,101,91
35385,109641,11129,52740,7449,98512,192,101,91
35390,109662,11131,52756,7450,98530,192,101,91
35395,109672,11132,52759,7451,98540,192,101,91
35400,109693,11134,52769,7452,98558,192,101,91
35405,109703,11137,52775,7454,98566,192,101,91
35410,109724,11140,52782,7454,98584,192,101,91
35415,109734,11141,52787,7455,98593,192,101,91
35420,109755,11144,52797,7456,98611,192,101,91
35425,109765,11145,52803,7457,98620,192,101,91
35430,109786,11148,52820,7460,98638,192,101,91
35435,109796,11149,52826,7461,98647,192,101,91
35440,109817,11152,52840,7464,98665,192,101,91
35445,109827,11153,52848,7465,98674,192,101,91
35450,109848,11156,52859,7467,98692,192,101,91
35455,109858,11157,52863,7467,98701,192,101,91
35460,109879,11160,52877,7470,98719,192,101,91
35465,109889,11162,52881,7471,98727,192,101,91
35470,109910,11165,52885,7472,98745,192,101,91
35475,109920,11167,52890,7473,98753,192,101,91
35480,109941,11171,52901,7476,98769,192,101,91
35485,109951,11174,52906,7479,98777,192,101,91
35490,109972,11177,52915,7480,98795,192,101,91
35495,109982,11178,52922,7481,98804,192,101,91
35500,110003,11182,52936,7484,98821,192,101,91
35505,110013,11183,52943,7485,98829,192,101,91
35510,110034,11188,52955,7489,98846,192,101,91
35515,110044,11189,52959,7490,98854,192,101,91
35520,110065,11193,52967,7493,98872,192,101,91
35525,110075,11193,52970,7493,98882,192,101,91
35530,110096,11194,52981,7493,98902,192,101,91
35535,110106,11194,52985,7493,98912,192,101,91
35540,110127,11196,53003,7495,98931,192,101,91
35545,110137,11196,53007,7495,98941,192,101,91
35550,110158,11196,53016,7495,98962,192,101,91
35555,110168,11196,53021,7495,98972,192,101,91
35560,110189,11196,53034,7495,98993,192,101,91
35565,110199,11196,53038,7495,99003,192,101,91
35570,110220,11196,53048,7495,99024,192,101,91
35575,110230,11196,53054,7495,99034,192,101,91
35580,110251,11196,53069,7495,99055,192,101,91
35585,110261,11196,53073,7495,99065,192,101,91
35590,110282,11196,53081,7495,99086,192,101,91
35595,110292,11197,53086,7496,99095,192,101,91
35600,110313,11197,53101,7496,99116,192,101,91
35605,110323,11198,53106,7496,99125,192,101,91
35610,110344,11198,53120,7496,99146,192,101,91
35615,110354,11199,53125,7497,99155,192,101,91
35620,110375,11199,53136,7497,99175,192,101,91
35625,110385,11201,53144,7499,99183,192,101,91
35630,110406,11204,53154,7500,99201,192,101,91
35635,110416,11208,53160,7504,99207,192,101,91
35640,110437,11212,53174,7508,99223,192,101,91
35645,110447,11215,53178,7510,99232,192,101,91
35650,110468,11217,53190,7511,99251,192,101,91
35655,110478,11218,53195,7512,99260,192,101,91
35660,110499,11220,53204,7512,99279,192,101,91
35665,110509,11221,53209,7512,99288,192,101,91
35670,110530,11223,53219,7514,99307,192,101,91
35675,110540,11224,53221,7514,99316,192,101,91
35680,110561,11226,53227,7515,99335,192,101,91
35685,110571,11227,53230,7516,99344,192,101,91
35690,110592,11229,53242,7518,99363,192,101,91
35695,110602,11230,53244,7518,99372,192,101,91
35700,110623,11232,53253,7519,99391,192,101,91
35705,110633,11233,53257,7519,99400,192,101,91
35710,110654,11235,53266,7521,99419,192,101,91
35715,110664,11236,53269,7521,99428,192,101,91
35720,110685,11238,53280,7523,99447,192,101,91
35725,110695,11239,53285,7523,99456,192,101,91
35730,110716,11241,53299,7524,99475,192,101,91
35735,110726,11242,53304,7525,99484,192,101,91
35740,110747,11244,53312,7526,99503,192,101,91
35745,110757,11245,53315,7527,99512,192,101,91
35750,110778,11249,53326,7529,99528,192,101,91
35755,110788,11252,53332,7531,99535,192,101,91
35760,110809,11260,53343,7537,99547,192,101,91
35765,110819,11262,53348,7539,99557,192,101,91
35770,110840,11263,53359,7540,99577,192,101,91
35775,110850,11263,53364,7540,99587,192,101,91
35780,110871,11264,53373,7540,99607,192,101,91
35785,110881,11264,53378,7540,99617,192,101,91
35790,110902,11265,53391,7541,99637,192,101,91
35795,110912,11265,53399,7541,99647,192,101,91
35800,110933,11266,53406,7541,99667,192,101,91
35805,110943,11266,53407,7541,99677,192,101,91
35810,110964,11267,53422,7542,99697,192,101,91
35815,110974,11267,53428,7542,99707,192,101,91
35820,110995,11268,53440,7543,99727,192,101,91
35825,111005,11268,53445,7543,99737,192,101,91
35830,111026,11269,53456,7543,99757,192,101,91
35835,111036,11269,53459,7543,99767,192,101,91
35840,111057,11270,53468,7543,99787,192,101,91
35845,111067,11270,53473,7543,99797,192,101,91
35850,111088,11271,53479,7543,99817,192,101,91
35855,111098,11271,53483,7543,99827,192,101,91
35860,111119,11272,53492,7543,99847,192,101,91
35865,111129,11272,53494,7543,99857,192,101,91
35870,111150,11276,53502,7546,99873,192,101,91
35875,111160,11280,53510,7549,99879,192,101,91
35880,111181,11287,53524,7556,99893,192,101,91
35885,111191,11289,53530,7558,99902,192,101,91
35890,111212,11290,53541,7559,99922,192,101,91
35895,111222,11291,53545,7559,99931,192,101,91
35900,111243,11292,53557,7559,99951,192,101,91
35905,111253,11293,53561,7560,99960,192,101,91
35910,111274,11294,53570,7560,99980,192,101,91
35915,111284,11295,53576,7561,99988,192,101,91
35920,111305,11297,53584,7563,100008,192,101,91
35925,111315,11298,53591,7564,100017,192,101,91
35930,111336,11299,53598,7565,100037,192,101,91
35935,111346,11300,53603,7565,100046,192,101,91
35940,111367,11301,53614,7565,100066,192,101,91
35945,111377,11302,53620,7565,100075,192,101,91
35950,111398,11303,53629,7566,100095,192,101,91
35955,111408,11304,53634,7566,100104,192,101,91
35960,111429,11305,53641,7566,100124,192,101,91
35965,111439,11306,53645,7566,100133,192,101,91
35970,111460,11307,53656,7566,100153,192,101,91
35975,111470,11308,53657,7566,100162,192,101,91
35980,111491,11309,53669,7566,100182,192,101,91
35985,111501,11310,53673,7566,100191,192,101,91
35990,111522,11313,53682,7568,100209,192,101,91
35995,111532,11314,53682,7568,100218,192,101,91
36000,111553,11319,53693,7571,100233,192,101,91
36005,111563,11320,53699,7572,100243,192,101,91
36010,111584,11324,53710,7573,100260,192,101,91
36015,111594,11324,53714,7573,100270,192,101,91
36020,111615,11328,53726,7575,100287,192,101,91
36025,111625,11328,53729,7575,100297,192,101,91
36030,111646,11331,53740,7577,100315,192,101,91
36035,111656,11331,53744,7577,100325,192,101,91
36040,111677,11335,53759,7580,100342,192,101,91
36045,111687,11335,53766,7580,100352,192,101,91
36050,111708,11338,53777,7581,100370,192,101,91
36055,111718,11338,53782,7581,100380,192,101,91
36060,111739,11342,53792,7585,100397,192,101,91
36065,111749,11342,53795,7585,100407,192,101,91
36070,111770,11345,53808,7587,100425,192,101,91
36075,111780,11345,53813,7587,100435,192,101,91
36080,111801,11348,53824,7589,100453,192,101,91
36085,111811,11348,53830,7589,100463,192,101,91
36090,111832,11351,53840,7592,100481,192,101,91
36095,111842,11351,53847,7592,100491,192,101,91
36100,111863,11354,53857,7594,100509,192,101,91
36105,111873,11354,53862,7594,100518,192,101,91
36110,111894,11359,53873,7597,100535,192,101,91
36115,111904,11360,53876,7597,100543,192,101,91
36120,111925,11364,53881,7599,100561,192,101,91
36125,111935,11365,53886,7600,100570,192,101,91
36130,111956,11365,53896,7600,100591,192,101,91
36135,111966,11366,53900,7600,100600,192,101,91
36140,111987,11366,53909,7600,100620,192,101,91
36145,111997,11368,53915,7602,100629,192,101,91
36150,112018,11368,53931,7602,100650,192,101,91
36155,112028,11369,53935,7602,100659,192,101,91
36160,112049,11369,53942,7602,100680,192,101,91
36165,112059,11370,53948,7603,100689,192,101,91
36170,112080,11370,53957,7603,100710,192,101,91
36175,112090,11371,53961,7603,100719,192,101,91
36180,112111,11371,53972,7603,100740,192,101,91
36185,112121,11372,53979,7604,100749,192,101,91
36190,112142,11372,53984,7604,100770,192,101,91
36195,112152,11373,53987,7604,100779,192,101,91
36200,112173,11373,53996,7604,100800,192,101,91
36205,112183,11374,54002,7605,100809,192,101,91
36210,112204,11374,54012,7605,100830,192,101,91
36215,112214,11375,54019,7606,100839,192,101,91
36220,112235,11375,54030,7606,100860,192,101,91
36225,112245,11376,54037,7607,100869,192,101,91
36230,112266,11380,54044,7609,100885,192,101,91
36235,112276,11383,54049,7612,100893,192,101,91
36240,112297,11387,54060,7613,100909,192,101,91
36245,112307,11388,54062,7614,100919,192,101,91
36250,112328,11389,54076,7615,100939,192,101,91
36255,112338,11389,54080,7615,100949,192,101,91
36260,112359,11390,54090,7616,100969,192,101,91
36265,112369,11390,54094,7616,100979,192,101,91
36270,112390,11391,54100,7616,100999,192,101,91
36275,112400,11391,54105,7616,101008,192,101,91
36280,112421,11393,54116,7618,101028,192,101,91
36285,112431,11393,54122,7618,101038,192,101,91
36290,112452,11394,54133,7619,101058,192,101,91
36295,112462,11394,54139,7619,101068,192,101,91
36300,112483,11395,54150,7620,101088,192,101,91
36305,112493,11395,54155,7620,101097,192,101,91
36310,112514,11398,54162,7621,101116,192,101,91
36315,112524,11398,54167,7621,101125,192,101,91
36320,112545,11401,54173,7623,101144,192,101,91
36325,112555,11401,54179,7623,101154,192,101,91
36330,112576,11404,54190,7625,101172,192,101,91
36335,112586,11404,54194,7625,101182,192,101,91
36340,112607,11407,54205,7627,101200,192,101,91
36345,112617,11407,54211,7627,101210,192,101,91
36350,112638,11410,54220,7628,101227,192,101,91
36355,112648,11412,54225,7629,101236,192,101,91
36360,112669,11416,54234,7632,101253,192,101,91
36365,112679,11417,54239,7633,101262,192,101,91
36370,112700,11418,54250,7633,101282,192,101,91
36375,112710,11419,54254,7634,101291,192,101,91
36380,112731,11420,54267,7635,101311,192,101,91
36385,112741,11421,54273,7636,101320,192,101,91
36390,112762,11422,54282,7636,101340,192,101,91
36395,112772,11423,54286,7637,101349,192,101,91
36400,112793,11424,54296,7638,101369,192,101,91
36405,112803,11425,54299,7638,101378,192,101,91
36410,112824,11426,54306,7639,101398,192,101,91
36415,112834,11427,54313,7640,101407,192,101,91
36420,112855,11428,54322,7640,101427,192,101,91
36425,112865,11429,54326,7641,101436,192,101,91
36430,112886,11430,54337,7641,101456,192,101,91
36435,112896,11431,54340,7641,101465,192,101,91
36440,112917,11432,54347,7642,101485,192,101,91
36445,112927,11433,54351,7642,101494,192,101,91
36450,112948,11434,54359,7643,101514,192,101,91
36455,112958,11435,54361,7643,101523,192,101,91
36460,112979,11436,54374,7644,101542,192,101,91
36465,112989,11438,54381,7646,101550,192,101,91
36470,113010,11442,54394,7649,101568,192,101,91
36475,113020,11444,54398,7650,101576,192,101,91
36480,113041,11449,54408,7653,101591,192,101,91
36485,113051,11451,54411,7654,101600,192,101,91
36490,113072,11452,54420,7654,101620,192,101,91
36495,113082,11453,54426,7654,101629,192,101,91
36500,113103,11454,54436,7655,101649,192,101,91
36505,113113,11455,54440,7655,101658,192,101,91
36510,113134,11456,54447,7655,101678,192,101,91
36515,113144,11457,54451,7655,101687,192,101,91
36520,113165,11458,54465,7655,101707,192,101,91
36525,113175,11459,54468,7656,101716,192,101,91
36530,113196,11460,54476,7656,101736,192,101,91
36535,113206,11461,54479,7656,101745,192,101,91
36540,113227,11462,54488,7656,101765,192,101,91
36545,113237,11463,54494,7656,101774,192,101,91
36550,113258,11464,54504,7657,101794,192,101,91
36555,113268,11465,54511,7658,101803,192,101,91
36560,113289,11466,54525,7658,101823,192,101,91
36565,113299,11467,54532,7658,101832,192,101,91
36570,113320,11468,54540,7658,101852,192,101,91
36575,113330,11469,54546,7659,101861,192,101,91
36580,113351,11470,54558,7659,101881,192,101,91
36585,113361,11471,54563,7659,101890,192,101,91
36590,113382,11476,54570,7662,101906,192,101,91
36595,113392,11478,54577,7664,101914,192,101,91
36600,113413,11484,54589,7668,101928,192,101,91
36605,113423,11485,54595,7669,101938,192,101,91
36610,113444,11487,54605,7669,101957,192,101,91
36615,113454,11487,54609,7669,101967,192,101,91
36620,113475,11489,54619,7671,101986,192,101,91
36625,113485,11489,54624,7671,101996,192,101,91
36630,113506,11491,54631,7673,102015,192,101,91
36635,113516,11491,54635,7673,102025,192,101,91
36640,113537,11493,54647,7674,102044,192,101,91
36645,113547,11493,54653,7674,102054,192,101,91
36650,113568,11495,54659,7676,102073,192,101,91
36655,113578,11495,54666,7676,102083,192,101,91
36660,113599,11497,54674,7676,102102,192,101,91
36665,113609,11497,54681,7676,102112,192,101,91
36670,113630,11499,54692,7677,102131,192,101,91
36675,113640,11499,54695,7677,102141,192,101,91
36680,113661,11501,54704,7678,102160,192,101,91
36685,113671,11501,54706,7678,102170,192,101,91
36690,113692,11503,54719,7679,102189,192,101,91
36695,113702,11503,54725,7679,102199,192,101,91
36700,113723,11505,54737,7681,102218,192,101,91
36705,113733,11506,54741,7682,102227,192,101,91
36710,113754,11510,54750,7685,102244,192,101,91
36715,113764,11512,54754,7686,102252,192,101,91
36720,113785,11517,54764,7689,102267,192,101,91
36725,113795,11520,54772,7692,102275,192,101,91
36730,113816,11521,54778,7692,102295,192,101,91
36735,113826,11522,54783,7693,102304,192,101,91
36740,113847,11523,54791,7694,102324,192,101,91
36745,113857,11525,54797,7696,102332,192,101,91
36750,113878,11526,54806,7697,102352,192,101,91
36755,113888,11527,54811,7697,102361,192,101,91
36760,113909,11528,54823,7698,102381,192,101,91
36765,113919,11530,54828,7699,102389,192,101,91
36770,113940,11531,54839,7699,102409,192,101,91
36775,113950,11532,54844,7700,102418,192,101,91
36780,113971,11533,54854,7701,102438,192,101,91
36785,113981,11535,54859,7702,102446,192,101,91
36790,114002,11536,54868,7703,102466,192,101,91
36795,114012,11538,54872,7704,102474,192,101,91
36800,114033,11539,54878,7704,102494,192,101,91
36805,114043,11540,54884,7704,102503,192,101,91
36810,114064,11541,54898,7705,102523,192,101,91
36815,114074,11542,54902,7705,102532,192,101,91
36820,114095,11543,54907,7705,102552,192,101,91
36825,114105,11544,54910,7705,102561,192,101,91
36830,114126,11547,54919,7707,102577,192,101,91
36835,114136,11552,54924,7711,102584,192,101,91
36840,114157,11556,54934,7713,102599,192,101,91
36845,114167,11558,54938,7715,102609,192,101,91
36850,114188,11561,54946,7718,102627,192,101,91
36855,114198,11561,54950,7718,102637,192,101,91
36860,114219,11563,54957,7719,102656,192,101,91
36865,114229,11563,54964,7719,102666,192,101,91
36870,114250,11566,54975,7722,102684,192,101,91
36875,114260,11566,54979,7722,102694,192,101,91
36880,114281,11568,54992,7724,102713,192,101,91
36885,114291,11568,54995,7724,102723,192,101,91
36890,114312,11570,55003,7725,102742,192,101,91
36895,114322,11570,55008,7725,102752,192,101,91
36900,114343,11573,55016,7727,102770,192,101,91
36905,114353,11573,55019,7727,102780,192,101,91
36910,114374,11576,55030,7729,102798,192,101,91
36915,114384,11576,55036,7729,102808,192,101,91
36920,114405,11578,55045,7729,102827,192,101,91
36925,114415,11578,55053,7729,102837,192,101,91
36930,114436,11581,55064,7730,102855,192,101,91
36935,114446,11581,55070,7730,102865,192,101,91
36940,114467,11584,55081,7731,102883,192,101,91
36945,114477,11585,55085,7731,102892,192,101,91
36950,114498,11590,55095,7734,102908,192,101,91
36955,114508,11592,55100,7735,102915,192,101,91
36960,114529,11599,55111,7742,102928,192,101,91
36965,114539,11601,55115,7744,102938,192,101,91
36970,114560,11602,55120,7745,102958,192,101,91
36975,114570,11602,55127,7745,102968,192,101,91
36980,114591,11603,55138,7745,102988,192,101,91
36985,114601,11603,55145,7745,102998,192,101,91
36990,114622,11604,55154,7746,103018,192,101,91
36995,114632,11604,55161,7746,103028,192,101,91
37000,114653,11605,55169,7746,103048,192,101,91
37005,114663,11605,55176,7746,103058,192,101,91
37010,114684,11606,55187,7746,103078,192,101,91
37015,114694,11606,55191,7746,103088,192,101,91
37020,114715,11607,55202,7746,103108,192,101,91
37025,114725,11607,55204,7746,103118,192,101,91
37030,114746,11611,55215,7749,103135,192,101,91
37035,114756,11611,55221,7749,103145,192,101,91
37040,114777,11615,55232,7753,103162,192,101,91
37045,114787,11615,55237,7753,103172,192,101,91
37050,114808,11619,55250,7756,103189,192,101,91
37055,114818,11619,55254,7756,103199,192,101,91
37060,114839,11622,55262,7757,103217,192,101,91
37065,114849,11622,55269,7757,103227,192,101,91
37070,114870,11625,55277,7758,103244,192,101,91
37075,114880,11629,55282,7761,103250,192,101,91
37080,114901,11633,55293,7764,103266,192,101,91
37085,114911,11636,55296,7767,103275,192,101,91
37090,114932,11637,55310,7768,103295,192,101,91
37095,114942,11638,55316,7768,103304,192,101,91
37100,114963,11639,55326,7769,103324,192,101,91
37105,114973,11640,55330,7769,103333,192,101,91
37110,114994,11641,55338,7770,103353,192,101,91
37115,115004,11642,55341,7770,103362,192,101,91
37120,115025,11643,55352,7771,103381,192,101,91
37125,115035,11645,55359,7773,103390,192,101,91
37130,115056,11646,55368,7773,103409,192,101,91
37135,115066,11648,55371,7774,103418,192,101,91
37140,115087,11649,55380,7775,103438,192,101,91
37145,115097,11650,55385,7776,103447,192,101,91
37150,115118,11651,55395,7777,103467,192,101,91
37155,115128,11652,55401,7778,103476,192,101,91
37160,115149,11653,55410,7778,103496,192,101,91
37165,115159,11654,55414,7778,103505,192,101,91
37170,115180,11655,55427,7779,103524,192,101,91
37175,115190,11657,55432,7780,103533,192,101,91
37180,115211,11658,55445,7781,103552,192,101,91
37185,115221,11660,55448,7782,103561,192,101,91
37190,115242,11664,55460,7785,103577,192,101,91
37195,115252,11668,55464,7788,103583,192,101,91
37200,115273,11674,55473,7792,103598,192,101,91
37205,115283,11675,55474,7793,103608,192,101,91
37210,115304,11677,55486,7795,103627,192,101,91
37215,115314,11677,55489,7795,103637,192,101,91
37220,115335,11678,55498,7795,103657,192,101,91
37225,115345,11678,55502,7795,103666,192,101,91
37230,115366,11681,55512,7798,103685,192,101,91
37235,115376,11681,55514,7798,103695,192,101,91
37240,115397,11681,55525,7798,103716,192,101,91
37245,115407,11681,55529,7798,103726,192,101,91
37250,115428,11681,55538,7798,103747,192,101,91
37255,115438,11681,55544,7798,103757,192,101,91
37260,115459,11681,55556,7798,103778,192,101,91
37265,115469,11681,55559,7798,103788,192,101,91
37270,115490,11683,55571,7800,103807,192,101,91
37275,115500,11683,55575,7800,103817,192,101,91
37280,115521,11685,55588,7802,103836,192,101,91
37285,115531,11685,55592,7802,103846,192,101,91
37290,115552,11686,55601,7803,103866,192,101,91
37295,115562,11686,55603,7803,103876,192,101,91
37300,115583,11688,55614,7804,103895,192,101,91
37305,115593,11689,55620,7805,103904,192,101,91
37310,115614,11693,55630,7807,103920,192,101,91
37315,115624,11696,55634,7810,103928,192,101,91
37320,115645,11701,55647,7815,103942,192,101,91
37325,115655,11705,55652,7818,103950,192,101,91
37330,115676,11707,55664,7820,103969,192,101,91
37335,115686,11709,55668,7821,103977,192,101,91
37340,115707,11711,55679,7821,103996,192,101,91
37345,115717,11712,55682,7821,104004,192,101,91
37350,115738,11715,55691,7822,104023,192,101,91
37355,115748,11716,55695,7822,104032,192,101,91
37360,115769,11718,55707,7823,104051,192,101,91
37365,115779,11719,55711,7823,104059,192,101,91
37370,115800,11722,55719,7824,104078,192,101,91
37375,115810,11723,55722,7824,104087,192,101,91
37380,115831,11725,55734,7825,104106,192,101,91
37385,115841,11726,55741,7826,104115,192,101,91
37390,115862,11728,55751,7826,104134,192,101,91
37395,115872,11729,55755,7827,104143,192,101,91
37400,115893,11731,55764,7828,104162,192,101,91
37405,115903,11732,55771,7828,104171,192,101,91
37410,115924,11734,55782,7829,104190,192,101,91
37415,115934,11735,55786,7830,104199,192,101,91
37420,115955,11737,55796,7832,104218,192,101,91
37425,115965,11738,55803,7833,104226,192,101,91
37430,115986,11743,55815,7837,104243,192,101,91
37435,115996,11746,55823,7840,104249,192,101,91
37440,116017,11752,55831,7843,104265,192,101,91
37445,116027,11752,55834,7843,104275,192,101,91
37450,116048,11754,55842,7843,104293,192,101,91
37455,116058,11756,55849,7845,104302,192,101,91
37460,116079,11761,55864,7849,104317,192,101,91
37465,116089,11762,55869,7850,104327,192,101,91
37470,116110,11764,55883,7852,104346,192,101,91
37475,116120,11764,55886,7852,104356,192,101,91
37480,116141,11768,55899,7855,104373,192,101,91
37485,116151,11768,55903,7855,104383,192,101,91
37490,116172,11770,55911,7857,104402,192,101,91
37495,116182,11770,55917,7857,104412,192,101,91
37500,116203,11772,55927,7859,104431,192,101,91
37505,116213,11772,55933,7859,104441,192,101,91
37510,116234,11772,55947,7859,104462,192,101,91
37515,116244,11772,55951,7859,104472,192,101,91
37520,116265,11772,55964,7859,104493,192,101,91
37525,116275,11772,55969,7859,104503,192,101,91
37530,116296,11772,55976,7859,104524,192,101,91
37535,116306,11772,55983,7859,104534,192,101,91
37540,116327,11772,55993,7859,104555,192,101,91
37545,116337,11772,55999,7859,104565,192,101,91
37550,116358,11773,56006,7860,104585,192,101,91
37555,116368,11774,56011,7861,104594,192,101,91
37560,116389,11775,56021,7862,104614,192,101,91
37565,116399,11777,56027,7864,104622,192,101,91
37570,116420,11779,56037,7866,104640,192,101,91
37575,116430,11782,56044,7868,104648,192,101,91
37580,116451,11782,56053,7868,104669,192,101,91
37585,116461,11784,56060,7869,104677,192,101,91
37590,116482,11785,56068,7869,104696,192,101,91
37595,116492,11787,56073,7871,104705,192,101,91
37600,116513,11788,56084,7871,104725,192,101,91
37605,116523,11789,56089,7871,104734,192,101,91
37610,116544,11790,56099,7871,104754,192,101,91
37615,116554,11791,56104,7871,104763,192,101,91
37620,116575,11792,56114,7872,104783,192,101,91
37625,116585,11792,56117,7872,104793,192,101,91
37630,116606,11793,56127,7872,104813,192,101,91
37635,116616,11793,56131,7872,104823,192,101,91
37640,116637,11794,56141,7872,104843,192,101,91
37645,116647,11794,56145,7872,104853,192,101,91
37650,116668,11795,56156,7873,104873,192,101,91
37655,116678,11795,56159,7873,104883,192,101,91
37660,116699,11796,56171,7873,104903,192,101,91
37665,116709,11796,56175,7873,104913,192,101,91
37670,116730,11799,56180,7873,104930,192,101,91
37675,116740,11801,56185,7875,104939,192,101,91
37680,116761,11805,56195,7877,104956,192,101,91
37685,116771,11805,56199,7877,104966,192,101,91
37690,116792,11807,56207,7879,104985,192,101,91
37695,116802,11807,56212,7879,104995,192,101,91
37700,116823,11809,56222,7881,105014,192,101,91
37705,116833,11809,56226,7881,105024,192,101,91
37710,116854,11811,56235,7882,105043,192,101,91
37715,116864,11811,56238,7882,105053,192,101,91
37720,116885,11813,56247,7883,105072,192,101,91
37725,116895,11813,56250,7883,105082,192,101,91
37730,116916,11816,56264,7886,105099,192,101,91
37735,116926,11818,56267,7887,105108,192,101,91
37740,116947,11821,56279,7888,105125,192,101,91
37745,116957,11823,56282,7889,105134,192,101,91
37750,116978,11826,56290,7891,105151,192,101,91
37755,116988,11828,56294,7893,105160,192,101,91
37760,117009,11830,56304,7895,105178,192,101,91
37765,117019,11832,56308,7896,105187,192,101,91
37770,117040,11834,56317,7896,105205,192,101,91
37775,117050,11836,56322,7897,105214,192,101,91
37780,117071,11838,56332,7898,105233,192,101,91
37785,117081,11839,56339,7898,105242,192,101,91
37790,117102,11843,56347,7901,105258,192,101,91
37795,117112,11846,56353,7903,105266,192,101,91
37800,117133,11851,56364,7906,105282,192,101,91
37805,117143,11852,56369,7906,105291,192,101,91
37810,117164,11855,56380,7907,105309,192,101,91
37815,117174,11856,56386,7907,105318,192,101,91
37820,117195,11857,56398,7908,105338,192,101,91
37825,117205,11858,56405,7908,105347,192,101,91
37830,117226,11859,56413,7908,105367,192,101,91
37835,117236,11860,56418,7909,105376,192,101,91
37840,117257,11861,56426,7910,105396,192,101,91
37845,117267,11862,56430,7910,105405,192,101,91
37850,117288,11863,56442,7910,105425,192,101,91
37855,117298,11864,56448,7910,105434,192,101,91
37860,117319,11865,56455,7910,105454,192,101,91
37865,117329,11865,56460,7910,105464,192,101,91
37870,117350,11868,56469,7913,105482,192,101,91
37875,117360,11868,56476,7913,105492,192,101,91
37880,117381,11870,56487,7915,105511,192,101,91
37885,117391,11870,56492,7915,105521,192,101,91
37890,117412,11872,56503,7916,105540,192,101,91
37895,117422,11872,56509,7916,105550,192,101,91
37900,117443,11875,56522,7918,105568,192,101,91
37905,117453,11875,56529,7918,105578,192,101,91
37910,117474,11877,56537,7919,105597,192,101,91
37915,117484,11877,56541,7919,105607,192,101,91
37920,117505,11879,56549,7920,105626,192,101,91
37925,117515,11879,56553,7920,105636,192,101,91
37930,117536,11880,56565,7921,105656,192,101,91
37935,117546,11880,56569,7921,105666,192,101,91
37940,117567,11881,56581,7921,105686,192,101,91
37945,117577,11881,56586,7921,105696,192,101,91
37950,117598,11882,56594,7921,105716,192,101,91
37955,117608,11882,56600,7921,105726,192,101,91
37960,117629,11883,56611,7922,105746,192,101,91
37965,117639,11883,56616,7922,105756,192,101,91
37970,117660,11884,56626,7922,105776,192,101,91
37975,117670,11885,56630,7923,105785,192,101,91
37980,117691,11886,56641,7924,105805,192,101,91
37985,117701,11887,56645,7925,105814,192,101,91
37990,117722,11891,56657,7928,105831,192,101,91
37995,117732,11893,56662,7929,105839,192,101,91
38000,117753,11897,56673,7932,105856,192,101,91
38005,117763,11898,56676,7932,105865,192,101,91
38010,117784,11902,56685,7934,105882,192,101,91
38015,117794,11903,56686,7934,105891,192,101,91
38020,117815,11906,56692,7935,105909,192,101,91
38025,117825,11907,56696,7936,105918,192,101,91
38030,117846,11910,56704,7936,105936,192,101,91
38035,117856,11911,56710,7937,105944,192,101,91
38040,117877,11916,56719,7939,105960,192,101,91
38045,117887,11918,56725,7940,105969,192,101,91
38050,117908,11919,56735,7941,105989,192,101,91
38055,117918,11920,56738,7942,105998,192,101,91
38060,117939,11920,56748,7942,106019,192,101,91
38065,117949,11921,56755,7943,106028,192,101,91
38070,117970,11921,56766,7943,106049,192,101,91
38075,117980,11922,56772,7943,106058,192,101,91
38080,118001,11922,56779,7943,106079,192,101,91
38085,118011,11923,56782,7943,106088,192,101,91
38090,118032,11923,56790,7943,106109,192,101,91
38095,118042,11924,56792,7943,106118,192,101,91
38100,118063,11924,56809,7943,106139,192,101,91
38105,118073,11925,56812,7944,106148,192,101,91
38110,118094,11925,56819,7944,106169,192,101,91
38115,118104,11926,56825,7945,106178,192,101,91
38120,118125,11926,56835,7945,106199,192,101,91
38125,118135,11927,56838,7945,106208,192,101,91
38130,118156,11927,56849,7945,106229,192,101,91
38135,118166,11928,56856,7945,106238,192,101,91
38140,118187,11928,56869,7945,106259,192,101,91
38145,118197,11929,56873,7945,106268,192,101,91
38150,118218,11931,56883,7946,106286,192,101,91
38155,118228,11934,56890,7948,106294,192,101,91
38160,118249,11939,56899,7951,106310,192,101,91
38165,118259,11939,56905,7951,106320,192,101,91
38170,118280,11942,56914,7953,106338,192,101,91
38175,118290,11942,56918,7953,106348,192,101,91
38180,118311,11945,56926,7954,106366,192,101,91
38185,118321,11945,56931,7954,106376,192,101,91
38190,118342,11948,56943,7955,106394,192,101,91
38195,118352,11948,56948,7955,106404,192,101,91
38200,118373,11951,56959,7958,106422,192,101,91
38205,118383,11951,56966,7958,106432,192,101,91
38210,118404,11954,56976,7960,106450,192,101,91
38215,118414,11954,56981,7960,106460,192,101,91
38220,118435,11957,56990,7960,106478,192,101,91
38225,118445,11957,56993,7960,106488,192,101,91
38230,118466,11960,57004,7961,106506,192,101,91
38235,118476,11960,57008,7961,106516,192,101,91
38240,118497,11963,57023,7963,106534,192,101,91
38245,118507,11963,57029,7963,106544,192,101,91
38250,118528,11966,57041,7965,106562,192,101,91
38255,118538,11966,57045,7965,106572,192,101,91
38260,118559,11969,57055,7967,106590,192,101,91
38265,118569,11969,57061,7967,106600,192,101,91
38270,118590,11972,57076,7970,106618,192,101,91
38275,118600,11974,57083,7972,106625,192,101,91
38280,118621,11981,57095,7978,106640,192,101,91
38285,118631,11982,57101,7979,106649,192,101,91
38290,118652,11982,57111,7979,106669,192,101,91
38295,118662,11984,57117,7980,106678,192,101,91
38300,118683,11985,57127,7981,106698,192,101,91
38305,118693,11986,57132,7981,106707,192,101,91
38310,118714,11986,57142,7981,106728,192,101,91
38315,118724,11987,57147,7981,106737,192,101,91
38320,118745,11988,57155,7982,106757,192,101,91
38325,118755,11989,57159,7982,106766,192,101,91
38330,118776,11989,57174,7982,106787,192,101,91
38335,118786,11990,57179,7982,106796,192,101,91
38340,118807,11990,57193,7982,106817,192,101,91
38345,118817,11991,57195,7982,106826,192,101,91
38350,118838,11991,57208,7982,106847,192,101,91
38355,118848,11992,57214,7983,106856,192,101,91
38360,118869,11993,57223,7984,106876,192,101,91
38365,118879,11994,57225,7984,106885,192,101,91
38370,118900,11995,57238,7985,106905,192,101,91
38375,118910,11996,57245,7986,106914,192,101,91
38380,118931,11997,57260,7987,106934,192,101,91
38385,118941,11998,57265,7987,106943,192,101,91
38390,118962,12005,57280,7992,106957,192,101,91
38395,118972,12007,57284,7993,106965,192,101,91
38400,118993,12013,57297,7997,106980,192,101,91
38405,119003,12013,57302,7997,106990,192,101,91
38410,119024,12015,57312,7998,107009,192,101,91
38415,119034,12015,57317,7998,107019,192,101,91
38420,119055,12018,57325,7999,107037,192,101,91
38425,119065,12018,57330,7999,107047,192,101,91
38430,119086,12020,57341,8000,107066,192,101,91
38435,119096,12020,57345,8000,107076,192,101,91
38440,119117,12022,57352,8001,107095,192,101,91
38445,119127,12022,57357,8001,107105,192,101,91
38450,119148,12025,57369,8002,107123,192,101,91
38455,119158,12026,57374,8003,107132,192,101,91
38460,119179,12028,57380,8004,107151,192,101,91
38465,119189,12030,57385,8006,107159,192,101,91
38470,119210,12032,57398,8008,107177,192,101,91
38475,119220,12036,57405,8011,107184,192,101,91
38480,119241,12038,57414,8012,107203,192,101,91
38485,119251,12040,57418,8014,107211,192,101,91
38490,119272,12042,57427,8015,107229,192,101,91
38495,119282,12045,57431,8018,107237,192,101,91
38500,119303,12047,57439,8019,107256,192,101,91
38505,119313,12049,57443,8021,107264,192,101,91
38510,119334,12052,57452,8021,107282,192,101,91
38515,119344,12054,57456,8023,107290,192,101,91
38520,119365,12058,57465,8024,107306,192,101,91
38525,119375,12059,57470,8025,107315,192,101,91
38530,119396,12062,57481,8028,107334,192,101,91
38535,119406,12062,57481,8028,107344,192,101,91
38540,119427,12064,57492,8029,107363,192,101,91
38545,119437,12064,57498,8029,107372,192,101,91
38550,119458,12068,57508,8032,107390,192,101,91
38555,119468,12068,57517,8032,107399,192,101,91
38560,119489,12072,57526,8034,107417,192,101,91
38565,119499,12072,57531,8034,107427,192,101,91
38570,119520,12075,57543,8037,107445,192,101,91
38575,119530,12075,57546,8037,107455,192,101,91
38580,119551,12077,57556,8037,107474,192,101,91
38585,119561,12077,57561,8037,107484,192,101,91
38590,119582,12081,57572,8039,107501,192,101,91
38595,119592,12081,57573,8039,107511,192,101,91
38600,119613,12084,57579,8040,107529,192,101,91
38605,119623,12084,57584,8040,107539,192,101,91
38610,119644,12088,57589,8041,107556,192,101,91
38615,119654,12088,57593,8041,107565,192,101,91
38620,119675,12093,57602,8044,107582,192,101,91
38625,119685,12093,57606,8044,107592,192,101,91
38630,119706,12098,57620,8048,107606,192,101,91
38635,119716,12102,57624,8051,107613,192,101,91
38640,119737,12108,57631,8055,107629,192,101,91
38645,119747,12109,57636,8056,107638,192,101,91
38650,119768,12109,57650,8056,107657,192,101,91
38655,119778,12112,57654,8058,107666,192,101,91
38660,119799,12112,57660,8058,107686,192,101,91
38665,119809,12114,57667,8059,107695,192,101,91
38670,119830,12114,57677,8059,107716,192,101,91
38675,119840,12114,57684,8059,107726,192,101,91
38680,119861,12114,57695,8059,107747,192,101,91
38685,119871,12114,57699,8059,107757,192,101,91
38690,119892,12114,57706,8059,107778,192,101,91
38695,119902,12114,57711,8059,107788,192,101,91
38700,119923,12114,57718,8059,107809,192,101,91
38705,119933,12114,57724,8059,107819,192,101,91
38710,119954,12114,57735,8059,107840,192,101,91
38715,119964,12114,57737,8059,107850,192,101,91
38720,119985,12114,57751,8059,107871,192,101,91
38725,119995,12114,57756,8059,107881,192,101,91
38730,120016,12114,57767,8059,107902,192,101,91
38735,120026,12114,57772,8059,107912,192,101,91
38740,120047,12114,57785,8059,107933,192,101,91
38745,120057,12114,57790,8059,107943,192,101,91
38750,120078,12118,57806,8063,107959,192,101,91
38755,120088,12119,57811,8064,107969,192,101,91
38760,120109,12124,57820,8066,107985,192,101,91
38765,120119,12125,57823,8066,107993,192,101,91
38770,120140,12128,57831,8068,108011,192,101,91
38775,120150,12130,57836,8070,108019,192,101,91
38780,120171,12133,57845,8071,108037,192,101,91
38785,120181,12135,57849,8073,108046,192,101,91
38790,120202,12137,57856,8073,108065,192,101,91
38795,120212,12138,57864,8074,108073,192,101,91
38800,120233,12141,57874,8076,108092,192,101,91
38805,120243,12142,57876,8076,108101,192,101,91
38810,120264,12144,57885,8077,108120,192,101,91
38815,120274,12145,57891,8078,108129,192,101,91
38820,120295,12147,57904,8079,108147,192,101,91
38825,120305,12149,57906,8081,108156,192,101,91
38830,120326,12151,57913,8081,108174,192,101,91
38835,120336,12153,57919,8082,108183,192,101,91
38840,120357,12155,57929,8083,108202,192,101,91
38845,120367,12156,57934,8083,108211,192,101,91
38850,120388,12158,57942,8085,108230,192,101,91
38855,120398,12159,57946,8085,108239,192,101,91
38860,120419,12161,57951,8086,108258,192,101,91
38865,120429,12162,57959,8086,108266,192,101,91
38870,120450,12168,57969,8091,108282,192,101,91
38875,120460,12169,57974,8091,108290,192,101,91
38880,120481,12175,57987,8095,108304,192,101,91
38885,120491,12177,57990,8097,108314,192,101,91
38890,120512,12179,58006,8098,108333,192,101,91
38895,120522,12179,58010,8098,108343,192,101,91
38900,120543,12180,58017,8098,108363,192,101,91
38905,120553,12180,58019,8098,108373,192,101,91
38910,120574,12181,58032,8099,108393,192,101,91
38915,120584,12181,58037,8099,108403,192,101,91
38920,120605,12182,58048,8100,108423,192,101,91
38925,120615,12182,58050,8100,108433,192,101,91
38930,120636,12183,58058,8100,108453,192,101,91
38935,120646,12183,58061,8100,108463,192,101,91
38940,120667,12184,58069,8100,108483,192,101,91
38945,120677,12185,58071,8100,108491,192,101,91
38950,120698,12188,58078,8101,108509,192,101,91
38955,120708,12190,58083,8103,108517,192,101,91
38960,120729,12194,58092,8106,108535,192,101,91
38965,120739,12195,58094,8106,108544,192,101,91
38970,120760,12198,58104,8107,108562,192,101,91
38975,120770,12199,58108,8108,108570,192,101,91
38980,120791,12202,58118,8110,108589,192,101,91
38985,120801,12203,58122,8111,108598,192,101,91
38990,120822,12205,58129,8113,108617,192,101,91
38995,120832,12206,58131,8113,108625,192,101,91
39000,120853,12210,58142,8116,108643,192,101,91
39005,120863,12211,58148,8116,108652,192,101,91
39010,120884,12213,58158,8117,108671,192,101,91
39015,120894,12214,58164,8117,108680,192,101,91
39020,120915,12216,58174,8118,108699,192,101,91
39025,120925,12217,58179,8119,108708,192,101,91
39030,120946,12219,58188,8121,108727,192,101,91
39035,120956,12220,58191,8121,108736,192,101,91
39040,120977,12222,58199,8122,108755,192,101,91
39045,120987,12223,58204,8122,108764,192,101,91
39050,121008,12228,58219,8127,108779,192,101,91
39055,121018,12231,58221,8129,108787,192,101,91
39060,121039,12234,58230,8132,108805,192,101,91
39065,121049,12235,58235,8133,108814,192,101,91
39070,121070,12236,58243,8134,108833,192,101,91
39075,121080,12238,58247,8136,108842,192,101,91
39080,121101,12239,58256,8136,108860,192,101,91
39085,121111,12242,58263,8138,108869,192,101,91
39090,121132,12243,58272,8138,108889,192,101,91
39095,121142,12244,58274,8138,108898,192,101,91
39100,121163,12246,58286,8139,108917,192,101,91
39105,121173,12247,58289,8139,108926,192,101,91
39110,121194,12249,58299,8140,108945,192,101,91
39115,121204,12250,58302,8140,108954,192,101,91
39120,121225,12252,58308,8140,108972,192,101,91
39125,121235,12254,58316,8141,108981,192,101,91
39130,121256,12255,58325,8141,109001,192,101,91
39135,121266,12256,58330,8142,109010,192,101,91
39140,121287,12257,58342,8142,109030,192,101,91
39145,121297,12258,58349,8143,109039,192,101,91
39150,121318,12259,58362,8144,109059,192,101,91
39155,121328,12260,58365,8144,109068,192,101,91
39160,121349,12262,58375,8144,109087,192,101,91
39165,121359,12263,58380,8144,109096,192,101,91
39170,121380,12267,58389,8147,109113,192,101,91
39175,121390,12268,58394,8147,109122,192,101,91
39180,121411,12272,58405,8150,109139,192,101,91
39185,121421,12272,58410,8150,109148,192,101,91
39190,121442,12276,58421,8153,109166,192,101,91
39195,121452,12276,58422,8153,109176,192,101,91
39200,121473,12279,58435,8155,109194,192,101,91
39205,121483,12279,58440,8155,109204,192,101,91
39210,121504,12282,58450,8157,109222,192,101,91
39215,121514,12282,58456,8157,109232,192,101,91
39220,121535,12283,58467,8158,109252,192,101,91
39225,121545,12283,58474,8158,109262,192,101,91
39230,121566,12285,58486,8160,109281,192,101,91
39235,121576,12285,58487,8160,109291,192,101,91
39240,121597,12286,58498,8160,109311,192,101,91
39245,121607,12286,58504,8160,109321,192,101,91
39250,121628,12288,58514,8162,109340,192,101,91
39255,121638,12288,58520,8162,109350,192,101,91
39260,121659,12289,58528,8163,109370,192,101,91
39265,121669,12289,58532,8163,109380,192,101,91
39270,121690,12291,58542,8164,109399,192,101,91
39275,121700,12291,58547,8164,109409,192,101,91
39280,121721,12292,58558,8165,109429,192,101,91
39285,121731,12293,58563,8165,109438,192,101,91
39290,121752,12296,58569,8167,109456,192,101,91
39295,121762,12298,58573,8169,109464,192,101,91
39300,121783,12301,58584,8170,109481,192,101,91
39305,121793,12303,58588,8171,109490,192,101,91
39310,121814,12304,58599,8171,109510,192,101,91
39315,121824,12305,58605,8171,109518,192,101,91
39320,121845,12307,58613,8173,109538,192,101,91
39325,121855,12309,58619,8175,109545,192,101,91
39330,121876,12312,58627,8177,109564,192,101,91
39335,121886,12314,58632,8178,109572,192,101,91
39340,121907,12316,58645,8180,109591,192,101,91
39345,121917,12317,58651,8181,109600,192,101,91
39350,121938,12319,58661,8183,109618,192,101,91
39355,121948,12322,58668,8185,109626,192,101,91
39360,121969,12324,58683,8187,109645,192,101,91
39365,121979,12324,58689,8187,109655,192,101,91
39370,122000,12326,58697,8187,109674,192,101,91
39375,122010,12326,58701,8187,109684,192,101,91
39380,122031,12328,58711,8189,109703,192,101,91
39385,122041,12328,58714,8189,109713,192,101,91
39390,122062,12330,58724,8190,109732,192,101,91
39395,122072,12330,58730,8190,109742,192,101,91
39400,122093,12332,58741,8192,109761,192,101,91
39405,122103,12332,58745,8192,109771,192,101,91
39410,122124,12336,58753,8194,109788,192,101,91
39415,122134,12337,58759,8195,109797,192,101,91
39420,122155,12341,58771,8198,109813,192,101,91
39425,122165,12344,58777,8200,109821,192,101,91
39430,122186,12345,58786,8200,109841,192,101,91
39435,122196,12346,58790,8200,109850,192,101,91
39440,122217,12348,58799,8201,109869,192,101,91
39445,122227,12349,58805,8201,109878,192,101,91
39450,122248,12352,58815,8203,109896,192,101,91
39455,122258,12354,58824,8205,109904,192,101,91
39460,122279,12354,58834,8205,109925,192,101,91
39465,122289,12355,58837,8205,109934,192,101,91
39470,122310,12355,58846,8205,109955,192,101,91
39475,122320,12356,58850,8206,109964,192,101,91
39480,122341,12356,58857,8206,109985,192,101,91
39485,122351,12357,58861,8206,109994,192,101,91
39490,122372,12357,58869,8206,110015,192,101,91
39495,122382,12358,58873,8206,110024,192,101,91
39500,122403,12358,58886,8206,110045,192,101,91
39505,122413,12359,58891,8206,110054,192,101,91
39510,122434,12359,58899,8206,110075,192,101,91
39515,122444,12360,58907,8207,110084,192,101,91
39520,122465,12360,58915,8207,110105,192,101,91
39525,122475,12361,58920,8207,110114,192,101,91
39530,122496,12363,58931,8209,110133,192,101,91
39535,122506,12364,58934,8210,110142,192,101,91
39540,122527,12367,58946,8211,110159,192,101,91
39545,122537,12368,58951,8212,110168,192,101,91
39550,122558,12371,58960,8215,110187,192,101,91
39555,122568,12372,58965,8216,110196,192,101,91
39560,122589,12374,58973,8217,110215,192,101,91
39565,122599,12375,58977,8218,110224,192,101,91
39570,122620,12377,58987,8219,110243,192,101,91
39575,122630,12378,58991,8220,110252,192,101,91
39580,122651,12380,59000,8222,110271,192,101,91
39585,122661,12380,59004,8222,110281,192,101,91
39590,122682,12383,59018,8223,110299,192,101,91
39595,122692,12383,59022,8223,110309,192,101,91
39600,122713,12385,59034,8225,110328,192,101,91
39605,122723,12385,59040,8225,110338,192,101,91
39610,122744,12387,59047,8225,110357,192,101,91
39615,122754,12387,59053,8225,110367,192,101,91
39620,122775,12390,59064,8227,110385,192,101,91
39625,122785,12390,59068,8227,110395,192,101,91
39630,122806,12393,59077,8229,110413,192,101,91
39635,122816,12393,59082,8229,110423,192,101,91
39640,122837,12395,59093,8231,110442,192,101,91
39645,122847,12396,59098,8232,110451,192,101,91
39650,122868,12401,59108,8235,110466,192,101,91
39655,122878,12404,59114,8238,110474,192,101,91
39660,122899,12411,59129,8243,110488,192,101,91
39665,122909,12412,59133,8244,110497,192,101,91
39670,122930,12413,59148,8245,110516,192,101,91
39675,122940,12415,59152,8246,110524,192,101,91
39680,122961,12417,59164,8247,110544,192,101,91
39685,122971,12418,59166,8248,110552,192,101,91
39690,122992,12420,59176,8250,110572,192,101,91
39695,123002,12421,59181,8251,110580,192,101,91
39700,123023,12423,59191,8252,110600,192,101,91
39705,123033,12424,59197,8252,110609,192,101,91
39710,123054,12425,59206,8252,110629,192,101,91
39715,123064,12426,59209,8252,110638,192,101,91
39720,123085,12427,59222,8253,110658,192,101,91
39725,123095,12428,59226,8253,110667,192,101,91
39730,123116,12430,59236,8254,110686,192,101,91
39735,123126,12431,59243,8254,110694,192,101,91
39740,123147,12434,59251,8256,110713,192,101,91
39745,123157,12435,59255,8256,110722,192,101,91
39750,123178,12437,59266,8257,110741,192,101,91
39755,123188,12438,59271,8258,110750,192,101,91
39760,123209,12441,59277,8259,110768,192,101,91
39765,123219,12442,59282,8259,110777,192,101,91
39770,123240,12446,59290,8262,110794,192,101,91
39775,123250,12449,59298,8265,110801,192,101,91
39780,123271,12454,59308,8269,110816,192,101,91
39785,123281,12455,59314,8270,110826,192,101,91
39790,123302,12456,59326,8270,110846,192,101,91
39795,123312,12456,59333,8270,110856,192,101,91
39800,123333,12457,59347,8271,110876,192,101,91
39805,123343,12457,59356,8271,110886,192,101,91
39810,123364,12458,59370,8271,110906,192,101,91
39815,123374,12458,59374,8271,110916,192,101,91
39820,123395,12459,59386,8272,110936,192,101,91
39825,123405,12459,59389,8272,110946,192,101,91
39830,123426,12460,59396,8272,110966,192,101,91
39835,123436,12460,59401,8272,110976,192,101,91
39840,123457,12461,59408,8272,110996,192,101,91
39845,123467,12462,59412,8273,111005,192,101,91
39850,123488,12466,59426,8276,111022,192,101,91
39855,123498,12468,59432,8278,111029,192,101,91
39860,123519,12472,59445,8281,111047,192,101,91
39865,123529,12472,59448,8281,111056,192,101,91
39870,123550,12476,59457,8284,111074,192,101,91
39875,123560,12476,59462,8284,111083,192,101,91
39880,123581,12480,59474,8287,111101,192,101,91
39885,123591,12482,59479,8289,111108,192,101,91
39890,123612,12487,59487,8291,111125,192,101,91
39895,123622,12489,59495,8293,111132,192,101,91
39900,123643,12493,59505,8296,111149,192,101,91
39905,123653,12495,59508,8297,111157,192,101,91
39910,123674,12497,59517,8299,111177,192,101,91
39915,123684,12498,59521,8300,111186,192,101,91
39920,123705,12499,59529,8300,111206,192,101,91
39925,123715,12500,59533,8300,111215,192,101,91
39930,123736,12501,59545,8301,111235,192,101,91
39935,123746,12502,59552,8302,111244,192,101,91
39940,123767,12503,59563,8302,111264,192,101,91
39945,123777,12504,59570,8302,111273,192,101,91
39950,123798,12505,59579,8303,111293,192,101,91
39955,123808,12506,59583,8303,111302,192,101,91
39960,123829,12507,59594,8304,111322,192,101,91
39965,123839,12508,59599,8304,111331,192,101,91
39970,123860,12509,59608,8304,111350,192,101,91
39975,123870,12512,59613,8307,111358,192,101,91
39980,123891,12513,59623,8308,111377,192,101,91
39985,123901,12515,59625,8309,111386,192,101,91
39990,123922,12517,59633,8311,111405,192,101,91
39995,123932,12519,59637,8312,111413,192,101,91
40000,123953,12521,59645,8313,111432,192,101,91
40005,123963,12523,59647,8314,111440,192,101,91
40010,123984,12527,59657,8317,111456,192,101,91
40015,123994,12530,59662,8319,111463,192,101,91
40020,124015,12535,59669,8321,111477,192,101,91
40025,124025,12538,59672,8324,111487,192,101,91
40030,124046,12540,59683,8325,111506,192,101,91
40035,124056,12540,59688,8325,111516,192,101,91
40040,124077,12542,59696,8325,111535,192,101,91
40045,124087,12542,59700,8325,111545,192,101,91
40050,124108,12544,59707,8325,111564,192,101,91
40055,124118,12544,59712,8325,111574,192,101,91
40060,124139,12546,59722,8327,111593,192,101,91
40065,124149,12546,59727,8327,111603,192,101,91
40070,124170,12549,59739,8329,111621,192,101,91
40075,124180,12549,59746,8329,111631,192,101,91
40080,124201,12552,59756,8332,111649,192,101,91
40085,124211,12554,59759,8333,111657,192,101,91
40090,124232,12559,59771,8337,111672,192,101,91
40095,124242,12562,59778,8339,111680,192,101,91
40100,124263,12565,59792,8342,111698,192,101,91
40105,124273,12567,59796,8343,111706,192,101,91
40110,124294,12571,59807,8345,111723,192,101,91
40115,124304,12573,59812,8346,111731,192,101,91
40120,124325,12576,59819,8348,111748,192,101,91
40125,124335,12579,59823,8351,111756,192,101,91
40130,124356,12580,59834,8352,111776,192,101,91
40135,124366,12581,59839,8352,111785,192,101,91
40140,124387,12582,59850,8353,111805,192,101,91
40145,124397,12583,59857,8354,111814,192,101,91
40150,124418,12583,59871,8354,111835,192,101,91
40155,124428,12584,59875,8354,111844,192,101,91
40160,124449,12584,59884,8354,111865,192,101,91
40165,124459,12585,59888,8354,111874,192,101,91
40170,124480,12585,59895,8354,111895,192,101,91
40175,124490,12586,59897,8354,111904,192,101,91
40180,124511,12586,59908,8354,111925,192,101,91
40185,124521,12587,59912,8355,111934,192,101,91
40190,124542,12588,59922,8355,111954,192,101,91
40195,124552,12589,59928,8355,111963,192,101,91
40200,124573,12590,59937,8355,111983,192,101,91
40205,124583,12591,59945,8356,111992,192,101,91
40210,124604,12595,59955,8358,112009,192,101,91
40215,124614,12596,59961,8359,112018,192,101,91
40220,124635,12600,59974,8362,112035,192,101,91
40225,124645,12602,59978,8364,112043,192,101,91
40230,124666,12607,59990,8368,112059,192,101,91
40235,124676,12609,59996,8369,112067,192,101,91
40240,124697,12613,60003,8370,112084,192,101,91
40245,124707,12614,60009,8371,112093,192,101,91
40250,124728,12618,60018,8374,112109,192,101,91
40255,124738,12621,60023,8377,112117,192,101,91
40260,124759,12624,60031,8378,112134,192,101,91
40265,124769,12625,60036,8379,112144,192,101,91
40270,124790,12627,60045,8380,112163,192,101,91
40275,124800,12627,60051,8380,112173,192,101,91
40280,124821,12628,60060,8380,112193,192,101,91
40285,124831,12628,60063,8380,112203,192,101,91
40290,124852,12629,60074,8381,112223,192,101,91
40295,124862,12629,60079,8381,112233,192,101,91
40300,124883,12630,60090,8381,112253,192,101,91
40305,124893,12630,60096,8381,112263,192,101,91
40310,124914,12631,60103,8381,112283,192,101,91
40315,124924,12631,60107,8381,112293,192,101,91
40320,124945,12632,60121,8382,112313,192,101,91
40325,124955,12632,60127,8382,112323,192,101,91
40330,124976,12633,60139,8382,112343,192,101,91
40335,124986,12633,60143,8382,112353,192,101,91
40340,125007,12634,60156,8383,112373,192,101,91
40345,125017,12634,60161,8383,112383,192,101,91
40350,125038,12635,60173,8384,112403,192,101,91
40355,125048,12635,60174,8384,112413,192,101,91
40360,125069,12636,60185,8384,112433,192,101,91
40365,125079,12636,60193,8384,112443,192,101,91
40370,125100,12639,60200,8386,112461,192,101,91
40375,125110,12641,60207,8388,112469,192,101,91
40380,125131,12645,60220,8390,112485,192,101,91
40385,125141,12648,60228,8393,112493,192,101,91
40390,125162,12649,60241,8394,112512,192,101,91
40395,125172,12651,60246,8395,112521,192,101,91
40400,125193,12652,60253,8395,112541,192,101,91
40405,125203,12653,60259,8396,112550,192,101,91
40410,125224,12654,60271,8397,112570,192,101,91
40415,125234,12655,60276,8398,112579,192,101,91
40420,125255,12656,60284,8398,112599,192,101,91
40425,125265,12657,60288,8399,112608,192,101,91
40430,125286,12658,60294,8399,112628,192,101,91
40435,125296,12659,60297,8400,112637,192,101,91
40440,125317,12660,60308,8401,112657,192,101,91
40445,125327,12661,60313,8402,112666,192,101,91
40450,125348,12662,60324,8403,112686,192,101,91
40455,125358,12663,60329,8403,112695,192,101,91
40460,125379,12664,60340,8404,112715,192,101,91
40465,125389,12665,60345,8405,112724,192,101,91
40470,125410,12666,60357,8406,112744,192,101,91
40475,125420,12667,60360,8406,112753,192,101,91
40480,125441,12668,60369,8406,112773,192,101,91
40485,125451,12669,60375,8407,112781,192,101,91
40490,125472,12675,60387,8412,112797,192,101,91
40495,125482,12677,60390,8413,112804,192,101,91
40500,125503,12683,60402,8418,112820,192,101,91
40505,125513,12683,60405,8418,112829,192,101,91
40510,125534,12686,60417,8421,112848,192,101,91
40515,125544,12687,60419,8422,112856,192,101,91
40520,125565,12688,60431,8423,112877,192,101,91
40525,125575,12688,60437,8423,112887,192,101,91
40530,125596,12688,60448,8423,112908,192,101,91
40535,125606,12688,60453,8423,112918,192,101,91
40540,125627,12688,60462,8423,112939,192,101,91
40545,125637,12688,60470,8423,112949,192,101,91
40550,125658,12688,60480,8423,112970,192,101,91
40555,125668,12688,60486,8423,112980,192,101,91
40560,125689,12688,60495,8423,113001,192,101,91
40565,125699,12688,60500,8423,113011,192,101,91
40570,125720,12688,60511,8423,113032,192,101,91
40575,125730,12688,60515,8423,113042,192,101,91
40580,125751,12688,60523,8423,113063,192,101,91
40585,125761,12688,60528,8423,113073,192,101,91
40590,125782,12688,60536,8423,113094,192,101,91
40595,125792,12688,60543,8423,113104,192,101,91
40600,125813,12688,60552,8423,113125,192,101,91
40605,125823,12688,60560,8423,113134,192,101,91
40610,125844,12692,60572,8425,113152,192,101,91
40615,125854,12693,60575,8425,113161,192,101,91
40620,125875,12695,60584,8426,113180,192,101,91
40625,125885,12697,60592,8428,113188,192,101,91
40630,125906,12701,60601,8430,113204,192,101,91
40635,125916,12704,60608,8433,113212,192,101,91
40640,125937,12707,60619,8434,113229,192,101,91
40645,125947,12709,60623,8435,113238,192,101,91
40650,125968,12712,60636,8437,113255,192,101,91
40655,125978,12715,60643,8439,113263,192,101,91
40660,125999,12718,60654,8440,113281,192,101,91
40665,126009,12719,60659,8440,113290,192,101,91
40670,126030,12722,60671,8443,113308,192,101,91
40675,126040,12723,60675,8444,113317,192,101,91
40680,126061,12726,60688,8445,113335,192,101,91
40685,126071,12727,60692,8445,113344,192,101,91
40690,126092,12730,60699,8446,113362,192,101,91
40695,126102,12731,60703,8447,113371,192,101,91
40700,126123,12734,60713,8449,113389,192,101,91
40705,126133,12735,60717,8450,113398,192,101,91
40710,126154,12738,60723,8451,113416,192,101,91
40715,126164,12739,60729,8451,113425,192,101,91
40720,126185,12742,60736,8453,113443,192,101,91
40725,126195,12743,60738,8453,113451,192,101,91
40730,126216,12747,60747,8456,113469,192,101,91
40735,126226,12748,60752,8456,113478,192,101,91
40740,126247,12751,60762,8457,113496,192,101,91
40745,126257,12753,60766,8458,113504,192,101,91
40750,126278,12753,60776,8458,113525,192,101,91
40755,126288,12754,60780,8459,113534,192,101,91
40760,126309,12754,60792,8459,113555,192,101,91
40765,126319,12755,60798,8460,113564,192,101,91
40770,126340,12755,60807,8460,113585,192,101,91
40775,126350,12757,60812,8462,113593,192,101,91
40780,126371,12757,60823,8462,113613,192,101,91
40785,126381,12760,60829,8464,113621,192,101,91
40790,126402,12760,60838,8464,113642,192,101,91
40795,126412,12761,60842,8465,113651,192,101,91
40800,126433,12761,60849,8465,113672,192,101,91
40805,126443,12762,60856,8466,113681,192,101,91
40810,126464,12762,60864,8466,113702,192,101,91
40815,126474,12762,60867,8466,113712,192,101,91
40820,126495,12762,60876,8466,113733,192,101,91
40825,126505,12762,60881,8466,113743,192,101,91
40830,126526,12762,60891,8466,113764,192,101,91
40835,126536,12762,60895,8466,113774,192,101,91
40840,126557,12762,60904,8466,113795,192,101,91
40845,126567,12762,60910,8466,113805,192,101,91
40850,126588,12766,60921,8468,113822,192,101,91
40855,126598,12767,60925,8469,113830,192,101,91
40860,126619,12771,60937,8473,113848,192,101,91
40865,126629,12773,60942,8475,113856,192,101,91
40870,126650,12775,60956,8475,113875,192,101,91
40875,126660,12777,60962,8476,113883,192,101,91
40880,126681,12779,60974,8478,113902,192,101,91
40885,126691,12781,60979,8479,113910,192,101,91
40890,126712,12783,60991,8481,113928,192,101,91
40895,126722,12785,60996,8483,113937,192,101,91
40900,126743,12787,61003,8484,113956,192,101,91
40905,126753,12788,61010,8485,113965,192,101,91
40910,126774,12790,61018,8486,113983,192,101,91
40915,126784,12792,61021,8487,113992,192,101,91
40920,126805,12794,61032,8488,114010,192,101,91
40925,126815,12796,61040,8490,114019,192,101,91
40930,126836,12799,61047,8492,114037,192,101,91
40935,126846,12799,61054,8492,114047,192,101,91
40940,126867,12801,61064,8492,114066,192,101,91
40945,126877,12801,61070,8492,114076,192,101,91
40950,126898,12803,61078,8493,114095,192,101,91
40955,126908,12803,61083,8493,114105,192,101,91
40960,126929,12805,61096,8493,114124,192,101,91
40965,126939,12805,61101,8493,114134,192,101,91
40970,126960,12809,61110,8496,114151,192,101,91
40975,126970,12809,61114,8496,114160,192,101,91
40980,126991,12814,61123,8499,114177,192,101,91
40985,127001,12815,61127,8499,114186,192,101,91
40990,127022,12816,61137,8500,114206,192,101,91
40995,127032,12817,61143,8501,114215,192,101,91
41000,127053,12817,61155,8501,114236,192,101,91
41005,127063,12818,61161,8502,114245,192,101,91
41010,127084,12818,61176,8502,114266,192,101,91
41015,127094,12819,61180,8503,114275,192,101,91
41020,127115,12819,61196,8503,114296,192,101,91
41025,127125,12820,61199,8503,114305,192,101,91
41030,127146,12820,61210,8503,114326,192,101,91
41035,127156,12821,61212,8504,114335,192,101,91
41040,127177,12821,61224,8504,114356,192,101,91
41045,127187,12822,61227,8504,114365,192,101,91
41050,127208,12822,61240,8504,114386,192,101,91
41055,127218,12823,61244,8505,114395,192,101,91
41060,127239,12823,61254,8505,114416,192,101,91
41065,127249,12824,61259,8506,114425,192,101,91
41070,127270,12824,61266,8506,114446,192,101,91
41075,127280,12825,61272,8506,114455,192,101,91
41080,127301,12825,61280,8506,114476,192,101,91
41085,127311,12826,61286,8506,114484,192,101,91
41090,127332,12831,61301,8510,114501,192,101,91
41095,127342,12832,61306,8510,114510,192,101,91
41100,127363,12836,61315,8512,114526,192,101,91
41105,127373,12838,61319,8514,114535,192,101,91
41110,127394,12842,61330,8518,114552,192,101,91
41115,127404,12842,61332,8518,114562,192,101,91
41120,127425,12845,61342,8520,114580,192,101,91
41125,127435,12846,61350,8521,114589,192,101,91
41130,127456,12849,61361,8522,114607,192,101,91
41135,127466,12849,61365,8522,114617,192,101,91
41140,127487,12852,61375,8523,114635,192,101,91
41145,127497,12852,61380,8523,114645,192,101,91
41150,127518,12854,61386,8524,114664,192,101,91
41155,127528,12854,61390,8524,114674,192,101,91
41160,127549,12855,61398,8524,114694,192,101,91
41165,127559,12857,61399,8525,114702,192,101,91
41170,127580,12858,61409,8525,114721,192,101,91
41175,127590,12861,61417,8527,114729,192,101,91
41180,127611,12863,61427,8528,114748,192,101,91
41185,127621,12864,61436,8529,114757,192,101,91
41190,127642,12865,61446,8530,114777,192,101,91
41195,127652,12866,61451,8530,114786,192,101,91
41200,127673,12868,61461,8531,114805,192,101,91
41205,127683,12870,61467,8533,114813,192,101,91
41210,127704,12873,61474,8534,114831,192,101,91
41215,127714,12875,61478,8535,114839,192,101,91
41220,127735,12879,61487,8539,114856,192,101,91
41225,127745,12879,61492,8539,114865,192,101,91
41230,127766,12881,61503,8541,114885,192,101,91
41235,127776,12881,61508,8541,114895,192,101,91
41240,127797,12882,61518,8542,114915,192,101,91
41245,127807,12882,61522,8542,114925,192,101,91
41250,127828,12885,61530,8544,114943,192,101,91
41255,127838,12885,61538,8544,114953,192,101,91
41260,127859,12888,61548,8546,114971,192,101,91
41265,127869,12888,61551,8546,114981,192,101,91
41270,127890,12891,61558,8548,114999,192,101,91
41275,127900,12891,61559,8548,115009,192,101,91
41280,127921,12893,61571,8548,115028,192,101,91
41285,127931,12895,61575,8549,115036,192,101,91
41290,127952,12898,61584,8551,115053,192,101,91
41295,127962,12900,61589,8553,115062,192,101,91
41300,127983,12903,61598,8556,115080,192,101,91
41305,127993,12904,61602,8557,115089,192,101,91
41310,128014,12907,61612,8560,115107,192,101,91
41315,128024,12909,61619,8562,115115,192,101,91
41320,128045,12914,61630,8565,115131,192,101,91
41325,128055,12916,61635,8566,115139,192,101,91
41330,128076,12919,61644,8568,115156,192,101,91
41335,128086,12923,61649,8572,115162,192,101,91
41340,128107,12927,61657,8575,115180,192,101,91
41345,128117,12927,61663,8575,115190,192,101,91
41350,128138,12928,61674,8575,115210,192,101,91
41355,128148,12928,61678,8575,115219,192,101,91
41360,128169,12930,61688,8576,115239,192,101,91
41365,128179,12930,61695,8576,115248,192,101,91
41370,128200,12932,61700,8577,115268,192,101,91
41375,128210,12932,61704,8577,115278,192,101,91
41380,128231,12933,61712,8577,115298,192,101,91
41385,128241,12933,61717,8577,115307,192,101,91
41390,128262,12935,61729,8579,115327,192,101,91
41395,128272,12935,61735,8579,115336,192,101,91
41400,128293,12937,61747,8581,115356,192,101,91
41405,128303,12938,61751,8582,115364,192,101,91
41410,128324,12940,61762,8583,115384,192,101,91
41415,128334,12942,61768,8584,115392,192,101,91
41420,128355,12944,61775,8585,115410,192,101,91
41425,128365,12946,61780,8586,115418,192,101,91
41430,128386,12948,61788,8587,115437,192,101,91
41435,128396,12950,61793,8588,115445,192,101,91
41440,128417,12952,61806,8590,115465,192,101,91
41445,128427,12953,61809,8591,115474,192,101,91
41450,128448,12957,61818,8594,115490,192,101,91
41455,128458,12961,61824,8598,115497,192,101,91
41460,128479,12966,61837,8603,115512,192,101,91
41465,128489,12967,61840,8604,115522,192,101,91
41470,128510,12970,61849,8606,115539,192,101,91
41475,128520,12971,61852,8607,115549,192,101,91
41480,128541,12976,61866,8612,115564,192,101,91
41485,128551,12977,61870,8613,115574,192,101,91
41490,128572,12979,61879,8614,115593,192,101,91
41495,128582,12979,61885,8614,115603,192,101,91
41500,128603,12981,61894,8615,115622,192,101,91
41505,128613,12981,61902,8615,115632,192,101,91
41510,128634,12982,61911,8616,115652,192,101,91
41515,128644,12982,61914,8616,115662,192,101,91
41520,128665,12984,61922,8617,115681,192,101,91
41525,128675,12984,61926,8617,115691,192,101,91
41530,128696,12984,61937,8617,115712,192,101,91
41535,128706,12984,61941,8617,115722,192,101,91
41540,128727,12984,61950,8617,115743,192,101,91
41545,128737,12984,61954,8617,115753,192,101,91
41550,128758,12984,61964,8617,115774,192,101,91
41555,128768,12984,61969,8617,115784,192,101,91
41560,128789,12984,61980,8617,115805,192,101,91
41565,128799,12984,61985,8617,115815,192,101,91
41570,128820,12985,61996,8618,115835,192,101,91
41575,128830,12986,62000,8618,115844,192,101,91
41580,128851,12987,62009,8619,115864,192,101,91
41585,128861,12989,62013,8621,115872,192,101,91
41590,128882,12993,62025,8623,115886,192,101,91
41595,128892,12997,62032,8627,115894,192,101,91
41600,128913,13001,62045,8631,115911,192,101,91
41605,128923,13003,62046,8632,115920,192,101,91
41610,128944,13007,62059,8635,115936,192,101,91
41615,128954,13010,62065,8637,115943,192,101,91
41620,128975,13013,62075,8640,115962,192,101,91
41625,128985,13015,62079,8642,115970,192,101,91
41630,129006,13017,62086,8642,115988,192,101,91
41635,129016,13019,62090,8643,115996,192,101,91
41640,129037,13023,62105,8647,116013,192,101,91
41645,129047,13025,62108,8648,116022,192,101,91
41650,129068,13027,62118,8649,116041,192,101,91
41655,129078,13028,62125,8650,116049,192,101,91
41660,129099,13031,62137,8652,116068,192,101,91
41665,129109,13032,62142,8652,116077,192,101,91
41670,129130,13034,62153,8653,116096,192,101,91
41675,129140,13035,62158,8653,116104,192,101,91
41680,129161,13038,62161,8654,116123,192,101,91
41685,129171,13039,62165,8654,116132,192,101,91
41690,129192,13041,62179,8654,116151,192,101,91
41695,129202,13042,62182,8655,116160,192,101,91
41700,129223,13045,62191,8655,116177,192,101,91
41705,129233,13046,62194,8656,116187,192,101,91
41710,129254,13048,62203,8656,116206,192,101,91
41715,129264,13048,62207,8656,116216,192,101,91
41720,129285,13050,62221,8657,116235,192,101,91
41725,129295,13051,62227,8658,116244,192,101,91
41730,129316,13053,62236,8658,116263,192,101,91
41735,129326,13053,62238,8658,116273,192,101,91
41740,129347,13055,62244,8658,116292,192,101,91
41745,129357,13055,62248,8658,116302,192,101,91
41750,129378,13058,62256,8659,116320,192,101,91
41755,129388,13058,62259,8659,116330,192,101,91
41760,129409,13062,62272,8662,116346,192,101,91
41765,129419,13064,62277,8663,116355,192,101,91
41770,129440,13066,62290,8664,116374,192,101,91
41775,129450,13067,62296,8665,116383,192,101,91
41780,129471,13068,62307,8665,116401,192,101,91
41785,129481,13072,62311,8669,116409,192,101,91
41790,129502,13073,62319,8669,116429,192,101,91
41795,129512,13075,62321,8670,116437,192,101,91
41800,129533,13077,62328,8671,116456,192,101,91
41805,129543,13078,62334,8671,116465,192,101,91
41810,129564,13080,62345,8673,116484,192,101,91
41815,129574,13081,62349,8673,116493,192,101,91
41820,129595,13083,62358,8675,116512,192,101,91
41825,129605,13083,62365,8675,116522,192,101,91
41830,129626,13084,62372,8675,116542,192,101,91
41835,129636,13084,62377,8675,116552,192,101,91
41840,129657,13085,62384,8675,116572,192,101,91
41845,129667,13085,62392,8675,116582,192,101,91
41850,129688,13086,62402,8675,116602,192,101,91
41855,129698,13086,62410,8675,116612,192,101,91
41860,129719,13087,62423,8676,116632,192,101,91
41865,129729,13087,62425,8676,116641,192,101,91
41870,129750,13090,62434,8679,116660,192,101,91
41875,129760,13090,62439,8679,116669,192,101,91
41880,129781,13093,62451,8681,116687,192,101,91
41885,129791,13095,62457,8683,116696,192,101,91
41890,129812,13097,62466,8683,116715,192,101,91
41895,129822,13097,62469,8683,116725,192,101,91
41900,129843,13099,62479,8685,116744,192,101,91
41905,129853,13100,62485,8686,116753,192,101,91
41910,129874,13102,62496,8686,116772,192,101,91
41915,129884,13103,62503,8687,116781,192,101,91
41920,129905,13105,62511,8687,116800,192,101,91
41925,129915,13105,62515,8687,116810,192,101,91
41930,129936,13107,62529,8688,116829,192,101,91
41935,129946,13110,62536,8691,116836,192,101,91
41940,129967,13112,62546,8692,116854,192,101,91
41945,129977,13113,62552,8693,116864,192,101,91
41950,129998,13114,62561,8694,116884,192,101,91
41955,130008,13114,62570,8694,116894,192,101,91
41960,130029,13115,62581,8695,116914,192,101,91
41965,130039,13115,62591,8695,116924,192,101,91
41970,130060,13116,62600,8696,116944,192,101,91
41975,130070,13116,62604,8696,116954,192,101,91
41980,130091,13117,62616,8697,116974,192,101,91
41985,130101,13117,62622,8697,116984,192,101,91
41990,130122,13118,62632,8698,117004,192,101,91
41995,130132,13118,62634,8698,117014,192,101,91
42000,130153,13119,62645,8698,117034,192,101,91
42005,130163,13121,62649,8699,117041,192,101,91
42010,130184,13124,62659,8701,117060,192,101,91
42015,130194,13125,62663,8701,117069,192,101,91
42020,130215,13127,62677,8702,117088,192,101,91
42025,130225,13128,62684,8703,117097,192,101,91
42030,130246,13130,62690,8704,117116,192,101,91
42035,130256,13131,62694,8705,117124,192,101,91
42040,130277,13134,62708,8706,117143,192,101,91
42045,130287,13135,62716,8707,117151,192,101,91
42050,130308,13139,62725,8709,117169,192,101,91
42055,130318,13140,62728,8709,117177,192,101,91
42060,130339,13147,62739,8714,117192,192,101,91
42065,130349,13148,62745,8715,117201,192,101,91
42070,130370,13150,62756,8716,117220,192,101,91
42075,130380,13151,62758,8716,117229,192,101,91
42080,130401,13152,62768,8717,117249,192,101,91
42085,130411,13153,62770,8717,117258,192,101,91
42090,130432,13154,62779,8718,117278,192,101,91
42095,130442,13155,62784,8718,117287,192,101,91
42100,130463,13157,62795,8720,117306,192,101,91
42105,130473,13158,62801,8721,117315,192,101,91
42110,130494,13159,62809,8721,117335,192,101,91
42115,130504,13160,62816,8722,117344,192,101,91
42120,130525,13163,62829,8725,117361,192,101,91
42125,130535,13166,62832,8727,117369,192,101,91
42130,130556,13167,62841,8727,117389,192,101,91
42135,130566,13168,62843,8728,117398,192,101,91
42140,130587,13169,62852,8728,117418,192,101,91
42145,130597,13170,62859,8729,117427,192,101,91
42150,130618,13172,62869,8731,117446,192,101,91
42155,130628,13173,62874,8732,117455,192,101,91
42160,130649,13174,62884,8733,117474,192,101,91
42165,130659,13176,62888,8734,117483,192,101,91
42170,130680,13180,62898,8735,117499,192,101,91
42175,130690,13182,62902,8736,117508,192,101,91
42180,130711,13185,62915,8738,117524,192,101,91
42185,130721,13188,62924,8741,117532,192,101,91
42190,130742,13192,62933,8743,117549,192,101,91
42195,130752,13194,62938,8745,117558,192,101,91
42200,130773,13196,62951,8745,117577,192,101,91
42205,130783,13196,62954,8745,117587,192,101,91
42210,130804,13199,62965,8747,117605,192,101,91
42215,130814,13200,62970,8748,117614,192,101,91
42220,130835,13202,62979,8749,117633,192,101,91
42225,130845,13203,62986,8750,117642,192,101,91
42230,130866,13205,62996,8751,117661,192,101,91
42235,130876,13205,63002,8751,117671,192,101,91
42240,130897,13207,63012,8752,117690,192,101,91
42245,130907,13208,63019,8753,117699,192,101,91
42250,130928,13211,63030,8755,117716,192,101,91
42255,130938,13213,63036,8757,117725,192,101,91
42260,130959,13217,63049,8760,117741,192,101,91
42265,130969,13219,63056,8762,117750,192,101,91
42270,130990,13221,63067,8763,117768,192,101,91
42275,131000,13223,63071,8764,117777,192,101,91
42280,131021,13227,63078,8766,117793,192,101,91
42285,131031,13229,63084,8767,117802,192,101,91
42290,131052,13234,63094,8769,117818,192,101,91
42295,131062,13235,63096,8770,117827,192,101,91
42300,131083,13238,63103,8772,117845,192,101,91
42305,131093,13239,63108,8773,117854,192,101,91
42310,131114,13239,63122,8773,117875,192,101,91
42315,131124,13239,63128,8773,117885,192,101,91
42320,131145,13239,63140,8773,117906,192,101,91
42325,131155,13239,63145,8773,117916,192,101,91
42330,131176,13239,63158,8773,117937,192,101,91
42335,131186,13239,63163,8773,117947,192,101,91
42340,131207,13239,63173,8773,117968,192,101,91
42345,131217,13239,63178,8773,117978,192,101,91
42350,131238,13239,63194,8773,117999,192,101,91
42355,131248,13239,63200,8773,118009,192,101,91
42360,131269,13239,63207,8773,118030,192,101,91
42365,131279,13239,63212,8773,118040,192,101,91
42370,131300,13240,63219,8774,118060,192,101,91
42375,131310,13241,63226,8775,118068,192,101,91
42380,131331,13243,63234,8777,118088,192,101,91
42385,131341,13243,63239,8777,118098,192,101,91
42390,131362,13244,63245,8777,118118,192,101,91
42395,131372,13245,63252,8778,118126,192,101,91
42400,131393,13247,63259,8779,118146,192,101,91
42405,131403,13248,63263,8780,118155,192,101,91
42410,131424,13250,63276,8782,118174,192,101,91
42415,131434,13253,63284,8785,118180,192,101,91
42420,131455,13260,63293,8790,118195,192,101,91
42425,131465,13260,63295,8790,118205,192,101,91
42430,131486,13261,63305,8791,118225,192,101,91
42435,131496,13261,63308,8791,118235,192,101,91
42440,131517,13263,63315,8793,118254,192,101,91
42445,131527,13263,63320,8793,118264,192,101,91
42450,131548,13264,63331,8794,118284,192,101,91
42455,131558,13264,63334,8794,118294,192,101,91
42460,131579,13265,63349,8795,118314,192,101,91
42465,131589,13265,63352,8795,118324,192,101,91
42470,131610,13266,63359,8795,118344,192,101,91
42475,131620,13266,63363,8795,118354,192,101,91
42480,131641,13267,63370,8795,118374,192,101,91
42485,131651,13267,63377,8795,118384,192,101,91
42490,131672,13269,63391,8797,118403,192,101,91
42495,131682,13269,63394,8797,118413,192,101,91
42500,131703,13271,63404,8798,118432,192,101,91
42505,131713,13271,63407,8798,118442,192,101,91
42510,131734,13272,63417,8798,118462,192,101,91
42515,131744,13272,63421,8798,118472,192,101,91
42520,131765,13274,63434,8799,118491,192,101,91
42525,131775,13274,63439,8799,118500,192,101,91
42530,131796,13278,63452,8803,118518,192,101,91
42535,131806,13280,63457,8804,118525,192,101,91
42540,131827,13285,63467,8808,118542,192,101,91
42545,131837,13286,63470,8809,118551,192,101,91
42550,131858,13286,63480,8809,118572,192,101,91
42555,131868,13286,63487,8809,118582,192,101,91
42560,131889,13286,63499,8809,118603,192,101,91
42565,131899,13286,63502,8809,118613,192,101,91
42570,131920,13286,63509,8809,118634,192,101,91
42575,131930,13286,63514,8809,118644,192,101,91
42580,131951,13286,63527,8809,118665,192,101,91
42585,131961,13286,63531,8809,118675,192,101,91
42590,131982,13286,63537,8809,118696,192,101,91
42595,131992,13286,63543,8809,118706,192,101,91
42600,132013,13286,63554,8809,118727,192,101,91
42605,132023,13286,63561,8809,118737,192,101,91
42610,132044,13286,63571,8809,118758,192,101,91
42615,132054,13286,63576,8809,118768,192,101,91
42620,132075,13286,63591,8809,118789,192,101,91
42625,132085,13286,63599,8809,118799,192,101,91
42630,132106,13286,63608,8809,118820,192,101,91
42635,132116,13286,63612,8809,118830,192,101,91
42640,132137,13286,63623,8809,118851,192,101,91
42645,132147,13286,63630,8809,118861,192,101,91
42650,132168,13290,63641,8813,118878,192,101,91
42655,132178,13291,63645,8814,118887,192,101,91
42660,132199,13294,63652,8815,118905,192,101,91
42665,132209,13296,63657,8817,118913,192,101,91
42670,132230,13300,63670,8819,118930,192,101,91
42675,132240,13301,63676,8820,118939,192,101,91
42680,132261,13304,63684,8821,118957,192,101,91
42685,132271,13305,63688,8821,118966,192,101,91
42690,132292,13309,63701,8822,118983,192,101,91
42695,132302,13310,63706,8823,118992,192,101,91
42700,132323,13314,63713,8826,119009,192,101,91
42705,132333,13315,63717,8826,119018,192,101,91
42710,132354,13317,63729,8828,119037,192,101,91
42715,132364,13318,63733,8829,119046,192,101,91
42720,132385,13320,63742,8830,119065,192,101,91
42725,132395,13321,63748,8831,119074,192,101,91
42730,132416,13323,63758,8833,119093,192,101,91
42735,132426,13324,63764,8834,119102,192,101,91
42740,132447,13326,63774,8835,119121,192,101,91
42745,132457,13327,63776,8835,119130,192,101,91
42750,132478,13330,63786,8837,119148,192,101,91
42755,132488,13331,63790,8838,119157,192,101,91
42760,132509,13334,63803,8841,119175,192,101,91
42765,132519,13335,63806,8841,119183,192,101,91
42770,132540,13341,63821,8847,119198,192,101,91
42775,132550,13343,63824,8849,119207,192,101,91
42780,132571,13348,63833,8853,119222,192,101,91
42785,132581,13350,63838,8855,119231,192,101,91
42790,132602,13351,63848,8856,119251,192,101,91
42795,132612,13352,63854,8857,119259,192,101,91
42800,132633,13354,63863,8859,119279,192,101,91
42805,132643,13355,63870,8860,119287,192,101,91
42810,132664,13357,63879,8862,119307,192,101,91
42815,132674,13357,63883,8862,119317,192,101,91
42820,132695,13358,63892,8862,119337,192,101,91
42825,132705,13359,63899,8863,119345,192,101,91
42830,132726,13361,63909,8865,119365,192,101,91
42835,132736,13361,63913,8865,119375,192,101,91
42840,132757,13362,63928,8866,119395,192,101,91
42845,132767,13362,63932,8866,119405,192,101,91
42850,132788,13363,63940,8867,119425,192,101,91
42855,132798,13363,63945,8867,119434,192,101,91
42860,132819,13365,63957,8868,119454,192,101,91
42865,132829,13365,63963,8868,119463,192,101,91
42870,132850,13368,63974,8871,119482,192,101,91
42875,132860,13368,63980,8871,119492,192,101,91
42880,132881,13368,63994,8871,119513,192,101,91
42885,132891,13368,63997,8871,119523,192,101,91
42890,132912,13370,64007,8873,119542,192,101,91
42895,132922,13371,64012,8873,119551,192,101,91
42900,132943,13376,64022,8876,119567,192,101,91
42905,132953,13377,64029,8877,119576,192,101,91
42910,132974,13380,64036,8878,119594,192,101,91
42915,132984,13381,64040,8878,119603,192,101,91
42920,133005,13383,64046,8880,119622,192,101,91
42925,133015,13384,64049,8880,119631,192,101,91
42930,133036,13387,64058,8881,119649,192,101,91
42935,133046,13388,64064,8882,119658,192,101,91
42940,133067,13390,64075,8883,119677,192,101,91
42945,133077,13391,64079,8883,119686,192,101,91
42950,133098,13393,64094,8884,119705,192,101,91
42955,133108,13395,64099,8885,119713,192,101,91
42960,133129,13397,64113,8886,119732,192,101,91
42965,133139,13398,64118,8887,119741,192,101,91
42970,133160,13399,64128,8887,119761,192,101,91
42975,133170,13400,64134,8888,119770,192,101,91
42980,133191,13401,64146,8889,119790,192,101,91
42985,133201,13402,64151,8889,119799,192,101,91
42990,133222,13403,64164,8889,119819,192,101,91
42995,133232,13404,64168,8889,119828,192,101,91
43000,133253,13405,64181,8889,119848,192,101,91
43005,133263,13406,64185,8889,119856,192,101,91
43010,133284,13409,64197,8891,119875,192,101,91
43015,133294,13411,64199,8892,119883,192,101,91
43020,133315,13414,64208,8895,119901,192,101,91
43025,133325,13415,64213,8896,119910,192,101,91
43030,133346,13418,64224,8897,119928,192,101,91
43035,133356,13419,64231,8898,119936,192,101,91
43040,133377,13423,64238,8901,119954,192,101,91
43045,133387,13423,64242,8901,119964,192,101,91
43050,133408,13426,64251,8902,119982,192,101,91
43055,133418,13427,64255,8903,119991,192,101,91
43060,133439,13430,64262,8903,120009,192,101,91
43065,133449,13431,64267,8904,120018,192,101,91
43070,133470,13434,64278,8905,120036,192,101,91
43075,133480,13434,64281,8905,120046,192,101,91
43080,133501,13437,64292,8906,120064,192,101,91
43085,133511,13437,64297,8906,120074,192,101,91
43090,133532,13440,64308,8909,120092,192,101,91
43095,133542,13440,64313,8909,120102,192,101,91
43100,133563,13443,64323,8909,120120,192,101,91
43105,133573,13443,64328,8909,120130,192,101,91
43110,133594,13446,64337,8911,120148,192,101,91
43115,133604,13446,64342,8911,120158,192,101,91
43120,133625,13449,64353,8911,120176,192,101,91
43125,133635,13449,64357,8911,120186,192,101,91
43130,133656,13454,64370,8915,120202,192,101,91
43135,133666,13456,64376,8917,120210,192,101,91
43140,133687,13460,64384,8920,120227,192,101,91
43145,133697,13462,64386,8922,120235,192,101,91
43150,133718,13464,64400,8924,120254,192,101,91
43155,133728,13464,64405,8924,120264,192,101,91
43160,133749,13465,64416,8925,120284,192,101,91
43165,133759,13465,64421,8925,120294,192,101,91
43170,133780,13466,64431,8925,120314,192,101,91
43175,133790,13466,64435,8925,120324,192,101,91
43180,133811,13468,64447,8927,120343,192,101,91
43185,133821,13469,64451,8928,120352,192,101,91
43190,133842,13470,64460,8928,120372,192,101,91
43195,133852,13470,64463,8928,120381,192,101,91
43200,133873,13472,64472,8929,120401,192,101,91
43205,133883,13472,64481,8929,120410,192,101,91
43210,133904,13474,64490,8930,120429,192,101,91
43215,133914,13475,64493,8931,120439,192,101,91
43220,133935,13475,64505,8931,120460,192,101,91
43225,133945,13475,64510,8931,120470,192,101,91
43230,133966,13475,64523,8931,120491,192,101,91
43235,133976,13475,64525,8931,120501,192,101,91
43240,133997,13475,64531,8931,120522,192,101,91
43245,134007,13475,64538,8931,120532,192,101,91
43250,134028,13476,64546,8931,120552,192,101,91
43255,134038,13477,64551,8932,120561,192,101,91
43260,134059,13478,64564,8932,120581,192,101,91
43265,134069,13479,64567,8932,120590,192,101,91
43270,134090,13480,64576,8932,120610,192,101,91
43275,134100,13481,64580,8932,120619,192,101,91
43280,134121,13482,64588,8932,120639,192,101,91
43285,134131,13483,64592,8932,120648,192,101,91
43290,134152,13485,64604,8934,120667,192,101,91
43295,134162,13486,64609,8934,120676,192,101,91
43300,134183,13487,64616,8934,120696,192,101,91
43305,134193,13488,64622,8934,120705,192,101,91
43310,134214,13490,64634,8936,120724,192,101,91
43315,134224,13491,64639,8937,120733,192,101,91
43320,134245,13494,64647,8938,120751,192,101,91
43325,134255,13496,64652,8939,120759,192,101,91
43330,134276,13499,64661,8940,120777,192,101,91
43335,134286,13501,64667,8941,120784,192,101,91
43340,134307,13505,64675,8943,120801,192,101,91
43345,134317,13507,64679,8945,120810,192,101,91
43350,134338,13510,64688,8948,120828,192,101,91
43355,134348,13511,64694,8949,120837,192,101,91
43360,134369,13514,64704,8950,120855,192,101,91
43365,134379,13515,64707,8951,120864,192,101,91
43370,134400,13518,64714,8951,120882,192,101,91
43375,134410,13519,64719,8951,120891,192,101,91
43380,134431,13523,64729,8954,120908,192,101,91
43385,134441,13524,64736,8954,120917,192,101,91
43390,134462,13527,64743,8955,120935,192,101,91
43395,134472,13527,64747,8955,120945,192,101,91
43400,134493,13529,64756,8956,120964,192,101,91
43405,134503,13529,64762,8956,120974,192,101,91
43410,134524,13531,64767,8957,120993,192,101,91
43415,134534,13531,64771,8957,121003,192,101,91
43420,134555,13533,64781,8958,121022,192,101,91
43425,134565,13533,64787,8958,121032,192,101,91
43430,134586,13536,64797,8959,121050,192,101,91
43435,134596,13536,64802,8959,121060,192,101,91
43440,134617,13538,64810,8960,121079,192,101,91
43445,134627,13538,64814,8960,121089,192,101,91
43450,134648,13542,64827,8962,121106,192,101,91
43455,134658,13543,64832,8963,121115,192,101,91
43460,134679,13546,64838,8964,121133,192,101,91
43465,134689,13546,64841,8964,121142,192,101,91
43470,134710,13550,64857,8968,121160,192,101,91
43475,134720,13551,64861,8969,121168,192,101,91
43480,134741,13555,64873,8971,121186,192,101,91
43485,134751,13555,64876,8971,121196,192,101,91
43490,134772,13557,64888,8972,121215,192,101,91
43495,134782,13558,64893,8973,121224,192,101,91
43500,134803,13560,64904,8975,121243,192,101,91
43505,134813,13562,64909,8976,121251,192,101,91
43510,134834,13564,64919,8977,121270,192,101,91
43515,134844,13566,64922,8978,121278,192,101,91
43520,134865,13569,64935,8981,121296,192,101,91
43525,134875,13570,64938,8981,121305,192,101,91
43530,134896,13572,64951,8983,121324,192,101,91
43535,134906,13573,64955,8983,121333,192,101,91
43540,134927,13574,64964,8984,121353,192,101,91
43545,134937,13575,64970,8985,121362,192,101,91
43550,134958,13577,64979,8986,121381,192,101,91
43555,134968,13578,64985,8986,121390,192,101,91
43560,134989,13580,64996,8987,121409,192,101,91
43565,134999,13581,65003,8988,121417,192,101,91
43570,135020,13583,65009,8990,121437,192,101,91
43575,135030,13584,65017,8990,121445,192,101,91
43580,135051,13586,65027,8991,121465,192,101,91
43585,135061,13587,65031,8992,121473,192,101,91
43590,135082,13591,65041,8996,121491,192,101,91
43595,135092,13592,65047,8997,121500,192,101,91
43600,135113,13595,65058,8999,121518,192,101,91
43605,135123,13596,65064,9000,121526,192,101,91
43610,135144,13600,65075,9003,121544,192,101,91
43615,135154,13601,65078,9003,121553,192,101,91
43620,135175,13604,65086,9005,121571,192,101,91
43625,135185,13607,65093,9007,121578,192,101,91
43630,135206,13609,65103,9008,121596,192,101,91
43635,135216,13611,65106,9009,121605,192,101,91
43640,135237,13613,65111,9010,121624,192,101,91
43645,135247,13615,65118,9012,121632,192,101,91
43650,135268,13617,65130,9013,121651,192,101,91
43655,135278,13619,65132,9014,121659,192,101,91
43660,135299,13621,65143,9016,121678,192,101,91
43665,135309,13622,65148,9017,121687,192,101,91
43670,135330,13625,65155,9018,121705,192,101,91
43675,135340,13627,65162,9019,121713,192,101,91
43680,135361,13631,65173,9023,121730,192,101,91
43685,135371,13632,65175,9023,121739,192,101,91
43690,135392,13634,65186,9023,121758,192,101,91
43695,135402,13636,65190,9024,121766,192,101,91
43700,135423,13640,65202,9026,121783,192,101,91
43705,135433,13641,65208,9027,121792,192,101,91
43710,135454,13644,65215,9028,121810,192,101,91
43715,135464,13645,65218,9028,121819,192,101,91
43720,135485,13648,65229,9029,121837,192,101,91
43725,135495,13649,65234,9029,121846,192,101,91
43730,135516,13654,65243,9031,121862,192,101,91
43735,135526,13655,65247,9032,121871,192,101,91
43740,135547,13660,65261,9036,121887,192,101,91
43745,135557,13660,65264,9036,121897,192,101,91
43750,135578,13661,65271,9037,121917,192,101,91
43755,135588,13661,65275,9037,121927,192,101,91
43760,135609,13662,65286,9038,121947,192,101,91
43765,135619,13662,65288,9038,121957,192,101,91
43770,135640,13663,65296,9038,121977,192,101,91
43775,135650,13663,65302,9038,121987,192,101,91
43780,135671,13664,65310,9039,122007,192,101,91
43785,135681,13664,65316,9039,122017,192,101,91
43790,135702,13665,65325,9039,122037,192,101,91
43795,135712,13665,65333,9039,122047,192,101,91
43800,135733,13666,65340,9039,122067,192,101,91
43805,135743,13666,65347,9039,122077,192,101,91
43810,135764,13667,65358,9040,122097,192,101,91
43815,135774,13667,65362,9040,122107,192,101,91
43820,135795,13668,65376,9041,122127,192,101,91
43825,135805,13668,65380,9041,122137,192,101,91
43830,135826,13669,65390,9041,122157,192,101,91
43835,135836,13669,65398,9041,122167,192,101,91
43840,135857,13670,65412,9041,122187,192,101,91
43845,135867,13670,65417,9041,122197,192,101,91
43850,135888,13674,65426,9043,122214,192,101,91
43855,135898,13677,65431,9045,122220,192,101,91
43860,135919,13684,65443,9050,122235,192,101,91
43865,135929,13685,65447,9051,122243,192,101,91
43870,135950,13688,65456,9054,122261,192,101,91
43875,135960,13690,65460,9055,122270,192,101,91
43880,135981,13692,65470,9056,122288,192,101,91
43885,135991,13694,65476,9058,122297,192,101,91
43890,136012,13696,65490,9060,122316,192,101,91
43895,136022,13697,65494,9061,122325,192,101,91
43900,136043,13698,65505,9061,122345,192,101,91
43905,136053,13699,65513,9061,122354,192,101,91
43910,136074,13700,65523,9062,122374,192,101,91
43915,136084,13701,65526,9062,122383,192,101,91
43920,136105,13702,65539,9063,122403,192,101,91
43925,136115,13703,65544,9064,122412,192,101,91
43930,136136,13704,65555,9064,122432,192,101,91
43935,136146,13705,65560,9065,122441,192,101,91
43940,136167,13706,65569,9066,122460,192,101,91
43945,136177,13708,65573,9068,122469,192,101,91
43950,136198,13709,65581,9069,122489,192,101,91
43955,136208,13710,65585,9070,122498,192,101,91
43960,136229,13711,65594,9070,122517,192,101,91
43965,136239,13713,65599,9072,122526,192,101,91
43970,136260,13717,65610,9074,122542,192,101,91
43975,136270,13720,65613,9077,122550,192,101,91
43980,136291,13723,65625,9080,122568,192,101,91
43985,136301,13724,65626,9081,122577,192,101,91
43990,136322,13726,65638,9083,122596,192,101,91
43995,136332,13727,65645,9084,122605,192,101,91
44000,136353,13728,65654,9084,122625,192,101,91
44005,136363,13729,65658,9084,122634,192,101,91
44010,136384,13730,65667,9084,122654,192,101,91
44015,136394,13731,65673,9085,122663,192,101,91
44020,136415,13732,65684,9086,122683,192,101,91
44025,136425,13733,65686,9087,122692,192,101,91
44030,136446,13734,65696,9088,122712,192,101,91
44035,136456,13735,65700,9089,122721,192,101,91
44040,136477,13736,65712,9090,122741,192,101,91
44045,136487,13737,65715,9090,122750,192,101,91
44050,136508,13738,65728,9091,122770,192,101,91
44055,136518,13739,65733,9092,122779,192,101,91
44060,136539,13740,65742,9093,122799,192,101,91
44065,136549,13741,65751,9094,122808,192,101,91
44070,136570,13742,65764,9095,122828,192,101,91
44075,136580,13743,65769,9096,122837,192,101,91
44080,136601,13744,65781,9096,122857,192,101,91
44085,136611,13745,65786,9097,122865,192,101,91
44090,136632,13750,65798,9101,122881,192,101,91
44095,136642,13753,65805,9103,122888,192,101,91
44100,136663,13757,65809,9105,122906,192,101,91
44105,136673,13757,65811,9105,122916,192,101,91
44110,136694,13759,65817,9105,122935,192,101,91
44115,136704,13759,65823,9105,122945,192,101,91
44120,136725,13760,65832,9106,122965,192,101,91
44125,136735,13760,65839,9106,122975,192,101,91
44130,136756,13761,65850,9107,122995,192,101,91
44135,136766,13761,65855,9107,123005,192,101,91
44140,136787,13762,65869,9108,123025,192,101,91
44145,136797,13762,65874,9108,123035,192,101,91
44150,136818,13763,65884,9109,123055,192,101,91
44155,136828,13763,65891,9109,123065,192,101,91
44160,136849,13764,65899,9109,123085,192,101,91
44165,136859,13764,65905,9109,123095,192,101,91
44170,136880,13765,65917,9110,123115,192,101,91
44175,136890,13765,65921,9110,123125,192,101,91
44180,136911,13766,65937,9111,123145,192,101,91
44185,136921,13766,65942,9111,123155,192,101,91
44190,136942,13767,65951,9111,123175,192,101,91
44195,136952,13767,65955,9111,123185,192,101,91
44200,136973,13768,65969,9112,123205,192,101,91
44205,136983,13768,65971,9112,123214,192,101,91
44210,137004,13771,65975,9114,123233,192,101,91
44215,137014,13772,65977,9115,123242,192,101,91
44220,137035,13777,65986,9119,123258,192,101,91
44225,137045,13778,65988,9119,123267,192,101,91
44230,137066,13780,65996,9119,123286,192,101,91
44235,137076,13782,66002,9121,123294,192,101,91
44240,137097,13785,66012,9123,123312,192,101,91
44245,137107,13787,66018,9124,123320,192,101,91
44250,137128,13789,66025,9126,123339,192,101,91
44255,137138,13790,66030,9126,123348,192,101,91
44260,137159,13793,66038,9128,123366,192,101,91
44265,137169,13794,66044,9129,123375,192,101,91
44270,137190,13797,66057,9131,123393,192,101,91
44275,137200,13798,66062,9132,123402,192,101,91
44280,137221,13800,66072,9134,123421,192,101,91
44285,137231,13801,66073,9134,123430,192,101,91
44290,137252,13803,66083,9135,123449,192,101,91
44295,137262,13804,66089,9135,123458,192,101,91
44300,137283,13807,66096,9136,123476,192,101,91
44305,137293,13808,66101,9137,123485,192,101,91
44310,137314,13811,66112,9139,123503,192,101,91
44315,137324,13812,66116,9140,123512,192,101,91
44320,137345,13814,66123,9140,123531,192,101,91
44325,137355,13815,66128,9140,123539,192,101,91
44330,137376,13819,66140,9143,123556,192,101,91
44335,137386,13821,66146,9145,123564,192,101,91
44340,137407,13827,66156,9149,123578,192,101,91
44345,137417,13829,66161,9151,123588,192,101,91
44350,137438,13830,66172,9152,123608,192,101,91
44355,137448,13830,66176,9152,123618,192,101,91
44360,137469,13831,66188,9152,123638,192,101,91
44365,137479,13831,66195,9152,123648,192,101,91
44370,137500,13832,66210,9153,123668,192,101,91
44375,137510,13832,66215,9153,123678,192,101,91
44380,137531,13833,66220,9154,123698,192,101,91
44385,137541,13833,66225,9154,123708,192,101,91
44390,137562,13834,66233,9154,123728,192,101,91
44395,137572,13834,66238,9154,123738,192,101,91
44400,137593,13835,66249,9154,123758,192,101,91
44405,137603,13835,66252,9154,123768,192,101,91
44410,137624,13836,66264,9155,123788,192,101,91
44415,137634,13836,66268,9155,123798,192,101,91
44420,137655,13837,66276,9155,123818,192,101,91
44425,137665,13837,66280,9155,123828,192,101,91
44430,137686,13838,66290,9155,123848,192,101,91
44435,137696,13838,66295,9155,123858,192,101,91
44440,137717,13839,66305,9156,123878,192,101,91
44445,137727,13839,66310,9156,123888,192,101,91
44450,137748,13842,66319,9157,123906,192,101,91
44455,137758,13845,66324,9159,123913,192,101,91
44460,137779,13850,66333,9162,123929,192,101,91
44465,137789,13852,66340,9164,123937,192,101,91
44470,137810,13853,66349,9164,123957,192,101,91
44475,137820,13853,66352,9164,123967,192,101,91
44480,137841,13854,66363,9165,123987,192,101,91
44485,137851,13854,66365,9165,123997,192,101,91
44490,137872,13855,66376,9166,124017,192,101,91
44495,137882,13855,66379,9166,124027,192,101,91
44500,137903,13856,66388,9166,124047,192,101,91
44505,137913,13856,66394,9166,124057,192,101,91
44510,137934,13857,66407,9167,124077,192,101,91
44515,137944,13857,66412,9167,124087,192,101,91
44520,137965,13858,66423,9168,124107,192,101,91
44525,137975,13858,66430,9168,124117,192,101,91
44530,137996,13859,66439,9168,124137,192,101,91
44535,138006,13859,66444,9168,124147,192,101,91
44540,138027,13860,66455,9169,124167,192,101,91
44545,138037,13860,66460,9169,124177,192,101,91
44550,138058,13861,66473,9169,124197,192,101,91
44555,138068,13861,66480,9169,124207,192,101,91
44560,138089,13862,66487,9169,124227,192,101,91
44565,138099,13862,66494,9169,124237,192,101,91
44570,138120,13865,66503,9172,124254,192,101,91
44575,138130,13868,66508,9175,124262,192,101,91
44580,138151,13874,66516,9179,124277,192,101,91
44585,138161,13875,66522,9180,124286,192,101,91
44590,138182,13876,66532,9181,124306,192,101,91
44595,138192,13877,66537,9182,124315,192,101,91
44600,138213,13878,66547,9183,124335,192,101,91
44605,138223,13879,66550,9183,124344,192,101,91
44610,138244,13879,66556,9183,124365,192,101,91
44615,138254,13880,66563,9184,124374,192,101,91
44620,138275,13881,66576,9185,124394,192,101,91
44625,138285,13882,66581,9186,124403,192,101,91
44630,138306,13882,66593,9186,124424,192,101,91
44635,138316,13883,66600,9187,124433,192,101,91
44640,138337,13883,66609,9187,124454,192,101,91
44645,138347,13884,66612,9187,124463,192,101,91
44650,138368,13884,66627,9187,124484,192,101,91
44655,138378,13885,66634,9188,124493,192,101,91
44660,138399,13885,66642,9188,124514,192,101,91
44665,138409,13886,66645,9188,124523,192,101,91
44670,138430,13887,66656,9189,124543,192,101,91
44675,138440,13888,66661,9189,124552,192,101,91
44680,138461,13889,66671,9190,124572,192,101,91
44685,138471,13890,66675,9190,124581,192,101,91
44690,138492,13895,66685,9194,124596,192,101,91
44695,138502,13897,66689,9196,124605,192,101,91
44700,138523,13902,66696,9200,124621,192,101,91
44705,138533,13903,66704,9201,124630,192,101,91
44710,138554,13904,66713,9202,124650,192,101,91
44715,138564,13904,66717,9202,124660,192,101,91
44720,138585,13905,66727,9202,124680,192,101,91
44725,138595,13905,66733,9202,124690,192,101,91
44730,138616,13906,66741,9202,124710,192,101,91
44735,138626,13906,66744,9202,124720,192,101,91
44740,138647,13907,66755,9203,124740,192,101,91
44745,138657,13907,66759,9203,124750,192,101,91
44750,138678,13908,66770,9203,124770,192,101,91
44755,138688,13908,66773,9203,124780,192,101,91
44760,138709,13909,66780,9203,124800,192,101,91
44765,138719,13909,66787,9203,124810,192,101,91
44770,138740,13910,66797,9204,124830,192,101,91
44775,138750,13910,66804,9204,124840,192,101,91
44780,138771,13911,66811,9205,124860,192,101,91
44785,138781,13911,66814,9205,124870,192,101,91
44790,138802,13912,66824,9206,124890,192,101,91
44795,138812,13912,66827,9206,124900,192,101,91
44800,138833,13913,66837,9206,124920,192,101,91
44805,138843,13914,66843,9206,124928,192,101,91
44810,138864,13917,66851,9208,124947,192,101,91
44815,138874,13919,66855,9209,124954,192,101,91
44820,138895,13923,66868,9213,124972,192,101,91
44825,138905,13923,66873,9213,124982,192,101,91
44830,138926,13926,66889,9216,125000,192,101,91
44835,138936,13926,66893,9216,125010,192,101,91
44840,138957,13928,66901,9218,125029,192,101,91
44845,138967,13928,66907,9218,125038,192,101,91
44850,138988,13931,66919,9220,125057,192,101,91
44855,138998,13932,66926,9221,125066,192,101,91
44860,139019,13935,66938,9223,125084,192,101,91
44865,139029,13936,66944,9224,125092,192,101,91
44870,139050,13939,66955,9227,125111,192,101,91
44875,139060,13939,66961,9227,125121,192,101,91
44880,139081,13941,66973,9228,125140,192,101,91
44885,139091,13941,66978,9228,125150,192,101,91
44890,139112,13943,66984,9230,125169,192,101,91
44895,139122,13943,66991,9230,125179,192,101,91
44900,139143,13944,66998,9231,125199,192,101,91
44905,139153,13944,67001,9231,125209,192,101,91
44910,139174,13946,67009,9233,125228,192,101,91
44915,139184,13946,67014,9233,125238,192,101,91
44920,139205,13947,67025,9234,125258,192,101,91
44925,139215,13947,67032,9234,125268,192,101,91
44930,139236,13949,67041,9236,125287,192,101,91
44935,139246,13951,67046,9237,125295,192,101,91
44940,139267,13956,67059,9241,125310,192,101,91
44945,139277,13958,67063,9242,125318,192,101,91
44950,139298,13960,67073,9244,125338,192,101,91
44955,139308,13961,67078,9244,125347,192,101,91
44960,139329,13963,67089,9245,125366,192,101,91
44965,139339,13964,67095,9245,125375,192,101,91
44970,139360,13965,67105,9245,125395,192,101,91
44975,139370,13966,67112,9245,125404,192,101,91
44980,139391,13968,67120,9245,125423,192,101,91
44985,139401,13969,67128,9246,125432,192,101,91
44990,139422,13972,67141,9248,125450,192,101,91
44995,139432,13973,67144,9249,125459,192,101,91
45000,139453,13976,67157,9251,125477,192,101,91
45005,139463,13977,67163,9252,125486,192,101,91
45010,139484,13979,67174,9254,125505,192,101,91
45015,139494,13980,67179,9254,125514,192,101,91
45020,139515,13982,67187,9255,125533,192,101,91
45025,139525,13983,67194,9255,125542,192,101,91
45030,139546,13985,67205,9257,125561,192,101,91
45035,139556,13986,67210,9258,125570,192,101,91
45040,139577,13988,67217,9258,125589,192,101,91
45045,139587,13989,67219,9259,125598,192,101,91
45050,139608,13992,67229,9261,125615,192,101,91
45055,139618,13994,67234,9263,125623,192,101,91
45060,139639,13999,67244,9265,125639,192,101,91
45065,139649,14001,67250,9267,125648,192,101,91
45070,139670,14003,67262,9269,125667,192,101,91
45075,139680,14003,67264,9269,125677,192,101,91
45080,139701,14006,67278,9272,125695,192,101,91
45085,139711,14006,67283,9272,125705,192,101,91
45090,139732,14009,67294,9274,125723,192,101,91
45095,139742,14010,67300,9275,125732,192,101,91
45100,139763,14012,67308,9275,125751,192,101,91
45105,139773,14012,67312,9275,125761,192,101,91
45110,139794,14014,67321,9276,125780,192,101,91
45115,139804,14014,67326,9276,125790,192,101,91
45120,139825,14016,67338,9276,125809,192,101,91
45125,139835,14018,67342,9277,125817,192,101,91
45130,139856,14020,67353,9278,125835,192,101,91
45135,139866,14023,67357,9280,125843,192,101,91
45140,139887,14025,67364,9280,125861,192,101,91
45145,139897,14027,67369,9282,125870,192,101,91
45150,139918,14029,67377,9283,125889,192,101,91
45155,139928,14031,67383,9285,125897,192,101,91
45160,139949,14033,67392,9287,125916,192,101,91
45165,139959,14035,67399,9288,125924,192,101,91
45170,139980,14038,67410,9289,125942,192,101,91
45175,139990,14039,67413,9289,125950,192,101,91
45180,140011,14043,67422,9291,125967,192,101,91
45185,140021,14045,67429,9293,125975,192,101,91
45190,140042,14047,67436,9294,125995,192,101,91
45195,140052,14048,67442,9294,126003,192,101,91
45200,140073,14050,67456,9296,126023,192,101,91
45205,140083,14051,67461,9296,126031,192,101,91
45210,140104,14053,67471,9298,126051,192,101,91
45215,140114,14054,67472,9298,126060,192,101,91
45220,140135,14055,67485,9299,126080,192,101,91
45225,140145,14056,67490,9300,126089,192,101,91
45230,140166,14057,67496,9301,126109,192,101,91
45235,140176,14058,67498,9302,126118,192,101,91
45240,140197,14059,67508,9303,126138,192,101,91
45245,140207,14061,67515,9305,126145,192,101,91
45250,140228,14065,67524,9307,126163,192,101,91
45255,140238,14066,67530,9308,126171,192,101,91
45260,140259,14070,67535,9311,126189,192,101,91
45265,140269,14072,67541,9312,126197,192,101,91
45270,140290,14074,67546,9312,126215,192,101,91
45275,140300,14076,67552,9314,126223,192,101,91
45280,140321,14080,67560,9316,126240,192,101,91
45285,140331,14082,67562,9317,126249,192,101,91
45290,140352,14086,67573,9320,126265,192,101,91
45295,140362,14089,67577,9322,126273,192,101,91
45300,140383,14094,67587,9326,126289,192,101,91
45305,140393,14095,67595,9327,126298,192,101,91
45310,140414,14096,67603,9327,126318,192,101,91
45315,140424,14097,67611,9328,126327,192,101,91
45320,140445,14098,67624,9329,126347,192,101,91
45325,140455,14098,67626,9329,126357,192,101,91
45330,140476,14099,67638,9329,126377,192,101,91
45335,140486,14099,67642,9329,126387,192,101,91
45340,140507,14100,67649,9329,126407,192,101,91
45345,140517,14100,67652,9329,126417,192,101,91
45350,140538,14101,67658,9329,126437,192,101,91
45355,140548,14101,67662,9329,126447,192,101,91
45360,140569,14102,67671,9330,126467,192,101,91
45365,140579,14103,67676,9331,126475,192,101,91
45370,140600,14107,67686,9333,126492,192,101,91
45375,140610,14108,67688,9334,126502,192,101,91
45380,140631,14109,67696,9334,126522,192,101,91
45385,140641,14109,67699,9334,126532,192,101,91
45390,140662,14110,67713,9335,126552,192,101,91
45395,140672,14110,67717,9335,126562,192,101,91
45400,140693,14111,67732,9336,126582,192,101,91
45405,140703,14112,67736,9337,126591,192,101,91
45410,140724,14114,67747,9338,126610,192,101,91
45415,140734,14115,67751,9339,126619,192,101,91
45420,140755,14117,67761,9339,126637,192,101,91
45425,140765,14120,67767,9342,126645,192,101,91
45430,140786,14122,67772,9342,126664,192,101,91
45435,140796,14123,67778,9343,126673,192,101,91
45440,140817,14126,67787,9345,126691,192,101,91
45445,140827,14127,67791,9345,126700,192,101,91
45450,140848,14130,67800,9347,126718,192,101,91
45455,140858,14131,67806,9347,126727,192,101,91
45460,140879,14133,67819,9348,126746,192,101,91
45465,140889,14134,67827,9349,126755,192,101,91
45470,140910,14136,67833,9350,126774,192,101,91
45475,140920,14137,67836,9350,126783,192,101,91
45480,140941,14139,67845,9351,126802,192,101,91
45485,140951,14140,67849,9352,126810,192,101,91
45490,140972,14145,67860,9357,126827,192,101,91
45495,140982,14146,67866,9358,126836,192,101,91
45500,141003,14147,67876,9359,126856,192,101,91
45505,141013,14148,67882,9359,126865,192,101,91
45510,141034,14150,67890,9360,126884,192,101,91
45515,141044,14151,67894,9360,126893,192,101,91
45520,141065,14153,67903,9361,126912,192,101,91
45525,141075,14154,67907,9362,126921,192,101,91
45530,141096,14155,67915,9362,126941,192,101,91
45535,141106,14157,67922,9364,126949,192,101,91
45540,141127,14159,67934,9365,126967,192,101,91
45545,141137,14160,67937,9366,126977,192,101,91
45550,141158,14162,67945,9368,126995,192,101,91
45555,141168,14164,67949,9370,127004,192,101,91
45560,141189,14166,67959,9372,127023,192,101,91
45565,141199,14166,67962,9372,127033,192,101,91
45570,141220,14166,67968,9372,127054,192,101,91
45575,141230,14166,67973,9372,127064,192,101,91
45580,141251,14166,67987,9372,127085,192,101,91
45585,141261,14166,67992,9372,127095,192,101,91
45590,141282,14166,68004,9372,127116,192,101,91
45595,141292,14167,68008,9373,127125,192,101,91
45600,141313,14168,68016,9373,127145,192,101,91
45605,141323,14169,68019,9373,127154,192,101,91
45610,141344,14171,68028,9374,127173,192,101,91
45615,141354,14173,68033,9375,127181,192,101,91
45620,141375,14175,68041,9375,127200,192,101,91
45625,141385,14176,68046,9376,127209,192,101,91
45630,141406,14179,68058,9378,127227,192,101,91
45635,141416,14181,68066,9380,127235,192,101,91
45640,141437,14183,68075,9380,127254,192,101,91
45645,141447,14185,68077,9381,127262,192,101,91
45650,141468,14189,68090,9385,127279,192,101,91
45655,141478,14190,68095,9386,127288,192,101,91
45660,141499,14194,68108,9389,127305,192,101,91
45665,141509,14195,68112,9390,127314,192,101,91
45670,141530,14197,68119,9390,127333,192,101,91
45675,141540,14197,68120,9390,127343,192,101,91
45680,141561,14198,68131,9390,127363,192,101,91
45685,141571,14198,68135,9390,127373,192,101,91
45690,141592,14199,68139,9391,127393,192,101,91
45695,141602,14199,68145,9391,127403,192,101,91
45700,141623,14200,68159,9392,127423,192,101,91
45705,141633,14200,68163,9392,127433,192,101,91
45710,141654,14201,68173,9392,127453,192,101,91
45715,141664,14201,68178,9392,127463,192,101,91
45720,141685,14202,68185,9392,127483,192,101,91
45725,141695,14202,68189,9392,127493,192,101,91
45730,141716,14203,68201,9393,127513,192,101,91
45735,141726,14203,68207,9393,127523,192,101,91
45740,141747,14204,68220,9393,127543,192,101,91
45745,141757,14204,68224,9393,127553,192,101,91
45750,141778,14205,68236,9393,127573,192,101,91
45755,141788,14205,68239,9393,127583,192,101,91
45760,141809,14206,68248,9393,127603,192,101,91
45765,141819,14207,68254,9394,127612,192,101,91
45770,141840,14210,68263,9396,127630,192,101,91
45775,141850,14212,68266,9397,127638,192,101,91
45780,141871,14217,68273,9401,127654,192,101,91
45785,141881,14218,68277,9402,127662,192,101,91
45790,141902,14222,68289,9406,127680,192,101,91
45795,141912,14224,68294,9408,127688,192,101,91
45800,141933,14225,68302,9409,127707,192,101,91
45805,141943,14227,68310,9410,127716,192,101,91
45810,141964,14228,68317,9410,127736,192,101,91
45815,141974,14229,68319,9410,127745,192,101,91
45820,141995,14230,68331,9411,127765,192,101,91
45825,142005,14231,68337,9412,127774,192,101,91
45830,142026,14233,68351,9413,127793,192,101,91
45835,142036,14234,68356,9414,127802,192,101,91
45840,142057,14235,68369,9415,127822,192,101,91
45845,142067,14236,68372,9416,127831,192,101,91
45850,142088,14238,68383,9417,127850,192,101,91
45855,142098,14239,68390,9417,127859,192,101,91
45860,142119,14240,68398,9418,127879,192,101,91
45865,142129,14241,68405,9419,127888,192,101,91
45870,142150,14243,68418,9421,127907,192,101,91
45875,142160,14244,68422,9422,127916,192,101,91
45880,142181,14245,68429,9423,127936,192,101,91
45885,142191,14246,68436,9423,127945,192,101,91
45890,142212,14249,68445,9423,127963,192,101,91
45895,142222,14250,68447,9423,127972,192,101,91
45900,142243,14255,68456,9426,127988,192,101,91
45905,142253,14257,68459,9427,127996,192,101,91
45910,142274,14261,68469,9430,128012,192,101,91
45915,142284,14263,68471,9431,128020,192,101,91
45920,142305,14266,68479,9433,128038,192,101,91
45925,142315,14268,68484,9434,128047,192,101,91
45930,142336,14270,68493,9436,128066,192,101,91
45935,142346,14272,68500,9438,128074,192,101,91
45940,142367,14274,68508,9440,128093,192,101,91
45945,142377,14275,68512,9441,128102,192,101,91
45950,142398,14277,68521,9443,128121,192,101,91
45955,142408,14278,68524,9443,128130,192,101,91
45960,142429,14281,68534,9445,128148,192,101,91
45965,142439,14282,68537,9445,128157,192,101,91
45970,142460,14283,68545,9446,128177,192,101,91
45975,142470,14284,68549,9446,128186,192,101,91
45980,142491,14284,68558,9446,128207,192,101,91
45985,142501,14285,68561,9446,128216,192,101,91
45990,142522,14286,68576,9447,128236,192,101,91
45995,142532,14287,68581,9447,128245,192,101,91
46000,142553,14288,68590,9448,128265,192,101,91
46005,142563,14289,68594,9448,128274,192,101,91
46010,142584,14291,68603,9449,128292,192,101,91
46015,142594,14293,68606,9450,128301,192,101,91
46020,142615,14295,68619,9451,128319,192,101,91
46025,142625,14298,68627,9454,128327,192,101,91
46030,142646,14301,68636,9456,128345,192,101,91
46035,142656,14302,68640,9456,128354,192,101,91
46040,142677,14305,68653,9458,128372,192,101,91
46045,142687,14306,68660,9459,128381,192,101,91
46050,142708,14308,68671,9459,128399,192,101,91
46055,142718,14310,68677,9460,128408,192,101,91
46060,142739,14312,68690,9460,128426,192,101,91
46065,142749,14314,68696,9462,128435,192,101,91
46070,142770,14316,68705,9462,128453,192,101,91
46075,142780,14318,68707,9463,128462,192,101,91
46080,142801,14321,68714,9464,128479,192,101,91
46085,142811,14322,68716,9465,128489,192,101,91
46090,142832,14322,68731,9465,128510,192,101,91
46095,142842,14322,68737,9465,128520,192,101,91
46100,142863,14322,68745,9465,128541,192,101,91
46105,142873,14322,68749,9465,128551,192,101,91
46110,142894,14322,68760,9465,128572,192,101,91
46115,142904,14322,68765,9465,128582,192,101,91
46120,142925,14322,68771,9465,128603,192,101,91
46125,142935,14322,68776,9465,128613,192,101,91
46130,142956,14322,68785,9465,128634,192,101,91
46135,142966,14322,68790,9465,128644,192,101,91
46140,142987,14324,68803,9467,128663,192,101,91
46145,142997,14325,68808,9467,128671,192,101,91
46150,143018,14326,68817,9467,128692,192,101,91
46155,143028,14327,68823,9468,128701,192,101,91
46160,143049,14328,68833,9469,128721,192,101,91
46165,143059,14329,68835,9469,128730,192,101,91
46170,143080,14330,68844,9470,128750,192,101,91
46175,143090,14331,68848,9470,128759,192,101,91
46180,143111,14332,68858,9471,128779,192,101,91
46185,143121,14333,68861,9471,128788,192,101,91
46190,143142,14335,68874,9472,128806,192,101,91
46195,143152,14337,68879,9474,128815,192,101,91
46200,143173,14339,68889,9476,128834,192,101,91
46205,143183,14339,68896,9476,128844,192,101,91
46210,143204,14341,68906,9476,128863,192,101,91
46215,143214,14341,68912,9476,128873,192,101,91
46220,143235,14343,68924,9478,128892,192,101,91
46225,143245,14343,68925,9478,128902,192,101,91
46230,143266,14345,68934,9480,128921,192,101,91
46235,143276,14345,68938,9480,128931,192,101,91
46240,143297,14347,68947,9481,128950,192,101,91
46245,143307,14347,68951,9481,128960,192,101,91
46250,143328,14351,68958,9482,128977,192,101,91
46255,143338,14352,68963,9483,128986,192,101,91
46260,143359,14357,68974,9487,129002,192,101,91
46265,143369,14358,68979,9488,129010,192,101,91
46270,143390,14361,68985,9489,129029,192,101,91
46275,143400,14361,68990,9489,129039,192,101,91
46280,143421,14364,69000,9490,129057,192,101,91
46285,143431,14364,69004,9490,129066,192,101,91
46290,143452,14368,69015,9494,129084,192,101,91
46295,143462,14368,69020,9494,129093,192,101,91
46300,143483,14372,69028,9496,129111,192,101,91
46305,143493,14372,69032,9496,129121,192,101,91
46310,143514,14375,69042,9499,129139,192,101,91
46315,143524,14376,69046,9499,129147,192,101,91
46320,143545,14381,69056,9503,129164,192,101,91
46325,143555,14381,69060,9503,129174,192,101,91
46330,143576,14382,69070,9503,129194,192,101,91
46335,143586,14382,69072,9503,129204,192,101,91
46340,143607,14383,69080,9503,129224,192,101,91
46345,143617,14383,69084,9503,129234,192,101,91
46350,143638,14384,69097,9504,129254,192,101,91
46355,143648,14384,69100,9504,129264,192,101,91
46360,143669,14385,69110,9505,129284,192,101,91
46365,143679,14385,69112,9505,129294,192,101,91
46370,143700,14386,69119,9506,129314,192,101,91
46375,143710,14386,69123,9506,129324,192,101,91
46380,143731,14389,69132,9507,129342,192,101,91
46385,143741,14389,69134,9507,129351,192,101,91
46390,143762,14393,69142,9509,129369,192,101,91
46395,143772,14393,69146,9509,129378,192,101,91
46400,143793,14397,69158,9512,129396,192,101,91
46405,143803,14397,69161,9512,129406,192,101,91
46410,143824,14399,69173,9512,129425,192,101,91
46415,143834,14400,69177,9513,129433,192,101,91
46420,143855,14404,69187,9517,129451,192,101,91
46425,143865,14404,69190,9517,129461,192,101,91
46430,143886,14406,69199,9519,129480,192,101,91
46435,143896,14408,69203,9520,129488,192,101,91
46440,143917,14410,69213,9522,129507,192,101,91
46445,143927,14411,69217,9522,129516,192,101,91
46450,143948,14414,69228,9524,129533,192,101,91
46455,143958,14416,69235,9526,129542,192,101,91
46460,143979,14420,69247,9529,129559,192,101,91
46465,143989,14421,69252,9530,129568,192,101,91
46470,144010,14424,69260,9530,129586,192,101,91
46475,144020,14425,69266,9531,129595,192,101,91
46480,144041,14428,69275,9532,129613,192,101,91
46485,144051,14429,69278,9533,129622,192,101,91
46490,144072,14433,69290,9534,129639,192,101,91
46495,144082,14434,69293,9534,129648,192,101,91
46500,144103,14438,69306,9537,129665,192,101,91
46505,144113,14439,69309,9537,129674,192,101,91
46510,144134,14442,69314,9537,129692,192,101,91
46515,144144,14443,69319,9537,129701,192,101,91
46520,144165,14447,69330,9538,129718,192,101,91
46525,144175,14448,69336,9538,129727,192,101,91
46530,144196,14451,69343,9540,129745,192,101,91
46535,144206,14452,69350,9541,129754,192,101,91
46540,144227,14455,69356,9542,129772,192,101,91
46545,144237,14456,69358,9542,129781,192,101,91
46550,144258,14460,69370,9546,129798,192,101,91
46555,144268,14463,69374,9548,129805,192,101,91
46560,144289,14467,69386,9552,129822,192,101,91
46565,144299,14467,69393,9552,129832,192,101,91
46570,144320,14467,69405,9552,129853,192,101,91
46575,144330,14467,69409,9552,129863,192,101,91
46580,144351,14467,69416,9552,129884,192,101,91
46585,144361,14467,69420,9552,129894,192,101,91
46590,144382,14467,69428,9552,129915,192,101,91
46595,144392,14467,69432,9552,129925,192,101,91
46600,144413,14467,69440,9552,129946,192,101,91
46605,144423,14467,69446,9552,129956,192,101,91
46610,144444,14467,69452,9552,129977,192,101,91
46615,144454,14467,69456,9552,129987,192,101,91
46620,144475,14467,69463,9552,130008,192,101,91
46625,144485,14467,69466,9552,130018,192,101,91
46630,144506,14467,69475,9552,130039,192,101,91
46635,144516,14467,69482,9552,130049,192,101,91
46640,144537,14467,69489,9552,130070,192,101,91
46645,144547,14467,69493,9552,130080,192,101,91
46650,144568,14467,69504,9552,130101,192,101,91
46655,144578,14467,69509,9552,130111,192,101,91
46660,144599,14467,69521,9552,130132,192,101,91
46665,144609,14467,69528,9552,130142,192,101,91
46670,144630,14470,69539,9555,130160,192,101,91
46675,144640,14473,69544,9557,130167,192,101,91
46680,144661,14478,69557,9561,130183,192,101,91
46685,144671,14479,69564,9562,130192,192,101,91
46690,144692,14482,69576,9564,130209,192,101,91
46695,144702,14484,69579,9566,130218,192,101,91
46700,144723,14487,69587,9568,130235,192,101,91
46705,144733,14489,69590,9569,130244,192,101,91
46710,144754,14492,69600,9570,130262,192,101,91
46715,144764,14493,69605,9570,130271,192,101,91
46720,144785,14497,69614,9572,130287,192,101,91
46725,144795,14499,69618,9573,130296,192,101,91
46730,144816,14503,69626,9575,130313,192,101,91
46735,144826,14504,69632,9575,130322,192,101,91
46740,144847,14507,69646,9576,130340,192,101,91
46745,144857,14509,69653,9577,130348,192,101,91
46750,144878,14512,69657,9579,130366,192,101,91
46755,144888,14513,69663,9580,130375,192,101,91
46760,144909,14516,69673,9581,130393,192,101,91
46765,144919,14517,69677,9581,130402,192,101,91
46770,144940,14519,69688,9582,130421,192,101,91
46775,144950,14520,69692,9583,130430,192,101,91
46780,144971,14522,69704,9585,130449,192,101,91
46785,144981,14523,69712,9586,130458,192,101,91
46790,145002,14526,69717,9587,130476,192,101,91
46795,145012,14527,69721,9588,130485,192,101,91
46800,145033,14531,69734,9592,130502,192,101,91
46805,145043,14531,69741,9592,130512,192,101,91
46810,145064,14534,69752,9593,130530,192,101,91
46815,145074,14534,69759,9593,130539,192,101,91
46820,145095,14537,69771,9596,130558,192,101,91
46825,145105,14537,69776,9596,130567,192,101,91
46830,145126,14541,69783,9599,130585,192,101,91
46835,145136,14541,69785,9599,130594,192,101,91
46840,145157,14544,69795,9601,130613,192,101,91
46845,145167,14544,69798,9601,130622,192,101,91
46850,145188,14547,69808,9603,130641,192,101,91
46855,145198,14547,69814,9603,130651,192,101,91
46860,145219,14550,69822,9604,130669,192,101,91
46865,145229,14550,69827,9604,130679,192,101,91
46870,145250,14552,69838,9605,130698,192,101,91
46875,145260,14552,69843,9605,130708,192,101,91
46880,145281,14553,69852,9605,130728,192,101,91
46885,145291,14553,69856,9605,130738,192,101,91
46890,145312,14555,69865,9607,130757,192,101,91
46895,145322,14555,69872,9607,130767,192,101,91
46900,145343,14557,69887,9609,130786,192,101,91
46905,145353,14557,69890,9609,130796,192,101,91
46910,145374,14560,69900,9611,130814,192,101,91
46915,145384,14561,69904,9612,130823,192,101,91
46920,145405,14563,69913,9613,130842,192,101,91
46925,145415,14564,69918,9614,130851,192,101,91
46930,145436,14567,69928,9617,130869,192,101,91
46935,145446,14568,69932,9617,130878,192,101,91
46940,145467,14572,69941,9621,130895,192,101,91
46945,145477,14573,69946,9621,130904,192,101,91
46950,145498,14577,69953,9624,130920,192,101,91
46955,145508,14579,69958,9626,130929,192,101,91
46960,145529,14581,69969,9627,130948,192,101,91
46965,145539,14582,69976,9628,130957,192,101,91
46970,145560,14585,69990,9630,130974,192,101,91
46975,145570,14587,69995,9632,130983,192,101,91
46980,145591,14589,70005,9633,131001,192,101,91
46985,145601,14591,70010,9634,131010,192,101,91
46990,145622,14593,70024,9636,131029,192,101,91
46995,145632,14594,70032,9637,131037,192,101,91
47000,145653,14597,70045,9640,131056,192,101,91
47005,145663,14598,70051,9641,131065,192,101,91
47010,145684,14600,70060,9641,131084,192,101,91
47015,145694,14601,70062,9641,131093,192,101,91
47020,145715,14603,70073,9641,131112,192,101,91
47025,145725,14604,70074,9641,131121,192,101,91
47030,145746,14607,70087,9644,131139,192,101,91
47035,145756,14609,70092,9646,131147,192,101,91
47040,145777,14612,70101,9648,131165,192,101,91
47045,145787,14613,70106,9649,131174,192,101,91
47050,145808,14615,70117,9650,131193,192,101,91
47055,145818,14617,70123,9651,131201,192,101,91
47060,145839,14619,70134,9651,131220,192,101,91
47065,145849,14621,70140,9653,131228,192,101,91
47070,145870,14624,70153,9654,131245,192,101,91
47075,145880,14626,70157,9656,131254,192,101,91
47080,145901,14629,70163,9657,131272,192,101,91
47085,145911,14630,70166,9657,131281,192,101,91
47090,145932,14635,70174,9660,131297,192,101,91
47095,145942,14637,70180,9661,131305,192,101,91
47100,145963,14640,70191,9664,131323,192,101,91
47105,145973,14641,70198,9665,131332,192,101,91
47110,145994,14642,70206,9666,131352,192,101,91
47115,146004,14643,70210,9667,131361,192,101,91
47120,146025,14644,70219,9668,131381,192,101,91
47125,146035,14645,70224,9668,131390,192,101,91
47130,146056,14647,70230,9669,131409,192,101,91
47135,146066,14648,70236,9670,131418,192,101,91
47140,146087,14650,70247,9672,131437,192,101,91
47145,146097,14651,70251,9672,131446,192,101,91
47150,146118,14653,70262,9673,131465,192,101,91
47155,146128,14654,70269,9674,131474,192,101,91
47160,146149,14656,70276,9676,131493,192,101,91
47165,146159,14657,70279,9676,131502,192,101,91
47170,146180,14660,70287,9676,131520,192,101,91
47175,146190,14661,70292,9677,131528,192,101,91
47180,146211,14665,70304,9680,131546,192,101,91
47185,146221,14666,70308,9680,131555,192,101,91
47190,146242,14670,70318,9683,131572,192,101,91
47195,146252,14671,70321,9683,131581,192,101,91
47200,146273,14674,70330,9685,131598,192,101,91
47205,146283,14676,70335,9686,131607,192,101,91
47210,146304,14679,70345,9687,131625,192,101,91
47215,146314,14681,70350,9688,131632,192,101,91
47220,146335,14685,70364,9691,131650,192,101,91
47225,146345,14686,70367,9692,131659,192,101,91
47230,146366,14689,70379,9694,131677,192,101,91
47235,146376,14691,70383,9696,131685,192,101,91
47240,146397,14694,70391,9697,131703,192,101,91
47245,146407,14694,70394,9697,131713,192,101,91
47250,146428,14696,70406,9699,131732,192,101,91
47255,146438,14696,70411,9699,131742,192,101,91
47260,146459,14699,70422,9701,131760,192,101,91
47265,146469,14699,70426,9701,131770,192,101,91
47270,146490,14702,70435,9704,131788,192,101,91
47275,146500,14702,70443,9704,131798,192,101,91
47280,146521,14706,70455,9708,131815,192,101,91
47285,146531,14708,70460,9709,131823,192,101,91
47290,146552,14711,70473,9711,131840,192,101,91
47295,146562,14714,70479,9713,131848,192,101,91
47300,146583,14717,70489,9715,131866,192,101,91
47305,146593,14718,70494,9715,131875,192,101,91
47310,146614,14722,70504,9718,131892,192,101,91
47315,146624,14724,70510,9720,131900,192,101,91
47320,146645,14727,70520,9722,131918,192,101,91
47325,146655,14728,70525,9723,131926,192,101,91
47330,146676,14732,70538,9727,131944,192,101,91
47335,146686,14733,70545,9728,131952,192,101,91
47340,146707,14737,70553,9731,131970,192,101,91
47345,146717,14738,70559,9732,131979,192,101,91
47350,146738,14741,70571,9734,131997,192,101,91
47355,146748,14742,70580,9735,132006,192,101,91
47360,146769,14745,70588,9737,132024,192,101,91
47365,146779,14746,70591,9737,132033,192,101,91
47370,146800,14747,70597,9738,132053,192,101,91
47375,146810,14748,70601,9739,132062,192,101,91
47380,146831,14749,70610,9740,132082,192,101,91
47385,146841,14750,70615,9740,132091,192,101,91
47390,146862,14751,70621,9740,132111,192,101,91
47395,146872,14752,70624,9740,132120,192,101,91
47400,146893,14755,70641,9743,132137,192,101,91
47405,146903,14757,70647,9744,132146,192,101,91
47410,146924,14757,70657,9744,132166,192,101,91
47415,146934,14759,70661,9746,132175,192,101,91
47420,146955,14759,70675,9746,132195,192,101,91
47425,146965,14761,70681,9748,132204,192,101,91
47430,146986,14761,70690,9748,132225,192,101,91
47435,146996,14761,70696,9748,132235,192,101,91
47440,147017,14761,70703,9748,132256,192,101,91
47445,147027,14761,70709,9748,132265,192,101,91
47450,147048,14763,70722,9749,132285,192,101,91
47455,147058,14763,70726,9749,132294,192,101,91
47460,147079,14768,70737,9754,132311,192,101,91
47465,147089,14768,70742,9754,132321,192,101,91
47470,147110,14769,70751,9754,132341,192,101,91
47475,147120,14769,70761,9754,132351,192,101,91
47480,147141,14770,70774,9754,132371,192,101,91
47485,147151,14770,70780,9754,132381,192,101,91
47490,147172,14771,70790,9754,132401,192,101,91
47495,147182,14771,70793,9754,132411,192,101,91
47500,147203,14772,70802,9754,132431,192,101,91
47505,147213,14772,70805,9754,132441,192,101,91
47510,147234,14774,70815,9756,132460,192,101,91
47515,147244,14774,70817,9756,132470,192,101,91
47520,147265,14776,70826,9757,132489,192,101,91
47525,147275,14776,70831,9757,132499,192,101,91
47530,147296,14779,70840,9759,132517,192,101,91
47535,147306,14779,70843,9759,132527,192,101,91
47540,147327,14782,70856,9762,132545,192,101,91
47545,147337,14782,70861,9762,132555,192,101,91
47550,147358,14785,70874,9764,132573,192,101,91
47555,147368,14785,70877,9764,132583,192,101,91
47560,147389,14788,70887,9766,132601,192,101,91
47565,147399,14788,70894,9766,132610,192,101,91
47570,147420,14792,70905,9770,132628,192,101,91
47575,147430,14793,70910,9770,132636,192,101,91
47580,147451,14798,70920,9774,132653,192,101,91
47585,147461,14799,70925,9774,132661,192,101,91
47590,147482,14804,70932,9778,132678,192,101,91
47595,147492,14806,70937,9779,132686,192,101,91
47600,147513,14809,70949,9781,132704,192,101,91
47605,147523,14810,70955,9782,132713,192,101,91
47610,147544,14811,70965,9782,132733,192,101,91
47615,147554,14813,70969,9783,132741,192,101,91
47620,147575,14814,70981,9784,132761,192,101,91
47625,147585,14815,70984,9784,132770,192,101,91
47630,147606,14816,70993,9784,132790,192,101,91
47635,147616,14818,70996,9785,132798,192,101,91
47640,147637,14819,71009,9785,132818,192,101,91
47645,147647,14820,71010,9785,132827,192,101,91
47650,147668,14821,71022,9786,132847,192,101,91
47655,147678,14822,71025,9786,132856,192,101,91
47660,147699,14824,71040,9788,132875,192,101,91
47665,147709,14825,71044,9789,132884,192,101,91
47670,147730,14827,71054,9790,132903,192,101,91
47675,147740,14828,71058,9791,132912,192,101,91
47680,147761,14829,71066,9792,132932,192,101,91
47685,147771,14830,71070,9793,132941,192,101,91
47690,147792,14832,71081,9794,132960,192,101,91
47695,147802,14834,71086,9795,132968,192,101,91
47700,147823,14838,71095,9796,132984,192,101,91
47705,147833,14839,71100,9797,132994,192,101,91
47710,147854,14842,71112,9798,133012,192,101,91
47715,147864,14842,71117,9798,133022,192,101,91
47720,147885,14845,71126,9798,133040,192,101,91
47725,147895,14845,71131,9798,133050,192,101,91
47730,147916,14848,71138,9799,133068,192,101,91
47735,147926,14848,71141,9799,133078,192,101,91
47740,147947,14851,71147,9800,133096,192,101,91
47745,147957,14851,71154,9800,133105,192,101,91
47750,147978,14856,71165,9803,133122,192,101,91
47755,147988,14856,71168,9803,133132,192,101,91
47760,148009,14861,71180,9806,133148,192,101,91
47765,148019,14862,71185,9806,133157,192,101,91
47770,148040,14864,71196,9806,133176,192,101,91
47775,148050,14865,71201,9806,133185,192,101,91
47780,148071,14867,71208,9807,133204,192,101,91
47785,148081,14868,71211,9808,133213,192,101,91
47790,148102,14871,71221,9810,133231,192,101,91
47795,148112,14873,71226,9811,133239,192,101,91
47800,148133,14875,71237,9812,133258,192,101,91
47805,148143,14877,71239,9813,133266,192,101,91
47810,148164,14879,71248,9814,133285,192,101,91
47815,148174,14882,71255,9816,133292,192,101,91
47820,148195,14885,71269,9818,133310,192,101,91
47825,148205,14888,71275,9820,133317,192,101,91
47830,148226,14891,71285,9822,133335,192,101,91
47835,148236,14892,71290,9822,133344,192,101,91
47840,148257,14893,71298,9822,133364,192,101,91
47845,148267,14895,71304,9824,133372,192,101,91
47850,148288,14896,71316,9825,133392,192,101,91
47855,148298,14897,71320,9825,133401,192,101,91
47860,148319,14898,71326,9826,133421,192,101,91
47865,148329,14900,71332,9828,133429,192,101,91
47870,148350,14904,71345,9831,133446,192,101,91
47875,148360,14905,71350,9832,133455,192,101,91
47880,148381,14908,71363,9834,133473,192,101,91
47885,148391,14909,71369,9835,133481,192,101,91
47890,148412,14914,71380,9838,133498,192,101,91
47895,148422,14915,71386,9839,133506,192,101,91
47900,148443,14919,71395,9842,133524,192,101,91
47905,148453,14919,71399,9842,133534,192,101,91
47910,148474,14922,71405,9842,133552,192,101,91
47915,148484,14922,71411,9842,133562,192,101,91
47920,148505,14925,71422,9844,133580,192,101,91
47925,148515,14925,71426,9844,133590,192,101,91
47930,148536,14928,71437,9846,133608,192,101,91
47935,148546,14929,71443,9847,133617,192,101,91
47940,148567,14932,71454,9848,133635,192,101,91
47945,148577,14932,71460,9848,133645,192,101,91
47950,148598,14935,71473,9850,133663,192,101,91
47955,148608,14935,71479,9850,133673,192,101,91
47960,148629,14937,71488,9850,133692,192,101,91
47965,148639,14937,71496,9850,133702,192,101,91
47970,148660,14939,71508,9851,133721,192,101,91
47975,148670,14939,71511,9851,133731,192,101,91
47980,148691,14941,71523,9852,133750,192,101,91
47985,148701,14942,71527,9852,133759,192,101,91
47990,148722,14944,71537,9853,133778,192,101,91
47995,148732,14945,71540,9854,133787,192,101,91
48000,148753,14947,71549,9854,133806,192,101,91
48005,148763,14948,71552,9854,133815,192,101,91
48010,148784,14950,71561,9854,133834,192,101,91
48015,148794,14951,71565,9855,133843,192,101,91
48020,148815,14953,71572,9856,133862,192,101,91
48025,148825,14954,71577,9857,133871,192,101,91
48030,148846,14956,71593,9859,133889,192,101,91
48035,148856,14958,71599,9861,133898,192,101,91
48040,148877,14960,71608,9862,133916,192,101,91
48045,148887,14962,71613,9863,133924,192,101,91
48050,148908,14965,71622,9865,133943,192,101,91
48055,148918,14966,71627,9866,133951,192,101,91
48060,148939,14970,71639,9870,133969,192,101,91
48065,148949,14971,71644,9870,133977,192,101,91
48070,148970,14975,71653,9873,133995,192,101,91
48075,148980,14977,71657,9874,134002,192,101,91
48080,149001,14981,71669,9877,134020,192,101,91
48085,149011,14982,71673,9878,134029,192,101,91
48090,149032,14985,71683,9881,134047,192,101,91
48095,149042,14986,71686,9881,134056,192,101,91
48100,149063,14990,71693,9883,134073,192,101,91
48105,149073,14992,71699,9885,134080,192,101,91
48110,149094,14995,71709,9887,134099,192,101,91
48115,149104,14998,71714,9890,134106,192,101,91
48120,149125,15001,71726,9892,134124,192,101,91
48125,149135,15002,71731,9892,134133,192,101,91
48130,149156,15002,71742,9892,134154,192,101,91
48135,149166,15004,71749,9894,134162,192,101,91
48140,149187,15004,71758,9894,134183,192,101,91
48145,149197,15005,71763,9894,134192,192,101,91
48150,149218,15005,71774,9894,134213,192,101,91
48155,149228,15006,71779,9895,134222,192,101,91
48160,149249,15006,71792,9895,134242,192,101,91
48165,149259,15008,71794,9896,134251,192,101,91
48170,149280,15009,71801,9896,134271,192,101,91
48175,149290,15010,71806,9897,134280,192,101,91
48180,149311,15012,71812,9899,134299,192,101,91
48185,149321,15012,71812,9899,134309,192,101,91
48190,149342,15016,71819,9901,134326,192,101,91
48195,149352,15016,71824,9901,134336,192,101,91
48200,149373,15020,71835,9904,134353,192,101,91
48205,149383,15021,71840,9905,134362,192,101,91
48210,149404,15024,71852,9907,134380,192,101,91
48215,149414,15025,71857,9908,134389,192,101,91
48220,149435,15029,71868,9910,134406,192,101,91
48225,149445,15029,71872,9910,134416,192,101,91
48230,149466,15032,71878,9912,134434,192,101,91
48235,149476,15032,71882,9912,134444,192,101,91
48240,149497,15036,71894,9914,134461,192,101,91
48245,149507,15036,71899,9914,134471,192,101,91
48250,149528,15039,71908,9916,134489,192,101,91
48255,149538,15039,71912,9916,134499,192,101,91
48260,149559,15042,71920,9916,134517,192,101,91
48265,149569,15042,71925,9916,134527,192,101,91
48270,149590,15045,71936,9916,134545,192,101,91
48275,149600,15045,71940,9916,134554,192,101,91
48280,149621,15050,71948,9919,134571,192,101,91
48285,149631,15050,71952,9919,134580,192,101,91
48290,149652,15055,71964,9923,134597,192,101,91
48295,149662,15056,71965,9924,134606,192,101,91
48300,149683,15059,71975,9926,134624,192,101,91
48305,149693,15060,71977,9926,134633,192,101,91
48310,149714,15063,71984,9927,134651,192,101,91
48315,149724,15064,71987,9928,134660,192,101,91
48320,149745,15068,71993,9930,134677,192,101,91
48325,149755,15069,72000,9931,134686,192,101,91
48330,149776,15072,72012,9933,134704,192,101,91
48335,149786,15073,72016,9934,134713,192,101,91
48340,149807,15075,72027,9935,134732,192,101,91
48345,149817,15076,72031,9935,134741,192,101,91
48350,149838,15079,72044,9937,134759,192,101,91
48355,149848,15080,72049,9937,134767,192,101,91
48360,149869,15083,72056,9939,134786,192,101,91
48365,149879,15084,72062,9940,134795,192,101,91
48370,149900,15086,72074,9941,134814,192,101,91
48375,149910,15088,72077,9942,134822,192,101,91
48380,149931,15090,72085,9944,134841,192,101,91
48385,149941,15091,72091,9945,134850,192,101,91
48390,149962,15093,72103,9947,134869,192,101,91
48395,149972,15094,72106,9947,134878,192,101,91
48400,149993,15096,72119,9949,134897,192,101,91
48405,150003,15097,72123,9950,134906,192,101,91
48410,150024,15098,72129,9950,134925,192,101,91
48415,150034,15101,72133,9952,134933,192,101,91
48420,150055,15104,72146,9954,134951,192,101,91
48425,150065,15104,72152,9954,134961,192,101,91
48430,150086,15105,72159,9954,134981,192,101,91
48435,150096,15105,72165,9954,134991,192,101,91
48440,150117,15105,72175,9954,135012,192,101,91
48445,150127,15105,72182,9954,135022,192,101,91
48450,150148,15105,72196,9954,135043,192,101,91
48455,150158,15105,72200,9954,135053,192,101,91
48460,150179,15105,72212,9954,135074,192,101,91
48465,150189,15105,72216,9954,135084,192,101,91
48470,150210,15106,72227,9954,135104,192,101,91
48475,150220,15106,72229,9954,135114,192,101,91
48480,150241,15107,72240,9954,135134,192,101,91
48485,150251,15107,72243,9954,135144,192,101,91
48490,150272,15111,72250,9955,135161,192,101,91
48495,150282,15111,72254,9955,135171,192,101,91
48500,150303,15114,72265,9956,135189,192,101,91
48505,150313,15114,72273,9956,135198,192,101,91
48510,150334,15119,72282,9959,135215,192,101,91
48515,150344,15120,72287,9960,135224,192,101,91
48520,150365,15124,72296,9962,135241,192,101,91
48525,150375,15125,72306,9963,135249,192,101,91
48530,150396,15129,72316,9967,135266,192,101,91
48535,150406,15131,72322,9969,135274,192,101,91
48540,150427,15137,72332,9974,135289,192,101,91
48545,150437,15140,72339,9977,135296,192,101,91
48550,150458,15144,72349,9979,135314,192,101,91
48555,150468,15145,72352,9979,135323,192,101,91
48560,150489,15146,72361,9980,135343,192,101,91
48565,150499,15147,72366,9981,135352,192,101,91
48570,150520,15148,72377,9981,135372,192,101,91
48575,150530,15149,72384,9982,135381,192,101,91
48580,150551,15151,72391,9983,135400,192,101,91
48585,150561,15152,72396,9984,135409,192,101,91
48590,150582,15153,72406,9985,135429,192,101,91
48595,150592,15154,72408,9985,135438,192,101,91
48600,150613,15155,72415,9986,135458,192,101,91
48605,150623,15156,72420,9986,135467,192,101,91
48610,150644,15157,72431,9986,135487,192,101,91
48615,150654,15158,72431,9986,135496,192,101,91
48620,150675,15158,72440,9986,135517,192,101,91
48625,150685,15159,72444,9987,135526,192,101,91
48630,150706,15159,72451,9987,135547,192,101,91
48635,150716,15160,72456,9988,135556,192,101,91
48640,150737,15160,72461,9988,135577,192,101,91
48645,150747,15161,72465,9988,135586,192,101,91
48650,150768,15161,72470,9988,135607,192,101,91
48655,150778,15162,72473,9988,135616,192,101,91
48660,150799,15163,72489,9989,135635,192,101,91
48665,150809,15164,72494,9990,135645,192,101,91
48670,150830,15165,72502,9991,135665,192,101,91
48675,150840,15165,72506,9991,135675,192,101,91
48680,150861,15166,72516,9992,135695,192,101,91
48685,150871,15166,72517,9992,135705,192,101,91
48690,150892,15168,72530,9994,135724,192,101,91
48695,150902,15168,72535,9994,135734,192,101,91
48700,150923,15170,72545,9996,135753,192,101,91
48705,150933,15170,72549,9996,135763,192,101,91
48710,150954,15173,72561,9998,135781,192,101,91
48715,150964,15174,72567,9999,135789,192,101,91
48720,150985,15178,72579,10003,135807,192,101,91
48725,150995,15180,72583,10005,135815,192,101,91
48730,151016,15182,72597,10006,135834,192,101,91
48735,151026,15184,72601,10007,135842,192,101,91
48740,151047,15185,72609,10008,135861,192,101,91
48745,151057,15188,72612,10010,135869,192,101,91
48750,151078,15189,72625,10010,135889,192,101,91
48755,151088,15190,72628,10010,135898,192,101,91
48760,151109,15192,72636,10011,135917,192,101,91
48765,151119,15193,72639,10012,135926,192,101,91
48770,151140,15197,72647,10015,135943,192,101,91
48775,151150,15198,72653,10016,135952,192,101,91
48780,151171,15201,72665,10017,135970,192,101,91
48785,151181,15201,72671,10017,135980,192,101,91
48790,151202,15204,72683,10018,135998,192,101,91
48795,151212,15205,72687,10019,136007,192,101,91
48800,151233,15209,72699,10022,136024,192,101,91
48805,151243,15210,72706,10023,136033,192,101,91
48810,151264,15212,72715,10024,136052,192,101,91
48815,151274,15212,72717,10024,136062,192,101,91
48820,151295,15215,72728,10025,136080,192,101,91
48825,151305,15216,72735,10026,136089,192,101,91
48830,151326,15218,72746,10027,136108,192,101,91
48835,151336,15218,72750,10027,136118,192,101,91
48840,151357,15221,72760,10029,136136,192,101,91
48845,151367,15221,72765,10029,136145,192,101,91
48850,151388,15224,72778,10032,136164,192,101,91
48855,151398,15224,72783,10032,136173,192,101,91
48860,151419,15227,72790,10034,136192,192,101,91
48865,151429,15227,72795,10034,136202,192,101,91
48870,151450,15229,72805,10035,136221,192,101,91
48875,151460,15229,72809,10035,136231,192,101,91
48880,151481,15231,72818,10035,136250,192,101,91
48885,151491,15231,72823,10035,136260,192,101,91
48890,151512,15233,72834,10036,136279,192,101,91
48895,151522,15235,72840,10038,136287,192,101,91
48900,151543,15238,72845,10039,136305,192,101,91
48905,151553,15239,72848,10040,136313,192,101,91
48910,151574,15244,72855,10042,136330,192,101,91
48915,151584,15245,72859,10042,136339,192,101,91
48920,151605,15247,72869,10043,136358,192,101,91
48925,151615,15249,72875,10045,136366,192,101,91
48930,151636,15251,72885,10045,136385,192,101,91
48935,151646,15253,72892,10047,136393,192,101,91
48940,151667,15255,72900,10047,136411,192,101,91
48945,151677,15258,72903,10049,136419,192,101,91
48950,151698,15261,72917,10050,136436,192,101,91
48955,151708,15263,72922,10051,136445,192,101,91
48960,151729,15266,72935,10053,136463,192,101,91
48965,151739,15267,72939,10053,136472,192,101,91
48970,151760,15269,72953,10055,136491,192,101,91
48975,151770,15270,72958,10055,136500,192,101,91
48980,151791,15274,72974,10059,136517,192,101,91
48985,151801,15275,72978,10059,136526,192,101,91
48990,151822,15278,72986,10061,136544,192,101,91
48995,151832,15279,72992,10061,136553,192,101,91
49000,151853,15283,73003,10065,136570,192,101,91
49005,151863,15284,73011,10066,136579,192,101,91
49010,151884,15286,73020,10068,136598,192,101,91
49015,151894,15287,73023,10068,136607,192,101,91
49020,151915,15289,73033,10068,136626,192,101,91
49025,151925,15290,73040,10068,136635,192,101,91
49030,151946,15290,73051,10068,136656,192,101,91
49035,151956,15291,73056,10068,136665,192,101,91
49040,151977,15291,73068,10068,136686,192,101,91
49045,151987,15292,73077,10069,136695,192,101,91
49050,152008,15292,73088,10069,136716,192,101,91
49055,152018,15293,73093,10069,136725,192,101,91
49060,152039,15293,73106,10069,136746,192,101,91
49065,152049,15294,73111,10069,136755,192,101,91
49070,152070,15295,73124,10070,136773,192,101,91
49075,152080,15298,73130,10073,136782,192,101,91
49080,152101,15300,73136,10075,136801,192,101,91
49085,152111,15300,73140,10075,136811,192,101,91
49090,152132,15301,73148,10076,136831,192,101,91
49095,152142,15301,73151,10076,136841,192,101,91
49100,152163,15303,73164,10078,136860,192,101,91
49105,152173,15303,73164,10078,136870,192,101,91
49110,152194,15305,73175,10079,136889,192,101,91
49115,152204,15305,73181,10079,136899,192,101,91
49120,152225,15307,73192,10080,136918,192,101,91
49125,152235,15307,73195,10080,136928,192,101,91
49130,152256,15311,73207,10084,136945,192,101,91
49135,152266,15311,73210,10084,136955,192,101,91
49140,152287,15314,73218,10085,136973,192,101,91
49145,152297,15314,73223,10085,136982,192,101,91
49150,152318,15317,73232,10088,137001,192,101,91
49155,152328,15318,73238,10089,137009,192,101,91
49160,152349,15321,73250,10091,137028,192,101,91
49165,152359,15321,73256,10091,137037,192,101,91
49170,152380,15324,73265,10093,137056,192,101,91
49175,152390,15324,73267,10093,137066,192,101,91
49180,152411,15327,73276,10095,137084,192,101,91
49185,152421,15328,73280,10096,137092,192,101,91
49190,152442,15331,73290,10098,137111,192,101,91
49195,152452,15332,73294,10098,137119,192,101,91
49200,152473,15335,73303,10099,137138,192,101,91
49205,152483,15336,73310,10099,137147,192,101,91
49210,152504,15337,73320,10099,137166,192,101,91
49215,152514,15339,73323,10101,137175,192,101,91
49220,152535,15341,73335,10103,137194,192,101,91
49225,152545,15341,73341,10103,137204,192,101,91
49230,152566,15342,73354,10104,137224,192,101,91
49235,152576,15342,73358,10104,137234,192,101,91
49240,152597,15343,73372,10104,137254,192,101,91
49245,152607,15343,73374,10104,137264,192,101,91
49250,152628,15344,73388,10105,137284,192,101,91
49255,152638,15344,73390,10105,137294,192,101,91
49260,152659,15345,73403,10106,137314,192,101,91
49265,152669,15345,73409,10106,137324,192,101,91
49270,152690,15346,73417,10106,137344,192,101,91
49275,152700,15346,73424,10106,137354,192,101,91
49280,152721,15347,73433,10106,137374,192,101,91
49285,152731,15347,73438,10106,137384,192,101,91
49290,152752,15348,73450,10107,137404,192,101,91
49295,152762,15348,73455,10107,137414,192,101,91
49300,152783,15349,73463,10107,137434,192,101,91
49305,152793,15349,73469,10107,137444,192,101,91
49310,152814,15353,73476,10109,137461,192,101,91
49315,152824,15353,73481,10109,137471,192,101,91
49320,152845,15357,73494,10111,137488,192,101,91
49325,152855,15358,73497,10111,137496,192,101,91
49330,152876,15362,73508,10114,137513,192,101,91
49335,152886,15364,73512,10116,137522,192,101,91
49340,152907,15367,73525,10119,137540,192,101,91
49345,152917,15368,73529,10119,137549,192,101,91
49350,152938,15368,73543,10119,137570,192,101,91
49355,152948,15369,73547,10119,137579,192,101,91
49360,152969,15369,73553,10119,137600,192,101,91
49365,152979,15370,73556,10119,137609,192,101,91
49370,153000,15370,73565,10119,137630,192,101,91
49375,153010,15371,73570,10120,137639,192,101,91
49380,153031,15371,73578,10120,137660,192,101,91
49385,153041,15372,73584,10120,137669,192,101,91
49390,153062,15372,73591,10120,137690,192,101,91
49395,153072,15373,73599,10121,137699,192,101,91
49400,153093,15373,73607,10121,137720,192,101,91
49405,153103,15374,73615,10122,137729,192,101,91
49410,153124,15374,73622,10122,137750,192,101,91
49415,153134,15375,73625,10122,137759,192,101,91
49420,153155,15375,73635,10122,137780,192,101,91
49425,153165,15376,73640,10123,137789,192,101,91
49430,153186,15378,73652,10125,137807,192,101,91
49435,153196,15380,73656,10127,137816,192,101,91
49440,153217,15383,73664,10129,137834,192,101,91
49445,153227,15383,73671,10129,137844,192,101,91
49450,153248,15385,73682,10130,137863,192,101,91
49455,153258,15385,73685,10130,137873,192,101,91
49460,153279,15386,73695,10130,137893,192,101,91
49465,153289,15386,73697,10130,137903,192,101,91
49470,153310,15387,73707,10130,137923,192,101,91
49475,153320,15387,73711,10130,137933,192,101,91
49480,153341,15388,73719,10130,137953,192,101,91
49485,153351,15388,73722,10130,137963,192,101,91
49490,153372,15389,73732,10131,137983,192,101,91
49495,153382,15389,73735,10131,137993,192,101,91
49500,153403,15390,73744,10132,138013,192,101,91
49505,153413,15390,73749,10132,138023,192,101,91
49510,153434,15391,73760,10132,138043,192,101,91
49515,153444,15391,73766,10132,138053,192,101,91
49520,153465,15392,73771,10132,138073,192,101,91
49525,153475,15392,73775,10132,138083,192,101,91
49530,153496,15393,73785,10132,138103,192,101,91
49535,153506,15393,73787,10132,138113,192,101,91
49540,153527,15394,73799,10133,138133,192,101,91
49545,153537,15394,73804,10133,138143,192,101,91
49550,153558,15399,73813,10136,138158,192,101,91
49555,153568,15401,73818,10138,138167,192,101,91
49560,153589,15406,73831,10143,138181,192,101,91
49565,153599,15409,73839,10146,138190,192,101,91
49570,153620,15409,73847,10146,138211,192,101,91
49575,153630,15410,73851,10147,138220,192,101,91
49580,153651,15410,73861,10147,138241,192,101,91
49585,153661,15411,73867,10148,138250,192,101,91
49590,153682,15411,73874,10148,138271,192,101,91
49595,153692,15412,73878,10148,138280,192,101,91
49600,153713,15412,73886,10148,138301,192,101,91
49605,153723,15413,73894,10149,138310,192,101,91
49610,153744,15413,73904,10149,138331,192,101,91
49615,153754,15414,73913,10150,138340,192,101,91
49620,153775,15414,73922,10150,138361,192,101,91
49625,153785,15415,73925,10150,138370,192,101,91
49630,153806,15415,73932,10150,138391,192,101,91
49635,153816,15416,73939,10151,138400,192,101,91
49640,153837,15416,73946,10151,138421,192,101,91
49645,153847,15417,73950,10151,138430,192,101,91
49650,153868,15417,73958,10151,138451,192,101,91
49655,153878,15418,73965,10152,138460,192,101,91
49660,153899,15418,73975,10152,138481,192,101,91
49665,153909,15419,73981,10153,138490,192,101,91
49670,153930,15422,73990,10153,138508,192,101,91
49675,153940,15423,73992,10153,138517,192,101,91
49680,153961,15427,73999,10154,138533,192,101,91
49685,153971,15428,74001,10155,138543,192,101,91
49690,153992,15434,74013,10159,138558,192,101,91
49695,154002,15434,74017,10159,138568,192,101,91
49700,154023,15439,74028,10162,138584,192,101,91
49705,154033,15439,74033,10162,138594,192,101,91
49710,154054,15441,74042,10164,138613,192,101,91
49715,154064,15441,74046,10164,138623,192,101,91
49720,154085,15445,74057,10167,138640,192,101,91
49725,154095,15445,74062,10167,138650,192,101,91
49730,154116,15447,74068,10168,138669,192,101,91
49735,154126,15447,74074,10168,138679,192,101,91
49740,154147,15450,74082,10170,138697,192,101,91
49745,154157,15450,74088,10170,138707,192,101,91
49750,154178,15451,74099,10170,138727,192,101,91
49755,154188,15451,74102,10170,138737,192,101,91
49760,154209,15452,74108,10170,138757,192,101,91
49765,154219,15452,74115,10170,138767,192,101,91
49770,154240,15453,74124,10170,138787,192,101,91
49775,154250,15453,74129,10170,138797,192,101,91
49780,154271,15455,74138,10171,138816,192,101,91
49785,154281,15455,74143,10171,138825,192,101,91
49790,154302,15458,74157,10174,138844,192,101,91
49795,154312,15459,74163,10174,138852,192,101,91
49800,154333,15463,74176,10178,138869,192,101,91
49805,154343,15467,74181,10181,138876,192,101,91
49810,154364,15469,74191,10183,138895,192,101,91
49815,154374,15471,74195,10185,138903,192,101,91
49820,154395,15473,74203,10187,138922,192,101,91
49825,154405,15475,74209,10188,138930,192,101,91
49830,154426,15477,74216,10188,138949,192,101,91
49835,154436,15479,74221,10189,138957,192,101,91
49840,154457,15481,74230,10190,138975,192,101,91
49845,154467,15484,74234,10192,138983,192,101,91
49850,154488,15486,74245,10193,139002,192,101,91
49855,154498,15488,74251,10194,139009,192,101,91
49860,154519,15491,74261,10197,139028,192,101,91
49865,154529,15492,74265,10198,139037,192,101,91
49870,154550,15493,74274,10198,139057,192,101,91
49875,154560,15494,74278,10198,139066,192,101,91
49880,154581,15495,74285,10198,139086,192,101,91
49885,154591,15496,74291,10199,139095,192,101,91
49890,154612,15497,74303,10200,139115,192,101,91
49895,154622,15498,74310,10201,139124,192,101,91
49900,154643,15499,74317,10201,139144,192,101,91
49905,154653,15500,74322,10201,139153,192,101,91
49910,154674,15502,74335,10203,139172,192,101,91
49915,154684,15503,74340,10204,139181,192,101,91
49920,154705,15505,74352,10205,139199,192,101,91
49925,154715,15506,74358,10206,139209,192,101,91
49930,154736,15508,74367,10206,139228,192,101,91
49935,154746,15508,74369,10206,139238,192,101,91
49940,154767,15510,74374,10207,139257,192,101,91
49945,154777,15510,74377,10207,139267,192,101,91
49950,154798,15512,74388,10207,139286,192,101,91
49955,154808,15512,74392,10207,139296,192,101,91
49960,154829,15515,74400,10208,139314,192,101,91
49965,154839,15515,74406,10208,139324,192,101,91
49970,154860,15517,74419,10209,139343,192,101,91
49975,154870,15517,74423,10209,139353,192,101,91
49980,154891,15520,74432,10211,139371,192,101,91
49985,154901,15521,74438,10211,139380,192,101,91
49990,154922,15522,74446,10211,139400,192,101,91
49995,154932,15523,74450,10211,139409,192,101,91
50000,154953,15525,74460,10213,139428,192,101,91
50005,154963,15526,74464,10213,139437,192,101,91
50010,154984,15527,74475,10214,139457,192,101,91
50015,154994,15528,74479,10214,139466,192,101,91
50020,155015,15529,74486,10214,139486,192,101,91
50025,155025,15530,74492,10214,139495,192,101,91
50030,155046,15533,74500,10216,139512,192,101,91
50035,155056,15536,74505,10218,139520,192,101,91
50040,155077,15539,74511,10221,139538,192,101,91
50045,155087,15540,74514,10221,139547,192,101,91
50050,155108,15542,74523,10222,139566,192,101,91
50055,155118,15542,74531,10222,139575,192,101,91
50060,155139,15545,74541,10224,139594,192,101,91
50065,155149,15545,74546,10224,139603,192,101,91
50070,155170,15549,74556,10227,139621,192,101,91
50075,155180,15549,74560,10227,139630,192,101,91
50080,155201,15553,74570,10231,139648,192,101,91
50085,155211,15553,74575,10231,139657,192,101,91
50090,155232,15557,74588,10235,139675,192,101,91
50095,155242,15557,74592,10235,139685,192,101,91
50100,155263,15560,74598,10237,139703,192,101,91
50105,155273,15560,74602,10237,139713,192,101,91
50110,155294,15562,74615,10238,139732,192,101,91
50115,155304,15562,74620,10238,139742,192,101,91
50120,155325,15563,74633,10239,139762,192,101,91
50125,155335,15563,74636,10239,139772,192,101,91
50130,155356,15564,74645,10239,139792,192,101,91
50135,155366,15564,74651,10239,139802,192,101,91
50140,155387,15565,74661,10240,139822,192,101,91
50145,155397,15565,74667,10240,139832,192,101,91
50150,155418,15568,74676,10243,139850,192,101,91
50155,155428,15569,74683,10244,139859,192,101,91
50160,155449,15574,74695,10247,139873,192,101,91
50165,155459,15576,74703,10249,139883,192,101,91
50170,155480,15577,74716,10249,139903,192,101,91
50175,155490,15577,74722,10249,139913,192,101,91
50180,155511,15578,74727,10250,139933,192,101,91
50185,155521,15578,74731,10250,139943,192,101,91
50190,155542,15580,74741,10252,139962,192,101,91
50195,155552,15580,74746,10252,139972,192,101,91
50200,155573,15581,74759,10253,139992,192,101,91
50205,155583,15581,74765,10253,140001,192,101,91
50210,155604,15583,74775,10254,140021,192,101,91
50215,155614,15583,74781,10254,140031,192,101,91
50220,155635,15585,74789,10254,140050,192,101,91
50225,155645,15587,74793,10256,140058,192,101,91
50230,155666,15592,74805,10261,140074,192,101,91
50235,155676,15594,74810,10263,140082,192,101,91
50240,155697,15597,74816,10264,140100,192,101,91
50245,155707,15598,74819,10264,140109,192,101,91
50250,155728,15603,74830,10267,140125,192,101,91
50255,155738,15605,74835,10268,140133,192,101,91
50260,155759,15609,74845,10272,140150,192,101,91
50265,155769,15610,74848,10272,140159,192,101,91
50270,155790,15615,74857,10275,140175,192,101,91
50275,155800,15615,74863,10275,140185,192,101,91
50280,155821,15619,74872,10277,140202,192,101,91
50285,155831,15620,74874,10277,140211,192,101,91
50290,155852,15624,74888,10280,140228,192,101,91
50295,155862,15625,74893,10280,140237,192,101,91
50300,155883,15629,74909,10283,140254,192,101,91
50305,155893,15630,74912,10283,140263,192,101,91
50310,155914,15633,74922,10284,140281,192,101,91
50315,155924,15634,74927,10285,140290,192,101,91
50320,155945,15637,74937,10286,140308,192,101,91
50325,155955,15638,74942,10287,140317,192,101,91
50330,155976,15642,74958,10290,140333,192,101,91
50335,155986,15644,74962,10291,140342,192,101,91
50340,156007,15647,74972,10293,140360,192,101,91
50345,156017,15648,74978,10294,140369,192,101,91
50350,156038,15650,74992,10295,140388,192,101,91
50355,156048,15651,74995,10296,140397,192,101,91
50360,156069,15653,75007,10298,140416,192,101,91
50365,156079,15654,75013,10299,140424,192,101,91
50370,156100,15657,75023,10301,140443,192,101,91
50375,156110,15658,75029,10301,140451,192,101,91
50380,156131,15661,75041,10302,140470,192,101,91
50385,156141,15662,75045,10303,140479,192,101,91
50390,156162,15664,75050,10303,140498,192,101,91
50395,156172,15665,75056,10304,140506,192,101,91
50400,156193,15669,75066,10307,140524,192,101,91
50405,156203,15670,75072,10308,140533,192,101,91
50410,156224,15671,75082,10308,140553,192,101,91
50415,156234,15671,75086,10308,140563,192,101,91
50420,156255,15672,75096,10309,140583,192,101,91
50425,156265,15672,75099,10309,140593,192,101,91
50430,156286,15673,75110,10310,140613,192,101,91
50435,156296,15674,75114,10311,140622,192,101,91
50440,156317,15675,75125,10312,140642,192,101,91
50445,156327,15676,75130,10313,140651,192,101,91
50450,156348,15679,75140,10315,140669,192,101,91
50455,156358,15680,75142,10316,140678,192,101,91
50460,156379,15682,75153,10318,140696,192,101,91
50465,156389,15683,75156,10319,140706,192,101,91
50470,156410,15686,75168,10320,140724,192,101,91
50475,156420,15686,75172,10320,140734,192,101,91
50480,156441,15688,75179,10321,140753,192,101,91
50485,156451,15688,75182,10321,140763,192,101,91
50490,156472,15690,75193,10322,140782,192,101,91
50495,156482,15690,75200,10322,140792,192,101,91
50500,156503,15692,75208,10322,140811,192,101,91
50505,156513,15692,75211,10322,140821,192,101,91
50510,156534,15694,75222,10322,140840,192,101,91
50515,156544,15695,75225,10322,140849,192,101,91
50520,156565,15697,75238,10323,140868,192,101,91
50525,156575,15698,75246,10324,140877,192,101,91
50530,156596,15701,75255,10325,140894,192,101,91
50535,156606,15704,75260,10328,140902,192,101,91
50540,156627,15708,75272,10329,140918,192,101,91
50545,156637,15710,75276,10330,140927,192,101,91
50550,156658,15713,75282,10330,140944,192,101,91
50555,156668,15716,75287,10332,140952,192,101,91
50560,156689,15719,75302,10335,140970,192,101,91
50565,156699,15722,75308,10338,140977,192,101,91
50570,156720,15726,75319,10340,140994,192,101,91
50575,156730,15728,75326,10341,141001,192,101,91
50580,156751,15732,75337,10344,141018,192,101,91
50585,156761,15733,75342,10345,141028,192,101,91
50590,156782,15733,75357,10345,141049,192,101,91
50595,156792,15733,75360,10345,141059,192,101,91
50600,156813,15733,75373,10345,141080,192,101,91
50605,156823,15733,75380,10345,141090,192,101,91
50610,156844,15733,75394,10345,141111,192,101,91
50615,156854,15733,75403,10345,141121,192,101,91
50620,156875,15733,75415,10345,141142,192,101,91
50625,156885,15733,75419,10345,141152,192,101,91
50630,156906,15733,75430,10345,141173,192,101,91
50635,156916,15733,75434,10345,141183,192,101,91
50640,156937,15733,75439,10345,141204,192,101,91
50645,156947,15733,75443,10345,141214,192,101,91
50650,156968,15733,75451,10345,141235,192,101,91
50655,156978,15733,75454,10345,141245,192,101,91
50660,156999,15733,75465,10345,141266,192,101,91
50665,157009,15733,75468,10345,141276,192,101,91
50670,157030,15733,75480,10345,141297,192,101,91
50675,157040,15733,75486,10345,141307,192,101,91
50680,157061,15733,75496,10345,141328,192,101,91
50685,157071,15733,75502,10345,141337,192,101,91
50690,157092,15736,75511,10347,141355,192,101,91
50695,157102,15738,75516,10349,141364,192,101,91
50700,157123,15743,75528,10352,141380,192,101,91
50705,157133,15744,75533,10352,141389,192,101,91
50710,157154,15745,75542,10352,141409,192,101,91
50715,157164,15746,75547,10353,141418,192,101,91
50720,157185,15747,75558,10354,141438,192,101,91
50725,157195,15748,75562,10354,141447,192,101,91
50730,157216,15749,75573,10355,141467,192,101,91
50735,157226,15750,75580,10355,141476,192,101,91
50740,157247,15752,75594,10357,141495,192,101,91
50745,157257,15753,75597,10357,141504,192,101,91
50750,157278,15755,75609,10358,141523,192,101,91
50755,157288,15756,75615,10359,141532,192,101,91
50760,157309,15757,75623,10359,141552,192,101,91
50765,157319,15758,75627,10360,141561,192,101,91
50770,157340,15759,75634,10361,141581,192,101,91
50775,157350,15760,75638,10361,141590,192,101,91
50780,157371,15761,75647,10362,141610,192,101,91
50785,157381,15762,75651,10363,141619,192,101,91
50790,157402,15763,75662,10364,141639,192,101,91
50795,157412,15764,75667,10364,141648,192,101,91
50800,157433,15765,75679,10365,141668,192,101,91
50805,157443,15766,75684,10366,141677,192,101,91
50810,157464,15770,75698,10369,141692,192,101,91
50815,157474,15773,75703,10372,141701,192,101,91
50820,157495,15778,75715,10377,141716,192,101,91
50825,157505,15779,75721,10378,141726,192,101,91
50830,157526,15781,75731,10379,141745,192,101,91
50835,157536,15782,75738,10380,141753,192,101,91
50840,157557,15784,75747,10381,141773,192,101,91
50845,157567,15785,75752,10382,141781,192,101,91
50850,157588,15786,75760,10383,141802,192,101,91
50855,157598,15786,75763,10383,141812,192,101,91
50860,157619,15786,75774,10383,141833,192,101,91
50865,157629,15786,75777,10383,141843,192,101,91
50870,157650,15786,75786,10383,141864,192,101,91
50875,157660,15786,75792,10383,141874,192,101,91
50880,157681,15786,75799,10383,141895,192,101,91
50885,157691,15786,75804,10383,141905,192,101,91
50890,157712,15786,75812,10383,141926,192,101,91
50895,157722,15786,75817,10383,141936,192,101,91
50900,157743,15786,75830,10383,141957,192,101,91
50905,157753,15786,75838,10383,141967,192,101,91
50910,157774,15786,75846,10383,141988,192,101,91
50915,157784,15786,75853,10383,141998,192,101,91
50920,157805,15786,75864,10383,142019,192,101,91
50925,157815,15786,75869,10383,142029,192,101,91
50930,157836,15788,75876,10384,142048,192,101,91
50935,157846,15789,75880,10384,142057,192,101,91
50940,157867,15791,75886,10385,142075,192,101,91
50945,157877,15793,75889,10387,142084,192,101,91
50950,157898,15795,75901,10389,142103,192,101,91
50955,157908,15796,75905,10390,142112,192,101,91
50960,157929,15799,75914,10391,142129,192,101,91
50965,157939,15801,75919,10393,142138,192,101,91
50970,157960,15804,75929,10394,142156,192,101,91
50975,157970,15805,75933,10395,142165,192,101,91
50980,157991,15808,75940,10396,142183,192,101,91
50985,158001,15810,75946,10397,142191,192,101,91
50990,158022,15813,75955,10398,142209,192,101,91
50995,158032,15814,75957,10398,142218,192,101,91
51000,158053,15817,75967,10400,142236,192,101,91
51005,158063,15819,75970,10401,142244,192,101,91
51010,158084,15823,75983,10403,142261,192,101,91
51015,158094,15825,75990,10405,142269,192,101,91
51020,158115,15828,75999,10407,142287,192,101,91
51025,158125,15829,76005,10408,142296,192,101,91
51030,158146,15832,76021,10410,142314,192,101,91
51035,158156,15833,76024,10410,142323,192,101,91
51040,158177,15837,76035,10413,142340,192,101,91
51045,158187,15838,76038,10413,142349,192,101,91
51050,158208,15841,76044,10415,142367,192,101,91
51055,158218,15843,76049,10417,142375,192,101,91
51060,158239,15848,76058,10420,142391,192,101,91
51065,158249,15848,76062,10420,142401,192,101,91
51070,158270,15848,76074,10420,142422,192,101,91
51075,158280,15848,76078,10420,142432,192,101,91
51080,158301,15848,76085,10420,142453,192,101,91
51085,158311,15848,76087,10420,142463,192,101,91
51090,158332,15848,76097,10420,142484,192,101,91
51095,158342,15848,76100,10420,142494,192,101,91
51100,158363,15848,76109,10420,142515,192,101,91
51105,158373,15848,76115,10420,142525,192,101,91
51110,158394,15848,76124,10420,142546,192,101,91
51115,158404,15848,76129,10420,142556,192,101,91
51120,158425,15848,76141,10420,142577,192,101,91
51125,158435,15848,76145,10420,142587,192,101,91
51130,158456,15848,76157,10420,142608,192,101,91
51135,158466,15848,76163,10420,142618,192,101,91
51140,158487,15848,76173,10420,142639,192,101,91
51145,158497,15848,76178,10420,142649,192,101,91
51150,158518,15848,76187,10420,142670,192,101,91
51155,158528,15848,76193,10420,142680,192,101,91
51160,158549,15848,76203,10420,142701,192,101,91
51165,158559,15848,76208,10420,142711,192,101,91
51170,158580,15850,76215,10421,142729,192,101,91
51175,158590,15853,76218,10423,142737,192,101,91
51180,158611,15859,76228,10426,142752,192,101,91
51185,158621,15861,76235,10427,142760,192,101,91
51190,158642,15862,76240,10427,142780,192,101,91
51195,158652,15864,76244,10428,142788,192,101,91
51200,158673,15865,76254,10428,142808,192,101,91
51205,158683,15866,76258,10428,142817,192,101,91
51210,158704,15867,76267,10428,142837,192,101,91
51215,158714,15868,76274,10429,142846,192,101,91
51220,158735,15869,76282,10429,142866,192,101,91
51225,158745,15870,76286,10429,142875,192,101,91
51230,158766,15871,76296,10430,142895,192,101,91
51235,158776,15872,76301,10430,142904,192,101,91
51240,158797,15873,76309,10430,142924,192,101,91
51245,158807,15874,76313,10430,142933,192,101,91
51250,158828,15875,76324,10431,142953,192,101,91
51255,158838,15876,76329,10432,142962,192,101,91
51260,158859,15877,76340,10433,142982,192,101,91
51265,158869,15878,76345,10433,142991,192,101,91
51270,158890,15879,76356,10433,143011,192,101,91
51275,158900,15880,76360,10434,143020,192,101,91
51280,158921,15881,76372,10434,143039,192,101,91
51285,158931,15883,76376,10435,143047,192,101,91
51290,158952,15887,76383,10437,143064,192,101,91
51295,158962,15890,76388,10439,143072,192,101,91
51300,158983,15896,76399,10443,143087,192,101,91
51305,158993,15898,76403,10444,143095,192,101,91
51310,159014,15901,76413,10446,143113,192,101,91
51315,159024,15903,76420,10447,143121,192,101,91
51320,159045,15906,76436,10450,143139,192,101,91
51325,159055,15906,76444,10450,143149,192,101,91
51330,159076,15907,76455,10451,143169,192,101,91
51335,159086,15907,76457,10451,143179,192,101,91
51340,159107,15908,76467,10451,143199,192,101,91
51345,159117,15908,76471,10451,143209,192,101,91
51350,159138,15909,76482,10451,143229,192,101,91
51355,159148,15909,76488,10451,143239,192,101,91
51360,159169,15910,76498,10451,143259,192,101,91
51365,159179,15910,76504,10451,143269,192,101,91
51370,159200,15911,76516,10451,143289,192,101,91
51375,159210,15911,76520,10451,143299,192,101,91
51380,159231,15912,76529,10452,143319,192,101,91
51385,159241,15912,76534,10452,143329,192,101,91
51390,159262,15913,76547,10452,143349,192,101,91
51395,159272,15913,76554,10452,143359,192,101,91
51400,159293,15914,76563,10452,143379,192,101,91
51405,159303,15914,76569,10452,143388,192,101,91
51410,159324,15917,76582,10455,143407,192,101,91
51415,159334,15917,76588,10455,143416,192,101,91
51420,159355,15920,76597,10457,143435,192,101,91
51425,159365,15920,76602,10457,143444,192,101,91
51430,159386,15923,76611,10459,143462,192,101,91
51435,159396,15926,76617,10462,143469,192,101,91
51440,159417,15929,76626,10464,143488,192,101,91
51445,159427,15931,76631,10466,143495,192,101,91
51450,159448,15934,76642,10469,143514,192,101,91
51455,159458,15936,76648,10471,143522,192,101,91
51460,159479,15939,76657,10473,143540,192,101,91
51465,159489,15940,76662,10473,143548,192,101,91
51470,159510,15943,76672,10474,143567,192,101,91
51475,159520,15944,76679,10475,143576,192,101,91
51480,159541,15947,76689,10477,143594,192,101,91
51485,159551,15948,76693,10477,143603,192,101,91
51490,159572,15950,76699,10477,143622,192,101,91
51495,159582,15951,76705,10478,143630,192,101,91
51500,159603,15955,76716,10481,143648,192,101,91
51505,159613,15956,76720,10481,143657,192,101,91
51510,159634,15958,76730,10483,143676,192,101,91
51515,159644,15959,76732,10483,143685,192,101,91
51520,159665,15962,76743,10485,143703,192,101,91
51525,159675,15963,76747,10486,143711,192,101,91
51530,159696,15968,76757,10491,143728,192,101,91
51535,159706,15970,76761,10493,143735,192,101,91
51540,159727,15974,76770,10495,143753,192,101,91
51545,159737,15975,76774,10496,143762,192,101,91
51550,159758,15977,76783,10497,143781,192,101,91
51555,159768,15978,76786,10497,143790,192,101,91
51560,159789,15979,76797,10497,143810,192,101,91
51565,159799,15980,76802,10497,143819,192,101,91
51570,159820,15981,76814,10498,143839,192,101,91
51575,159830,15982,76820,10498,143848,192,101,91
51580,159851,15983,76832,10499,143868,192,101,91
51585,159861,15984,76834,10499,143877,192,101,91
51590,159882,15985,76841,10500,143897,192,101,91
51595,159892,15986,76848,10501,143906,192,101,91
51600,159913,15987,76854,10502,143926,192,101,91
51605,159923,15988,76859,10502,143935,192,101,91
51610,159944,15990,76868,10504,143954,192,101,91
51615,159954,15992,76875,10505,143962,192,101,91
51620,159975,15993,76883,10505,143982,192,101,91
51625,159985,15994,76884,10505,143991,192,101,91
51630,160006,15995,76896,10505,144011,192,101,91
51635,160016,15996,76902,10505,144020,192,101,91
51640,160037,15997,76912,10505,144040,192,101,91
51645,160047,15998,76918,10505,144048,192,101,91
51650,160068,16002,76928,10509,144066,192,101,91
51655,160078,16003,76932,10510,144074,192,101,91
51660,160099,16009,76947,10515,144090,192,101,91
51665,160109,16011,76952,10517,144098,192,101,91
51670,160130,16014,76964,10520,144115,192,101,91
51675,160140,16016,76969,10521,144124,192,101,91
51680,160161,16018,76977,10523,144143,192,101,91
51685,160171,16019,76983,10523,144152,192,101,91
51690,160192,16022,76993,10524,144170,192,101,91
51695,160202,16023,76999,10525,144179,192,101,91
51700,160223,16025,77006,10525,144198,192,101,91
51705,160233,16026,77011,10526,144207,192,101,91
51710,160254,16029,77021,10528,144225,192,101,91
51715,160264,16030,77024,10529,144234,192,101,91
51720,160285,16033,77036,10532,144252,192,101,91
51725,160295,16034,77043,10533,144261,192,101,91
51730,160316,16035,77049,10533,144281,192,101,91
51735,160326,16036,77053,10534,144290,192,101,91
51740,160347,16037,77060,10534,144310,192,101,91
51745,160357,16038,77067,10535,144319,192,101,91
51750,160378,16039,77077,10536,144339,192,101,91
51755,160388,16040,77080,10536,144348,192,101,91
51760,160409,16042,77092,10538,144367,192,101,91
51765,160419,16043,77095,10539,144376,192,101,91
51770,160440,16047,77103,10541,144393,192,101,91
51775,160450,16048,77107,10542,144401,192,101,91
51780,160471,16051,77118,10544,144420,192,101,91
51785,160481,16051,77125,10544,144429,192,101,91
51790,160502,16054,77134,10545,144448,192,101,91
51795,160512,16054,77142,10545,144457,192,101,91
51800,160533,16057,77156,10548,144476,192,101,91
51805,160543,16057,77165,10548,144485,192,101,91
51810,160564,16060,77174,10550,144504,192,101,91
51815,160574,16060,77176,10550,144514,192,101,91
51820,160595,16062,77181,10550,144533,192,101,91
51825,160605,16062,77186,10550,144543,192,101,91
51830,160626,16064,77196,10551,144562,192,101,91
51835,160636,16064,77202,10551,144572,192,101,91
51840,160657,16066,77216,10552,144591,192,101,91
51845,160667,16066,77218,10552,144600,192,101,91
51850,160688,16069,77230,10554,144619,192,101,91
51855,160698,16069,77236,10554,144629,192,101,91
51860,160719,16071,77247,10556,144648,192,101,91
51865,160729,16071,77252,10556,144658,192,101,91
51870,160750,16073,77261,10556,144677,192,101,91
51875,160760,16073,77265,10556,144687,192,101,91
51880,160781,16075,77276,10556,144706,192,101,91
51885,160791,16075,77282,10556,144716,192,101,91
51890,160812,16078,77291,10557,144734,192,101,91
51895,160822,16080,77298,10559,144742,192,101,91
51900,160843,16083,77306,10561,144760,192,101,91
51905,160853,16084,77313,10562,144769,192,101,91
51910,160874,16085,77321,10563,144789,192,101,91
51915,160884,16086,77327,10564,144798,192,101,91
51920,160905,16087,77333,10565,144818,192,101,91
51925,160915,16088,77336,10565,144827,192,101,91
51930,160936,16089,77348,10566,144847,192,101,91
51935,160946,16090,77351,10566,144856,192,101,91
51940,160967,16092,77362,10568,144875,192,101,91
51945,160977,16093,77369,10568,144884,192,101,91
51950,160998,16094,77377,10568,144904,192,101,91
51955,161008,16095,77379,10568,144913,192,101,91
51960,161029,16096,77392,10569,144933,192,101,91
51965,161039,16097,77396,10569,144942,192,101,91
51970,161060,16098,77407,10570,144962,192,101,91
51975,161070,16099,77411,10570,144971,192,101,91
51980,161091,16101,77421,10572,144990,192,101,91
51985,161101,16102,77425,10573,144999,192,101,91
51990,161122,16103,77432,10574,145019,192,101,91
51995,161132,16104,77434,10574,145028,192,101,91
52000,161153,16105,77445,10574,145048,192,101,91
52005,161163,16107,77449,10575,145056,192,101,91
52010,161184,16110,77460,10576,145073,192,101,91
52015,161194,16113,77467,10578,145081,192,101,91
52020,161215,16118,77479,10582,145097,192,101,91
52025,161225,16119,77484,10582,145106,192,101,91
52030,161246,16121,77493,10583,145124,192,101,91
52035,161256,16123,77498,10585,145133,192,101,91
52040,161277,16125,77508,10585,145152,192,101,91
52045,161287,16126,77514,10585,145160,192,101,91
52050,161308,16129,77525,10587,145179,192,101,91
52055,161318,16130,77532,10588,145188,192,101,91
52060,161339,16133,77541,10589,145206,192,101,91
52065,161349,16134,77550,10589,145214,192,101,91
52070,161370,16138,77560,10591,145232,192,101,91
52075,161380,16139,77563,10592,145241,192,101,91
52080,161401,16141,77571,10592,145260,192,101,91
52085,161411,16142,77574,10592,145269,192,101,91
52090,161432,16144,77586,10592,145288,192,101,91
52095,161442,16145,77593,10592,145296,192,101,91
52100,161463,16149,77602,10596,145313,192,101,91
52105,161473,16151,77606,10597,145321,192,101,91
52110,161494,16155,77614,10601,145339,192,101,91
52115,161504,16155,77618,10601,145349,192,101,91
52120,161525,16158,77630,10602,145367,192,101,91
52125,161535,16158,77635,10602,145377,192,101,91
52130,161556,16162,77644,10605,145394,192,101,91
52135,161566,16164,77651,10607,145402,192,101,91
52140,161587,16169,77657,10610,145418,192,101,91
52145,161597,16170,77659,10610,145427,192,101,91
52150,161618,16173,77668,10612,145445,192,101,91
52155,161628,16174,77671,10612,145454,192,101,91
52160,161649,16176,77678,10613,145473,192,101,91
52165,161659,16177,77684,10613,145482,192,101,91
52170,161680,16180,77694,10616,145500,192,101,91
52175,161690,16182,77699,10618,145508,192,101,91
52180,161711,16183,77710,10618,145528,192,101,91
52185,161721,16183,77715,10618,145538,192,101,91
52190,161742,16185,77725,10619,145557,192,101,91
52195,161752,16185,77730,10619,145567,192,101,91
52200,161773,16187,77738,10620,145586,192,101,91
52205,161783,16187,77744,10620,145596,192,101,91
52210,161804,16189,77753,10622,145615,192,101,91
52215,161814,16189,77758,10622,145625,192,101,91
52220,161835,16191,77768,10623,145644,192,101,91
52225,161845,16191,77773,10623,145654,192,101,91
52230,161866,16191,77781,10623,145675,192,101,91
52235,161876,16191,77785,10623,145685,192,101,91
52240,161897,16191,77797,10623,145706,192,101,91
52245,161907,16191,77800,10623,145716,192,101,91
52250,161928,16192,77809,10623,145736,192,101,91
52255,161938,16193,77817,10624,145744,192,101,91
52260,161959,16197,77828,10628,145762,192,101,91
52265,161969,16197,77835,10628,145771,192,101,91
52270,161990,16201,77844,10631,145789,192,101,91
52275,162000,16201,77849,10631,145799,192,101,91
52280,162021,16204,77860,10633,145817,192,101,91
52285,162031,16205,77864,10633,145825,192,101,91
52290,162052,16209,77874,10636,145843,192,101,91
52295,162062,16210,77876,10636,145851,192,101,91
52300,162083,16215,77895,10641,145868,192,101,91
52305,162093,16216,77901,10642,145877,192,101,91
52310,162114,16219,77914,10644,145895,192,101,91
52315,162124,16220,77921,10645,145904,192,101,91
52320,162145,16223,77933,10646,145922,192,101,91
52325,162155,16225,77939,10648,145930,192,101,91
52330,162176,16227,77949,10650,145949,192,101,91
52335,162186,16228,77952,10650,145958,192,101,91
52340,162207,16229,77961,10650,145978,192,101,91
52345,162217,16231,77967,10652,145986,192,101,91
52350,162238,16232,77982,10652,146004,192,101,91
52355,162248,16235,77986,10654,146013,192,101,91
52360,162269,16237,77996,10656,146031,192,101,91
52365,162279,16240,78002,10659,146039,192,101,91
52370,162300,16243,78014,10661,146056,192,101,91
52375,162310,16246,78020,10663,146064,192,101,91
52380,162331,16248,78029,10664,146083,192,101,91
52385,162341,16250,78033,10665,146091,192,101,91
52390,162362,16252,78042,10667,146110,192,101,91
52395,162372,16253,78047,10668,146119,192,101,91
52400,162393,16254,78057,10669,146139,192,101,91
52405,162403,16256,78062,10671,146147,192,101,91
52410,162424,16257,78070,10671,146167,192,101,91
52415,162434,16259,78073,10673,146175,192,101,91
52420,162455,16260,78085,10673,146195,192,101,91
52425,162465,16262,78090,10675,146203,192,101,91
52430,162486,16264,78100,10676,146222,192,101,91
52435,162496,16265,78107,10677,146231,192,101,91
52440,162517,16267,78116,10677,146250,192,101,91
52445,162527,16268,78121,10677,146258,192,101,91
52450,162548,16271,78126,10679,146277,192,101,91
52455,162558,16272,78131,10679,146285,192,101,91
52460,162579,16276,78142,10683,146303,192,101,91
52465,162589,16277,78148,10684,146312,192,101,91
52470,162610,16281,78159,10687,146329,192,101,91
52475,162620,16282,78166,10688,146337,192,101,91
52480,162641,16285,78180,10691,146356,192,101,91
52485,162651,16286,78187,10691,146364,192,101,91
52490,162672,16291,78199,10694,146380,192,101,91
52495,162682,16293,78203,10695,146389,192,101,91
52500,162703,16295,78211,10696,146407,192,101,91
52505,162713,16297,78218,10698,146416,192,101,91
52510,162734,16300,78227,10700,146434,192,101,91
52515,162744,16301,78235,10701,146443,192,101,91
52520,162765,16304,78245,10702,146461,192,101,91
52525,162775,16304,78248,10702,146471,192,101,91
52530,162796,16308,78262,10706,146488,192,101,91
52535,162806,16309,78268,10707,146497,192,101,91
52540,162827,16313,78278,10711,146514,192,101,91
52545,162837,16313,78283,10711,146524,192,101,91
52550,162858,16317,78292,10714,146541,192,101,91
52555,162868,16317,78296,10714,146551,192,101,91
52560,162889,16319,78304,10715,146570,192,101,91
52565,162899,16320,78311,10716,146579,192,101,91
52570,162920,16321,78326,10716,146599,192,101,91
52575,162930,16322,78328,10716,146608,192,101,91
52580,162951,16324,78336,10717,146627,192,101,91
52585,162961,16325,78341,10717,146636,192,101,91
52590,162982,16327,78348,10718,146655,192,101,91
52595,162992,16328,78355,10719,146664,192,101,91
52600,163013,16329,78364,10720,146684,192,101,91
52605,163023,16330,78369,10721,146693,192,101,91
52610,163044,16333,78380,10723,146711,192,101,91
52615,163054,16334,78386,10724,146720,192,101,91
52620,163075,16337,78395,10725,146738,192,101,91
52625,163085,16337,78399,10725,146748,192,101,91
52630,163106,16341,78409,10728,146765,192,101,91
52635,163116,16342,78416,10729,146774,192,101,91
52640,163137,16345,78431,10732,146792,192,101,91
52645,163147,16346,78435,10733,146801,192,101,91
52650,163168,16349,78444,10735,146819,192,101,91
52655,163178,16349,78447,10735,146828,192,101,91
52660,163199,16353,78456,10737,146846,192,101,91
52665,163209,16353,78461,10737,146856,192,101,91
52670,163230,16355,78474,10739,146875,192,101,91
52675,163240,16355,78477,10739,146884,192,101,91
52680,163261,16359,78487,10742,146902,192,101,91
52685,163271,16361,78491,10743,146910,192,101,91
52690,163292,16362,78502,10744,146930,192,101,91
52695,163302,16364,78506,10745,146938,192,101,91
52700,163323,16365,78517,10746,146958,192,101,91
52705,163333,16366,78522,10747,146967,192,101,91
52710,163354,16367,78531,10748,146987,192,101,91
52715,163364,16368,78534,10748,146996,192,101,91
52720,163385,16369,78542,10748,147016,192,101,91
52725,163395,16370,78548,10749,147024,192,101,91
52730,163416,16372,78560,10750,147044,192,101,91
52735,163426,16373,78562,10750,147053,192,101,91
52740,163447,16375,78574,10752,147072,192,101,91
52745,163457,16377,78580,10753,147080,192,101,91
52750,163478,16379,78590,10754,147099,192,101,91
52755,163488,16380,78593,10755,147108,192,101,91
52760,163509,16382,78605,10757,147127,192,101,91
52765,163519,16383,78611,10757,147136,192,101,91
52770,163540,16385,78620,10758,147155,192,101,91
52775,163550,16386,78625,10759,147164,192,101,91
52780,163571,16389,78636,10762,147182,192,101,91
52785,163581,16390,78641,10762,147191,192,101,91
52790,163602,16393,78652,10764,147209,192,101,91
52795,163612,16395,78661,10766,147217,192,101,91
52800,163633,16398,78675,10768,147235,192,101,91
52805,163643,16399,78682,10769,147244,192,101,91
52810,163664,16403,78693,10771,147261,192,101,91
52815,163674,16404,78700,10772,147270,192,101,91
52820,163695,16408,78711,10775,147287,192,101,91
52825,163705,16409,78719,10776,147296,192,101,91
52830,163726,16412,78727,10778,147314,192,101,91
52835,163736,16412,78730,10778,147324,192,101,91
52840,163757,16416,78746,10782,147341,192,101,91
52845,163767,16416,78752,10782,147351,192,101,91
52850,163788,16419,78762,10784,147369,192,101,91
52855,163798,16419,78766,10784,147378,192,101,91
52860,163819,16424,78780,10788,147395,192,101,91
52865,163829,16424,78785,10788,147404,192,101,91
52870,163850,16428,78793,10790,147422,192,101,91
52875,163860,16428,78799,10790,147431,192,101,91
52880,163881,16431,78811,10791,147450,192,101,91
52885,163891,16431,78816,10791,147460,192,101,91
52890,163912,16434,78824,10794,147478,192,101,91
52895,163922,16434,78825,10794,147488,192,101,91
52900,163943,16436,78831,10794,147507,192,101,91
52905,163953,16436,78837,10794,147517,192,101,91
52910,163974,16440,78848,10796,147534,192,101,91
52915,163984,16441,78854,10797,147542,192,101,91
52920,164005,16445,78863,10800,147560,192,101,91
52925,164015,16446,78867,10800,147569,192,101,91
52930,164036,16447,78875,10801,147588,192,101,91
52935,164046,16450,78881,10804,147596,192,101,91
52940,164067,16450,78890,10804,147617,192,101,91
52945,164077,16451,78892,10804,147626,192,101,91
52950,164098,16451,78902,10804,147647,192,101,91
52955,164108,16452,78906,10805,147656,192,101,91
52960,164129,16453,78917,10806,147676,192,101,91
52965,164139,16454,78925,10807,147685,192,101,91
52970,164160,16455,78933,10808,147705,192,101,91
52975,164170,16456,78938,10809,147714,192,101,91
52980,164191,16457,78951,10810,147734,192,101,91
52985,164201,16458,78959,10811,147743,192,101,91
52990,164222,16460,78965,10813,147762,192,101,91
52995,164232,16461,78971,10814,147771,192,101,91
53000,164253,16464,78984,10817,147789,192,101,91
53005,164263,16465,78988,10817,147798,192,101,91
53010,164284,16467,78998,10819,147817,192,101,91
53015,164294,16468,79005,10820,147826,192,101,91
53020,164315,16469,79014,10821,147846,192,101,91
53025,164325,16470,79022,10821,147855,192,101,91
53030,164346,16474,79026,10822,147872,192,101,91
53035,164356,16475,79033,10823,147881,192,101,91
53040,164377,16480,79040,10825,147896,192,101,91
53045,164387,16482,79044,10827,147905,192,101,91
53050,164408,16485,79054,10829,147923,192,101,91
53055,164418,16485,79061,10829,147932,192,101,91
53060,164439,16489,79072,10831,147950,192,101,91
53065,164449,16489,79077,10831,147959,192,101,91
53070,164470,16493,79088,10834,147977,192,101,91
53075,164480,16493,79093,10834,147987,192,101,91
53080,164501,16496,79105,10836,148005,192,101,91
53085,164511,16496,79113,10836,148014,192,101,91
53090,164532,16500,79120,10838,148032,192,101,91
53095,164542,16500,79126,10838,148041,192,101,91
53100,164563,16504,79140,10840,148059,192,101,91
53105,164573,16505,79145,10840,148067,192,101,91
53110,164594,16510,79158,10844,148083,192,101,91
53115,164604,16512,79163,10845,148091,192,101,91
53120,164625,16516,79170,10848,148109,192,101,91
53125,164635,16517,79175,10848,148117,192,101,91
53130,164656,16521,79182,10850,148135,192,101,91
53135,164666,16522,79186,10850,148144,192,101,91
53140,164687,16525,79194,10852,148162,192,101,91
53145,164697,16526,79198,10853,148171,192,101,91
53150,164718,16530,79212,10857,148188,192,101,91
53155,164728,16531,79217,10857,148196,192,101,91
53160,164749,16536,79227,10862,148213,192,101,91
53165,164759,16537,79233,10863,148222,192,101,91
53170,164780,16539,79241,10863,148241,192,101,91
53175,164790,16541,79245,10864,148249,192,101,91
53180,164811,16543,79251,10865,148268,192,101,91
53185,164821,16544,79252,10865,148277,192,101,91
53190,164842,16547,79263,10868,148295,192,101,91
53195,164852,16548,79269,10868,148304,192,101,91
53200,164873,16552,79279,10871,148321,192,101,91
53205,164883,16553,79283,10872,148330,192,101,91
53210,164904,16556,79293,10873,148348,192,101,91
53215,164914,16557,79297,10873,148357,192,101,91
53220,164935,16558,79307,10874,148377,192,101,91
53225,164945,16559,79310,10874,148386,192,101,91
53230,164966,16561,79321,10875,148405,192,101,91
53235,164976,16562,79326,10875,148414,192,101,91
53240,164997,16563,79338,10875,148434,192,101,91
53245,165007,16564,79343,10876,148443,192,101,91
53250,165028,16566,79352,10877,148462,192,101,91
53255,165038,16567,79354,10877,148471,192,101,91
53260,165059,16568,79364,10878,148491,192,101,91
53265,165069,16569,79369,10878,148500,192,101,91
53270,165090,16571,79378,10879,148518,192,101,91
53275,165100,16573,79381,10881,148527,192,101,91
53280,165121,16577,79395,10884,148543,192,101,91
53285,165131,16578,79402,10885,148553,192,101,91
53290,165152,16581,79412,10888,148571,192,101,91
53295,165162,16581,79419,10888,148581,192,101,91
53300,165183,16584,79426,10888,148599,192,101,91
53305,165193,16584,79432,10888,148609,192,101,91
53310,165214,16587,79440,10888,148627,192,101,91
53315,165224,16587,79447,10888,148637,192,101,91
53320,165245,16590,79454,10889,148655,192,101,91
53325,165255,16590,79459,10889,148665,192,101,91
53330,165276,16593,79472,10890,148683,192,101,91
53335,165286,16593,79476,10890,148693,192,101,91
53340,165307,16596,79486,10890,148711,192,101,91
53345,165317,16596,79492,10890,148721,192,101,91
53350,165338,16599,79502,10892,148739,192,101,91
53355,165348,16599,79507,10892,148749,192,101,91
53360,165369,16602,79521,10895,148767,192,101,91
53365,165379,16602,79526,10895,148777,192,101,91
53370,165400,16605,79536,10895,148795,192,101,91
53375,165410,16605,79540,10895,148805,192,101,91
53380,165431,16608,79547,10895,148823,192,101,91
53385,165441,16608,79548,10895,148833,192,101,91
53390,165462,16613,79554,10897,148848,192,101,91
53395,165472,16615,79559,10898,148856,192,101,91
53400,165493,16621,79571,10903,148871,192,101,91
53405,165503,16622,79576,10904,148881,192,101,91
53410,165524,16622,79584,10904,148902,192,101,91
53415,165534,16622,79588,10904,148912,192,101,91
53420,165555,16622,79592,10904,148933,192,101,91
53425,165565,16622,79597,10904,148943,192,101,91
53430,165586,16622,79608,10904,148964,192,101,91
53435,165596,16622,79611,10904,148974,192,101,91
53440,165617,16622,79621,10904,148995,192,101,91
53445,165627,16622,79625,10904,149005,192,101,91
53450,165648,16622,79634,10904,149026,192,101,91
53455,165658,16622,79637,10904,149036,192,101,91
53460,165679,16622,79646,10904,149057,192,101,91
53465,165689,16622,79650,10904,149067,192,101,91
53470,165710,16622,79661,10904,149088,192,101,91
53475,165720,16622,79665,10904,149098,192,101,91
53480,165741,16622,79680,10904,149119,192,101,91
53485,165751,16622,79688,10904,149129,192,101,91
53490,165772,16622,79696,10904,149150,192,101,91
53495,165782,16622,79701,10904,149160,192,101,91
53500,165803,16622,79709,10904,149181,192,101,91
53505,165813,16623,79715,10905,149190,192,101,91
53510,165834,16624,79724,10905,149210,192,101,91
53515,165844,16625,79729,10905,149219,192,101,91
53520,165865,16629,79740,10908,149235,192,101,91
53525,165875,16631,79744,10910,149244,192,101,91
53530,165896,16633,79759,10911,149263,192,101,91
53535,165906,16633,79764,10911,149273,192,101,91
53540,165927,16634,79774,10911,149293,192,101,91
53545,165937,16634,79780,10911,149303,192,101,91
53550,165958,16635,79792,10912,149323,192,101,91
53555,165968,16635,79799,10912,149333,192,101,91
53560,165989,16636,79809,10913,149353,192,101,91
53565,165999,16636,79815,10913,149363,192,101,91
53570,166020,16637,79823,10913,149383,192,101,91
53575,166030,16637,79829,10913,149393,192,101,91
53580,166051,16638,79845,10914,149413,192,101,91
53585,166061,16638,79848,10914,149423,192,101,91
53590,166082,16639,79858,10915,149443,192,101,91
53595,166092,16639,79862,10915,149453,192,101,91
53600,166113,16640,79869,10916,149473,192,101,91
53605,166123,16640,79874,10916,149483,192,101,91
53610,166144,16641,79882,10917,149503,192,101,91
53615,166154,16641,79890,10917,149513,192,101,91
53620,166175,16642,79899,10918,149533,192,101,91
53625,166185,16642,79903,10918,149543,192,101,91
53630,166206,16646,79914,10920,149559,192,101,91
53635,166216,16648,79921,10922,149567,192,101,91
53640,166237,16654,79931,10927,149582,192,101,91
53645,166247,16655,79935,10928,149592,192,101,91
53650,166268,16657,79948,10929,149611,192,101,91
53655,166278,16657,79953,10929,149620,192,101,91
53660,166299,16660,79967,10931,149639,192,101,91
53665,166309,16660,79972,10931,149649,192,101,91
53670,166330,16662,79985,10933,149668,192,101,91
53675,166340,16662,79989,10933,149678,192,101,91
53680,166361,16663,79999,10934,149698,192,101,91
53685,166371,16663,80005,10934,149708,192,101,91
53690,166392,16664,80012,10935,149728,192,101,91
53695,166402,16664,80017,10935,149738,192,101,91
53700,166423,16665,80025,10935,149758,192,101,91
53705,166433,16666,80031,10936,149767,192,101,91
53710,166454,16669,80039,10939,149785,192,101,91
53715,166464,16669,80046,10939,149795,192,101,91
53720,166485,16671,80060,10940,149814,192,101,91
53725,166495,16671,80062,10940,149824,192,101,91
53730,166516,16673,80072,10941,149843,192,101,91
53735,166526,16674,80076,10942,149852,192,101,91
53740,166547,16677,80089,10944,149870,192,101,91
53745,166557,16678,80091,10945,149879,192,101,91
53750,166578,16682,80104,10947,149895,192,101,91
53755,166588,16684,80108,10949,149904,192,101,91
53760,166609,16687,80115,10952,149922,192,101,91
53765,166619,16688,80120,10953,149931,192,101,91
53770,166640,16690,80135,10955,149950,192,101,91
53775,166650,16691,80138,10955,149959,192,101,91
53780,166671,16692,80145,10956,149979,192,101,91
53785,166681,16693,80149,10957,149988,192,101,91
53790,166702,16694,80159,10957,150008,192,101,91
53795,166712,16695,80163,10957,150017,192,101,91
53800,166733,16696,80173,10958,150037,192,101,91
53805,166743,16697,80181,10958,150045,192,101,91
53810,166764,16699,80192,10960,150065,192,101,91
53815,166774,16700,80198,10961,150074,192,101,91
53820,166795,16701,80210,10962,150094,192,101,91
53825,166805,16702,80214,10963,150103,192,101,91
53830,166826,16702,80223,10963,150124,192,101,91
53835,166836,16703,80227,10964,150133,192,101,91
53840,166857,16703,80242,10964,150154,192,101,91
53845,166867,16704,80244,10964,150163,192,101,91
53850,166888,16704,80252,10964,150184,192,101,91
53855,166898,16705,80256,10964,150193,192,101,91
53860,166919,16705,80264,10964,150214,192,101,91
53865,166929,16706,80267,10965,150222,192,101,91
53870,166950,16711,80280,10969,150239,192,101,91
53875,166960,16712,80288,10970,150247,192,101,91
53880,166981,16716,80298,10973,150265,192,101,91
53885,166991,16716,80302,10973,150275,192,101,91
53890,167012,16719,80310,10974,150293,192,101,91
53895,167022,16720,80315,10975,150302,192,101,91
53900,167043,16724,80326,10977,150319,192,101,91
53905,167053,16724,80330,10977,150329,192,101,91
53910,167074,16728,80343,10981,150346,192,101,91
53915,167084,16729,80352,10982,150355,192,101,91
53920,167105,16733,80362,10985,150372,192,101,91
53925,167115,16733,80365,10985,150382,192,101,91
53930,167136,16737,80376,10987,150399,192,101,91
53935,167146,16737,80380,10987,150409,192,101,91
53940,167167,16741,80392,10989,150426,192,101,91
53945,167177,16741,80398,10989,150436,192,101,91
53950,167198,16744,80408,10991,150454,192,101,91
53955,167208,16744,80413,10991,150464,192,101,91
53960,167229,16747,80420,10993,150482,192,101,91
53965,167239,16747,80426,10993,150492,192,101,91
53970,167260,16750,80439,10995,150510,192,101,91
53975,167270,16750,80445,10995,150520,192,101,91
53980,167291,16752,80459,10997,150539,192,101,91
53985,167301,16752,80462,10997,150549,192,101,91
53990,167322,16754,80470,10999,150568,192,101,91
53995,167332,16755,80473,10999,150577,192,101,91
54000,167353,16757,80479,11001,150596,192,101,91
54005,167363,16759,80482,11002,150604,192,101,91
54010,167384,16761,80490,11002,150623,192,101,91
54015,167394,16763,80497,11004,150630,192,101,91
54020,167415,16766,80507,11006,150648,192,101,91
54025,167425,16768,80512,11008,150656,192,101,91
54030,167446,16772,80522,11010,150673,192,101,91
54035,167456,16773,80526,11011,150682,192,101,91
54040,167477,16776,80534,11013,150701,192,101,91
54045,167487,16776,80537,11013,150710,192,101,91
54050,167508,16780,80548,11016,150728,192,101,91
54055,167518,16781,80552,11017,150737,192,101,91
54060,167539,16782,80559,11018,150757,192,101,91
54065,167549,16782,80564,11018,150766,192,101,91
54070,167570,16784,80576,11020,150786,192,101,91
54075,167580,16784,80582,11020,150796,192,101,91
54080,167601,16785,80596,11021,150816,192,101,91
54085,167611,16785,80600,11021,150826,192,101,91
54090,167632,16786,80608,11022,150846,192,101,91
54095,167642,16786,80615,11022,150856,192,101,91
54100,167663,16788,80626,11023,150875,192,101,91
54105,167673,16788,80628,11023,150885,192,101,91
54110,167694,16790,80635,11025,150904,192,101,91
54115,167704,16790,80639,11025,150914,192,101,91
54120,167725,16794,80648,11028,150931,192,101,91
54125,167735,16796,80654,11029,150939,192,101,91
54130,167756,16800,80662,11031,150956,192,101,91
54135,167766,16802,80668,11032,150964,192,101,91
54140,167787,16805,80679,11033,150982,192,101,91
54145,167797,16806,80681,11033,150991,192,101,91
54150,167818,16810,80694,11036,151008,192,101,91
54155,167828,16811,80697,11037,151017,192,101,91
54160,167849,16813,80707,11039,151036,192,101,91
54165,167859,16814,80713,11040,151045,192,101,91
54170,167880,16817,80725,11043,151063,192,101,91
54175,167890,16818,80728,11044,151072,192,101,91
54180,167911,16820,80735,11046,151091,192,101,91
54185,167921,16821,80740,11046,151100,192,101,91
54190,167942,16825,80753,11050,151117,192,101,91
54195,167952,16826,80758,11051,151126,192,101,91
54200,167973,16826,80768,11051,151147,192,101,91
54205,167983,16827,80770,11051,151156,192,101,91
54210,168004,16827,80780,11051,151177,192,101,91
54215,168014,16828,80787,11052,151186,192,101,91
54220,168035,16828,80795,11052,151207,192,101,91
54225,168045,16829,80801,11053,151216,192,101,91
54230,168066,16830,80812,11054,151236,192,101,91
54235,168076,16831,80814,11055,151244,192,101,91
54240,168097,16833,80821,11056,151264,192,101,91
54245,168107,16834,80824,11056,151273,192,101,91
54250,168128,16837,80836,11058,151291,192,101,91
54255,168138,16838,80839,11059,151300,192,101,91
54260,168159,16841,80848,11059,151318,192,101,91
54265,168169,16842,80853,11060,151327,192,101,91
54270,168190,16845,80860,11061,151345,192,101,91
54275,168200,16846,80864,11061,151354,192,101,91
54280,168221,16849,80873,11064,151372,192,101,91
54285,168231,16850,80880,11065,151381,192,101,91
54290,168252,16853,80890,11066,151399,192,101,91
54295,168262,16854,80895,11066,151408,192,101,91
54300,168283,16857,80905,11067,151426,192,101,91
54305,168293,16858,80909,11067,151435,192,101,91
54310,168314,16861,80921,11068,151453,192,101,91
54315,168324,16862,80926,11068,151462,192,101,91
54320,168345,16865,80936,11070,151480,192,101,91
54325,168355,16866,80938,11071,151489,192,101,91
54330,168376,16869,80949,11073,151507,192,101,91
54335,168386,16870,80954,11073,151516,192,101,91
54340,168407,16873,80963,11074,151534,192,101,91
54345,168417,16874,80968,11074,151543,192,101,91
54350,168438,16879,80978,11078,151558,192,101,91
54355,168448,16881,80985,11080,151566,192,101,91
54360,168469,16888,80996,11086,151580,192,101,91
54365,168479,16889,81002,11087,151590,192,101,91
54370,168500,16889,81017,11087,151611,192,101,91
54375,168510,16889,81020,11087,151621,192,101,91
54380,168531,16889,81028,11087,151642,192,101,91
54385,168541,16889,81033,11087,151652,192,101,91
54390,168562,16889,81043,11087,151673,192,101,91
54395,168572,16889,81048,11087,151683,192,101,91
54400,168593,16889,81058,11087,151704,192,101,91
54405,168603,16889,81062,11087,151714,192,101,91
54410,168624,16889,81073,11087,151735,192,101,91
54415,168634,16889,81079,11087,151745,192,101,91
54420,168655,16889,81091,11087,151766,192,101,91
54425,168665,16889,81097,11087,151776,192,101,91
54430,168686,16889,81110,11087,151797,192,101,91
54435,168696,16889,81114,11087,151807,192,101,91
54440,168717,16889,81121,11087,151828,192,101,91
54445,168727,16889,81122,11087,151838,192,101,91
54450,168748,16889,81129,11087,151859,192,101,91
54455,168758,16889,81136,11087,151869,192,101,91
54460,168779,16889,81141,11087,151890,192,101,91
54465,168789,16889,81145,11087,151900,192,101,91
54470,168810,16892,81156,11089,151918,192,101,91
54475,168820,16894,81163,11091,151926,192,101,91
54480,168841,16899,81177,11095,151940,192,101,91
54485,168851,16901,81182,11097,151949,192,101,91
54490,168872,16904,81188,11098,151968,192,101,91
54495,168882,16904,81194,11098,151977,192,101,91
54500,168903,16907,81208,11100,151996,192,101,91
54505,168913,16907,81214,11100,152006,192,101,91
54510,168934,16909,81228,11101,152025,192,101,91
54515,168944,16909,81231,11101,152035,192,101,91
54520,168965,16911,81241,11102,152054,192,101,91
54525,168975,16911,81243,11102,152064,192,101,91
54530,168996,16913,81254,11103,152083,192,101,91
54535,169006,16913,81258,11103,152093,192,101,91
54540,169027,16915,81270,11104,152112,192,101,91
54545,169037,16915,81274,11104,152121,192,101,91
54550,169058,16918,81285,11107,152140,192,101,91
54555,169068,16918,81288,11107,152150,192,101,91
54560,169089,16920,81300,11107,152169,192,101,91
54565,169099,16920,81305,11107,152179,192,101,91
54570,169120,16922,81317,11108,152198,192,101,91
54575,169130,16922,81321,11108,152208,192,101,91
54580,169151,16924,81330,11109,152227,192,101,91
54585,169161,16924,81335,11109,152237,192,101,91
54590,169182,16928,81344,11110,152254,192,101,91
54595,169192,16930,81349,11111,152261,192,101,91
54600,169213,16936,81359,11115,152277,192,101,91
54605,169223,16938,81367,11117,152285,192,101,91
54610,169244,16939,81374,11118,152304,192,101,91
54615,169254,16942,81381,11120,152312,192,101,91
54620,169275,16943,81387,11120,152332,192,101,91
54625,169285,16945,81394,11121,152340,192,101,91
54630,169306,16946,81403,11122,152360,192,101,91
54635,169316,16948,81406,11123,152368,192,101,91
54640,169337,16950,81419,11125,152386,192,101,91
54645,169347,16952,81421,11126,152395,192,101,91
54650,169368,16953,81429,11127,152415,192,101,91
54655,169378,16954,81434,11128,152424,192,101,91
54660,169399,16955,81442,11128,152444,192,101,91
54665,169409,16956,81448,11128,152453,192,101,91
54670,169430,16957,81457,11129,152473,192,101,91
54675,169440,16958,81463,11130,152482,192,101,91
54680,169461,16959,81477,11130,152502,192,101,91
54685,169471,16960,81484,11130,152511,192,101,91
54690,169492,16961,81492,11130,152531,192,101,91
54695,169502,16962,81497,11131,152540,192,101,91
54700,169523,16963,81508,11131,152560,192,101,91
54705,169533,16964,81515,11131,152568,192,101,91
54710,169554,16968,81523,11133,152586,192,101,91
54715,169564,16969,81527,11133,152595,192,101,91
54720,169585,16973,81536,11135,152612,192,101,91
54725,169595,16974,81539,11135,152621,192,101,91
54730,169616,16977,81549,11138,152639,192,101,91
54735,169626,16979,81556,11139,152647,192,101,91
54740,169647,16982,81565,11142,152665,192,101,91
54745,169657,16984,81571,11144,152673,192,101,91
54750,169678,16986,81579,11145,152692,192,101,91
54755,169688,16988,81584,11146,152700,192,101,91
54760,169709,16990,81594,11147,152719,192,101,91
54765,169719,16991,81599,11148,152728,192,101,91
54770,169740,16993,81612,11150,152747,192,101,91
54775,169750,16994,81617,11151,152756,192,101,91
54780,169771,16995,81621,11151,152776,192,101,91
54785,169781,16996,81628,11151,152785,192,101,91
54790,169802,17000,81638,11155,152802,192,101,91
54795,169812,17001,81644,11156,152811,192,101,91
54800,169833,17004,81653,11157,152829,192,101,91
54805,169843,17005,81659,11158,152838,192,101,91
54810,169864,17008,81671,11160,152856,192,101,91
54815,169874,17009,81676,11160,152865,192,101,91
54820,169895,17012,81686,11160,152883,192,101,91
54825,169905,17013,81689,11160,152892,192,101,91
54830,169926,17016,81697,11162,152910,192,101,91
54835,169936,17018,81702,11164,152917,192,101,91
54840,169957,17022,81710,11166,152934,192,101,91
54845,169967,17023,81716,11167,152944,192,101,91
54850,169988,17023,81727,11167,152965,192,101,91
54855,169998,17023,81730,11167,152975,192,101,91
54860,170019,17023,81739,11167,152996,192,101,91
54865,170029,17023,81744,11167,153006,192,101,91
54870,170050,17023,81758,11167,153027,192,101,91
54875,170060,17023,81763,11167,153037,192,101,91
54880,170081,17023,81774,11167,153058,192,101,91
54885,170091,17023,81781,11167,153068,192,101,91
54890,170112,17023,81792,11167,153089,192,101,91
54895,170122,17023,81796,11167,153099,192,101,91
54900,170143,17023,81808,11167,153120,192,101,91
54905,170153,17023,81813,11167,153130,192,101,91
54910,170174,17023,81822,11167,153151,192,101,91
54915,170184,17023,81824,11167,153161,192,101,91
54920,170205,17023,81833,11167,153182,192,101,91
54925,170215,17023,81838,11167,153192,192,101,91
54930,170236,17023,81852,11167,153213,192,101,91
54935,170246,17023,81857,11167,153223,192,101,91
54940,170267,17023,81868,11167,153244,192,101,91
54945,170277,17023,81876,11167,153254,192,101,91
54950,170298,17027,81887,11170,153271,192,101,91
54955,170308,17029,81894,11172,153279,192,101,91
54960,170329,17033,81900,11175,153296,192,101,91
54965,170339,17035,81908,11177,153304,192,101,91
54970,170360,17038,81919,11179,153322,192,101,91
54975,170370,17039,81921,11179,153330,192,101,91
54980,170391,17044,81933,11184,153347,192,101,91
54985,170401,17045,81937,11185,153356,192,101,91
54990,170422,17048,81947,11187,153374,192,101,91
54995,170432,17049,81952,11188,153383,192,101,91
55000,170453,17052,81962,11189,153401,192,101,91
55005,170463,17053,81965,11189,153410,192,101,91
55010,170484,17056,81979,11191,153428,192,101,91
55015,170494,17057,81983,11192,153436,192,101,91
55020,170515,17061,81993,11193,153454,192,101,91
55025,170525,17062,81999,11193,153462,192,101,91
55030,170546,17065,82013,11195,153481,192,101,91
55035,170556,17066,82017,11195,153490,192,101,91
55040,170577,17068,82026,11196,153509,192,101,91
55045,170587,17069,82028,11196,153518,192,101,91
55050,170608,17071,82039,11196,153537,192,101,91
55055,170618,17072,82043,11196,153545,192,101,91
55060,170639,17075,82054,11198,153564,192,101,91
55065,170649,17076,82057,11198,153573,192,101,91
55070,170670,17078,82062,11199,153592,192,101,91
55075,170680,17079,82070,11199,153600,192,101,91
55080,170701,17083,82082,11202,153618,192,101,91
55085,170711,17085,82088,11203,153626,192,101,91
55090,170732,17089,82099,11206,153643,192,101,91
55095,170742,17091,82103,11207,153651,192,101,91
55100,170763,17095,82112,11210,153668,192,101,91
55105,170773,17097,82119,11212,153676,192,101,91
55110,170794,17101,82128,11214,153692,192,101,91
55115,170804,17103,82132,11215,153701,192,101,91
55120,170825,17108,82147,11220,153715,192,101,91
55125,170835,17112,82154,11224,153723,192,101,91
55130,170856,17114,82169,11226,153742,192,101,91
55135,170866,17114,82173,11226,153752,192,101,91
55140,170887,17115,82181,11226,153772,192,101,91
55145,170897,17115,82186,11226,153782,192,101,91
55150,170918,17116,82197,11226,153802,192,101,91
55155,170928,17116,82203,11226,153812,192,101,91
55160,170949,17117,82212,11227,153832,192,101,91
55165,170959,17117,82214,11227,153842,192,101,91
55170,170980,17118,82225,11227,153862,192,101,91
55175,170990,17118,82230,11227,153872,192,101,91
55180,171011,17119,82238,11228,153892,192,101,91
55185,171021,17119,82243,11228,153902,192,101,91
55190,171042,17121,82252,11229,153921,192,101,91
55195,171052,17121,82258,11229,153930,192,101,91
55200,171073,17124,82267,11231,153949,192,101,91
55205,171083,17125,82271,11232,153958,192,101,91
55210,171104,17129,82283,11233,153975,192,101,91
55215,171114,17129,82285,11233,153985,192,101,91
55220,171135,17132,82294,11235,154003,192,101,91
55225,171145,17132,82300,11235,154012,192,101,91
55230,171166,17137,82313,11239,154029,192,101,91
55235,171176,17138,82319,11239,154037,192,101,91
55240,171197,17143,82328,11242,154053,192,101,91
55245,171207,17146,82332,11244,154061,192,101,91
55250,171228,17151,82340,11246,154076,192,101,91
55255,171238,17153,82343,11247,154084,192,101,91
55260,171259,17159,82358,11253,154100,192,101,91
55265,171269,17161,82363,11255,154108,192,101,91
55270,171290,17163,82376,11256,154127,192,101,91
55275,171300,17165,82381,11258,154135,192,101,91
55280,171321,17166,82393,11258,154155,192,101,91
55285,171331,17167,82397,11258,154164,192,101,91
55290,171352,17168,82406,11259,154184,192,101,91
55295,171362,17169,82409,11260,154193,192,101,91
55300,171383,17169,82419,11260,154214,192,101,91
55305,171393,17170,82423,11260,154223,192,101,91
55310,171414,17170,82434,11260,154244,192,101,91
55315,171424,17171,82436,11260,154253,192,101,91
55320,171445,17171,82446,11260,154274,192,101,91
55325,171455,17172,82449,11260,154283,192,101,91
55330,171476,17172,82458,11260,154304,192,101,91
55335,171486,17173,82463,11261,154313,192,101,91
55340,171507,17173,82474,11261,154334,192,101,91
55345,171517,17174,82478,11261,154343,192,101,91
55350,171538,17174,82488,11261,154364,192,101,91
55355,171548,17175,82492,11261,154373,192,101,91
55360,171569,17175,82503,11261,154394,192,101,91
55365,171579,17176,82509,11262,154402,192,101,91
55370,171600,17180,82522,11265,154419,192,101,91
55375,171610,17183,82526,11267,154427,192,101,91
55380,171631,17188,82539,11272,154442,192,101,91
55385,171641,17189,82545,11273,154451,192,101,91
55390,171662,17193,82552,11275,154469,192,101,91
55395,171672,17193,82558,11275,154478,192,101,91
55400,171693,17196,82566,11277,154497,192,101,91
55405,171703,17196,82569,11277,154506,192,101,91
55410,171724,17200,82578,11280,154524,192,101,91
55415,171734,17200,82582,11280,154533,192,101,91
55420,171755,17204,82594,11283,154551,192,101,91
55425,171765,17204,82597,11283,154561,192,101,91
55430,171786,17206,82605,11285,154580,192,101,91
55435,171796,17206,82610,11285,154590,192,101,91
55440,171817,17208,82618,11286,154609,192,101,91
55445,171827,17209,82624,11287,154618,192,101,91
55450,171848,17212,82634,11289,154636,192,101,91
55455,171858,17213,82639,11290,154645,192,101,91
55460,171879,17215,82647,11290,154664,192,101,91
55465,171889,17216,82652,11290,154673,192,101,91
55470,171910,17218,82665,11291,154691,192,101,91
55475,171920,17220,82671,11293,154700,192,101,91
55480,171941,17223,82683,11294,154717,192,101,91
55485,171951,17225,82687,11295,154726,192,101,91
55490,171972,17228,82693,11295,154744,192,101,91
55495,171982,17229,82700,11296,154753,192,101,91
55500,172003,17232,82710,11297,154771,192,101,91
55505,172013,17233,82717,11298,154780,192,101,91
55510,172034,17234,82725,11299,154800,192,101,91
55515,172044,17235,82729,11300,154809,192,101,91
55520,172065,17237,82741,11301,154828,192,101,91
55525,172075,17238,82746,11302,154837,192,101,91
55530,172096,17239,82755,11303,154857,192,101,91
55535,172106,17239,82757,11303,154867,192,101,91
55540,172127,17240,82766,11303,154887,192,101,91
55545,172137,17240,82771,11303,154897,192,101,91
55550,172158,17241,82782,11304,154917,192,101,91
55555,172168,17241,82789,11304,154927,192,101,91
55560,172189,17242,82797,11304,154947,192,101,91
55565,172199,17244,82805,11306,154955,192,101,91
55570,172220,17246,82815,11307,154974,192,101,91
55575,172230,17248,82823,11309,154981,192,101,91
55580,172251,17251,82837,11311,154999,192,101,91
55585,172261,17254,82842,11314,155007,192,101,91
55590,172282,17256,82849,11315,155026,192,101,91
55595,172292,17258,82852,11316,155033,192,101,91
55600,172313,17261,82862,11317,155051,192,101,91
55605,172323,17264,82867,11319,155058,192,101,91
55610,172344,17269,82878,11322,155074,192,101,91
55615,172354,17272,82882,11324,155081,192,101,91
55620,172375,17277,82894,11329,155098,192,101,91
55625,172385,17278,82901,11330,155107,192,101,91
55630,172406,17282,82912,11333,155124,192,101,91
55635,172416,17283,82916,11334,155133,192,101,91
55640,172437,17288,82927,11338,155149,192,101,91
55645,172447,17289,82933,11339,155157,192,101,91
55650,172468,17295,82943,11344,155173,192,101,91
55655,172478,17296,82948,11344,155182,192,101,91
55660,172499,17298,82962,11345,155201,192,101,91
55665,172509,17299,82967,11346,155209,192,101,91
55670,172530,17301,82975,11347,155229,192,101,91
55675,172540,17302,82979,11348,155238,192,101,91
55680,172561,17304,82985,11349,155257,192,101,91
55685,172571,17304,82988,11349,155267,192,101,91
55690,172592,17305,82999,11350,155287,192,101,91
55695,172602,17305,83005,11350,155297,192,101,91
55700,172623,17306,83014,11351,155317,192,101,91
55705,172633,17306,83019,11351,155327,192,101,91
55710,172654,17307,83026,11351,155347,192,101,91
55715,172664,17307,83030,11351,155357,192,101,91
55720,172685,17308,83040,11351,155377,192,101,91
55725,172695,17308,83044,11351,155387,192,101,91
55730,172716,17311,83053,11353,155405,192,101,91
55735,172726,17311,83059,11353,155415,192,101,91
55740,172747,17313,83067,11353,155434,192,101,91
55745,172757,17313,83072,11353,155443,192,101,91
55750,172778,17316,83082,11356,155462,192,101,91
55755,172788,17316,83088,11356,155471,192,101,91
55760,172809,17320,83100,11359,155489,192,101,91
55765,172819,17320,83103,11359,155499,192,101,91
55770,172840,17323,83115,11362,155517,192,101,91
55775,172850,17323,83121,11362,155527,192,101,91
55780,172871,17326,83133,11365,155545,192,101,91
55785,172881,17326,83138,11365,155555,192,101,91
55790,172902,17330,83145,11367,155572,192,101,91
55795,172912,17332,83149,11368,155580,192,101,91
55800,172933,17336,83162,11370,155597,192,101,91
55805,172943,17338,83170,11372,155605,192,101,91
55810,172964,17340,83178,11373,155624,192,101,91
55815,172974,17341,83185,11374,155633,192,101,91
55820,172995,17344,83194,11376,155651,192,101,91
55825,173005,17346,83201,11378,155659,192,101,91
55830,173026,17349,83211,11380,155677,192,101,91
55835,173036,17350,83215,11380,155686,192,101,91
55840,173057,17352,83224,11381,155704,192,101,91
55845,173067,17354,83229,11383,155713,192,101,91
55850,173088,17357,83244,11386,155731,192,101,91
55855,173098,17358,83248,11386,155740,192,101,91
55860,173119,17361,83258,11387,155757,192,101,91
55865,173129,17363,83262,11389,155766,192,101,91
55870,173150,17366,83272,11391,155784,192,101,91
55875,173160,17367,83275,11391,155793,192,101,91
55880,173181,17370,83282,11393,155811,192,101,91
55885,173191,17371,83287,11394,155820,192,101,91
55890,173212,17374,83297,11397,155838,192,101,91
55895,173222,17375,83303,11398,155847,192,101,91
55900,173243,17378,83316,11401,155865,192,101,91
55905,173253,17379,83318,11401,155874,192,101,91
55910,173274,17383,83329,11403,155891,192,101,91
55915,173284,17384,83333,11403,155900,192,101,91
55920,173305,17388,83343,11405,155917,192,101,91
55925,173315,17389,83347,11406,155926,192,101,91
55930,173336,17390,83356,11407,155946,192,101,91
55935,173346,17390,83362,11407,155956,192,101,91
55940,173367,17391,83368,11407,155976,192,101,91
55945,173377,17391,83374,11407,155986,192,101,91
55950,173398,17392,83382,11407,156006,192,101,91
55955,173408,17392,83384,11407,156016,192,101,91
55960,173429,17393,83390,11408,156036,192,101,91
55965,173439,17393,83395,11408,156046,192,101,91
55970,173460,17394,83400,11408,156066,192,101,91
55975,173470,17394,83404,11408,156076,192,101,91
55980,173491,17395,83416,11409,156096,192,101,91
55985,173501,17395,83421,11409,156106,192,101,91
55990,173522,17396,83434,11409,156126,192,101,91
55995,173532,17396,83437,11409,156136,192,101,91
56000,173553,17397,83446,11409,156156,192,101,91
56005,173563,17397,83450,11409,156166,192,101,91
56010,173584,17398,83458,11409,156186,192,101,91
56015,173594,17398,83465,11409,156196,192,101,91
56020,173615,17399,83475,11410,156216,192,101,91
56025,173625,17399,83479,11410,156226,192,101,91
56030,173646,17402,83487,11411,156244,192,101,91
56035,173656,17403,83494,11412,156253,192,101,91
56040,173677,17409,83507,11417,156266,192,101,91
56045,173687,17412,83511,11420,156275,192,101,91
56050,173708,17414,83517,11420,156294,192,101,91
56055,173718,17416,83523,11422,156302,192,101,91
56060,173739,17418,83528,11422,156321,192,101,91
56065,173749,17419,83533,11423,156330,192,101,91
56070,173770,17421,83540,11424,156349,192,101,91
56075,173780,17423,83544,11425,156357,192,101,91
56080,173801,17425,83551,11426,156376,192,101,91
56085,173811,17427,83559,11427,156384,192,101,91
56090,173832,17429,83571,11429,156403,192,101,91
56095,173842,17430,83577,11430,156412,192,101,91
56100,173863,17432,83584,11430,156431,192,101,91
56105,173873,17433,83588,11430,156440,192,101,91
56110,173894,17435,83598,11432,156459,192,101,91
56115,173904,17437,83601,11433,156467,192,101,91
56120,173925,17439,83610,11433,156486,192,101,91
56125,173935,17440,83615,11433,156495,192,101,91
56130,173956,17442,83620,11434,156514,192,101,91
56135,173966,17443,83623,11434,156523,192,101,91
56140,173987,17445,83632,11435,156542,192,101,91
56145,173997,17447,83637,11437,156550,192,101,91
56150,174018,17451,83647,11440,156567,192,101,91
56155,174028,17452,83650,11440,156576,192,101,91
56160,174049,17456,83660,11441,156593,192,101,91
56165,174059,17456,83664,11441,156603,192,101,91
56170,174080,17457,83675,11442,156623,192,101,91
56175,174090,17457,83681,11442,156632,192,101,91
56180,174111,17459,83693,11444,156652,192,101,91
56185,174121,17459,83694,11444,156661,192,101,91
56190,174142,17461,83705,11445,156681,192,101,91
56195,174152,17461,83709,11445,156691,192,101,91
56200,174173,17461,83723,11445,156712,192,101,91
56205,174183,17461,83725,11445,156722,192,101,91
56210,174204,17461,83736,11445,156743,192,101,91
56215,174214,17461,83739,11445,156753,192,101,91
56220,174235,17461,83750,11445,156774,192,101,91
56225,174245,17461,83757,11445,156784,192,101,91
56230,174266,17461,83768,11445,156805,192,101,91
56235,174276,17461,83772,11445,156815,192,101,91
56240,174297,17461,83775,11445,156836,192,101,91
56245,174307,17461,83780,11445,156846,192,101,91
56250,174328,17461,83789,11445,156867,192,101,91
56255,174338,17461,83792,11445,156877,192,101,91
56260,174359,17461,83803,11445,156898,192,101,91
56265,174369,17461,83807,11445,156908,192,101,91
56270,174390,17464,83816,11448,156926,192,101,91
56275,174400,17466,83822,11450,156934,192,101,91
56280,174421,17469,83835,11452,156951,192,101,91
56285,174431,17471,83840,11454,156960,192,101,91
56290,174452,17475,83850,11456,156977,192,101,91
56295,174462,17476,83857,11457,156985,192,101,91
56300,174483,17479,83869,11460,157004,192,101,91
56305,174493,17480,83873,11460,157013,192,101,91
56310,174514,17482,83880,11460,157032,192,101,91
56315,174524,17483,83884,11460,157041,192,101,91
56320,174545,17486,83896,11462,157059,192,101,91
56325,174555,17487,83901,11462,157068,192,101,91
56330,174576,17489,83912,11464,157087,192,101,91
56335,174586,17490,83917,11464,157096,192,101,91
56340,174607,17493,83929,11467,157114,192,101,91
56345,174617,17494,83933,11467,157123,192,101,91
56350,174638,17496,83946,11468,157142,192,101,91
56355,174648,17497,83947,11468,157151,192,101,91
56360,174669,17499,83959,11468,157170,192,101,91
56365,174679,17500,83960,11468,157179,192,101,91
56370,174700,17503,83969,11469,157197,192,101,91
56375,174710,17504,83976,11470,157206,192,101,91
56380,174731,17506,83981,11471,157225,192,101,91
56385,174741,17507,83986,11471,157234,192,101,91
56390,174762,17510,83995,11473,157252,192,101,91
56395,174772,17511,84000,11474,157261,192,101,91
56400,174793,17515,84011,11477,157278,192,101,91
56405,174803,17515,84015,11477,157288,192,101,91
56410,174824,17517,84023,11478,157307,192,101,91
56415,174834,17518,84030,11479,157316,192,101,91
56420,174855,17520,84043,11480,157335,192,101,91
56425,174865,17520,84049,11480,157344,192,101,91
56430,174886,17523,84056,11482,157363,192,101,91
56435,174896,17523,84061,11482,157373,192,101,91
56440,174917,17525,84073,11484,157392,192,101,91
56445,174927,17525,84078,11484,157401,192,101,91
56450,174948,17528,84091,11486,157420,192,101,91
56455,174958,17528,84095,11486,157429,192,101,91
56460,174979,17531,84105,11488,157448,192,101,91
56465,174989,17531,84109,11488,157458,192,101,91
56470,175010,17533,84117,11490,157477,192,101,91
56475,175020,17533,84120,11490,157487,192,101,91
56480,175041,17535,84130,11491,157506,192,101,91
56485,175051,17535,84137,11491,157516,192,101,91
56490,175072,17537,84145,11491,157535,192,101,91
56495,175082,17537,84149,11491,157545,192,101,91
56500,175103,17539,84160,11493,157564,192,101,91
56505,175113,17539,84165,11493,157574,192,101,91
56510,175134,17543,84176,11496,157591,192,101,91
56515,175144,17544,84180,11497,157600,192,101,91
56520,175165,17550,84191,11501,157615,192,101,91
56525,175175,17552,84195,11503,157623,192,101,91
56530,175196,17554,84204,11505,157641,192,101,91
56535,175206,17556,84206,11506,157650,192,101,91
56540,175227,17557,84213,11506,157670,192,101,91
56545,175237,17558,84218,11507,157679,192,101,91
56550,175258,17559,84223,11508,157699,192,101,91
56555,175268,17560,84228,11509,157708,192,101,91
56560,175289,17562,84239,11510,157727,192,101,91
56565,175299,17564,84246,11512,157735,192,101,91
56570,175320,17565,84258,11513,157755,192,101,91
56575,175330,17566,84260,11513,157764,192,101,91
56580,175351,17567,84267,11513,157784,192,101,91
56585,175361,17568,84272,11514,157793,192,101,91
56590,175382,17569,84287,11515,157813,192,101,91
56595,175392,17570,84290,11516,157822,192,101,91
56600,175413,17572,84300,11517,157841,192,101,91
56605,175423,17573,84305,11518,157850,192,101,91
56610,175444,17575,84316,11520,157869,192,101,91
56615,175454,17576,84322,11520,157878,192,101,91
56620,175475,17578,84331,11522,157897,192,101,91
56625,175485,17579,84333,11522,157906,192,101,91
56630,175506,17583,84342,11525,157923,192,101,91
56635,175516,17584,84346,11526,157931,192,101,91
56640,175537,17589,84355,11530,157948,192,101,91
56645,175547,17591,84358,11531,157956,192,101,91
56650,175568,17595,84372,11535,157972,192,101,91
56655,175578,17598,84375,11538,157980,192,101,91
56660,175599,17601,84382,11538,157998,192,101,91
56665,175609,17602,84386,11538,158007,192,101,91
56670,175630,17606,84398,11540,158024,192,101,91
56675,175640,17607,84402,11541,158033,192,101,91
56680,175661,17610,84412,11543,158051,192,101,91
56685,175671,17611,84416,11544,158060,192,101,91
56690,175692,17615,84424,11545,158077,192,101,91
56695,175702,17616,84427,11545,158086,192,101,91
56700,175723,17620,84443,11547,158103,192,101,91
56705,175733,17621,84447,11548,158112,192,101,91
56710,175754,17625,84455,11551,158129,192,101,91
56715,175764,17626,84458,11551,158138,192,101,91
56720,175785,17630,84469,11554,158155,192,101,91
56725,175795,17631,84474,11554,158164,192,101,91
56730,175816,17635,84487,11558,158181,192,101,91
56735,175826,17636,84491,11558,158190,192,101,91
56740,175847,17639,84499,11560,158208,192,101,91
56745,175857,17640,84504,11560,158216,192,101,91
56750,175878,17646,84513,11564,158232,192,101,91
56755,175888,17648,84520,11566,158239,192,101,91
56760,175909,17654,84529,11569,158255,192,101,91
56765,175919,17655,84534,11570,158264,192,101,91
56770,175940,17656,84541,11570,158284,192,101,91
56775,175950,17658,84545,11572,158292,192,101,91
56780,175971,17659,84558,11572,158311,192,101,91
56785,175981,17662,84566,11575,158319,192,101,91
56790,176002,17663,84577,11576,158339,192,101,91
56795,176012,17664,84581,11576,158348,192,101,91
56800,176033,17666,84591,11578,158366,192,101,91
56805,176043,17668,84596,11580,158375,192,101,91
56810,176064,17669,84608,11580,158395,192,101,91
56815,176074,17669,84612,11580,158405,192,101,91
56820,176095,17670,84622,11580,158425,192,101,91
56825,176105,17670,84628,11580,158435,192,101,91
56830,176126,17672,84638,11581,158454,192,101,91
56835,176136,17672,84643,11581,158464,192,101,91
56840,176157,17673,84655,11582,158484,192,101,91
56845,176167,17673,84661,11582,158494,192,101,91
56850,176188,17674,84674,11583,158514,192,101,91
56855,176198,17674,84676,11583,158524,192,101,91
56860,176219,17675,84686,11583,158544,192,101,91
56865,176229,17675,84691,11583,158553,192,101,91
56870,176250,17680,84703,11586,158570,192,101,91
56875,176260,17680,84706,11586,158580,192,101,91
56880,176281,17684,84719,11589,158597,192,101,91
56885,176291,17684,84720,11589,158607,192,101,91
56890,176312,17686,84727,11590,158626,192,101,91
56895,176322,17686,84732,11590,158636,192,101,91
56900,176343,17687,84743,11591,158656,192,101,91
56905,176353,17687,84744,11591,158666,192,101,91
56910,176374,17688,84751,11592,158686,192,101,91
56915,176384,17689,84756,11593,158695,192,101,91
56920,176405,17691,84766,11594,158714,192,101,91
56925,176415,17692,84770,11594,158723,192,101,91
56930,176436,17694,84783,11595,158741,192,101,91
56935,176446,17696,84788,11597,158750,192,101,91
56940,176467,17697,84799,11597,158769,192,101,91
56945,176477,17699,84803,11598,158778,192,101,91
56950,176498,17702,84809,11599,158795,192,101,91
56955,176508,17704,84813,11600,158804,192,101,91
56960,176529,17706,84821,11600,158823,192,101,91
56965,176539,17707,84823,11600,158832,192,101,91
56970,176560,17709,84833,11602,158851,192,101,91
56975,176570,17710,84836,11603,158860,192,101,91
56980,176591,17713,84851,11605,158878,192,101,91
56985,176601,17715,84858,11607,158885,192,101,91
56990,176622,17719,84867,11610,158903,192,101,91
56995,176632,17721,84871,11611,158911,192,101,91
57000,176653,17724,84878,11612,158929,192,101,91
57005,176663,17726,84882,11613,158937,192,101,91
57010,176684,17729,84889,11614,158955,192,101,91
57015,176694,17731,84895,11616,158963,192,101,91
57020,176715,17734,84904,11616,158981,192,101,91
57025,176725,17736,84911,11617,158988,192,101,91
57030,176746,17740,84920,11620,159006,192,101,91
57035,176756,17741,84927,11621,159015,192,101,91
57040,176777,17744,84934,11621,159033,192,101,91
57045,176787,17745,84941,11622,159042,192,101,91
57050,176808,17748,84953,11624,159060,192,101,91
57055,176818,17749,84958,11624,159069,192,101,91
57060,176839,17753,84968,11628,159085,192,101,91
57065,176849,17754,84974,11629,159095,192,101,91
57070,176870,17756,84989,11630,159114,192,101,91
57075,176880,17756,84992,11630,159124,192,101,91
57080,176901,17758,85003,11631,159143,192,101,91
57085,176911,17758,85006,11631,159153,192,101,91
57090,176932,17760,85018,11632,159172,192,101,91
57095,176942,17760,85021,11632,159182,192,101,91
57100,176963,17760,85031,11632,159203,192,101,91
57105,176973,17760,85033,11632,159213,192,101,91
57110,176994,17760,85043,11632,159234,192,101,91
57115,177004,17760,85049,11632,159244,192,101,91
57120,177025,17760,85058,11632,159265,192,101,91
57125,177035,17761,85064,11633,159274,192,101,91
57130,177056,17764,85074,11636,159292,192,101,91
57135,177066,17765,85080,11637,159301,192,101,91
57140,177087,17768,85088,11638,159319,192,101,91
57145,177097,17770,85093,11640,159327,192,101,91
57150,177118,17773,85103,11643,159345,192,101,91
57155,177128,17775,85109,11645,159352,192,101,91
57160,177149,17779,85117,11648,159370,192,101,91
57165,177159,17780,85122,11648,159378,192,101,91
57170,177180,17784,85135,11650,159396,192,101,91
57175,177190,17786,85139,11651,159403,192,101,91
57180,177211,17791,85149,11654,159420,192,101,91
57185,177221,17791,85155,11654,159430,192,101,91
57190,177242,17792,85171,11655,159450,192,101,91
57195,177252,17792,85177,11655,159460,192,101,91
57200,177273,17793,85181,11655,159480,192,101,91
57205,177283,17793,85186,11655,159490,192,101,91
57210,177304,17795,85195,11657,159509,192,101,91
57215,177314,17795,85199,11657,159519,192,101,91
57220,177335,17796,85209,11657,159539,192,101,91
57225,177345,17796,85212,11657,159549,192,101,91
57230,177366,17798,85226,11658,159568,192,101,91
57235,177376,17798,85231,11658,159578,192,101,91
57240,177397,17799,85243,11659,159598,192,101,91
57245,177407,17799,85247,11659,159608,192,101,91
57250,177428,17801,85259,11661,159627,192,101,91
57255,177438,17801,85263,11661,159637,192,101,91
57260,177459,17803,85274,11662,159656,192,101,91
57265,177469,17803,85279,11662,159666,192,101,91
57270,177490,17805,85288,11662,159685,192,101,91
57275,177500,17805,85293,11662,159695,192,101,91
57280,177521,17807,85304,11662,159714,192,101,91
57285,177531,17807,85311,11662,159723,192,101,91
57290,177552,17813,85321,11666,159739,192,101,91
57295,177562,17814,85325,11667,159747,192,101,91
57300,177583,17818,85331,11669,159765,192,101,91
57305,177593,17819,85335,11669,159774,192,101,91
57310,177614,17819,85343,11669,159795,192,101,91
57315,177624,17820,85346,11669,159804,192,101,91
57320,177645,17820,85355,11669,159825,192,101,91
57325,177655,17821,85359,11670,159834,192,101,91
57330,177676,17821,85367,11670,159855,192,101,91
57335,177686,17822,85377,11671,159864,192,101,91
57340,177707,17822,85387,11671,159885,192,101,91
57345,177717,17823,85392,11672,159894,192,101,91
57350,177738,17823,85400,11672,159915,192,101,91
57355,177748,17824,85402,11672,159924,192,101,91
57360,177769,17824,85409,11672,159945,192,101,91
57365,177779,17825,85416,11673,159954,192,101,91
57370,177800,17825,85424,11673,159975,192,101,91
57375,177810,17826,85428,11673,159984,192,101,91
57380,177831,17826,85445,11673,160005,192,101,91
57385,177841,17827,85449,11674,160014,192,101,91
57390,177862,17827,85462,11674,160035,192,101,91
57395,177872,17828,85466,11674,160044,192,101,91
57400,177893,17828,85476,11674,160065,192,101,91
57405,177903,17829,85479,11674,160074,192,101,91
57410,177924,17832,85487,11674,160092,192,101,91
57415,177934,17834,85494,11676,160099,192,101,91
57420,177955,17840,85505,11681,160115,192,101,91
57425,177965,17840,85509,11681,160125,192,101,91
57430,177986,17842,85523,11683,160144,192,101,91
57435,177996,17842,85527,11683,160154,192,101,91
57440,178017,17844,85539,11684,160173,192,101,91
57445,178027,17844,85542,11684,160183,192,101,91
57450,178048,17846,85549,11686,160202,192,101,91
57455,178058,17846,85551,11686,160212,192,101,91
57460,178079,17848,85561,11688,160231,192,101,91
57465,178089,17848,85568,11688,160241,192,101,91
57470,178110,17850,85575,11688,160260,192,101,91
57475,178120,17850,85580,11688,160270,192,101,91
57480,178141,17852,85592,11689,160289,192,101,91
57485,178151,17852,85598,11689,160299,192,101,91
57490,178172,17854,85611,11690,160318,192,101,91
57495,178182,17854,85616,11690,160328,192,101,91
57500,178203,17856,85626,11690,160347,192,101,91
57505,178213,17856,85630,11690,160357,192,101,91
57510,178234,17858,85642,11691,160376,192,101,91
57515,178244,17858,85643,11691,160386,192,101,91
57520,178265,17860,85656,11692,160405,192,101,91
57525,178275,17860,85661,11692,160415,192,101,91
57530,178296,17863,85669,11692,160433,192,101,91
57535,178306,17864,85672,11693,160441,192,101,91
57540,178327,17871,85681,11697,160456,192,101,91
57545,178337,17872,85686,11697,160465,192,101,91
57550,178358,17872,85698,11697,160486,192,101,91
57555,178368,17873,85702,11698,160495,192,101,91
57560,178389,17873,85713,11698,160516,192,101,91
57565,178399,17874,85715,11698,160525,192,101,91
57570,178420,17874,85731,11698,160546,192,101,91
57575,178430,17875,85734,11698,160555,192,101,91
57580,178451,17875,85744,11698,160576,192,101,91
57585,178461,17876,85750,11699,160585,192,101,91
57590,178482,17876,85756,11699,160606,192,101,91
57595,178492,17877,85759,11699,160615,192,101,91
57600,178513,17877,85771,11699,160636,192,101,91
57605,178523,17878,85775,11699,160645,192,101,91
57610,178544,17878,85781,11699,160666,192,101,91
57615,178554,17879,85788,11699,160675,192,101,91
57620,178575,17879,85799,11699,160696,192,101,91
57625,178585,17880,85804,11699,160705,192,101,91
57630,178606,17880,85816,11699,160726,192,101,91
57635,178616,17881,85819,11699,160735,192,101,91
57640,178637,17881,85833,11699,160756,192,101,91
57645,178647,17882,85840,11700,160765,192,101,91
57650,178668,17887,85852,11704,160780,192,101,91
57655,178678,17890,85857,11707,160788,192,101,91
57660,178699,17894,85867,11710,160805,192,101,91
57665,178709,17895,85870,11711,160814,192,101,91
57670,178730,17897,85879,11711,160833,192,101,91
57675,178740,17898,85884,11711,160842,192,101,91
57680,178761,17901,85896,11712,160860,192,101,91
57685,178771,17902,85902,11712,160868,192,101,91
57690,178792,17906,85913,11715,160886,192,101,91
57695,178802,17907,85918,11716,160895,192,101,91
57700,178823,17910,85929,11718,160913,192,101,91
57705,178833,17911,85933,11719,160922,192,101,91
57710,178854,17913,85943,11720,160941,192,101,91
57715,178864,17914,85950,11721,160949,192,101,91
57720,178885,17917,85958,11723,160968,192,101,91
57725,178895,17918,85960,11724,160976,192,101,91
57730,178916,17920,85971,11726,160996,192,101,91
57735,178926,17921,85976,11727,161005,192,101,91
57740,178947,17922,85985,11727,161025,192,101,91
57745,178957,17923,85990,11728,161034,192,101,91
57750,178978,17924,85998,11729,161054,192,101,91
57755,178988,17925,86004,11730,161063,192,101,91
57760,179009,17926,86017,11731,161082,192,101,91
57765,179019,17928,86023,11733,161091,192,101,91
57770,179040,17932,86033,11736,161108,192,101,91
57775,179050,17933,86037,11736,161117,192,101,91
57780,179071,17935,86044,11736,161136,192,101,91
57785,179081,17936,86049,11737,161145,192,101,91
57790,179102,17938,86059,11737,161164,192,101,91
57795,179112,17939,86064,11738,161173,192,101,91
57800,179133,17941,86076,11739,161192,192,101,91
57805,179143,17942,86083,11740,161201,192,101,91
57810,179164,17944,86096,11742,161220,192,101,91
57815,179174,17946,86100,11744,161228,192,101,91
57820,179195,17948,86108,11745,161247,192,101,91
57825,179205,17949,86113,11746,161256,192,101,91
57830,179226,17950,86124,11747,161276,192,101,91
57835,179236,17950,86127,11747,161286,192,101,91
57840,179257,17951,86135,11747,161306,192,101,91
57845,179267,17951,86139,11747,161316,192,101,91
57850,179288,17953,86150,11747,161335,192,101,91
57855,179298,17953,86154,11747,161345,192,101,91
57860,179319,17955,86167,11748,161364,192,101,91
57865,179329,17955,86170,11748,161374,192,101,91
57870,179350,17957,86180,11749,161393,192,101,91
57875,179360,17957,86185,11749,161403,192,101,91
57880,179381,17959,86197,11750,161422,192,101,91
57885,179391,17959,86202,11750,161432,192,101,91
57890,179412,17962,86209,11752,161450,192,101,91
57895,179422,17963,86213,11752,161459,192,101,91
57900,179443,17966,86225,11755,161476,192,101,91
57905,179453,17968,86231,11757,161485,192,101,91
57910,179474,17968,86242,11757,161506,192,101,91
57915,179484,17969,86248,11758,161515,192,101,91
57920,179505,17969,86259,11758,161536,192,101,91
57925,179515,17970,86263,11758,161545,192,101,91
57930,179536,17970,86278,11758,161566,192,101,91
57935,179546,17971,86282,11759,161575,192,101,91
57940,179567,17971,86290,11759,161596,192,101,91
57945,179577,17972,86295,11760,161605,192,101,91
57950,179598,17973,86307,11760,161625,192,101,91
57955,179608,17974,86310,11761,161634,192,101,91
57960,179629,17975,86318,11761,161654,192,101,91
57965,179639,17977,86323,11763,161662,192,101,91
57970,179660,17978,86333,11763,161682,192,101,91
57975,179670,17979,86336,11764,161691,192,101,91
57980,179691,17980,86342,11764,161711,192,101,91
57985,179701,17980,86346,11764,161721,192,101,91
57990,179722,17981,86355,11764,161741,192,101,91
57995,179732,17981,86357,11764,161751,192,101,91
58000,179753,17982,86369,11765,161771,192,101,91
58005,179763,17982,86372,11765,161781,192,101,91
58010,179784,17985,86381,11766,161799,192,101,91
58015,179794,17986,86387,11767,161808,192,101,91
58020,179815,17989,86397,11769,161826,192,101,91
58025,179825,17989,86400,11769,161836,192,101,91
58030,179846,17991,86410,11769,161855,192,101,91
58035,179856,17991,86416,11769,161865,192,101,91
58040,179877,17993,86427,11770,161884,192,101,91
58045,179887,17993,86434,11770,161893,192,101,91
58050,179908,17996,86449,11772,161912,192,101,91
58055,179918,17996,86453,11772,161922,192,101,91
58060,179939,17998,86460,11772,161941,192,101,91
58065,179949,17998,86464,11772,161950,192,101,91
58070,179970,18003,86476,11777,161967,192,101,91
58075,179980,18004,86481,11778,161976,192,101,91
58080,180001,18007,86489,11780,161994,192,101,91
58085,180011,18008,86493,11781,162003,192,101,91
58090,180032,18011,86503,11782,162020,192,101,91
58095,180042,18013,86507,11784,162029,192,101,91
58100,180063,18016,86515,11786,162047,192,101,91
58105,180073,18018,86520,11788,162055,192,101,91
58110,180094,18022,86528,11791,162072,192,101,91
58115,180104,18023,86533,11791,162081,192,101,91
58120,180125,18027,86544,11795,162098,192,101,91
58125,180135,18028,86548,11796,162106,192,101,91
58130,180156,18032,86557,11799,162124,192,101,91
58135,180166,18033,86564,11800,162132,192,101,91
58140,180187,18038,86579,11805,162149,192,101,91
58145,180197,18039,86584,11805,162157,192,101,91
58150,180218,18042,86593,11808,162176,192,101,91
58155,180228,18043,86596,11808,162185,192,101,91
58160,180249,18045,86606,11810,162204,192,101,91
58165,180259,18046,86610,11810,162213,192,101,91
58170,180280,18048,86617,11810,162232,192,101,91
58175,180290,18049,86619,11810,162241,192,101,91
58180,180311,18051,86626,11810,162260,192,101,91
58185,180321,18052,86631,11810,162269,192,101,91
58190,180342,18054,86640,11811,162288,192,101,91
58195,180352,18055,86641,11811,162297,192,101,91
58200,180373,18057,86651,11812,162315,192,101,91
58205,180383,18059,86657,11814,162324,192,101,91
58210,180404,18061,86667,11815,162343,192,101,91
58215,180414,18061,86672,11815,162353,192,101,91
58220,180435,18063,86686,11817,162372,192,101,91
58225,180445,18064,86691,11818,162381,192,101,91
58230,180466,18067,86698,11820,162399,192,101,91
58235,180476,18068,86704,11821,162408,192,101,91
58240,180497,18071,86717,11824,162426,192,101,91
58245,180507,18072,86722,11825,162435,192,101,91
58250,180528,18075,86735,11827,162453,192,101,91
58255,180538,18075,86742,11827,162462,192,101,91
58260,180559,18079,86748,11828,162480,192,101,91
58265,180569,18080,86755,11828,162488,192,101,91
58270,180590,18083,86765,11830,162507,192,101,91
58275,180600,18084,86772,11831,162515,192,101,91
58280,180621,18087,86782,11833,162534,192,101,91
58285,180631,18088,86788,11833,162542,192,101,91
58290,180652,18090,86797,11835,162562,192,101,91
58295,180662,18091,86804,11836,162571,192,101,91
58300,180683,18092,86812,11836,162591,192,101,91
58305,180693,18093,86818,11837,162600,192,101,91
58310,180714,18095,86829,11838,162619,192,101,91
58315,180724,18096,86832,11838,162628,192,101,91
58320,180745,18097,86845,11838,162648,192,101,91
58325,180755,18097,86850,11838,162658,192,101,91
58330,180776,18098,86857,11838,162678,192,101,91
58335,180786,18098,86863,11838,162688,192,101,91
58340,180807,18099,86870,11838,162708,192,101,91
58345,180817,18099,86875,11838,162718,192,101,91
58350,180838,18100,86886,11838,162738,192,101,91
58355,180848,18100,86893,11838,162748,192,101,91
58360,180869,18101,86905,11839,162768,192,101,91
58365,180879,18102,86909,11840,162777,192,101,91
58370,180900,18105,86917,11841,162795,192,101,91
58375,180910,18105,86920,11841,162805,192,101,91
58380,180931,18108,86930,11843,162823,192,101,91
58385,180941,18109,86934,11843,162832,192,101,91
58390,180962,18111,86947,11844,162851,192,101,91
58395,180972,18112,86954,11844,162859,192,101,91
58400,180993,18115,86961,11846,162878,192,101,91
58405,181003,18116,86964,11846,162887,192,101,91
58410,181024,18118,86973,11847,162906,192,101,91
58415,181034,18119,86980,11847,162914,192,101,91
58420,181055,18122,86991,11848,162933,192,101,91
58425,181065,18123,86994,11848,162942,192,101,91
58430,181086,18126,87007,11849,162960,192,101,91
58435,181096,18127,87011,11849,162968,192,101,91
58440,181117,18131,87023,11852,162986,192,101,91
58445,181127,18132,87030,11853,162994,192,101,91
58450,181148,18136,87040,11856,163012,192,101,91
58455,181158,18137,87045,11857,163020,192,101,91
58460,181179,18140,87056,11860,163038,192,101,91
58465,181189,18143,87062,11863,163045,192,101,91
58470,181210,18147,87074,11866,163062,192,101,91
58475,181220,18149,87076,11868,163071,192,101,91
58480,181241,18152,87088,11871,163089,192,101,91
58485,181251,18153,87092,11871,163097,192,101,91
58490,181272,18159,87105,11875,163113,192,101,91
58495,181282,18161,87111,11876,163120,192,101,91
58500,181303,18166,87118,11879,163137,192,101,91
58505,181313,18167,87123,11879,163146,192,101,91
58510,181334,18168,87133,11879,163166,192,101,91
58515,181344,18170,87140,11881,163174,192,101,91
58520,181365,18171,87151,11881,163194,192,101,91
58525,181375,18172,87154,11882,163203,192,101,91
58530,181396,18173,87165,11883,163223,192,101,91
58535,181406,18174,87170,11884,163232,192,101,91
58540,181427,18175,87179,11885,163252,192,101,91
58545,181437,18176,87185,11885,163261,192,101,91
58550,181458,18177,87197,11886,163281,192,101,91
58555,181468,18178,87202,11886,163290,192,101,91
58560,181489,18179,87210,11887,163310,192,101,91
58565,181499,18180,87219,11888,163319,192,101,91
58570,181520,18181,87226,11888,163339,192,101,91
58575,181530,18182,87228,11888,163348,192,101,91
58580,181551,18183,87241,11889,163368,192,101,91
58585,181561,18184,87244,11889,163377,192,101,91
58590,181582,18185,87253,11890,163397,192,101,91
58595,181592,18186,87257,11890,163406,192,101,91
58600,181613,18187,87269,11891,163426,192,101,91
58605,181623,18188,87272,11892,163435,192,101,91
58610,181644,18192,87282,11894,163451,192,101,91
58615,181654,18194,87287,11896,163460,192,101,91
58620,181675,18198,87297,11898,163476,192,101,91
58625,181685,18200,87300,11900,163485,192,101,91
58630,181706,18204,87313,11903,163502,192,101,91
58635,181716,18204,87319,11903,163512,192,101,91
58640,181737,18207,87325,11904,163530,192,101,91
58645,181747,18208,87329,11905,163539,192,101,91
58650,181768,18213,87342,11910,163555,192,101,91
58655,181778,18213,87345,11910,163565,192,101,91
58660,181799,18215,87351,11911,163584,192,101,91
58665,181809,18215,87357,11911,163594,192,101,91
58670,181830,18217,87367,11912,163613,192,101,91
58675,181840,18217,87377,11912,163623,192,101,91
58680,181861,18220,87389,11913,163641,192,101,91
58685,181871,18222,87393,11915,163649,192,101,91
58690,181892,18225,87403,11917,163666,192,101,91
58695,181902,18227,87407,11918,163675,192,101,91
58700,181923,18230,87413,11919,163693,192,101,91
58705,181933,18231,87418,11920,163702,192,101,91
58710,181954,18235,87428,11923,163719,192,101,91
58715,181964,18237,87435,11924,163727,192,101,91
58720,181985,18238,87444,11925,163747,192,101,91
58725,181995,18240,87450,11927,163755,192,101,91
58730,182016,18242,87460,11929,163774,192,101,91
58735,182026,18244,87466,11930,163781,192,101,91
58740,182047,18246,87475,11931,163801,192,101,91
58745,182057,18248,87478,11932,163808,192,101,91
58750,182078,18253,87488,11936,163825,192,101,91
58755,182088,18254,87493,11936,163833,192,101,91
58760,182109,18259,87503,11939,163850,192,101,91
58765,182119,18260,87507,11939,163859,192,101,91
58770,182140,18264,87519,11943,163876,192,101,91
58775,182150,18265,87524,11944,163884,192,101,91
58780,182171,18270,87533,11948,163901,192,101,91
58785,182181,18271,87539,11948,163909,192,101,91
58790,182202,18277,87549,11951,163925,192,101,91
58795,182212,18278,87553,11951,163933,192,101,91
58800,182233,18283,87563,11954,163950,192,101,91
58805,182243,18285,87569,11956,163958,192,101,91
58810,182264,18287,87575,11956,163977,192,101,91
58815,182274,18288,87578,11957,163986,192,101,91
58820,182295,18290,87591,11958,164004,192,101,91
58825,182305,18293,87595,11961,164012,192,101,91
58830,182326,18295,87607,11962,164031,192,101,91
58835,182336,18296,87610,11962,164040,192,101,91
58840,182357,18298,87619,11964,164059,192,101,91
58845,182367,18300,87622,11966,164067,192,101,91
58850,182388,18302,87635,11967,164086,192,101,91
58855,182398,18304,87641,11969,164094,192,101,91
58860,182419,18306,87653,11971,164113,192,101,91
58865,182429,18306,87657,11971,164123,192,101,91
58870,182450,18307,87664,11972,164143,192,101,91
58875,182460,18307,87668,11972,164153,192,101,91
58880,182481,18309,87682,11974,164172,192,101,91
58885,182491,18309,87688,11974,164182,192,101,91
58890,182512,18311,87701,11975,164201,192,101,91
58895,182522,18311,87706,11975,164211,192,101,91
58900,182543,18313,87717,11977,164230,192,101,91
58905,182553,18313,87721,11977,164240,192,101,91
58910,182574,18316,87735,11980,164258,192,101,91
58915,182584,18316,87739,11980,164268,192,101,91
58920,182605,18316,87747,11980,164289,192,101,91
58925,182615,18316,87751,11980,164299,192,101,91
58930,182636,18317,87761,11981,164319,192,101,91
58935,182646,18318,87767,11982,164328,192,101,91
58940,182667,18319,87775,11982,164348,192,101,91
58945,182677,18320,87780,11983,164356,192,101,91
58950,182698,18322,87790,11985,164376,192,101,91
58955,182708,18323,87795,11986,164385,192,101,91
58960,182729,18324,87810,11986,164405,192,101,91
58965,182739,18325,87816,11987,164413,192,101,91
58970,182760,18327,87827,11989,164433,192,101,91
58975,182770,18328,87833,11989,164442,192,101,91
58980,182791,18330,87839,11990,164461,192,101,91
58985,182801,18331,87843,11990,164470,192,101,91
58990,182822,18332,87856,11990,164490,192,101,91
58995,182832,18333,87861,11991,164499,192,101,91
59000,182853,18334,87872,11992,164519,192,101,91
59005,182863,18335,87879,11993,164528,192,101,91
59010,182884,18336,87888,11994,164548,192,101,91
59015,182894,18337,87895,11995,164556,192,101,91
59020,182915,18340,87906,11996,164574,192,101,91
59025,182925,18342,87911,11998,164583,192,101,91
59030,182946,18344,87923,11999,164602,192,101,91
59035,182956,18345,87931,11999,164610,192,101,91
59040,182977,18348,87940,12000,164629,192,101,91
59045,182987,18349,87944,12001,164638,192,101,91
59050,183008,18352,87953,12002,164656,192,101,91
59055,183018,18353,87956,12002,164665,192,101,91
59060,183039,18356,87964,12003,164683,192,101,91
59065,183049,18357,87971,12004,164692,192,101,91
59070,183070,18360,87978,12004,164710,192,101,91
59075,183080,18361,87980,12004,164719,192,101,91
59080,183101,18365,87991,12006,164736,192,101,91
59085,183111,18366,87997,12007,164745,192,101,91
59090,183132,18372,88009,12011,164760,192,101,91
59095,183142,18373,88013,12011,164769,192,101,91
59100,183163,18378,88020,12013,164785,192,101,91
59105,183173,18379,88023,12014,164794,192,101,91
59110,183194,18383,88032,12018,164811,192,101,91
59115,183204,18384,88037,12019,164820,192,101,91
59120,183225,18388,88051,12021,164837,192,101,91
59125,183235,18389,88057,12021,164846,192,101,91
59130,183256,18393,88067,12023,164863,192,101,91
59135,183266,18394,88071,12024,164872,192,101,91
59140,183287,18398,88075,12026,164889,192,101,91
59145,183297,18400,88080,12028,164897,192,101,91
59150,183318,18403,88091,12030,164915,192,101,91
59155,183328,18405,88099,12031,164922,192,101,91
59160,183349,18410,88110,12033,164938,192,101,91
59165,183359,18412,88116,12034,164946,192,101,91
59170,183380,18415,88126,12036,164965,192,101,91
59175,183390,18416,88131,12037,164973,192,101,91
59180,183411,18419,88142,12040,164992,192,101,91
59185,183421,18420,88146,12041,165000,192,101,91
59190,183442,18423,88157,12044,165019,192,101,91
59195,183452,18424,88161,12044,165027,192,101,91
59200,183473,18427,88169,12046,165046,192,101,91
59205,183483,18428,88171,12046,165055,192,101,91
59210,183504,18430,88180,12047,165074,192,101,91
59215,183514,18431,88186,12047,165083,192,101,91
59220,183535,18433,88196,12047,165102,192,101,91
59225,183545,18434,88201,12048,165111,192,101,91
59230,183566,18436,88213,12049,165130,192,101,91
59235,183576,18437,88217,12049,165139,192,101,91
59240,183597,18439,88232,12050,165158,192,101,91
59245,183607,18440,88236,12051,165167,192,101,91
59250,183628,18442,88242,12051,165186,192,101,91
59255,183638,18444,88247,12052,165194,192,101,91
59260,183659,18447,88261,12054,165212,192,101,91
59265,183669,18449,88265,12055,165220,192,101,91
59270,183690,18453,88280,12059,165237,192,101,91
59275,183700,18454,88285,12059,165246,192,101,91
59280,183721,18459,88299,12063,165262,192,101,91
59285,183731,18461,88303,12064,165270,192,101,91
59290,183752,18462,88313,12064,165290,192,101,91
59295,183762,18464,88319,12066,165298,192,101,91
59300,183783,18465,88332,12067,165318,192,101,91
59305,183793,18466,88335,12068,165327,192,101,91
59310,183814,18467,88346,12069,165347,192,101,91
59315,183824,18469,88351,12071,165355,192,101,91
59320,183845,18471,88360,12072,165374,192,101,91
59325,183855,18473,88366,12073,165382,192,101,91
59330,183876,18474,88374,12073,165402,192,101,91
59335,183886,18475,88379,12074,165411,192,101,91
59340,183907,18477,88394,12075,165430,192,101,91
59345,183917,18478,88400,12075,165439,192,101,91
59350,183938,18479,88407,12075,165459,192,101,91
59355,183948,18480,88412,12075,165468,192,101,91
59360,183969,18482,88426,12076,165487,192,101,91
59365,183979,18483,88431,12077,165496,192,101,91
59370,184000,18484,88438,12077,165516,192,101,91
59375,184010,18485,88443,12078,165525,192,101,91
59380,184031,18487,88456,12080,165544,192,101,91
59385,184041,18488,88460,12081,165553,192,101,91
59390,184062,18491,88467,12082,165570,192,101,91
59395,184072,18493,88472,12084,165579,192,101,91
59400,184093,18497,88484,12086,165596,192,101,91
59405,184103,18497,88488,12086,165606,192,101,91
59410,184124,18499,88499,12086,165625,192,101,91
59415,184134,18499,88501,12086,165635,192,101,91
59420,184155,18502,88511,12089,165653,192,101,91
59425,184165,18502,88516,12089,165663,192,101,91
59430,184186,18504,88527,12090,165682,192,101,91
59435,184196,18504,88534,12090,165692,192,101,91
59440,184217,18507,88545,12092,165710,192,101,91
59445,184227,18507,88550,12092,165720,192,101,91
59450,184248,18510,88559,12094,165738,192,101,91
59455,184258,18510,88566,12094,165748,192,101,91
59460,184279,18512,88573,12094,165767,192,101,91
59465,184289,18512,88578,12094,165777,192,101,91
59470,184310,18514,88591,12095,165796,192,101,91
59475,184320,18514,88596,12095,165806,192,101,91
59480,184341,18516,88605,12095,165825,192,101,91
59485,184351,18516,88609,12095,165835,192,101,91
59490,184372,18518,88616,12096,165854,192,101,91
59495,184382,18518,88621,12096,165864,192,101,91
59500,184403,18520,88632,12097,165883,192,101,91
59505,184413,18520,88635,12097,165893,192,101,91
59510,184434,18523,88641,12099,165911,192,101,91
59515,184444,18524,88646,12099,165919,192,101,91
59520,184465,18530,88657,12104,165934,192,101,91
59525,184475,18532,88661,12106,165943,192,101,91
59530,184496,18535,88672,12107,165961,192,101,91
59535,184506,18538,88677,12109,165968,192,101,91
59540,184527,18541,88691,12111,165986,192,101,91
59545,184537,18544,88698,12114,165993,192,101,91
59550,184558,18546,88706,12114,166012,192,101,91
59555,184568,18548,88710,12115,166020,192,101,91
59560,184589,18551,88721,12116,166038,192,101,91
59565,184599,18554,88726,12119,166045,192,101,91
59570,184620,18556,88737,12120,166064,192,101,91
59575,184630,18558,88743,12122,166072,192,101,91
59580,184651,18560,88754,12123,166091,192,101,91
59585,184661,18561,88757,12123,166100,192,101,91
59590,184682,18562,88768,12124,166119,192,101,91
59595,184692,18564,88771,12125,166128,192,101,91
59600,184713,18565,88780,12125,166148,192,101,91
59605,184723,18566,88788,12126,166157,192,101,91
59610,184744,18567,88795,12127,166177,192,101,91
59615,184754,18568,88800,12128,166186,192,101,91
59620,184775,18570,88810,12130,166205,192,101,91
59625,184785,18571,88813,12130,166214,192,101,91
59630,184806,18574,88819,12133,166232,192,101,91
59635,184816,18575,88824,12134,166241,192,101,91
59640,184837,18578,88834,12136,166259,192,101,91
59645,184847,18578,88838,12136,166269,192,101,91
59650,184868,18580,88846,12136,166288,192,101,91
59655,184878,18580,88849,12136,166298,192,101,91
59660,184899,18582,88861,12137,166317,192,101,91
59665,184909,18582,88864,12137,166327,192,101,91
59670,184930,18584,88881,12139,166346,192,101,91
59675,184940,18584,88884,12139,166356,192,101,91
59680,184961,18586,88898,12139,166375,192,101,91
59685,184971,18586,88903,12139,166385,192,101,91
59690,184992,18589,88914,12142,166403,192,101,91
59695,185002,18589,88920,12142,166413,192,101,91
59700,185023,18591,88931,12144,166432,192,101,91
59705,185033,18591,88937,12144,166442,192,101,91
59710,185054,18593,88947,12146,166461,192,101,91
59715,185064,18593,88952,12146,166471,192,101,91
59720,185085,18594,88960,12146,166491,192,101,91
59725,185095,18594,88964,12146,166501,192,101,91
59730,185116,18595,88974,12146,166521,192,101,91
59735,185126,18595,88976,12146,166531,192,101,91
59740,185147,18596,88987,12147,166551,192,101,91
59745,185157,18596,88990,12147,166561,192,101,91
59750,185178,18599,89001,12150,166579,192,101,91
59755,185188,18601,89008,12152,166587,192,101,91
59760,185209,18603,89017,12153,166605,192,101,91
59765,185219,18605,89021,12155,166614,192,101,91
59770,185240,18607,89034,12156,166632,192,101,91
59775,185250,18609,89037,12157,166641,192,101,91
59780,185271,18611,89049,12158,166659,192,101,91
59785,185281,18613,89055,12160,166667,192,101,91
59790,185302,18617,89066,12163,166685,192,101,91
59795,185312,18618,89069,12163,166694,192,101,91
59800,185333,18620,89075,12163,166713,192,101,91
59805,185343,18621,89080,12164,166721,192,101,91
59810,185364,18625,89092,12167,166739,192,101,91
59815,185374,18626,89096,12167,166747,192,101,91
59820,185395,18631,89107,12170,166764,192,101,91
59825,185405,18632,89113,12170,166772,192,101,91
59830,185426,18635,89123,12173,166791,192,101,91
59835,185436,18636,89131,12173,166800,192,101,91
59840,185457,18638,89140,12174,166819,192,101,91
59845,185467,18639,89146,12174,166828,192,101,91
59850,185488,18641,89158,12174,166847,192,101,91
59855,185498,18642,89162,12174,166856,192,101,91
59860,185519,18644,89167,12174,166875,192,101,91
59865,185529,18645,89173,12175,166884,192,101,91
59870,185550,18648,89181,12177,166902,192,101,91
59875,185560,18649,89184,12177,166911,192,101,91
59880,185581,18653,89195,12180,166928,192,101,91
59885,185591,18655,89200,12182,166936,192,101,91
59890,185612,18655,89208,12182,166957,192,101,91
59895,185622,18655,89214,12182,166967,192,101,91
59900,185643,18655,89222,12182,166988,192,101,91
59905,185653,18655,89229,12182,166998,192,101,91
59910,185674,18655,89241,12182,167019,192,101,91
59915,185684,18655,89248,12182,167029,192,101,91
59920,185705,18655,89256,12182,167050,192,101,91
59925,185715,18655,89261,12182,167060,192,101,91
59930,185736,18656,89275,12183,167080,192,101,91
59935,185746,18657,89281,12184,167089,192,101,91
59940,185767,18658,89289,12184,167109,192,101,91
59945,185777,18658,89294,12184,167119,192,101,91
59950,185798,18660,89304,12186,167138,192,101,91
59955,185808,18660,89309,12186,167148,192,101,91
59960,185829,18663,89319,12188,167166,192,101,91
59965,185839,18663,89325,12188,167176,192,101,91
59970,185860,18665,89336,12189,167195,192,101,91
59975,185870,18665,89342,12189,167205,192,101,91
59980,185891,18667,89352,12190,167224,192,101,91
59985,185901,18667,89355,12190,167234,192,101,91
59990,185922,18670,89366,12193,167252,192,101,91
59995,185932,18671,89371,12193,167261,192,101,91
60000,185953,18674,89377,12194,167279,192,101,91
60005,185963,18675,89381,12194,167287,192,101,91
60010,185984,18682,89394,12200,167301,192,101,91
60015,185994,18685,89399,12203,167308,192,101,91
60020,186015,18691,89408,12207,167324,192,101,91
60025,186025,18693,89411,12208,167332,192,101,91
60030,186046,18696,89416,12209,167350,192,101,91
60035,186056,18697,89422,12209,167358,192,101,91
60040,186077,18700,89426,12210,167377,192,101,91
60045,186087,18701,89430,12210,167386,192,101,91
60050,186108,18703,89439,12211,167405,192,101,91
60055,186118,18704,89446,12212,167413,192,101,91
60060,186139,18708,89457,12214,167431,192,101,91
60065,186149,18709,89461,12214,167440,192,101,91
60070,186170,18710,89471,12214,167460,192,101,91
60075,186180,18711,89478,12215,167469,192,101,91
60080,186201,18712,89486,12215,167489,192,101,91
60085,186211,18713,89489,12215,167497,192,101,91
60090,186232,18715,89495,12216,167517,192,101,91
60095,186242,18716,89501,12216,167525,192,101,91
60100,186263,18718,89509,12218,167545,192,101,91
60105,186273,18719,89512,12218,167554,192,101,91
60110,186294,18720,89522,12218,167574,192,101,91
60115,186304,18721,89522,12218,167583,192,101,91
60120,186325,18722,89529,12218,167603,192,101,91
60125,186335,18723,89533,12218,167612,192,101,91
60130,186356,18725,89543,12219,167630,192,101,91
60135,186366,18728,89547,12222,167638,192,101,91
60140,186387,18729,89558,12222,167657,192,101,91
60145,186397,18731,89562,12223,167666,192,101,91
60150,186418,18733,89574,12225,167685,192,101,91
60155,186428,18733,89578,12225,167695,192,101,91
60160,186449,18735,89587,12227,167714,192,101,91
60165,186459,18735,89593,12227,167724,192,101,91
60170,186480,18737,89603,12227,167743,192,101,91
60175,186490,18737,89608,12227,167753,192,101,91
60180,186511,18741,89619,12230,167770,192,101,91
60185,186521,18741,89621,12230,167780,192,101,91
60190,186542,18743,89627,12231,167799,192,101,91
60195,186552,18743,89634,12231,167809,192,101,91
60200,186573,18745,89643,12233,167828,192,101,91
60205,186583,18745,89648,12233,167838,192,101,91
60210,186604,18747,89657,12235,167857,192,101,91
60215,186614,18747,89662,12235,167867,192,101,91
60220,186635,18749,89671,12235,167886,192,101,91
60225,186645,18749,89677,12235,167896,192,101,91
60230,186666,18752,89688,12237,167914,192,101,91
60235,186676,18752,89692,12237,167923,192,101,91
60240,186697,18756,89700,12239,167941,192,101,91
60245,186707,18756,89705,12239,167950,192,101,91
60250,186728,18760,89715,12242,167968,192,101,91
60255,186738,18762,89719,12244,167976,192,101,91
60260,186759,18766,89730,12248,167992,192,101,91
60265,186769,18768,89735,12249,168000,192,101,91
60270,186790,18772,89746,12252,168018,192,101,91
60275,186800,18774,89750,12254,168026,192,101,91
60280,186821,18777,89758,12255,168044,192,101,91
60285,186831,18779,89760,12257,168052,192,101,91
60290,186852,18782,89767,12257,168070,192,101,91
60295,186862,18783,89771,12258,168079,192,101,91
60300,186883,18787,89781,12261,168096,192,101,91
60305,186893,18788,89783,12261,168105,192,101,91
60310,186914,18791,89793,12263,168123,192,101,91
60315,186924,18793,89799,12265,168131,192,101,91
60320,186945,18795,89808,12267,168150,192,101,91
60325,186955,18797,89813,12269,168158,192,101,91
60330,186976,18800,89826,12272,168176,192,101,91
60335,186986,18801,89831,12272,168185,192,101,91
60340,187007,18803,89843,12273,168204,192,101,91
60345,187017,18804,89846,12273,168213,192,101,91
60350,187038,18806,89854,12274,168232,192,101,91
60355,187048,18807,89859,12275,168241,192,101,91
60360,187069,18809,89870,12276,168260,192,101,91
60365,187079,18810,89874,12276,168269,192,101,91
60370,187100,18812,89883,12276,168288,192,101,91
60375,187110,18813,89889,12277,168297,192,101,91
60380,187131,18815,89898,12278,168315,192,101,91
60385,187141,18817,89903,12279,168324,192,101,91
60390,187162,18820,89912,12280,168342,192,101,91
60395,187172,18821,89917,12280,168351,192,101,91
60400,187193,18824,89930,12283,168369,192,101,91
60405,187203,18825,89934,12283,168378,192,101,91
60410,187224,18828,89947,12284,168396,192,101,91
60415,187234,18830,89953,12286,168403,192,101,91
60420,187255,18836,89970,12291,168418,192,101,91
60425,187265,18839,89978,12294,168425,192,101,91
60430,187286,18841,89992,12295,168445,192,101,91
60435,187296,18842,89996,12296,168453,192,101,91
60440,187317,18844,90004,12298,168473,192,101,91
60445,187327,18845,90009,12298,168481,192,101,91
60450,187348,18847,90016,12300,168501,192,101,91
60455,187358,18848,90021,12301,168509,192,101,91
60460,187379,18850,90031,12302,168529,192,101,91
60465,187389,18851,90034,12302,168538,192,101,91
60470,187410,18852,90041,12302,168558,192,101,91
60475,187420,18853,90047,12302,168566,192,101,91
60480,187441,18856,90057,12305,168585,192,101,91
60485,187451,18858,90062,12307,168593,192,101,91
60490,187472,18859,90074,12308,168613,192,101,91
60495,187482,18860,90077,12309,168622,192,101,91
60500,187503,18861,90090,12310,168642,192,101,91
60505,187513,18862,90094,12310,168651,192,101,91
60510,187534,18862,90108,12310,168672,192,101,91
60515,187544,18863,90110,12310,168681,192,101,91
60520,187565,18863,90122,12310,168702,192,101,91
60525,187575,18864,90130,12311,168711,192,101,91
60530,187596,18865,90141,12312,168731,192,101,91
60535,187606,18866,90147,12312,168739,192,101,91
60540,187627,18870,90156,12315,168756,192,101,91
60545,187637,18872,90162,12317,168765,192,101,91
60550,187658,18875,90174,12318,168783,192,101,91
60555,187668,18875,90180,12318,168793,192,101,91
60560,187689,18878,90190,12319,168811,192,101,91
60565,187699,18878,90193,12319,168821,192,101,91
60570,187720,18881,90204,12320,168839,192,101,91
60575,187730,18881,90209,12320,168849,192,101,91
60580,187751,18885,90220,12322,168866,192,101,91
60585,187761,18886,90225,12323,168875,192,101,91
60590,187782,18890,90235,12326,168892,192,101,91
60595,187792,18890,90239,12326,168902,192,101,91
60600,187813,18893,90247,12328,168920,192,101,91
60605,187823,18894,90252,12329,168929,192,101,91
60610,187844,18898,90263,12332,168946,192,101,91
60615,187854,18899,90268,12332,168955,192,101,91
60620,187875,18902,90276,12332,168973,192,101,91
60625,187885,18903,90279,12332,168982,192,101,91
60630,187906,18907,90288,12335,168999,192,101,91
60635,187916,18908,90293,12335,169008,192,101,91
60640,187937,18911,90303,12337,169026,192,101,91
60645,187947,18912,90310,12337,169035,192,101,91
60650,187968,18918,90323,12341,169050,192,101,91
60655,187978,18919,90328,12341,169058,192,101,91
60660,187999,18924,90336,12344,169074,192,101,91
60665,188009,18925,90339,12345,169084,192,101,91
60670,188030,18925,90348,12345,169105,192,101,91
60675,188040,18925,90351,12345,169115,192,101,91
60680,188061,18925,90362,12345,169136,192,101,91
60685,188071,18925,90369,12345,169146,192,101,91
60690,188092,18925,90382,12345,169167,192,101,91
60695,188102,18925,90387,12345,169177,192,101,91
60700,188123,18925,90400,12345,169198,192,101,91
60705,188133,18925,90404,12345,169208,192,101,91
60710,188154,18925,90419,12345,169229,192,101,91
60715,188164,18925,90427,12345,169239,192,101,91
60720,188185,18925,90437,12345,169260,192,101,91
60725,188195,18925,90443,12345,169270,192,101,91
60730,188216,18926,90455,12346,169290,192,101,91
60735,188226,18926,90456,12346,169300,192,101,91
60740,188247,18927,90465,12347,169320,192,101,91
60745,188257,18928,90471,12348,169329,192,101,91
60750,188278,18929,90481,12349,169349,192,101,91
60755,188288,18929,90489,12349,169359,192,101,91
60760,188309,18930,90499,12349,169379,192,101,91
60765,188319,18930,90504,12349,169389,192,101,91
60770,188340,18934,90512,12352,169406,192,101,91
60775,188350,18936,90518,12353,169414,192,101,91
60780,188371,18939,90527,12355,169431,192,101,91
60785,188381,18942,90532,12357,169438,192,101,91
60790,188402,18946,90541,12360,169456,192,101,91
60795,188412,18947,90544,12360,169465,192,101,91
60800,188433,18951,90555,12362,169482,192,101,91
60805,188443,18952,90559,12362,169491,192,101,91
60810,188464,18955,90569,12363,169509,192,101,91
60815,188474,18956,90571,12363,169517,192,101,91
60820,188495,18960,90584,12366,169535,192,101,91
60825,188505,18961,90591,12366,169544,192,101,91
60830,188526,18964,90601,12367,169562,192,101,91
60835,188536,18965,90603,12368,169571,192,101,91
60840,188557,18969,90611,12371,169588,192,101,91
60845,188567,18970,90618,12372,169597,192,101,91
60850,188588,18971,90629,12373,169617,192,101,91
60855,188598,18972,90638,12374,169626,192,101,91
60860,188619,18973,90650,12375,169646,192,101,91
60865,188629,18974,90653,12375,169655,192,101,91
60870,188650,18975,90661,12376,169675,192,101,91
60875,188660,18976,90665,12377,169684,192,101,91
60880,188681,18977,90676,12378,169704,192,101,91
60885,188691,18978,90681,12378,169713,192,101,91
60890,188712,18980,90693,12379,169732,192,101,91
60895,188722,18981,90700,12379,169741,192,101,91
60900,188743,18982,90710,12379,169761,192,101,91
60905,188753,18983,90715,12380,169770,192,101,91
60910,188774,18986,90728,12383,169788,192,101,91
60915,188784,18986,90730,12383,169798,192,101,91
60920,188805,18988,90742,12384,169817,192,101,91
60925,188815,18988,90749,12384,169827,192,101,91
60930,188836,18990,90761,12385,169846,192,101,91
60935,188846,18990,90766,12385,169856,192,101,91
60940,188867,18992,90771,12386,169875,192,101,91
60945,188877,18992,90776,12386,169884,192,101,91
60950,188898,18996,90784,12388,169902,192,101,91
60955,188908,18997,90787,12389,169911,192,101,91
60960,188929,19001,90798,12392,169928,192,101,91
60965,188939,19001,90802,12392,169938,192,101,91
60970,188960,19001,90818,12392,169959,192,101,91
60975,188970,19001,90823,12392,169969,192,101,91
60980,188991,19001,90829,12392,169990,192,101,91
60985,189001,19001,90832,12392,170000,192,101,91
60990,189022,19001,90843,12392,170021,192,101,91
60995,189032,19001,90848,12392,170031,192,101,91
61000,189053,19001,90860,12392,170052,192,101,91
61005,189063,19001,90867,12392,170062,192,101,91
61010,189084,19001,90878,12392,170083,192,101,91
61015,189094,19002,90886,12393,170092,192,101,91
61020,189115,19002,90893,12393,170113,192,101,91
61025,189125,19003,90896,12393,170122,192,101,91
61030,189146,19004,90902,12393,170142,192,101,91
61035,189156,19005,90907,12394,170151,192,101,91
61040,189177,19006,90913,12395,170171,192,101,91
61045,189187,19007,90919,12395,170180,192,101,91
61050,189208,19009,90929,12397,170198,192,101,91
61055,189218,19011,90935,12398,170207,192,101,91
61060,189239,19012,90942,12399,170226,192,101,91
61065,189249,19014,90945,12400,170235,192,101,91
61070,189270,19018,90954,12403,170252,192,101,91
61075,189280,19020,90960,12405,170259,192,101,91
61080,189301,19025,90970,12409,170276,192,101,91
61085,189311,19026,90975,12409,170285,192,101,91
61090,189332,19029,90989,12411,170303,192,101,91
61095,189342,19030,90994,12411,170312,192,101,91
61100,189363,19033,91003,12413,170330,192,101,91
61105,189373,19034,91009,12414,170339,192,101,91
61110,189394,19037,91021,12416,170357,192,101,91
61115,189404,19038,91027,12416,170366,192,101,91
61120,189425,19041,91036,12418,170384,192,101,91
61125,189435,19042,91040,12418,170393,192,101,91
61130,189456,19042,91056,12418,170414,192,101,91
61135,189466,19043,91061,12418,170423,192,101,91
61140,189487,19043,91072,12418,170444,192,101,91
61145,189497,19043,91079,12418,170454,192,101,91
61150,189518,19043,91090,12418,170475,192,101,91
61155,189528,19043,91095,12418,170485,192,101,91
61160,189549,19043,91104,12418,170506,192,101,91
61165,189559,19043,91109,12418,170516,192,101,91
61170,189580,19043,91120,12418,170537,192,101,91
61175,189590,19043,91125,12418,170547,192,101,91
61180,189611,19043,91137,12418,170568,192,101,91
61185,189621,19043,91140,12418,170577,192,101,91
61190,189642,19046,91148,12420,170596,192,101,91
61195,189652,19047,91152,12421,170604,192,101,91
61200,189673,19051,91161,12424,170622,192,101,91
61205,189683,19051,91166,12424,170632,192,101,91
61210,189704,19053,91180,12425,170651,192,101,91
61215,189714,19054,91185,12426,170660,192,101,91
61220,189735,19056,91197,12428,170679,192,101,91
61225,189745,19057,91204,12429,170688,192,101,91
61230,189766,19060,91214,12431,170706,192,101,91
61235,189776,19061,91218,12432,170715,192,101,91
61240,189797,19064,91226,12432,170733,192,101,91
61245,189807,19065,91231,12433,170742,192,101,91
61250,189828,19069,91240,12437,170759,192,101,91
61255,189838,19070,91246,12438,170768,192,101,91
61260,189859,19073,91254,12439,170785,192,101,91
61265,189869,19076,91258,12441,170793,192,101,91
61270,189890,19079,91266,12442,170811,192,101,91
61275,189900,19081,91270,12443,170819,192,101,91
61280,189921,19083,91281,12444,170838,192,101,91
61285,189931,19084,91286,12445,170847,192,101,91
61290,189952,19087,91291,12446,170865,192,101,91
61295,189962,19088,91296,12447,170874,192,101,91
61300,189983,19091,91307,12449,170892,192,101,91
61305,189993,19092,91311,12449,170901,192,101,91
61310,190014,19095,91319,12452,170919,192,101,91
61315,190024,19096,91322,12452,170928,192,101,91
61320,190045,19099,91331,12453,170946,192,101,91
61325,190055,19100,91338,12453,170955,192,101,91
61330,190076,19102,91347,12454,170974,192,101,91
61335,190086,19104,91354,12455,170982,192,101,91
61340,190107,19106,91358,12456,171001,192,101,91
61345,190117,19107,91359,12457,171010,192,101,91
61350,190138,19109,91374,12459,171029,192,101,91
61355,190148,19110,91376,12459,171038,192,101,91
61360,190169,19112,91385,12460,171057,192,101,91
61365,190179,19113,91388,12460,171066,192,101,91
61370,190200,19115,91400,12461,171085,192,101,91
61375,190210,19116,91407,12461,171094,192,101,91
61380,190231,19118,91414,12462,171112,192,101,91
61385,190241,19120,91418,12464,171121,192,101,91
61390,190262,19121,91428,12465,171141,192,101,91
61395,190272,19122,91433,12465,171150,192,101,91
61400,190293,19123,91444,12465,171170,192,101,91
61405,190303,19124,91447,12466,171179,192,101,91
61410,190324,19125,91452,12466,171199,192,101,91
61415,190334,19126,91458,12466,171208,192,101,91
61420,190355,19127,91467,12467,171228,192,101,91
61425,190365,19128,91474,12468,171237,192,101,91
61430,190386,19133,91487,12473,171253,192,101,91
61435,190396,19135,91494,12475,171261,192,101,91
61440,190417,19139,91509,12479,171278,192,101,91
61445,190427,19140,91516,12480,171286,192,101,91
61450,190448,19144,91523,12482,171304,192,101,91
61455,190458,19144,91527,12482,171313,192,101,91
61460,190479,19149,91543,12486,171330,192,101,91
61465,190489,19149,91550,12486,171340,192,101,91
61470,190510,19152,91559,12488,171358,192,101,91
61475,190520,19152,91564,12488,171367,192,101,91
61480,190541,19155,91571,12489,171386,192,101,91
61485,190551,19155,91577,12489,171396,192,101,91
61490,190572,19158,91586,12492,171414,192,101,91
61495,190582,19158,91588,12492,171424,192,101,91
61500,190603,19160,91603,12493,171443,192,101,91
61505,190613,19160,91609,12493,171453,192,101,91
61510,190634,19161,91619,12493,171473,192,101,91
61515,190644,19161,91625,12493,171483,192,101,91
61520,190665,19162,91633,12493,171503,192,101,91
61525,190675,19162,91641,12493,171513,192,101,91
61530,190696,19163,91652,12493,171533,192,101,91
61535,190706,19163,91657,12493,171543,192,101,91
61540,190727,19165,91667,12494,171562,192,101,91
61545,190737,19166,91673,12495,171571,192,101,91
61550,190758,19168,91686,12497,171589,192,101,91
61555,190768,19170,91690,12498,171598,192,101,91
61560,190789,19171,91702,12499,171617,192,101,91
61565,190799,19173,91706,12501,171626,192,101,91
61570,190820,19176,91718,12503,171644,192,101,91
61575,190830,19177,91724,12503,171653,192,101,91
61580,190851,19179,91734,12505,171672,192,101,91
61585,190861,19181,91739,12506,171680,192,101,91
61590,190882,19184,91753,12508,171698,192,101,91
61595,190892,19186,91756,12509,171706,192,101,91
61600,190913,19189,91766,12510,171724,192,101,91
61605,190923,19191,91770,12511,171732,192,101,91
61610,190944,19195,91779,12514,171749,192,101,91
61615,190954,19197,91783,12516,171757,192,101,91
61620,190975,19201,91796,12518,171774,192,101,91
61625,190985,19202,91800,12518,171783,192,101,91
61630,191006,19205,91814,12521,171801,192,101,91
61635,191016,19206,91817,12521,171810,192,101,91
61640,191037,19208,91828,12522,171829,192,101,91
61645,191047,19209,91830,12522,171838,192,101,91
61650,191068,19211,91840,12523,171857,192,101,91
61655,191078,19212,91844,12524,171866,192,101,91
61660,191099,19214,91859,12526,171885,192,101,91
61665,191109,19215,91862,12526,171893,192,101,91
61670,191130,19218,91872,12529,171912,192,101,91
61675,191140,19219,91877,12529,171921,192,101,91
61680,191161,19221,91886,12530,171940,192,101,91
61685,191171,19222,91892,12530,171949,192,101,91
61690,191192,19226,91901,12533,171966,192,101,91
61695,191202,19227,91906,12533,171975,192,101,91
61700,191223,19230,91916,12535,171993,192,101,91
61705,191233,19231,91920,12535,172002,192,101,91
61710,191254,19235,91933,12537,172019,192,101,91
61715,191264,19236,91939,12538,172028,192,101,91
61720,191285,19240,91948,12541,172045,192,101,91
61725,191295,19241,91955,12542,172054,192,101,91
61730,191316,19245,91969,12545,172071,192,101,91
61735,191326,19246,91973,12545,172080,192,101,91
61740,191347,19249,91981,12546,172097,192,101,91
61745,191357,19252,91987,12549,172105,192,101,91
61750,191378,19254,91995,12551,172124,192,101,91
61755,191388,19256,92001,12553,172132,192,101,91
61760,191409,19259,92013,12554,172149,192,101,91
61765,191419,19263,92021,12557,172156,192,101,91
61770,191440,19265,92029,12557,172175,192,101,91
61775,191450,19266,92033,12558,172184,192,101,91
61780,191471,19268,92043,12559,172203,192,101,91
61785,191481,19269,92047,12560,172212,192,101,91
61790,191502,19273,92055,12563,172229,192,101,91
61795,191512,19274,92058,12563,172238,192,101,91
61800,191533,19277,92069,12565,172255,192,101,91
61805,191543,19278,92075,12566,172264,192,101,91
61810,191564,19280,92086,12567,172284,192,101,91
61815,191574,19280,92090,12567,172294,192,101,91
61820,191595,19281,92105,12567,172314,192,101,91
61825,191605,19281,92108,12567,172324,192,101,91
61830,191626,19282,92118,12567,172344,192,101,91
61835,191636,19282,92124,12567,172353,192,101,91
61840,191657,19284,92130,12568,172373,192,101,91
61845,191667,19284,92133,12568,172383,192,101,91
61850,191688,19287,92141,12569,172401,192,101,91
61855,191698,19287,92147,12569,172410,192,101,91
61860,191719,19290,92158,12571,172429,192,101,91
61865,191729,19291,92164,12572,172438,192,101,91
61870,191750,19294,92175,12575,172456,192,101,91
61875,191760,19295,92182,12576,172465,192,101,91
61880,191781,19298,92190,12577,172483,192,101,91
61885,191791,19299,92192,12577,172492,192,101,91
61890,191812,19302,92204,12579,172510,192,101,91
61895,191822,19303,92212,12580,172519,192,101,91
61900,191843,19305,92220,12581,172538,192,101,91
61905,191853,19306,92226,12582,172547,192,101,91
61910,191874,19310,92236,12585,172563,192,101,91
61915,191884,19312,92239,12586,172572,192,101,91
61920,191905,19316,92250,12589,172588,192,101,91
61925,191915,19319,92255,12592,172596,192,101,91
61930,191936,19322,92267,12594,172614,192,101,91
61935,191946,19323,92272,12594,172623,192,101,91
61940,191967,19326,92279,12597,172641,192,101,91
61945,191977,19327,92285,12598,172650,192,101,91
61950,191998,19330,92294,12601,172668,192,101,91
61955,192008,19331,92296,12601,172677,192,101,91
61960,192029,19334,92306,12602,172695,192,101,91
61965,192039,19336,92314,12604,172703,192,101,91
61970,192060,19340,92329,12607,172720,192,101,91
61975,192070,19341,92333,12607,172729,192,101,91
61980,192091,19345,92341,12609,172746,192,101,91
61985,192101,19346,92343,12610,172755,192,101,91
61990,192122,19346,92354,12610,172776,192,101,91
61995,192132,19348,92359,12612,172784,192,101,91
62000,192153,19348,92368,12612,172805,192,101,91
62005,192163,19349,92371,12612,172814,192,101,91
62010,192184,19349,92381,12612,172835,192,101,91
62015,192194,19350,92385,12612,172844,192,101,91
62020,192215,19351,92401,12613,172864,192,101,91
62025,192225,19352,92405,12614,172873,192,101,91
62030,192246,19353,92416,12615,172893,192,101,91
62035,192256,19354,92419,12615,172902,192,101,91
62040,192277,19355,92426,12616,172922,192,101,91
62045,192287,19355,92428,12616,172932,192,101,91
62050,192308,19355,92439,12616,172953,192,101,91
62055,192318,19355,92444,12616,172963,192,101,91
62060,192339,19355,92455,12616,172984,192,101,91
62065,192349,19355,92459,12616,172994,192,101,91
62070,192370,19355,92472,12616,173015,192,101,91
62075,192380,19355,92476,12616,173025,192,101,91
62080,192401,19355,92487,12616,173046,192,101,91
62085,192411,19355,92490,12616,173056,192,101,91
62090,192432,19358,92500,12617,173074,192,101,91
62095,192442,19359,92505,12618,173082,192,101,91
62100,192463,19363,92516,12620,173100,192,101,91
62105,192473,19364,92525,12621,173108,192,101,91
62110,192494,19367,92534,12623,173127,192,101,91
62115,192504,19368,92537,12623,173136,192,101,91
62120,192525,19370,92551,12625,173155,192,101,91
62125,192535,19371,92553,12625,173164,192,101,91
62130,192556,19373,92563,12626,173183,192,101,91
62135,192566,19374,92567,12626,173192,192,101,91
62140,192587,19376,92575,12627,173211,192,101,91
62145,192597,19377,92579,12627,173220,192,101,91
62150,192618,19379,92588,12628,173239,192,101,91
62155,192628,19380,92593,12628,173248,192,101,91
62160,192649,19382,92602,12629,173267,192,101,91
62165,192659,19384,92606,12630,173275,192,101,91
62170,192680,19387,92618,12633,173293,192,101,91
62175,192690,19388,92626,12634,173301,192,101,91
62180,192711,19392,92635,12636,173319,192,101,91
62185,192721,19392,92638,12636,173329,192,101,91
62190,192742,19394,92648,12637,173348,192,101,91
62195,192752,19394,92653,12637,173357,192,101,91
62200,192773,19398,92664,12640,173375,192,101,91
62205,192783,19398,92667,12640,173384,192,101,91
62210,192804,19403,92677,12643,173401,192,101,91
62215,192814,19403,92681,12643,173410,192,101,91
62220,192835,19407,92692,12646,173428,192,101,91
62225,192845,19407,92698,12646,173438,192,101,91
62230,192866,19410,92708,12647,173456,192,101,91
62235,192876,19410,92713,12647,173466,192,101,91
62240,192897,19413,92724,12649,173484,192,101,91
62245,192907,19413,92731,12649,173494,192,101,91
62250,192928,19416,92735,12649,173512,192,101,91
62255,192938,19416,92742,12649,173522,192,101,91
62260,192959,19419,92752,12650,173540,192,101,91
62265,192969,19419,92758,12650,173550,192,101,91
62270,192990,19422,92768,12651,173568,192,101,91
62275,193000,19423,92773,12651,173577,192,101,91
62280,193021,19427,92782,12653,173594,192,101,91
62285,193031,19429,92790,12655,173602,192,101,91
62290,193052,19433,92800,12658,173619,192,101,91
62295,193062,19435,92804,12659,173627,192,101,91
62300,193083,19437,92812,12661,173646,192,101,91
62305,193093,19439,92820,12663,173654,192,101,91
62310,193114,19442,92830,12665,173672,192,101,91
62315,193124,19444,92836,12666,173680,192,101,91
62320,193145,19445,92847,12667,173700,192,101,91
62325,193155,19446,92851,12667,173709,192,101,91
62330,193176,19447,92864,12667,173729,192,101,91
62335,193186,19449,92870,12669,173737,192,101,91
62340,193207,19450,92883,12669,173757,192,101,91
62345,193217,19451,92890,12669,173766,192,101,91
62350,193238,19452,92902,12669,173785,192,101,91
62355,193248,19454,92906,12671,173794,192,101,91
62360,193269,19455,92916,12672,173814,192,101,91
62365,193279,19457,92921,12673,173822,192,101,91
62370,193300,19458,92931,12673,173842,192,101,91
62375,193310,19460,92937,12674,173850,192,101,91
62380,193331,19461,92947,12674,173870,192,101,91
62385,193341,19463,92951,12676,173878,192,101,91
62390,193362,19464,92966,12677,173898,192,101,91
62395,193372,19465,92967,12677,173907,192,101,91
62400,193393,19467,92979,12678,173926,192,101,91
62405,193403,19468,92986,12679,173935,192,101,91
62410,193424,19471,92992,12680,173953,192,101,91
62415,193434,19472,92997,12681,173962,192,101,91
62420,193455,19476,93005,12683,173979,192,101,91
62425,193465,19477,93009,12683,173988,192,101,91
62430,193486,19481,93019,12685,174005,192,101,91
62435,193496,19483,93023,12686,174013,192,101,91
62440,193517,19488,93034,12689,174029,192,101,91
62445,193527,19490,93039,12691,174037,192,101,91
62450,193548,19493,93047,12691,174055,192,101,91
62455,193558,19495,93049,12692,174063,192,101,91
62460,193579,19499,93059,12693,174080,192,101,91
62465,193589,19500,93065,12694,174089,192,101,91
62470,193610,19502,93073,12694,174108,192,101,91
62475,193620,19503,93076,12694,174117,192,101,91
62480,193641,19506,93089,12696,174135,192,101,91
62485,193651,19507,93094,12697,174144,192,101,91
62490,193672,19510,93107,12699,174161,192,101,91
62495,193682,19512,93112,12701,174170,192,101,91
62500,193703,19515,93122,12704,174187,192,101,91
62505,193713,19517,93126,12705,174196,192,101,91
62510,193734,19522,93139,12709,174212,192,101,91
62515,193744,19522,93145,12709,174222,192,101,91
62520,193765,19526,93159,12713,174239,192,101,91
62525,193775,19526,93165,12713,174249,192,101,91
62530,193796,19527,93173,12713,174269,192,101,91
62535,193806,19527,93178,12713,174279,192,101,91
62540,193827,19528,93187,12713,174299,192,101,91
62545,193837,19528,93189,12713,174309,192,101,91
62550,193858,19529,93200,12714,174329,192,101,91
62555,193868,19529,93205,12714,174338,192,101,91
62560,193889,19531,93217,12715,174358,192,101,91
62565,193899,19531,93221,12715,174368,192,101,91
62570,193920,19532,93233,12716,174388,192,101,91
62575,193930,19532,93239,12716,174397,192,101,91
62580,193951,19534,93248,12718,174417,192,101,91
62585,193961,19534,93251,12718,174427,192,101,91
62590,193982,19535,93259,12718,174447,192,101,91
62595,193992,19535,93263,12718,174456,192,101,91
62600,194013,19537,93270,12719,174476,192,101,91
62605,194023,19537,93275,12719,174486,192,101,91
62610,194044,19538,93282,12719,174506,192,101,91
62615,194054,19539,93286,12719,174515,192,101,91
62620,194075,19540,93295,12719,174535,192,101,91
62625,194085,19541,93302,12719,174543,192,101,91
62630,194106,19548,93317,12725,174558,192,101,91
62635,194116,19549,93321,12725,174566,192,101,91
62640,194137,19555,93332,12730,174582,192,101,91
62645,194147,19556,93334,12730,174591,192,101,91
62650,194168,19558,93346,12730,174610,192,101,91
62655,194178,19559,93351,12730,174619,192,101,91
62660,194199,19561,93357,12731,174638,192,101,91
62665,194209,19562,93358,12731,174647,192,101,91
62670,194230,19564,93367,12733,174666,192,101,91
62675,194240,19565,93373,12733,174675,192,101,91
62680,194261,19567,93382,12734,174694,192,101,91
62685,194271,19568,93387,12734,174703,192,101,91
62690,194292,19570,93397,12735,174722,192,101,91
62695,194302,19571,93403,12736,174731,192,101,91
62700,194323,19573,93415,12738,174750,192,101,91
62705,194333,19574,93420,12738,174759,192,101,91
62710,194354,19576,93436,12739,174778,192,101,91
62715,194364,19577,93439,12740,174787,192,101,91
62720,194385,19579,93444,12740,174806,192,101,91
62725,194395,19580,93448,12741,174815,192,101,91
62730,194416,19582,93458,12741,174834,192,101,91
62735,194426,19583,93462,12741,174843,192,101,91
62740,194447,19585,93474,12743,174862,192,101,91
62745,194457,19586,93480,12744,174871,192,101,91
62750,194478,19590,93492,12747,174888,192,101,91
62755,194488,19592,93498,12749,174896,192,101,91
62760,194509,19596,93509,12750,174913,192,101,91
62765,194519,19596,93514,12750,174923,192,101,91
62770,194540,19597,93523,12750,174943,192,101,91
62775,194550,19597,93527,12750,174953,192,101,91
62780,194571,19598,93531,12750,174973,192,101,91
62785,194581,19598,93537,12750,174983,192,101,91
62790,194602,19600,93549,12752,175002,192,101,91
62795,194612,19600,93554,12752,175012,192,101,91
62800,194633,19601,93566,12753,175032,192,101,91
62805,194643,19601,93569,12753,175042,192,101,91
62810,194664,19602,93580,12754,175062,192,101,91
62815,194674,19602,93585,12754,175072,192,101,91
62820,194695,19603,93593,12754,175092,192,101,91
62825,194705,19604,93599,12754,175101,192,101,91
62830,194726,19607,93612,12757,175119,192,101,91
62835,194736,19608,93618,12757,175127,192,101,91
62840,194757,19612,93627,12759,175145,192,101,91
62845,194767,19613,93634,12760,175153,192,101,91
62850,194788,19617,93644,12763,175171,192,101,91
62855,194798,19618,93651,12764,175180,192,101,91
62860,194819,19621,93659,12766,175198,192,101,91
62865,194829,19623,93663,12767,175206,192,101,91
62870,194850,19625,93670,12767,175225,192,101,91
62875,194860,19626,93674,12767,175233,192,101,91
62880,194881,19631,93684,12770,175250,192,101,91
62885,194891,19631,93686,12770,175260,192,101,91
62890,194912,19633,93696,12771,175279,192,101,91
62895,194922,19633,93699,12771,175289,192,101,91
62900,194943,19634,93704,12771,175309,192,101,91
62905,194953,19634,93706,12771,175319,192,101,91
62910,194974,19635,93716,12771,175339,192,101,91
62915,194984,19635,93719,12771,175349,192,101,91
62920,195005,19636,93725,12771,175369,192,101,91
62925,195015,19636,93729,12771,175379,192,101,91
62930,195036,19637,93739,12772,175399,192,101,91
62935,195046,19637,93743,12772,175409,192,101,91
62940,195067,19638,93751,12772,175429,192,101,91
62945,195077,19638,93755,12772,175439,192,101,91
62950,195098,19639,93762,12772,175459,192,101,91
62955,195108,19639,93766,12772,175469,192,101,91
62960,195129,19640,93778,12773,175489,192,101,91
62965,195139,19640,93784,12773,175499,192,101,91
62970,195160,19641,93790,12773,175519,192,101,91
62975,195170,19641,93794,12773,175529,192,101,91
62980,195191,19643,93802,12775,175548,192,101,91
62985,195201,19643,93806,12775,175558,192,101,91
62990,195222,19646,93819,12777,175576,192,101,91
62995,195232,19647,93824,12777,175584,192,101,91
63000,195253,19652,93832,12779,175601,192,101,91
63005,195263,19654,93837,12780,175609,192,101,91
63010,195284,19657,93850,12783,175626,192,101,91
63015,195294,19659,93857,12784,175635,192,101,91
63020,195315,19660,93863,12784,175655,192,101,91
63025,195325,19661,93867,12784,175664,192,101,91
63030,195346,19662,93879,12785,175684,192,101,91
63035,195356,19663,93885,12786,175693,192,101,91
63040,195377,19664,93896,12786,175713,192,101,91
63045,195387,19665,93900,12787,175722,192,101,91
63050,195408,19667,93906,12789,175741,192,101,91
63055,195418,19668,93910,12790,175750,192,101,91
63060,195439,19670,93922,12792,175769,192,101,91
63065,195449,19671,93924,12792,175778,192,101,91
63070,195470,19672,93936,12793,175798,192,101,91
63075,195480,19673,93941,12793,175807,192,101,91
63080,195501,19675,93952,12795,175826,192,101,91
63085,195511,19676,93959,12796,175835,192,101,91
63090,195532,19677,93970,12797,175855,192,101,91
63095,195542,19678,93977,12798,175864,192,101,91
63100,195563,19680,93988,12799,175883,192,101,91
63105,195573,19681,93993,12800,175892,192,101,91
63110,195594,19684,94000,12801,175910,192,101,91
63115,195604,19685,94005,12801,175919,192,101,91
63120,195625,19689,94012,12803,175935,192,101,91
63125,195635,19691,94017,12805,175943,192,101,91
63130,195656,19693,94026,12807,175963,192,101,91
63135,195666,19694,94030,12808,175972,192,101,91
63140,195687,19695,94041,12809,175992,192,101,91
63145,195697,19695,94046,12809,176001,192,101,91
63150,195718,19697,94057,12811,176021,192,101,91
63155,195728,19697,94060,12811,176031,192,101,91
63160,195749,19698,94072,12812,176051,192,101,91
63165,195759,19699,94077,12813,176060,192,101,91
63170,195780,19700,94085,12813,176080,192,101,91
63175,195790,19701,94091,12814,176089,192,101,91
63180,195811,19702,94101,12815,176109,192,101,91
63185,195821,19703,94107,12816,176118,192,101,91
63190,195842,19704,94114,12816,176138,192,101,91
63195,195852,19707,94122,12819,176145,192,101,91
63200,195873,19708,94132,12819,176165,192,101,91
63205,195883,19710,94138,12820,176173,192,101,91
63210,195904,19711,94152,12821,176193,192,101,91
63215,195914,19713,94157,12823,176201,192,101,91
63220,195935,19714,94168,12823,176221,192,101,91
63225,195945,19715,94174,12823,176230,192,101,91
63230,195966,19719,94183,12824,176247,192,101,91
63235,195976,19720,94188,12825,176256,192,101,91
63240,195997,19723,94202,12827,176274,192,101,91
63245,196007,19724,94211,12828,176282,192,101,91
63250,196028,19728,94221,12832,176300,192,101,91
63255,196038,19729,94224,12832,176308,192,101,91
63260,196059,19732,94232,12834,176327,192,101,91
63265,196069,19733,94237,12834,176335,192,101,91
63270,196090,19737,94245,12837,176353,192,101,91
63275,196100,19738,94250,12837,176361,192,101,91
63280,196121,19742,94261,12839,176379,192,101,91
63285,196131,19743,94264,12839,176387,192,101,91
63290,196152,19747,94272,12842,176405,192,101,91
63295,196162,19748,94279,12842,176413,192,101,91
63300,196183,19752,94291,12844,176430,192,101,91
63305,196193,19753,94296,12845,176440,192,101,91
63310,196214,19753,94306,12845,176461,192,101,91
63315,196224,19753,94311,12845,176471,192,101,91
63320,196245,19753,94319,12845,176492,192,101,91
63325,196255,19753,94323,12845,176502,192,101,91
63330,196276,19753,94334,12845,176523,192,101,91
63335,196286,19753,94339,12845,176533,192,101,91
63340,196307,19753,94352,12845,176554,192,101,91
63345,196317,19754,94358,12846,176562,192,101,91
63350,196338,19756,94366,12848,176582,192,101,91
63355,196348,19757,94373,12849,176590,192,101,91
63360,196369,19759,94383,12850,176610,192,101,91
63365,196379,19760,94386,12850,176619,192,101,91
63370,196400,19761,94399,12850,176639,192,101,91
63375,196410,19762,94402,12850,176648,192,101,91
63380,196431,19763,94411,12851,176668,192,101,91
63385,196441,19764,94416,12851,176677,192,101,91
63390,196462,19766,94429,12853,176696,192,101,91
63395,196472,19767,94432,12853,176705,192,101,91
63400,196493,19768,94441,12854,176725,192,101,91
63405,196503,19769,94447,12854,176734,192,101,91
63410,196524,19773,94456,12855,176751,192,101,91
63415,196534,19774,94458,12855,176760,192,101,91
63420,196555,19777,94468,12856,176778,192,101,91
63425,196565,19777,94472,12856,176788,192,101,91
63430,196586,19780,94478,12857,176806,192,101,91
63435,196596,19780,94481,12857,176816,192,101,91
63440,196617,19783,94487,12858,176834,192,101,91
63445,196627,19783,94489,12858,176844,192,101,91
63450,196648,19786,94498,12859,176862,192,101,91
63455,196658,19786,94503,12859,176872,192,101,91
63460,196679,19789,94511,12860,176890,192,101,91
63465,196689,19789,94517,12860,176900,192,101,91
63470,196710,19792,94527,12862,176918,192,101,91
63475,196720,19793,94530,12863,176927,192,101,91
63480,196741,19797,94537,12865,176944,192,101,91
63485,196751,19800,94543,12868,176951,192,101,91
63490,196772,19804,94554,12872,176968,192,101,91
63495,196782,19807,94562,12875,176975,192,101,91
63500,196803,19810,94575,12877,176992,192,101,91
63505,196813,19812,94579,12878,177001,192,101,91
63510,196834,19816,94588,12880,177018,192,101,91
63515,196844,19817,94591,12881,177027,192,101,91
63520,196865,19821,94601,12884,177044,192,101,91
63525,196875,19823,94606,12886,177052,192,101,91
63530,196896,19826,94614,12888,177070,192,101,91
63535,196906,19827,94618,12889,177079,192,101,91
63540,196927,19831,94625,12892,177096,192,101,91
63545,196937,19832,94629,12892,177104,192,101,91
63550,196958,19835,94637,12894,177123,192,101,91
63555,196968,19836,94642,12895,177131,192,101,91
63560,196989,19840,94651,12898,177149,192,101,91
63565,196999,19841,94659,12899,177157,192,101,91
63570,197020,19846,94666,12903,177174,192,101,91
63575,197030,19847,94670,12904,177182,192,101,91
63580,197051,19852,94683,12908,177199,192,101,91
63585,197061,19853,94689,12908,177207,192,101,91
63590,197082,19856,94696,12909,177226,192,101,91
63595,197092,19857,94699,12909,177235,192,101,91
63600,197113,19858,94710,12909,177255,192,101,91
63605,197123,19859,94713,12910,177264,192,101,91
63610,197144,19860,94724,12910,177284,192,101,91
63615,197154,19861,94727,12910,177293,192,101,91
63620,197175,19862,94739,12910,177312,192,101,91
63625,197185,19864,94744,12912,177321,192,101,91
63630,197206,19866,94754,12913,177340,192,101,91
63635,197216,19867,94758,12914,177349,192,101,91
63640,197237,19868,94770,12915,177368,192,101,91
63645,197247,19870,94774,12916,177377,192,101,91
63650,197268,19872,94783,12916,177395,192,101,91
63655,197278,19874,94785,12917,177404,192,101,91
63660,197299,19876,94794,12919,177422,192,101,91
63665,197309,19877,94800,12920,177432,192,101,91
63670,197330,19880,94808,12921,177450,192,101,91
63675,197340,19880,94813,12921,177460,192,101,91
63680,197361,19882,94824,12923,177479,192,101,91
63685,197371,19882,94829,12923,177489,192,101,91
63690,197392,19884,94839,12925,177508,192,101,91
63695,197402,19884,94842,12925,177518,192,101,91
63700,197423,19887,94848,12927,177536,192,101,91
63705,197433,19887,94853,12927,177546,192,101,91
63710,197454,19890,94864,12929,177564,192,101,91
63715,197464,19890,94870,12929,177574,192,101,91
63720,197485,19893,94881,12930,177592,192,101,91
63725,197495,19893,94884,12930,177602,192,101,91
63730,197516,19896,94897,12932,177620,192,101,91
63735,197526,19896,94898,12932,177630,192,101,91
63740,197547,19897,94908,12932,177650,192,101,91
63745,197557,19897,94914,12932,177660,192,101,91
63750,197578,19898,94923,12932,177680,192,101,91
63755,197588,19898,94929,12932,177690,192,101,91
63760,197609,19899,94940,12932,177710,192,101,91
63765,197619,19899,94946,12932,177720,192,101,91
63770,197640,19903,94956,12934,177736,192,101,91
63775,197650,19905,94962,12936,177744,192,101,91
63780,197671,19911,94975,12942,177760,192,101,91
63785,197681,19913,94979,12943,177767,192,101,91
63790,197702,19918,94993,12947,177783,192,101,91
63795,197712,19920,94999,12948,177792,192,101,91
63800,197733,19924,95012,12952,177809,192,101,91
63805,197743,19925,95017,12952,177817,192,101,91
63810,197764,19930,95026,12956,177834,192,101,91
63815,197774,19932,95032,12957,177841,192,101,91
63820,197795,19937,95043,12960,177858,192,101,91
63825,197805,19938,95051,12961,177866,192,101,91
63830,197826,19942,95059,12963,177884,192,101,91
63835,197836,19943,95065,12964,177893,192,101,91
63840,197857,19945,95070,12965,177912,192,101,91
63845,197867,19946,95071,12965,177921,192,101,91
63850,197888,19947,95082,12965,177941,192,101,91
63855,197898,19948,95087,12965,177949,192,101,91
63860,197919,19950,95096,12967,177969,192,101,91
63865,197929,19951,95102,12967,177978,192,101,91
63870,197950,19953,95114,12968,177997,192,101,91
63875,197960,19954,95118,12968,178005,192,101,91
63880,197981,19957,95131,12970,178024,192,101,91
63885,197991,19958,95134,12970,178033,192,101,91
63890,198012,19960,95140,12971,178052,192,101,91
63895,198022,19961,95146,12972,178061,192,101,91
63900,198043,19964,95158,12975,178078,192,101,91
63905,198053,19965,95161,12976,178088,192,101,91
63910,198074,19967,95171,12978,178107,192,101,91
63915,198084,19967,95174,12978,178117,192,101,91
63920,198105,19969,95186,12978,178136,192,101,91
63925,198115,19970,95193,12979,178145,192,101,91
63930,198136,19972,95201,12979,178164,192,101,91
63935,198146,19972,95206,12979,178174,192,101,91
63940,198167,19974,95218,12979,178193,192,101,91
63945,198177,19974,95222,12979,178203,192,101,91
63950,198198,19976,95234,12980,178222,192,101,91
63955,198208,19976,95238,12980,178232,192,101,91
63960,198229,19979,95249,12983,178250,192,101,91
63965,198239,19980,95253,12983,178259,192,101,91
63970,198260,19982,95261,12985,178278,192,101,91
63975,198270,19983,95262,12985,178287,192,101,91
63980,198291,19985,95274,12987,178306,192,101,91
63985,198301,19986,95279,12987,178315,192,101,91
63990,198322,19987,95288,12987,178335,192,101,91
63995,198332,19988,95293,12987,178344,192,101,91
64000,198353,19989,95301,12987,178364,192,101,91
64005,198363,19990,95306,12988,178373,192,101,91
64010,198384,19993,95314,12989,178391,192,101,91
64015,198394,19994,95322,12990,178399,192,101,91
64020,198415,19999,95332,12995,178416,192,101,91
64025,198425,20000,95338,12996,178424,192,101,91
64030,198446,20002,95351,12998,178444,192,101,91
64035,198456,20003,95358,12999,178453,192,101,91
64040,198477,20004,95369,12999,178473,192,101,91
64045,198487,20005,95373,12999,178482,192,101,91
64050,198508,20007,95382,13000,178501,192,101,91
64055,198518,20008,95385,13000,178510,192,101,91
64060,198539,20009,95397,13001,178530,192,101,91
64065,198549,20010,95406,13002,178539,192,101,91
64070,198570,20013,95411,13003,178557,192,101,91
64075,198580,20014,95415,13003,178566,192,101,91
64080,198601,20018,95425,13006,178582,192,101,91
64085,198611,20019,95428,13007,178592,192,101,91
64090,198632,20022,95433,13009,178610,192,101,91
64095,198642,20022,95438,13009,178620,192,101,91
64100,198663,20026,95445,13011,178637,192,101,91
64105,198673,20026,95450,13011,178647,192,101,91
64110,198694,20030,95462,13015,178664,192,101,91
64115,198704,20030,95468,13015,178674,192,101,91
64120,198725,20033,95482,13017,178692,192,101,91
64125,198735,20034,95489,13018,178701,192,101,91
64130,198756,20038,95498,13020,178718,192,101,91
64135,198766,20039,95501,13021,178727,192,101,91
64140,198787,20042,95512,13022,178745,192,101,91
64145,198797,20043,95516,13023,178754,192,101,91
64150,198818,20047,95525,13025,178771,192,101,91
64155,198828,20049,95528,13026,178779,192,101,91
64160,198849,20052,95537,13028,178796,192,101,91
64165,198859,20055,95544,13030,178804,192,101,91
64170,198880,20057,95549,13031,178823,192,101,91
64175,198890,20058,95555,13032,178832,192,101,91
64180,198911,20060,95562,13032,178851,192,101,91
64185,198921,20061,95569,13032,178859,192,101,91
64190,198942,20065,95578,13034,178877,192,101,91
64195,198952,20066,95580,13034,178886,192,101,91
64200,198973,20068,95590,13034,178905,192,101,91
64205,198983,20069,95593,13034,178914,192,101,91
64210,199004,20072,95601,13037,178932,192,101,91
64215,199014,20074,95607,13038,178939,192,101,91
64220,199035,20079,95619,13042,178956,192,101,91
64225,199045,20080,95625,13043,178965,192,101,91
64230,199066,20084,95637,13046,178982,192,101,91
64235,199076,20086,95642,13048,178989,192,101,91
64240,199097,20090,95651,13052,179007,192,101,91
64245,199107,20091,95657,13053,179015,192,101,91
64250,199128,20095,95671,13056,179033,192,101,91
64255,199138,20096,95678,13057,179042,192,101,91
64260,199159,20099,95690,13058,179060,192,101,91
64265,199169,20100,95694,13059,179069,192,101,91
64270,199190,20101,95700,13059,179088,192,101,91
64275,199200,20103,95707,13061,179097,192,101,91
64280,199221,20105,95715,13063,179116,192,101,91
64285,199231,20107,95721,13065,179124,192,101,91
64290,199252,20109,95731,13067,179143,192,101,91
64295,199262,20111,95738,13068,179151,192,101,91
64300,199283,20112,95748,13069,179171,192,101,91
64305,199293,20114,95755,13071,179179,192,101,91
64310,199314,20117,95769,13074,179197,192,101,91
64315,199324,20118,95773,13075,179206,192,101,91
64320,199345,20120,95781,13076,179225,192,101,91
64325,199355,20120,95786,13076,179235,192,101,91
64330,199376,20123,95798,13078,179253,192,101,91
64335,199386,20123,95802,13078,179263,192,101,91
64340,199407,20126,95818,13080,179281,192,101,91
64345,199417,20126,95826,13080,179291,192,101,91
64350,199438,20128,95835,13080,179310,192,101,91
64355,199448,20128,95840,13080,179319,192,101,91
64360,199469,20132,95848,13082,179337,192,101,91
64365,199479,20132,95854,13082,179346,192,101,91
64370,199500,20135,95865,13083,179365,192,101,91
64375,199510,20135,95869,13083,179375,192,101,91
64380,199531,20139,95876,13085,179392,192,101,91
64385,199541,20139,95880,13085,179402,192,101,91
64390,199562,20141,95891,13087,179421,192,101,91
64395,199572,20141,95896,13087,179431,192,101,91
64400,199593,20144,95906,13088,179449,192,101,91
64405,199603,20144,95910,13088,179458,192,101,91
64410,199624,20148,95924,13092,179476,192,101,91
64415,199634,20148,95930,13092,179486,192,101,91
64420,199655,20152,95942,13094,179503,192,101,91
64425,199665,20152,95947,13094,179513,192,101,91
64430,199686,20155,95958,13096,179530,192,101,91
64435,199696,20158,95963,13099,179538,192,101,91
64440,199717,20162,95974,13103,179554,192,101,91
64445,199727,20164,95978,13105,179563,192,101,91
64450,199748,20164,95987,13105,179584,192,101,91
64455,199758,20166,95991,13107,179592,192,101,91
64460,199779,20166,96002,13107,179613,192,101,91
64465,199789,20167,96007,13107,179622,192,101,91
64470,199810,20167,96017,13107,179643,192,101,91
64475,199820,20168,96022,13108,179652,192,101,91
64480,199841,20168,96033,13108,179673,192,101,91
64485,199851,20169,96038,13109,179682,192,101,91
64490,199872,20170,96051,13110,179702,192,101,91
64495,199882,20171,96056,13111,179711,192,101,91
64500,199903,20172,96068,13112,179731,192,101,91
64505,199913,20173,96071,13113,179740,192,101,91
64510,199934,20174,96080,13113,179760,192,101,91
64515,199944,20175,96085,13113,179769,192,101,91
64520,199965,20176,96094,13113,179789,192,101,91
64525,199975,20177,96098,13113,179797,192,101,91
64530,199996,20179,96108,13114,179817,192,101,91
64535,200006,20180,96115,13115,179826,192,101,91
64540,200027,20181,96126,13116,179846,192,101,91
64545,200037,20182,96131,13116,179855,192,101,91
64550,200058,20185,96142,13119,179872,192,101,91
64555,200068,20187,96148,13121,179881,192,101,91
64560,200089,20190,96155,13123,179899,192,101,91
64565,200099,20191,96158,13124,179908,192,101,91
64570,200120,20194,96169,13125,179926,192,101,91
64575,200130,20195,96173,13126,179935,192,101,91
64580,200151,20198,96182,13127,179953,192,101,91
64585,200161,20199,96189,13128,179962,192,101,91
64590,200182,20202,96199,13129,179980,192,101,91
64595,200192,20203,96207,13130,179989,192,101,91
64600,200213,20207,96215,13132,180006,192,101,91
64605,200223,20208,96223,13133,180015,192,101,91
64610,200244,20213,96235,13137,180031,192,101,91
64615,200254,20213,96239,13137,180041,192,101,91
64620,200275,20216,96247,13138,180059,192,101,91
64625,200285,20216,96252,13138,180069,192,101,91
64630,200306,20219,96261,13139,180087,192,101,91
64635,200316,20219,96264,13139,180097,192,101,91
64640,200337,20222,96275,13142,180115,192,101,91
64645,200347,20222,96280,13142,180125,192,101,91
64650,200368,20225,96289,13144,180143,192,101,91
64655,200378,20225,96294,13144,180153,192,101,91
64660,200399,20229,96303,13147,180170,192,101,91
64665,200409,20229,96306,13147,180180,192,101,91
64670,200430,20231,96317,13149,180199,192,101,91
64675,200440,20232,96318,13149,180208,192,101,91
64680,200461,20235,96327,13151,180225,192,101,91
64685,200471,20238,96333,13154,180233,192,101,91
64690,200492,20241,96342,13157,180251,192,101,91
64695,200502,20242,96345,13157,180260,192,101,91
64700,200523,20244,96354,13157,180279,192,101,91
64705,200533,20245,96357,13157,180288,192,101,91
64710,200554,20249,96366,13160,180304,192,101,91
64715,200564,20251,96369,13162,180313,192,101,91
64720,200585,20255,96380,13164,180330,192,101,91
64725,200595,20256,96385,13164,180339,192,101,91
64730,200616,20262,96397,13169,180354,192,101,91
64735,200626,20263,96403,13169,180362,192,101,91
64740,200647,20267,96414,13172,180380,192,101,91
64745,200657,20269,96419,13173,180387,192,101,91
64750,200678,20271,96426,13175,180407,192,101,91
64755,200688,20272,96431,13176,180416,192,101,91
64760,200709,20273,96442,13176,180436,192,101,91
64765,200719,20274,96447,13177,180444,192,101,91
64770,200740,20277,96454,13180,180463,192,101,91
64775,200750,20279,96459,13182,180470,192,101,91
64780,200771,20282,96469,13185,180489,192,101,91
64785,200781,20284,96477,13187,180497,192,101,91
64790,200802,20286,96488,13188,180516,192,101,91
64795,200812,20287,96494,13189,180525,192,101,91
64800,200833,20288,96505,13190,180545,192,101,91
64805,200843,20289,96510,13191,180554,192,101,91
64810,200864,20289,96517,13191,180575,192,101,91
64815,200874,20289,96523,13191,180585,192,101,91
64820,200895,20289,96530,13191,180606,192,101,91
64825,200905,20289,96538,13191,180616,192,101,91
64830,200926,20289,96554,13191,180637,192,101,91
64835,200936,20289,96559,13191,180647,192,101,91
64840,200957,20289,96568,13191,180668,192,101,91
64845,200967,20289,96569,13191,180678,192,101,91
64850,200988,20290,96582,13192,180698,192,101,91
64855,200998,20290,96586,13192,180708,192,101,91
64860,201019,20292,96599,13194,180727,192,101,91
64865,201029,20293,96607,13195,180736,192,101,91
64870,201050,20297,96618,13197,180752,192,101,91
64875,201060,20299,96623,13199,180761,192,101,91
64880,201081,20302,96633,13199,180778,192,101,91
64885,201091,20304,96639,13200,180787,192,101,91
64890,201112,20308,96651,13203,180804,192,101,91
64895,201122,20309,96655,13203,180813,192,101,91
64900,201143,20313,96670,13207,180830,192,101,91
64905,201153,20314,96677,13208,180839,192,101,91
64910,201174,20318,96689,13212,180856,192,101,91
64915,201184,20319,96695,13213,180864,192,101,91
64920,201205,20324,96709,13217,180881,192,101,91
64925,201215,20325,96714,13218,180889,192,101,91
64930,201236,20329,96725,13220,180907,192,101,91
64935,201246,20330,96732,13221,180916,192,101,91
64940,201267,20333,96744,13222,180934,192,101,91
64945,201277,20334,96748,13222,180943,192,101,91
64950,201298,20336,96762,13223,180962,192,101,91
64955,201308,20337,96765,13224,180971,192,101,91
64960,201329,20339,96776,13224,180990,192,101,91
64965,201339,20340,96781,13225,180998,192,101,91
64970,201360,20344,96792,13228,181016,192,101,91
64975,201370,20345,96794,13229,181025,192,101,91
64980,201391,20347,96801,13230,181044,192,101,91
64985,201401,20348,96805,13231,181053,192,101,91
64990,201422,20351,96816,13233,181071,192,101,91
64995,201432,20352,96822,13233,181080,192,101,91
65000,201453,20354,96833,13234,181099,192,101,91
65005,201463,20356,96839,13235,181106,192,101,91
65010,201484,20359,96846,13236,181125,192,101,91
65015,201494,20361,96853,13238,181133,192,101,91
65020,201515,20364,96868,13241,181151,192,101,91
65025,201525,20366,96877,13243,181158,192,101,91
65030,201546,20371,96887,13247,181175,192,101,91
65035,201556,20374,96893,13249,181181,192,101,91
65040,201577,20378,96906,13252,181199,192,101,91
65045,201587,20379,96909,13252,181208,192,101,91
65050,201608,20380,96922,13253,181228,192,101,91
65055,201618,20381,96926,13253,181237,192,101,91
65060,201639,20381,96936,13253,181258,192,101,91
65065,201649,20382,96941,13253,181267,192,101,91
65070,201670,20383,96954,13254,181287,192,101,91
65075,201680,20384,96959,13254,181296,192,101,91
65080,201701,20384,96968,13254,181317,192,101,91
65085,201711,20385,96972,13255,181326,192,101,91
65090,201732,20385,96979,13255,181347,192,101,91
65095,201742,20386,96982,13255,181356,192,101,91
65100,201763,20386,96997,13255,181377,192,101,91
65105,201773,20387,97001,13255,181386,192,101,91
65110,201794,20387,97010,13255,181407,192,101,91
65115,201804,20388,97018,13256,181416,192,101,91
65120,201825,20389,97029,13257,181436,192,101,91
65125,201835,20390,97034,13257,181445,192,101,91
65130,201856,20390,97043,13257,181466,192,101,91
65135,201866,20391,97048,13257,181475,192,101,91
65140,201887,20392,97056,13258,181495,192,101,91
65145,201897,20393,97060,13258,181503,192,101,91
65150,201918,20400,97070,13263,181517,192,101,91
65155,201928,20404,97074,13266,181523,192,101,91
65160,201949,20411,97086,13271,181538,192,101,91
65165,201959,20411,97091,13271,181548,192,101,91
65170,201980,20414,97102,13272,181566,192,101,91
65175,201990,20414,97106,13272,181576,192,101,91
65180,202011,20418,97115,13275,181593,192,101,91
65185,202021,20418,97121,13275,181603,192,101,91
65190,202042,20421,97132,13276,181621,192,101,91
65195,202052,20421,97137,13276,181631,192,101,91
65200,202073,20425,97148,13278,181648,192,101,91
65205,202083,20425,97150,13278,181658,192,101,91
65210,202104,20428,97160,13279,181676,192,101,91
65215,202114,20428,97166,13279,181686,192,101,91
65220,202135,20431,97172,13281,181704,192,101,91
65225,202145,20431,97178,13281,181714,192,101,91
65230,202166,20435,97190,13285,181731,192,101,91
65235,202176,20435,97198,13285,181741,192,101,91
65240,202197,20438,97207,13287,181759,192,101,91
65245,202207,20438,97211,13287,181769,192,101,91
65250,202228,20440,97219,13289,181788,192,101,91
65255,202238,20440,97224,13289,181798,192,101,91
65260,202259,20444,97234,13293,181815,192,101,91
65265,202269,20444,97240,13293,181824,192,101,91
65270,202290,20450,97251,13298,181840,192,101,91
65275,202300,20452,97253,13299,181847,192,101,91
65280,202321,20458,97260,13303,181863,192,101,91
65285,202331,20459,97264,13304,181872,192,101,91
65290,202352,20460,97274,13304,181892,192,101,91
65295,202362,20461,97279,13305,181901,192,101,91
65300,202383,20461,97289,13305,181922,192,101,91
65305,202393,20462,97295,13305,181931,192,101,91
65310,202414,20462,97308,13305,181952,192,101,91
65315,202424,20463,97310,13306,181961,192,101,91
65320,202445,20463,97320,13306,181982,192,101,91
65325,202455,20464,97321,13306,181991,192,101,91
65330,202476,20464,97332,13306,182012,192,101,91
65335,202486,20465,97339,13306,182021,192,101,91
65340,202507,20465,97351,13306,182042,192,101,91
65345,202517,20466,97356,13306,182051,192,101,91
65350,202538,20466,97363,13306,182072,192,101,91
65355,202548,20467,97369,13307,182081,192,101,91
65360,202569,20467,97380,13307,182102,192,101,91
65365,202579,20468,97386,13307,182111,192,101,91
65370,202600,20468,97398,13307,182132,192,101,91
65375,202610,20469,97402,13308,182141,192,101,91
65380,202631,20469,97416,13308,182162,192,101,91
65385,202641,20470,97421,13309,182171,192,101,91
65390,202662,20473,97435,13312,182188,192,101,91
65395,202672,20475,97440,13314,182197,192,101,91
65400,202693,20478,97450,13315,182215,192,101,91
65405,202703,20478,97456,13315,182225,192,101,91
65410,202724,20481,97464,13316,182243,192,101,91
65415,202734,20481,97467,13316,182253,192,101,91
65420,202755,20483,97477,13316,182272,192,101,91
65425,202765,20483,97481,13316,182282,192,101,91
65430,202786,20486,97492,13318,182300,192,101,91
65435,202796,20486,97500,13318,182310,192,101,91
65440,202817,20489,97508,13320,182328,192,101,91
65445,202827,20489,97513,13320,182338,192,101,91
65450,202848,20492,97522,13322,182356,192,101,91
65455,202858,20492,97528,13322,182366,192,101,91
65460,202879,20494,97539,13323,182385,192,101,91
65465,202889,20494,97543,13323,182395,192,101,91
65470,202910,20496,97555,13324,182414,192,101,91
65475,202920,20496,97560,13324,182424,192,101,91
65480,202941,20498,97570,13326,182443,192,101,91
65485,202951,20498,97576,13326,182453,192,101,91
65490,202972,20501,97591,13328,182471,192,101,91
65495,202982,20501,97594,13328,182481,192,101,91
65500,203003,20504,97608,13331,182499,192,101,91
65505,203013,20504,97612,13331,182509,192,101,91
65510,203034,20508,97623,13333,182526,192,101,91
65515,203044,20511,97626,13335,182532,192,101,91
65520,203065,20516,97638,13338,182549,192,101,91
65525,203075,20517,97641,13339,182558,192,101,91
65530,203096,20518,97647,13339,182578,192,101,91
65535,203106,20519,97651,13340,182587,192,101,91
65540,203127,20520,97657,13340,182607,192,101,91
65545,203137,20521,97661,13341,182616,192,101,91
65550,203158,20523,97671,13343,182635,192,101,91
65555,203168,20524,97677,13343,182643,192,101,91
65560,203189,20528,97686,13347,182661,192,101,91
65565,203199,20529,97692,13347,182670,192,101,91
65570,203220,20531,97701,13349,182689,192,101,91
65575,203230,20532,97705,13350,182698,192,101,91
65580,203251,20533,97719,13351,182718,192,101,91
65585,203261,20534,97723,13352,182727,192,101,91
65590,203282,20534,97734,13352,182748,192,101,91
65595,203292,20535,97737,13352,182757,192,101,91
65600,203313,20535,97748,13352,182778,192,101,91
65605,203323,20536,97751,13352,182787,192,101,91
65610,203344,20536,97761,13352,182808,192,101,91
65615,203354,20537,97765,13352,182817,192,101,91
65620,203375,20538,97776,13353,182837,192,101,91
65625,203385,20539,97779,13353,182846,192,101,91
65630,203406,20541,97785,13353,182865,192,101,91
65635,203416,20542,97790,13353,182873,192,101,91
65640,203437,20545,97798,13355,182892,192,101,91
65645,203447,20546,97805,13356,182901,192,101,91
65650,203468,20550,97815,13359,182918,192,101,91
65655,203478,20550,97820,13359,182928,192,101,91
65660,203499,20554,97831,13361,182945,192,101,91
65665,203509,20554,97836,13361,182955,192,101,91
65670,203530,20558,97843,13363,182972,192,101,91
65675,203540,20558,97846,13363,182982,192,101,91
65680,203561,20561,97856,13365,183000,192,101,91
65685,203571,20561,97862,13365,183010,192,101,91
65690,203592,20565,97873,13367,183027,192,101,91
65695,203602,20565,97876,13367,183037,192,101,91
65700,203623,20568,97885,13368,183055,192,101,91
65705,203633,20569,97892,13369,183064,192,101,91
65710,203654,20572,97906,13372,183082,192,101,91
65715,203664,20573,97911,13373,183091,192,101,91
65720,203685,20577,97924,13376,183108,192,101,91
65725,203695,20578,97928,13377,183117,192,101,91
65730,203716,20581,97939,13380,183135,192,101,91
65735,203726,20581,97945,13380,183145,192,101,91
65740,203747,20585,97953,13382,183162,192,101,91
65745,203757,20586,97959,13383,183171,192,101,91
65750,203778,20590,97966,13384,183187,192,101,91
65755,203788,20592,97970,13386,183196,192,101,91
65760,203809,20596,97980,13387,183213,192,101,91
65765,203819,20597,97986,13388,183222,192,101,91
65770,203840,20599,97996,13389,183241,192,101,91
65775,203850,20601,98003,13390,183248,192,101,91
65780,203871,20605,98013,13392,183266,192,101,91
65785,203881,20606,98018,13393,183275,192,101,91
65790,203902,20607,98027,13393,183295,192,101,91
65795,203912,20608,98031,13393,183304,192,101,91
65800,203933,20609,98039,13393,183324,192,101,91
65805,203943,20610,98041,13393,183333,192,101,91
65810,203964,20612,98052,13395,183352,192,101,91
65815,203974,20613,98058,13396,183361,192,101,91
65820,203995,20615,98063,13397,183380,192,101,91
65825,204005,20616,98069,13398,183389,192,101,91
65830,204026,20616,98076,13398,183410,192,101,91
65835,204036,20617,98080,13399,183419,192,101,91
65840,204057,20617,98090,13399,183440,192,101,91
65845,204067,20618,98097,13400,183449,192,101,91
65850,204088,20618,98108,13400,183469,192,101,91
65855,204098,20620,98117,13402,183478,192,101,91
65860,204119,20620,98129,13402,183499,192,101,91
65865,204129,20621,98135,13403,183508,192,101,91
65870,204150,20621,98146,13403,183529,192,101,91
65875,204160,20622,98153,13404,183538,192,101,91
65880,204181,20624,98164,13406,183557,192,101,91
65885,204191,20626,98171,13408,183564,192,101,91
65890,204212,20630,98183,13411,183582,192,101,91
65895,204222,20631,98189,13412,183591,192,101,91
65900,204243,20635,98200,13415,183608,192,101,91
65905,204253,20636,98206,13416,183617,192,101,91
65910,204274,20638,98216,13417,183636,192,101,91
65915,204284,20639,98221,13417,183645,192,101,91
65920,204305,20640,98230,13417,183665,192,101,91
65925,204315,20641,98234,13418,183674,192,101,91
65930,204336,20645,98243,13420,183691,192,101,91
65935,204346,20646,98247,13421,183700,192,101,91
65940,204367,20649,98257,13422,183718,192,101,91
65945,204377,20649,98263,13422,183728,192,101,91
65950,204398,20651,98274,13422,183747,192,101,91
65955,204408,20651,98281,13422,183757,192,101,91
65960,204429,20653,98295,13424,183776,192,101,91
65965,204439,20653,98296,13424,183786,192,101,91
65970,204460,20655,98307,13425,183805,192,101,91
65975,204470,20655,98314,13425,183815,192,101,91
65980,204491,20657,98324,13427,183834,192,101,91
65985,204501,20657,98327,13427,183844,192,101,91
65990,204522,20660,98338,13428,183862,192,101,91
65995,204532,20660,98339,13428,183872,192,101,91
66000,204553,20662,98350,13429,183891,192,101,91
66005,204563,20662,98357,13429,183900,192,101,91
66010,204584,20667,98365,13432,183917,192,101,91
66015,204594,20667,98368,13432,183927,192,101,91
66020,204615,20669,98377,13432,183946,192,101,91
66025,204625,20670,98381,13433,183955,192,101,91
66030,204646,20672,98390,13434,183974,192,101,91
66035,204656,20672,98394,13434,183984,192,101,91
66040,204677,20675,98402,13435,184002,192,101,91
66045,204687,20675,98406,13435,184012,192,101,91
66050,204708,20678,98415,13436,184030,192,101,91
66055,204718,20681,98422,13439,184036,192,101,91
66060,204739,20684,98431,13441,184055,192,101,91
66065,204749,20687,98436,13444,184062,192,101,91
66070,204770,20689,98443,13445,184081,192,101,91
66075,204780,20691,98449,13446,184089,192,101,91
66080,204801,20693,98459,13447,184108,192,101,91
66085,204811,20694,98464,13447,184117,192,101,91
66090,204832,20696,98480,13448,184136,192,101,91
66095,204842,20697,98485,13449,184145,192,101,91
66100,204863,20699,98498,13450,184164,192,101,91
66105,204873,20700,98503,13450,184173,192,101,91
66110,204894,20702,98513,13451,184191,192,101,91
66115,204904,20704,98519,13453,184200,192,101,91
66120,204925,20707,98527,13455,184217,192,101,91
66125,204935,20710,98531,13457,184225,192,101,91
66130,204956,20712,98538,13459,184244,192,101,91
66135,204966,20713,98542,13460,184253,192,101,91
66140,204987,20716,98552,13463,184271,192,101,91
66145,204997,20717,98557,13464,184280,192,101,91
66150,205018,20718,98571,13465,184300,192,101,91
66155,205028,20719,98576,13466,184309,192,101,91
66160,205049,20721,98588,13467,184328,192,101,91
66165,205059,20722,98592,13467,184337,192,101,91
66170,205080,20724,98605,13468,184356,192,101,91
66175,205090,20725,98608,13468,184365,192,101,91
66180,205111,20727,98616,13470,184384,192,101,91
66185,205121,20727,98622,13470,184394,192,101,91
66190,205142,20729,98630,13471,184413,192,101,91
66195,205152,20729,98632,13471,184423,192,101,91
66200,205173,20729,98645,13471,184444,192,101,91
66205,205183,20729,98648,13471,184454,192,101,91
66210,205204,20729,98656,13471,184475,192,101,91
66215,205214,20729,98659,13471,184485,192,101,91
66220,205235,20729,98669,13471,184506,192,101,91
66225,205245,20729,98676,13471,184516,192,101,91
66230,205266,20730,98690,13472,184536,192,101,91
66235,205276,20730,98697,13472,184545,192,101,91
66240,205297,20734,98704,13474,184563,192,101,91
66245,205307,20734,98709,13474,184573,192,101,91
66250,205328,20735,98718,13474,184593,192,101,91
66255,205338,20735,98725,13474,184603,192,101,91
66260,205359,20736,98735,13474,184623,192,101,91
66265,205369,20736,98740,13474,184633,192,101,91
66270,205390,20737,98748,13475,184653,192,101,91
66275,205400,20737,98753,13475,184663,192,101,91
66280,205421,20738,98764,13476,184683,192,101,91
66285,205431,20738,98768,13476,184693,192,101,91
66290,205452,20739,98775,13476,184713,192,101,91
66295,205462,20740,98777,13476,184722,192,101,91
66300,205483,20742,98789,13477,184741,192,101,91
66305,205493,20744,98795,13478,184749,192,101,91
66310,205514,20747,98809,13481,184767,192,101,91
66315,205524,20748,98815,13482,184776,192,101,91
66320,205545,20750,98828,13484,184795,192,101,91
66325,205555,20751,98831,13484,184804,192,101,91
66330,205576,20752,98841,13484,184824,192,101,91
66335,205586,20753,98846,13485,184833,192,101,91
66340,205607,20755,98856,13487,184852,192,101,91
66345,205617,20756,98860,13488,184861,192,101,91
66350,205638,20760,98873,13491,184878,192,101,91
66355,205648,20762,98880,13492,184886,192,101,91
66360,205669,20766,98892,13495,184902,192,101,91
66365,205679,20769,98898,13498,184910,192,101,91
66370,205700,20772,98911,13501,184928,192,101,91
66375,205710,20773,98914,13501,184937,192,101,91
66380,205731,20775,98927,13503,184956,192,101,91
66385,205741,20776,98931,13503,184965,192,101,91
66390,205762,20778,98941,13504,184984,192,101,91
66395,205772,20779,98944,13504,184993,192,101,91
66400,205793,20781,98952,13505,185012,192,101,91
66405,205803,20782,98958,13506,185021,192,101,91
66410,205824,20783,98969,13507,185041,192,101,91
66415,205834,20784,98978,13508,185050,192,101,91
66420,205855,20785,98983,13508,185070,192,101,91
66425,205865,20786,98987,13509,185079,192,101,91
66430,205886,20788,99001,13511,185098,192,101,91
66435,205896,20789,99008,13512,185107,192,101,91
66440,205917,20793,99020,13515,185124,192,101,91
66445,205927,20793,99026,13515,185134,192,101,91
66450,205948,20796,99033,13517,185152,192,101,91
66455,205958,20796,99038,13517,185162,192,101,91
66460,205979,20798,99046,13518,185181,192,101,91
66465,205989,20798,99051,13518,185191,192,101,91
66470,206010,20800,99060,13520,185210,192,101,91
66475,206020,20800,99065,13520,185220,192,101,91
66480,206041,20804,99076,13522,185237,192,101,91
66485,206051,20804,99083,13522,185247,192,101,91
66490,206072,20808,99089,13524,185264,192,101,91
66495,206082,20808,99094,13524,185274,192,101,91
66500,206103,20812,99106,13527,185291,192,101,91
66505,206113,20812,99113,13527,185301,192,101,91
66510,206134,20815,99120,13528,185319,192,101,91
66515,206144,20815,99127,13528,185329,192,101,91
66520,206165,20819,99137,13531,185346,192,101,91
66525,206175,20819,99139,13531,185356,192,101,91
66530,206196,20823,99151,13533,185373,192,101,91
66535,206206,20824,99157,13534,185382,192,101,91
66540,206227,20827,99165,13535,185400,192,101,91
66545,206237,20829,99170,13536,185407,192,101,91
66550,206258,20832,99180,13539,185426,192,101,91
66555,206268,20833,99183,13540,185434,192,101,91
66560,206289,20838,99192,13545,185451,192,101,91
66565,206299,20840,99196,13546,185459,192,101,91
66570,206320,20843,99204,13549,185477,192,101,91
66575,206330,20846,99208,13551,185483,192,101,91
66580,206351,20850,99218,13554,185501,192,101,91
66585,206361,20852,99223,13556,185509,192,101,91
66590,206382,20854,99236,13558,185528,192,101,91
66595,206392,20856,99242,13560,185536,192,101,91
66600,206413,20858,99250,13562,185555,192,101,91
66605,206423,20859,99254,13563,185564,192,101,91
66610,206444,20860,99267,13563,185583,192,101,91
66615,206454,20862,99271,13565,185592,192,101,91
66620,206475,20863,99281,13565,185611,192,101,91
66625,206485,20865,99286,13566,185620,192,101,91
66630,206506,20866,99297,13566,185640,192,101,91
66635,206516,20867,99301,13567,185648,192,101,91
66640,206537,20869,99312,13569,185667,192,101,91
66645,206547,20871,99318,13571,185675,192,101,91
66650,206568,20875,99328,13574,185693,192,101,91
66655,206578,20876,99331,13574,185702,192,101,91
66660,206599,20879,99342,13575,185720,192,101,91
66665,206609,20880,99349,13576,185729,192,101,91
66670,206630,20882,99359,13578,185748,192,101,91
66675,206640,20883,99364,13578,185757,192,101,91
66680,206661,20885,99376,13579,185776,192,101,91
66685,206671,20886,99378,13579,185785,192,101,91
66690,206692,20888,99387,13580,185804,192,101,91
66695,206702,20889,99393,13581,185813,192,101,91
66700,206723,20891,99406,13583,185832,192,101,91
66705,206733,20892,99409,13583,185841,192,101,91
66710,206754,20896,99416,13585,185858,192,101,91
66715,206764,20897,99419,13585,185867,192,101,91
66720,206785,20900,99431,13587,185885,192,101,91
66725,206795,20900,99437,13587,185895,192,101,91
66730,206816,20902,99444,13589,185914,192,101,91
66735,206826,20902,99450,13589,185924,192,101,91
66740,206847,20904,99457,13590,185943,192,101,91
66745,206857,20904,99464,13590,185953,192,101,91
66750,206878,20906,99475,13591,185972,192,101,91
66755,206888,20906,99480,13591,185982,192,101,91
66760,206909,20907,99489,13592,186002,192,101,91
66765,206919,20907,99494,13592,186012,192,101,91
66770,206940,20909,99504,13593,186031,192,101,91
66775,206950,20909,99508,13593,186040,192,101,91
66780,206971,20913,99522,13597,186058,192,101,91
66785,206981,20913,99526,13597,186068,192,101,91
66790,207002,20917,99533,13599,186085,192,101,91
66795,207012,20917,99538,13599,186095,192,101,91
66800,207033,20920,99549,13601,186113,192,101,91
66805,207043,20920,99552,13601,186123,192,101,91
66810,207064,20923,99569,13604,186141,192,101,91
66815,207074,20923,99576,13604,186151,192,101,91
66820,207095,20926,99585,13605,186169,192,101,91
66825,207105,20927,99588,13605,186178,192,101,91
66830,207126,20932,99599,13610,186194,192,101,91
66835,207136,20933,99607,13611,186203,192,101,91
66840,207157,20935,99617,13613,186222,192,101,91
66845,207167,20936,99626,13614,186231,192,101,91
66850,207188,20938,99635,13615,186250,192,101,91
66855,207198,20939,99640,13615,186259,192,101,91
66860,207219,20940,99650,13616,186279,192,101,91
66865,207229,20941,99655,13617,186288,192,101,91
66870,207250,20943,99663,13618,186307,192,101,91
66875,207260,20945,99667,13619,186315,192,101,91
66880,207281,20947,99677,13620,186334,192,101,91
66885,207291,20949,99682,13622,186342,192,101,91
66890,207312,20951,99694,13623,186361,192,101,91
66895,207322,20952,99700,13624,186370,192,101,91
66900,207343,20954,99712,13626,186389,192,101,91
66905,207353,20956,99718,13628,186397,192,101,91
66910,207374,20958,99727,13628,186416,192,101,91
66915,207384,20960,99731,13629,186424,192,101,91
66920,207405,20962,99739,13629,186442,192,101,91
66925,207415,20964,99743,13631,186451,192,101,91
66930,207436,20966,99752,13632,186469,192,101,91
66935,207446,20969,99758,13635,186477,192,101,91
66940,207467,20972,99772,13637,186495,192,101,91
66945,207477,20973,99778,13637,186504,192,101,91
66950,207498,20978,99790,13642,186520,192,101,91
66955,207508,20979,99794,13642,186529,192,101,91
66960,207529,20982,99806,13645,186547,192,101,91
66965,207539,20983,99814,13646,186556,192,101,91
66970,207560,20986,99821,13646,186574,192,101,91
66975,207570,20987,99826,13646,186583,192,101,91
66980,207591,20991,99832,13649,186600,192,101,91
66985,207601,20992,99836,13649,186609,192,101,91
66990,207622,20995,99844,13651,186627,192,101,91
66995,207632,20996,99848,13651,186636,192,101,91
67000,207653,21000,99857,13652,186653,192,101,91
67005,207663,21001,99863,13652,186662,192,101,91
67010,207684,21006,99872,13656,186678,192,101,91
67015,207694,21007,99878,13657,186687,192,101,91
67020,207715,21011,99890,13660,186704,192,101,91
67025,207725,21013,99894,13661,186712,192,101,91
67030,207746,21016,99904,13664,186730,192,101,91
67035,207756,21017,99908,13664,186739,192,101,91
67040,207777,21019,99915,13665,186758,192,101,91
67045,207787,21020,99919,13665,186767,192,101,91
67050,207808,21022,99933,13667,186785,192,101,91
67055,207818,21024,99936,13668,186794,192,101,91
67060,207839,21026,99948,13668,186813,192,101,91
67065,207849,21027,99953,13668,186822,192,101,91
67070,207870,21030,99962,13670,186840,192,101,91
67075,207880,21031,99968,13670,186848,192,101,91
67080,207901,21035,99979,13674,186866,192,101,91
67085,207911,21036,99985,13674,186875,192,101,91
67090,207932,21038,99995,13675,186894,192,101,91
67095,207942,21039,100000,13676,186903,192,101,91
67100,207963,21041,100015,13678,186922,192,101,91
67105,207973,21042,100021,13679,186931,192,101,91
67110,207994,21044,100029,13681,186950,192,101,91
67115,208004,21044,100032,13681,186960,192,101,91
67120,208025,21045,100040,13681,186980,192,101,91
67125,208035,21045,100045,13681,186990,192,101,91
67130,208056,21046,100058,13681,187010,192,101,91
67135,208066,21046,100062,13681,187020,192,101,91
67140,208087,21048,100074,13682,187039,192,101,91
67145,208097,21050,100080,13683,187047,192,101,91
67150,208118,21052,100090,13684,187066,192,101,91
67155,208128,21053,100094,13685,187075,192,101,91
67160,208149,21054,100104,13686,187095,192,101,91
67165,208159,21056,100110,13687,187103,192,101,91
67170,208180,21058,100118,13689,187122,192,101,91
67175,208190,21059,100121,13689,187131,192,101,91
67180,208211,21061,100131,13691,187150,192,101,91
67185,208221,21062,100135,13691,187159,192,101,91
67190,208242,21066,100148,13694,187175,192,101,91
67195,208252,21068,100151,13695,187184,192,101,91
67200,208273,21072,100159,13697,187201,192,101,91
67205,208283,21072,100166,13697,187210,192,101,91
67210,208304,21075,100176,13699,187229,192,101,91
67215,208314,21075,100181,13699,187238,192,101,91
67220,208335,21079,100191,13702,187256,192,101,91
67225,208345,21079,100195,13702,187265,192,101,91
67230,208366,21082,100203,13704,187284,192,101,91
67235,208376,21082,100209,13704,187293,192,101,91
67240,208397,21086,100218,13708,187311,192,101,91
67245,208407,21086,100223,13708,187320,192,101,91
67250,208428,21089,100234,13711,187339,192,101,91
67255,208438,21089,100238,13711,187349,192,101,91
67260,208459,21091,100250,13713,187368,192,101,91
67265,208469,21092,100255,13714,187377,192,101,91
67270,208490,21093,100263,13715,187397,192,101,91
67275,208500,21093,100268,13715,187407,192,101,91
67280,208521,21094,100281,13716,187427,192,101,91
67285,208531,21095,100283,13717,187436,192,101,91
67290,208552,21096,100295,13717,187456,192,101,91
67295,208562,21096,100298,13717,187466,192,101,91
67300,208583,21097,100307,13718,187486,192,101,91
67305,208593,21097,100314,13718,187496,192,101,91
67310,208614,21099,100323,13719,187515,192,101,91
67315,208624,21099,100328,13719,187525,192,101,91
67320,208645,21102,100340,13720,187543,192,101,91
67325,208655,21102,100343,13720,187553,192,101,91
67330,208676,21106,100355,13723,187570,192,101,91
67335,208686,21106,100358,13723,187580,192,101,91
67340,208707,21110,100370,13726,187597,192,101,91
67345,208717,21110,100375,13726,187606,192,101,91
67350,208738,21116,100387,13731,187622,192,101,91
67355,208748,21116,100394,13731,187631,192,101,91
67360,208769,21121,100407,13734,187648,192,101,91
67365,208779,21121,100409,13734,187658,192,101,91
67370,208800,21126,100424,13738,187674,192,101,91
67375,208810,21127,100431,13738,187683,192,101,91
67380,208831,21131,100439,13741,187700,192,101,91
67385,208841,21132,100445,13741,187709,192,101,91
67390,208862,21134,100455,13742,187728,192,101,91
67395,208872,21135,100459,13742,187737,192,101,91
67400,208893,21136,100473,13743,187756,192,101,91
67405,208903,21139,100479,13746,187764,192,101,91
67410,208924,21140,100488,13746,187783,192,101,91
67415,208934,21143,100493,13749,187791,192,101,91
67420,208955,21144,100502,13749,187811,192,101,91
67425,208965,21146,100505,13750,187819,192,101,91
67430,208986,21147,100514,13751,187839,192,101,91
67435,208996,21148,100516,13751,187848,192,101,91
67440,209017,21150,100530,13752,187867,192,101,91
67445,209027,21151,100538,13752,187875,192,101,91
67450,209048,21156,100549,13756,187892,192,101,91
67455,209058,21157,100553,13756,187901,192,101,91
67460,209079,21161,100563,13758,187918,192,101,91
67465,209089,21162,100569,13758,187927,192,101,91
67470,209110,21166,100581,13760,187944,192,101,91
67475,209120,21167,100586,13761,187953,192,101,91
67480,209141,21172,100594,13764,187969,192,101,91
67485,209151,21173,100600,13765,187978,192,101,91
67490,209172,21177,100613,13766,187995,192,101,91
67495,209182,21178,100614,13767,188004,192,101,91
67500,209203,21181,100625,13769,188022,192,101,91
67505,209213,21182,100628,13770,188031,192,101,91
67510,209234,21187,100636,13774,188047,192,101,91
67515,209244,21187,100643,13774,188057,192,101,91
67520,209265,21192,100652,13777,188073,192,101,91
67525,209275,21192,100660,13777,188083,192,101,91
67530,209296,21196,100669,13780,188100,192,101,91
67535,209306,21196,100673,13780,188110,192,101,91
67540,209327,21200,100683,13781,188127,192,101,91
67545,209337,21200,100688,13781,188137,192,101,91
67550,209358,21204,100701,13783,188154,192,101,91
67555,209368,21204,100706,13783,188164,192,101,91
67560,209389,21210,100719,13787,188179,192,101,91
67565,209399,21210,100724,13787,188189,192,101,91
67570,209420,21210,100731,13787,188210,192,101,91
67575,209430,21210,100737,13787,188220,192,101,91
67580,209451,21210,100743,13787,188241,192,101,91
67585,209461,21210,100751,13787,188251,192,101,91
67590,209482,21210,100764,13787,188272,192,101,91
67595,209492,21210,100769,13787,188282,192,101,91
67600,209513,21210,100780,13787,188303,192,101,91
67605,209523,21210,100786,13787,188313,192,101,91
67610,209544,21210,100796,13787,188334,192,101,91
67615,209554,21210,100802,13787,188344,192,101,91
67620,209575,21210,100811,13787,188365,192,101,91
67625,209585,21210,100819,13787,188375,192,101,91
67630,209606,21210,100830,13787,188396,192,101,91
67635,209616,21210,100834,13787,188406,192,101,91
67640,209637,21210,100844,13787,188427,192,101,91
67645,209647,21210,100846,13787,188437,192,101,91
67650,209668,21210,100852,13787,188458,192,101,91
67655,209678,21210,100856,13787,188468,192,101,91
67660,209699,21210,100866,13787,188489,192,101,91
67665,209709,21210,100870,13787,188499,192,101,91
67670,209730,21212,100883,13788,188518,192,101,91
67675,209740,21213,100888,13788,188527,192,101,91
67680,209761,21217,100895,13790,188544,192,101,91
67685,209771,21218,100899,13790,188553,192,101,91
67690,209792,21222,100909,13792,188570,192,101,91
67695,209802,21223,100913,13792,188579,192,101,91
67700,209823,21228,100924,13796,188595,192,101,91
67705,209833,21229,100932,13797,188604,192,101,91
67710,209854,21234,100946,13801,188620,192,101,91
67715,209864,21235,100951,13802,188629,192,101,91
67720,209885,21240,100961,13806,188645,192,101,91
67725,209895,21241,100966,13806,188654,192,101,91
67730,209916,21245,100974,13808,188671,192,101,91
67735,209926,21246,100980,13808,188679,192,101,91
67740,209947,21251,100987,13813,188696,192,101,91
67745,209957,21252,100991,13813,188705,192,101,91
67750,209978,21253,101005,13814,188725,192,101,91
67755,209988,21254,101012,13815,188734,192,101,91
67760,210009,21256,101021,13816,188753,192,101,91
67765,210019,21257,101023,13817,188762,192,101,91
67770,210040,21258,101031,13818,188782,192,101,91
67775,210050,21259,101034,13818,188791,192,101,91
67780,210071,21261,101049,13820,188810,192,101,91
67785,210081,21262,101055,13821,188819,192,101,91
67790,210102,21264,101070,13823,188838,192,101,91
67795,210112,21265,101074,13823,188847,192,101,91
67800,210133,21267,101089,13825,188866,192,101,91
67805,210143,21267,101095,13825,188876,192,101,91
67810,210164,21268,101107,13825,188896,192,101,91
67815,210174,21268,101114,13825,188906,192,101,91
67820,210195,21269,101128,13826,188926,192,101,91
67825,210205,21270,101133,13827,188935,192,101,91
67830,210226,21271,101142,13827,188955,192,101,91
67835,210236,21271,101147,13827,188965,192,101,91
67840,210257,21272,101162,13828,188985,192,101,91
67845,210267,21272,101165,13828,188995,192,101,91
67850,210288,21275,101173,13829,189013,192,101,91
67855,210298,21275,101179,13829,189023,192,101,91
67860,210319,21281,101191,13834,189038,192,101,91
67865,210329,21282,101197,13835,189047,192,101,91
67870,210350,21285,101207,13838,189065,192,101,91
67875,210360,21285,101209,13838,189075,192,101,91
67880,210381,21289,101221,13840,189092,192,101,91
67885,210391,21289,101225,13840,189102,192,101,91
67890,210412,21290,101234,13841,189122,192,101,91
67895,210422,21290,101238,13841,189132,192,101,91
67900,210443,21291,101250,13842,189152,192,101,91
67905,210453,21292,101255,13842,189161,192,101,91
67910,210474,21293,101264,13842,189181,192,101,91
67915,210484,21294,101268,13843,189190,192,101,91
67920,210505,21296,101275,13844,189209,192,101,91
67925,210515,21297,101280,13845,189218,192,101,91
67930,210536,21300,101293,13847,189235,192,101,91
67935,210546,21302,101297,13849,189244,192,101,91
67940,210567,21302,101308,13849,189264,192,101,91
67945,210577,21304,101314,13850,189273,192,101,91
67950,210598,21304,101322,13850,189293,192,101,91
67955,210608,21306,101327,13852,189302,192,101,91
67960,210629,21307,101334,13853,189322,192,101,91
67965,210639,21308,101337,13853,189331,192,101,91
67970,210660,21310,101349,13854,189350,192,101,91
67975,210670,21311,101353,13854,189359,192,101,91
67980,210691,21313,101365,13856,189378,192,101,91
67985,210701,21315,101369,13857,189385,192,101,91
67990,210722,21320,101378,13862,189402,192,101,91
67995,210732,21322,101383,13863,189410,192,101,91
68000,210753,21327,101395,13868,189426,192,101,91
68005,210763,21330,101401,13870,189433,192,101,91
68010,210784,21335,101410,13873,189449,192,101,91
68015,210794,21338,101418,13876,189456,192,101,91
68020,210815,21343,101430,13880,189472,192,101,91
68025,210825,21345,101436,13882,189480,192,101,91
68030,210846,21350,101447,13886,189496,192,101,91
68035,210856,21352,101450,13888,189504,192,101,91
68040,210877,21356,101460,13891,189521,192,101,91
68045,210887,21357,101464,13891,189530,192,101,91
68050,210908,21360,101474,13894,189548,192,101,91
68055,210918,21361,101477,13895,189557,192,101,91
68060,210939,21365,101487,13898,189574,192,101,91
68065,210949,21366,101494,13899,189583,192,101,91
68070,210970,21371,101509,13903,189599,192,101,91
68075,210980,21372,101514,13904,189608,192,101,91
68080,211001,21375,101522,13906,189626,192,101,91
68085,211011,21376,101530,13907,189635,192,101,91
68090,211032,21379,101536,13908,189653,192,101,91
68095,211042,21380,101541,13908,189662,192,101,91
68100,211063,21382,101548,13909,189680,192,101,91
68105,211073,21383,101550,13910,189690,192,101,91
68110,211094,21384,101559,13911,189710,192,101,91
68115,211104,21384,101564,13911,189720,192,101,91
68120,211125,21385,101575,13912,189740,192,101,91
68125,211135,21385,101579,13912,189750,192,101,91
68130,211156,21386,101592,13913,189770,192,101,91
68135,211166,21386,101599,13913,189780,192,101,91
68140,211187,21387,101611,13914,189800,192,101,91
68145,211197,21387,101615,13914,189810,192,101,91
68150,211218,21388,101628,13914,189830,192,101,91
68155,211228,21388,101632,13914,189840,192,101,91
68160,211249,21389,101642,13915,189860,192,101,91
68165,211259,21390,101648,13916,189868,192,101,91
68170,211280,21392,101659,13917,189888,192,101,91
68175,211290,21392,101662,13917,189898,192,101,91
68180,211311,21394,101672,13919,189917,192,101,91
68185,211321,21394,101679,13919,189927,192,101,91
68190,211342,21395,101685,13919,189947,192,101,91
68195,211352,21395,101689,13919,189957,192,101,91
68200,211373,21396,101697,13919,189977,192,101,91
68205,211383,21396,101702,13919,189987,192,101,91
68210,211404,21398,101712,13920,190006,192,101,91
68215,211414,21398,101718,13920,190016,192,101,91
68220,211435,21400,101725,13920,190035,192,101,91
68225,211445,21401,101729,13921,190044,192,101,91
68230,211466,21405,101739,13922,190061,192,101,91
68235,211476,21405,101744,13922,190071,192,101,91
68240,211497,21408,101753,13924,190089,192,101,91
68245,211507,21408,101757,13924,190099,192,101,91
68250,211528,21413,101767,13928,190115,192,101,91
68255,211538,21413,101773,13928,190125,192,101,91
68260,211559,21418,101785,13932,190141,192,101,91
68265,211569,21418,101791,13932,190151,192,101,91
68270,211590,21422,101799,13934,190168,192,101,91
68275,211600,21423,101804,13934,190176,192,101,91
68280,211621,21428,101815,13938,190193,192,101,91
68285,211631,21429,101818,13938,190202,192,101,91
68290,211652,21431,101827,13940,190221,192,101,91
68295,211662,21433,101833,13942,190229,192,101,91
68300,211683,21435,101841,13943,190248,192,101,91
68305,211693,21436,101847,13944,190257,192,101,91
68310,211714,21437,101855,13945,190277,192,101,91
68315,211724,21439,101859,13947,190285,192,101,91
68320,211745,21440,101867,13948,190305,192,101,91
68325,211755,21442,101873,13949,190312,192,101,91
68330,211776,21444,101883,13950,190332,192,101,91
68335,211786,21445,101886,13950,190341,192,101,91
68340,211807,21447,101894,13951,190360,192,101,91
68345,211817,21448,101898,13951,190369,192,101,91
68350,211838,21450,101906,13951,190388,192,101,91
68355,211848,21451,101910,13951,190397,192,101,91
68360,211869,21455,101919,13955,190414,192,101,91
68365,211879,21457,101923,13956,190422,192,101,91
68370,211900,21459,101932,13958,190441,192,101,91
68375,211910,21460,101935,13959,190450,192,101,91
68380,211931,21462,101945,13960,190469,192,101,91
68385,211941,21464,101951,13962,190477,192,101,91
68390,211962,21467,101958,13963,190495,192,101,91
68395,211972,21468,101962,13963,190504,192,101,91
68400,211993,21470,101968,13963,190523,192,101,91
68405,212003,21471,101974,13964,190532,192,101,91
68410,212024,21472,101986,13964,190552,192,101,91
68415,212034,21473,101989,13964,190561,192,101,91
68420,212055,21475,102002,13966,190579,192,101,91
68425,212065,21477,102004,13968,190588,192,101,91
68430,212086,21478,102011,13969,190608,192,101,91
68435,212096,21479,102016,13970,190617,192,101,91
68440,212117,21480,102025,13971,190636,192,101,91
68445,212127,21483,102028,13973,190644,192,101,91
68450,212148,21484,102040,13973,190664,192,101,91
68455,212158,21485,102046,13973,190673,192,101,91
68460,212179,21487,102055,13975,190692,192,101,91
68465,212189,21487,102059,13975,190702,192,101,91
68470,212210,21488,102065,13976,190722,192,101,91
68475,212220,21489,102067,13977,190731,192,101,91
68480,212241,21490,102078,13977,190751,192,101,91
68485,212251,21490,102081,13977,190761,192,101,91
68490,212272,21491,102093,13978,190781,192,101,91
68495,212282,21491,102096,13978,190791,192,101,91
68500,212303,21492,102110,13979,190811,192,101,91
68505,212313,21492,102114,13979,190821,192,101,91
68510,212334,21495,102124,13981,190839,192,101,91
68515,212344,21495,102132,13981,190849,192,101,91
68520,212365,21499,102141,13983,190866,192,101,91
68525,212375,21499,102147,13983,190876,192,101,91
68530,212396,21502,102158,13985,190894,192,101,91
68535,212406,21502,102163,13985,190903,192,101,91
68540,212427,21506,102175,13989,190921,192,101,91
68545,212437,21506,102177,13989,190931,192,101,91
68550,212458,21509,102189,13992,190949,192,101,91
68555,212468,21509,102191,13992,190959,192,101,91
68560,212489,21511,102206,13994,190978,192,101,91
68565,212499,21511,102212,13994,190988,192,101,91
68570,212520,21515,102226,13998,191004,192,101,91
68575,212530,21517,102231,13999,191013,192,101,91
68580,212551,21521,102241,14001,191029,192,101,91
68585,212561,21524,102246,14004,191037,192,101,91
68590,212582,21526,102256,14005,191056,192,101,91
68595,212592,21527,102261,14005,191065,192,101,91
68600,212613,21529,102271,14006,191084,192,101,91
68605,212623,21530,102275,14007,191093,192,101,91
68610,212644,21531,102285,14007,191113,192,101,91
68615,212654,21532,102291,14008,191122,192,101,91
68620,212675,21533,102299,14008,191142,192,101,91
68625,212685,21534,102302,14008,191151,192,101,91
68630,212706,21536,102311,14009,191170,192,101,91
68635,212716,21537,102316,14010,191179,192,101,91
68640,212737,21540,102328,14012,191197,192,101,91
68645,212747,21540,102334,14012,191207,192,101,91
68650,212768,21542,102348,14014,191226,192,101,91
68655,212778,21542,102354,14014,191236,192,101,91
68660,212799,21543,102361,14014,191256,192,101,91
68665,212809,21543,102368,14014,191266,192,101,91
68670,212830,21545,102379,14016,191285,192,101,91
68675,212840,21546,102384,14017,191294,192,101,91
68680,212861,21547,102391,14018,191314,192,101,91
68685,212871,21547,102395,14018,191324,192,101,91
68690,212892,21548,102399,14019,191344,192,101,91
68695,212902,21549,102405,14020,191353,192,101,91
68700,212923,21551,102416,14021,191372,192,101,91
68705,212933,21551,102419,14021,191382,192,101,91
68710,212954,21551,102431,14021,191403,192,101,91
68715,212964,21551,102435,14021,191413,192,101,91
68720,212985,21551,102446,14021,191434,192,101,91
68725,212995,21551,102452,14021,191444,192,101,91
68730,213016,21551,102466,14021,191465,192,101,91
68735,213026,21551,102472,14021,191475,192,101,91
68740,213047,21551,102483,14021,191496,192,101,91
68745,213057,21552,102489,14022,191505,192,101,91
68750,213078,21555,102500,14024,191523,192,101,91
68755,213088,21557,102509,14026,191531,192,101,91
68760,213109,21560,102516,14028,191549,192,101,91
68765,213119,21561,102523,14029,191557,192,101,91
68770,213140,21566,102534,14033,191574,192,101,91
68775,213150,21567,102538,14033,191583,192,101,91
68780,213171,21571,102547,14035,191600,192,101,91
68785,213181,21572,102553,14036,191609,192,101,91
68790,213202,21576,102561,14037,191626,192,101,91
68795,213212,21577,102564,14038,191635,192,101,91
68800,213233,21580,102573,14038,191653,192,101,91
68805,213243,21581,102579,14039,191661,192,101,91
68810,213264,21586,102592,14041,191677,192,101,91
68815,213274,21588,102595,14042,191685,192,101,91
68820,213295,21593,102605,14046,191702,192,101,91
68825,213305,21594,102613,14047,191711,192,101,91
68830,213326,21594,102623,14047,191731,192,101,91
68835,213336,21596,102626,14048,191740,192,101,91
68840,213357,21596,102637,14048,191761,192,101,91
68845,213367,21597,102641,14049,191770,192,101,91
68850,213388,21597,102652,14049,191791,192,101,91
68855,213398,21598,102658,14049,191800,192,101,91
68860,213419,21598,102669,14049,191821,192,101,91
68865,213429,21599,102673,14049,191830,192,101,91
68870,213450,21600,102685,14050,191850,192,101,91
68875,213460,21601,102691,14051,191859,192,101,91
68880,213481,21602,102701,14052,191879,192,101,91
68885,213491,21602,102705,14052,191889,192,101,91
68890,213512,21603,102715,14053,191909,192,101,91
68895,213522,21604,102723,14054,191918,192,101,91
68900,213543,21605,102734,14054,191938,192,101,91
68905,213553,21605,102741,14054,191948,192,101,91
68910,213574,21606,102752,14054,191968,192,101,91
68915,213584,21606,102757,14054,191978,192,101,91
68920,213605,21607,102770,14055,191998,192,101,91
68925,213615,21607,102775,14055,192008,192,101,91
68930,213636,21611,102786,14058,192025,192,101,91
68935,213646,21611,102791,14058,192034,192,101,91
68940,213667,21616,102800,14062,192051,192,101,91
68945,213677,21617,102805,14063,192059,192,101,91
68950,213698,21621,102813,14065,192077,192,101,91
68955,213708,21621,102822,14065,192086,192,101,91
68960,213729,21627,102835,14069,192102,192,101,91
68965,213739,21627,102840,14069,192111,192,101,91
68970,213760,21633,102849,14074,192127,192,101,91
68975,213770,21633,102856,14074,192137,192,101,91
68980,213791,21633,102865,14074,192158,192,101,91
68985,213801,21634,102871,14074,192167,192,101,91
68990,213822,21634,102878,14074,192188,192,101,91
68995,213832,21635,102882,14074,192197,192,101,91
69000,213853,21636,102892,14075,192217,192,101,91
69005,213863,21637,102896,14076,192226,192,101,91
69010,213884,21638,102902,14076,192246,192,101,91
69015,213894,21639,102906,14076,192255,192,101,91
69020,213915,21641,102917,14077,192273,192,101,91
69025,213925,21644,102925,14080,192281,192,101,91
69030,213946,21647,102937,14083,192298,192,101,91
69035,213956,21649,102942,14085,192307,192,101,91
69040,213977,21650,102954,14086,192327,192,101,91
69045,213987,21651,102957,14086,192336,192,101,91
69050,214008,21651,102965,14086,192357,192,101,91
69055,214018,21652,102969,14087,192366,192,101,91
69060,214039,21654,102978,14089,192385,192,101,91
69065,214049,21656,102982,14090,192393,192,101,91
69070,214070,21657,102993,14090,192413,192,101,91
69075,214080,21659,102999,14092,192420,192,101,91
69080,214101,21663,103009,14095,192438,192,101,91
69085,214111,21664,103013,14096,192447,192,101,91
69090,214132,21667,103026,14098,192465,192,101,91
69095,214142,21668,103032,14098,192473,192,101,91
69100,214163,21672,103040,14101,192491,192,101,91
69105,214173,21673,103045,14101,192500,192,101,91
69110,214194,21675,103057,14102,192519,192,101,91
69115,214204,21676,103064,14103,192527,192,101,91
69120,214225,21681,103074,14107,192544,192,101,91
69125,214235,21682,103076,14108,192553,192,101,91
69130,214256,21686,103087,14111,192570,192,101,91
69135,214266,21687,103089,14111,192579,192,101,91
69140,214287,21691,103101,14115,192596,192,101,91
69145,214297,21692,103108,14116,192605,192,101,91
69150,214318,21697,103115,14118,192620,192,101,91
69155,214328,21699,103123,14120,192628,192,101,91
69160,214349,21705,103136,14125,192644,192,101,91
69165,214359,21705,103141,14125,192653,192,101,91
69170,214380,21711,103155,14129,192669,192,101,91
69175,214390,21711,103162,14129,192678,192,101,91
69180,214411,21717,103174,14133,192694,192,101,91
69185,214421,21717,103181,14133,192703,192,101,91
69190,214442,21721,103191,14137,192721,192,101,91
69195,214452,21721,103196,14137,192731,192,101,91
69200,214473,21723,103205,14137,192750,192,101,91
69205,214483,21723,103208,14137,192760,192,101,91
69210,214504,21725,103218,14137,192779,192,101,91
69215,214514,21725,103222,14137,192789,192,101,91
69220,214535,21728,103235,14139,192807,192,101,91
69225,214545,21729,103241,14140,192816,192,101,91
69230,214566,21732,103255,14141,192834,192,101,91
69235,214576,21732,103260,14141,192844,192,101,91
69240,214597,21734,103270,14142,192863,192,101,91
69245,214607,21736,103272,14143,192871,192,101,91
69250,214628,21739,103279,14145,192889,192,101,91
69255,214638,21741,103283,14146,192897,192,101,91
69260,214659,21744,103291,14148,192915,192,101,91
69265,214669,21746,103296,14149,192923,192,101,91
69270,214690,21748,103308,14150,192942,192,101,91
69275,214700,21749,103314,14151,192951,192,101,91
69280,214721,21753,103325,14154,192967,192,101,91
69285,214731,21756,103334,14157,192975,192,101,91
69290,214752,21759,103342,14158,192993,192,101,91
69295,214762,21760,103348,14159,193001,192,101,91
69300,214783,21764,103362,14163,193019,192,101,91
69305,214793,21765,103368,14164,193028,192,101,91
69310,214814,21765,103382,14164,193049,192,101,91
69315,214824,21765,103387,14164,193059,192,101,91
69320,214845,21765,103395,14164,193080,192,101,91
69325,214855,21765,103398,14164,193090,192,101,91
69330,214876,21765,103409,14164,193111,192,101,91
69335,214886,21765,103414,14164,193121,192,101,91
69340,214907,21765,103424,14164,193142,192,101,91
69345,214917,21765,103429,14164,193152,192,101,91
69350,214938,21765,103442,14164,193173,192,101,91
69355,214948,21765,103448,14164,193183,192,101,91
69360,214969,21765,103457,14164,193204,192,101,91
69365,214979,21765,103462,14164,193214,192,101,91
69370,215000,21766,103468,14164,193234,192,101,91
69375,215010,21766,103474,14164,193244,192,101,91
69380,215031,21767,103485,14164,193264,192,101,91
69385,215041,21767,103490,14164,193274,192,101,91
69390,215062,21768,103500,14164,193294,192,101,91
69395,215072,21768,103505,14164,193304,192,101,91
69400,215093,21769,103513,14164,193324,192,101,91
69405,215103,21769,103520,14164,193334,192,101,91
69410,215124,21773,103534,14166,193351,192,101,91
69415,215134,21774,103538,14167,193360,192,101,91
69420,215155,21780,103549,14170,193374,192,101,91
69425,215165,21783,103554,14173,193382,192,101,91
69430,215186,21787,103565,14176,193398,192,101,91
69435,215196,21790,103568,14178,193406,192,101,91
69440,215217,21794,103579,14180,193423,192,101,91
69445,215227,21796,103584,14182,193431,192,101,91
69450,215248,21800,103591,14184,193448,192,101,91
69455,215258,21801,103597,14185,193457,192,101,91
69460,215279,21804,103608,14188,193475,192,101,91
69465,215289,21805,103612,14188,193484,192,101,91
69470,215310,21808,103618,14190,193502,192,101,91
69475,215320,21809,103624,14190,193511,192,101,91
69480,215341,21812,103635,14191,193529,192,101,91
69485,215351,21813,103641,14192,193538,192,101,91
69490,215372,21816,103650,14194,193556,192,101,91
69495,215382,21817,103656,14195,193565,192,101,91
69500,215403,21819,103666,14197,193584,192,101,91
69505,215413,21820,103671,14198,193593,192,101,91
69510,215434,21822,103681,14199,193612,192,101,91
69515,215444,21823,103684,14199,193621,192,101,91
69520,215465,21825,103690,14200,193640,192,101,91
69525,215475,21826,103697,14201,193649,192,101,91
69530,215496,21827,103707,14202,193669,192,101,91
69535,215506,21828,103712,14203,193678,192,101,91
69540,215527,21831,103723,14206,193696,192,101,91
69545,215537,21832,103725,14206,193705,192,101,91
69550,215558,21834,103736,14206,193723,192,101,91
69555,215568,21836,103743,14208,193732,192,101,91
69560,215589,21839,103753,14210,193749,192,101,91
69565,215599,21843,103759,14213,193756,192,101,91
69570,215620,21846,103769,14214,193774,192,101,91
69575,215630,21848,103771,14216,193782,192,101,91
69580,215651,21852,103782,14219,193799,192,101,91
69585,215661,21855,103787,14222,193806,192,101,91
69590,215682,21859,103796,14223,193822,192,101,91
69595,215692,21863,103803,14227,193829,192,101,91
69600,215713,21868,103812,14231,193844,192,101,91
69605,215723,21869,103817,14232,193854,192,101,91
69610,215744,21872,103830,14234,193872,192,101,91
69615,215754,21872,103835,14234,193882,192,101,91
69620,215775,21875,103846,14236,193900,192,101,91
69625,215785,21875,103851,14236,193910,192,101,91
69630,215806,21877,103857,14236,193929,192,101,91
69635,215816,21877,103859,14236,193939,192,101,91
69640,215837,21878,103870,14236,193959,192,101,91
69645,215847,21878,103872,14236,193969,192,101,91
69650,215868,21879,103884,14237,193989,192,101,91
69655,215878,21879,103887,14237,193999,192,101,91
69660,215899,21880,103901,14238,194019,192,101,91
69665,215909,21881,103905,14239,194028,192,101,91
69670,215930,21883,103916,14240,194047,192,101,91
69675,215940,21884,103920,14240,194056,192,101,91
69680,215961,21886,103932,14242,194074,192,101,91
69685,215971,21888,103938,14244,194083,192,101,91
69690,215992,21891,103950,14247,194100,192,101,91
69695,216002,21893,103955,14249,194109,192,101,91
69700,216023,21895,103965,14251,194127,192,101,91
69705,216033,21897,103971,14253,194136,192,101,91
69710,216054,21900,103980,14255,194154,192,101,91
69715,216064,21901,103986,14256,194163,192,101,91
69720,216085,21905,103996,14259,194180,192,101,91
69725,216095,21906,104004,14260,194188,192,101,91
69730,216116,21910,104016,14264,194206,192,101,91
69735,216126,21910,104020,14264,194216,192,101,91
69740,216147,21913,104030,14265,194234,192,101,91
69745,216157,21913,104036,14265,194244,192,101,91
69750,216178,21914,104046,14265,194264,192,101,91
69755,216188,21914,104049,14265,194274,192,101,91
69760,216209,21916,104064,14266,194293,192,101,91
69765,216219,21916,104067,14266,194303,192,101,91
69770,216240,21918,104077,14267,194322,192,101,91
69775,216250,21918,104082,14267,194332,192,101,91
69780,216271,21919,104095,14267,194352,192,101,91
69785,216281,21920,104101,14268,194361,192,101,91
69790,216302,21922,104112,14269,194380,192,101,91
69795,216312,21923,104117,14270,194389,192,101,91
69800,216333,21925,104128,14271,194408,192,101,91
69805,216343,21925,104134,14271,194418,192,101,91
69810,216364,21927,104145,14272,194437,192,101,91
69815,216374,21927,104147,14272,194447,192,101,91
69820,216395,21929,104161,14274,194466,192,101,91
69825,216405,21930,104165,14274,194475,192,101,91
69830,216426,21934,104178,14278,194492,192,101,91
69835,216436,21935,104184,14279,194500,192,101,91
69840,216457,21940,104192,14282,194517,192,101,91
69845,216467,21941,104198,14282,194525,192,101,91
69850,216488,21944,104208,14285,194544,192,101,91
69855,216498,21944,104215,14285,194553,192,101,91
69860,216519,21946,104225,14286,194573,192,101,91
69865,216529,21946,104232,14286,194583,192,101,91
69870,216550,21948,104244,14287,194602,192,101,91
69875,216560,21948,104248,14287,194611,192,101,91
69880,216581,21950,104254,14288,194631,192,101,91
69885,216591,21950,104257,14288,194641,192,101,91
69890,216612,21951,104266,14288,194661,192,101,91
69895,216622,21951,104270,14288,194671,192,101,91
69900,216643,21953,104283,14290,194690,192,101,91
69905,216653,21953,104287,14290,194700,192,101,91
69910,216674,21955,104293,14291,194719,192,101,91
69915,216684,21955,104301,14291,194729,192,101,91
69920,216705,21956,104314,14292,194749,192,101,91
69925,216715,21956,104317,14292,194759,192,101,91
69930,216736,21957,104328,14293,194779,192,101,91
69935,216746,21957,104332,14293,194789,192,101,91
69940,216767,21958,104343,14293,194809,192,101,91
69945,216777,21958,104347,14293,194819,192,101,91
69950,216798,21963,104359,14298,194835,192,101,91
69955,216808,21964,104363,14298,194844,192,101,91
69960,216829,21968,104372,14299,194861,192,101,91
69965,216839,21969,104377,14300,194870,192,101,91
69970,216860,21971,104388,14300,194889,192,101,91
69975,216870,21972,104391,14300,194898,192,101,91
69980,216891,21976,104402,14302,194915,192,101,91
69985,216901,21977,104404,14302,194924,192,101,91
69990,216922,21980,104416,14305,194942,192,101,91
69995,216932,21981,104423,14306,194951,192,101,91
70000,216953,21984,104433,14308,194969,192,101,91
70005,216963,21985,104435,14309,194978,192,101,91
70010,216984,21988,104444,14311,194996,192,101,91
70015,216994,21989,104449,14312,195004,192,101,91
70020,217015,21993,104460,14315,195022,192,101,91
70025,217025,21994,104464,14316,195031,192,101,91
70030,217046,21994,104471,14316,195052,192,101,91
70035,217056,21995,104474,14316,195061,192,101,91
70040,217077,21996,104487,14317,195081,192,101,91
70045,217087,21997,104493,14318,195090,192,101,91
70050,217108,21997,104497,14318,195111,192,101,91
70055,217118,21998,104501,14319,195120,192,101,91
70060,217139,21999,104511,14320,195140,192,101,91
70065,217149,22000,104516,14321,195149,192,101,91
70070,217170,22000,104531,14321,195170,192,101,91
70075,217180,22001,104535,14322,195179,192,101,91
70080,217201,22001,104547,14322,195199,192,101,91
70085,217211,22002,104552,14323,195209,192,101,91
70090,217232,22002,104562,14323,195230,192,101,91
70095,217242,22002,104569,14323,195240,192,101,91
70100,217263,22002,104579,14323,195261,192,101,91
70105,217273,22002,104586,14323,195271,192,101,91
70110,217294,22002,104593,14323,195292,192,101,91
70115,217304,22002,104597,14323,195302,192,101,91
70120,217325,22002,104608,14323,195323,192,101,91
70125,217335,22002,104615,14323,195332,192,101,91
70130,217356,22006,104625,14326,195350,192,101,91
70135,217366,22006,104629,14326,195359,192,101,91
70140,217387,22012,104639,14330,195375,192,101,91
70145,217397,22014,104645,14332,195383,192,101,91
70150,217418,22016,104651,14332,195402,192,101,91
70155,217428,22017,104658,14333,195411,192,101,91
70160,217449,22019,104667,14334,195430,192,101,91
70165,217459,22020,104670,14334,195439,192,101,91
70170,217480,22022,104679,14335,195458,192,101,91
70175,217490,22023,104685,14335,195467,192,101,91
70180,217511,22025,104695,14335,195486,192,101,91
70185,217521,22026,104700,14336,195495,192,101,91
70190,217542,22028,104707,14338,195514,192,101,91
70195,217552,22029,104712,14339,195523,192,101,91
70200,217573,22032,104720,14342,195541,192,101,91
70205,217583,22033,104724,14342,195550,192,101,91
70210,217604,22036,104733,14344,195568,192,101,91
70215,217614,22037,104739,14344,195577,192,101,91
70220,217635,22041,104750,14347,195594,192,101,91
70225,217645,22042,104757,14348,195603,192,101,91
70230,217666,22046,104771,14351,195620,192,101,91
70235,217676,22047,104775,14351,195629,192,101,91
70240,217697,22050,104787,14354,195647,192,101,91
70245,217707,22051,104792,14354,195655,192,101,91
70250,217728,22057,104802,14358,195670,192,101,91
70255,217738,22059,104806,14360,195678,192,101,91
70260,217759,22064,104817,14363,195695,192,101,91
70265,217769,22064,104821,14363,195705,192,101,91
70270,217790,22066,104825,14363,195724,192,101,91
70275,217800,22068,104828,14365,195732,192,101,91
70280,217821,22071,104834,14367,195750,192,101,91
70285,217831,22072,104842,14368,195758,192,101,91
70290,217852,22074,104852,14370,195778,192,101,91
70295,217862,22074,104857,14370,195788,192,101,91
70300,217883,22075,104871,14371,195808,192,101,91
70305,217893,22075,104876,14371,195818,192,101,91
70310,217914,22076,104886,14372,195838,192,101,91
70315,217924,22076,104889,14372,195848,192,101,91
70320,217945,22077,104899,14372,195868,192,101,91
70325,217955,22077,104905,14372,195878,192,101,91
70330,217976,22078,104918,14373,195898,192,101,91
70335,217986,22078,104925,14373,195908,192,101,91
70340,218007,22079,104939,14374,195928,192,101,91
70345,218017,22079,104943,14374,195938,192,101,91
70350,218038,22080,104951,14374,195958,192,101,91
70355,218048,22080,104953,14374,195968,192,101,91
70360,218069,22081,104964,14374,195988,192,101,91
70365,218079,22081,104970,14374,195998,192,101,91
70370,218100,22083,104983,14376,196017,192,101,91
70375,218110,22084,104988,14377,196026,192,101,91
70380,218131,22088,105001,14381,196043,192,101,91
70385,218141,22089,105008,14382,196052,192,101,91
70390,218162,22093,105019,14384,196068,192,101,91
70395,218172,22095,105025,14386,196076,192,101,91
70400,218193,22101,105038,14391,196091,192,101,91
70405,218203,22103,105044,14392,196099,192,101,91
70410,218224,22107,105053,14395,196117,192,101,91
70415,218234,22108,105058,14396,196126,192,101,91
70420,218255,22110,105064,14397,196145,192,101,91
70425,218265,22111,105069,14397,196154,192,101,91
70430,218286,22115,105079,14400,196171,192,101,91
70435,218296,22116,105085,14400,196179,192,101,91
70440,218317,22119,105094,14401,196197,192,101,91
70445,218327,22121,105102,14403,196206,192,101,91
70450,218348,22123,105113,14404,196225,192,101,91
70455,218358,22124,105118,14404,196234,192,101,91
70460,218379,22126,105128,14406,196253,192,101,91
70465,218389,22127,105129,14406,196262,192,101,91
70470,218410,22129,105142,14408,196281,192,101,91
70475,218420,22130,105146,14408,196290,192,101,91
70480,218441,22132,105156,14409,196309,192,101,91
70485,218451,22133,105159,14410,196318,192,101,91
70490,218472,22134,105171,14410,196338,192,101,91
70495,218482,22135,105174,14411,196347,192,101,91
70500,218503,22137,105186,14413,196366,192,101,91
70505,218513,22137,105192,14413,196376,192,101,91
70510,218534,22139,105204,14414,196395,192,101,91
70515,218544,22139,105209,14414,196405,192,101,91
70520,218565,22141,105218,14415,196424,192,101,91
70525,218575,22141,105224,14415,196434,192,101,91
70530,218596,22143,105231,14415,196453,192,101,91
70535,218606,22143,105236,14415,196463,192,101,91
70540,218627,22145,105249,14417,196482,192,101,91
70545,218637,22145,105252,14417,196492,192,101,91
70550,218658,22148,105260,14419,196510,192,101,91
70555,218668,22148,105265,14419,196520,192,101,91
70560,218689,22152,105272,14421,196537,192,101,91
70565,218699,22154,105276,14423,196545,192,101,91
70570,218720,22156,105284,14424,196563,192,101,91
70575,218730,22159,105287,14426,196570,192,101,91
70580,218751,22162,105296,14429,196589,192,101,91
70585,218761,22164,105301,14431,196597,192,101,91
70590,218782,22166,105310,14432,196616,192,101,91
70595,218792,22168,105316,14434,196624,192,101,91
70600,218813,22171,105325,14436,196641,192,101,91
70605,218823,22173,105329,14438,196650,192,101,91
70610,218844,22175,105339,14439,196669,192,101,91
70615,218854,22176,105341,14439,196678,192,101,91
70620,218875,22178,105353,14441,196697,192,101,91
70625,218885,22179,105357,14441,196706,192,101,91
70630,218906,22179,105370,14441,196727,192,101,91
70635,218916,22180,105375,14442,196736,192,101,91
70640,218937,22180,105386,14442,196757,192,101,91
70645,218947,22181,105391,14442,196766,192,101,91
70650,218968,22181,105403,14442,196787,192,101,91
70655,218978,22182,105410,14442,196796,192,101,91
70660,218999,22182,105419,14442,196817,192,101,91
70665,219009,22183,105427,14443,196826,192,101,91
70670,219030,22184,105436,14443,196846,192,101,91
70675,219040,22185,105442,14444,196855,192,101,91
70680,219061,22188,105452,14447,196873,192,101,91
70685,219071,22189,105454,14447,196882,192,101,91
70690,219092,22193,105466,14449,196899,192,101,91
70695,219102,22194,105472,14450,196908,192,101,91
70700,219123,22198,105482,14452,196925,192,101,91
70705,219133,22200,105486,14454,196933,192,101,91
70710,219154,22203,105495,14456,196951,192,101,91
70715,219164,22204,105500,14457,196960,192,101,91
70720,219185,22208,105515,14461,196976,192,101,91
70725,219195,22211,105519,14463,196984,192,101,91
70730,219216,22214,105527,14463,197001,192,101,91
70735,219226,22216,105530,14465,197010,192,101,91
70740,219247,22219,105540,14467,197027,192,101,91
70745,219257,22221,105546,14469,197036,192,101,91
70750,219278,22223,105556,14470,197055,192,101,91
70755,219288,22224,105559,14471,197064,192,101,91
70760,219309,22227,105573,14472,197082,192,101,91
70765,219319,22227,105576,14472,197092,192,101,91
70770,219340,22228,105587,14472,197112,192,101,91
70775,219350,22228,105590,14472,197122,192,101,91
70780,219371,22229,105603,14473,197142,192,101,91
70785,219381,22230,105608,14474,197151,192,101,91
70790,219402,22231,105623,14475,197171,192,101,91
70795,219412,22232,105628,14476,197180,192,101,91
70800,219433,22233,105635,14476,197200,192,101,91
70805,219443,22233,105637,14476,197210,192,101,91
70810,219464,22233,105648,14476,197231,192,101,91
70815,219474,22233,105652,14476,197241,192,101,91
70820,219495,22233,105661,14476,197262,192,101,91
70825,219505,22233,105667,14476,197272,192,101,91
70830,219526,22233,105682,14476,197293,192,101,91
70835,219536,22233,105689,14476,197303,192,101,91
70840,219557,22233,105698,14476,197324,192,101,91
70845,219567,22233,105700,14476,197334,192,101,91
70850,219588,22233,105712,14476,197355,192,101,91
70855,219598,22233,105718,14476,197365,192,101,91
70860,219619,22236,105727,14478,197383,192,101,91
70865,219629,22236,105732,14478,197393,192,101,91
70870,219650,22237,105742,14478,197413,192,101,91
70875,219660,22237,105745,14478,197423,192,101,91
70880,219681,22238,105754,14478,197443,192,101,91
70885,219691,22238,105756,14478,197453,192,101,91
70890,219712,22239,105766,14479,197473,192,101,91
70895,219722,22239,105772,14479,197483,192,101,91
70900,219743,22240,105775,14479,197503,192,101,91
70905,219753,22240,105779,14479,197513,192,101,91
70910,219774,22243,105792,14481,197530,192,101,91
70915,219784,22245,105799,14483,197539,192,101,91
70920,219805,22250,105811,14486,197554,192,101,91
70925,219815,22252,105818,14488,197562,192,101,91
70930,219836,22256,105830,14492,197579,192,101,91
70935,219846,22258,105836,14493,197587,192,101,91
70940,219867,22262,105845,14496,197605,192,101,91
70945,219877,22262,105850,14496,197615,192,101,91
70950,219898,22265,105858,14498,197633,192,101,91
70955,219908,22265,105864,14498,197642,192,101,91
70960,219929,22268,105872,14500,197661,192,101,91
70965,219939,22268,105878,14500,197670,192,101,91
70970,219960,22271,105889,14502,197689,192,101,91
70975,219970,22271,105892,14502,197699,192,101,91
70980,219991,22273,105902,14502,197718,192,101,91
70985,220001,22273,105906,14502,197728,192,101,91
70990,220022,22274,105913,14503,197748,192,101,91
70995,220032,22274,105919,14503,197758,192,101,91
71000,220053,22275,105926,14504,197778,192,101,91
71005,220063,22275,105933,14504,197788,192,101,91
71010,220084,22276,105939,14504,197808,192,101,91
71015,220094,22276,105943,14504,197818,192,101,91
71020,220115,22277,105959,14505,197838,192,101,91
71025,220125,22277,105965,14505,197848,192,101,91
71030,220146,22280,105975,14507,197866,192,101,91
71035,220156,22281,105980,14508,197874,192,101,91
71040,220177,22284,105987,14509,197893,192,101,91
71045,220187,22285,105991,14509,197902,192,101,91
71050,220208,22288,106002,14511,197919,192,101,91
71055,220218,22292,106007,14514,197926,192,101,91
71060,220239,22296,106019,14517,197943,192,101,91
71065,220249,22299,106026,14519,197950,192,101,91
71070,220270,22302,106036,14521,197967,192,101,91
71075,220280,22304,106041,14523,197976,192,101,91
71080,220301,22307,106051,14525,197994,192,101,91
71085,220311,22308,106057,14526,198003,192,101,91
71090,220332,22309,106067,14527,198022,192,101,91
71095,220342,22311,106071,14528,198031,192,101,91
71100,220363,22313,106084,14530,198050,192,101,91
71105,220373,22315,106086,14532,198058,192,101,91
71110,220394,22316,106100,14532,198078,192,101,91
71115,220404,22317,106106,14533,198087,192,101,91
71120,220425,22318,106116,14534,198107,192,101,91
71125,220435,22319,106122,14534,198116,192,101,91
71130,220456,22321,106132,14536,198135,192,101,91
71135,220466,22322,106138,14537,198144,192,101,91
71140,220487,22325,106150,14540,198162,192,101,91
71145,220497,22326,106156,14540,198171,192,101,91
71150,220518,22329,106165,14541,198189,192,101,91
71155,220528,22330,106170,14542,198197,192,101,91
71160,220549,22334,106183,14546,198215,192,101,91
71165,220559,22335,106186,14546,198224,192,101,91
71170,220580,22339,106194,14548,198241,192,101,91
71175,220590,22340,106199,14548,198250,192,101,91
71180,220611,22343,106209,14549,198268,192,101,91
71185,220621,22344,106213,14549,198276,192,101,91
71190,220642,22348,106224,14552,198294,192,101,91
71195,220652,22349,106228,14553,198302,192,101,91
71200,220673,22352,106236,14555,198321,192,101,91
71205,220683,22353,106241,14555,198329,192,101,91
71210,220704,22356,106248,14556,198347,192,101,91
71215,220714,22358,106252,14557,198356,192,101,91
71220,220735,22361,106264,14559,198373,192,101,91
71225,220745,22362,106267,14560,198383,192,101,91
71230,220766,22364,106279,14561,198402,192,101,91
71235,220776,22364,106286,14561,198411,192,101,91
71240,220797,22367,106296,14562,198430,192,101,91
71245,220807,22367,106298,14562,198440,192,101,91
71250,220828,22369,106306,14563,198459,192,101,91
71255,220838,22369,106309,14563,198469,192,101,91
71260,220859,22371,106320,14563,198488,192,101,91
71265,220869,22372,106328,14564,198497,192,101,91
71270,220890,22375,106337,14565,198515,192,101,91
71275,220900,22376,106344,14566,198524,192,101,91
71280,220921,22379,106354,14566,198542,192,101,91
71285,220931,22381,106357,14567,198550,192,101,91
71290,220952,22385,106366,14569,198567,192,101,91
71295,220962,22386,106372,14570,198575,192,101,91
71300,220983,22390,106381,14573,198593,192,101,91
71305,220993,22392,106388,14575,198600,192,101,91
71310,221014,22397,106397,14579,198617,192,101,91
71315,221024,22399,106404,14581,198624,192,101,91
71320,221045,22402,106413,14583,198643,192,101,91
71325,221055,22403,106418,14583,198652,192,101,91
71330,221076,22405,106426,14584,198671,192,101,91
71335,221086,22406,106432,14585,198680,192,101,91
71340,221107,22409,106445,14588,198698,192,101,91
71345,221117,22409,106449,14588,198708,192,101,91
71350,221138,22411,106462,14589,198727,192,101,91
71355,221148,22411,106469,14589,198737,192,101,91
71360,221169,22413,106478,14591,198756,192,101,91
71365,221179,22413,106483,14591,198766,192,101,91
71370,221200,22413,106493,14591,198787,192,101,91
71375,221210,22413,106499,14591,198797,192,101,91
71380,221231,22413,106515,14591,198818,192,101,91
71385,221241,22413,106520,14591,198828,192,101,91
71390,221262,22413,106530,14591,198849,192,101,91
71395,221272,22413,106537,14591,198859,192,101,91
71400,221293,22413,106549,14591,198880,192,101,91
71405,221303,22413,106554,14591,198890,192,101,91
71410,221324,22413,106564,14591,198911,192,101,91
71415,221334,22413,106567,14591,198921,192,101,91
71420,221355,22413,106581,14591,198942,192,101,91
71425,221365,22413,106586,14591,198952,192,101,91
71430,221386,22413,106595,14591,198973,192,101,91
71435,221396,22413,106599,14591,198983,192,101,91
71440,221417,22413,106606,14591,199004,192,101,91
71445,221427,22413,106612,14591,199014,192,101,91
71450,221448,22414,106625,14591,199034,192,101,91
71455,221458,22416,106630,14592,199042,192,101,91
71460,221479,22418,106639,14592,199061,192,101,91
71465,221489,22420,106644,14593,199069,192,101,91
71470,221510,22424,106655,14595,199086,192,101,91
71475,221520,22426,106659,14597,199094,192,101,91
71480,221541,22430,106670,14599,199111,192,101,91
71485,221551,22431,106674,14600,199120,192,101,91
71490,221572,22436,106686,14604,199136,192,101,91
71495,221582,22437,106690,14605,199145,192,101,91
71500,221603,22441,106701,14608,199161,192,101,91
71505,221613,22443,106705,14609,199170,192,101,91
71510,221634,22447,106714,14612,199187,192,101,91
71515,221644,22448,106719,14613,199195,192,101,91
71520,221665,22453,106733,14617,199211,192,101,91
71525,221675,22455,106738,14619,199220,192,101,91
71530,221696,22459,106747,14622,199237,192,101,91
71535,221706,22459,106752,14622,199247,192,101,91
71540,221727,22463,106763,14625,199264,192,101,91
71545,221737,22463,106765,14625,199274,192,101,91
71550,221758,22466,106776,14626,199292,192,101,91
71555,221768,22466,106780,14626,199301,192,101,91
71560,221789,22472,106793,14632,199317,192,101,91
71565,221799,22472,106798,14632,199327,192,101,91
71570,221820,22476,106808,14634,199344,192,101,91
71575,221830,22476,106813,14634,199353,192,101,91
71580,221851,22480,106822,14637,199371,192,101,91
71585,221861,22480,106826,14637,199381,192,101,91
71590,221882,22481,106832,14637,199401,192,101,91
71595,221892,22481,106836,14637,199411,192,101,91
71600,221913,22484,106846,14639,199429,192,101,91
71605,221923,22485,106849,14640,199438,192,101,91
71610,221944,22486,106861,14640,199458,192,101,91
71615,221954,22486,106864,14640,199468,192,101,91
71620,221975,22487,106872,14641,199488,192,101,91
71625,221985,22487,106876,14641,199498,192,101,91
71630,222006,22489,106885,14642,199517,192,101,91
71635,222016,22491,106890,14643,199525,192,101,91
71640,222037,22492,106900,14643,199545,192,101,91
71645,222047,22493,106906,14644,199554,192,101,91
71650,222068,22494,106913,14645,199574,192,101,91
71655,222078,22495,106919,14645,199583,192,101,91
71660,222099,22495,106927,14645,199604,192,101,91
71665,222109,22496,106930,14646,199613,192,101,91
71670,222130,22496,106939,14646,199634,192,101,91
71675,222140,22497,106947,14647,199643,192,101,91
71680,222161,22497,106955,14647,199664,192,101,91
71685,222171,22498,106961,14648,199672,192,101,91
71690,222192,22502,106970,14651,199690,192,101,91
71695,222202,22503,106976,14652,199698,192,101,91
71700,222223,22507,106987,14655,199716,192,101,91
71705,222233,22508,106992,14656,199725,192,101,91
71710,222254,22512,107006,14658,199741,192,101,91
71715,222264,22514,107011,14659,199749,192,101,91
71720,222285,22518,107018,14660,199766,192,101,91
71725,222295,22520,107021,14662,199775,192,101,91
71730,222316,22523,107033,14665,199793,192,101,91
71735,222326,22525,107039,14666,199800,192,101,91
71740,222347,22529,107049,14668,199818,192,101,91
71745,222357,22531,107056,14670,199825,192,101,91
71750,222378,22536,107070,14674,199841,192,101,91
71755,222388,22540,107076,14677,199848,192,101,91
71760,222409,22544,107080,14678,199864,192,101,91
71765,222419,22545,107085,14679,199874,192,101,91
71770,222440,22546,107095,14679,199894,192,101,91
71775,222450,22546,107100,14679,199904,192,101,91
71780,222471,22547,107108,14679,199924,192,101,91
71785,222481,22547,107111,14679,199934,192,101,91
71790,222502,22549,107124,14681,199953,192,101,91
71795,222512,22549,107131,14681,199963,192,101,91
71800,222533,22551,107138,14683,199982,192,101,91
71805,222543,22551,107143,14683,199992,192,101,91
71810,222564,22553,107154,14684,200011,192,101,91
71815,222574,22553,107160,14684,200021,192,101,91
71820,222595,22556,107172,14687,200039,192,101,91
71825,222605,22557,107177,14688,200048,192,101,91
71830,222626,22558,107185,14688,200068,192,101,91
71835,222636,22560,107192,14690,200076,192,101,91
71840,222657,22563,107202,14693,200094,192,101,91
71845,222667,22565,107205,14694,200102,192,101,91
71850,222688,22568,107219,14696,200119,192,101,91
71855,222698,22571,107225,14699,200127,192,101,91
71860,222719,22573,107233,14700,200146,192,101,91
71865,222729,22574,107238,14700,200155,192,101,91
71870,222750,22578,107251,14703,200172,192,101,91
71875,222760,22579,107256,14703,200180,192,101,91
71880,222781,22583,107269,14706,200198,192,101,91
71885,222791,22583,107273,14706,200207,192,101,91
71890,222812,22586,107283,14708,200226,192,101,91
71895,222822,22586,107287,14708,200236,192,101,91
71900,222843,22588,107297,14710,200255,192,101,91
71905,222853,22588,107300,14710,200265,192,101,91
71910,222874,22589,107308,14711,200285,192,101,91
71915,222884,22590,107312,14712,200294,192,101,91
71920,222905,22592,107318,14713,200313,192,101,91
71925,222915,22592,107321,14713,200323,192,101,91
71930,222936,22594,107333,14714,200342,192,101,91
71935,222946,22594,107336,14714,200352,192,101,91
71940,222967,22596,107345,14715,200371,192,101,91
71945,222977,22596,107351,14715,200381,192,101,91
71950,222998,22596,107361,14715,200402,192,101,91
71955,223008,22596,107364,14715,200412,192,101,91
71960,223029,22596,107375,14715,200433,192,101,91
71965,223039,22596,107382,14715,200443,192,101,91
71970,223060,22596,107391,14715,200464,192,101,91
71975,223070,22596,107396,14715,200474,192,101,91
71980,223091,22596,107410,14715,200495,192,101,91
71985,223101,22596,107419,14715,200505,192,101,91
71990,223122,22599,107430,14718,200523,192,101,91
71995,223132,22600,107432,14719,200532,192,101,91
72000,223153,22602,107442,14720,200550,192,101,91
72005,223163,22605,107445,14722,200557,192,101,91
72010,223184,22608,107458,14725,200575,192,101,91
72015,223194,22610,107463,14727,200584,192,101,91
72020,223215,22611,107473,14727,200604,192,101,91
72025,223225,22611,107475,14727,200614,192,101,91
72030,223246,22613,107488,14728,200633,192,101,91
72035,223256,22613,107490,14728,200643,192,101,91
72040,223277,22615,107503,14730,200662,192,101,91
72045,223287,22615,107506,14730,200672,192,101,91
72050,223308,22617,107515,14731,200691,192,101,91
72055,223318,22617,107517,14731,200701,192,101,91
72060,223339,22619,107530,14732,200720,192,101,91
72065,223349,22619,107535,14732,200730,192,101,91
72070,223370,22622,107547,14734,200748,192,101,91
72075,223380,22622,107552,14734,200758,192,101,91
72080,223401,22624,107563,14735,200777,192,101,91
72085,223411,22624,107571,14735,200787,192,101,91
72090,223432,22626,107579,14737,200806,192,101,91
72095,223442,22626,107584,14737,200816,192,101,91
72100,223463,22628,107591,14737,200835,192,101,91
72105,223473,22628,107595,14737,200845,192,101,91
72110,223494,22633,107604,14739,200861,192,101,91
72115,223504,22633,107609,14739,200871,192,101,91
72120,223525,22637,107615,14741,200888,192,101,91
72125,223535,22638,107620,14741,200896,192,101,91
72130,223556,22641,107628,14744,200915,192,101,91
72135,223566,22642,107631,14744,200924,192,101,91
72140,223587,22644,107640,14745,200943,192,101,91
72145,223597,22645,107648,14746,200951,192,101,91
72150,223618,22648,107657,14748,200970,192,101,91
72155,223628,22649,107662,14748,200978,192,101,91
72160,223649,22651,107671,14750,200998,192,101,91
72165,223659,22653,107677,14752,201005,192,101,91
72170,223680,22656,107685,14754,201023,192,101,91
72175,223690,22659,107691,14757,201030,192,101,91
72180,223711,22663,107705,14760,201048,192,101,91
72185,223721,22664,107712,14761,201056,192,101,91
72190,223742,22667,107722,14764,201075,192,101,91
72195,223752,22668,107724,14764,201084,192,101,91
72200,223773,22669,107734,14765,201104,192,101,91
72205,223783,22671,107739,14766,201112,192,101,91
72210,223804,22673,107749,14767,201131,192,101,91
72215,223814,22673,107753,14767,201140,192,101,91
72220,223835,22676,107765,14769,201159,192,101,91
72225,223845,22676,107770,14769,201169,192,101,91
72230,223866,22677,107782,14769,201189,192,101,91
72235,223876,22677,107784,14769,201199,192,101,91
72240,223897,22680,107793,14771,201217,192,101,91
72245,223907,22680,107799,14771,201227,192,101,91
72250,223928,22683,107808,14774,201245,192,101,91
72255,223938,22683,107809,14774,201255,192,101,91
72260,223959,22684,107819,14775,201275,192,101,91
72265,223969,22684,107822,14775,201285,192,101,91
72270,223990,22686,107835,14776,201304,192,101,91
72275,224000,22686,107841,14776,201314,192,101,91
72280,224021,22688,107857,14778,201333,192,101,91
72285,224031,22688,107863,14778,201342,192,101,91
72290,224052,22691,107870,14779,201361,192,101,91
72295,224062,22691,107877,14779,201371,192,101,91
72300,224083,22694,107885,14780,201389,192,101,91
72305,224093,22694,107889,14780,201399,192,101,91
72310,224114,22698,107898,14782,201416,192,101,91
72315,224124,22699,107900,14782,201425,192,101,91
72320,224145,22701,107911,14784,201444,192,101,91
72325,224155,22703,107913,14785,201452,192,101,91
72330,224176,22705,107925,14787,201471,192,101,91
72335,224186,22707,107930,14789,201479,192,101,91
72340,224207,22709,107937,14789,201498,192,101,91
72345,224217,22710,107939,14790,201507,192,101,91
72350,224238,22713,107949,14792,201525,192,101,91
72355,224248,22715,107956,14793,201533,192,101,91
72360,224269,22717,107961,14794,201551,192,101,91
72365,224279,22719,107966,14795,201560,192,101,91
72370,224300,22721,107979,14796,201579,192,101,91
72375,224310,22722,107983,14796,201588,192,101,91
72380,224331,22725,107995,14798,201605,192,101,91
72385,224341,22728,108001,14800,201613,192,101,91
72390,224362,22731,108013,14802,201631,192,101,91
72395,224372,22732,108014,14802,201640,192,101,91
72400,224393,22734,108024,14803,201658,192,101,91
72405,224403,22736,108029,14804,201666,192,101,91
72410,224424,22739,108036,14805,201684,192,101,91
72415,224434,22741,108041,14806,201692,192,101,91
72420,224455,22746,108051,14810,201709,192,101,91
72425,224465,22746,108055,14810,201719,192,101,91
72430,224486,22748,108065,14810,201738,192,101,91
72435,224496,22748,108069,14810,201748,192,101,91
72440,224517,22751,108077,14811,201766,192,101,91
72445,224527,22751,108083,14811,201775,192,101,91
72450,224548,22755,108094,14814,201793,192,101,91
72455,224558,22755,108100,14814,201802,192,101,91
72460,224579,22759,108109,14817,201820,192,101,91
72465,224589,22759,108115,14817,201829,192,101,91
72470,224610,22764,108126,14821,201846,192,101,91
72475,224620,22765,108132,14822,201854,192,101,91
72480,224641,22767,108141,14824,201874,192,101,91
72485,224651,22767,108144,14824,201884,192,101,91
72490,224672,22767,108152,14824,201905,192,101,91
72495,224682,22767,108158,14824,201915,192,101,91
72500,224703,22767,108168,14824,201936,192,101,91
72505,224713,22767,108171,14824,201946,192,101,91
72510,224734,22767,108180,14824,201967,192,101,91
72515,224744,22767,108184,14824,201977,192,101,91
72520,224765,22767,108194,14824,201998,192,101,91
72525,224775,22767,108199,14824,202008,192,101,91
72530,224796,22770,108208,14826,202025,192,101,91
72535,224806,22772,108215,14828,202034,192,101,91
72540,224827,22774,108226,14830,202052,192,101,91
72545,224837,22775,108230,14831,202062,192,101,91
72550,224858,22776,108237,14832,202082,192,101,91
72555,224868,22776,108241,14832,202092,192,101,91
72560,224889,22777,108250,14832,202112,192,101,91
72565,224899,22777,108254,14832,202122,192,101,91
72570,224920,22778,108265,14832,202142,192,101,91
72575,224930,22778,108268,14832,202152,192,101,91
72580,224951,22780,108278,14833,202171,192,101,91
72585,224961,22780,108283,14833,202181,192,101,91
72590,224982,22783,108293,14835,202199,192,101,91
72595,224992,22783,108301,14835,202208,192,101,91
72600,225013,22787,108310,14837,202226,192,101,91
72605,225023,22788,108317,14838,202234,192,101,91
72610,225044,22794,108329,14841,202250,192,101,91
72615,225054,22795,108333,14842,202259,192,101,91
72620,225075,22799,108345,14844,202275,192,101,91
72625,225085,22801,108351,14845,202284,192,101,91
72630,225106,22805,108364,14848,202300,192,101,91
72635,225116,22807,108368,14850,202309,192,101,91
72640,225137,22810,108378,14851,202327,192,101,91
72645,225147,22811,108382,14851,202336,192,101,91
72650,225168,22814,108390,14851,202354,192,101,91
72655,225178,22816,108396,14853,202362,192,101,91
72660,225199,22819,108405,14853,202379,192,101,91
72665,225209,22820,108408,14854,202389,192,101,91
72670,225230,22822,108415,14855,202408,192,101,91
72675,225240,22822,108421,14855,202418,192,101,91
72680,225261,22824,108431,14856,202437,192,101,91
72685,225271,22824,108437,14856,202447,192,101,91
72690,225292,22826,108446,14856,202466,192,101,91
72695,225302,22826,108450,14856,202476,192,101,91
72700,225323,22828,108459,14857,202495,192,101,91
72705,225333,22828,108464,14857,202505,192,101,91
72710,225354,22830,108474,14858,202524,192,101,91
72715,225364,22831,108481,14859,202533,192,101,91
72720,225385,22833,108492,14859,202552,192,101,91
72725,225395,22834,108494,14859,202561,192,101,91
72730,225416,22836,108506,14861,202580,192,101,91
72735,225426,22838,108513,14862,202588,192,101,91
72740,225447,22840,108521,14862,202607,192,101,91
72745,225457,22841,108524,14862,202616,192,101,91
72750,225478,22843,108534,14863,202635,192,101,91
72755,225488,22844,108538,14863,202644,192,101,91
72760,225509,22846,108544,14864,202663,192,101,91
72765,225519,22848,108548,14865,202671,192,101,91
72770,225540,22851,108557,14865,202689,192,101,91
72775,225550,22852,108559,14865,202698,192,101,91
72780,225571,22856,108570,14868,202715,192,101,91
72785,225581,22857,108574,14868,202724,192,101,91
72790,225602,22859,108585,14869,202743,192,101,91
72795,225612,22860,108592,14870,202752,192,101,91
72800,225633,22863,108605,14871,202770,192,101,91
72805,225643,22864,108611,14872,202778,192,101,91
72810,225664,22867,108623,14875,202797,192,101,91
72815,225674,22868,108627,14875,202805,192,101,91
72820,225695,22872,108639,14877,202823,192,101,91
72825,225705,22873,108647,14878,202831,192,101,91
72830,225726,22877,108658,14880,202849,192,101,91
72835,225736,22877,108664,14880,202858,192,101,91
72840,225757,22880,108677,14882,202877,192,101,91
72845,225767,22880,108681,14882,202886,192,101,91
72850,225788,22883,108690,14884,202905,192,101,91
72855,225798,22883,108695,14884,202914,192,101,91
72860,225819,22886,108706,14886,202933,192,101,91
72865,225829,22887,108711,14887,202941,192,101,91
72870,225850,22890,108720,14889,202960,192,101,91
72875,225860,22890,108725,14889,202970,192,101,91
72880,225881,22892,108733,14889,202989,192,101,91
72885,225891,22892,108736,14889,202998,192,101,91
72890,225912,22896,108747,14893,203016,192,101,91
72895,225922,22898,108754,14895,203023,192,101,91
72900,225943,22902,108762,14898,203041,192,101,91
72905,225953,22903,108767,14899,203050,192,101,91
72910,225974,22907,108777,14901,203067,192,101,91
72915,225984,22907,108782,14901,203077,192,101,91
72920,226005,22911,108795,14903,203094,192,101,91
72925,226015,22911,108799,14903,203104,192,101,91
72930,226036,22914,108808,14905,203122,192,101,91
72935,226046,22915,108812,14906,203131,192,101,91
72940,226067,22918,108825,14908,203149,192,101,91
72945,226077,22919,108831,14909,203158,192,101,91
72950,226098,22922,108840,14911,203176,192,101,91
72955,226108,22923,108845,14912,203184,192,101,91
72960,226129,22928,108855,14916,203201,192,101,91
72965,226139,22929,108860,14917,203210,192,101,91
72970,226160,22929,108872,14917,203231,192,101,91
72975,226170,22930,108878,14917,203240,192,101,91
72980,226191,22930,108886,14917,203261,192,101,91
72985,226201,22931,108893,14918,203270,192,101,91
72990,226222,22931,108907,14918,203291,192,101,91
72995,226232,22932,108912,14919,203300,192,101,91
73000,226253,22932,108925,14919,203321,192,101,91
73005,226263,22933,108930,14919,203330,192,101,91
73010,226284,22934,108937,14919,203350,192,101,91
73015,226294,22936,108945,14921,203357,192,101,91
73020,226315,22938,108958,14922,203377,192,101,91
73025,226325,22940,108960,14923,203384,192,101,91
73030,226346,22943,108971,14926,203403,192,101,91
73035,226356,22946,108976,14928,203409,192,101,91
73040,226377,22949,108989,14931,203428,192,101,91
73045,226387,22950,108994,14931,203436,192,101,91
73050,226408,22953,109002,14933,203455,192,101,91
73055,226418,22955,109006,14934,203462,192,101,91
73060,226439,22959,109017,14936,203479,192,101,91
73065,226449,22963,109025,14940,203486,192,101,91
73070,226470,22966,109035,14941,203504,192,101,91
73075,226480,22968,109039,14943,203511,192,101,91
73080,226501,22972,109051,14947,203528,192,101,91
73085,226511,22973,109058,14948,203538,192,101,91
73090,226532,22976,109069,14950,203556,192,101,91
73095,226542,22976,109072,14950,203566,192,101,91
73100,226563,22978,109085,14950,203585,192,101,91
73105,226573,22978,109088,14950,203595,192,101,91
73110,226594,22980,109098,14952,203614,192,101,91
73115,226604,22980,109104,14952,203624,192,101,91
73120,226625,22982,109115,14952,203643,192,101,91
73125,226635,22982,109116,14952,203653,192,101,91
73130,226656,22984,109131,14953,203672,192,101,91
73135,226666,22984,109136,14953,203682,192,101,91
73140,226687,22986,109151,14954,203701,192,101,91
73145,226697,22986,109157,14954,203711,192,101,91
73150,226718,22988,109164,14954,203730,192,101,91
73155,226728,22988,109171,14954,203740,192,101,91
73160,226749,22990,109183,14955,203759,192,101,91
73165,226759,22990,109189,14955,203769,192,101,91
73170,226780,22992,109198,14955,203788,192,101,91
73175,226790,22993,109203,14956,203797,192,101,91
73180,226811,22995,109215,14957,203816,192,101,91
73185,226821,22995,109218,14957,203826,192,101,91
73190,226842,22998,109228,14958,203844,192,101,91
73195,226852,23000,109231,14959,203852,192,101,91
73200,226873,23005,109237,14961,203868,192,101,91
73205,226883,23006,109239,14961,203877,192,101,91
73210,226904,23010,109247,14964,203893,192,101,91
73215,226914,23013,109253,14966,203901,192,101,91
73220,226935,23015,109261,14967,203920,192,101,91
73225,226945,23018,109266,14969,203926,192,101,91
73230,226966,23022,109276,14971,203943,192,101,91
73235,226976,23025,109282,14973,203950,192,101,91
73240,226997,23030,109293,14977,203966,192,101,91
73245,227007,23033,109299,14979,203974,192,101,91
73250,227028,23035,109307,14980,203992,192,101,91
73255,227038,23037,109311,14982,204001,192,101,91
73260,227059,23038,109322,14983,204021,192,101,91
73265,227069,23038,109325,14983,204031,192,101,91
73270,227090,23039,109333,14983,204051,192,101,91
73275,227100,23039,109337,14983,204061,192,101,91
73280,227121,23040,109351,14984,204081,192,101,91
73285,227131,23040,109357,14984,204091,192,101,91
73290,227152,23041,109373,14985,204111,192,101,91
73295,227162,23042,109377,14986,204120,192,101,91
73300,227183,23043,109391,14987,204140,192,101,91
73305,227193,23043,109396,14987,204150,192,101,91
73310,227214,23047,109405,14989,204167,192,101,91
73315,227224,23047,109407,14989,204176,192,101,91
73320,227245,23050,109418,14991,204195,192,101,91
73325,227255,23050,109424,14991,204204,192,101,91
73330,227276,23052,109434,14992,204224,192,101,91
73335,227286,23052,109439,14992,204234,192,101,91
73340,227307,23053,109445,14992,204254,192,101,91
73345,227317,23053,109450,14992,204263,192,101,91
73350,227338,23055,109464,14994,204283,192,101,91
73355,227348,23055,109470,14994,204293,192,101,91
73360,227369,23057,109476,14994,204312,192,101,91
73365,227379,23057,109478,14994,204322,192,101,91
73370,227400,23059,109488,14995,204341,192,101,91
73375,227410,23060,109491,14995,204350,192,101,91
73380,227431,23062,109501,14996,204369,192,101,91
73385,227441,23063,109505,14996,204378,192,101,91
73390,227462,23065,109516,14997,204397,192,101,91
73395,227472,23066,109517,14997,204406,192,101,91
73400,227493,23068,109529,14999,204425,192,101,91
73405,227503,23069,109533,15000,204434,192,101,91
73410,227524,23071,109546,15001,204453,192,101,91
73415,227534,23073,109551,15002,204460,192,101,91
73420,227555,23076,109563,15004,204479,192,101,91
73425,227565,23077,109570,15004,204488,192,101,91
73430,227586,23080,109580,15006,204506,192,101,91
73435,227596,23081,109585,15007,204514,192,101,91
73440,227617,23086,109593,15010,204531,192,101,91
73445,227627,23087,109598,15011,204539,192,101,91
73450,227648,23090,109604,15013,204557,192,101,91
73455,227658,23093,109610,15016,204565,192,101,91
73460,227679,23097,109623,15020,204582,192,101,91
73465,227689,23098,109626,15020,204590,192,101,91
73470,227710,23103,109637,15023,204606,192,101,91
73475,227720,23105,109640,15024,204614,192,101,91
73480,227741,23110,109651,15028,204630,192,101,91
73485,227751,23112,109655,15030,204638,192,101,91
73490,227772,23115,109663,15032,204656,192,101,91
73495,227782,23117,109670,15034,204664,192,101,91
73500,227803,23120,109679,15036,204683,192,101,91
73505,227813,23121,109684,15037,204691,192,101,91
73510,227834,23125,109692,15040,204708,192,101,91
73515,227844,23127,109699,15042,204716,192,101,91
73520,227865,23130,109710,15043,204735,192,101,91
73525,227875,23130,109717,15043,204745,192,101,91
73530,227896,23132,109723,15043,204764,192,101,91
73535,227906,23133,109729,15044,204773,192,101,91
73540,227927,23135,109738,15046,204792,192,101,91
73545,227937,23135,109744,15046,204801,192,101,91
73550,227958,23140,109752,15048,204818,192,101,91
73555,227968,23140,109756,15048,204828,192,101,91
73560,227989,23144,109765,15050,204845,192,101,91
73565,227999,23144,109770,15050,204855,192,101,91
73570,228020,23147,109780,15052,204873,192,101,91
73575,228030,23147,109783,15052,204882,192,101,91
73580,228051,23151,109796,15054,204900,192,101,91
73585,228061,23151,109801,15054,204910,192,101,91
73590,228082,23154,109810,15056,204928,192,101,91
73595,228092,23154,109816,15056,204938,192,101,91
73600,228113,23157,109827,15057,204956,192,101,91
73605,228123,23158,109832,15058,204965,192,101,91
73610,228144,23161,109845,15059,204983,192,101,91
73615,228154,23161,109850,15059,204993,192,101,91
73620,228175,23164,109861,15059,205011,192,101,91
73625,228185,23164,109866,15059,205021,192,101,91
73630,228206,23166,109877,15061,205040,192,101,91
73635,228216,23166,109881,15061,205050,192,101,91
73640,228237,23168,109890,15063,205069,192,101,91
73645,228247,23168,109894,15063,205079,192,101,91
73650,228268,23170,109904,15064,205098,192,101,91
73655,228278,23170,109905,15064,205108,192,101,91
73660,228299,23172,109919,15066,205127,192,101,91
73665,228309,23172,109923,15066,205137,192,101,91
73670,228330,23174,109933,15068,205156,192,101,91
73675,228340,23175,109938,15068,205165,192,101,91
73680,228361,23176,109947,15068,205185,192,101,91
73685,228371,23177,109952,15069,205194,192,101,91
73690,228392,23177,109960,15069,205215,192,101,91
73695,228402,23178,109964,15070,205224,192,101,91
73700,228423,23178,109982,15070,205245,192,101,91
73705,228433,23179,109986,15070,205254,192,101,91
73710,228454,23179,109995,15070,205275,192,101,91
73715,228464,23180,109999,15071,205284,192,101,91
73720,228485,23180,110011,15071,205305,192,101,91
73725,228495,23181,110016,15071,205313,192,101,91
73730,228516,23185,110026,15075,205331,192,101,91
73735,228526,23186,110031,15075,205339,192,101,91
73740,228547,23190,110042,15078,205357,192,101,91
73745,228557,23193,110046,15080,205364,192,101,91
73750,228578,23195,110057,15081,205383,192,101,91
73755,228588,23196,110060,15081,205392,192,101,91
73760,228609,23199,110067,15083,205409,192,101,91
73765,228619,23201,110072,15084,205417,192,101,91
73770,228640,23205,110079,15087,205434,192,101,91
73775,228650,23207,110085,15088,205442,192,101,91
73780,228671,23210,110089,15089,205461,192,101,91
73785,228681,23212,110092,15090,205469,192,101,91
73790,228702,23216,110101,15092,205485,192,101,91
73795,228712,23218,110107,15094,205494,192,101,91
73800,228733,23222,110118,15095,205510,192,101,91
73805,228743,23224,110124,15097,205518,192,101,91
73810,228764,23228,110133,15099,205536,192,101,91
73815,228774,23229,110136,15099,205545,192,101,91
73820,228795,23232,110146,15100,205563,192,101,91
73825,228805,23233,110150,15101,205572,192,101,91
73830,228826,23236,110158,15103,205590,192,101,91
73835,228836,23237,110162,15103,205598,192,101,91
73840,228857,23241,110168,15105,205615,192,101,91
73845,228867,23243,110174,15106,205623,192,101,91
73850,228888,23248,110182,15109,205639,192,101,91
73855,228898,23250,110186,15110,205648,192,101,91
73860,228919,23255,110197,15114,205664,192,101,91
73865,228929,23255,110202,15114,205673,192,101,91
73870,228950,23259,110211,15116,205691,192,101,91
73875,228960,23260,110213,15117,205700,192,101,91
73880,228981,23262,110223,15118,205719,192,101,91
73885,228991,23262,110227,15118,205729,192,101,91
73890,229012,23265,110239,15121,205747,192,101,91
73895,229022,23267,110247,15123,205754,192,101,91
73900,229043,23270,110253,15124,205773,192,101,91
73905,229053,23271,110258,15125,205782,192,101,91
73910,229074,23274,110270,15128,205800,192,101,91
73915,229084,23275,110275,15129,205808,192,101,91
73920,229105,23279,110283,15131,205826,192,101,91
73925,229115,23281,110289,15133,205834,192,101,91
73930,229136,23282,110297,15133,205854,192,101,91
73935,229146,23282,110301,15133,205864,192,101,91
73940,229167,23283,110313,15134,205884,192,101,91
73945,229177,23283,110317,15134,205894,192,101,91
73950,229198,23284,110326,15134,205914,192,101,91
73955,229208,23285,110333,15135,205922,192,101,91
73960,229229,23286,110344,15136,205943,192,101,91
73965,229239,23286,110349,15136,205953,192,101,91
73970,229260,23287,110358,15136,205973,192,101,91
73975,229270,23289,110360,15137,205981,192,101,91
73980,229291,23292,110372,15140,205999,192,101,91
73985,229301,23293,110379,15141,206007,192,101,91
73990,229322,23297,110390,15144,206025,192,101,91
73995,229332,23298,110396,15145,206033,192,101,91
74000,229353,23300,110406,15147,206052,192,101,91
74005,229363,23302,110410,15148,206061,192,101,91
74010,229384,23305,110422,15151,206078,192,101,91
74015,229394,23307,110430,15152,206086,192,101,91
74020,229415,23308,110438,15153,206107,192,101,91
74025,229425,23309,110442,15154,206116,192,101,91
74030,229446,23310,110450,15155,206136,192,101,91
74035,229456,23311,110455,15155,206145,192,101,91
74040,229477,23313,110461,15156,206164,192,101,91
74045,229487,23314,110467,15157,206173,192,101,91
74050,229508,23315,110480,15158,206193,192,101,91
74055,229518,23315,110486,15158,206203,192,101,91
74060,229539,23316,110495,15159,206223,192,101,91
74065,229549,23316,110497,15159,206233,192,101,91
74070,229570,23318,110509,15160,206252,192,101,91
74075,229580,23318,110510,15160,206262,192,101,91
74080,229601,23320,110521,15161,206281,192,101,91
74085,229611,23320,110525,15161,206290,192,101,91
74090,229632,23323,110536,15163,206309,192,101,91
74095,229642,23324,110542,15164,206317,192,101,91
74100,229663,23327,110554,15165,206336,192,101,91
74105,229673,23327,110558,15165,206345,192,101,91
74110,229694,23330,110569,15166,206364,192,101,91
74115,229704,23331,110574,15167,206373,192,101,91
74120,229725,23333,110584,15168,206392,192,101,91
74125,229735,23333,110590,15168,206401,192,101,91
74130,229756,23337,110599,15171,206419,192,101,91
74135,229766,23339,110606,15173,206426,192,101,91
74140,229787,23343,110615,15175,206444,192,101,91
74145,229797,23344,110621,15176,206452,192,101,91
74150,229818,23349,110627,15180,206469,192,101,91
74155,229828,23350,110632,15181,206477,192,101,91
74160,229849,23355,110643,15185,206493,192,101,91
74165,229859,23358,110650,15187,206500,192,101,91
74170,229880,23361,110659,15188,206519,192,101,91
74175,229890,23362,110664,15189,206527,192,101,91
74180,229911,23366,110676,15193,206545,192,101,91
74185,229921,23367,110679,15194,206554,192,101,91
74190,229942,23370,110691,15195,206571,192,101,91
74195,229952,23372,110693,15197,206580,192,101,91
74200,229973,23375,110700,15199,206598,192,101,91
74205,229983,23375,110703,15199,206608,192,101,91
74210,230004,23378,110714,15200,206626,192,101,91
74215,230014,23378,110718,15200,206635,192,101,91
74220,230035,23381,110728,15202,206654,192,101,91
74225,230045,23381,110734,15202,206664,192,101,91
74230,230066,23382,110748,15203,206684,192,101,91
74235,230076,23382,110755,15203,206693,192,101,91
74240,230097,23384,110763,15205,206713,192,101,91
74245,230107,23384,110767,15205,206722,192,101,91
74250,230128,23386,110778,15207,206742,192,101,91
74255,230138,23386,110784,15207,206752,192,101,91
74260,230159,23387,110793,15207,206772,192,101,91
74265,230169,23387,110797,15207,206782,192,101,91
74270,230190,23390,110806,15208,206800,192,101,91
74275,230200,23390,110809,15208,206809,192,101,91
74280,230221,23394,110819,15210,206827,192,101,91
74285,230231,23394,110824,15210,206837,192,101,91
74290,230252,23397,110835,15212,206855,192,101,91
74295,230262,23397,110840,15212,206865,192,101,91
74300,230283,23400,110851,15213,206883,192,101,91
74305,230293,23400,110856,15213,206892,192,101,91
74310,230314,23404,110868,15217,206910,192,101,91
74315,230324,23404,110873,15217,206920,192,101,91
74320,230345,23406,110886,15217,206939,192,101,91
74325,230355,23406,110890,15217,206949,192,101,91
74330,230376,23410,110901,15220,206966,192,101,91
74335,230386,23412,110907,15222,206974,192,101,91
74340,230407,23415,110915,15223,206992,192,101,91
74345,230417,23415,110918,15223,207002,192,101,91
74350,230438,23417,110928,15225,207021,192,101,91
74355,230448,23417,110931,15225,207031,192,101,91
74360,230469,23419,110946,15226,207050,192,101,91
74365,230479,23421,110953,15228,207057,192,101,91
74370,230500,23424,110961,15229,207076,192,101,91
74375,230510,23425,110968,15230,207085,192,101,91
74380,230531,23426,110975,15230,207105,192,101,91
74385,230541,23426,110978,15230,207115,192,101,91
74390,230562,23427,110991,15230,207135,192,101,91
74395,230572,23428,110997,15231,207144,192,101,91
74400,230593,23429,111008,15232,207164,192,101,91
74405,230603,23429,111012,15232,207174,192,101,91
74410,230624,23430,111018,15232,207194,192,101,91
74415,230634,23431,111022,15233,207203,192,101,91
74420,230655,23432,111031,15234,207223,192,101,91
74425,230665,23432,111037,15234,207233,192,101,91
74430,230686,23433,111046,15234,207253,192,101,91
74435,230696,23433,111049,15234,207263,192,101,91
74440,230717,23434,111056,15235,207283,192,101,91
74445,230727,23435,111062,15236,207291,192,101,91
74450,230748,23439,111073,15239,207309,192,101,91
74455,230758,23439,111077,15239,207319,192,101,91
74460,230779,23442,111088,15241,207337,192,101,91
74465,230789,23442,111094,15241,207347,192,101,91
74470,230810,23445,111101,15242,207365,192,101,91
74475,230820,23445,111106,15242,207375,192,101,91
74480,230841,23448,111116,15245,207393,192,101,91
74485,230851,23449,111121,15246,207402,192,101,91
74490,230872,23452,111132,15248,207420,192,101,91
74495,230882,23453,111136,15249,207428,192,101,91
74500,230903,23457,111147,15252,207446,192,101,91
74505,230913,23457,111154,15252,207455,192,101,91
74510,230934,23460,111168,15255,207474,192,101,91
74515,230944,23460,111172,15255,207484,192,101,91
74520,230965,23462,111184,15256,207503,192,101,91
74525,230975,23462,111188,15256,207512,192,101,91
74530,230996,23464,111203,15258,207532,192,101,91
74535,231006,23464,111207,15258,207541,192,101,91
74540,231027,23466,111214,15260,207561,192,101,91
74545,231037,23466,111220,15260,207571,192,101,91
74550,231058,23467,111231,15261,207591,192,101,91
74555,231068,23467,111232,15261,207601,192,101,91
74560,231089,23468,111240,15261,207621,192,101,91
74565,231099,23468,111246,15261,207631,192,101,91
74570,231120,23469,111255,15261,207651,192,101,91
74575,231130,23469,111260,15261,207660,192,101,91
74580,231151,23472,111270,15262,207679,192,101,91
74585,231161,23472,111274,15262,207688,192,101,91
74590,231182,23476,111283,15266,207706,192,101,91
74595,231192,23476,111287,15266,207715,192,101,91
74600,231213,23479,111298,15268,207734,192,101,91
74605,231223,23480,111303,15269,207743,192,101,91
74610,231244,23483,111314,15270,207761,192,101,91
74615,231254,23484,111318,15271,207770,192,101,91
74620,231275,23486,111327,15271,207789,192,101,91
74625,231285,23486,111332,15271,207798,192,101,91
74630,231306,23490,111344,15275,207816,192,101,91
74635,231316,23492,111349,15277,207824,192,101,91
74640,231337,23495,111355,15278,207842,192,101,91
74645,231347,23496,111361,15279,207850,192,101,91
74650,231368,23501,111370,15282,207867,192,101,91
74655,231378,23502,111376,15283,207875,192,101,91
74660,231399,23507,111387,15287,207892,192,101,91
74665,231409,23509,111394,15289,207899,192,101,91
74670,231430,23513,111404,15292,207917,192,101,91
74675,231440,23513,111406,15292,207927,192,101,91
74680,231461,23517,111419,15294,207944,192,101,91
74685,231471,23519,111427,15296,207951,192,101,91
74690,231492,23523,111437,15298,207969,192,101,91
74695,231502,23523,111439,15298,207979,192,101,91
74700,231523,23526,111451,15301,207997,192,101,91
74705,231533,23527,111456,15302,208005,192,101,91
74710,231554,23529,111463,15303,208025,192,101,91
74715,231564,23529,111468,15303,208035,192,101,91
74720,231585,23530,111472,15304,208055,192,101,91
74725,231595,23530,111474,15304,208065,192,101,91
74730,231616,23532,111481,15306,208084,192,101,91
74735,231626,23532,111488,15306,208094,192,101,91
74740,231647,23533,111495,15306,208114,192,101,91
74745,231657,23533,111502,15306,208124,192,101,91
74750,231678,23533,111510,15306,208145,192,101,91
74755,231688,23533,111516,15306,208155,192,101,91
74760,231709,23533,111531,15306,208176,192,101,91
74765,231719,23533,111533,15306,208186,192,101,91
74770,231740,23535,111542,15307,208205,192,101,91
74775,231750,23535,111548,15307,208215,192,101,91
74780,231771,23537,111559,15308,208234,192,101,91
74785,231781,23537,111566,15308,208244,192,101,91
74790,231802,23538,111572,15309,208264,192,101,91
74795,231812,23539,111579,15310,208273,192,101,91
74800,231833,23541,111588,15312,208292,192,101,91
74805,231843,23541,111589,15312,208302,192,101,91
74810,231864,23543,111601,15314,208321,192,101,91
74815,231874,23544,111607,15315,208330,192,101,91
74820,231895,23546,111619,15315,208349,192,101,91
74825,231905,23546,111626,15315,208358,192,101,91
74830,231926,23548,111634,15316,208378,192,101,91
74835,231936,23548,111639,15316,208388,192,101,91
74840,231957,23549,111648,15316,208408,192,101,91
74845,231967,23549,111653,15316,208418,192,101,91
74850,231988,23550,111667,15317,208438,192,101,91
74855,231998,23550,111671,15317,208447,192,101,91
74860,232019,23552,111682,15318,208467,192,101,91
74865,232029,23552,111687,15318,208477,192,101,91
74870,232050,23553,111701,15319,208497,192,101,91
74875,232060,23553,111704,15319,208506,192,101,91
74880,232081,23555,111715,15320,208526,192,101,91
74885,232091,23555,111719,15320,208536,192,101,91
74890,232112,23556,111728,15320,208556,192,101,91
74895,232122,23556,111734,15320,208565,192,101,91
74900,232143,23558,111746,15322,208585,192,101,91
74905,232153,23559,111750,15323,208594,192,101,91
74910,232174,23560,111763,15324,208614,192,101,91
74915,232184,23560,111768,15324,208623,192,101,91
74920,232205,23562,111780,15326,208643,192,101,91
74925,232215,23562,111783,15326,208652,192,101,91
74930,232236,23565,111793,15329,208671,192,101,91
74935,232246,23567,111796,15331,208679,192,101,91
74940,232267,23569,111807,15331,208698,192,101,91
74945,232277,23571,111812,15333,208706,192,101,91
74950,232298,23573,111822,15333,208725,192,101,91
74955,232308,23573,111827,15333,208735,192,101,91
74960,232329,23575,111839,15335,208754,192,101,91
74965,232339,23575,111844,15335,208763,192,101,91
74970,232360,23578,111853,15336,208782,192,101,91
74975,232370,23580,111857,15338,208790,192,101,91
74980,232391,23582,111867,15340,208809,192,101,91
74985,232401,23583,111872,15341,208817,192,101,91
74990,232422,23586,111879,15343,208836,192,101,91
74995,232432,23587,111883,15344,208845,192,101,91
75000,232453,23589,111889,15345,208864,192,101,91
75005,232463,23589,111892,15345,208874,192,101,91
75010,232484,23590,111898,15345,208894,192,101,91
75015,232494,23590,111904,15345,208904,192,101,91
75020,232515,23592,111914,15346,208923,192,101,91
75025,232525,23593,111920,15347,208932,192,101,91
75030,232546,23595,111931,15348,208951,192,101,91
75035,232556,23596,111940,15349,208960,192,101,91
75040,232577,23597,111951,15350,208980,192,101,91
75045,232587,23597,111956,15350,208990,192,101,91
75050,232608,23598,111964,15351,209010,192,101,91
75055,232618,23599,111969,15352,209019,192,101,91
75060,232639,23601,111979,15354,209038,192,101,91
75065,232649,23601,111985,15354,209048,192,101,91
75070,232670,23601,111998,15354,209069,192,101,91
75075,232680,23601,112004,15354,209079,192,101,91
75080,232701,23601,112014,15354,209100,192,101,91
75085,232711,23601,112019,15354,209110,192,101,91
75090,232732,23601,112029,15354,209131,192,101,91
75095,232742,23601,112033,15354,209141,192,101,91
75100,232763,23601,112043,15354,209162,192,101,91
75105,232773,23601,112047,15354,209171,192,101,91
75110,232794,23603,112057,15356,209191,192,101,91
75115,232804,23604,112061,15357,209200,192,101,91
75120,232825,23605,112071,15357,209220,192,101,91
75125,232835,23606,112078,15358,209228,192,101,91
75130,232856,23608,112092,15360,209248,192,101,91
75135,232866,23609,112099,15361,209257,192,101,91
75140,232887,23610,112108,15361,209277,192,101,91
75145,232897,23610,112112,15361,209287,192,101,91
75150,232918,23611,112118,15361,209307,192,101,91
75155,232928,23612,112123,15362,209316,192,101,91
75160,232949,23613,112130,15362,209336,192,101,91
75165,232959,23613,112135,15362,209345,192,101,91
75170,232980,23616,112146,15364,209364,192,101,91
75175,232990,23617,112150,15365,209373,192,101,91
75180,233011,23620,112160,15367,209391,192,101,91
75185,233021,23621,112162,15368,209399,192,101,91
75190,233042,23625,112172,15370,209417,192,101,91
75195,233052,23626,112176,15371,209425,192,101,91
75200,233073,23630,112185,15374,209443,192,101,91
75205,233083,23631,112189,15375,209452,192,101,91
75210,233104,23634,112198,15376,209470,192,101,91
75215,233114,23636,112204,15378,209478,192,101,91
75220,233135,23639,112212,15380,209496,192,101,91
75225,233145,23640,112215,15381,209504,192,101,91
75230,233166,23643,112226,15383,209523,192,101,91
75235,233176,23644,112232,15384,209531,192,101,91
75240,233197,23647,112239,15385,209550,192,101,91
75245,233207,23647,112241,15385,209560,192,101,91
75250,233228,23647,112252,15385,209581,192,101,91
75255,233238,23647,112258,15385,209591,192,101,91
75260,233259,23647,112268,15385,209612,192,101,91
75265,233269,23647,112273,15385,209622,192,101,91
75270,233290,23647,112285,15385,209643,192,101,91
75275,233300,23647,112286,15385,209653,192,101,91
75280,233321,23647,112294,15385,209674,192,101,91
75285,233331,23647,112298,15385,209684,192,101,91
75290,233352,23647,112307,15385,209705,192,101,91
75295,233362,23647,112311,15385,209715,192,101,91
75300,233383,23647,112324,15385,209736,192,101,91
75305,233393,23647,112329,15385,209746,192,101,91
75310,233414,23647,112337,15385,209767,192,101,91
75315,233424,23647,112343,15385,209777,192,101,91
75320,233445,23647,112352,15385,209798,192,101,91
75325,233455,23647,112356,15385,209808,192,101,91
75330,233476,23647,112365,15385,209829,192,101,91
75335,233486,23647,112369,15385,209839,192,101,91
75340,233507,23647,112379,15385,209860,192,101,91
75345,233517,23647,112382,15385,209870,192,101,91
75350,233538,23650,112389,15387,209888,192,101,91
75355,233548,23651,112394,15388,209896,192,101,91
75360,233569,23654,112403,15390,209915,192,101,91
75365,233579,23654,112408,15390,209925,192,101,91
75370,233600,23656,112417,15390,209944,192,101,91
75375,233610,23657,112422,15391,209953,192,101,91
75380,233631,23659,112431,15392,209972,192,101,91
75385,233641,23659,112434,15392,209981,192,101,91
75390,233662,23662,112442,15394,210000,192,101,91
75395,233672,23664,112448,15396,210008,192,101,91
75400,233693,23666,112453,15396,210027,192,101,91
75405,233703,23666,112456,15396,210037,192,101,91
75410,233724,23668,112465,15396,210056,192,101,91
75415,233734,23670,112471,15398,210063,192,101,91
75420,233755,23673,112481,15400,210082,192,101,91
75425,233765,23674,112486,15401,210090,192,101,91
75430,233786,23678,112497,15405,210108,192,101,91
75435,233796,23680,112502,15407,210116,192,101,91
75440,233817,23683,112514,15410,210134,192,101,91
75445,233827,23684,112518,15411,210142,192,101,91
75450,233848,23688,112526,15414,210160,192,101,91
75455,233858,23688,112530,15414,210170,192,101,91
75460,233879,23689,112542,15415,210190,192,101,91
75465,233889,23690,112550,15416,210199,192,101,91
75470,233910,23691,112564,15417,210219,192,101,91
75475,233920,23692,112567,15418,210228,192,101,91
75480,233941,23693,112573,15418,210248,192,101,91
75485,233951,23693,112580,15418,210258,192,101,91
75490,233972,23693,112593,15418,210279,192,101,91
75495,233982,23693,112597,15418,210289,192,101,91
75500,234003,23693,112606,15418,210310,192,101,91
75505,234013,23693,112609,15418,210320,192,101,91
75510,234034,23693,112623,15418,210341,192,101,91
75515,234044,23693,112626,15418,210351,192,101,91
75520,234065,23693,112639,15418,210372,192,101,91
75525,234075,23693,112644,15418,210382,192,101,91
75530,234096,23693,112651,15418,210403,192,101,91
75535,234106,23693,112654,15418,210413,192,101,91
75540,234127,23693,112666,15418,210434,192,101,91
75545,234137,23693,112670,15418,210444,192,101,91
75550,234158,23693,112682,15418,210465,192,101,91
75555,234168,23693,112687,15418,210475,192,101,91
75560,234189,23694,112703,15419,210495,192,101,91
75565,234199,23695,112708,15420,210504,192,101,91
75570,234220,23696,112718,15421,210524,192,101,91
75575,234230,23696,112722,15421,210534,192,101,91
75580,234251,23697,112733,15422,210554,192,101,91
75585,234261,23697,112734,15422,210564,192,101,91
75590,234282,23699,112746,15423,210583,192,101,91
75595,234292,23701,112753,15425,210591,192,101,91
75600,234313,23703,112759,15425,210610,192,101,91
75605,234323,23703,112763,15425,210620,192,101,91
75610,234344,23705,112773,15426,210639,192,101,91
75615,234354,23706,112776,15427,210647,192,101,91
75620,234375,23709,112786,15430,210666,192,101,91
75625,234385,23710,112788,15431,210675,192,101,91
75630,234406,23713,112798,15433,210693,192,101,91
75635,234416,23714,112803,15434,210702,192,101,91
75640,234437,23716,112810,15435,210721,192,101,91
75645,234447,23716,112813,15435,210730,192,101,91
75650,234468,23720,112820,15437,210748,192,101,91
75655,234478,23721,112827,15438,210756,192,101,91
75660,234499,23724,112836,15441,210775,192,101,91
75665,234509,23724,112838,15441,210785,192,101,91
75670,234530,23727,112844,15443,210803,192,101,91
75675,234540,23727,112848,15443,210812,192,101,91
75680,234561,23730,112858,15445,210831,192,101,91
75685,234571,23731,112864,15446,210839,192,101,91
75690,234592,23735,112876,15449,210857,192,101,91
75695,234602,23735,112879,15449,210866,192,101,91
75700,234623,23739,112889,15452,210884,192,101,91
75705,234633,23739,112894,15452,210893,192,101,91
75710,234654,23743,112902,15454,210911,192,101,91
75715,234664,23743,112906,15454,210921,192,101,91
75720,234685,23746,112918,15455,210939,192,101,91
75725,234695,23746,112922,15455,210949,192,101,91
75730,234716,23747,112934,15455,210969,192,101,91
75735,234726,23747,112937,15455,210979,192,101,91
75740,234747,23747,112948,15455,211000,192,101,91
75745,234757,23747,112954,15455,211010,192,101,91
75750,234778,23747,112963,15455,211031,192,101,91
75755,234788,23747,112965,15455,211041,192,101,91
75760,234809,23747,112972,15455,211062,192,101,91
75765,234819,23747,112977,15455,211072,192,101,91
75770,234840,23747,112984,15455,211093,192,101,91
75775,234850,23747,112991,15455,211103,192,101,91
75780,234871,23747,112999,15455,211124,192,101,91
75785,234881,23747,113004,15455,211134,192,101,91
75790,234902,23747,113015,15455,211155,192,101,91
75795,234912,23747,113019,15455,211165,192,101,91
75800,234933,23747,113026,15455,211186,192,101,91
75805,234943,23747,113032,15455,211196,192,101,91
75810,234964,23747,113045,15455,211217,192,101,91
75815,234974,23747,113051,15455,211227,192,101,91
75820,234995,23747,113061,15455,211248,192,101,91
75825,235005,23747,113064,15455,211258,192,101,91
75830,235026,23748,113074,15455,211278,192,101,91
75835,235036,23748,113079,15455,211288,192,101,91
75840,235057,23750,113089,15456,211307,192,101,91
75845,235067,23750,113091,15456,211317,192,101,91
75850,235088,23753,113104,15458,211335,192,101,91
75855,235098,23754,113110,15459,211343,192,101,91
75860,235119,23757,113115,15460,211362,192,101,91
75865,235129,23758,113123,15461,211370,192,101,91
75870,235150,23761,113128,15463,211389,192,101,91
75875,235160,23761,113133,15463,211398,192,101,91
75880,235181,23765,113147,15467,211416,192,101,91
75885,235191,23765,113153,15467,211425,192,101,91
75890,235212,23768,113163,15468,211444,192,101,91
75895,235222,23768,113168,15468,211453,192,101,91
75900,235243,23771,113174,15469,211472,192,101,91
75905,235253,23771,113177,15469,211482,192,101,91
75910,235274,23773,113186,15469,211501,192,101,91
75915,235284,23774,113192,15470,211509,192,101,91
75920,235305,23777,113200,15471,211528,192,101,91
75925,235315,23777,113206,15471,211538,192,101,91
75930,235336,23780,113215,15473,211556,192,101,91
75935,235346,23781,113221,15474,211564,192,101,91
75940,235367,23785,113232,15476,211582,192,101,91
75945,235377,23785,113236,15476,211591,192,101,91
75950,235398,23789,113246,15478,211609,192,101,91
75955,235408,23790,113249,15479,211618,192,101,91
75960,235429,23792,113256,15480,211637,192,101,91
75965,235439,23792,113259,15480,211646,192,101,91
75970,235460,23794,113270,15482,211666,192,101,91
75975,235470,23794,113276,15482,211675,192,101,91
75980,235491,23796,113282,15484,211695,192,101,91
75985,235501,23796,113287,15484,211704,192,101,91
75990,235522,23798,113300,15485,211724,192,101,91
75995,235532,23798,113304,15485,211734,192,101,91
76000,235553,23799,113312,15485,211754,192,101,91
76005,235563,23799,113318,15485,211763,192,101,91
76010,235584,23801,113324,15487,211783,192,101,91
76015,235594,23801,113325,15487,211793,192,101,91
76020,235615,23802,113339,15488,211813,192,101,91
76025,235625,23802,113344,15488,211822,192,101,91
76030,235646,23804,113356,15489,211842,192,101,91
76035,235656,23804,113361,15489,211851,192,101,91
76040,235677,23806,113370,15490,211871,192,101,91
76045,235687,23806,113379,15490,211881,192,101,91
76050,235708,23807,113391,15491,211901,192,101,91
76055,235718,23807,113394,15491,211911,192,101,91
76060,235739,23808,113405,15491,211931,192,101,91
76065,235749,23808,113411,15491,211940,192,101,91
76070,235770,23811,113420,15492,211959,192,101,91
76075,235780,23811,113426,15492,211968,192,101,91
76080,235801,23814,113432,15493,211987,192,101,91
76085,235811,23814,113439,15493,211996,192,101,91
76090,235832,23818,113453,15496,212014,192,101,91
76095,235842,23819,113460,15497,212023,192,101,91
76100,235863,23822,113471,15499,212041,192,101,91
76105,235873,23822,113473,15499,212051,192,101,91
76110,235894,23824,113480,15500,212070,192,101,91
76115,235904,23824,113484,15500,212080,192,101,91
76120,235925,23827,113500,15503,212098,192,101,91
76125,235935,23828,113506,15504,212106,192,101,91
76130,235956,23832,113518,15507,212124,192,101,91
76135,235966,23833,113523,15508,212133,192,101,91
76140,235987,23836,113533,15511,212151,192,101,91
76145,235997,23836,113537,15511,212161,192,101,91
76150,236018,23837,113549,15512,212181,192,101,91
76155,236028,23837,113552,15512,212190,192,101,91
76160,236049,23839,113561,15513,212210,192,101,91
76165,236059,23839,113567,15513,212219,192,101,91
76170,236080,23841,113574,15514,212239,192,101,91
76175,236090,23841,113581,15514,212248,192,101,91
76180,236111,23843,113591,15515,212268,192,101,91
76185,236121,23843,113598,15515,212277,192,101,91
76190,236142,23845,113608,15517,212297,192,101,91
76195,236152,23845,113611,15517,212307,192,101,91
76200,236173,23846,113624,15518,212327,192,101,91
76205,236183,23846,113628,15518,212337,192,101,91
76210,236204,23847,113642,15518,212357,192,101,91
76215,236214,23847,113648,15518,212366,192,101,91
76220,236235,23849,113659,15519,212386,192,101,91
76225,236245,23849,113663,15519,212395,192,101,91
76230,236266,23851,113672,15520,212415,192,101,91
76235,236276,23851,113676,15520,212424,192,101,91
76240,236297,23853,113683,15522,212444,192,101,91
76245,236307,23853,113689,15522,212454,192,101,91
76250,236328,23855,113697,15524,212473,192,101,91
76255,236338,23855,113702,15524,212483,192,101,91
76260,236359,23857,113713,15526,212502,192,101,91
76265,236369,23857,113715,15526,212512,192,101,91
76270,236390,23859,113728,15526,212531,192,101,91
76275,236400,23859,113734,15526,212541,192,101,91
76280,236421,23861,113746,15527,212560,192,101,91
76285,236431,23861,113749,15527,212570,192,101,91
76290,236452,23863,113759,15528,212589,192,101,91
76295,236462,23864,113765,15529,212598,192,101,91
76300,236483,23866,113778,15531,212617,192,101,91
76305,236493,23867,113783,15532,212626,192,101,91
76310,236514,23870,113795,15534,212644,192,101,91
76315,236524,23871,113800,15535,212653,192,101,91
76320,236545,23874,113806,15537,212671,192,101,91
76325,236555,23874,113811,15537,212681,192,101,91
76330,236576,23876,113823,15539,212700,192,101,91
76335,236586,23877,113829,15540,212709,192,101,91
76340,236607,23880,113836,15541,212727,192,101,91
76345,236617,23880,113841,15541,212737,192,101,91
76350,236638,23882,113849,15541,212756,192,101,91
76355,236648,23883,113854,15542,212765,192,101,91
76360,236669,23885,113861,15542,212784,192,101,91
76365,236679,23885,113866,15542,212794,192,101,91
76370,236700,23888,113878,15545,212812,192,101,91
76375,236710,23889,113883,15546,212821,192,101,91
76380,236731,23891,113891,15547,212840,192,101,91
76385,236741,23891,113898,15547,212850,192,101,91
76390,236762,23892,113908,15547,212870,192,101,91
76395,236772,23892,113911,15547,212880,192,101,91
76400,236793,23893,113922,15547,212900,192,101,91
76405,236803,23893,113928,15547,212910,192,101,91
76410,236824,23894,113940,15547,212930,192,101,91
76415,236834,23894,113944,15547,212940,192,101,91
76420,236855,23895,113952,15548,212960,192,101,91
76425,236865,23895,113955,15548,212970,192,101,91
76430,236886,23896,113961,15549,212990,192,101,91
76435,236896,23896,113968,15549,213000,192,101,91
76440,236917,23897,113979,15549,213020,192,101,91
76445,236927,23897,113984,15549,213030,192,101,91
76450,236948,23898,113996,15550,213050,192,101,91
76455,236958,23898,114001,15550,213060,192,101,91
76460,236979,23899,114013,15551,213080,192,101,91
76465,236989,23899,114018,15551,213090,192,101,91
76470,237010,23900,114029,15551,213110,192,101,91
76475,237020,23900,114034,15551,213120,192,101,91
76480,237041,23901,114046,15551,213140,192,101,91
76485,237051,23901,114051,15551,213150,192,101,91
76490,237072,23903,114063,15553,213169,192,101,91
76495,237082,23903,114069,15553,213179,192,101,91
76500,237103,23906,114079,15555,213197,192,101,91
76505,237113,23906,114086,15555,213207,192,101,91
76510,237134,23908,114094,15556,213226,192,101,91
76515,237144,23908,114100,15556,213236,192,101,91
76520,237165,23911,114107,15558,213254,192,101,91
76525,237175,23911,114112,15558,213264,192,101,91
76530,237196,23913,114118,15558,213283,192,101,91
76535,237206,23913,114120,15558,213293,192,101,91
76540,237227,23916,114129,15560,213311,192,101,91
76545,237237,23917,114131,15561,213320,192,101,91
76550,237258,23920,114141,15563,213338,192,101,91
76555,237268,23921,114148,15564,213347,192,101,91
76560,237289,23923,114160,15565,213366,192,101,91
76565,237299,23924,114164,15566,213375,192,101,91
76570,237320,23927,114177,15568,213393,192,101,91
76575,237330,23927,114179,15568,213403,192,101,91
76580,237351,23929,114184,15568,213422,192,101,91
76585,237361,23930,114190,15569,213431,192,101,91
76590,237382,23933,114198,15570,213449,192,101,91
76595,237392,23933,114202,15570,213459,192,101,91
