Time,  Packets Generated,  Packets Reached,High Priority Packets Generated, High Priority Packets reached, Packet Dropped, Packet Dropped due to Faulty Node, High Prio Packet Dropped due to Faulty Node, Low Prio Packet Dropped due to Faulty Node 
5,1,1,1,1,0,0,0,0
10,6,3,5,2,3,3,3,0
15,8,3,6,2,4,4,4,0
20,16,7,10,3,8,8,6,2
25,20,10,11,5,10,10,6,4
30,30,16,16,7,14,14,9,5
35,36,16,19,7,18,18,11,7
40,47,22,23,10,24,24,13,11
45,51,25,27,12,26,26,15,11
50,61,31,30,14,30,30,16,14
55,67,31,32,14,34,34,18,16
60,78,37,36,16,40,40,20,20
65,82,40,37,16,40,40,20,20
70,92,48,43,21,42,42,20,22
75,98,51,44,23,45,45,21,24
80,109,58,50,26,47,47,22,25
85,113,64,54,30,47,47,22,25
90,123,72,59,35,49,49,24,25
95,129,75,63,36,52,52,26,26
100,140,82,68,39,54,54,27,27
105,144,88,70,42,54,54,27,27
110,154,96,75,47,56,56,28,28
115,160,99,79,48,59,59,31,28
120,171,105,85,51,62,61,31,30
125,175,110,88,55,63,61,31,30
130,185,116,94,61,69,63,33,30
135,191,117,95,61,73,65,33,32
140,202,121,101,64,78,67,34,33
145,206,125,104,68,79,67,34,33
150,216,132,107,72,83,69,34,35
155,222,134,110,73,86,71,35,36
160,233,141,113,75,90,74,37,37
165,237,143,115,75,90,74,37,37
170,247,151,120,80,95,76,39,37
175,253,153,123,81,97,78,40,38
180,264,161,131,86,100,81,42,39
185,268,163,132,88,103,81,42,39
190,278,168,137,93,109,83,42,41
195,284,168,138,93,114,85,42,43
200,295,173,144,98,121,87,44,43
205,299,174,145,99,124,87,44,43
210,309,177,151,101,131,89,46,43
215,315,177,156,101,135,91,47,44
220,326,182,161,106,142,93,48,45
225,330,183,163,107,146,93,48,45
230,340,187,170,111,152,95,50,45
235,346,187,172,111,157,97,51,46
240,357,190,177,114,165,99,53,46
245,361,190,178,114,171,99,53,46
250,371,190,183,114,181,101,54,47
255,377,190,186,114,187,103,56,47
260,388,190,193,114,198,105,57,48
265,392,190,194,114,202,105,57,48
270,402,191,200,115,211,107,59,48
275,408,191,200,115,217,109,59,50
280,419,191,205,115,228,111,60,51
285,423,191,206,115,232,111,60,51
290,433,193,210,116,240,113,60,53
295,439,193,212,116,246,115,61,54
300,450,193,218,116,257,117,62,55
305,454,193,221,116,261,117,62,55
310,464,194,223,116,270,118,63,55
315,470,194,225,116,275,120,64,56
320,481,196,227,118,285,122,64,58
325,485,196,228,118,289,122,64,58
330,495,197,231,118,298,122,64,58
335,501,197,234,118,303,124,64,60
340,512,199,241,120,313,126,66,60
345,516,199,242,120,316,126,66,60
350,526,202,245,121,324,126,66,60
355,532,202,247,121,329,128,66,62
360,543,206,252,124,336,130,66,64
365,547,208,253,126,339,130,66,64
370,557,209,255,126,348,130,66,64
375,563,209,257,126,354,132,67,65
380,574,210,261,126,364,133,67,66
385,578,210,264,126,368,133,67,66
390,588,211,270,126,377,133,67,66
395,594,211,274,126,383,134,68,66
400,605,212,281,127,393,135,69,66
405,609,212,283,127,397,135,69,66
410,619,213,286,127,406,136,69,67
415,625,213,290,127,412,137,69,68
420,636,214,296,128,422,138,70,68
425,640,215,297,129,425,138,70,68
430,650,217,302,130,433,139,70,69
435,656,217,306,130,438,140,70,70
440,667,220,312,133,447,142,71,71
445,671,221,315,134,449,142,71,71
450,681,224,322,136,457,143,71,72
455,687,224,325,136,462,144,71,73
460,698,228,333,140,470,146,71,75
465,702,228,335,140,473,146,71,75
470,712,231,340,142,480,148,72,76
475,718,231,344,142,485,149,73,76
480,729,235,350,146,492,151,73,78
485,733,236,353,147,497,151,73,78
490,743,237,357,148,506,151,73,78
495,749,237,360,148,512,152,73,79
500,760,237,365,148,523,153,73,80
505,764,237,368,148,527,153,73,80
510,774,238,374,149,536,153,73,80
515,780,238,375,149,541,154,73,81
520,791,239,380,150,552,155,74,81
525,795,239,381,150,556,155,74,81
530,805,240,384,150,565,155,74,81
535,811,240,385,150,571,157,75,82
540,822,240,389,150,582,158,75,83
545,826,240,390,150,586,158,75,83
550,836,241,392,150,595,159,75,84
555,842,241,396,150,600,160,76,84
560,853,243,401,151,610,161,76,85
565,857,243,402,151,614,161,76,85
570,867,245,407,152,622,162,77,85
575,873,245,410,152,628,163,77,86
580,884,246,417,153,638,164,78,86
585,888,246,418,153,642,164,78,86
590,898,249,422,155,648,166,78,88
595,904,251,425,157,653,167,78,89
600,915,254,431,159,661,169,80,89
605,919,255,433,160,664,169,80,89
610,929,257,437,162,672,169,80,89
615,935,257,440,162,677,170,81,89
620,946,258,446,163,687,171,82,89
625,950,259,448,164,691,171,82,89
630,960,261,454,166,699,171,82,89
635,966,261,458,166,705,172,83,89
640,977,261,461,166,716,173,83,90
645,981,261,462,166,720,173,83,90
650,991,263,467,168,728,173,83,90
655,997,263,471,168,732,175,85,90
660,1008,265,478,170,741,176,86,90
665,1012,265,479,170,747,176,86,90
670,1022,266,483,171,756,177,87,90
675,1028,266,486,171,761,178,88,90
680,1039,267,492,172,771,178,88,90
685,1043,268,494,173,775,178,88,90
690,1053,269,497,173,784,178,88,90
695,1059,269,501,173,789,179,89,90
700,1070,270,509,174,799,179,89,90
705,1074,271,511,175,803,179,89,90
710,1084,273,515,175,811,180,89,91
715,1090,273,515,175,817,182,89,93
720,1101,275,520,177,826,184,90,94
725,1105,275,523,177,830,184,90,94
730,1115,276,527,177,839,184,90,94
735,1121,276,533,177,844,185,91,94
740,1132,278,539,178,854,185,91,94
745,1136,278,543,178,858,185,91,94
750,1146,279,548,178,867,185,91,94
755,1152,279,551,178,873,186,92,94
760,1163,280,556,178,883,186,92,94
765,1167,280,560,178,887,186,92,94
770,1177,281,565,178,896,186,92,94
775,1183,281,567,178,902,187,92,95
780,1194,282,571,179,912,187,92,95
785,1198,282,573,179,916,187,92,95
790,1208,283,579,179,925,187,92,95
795,1214,283,581,179,931,188,92,96
800,1225,284,585,180,941,188,92,96
805,1229,284,587,180,945,188,92,96
810,1239,285,593,181,954,189,93,96
815,1245,285,594,181,960,190,93,97
820,1256,286,598,181,970,190,93,97
825,1260,286,600,181,974,190,93,97
830,1270,289,607,183,979,192,95,97
835,1276,292,609,186,983,194,95,99
840,1287,296,615,190,990,196,95,101
845,1291,297,616,191,994,196,95,101
850,1301,298,619,191,1003,197,95,102
855,1307,298,622,191,1009,199,95,104
860,1318,298,627,191,1020,199,95,104
865,1322,298,628,191,1024,199,95,104
870,1332,299,631,192,1033,200,95,105
875,1338,299,634,192,1039,202,96,106
880,1349,299,639,192,1050,202,96,106
885,1353,299,640,192,1054,202,96,106
890,1363,300,648,193,1063,203,96,107
895,1369,300,650,193,1069,205,97,108
900,1380,300,656,193,1080,205,97,108
905,1384,300,659,193,1084,205,97,108
910,1394,301,662,193,1093,205,97,108
915,1400,301,665,193,1099,207,99,108
920,1411,301,671,193,1110,207,99,108
925,1415,301,673,193,1114,207,99,108
930,1425,302,678,194,1123,207,99,108
935,1431,302,682,194,1129,208,99,109
940,1442,302,687,194,1140,208,99,109
945,1446,302,689,194,1144,208,99,109
950,1456,303,693,194,1153,208,99,109
955,1462,304,697,195,1157,209,99,110
960,1473,308,701,198,1165,211,100,111
965,1477,308,701,198,1169,211,100,111
970,1487,309,706,199,1178,212,100,112
975,1493,309,710,199,1184,213,101,112
980,1504,310,717,200,1194,213,101,112
985,1508,310,720,200,1198,213,101,112
990,1518,310,726,200,1208,214,102,112
995,1524,310,727,200,1214,215,102,113
1000,1535,311,732,200,1224,215,102,113
1005,1539,311,735,200,1228,215,102,113
1010,1549,311,740,200,1238,215,102,113
1015,1555,311,743,200,1244,216,103,113
1020,1566,312,747,200,1254,216,103,113
1025,1570,312,750,200,1258,216,103,113
1030,1580,312,752,200,1268,217,103,114
1035,1586,312,754,200,1274,218,103,115
1040,1597,313,760,201,1284,218,103,115
1045,1601,313,763,201,1288,218,103,115
1050,1611,313,766,201,1298,219,104,115
1055,1617,313,769,201,1304,220,104,116
1060,1628,314,774,202,1314,220,104,116
1065,1632,314,777,202,1318,220,104,116
1070,1642,316,781,203,1326,220,104,116
1075,1648,317,785,204,1330,221,105,116
1080,1659,321,792,207,1336,223,107,116
1085,1663,323,794,209,1340,223,107,116
1090,1673,324,799,210,1349,224,107,117
1095,1679,324,803,210,1355,225,108,117
1100,1690,325,809,211,1365,226,108,118
1105,1694,325,809,211,1369,226,108,118
1110,1704,326,813,211,1378,227,108,119
1115,1710,326,816,211,1384,228,108,120
1120,1721,327,822,212,1394,229,108,121
1125,1725,327,824,212,1398,229,108,121
1130,1735,328,829,213,1407,229,108,121
1135,1741,328,832,213,1413,230,108,122
1140,1752,328,838,213,1424,231,109,122
1145,1756,328,839,213,1428,231,109,122
1150,1766,330,843,213,1436,231,109,122
1155,1772,330,844,213,1442,232,109,123
1160,1783,330,846,213,1453,234,109,125
1165,1787,330,847,213,1457,234,109,125
1170,1797,332,853,213,1465,234,109,125
1175,1803,332,856,213,1470,235,110,125
1180,1814,334,860,215,1480,237,111,126
1185,1818,334,864,215,1483,237,111,126
1190,1828,340,870,219,1488,239,112,127
1195,1834,340,874,219,1492,241,114,127
1200,1845,344,876,222,1500,242,114,128
1205,1849,345,879,223,1504,242,114,128
1210,1859,346,886,224,1513,242,114,128
1215,1865,346,888,224,1519,243,114,129
1220,1876,347,895,225,1529,243,114,129
1225,1880,347,895,225,1533,243,114,129
1230,1890,348,900,225,1542,243,114,129
1235,1896,348,902,225,1548,244,114,130
1240,1907,349,911,226,1558,244,114,130
1245,1911,349,914,226,1562,244,114,130
1250,1921,350,920,227,1571,244,114,130
1255,1927,350,925,227,1577,245,115,130
1260,1938,351,929,228,1587,245,115,130
1265,1942,351,932,228,1591,245,115,130
1270,1952,352,937,229,1600,245,115,130
1275,1958,352,940,229,1606,246,115,131
1280,1969,353,946,229,1616,246,115,131
1285,1973,353,947,229,1620,246,115,131
1290,1983,354,951,229,1629,246,115,131
1295,1989,354,953,229,1635,247,115,132
1300,2000,355,956,229,1645,247,115,132
1305,2004,355,958,229,1649,247,115,132
1310,2014,357,960,229,1657,248,115,133
1315,2020,357,963,229,1663,250,117,133
1320,2031,362,972,234,1667,252,119,133
1325,2035,362,972,234,1673,252,119,133
1330,2045,362,980,234,1683,253,120,133
1335,2051,362,983,234,1689,254,120,134
1340,2062,363,989,234,1699,254,120,134
1345,2066,363,991,234,1703,254,120,134
1350,2076,363,994,234,1713,255,120,135
1355,2082,363,998,234,1719,256,120,136
1360,2093,364,1006,235,1729,256,120,136
1365,2097,364,1009,235,1733,256,120,136
1370,2107,364,1014,235,1743,256,120,136
1375,2113,364,1016,235,1749,257,121,136
1380,2124,365,1022,235,1759,257,121,136
1385,2128,365,1024,235,1763,257,121,136
1390,2138,365,1027,235,1773,257,121,136
1395,2144,365,1030,235,1779,258,122,136
1400,2155,366,1034,235,1789,258,122,136
1405,2159,366,1037,235,1793,258,122,136
1410,2169,366,1043,235,1803,258,122,136
1415,2175,366,1047,235,1809,259,122,137
1420,2186,367,1051,236,1819,259,122,137
1425,2190,367,1052,236,1823,259,122,137
1430,2200,370,1060,238,1830,259,122,137
1435,2206,370,1064,238,1834,261,123,138
1440,2217,374,1069,242,1842,262,124,138
1445,2221,375,1072,243,1846,262,124,138
1450,2231,375,1077,243,1856,262,124,138
1455,2237,375,1077,243,1862,264,124,140
1460,2248,375,1086,243,1873,264,124,140
1465,2252,375,1090,243,1877,264,124,140
1470,2262,375,1093,243,1887,264,124,140
1475,2268,375,1096,243,1893,265,124,141
1480,2279,375,1100,243,1904,265,124,141
1485,2283,375,1103,243,1908,265,124,141
1490,2293,375,1107,243,1918,265,124,141
1495,2299,375,1110,243,1924,266,125,141
1500,2310,375,1114,243,1935,266,125,141
1505,2314,375,1115,243,1939,266,125,141
1510,2324,375,1118,243,1949,266,125,141
1515,2330,375,1121,243,1955,267,126,141
1520,2341,375,1128,243,1966,267,126,141
1525,2345,375,1131,243,1970,267,126,141
1530,2355,375,1134,243,1980,267,126,141
1535,2361,375,1137,243,1986,268,126,142
1540,2372,375,1143,243,1997,268,126,142
1545,2376,375,1146,243,2001,268,126,142
1550,2386,377,1153,245,2009,268,126,142
1555,2392,377,1154,245,2014,269,126,143
1560,2403,382,1161,250,2020,271,126,145
1565,2407,383,1163,251,2024,271,126,145
1570,2417,384,1169,252,2033,272,127,145
1575,2423,384,1173,252,2039,273,127,146
1580,2434,385,1179,253,2049,274,128,146
1585,2438,386,1180,254,2052,274,128,146
1590,2448,387,1181,254,2061,275,128,147
1595,2454,387,1184,254,2067,276,128,148
1600,2465,388,1188,254,2077,277,129,148
1605,2469,389,1190,255,2080,277,129,148
1610,2479,390,1192,256,2089,278,129,149
1615,2485,390,1195,256,2095,279,130,149
1620,2496,391,1200,256,2105,280,130,150
1625,2500,392,1203,257,2108,280,130,150
1630,2510,394,1210,258,2116,282,132,150
1635,2516,394,1213,258,2122,283,132,151
1640,2527,395,1216,259,2132,284,132,152
1645,2531,395,1218,259,2136,284,132,152
1650,2541,397,1221,260,2144,286,132,154
1655,2547,397,1224,260,2150,287,132,155
1660,2558,399,1230,261,2159,288,133,155
1665,2562,400,1233,262,2162,288,133,155
1670,2572,403,1239,264,2169,290,135,155
1675,2578,404,1242,265,2172,292,135,157
1680,2589,411,1248,271,2178,294,137,157
1685,2593,411,1249,271,2182,294,137,157
1690,2603,411,1253,271,2192,294,137,157
1695,2609,411,1256,271,2198,295,137,158
1700,2620,411,1263,271,2209,295,137,158
1705,2624,411,1264,271,2213,295,137,158
1710,2634,411,1271,271,2223,295,137,158
1715,2640,411,1273,271,2229,296,138,158
1720,2651,411,1280,271,2240,296,138,158
1725,2655,411,1282,271,2244,296,138,158
1730,2665,411,1284,271,2254,296,138,158
1735,2671,411,1286,271,2260,297,138,159
1740,2682,411,1290,271,2271,297,138,159
1745,2686,411,1293,271,2275,297,138,159
1750,2696,411,1297,271,2285,297,138,159
1755,2702,411,1299,271,2291,298,138,160
1760,2713,411,1303,271,2302,298,138,160
1765,2717,411,1304,271,2306,298,138,160
1770,2727,411,1310,271,2316,298,138,160
1775,2733,411,1313,271,2322,299,138,161
1780,2744,411,1319,271,2333,299,138,161
1785,2748,411,1322,271,2337,299,138,161
1790,2758,413,1325,272,2345,301,138,163
1795,2764,414,1328,273,2349,303,139,164
1800,2775,418,1334,276,2356,303,139,164
1805,2779,419,1337,277,2360,303,139,164
1810,2789,421,1343,279,2368,303,139,164
1815,2795,422,1347,280,2373,304,140,164
1820,2806,424,1352,282,2382,304,140,164
1825,2810,424,1353,282,2386,304,140,164
1830,2820,426,1358,283,2394,304,140,164
1835,2826,426,1361,283,2400,305,141,164
1840,2837,428,1367,285,2409,305,141,164
1845,2841,429,1369,286,2412,305,141,164
1850,2851,431,1376,288,2420,305,141,164
1855,2857,431,1378,288,2426,306,142,164
1860,2868,433,1382,289,2435,306,142,164
1865,2872,433,1384,289,2439,306,142,164
1870,2882,435,1391,289,2447,306,142,164
1875,2888,435,1393,289,2453,307,142,165
1880,2899,437,1399,290,2462,307,142,165
1885,2903,437,1401,290,2466,307,142,165
1890,2913,439,1404,290,2474,307,142,165
1895,2919,439,1407,290,2480,308,143,165
1900,2930,440,1413,291,2490,308,143,165
1905,2934,441,1415,292,2493,308,143,165
1910,2944,443,1416,292,2501,308,143,165
1915,2950,443,1420,292,2506,310,144,166
1920,2961,445,1424,294,2514,312,145,167
1925,2965,446,1427,295,2519,312,145,167
1930,2975,446,1434,295,2529,313,146,167
1935,2981,446,1437,295,2535,314,146,168
1940,2992,447,1443,295,2545,314,146,168
1945,2996,447,1445,295,2549,314,146,168
1950,3006,447,1450,295,2559,315,146,169
1955,3012,447,1454,295,2565,316,147,169
1960,3023,448,1458,295,2575,316,147,169
1965,3027,448,1458,295,2579,316,147,169
1970,3037,448,1461,295,2589,317,148,169
1975,3043,448,1462,295,2595,318,148,170
1980,3054,449,1466,296,2605,318,148,170
1985,3058,449,1468,296,2609,318,148,170
1990,3068,449,1472,296,2619,318,148,170
1995,3074,449,1475,296,2625,319,149,170
2000,3085,450,1478,296,2635,319,149,170
2005,3089,450,1481,296,2639,319,149,170
2010,3099,450,1487,296,2649,319,149,170
2015,3105,450,1490,296,2655,320,149,171
2020,3116,452,1497,297,2664,320,149,171
2025,3120,452,1499,297,2668,320,149,171
2030,3130,453,1502,297,2677,320,149,171
2035,3136,453,1505,297,2683,321,150,171
2040,3147,455,1510,298,2692,322,151,171
2045,3151,455,1510,298,2696,322,151,171
2050,3161,456,1513,299,2705,322,151,171
2055,3167,456,1517,299,2711,323,152,171
2060,3178,456,1518,299,2722,323,152,171
2065,3182,456,1521,299,2726,323,152,171
2070,3192,457,1527,300,2735,323,152,171
2075,3198,457,1530,300,2741,324,152,172
2080,3209,457,1532,300,2752,324,152,172
2085,3213,457,1535,300,2756,324,152,172
2090,3223,459,1541,300,2764,324,152,172
2095,3229,459,1545,300,2769,325,152,173
2100,3240,460,1551,301,2780,325,152,173
2105,3244,460,1554,301,2784,325,152,173
2110,3254,462,1560,302,2792,325,152,173
2115,3260,462,1564,302,2798,327,154,173
2120,3271,464,1570,304,2806,327,154,173
2125,3275,464,1573,304,2811,327,154,173
2130,3285,467,1577,305,2818,328,154,174
2135,3291,467,1579,305,2824,330,154,176
2140,3302,470,1584,307,2831,330,154,176
2145,3306,470,1588,307,2836,330,154,176
2150,3316,473,1594,309,2843,332,155,177
2155,3322,473,1599,309,2847,334,156,178
2160,3333,479,1605,314,2853,335,157,178
2165,3337,479,1607,314,2858,335,157,178
2170,3347,480,1613,314,2867,335,157,178
2175,3353,480,1615,314,2873,336,157,179
2180,3364,480,1623,314,2884,338,159,179
2185,3368,480,1625,314,2888,338,159,179
2190,3378,481,1634,315,2897,338,159,179
2195,3384,481,1640,315,2903,339,160,179
2200,3395,481,1646,315,2914,340,160,180
2205,3399,481,1649,315,2918,340,160,180
2210,3409,482,1654,315,2927,340,160,180
2215,3415,482,1658,315,2933,341,161,180
2220,3426,482,1663,315,2944,341,161,180
2225,3430,482,1666,315,2948,341,161,180
2230,3440,483,1669,315,2957,341,161,180
2235,3446,483,1671,315,2963,343,161,182
2240,3457,483,1676,315,2974,343,161,182
2245,3461,483,1677,315,2978,343,161,182
2250,3471,484,1679,315,2987,343,161,182
2255,3477,484,1683,315,2993,345,163,182
2260,3488,484,1689,315,3004,345,163,182
2265,3492,484,1689,315,3008,345,163,182
2270,3502,486,1693,316,3016,345,163,182
2275,3508,486,1695,316,3022,346,164,182
2280,3519,488,1701,317,3030,347,165,182
2285,3523,489,1703,318,3034,347,165,182
2290,3533,491,1705,318,3042,348,165,183
2295,3539,491,1708,318,3048,349,165,184
2300,3550,494,1713,320,3056,350,165,185
2305,3554,494,1714,320,3060,350,165,185
2310,3564,496,1716,321,3068,352,165,187
2315,3570,496,1718,321,3074,353,166,187
2320,3581,498,1723,323,3083,354,166,188
2325,3585,499,1726,324,3086,354,166,188
2330,3595,501,1728,324,3094,355,166,189
2335,3601,501,1731,324,3100,356,167,189
2340,3612,503,1737,326,3109,357,168,189
2345,3616,503,1738,326,3113,357,168,189
2350,3626,504,1743,326,3122,357,168,189
2355,3632,504,1745,326,3128,359,169,190
2360,3643,505,1751,327,3138,359,169,190
2365,3647,505,1753,327,3142,359,169,190
2370,3657,506,1758,328,3151,359,169,190
2375,3663,506,1761,328,3157,361,171,190
2380,3674,507,1767,329,3167,361,171,190
2385,3678,507,1771,329,3171,361,171,190
2390,3688,508,1775,330,3180,361,171,190
2395,3694,508,1776,330,3185,363,171,192
2400,3705,512,1781,334,3192,364,171,193
2405,3709,513,1782,335,3196,364,171,193
2410,3719,515,1788,337,3204,364,171,193
2415,3725,515,1792,337,3210,366,172,194
2420,3736,515,1797,337,3221,367,172,195
2425,3740,515,1799,337,3225,367,172,195
2430,3750,517,1801,338,3233,367,172,195
2435,3756,517,1805,338,3239,369,173,196
2440,3767,517,1809,338,3250,370,174,196
2445,3771,517,1811,338,3254,370,174,196
2450,3781,519,1816,339,3262,371,175,196
2455,3787,519,1817,339,3268,373,176,197
2460,3798,519,1823,339,3279,375,176,199
2465,3802,519,1825,339,3283,375,176,199
2470,3812,522,1832,341,3290,375,176,199
2475,3818,522,1835,341,3296,376,177,199
2480,3829,524,1842,342,3304,376,177,199
2485,3833,525,1844,343,3308,376,177,199
2490,3843,528,1851,346,3315,376,177,199
2495,3849,528,1855,346,3321,377,177,200
2500,3860,530,1862,348,3330,377,177,200
2505,3864,530,1864,348,3334,377,177,200
2510,3874,534,1870,352,3340,377,177,200
2515,3880,534,1874,352,3346,378,178,200
2520,3891,537,1880,355,3353,380,179,201
2525,3895,538,1883,356,3357,380,179,201
2530,3905,539,1885,356,3366,381,179,202
2535,3911,539,1889,356,3372,382,180,202
2540,3922,540,1894,356,3382,382,180,202
2545,3926,540,1894,356,3386,382,180,202
2550,3936,541,1896,356,3395,383,180,203
2555,3942,541,1899,356,3401,384,181,203
2560,3953,543,1906,357,3409,384,181,203
2565,3957,545,1909,359,3412,384,181,203
2570,3967,546,1914,360,3421,385,181,204
2575,3973,546,1916,360,3427,387,182,205
2580,3984,549,1921,362,3434,387,182,205
2585,3988,550,1924,363,3438,387,182,205
2590,3998,551,1928,364,3447,387,182,205
2595,4004,551,1933,364,3452,389,183,206
2600,4015,555,1938,368,3460,389,183,206
2605,4019,555,1941,368,3464,389,183,206
2610,4029,558,1948,371,3471,389,183,206
2615,4035,558,1950,371,3477,391,183,208
2620,4046,561,1956,374,3485,391,183,208
2625,4050,562,1959,375,3488,391,183,208
2630,4060,563,1962,376,3497,392,183,209
2635,4066,563,1964,376,3503,394,184,210
2640,4077,566,1971,379,3511,395,184,211
2645,4081,567,1974,380,3514,395,184,211
2650,4091,567,1976,380,3524,396,184,212
2655,4097,567,1979,380,3530,398,184,214
2660,4108,569,1982,381,3539,398,184,214
2665,4112,569,1985,381,3543,398,184,214
2670,4122,569,1991,381,3553,398,184,214
2675,4128,569,1994,381,3559,400,185,215
2680,4139,570,2001,382,3569,400,185,215
2685,4143,570,2003,382,3573,400,185,215
2690,4153,571,2006,382,3582,400,185,215
2695,4159,571,2008,382,3587,401,186,215
2700,4170,574,2012,385,3596,402,186,216
2705,4174,575,2015,386,3599,402,186,216
2710,4184,576,2020,387,3608,402,186,216
2715,4190,576,2024,387,3614,403,187,216
2720,4201,576,2031,387,3625,404,188,216
2725,4205,577,2033,388,3628,404,188,216
2730,4215,578,2037,389,3637,404,188,216
2735,4221,578,2038,389,3643,405,188,217
2740,4232,578,2043,389,3654,406,189,217
2745,4236,579,2046,390,3657,406,189,217
2750,4246,582,2051,392,3664,407,189,218
2755,4252,582,2055,392,3670,408,190,218
2760,4263,582,2059,392,3681,410,191,219
2765,4267,582,2061,392,3685,410,191,219
2770,4277,583,2067,393,3694,410,191,219
2775,4283,583,2069,393,3700,411,191,220
2780,4294,584,2073,394,3710,412,191,221
2785,4298,584,2074,394,3714,412,191,221
2790,4308,585,2083,394,3723,412,191,221
2795,4314,585,2086,394,3729,413,191,222
2800,4325,586,2092,395,3739,414,192,222
2805,4329,586,2096,395,3743,414,192,222
2810,4339,587,2100,395,3752,414,192,222
2815,4345,587,2104,395,3758,415,193,222
2820,4356,588,2110,396,3768,415,193,222
2825,4360,588,2111,396,3772,415,193,222
2830,4370,589,2116,396,3781,415,193,222
2835,4376,589,2120,396,3787,416,194,222
2840,4387,590,2125,397,3797,416,194,222
2845,4391,590,2127,397,3801,416,194,222
2850,4401,591,2130,397,3810,416,194,222
2855,4407,591,2136,397,3816,417,195,222
2860,4418,591,2142,397,3827,417,195,222
2865,4422,591,2143,397,3831,417,195,222
2870,4432,593,2145,398,3839,418,195,223
2875,4438,593,2147,398,3845,419,195,224
2880,4449,596,2154,401,3852,420,195,225
2885,4453,597,2157,402,3856,420,195,225
2890,4463,597,2163,402,3866,421,195,226
2895,4469,597,2166,402,3872,422,196,226
2900,4480,598,2170,402,3882,423,197,226
2905,4484,598,2170,402,3886,423,197,226
2910,4494,598,2178,402,3896,423,197,226
2915,4500,598,2181,402,3902,424,197,227
2920,4511,599,2188,402,3912,426,199,227
2925,4515,599,2189,402,3916,426,199,227
2930,4525,599,2195,402,3926,426,199,227
2935,4531,599,2198,402,3932,427,200,227
2940,4542,600,2203,402,3942,429,201,228
2945,4546,600,2204,402,3946,429,201,228
2950,4556,601,2212,403,3955,430,202,228
2955,4562,601,2216,403,3960,431,203,228
2960,4573,603,2222,404,3970,432,204,228
2965,4577,604,2223,405,3973,432,204,228
2970,4587,605,2227,406,3982,432,204,228
2975,4593,605,2230,406,3988,433,205,228
2980,4604,607,2235,407,3997,434,206,228
2985,4608,608,2236,408,4000,434,206,228
2990,4618,610,2240,410,4008,434,206,228
2995,4624,610,2243,410,4014,435,207,228
3000,4635,613,2249,412,4021,436,208,228
3005,4639,614,2250,413,4025,436,208,228
3010,4649,615,2256,414,4034,436,208,228
3015,4655,615,2259,414,4040,438,209,229
3020,4666,616,2263,415,4050,439,210,229
3025,4670,616,2264,415,4054,439,210,229
3030,4680,617,2269,415,4063,439,210,229
3035,4686,617,2271,415,4069,441,210,231
3040,4697,620,2278,418,4077,442,210,232
3045,4701,621,2280,419,4080,442,210,232
3050,4711,622,2284,420,4089,442,210,232
3055,4717,622,2287,420,4095,444,211,233
3060,4728,625,2295,423,4103,446,213,233
3065,4732,625,2297,423,4107,446,213,233
3070,4742,625,2302,423,4117,447,214,233
3075,4748,625,2305,423,4123,448,214,234
3080,4759,625,2309,423,4134,448,214,234
3085,4763,625,2310,423,4138,448,214,234
3090,4773,625,2315,423,4148,449,214,235
3095,4779,625,2319,423,4154,450,214,236
3100,4790,625,2325,423,4165,450,214,236
3105,4794,625,2327,423,4169,450,214,236
3110,4804,625,2329,423,4179,451,214,237
3115,4810,625,2333,423,4185,452,214,238
3120,4821,625,2339,423,4196,452,214,238
3125,4825,625,2340,423,4200,452,214,238
3130,4835,626,2346,423,4209,452,214,238
3135,4841,626,2349,423,4215,454,215,239
3140,4852,626,2355,423,4225,454,215,239
3145,4856,628,2356,425,4228,454,215,239
3150,4866,629,2360,425,4237,454,215,239
3155,4872,629,2362,425,4243,456,216,240
3160,4883,629,2364,425,4254,456,216,240
3165,4887,630,2368,426,4256,456,216,240
3170,4897,632,2373,427,4265,456,216,240
3175,4903,632,2377,427,4270,458,217,241
3180,4914,635,2382,429,4279,459,218,241
3185,4918,635,2385,429,4283,459,218,241
3190,4928,638,2390,431,4290,459,218,241
3195,4934,638,2394,431,4296,460,218,242
3200,4945,640,2402,433,4305,461,219,242
3205,4949,640,2402,433,4309,461,219,242
3210,4959,642,2404,433,4317,461,219,242
3215,4965,642,2407,433,4323,462,219,243
3220,4976,643,2412,434,4333,463,220,243
3225,4980,643,2413,434,4337,463,220,243
3230,4990,645,2418,436,4345,463,220,243
3235,4996,645,2423,436,4351,464,221,243
3240,5007,647,2429,437,4360,465,221,244
3245,5011,647,2432,437,4364,465,221,244
3250,5021,650,2440,440,4371,465,221,244
3255,5027,650,2442,440,4377,466,221,245
3260,5038,652,2448,441,4386,467,222,245
3265,5042,652,2450,441,4390,467,222,245
3270,5052,654,2453,441,4398,467,222,245
3275,5058,654,2458,441,4404,468,223,245
3280,5069,655,2463,442,4414,469,223,246
3285,5073,656,2466,443,4417,469,223,246
3290,5083,658,2469,444,4425,469,223,246
3295,5089,658,2473,444,4430,470,224,246
3300,5100,661,2476,446,4439,472,224,248
3305,5104,661,2479,446,4443,472,224,248
3310,5114,661,2483,446,4453,472,224,248
3315,5120,661,2487,446,4459,473,225,248
3320,5131,661,2492,446,4470,474,225,249
3325,5135,661,2495,446,4474,474,225,249
3330,5145,661,2501,446,4484,474,225,249
3335,5151,661,2505,446,4490,475,226,249
3340,5162,661,2509,446,4501,476,227,249
3345,5166,661,2513,446,4505,476,227,249
3350,5176,661,2520,446,4515,476,227,249
3355,5182,661,2523,446,4521,477,228,249
3360,5193,661,2528,446,4532,477,228,249
3365,5197,661,2531,446,4536,477,228,249
3370,5207,661,2535,446,4546,477,228,249
3375,5213,661,2539,446,4552,478,228,250
3380,5224,661,2543,446,4563,478,228,250
3385,5228,661,2544,446,4567,478,228,250
3390,5238,661,2549,446,4577,478,228,250
3395,5244,661,2550,446,4583,479,228,251
3400,5255,661,2558,446,4594,479,228,251
3405,5259,661,2559,446,4598,479,228,251
3410,5269,663,2566,448,4606,479,228,251
3415,5275,663,2569,448,4612,480,228,252
3420,5286,666,2573,451,4620,481,228,253
3425,5290,666,2576,451,4624,481,228,253
3430,5300,668,2582,453,4632,481,228,253
3435,5306,668,2584,453,4638,483,229,254
3440,5317,670,2589,454,4647,483,229,254
3445,5321,670,2591,454,4651,483,229,254
3450,5331,672,2598,455,4659,483,229,254
3455,5337,672,2602,455,4665,485,230,255
3460,5348,673,2606,455,4675,486,231,255
3465,5352,673,2608,455,4679,486,231,255
3470,5362,675,2612,455,4687,486,231,255
3475,5368,675,2613,455,4693,488,231,257
3480,5379,676,2616,456,4703,489,231,258
3485,5383,676,2619,456,4707,489,231,258
3490,5393,678,2622,456,4715,489,231,258
3495,5399,678,2625,456,4721,491,232,259
3500,5410,679,2629,456,4731,492,232,260
3505,5414,679,2629,456,4735,492,232,260
3510,5424,681,2637,458,4743,492,232,260
3515,5430,681,2640,458,4749,494,233,261
3520,5441,682,2644,458,4759,495,233,262
3525,5445,683,2647,459,4761,495,233,262
3530,5455,686,2651,460,4769,495,233,262
3535,5461,686,2654,460,4775,497,234,263
3540,5472,689,2657,462,4783,499,235,264
3545,5476,689,2658,462,4787,499,235,264
3550,5486,689,2664,462,4797,499,235,264
3555,5492,689,2667,462,4803,500,235,265
3560,5503,692,2672,464,4811,500,235,265
3565,5507,692,2673,464,4815,500,235,265
3570,5517,692,2676,464,4825,500,235,265
3575,5523,692,2679,464,4831,501,235,266
3580,5534,694,2683,466,4840,501,235,266
3585,5538,694,2686,466,4844,501,235,266
3590,5548,694,2691,466,4854,501,235,266
3595,5554,694,2692,466,4860,502,235,267
3600,5565,696,2697,468,4869,502,235,267
3605,5569,696,2700,468,4873,502,235,267
3610,5579,696,2707,468,4883,502,235,267
3615,5585,696,2709,468,4889,503,236,267
3620,5596,697,2711,468,4899,503,236,267
3625,5600,697,2714,468,4903,503,236,267
3630,5610,697,2717,468,4913,503,236,267
3635,5616,697,2721,468,4919,504,237,267
3640,5627,699,2729,470,4928,504,237,267
3645,5631,699,2731,470,4931,504,237,267
3650,5641,703,2734,473,4938,504,237,267
3655,5647,703,2735,473,4944,505,237,268
3660,5658,705,2741,475,4952,507,237,270
3665,5662,706,2743,476,4956,507,237,270
3670,5672,708,2748,477,4964,507,237,270
3675,5678,708,2751,477,4969,508,237,271
3680,5689,709,2756,478,4979,508,237,271
3685,5693,710,2756,479,4983,508,237,271
3690,5703,712,2760,480,4991,508,237,271
3695,5709,712,2762,480,4996,509,237,272
3700,5720,714,2768,482,5006,509,237,272
3705,5724,714,2768,482,5010,509,237,272
3710,5734,716,2774,483,5018,509,237,272
3715,5740,716,2776,483,5023,510,237,273
3720,5751,717,2781,484,5034,510,237,273
3725,5755,717,2782,484,5038,510,237,273
3730,5765,718,2787,484,5047,510,237,273
3735,5771,718,2791,484,5053,511,237,274
3740,5782,718,2796,484,5064,512,237,275
3745,5786,718,2799,484,5068,512,237,275
3750,5796,719,2803,484,5077,512,237,275
3755,5802,719,2807,484,5083,513,237,276
3760,5813,719,2812,484,5094,514,238,276
3765,5817,719,2814,484,5098,514,238,276
3770,5827,720,2821,484,5107,514,238,276
3775,5833,720,2823,484,5113,516,239,277
3780,5844,720,2829,484,5124,518,240,278
3785,5848,720,2831,484,5128,518,240,278
3790,5858,721,2836,484,5137,518,240,278
3795,5864,721,2839,484,5143,519,241,278
3800,5875,722,2850,485,5153,520,242,278
3805,5879,722,2852,485,5157,520,242,278
3810,5889,723,2857,486,5166,520,242,278
3815,5895,723,2859,486,5172,521,243,278
3820,5906,723,2864,486,5183,522,243,279
3825,5910,723,2868,486,5187,522,243,279
3830,5920,724,2870,486,5196,522,243,279
3835,5926,724,2873,486,5202,523,243,280
3840,5937,726,2879,488,5211,524,243,281
3845,5941,726,2880,488,5215,524,243,281
3850,5951,727,2885,489,5224,524,243,281
3855,5957,727,2888,489,5230,525,244,281
3860,5968,729,2897,490,5239,526,245,281
3865,5972,729,2898,490,5243,526,245,281
3870,5982,730,2903,491,5252,526,245,281
3875,5988,730,2908,491,5258,527,246,281
3880,5999,732,2916,493,5267,528,247,281
3885,6003,732,2917,493,5271,528,247,281
3890,6013,733,2921,493,5280,528,247,281
3895,6019,733,2924,493,5285,530,249,281
3900,6030,736,2928,496,5294,531,250,281
3905,6034,736,2930,496,5298,531,250,281
3910,6044,736,2934,496,5308,531,250,281
3915,6050,736,2936,496,5314,532,250,282
3920,6061,738,2944,498,5323,532,250,282
3925,6065,738,2944,498,5327,532,250,282
3930,6075,738,2950,498,5337,532,250,282
3935,6081,738,2953,498,5343,533,251,282
3940,6092,739,2955,498,5353,533,251,282
3945,6096,739,2957,498,5357,533,251,282
3950,6106,739,2960,498,5367,533,251,282
3955,6112,739,2964,498,5373,534,252,282
3960,6123,740,2968,498,5383,535,253,282
3965,6127,740,2970,498,5387,535,253,282
3970,6137,740,2978,498,5397,535,253,282
3975,6143,740,2983,498,5403,536,254,282
3980,6154,741,2988,499,5413,536,254,282
3985,6158,741,2990,499,5417,536,254,282
3990,6168,741,2996,499,5427,536,254,282
3995,6174,741,2999,499,5433,537,255,282
4000,6185,742,3004,499,5443,537,255,282
4005,6189,742,3004,499,5447,537,255,282
4010,6199,743,3013,500,5456,537,255,282
4015,6205,743,3015,500,5462,538,256,282
4020,6216,746,3021,502,5469,539,256,283
4025,6220,747,3024,503,5473,539,256,283
4030,6230,748,3029,504,5482,539,256,283
4035,6236,748,3029,504,5488,540,256,284
4040,6247,750,3037,505,5497,540,256,284
4045,6251,750,3038,505,5501,540,256,284
4050,6261,751,3040,505,5510,540,256,284
4055,6267,751,3046,505,5516,541,257,284
4060,6278,752,3051,505,5526,541,257,284
4065,6282,752,3053,505,5530,541,257,284
4070,6292,753,3055,506,5539,541,257,284
4075,6298,753,3058,506,5545,542,258,284
4080,6309,755,3066,508,5554,543,258,285
4085,6313,755,3069,508,5558,543,258,285
4090,6323,756,3075,508,5567,543,258,285
4095,6329,756,3080,508,5572,544,259,285
4100,6340,758,3083,509,5582,544,259,285
4105,6344,758,3085,509,5586,544,259,285
4110,6354,759,3091,509,5595,544,259,285
4115,6360,759,3097,509,5600,545,260,285
4120,6371,761,3102,510,5610,545,260,285
4125,6375,761,3104,510,5614,545,260,285
4130,6385,762,3108,511,5623,545,260,285
4135,6391,762,3111,511,5628,546,260,286
4140,6402,765,3117,514,5637,547,260,287
4145,6406,765,3119,514,5640,547,260,287
4150,6416,766,3123,515,5650,547,260,287
4155,6422,766,3126,515,5656,548,260,288
4160,6433,767,3130,516,5666,548,260,288
4165,6437,767,3132,516,5670,548,260,288
4170,6447,767,3137,516,5680,548,260,288
4175,6453,767,3138,516,5686,549,260,289
4180,6464,768,3141,517,5696,549,260,289
4185,6468,768,3143,517,5700,549,260,289
4190,6478,769,3149,518,5709,549,260,289
4195,6484,769,3151,518,5715,550,260,290
4200,6495,771,3155,519,5724,551,261,290
4205,6499,771,3159,519,5728,551,261,290
4210,6509,772,3166,519,5737,551,261,290
4215,6515,772,3169,519,5742,552,262,290
4220,6526,775,3175,522,5751,552,262,290
4225,6530,775,3176,522,5755,552,262,290
4230,6540,776,3179,523,5764,552,262,290
4235,6546,776,3181,523,5770,553,263,290
4240,6557,776,3187,523,5781,553,263,290
4245,6561,777,3189,524,5784,553,263,290
4250,6571,779,3191,525,5792,553,263,290
4255,6577,779,3196,525,5797,554,264,290
4260,6588,782,3202,528,5806,555,264,291
4265,6592,782,3203,528,5810,555,264,291
4270,6602,783,3208,528,5819,555,264,291
4275,6608,783,3209,528,5825,557,264,293
4280,6619,786,3216,531,5833,558,265,293
4285,6623,787,3219,532,5836,558,265,293
4290,6633,788,3220,532,5845,558,265,293
4295,6639,788,3224,532,5851,560,267,293
4300,6650,789,3228,533,5861,561,267,294
4305,6654,790,3230,534,5864,561,267,294
4310,6664,791,3234,534,5873,561,267,294
4315,6670,791,3236,534,5879,563,268,295
4320,6681,792,3239,534,5889,565,269,296
4325,6685,792,3241,534,5893,565,269,296
4330,6695,793,3249,535,5902,565,269,296
4335,6701,793,3252,535,5908,566,270,296
4340,6712,794,3256,535,5918,566,270,296
4345,6716,794,3258,535,5922,566,270,296
4350,6726,795,3261,536,5931,566,270,296
4355,6732,795,3264,536,5937,567,270,297
4360,6743,796,3270,537,5947,567,270,297
4365,6747,796,3271,537,5951,567,270,297
4370,6757,797,3279,538,5960,567,270,297
4375,6763,797,3281,538,5966,568,270,298
4380,6774,798,3285,539,5976,568,270,298
4385,6778,798,3287,539,5980,568,270,298
4390,6788,799,3295,540,5989,568,270,298
4395,6794,799,3299,540,5995,569,271,298
4400,6805,800,3305,541,6005,569,271,298
4405,6809,800,3306,541,6009,569,271,298
4410,6819,801,3312,541,6018,569,271,298
4415,6825,801,3314,541,6024,570,271,299
4420,6836,802,3322,542,6034,570,271,299
4425,6840,802,3324,542,6038,570,271,299
4430,6850,804,3328,543,6046,570,271,299
4435,6856,804,3331,543,6052,571,272,299
4440,6867,807,3338,546,6059,572,273,299
4445,6871,808,3340,547,6063,572,273,299
4450,6881,809,3343,547,6072,572,273,299
4455,6887,809,3345,547,6078,574,273,301
4460,6898,809,3350,547,6089,575,274,301
4465,6902,809,3352,547,6093,575,274,301
4470,6912,810,3356,548,6102,575,274,301
4475,6918,810,3357,548,6108,576,275,301
4480,6929,810,3363,548,6119,577,275,302
4485,6933,810,3367,548,6123,577,275,302
4490,6943,811,3372,549,6132,577,275,302
4495,6949,811,3373,549,6138,578,275,303
4500,6960,812,3378,550,6148,579,275,304
4505,6964,812,3380,550,6152,579,275,304
4510,6974,813,3384,550,6161,579,275,304
4515,6980,813,3388,550,6167,580,275,305
4520,6991,813,3393,550,6178,581,276,305
4525,6995,813,3396,550,6182,581,276,305
4530,7005,814,3401,550,6191,581,276,305
4535,7011,814,3402,550,6197,582,276,306
4540,7022,815,3409,551,6207,583,277,306
4545,7026,815,3411,551,6211,583,277,306
4550,7036,818,3415,553,6218,583,277,306
4555,7042,818,3419,553,6223,584,278,306
4560,7053,821,3422,555,6232,586,278,308
4565,7057,821,3424,555,6236,586,278,308
4570,7067,821,3427,555,6246,586,278,308
4575,7073,821,3429,555,6252,588,279,309
4580,7084,822,3432,556,6262,588,279,309
4585,7088,822,3434,556,6266,588,279,309
4590,7098,823,3439,557,6275,588,279,309
4595,7104,823,3444,557,6281,590,281,309
4600,7115,825,3449,558,6290,590,281,309
4605,7119,825,3451,558,6294,590,281,309
4610,7129,826,3456,559,6303,590,281,309
4615,7135,826,3459,559,6309,592,282,310
4620,7146,827,3464,560,6319,592,282,310
4625,7150,827,3466,560,6323,592,282,310
4630,7160,828,3472,561,6332,592,282,310
4635,7166,828,3477,561,6338,594,283,311
4640,7177,829,3480,561,6348,594,283,311
4645,7181,829,3482,561,6352,594,283,311
4650,7191,829,3488,561,6362,594,283,311
4655,7197,829,3494,561,6368,595,284,311
4660,7208,830,3499,562,6378,595,284,311
4665,7212,830,3500,562,6381,595,284,311
4670,7222,833,3503,563,6389,595,284,311
4675,7228,833,3506,563,6394,596,285,311
4680,7239,836,3511,566,6402,597,286,311
4685,7243,837,3514,567,6406,597,286,311
4690,7253,839,3519,567,6414,597,286,311
4695,7259,839,3522,567,6420,599,287,312
4700,7270,840,3527,568,6430,600,288,312
4705,7274,840,3529,568,6434,600,288,312
4710,7284,843,3536,570,6441,600,288,312
4715,7290,843,3541,570,6447,602,290,312
4720,7301,844,3546,571,6457,603,290,313
4725,7305,844,3546,571,6461,603,290,313
4730,7315,847,3552,573,6468,603,290,313
4735,7321,847,3557,573,6474,605,291,314
4740,7332,847,3561,573,6485,606,292,314
4745,7336,847,3564,573,6489,606,292,314
4750,7346,849,3570,575,6497,606,292,314
4755,7352,849,3576,575,6503,607,293,314
4760,7363,850,3584,576,6513,607,293,314
4765,7367,850,3587,576,6517,607,293,314
4770,7377,852,3593,578,6525,607,293,314
4775,7383,852,3599,578,6531,608,294,314
4780,7394,853,3605,579,6541,608,294,314
4785,7398,853,3607,579,6545,608,294,314
4790,7408,855,3612,580,6553,608,294,314
4795,7414,855,3613,580,6558,609,294,315
4800,7425,860,3621,585,6564,611,296,315
4805,7429,861,3623,586,6568,611,296,315
4810,7439,862,3631,586,6577,611,296,315
4815,7445,862,3634,586,6582,612,297,315
4820,7456,863,3640,587,6593,612,297,315
4825,7460,863,3643,587,6597,612,297,315
4830,7470,864,3648,588,6606,612,297,315
4835,7476,864,3653,588,6611,613,297,316
4840,7487,866,3660,590,6621,613,297,316
4845,7491,866,3662,590,6625,613,297,316
4850,7501,867,3665,590,6634,613,297,316
4855,7507,867,3667,590,6640,615,298,317
4860,7518,867,3672,590,6651,615,298,317
4865,7522,867,3675,590,6655,615,298,317
4870,7532,868,3677,590,6664,615,298,317
4875,7538,868,3679,590,6669,616,299,317
4880,7549,869,3681,591,6679,616,299,317
4885,7553,870,3681,592,6683,616,299,317
4890,7563,871,3684,592,6692,616,299,317
4895,7569,871,3688,592,6698,617,300,317
4900,7580,871,3692,592,6708,617,300,317
4905,7584,872,3694,593,6712,617,300,317
4910,7594,873,3697,593,6721,617,300,317
4915,7600,873,3702,593,6726,618,301,317
4920,7611,876,3708,596,6735,620,302,318
4925,7615,876,3710,596,6739,620,302,318
4930,7625,877,3715,597,6748,620,302,318
4935,7631,877,3716,597,6754,621,302,319
4940,7642,879,3723,598,6763,622,303,319
4945,7646,879,3725,598,6767,622,303,319
4950,7656,880,3728,598,6776,622,303,319
4955,7662,880,3731,598,6782,623,303,320
4960,7673,881,3736,599,6792,624,304,320
4965,7677,881,3740,599,6796,624,304,320
4970,7687,883,3746,600,6804,624,304,320
4975,7693,883,3750,600,6810,626,306,320
4980,7704,887,3760,604,6817,627,307,320
4985,7708,887,3763,604,6821,627,307,320
4990,7718,888,3770,605,6830,627,307,320
4995,7724,888,3772,605,6835,628,307,321
5000,7735,891,3778,607,6844,628,307,321
5005,7739,891,3779,607,6848,628,307,321
5010,7749,892,3784,607,6857,628,307,321
5015,7755,892,3786,607,6863,629,307,322
5020,7766,893,3793,608,6873,629,307,322
5025,7770,893,3793,608,6877,629,307,322
5030,7780,894,3798,609,6886,629,307,322
5035,7786,894,3798,609,6892,630,307,323
5040,7797,895,3802,609,6902,630,307,323
5045,7801,895,3803,609,6906,630,307,323
5050,7811,895,3807,609,6916,630,307,323
5055,7817,895,3810,609,6922,631,308,323
5060,7828,895,3818,609,6933,631,308,323
5065,7832,895,3821,609,6937,631,308,323
5070,7842,895,3824,609,6947,631,308,323
5075,7848,895,3829,609,6953,632,309,323
5080,7859,895,3837,609,6964,632,309,323
5085,7863,895,3840,609,6968,632,309,323
5090,7873,896,3842,609,6977,632,309,323
5095,7879,896,3844,609,6983,633,309,324
5100,7890,897,3849,610,6993,634,310,324
5105,7894,897,3852,610,6997,634,310,324
5110,7904,899,3857,611,7005,634,310,324
5115,7910,899,3862,611,7011,636,312,324
5120,7921,899,3866,611,7022,636,312,324
5125,7925,899,3868,611,7026,636,312,324
5130,7935,901,3872,613,7034,636,312,324
5135,7941,901,3877,613,7040,637,312,325
5140,7952,902,3881,614,7050,637,312,325
5145,7956,902,3883,614,7054,637,312,325
5150,7966,904,3886,614,7062,637,312,325
5155,7972,904,3889,614,7068,638,312,326
5160,7983,906,3895,615,7077,639,313,326
5165,7987,906,3895,615,7081,639,313,326
5170,7997,908,3900,616,7089,639,313,326
5175,8003,908,3902,616,7095,640,314,326
5180,8014,909,3904,616,7104,642,314,328
5185,8018,910,3906,617,7108,642,314,328
5190,8028,911,3911,618,7117,642,314,328
5195,8034,911,3913,618,7123,643,314,329
5200,8045,912,3917,618,7132,644,314,330
5205,8049,913,3919,619,7136,644,314,330
5210,8059,914,3922,619,7145,644,314,330
5215,8065,914,3924,619,7151,645,315,330
5220,8076,917,3931,621,7158,646,316,330
5225,8080,918,3932,622,7162,646,316,330
5230,8090,920,3935,623,7170,646,316,330
5235,8096,920,3937,623,7175,648,316,332
5240,8107,922,3945,624,7184,649,317,332
5245,8111,923,3947,625,7188,649,317,332
5250,8121,925,3953,625,7196,649,317,332
5255,8127,925,3957,625,7201,650,318,332
5260,8138,928,3963,627,7209,651,319,332
5265,8142,929,3964,628,7213,651,319,332
5270,8152,931,3970,630,7221,651,319,332
5275,8158,931,3975,630,7227,652,320,332
5280,8169,934,3981,632,7234,653,321,332
5285,8173,935,3983,633,7238,653,321,332
5290,8183,936,3988,634,7247,653,321,332
5295,8189,936,3989,634,7253,654,321,333
5300,8200,937,3994,635,7263,655,321,334
5305,8204,937,3997,635,7267,655,321,334
5310,8214,938,4003,635,7276,655,321,334
5315,8220,938,4005,635,7282,656,321,335
5320,8231,939,4009,635,7292,657,321,336
5325,8235,940,4011,636,7295,657,321,336
5330,8245,941,4014,637,7304,657,321,336
5335,8251,941,4015,637,7310,658,321,337
5340,8262,944,4022,640,7318,660,322,338
5345,8266,944,4023,640,7322,660,322,338
5350,8276,945,4028,641,7331,660,322,338
5355,8282,945,4031,641,7337,661,323,338
5360,8293,946,4035,641,7347,661,323,338
5365,8297,946,4037,641,7351,661,323,338
5370,8307,947,4044,642,7360,661,323,338
5375,8313,947,4048,642,7366,662,324,338
5380,8324,948,4052,643,7376,662,324,338
5385,8328,948,4053,643,7380,662,324,338
5390,8338,949,4056,643,7389,662,324,338
5395,8344,949,4060,643,7395,663,325,338
5400,8355,950,4065,644,7405,663,325,338
5405,8359,951,4067,645,7408,663,325,338
5410,8369,953,4070,647,7416,663,325,338
5415,8375,953,4073,647,7422,664,326,338
5420,8386,955,4079,649,7430,665,326,339
5425,8390,957,4082,651,7433,665,326,339
5430,8400,959,4087,651,7441,665,326,339
5435,8406,959,4089,651,7446,666,326,340
5440,8417,962,4094,654,7454,667,326,341
5445,8421,964,4098,656,7457,667,326,341
5450,8431,966,4104,657,7465,667,326,341
5455,8437,966,4107,657,7471,669,327,342
5460,8448,968,4112,658,7480,671,327,344
5465,8452,968,4114,658,7484,671,327,344
5470,8462,968,4119,658,7494,671,327,344
5475,8468,968,4119,658,7500,673,327,346
5480,8479,968,4124,658,7511,673,327,346
5485,8483,968,4127,658,7515,673,327,346
5490,8493,968,4134,658,7525,673,327,346
5495,8499,968,4138,658,7531,674,327,347
5500,8510,968,4143,658,7542,674,327,347
5505,8514,968,4146,658,7546,674,327,347
5510,8524,968,4150,658,7556,674,327,347
5515,8530,968,4153,658,7562,675,327,348
5520,8541,968,4159,658,7573,675,327,348
5525,8545,968,4160,658,7577,675,327,348
5530,8555,968,4165,658,7587,675,327,348
5535,8561,968,4169,658,7593,676,328,348
5540,8572,968,4175,658,7604,676,328,348
5545,8576,968,4177,658,7608,676,328,348
5550,8586,968,4182,658,7618,676,328,348
5555,8592,968,4186,658,7624,677,329,348
5560,8603,968,4194,658,7635,677,329,348
5565,8607,968,4196,658,7639,677,329,348
5570,8617,970,4201,659,7647,677,329,348
5575,8623,970,4203,659,7652,678,329,349
5580,8634,975,4212,664,7658,679,329,350
5585,8638,976,4214,665,7662,679,329,350
5590,8648,978,4218,665,7670,679,329,350
5595,8654,978,4220,665,7676,681,330,351
5600,8665,979,4226,666,7686,681,330,351
5605,8669,979,4228,666,7690,681,330,351
5610,8679,981,4235,667,7698,681,330,351
5615,8685,981,4236,667,7704,682,330,352
5620,8696,983,4242,668,7713,682,330,352
5625,8700,983,4245,668,7717,682,330,352
5630,8710,985,4249,669,7725,682,330,352
5635,8716,985,4250,669,7731,683,331,352
5640,8727,986,4252,669,7741,683,331,352
5645,8731,986,4253,669,7745,683,331,352
5650,8741,988,4258,669,7753,683,331,352
5655,8747,988,4259,669,7759,684,331,353
5660,8758,990,4266,671,7768,685,332,353
5665,8762,990,4267,671,7772,685,332,353
5670,8772,992,4272,672,7780,685,332,353
5675,8778,992,4277,672,7786,686,333,353
5680,8789,995,4282,675,7794,688,334,354
5685,8793,996,4284,676,7797,688,334,354
5690,8803,999,4288,678,7804,688,334,354
5695,8809,999,4291,678,7810,689,334,355
5700,8820,1003,4298,682,7816,691,335,356
5705,8824,1004,4300,683,7820,691,335,356
5710,8834,1004,4305,683,7830,691,335,356
5715,8840,1004,4305,683,7836,693,335,358
5720,8851,1005,4311,683,7846,694,336,358
5725,8855,1005,4312,683,7850,694,336,358
5730,8865,1005,4314,683,7860,694,336,358
5735,8871,1005,4316,683,7866,695,336,359
5740,8882,1007,4322,684,7875,696,337,359
5745,8886,1007,4324,684,7879,696,337,359
5750,8896,1007,4327,684,7889,696,337,359
5755,8902,1007,4330,684,7895,697,337,360
5760,8913,1008,4335,685,7905,698,338,360
5765,8917,1008,4339,685,7909,698,338,360
5770,8927,1009,4345,686,7918,698,338,360
5775,8933,1009,4350,686,7924,699,339,360
5780,8944,1010,4353,686,7934,699,339,360
5785,8948,1010,4354,686,7938,699,339,360
5790,8958,1011,4359,687,7947,699,339,360
5795,8964,1011,4361,687,7952,700,340,360
5800,8975,1014,4365,689,7961,700,340,360
5805,8979,1014,4365,689,7965,700,340,360
5810,8989,1016,4369,690,7973,700,340,360
5815,8995,1016,4370,690,7979,701,340,361
5820,9006,1020,4377,694,7985,702,340,362
5825,9010,1021,4378,695,7989,702,340,362
5830,9020,1022,4383,696,7998,702,340,362
5835,9026,1022,4387,696,8004,703,341,362
5840,9037,1022,4391,696,8015,703,341,362
5845,9041,1022,4395,696,8019,703,341,362
5850,9051,1023,4401,697,8028,703,341,362
5855,9057,1023,4405,697,8034,704,341,363
5860,9068,1024,4410,698,8044,704,341,363
5865,9072,1024,4413,698,8048,704,341,363
5870,9082,1025,4420,699,8057,704,341,363
5875,9088,1025,4426,699,8063,705,342,363
5880,9099,1025,4430,699,8074,705,342,363
5885,9103,1025,4432,699,8078,705,342,363
5890,9113,1026,4439,700,8087,705,342,363
5895,9119,1026,4442,700,8093,706,342,364
5900,9130,1027,4450,701,8103,706,342,364
5905,9134,1027,4453,701,8107,706,342,364
5910,9144,1028,4456,701,8116,706,342,364
5915,9150,1028,4457,701,8122,707,342,365
5920,9161,1029,4463,702,8132,707,342,365
5925,9165,1029,4464,702,8136,707,342,365
5930,9175,1031,4469,703,8143,707,342,365
5935,9181,1032,4473,704,8148,708,342,366
5940,9192,1036,4477,707,8156,710,343,367
5945,9196,1036,4480,707,8160,710,343,367
5950,9206,1038,4483,708,8168,710,343,367
5955,9212,1038,4487,708,8174,711,344,367
5960,9223,1039,4491,709,8184,711,344,367
5965,9227,1040,4495,710,8187,711,344,367
5970,9237,1042,4500,711,8195,711,344,367
5975,9243,1042,4504,711,8201,712,345,367
5980,9254,1043,4511,712,8211,712,345,367
5985,9258,1044,4513,713,8214,712,345,367
5990,9268,1046,4517,713,8222,712,345,367
5995,9274,1046,4519,713,8228,713,346,367
6000,9285,1048,4525,715,8237,713,346,367
6005,9289,1048,4525,715,8241,713,346,367
6010,9299,1050,4528,715,8249,713,346,367
6015,9305,1050,4531,715,8255,715,348,367
6020,9316,1051,4537,716,8265,716,348,368
6025,9320,1051,4538,716,8269,716,348,368
6030,9330,1053,4542,717,8277,716,348,368
6035,9336,1053,4545,717,8283,718,349,369
6040,9347,1054,4550,717,8293,719,349,370
6045,9351,1055,4551,718,8296,719,349,370
6050,9361,1058,4556,720,8303,719,349,370
6055,9367,1058,4558,720,8309,721,350,371
6060,9378,1061,4562,723,8317,723,351,372
6065,9382,1061,4565,723,8321,723,351,372
6070,9392,1061,4570,723,8331,723,351,372
6075,9398,1061,4574,723,8337,724,351,373
6080,9409,1061,4578,723,8348,725,351,374
6085,9413,1061,4580,723,8352,725,351,374
6090,9423,1061,4584,723,8362,725,351,374
6095,9429,1061,4588,723,8368,726,352,374
6100,9440,1061,4595,723,8379,727,353,374
6105,9444,1061,4598,723,8383,727,353,374
6110,9454,1061,4604,723,8393,727,353,374
6115,9460,1061,4608,723,8399,728,354,374
6120,9471,1061,4615,723,8410,729,355,374
6125,9475,1061,4617,723,8414,729,355,374
6130,9485,1061,4622,723,8424,729,355,374
6135,9491,1061,4628,723,8430,730,356,374
6140,9502,1061,4634,723,8441,731,357,374
6145,9506,1061,4635,723,8445,731,357,374
6150,9516,1061,4640,723,8455,731,357,374
6155,9522,1061,4645,723,8461,732,358,374
6160,9533,1061,4652,723,8472,733,359,374
6165,9537,1061,4653,723,8476,733,359,374
6170,9547,1064,4657,725,8483,733,359,374
6175,9553,1064,4659,725,8489,735,360,375
6180,9564,1067,4666,728,8496,736,361,375
6185,9568,1068,4667,729,8500,736,361,375
6190,9578,1070,4672,731,8508,736,361,375
6195,9584,1070,4675,731,8514,738,361,377
6200,9595,1072,4684,733,8523,738,361,377
6205,9599,1072,4686,733,8527,738,361,377
6210,9609,1074,4693,735,8535,738,361,377
6215,9615,1074,4697,735,8541,740,363,377
6220,9626,1075,4702,735,8551,740,363,377
6225,9630,1075,4704,735,8555,740,363,377
6230,9640,1077,4710,736,8563,740,363,377
6235,9646,1077,4713,736,8569,742,364,378
6240,9657,1078,4721,737,8579,742,364,378
6245,9661,1078,4723,737,8583,742,364,378
6250,9671,1080,4730,739,8591,742,364,378
6255,9677,1080,4731,739,8597,743,364,379
6260,9688,1081,4736,740,8607,743,364,379
6265,9692,1081,4738,740,8611,743,364,379
6270,9702,1083,4743,742,8619,743,364,379
6275,9708,1083,4744,742,8625,744,364,380
6280,9719,1084,4751,743,8635,744,364,380
6285,9723,1084,4753,743,8639,744,364,380
6290,9733,1087,4758,746,8646,744,364,380
6295,9739,1087,4761,746,8652,745,365,380
6300,9750,1090,4769,749,8660,747,367,380
6305,9754,1090,4771,749,8664,747,367,380
6310,9764,1091,4776,750,8673,747,367,380
6315,9770,1091,4779,750,8678,748,367,381
6320,9781,1093,4783,751,8688,748,367,381
6325,9785,1093,4784,751,8692,748,367,381
6330,9795,1094,4790,751,8701,748,367,381
6335,9801,1094,4793,751,8706,749,367,382
6340,9812,1096,4795,752,8716,749,367,382
6345,9816,1096,4796,752,8720,749,367,382
6350,9826,1097,4799,752,8729,749,367,382
6355,9832,1097,4803,752,8734,751,368,383
6360,9843,1100,4809,755,8743,751,368,383
6365,9847,1100,4810,755,8747,751,368,383
6370,9857,1100,4815,755,8757,751,368,383
6375,9863,1100,4818,755,8763,753,370,383
6380,9874,1101,4825,756,8773,753,370,383
6385,9878,1101,4827,756,8777,753,370,383
6390,9888,1101,4834,756,8787,753,370,383
6395,9894,1101,4837,756,8793,755,371,384
6400,9905,1102,4843,756,8803,755,371,384
6405,9909,1102,4845,756,8807,755,371,384
6410,9919,1103,4851,757,8816,755,371,384
6415,9925,1103,4853,757,8821,757,372,385
6420,9936,1108,4859,762,8828,759,373,386
6425,9940,1108,4861,762,8832,759,373,386
6430,9950,1110,4865,763,8840,759,373,386
6435,9956,1110,4867,763,8846,761,373,388
6440,9967,1112,4871,764,8855,761,373,388
6445,9971,1112,4872,764,8859,761,373,388
6450,9981,1114,4875,766,8867,761,373,388
6455,9987,1114,4877,766,8873,763,374,389
6460,9998,1115,4879,767,8883,763,374,389
6465,10002,1115,4880,767,8887,763,374,389
6470,10012,1117,4885,769,8895,763,374,389
6475,10018,1117,4889,769,8901,765,375,390
6480,10029,1119,4896,770,8910,765,375,390
6485,10033,1120,4898,771,8913,765,375,390
6490,10043,1122,4901,772,8921,765,375,390
6495,10049,1122,4903,772,8927,767,375,392
6500,10060,1124,4909,774,8936,768,375,393
6505,10064,1125,4912,775,8939,768,375,393
6510,10074,1127,4916,776,8947,768,375,393
6515,10080,1127,4919,776,8953,770,376,394
6520,10091,1129,4926,778,8962,771,376,395
6525,10095,1129,4926,778,8966,771,376,395
6530,10105,1131,4929,779,8974,771,376,395
6535,10111,1131,4931,779,8980,773,376,397
6540,10122,1135,4940,783,8987,775,378,397
6545,10126,1135,4943,783,8991,775,378,397
6550,10136,1135,4950,783,9001,775,378,397
6555,10142,1135,4952,783,9007,776,379,397
6560,10153,1135,4957,783,9018,776,379,397
6565,10157,1135,4960,783,9022,776,379,397
6570,10167,1135,4964,783,9032,776,379,397
6575,10173,1135,4968,783,9038,777,379,398
6580,10184,1135,4971,783,9049,777,379,398
6585,10188,1135,4973,783,9053,777,379,398
6590,10198,1135,4978,783,9063,777,379,398
6595,10204,1135,4980,783,9069,778,380,398
6600,10215,1135,4985,783,9080,778,380,398
6605,10219,1135,4987,783,9084,778,380,398
6610,10229,1135,4991,783,9094,778,380,398
6615,10235,1135,4993,783,9100,779,381,398
6620,10246,1135,5001,783,9111,779,381,398
6625,10250,1135,5004,783,9115,779,381,398
6630,10260,1135,5007,783,9125,779,381,398
6635,10266,1135,5007,783,9131,780,381,399
6640,10277,1135,5013,783,9142,780,381,399
6645,10281,1135,5014,783,9146,780,381,399
6650,10291,1139,5019,786,9152,780,381,399
6655,10297,1139,5021,786,9158,782,382,400
6660,10308,1142,5026,788,9166,783,382,401
6665,10312,1142,5028,788,9170,783,382,401
6670,10322,1144,5037,790,9178,783,382,401
6675,10328,1144,5040,790,9184,784,383,401
6680,10339,1145,5045,791,9194,784,383,401
6685,10343,1145,5048,791,9198,784,383,401
6690,10353,1147,5053,792,9206,784,383,401
6695,10359,1147,5055,792,9212,785,384,401
6700,10370,1148,5060,793,9222,785,384,401
6705,10374,1148,5063,793,9226,785,384,401
6710,10384,1150,5072,795,9234,785,384,401
6715,10390,1150,5077,795,9240,786,385,401
6720,10401,1151,5085,796,9250,787,386,401
6725,10405,1151,5086,796,9254,787,386,401
6730,10415,1153,5091,796,9262,787,386,401
6735,10421,1153,5095,796,9268,788,387,401
6740,10432,1154,5102,797,9278,789,388,401
6745,10436,1154,5104,797,9282,789,388,401
6750,10446,1156,5106,798,9290,789,388,401
6755,10452,1156,5107,798,9296,790,388,402
6760,10463,1157,5113,799,9306,791,388,403
6765,10467,1158,5114,800,9309,791,388,403
6770,10477,1161,5119,803,9316,791,388,403
6775,10483,1161,5121,803,9322,792,389,403
6780,10494,1164,5126,805,9330,794,390,404
6785,10498,1164,5127,805,9334,794,390,404
6790,10508,1164,5133,805,9344,794,390,404
6795,10514,1164,5136,805,9350,796,392,404
6800,10525,1165,5140,806,9360,796,392,404
6805,10529,1165,5143,806,9364,796,392,404
6810,10539,1165,5149,806,9374,796,392,404
6815,10545,1165,5154,806,9380,797,393,404
6820,10556,1166,5161,807,9390,797,393,404
6825,10560,1166,5164,807,9394,797,393,404
6830,10570,1166,5168,807,9404,797,393,404
6835,10576,1166,5171,807,9410,798,393,405
6840,10587,1167,5176,808,9420,798,393,405
6845,10591,1167,5176,808,9424,798,393,405
6850,10601,1167,5178,808,9434,798,393,405
6855,10607,1167,5182,808,9440,799,394,405
6860,10618,1168,5188,808,9450,799,394,405
6865,10622,1168,5191,808,9454,799,394,405
6870,10632,1168,5199,808,9464,799,394,405
6875,10638,1168,5202,808,9470,800,395,405
6880,10649,1169,5204,808,9480,800,395,405
6885,10653,1169,5205,808,9484,800,395,405
6890,10663,1171,5209,808,9492,800,395,405
6895,10669,1171,5213,808,9497,801,396,405
6900,10680,1175,5218,811,9505,803,397,406
6905,10684,1175,5219,811,9509,803,397,406
6910,10694,1176,5224,811,9518,803,397,406
6915,10700,1176,5227,811,9524,805,398,407
6920,10711,1179,5234,814,9532,805,398,407
6925,10715,1179,5235,814,9536,805,398,407
6930,10725,1180,5240,815,9545,805,398,407
6935,10731,1180,5245,815,9551,807,400,407
6940,10742,1182,5250,816,9560,807,400,407
6945,10746,1182,5252,816,9564,807,400,407
6950,10756,1183,5255,817,9573,807,400,407
6955,10762,1183,5259,817,9579,808,401,407
6960,10773,1186,5264,819,9587,808,401,407
6965,10777,1186,5265,819,9591,808,401,407
6970,10787,1187,5272,820,9600,808,401,407
6975,10793,1187,5275,820,9606,809,402,407
6980,10804,1189,5282,822,9615,809,402,407
6985,10808,1189,5285,822,9619,809,402,407
6990,10818,1190,5291,822,9628,809,402,407
6995,10824,1190,5294,822,9634,810,402,408
7000,10835,1191,5300,823,9644,810,402,408
7005,10839,1191,5302,823,9648,810,402,408
7010,10849,1193,5303,824,9656,810,402,408
7015,10855,1193,5304,824,9662,811,402,409
7020,10866,1195,5311,826,9671,812,402,410
7025,10870,1195,5313,826,9675,812,402,410
7030,10880,1196,5317,826,9684,812,402,410
7035,10886,1196,5321,826,9689,813,403,410
7040,10897,1198,5328,828,9698,813,403,410
7045,10901,1199,5332,829,9702,813,403,410
7050,10911,1200,5336,830,9711,813,403,410
7055,10917,1200,5339,830,9717,814,403,411
7060,10928,1201,5346,831,9726,814,403,411
7065,10932,1202,5348,832,9730,814,403,411
7070,10942,1203,5354,833,9739,814,403,411
7075,10948,1203,5358,833,9744,816,404,412
7080,10959,1205,5367,835,9753,816,404,412
7085,10963,1206,5368,836,9757,816,404,412
7090,10973,1207,5373,836,9766,816,404,412
7095,10979,1207,5376,836,9772,817,404,413
7100,10990,1208,5381,837,9781,817,404,413
7105,10994,1209,5385,838,9785,817,404,413
7110,11004,1210,5392,838,9794,817,404,413
7115,11010,1210,5395,838,9800,818,405,413
7120,11021,1212,5401,840,9809,818,405,413
7125,11025,1212,5402,840,9813,818,405,413
7130,11035,1214,5409,841,9821,818,405,413
7135,11041,1214,5410,841,9827,819,405,414
7140,11052,1217,5415,843,9834,821,406,415
7145,11056,1218,5417,844,9838,821,406,415
7150,11066,1219,5422,844,9847,821,406,415
7155,11072,1219,5425,844,9853,822,406,416
7160,11083,1219,5429,844,9864,822,406,416
7165,11087,1219,5432,844,9868,822,406,416
7170,11097,1220,5436,845,9877,822,406,416
7175,11103,1220,5439,845,9883,823,407,416
7180,11114,1220,5444,845,9894,823,407,416
7185,11118,1220,5446,845,9898,823,407,416
7190,11128,1221,5452,846,9907,823,407,416
7195,11134,1221,5455,846,9913,824,408,416
7200,11145,1221,5461,846,9924,824,408,416
7205,11149,1221,5463,846,9928,824,408,416
7210,11159,1223,5467,848,9936,824,408,416
7215,11165,1223,5471,848,9942,825,409,416
7220,11176,1225,5474,850,9951,826,409,417
7225,11180,1226,5475,851,9954,826,409,417
7230,11190,1228,5480,853,9962,826,409,417
7235,11196,1228,5484,853,9968,827,409,418
7240,11207,1229,5489,854,9978,828,410,418
7245,11211,1230,5492,855,9981,828,410,418
7250,11221,1232,5499,856,9989,828,410,418
7255,11227,1232,5502,856,9995,830,410,420
7260,11238,1234,5509,858,10003,832,412,420
7265,11242,1235,5511,859,10007,832,412,420
7270,11252,1236,5517,860,10016,832,412,420
7275,11258,1236,5522,860,10022,833,413,420
7280,11269,1237,5529,861,10032,833,413,420
7285,11273,1237,5530,861,10036,833,413,420
7290,11283,1238,5535,862,10045,833,413,420
7295,11289,1238,5538,862,10051,834,414,420
7300,11300,1240,5542,863,10060,834,414,420
7305,11304,1240,5544,863,10064,834,414,420
7310,11314,1241,5549,864,10073,834,414,420
7315,11320,1241,5553,864,10079,835,415,420
7320,11331,1242,5557,864,10089,835,415,420
7325,11335,1243,5560,865,10092,835,415,420
7330,11345,1245,5563,865,10100,835,415,420
7335,11351,1245,5564,865,10105,836,415,421
7340,11362,1248,5567,868,10113,837,415,422
7345,11366,1249,5569,869,10117,837,415,422
7350,11376,1252,5573,870,10124,837,415,422
7355,11382,1252,5576,870,10130,838,416,422
7360,11393,1254,5581,871,10139,839,417,422
7365,11397,1255,5583,872,10142,839,417,422
7370,11407,1258,5586,873,10149,839,417,422
7375,11413,1258,5589,873,10155,841,419,422
7380,11424,1262,5593,877,10162,843,419,424
7385,11428,1262,5595,877,10166,843,419,424
7390,11438,1262,5599,877,10176,843,419,424
7395,11444,1262,5604,877,10182,845,420,425
7400,11455,1263,5607,877,10192,845,420,425
7405,11459,1263,5609,877,10196,845,420,425
7410,11469,1263,5616,877,10206,845,420,425
7415,11475,1263,5618,877,10212,846,420,426
7420,11486,1264,5623,878,10222,846,420,426
7425,11490,1264,5626,878,10226,846,420,426
7430,11500,1264,5630,878,10236,846,420,426
7435,11506,1264,5633,878,10242,847,421,426
7440,11517,1265,5636,878,10252,847,421,426
7445,11521,1265,5637,878,10256,847,421,426
7450,11531,1265,5641,878,10266,847,421,426
7455,11537,1265,5643,878,10272,848,421,427
7460,11548,1266,5644,878,10282,848,421,427
7465,11552,1266,5646,878,10286,848,421,427
7470,11562,1266,5651,878,10296,848,421,427
7475,11568,1266,5653,878,10302,849,422,427
7480,11579,1267,5656,878,10312,849,422,427
7485,11583,1267,5656,878,10316,849,422,427
7490,11593,1268,5660,878,10325,849,422,427
7495,11599,1268,5663,878,10330,850,423,427
7500,11610,1274,5668,883,10336,851,423,428
7505,11614,1275,5671,884,10339,851,423,428
7510,11624,1276,5675,884,10348,851,423,428
7515,11630,1276,5677,884,10354,853,424,429
7520,11641,1277,5683,885,10364,853,424,429
7525,11645,1277,5685,885,10368,853,424,429
7530,11655,1278,5690,886,10377,853,424,429
7535,11661,1278,5691,886,10383,855,425,430
7540,11672,1280,5697,887,10392,856,425,431
7545,11676,1280,5699,887,10396,856,425,431
7550,11686,1281,5704,888,10405,856,425,431
7555,11692,1281,5705,888,10411,858,425,433
7560,11703,1282,5707,888,10421,859,426,433
7565,11707,1282,5710,888,10425,859,426,433
7570,11717,1283,5718,888,10434,859,426,433
7575,11723,1283,5720,888,10440,861,427,434
7580,11734,1284,5725,889,10450,862,427,435
7585,11738,1284,5728,889,10454,862,427,435
7590,11748,1285,5734,890,10463,862,427,435
7595,11754,1285,5738,890,10469,864,429,435
7600,11765,1287,5744,892,10478,865,429,436
7605,11769,1287,5745,892,10482,865,429,436
7610,11779,1289,5749,892,10489,865,429,436
7615,11785,1290,5752,893,10494,866,430,436
7620,11796,1292,5756,895,10504,867,430,437
7625,11800,1292,5758,895,10508,867,430,437
7630,11810,1292,5759,895,10518,867,430,437
7635,11816,1292,5762,895,10524,868,431,437
7640,11827,1293,5768,895,10534,868,431,437
7645,11831,1293,5772,895,10538,868,431,437
7650,11841,1293,5776,895,10548,868,431,437
7655,11847,1293,5778,895,10554,869,432,437
7660,11858,1294,5783,896,10564,869,432,437
7665,11862,1294,5787,896,10568,869,432,437
7670,11872,1294,5793,896,10578,869,432,437
7675,11878,1294,5796,896,10584,870,432,438
7680,11889,1295,5803,897,10594,870,432,438
7685,11893,1295,5806,897,10598,870,432,438
7690,11903,1295,5813,897,10608,870,432,438
7695,11909,1295,5814,897,10614,871,432,439
7700,11920,1296,5823,898,10624,871,432,439
7705,11924,1296,5825,898,10628,871,432,439
7710,11934,1296,5830,898,10638,871,432,439
7715,11940,1296,5832,898,10644,872,432,440
7720,11951,1297,5837,898,10654,872,432,440
7725,11955,1297,5839,898,10658,872,432,440
7730,11965,1299,5845,900,10666,872,432,440
7735,11971,1299,5846,900,10672,874,433,441
7740,11982,1302,5851,902,10680,876,433,443
7745,11986,1302,5853,902,10684,876,433,443
7750,11996,1304,5857,903,10692,876,433,443
7755,12002,1304,5860,903,10698,878,433,445
7760,12013,1305,5866,904,10708,878,433,445
7765,12017,1305,5868,904,10712,878,433,445
7770,12027,1307,5874,905,10720,878,433,445
7775,12033,1307,5877,905,10726,880,435,445
7780,12044,1308,5883,906,10736,880,435,445
7785,12048,1308,5885,906,10740,880,435,445
7790,12058,1310,5889,907,10748,880,435,445
7795,12064,1310,5894,907,10754,882,437,445
7800,12075,1311,5899,908,10764,882,437,445
7805,12079,1311,5901,908,10768,882,437,445
7810,12089,1313,5907,909,10776,882,437,445
7815,12095,1313,5913,909,10782,884,439,445
7820,12106,1313,5917,909,10793,884,439,445
7825,12110,1313,5918,909,10797,884,439,445
7830,12120,1315,5923,911,10805,884,439,445
7835,12126,1315,5928,911,10811,886,441,445
7840,12137,1315,5936,911,10822,886,441,445
7845,12141,1315,5937,911,10826,886,441,445
7850,12151,1317,5940,912,10834,886,441,445
7855,12157,1317,5944,912,10839,888,442,446
7860,12168,1320,5949,914,10847,889,443,446
7865,12172,1322,5952,916,10850,889,443,446
7870,12182,1322,5955,916,10860,889,443,446
7875,12188,1322,5958,916,10866,890,444,446
7880,12199,1323,5960,917,10876,890,444,446
7885,12203,1323,5962,917,10880,890,444,446
7890,12213,1323,5966,917,10890,890,444,446
7895,12219,1323,5971,917,10896,891,445,446
7900,12230,1324,5978,918,10906,891,445,446
7905,12234,1324,5978,918,10910,891,445,446
7910,12244,1324,5986,918,10920,891,445,446
7915,12250,1324,5987,918,10926,892,445,447
7920,12261,1325,5992,918,10936,892,445,447
7925,12265,1325,5992,918,10940,892,445,447
7930,12275,1326,5994,918,10949,892,445,447
7935,12281,1326,5996,918,10955,893,446,447
7940,12292,1327,6001,918,10965,894,447,447
7945,12296,1328,6003,919,10968,894,447,447
7950,12306,1329,6005,919,10977,894,447,447
7955,12312,1329,6005,919,10983,895,447,448
7960,12323,1330,6010,920,10993,896,448,448
7965,12327,1331,6013,921,10996,896,448,448
7970,12337,1333,6017,923,11004,896,448,448
7975,12343,1333,6020,923,11009,897,449,448
7980,12354,1338,6024,927,11015,898,449,449
7985,12358,1339,6024,928,11019,898,449,449
7990,12368,1340,6028,929,11028,898,449,449
7995,12374,1340,6031,929,11034,900,449,451
8000,12385,1341,6032,929,11044,901,449,452
8005,12389,1341,6032,929,11048,901,449,452
8010,12399,1342,6036,929,11057,901,449,452
8015,12405,1342,6037,929,11063,903,449,454
8020,12416,1344,6042,931,11072,904,450,454
8025,12420,1345,6044,932,11075,904,450,454
8030,12430,1346,6048,933,11084,904,450,454
8035,12436,1346,6049,933,11090,905,450,455
8040,12447,1348,6054,935,11099,906,451,455
8045,12451,1348,6056,935,11103,906,451,455
8050,12461,1350,6064,936,11111,906,451,455
8055,12467,1350,6065,936,11117,907,452,455
8060,12478,1350,6066,936,11128,908,453,455
8065,12482,1350,6068,936,11132,908,453,455
8070,12492,1352,6075,938,11140,908,453,455
8075,12498,1352,6078,938,11146,909,454,455
8080,12509,1354,6083,940,11155,910,455,455
8085,12513,1354,6084,940,11159,910,455,455
8090,12523,1356,6087,941,11167,910,455,455
8095,12529,1356,6090,941,11172,911,456,455
8100,12540,1359,6096,944,11180,912,456,456
8105,12544,1360,6098,945,11184,912,456,456
8110,12554,1361,6102,946,11193,912,456,456
8115,12560,1361,6103,946,11199,913,456,457
8120,12571,1363,6109,948,11208,913,456,457
8125,12575,1363,6111,948,11212,913,456,457
8130,12585,1363,6117,948,11222,913,456,457
8135,12591,1363,6119,948,11228,915,457,458
8140,12602,1364,6125,948,11237,915,457,458
8145,12606,1365,6127,949,11241,915,457,458
8150,12616,1365,6133,949,11251,915,457,458
8155,12622,1365,6136,949,11257,917,458,459
8160,12633,1367,6143,950,11265,917,458,459
8165,12637,1368,6145,951,11269,917,458,459
8170,12647,1369,6149,951,11278,917,458,459
8175,12653,1369,6152,951,11284,919,458,461
8180,12664,1371,6155,952,11292,920,458,462
8185,12668,1373,6158,954,11295,920,458,462
8190,12678,1376,6163,956,11302,920,458,462
8195,12684,1376,6166,956,11308,922,459,463
8200,12695,1378,6171,958,11317,923,459,464
8205,12699,1379,6175,959,11320,923,459,464
8210,12709,1381,6176,960,11328,923,459,464
8215,12715,1381,6179,960,11334,925,460,465
8220,12726,1383,6181,961,11343,926,460,466
8225,12730,1384,6184,962,11346,926,460,466
8230,12740,1385,6188,962,11355,926,460,466
8235,12746,1385,6189,962,11361,927,460,467
8240,12757,1386,6190,962,11371,928,460,468
8245,12761,1386,6192,962,11375,928,460,468
8250,12771,1387,6198,963,11384,928,460,468
8255,12777,1387,6200,963,11390,929,460,469
8260,12788,1389,6206,964,11399,930,461,469
8265,12792,1389,6208,964,11403,930,461,469
8270,12802,1390,6213,964,11412,930,461,469
8275,12808,1390,6216,964,11418,931,462,469
8280,12819,1392,6220,965,11427,932,462,470
8285,12823,1392,6223,965,11431,932,462,470
8290,12833,1393,6230,966,11440,932,462,470
8295,12839,1393,6231,966,11446,933,462,471
8300,12850,1394,6239,967,11456,934,463,471
8305,12854,1394,6241,967,11460,934,463,471
8310,12864,1395,6246,968,11469,934,463,471
8315,12870,1395,6250,968,11475,935,464,471
8320,12881,1395,6256,968,11486,936,465,471
8325,12885,1395,6259,968,11490,936,465,471
8330,12895,1397,6262,968,11498,936,465,471
8335,12901,1397,6266,968,11504,938,467,471
8340,12912,1398,6271,969,11513,939,468,471
8345,12916,1399,6272,970,11517,939,468,471
8350,12926,1402,6275,971,11524,939,468,471
8355,12932,1402,6277,971,11530,940,468,472
8360,12943,1404,6283,973,11539,940,468,472
8365,12947,1405,6286,974,11542,940,468,472
8370,12957,1407,6291,975,11550,940,468,472
8375,12963,1407,6293,975,11556,941,469,472
8380,12974,1409,6301,977,11565,941,469,472
8385,12978,1410,6303,978,11568,941,469,472
8390,12988,1413,6310,980,11575,941,469,472
8395,12994,1413,6314,980,11581,942,470,472
8400,13005,1415,6321,982,11590,942,470,472
8405,13009,1417,6324,984,11592,942,470,472
8410,13019,1420,6328,985,11599,942,470,472
8415,13025,1420,6331,985,11605,943,470,473
8420,13036,1423,6339,988,11613,944,471,473
8425,13040,1424,6342,989,11616,944,471,473
8430,13050,1425,6347,989,11625,944,471,473
8435,13056,1425,6351,989,11631,945,472,473
8440,13067,1427,6358,991,11639,946,473,473
8445,13071,1428,6359,992,11643,946,473,473
8450,13081,1429,6363,992,11652,946,473,473
8455,13087,1429,6366,992,11658,947,474,473
8460,13098,1431,6368,993,11666,948,474,474
8465,13102,1432,6368,994,11670,948,474,474
8470,13112,1432,6373,994,11680,948,474,474
8475,13118,1432,6376,994,11686,949,474,475
8480,13129,1432,6382,994,11697,949,474,475
8485,13133,1432,6385,994,11701,949,474,475
8490,13143,1432,6387,994,11711,949,474,475
8495,13149,1432,6389,994,11717,950,474,476
8500,13160,1432,6394,994,11728,950,474,476
8505,13164,1432,6396,994,11732,950,474,476
8510,13174,1432,6401,994,11742,950,474,476
8515,13180,1432,6404,994,11748,951,475,476
8520,13191,1432,6410,994,11759,951,475,476
8525,13195,1432,6413,994,11763,951,475,476
8530,13205,1432,6416,994,11773,951,475,476
8535,13211,1432,6419,994,11779,952,476,476
8540,13222,1432,6423,994,11790,952,476,476
8545,13226,1432,6425,994,11794,952,476,476
8550,13236,1432,6432,994,11804,952,476,476
8555,13242,1432,6433,994,11810,953,476,477
8560,13253,1432,6440,994,11821,953,476,477
8565,13257,1432,6442,994,11825,953,476,477
8570,13267,1434,6445,994,11832,953,476,477
8575,13273,1435,6445,995,11838,954,476,478
8580,13284,1436,6449,996,11848,954,476,478
8585,13288,1438,6452,998,11850,954,476,478
8590,13298,1440,6456,999,11858,954,476,478
8595,13304,1440,6461,999,11864,956,478,478
8600,13315,1442,6465,1001,11873,957,478,479
8605,13319,1443,6466,1002,11876,957,478,479
8610,13329,1445,6474,1004,11884,957,478,479
8615,13335,1445,6478,1004,11890,958,478,480
8620,13346,1447,6486,1006,11899,959,479,480
8625,13350,1448,6488,1007,11902,959,479,480
8630,13360,1450,6491,1008,11910,959,479,480
8635,13366,1450,6495,1008,11916,960,479,481
8640,13377,1452,6501,1009,11924,961,480,481
8645,13381,1453,6503,1010,11928,961,480,481
8650,13391,1455,6506,1011,11936,961,480,481
8655,13397,1455,6511,1011,11942,962,481,481
8660,13408,1457,6517,1012,11951,963,481,482
8665,13412,1458,6520,1013,11954,963,481,482
8670,13422,1460,6528,1015,11962,963,481,482
8675,13428,1460,6530,1015,11968,964,481,483
8680,13439,1462,6536,1016,11977,965,482,483
8685,13443,1463,6538,1017,11980,965,482,483
8690,13453,1465,6541,1017,11988,965,482,483
8695,13459,1465,6543,1017,11994,966,482,484
8700,13470,1469,6550,1021,12001,967,483,484
8705,13474,1469,6554,1021,12005,967,483,484
8710,13484,1470,6556,1021,12014,967,483,484
8715,13490,1470,6558,1021,12020,968,483,485
8720,13501,1470,6563,1021,12031,968,483,485
8725,13505,1470,6566,1021,12035,968,483,485
8730,13515,1471,6571,1022,12044,968,483,485
8735,13521,1471,6575,1022,12050,969,484,485
8740,13532,1471,6582,1022,12061,969,484,485
8745,13536,1471,6586,1022,12065,969,484,485
8750,13546,1472,6590,1023,12074,969,484,485
8755,13552,1472,6592,1023,12080,971,485,486
8760,13563,1473,6598,1024,12090,972,486,486
8765,13567,1473,6600,1024,12094,972,486,486
8770,13577,1475,6606,1025,12102,972,486,486
8775,13583,1475,6611,1025,12108,974,488,486
8780,13594,1477,6616,1027,12117,975,488,487
8785,13598,1477,6619,1027,12121,975,488,487
8790,13608,1479,6623,1029,12129,975,488,487
8795,13614,1479,6624,1029,12135,977,488,489
8800,13625,1482,6628,1031,12143,978,489,489
8805,13629,1483,6632,1032,12146,978,489,489
8810,13639,1485,6634,1032,12154,978,489,489
8815,13645,1485,6637,1032,12160,980,490,490
8820,13656,1488,6642,1035,12167,981,490,491
8825,13660,1489,6644,1036,12171,981,490,491
8830,13670,1489,6649,1036,12181,981,490,491
8835,13676,1489,6652,1036,12187,982,490,492
8840,13687,1489,6658,1036,12198,982,490,492
8845,13691,1489,6660,1036,12202,982,490,492
8850,13701,1489,6664,1036,12212,982,490,492
8855,13707,1489,6667,1036,12218,983,490,493
8860,13718,1489,6669,1036,12229,983,490,493
8865,13722,1489,6671,1036,12233,983,490,493
8870,13732,1489,6673,1036,12243,983,490,493
8875,13738,1489,6677,1036,12249,984,491,493
8880,13749,1489,6683,1036,12260,984,491,493
8885,13753,1489,6684,1036,12264,984,491,493
8890,13763,1490,6686,1036,12273,984,491,493
8895,13769,1490,6688,1036,12279,986,492,494
8900,13780,1490,6693,1036,12290,987,492,495
8905,13784,1490,6695,1036,12294,987,492,495
8910,13794,1492,6701,1037,12302,987,492,495
8915,13800,1492,6704,1037,12307,989,492,497
8920,13811,1493,6710,1038,12318,990,493,497
8925,13815,1494,6713,1039,12321,990,493,497
8930,13825,1497,6719,1041,12328,990,493,497
8935,13831,1497,6721,1041,12334,992,494,498
8940,13842,1500,6727,1043,12341,993,494,499
8945,13846,1501,6728,1044,12345,993,494,499
8950,13856,1502,6731,1044,12354,993,494,499
8955,13862,1502,6732,1044,12360,994,495,499
8960,13873,1504,6736,1046,12369,994,495,499
8965,13877,1504,6737,1046,12373,994,495,499
8970,13887,1505,6741,1046,12382,994,495,499
8975,13893,1505,6743,1046,12388,995,495,500
8980,13904,1507,6746,1047,12397,995,495,500
8985,13908,1508,6747,1048,12400,995,495,500
8990,13918,1509,6753,1048,12409,995,495,500
8995,13924,1509,6754,1048,12415,996,495,501
9000,13935,1511,6758,1049,12424,996,495,501
9005,13939,1512,6760,1050,12427,996,495,501
9010,13949,1514,6766,1051,12435,996,495,501
9015,13955,1514,6769,1051,12441,997,495,502
9020,13966,1515,6772,1051,12451,997,495,502
9025,13970,1516,6773,1052,12454,997,495,502
9030,13980,1518,6777,1052,12462,997,495,502
9035,13986,1518,6781,1052,12467,998,496,502
9040,13997,1521,6787,1055,12476,998,496,502
9045,14001,1521,6788,1055,12480,998,496,502
9050,14011,1523,6791,1055,12488,998,496,502
9055,14017,1523,6794,1055,12493,1000,496,504
9060,14028,1527,6799,1059,12501,1001,496,505
9065,14032,1527,6800,1059,12505,1001,496,505
9070,14042,1527,6802,1059,12515,1001,496,505
9075,14048,1527,6804,1059,12521,1003,496,507
9080,14059,1527,6810,1059,12532,1003,496,507
9085,14063,1527,6812,1059,12536,1003,496,507
9090,14073,1527,6820,1059,12546,1003,496,507
9095,14079,1527,6821,1059,12552,1004,496,508
9100,14090,1527,6829,1059,12563,1004,496,508
9105,14094,1527,6832,1059,12567,1004,496,508
9110,14104,1527,6836,1059,12577,1004,496,508
9115,14110,1527,6838,1059,12583,1005,497,508
9120,14121,1527,6843,1059,12594,1005,497,508
9125,14125,1527,6843,1059,12598,1005,497,508
9130,14135,1527,6848,1059,12608,1005,497,508
9135,14141,1527,6853,1059,12614,1006,498,508
9140,14152,1527,6856,1059,12625,1006,498,508
9145,14156,1527,6856,1059,12629,1006,498,508
9150,14166,1527,6862,1059,12639,1006,498,508
9155,14172,1527,6864,1059,12645,1007,499,508
9160,14183,1527,6868,1059,12656,1007,499,508
9165,14187,1527,6868,1059,12660,1007,499,508
9170,14197,1530,6873,1062,12667,1007,499,508
9175,14203,1530,6874,1062,12672,1008,499,509
9180,14214,1535,6878,1066,12679,1009,499,510
9185,14218,1536,6880,1067,12682,1009,499,510
9190,14228,1537,6886,1067,12691,1009,499,510
9195,14234,1537,6887,1067,12697,1011,499,512
9200,14245,1539,6895,1068,12706,1011,499,512
9205,14249,1540,6898,1069,12709,1011,499,512
9210,14259,1541,6902,1070,12718,1011,499,512
9215,14265,1541,6908,1070,12724,1013,501,512
9220,14276,1543,6914,1072,12733,1013,501,512
9225,14280,1544,6917,1073,12736,1013,501,512
9230,14290,1545,6924,1074,12745,1013,501,512
9235,14296,1545,6926,1074,12751,1015,501,514
9240,14307,1546,6930,1074,12761,1015,501,514
9245,14311,1547,6931,1075,12764,1015,501,514
9250,14321,1548,6937,1076,12773,1015,501,514
9255,14327,1548,6941,1076,12779,1016,501,515
9260,14338,1550,6947,1078,12788,1016,501,515
9265,14342,1551,6948,1079,12791,1016,501,515
9270,14352,1552,6953,1079,12800,1016,501,515
9275,14358,1552,6955,1079,12806,1017,501,516
9280,14369,1553,6956,1079,12816,1017,501,516
9285,14373,1554,6958,1080,12819,1017,501,516
9290,14383,1556,6964,1081,12827,1017,501,516
9295,14389,1556,6967,1081,12833,1018,502,516
9300,14400,1558,6972,1082,12842,1019,503,516
9305,14404,1558,6975,1082,12846,1019,503,516
9310,14414,1558,6977,1082,12856,1019,503,516
9315,14420,1558,6978,1082,12862,1020,503,517
9320,14431,1558,6985,1082,12873,1020,503,517
9325,14435,1558,6986,1082,12877,1020,503,517
9330,14445,1558,6992,1082,12887,1020,503,517
9335,14451,1558,6995,1082,12893,1021,504,517
9340,14462,1558,7001,1082,12904,1021,504,517
9345,14466,1558,7004,1082,12908,1021,504,517
9350,14476,1558,7010,1082,12918,1021,504,517
9355,14482,1558,7012,1082,12924,1022,504,518
9360,14493,1558,7015,1082,12935,1022,504,518
9365,14497,1558,7016,1082,12939,1022,504,518
9370,14507,1558,7021,1082,12949,1022,504,518
9375,14513,1558,7023,1082,12955,1023,504,519
9380,14524,1558,7028,1082,12966,1023,504,519
9385,14528,1558,7030,1082,12970,1023,504,519
9390,14538,1558,7034,1082,12980,1023,504,519
9395,14544,1558,7037,1082,12986,1024,505,519
9400,14555,1558,7044,1082,12997,1024,505,519
9405,14559,1559,7047,1083,13000,1024,505,519
9410,14569,1560,7051,1083,13009,1024,505,519
9415,14575,1560,7055,1083,13014,1026,506,520
9420,14586,1565,7062,1088,13020,1027,507,520
9425,14590,1567,7066,1090,13023,1027,507,520
9430,14600,1567,7071,1090,13033,1027,507,520
9435,14606,1567,7076,1090,13039,1028,508,520
9440,14617,1568,7079,1090,13049,1028,508,520
9445,14621,1568,7080,1090,13053,1028,508,520
9450,14631,1568,7083,1090,13063,1028,508,520
9455,14637,1568,7085,1090,13069,1029,508,521
9460,14648,1569,7090,1091,13079,1029,508,521
9465,14652,1569,7091,1091,13083,1029,508,521
9470,14662,1569,7097,1091,13093,1029,508,521
9475,14668,1569,7099,1091,13099,1030,508,522
9480,14679,1570,7103,1091,13109,1030,508,522
9485,14683,1572,7105,1093,13111,1030,508,522
9490,14693,1573,7109,1094,13120,1030,508,522
9495,14699,1573,7111,1094,13125,1031,508,523
9500,14710,1576,7119,1096,13134,1032,509,523
9505,14714,1576,7120,1096,13138,1032,509,523
9510,14724,1577,7124,1096,13147,1032,509,523
9515,14730,1577,7127,1096,13152,1033,509,524
9520,14741,1580,7134,1099,13161,1034,510,524
9525,14745,1580,7135,1099,13165,1034,510,524
9530,14755,1582,7140,1100,13173,1034,510,524
9535,14761,1582,7144,1100,13178,1036,511,525
9540,14772,1585,7150,1103,13186,1037,512,525
9545,14776,1586,7154,1104,13190,1037,512,525
9550,14786,1587,7161,1105,13199,1037,512,525
9555,14792,1587,7163,1105,13205,1038,512,526
9560,14803,1589,7170,1107,13214,1038,512,526
9565,14807,1589,7172,1107,13218,1038,512,526
9570,14817,1590,7177,1108,13227,1038,512,526
9575,14823,1590,7180,1108,13233,1039,512,527
9580,14834,1592,7185,1110,13242,1039,512,527
9585,14838,1592,7186,1110,13246,1039,512,527
9590,14848,1593,7188,1111,13255,1039,512,527
9595,14854,1593,7192,1111,13261,1040,513,527
9600,14865,1595,7198,1112,13270,1040,513,527
9605,14869,1595,7200,1112,13274,1040,513,527
9610,14879,1596,7201,1112,13283,1040,513,527
9615,14885,1596,7202,1112,13289,1041,513,528
9620,14896,1598,7209,1114,13298,1041,513,528
9625,14900,1598,7211,1114,13302,1041,513,528
9630,14910,1599,7216,1114,13311,1041,513,528
9635,14916,1599,7218,1114,13317,1042,514,528
9640,14927,1600,7220,1114,13327,1042,514,528
9645,14931,1600,7223,1114,13331,1042,514,528
9650,14941,1603,7228,1117,13338,1042,514,528
9655,14947,1603,7232,1117,13343,1044,516,528
9660,14958,1606,7237,1120,13351,1045,517,528
9665,14962,1607,7239,1121,13355,1045,517,528
9670,14972,1608,7243,1121,13364,1045,517,528
9675,14978,1608,7247,1121,13370,1047,519,528
9680,14989,1608,7253,1121,13381,1047,519,528
9685,14993,1608,7254,1121,13385,1047,519,528
9690,15003,1609,7256,1121,13394,1047,519,528
9695,15009,1609,7258,1121,13400,1048,519,529
9700,15020,1609,7263,1121,13411,1048,519,529
9705,15024,1609,7266,1121,13415,1048,519,529
9710,15034,1610,7271,1121,13424,1048,519,529
9715,15040,1610,7274,1121,13430,1049,519,530
9720,15051,1610,7280,1121,13441,1049,519,530
9725,15055,1610,7284,1121,13445,1049,519,530
9730,15065,1611,7288,1121,13454,1049,519,530
9735,15071,1611,7292,1121,13460,1050,520,530
9740,15082,1611,7298,1121,13471,1050,520,530
9745,15086,1611,7299,1121,13475,1050,520,530
9750,15096,1612,7303,1121,13484,1050,520,530
9755,15102,1612,7306,1121,13490,1051,521,530
9760,15113,1612,7313,1121,13501,1051,521,530
9765,15117,1612,7315,1121,13505,1051,521,530
9770,15127,1614,7321,1122,13512,1051,521,530
9775,15133,1615,7324,1123,13517,1052,521,531
9780,15144,1618,7331,1125,13525,1053,522,531
9785,15148,1619,7333,1126,13529,1053,522,531
9790,15158,1620,7339,1127,13538,1053,522,531
9795,15164,1620,7343,1127,13543,1055,524,531
9800,15175,1623,7349,1130,13552,1055,524,531
9805,15179,1623,7349,1130,13556,1055,524,531
9810,15189,1624,7353,1130,13565,1055,524,531
9815,15195,1624,7355,1130,13571,1057,526,531
9820,15206,1625,7356,1131,13581,1057,526,531
9825,15210,1626,7359,1132,13584,1057,526,531
9830,15220,1627,7366,1133,13593,1057,526,531
9835,15226,1627,7369,1133,13598,1058,527,531
9840,15237,1630,7373,1136,13607,1058,527,531
9845,15241,1630,7373,1136,13611,1058,527,531
9850,15251,1630,7380,1136,13621,1058,527,531
9855,15257,1630,7383,1136,13627,1059,528,531
9860,15268,1630,7386,1136,13638,1059,528,531
9865,15272,1630,7387,1136,13642,1059,528,531
9870,15282,1630,7391,1136,13652,1059,528,531
9875,15288,1630,7392,1136,13658,1060,528,532
9880,15299,1630,7395,1136,13669,1060,528,532
9885,15303,1630,7397,1136,13673,1060,528,532
9890,15313,1631,7404,1136,13682,1060,528,532
9895,15319,1631,7407,1136,13687,1061,529,532
9900,15330,1632,7413,1137,13698,1062,530,532
9905,15334,1632,7415,1137,13702,1062,530,532
9910,15344,1633,7420,1137,13711,1062,530,532
9915,15350,1633,7424,1137,13717,1063,531,532
9920,15361,1633,7431,1137,13728,1063,531,532
9925,15365,1633,7435,1137,13732,1063,531,532
9930,15375,1634,7439,1138,13741,1063,531,532
9935,15381,1634,7442,1138,13747,1064,531,533
9940,15392,1634,7448,1138,13758,1064,531,533
9945,15396,1634,7448,1138,13762,1064,531,533
9950,15406,1636,7454,1140,13770,1064,531,533
9955,15412,1636,7457,1140,13776,1065,531,534
9960,15423,1637,7459,1140,13786,1066,531,535
9965,15427,1637,7461,1140,13790,1066,531,535
9970,15437,1639,7464,1140,13798,1066,531,535
9975,15443,1639,7469,1140,13804,1067,532,535
9980,15454,1639,7473,1140,13815,1067,532,535
9985,15458,1639,7474,1140,13819,1067,532,535
9990,15468,1641,7478,1141,13827,1067,532,535
9995,15474,1641,7481,1141,13833,1068,532,536
10000,15485,1642,7488,1142,13843,1068,532,536
10005,15489,1642,7490,1142,13847,1068,532,536
10010,15499,1645,7495,1144,13854,1068,532,536
10015,15505,1645,7498,1144,13860,1069,533,536
10020,15516,1646,7504,1145,13870,1070,534,536
10025,15520,1646,7507,1145,13874,1070,534,536
10030,15530,1648,7511,1146,13882,1070,534,536
10035,15536,1648,7514,1146,13888,1072,535,537
10040,15547,1648,7520,1146,13899,1072,535,537
10045,15551,1648,7523,1146,13903,1072,535,537
10050,15561,1650,7527,1147,13911,1072,535,537
10055,15567,1650,7530,1147,13917,1074,537,537
10060,15578,1650,7537,1147,13928,1074,537,537
10065,15582,1650,7539,1147,13932,1074,537,537
10070,15592,1652,7544,1147,13939,1074,537,537
10075,15598,1653,7547,1148,13945,1076,538,538
10080,15609,1657,7554,1152,13951,1076,538,538
10085,15613,1659,7557,1154,13954,1076,538,538
10090,15623,1661,7563,1155,13962,1076,538,538
10095,15629,1661,7568,1155,13967,1078,539,539
10100,15640,1664,7576,1157,13976,1078,539,539
10105,15644,1664,7578,1157,13980,1078,539,539
10110,15654,1666,7583,1159,13988,1078,539,539
10115,15660,1666,7586,1159,13993,1080,540,540
10120,15671,1670,7594,1162,14001,1080,540,540
10125,15675,1672,7598,1164,14003,1080,540,540
10130,15685,1674,7603,1166,14011,1080,540,540
10135,15691,1674,7607,1166,14017,1082,542,540
10140,15702,1676,7610,1167,14026,1083,542,541
10145,15706,1676,7611,1167,14030,1083,542,541
10150,15716,1676,7616,1167,14040,1083,542,541
10155,15722,1676,7620,1167,14046,1084,543,541
10160,15733,1677,7626,1168,14056,1084,543,541
10165,15737,1677,7628,1168,14060,1084,543,541
10170,15747,1677,7633,1168,14070,1084,543,541
10175,15753,1677,7638,1168,14076,1085,544,541
10180,15764,1678,7643,1169,14086,1085,544,541
10185,15768,1678,7644,1169,14090,1085,544,541
10190,15778,1678,7649,1169,14100,1085,544,541
10195,15784,1678,7653,1169,14106,1086,545,541
10200,15795,1679,7658,1170,14116,1086,545,541
10205,15799,1679,7659,1170,14120,1086,545,541
10210,15809,1679,7661,1170,14130,1086,545,541
10215,15815,1679,7664,1170,14136,1087,545,542
10220,15826,1680,7673,1171,14146,1087,545,542
10225,15830,1680,7675,1171,14150,1087,545,542
10230,15840,1680,7680,1171,14160,1087,545,542
10235,15846,1680,7683,1171,14166,1088,545,543
10240,15857,1681,7689,1172,14176,1088,545,543
10245,15861,1681,7692,1172,14180,1088,545,543
10250,15871,1683,7699,1173,14188,1088,545,543
10255,15877,1683,7702,1173,14193,1089,545,544
10260,15888,1687,7705,1176,14201,1090,545,545
10265,15892,1687,7706,1176,14205,1090,545,545
10270,15902,1689,7710,1177,14213,1090,545,545
10275,15908,1689,7714,1177,14219,1092,546,546
10280,15919,1690,7718,1178,14229,1092,546,546
10285,15923,1690,7719,1178,14233,1092,546,546
10290,15933,1692,7722,1179,14241,1092,546,546
10295,15939,1692,7725,1179,14247,1094,546,548
10300,15950,1693,7730,1180,14257,1094,546,548
10305,15954,1693,7731,1180,14261,1094,546,548
10310,15964,1695,7736,1182,14269,1094,546,548
10315,15970,1695,7739,1182,14275,1096,547,549
10320,15981,1697,7747,1184,14284,1096,547,549
10325,15985,1697,7750,1184,14288,1096,547,549
10330,15995,1698,7758,1185,14297,1096,547,549
10335,16001,1698,7759,1185,14303,1098,547,551
10340,16012,1698,7767,1185,14314,1098,547,551
10345,16016,1698,7769,1185,14318,1098,547,551
10350,16026,1699,7776,1185,14327,1098,547,551
10355,16032,1699,7779,1185,14333,1099,548,551
10360,16043,1699,7783,1185,14344,1099,548,551
10365,16047,1700,7786,1186,14347,1099,548,551
10370,16057,1701,7793,1187,14356,1099,548,551
10375,16063,1701,7795,1187,14362,1100,548,552
10380,16074,1703,7800,1189,14370,1101,548,553
10385,16078,1704,7801,1190,14374,1101,548,553
10390,16088,1705,7808,1191,14383,1101,548,553
10395,16094,1705,7812,1191,14389,1102,549,553
10400,16105,1706,7818,1191,14399,1102,549,553
10405,16109,1706,7821,1191,14403,1102,549,553
10410,16119,1707,7825,1192,14412,1102,549,553
10415,16125,1707,7829,1192,14418,1103,550,553
10420,16136,1709,7839,1194,14427,1103,550,553
10425,16140,1709,7841,1194,14431,1103,550,553
10430,16150,1710,7847,1194,14440,1103,550,553
10435,16156,1710,7852,1194,14446,1104,551,553
10440,16167,1712,7857,1195,14455,1104,551,553
10445,16171,1712,7857,1195,14459,1104,551,553
10450,16181,1713,7861,1196,14468,1104,551,553
10455,16187,1713,7863,1196,14474,1105,551,554
10460,16198,1714,7866,1197,14484,1105,551,554
10465,16202,1715,7868,1198,14487,1105,551,554
10470,16212,1716,7873,1198,14496,1105,551,554
10475,16218,1716,7879,1198,14502,1107,553,554
10480,16229,1718,7884,1199,14511,1107,553,554
10485,16233,1718,7886,1199,14515,1107,553,554
10490,16243,1720,7890,1201,14523,1107,553,554
10495,16249,1720,7893,1201,14528,1109,554,555
10500,16260,1723,7899,1203,14536,1110,555,555
10505,16264,1724,7901,1204,14540,1110,555,555
10510,16274,1725,7904,1205,14549,1110,555,555
10515,16280,1725,7907,1205,14555,1111,555,556
10520,16291,1726,7912,1205,14565,1111,555,556
10525,16295,1727,7915,1206,14568,1111,555,556
10530,16305,1728,7920,1207,14577,1111,555,556
10535,16311,1728,7923,1207,14582,1112,556,556
10540,16322,1730,7930,1209,14592,1112,556,556
10545,16326,1731,7931,1210,14595,1112,556,556
10550,16336,1732,7937,1210,14604,1112,556,556
10555,16342,1732,7941,1210,14609,1113,557,556
10560,16353,1734,7944,1211,14618,1113,557,556
10565,16357,1735,7946,1212,14622,1113,557,556
10570,16367,1736,7951,1213,14631,1113,557,556
10575,16373,1736,7954,1213,14636,1114,558,556
10580,16384,1738,7959,1214,14646,1114,558,556
10585,16388,1738,7962,1214,14650,1114,558,556
10590,16398,1739,7967,1214,14659,1114,558,556
10595,16404,1739,7971,1214,14664,1115,559,556
10600,16415,1741,7977,1215,14674,1115,559,556
10605,16419,1742,7978,1216,14677,1115,559,556
10610,16429,1745,7985,1218,14684,1115,559,556
10615,16435,1745,7986,1218,14690,1117,560,557
10620,16446,1747,7990,1219,14699,1118,560,558
10625,16450,1747,7994,1219,14703,1118,560,558
10630,16460,1748,7998,1220,14712,1118,560,558
10635,16466,1748,8001,1220,14718,1119,560,559
10640,16477,1751,8007,1222,14726,1120,560,560
10645,16481,1751,8010,1222,14730,1120,560,560
10650,16491,1752,8013,1222,14739,1120,560,560
10655,16497,1752,8015,1222,14745,1121,560,561
10660,16508,1753,8019,1222,14755,1122,560,562
10665,16512,1753,8020,1222,14759,1122,560,562
10670,16522,1754,8027,1223,14768,1122,560,562
10675,16528,1754,8028,1223,14774,1123,560,563
10680,16539,1756,8032,1224,14783,1124,560,564
10685,16543,1756,8033,1224,14787,1124,560,564
10690,16553,1757,8040,1224,14796,1124,560,564
10695,16559,1757,8044,1224,14802,1125,561,564
10700,16570,1759,8048,1225,14811,1125,561,564
10705,16574,1760,8052,1226,14814,1125,561,564
10710,16584,1761,8054,1226,14823,1125,561,564
10715,16590,1761,8058,1226,14829,1126,561,565
10720,16601,1762,8060,1226,14839,1126,561,565
10725,16605,1762,8063,1226,14843,1126,561,565
10730,16615,1764,8068,1226,14851,1126,561,565
10735,16621,1764,8070,1226,14857,1127,562,565
10740,16632,1766,8075,1227,14866,1128,562,566
10745,16636,1767,8076,1228,14869,1128,562,566
10750,16646,1768,8082,1229,14878,1128,562,566
10755,16652,1768,8084,1229,14884,1130,562,568
10760,16663,1770,8090,1231,14892,1131,563,568
10765,16667,1771,8091,1232,14896,1131,563,568
10770,16677,1772,8096,1232,14905,1131,563,568
10775,16683,1772,8100,1232,14910,1132,563,569
10780,16694,1775,8105,1235,14919,1133,563,570
10785,16698,1775,8105,1235,14923,1133,563,570
10790,16708,1776,8108,1236,14932,1133,563,570
10795,16714,1776,8111,1236,14938,1134,563,571
10800,16725,1777,8114,1237,14947,1135,563,572
10805,16729,1778,8114,1238,14951,1135,563,572
10810,16739,1778,8118,1238,14961,1135,563,572
10815,16745,1778,8120,1238,14967,1136,563,573
10820,16756,1778,8125,1238,14978,1136,563,573
10825,16760,1778,8129,1238,14982,1136,563,573
10830,16770,1778,8131,1238,14992,1136,563,573
10835,16776,1778,8134,1238,14998,1137,563,574
10840,16787,1778,8139,1238,15009,1137,563,574
10845,16791,1778,8140,1238,15013,1137,563,574
10850,16801,1779,8145,1239,15022,1137,563,574
10855,16807,1779,8148,1239,15028,1138,563,575
10860,16818,1782,8154,1241,15036,1138,563,575
10865,16822,1783,8157,1242,15039,1138,563,575
10870,16832,1785,8162,1243,15047,1138,563,575
10875,16838,1785,8165,1243,15053,1139,563,576
10880,16849,1787,8169,1245,15062,1139,563,576
10885,16853,1789,8172,1247,15064,1139,563,576
10890,16863,1791,8175,1247,15072,1139,563,576
10895,16869,1791,8178,1247,15078,1140,564,576
10900,16880,1793,8183,1248,15087,1140,564,576
10905,16884,1794,8185,1249,15090,1140,564,576
10910,16894,1796,8191,1250,15098,1140,564,576
10915,16900,1796,8193,1250,15103,1141,564,577
10920,16911,1801,8200,1254,15110,1141,564,577
10925,16915,1801,8203,1254,15114,1141,564,577
10930,16925,1802,8208,1255,15123,1141,564,577
10935,16931,1802,8211,1255,15128,1142,565,577
10940,16942,1804,8215,1256,15138,1142,565,577
10945,16946,1804,8216,1256,15142,1142,565,577
10950,16956,1805,8221,1257,15151,1142,565,577
10955,16962,1805,8225,1257,15156,1143,565,578
10960,16973,1807,8229,1258,15166,1143,565,578
10965,16977,1807,8231,1258,15170,1143,565,578
10970,16987,1808,8236,1259,15179,1143,565,578
10975,16993,1808,8239,1259,15184,1145,567,578
10980,17004,1810,8244,1261,15194,1145,567,578
10985,17008,1810,8246,1261,15198,1145,567,578
10990,17018,1810,8251,1261,15208,1145,567,578
10995,17024,1810,8253,1261,15214,1146,567,579
11000,17035,1810,8258,1261,15225,1146,567,579
11005,17039,1810,8260,1261,15229,1146,567,579
11010,17049,1810,8266,1261,15239,1146,567,579
11015,17055,1810,8269,1261,15245,1147,568,579
11020,17066,1810,8276,1261,15256,1147,568,579
11025,17070,1810,8278,1261,15260,1147,568,579
11030,17080,1811,8284,1262,15269,1147,568,579
11035,17086,1811,8287,1262,15274,1148,569,579
11040,17097,1812,8293,1263,15285,1148,569,579
11045,17101,1812,8296,1263,15289,1148,569,579
11050,17111,1813,8302,1263,15298,1148,569,579
11055,17117,1813,8305,1263,15304,1150,570,580
11060,17128,1813,8310,1263,15315,1151,570,581
11065,17132,1813,8311,1263,15319,1151,570,581
11070,17142,1814,8315,1264,15328,1151,570,581
11075,17148,1814,8318,1264,15334,1152,570,582
11080,17159,1814,8322,1264,15345,1153,570,583
11085,17163,1814,8326,1264,15349,1153,570,583
11090,17173,1816,8333,1265,15357,1153,570,583
11095,17179,1816,8338,1265,15363,1154,571,583
11100,17190,1818,8343,1266,15371,1155,571,584
11105,17194,1820,8347,1268,15374,1155,571,584
11110,17204,1822,8350,1269,15382,1155,571,584
11115,17210,1822,8353,1269,15388,1156,572,584
11120,17221,1824,8356,1270,15397,1157,573,584
11125,17225,1825,8357,1271,15400,1157,573,584
11130,17235,1827,8362,1273,15408,1157,573,584
11135,17241,1827,8364,1273,15414,1158,574,584
11140,17252,1829,8369,1274,15423,1159,574,585
11145,17256,1830,8371,1275,15426,1159,574,585
11150,17266,1832,8372,1276,15434,1159,574,585
11155,17272,1832,8376,1276,15440,1160,575,585
11160,17283,1834,8380,1278,15449,1161,575,586
11165,17287,1835,8381,1279,15452,1161,575,586
11170,17297,1837,8386,1280,15460,1161,575,586
11175,17303,1837,8389,1280,15466,1162,575,587
11180,17314,1838,8394,1280,15476,1162,575,587
11185,17318,1839,8398,1281,15479,1162,575,587
11190,17328,1841,8404,1282,15487,1162,575,587
11195,17334,1841,8407,1282,15493,1163,575,588
11200,17345,1843,8411,1283,15502,1163,575,588
11205,17349,1843,8413,1283,15506,1163,575,588
11210,17359,1845,8417,1284,15514,1163,575,588
11215,17365,1845,8418,1284,15520,1164,576,588
11220,17376,1848,8421,1286,15528,1165,577,588
11225,17380,1848,8422,1286,15532,1165,577,588
11230,17390,1850,8425,1286,15540,1165,577,588
11235,17396,1850,8426,1286,15546,1166,577,589
11240,17407,1851,8432,1287,15556,1166,577,589
11245,17411,1851,8434,1287,15560,1166,577,589
11250,17421,1853,8441,1288,15568,1166,577,589
11255,17427,1853,8442,1288,15574,1167,577,590
11260,17438,1854,8448,1289,15584,1167,577,590
11265,17442,1854,8450,1289,15588,1167,577,590
11270,17452,1856,8455,1289,15596,1167,577,590
11275,17458,1856,8457,1289,15602,1168,577,591
11280,17469,1857,8461,1290,15612,1169,578,591
11285,17473,1857,8462,1290,15616,1169,578,591
11290,17483,1859,8469,1292,15624,1169,578,591
11295,17489,1859,8473,1292,15630,1170,579,591
11300,17500,1860,8476,1293,15640,1170,579,591
11305,17504,1860,8479,1293,15644,1170,579,591
11310,17514,1862,8485,1294,15652,1170,579,591
11315,17520,1862,8487,1294,15658,1171,580,591
11320,17531,1862,8490,1294,15669,1171,580,591
11325,17535,1862,8494,1294,15673,1171,580,591
11330,17545,1864,8499,1294,15681,1171,580,591
11335,17551,1864,8502,1294,15687,1172,581,591
11340,17562,1865,8506,1295,15697,1173,581,592
11345,17566,1865,8509,1295,15701,1173,581,592
11350,17576,1866,8515,1296,15710,1173,581,592
11355,17582,1866,8519,1296,15715,1174,582,592
11360,17593,1868,8523,1298,15725,1174,582,592
11365,17597,1868,8525,1298,15729,1174,582,592
11370,17607,1869,8532,1299,15738,1174,582,592
11375,17613,1869,8536,1299,15744,1175,583,592
11380,17624,1869,8539,1299,15755,1175,583,592
11385,17628,1869,8540,1299,15759,1175,583,592
11390,17638,1870,8545,1299,15768,1175,583,592
11395,17644,1870,8548,1299,15773,1176,584,592
11400,17655,1871,8556,1300,15784,1177,585,592
11405,17659,1871,8558,1300,15788,1177,585,592
11410,17669,1872,8562,1301,15797,1177,585,592
11415,17675,1872,8565,1301,15803,1178,585,593
11420,17686,1872,8571,1301,15814,1178,585,593
11425,17690,1872,8571,1301,15818,1178,585,593
11430,17700,1873,8574,1301,15827,1178,585,593
11435,17706,1873,8578,1301,15832,1179,586,593
11440,17717,1874,8583,1302,15843,1179,586,593
11445,17721,1874,8585,1302,15847,1179,586,593
11450,17731,1876,8590,1304,15855,1179,586,593
11455,17737,1876,8593,1304,15861,1180,586,594
11460,17748,1878,8597,1305,15869,1180,586,594
11465,17752,1879,8598,1306,15873,1180,586,594
11470,17762,1880,8603,1307,15882,1180,586,594
11475,17768,1880,8606,1307,15888,1181,586,595
11480,17779,1882,8611,1308,15897,1182,587,595
11485,17783,1882,8612,1308,15901,1182,587,595
11490,17793,1883,8617,1308,15910,1182,587,595
11495,17799,1883,8618,1308,15916,1183,587,596
11500,17810,1884,8624,1309,15926,1184,588,596
11505,17814,1884,8627,1309,15930,1184,588,596
11510,17824,1885,8631,1309,15939,1184,588,596
11515,17830,1885,8633,1309,15945,1185,588,597
11520,17841,1887,8638,1310,15954,1186,589,597
11525,17845,1888,8642,1311,15957,1186,589,597
11530,17855,1889,8646,1311,15966,1186,589,597
11535,17861,1889,8650,1311,15972,1188,590,598
11540,17872,1889,8655,1311,15983,1188,590,598
11545,17876,1889,8657,1311,15987,1188,590,598
11550,17886,1890,8663,1311,15996,1188,590,598
11555,17892,1890,8667,1311,16002,1190,592,598
11560,17903,1890,8674,1311,16013,1190,592,598
11565,17907,1890,8674,1311,16017,1190,592,598
11570,17917,1892,8678,1312,16025,1190,592,598
11575,17923,1892,8681,1312,16031,1192,593,599
11580,17934,1895,8688,1315,16038,1192,593,599
11585,17938,1897,8691,1317,16040,1192,593,599
11590,17948,1899,8695,1318,16049,1192,593,599
11595,17954,1899,8698,1318,16055,1193,594,599
11600,17965,1901,8705,1320,16063,1193,594,599
11605,17969,1903,8708,1322,16065,1193,594,599
11610,17979,1905,8713,1324,16074,1193,594,599
11615,17985,1905,8716,1324,16080,1194,595,599
11620,17996,1908,8723,1326,16087,1194,595,599
11625,18000,1910,8725,1328,16090,1194,595,599
11630,18010,1911,8730,1329,16099,1194,595,599
11635,18016,1911,8735,1329,16105,1195,596,599
11640,18027,1914,8743,1331,16112,1196,597,599
11645,18031,1915,8745,1332,16116,1196,597,599
11650,18041,1916,8750,1333,16125,1196,597,599
11655,18047,1916,8754,1333,16131,1197,597,600
11660,18058,1916,8759,1333,16142,1198,597,601
11665,18062,1916,8762,1333,16146,1198,597,601
11670,18072,1917,8769,1334,16155,1198,597,601
11675,18078,1917,8772,1334,16161,1199,598,601
11680,18089,1917,8774,1334,16172,1200,598,602
11685,18093,1917,8774,1334,16176,1200,598,602
11690,18103,1919,8777,1334,16184,1200,598,602
11695,18109,1919,8782,1334,16190,1201,599,602
11700,18120,1921,8786,1336,16199,1202,599,603
11705,18124,1921,8789,1336,16203,1202,599,603
11710,18134,1923,8793,1336,16211,1202,599,603
11715,18140,1923,8797,1336,16217,1203,599,604
11720,18151,1924,8802,1337,16227,1203,599,604
11725,18155,1924,8806,1337,16231,1203,599,604
11730,18165,1926,8809,1337,16239,1203,599,604
11735,18171,1926,8809,1337,16245,1204,599,605
11740,18182,1926,8815,1337,16256,1204,599,605
11745,18186,1926,8817,1337,16260,1204,599,605
11750,18196,1928,8823,1337,16268,1204,599,605
11755,18202,1928,8828,1337,16274,1205,600,605
11760,18213,1928,8832,1337,16285,1206,600,606
11765,18217,1929,8834,1338,16288,1206,600,606
11770,18227,1931,8840,1338,16296,1206,600,606
11775,18233,1931,8845,1338,16302,1207,601,606
11780,18244,1932,8850,1339,16312,1208,602,606
11785,18248,1933,8853,1340,16315,1208,602,606
11790,18258,1935,8858,1340,16323,1208,602,606
11795,18264,1935,8860,1340,16329,1209,602,607
11800,18275,1936,8867,1341,16339,1210,603,607
11805,18279,1936,8869,1341,16343,1210,603,607
11810,18289,1938,8872,1341,16351,1210,603,607
11815,18295,1938,8873,1341,16357,1211,604,607
11820,18306,1941,8878,1343,16364,1212,604,608
11825,18310,1942,8878,1344,16368,1212,604,608
11830,18320,1942,8884,1344,16378,1212,604,608
11835,18326,1942,8888,1344,16384,1213,605,608
11840,18337,1942,8893,1344,16395,1213,605,608
11845,18341,1942,8896,1344,16399,1213,605,608
11850,18351,1942,8900,1344,16409,1213,605,608
11855,18357,1942,8904,1344,16415,1214,606,608
11860,18368,1942,8910,1344,16426,1214,606,608
11865,18372,1942,8913,1344,16430,1214,606,608
11870,18382,1942,8918,1344,16440,1214,606,608
11875,18388,1942,8923,1344,16446,1215,607,608
11880,18399,1942,8930,1344,16457,1215,607,608
11885,18403,1942,8932,1344,16461,1215,607,608
11890,18413,1942,8938,1344,16471,1215,607,608
11895,18419,1942,8943,1344,16477,1216,608,608
11900,18430,1942,8950,1344,16488,1216,608,608
11905,18434,1942,8951,1344,16492,1216,608,608
11910,18444,1942,8956,1344,16502,1216,608,608
11915,18450,1942,8960,1344,16508,1217,608,609
11920,18461,1942,8967,1344,16519,1217,608,609
11925,18465,1942,8968,1344,16523,1217,608,609
11930,18475,1944,8971,1345,16531,1217,608,609
11935,18481,1944,8974,1345,16537,1219,609,610
11940,18492,1948,8978,1348,16544,1220,610,610
11945,18496,1948,8980,1348,16548,1220,610,610
11950,18506,1949,8985,1348,16557,1220,610,610
11955,18512,1949,8989,1348,16563,1221,611,610
11960,18523,1951,8993,1349,16572,1221,611,610
11965,18527,1951,8994,1349,16576,1221,611,610
11970,18537,1952,8999,1350,16585,1221,611,610
11975,18543,1952,9001,1350,16591,1222,611,611
11980,18554,1953,9005,1350,16601,1222,611,611
11985,18558,1953,9007,1350,16605,1222,611,611
11990,18568,1954,9014,1350,16614,1222,611,611
11995,18574,1954,9019,1350,16620,1223,612,611
12000,18585,1955,9025,1351,16630,1223,612,611
12005,18589,1956,9027,1352,16633,1223,612,611
12010,18599,1957,9032,1352,16642,1223,612,611
12015,18605,1957,9034,1352,16648,1224,612,612
12020,18616,1958,9038,1353,16658,1224,612,612
12025,18620,1958,9041,1353,16662,1224,612,612
12030,18630,1959,9044,1354,16671,1224,612,612
12035,18636,1959,9046,1354,16677,1225,613,612
12040,18647,1960,9053,1354,16687,1225,613,612
12045,18651,1961,9056,1355,16690,1225,613,612
12050,18661,1964,9060,1357,16697,1225,613,612
12055,18667,1964,9064,1357,16702,1226,614,612
12060,18678,1969,9072,1362,16709,1227,615,612
12065,18682,1969,9072,1362,16713,1227,615,612
12070,18692,1969,9076,1362,16723,1227,615,612
12075,18698,1969,9078,1362,16729,1228,615,613
12080,18709,1969,9082,1362,16740,1228,615,613
12085,18713,1969,9083,1362,16744,1228,615,613
12090,18723,1969,9088,1362,16754,1228,615,613
12095,18729,1969,9093,1362,16760,1229,616,613
12100,18740,1969,9101,1362,16771,1229,616,613
12105,18744,1969,9104,1362,16775,1229,616,613
12110,18754,1969,9109,1362,16785,1229,616,613
12115,18760,1969,9113,1362,16791,1230,616,614
12120,18771,1969,9115,1362,16802,1230,616,614
12125,18775,1969,9117,1362,16806,1230,616,614
12130,18785,1969,9119,1362,16816,1230,616,614
12135,18791,1969,9123,1362,16822,1231,617,614
12140,18802,1969,9132,1362,16833,1231,617,614
12145,18806,1969,9133,1362,16837,1231,617,614
12150,18816,1969,9137,1362,16847,1231,617,614
12155,18822,1969,9139,1362,16853,1232,617,615
12160,18833,1969,9142,1362,16864,1232,617,615
12165,18837,1969,9144,1362,16868,1232,617,615
12170,18847,1971,9152,1363,16876,1232,617,615
12175,18853,1971,9156,1363,16882,1233,618,615
12180,18864,1974,9162,1365,16890,1234,619,615
12185,18868,1975,9164,1366,16893,1234,619,615
12190,18878,1976,9172,1367,16902,1234,619,615
12195,18884,1976,9176,1367,16908,1235,620,615
12200,18895,1978,9179,1368,16917,1235,620,615
12205,18899,1978,9181,1368,16921,1235,620,615
12210,18909,1979,9189,1369,16930,1235,620,615
12215,18915,1979,9191,1369,16936,1236,620,616
12220,18926,1981,9195,1370,16945,1236,620,616
12225,18930,1982,9197,1371,16948,1236,620,616
12230,18940,1983,9201,1371,16957,1236,620,616
12235,18946,1983,9206,1371,16963,1237,620,617
12240,18957,1984,9209,1371,16973,1237,620,617
12245,18961,1985,9210,1372,16976,1237,620,617
12250,18971,1986,9217,1373,16985,1237,620,617
12255,18977,1986,9220,1373,16991,1238,620,618
12260,18988,1988,9226,1375,17000,1238,620,618
12265,18992,1988,9228,1375,17004,1238,620,618
12270,19002,1989,9230,1375,17013,1238,620,618
12275,19008,1989,9231,1375,17019,1239,620,619
12280,19019,1990,9236,1376,17029,1239,620,619
12285,19023,1991,9238,1377,17032,1239,620,619
12290,19033,1993,9243,1378,17040,1239,620,619
12295,19039,1993,9246,1378,17046,1241,622,619
12300,19050,1996,9252,1381,17054,1242,623,619
12305,19054,1996,9254,1381,17058,1242,623,619
12310,19064,1996,9256,1381,17068,1242,623,619
12315,19070,1996,9259,1381,17074,1243,623,620
12320,19081,1996,9266,1381,17085,1244,624,620
12325,19085,1996,9267,1381,17089,1244,624,620
12330,19095,1996,9276,1381,17099,1244,624,620
12335,19101,1996,9279,1381,17105,1245,624,621
12340,19112,1996,9283,1381,17116,1246,624,622
12345,19116,1996,9284,1381,17120,1246,624,622
12350,19126,1996,9292,1381,17130,1246,624,622
12355,19132,1996,9295,1381,17136,1247,624,623
12360,19143,1996,9302,1381,17147,1248,625,623
12365,19147,1996,9303,1381,17151,1248,625,623
12370,19157,1996,9306,1381,17161,1248,625,623
12375,19163,1996,9309,1381,17167,1249,625,624
12380,19174,1996,9312,1381,17178,1250,625,625
12385,19178,1996,9314,1381,17182,1250,625,625
12390,19188,1996,9321,1381,17192,1250,625,625
12395,19194,1996,9326,1381,17198,1251,625,626
12400,19205,1996,9333,1381,17209,1252,625,627
12405,19209,1996,9334,1381,17213,1252,625,627
12410,19219,1997,9339,1382,17222,1252,625,627
12415,19225,1997,9342,1382,17228,1254,626,628
12420,19236,1999,9346,1383,17237,1255,626,629
12425,19240,1999,9346,1383,17241,1255,626,629
12430,19250,2001,9350,1383,17249,1255,626,629
12435,19256,2001,9353,1383,17255,1257,627,630
12440,19267,2003,9358,1384,17264,1257,627,630
12445,19271,2003,9360,1384,17268,1257,627,630
12450,19281,2005,9365,1385,17276,1257,627,630
12455,19287,2005,9368,1385,17282,1259,628,631
12460,19298,2006,9371,1385,17292,1259,628,631
12465,19302,2007,9373,1386,17295,1259,628,631
12470,19312,2009,9377,1386,17303,1259,628,631
12475,19318,2009,9380,1386,17309,1261,628,633
12480,19329,2010,9385,1386,17319,1261,628,633
12485,19333,2010,9388,1386,17323,1261,628,633
12490,19343,2012,9394,1388,17331,1261,628,633
12495,19349,2012,9397,1388,17337,1262,628,634
12500,19360,2014,9402,1389,17346,1262,628,634
12505,19364,2014,9403,1389,17350,1262,628,634
12510,19374,2016,9409,1390,17358,1262,628,634
12515,19380,2016,9412,1390,17364,1263,628,635
12520,19391,2018,9417,1392,17373,1263,628,635
12525,19395,2018,9418,1392,17377,1263,628,635
12530,19405,2021,9423,1394,17384,1263,628,635
12535,19411,2021,9426,1394,17390,1264,628,636
12540,19422,2025,9433,1397,17396,1265,629,636
12545,19426,2026,9434,1398,17400,1265,629,636
12550,19436,2026,9439,1398,17410,1265,629,636
12555,19442,2026,9443,1398,17416,1266,630,636
12560,19453,2026,9449,1398,17427,1266,630,636
12565,19457,2026,9452,1398,17431,1266,630,636
12570,19467,2026,9456,1398,17441,1266,630,636
12575,19473,2026,9460,1398,17447,1267,630,637
12580,19484,2026,9464,1398,17458,1267,630,637
12585,19488,2026,9467,1398,17462,1267,630,637
12590,19498,2026,9472,1398,17472,1267,630,637
12595,19504,2026,9473,1398,17478,1269,630,639
12600,19515,2026,9478,1398,17489,1269,630,639
12605,19519,2026,9481,1398,17493,1269,630,639
12610,19529,2026,9487,1398,17503,1269,630,639
12615,19535,2026,9490,1398,17509,1271,632,639
12620,19546,2026,9496,1398,17520,1271,632,639
12625,19550,2026,9499,1398,17524,1271,632,639
12630,19560,2026,9502,1398,17534,1271,632,639
12635,19566,2026,9505,1398,17540,1273,633,640
12640,19577,2026,9510,1398,17551,1273,633,640
12645,19581,2026,9513,1398,17555,1273,633,640
12650,19591,2028,9517,1398,17563,1273,633,640
12655,19597,2028,9520,1398,17569,1275,634,641
12660,19608,2032,9525,1402,17576,1276,634,642
12665,19612,2032,9526,1402,17580,1276,634,642
12670,19622,2033,9529,1402,17589,1276,634,642
12675,19628,2033,9533,1402,17595,1278,636,642
12680,19639,2034,9540,1402,17605,1278,636,642
12685,19643,2035,9541,1403,17608,1278,636,642
12690,19653,2036,9544,1404,17617,1278,636,642
12695,19659,2036,9548,1404,17623,1280,637,643
12700,19670,2037,9554,1405,17633,1280,637,643
12705,19674,2038,9556,1406,17636,1280,637,643
12710,19684,2039,9559,1406,17645,1280,637,643
12715,19690,2039,9563,1406,17651,1282,639,643
12720,19701,2040,9570,1407,17661,1282,639,643
12725,19705,2040,9571,1407,17665,1282,639,643
12730,19715,2041,9577,1408,17674,1282,639,643
12735,19721,2041,9578,1408,17680,1283,639,644
12740,19732,2042,9585,1408,17690,1283,639,644
12745,19736,2043,9587,1409,17693,1283,639,644
12750,19746,2044,9595,1410,17702,1283,639,644
12755,19752,2044,9599,1410,17708,1284,640,644
12760,19763,2046,9604,1411,17717,1284,640,644
12765,19767,2046,9605,1411,17721,1284,640,644
12770,19777,2048,9610,1413,17728,1284,640,644
12775,19783,2049,9613,1414,17734,1285,641,644
12780,19794,2051,9617,1415,17742,1286,641,645
12785,19798,2052,9620,1416,17746,1286,641,645
12790,19808,2052,9627,1416,17756,1286,641,645
12795,19814,2052,9630,1416,17762,1288,642,646
12800,19825,2052,9634,1416,17773,1288,642,646
12805,19829,2052,9636,1416,17777,1288,642,646
12810,19839,2052,9641,1416,17787,1288,642,646
12815,19845,2052,9645,1416,17793,1290,643,647
12820,19856,2052,9651,1416,17804,1290,643,647
12825,19860,2052,9653,1416,17808,1290,643,647
12830,19870,2052,9659,1416,17818,1290,643,647
12835,19876,2052,9662,1416,17824,1291,644,647
12840,19887,2052,9666,1416,17835,1291,644,647
12845,19891,2052,9669,1416,17839,1291,644,647
12850,19901,2052,9674,1416,17849,1291,644,647
12855,19907,2052,9676,1416,17855,1292,644,648
12860,19918,2052,9680,1416,17866,1292,644,648
12865,19922,2052,9682,1416,17870,1292,644,648
12870,19932,2052,9686,1416,17880,1292,644,648
12875,19938,2052,9689,1416,17886,1293,645,648
12880,19949,2052,9693,1416,17897,1293,645,648
12885,19953,2052,9696,1416,17901,1293,645,648
12890,19963,2054,9698,1416,17909,1293,645,648
12895,19969,2054,9701,1416,17914,1294,646,648
12900,19980,2057,9707,1419,17923,1295,647,648
12905,19984,2057,9709,1419,17927,1295,647,648
12910,19994,2058,9711,1419,17936,1295,647,648
12915,20000,2058,9714,1419,17942,1297,649,648
12920,20011,2059,9720,1420,17952,1297,649,648
12925,20015,2060,9722,1421,17955,1297,649,648
12930,20025,2061,9728,1422,17964,1297,649,648
12935,20031,2061,9730,1422,17970,1299,650,649
12940,20042,2062,9735,1422,17980,1299,650,649
12945,20046,2062,9737,1422,17984,1299,650,649
12950,20056,2063,9743,1423,17993,1299,650,649
12955,20062,2063,9748,1423,17999,1301,651,650
12960,20073,2064,9754,1424,18009,1301,651,650
12965,20077,2065,9756,1425,18012,1301,651,650
12970,20087,2066,9762,1425,18021,1301,651,650
12975,20093,2066,9765,1425,18027,1302,651,651
12980,20104,2067,9772,1425,18037,1302,651,651
12985,20108,2068,9773,1426,18040,1302,651,651
12990,20118,2069,9774,1426,18049,1302,651,651
12995,20124,2069,9777,1426,18055,1303,652,651
13000,20135,2070,9781,1426,18065,1303,652,651
13005,20139,2071,9784,1427,18067,1303,652,651
13010,20149,2074,9787,1428,18075,1303,652,651
13015,20155,2074,9790,1428,18081,1304,653,651
13020,20166,2077,9794,1430,18089,1305,653,652
13025,20170,2077,9794,1430,18093,1305,653,652
13030,20180,2078,9799,1431,18102,1305,653,652
13035,20186,2078,9802,1431,18108,1306,654,652
13040,20197,2079,9808,1432,18118,1306,654,652
13045,20201,2079,9810,1432,18122,1306,654,652
13050,20211,2080,9814,1433,18131,1306,654,652
13055,20217,2080,9818,1433,18137,1307,655,652
13060,20228,2081,9822,1434,18147,1307,655,652
13065,20232,2081,9824,1434,18151,1307,655,652
13070,20242,2082,9829,1434,18160,1307,655,652
13075,20248,2082,9831,1434,18166,1308,655,653
13080,20259,2083,9836,1435,18176,1308,655,653
13085,20263,2083,9836,1435,18180,1308,655,653
13090,20273,2084,9841,1435,18189,1308,655,653
13095,20279,2084,9844,1435,18195,1309,656,653
13100,20290,2084,9846,1435,18206,1309,656,653
13105,20294,2084,9846,1435,18210,1309,656,653
13110,20304,2085,9851,1435,18219,1309,656,653
13115,20310,2085,9855,1435,18225,1310,657,653
13120,20321,2085,9858,1435,18236,1310,657,653
13125,20325,2085,9861,1435,18240,1310,657,653
13130,20335,2088,9867,1438,18246,1310,657,653
13135,20341,2089,9869,1439,18252,1312,658,654
13140,20352,2090,9873,1440,18261,1313,658,655
13145,20356,2091,9874,1441,18265,1313,658,655
13150,20366,2092,9879,1442,18274,1313,658,655
13155,20372,2092,9883,1442,18280,1314,659,655
13160,20383,2093,9890,1442,18290,1314,659,655
13165,20387,2094,9892,1443,18293,1314,659,655
13170,20397,2095,9899,1443,18302,1314,659,655
13175,20403,2095,9900,1443,18308,1315,659,656
13180,20414,2096,9906,1443,18318,1315,659,656
13185,20418,2097,9907,1444,18321,1315,659,656
13190,20428,2098,9912,1444,18330,1315,659,656
13195,20434,2098,9915,1444,18336,1316,659,657
13200,20445,2099,9920,1444,18346,1316,659,657
13205,20449,2099,9922,1444,18350,1316,659,657
13210,20459,2100,9924,1444,18359,1316,659,657
13215,20465,2100,9929,1444,18364,1317,659,658
13220,20476,2102,9934,1446,18374,1317,659,658
13225,20480,2102,9936,1446,18378,1317,659,658
13230,20490,2103,9941,1447,18387,1317,659,658
13235,20496,2103,9946,1447,18393,1318,660,658
13240,20507,2104,9951,1447,18403,1318,660,658
13245,20511,2104,9952,1447,18407,1318,660,658
13250,20521,2106,9958,1448,18415,1318,660,658
13255,20527,2106,9962,1448,18420,1319,661,658
13260,20538,2109,9964,1450,18429,1320,661,659
13265,20542,2109,9966,1450,18433,1320,661,659
13270,20552,2110,9972,1451,18442,1320,661,659
13275,20558,2110,9973,1451,18448,1322,661,661
13280,20569,2112,9978,1453,18457,1322,661,661
13285,20573,2112,9980,1453,18461,1322,661,661
13290,20583,2113,9984,1453,18470,1322,661,661
13295,20589,2113,9985,1453,18476,1324,662,662
13300,20600,2116,9992,1456,18484,1324,662,662
13305,20604,2116,9995,1456,18488,1324,662,662
13310,20614,2117,10005,1457,18497,1324,662,662
13315,20620,2117,10009,1457,18503,1326,663,663
13320,20631,2120,10016,1460,18511,1326,663,663
13325,20635,2120,10018,1460,18515,1326,663,663
13330,20645,2121,10021,1460,18524,1326,663,663
13335,20651,2121,10023,1460,18530,1327,664,663
13340,20662,2121,10029,1460,18541,1327,664,663
13345,20666,2121,10031,1460,18545,1327,664,663
13350,20676,2123,10036,1461,18553,1327,664,663
13355,20682,2123,10039,1461,18559,1328,664,664
13360,20693,2124,10043,1462,18569,1328,664,664
13365,20697,2124,10044,1462,18573,1328,664,664
13370,20707,2126,10049,1463,18581,1328,664,664
13375,20713,2126,10050,1463,18586,1329,664,665
13380,20724,2128,10054,1465,18596,1330,664,666
13385,20728,2128,10055,1465,18600,1330,664,666
13390,20738,2128,10062,1465,18610,1330,664,666
13395,20744,2128,10067,1465,18616,1332,666,666
13400,20755,2128,10070,1465,18627,1332,666,666
13405,20759,2128,10072,1465,18631,1332,666,666
13410,20769,2128,10078,1465,18641,1332,666,666
13415,20775,2128,10079,1465,18647,1333,666,667
13420,20786,2128,10083,1465,18658,1333,666,667
13425,20790,2128,10085,1465,18662,1333,666,667
13430,20800,2128,10091,1465,18672,1333,666,667
13435,20806,2128,10094,1465,18678,1334,667,667
13440,20817,2128,10101,1465,18689,1334,667,667
13445,20821,2128,10103,1465,18693,1334,667,667
13450,20831,2128,10108,1465,18703,1334,667,667
13455,20837,2128,10112,1465,18709,1335,668,667
13460,20848,2128,10119,1465,18720,1335,668,667
13465,20852,2128,10121,1465,18724,1335,668,667
13470,20862,2128,10126,1465,18734,1335,668,667
13475,20868,2128,10129,1465,18740,1336,669,667
13480,20879,2128,10133,1465,18751,1336,669,667
13485,20883,2128,10134,1465,18755,1336,669,667
13490,20893,2130,10138,1466,18763,1336,669,667
13495,20899,2130,10141,1466,18768,1337,669,668
13500,20910,2135,10149,1471,18775,1338,670,668
13505,20914,2136,10152,1472,18778,1338,670,668
13510,20924,2137,10155,1473,18787,1338,670,668
13515,20930,2137,10157,1473,18793,1340,671,669
13520,20941,2139,10163,1475,18802,1340,671,669
13525,20945,2139,10163,1475,18806,1340,671,669
13530,20955,2140,10168,1476,18815,1340,671,669
13535,20961,2140,10169,1476,18821,1341,671,670
13540,20972,2141,10175,1476,18831,1341,671,670
13545,20976,2141,10177,1476,18835,1341,671,670
13550,20986,2142,10181,1476,18844,1341,671,670
13555,20992,2142,10184,1476,18850,1342,671,671
13560,21003,2143,10189,1477,18860,1342,671,671
13565,21007,2144,10192,1478,18863,1342,671,671
13570,21017,2145,10193,1478,18872,1342,671,671
13575,21023,2145,10196,1478,18878,1343,671,672
13580,21034,2146,10200,1478,18888,1343,671,672
13585,21038,2147,10201,1479,18891,1343,671,672
13590,21048,2148,10207,1480,18900,1343,671,672
13595,21054,2148,10211,1480,18906,1344,672,672
13600,21065,2149,10216,1481,18916,1344,672,672
13605,21069,2149,10216,1481,18920,1344,672,672
13610,21079,2151,10221,1482,18928,1344,672,672
13615,21085,2151,10225,1482,18933,1345,672,673
13620,21096,2155,10230,1486,18941,1346,673,673
13625,21100,2155,10231,1486,18945,1346,673,673
13630,21110,2156,10235,1486,18954,1346,673,673
13635,21116,2156,10239,1486,18960,1347,674,673
13640,21127,2156,10244,1486,18971,1347,674,673
13645,21131,2156,10247,1486,18975,1347,674,673
13650,21141,2157,10252,1487,18984,1347,674,673
13655,21147,2157,10253,1487,18990,1348,674,674
13660,21158,2157,10259,1487,19001,1348,674,674
13665,21162,2157,10260,1487,19005,1348,674,674
13670,21172,2158,10263,1487,19014,1348,674,674
13675,21178,2158,10266,1487,19019,1349,674,675
13680,21189,2159,10272,1488,19030,1349,674,675
13685,21193,2159,10272,1488,19034,1349,674,675
13690,21203,2160,10276,1488,19043,1349,674,675
13695,21209,2160,10279,1488,19048,1350,675,675
13700,21220,2161,10286,1489,19059,1350,675,675
13705,21224,2161,10289,1489,19063,1350,675,675
13710,21234,2162,10296,1490,19072,1350,675,675
13715,21240,2162,10299,1490,19078,1351,676,675
13720,21251,2162,10306,1490,19089,1351,676,675
13725,21255,2162,10308,1490,19093,1351,676,675
13730,21265,2164,10314,1492,19101,1351,676,675
13735,21271,2164,10316,1492,19107,1353,676,677
13740,21282,2165,10317,1492,19117,1354,676,678
13745,21286,2165,10320,1492,19121,1354,676,678
13750,21296,2166,10327,1493,19130,1354,676,678
13755,21302,2166,10327,1493,19136,1355,676,679
13760,21313,2168,10333,1495,19145,1355,676,679
13765,21317,2168,10333,1495,19149,1355,676,679
13770,21327,2169,10335,1495,19158,1355,676,679
13775,21333,2169,10339,1495,19164,1356,677,679
13780,21344,2171,10346,1496,19173,1356,677,679
13785,21348,2171,10348,1496,19177,1356,677,679
13790,21358,2172,10351,1497,19186,1356,677,679
13795,21364,2172,10355,1497,19192,1357,678,679
13800,21375,2174,10360,1498,19201,1357,678,679
13805,21379,2174,10362,1498,19205,1357,678,679
13810,21389,2175,10367,1498,19214,1357,678,679
13815,21395,2175,10371,1498,19220,1358,679,679
13820,21406,2177,10377,1499,19229,1358,679,679
13825,21410,2177,10378,1499,19233,1358,679,679
13830,21420,2178,10382,1499,19242,1358,679,679
13835,21426,2178,10383,1499,19248,1359,679,680
13840,21437,2180,10391,1500,19257,1359,679,680
13845,21441,2180,10391,1500,19261,1359,679,680
13850,21451,2184,10398,1504,19267,1359,679,680
13855,21457,2184,10401,1504,19273,1361,681,680
13860,21468,2189,10409,1508,19278,1362,682,680
13865,21472,2190,10412,1509,19282,1362,682,680
13870,21482,2190,10419,1509,19292,1362,682,680
13875,21488,2190,10421,1509,19298,1363,683,680
13880,21499,2190,10424,1509,19309,1363,683,680
13885,21503,2190,10427,1509,19313,1363,683,680
13890,21513,2190,10429,1509,19323,1363,683,680
13895,21519,2190,10431,1509,19329,1364,683,681
13900,21530,2190,10438,1509,19340,1364,683,681
13905,21534,2190,10440,1509,19344,1364,683,681
13910,21544,2190,10443,1509,19354,1364,683,681
13915,21550,2190,10447,1509,19360,1365,684,681
13920,21561,2190,10452,1509,19371,1365,684,681
13925,21565,2190,10454,1509,19375,1365,684,681
13930,21575,2190,10462,1509,19385,1365,684,681
13935,21581,2190,10465,1509,19391,1366,685,681
13940,21592,2190,10472,1509,19402,1366,685,681
13945,21596,2190,10473,1509,19406,1366,685,681
13950,21606,2190,10479,1509,19416,1366,685,681
13955,21612,2190,10484,1509,19422,1367,686,681
13960,21623,2190,10490,1509,19433,1367,686,681
13965,21627,2190,10491,1509,19437,1367,686,681
13970,21637,2192,10494,1510,19445,1367,686,681
13975,21643,2192,10499,1510,19450,1369,688,681
13980,21654,2196,10506,1514,19457,1370,688,682
13985,21658,2198,10508,1516,19460,1370,688,682
13990,21668,2199,10514,1517,19469,1370,688,682
13995,21674,2199,10516,1517,19475,1371,689,682
14000,21685,2200,10521,1517,19485,1371,689,682
14005,21689,2201,10524,1518,19488,1371,689,682
14010,21699,2202,10528,1519,19497,1371,689,682
14015,21705,2202,10533,1519,19503,1372,690,682
14020,21716,2204,10537,1521,19512,1372,690,682
14025,21720,2205,10540,1522,19515,1372,690,682
14030,21730,2206,10543,1523,19524,1372,690,682
14035,21736,2206,10545,1523,19530,1373,690,683
14040,21747,2208,10550,1524,19539,1373,690,683
14045,21751,2208,10550,1524,19543,1373,690,683
14050,21761,2209,10556,1525,19552,1373,690,683
14055,21767,2209,10559,1525,19558,1374,691,683
14060,21778,2211,10565,1527,19567,1374,691,683
14065,21782,2211,10566,1527,19571,1374,691,683
14070,21792,2212,10570,1527,19580,1374,691,683
14075,21798,2212,10572,1527,19586,1375,692,683
14080,21809,2213,10575,1527,19596,1375,692,683
14085,21813,2213,10575,1527,19600,1375,692,683
14090,21823,2215,10581,1528,19608,1375,692,683
14095,21829,2215,10585,1528,19613,1377,693,684
14100,21840,2220,10593,1533,19619,1378,694,684
14105,21844,2221,10597,1534,19623,1378,694,684
14110,21854,2221,10603,1534,19633,1378,694,684
14115,21860,2221,10606,1534,19639,1379,694,685
14120,21871,2221,10612,1534,19650,1379,694,685
14125,21875,2221,10612,1534,19654,1379,694,685
14130,21885,2221,10619,1534,19664,1379,694,685
14135,21891,2221,10623,1534,19670,1380,694,686
14140,21902,2221,10629,1534,19681,1380,694,686
14145,21906,2221,10629,1534,19685,1380,694,686
14150,21916,2221,10635,1534,19695,1380,694,686
14155,21922,2221,10639,1534,19701,1381,695,686
14160,21933,2221,10645,1534,19712,1381,695,686
14165,21937,2221,10648,1534,19716,1381,695,686
14170,21947,2221,10653,1534,19726,1381,695,686
14175,21953,2221,10657,1534,19732,1382,696,686
14180,21964,2221,10661,1534,19743,1382,696,686
14185,21968,2221,10663,1534,19747,1382,696,686
14190,21978,2221,10667,1534,19757,1382,696,686
14195,21984,2221,10671,1534,19763,1383,697,686
14200,21995,2221,10675,1534,19774,1383,697,686
14205,21999,2221,10676,1534,19778,1383,697,686
14210,22009,2223,10681,1535,19786,1383,697,686
14215,22015,2223,10685,1535,19791,1385,697,688
14220,22026,2226,10689,1537,19800,1386,698,688
14225,22030,2226,10691,1537,19804,1386,698,688
14230,22040,2228,10695,1537,19812,1386,698,688
14235,22046,2228,10697,1537,19818,1387,698,689
14240,22057,2231,10703,1539,19825,1388,699,689
14245,22061,2232,10705,1540,19829,1388,699,689
14250,22071,2234,10709,1540,19837,1388,699,689
14255,22077,2234,10710,1540,19843,1389,699,690
14260,22088,2236,10715,1541,19852,1390,700,690
14265,22092,2236,10718,1541,19855,1390,700,690
14270,22102,2239,10721,1543,19863,1390,700,690
14275,22108,2239,10724,1543,19869,1391,701,690
14280,22119,2242,10731,1545,19876,1392,701,691
14285,22123,2243,10733,1546,19880,1392,701,691
14290,22133,2244,10736,1546,19889,1392,701,691
14295,22139,2244,10738,1546,19895,1393,701,692
14300,22150,2245,10741,1546,19905,1394,701,693
14305,22154,2245,10742,1546,19909,1394,701,693
14310,22164,2246,10747,1546,19918,1394,701,693
14315,22170,2246,10749,1546,19924,1395,701,694
14320,22181,2247,10754,1546,19934,1396,702,694
14325,22185,2247,10756,1546,19938,1396,702,694
14330,22195,2248,10759,1546,19947,1396,702,694
14335,22201,2248,10761,1546,19953,1398,702,696
14340,22212,2251,10768,1548,19961,1399,703,696
14345,22216,2251,10768,1548,19965,1399,703,696
14350,22226,2251,10772,1548,19975,1399,703,696
14355,22232,2251,10776,1548,19981,1400,704,696
14360,22243,2251,10779,1548,19992,1401,704,697
14365,22247,2251,10781,1548,19996,1401,704,697
14370,22257,2251,10785,1548,20006,1401,704,697
14375,22263,2251,10787,1548,20012,1402,704,698
14380,22274,2251,10793,1548,20023,1402,704,698
14385,22278,2251,10796,1548,20027,1402,704,698
14390,22288,2251,10801,1548,20037,1402,704,698
14395,22294,2251,10801,1548,20043,1403,704,699
14400,22305,2251,10805,1548,20054,1403,704,699
14405,22309,2251,10807,1548,20058,1403,704,699
14410,22319,2251,10812,1548,20068,1403,704,699
14415,22325,2251,10816,1548,20074,1404,705,699
14420,22336,2251,10821,1548,20085,1404,705,699
14425,22340,2251,10822,1548,20089,1404,705,699
14430,22350,2251,10826,1548,20099,1404,705,699
14435,22356,2251,10828,1548,20105,1405,706,699
14440,22367,2251,10832,1548,20116,1405,706,699
14445,22371,2251,10834,1548,20120,1405,706,699
14450,22381,2253,10841,1549,20128,1405,706,699
14455,22387,2253,10844,1549,20134,1407,706,701
14460,22398,2257,10852,1553,20140,1407,706,701
14465,22402,2259,10854,1555,20143,1407,706,701
14470,22412,2261,10859,1555,20151,1407,706,701
14475,22418,2261,10861,1555,20157,1408,706,702
14480,22429,2262,10867,1556,20167,1408,706,702
14485,22433,2262,10868,1556,20171,1408,706,702
14490,22443,2264,10873,1556,20179,1408,706,702
14495,22449,2264,10877,1556,20185,1409,707,702
14500,22460,2265,10882,1557,20195,1409,707,702
14505,22464,2265,10883,1557,20199,1409,707,702
14510,22474,2267,10888,1558,20207,1409,707,702
14515,22480,2267,10890,1558,20213,1410,707,703
14520,22491,2267,10894,1558,20224,1410,707,703
14525,22495,2267,10895,1558,20228,1410,707,703
14530,22505,2269,10899,1558,20236,1410,707,703
14535,22511,2269,10903,1558,20242,1411,707,704
14540,22522,2269,10908,1558,20253,1411,707,704
14545,22526,2269,10908,1558,20257,1411,707,704
14550,22536,2271,10912,1559,20265,1411,707,704
14555,22542,2271,10917,1559,20271,1412,708,704
14560,22553,2271,10923,1559,20282,1412,708,704
14565,22557,2271,10924,1559,20286,1412,708,704
14570,22567,2273,10930,1560,20294,1412,708,704
14575,22573,2273,10934,1560,20299,1414,708,706
14580,22584,2276,10940,1563,20308,1414,708,706
14585,22588,2276,10944,1563,20312,1414,708,706
14590,22598,2276,10947,1563,20322,1414,708,706
14595,22604,2276,10950,1563,20328,1416,709,707
14600,22615,2278,10953,1564,20337,1416,709,707
14605,22619,2278,10955,1564,20341,1416,709,707
14610,22629,2278,10962,1564,20351,1416,709,707
14615,22635,2278,10966,1564,20357,1417,710,707
14620,22646,2281,10972,1566,20364,1418,711,707
14625,22650,2282,10974,1567,20368,1418,711,707
14630,22660,2282,10976,1567,20378,1418,711,707
14635,22666,2282,10981,1567,20384,1419,712,707
14640,22677,2284,10987,1569,20392,1420,712,708
14645,22681,2285,10988,1570,20396,1420,712,708
14650,22691,2285,10993,1570,20406,1420,712,708
14655,22697,2285,10995,1570,20412,1421,712,709
14660,22708,2285,11001,1570,20423,1422,712,710
14665,22712,2285,11003,1570,20427,1422,712,710
14670,22722,2285,11007,1570,20437,1422,712,710
14675,22728,2285,11009,1570,20443,1423,713,710
14680,22739,2285,11015,1570,20454,1423,713,710
14685,22743,2285,11017,1570,20458,1423,713,710
14690,22753,2287,11022,1571,20466,1423,713,710
14695,22759,2287,11026,1571,20471,1424,714,710
14700,22770,2288,11032,1572,20481,1425,715,710
14705,22774,2289,11033,1573,20485,1425,715,710
14710,22784,2291,11037,1575,20493,1425,715,710
14715,22790,2291,11040,1575,20499,1427,716,711
14720,22801,2291,11046,1575,20510,1427,716,711
14725,22805,2291,11048,1575,20514,1427,716,711
14730,22815,2293,11053,1575,20522,1427,716,711
14735,22821,2293,11056,1575,20528,1428,716,712
14740,22832,2293,11062,1575,20539,1428,716,712
14745,22836,2293,11065,1575,20543,1428,716,712
14750,22846,2295,11067,1576,20551,1428,716,712
14755,22852,2295,11071,1576,20557,1429,716,713
14760,22863,2295,11078,1576,20568,1429,716,713
14765,22867,2295,11080,1576,20572,1429,716,713
14770,22877,2297,11086,1578,20580,1429,716,713
14775,22883,2297,11091,1578,20586,1430,717,713
14780,22894,2298,11096,1579,20596,1430,717,713
14785,22898,2299,11098,1580,20599,1430,717,713
14790,22908,2301,11104,1582,20607,1430,717,713
14795,22914,2301,11106,1582,20613,1431,717,714
14800,22925,2302,11112,1583,20623,1431,717,714
14805,22929,2303,11114,1584,20626,1431,717,714
14810,22939,2305,11120,1586,20634,1431,717,714
14815,22945,2305,11124,1586,20640,1432,718,714
14820,22956,2308,11131,1588,20648,1433,719,714
14825,22960,2309,11133,1589,20651,1433,719,714
14830,22970,2311,11135,1590,20659,1433,719,714
14835,22976,2311,11138,1590,20665,1435,720,715
14840,22987,2313,11145,1592,20674,1435,720,715
14845,22991,2314,11147,1593,20677,1435,720,715
14850,23001,2316,11151,1594,20685,1435,720,715
14855,23007,2316,11153,1594,20691,1436,721,715
14860,23018,2318,11161,1596,20700,1436,721,715
14865,23022,2319,11164,1597,20703,1436,721,715
14870,23032,2321,11168,1598,20711,1436,721,715
14875,23038,2321,11171,1598,20716,1437,722,715
14880,23049,2324,11175,1601,20725,1437,722,715
14885,23053,2324,11177,1601,20729,1437,722,715
14890,23063,2325,11182,1602,20738,1437,722,715
14895,23069,2325,11184,1602,20743,1438,722,716
14900,23080,2326,11190,1603,20754,1438,722,716
14905,23084,2326,11190,1603,20758,1438,722,716
14910,23094,2327,11196,1603,20767,1438,722,716
14915,23100,2327,11199,1603,20772,1439,722,717
14920,23111,2328,11207,1604,20782,1439,722,717
14925,23115,2329,11208,1605,20786,1439,722,717
14930,23125,2330,11213,1605,20795,1439,722,717
14935,23131,2330,11214,1605,20801,1440,722,718
14940,23142,2331,11219,1606,20810,1441,722,719
14945,23146,2332,11221,1607,20814,1441,722,719
14950,23156,2332,11226,1607,20824,1441,722,719
14955,23162,2332,11230,1607,20830,1443,723,720
14960,23173,2332,11234,1607,20841,1444,723,721
14965,23177,2332,11235,1607,20845,1444,723,721
14970,23187,2332,11238,1607,20855,1444,723,721
14975,23193,2332,11240,1607,20861,1446,724,722
14980,23204,2332,11243,1607,20872,1447,724,723
14985,23208,2332,11245,1607,20876,1447,724,723
14990,23218,2333,11252,1608,20885,1447,724,723
14995,23224,2333,11256,1608,20891,1449,725,724
15000,23235,2333,11259,1608,20902,1450,725,725
15005,23239,2333,11259,1608,20906,1450,725,725
15010,23249,2334,11261,1608,20915,1450,725,725
15015,23255,2334,11265,1608,20921,1452,727,725
15020,23266,2337,11273,1610,20929,1453,728,725
15025,23270,2337,11276,1610,20933,1453,728,725
15030,23280,2338,11282,1611,20942,1453,728,725
15035,23286,2338,11286,1611,20948,1455,729,726
15040,23297,2339,11291,1612,20958,1456,730,726
15045,23301,2339,11294,1612,20962,1456,730,726
15050,23311,2340,11296,1612,20971,1456,730,726
15055,23317,2340,11297,1612,20977,1458,730,728
15060,23328,2342,11304,1614,20986,1459,731,728
15065,23332,2342,11307,1614,20990,1459,731,728
15070,23342,2343,11312,1614,20999,1459,731,728
15075,23348,2343,11315,1614,21005,1460,731,729
15080,23359,2344,11319,1614,21015,1460,731,729
15085,23363,2344,11321,1614,21019,1460,731,729
15090,23373,2345,11324,1614,21028,1460,731,729
15095,23379,2345,11325,1614,21034,1461,731,730
15100,23390,2347,11331,1615,21043,1461,731,730
15105,23394,2347,11332,1615,21047,1461,731,730
15110,23404,2349,11335,1616,21055,1461,731,730
15115,23410,2349,11338,1616,21061,1462,732,730
15120,23421,2350,11345,1616,21071,1462,732,730
15125,23425,2350,11346,1616,21075,1462,732,730
15130,23435,2352,11353,1618,21083,1462,732,730
15135,23441,2352,11357,1618,21089,1463,732,731
15140,23452,2354,11363,1619,21098,1463,732,731
15145,23456,2354,11364,1619,21102,1463,732,731
15150,23466,2356,11367,1619,21110,1463,732,731
15155,23472,2356,11370,1619,21116,1464,733,731
15160,23483,2357,11376,1620,21126,1464,733,731
15165,23487,2357,11378,1620,21130,1464,733,731
15170,23497,2359,11384,1620,21138,1464,733,731
15175,23503,2359,11386,1620,21144,1466,734,732
15180,23514,2360,11392,1621,21154,1467,734,733
15185,23518,2360,11395,1621,21158,1467,734,733
15190,23528,2362,11400,1621,21166,1467,734,733
15195,23534,2362,11403,1621,21172,1468,734,734
15200,23545,2362,11409,1621,21183,1468,734,734
15205,23549,2362,11411,1621,21187,1468,734,734
15210,23559,2364,11418,1622,21195,1468,734,734
15215,23565,2364,11421,1622,21201,1469,734,735
15220,23576,2364,11424,1622,21212,1469,734,735
15225,23580,2364,11425,1622,21216,1469,734,735
15230,23590,2366,11430,1623,21224,1469,734,735
15235,23596,2366,11435,1623,21230,1470,735,735
15240,23607,2366,11439,1623,21241,1470,735,735
15245,23611,2366,11441,1623,21245,1470,735,735
15250,23621,2368,11446,1623,21253,1470,735,735
15255,23627,2368,11448,1623,21259,1471,735,736
15260,23638,2369,11454,1624,21269,1471,735,736
15265,23642,2369,11457,1624,21273,1471,735,736
15270,23652,2371,11462,1625,21281,1471,735,736
15275,23658,2371,11463,1625,21287,1472,736,736
15280,23669,2371,11468,1625,21298,1472,736,736
15285,23673,2372,11470,1626,21301,1472,736,736
15290,23683,2375,11473,1627,21308,1472,736,736
15295,23689,2375,11475,1627,21314,1474,738,736
15300,23700,2377,11481,1629,21322,1475,738,737
15305,23704,2377,11482,1629,21327,1475,738,737
15310,23714,2378,11488,1629,21336,1475,738,737
15315,23720,2378,11491,1629,21342,1476,738,738
15320,23731,2379,11495,1630,21352,1476,738,738
15325,23735,2379,11495,1630,21356,1476,738,738
15330,23745,2380,11500,1630,21365,1476,738,738
15335,23751,2380,11502,1630,21371,1477,738,739
15340,23762,2381,11506,1631,21381,1477,738,739
15345,23766,2381,11507,1631,21385,1477,738,739
15350,23776,2382,11508,1631,21394,1477,738,739
15355,23782,2382,11510,1631,21400,1478,738,740
15360,23793,2383,11514,1632,21410,1478,738,740
15365,23797,2384,11517,1633,21413,1478,738,740
15370,23807,2385,11521,1633,21422,1478,738,740
15375,23813,2385,11526,1633,21427,1479,739,740
15380,23824,2388,11534,1636,21436,1479,739,740
15385,23828,2389,11535,1637,21439,1479,739,740
15390,23838,2390,11543,1638,21448,1479,739,740
15395,23844,2390,11545,1638,21454,1480,740,740
15400,23855,2391,11551,1639,21464,1480,740,740
15405,23859,2392,11553,1640,21467,1480,740,740
15410,23869,2394,11559,1642,21475,1480,740,740
15415,23875,2394,11564,1642,21480,1482,741,741
15420,23886,2398,11571,1645,21486,1483,742,741
15425,23890,2399,11571,1646,21491,1483,742,741
15430,23900,2400,11575,1647,21500,1483,742,741
15435,23906,2400,11580,1647,21506,1484,743,741
15440,23917,2401,11586,1648,21516,1484,743,741
15445,23921,2401,11589,1648,21520,1484,743,741
15450,23931,2402,11594,1648,21529,1484,743,741
15455,23937,2402,11598,1648,21535,1485,744,741
15460,23948,2403,11604,1649,21545,1485,744,741
15465,23952,2403,11605,1649,21549,1485,744,741
15470,23962,2404,11609,1649,21558,1485,744,741
15475,23968,2404,11611,1649,21564,1486,744,742
15480,23979,2405,11615,1650,21574,1486,744,742
15485,23983,2405,11618,1650,21578,1486,744,742
15490,23993,2406,11626,1651,21587,1486,744,742
15495,23999,2406,11630,1651,21592,1487,745,742
15500,24010,2408,11634,1653,21601,1487,745,742
15505,24014,2409,11635,1654,21605,1487,745,742
15510,24024,2410,11641,1654,21614,1487,745,742
15515,24030,2410,11645,1654,21620,1488,745,743
15520,24041,2411,11653,1654,21630,1488,745,743
15525,24045,2411,11656,1654,21634,1488,745,743
15530,24055,2412,11659,1654,21643,1488,745,743
15535,24061,2412,11660,1654,21649,1490,746,744
15540,24072,2414,11664,1655,21658,1491,746,745
15545,24076,2414,11665,1655,21662,1491,746,745
15550,24086,2414,11670,1655,21672,1491,746,745
15555,24092,2414,11671,1655,21678,1492,746,746
15560,24103,2415,11677,1656,21688,1492,746,746
15565,24107,2415,11679,1656,21692,1492,746,746
15570,24117,2415,11684,1656,21702,1492,746,746
15575,24123,2415,11685,1656,21708,1493,746,747
15580,24134,2416,11690,1656,21718,1493,746,747
15585,24138,2416,11691,1656,21722,1493,746,747
15590,24148,2417,11695,1656,21731,1493,746,747
15595,24154,2417,11697,1656,21737,1494,747,747
15600,24165,2419,11700,1657,21746,1494,747,747
15605,24169,2419,11700,1657,21750,1494,747,747
15610,24179,2420,11707,1658,21759,1494,747,747
15615,24185,2420,11707,1658,21765,1495,747,748
15620,24196,2423,11715,1661,21773,1496,748,748
15625,24200,2423,11716,1661,21777,1496,748,748
15630,24210,2424,11720,1661,21786,1496,748,748
15635,24216,2424,11723,1661,21792,1497,749,748
15640,24227,2426,11728,1663,21801,1498,749,749
15645,24231,2426,11729,1663,21805,1498,749,749
15650,24241,2427,11732,1663,21814,1498,749,749
15655,24247,2427,11735,1663,21820,1500,750,750
15660,24258,2429,11741,1665,21829,1501,750,751
15665,24262,2429,11742,1665,21833,1501,750,751
15670,24272,2429,11748,1665,21843,1501,750,751
15675,24278,2429,11750,1665,21849,1503,750,753
15680,24289,2430,11754,1666,21859,1503,750,753
15685,24293,2430,11755,1666,21863,1503,750,753
15690,24303,2430,11763,1666,21873,1503,750,753
15695,24309,2430,11767,1666,21879,1505,751,754
15700,24320,2431,11771,1666,21889,1505,751,754
15705,24324,2431,11774,1666,21893,1505,751,754
15710,24334,2432,11781,1667,21902,1505,751,754
15715,24340,2432,11783,1667,21907,1507,752,755
15720,24351,2434,11788,1669,21917,1507,752,755
15725,24355,2434,11788,1669,21921,1507,752,755
15730,24365,2435,11794,1670,21930,1507,752,755
15735,24371,2435,11798,1670,21936,1508,753,755
15740,24382,2437,11806,1672,21945,1508,753,755
15745,24386,2438,11808,1673,21948,1508,753,755
15750,24396,2439,11814,1674,21957,1508,753,755
15755,24402,2439,11817,1674,21963,1509,754,755
15760,24413,2440,11819,1675,21973,1509,754,755
15765,24417,2441,11822,1676,21976,1509,754,755
15770,24427,2443,11824,1676,21984,1509,754,755
15775,24433,2443,11826,1676,21990,1510,754,756
15780,24444,2444,11831,1677,22000,1511,755,756
15785,24448,2444,11833,1677,22004,1511,755,756
15790,24458,2445,11836,1677,22013,1511,755,756
15795,24464,2445,11839,1677,22019,1513,757,756
15800,24475,2447,11846,1679,22028,1513,757,756
15805,24479,2447,11846,1679,22032,1513,757,756
15810,24489,2448,11850,1680,22041,1513,757,756
15815,24495,2448,11855,1680,22047,1515,759,756
15820,24506,2449,11863,1680,22057,1515,759,756
15825,24510,2449,11864,1680,22061,1515,759,756
15830,24520,2450,11869,1680,22070,1515,759,756
15835,24526,2450,11873,1680,22076,1517,759,758
15840,24537,2453,11878,1682,22083,1517,759,758
15845,24541,2454,11880,1683,22087,1517,759,758
15850,24551,2455,11886,1683,22096,1517,759,758
15855,24557,2455,11889,1683,22102,1518,759,759
15860,24568,2455,11892,1683,22113,1518,759,759
15865,24572,2455,11895,1683,22117,1518,759,759
15870,24582,2456,11899,1684,22126,1518,759,759
15875,24588,2456,11901,1684,22132,1519,759,760
15880,24599,2456,11905,1684,22143,1519,759,760
15885,24603,2456,11907,1684,22147,1519,759,760
15890,24613,2458,11911,1685,22155,1519,759,760
15895,24619,2458,11914,1685,22161,1520,760,760
15900,24630,2460,11918,1687,22169,1521,761,760
15905,24634,2461,11918,1688,22173,1521,761,760
15910,24644,2462,11922,1688,22182,1521,761,760
15915,24650,2462,11927,1688,22187,1522,762,760
15920,24661,2463,11931,1689,22198,1523,763,760
15925,24665,2463,11931,1689,22202,1523,763,760
15930,24675,2464,11935,1689,22211,1523,763,760
15935,24681,2464,11937,1689,22216,1524,763,761
15940,24692,2466,11941,1691,22226,1525,764,761
15945,24696,2466,11944,1691,22230,1525,764,761
15950,24706,2467,11951,1692,22239,1525,764,761
15955,24712,2467,11954,1692,22244,1526,765,761
15960,24723,2469,11961,1694,22254,1527,766,761
15965,24727,2469,11963,1694,22258,1527,766,761
15970,24737,2469,11968,1694,22268,1527,766,761
15975,24743,2469,11970,1694,22274,1528,767,761
15980,24754,2469,11977,1694,22285,1529,768,761
15985,24758,2469,11979,1694,22289,1529,768,761
15990,24768,2469,11982,1694,22299,1529,768,761
15995,24774,2469,11984,1694,22305,1530,768,762
16000,24785,2469,11991,1694,22316,1531,769,762
16005,24789,2469,11995,1694,22320,1531,769,762
16010,24799,2470,11999,1694,22329,1531,769,762
16015,24805,2470,12002,1694,22334,1532,770,762
16020,24816,2474,12009,1698,22341,1533,771,762
16025,24820,2475,12012,1699,22344,1533,771,762
16030,24830,2478,12017,1701,22352,1533,771,762
16035,24836,2478,12021,1701,22358,1535,772,763
16040,24847,2480,12026,1702,22367,1536,773,763
16045,24851,2482,12030,1704,22369,1536,773,763
16050,24861,2484,12033,1705,22377,1536,773,763
16055,24867,2484,12037,1705,22383,1538,774,764
16060,24878,2486,12041,1707,22392,1539,774,765
16065,24882,2486,12041,1707,22396,1539,774,765
16070,24892,2488,12046,1708,22404,1539,774,765
16075,24898,2488,12046,1708,22410,1541,774,767
16080,24909,2490,12054,1710,22419,1542,774,768
16085,24913,2490,12056,1710,22423,1542,774,768
16090,24923,2492,12059,1711,22431,1542,774,768
16095,24929,2492,12061,1711,22437,1544,775,769
16100,24940,2493,12066,1712,22447,1544,775,769
16105,24944,2493,12067,1712,22451,1544,775,769
16110,24954,2495,12073,1714,22459,1544,775,769
16115,24960,2495,12076,1714,22465,1546,776,770
16120,24971,2496,12081,1715,22475,1546,776,770
16125,24975,2496,12082,1715,22479,1546,776,770
16130,24985,2498,12084,1715,22487,1546,776,770
16135,24991,2498,12087,1715,22493,1548,778,770
16140,25002,2500,12089,1716,22502,1549,778,771
16145,25006,2500,12090,1716,22506,1549,778,771
16150,25016,2501,12091,1716,22515,1549,778,771
16155,25022,2501,12093,1716,22521,1550,779,771
16160,25033,2501,12098,1716,22532,1550,779,771
16165,25037,2501,12100,1716,22536,1550,779,771
16170,25047,2502,12106,1716,22545,1550,779,771
16175,25053,2502,12108,1716,22551,1551,780,771
16180,25064,2502,12113,1716,22562,1551,780,771
16185,25068,2503,12114,1717,22565,1551,780,771
16190,25078,2504,12119,1717,22574,1551,780,771
16195,25084,2504,12123,1717,22580,1552,781,771
16200,25095,2504,12128,1717,22591,1552,781,771
16205,25099,2504,12130,1717,22595,1552,781,771
16210,25109,2504,12135,1717,22605,1552,781,771
16215,25115,2504,12138,1717,22611,1553,782,771
16220,25126,2504,12146,1717,22622,1553,782,771
16225,25130,2504,12147,1717,22626,1553,782,771
16230,25140,2504,12151,1717,22636,1553,782,771
16235,25146,2504,12154,1717,22642,1554,782,772
16240,25157,2504,12159,1717,22653,1554,782,772
16245,25161,2504,12162,1717,22657,1554,782,772
16250,25171,2505,12168,1718,22666,1554,782,772
16255,25177,2505,12172,1718,22672,1555,782,773
16260,25188,2507,12176,1720,22681,1555,782,773
16265,25192,2507,12177,1720,22685,1555,782,773
16270,25202,2509,12181,1722,22693,1555,782,773
16275,25208,2509,12184,1722,22698,1556,783,773
16280,25219,2511,12189,1724,22707,1556,783,773
16285,25223,2513,12192,1726,22710,1556,783,773
16290,25233,2514,12197,1727,22719,1556,783,773
16295,25239,2514,12198,1727,22725,1557,783,774
16300,25250,2516,12205,1729,22733,1557,783,774
16305,25254,2517,12206,1730,22737,1557,783,774
16310,25264,2519,12211,1732,22745,1557,783,774
16315,25270,2519,12213,1732,22750,1559,783,776
16320,25281,2524,12219,1736,22757,1560,783,777
16325,25285,2524,12219,1736,22761,1560,783,777
16330,25295,2525,12222,1736,22770,1560,783,777
16335,25301,2525,12223,1736,22776,1561,783,778
16340,25312,2526,12227,1737,22786,1561,783,778
16345,25316,2527,12231,1738,22789,1561,783,778
16350,25326,2528,12234,1739,22798,1561,783,778
16355,25332,2528,12236,1739,22804,1562,784,778
16360,25343,2529,12243,1739,22814,1562,784,778
16365,25347,2529,12243,1739,22818,1562,784,778
16370,25357,2530,12249,1740,22827,1562,784,778
16375,25363,2530,12251,1740,22833,1563,784,779
16380,25374,2531,12256,1740,22843,1563,784,779
16385,25378,2531,12256,1740,22847,1563,784,779
16390,25388,2532,12261,1741,22856,1563,784,779
16395,25394,2532,12263,1741,22862,1564,785,779
16400,25405,2533,12268,1741,22872,1564,785,779
16405,25409,2533,12271,1741,22876,1564,785,779
16410,25419,2534,12274,1741,22885,1564,785,779
16415,25425,2534,12275,1741,22891,1565,785,780
16420,25436,2535,12280,1741,22901,1565,785,780
16425,25440,2535,12281,1741,22905,1565,785,780
16430,25450,2537,12284,1742,22913,1565,785,780
16435,25456,2537,12287,1742,22918,1567,786,781
16440,25467,2540,12290,1744,22927,1568,786,782
16445,25471,2540,12293,1744,22930,1568,786,782
16450,25481,2543,12300,1746,22938,1568,786,782
16455,25487,2543,12300,1746,22944,1570,786,784
16460,25498,2545,12305,1748,22953,1570,786,784
16465,25502,2546,12306,1749,22956,1570,786,784
16470,25512,2548,12312,1749,22964,1570,786,784
16475,25518,2548,12314,1749,22970,1572,787,785
16480,25529,2550,12319,1750,22979,1572,787,785
16485,25533,2551,12322,1751,22982,1572,787,785
16490,25543,2553,12326,1752,22990,1572,787,785
16495,25549,2553,12328,1752,22996,1574,788,786
16500,25560,2555,12333,1753,23005,1574,788,786
16505,25564,2555,12334,1753,23009,1574,788,786
16510,25574,2557,12338,1754,23017,1574,788,786
16515,25580,2557,12339,1754,23023,1575,788,787
16520,25591,2558,12347,1755,23033,1575,788,787
16525,25595,2558,12349,1755,23037,1575,788,787
16530,25605,2560,12353,1756,23045,1575,788,787
16535,25611,2560,12357,1756,23051,1576,789,787
16540,25622,2561,12362,1757,23061,1576,789,787
16545,25626,2562,12364,1758,23064,1576,789,787
16550,25636,2565,12371,1761,23071,1576,789,787
16555,25642,2565,12375,1761,23077,1578,791,787
16560,25653,2566,12381,1762,23086,1579,792,787
16565,25657,2567,12384,1763,23090,1579,792,787
16570,25667,2567,12389,1763,23100,1579,792,787
16575,25673,2567,12392,1763,23106,1581,794,787
16580,25684,2567,12400,1763,23117,1581,794,787
16585,25688,2567,12403,1763,23121,1581,794,787
16590,25698,2567,12407,1763,23131,1581,794,787
16595,25704,2567,12411,1763,23137,1582,795,787
16600,25715,2567,12418,1763,23148,1582,795,787
16605,25719,2567,12419,1763,23152,1582,795,787
16610,25729,2567,12424,1763,23162,1582,795,787
16615,25735,2567,12427,1763,23168,1583,796,787
16620,25746,2567,12428,1763,23179,1583,796,787
16625,25750,2567,12429,1763,23183,1583,796,787
16630,25760,2568,12433,1763,23192,1583,796,787
16635,25766,2568,12436,1763,23198,1584,797,787
16640,25777,2568,12441,1763,23209,1585,797,788
16645,25781,2568,12444,1763,23213,1585,797,788
16650,25791,2569,12451,1763,23222,1585,797,788
16655,25797,2569,12454,1763,23227,1586,797,789
16660,25808,2570,12462,1764,23237,1587,798,789
16665,25812,2572,12465,1766,23240,1587,798,789
16670,25822,2574,12468,1766,23248,1587,798,789
16675,25828,2574,12470,1766,23253,1589,798,791
16680,25839,2580,12477,1771,23258,1590,798,792
16685,25843,2581,12478,1772,23262,1590,798,792
16690,25853,2582,12483,1772,23271,1590,798,792
16695,25859,2582,12486,1772,23277,1592,799,793
16700,25870,2583,12490,1773,23287,1592,799,793
16705,25874,2584,12492,1774,23290,1592,799,793
16710,25884,2585,12494,1774,23299,1592,799,793
16715,25890,2585,12497,1774,23305,1594,800,794
16720,25901,2587,12502,1775,23314,1594,800,794
16725,25905,2588,12504,1776,23317,1594,800,794
16730,25915,2589,12508,1776,23326,1594,800,794
16735,25921,2589,12512,1776,23332,1596,801,795
16740,25932,2591,12518,1777,23341,1596,801,795
16745,25936,2591,12519,1777,23345,1596,801,795
16750,25946,2592,12523,1777,23354,1596,801,795
16755,25952,2592,12526,1777,23360,1598,803,795
16760,25963,2594,12532,1779,23369,1598,803,795
16765,25967,2595,12534,1780,23372,1598,803,795
16770,25977,2596,12538,1781,23381,1598,803,795
16775,25983,2596,12542,1781,23387,1600,805,795
16780,25994,2597,12546,1781,23397,1600,805,795
16785,25998,2598,12550,1782,23399,1600,805,795
16790,26008,2601,12553,1784,23407,1600,805,795
16795,26014,2601,12558,1784,23412,1602,807,795
16800,26025,2606,12564,1788,23418,1603,808,795
16805,26029,2607,12565,1789,23422,1603,808,795
16810,26039,2608,12571,1790,23431,1603,808,795
16815,26045,2608,12575,1790,23437,1604,809,795
16820,26056,2608,12582,1790,23448,1604,809,795
16825,26060,2608,12583,1790,23452,1604,809,795
16830,26070,2609,12587,1790,23461,1604,809,795
16835,26076,2609,12590,1790,23467,1605,810,795
16840,26087,2609,12594,1790,23478,1605,810,795
16845,26091,2609,12597,1790,23482,1605,810,795
16850,26101,2610,12601,1790,23491,1605,810,795
16855,26107,2610,12604,1790,23497,1606,811,795
16860,26118,2610,12608,1790,23508,1606,811,795
16865,26122,2610,12609,1790,23511,1606,811,795
16870,26132,2612,12613,1791,23520,1606,811,795
16875,26138,2612,12614,1791,23526,1607,811,796
16880,26149,2612,12619,1791,23537,1607,811,796
16885,26153,2612,12621,1791,23541,1607,811,796
16890,26163,2613,12625,1791,23550,1607,811,796
16895,26169,2613,12627,1791,23556,1608,811,797
16900,26180,2613,12633,1791,23567,1608,811,797
16905,26184,2613,12635,1791,23571,1608,811,797
16910,26194,2614,12641,1791,23580,1608,811,797
16915,26200,2614,12646,1791,23586,1610,813,797
16920,26211,2617,12652,1794,23594,1610,813,797
16925,26215,2617,12656,1794,23598,1610,813,797
16930,26225,2618,12661,1795,23607,1610,813,797
16935,26231,2618,12664,1795,23613,1611,813,798
16940,26242,2619,12671,1796,23623,1612,814,798
16945,26246,2619,12673,1796,23627,1612,814,798
16950,26256,2620,12677,1797,23636,1612,814,798
16955,26262,2620,12680,1797,23642,1613,815,798
16960,26273,2621,12687,1798,23652,1614,816,798
16965,26277,2621,12688,1798,23656,1614,816,798
16970,26287,2623,12693,1798,23664,1614,816,798
16975,26293,2623,12696,1798,23670,1615,816,799
16980,26304,2625,12703,1800,23679,1616,817,799
16985,26308,2625,12704,1800,23683,1616,817,799
16990,26318,2626,12709,1800,23692,1616,817,799
16995,26324,2626,12711,1800,23698,1617,818,799
17000,26335,2627,12718,1801,23708,1618,819,799
17005,26339,2627,12720,1801,23712,1618,819,799
17010,26349,2628,12725,1801,23721,1618,819,799
17015,26355,2628,12729,1801,23727,1619,820,799
17020,26366,2629,12733,1802,23737,1620,821,799
17025,26370,2629,12735,1802,23741,1620,821,799
17030,26380,2630,12739,1802,23750,1620,821,799
17035,26386,2630,12741,1802,23756,1622,822,800
17040,26397,2632,12746,1804,23765,1623,823,800
17045,26401,2632,12749,1804,23769,1623,823,800
17050,26411,2633,12755,1804,23778,1623,823,800
17055,26417,2633,12758,1804,23783,1625,824,801
17060,26428,2636,12765,1806,23792,1625,824,801
17065,26432,2636,12768,1806,23796,1625,824,801
17070,26442,2637,12771,1806,23805,1625,824,801
17075,26448,2637,12774,1806,23810,1627,825,802
17080,26459,2640,12781,1808,23819,1627,825,802
17085,26463,2640,12781,1808,23823,1627,825,802
17090,26473,2642,12785,1809,23830,1627,825,802
17095,26479,2643,12789,1810,23835,1629,826,803
17100,26490,2645,12795,1812,23845,1630,827,803
17105,26494,2645,12798,1812,23849,1630,827,803
17110,26504,2646,12802,1813,23858,1630,827,803
17115,26510,2646,12806,1813,23864,1631,828,803
17120,26521,2648,12809,1814,23873,1632,828,804
17125,26525,2648,12811,1814,23877,1632,828,804
17130,26535,2650,12819,1816,23885,1632,828,804
17135,26541,2650,12820,1816,23891,1633,828,805
17140,26552,2653,12828,1819,23899,1634,829,805
17145,26556,2653,12829,1819,23903,1634,829,805
17150,26566,2655,12832,1820,23911,1634,829,805
17155,26572,2655,12835,1820,23917,1635,830,805
17160,26583,2657,12839,1822,23926,1636,830,806
17165,26587,2657,12841,1822,23930,1636,830,806
17170,26597,2659,12847,1823,23938,1636,830,806
17175,26603,2659,12849,1823,23944,1637,830,807
17180,26614,2660,12854,1824,23954,1637,830,807
17185,26618,2660,12857,1824,23958,1637,830,807
17190,26628,2662,12863,1824,23966,1637,830,807
17195,26634,2662,12864,1824,23972,1638,831,807
17200,26645,2663,12870,1825,23982,1638,831,807
17205,26649,2663,12872,1825,23986,1638,831,807
17210,26659,2665,12876,1826,23994,1638,831,807
17215,26665,2665,12879,1826,24000,1640,832,808
17220,26676,2665,12885,1826,24011,1640,832,808
17225,26680,2665,12888,1826,24015,1640,832,808
17230,26690,2667,12892,1827,24023,1640,832,808
17235,26696,2667,12894,1827,24029,1641,832,809
17240,26707,2668,12900,1828,24039,1641,832,809
17245,26711,2668,12901,1828,24043,1641,832,809
17250,26721,2670,12907,1830,24051,1641,832,809
17255,26727,2670,12909,1830,24057,1642,832,810
17260,26738,2670,12915,1830,24068,1642,832,810
17265,26742,2670,12918,1830,24072,1642,832,810
17270,26752,2673,12923,1831,24079,1642,832,810
17275,26758,2673,12925,1831,24085,1643,832,811
17280,26769,2676,12934,1834,24093,1643,832,811
17285,26773,2677,12937,1835,24096,1643,832,811
17290,26783,2678,12942,1835,24105,1643,832,811
17295,26789,2678,12944,1835,24111,1644,833,811
17300,26800,2680,12952,1836,24119,1644,833,811
17305,26804,2682,12954,1838,24122,1644,833,811
17310,26814,2683,12960,1839,24131,1644,833,811
17315,26820,2683,12960,1839,24137,1645,833,812
17320,26831,2685,12967,1841,24145,1645,833,812
17325,26835,2687,12970,1843,24147,1645,833,812
17330,26845,2689,12979,1844,24156,1645,833,812
17335,26851,2689,12984,1844,24162,1646,834,812
17340,26862,2691,12991,1846,24170,1647,835,812
17345,26866,2692,12993,1847,24174,1647,835,812
17350,26876,2692,12997,1847,24184,1647,835,812
17355,26882,2692,12999,1847,24190,1649,835,814
17360,26893,2694,13002,1848,24199,1649,835,814
17365,26897,2694,13003,1848,24203,1649,835,814
17370,26907,2694,13009,1848,24213,1649,835,814
17375,26913,2694,13012,1848,24219,1650,836,814
17380,26924,2696,13017,1849,24228,1650,836,814
17385,26928,2696,13018,1849,24232,1650,836,814
17390,26938,2697,13024,1850,24241,1650,836,814
17395,26944,2697,13026,1850,24247,1651,837,814
17400,26955,2698,13034,1850,24257,1651,837,814
17405,26959,2698,13036,1850,24260,1651,837,814
17410,26969,2701,13041,1852,24268,1651,837,814
17415,26975,2701,13043,1852,24274,1652,837,815
17420,26986,2702,13049,1853,24284,1653,837,816
17425,26990,2702,13051,1853,24287,1653,837,816
17430,27000,2704,13056,1854,24296,1653,837,816
17435,27006,2704,13060,1854,24301,1654,838,816
17440,27017,2706,13065,1856,24311,1655,838,817
17445,27021,2706,13068,1856,24314,1655,838,817
17450,27031,2709,13071,1858,24322,1655,838,817
17455,27037,2709,13076,1858,24328,1656,839,817
17460,27048,2711,13084,1860,24336,1657,840,817
17465,27052,2712,13085,1861,24340,1657,840,817
17470,27062,2713,13093,1861,24349,1657,840,817
17475,27068,2713,13096,1861,24355,1658,840,818
17480,27079,2716,13103,1863,24363,1659,841,818
17485,27083,2716,13104,1863,24367,1659,841,818
17490,27093,2718,13108,1864,24375,1659,841,818
17495,27099,2718,13113,1864,24381,1660,842,818
17500,27110,2721,13120,1866,24388,1661,843,818
17505,27114,2722,13123,1867,24391,1661,843,818
17510,27124,2725,13128,1869,24399,1661,843,818
17515,27130,2725,13131,1869,24405,1662,844,818
17520,27141,2727,13138,1871,24413,1663,845,818
17525,27145,2728,13139,1872,24417,1663,845,818
17530,27155,2730,13144,1873,24425,1663,845,818
17535,27161,2730,13146,1873,24431,1665,846,819
17540,27172,2731,13154,1874,24441,1665,846,819
17545,27176,2732,13157,1875,24444,1665,846,819
17550,27186,2734,13158,1875,24452,1665,846,819
17555,27192,2734,13160,1875,24458,1667,847,820
17560,27203,2734,13163,1875,24469,1667,847,820
17565,27207,2735,13167,1876,24472,1667,847,820
17570,27217,2737,13172,1877,24480,1667,847,820
17575,27223,2737,13173,1877,24486,1669,847,822
17580,27234,2738,13182,1878,24496,1669,847,822
17585,27238,2738,13184,1878,24500,1669,847,822
17590,27248,2739,13189,1878,24509,1669,847,822
17595,27254,2739,13192,1878,24515,1670,847,823
17600,27265,2741,13199,1880,24524,1670,847,823
17605,27269,2742,13201,1881,24527,1670,847,823
17610,27279,2743,13207,1881,24536,1670,847,823
17615,27285,2743,13212,1881,24542,1671,848,823
17620,27296,2744,13215,1882,24552,1671,848,823
17625,27300,2745,13218,1883,24555,1671,848,823
17630,27310,2746,13223,1884,24564,1671,848,823
17635,27316,2746,13225,1884,24570,1672,848,824
17640,27327,2748,13229,1886,24579,1672,848,824
17645,27331,2748,13231,1886,24583,1672,848,824
17650,27341,2749,13235,1886,24592,1672,848,824
17655,27347,2749,13237,1886,24598,1674,849,825
17660,27358,2750,13242,1887,24607,1674,849,825
17665,27362,2751,13244,1888,24610,1674,849,825
17670,27372,2753,13249,1890,24619,1674,849,825
17675,27378,2753,13254,1890,24624,1676,850,826
17680,27389,2755,13258,1892,24634,1676,850,826
17685,27393,2755,13259,1892,24638,1676,850,826
17690,27403,2756,13264,1893,24646,1676,850,826
17695,27409,2757,13267,1894,24651,1678,851,827
17700,27420,2759,13269,1896,24661,1679,851,828
17705,27424,2759,13270,1896,24665,1679,851,828
17710,27434,2759,13275,1896,24675,1679,851,828
17715,27440,2759,13279,1896,24681,1680,851,829
17720,27451,2761,13283,1897,24690,1681,852,829
17725,27455,2761,13284,1897,24694,1681,852,829
17730,27465,2761,13286,1897,24704,1681,852,829
17735,27471,2761,13290,1897,24710,1682,853,829
17740,27482,2763,13294,1898,24719,1683,853,830
17745,27486,2763,13295,1898,24723,1683,853,830
17750,27496,2764,13301,1898,24732,1683,853,830
17755,27502,2764,13304,1898,24738,1684,853,831
17760,27513,2766,13310,1899,24747,1685,854,831
17765,27517,2766,13313,1899,24751,1685,854,831
17770,27527,2767,13316,1899,24760,1685,854,831
17775,27533,2767,13318,1899,24766,1686,854,832
17780,27544,2768,13322,1900,24776,1687,855,832
17785,27548,2768,13324,1900,24780,1687,855,832
17790,27558,2769,13329,1900,24789,1687,855,832
17795,27564,2769,13332,1900,24795,1688,855,833
17800,27575,2769,13334,1900,24806,1689,855,834
17805,27579,2769,13335,1900,24810,1689,855,834
17810,27589,2771,13340,1900,24817,1689,855,834
17815,27595,2772,13342,1901,24822,1691,856,835
17820,27606,2775,13347,1904,24831,1692,856,836
17825,27610,2775,13347,1904,24835,1692,856,836
17830,27620,2777,13351,1906,24843,1692,856,836
17835,27626,2777,13353,1906,24849,1693,857,836
17840,27637,2777,13355,1906,24860,1693,857,836
17845,27641,2777,13356,1906,24864,1693,857,836
17850,27651,2779,13362,1908,24872,1693,857,836
17855,27657,2779,13365,1908,24878,1694,858,836
17860,27668,2780,13370,1909,24888,1694,858,836
17865,27672,2780,13374,1909,24892,1694,858,836
17870,27682,2782,13378,1910,24900,1694,858,836
17875,27688,2782,13384,1910,24906,1695,859,836
17880,27699,2783,13387,1910,24916,1695,859,836
17885,27703,2783,13388,1910,24920,1695,859,836
17890,27713,2785,13392,1911,24928,1695,859,836
17895,27719,2785,13394,1911,24934,1696,859,837
17900,27730,2786,13396,1911,24944,1696,859,837
17905,27734,2786,13399,1911,24948,1696,859,837
17910,27744,2788,13402,1912,24956,1696,859,837
17915,27750,2788,13406,1912,24962,1697,859,838
17920,27761,2789,13408,1912,24972,1697,859,838
17925,27765,2789,13411,1912,24976,1697,859,838
17930,27775,2791,13420,1913,24984,1697,859,838
17935,27781,2791,13425,1913,24989,1699,861,838
17940,27792,2795,13427,1916,24997,1700,861,839
17945,27796,2795,13430,1916,25001,1700,861,839
17950,27806,2795,13431,1916,25011,1700,861,839
17955,27812,2795,13434,1916,25017,1701,862,839
17960,27823,2796,13439,1916,25027,1701,862,839
17965,27827,2796,13440,1916,25031,1701,862,839
17970,27837,2796,13447,1916,25041,1701,862,839
17975,27843,2796,13449,1916,25047,1702,862,840
17980,27854,2797,13454,1917,25057,1702,862,840
17985,27858,2797,13456,1917,25061,1702,862,840
17990,27868,2797,13460,1917,25071,1702,862,840
17995,27874,2797,13462,1917,25077,1703,863,840
18000,27885,2798,13469,1917,25087,1703,863,840
18005,27889,2798,13471,1917,25091,1703,863,840
18010,27899,2798,13479,1917,25101,1703,863,840
18015,27905,2798,13481,1917,25107,1704,863,841
18020,27916,2799,13488,1917,25117,1704,863,841
18025,27920,2799,13490,1917,25121,1704,863,841
18030,27930,2799,13494,1917,25131,1704,863,841
18035,27936,2799,13498,1917,25137,1705,863,842
18040,27947,2800,13503,1918,25147,1705,863,842
18045,27951,2800,13505,1918,25151,1705,863,842
18050,27961,2802,13510,1920,25159,1705,863,842
18055,27967,2802,13513,1920,25165,1707,865,842
18060,27978,2804,13520,1922,25173,1708,865,843
18065,27982,2805,13521,1923,25177,1708,865,843
18070,27992,2806,13525,1923,25186,1708,865,843
18075,27998,2806,13526,1923,25192,1709,865,844
18080,28009,2808,13531,1924,25201,1709,865,844
18085,28013,2808,13532,1924,25205,1709,865,844
18090,28023,2809,13538,1924,25214,1709,865,844
18095,28029,2809,13540,1924,25220,1710,865,845
18100,28040,2811,13545,1926,25229,1710,865,845
18105,28044,2812,13549,1927,25232,1710,865,845
18110,28054,2813,13555,1928,25241,1710,865,845
18115,28060,2813,13557,1928,25247,1711,866,845
18120,28071,2815,13561,1930,25256,1711,866,845
18125,28075,2815,13562,1930,25260,1711,866,845
18130,28085,2816,13565,1931,25269,1711,866,845
18135,28091,2816,13568,1931,25275,1712,866,846
18140,28102,2818,13574,1933,25284,1712,866,846
18145,28106,2819,13576,1934,25287,1712,866,846
18150,28116,2820,13578,1934,25296,1712,866,846
18155,28122,2820,13579,1934,25302,1713,866,847
18160,28133,2821,13584,1935,25312,1713,866,847
18165,28137,2822,13586,1936,25315,1713,866,847
18170,28147,2824,13591,1937,25323,1713,866,847
18175,28153,2824,13594,1937,25328,1715,867,848
18180,28164,2828,13599,1940,25336,1716,868,848
18185,28168,2828,13600,1940,25340,1716,868,848
18190,28178,2829,13604,1940,25349,1716,868,848
18195,28184,2829,13606,1940,25355,1717,868,849
18200,28195,2829,13617,1940,25366,1717,868,849
18205,28199,2829,13619,1940,25370,1717,868,849
18210,28209,2830,13624,1940,25379,1717,868,849
18215,28215,2830,13625,1940,25385,1718,868,850
18220,28226,2830,13628,1940,25396,1718,868,850
18225,28230,2830,13630,1940,25400,1718,868,850
18230,28240,2831,13636,1941,25409,1718,868,850
18235,28246,2831,13641,1941,25415,1719,869,850
18240,28257,2831,13645,1941,25426,1719,869,850
18245,28261,2831,13645,1941,25430,1719,869,850
18250,28271,2832,13649,1942,25439,1719,869,850
18255,28277,2832,13653,1942,25445,1720,869,851
18260,28288,2832,13660,1942,25456,1720,869,851
18265,28292,2832,13661,1942,25460,1720,869,851
18270,28302,2833,13668,1943,25469,1720,869,851
18275,28308,2833,13671,1943,25475,1721,870,851
18280,28319,2833,13674,1943,25486,1721,870,851
18285,28323,2834,13676,1944,25489,1721,870,851
18290,28333,2836,13679,1945,25497,1721,870,851
18295,28339,2836,13679,1945,25503,1723,870,853
18300,28350,2838,13683,1946,25512,1723,870,853
18305,28354,2838,13684,1946,25516,1723,870,853
18310,28364,2839,13688,1946,25525,1723,870,853
18315,28370,2839,13690,1946,25531,1724,870,854
18320,28381,2840,13696,1947,25541,1724,870,854
18325,28385,2840,13697,1947,25545,1724,870,854
18330,28395,2841,13700,1947,25554,1724,870,854
18335,28401,2841,13703,1947,25559,1725,870,855
18340,28412,2843,13708,1949,25569,1725,870,855
18345,28416,2843,13710,1949,25573,1725,870,855
18350,28426,2844,13714,1950,25582,1725,870,855
18355,28432,2844,13717,1950,25588,1726,871,855
18360,28443,2845,13723,1951,25598,1726,871,855
18365,28447,2845,13725,1951,25602,1726,871,855
18370,28457,2846,13731,1952,25611,1726,871,855
18375,28463,2846,13734,1952,25617,1728,872,856
18380,28474,2847,13740,1953,25627,1729,873,856
18385,28478,2847,13742,1953,25631,1729,873,856
18390,28488,2848,13745,1954,25640,1729,873,856
18395,28494,2848,13748,1954,25646,1730,873,857
18400,28505,2849,13754,1955,25656,1731,873,858
18405,28509,2849,13756,1955,25660,1731,873,858
18410,28519,2852,13763,1958,25667,1731,873,858
18415,28525,2852,13766,1958,25673,1732,874,858
18420,28536,2856,13773,1962,25679,1733,874,859
18425,28540,2858,13776,1964,25682,1733,874,859
18430,28550,2859,13779,1965,25691,1733,874,859
18435,28556,2859,13783,1965,25697,1734,875,859
18440,28567,2861,13787,1966,25706,1734,875,859
18445,28571,2861,13788,1966,25710,1734,875,859
18450,28581,2862,13791,1966,25719,1734,875,859
18455,28587,2862,13793,1966,25725,1735,876,859
18460,28598,2863,13798,1967,25735,1735,876,859
18465,28602,2863,13801,1967,25739,1735,876,859
18470,28612,2864,13807,1967,25748,1735,876,859
18475,28618,2864,13811,1967,25754,1736,877,859
18480,28629,2865,13816,1968,25763,1736,877,859
18485,28633,2866,13817,1969,25767,1736,877,859
18490,28643,2867,13820,1970,25776,1736,877,859
18495,28649,2867,13823,1970,25782,1737,877,860
18500,28660,2868,13825,1970,25792,1737,877,860
18505,28664,2868,13827,1970,25796,1737,877,860
18510,28674,2869,13831,1971,25805,1737,877,860
18515,28680,2869,13835,1971,25811,1738,877,861
18520,28691,2870,13840,1972,25821,1738,877,861
18525,28695,2870,13842,1972,25825,1738,877,861
18530,28705,2872,13847,1974,25833,1738,877,861
18535,28711,2872,13851,1974,25839,1740,878,862
18540,28722,2875,13857,1977,25847,1741,879,862
18545,28726,2875,13861,1977,25851,1741,879,862
18550,28736,2877,13867,1979,25859,1741,879,862
18555,28742,2877,13870,1979,25865,1743,880,863
18560,28753,2879,13874,1980,25874,1743,880,863
18565,28757,2879,13877,1980,25878,1743,880,863
18570,28767,2881,13882,1980,25886,1743,880,863
18575,28773,2881,13885,1980,25892,1744,881,863
18580,28784,2883,13890,1981,25901,1744,881,863
18585,28788,2883,13893,1981,25905,1744,881,863
18590,28798,2885,13899,1983,25913,1744,881,863
18595,28804,2885,13902,1983,25919,1745,882,863
18600,28815,2886,13906,1983,25928,1745,882,863
18605,28819,2888,13907,1985,25931,1745,882,863
18610,28829,2889,13913,1986,25940,1745,882,863
18615,28835,2889,13915,1986,25946,1746,882,864
18620,28846,2890,13918,1986,25956,1746,882,864
18625,28850,2890,13920,1986,25960,1746,882,864
18630,28860,2891,13923,1987,25969,1746,882,864
18635,28866,2891,13928,1987,25975,1747,883,864
18640,28877,2892,13935,1987,25985,1747,883,864
18645,28881,2892,13935,1987,25989,1747,883,864
18650,28891,2893,13939,1987,25998,1747,883,864
18655,28897,2893,13940,1987,26004,1748,883,865
18660,28908,2894,13945,1987,26014,1748,883,865
18665,28912,2894,13947,1987,26018,1748,883,865
18670,28922,2894,13951,1987,26028,1748,883,865
18675,28928,2894,13954,1987,26034,1750,884,866
18680,28939,2895,13960,1987,26044,1750,884,866
18685,28943,2895,13961,1987,26048,1750,884,866
18690,28953,2895,13968,1987,26058,1750,884,866
18695,28959,2895,13971,1987,26064,1751,885,866
18700,28970,2896,13976,1988,26074,1751,885,866
18705,28974,2896,13977,1988,26078,1751,885,866
18710,28984,2897,13979,1988,26087,1751,885,866
18715,28990,2897,13983,1988,26092,1752,885,867
18720,29001,2899,13986,1990,26102,1752,885,867
18725,29005,2899,13987,1990,26106,1752,885,867
18730,29015,2900,13990,1990,26115,1752,885,867
18735,29021,2900,13992,1990,26121,1753,885,868
18740,29032,2902,13995,1991,26130,1753,885,868
18745,29036,2902,13995,1991,26134,1753,885,868
18750,29046,2903,13998,1991,26143,1753,885,868
18755,29052,2903,14003,1991,26149,1754,885,869
18760,29063,2905,14010,1993,26158,1754,885,869
18765,29067,2905,14012,1993,26162,1754,885,869
18770,29077,2907,14017,1994,26170,1754,885,869
18775,29083,2907,14019,1994,26176,1755,885,870
18780,29094,2909,14024,1996,26184,1756,885,871
18785,29098,2910,14024,1997,26188,1756,885,871
18790,29108,2911,14030,1998,26197,1756,885,871
18795,29114,2911,14035,1998,26202,1758,887,871
18800,29125,2912,14041,1999,26213,1759,887,872
18805,29129,2912,14044,1999,26217,1759,887,872
18810,29139,2914,14048,2001,26225,1759,887,872
18815,29145,2914,14051,2001,26230,1761,888,873
18820,29156,2915,14054,2002,26241,1762,889,873
18825,29160,2916,14057,2003,26244,1762,889,873
18830,29170,2918,14062,2005,26252,1762,889,873
18835,29176,2918,14067,2005,26257,1764,891,873
18840,29187,2920,14072,2007,26267,1765,891,874
18845,29191,2920,14073,2007,26271,1765,891,874
18850,29201,2920,14080,2007,26281,1765,891,874
18855,29207,2920,14081,2007,26287,1766,891,875
18860,29218,2920,14091,2007,26298,1766,891,875
18865,29222,2920,14093,2007,26302,1766,891,875
18870,29232,2920,14100,2007,26312,1766,891,875
18875,29238,2920,14103,2007,26318,1767,891,876
18880,29249,2920,14108,2007,26329,1767,891,876
18885,29253,2920,14111,2007,26333,1767,891,876
18890,29263,2920,14115,2007,26343,1767,891,876
18895,29269,2920,14118,2007,26349,1768,892,876
18900,29280,2920,14125,2007,26360,1768,892,876
18905,29284,2921,14128,2008,26363,1768,892,876
18910,29294,2922,14131,2009,26372,1768,892,876
18915,29300,2922,14135,2009,26377,1770,894,876
18920,29311,2923,14139,2010,26388,1770,894,876
18925,29315,2923,14140,2010,26392,1770,894,876
18930,29325,2925,14145,2011,26400,1770,894,876
18935,29331,2925,14148,2011,26405,1772,895,877
18940,29342,2926,14152,2012,26415,1772,895,877
18945,29346,2927,14154,2013,26419,1772,895,877
18950,29356,2929,14157,2014,26427,1772,895,877
18955,29362,2929,14159,2014,26433,1773,895,878
18960,29373,2932,14167,2017,26440,1773,895,878
18965,29377,2933,14167,2018,26444,1773,895,878
18970,29387,2934,14171,2019,26453,1773,895,878
18975,29393,2934,14174,2019,26459,1774,895,879
18980,29404,2935,14179,2019,26469,1775,896,879
18985,29408,2935,14180,2019,26473,1775,896,879
18990,29418,2936,14184,2020,26482,1775,896,879
18995,29424,2936,14187,2020,26488,1776,896,880
19000,29435,2938,14194,2021,26497,1777,896,881
19005,29439,2938,14197,2021,26501,1777,896,881
19010,29449,2939,14202,2022,26510,1777,896,881
19015,29455,2939,14206,2022,26516,1778,897,881
19020,29466,2941,14213,2023,26525,1779,897,882
19025,29470,2941,14214,2023,26529,1779,897,882
19030,29480,2943,14219,2023,26537,1779,897,882
19035,29486,2943,14222,2023,26542,1780,898,882
19040,29497,2946,14227,2025,26551,1781,898,883
19045,29501,2947,14229,2026,26554,1781,898,883
19050,29511,2949,14236,2028,26562,1781,898,883
19055,29517,2949,14238,2028,26568,1783,898,885
19060,29528,2953,14248,2032,26575,1784,899,885
19065,29532,2955,14251,2034,26577,1784,899,885
19070,29542,2958,14257,2036,26584,1784,899,885
19075,29548,2958,14257,2036,26590,1786,899,887
19080,29559,2961,14265,2039,26598,1787,900,887
19085,29563,2961,14266,2039,26602,1787,900,887
19090,29573,2961,14270,2039,26612,1787,900,887
19095,29579,2961,14273,2039,26618,1788,900,888
19100,29590,2961,14277,2039,26629,1788,900,888
19105,29594,2961,14279,2039,26633,1788,900,888
19110,29604,2961,14284,2039,26643,1788,900,888
19115,29610,2961,14288,2039,26649,1789,900,889
19120,29621,2961,14292,2039,26660,1789,900,889
19125,29625,2961,14293,2039,26664,1789,900,889
19130,29635,2961,14299,2039,26674,1789,900,889
19135,29641,2961,14303,2039,26680,1790,901,889
19140,29652,2961,14309,2039,26691,1790,901,889
19145,29656,2961,14313,2039,26695,1790,901,889
19150,29666,2961,14320,2039,26705,1790,901,889
19155,29672,2961,14324,2039,26711,1791,902,889
19160,29683,2961,14330,2039,26722,1791,902,889
19165,29687,2961,14330,2039,26726,1791,902,889
19170,29697,2961,14336,2039,26736,1791,902,889
19175,29703,2961,14339,2039,26742,1792,903,889
19180,29714,2961,14343,2039,26753,1792,903,889
19185,29718,2961,14345,2039,26757,1792,903,889
19190,29728,2963,14350,2040,26765,1792,903,889
19195,29734,2963,14352,2040,26771,1794,903,891
19200,29745,2967,14359,2044,26777,1795,904,891
19205,29749,2968,14359,2045,26781,1795,904,891
19210,29759,2969,14367,2046,26790,1795,904,891
19215,29765,2969,14370,2046,26796,1797,905,892
19220,29776,2970,14376,2046,26806,1797,905,892
19225,29780,2970,14380,2046,26810,1797,905,892
19230,29790,2971,14386,2047,26819,1797,905,892
19235,29796,2971,14389,2047,26825,1799,906,893
19240,29807,2973,14396,2049,26834,1799,906,893
19245,29811,2973,14396,2049,26838,1799,906,893
19250,29821,2974,14401,2050,26847,1799,906,893
19255,29827,2974,14404,2050,26853,1801,906,895
19260,29838,2976,14411,2052,26862,1801,906,895
19265,29842,2977,14415,2053,26865,1801,906,895
19270,29852,2978,14419,2053,26874,1801,906,895
19275,29858,2978,14421,2053,26880,1802,906,896
19280,29869,2980,14426,2054,26889,1802,906,896
19285,29873,2981,14428,2055,26892,1802,906,896
19290,29883,2982,14430,2055,26901,1802,906,896
19295,29889,2982,14434,2055,26907,1803,906,897
19300,29900,2984,14440,2056,26916,1803,906,897
19305,29904,2984,14441,2056,26920,1803,906,897
19310,29914,2986,14447,2058,26928,1803,906,897
19315,29920,2986,14451,2058,26933,1804,907,897
19320,29931,2991,14456,2062,26939,1804,907,897
19325,29935,2992,14457,2063,26943,1804,907,897
19330,29945,2992,14461,2063,26953,1804,907,897
19335,29951,2992,14464,2063,26959,1805,907,898
19340,29962,2992,14472,2063,26970,1805,907,898
19345,29966,2992,14474,2063,26974,1805,907,898
19350,29976,2992,14478,2063,26984,1805,907,898
19355,29982,2992,14482,2063,26990,1806,908,898
19360,29993,2992,14487,2063,27001,1806,908,898
19365,29997,2992,14490,2063,27005,1806,908,898
19370,30007,2992,14496,2063,27015,1806,908,898
19375,30013,2992,14500,2063,27021,1807,908,899
19380,30024,2992,14506,2063,27032,1807,908,899
19385,30028,2993,14508,2064,27035,1807,908,899
19390,30038,2994,14515,2065,27044,1807,908,899
19395,30044,2994,14516,2065,27050,1808,908,900
19400,30055,2994,14518,2065,27061,1808,908,900
19405,30059,2995,14521,2066,27064,1808,908,900
19410,30069,2996,14527,2067,27073,1808,908,900
19415,30075,2996,14529,2067,27079,1809,909,900
19420,30086,2996,14533,2067,27090,1809,909,900
19425,30090,2996,14534,2067,27094,1809,909,900
19430,30100,2998,14541,2069,27102,1809,909,900
19435,30106,2998,14545,2069,27108,1810,910,900
19440,30117,3002,14552,2072,27115,1810,910,900
19445,30121,3002,14552,2072,27119,1810,910,900
19450,30131,3005,14555,2073,27126,1810,910,900
19455,30137,3005,14558,2073,27132,1812,912,900
19460,30148,3007,14563,2074,27141,1813,913,900
19465,30152,3007,14565,2074,27145,1813,913,900
19470,30162,3010,14567,2075,27152,1813,913,900
19475,30168,3010,14569,2075,27158,1814,913,901
19480,30179,3012,14574,2076,27167,1815,914,901
19485,30183,3013,14577,2077,27170,1815,914,901
19490,30193,3016,14582,2079,27177,1815,914,901
19495,30199,3016,14586,2079,27183,1816,915,901
19500,30210,3018,14591,2080,27192,1817,916,901
19505,30214,3018,14592,2080,27196,1817,916,901
19510,30224,3020,14595,2080,27204,1817,916,901
19515,30230,3020,14597,2080,27210,1818,916,902
19520,30241,3021,14604,2081,27220,1818,916,902
19525,30245,3021,14605,2081,27224,1818,916,902
19530,30255,3023,14611,2082,27232,1818,916,902
19535,30261,3023,14614,2082,27238,1819,916,903
19540,30272,3024,14617,2083,27248,1819,916,903
19545,30276,3024,14620,2083,27252,1819,916,903
19550,30286,3027,14624,2085,27259,1819,916,903
19555,30292,3027,14627,2085,27264,1820,916,904
19560,30303,3028,14631,2086,27275,1821,916,905
19565,30307,3028,14632,2086,27279,1821,916,905
19570,30317,3029,14637,2087,27288,1821,916,905
19575,30323,3029,14640,2087,27294,1823,917,906
19580,30334,3029,14647,2087,27305,1823,917,906
19585,30338,3029,14650,2087,27309,1823,917,906
19590,30348,3030,14652,2087,27318,1823,917,906
19595,30354,3030,14655,2087,27324,1824,917,907
19600,30365,3031,14662,2088,27334,1824,917,907
19605,30369,3031,14662,2088,27338,1824,917,907
19610,30379,3032,14667,2089,27347,1824,917,907
19615,30385,3032,14670,2089,27352,1825,917,908
19620,30396,3036,14676,2092,27360,1826,918,908
19625,30400,3036,14677,2092,27364,1826,918,908
19630,30410,3037,14683,2092,27373,1826,918,908
19635,30416,3037,14686,2092,27378,1828,919,909
19640,30427,3039,14693,2094,27388,1828,919,909
19645,30431,3039,14695,2094,27392,1828,919,909
19650,30441,3040,14700,2094,27401,1828,919,909
19655,30447,3040,14702,2094,27406,1830,919,911
19660,30458,3041,14707,2095,27417,1830,919,911
19665,30462,3041,14707,2095,27421,1830,919,911
19670,30472,3042,14711,2095,27430,1830,919,911
19675,30478,3042,14714,2095,27435,1832,919,913
19680,30489,3043,14720,2096,27446,1832,919,913
19685,30493,3043,14722,2096,27450,1832,919,913
19690,30503,3043,14727,2096,27460,1832,919,913
19695,30509,3043,14730,2096,27466,1833,920,913
19700,30520,3043,14733,2096,27477,1833,920,913
19705,30524,3043,14736,2096,27481,1833,920,913
19710,30534,3043,14742,2096,27491,1833,920,913
19715,30540,3043,14744,2096,27497,1834,921,913
19720,30551,3043,14748,2096,27508,1834,921,913
19725,30555,3043,14750,2096,27512,1834,921,913
19730,30565,3044,14755,2097,27521,1834,921,913
19735,30571,3044,14760,2097,27526,1835,922,913
19740,30582,3049,14768,2102,27533,1836,922,914
19745,30586,3051,14772,2104,27535,1836,922,914
19750,30596,3053,14779,2106,27543,1836,922,914
19755,30602,3053,14783,2106,27549,1837,922,915
19760,30613,3054,14789,2107,27559,1837,922,915
19765,30617,3054,14791,2107,27563,1837,922,915
19770,30627,3056,14796,2107,27571,1837,922,915
19775,30633,3056,14799,2107,27577,1838,922,916
19780,30644,3058,14805,2109,27586,1839,922,917
19785,30648,3058,14807,2109,27590,1839,922,917
19790,30658,3060,14812,2109,27598,1839,922,917
19795,30664,3060,14816,2109,27604,1840,922,918
19800,30675,3063,14823,2112,27612,1841,923,918
19805,30679,3064,14826,2113,27615,1841,923,918
19810,30689,3066,14831,2113,27623,1841,923,918
19815,30695,3066,14835,2113,27629,1842,924,918
19820,30706,3068,14840,2114,27638,1842,924,918
19825,30710,3068,14842,2114,27642,1842,924,918
19830,30720,3070,14843,2114,27650,1842,924,918
19835,30726,3070,14845,2114,27656,1844,925,919
19840,30737,3072,14850,2116,27665,1844,925,919
19845,30741,3072,14851,2116,27669,1844,925,919
19850,30751,3074,14853,2117,27677,1844,925,919
19855,30757,3074,14856,2117,27683,1846,926,920
19860,30768,3078,14866,2121,27690,1847,927,920
19865,30772,3078,14868,2121,27694,1847,927,920
19870,30782,3078,14871,2121,27704,1847,927,920
19875,30788,3078,14876,2121,27710,1849,929,920
19880,30799,3078,14882,2121,27721,1849,929,920
19885,30803,3078,14884,2121,27725,1849,929,920
19890,30813,3078,14889,2121,27735,1849,929,920
19895,30819,3078,14893,2121,27741,1850,929,921
19900,30830,3078,14898,2121,27752,1850,929,921
19905,30834,3078,14899,2121,27756,1850,929,921
19910,30844,3078,14904,2121,27766,1850,929,921
19915,30850,3078,14907,2121,27772,1851,930,921
19920,30861,3078,14911,2121,27783,1851,930,921
19925,30865,3079,14914,2122,27786,1851,930,921
19930,30875,3080,14918,2122,27795,1851,930,921
19935,30881,3080,14920,2122,27801,1852,930,922
19940,30892,3082,14924,2124,27810,1853,930,923
19945,30896,3082,14927,2124,27814,1853,930,923
19950,30906,3083,14932,2124,27823,1853,930,923
19955,30912,3083,14934,2124,27829,1854,931,923
19960,30923,3085,14942,2126,27838,1855,932,923
19965,30927,3085,14943,2126,27842,1855,932,923
19970,30937,3087,14950,2127,27850,1855,932,923
19975,30943,3087,14953,2127,27856,1856,933,923
19980,30954,3088,14956,2128,27865,1857,933,924
19985,30958,3089,14959,2129,27869,1857,933,924
19990,30968,3090,14962,2129,27878,1857,933,924
19995,30974,3090,14966,2129,27884,1858,933,925
20000,30985,3092,14971,2130,27893,1858,933,925
20005,30989,3093,14975,2131,27896,1858,933,925
20010,30999,3094,14982,2131,27905,1858,933,925
20015,31005,3094,14985,2131,27911,1859,934,925
20020,31016,3096,14993,2133,27920,1859,934,925
20025,31020,3097,14996,2134,27923,1859,934,925
20030,31030,3098,15000,2134,27932,1859,934,925
20035,31036,3098,15002,2134,27937,1860,935,925
20040,31047,3100,15007,2136,27946,1860,935,925
20045,31051,3101,15008,2137,27950,1860,935,925
20050,31061,3103,15013,2139,27958,1860,935,925
20055,31067,3103,15017,2139,27963,1862,936,926
20060,31078,3106,15020,2142,27971,1862,936,926
20065,31082,3109,15023,2145,27973,1862,936,926
20070,31092,3112,15027,2147,27980,1862,936,926
20075,31098,3112,15029,2147,27986,1864,937,927
20080,31109,3114,15034,2148,27995,1864,937,927
20085,31113,3116,15037,2150,27997,1864,937,927
20090,31123,3118,15040,2150,28005,1864,937,927
20095,31129,3118,15044,2150,28011,1866,939,927
20100,31140,3120,15048,2152,28020,1867,939,928
20105,31144,3120,15049,2152,28024,1867,939,928
20110,31154,3120,15054,2152,28034,1867,939,928
20115,31160,3120,15058,2152,28040,1868,940,928
20120,31171,3120,15060,2152,28051,1868,940,928
20125,31175,3120,15060,2152,28055,1868,940,928
20130,31185,3120,15064,2152,28065,1868,940,928
20135,31191,3120,15065,2152,28071,1869,940,929
20140,31202,3120,15071,2152,28082,1869,940,929
20145,31206,3120,15072,2152,28086,1869,940,929
20150,31216,3120,15073,2152,28096,1869,940,929
20155,31222,3120,15074,2152,28102,1870,940,930
20160,31233,3120,15079,2152,28113,1870,940,930
20165,31237,3120,15080,2152,28117,1870,940,930
20170,31247,3120,15087,2152,28127,1870,940,930
20175,31253,3120,15091,2152,28133,1871,941,930
20180,31264,3120,15098,2152,28144,1871,941,930
20185,31268,3120,15100,2152,28148,1871,941,930
20190,31278,3120,15106,2152,28158,1871,941,930
20195,31284,3120,15109,2152,28164,1872,941,931
20200,31295,3120,15117,2152,28175,1872,941,931
20205,31299,3120,15118,2152,28179,1872,941,931
20210,31309,3122,15123,2153,28187,1872,941,931
20215,31315,3122,15125,2153,28192,1874,942,932
20220,31326,3125,15131,2156,28200,1875,943,932
20225,31330,3127,15132,2158,28203,1875,943,932
20230,31340,3128,15138,2159,28212,1875,943,932
20235,31346,3128,15139,2159,28218,1877,944,933
20240,31357,3129,15145,2159,28228,1877,944,933
20245,31361,3130,15148,2160,28231,1877,944,933
20250,31371,3131,15152,2160,28240,1877,944,933
20255,31377,3131,15155,2160,28246,1879,944,935
20260,31388,3132,15157,2160,28256,1879,944,935
20265,31392,3132,15159,2160,28260,1879,944,935
20270,31402,3133,15166,2161,28269,1879,944,935
20275,31408,3133,15170,2161,28275,1880,945,935
20280,31419,3134,15173,2161,28285,1880,945,935
20285,31423,3134,15173,2161,28289,1880,945,935
20290,31433,3135,15177,2161,28298,1880,945,935
20295,31439,3135,15180,2161,28304,1881,946,935
20300,31450,3137,15186,2163,28313,1881,946,935
20305,31454,3137,15187,2163,28317,1881,946,935
20310,31464,3138,15193,2164,28326,1881,946,935
20315,31470,3138,15199,2164,28332,1882,947,935
20320,31481,3140,15206,2166,28341,1882,947,935
20325,31485,3140,15206,2166,28345,1882,947,935
20330,31495,3142,15210,2166,28353,1882,947,935
20335,31501,3142,15214,2166,28358,1883,947,936
20340,31512,3145,15218,2169,28366,1884,947,937
20345,31516,3146,15220,2170,28370,1884,947,937
20350,31526,3146,15225,2170,28380,1884,947,937
20355,31532,3146,15227,2170,28386,1885,947,938
20360,31543,3146,15232,2170,28397,1886,947,939
20365,31547,3146,15233,2170,28401,1886,947,939
20370,31557,3146,15238,2170,28411,1886,947,939
20375,31563,3146,15240,2170,28417,1887,947,940
20380,31574,3146,15244,2170,28428,1887,947,940
20385,31578,3146,15245,2170,28432,1887,947,940
20390,31588,3146,15250,2170,28442,1887,947,940
20395,31594,3146,15253,2170,28448,1888,947,941
20400,31605,3146,15262,2170,28459,1888,947,941
20405,31609,3146,15265,2170,28463,1888,947,941
20410,31619,3147,15269,2171,28472,1888,947,941
20415,31625,3147,15271,2171,28478,1890,947,943
20420,31636,3148,15274,2172,28488,1890,947,943
20425,31640,3148,15275,2172,28492,1890,947,943
20430,31650,3149,15279,2173,28501,1890,947,943
20435,31656,3149,15281,2173,28507,1892,947,945
20440,31667,3151,15287,2175,28516,1892,947,945
20445,31671,3151,15289,2175,28520,1892,947,945
20450,31681,3153,15295,2177,28528,1892,947,945
20455,31687,3153,15296,2177,28534,1894,948,946
20460,31698,3155,15300,2178,28543,1894,948,946
20465,31702,3156,15302,2179,28546,1894,948,946
20470,31712,3156,15308,2179,28556,1894,948,946
20475,31718,3156,15312,2179,28562,1895,949,946
20480,31729,3157,15320,2180,28572,1895,949,946
20485,31733,3158,15323,2181,28575,1895,949,946
20490,31743,3158,15328,2181,28585,1895,949,946
20495,31749,3158,15332,2181,28591,1896,950,946
20500,31760,3159,15336,2182,28601,1896,950,946
20505,31764,3159,15337,2182,28605,1896,950,946
20510,31774,3159,15344,2182,28615,1896,950,946
20515,31780,3159,15348,2182,28621,1897,951,946
20520,31791,3160,15351,2183,28631,1897,951,946
20525,31795,3161,15352,2184,28634,1897,951,946
20530,31805,3161,15355,2184,28644,1897,951,946
20535,31811,3161,15358,2184,28650,1899,952,947
20540,31822,3162,15363,2184,28660,1899,952,947
20545,31826,3162,15365,2184,28664,1899,952,947
20550,31836,3162,15371,2184,28674,1899,952,947
20555,31842,3162,15374,2184,28680,1900,953,947
20560,31853,3163,15380,2184,28690,1900,953,947
20565,31857,3163,15380,2184,28694,1900,953,947
20570,31867,3165,15382,2184,28702,1900,953,947
20575,31873,3165,15387,2184,28707,1901,954,947
20580,31884,3170,15391,2188,28713,1902,954,948
20585,31888,3171,15393,2189,28717,1902,954,948
20590,31898,3173,15399,2191,28725,1902,954,948
20595,31904,3173,15402,2191,28731,1903,954,949
20600,31915,3173,15409,2191,28742,1904,955,949
20605,31919,3173,15411,2191,28746,1904,955,949
20610,31929,3174,15416,2191,28755,1904,955,949
20615,31935,3174,15418,2191,28761,1905,955,950
20620,31946,3174,15424,2191,28772,1906,955,951
20625,31950,3175,15428,2192,28775,1906,955,951
20630,31960,3177,15433,2193,28783,1906,955,951
20635,31966,3177,15434,2193,28789,1907,955,952
20640,31977,3177,15442,2193,28800,1908,956,952
20645,31981,3177,15444,2193,28804,1908,956,952
20650,31991,3179,15448,2193,28812,1908,956,952
20655,31997,3179,15452,2193,28818,1909,956,953
20660,32008,3179,15457,2193,28829,1909,956,953
20665,32012,3179,15458,2193,28833,1909,956,953
20670,32022,3181,15461,2193,28841,1909,956,953
20675,32028,3181,15465,2193,28847,1910,957,953
20680,32039,3181,15471,2193,28858,1910,957,953
20685,32043,3181,15472,2193,28862,1910,957,953
20690,32053,3183,15477,2194,28870,1910,957,953
20695,32059,3183,15481,2194,28876,1911,958,953
20700,32070,3187,15489,2197,28882,1912,959,953
20705,32074,3188,15491,2198,28886,1912,959,953
20710,32084,3188,15495,2198,28896,1912,959,953
20715,32090,3188,15500,2198,28902,1914,961,953
20720,32101,3188,15504,2198,28913,1914,961,953
20725,32105,3188,15506,2198,28917,1914,961,953
20730,32115,3188,15511,2198,28927,1914,961,953
20735,32121,3188,15512,2198,28933,1916,961,955
20740,32132,3188,15515,2198,28944,1916,961,955
20745,32136,3188,15517,2198,28948,1916,961,955
20750,32146,3188,15524,2198,28958,1916,961,955
20755,32152,3188,15529,2198,28964,1918,963,955
20760,32163,3188,15533,2198,28975,1918,963,955
20765,32167,3188,15533,2198,28979,1918,963,955
20770,32177,3189,15538,2198,28988,1918,963,955
20775,32183,3189,15541,2198,28994,1919,963,956
20780,32194,3190,15545,2199,29004,1919,963,956
20785,32198,3190,15547,2199,29008,1919,963,956
20790,32208,3191,15552,2199,29017,1919,963,956
20795,32214,3191,15555,2199,29023,1920,964,956
20800,32225,3191,15561,2199,29034,1920,964,956
20805,32229,3191,15561,2199,29038,1920,964,956
20810,32239,3194,15566,2201,29045,1920,964,956
20815,32245,3194,15570,2201,29051,1921,964,957
20820,32256,3199,15576,2205,29057,1922,964,958
20825,32260,3199,15579,2205,29061,1922,964,958
20830,32270,3199,15586,2205,29071,1922,964,958
20835,32276,3199,15588,2205,29077,1923,964,959
20840,32287,3201,15596,2207,29086,1923,964,959
20845,32291,3201,15597,2207,29090,1923,964,959
20850,32301,3201,15602,2207,29100,1923,964,959
20855,32307,3201,15604,2207,29106,1924,965,959
20860,32318,3203,15609,2209,29115,1924,965,959
20865,32322,3203,15609,2209,29119,1924,965,959
20870,32332,3203,15613,2209,29129,1924,965,959
20875,32338,3203,15615,2209,29135,1925,966,959
20880,32349,3204,15620,2210,29145,1925,966,959
20885,32353,3204,15623,2210,29149,1925,966,959
20890,32363,3204,15626,2210,29159,1925,966,959
20895,32369,3204,15628,2210,29165,1926,966,960
20900,32380,3206,15633,2212,29174,1926,966,960
20905,32384,3206,15634,2212,29178,1926,966,960
20910,32394,3206,15641,2212,29188,1926,966,960
20915,32400,3206,15644,2212,29194,1927,966,961
20920,32411,3207,15652,2213,29204,1927,966,961
20925,32415,3207,15654,2213,29208,1927,966,961
20930,32425,3209,15661,2215,29216,1927,966,961
20935,32431,3209,15664,2215,29222,1929,967,962
20940,32442,3213,15668,2218,29229,1930,967,963
20945,32446,3214,15671,2219,29232,1930,967,963
20950,32456,3215,15677,2220,29241,1930,967,963
20955,32462,3215,15680,2220,29246,1931,967,964
20960,32473,3217,15687,2222,29255,1931,967,964
20965,32477,3218,15690,2223,29259,1931,967,964
20970,32487,3219,15694,2223,29268,1931,967,964
20975,32493,3219,15698,2223,29274,1932,968,964
20980,32504,3220,15705,2224,29284,1932,968,964
20985,32508,3220,15708,2224,29288,1932,968,964
20990,32518,3221,15715,2224,29297,1932,968,964
20995,32524,3221,15718,2224,29303,1933,969,964
21000,32535,3222,15727,2225,29313,1933,969,964
21005,32539,3222,15728,2225,29317,1933,969,964
21010,32549,3223,15735,2226,29326,1933,969,964
21015,32555,3223,15740,2226,29332,1934,970,964
21020,32566,3223,15744,2226,29343,1934,970,964
21025,32570,3223,15745,2226,29347,1934,970,964
21030,32580,3224,15746,2226,29356,1934,970,964
21035,32586,3224,15747,2226,29362,1935,970,965
21040,32597,3224,15751,2226,29373,1935,970,965
21045,32601,3225,15753,2227,29376,1935,970,965
21050,32611,3227,15756,2227,29384,1935,970,965
21055,32617,3227,15760,2227,29390,1937,971,966
21060,32628,3230,15764,2229,29398,1938,971,967
21065,32632,3230,15766,2229,29402,1938,971,967
21070,32642,3230,15771,2229,29412,1938,971,967
21075,32648,3230,15773,2229,29418,1939,971,968
21080,32659,3231,15777,2230,29428,1939,971,968
21085,32663,3231,15779,2230,29432,1939,971,968
21090,32673,3231,15783,2230,29442,1939,971,968
21095,32679,3231,15786,2230,29448,1940,972,968
21100,32690,3232,15791,2231,29458,1940,972,968
21105,32694,3232,15792,2231,29462,1940,972,968
21110,32704,3232,15795,2231,29472,1940,972,968
21115,32710,3232,15796,2231,29478,1941,972,969
21120,32721,3233,15802,2232,29488,1941,972,969
21125,32725,3233,15805,2232,29492,1941,972,969
21130,32735,3233,15811,2232,29502,1941,972,969
21135,32741,3233,15812,2232,29508,1942,972,970
21140,32752,3234,15816,2232,29518,1942,972,970
21145,32756,3234,15817,2232,29522,1942,972,970
21150,32766,3234,15824,2232,29532,1942,972,970
21155,32772,3234,15827,2232,29538,1943,972,971
21160,32783,3236,15832,2233,29547,1943,972,971
21165,32787,3237,15835,2234,29550,1943,972,971
21170,32797,3239,15839,2234,29558,1943,972,971
21175,32803,3239,15844,2234,29563,1945,974,971
21180,32814,3242,15850,2237,29571,1946,975,971
21185,32818,3243,15852,2238,29575,1946,975,971
21190,32828,3244,15857,2239,29584,1946,975,971
21195,32834,3244,15862,2239,29590,1947,976,971
21200,32845,3245,15867,2240,29600,1947,976,971
21205,32849,3245,15869,2240,29604,1947,976,971
21210,32859,3246,15872,2240,29613,1947,976,971
21215,32865,3246,15876,2240,29619,1948,977,971
21220,32876,3247,15882,2241,29629,1948,977,971
21225,32880,3247,15884,2241,29633,1948,977,971
21230,32890,3248,15889,2242,29642,1948,977,971
21235,32896,3248,15892,2242,29648,1949,978,971
21240,32907,3248,15896,2242,29659,1949,978,971
21245,32911,3248,15897,2242,29663,1949,978,971
21250,32921,3250,15901,2243,29671,1949,978,971
21255,32927,3250,15902,2243,29677,1950,978,972
21260,32938,3252,15909,2245,29685,1950,978,972
21265,32942,3253,15910,2246,29689,1950,978,972
21270,32952,3255,15918,2248,29697,1950,978,972
21275,32958,3255,15921,2248,29703,1951,978,973
21280,32969,3255,15925,2248,29714,1951,978,973
21285,32973,3256,15929,2249,29717,1951,978,973
21290,32983,3258,15938,2251,29725,1951,978,973
21295,32989,3258,15939,2251,29731,1953,978,975
21300,33000,3261,15945,2254,29739,1954,978,976
21305,33004,3261,15947,2254,29743,1954,978,976
21310,33014,3262,15949,2255,29752,1954,978,976
21315,33020,3262,15950,2255,29758,1955,978,977
21320,33031,3264,15955,2257,29767,1955,978,977
21325,33035,3264,15958,2257,29771,1955,978,977
21330,33045,3265,15962,2257,29780,1955,978,977
21335,33051,3265,15965,2257,29786,1956,979,977
21340,33062,3267,15973,2259,29795,1956,979,977
21345,33066,3267,15974,2259,29799,1956,979,977
21350,33076,3268,15980,2260,29808,1956,979,977
21355,33082,3268,15982,2260,29814,1957,979,978
21360,33093,3269,15987,2261,29823,1957,979,978
21365,33097,3270,15990,2262,29827,1957,979,978
21370,33107,3271,15994,2262,29836,1957,979,978
21375,33113,3271,15999,2262,29842,1958,980,978
21380,33124,3272,16003,2262,29852,1958,980,978
21385,33128,3272,16005,2262,29856,1958,980,978
21390,33138,3273,16009,2263,29865,1958,980,978
21395,33144,3273,16015,2263,29870,1959,981,978
21400,33155,3275,16017,2264,29880,1959,981,978
21405,33159,3275,16019,2264,29884,1959,981,978
21410,33169,3276,16024,2265,29893,1959,981,978
21415,33175,3276,16025,2265,29899,1961,982,979
21420,33186,3277,16028,2266,29908,1962,982,980
21425,33190,3278,16030,2267,29912,1962,982,980
21430,33200,3278,16037,2267,29922,1962,982,980
21435,33206,3278,16041,2267,29928,1963,983,980
21440,33217,3279,16045,2267,29938,1963,983,980
21445,33221,3280,16047,2268,29941,1963,983,980
21450,33231,3280,16051,2268,29951,1963,983,980
21455,33237,3280,16056,2268,29957,1964,984,980
21460,33248,3282,16061,2269,29966,1964,984,980
21465,33252,3282,16062,2269,29970,1964,984,980
21470,33262,3283,16064,2269,29979,1964,984,980
21475,33268,3283,16066,2269,29985,1965,984,981
21480,33279,3286,16073,2271,29993,1965,984,981
21485,33283,3287,16076,2272,29996,1965,984,981
21490,33293,3289,16080,2273,30004,1965,984,981
21495,33299,3289,16085,2273,30009,1966,985,981
21500,33310,3290,16090,2274,30020,1966,985,981
21505,33314,3290,16092,2274,30024,1966,985,981
21510,33324,3292,16097,2275,30032,1966,985,981
21515,33330,3292,16100,2275,30037,1967,985,982
21520,33341,3294,16103,2277,30047,1967,985,982
21525,33345,3295,16106,2278,30050,1967,985,982
21530,33355,3298,16113,2281,30057,1967,985,982
21535,33361,3298,16115,2281,30063,1969,986,983
21540,33372,3300,16119,2283,30072,1970,986,984
21545,33376,3300,16121,2283,30076,1970,986,984
21550,33386,3301,16127,2283,30085,1970,986,984
21555,33392,3301,16131,2283,30091,1971,987,984
21560,33403,3303,16136,2285,30099,1972,987,985
21565,33407,3304,16140,2286,30103,1972,987,985
21570,33417,3305,16146,2286,30112,1972,987,985
21575,33423,3305,16149,2286,30118,1973,988,985
21580,33434,3306,16155,2287,30128,1974,988,986
21585,33438,3306,16156,2287,30132,1974,988,986
21590,33448,3307,16162,2288,30141,1974,988,986
21595,33454,3307,16166,2288,30147,1975,989,986
21600,33465,3309,16175,2290,30156,1976,990,986
21605,33469,3310,16179,2291,30159,1976,990,986
21610,33479,3311,16186,2292,30168,1976,990,986
21615,33485,3311,16189,2292,30174,1977,990,987
21620,33496,3313,16195,2294,30183,1977,990,987
21625,33500,3313,16196,2294,30187,1977,990,987
21630,33510,3314,16201,2294,30196,1977,990,987
21635,33516,3314,16204,2294,30202,1978,990,988
21640,33527,3316,16212,2296,30211,1978,990,988
21645,33531,3316,16215,2296,30215,1978,990,988
21650,33541,3318,16220,2297,30223,1978,990,988
21655,33547,3318,16222,2297,30229,1980,991,989
21660,33558,3319,16224,2298,30239,1981,992,989
21665,33562,3319,16225,2298,30243,1981,992,989
21670,33572,3320,16232,2298,30252,1981,992,989
21675,33578,3320,16235,2298,30257,1982,993,989
21680,33589,3323,16240,2300,30266,1982,993,989
21685,33593,3323,16241,2300,30270,1982,993,989
21690,33603,3324,16250,2301,30279,1982,993,989
21695,33609,3324,16252,2301,30284,1983,993,990
21700,33620,3326,16257,2303,30294,1983,993,990
21705,33624,3326,16259,2303,30298,1983,993,990
21710,33634,3327,16263,2303,30307,1983,993,990
21715,33640,3327,16266,2303,30313,1984,994,990
21720,33651,3329,16271,2304,30322,1985,995,990
21725,33655,3329,16274,2304,30326,1985,995,990
21730,33665,3330,16279,2304,30335,1985,995,990
21735,33671,3330,16281,2304,30341,1986,996,990
21740,33682,3332,16287,2306,30350,1986,996,990
21745,33686,3332,16290,2306,30354,1986,996,990
21750,33696,3333,16296,2307,30363,1986,996,990
21755,33702,3333,16299,2307,30369,1987,997,990
21760,33713,3335,16304,2308,30378,1987,997,990
21765,33717,3335,16306,2308,30382,1987,997,990
21770,33727,3336,16308,2309,30391,1987,997,990
21775,33733,3336,16312,2309,30397,1989,999,990
21780,33744,3338,16319,2311,30406,1989,999,990
21785,33748,3338,16321,2311,30410,1989,999,990
21790,33758,3338,16325,2311,30420,1989,999,990
21795,33764,3338,16327,2311,30426,1991,1000,991
21800,33775,3339,16335,2312,30436,1991,1000,991
21805,33779,3339,16336,2312,30440,1991,1000,991
21810,33789,3339,16339,2312,30450,1991,1000,991
21815,33795,3339,16341,2312,30456,1993,1000,993
21820,33806,3340,16348,2312,30466,1993,1000,993
21825,33810,3341,16350,2313,30469,1993,1000,993
21830,33820,3341,16357,2313,30479,1993,1000,993
21835,33826,3341,16358,2313,30485,1995,1001,994
21840,33837,3342,16364,2313,30495,1995,1001,994
21845,33841,3343,16367,2314,30498,1995,1001,994
21850,33851,3344,16373,2315,30507,1995,1001,994
21855,33857,3344,16376,2315,30513,1996,1002,994
21860,33868,3347,16383,2317,30521,1996,1002,994
21865,33872,3347,16385,2317,30525,1996,1002,994
21870,33882,3348,16388,2317,30534,1996,1002,994
21875,33888,3348,16391,2317,30540,1997,1003,994
21880,33899,3350,16396,2318,30549,1997,1003,994
21885,33903,3351,16397,2319,30552,1997,1003,994
21890,33913,3353,16402,2320,30560,1997,1003,994
21895,33919,3353,16406,2320,30565,1998,1003,995
21900,33930,3357,16411,2323,30572,1999,1004,995
21905,33934,3358,16413,2324,30576,1999,1004,995
21910,33944,3360,16419,2326,30584,1999,1004,995
21915,33950,3360,16421,2326,30590,2000,1004,996
21920,33961,3362,16429,2328,30599,2001,1005,996
21925,33965,3362,16431,2328,30603,2001,1005,996
21930,33975,3364,16434,2329,30611,2001,1005,996
21935,33981,3364,16436,2329,30617,2002,1005,997
21940,33992,3365,16442,2330,30627,2003,1005,998
21945,33996,3365,16444,2330,30631,2003,1005,998
21950,34006,3367,16449,2331,30639,2003,1005,998
21955,34012,3367,16453,2331,30645,2004,1006,998
21960,34023,3368,16457,2332,30655,2005,1006,999
21965,34027,3368,16458,2332,30659,2005,1006,999
21970,34037,3369,16461,2332,30668,2005,1006,999
21975,34043,3369,16464,2332,30674,2006,1006,1000
21980,34054,3369,16468,2332,30685,2007,1007,1000
21985,34058,3369,16470,2332,30689,2007,1007,1000
21990,34068,3370,16476,2333,30698,2007,1007,1000
21995,34074,3370,16479,2333,30704,2008,1008,1000
22000,34085,3370,16482,2333,30715,2008,1008,1000
22005,34089,3371,16484,2334,30718,2008,1008,1000
22010,34099,3373,16489,2335,30726,2008,1008,1000
22015,34105,3373,16494,2335,30732,2010,1010,1000
22020,34116,3374,16499,2335,30741,2010,1010,1000
22025,34120,3375,16501,2336,30745,2010,1010,1000
22030,34130,3376,16505,2337,30754,2010,1010,1000
22035,34136,3376,16510,2337,30760,2012,1012,1000
22040,34147,3379,16518,2340,30768,2012,1012,1000
22045,34151,3379,16521,2340,30772,2012,1012,1000
22050,34161,3380,16526,2341,30781,2012,1012,1000
22055,34167,3380,16529,2341,30787,2014,1013,1001
22060,34178,3382,16535,2342,30796,2014,1013,1001
22065,34182,3382,16538,2342,30800,2014,1013,1001
22070,34192,3383,16543,2342,30809,2014,1013,1001
22075,34198,3383,16546,2342,30815,2016,1014,1002
22080,34209,3385,16551,2344,30824,2016,1014,1002
22085,34213,3385,16552,2344,30828,2016,1014,1002
22090,34223,3386,16560,2345,30837,2016,1014,1002
22095,34229,3386,16563,2345,30843,2017,1014,1003
22100,34240,3387,16570,2346,30853,2017,1014,1003
22105,34244,3388,16572,2347,30856,2017,1014,1003
22110,34254,3389,16577,2347,30865,2017,1014,1003
22115,34260,3389,16580,2347,30871,2018,1015,1003
22120,34271,3390,16588,2348,30881,2019,1016,1003
22125,34275,3390,16589,2348,30885,2019,1016,1003
22130,34285,3392,16594,2349,30893,2019,1016,1003
22135,34291,3392,16595,2349,30899,2020,1016,1004
22140,34302,3394,16601,2351,30908,2020,1016,1004
22145,34306,3395,16605,2352,30911,2020,1016,1004
22150,34316,3395,16606,2352,30921,2020,1016,1004
22155,34322,3395,16608,2352,30927,2021,1016,1005
22160,34333,3397,16613,2353,30936,2021,1016,1005
22165,34337,3397,16614,2353,30940,2021,1016,1005
22170,34347,3397,16623,2353,30950,2021,1016,1005
22175,34353,3397,16625,2353,30956,2022,1016,1006
22180,34364,3399,16629,2355,30965,2022,1016,1006
22185,34368,3400,16631,2356,30968,2022,1016,1006
22190,34378,3401,16635,2356,30977,2022,1016,1006
22195,34384,3401,16639,2356,30983,2023,1017,1006
22200,34395,3403,16645,2358,30992,2024,1017,1007
22205,34399,3404,16648,2359,30995,2024,1017,1007
22210,34409,3405,16650,2359,31004,2024,1017,1007
22215,34415,3405,16654,2359,31010,2025,1017,1008
22220,34426,3406,16660,2360,31020,2025,1017,1008
22225,34430,3407,16663,2361,31023,2025,1017,1008
22230,34440,3409,16670,2362,31031,2025,1017,1008
22235,34446,3409,16671,2362,31037,2027,1018,1009
22240,34457,3410,16677,2363,31047,2027,1018,1009
22245,34461,3410,16680,2363,31051,2027,1018,1009
22250,34471,3411,16684,2364,31060,2027,1018,1009
22255,34477,3411,16688,2364,31065,2029,1019,1010
22260,34488,3412,16695,2365,31076,2029,1019,1010
22265,34492,3412,16697,2365,31080,2029,1019,1010
22270,34502,3413,16701,2366,31089,2029,1019,1010
22275,34508,3413,16704,2366,31094,2031,1019,1012
22280,34519,3414,16710,2367,31105,2031,1019,1012
22285,34523,3414,16712,2367,31109,2031,1019,1012
22290,34533,3415,16716,2367,31118,2031,1019,1012
22295,34539,3415,16720,2367,31123,2032,1020,1012
22300,34550,3416,16726,2368,31134,2032,1020,1012
22305,34554,3416,16727,2368,31138,2032,1020,1012
22310,34564,3418,16731,2368,31146,2032,1020,1012
22315,34570,3418,16733,2368,31151,2033,1021,1012
22320,34581,3422,16738,2371,31159,2034,1022,1012
22325,34585,3423,16740,2372,31162,2034,1022,1012
22330,34595,3424,16745,2373,31171,2034,1022,1012
22335,34601,3424,16746,2373,31177,2035,1022,1013
22340,34612,3426,16750,2374,31186,2035,1022,1013
22345,34616,3426,16752,2374,31190,2035,1022,1013
22350,34626,3427,16758,2375,31199,2035,1022,1013
22355,34632,3427,16760,2375,31205,2036,1022,1014
22360,34643,3429,16765,2376,31214,2036,1022,1014
22365,34647,3430,16768,2377,31217,2036,1022,1014
22370,34657,3431,16775,2378,31226,2036,1022,1014
22375,34663,3431,16778,2378,31232,2037,1022,1015
22380,34674,3433,16784,2379,31241,2037,1022,1015
22385,34678,3433,16785,2379,31245,2037,1022,1015
22390,34688,3435,16789,2379,31253,2037,1022,1015
22395,34694,3435,16792,2379,31258,2038,1023,1015
22400,34705,3437,16797,2380,31268,2038,1023,1015
22405,34709,3437,16799,2380,31272,2038,1023,1015
22410,34719,3439,16803,2381,31280,2038,1023,1015
22415,34725,3439,16805,2381,31285,2039,1023,1016
22420,34736,3443,16811,2384,31293,2039,1023,1016
22425,34740,3443,16812,2384,31297,2039,1023,1016
22430,34750,3445,16816,2385,31305,2039,1023,1016
22435,34756,3445,16819,2385,31311,2040,1024,1016
22440,34767,3446,16823,2385,31320,2041,1025,1016
22445,34771,3447,16824,2386,31324,2041,1025,1016
22450,34781,3448,16830,2386,31333,2041,1025,1016
22455,34787,3448,16831,2386,31339,2042,1025,1017
22460,34798,3449,16836,2387,31349,2042,1025,1017
22465,34802,3449,16839,2387,31353,2042,1025,1017
22470,34812,3450,16843,2388,31362,2042,1025,1017
22475,34818,3450,16848,2388,31368,2043,1026,1017
22480,34829,3451,16853,2389,31378,2043,1026,1017
22485,34833,3451,16857,2389,31382,2043,1026,1017
22490,34843,3452,16863,2390,31391,2043,1026,1017
22495,34849,3452,16866,2390,31397,2045,1028,1017
22500,34860,3452,16872,2390,31408,2045,1028,1017
22505,34864,3452,16875,2390,31412,2045,1028,1017
22510,34874,3454,16878,2391,31420,2045,1028,1017
22515,34880,3454,16879,2391,31426,2047,1028,1019
22520,34891,3455,16882,2392,31436,2047,1028,1019
22525,34895,3455,16883,2392,31440,2047,1028,1019
22530,34905,3457,16888,2393,31448,2047,1028,1019
22535,34911,3457,16892,2393,31454,2049,1030,1019
22540,34922,3458,16896,2394,31464,2049,1030,1019
22545,34926,3458,16897,2394,31468,2049,1030,1019
22550,34936,3460,16904,2395,31476,2049,1030,1019
22555,34942,3460,16907,2395,31482,2051,1030,1021
22560,34953,3461,16911,2396,31491,2052,1031,1021
22565,34957,3463,16914,2398,31494,2052,1031,1021
22570,34967,3465,16918,2400,31502,2052,1031,1021
22575,34973,3465,16920,2400,31508,2053,1031,1022
22580,34984,3466,16923,2400,31518,2053,1031,1022
22585,34988,3466,16925,2400,31522,2053,1031,1022
22590,34998,3468,16931,2402,31530,2053,1031,1022
22595,35004,3468,16934,2402,31536,2054,1031,1023
22600,35015,3470,16939,2403,31545,2054,1031,1023
22605,35019,3470,16940,2403,31549,2054,1031,1023
22610,35029,3472,16946,2404,31557,2054,1031,1023
22615,35035,3472,16949,2404,31563,2055,1031,1024
22620,35046,3475,16953,2407,31571,2055,1031,1024
22625,35050,3475,16954,2407,31575,2055,1031,1024
22630,35060,3476,16958,2408,31584,2055,1031,1024
22635,35066,3476,16961,2408,31590,2056,1032,1024
22640,35077,3478,16972,2410,31599,2056,1032,1024
22645,35081,3478,16975,2410,31603,2056,1032,1024
22650,35091,3479,16978,2410,31612,2056,1032,1024
22655,35097,3479,16982,2410,31618,2057,1032,1025
22660,35108,3481,16987,2412,31627,2057,1032,1025
22665,35112,3481,16988,2412,31631,2057,1032,1025
22670,35122,3482,16991,2413,31640,2057,1032,1025
22675,35128,3482,16994,2413,31645,2059,1033,1026
22680,35139,3485,16998,2415,31654,2059,1033,1026
22685,35143,3486,17002,2416,31657,2059,1033,1026
22690,35153,3487,17006,2417,31666,2059,1033,1026
22695,35159,3487,17010,2417,31671,2061,1033,1028
22700,35170,3491,17017,2421,31679,2061,1033,1028
22705,35174,3492,17020,2422,31682,2061,1033,1028
22710,35184,3493,17024,2423,31691,2061,1033,1028
22715,35190,3493,17027,2423,31696,2062,1034,1028
22720,35201,3497,17035,2426,31704,2062,1034,1028
22725,35205,3498,17037,2427,31707,2062,1034,1028
22730,35215,3499,17040,2427,31716,2062,1034,1028
22735,35221,3499,17041,2427,31722,2063,1034,1029
22740,35232,3500,17047,2428,31732,2063,1034,1029
22745,35236,3500,17049,2428,31736,2063,1034,1029
22750,35246,3501,17054,2429,31745,2063,1034,1029
22755,35252,3501,17059,2429,31750,2065,1036,1029
22760,35263,3504,17062,2432,31759,2065,1036,1029
22765,35267,3504,17065,2432,31763,2065,1036,1029
22770,35277,3505,17069,2432,31772,2065,1036,1029
22775,35283,3505,17070,2432,31778,2066,1036,1030
22780,35294,3507,17076,2433,31787,2066,1036,1030
22785,35298,3507,17077,2433,31791,2066,1036,1030
22790,35308,3509,17081,2433,31799,2066,1036,1030
22795,35314,3509,17085,2433,31804,2067,1037,1030
22800,35325,3513,17091,2436,31811,2068,1037,1031
22805,35329,3514,17091,2437,31815,2068,1037,1031
22810,35339,3515,17096,2438,31824,2068,1037,1031
22815,35345,3515,17098,2438,31830,2069,1038,1031
22820,35356,3516,17099,2438,31839,2070,1038,1032
22825,35360,3517,17100,2439,31843,2070,1038,1032
22830,35370,3518,17109,2439,31852,2070,1038,1032
22835,35376,3518,17112,2439,31858,2071,1039,1032
22840,35387,3519,17117,2440,31868,2072,1040,1032
22845,35391,3519,17119,2440,31872,2072,1040,1032
22850,35401,3520,17125,2441,31881,2072,1040,1032
22855,35407,3520,17129,2441,31887,2073,1041,1032
22860,35418,3522,17134,2443,31896,2073,1041,1032
22865,35422,3524,17137,2445,31898,2073,1041,1032
22870,35432,3525,17141,2446,31907,2073,1041,1032
22875,35438,3525,17144,2446,31913,2074,1041,1033
22880,35449,3527,17148,2447,31922,2074,1041,1033
22885,35453,3527,17148,2447,31926,2074,1041,1033
22890,35463,3528,17153,2447,31935,2074,1041,1033
22895,35469,3528,17156,2447,31941,2075,1042,1033
22900,35480,3531,17164,2450,31949,2075,1042,1033
22905,35484,3532,17166,2451,31952,2075,1042,1033
22910,35494,3533,17169,2451,31961,2075,1042,1033
22915,35500,3533,17174,2451,31967,2077,1043,1034
22920,35511,3536,17182,2454,31975,2077,1043,1034
22925,35515,3536,17184,2454,31979,2077,1043,1034
22930,35525,3537,17187,2454,31988,2077,1043,1034
22935,35531,3537,17190,2454,31994,2079,1043,1036
22940,35542,3539,17195,2456,32003,2079,1043,1036
22945,35546,3539,17197,2456,32007,2079,1043,1036
22950,35556,3540,17202,2457,32016,2079,1043,1036
22955,35562,3540,17205,2457,32022,2081,1043,1038
22960,35573,3542,17211,2459,32031,2082,1044,1038
22965,35577,3542,17211,2459,32035,2082,1044,1038
22970,35587,3543,17217,2459,32044,2082,1044,1038
22975,35593,3543,17221,2459,32049,2084,1044,1040
22980,35604,3547,17227,2462,32056,2085,1045,1040
22985,35608,3548,17229,2463,32060,2085,1045,1040
22990,35618,3548,17235,2463,32070,2085,1045,1040
22995,35624,3548,17238,2463,32076,2087,1046,1041
23000,35635,3548,17240,2463,32087,2087,1046,1041
23005,35639,3548,17243,2463,32091,2087,1046,1041
23010,35649,3548,17247,2463,32101,2087,1046,1041
23015,35655,3548,17249,2463,32107,2089,1046,1043
23020,35666,3548,17256,2463,32118,2089,1046,1043
23025,35670,3548,17257,2463,32122,2089,1046,1043
23030,35680,3548,17262,2463,32132,2089,1046,1043
23035,35686,3548,17263,2463,32138,2091,1046,1045
23040,35697,3548,17270,2463,32149,2091,1046,1045
23045,35701,3548,17270,2463,32153,2091,1046,1045
23050,35711,3549,17274,2463,32162,2091,1046,1045
23055,35717,3549,17277,2463,32168,2092,1046,1046
23060,35728,3551,17282,2465,32176,2093,1046,1047
23065,35732,3552,17284,2466,32180,2093,1046,1047
23070,35742,3553,17290,2466,32189,2093,1046,1047
23075,35748,3553,17295,2466,32194,2094,1047,1047
23080,35759,3556,17301,2469,32203,2095,1048,1047
23085,35763,3556,17302,2469,32207,2095,1048,1047
23090,35773,3558,17305,2470,32215,2095,1048,1047
23095,35779,3558,17310,2470,32220,2096,1048,1048
23100,35790,3562,17317,2474,32228,2097,1049,1048
23105,35794,3562,17320,2474,32232,2097,1049,1048
23110,35804,3563,17326,2474,32241,2097,1049,1048
23115,35810,3563,17326,2474,32247,2098,1049,1049
23120,35821,3564,17330,2475,32257,2098,1049,1049
23125,35825,3564,17331,2475,32261,2098,1049,1049
23130,35835,3565,17338,2476,32270,2098,1049,1049
23135,35841,3565,17341,2476,32276,2099,1050,1049
23140,35852,3565,17346,2476,32287,2099,1050,1049
23145,35856,3565,17347,2476,32291,2099,1050,1049
23150,35866,3566,17353,2477,32300,2099,1050,1049
23155,35872,3566,17358,2477,32306,2100,1051,1049
23160,35883,3567,17363,2478,32316,2100,1051,1049
23165,35887,3567,17366,2478,32320,2100,1051,1049
23170,35897,3568,17372,2479,32329,2100,1051,1049
23175,35903,3568,17376,2479,32335,2101,1051,1050
23180,35914,3568,17380,2479,32346,2101,1051,1050
23185,35918,3568,17381,2479,32350,2101,1051,1050
23190,35928,3569,17384,2480,32359,2101,1051,1050
23195,35934,3569,17388,2480,32365,2102,1051,1051
23200,35945,3570,17395,2481,32375,2102,1051,1051
23205,35949,3570,17396,2481,32379,2102,1051,1051
23210,35959,3572,17403,2483,32387,2102,1051,1051
23215,35965,3572,17407,2483,32393,2104,1053,1051
23220,35976,3576,17413,2487,32400,2105,1053,1052
23225,35980,3576,17416,2487,32404,2105,1053,1052
23230,35990,3578,17421,2488,32412,2105,1053,1052
23235,35996,3578,17424,2488,32418,2107,1054,1053
23240,36007,3580,17430,2490,32427,2107,1054,1053
23245,36011,3580,17433,2490,32431,2107,1054,1053
23250,36021,3581,17436,2490,32440,2107,1054,1053
23255,36027,3581,17439,2490,32446,2108,1054,1054
23260,36038,3582,17444,2491,32456,2108,1054,1054
23265,36042,3582,17446,2491,32460,2108,1054,1054
23270,36052,3584,17451,2493,32468,2108,1054,1054
23275,36058,3584,17455,2493,32474,2109,1055,1054
23280,36069,3586,17460,2495,32483,2109,1055,1054
23285,36073,3586,17464,2495,32487,2109,1055,1054
23290,36083,3587,17469,2495,32496,2109,1055,1054
23295,36089,3587,17473,2495,32502,2110,1056,1054
23300,36100,3589,17479,2496,32511,2110,1056,1054
23305,36104,3589,17480,2496,32515,2110,1056,1054
23310,36114,3590,17488,2497,32524,2110,1056,1054
23315,36120,3590,17491,2497,32530,2111,1056,1055
23320,36131,3592,17496,2498,32539,2111,1056,1055
23325,36135,3592,17499,2498,32543,2111,1056,1055
23330,36145,3595,17505,2499,32550,2111,1056,1055
23335,36151,3595,17508,2499,32556,2112,1057,1055
23340,36162,3599,17514,2503,32562,2113,1057,1056
23345,36166,3600,17515,2504,32566,2113,1057,1056
23350,36176,3602,17517,2504,32574,2113,1057,1056
23355,36182,3602,17517,2504,32580,2115,1057,1058
23360,36193,3604,17523,2506,32589,2115,1057,1058
23365,36197,3605,17526,2507,32592,2115,1057,1058
23370,36207,3607,17530,2507,32600,2115,1057,1058
23375,36213,3607,17534,2507,32606,2116,1058,1058
23380,36224,3608,17541,2508,32616,2116,1058,1058
23385,36228,3608,17543,2508,32620,2116,1058,1058
23390,36238,3610,17548,2508,32628,2116,1058,1058
23395,36244,3610,17552,2508,32634,2117,1059,1058
23400,36255,3611,17557,2509,32644,2117,1059,1058
23405,36259,3611,17558,2509,32648,2117,1059,1058
23410,36269,3613,17566,2511,32656,2117,1059,1058
23415,36275,3613,17569,2511,32662,2118,1059,1059
23420,36286,3615,17577,2513,32671,2118,1059,1059
23425,36290,3615,17580,2513,32675,2118,1059,1059
23430,36300,3617,17583,2513,32683,2118,1059,1059
23435,36306,3617,17588,2513,32689,2119,1059,1060
23440,36317,3617,17590,2513,32700,2119,1059,1060
23445,36321,3617,17592,2513,32704,2119,1059,1060
23450,36331,3619,17597,2513,32712,2119,1059,1060
23455,36337,3619,17600,2513,32717,2120,1059,1061
23460,36348,3620,17602,2514,32728,2121,1059,1062
23465,36352,3621,17605,2515,32731,2121,1059,1062
23470,36362,3621,17609,2515,32741,2121,1059,1062
23475,36368,3621,17612,2515,32747,2122,1059,1063
23480,36379,3621,17618,2515,32758,2122,1059,1063
23485,36383,3621,17621,2515,32762,2122,1059,1063
23490,36393,3621,17628,2515,32772,2122,1059,1063
23495,36399,3621,17629,2515,32778,2123,1059,1064
23500,36410,3621,17634,2515,32789,2123,1059,1064
23505,36414,3621,17636,2515,32793,2123,1059,1064
23510,36424,3621,17642,2515,32803,2123,1059,1064
23515,36430,3621,17646,2515,32809,2124,1059,1065
23520,36441,3621,17650,2515,32820,2124,1059,1065
23525,36445,3621,17651,2515,32824,2124,1059,1065
23530,36455,3621,17653,2515,32834,2124,1059,1065
23535,36461,3621,17654,2515,32840,2126,1059,1067
23540,36472,3621,17660,2515,32851,2126,1059,1067
23545,36476,3621,17662,2515,32855,2126,1059,1067
23550,36486,3621,17666,2515,32865,2126,1059,1067
23555,36492,3621,17669,2515,32871,2128,1060,1068
23560,36503,3621,17674,2515,32882,2128,1060,1068
23565,36507,3621,17677,2515,32886,2128,1060,1068
23570,36517,3623,17682,2517,32894,2128,1060,1068
23575,36523,3623,17686,2517,32899,2130,1062,1068
23580,36534,3626,17691,2519,32908,2130,1062,1068
23585,36538,3626,17693,2519,32912,2130,1062,1068
23590,36548,3627,17696,2519,32921,2130,1062,1068
23595,36554,3627,17699,2519,32927,2131,1063,1068
23600,36565,3628,17704,2520,32937,2131,1063,1068
23605,36569,3628,17704,2520,32941,2131,1063,1068
23610,36579,3629,17709,2521,32950,2131,1063,1068
23615,36585,3629,17711,2521,32956,2132,1063,1069
23620,36596,3629,17717,2521,32967,2132,1063,1069
23625,36600,3629,17720,2521,32971,2132,1063,1069
23630,36610,3630,17724,2522,32980,2132,1063,1069
23635,36616,3630,17727,2522,32986,2133,1064,1069
23640,36627,3630,17730,2522,32997,2133,1064,1069
23645,36631,3630,17731,2522,33001,2133,1064,1069
23650,36641,3632,17733,2523,33009,2133,1064,1069
23655,36647,3632,17737,2523,33014,2135,1066,1069
23660,36658,3634,17743,2525,33024,2136,1066,1070
23665,36662,3634,17745,2525,33028,2136,1066,1070
23670,36672,3636,17748,2526,33036,2136,1066,1070
23675,36678,3636,17751,2526,33042,2137,1067,1070
23680,36689,3637,17758,2527,33052,2137,1067,1070
23685,36693,3637,17759,2527,33056,2137,1067,1070
23690,36703,3639,17765,2528,33064,2137,1067,1070
23695,36709,3639,17768,2528,33069,2138,1068,1070
23700,36720,3643,17771,2531,33077,2139,1068,1071
23705,36724,3643,17772,2531,33081,2139,1068,1071
23710,36734,3645,17777,2532,33089,2139,1068,1071
23715,36740,3645,17779,2532,33095,2140,1069,1071
23720,36751,3647,17786,2534,33104,2140,1069,1071
23725,36755,3647,17788,2534,33108,2140,1069,1071
23730,36765,3649,17792,2534,33116,2140,1069,1071
23735,36771,3649,17795,2534,33122,2141,1070,1071
23740,36782,3650,17799,2534,33132,2141,1070,1071
23745,36786,3651,17803,2535,33135,2141,1070,1071
23750,36796,3653,17810,2537,33143,2141,1070,1071
23755,36802,3653,17814,2537,33149,2142,1070,1072
23760,36813,3654,17817,2537,33159,2142,1070,1072
23765,36817,3654,17820,2537,33163,2142,1070,1072
23770,36827,3656,17824,2539,33171,2142,1070,1072
23775,36833,3656,17826,2539,33177,2144,1070,1074
23780,36844,3657,17829,2539,33187,2145,1070,1075
23785,36848,3657,17831,2539,33191,2145,1070,1075
23790,36858,3659,17837,2541,33199,2145,1070,1075
23795,36864,3659,17839,2541,33205,2147,1071,1076
23800,36875,3661,17844,2542,33214,2148,1072,1076
23805,36879,3662,17845,2543,33217,2148,1072,1076
23810,36889,3665,17849,2545,33224,2148,1072,1076
23815,36895,3665,17853,2545,33229,2150,1073,1077
23820,36906,3670,17859,2549,33236,2151,1073,1078
23825,36910,3670,17860,2549,33240,2151,1073,1078
23830,36920,3670,17866,2549,33250,2151,1073,1078
23835,36926,3670,17869,2549,33256,2152,1073,1079
23840,36937,3671,17871,2549,33266,2152,1073,1079
23845,36941,3671,17871,2549,33270,2152,1073,1079
23850,36951,3671,17876,2549,33280,2152,1073,1079
23855,36957,3671,17879,2549,33286,2153,1074,1079
23860,36968,3672,17885,2550,33296,2153,1074,1079
23865,36972,3672,17887,2550,33300,2153,1074,1079
23870,36982,3672,17890,2550,33310,2153,1074,1079
23875,36988,3672,17892,2550,33316,2154,1074,1080
23880,36999,3673,17897,2551,33326,2154,1074,1080
23885,37003,3673,17898,2551,33330,2154,1074,1080
23890,37013,3673,17905,2551,33340,2154,1074,1080
23895,37019,3673,17907,2551,33346,2155,1074,1081
23900,37030,3673,17914,2551,33357,2155,1074,1081
23905,37034,3673,17918,2551,33361,2155,1074,1081
23910,37044,3673,17920,2551,33371,2155,1074,1081
23915,37050,3673,17923,2551,33377,2156,1074,1082
23920,37061,3673,17930,2551,33388,2156,1074,1082
23925,37065,3673,17933,2551,33392,2156,1074,1082
23930,37075,3675,17940,2553,33400,2156,1074,1082
23935,37081,3675,17942,2553,33406,2157,1075,1082
23940,37092,3677,17947,2555,33415,2158,1076,1082
23945,37096,3677,17949,2555,33419,2158,1076,1082
23950,37106,3679,17954,2556,33427,2158,1076,1082
23955,37112,3679,17955,2556,33433,2159,1076,1083
23960,37123,3681,17962,2558,33441,2160,1077,1083
23965,37127,3682,17962,2559,33445,2160,1077,1083
23970,37137,3684,17966,2560,33453,2160,1077,1083
23975,37143,3684,17969,2560,33459,2161,1078,1083
23980,37154,3685,17976,2561,33468,2162,1079,1083
23985,37158,3686,17977,2562,33472,2162,1079,1083
23990,37168,3688,17980,2563,33480,2162,1079,1083
23995,37174,3688,17982,2563,33486,2163,1080,1083
24000,37185,3688,17986,2563,33497,2163,1080,1083
24005,37189,3688,17988,2563,33501,2163,1080,1083
24010,37199,3690,17991,2565,33509,2163,1080,1083
24015,37205,3690,17993,2565,33515,2164,1081,1083
24020,37216,3690,17996,2565,33526,2164,1081,1083
24025,37220,3690,17996,2565,33530,2164,1081,1083
24030,37230,3692,18001,2567,33538,2164,1081,1083
24035,37236,3692,18005,2567,33544,2166,1083,1083
24040,37247,3692,18011,2567,33555,2166,1083,1083
24045,37251,3692,18012,2567,33559,2166,1083,1083
24050,37261,3695,18016,2568,33566,2166,1083,1083
24055,37267,3695,18020,2568,33571,2168,1084,1084
24060,37278,3699,18025,2571,33578,2169,1085,1084
24065,37282,3701,18028,2573,33581,2169,1085,1084
24070,37292,3702,18033,2574,33590,2169,1085,1084
24075,37298,3702,18037,2574,33596,2171,1087,1084
24080,37309,3703,18045,2575,33606,2172,1088,1084
24085,37313,3703,18047,2575,33610,2172,1088,1084
24090,37323,3704,18053,2576,33619,2172,1088,1084
24095,37329,3704,18055,2576,33625,2174,1089,1085
24100,37340,3706,18061,2577,33634,2175,1090,1085
24105,37344,3707,18065,2578,33637,2175,1090,1085
24110,37354,3708,18071,2579,33646,2175,1090,1085
24115,37360,3708,18074,2579,33652,2177,1091,1086
24120,37371,3711,18081,2582,33660,2178,1092,1086
24125,37375,3712,18084,2583,33663,2178,1092,1086
24130,37385,3714,18091,2585,33671,2178,1092,1086
24135,37391,3714,18091,2585,33677,2179,1092,1087
24140,37402,3716,18099,2587,33686,2179,1092,1087
24145,37406,3716,18101,2587,33690,2179,1092,1087
24150,37416,3718,18106,2588,33698,2179,1092,1087
24155,37422,3718,18107,2588,33704,2180,1092,1088
24160,37433,3719,18114,2589,33714,2180,1092,1088
24165,37437,3720,18116,2590,33717,2180,1092,1088
24170,37447,3722,18120,2591,33725,2180,1092,1088
24175,37453,3722,18124,2591,33730,2181,1093,1088
24180,37464,3724,18129,2593,33740,2181,1093,1088
24185,37468,3724,18129,2593,33744,2181,1093,1088
24190,37478,3724,18133,2593,33754,2181,1093,1088
24195,37484,3724,18135,2593,33760,2182,1093,1089
24200,37495,3725,18137,2593,33770,2183,1093,1090
24205,37499,3725,18138,2593,33774,2183,1093,1090
24210,37509,3725,18140,2593,33784,2183,1093,1090
24215,37515,3725,18142,2593,33790,2184,1093,1091
24220,37526,3727,18147,2594,33799,2185,1094,1091
24225,37530,3727,18148,2594,33803,2185,1094,1091
24230,37540,3727,18154,2594,33813,2185,1094,1091
24235,37546,3727,18158,2594,33819,2186,1095,1091
24240,37557,3728,18165,2595,33829,2187,1096,1091
24245,37561,3729,18169,2596,33832,2187,1096,1091
24250,37571,3729,18172,2596,33842,2187,1096,1091
24255,37577,3729,18175,2596,33848,2188,1096,1092
24260,37588,3730,18182,2597,33858,2188,1096,1092
24265,37592,3731,18186,2598,33861,2188,1096,1092
24270,37602,3731,18190,2598,33871,2188,1096,1092
24275,37608,3731,18193,2598,33877,2189,1096,1093
24280,37619,3732,18197,2599,33887,2189,1096,1093
24285,37623,3733,18199,2600,33890,2189,1096,1093
24290,37633,3735,18203,2600,33898,2189,1096,1093
24295,37639,3735,18206,2600,33904,2191,1098,1093
24300,37650,3736,18209,2601,33914,2191,1098,1093
24305,37654,3737,18212,2602,33917,2191,1098,1093
24310,37664,3739,18219,2604,33925,2191,1098,1093
24315,37670,3739,18220,2604,33931,2192,1099,1093
24320,37681,3741,18227,2606,33940,2193,1100,1093
24325,37685,3741,18228,2606,33944,2193,1100,1093
24330,37695,3743,18233,2607,33952,2193,1100,1093
24335,37701,3743,18236,2607,33957,2194,1100,1094
24340,37712,3744,18239,2608,33968,2195,1101,1094
24345,37716,3744,18240,2608,33972,2195,1101,1094
24350,37726,3746,18247,2609,33980,2195,1101,1094
24355,37732,3746,18250,2609,33985,2196,1101,1095
24360,37743,3750,18257,2613,33993,2197,1102,1095
24365,37747,3750,18258,2613,33997,2197,1102,1095
24370,37757,3750,18264,2613,34007,2197,1102,1095
24375,37763,3750,18265,2613,34013,2198,1102,1096
24380,37774,3751,18272,2614,34023,2198,1102,1096
24385,37778,3751,18276,2614,34027,2198,1102,1096
24390,37788,3751,18280,2614,34037,2198,1102,1096
24395,37794,3751,18284,2614,34043,2199,1102,1097
24400,37805,3753,18288,2615,34052,2199,1102,1097
24405,37809,3753,18290,2615,34056,2199,1102,1097
24410,37819,3753,18293,2615,34066,2199,1102,1097
24415,37825,3753,18296,2615,34072,2201,1103,1098
24420,37836,3754,18304,2616,34082,2201,1103,1098
24425,37840,3754,18305,2616,34086,2201,1103,1098
24430,37850,3756,18310,2618,34094,2201,1103,1098
24435,37856,3756,18313,2618,34100,2202,1103,1099
24440,37867,3757,18316,2619,34110,2203,1103,1100
24445,37871,3757,18318,2619,34114,2203,1103,1100
24450,37881,3759,18324,2621,34122,2203,1103,1100
24455,37887,3759,18327,2621,34128,2204,1104,1100
24460,37898,3759,18331,2621,34138,2205,1104,1101
24465,37902,3760,18333,2622,34142,2205,1104,1101
24470,37912,3762,18338,2622,34150,2205,1104,1101
24475,37918,3762,18342,2622,34156,2206,1105,1101
24480,37929,3762,18348,2622,34166,2207,1106,1101
24485,37933,3763,18349,2623,34170,2207,1106,1101
24490,37943,3765,18354,2624,34178,2207,1106,1101
24495,37949,3765,18356,2624,34184,2208,1106,1102
24500,37960,3766,18361,2625,34194,2208,1106,1102
24505,37964,3766,18363,2625,34198,2208,1106,1102
24510,37974,3768,18368,2626,34206,2208,1106,1102
24515,37980,3768,18371,2626,34212,2209,1106,1103
24520,37991,3768,18378,2626,34223,2209,1106,1103
24525,37995,3768,18378,2626,34227,2209,1106,1103
24530,38005,3770,18384,2627,34235,2209,1106,1103
24535,38011,3770,18386,2627,34241,2211,1107,1104
24540,38022,3773,18392,2630,34249,2212,1107,1105
24545,38026,3775,18396,2632,34251,2212,1107,1105
24550,38036,3776,18403,2633,34260,2212,1107,1105
24555,38042,3776,18407,2633,34265,2213,1108,1105
24560,38053,3779,18411,2636,34274,2214,1108,1106
24565,38057,3781,18415,2638,34276,2214,1108,1106
24570,38067,3783,18419,2639,34284,2214,1108,1106
24575,38073,3783,18420,2639,34290,2215,1108,1107
24580,38084,3786,18429,2642,34298,2216,1109,1107
24585,38088,3786,18432,2642,34302,2216,1109,1107
24590,38098,3787,18436,2642,34311,2216,1109,1107
24595,38104,3787,18438,2642,34317,2217,1109,1108
24600,38115,3788,18446,2643,34327,2218,1110,1108
24605,38119,3788,18447,2643,34331,2218,1110,1108
24610,38129,3788,18453,2643,34341,2218,1110,1108
24615,38135,3788,18455,2643,34347,2219,1110,1109
24620,38146,3788,18460,2643,34358,2219,1110,1109
24625,38150,3788,18462,2643,34362,2219,1110,1109
24630,38160,3788,18466,2643,34372,2219,1110,1109
24635,38166,3788,18472,2643,34378,2220,1111,1109
24640,38177,3788,18477,2643,34389,2220,1111,1109
24645,38181,3788,18477,2643,34393,2220,1111,1109
24650,38191,3788,18482,2643,34403,2220,1111,1109
24655,38197,3788,18484,2643,34409,2222,1112,1110
24660,38208,3788,18489,2643,34420,2222,1112,1110
24665,38212,3788,18490,2643,34424,2222,1112,1110
24670,38222,3790,18494,2645,34432,2222,1112,1110
24675,38228,3790,18497,2645,34438,2223,1113,1110
24680,38239,3791,18503,2646,34448,2224,1114,1110
24685,38243,3791,18506,2646,34452,2224,1114,1110
24690,38253,3793,18510,2647,34460,2224,1114,1110
24695,38259,3793,18514,2647,34466,2225,1115,1110
24700,38270,3795,18518,2649,34475,2226,1116,1110
24705,38274,3795,18520,2649,34479,2226,1116,1110
24710,38284,3798,18526,2651,34486,2226,1116,1110
24715,38290,3798,18528,2651,34492,2227,1116,1111
24720,38301,3800,18533,2652,34501,2228,1116,1112
24725,38305,3800,18533,2652,34505,2228,1116,1112
24730,38315,3801,18539,2652,34514,2228,1116,1112
24735,38321,3801,18542,2652,34520,2229,1116,1113
24740,38332,3803,18547,2654,34529,2229,1116,1113
24745,38336,3804,18548,2655,34532,2229,1116,1113
24750,38346,3805,18554,2656,34541,2229,1116,1113
24755,38352,3805,18557,2656,34547,2230,1117,1113
24760,38363,3806,18561,2656,34557,2230,1117,1113
24765,38367,3807,18563,2657,34560,2230,1117,1113
24770,38377,3808,18568,2658,34569,2230,1117,1113
24775,38383,3808,18572,2658,34575,2231,1118,1113
24780,38394,3809,18577,2658,34585,2231,1118,1113
24785,38398,3809,18578,2658,34589,2231,1118,1113
24790,38408,3810,18583,2659,34598,2231,1118,1113
24795,38414,3810,18585,2659,34604,2232,1119,1113
24800,38425,3811,18591,2660,34614,2232,1119,1113
24805,38429,3812,18592,2661,34617,2232,1119,1113
24810,38439,3813,18597,2662,34626,2232,1119,1113
24815,38445,3813,18601,2662,34632,2233,1119,1114
24820,38456,3815,18608,2664,34641,2233,1119,1114
24825,38460,3815,18608,2664,34645,2233,1119,1114
24830,38470,3817,18611,2664,34653,2233,1119,1114
24835,38476,3817,18612,2664,34659,2234,1120,1114
24840,38487,3819,18614,2665,34667,2234,1120,1114
24845,38491,3820,18614,2666,34671,2234,1120,1114
24850,38501,3821,18621,2666,34680,2234,1120,1114
24855,38507,3821,18623,2666,34686,2236,1120,1116
24860,38518,3822,18629,2667,34696,2237,1120,1117
24865,38522,3822,18631,2667,34700,2237,1120,1117
24870,38532,3823,18636,2668,34709,2237,1120,1117
24875,38538,3823,18638,2668,34715,2239,1121,1118
24880,38549,3823,18642,2668,34726,2240,1122,1118
24885,38553,3823,18645,2668,34730,2240,1122,1118
24890,38563,3824,18650,2668,34739,2240,1122,1118
24895,38569,3824,18653,2668,34745,2242,1123,1119
24900,38580,3825,18658,2669,34755,2243,1124,1119
24905,38584,3826,18659,2670,34758,2243,1124,1119
24910,38594,3828,18664,2672,34766,2243,1124,1119
24915,38600,3828,18668,2672,34772,2244,1125,1119
24920,38611,3829,18671,2673,34782,2245,1125,1120
24925,38615,3830,18673,2674,34785,2245,1125,1120
24930,38625,3832,18680,2675,34793,2245,1125,1120
24935,38631,3832,18682,2675,34799,2246,1125,1121
24940,38642,3834,18687,2676,34808,2247,1125,1122
24945,38646,3834,18687,2676,34812,2247,1125,1122
24950,38656,3837,18693,2677,34819,2247,1125,1122
24955,38662,3837,18697,2677,34825,2248,1126,1122
24960,38673,3839,18700,2678,34834,2249,1126,1123
24965,38677,3839,18703,2678,34838,2249,1126,1123
24970,38687,3841,18705,2679,34846,2249,1126,1123
24975,38693,3841,18707,2679,34852,2250,1126,1124
24980,38704,3842,18711,2680,34862,2250,1126,1124
24985,38708,3842,18712,2680,34866,2250,1126,1124
24990,38718,3844,18717,2681,34874,2250,1126,1124
24995,38724,3844,18722,2681,34880,2251,1127,1124
25000,38735,3845,18730,2682,34890,2251,1127,1124
25005,38739,3845,18732,2682,34894,2251,1127,1124
25010,38749,3847,18738,2683,34902,2251,1127,1124
25015,38755,3847,18741,2683,34908,2252,1127,1125
25020,38766,3849,18749,2685,34917,2252,1127,1125
25025,38770,3849,18751,2685,34921,2252,1127,1125
25030,38780,3851,18756,2685,34929,2252,1127,1125
25035,38786,3851,18758,2685,34935,2253,1127,1126
25040,38797,3851,18760,2685,34946,2253,1127,1126
25045,38801,3851,18762,2685,34950,2253,1127,1126
25050,38811,3853,18766,2686,34958,2253,1127,1126
25055,38817,3853,18770,2686,34964,2254,1128,1126
25060,38828,3854,18774,2687,34974,2254,1128,1126
25065,38832,3855,18777,2688,34977,2254,1128,1126
25070,38842,3857,18783,2689,34985,2254,1128,1126
25075,38848,3857,18786,2689,34990,2255,1128,1127
25080,38859,3859,18794,2691,35000,2256,1129,1127
25085,38863,3859,18796,2691,35004,2256,1129,1127
25090,38873,3860,18804,2691,35013,2256,1129,1127
25095,38879,3860,18807,2691,35019,2257,1129,1128
25100,38890,3860,18813,2691,35029,2257,1129,1128
25105,38894,3861,18816,2692,35033,2257,1129,1128
25110,38904,3862,18822,2692,35042,2257,1129,1128
25115,38910,3862,18822,2692,35048,2258,1129,1129
25120,38921,3862,18827,2692,35058,2258,1129,1129
25125,38925,3863,18828,2693,35062,2258,1129,1129
25130,38935,3865,18834,2694,35070,2258,1129,1129
25135,38941,3865,18837,2694,35076,2259,1130,1129
25140,38952,3868,18845,2696,35083,2260,1131,1129
25145,38956,3869,18846,2697,35087,2260,1131,1129
25150,38966,3870,18851,2697,35096,2260,1131,1129
25155,38972,3870,18855,2697,35102,2261,1132,1129
25160,38983,3871,18859,2698,35112,2262,1132,1130
25165,38987,3872,18861,2699,35115,2262,1132,1130
25170,38997,3873,18868,2699,35124,2262,1132,1130
25175,39003,3873,18870,2699,35130,2263,1132,1131
25180,39014,3874,18872,2700,35140,2264,1132,1132
25185,39018,3875,18875,2701,35143,2264,1132,1132
25190,39028,3876,18881,2702,35152,2264,1132,1132
25195,39034,3876,18886,2702,35158,2265,1133,1132
25200,39045,3878,18895,2704,35167,2266,1134,1132
25205,39049,3879,18896,2705,35170,2266,1134,1132
25210,39059,3880,18900,2705,35179,2266,1134,1132
25215,39065,3880,18902,2705,35185,2267,1135,1132
25220,39076,3881,18908,2706,35195,2267,1135,1132
25225,39080,3881,18911,2706,35199,2267,1135,1132
25230,39090,3882,18915,2706,35208,2267,1135,1132
25235,39096,3882,18919,2706,35214,2268,1135,1133
25240,39107,3883,18923,2707,35224,2268,1135,1133
25245,39111,3883,18924,2707,35228,2268,1135,1133
25250,39121,3884,18929,2707,35237,2268,1135,1133
25255,39127,3884,18931,2707,35243,2269,1135,1134
25260,39138,3885,18938,2708,35253,2269,1135,1134
25265,39142,3885,18940,2708,35257,2269,1135,1134
25270,39152,3886,18942,2708,35266,2269,1135,1134
25275,39158,3886,18947,2708,35271,2270,1136,1134
25280,39169,3888,18953,2709,35281,2270,1136,1134
25285,39173,3888,18955,2709,35285,2270,1136,1134
25290,39183,3889,18961,2709,35294,2270,1136,1134
25295,39189,3889,18964,2709,35299,2271,1136,1135
25300,39200,3891,18971,2711,35309,2271,1136,1135
25305,39204,3891,18973,2711,35313,2271,1136,1135
25310,39214,3893,18979,2713,35321,2271,1136,1135
25315,39220,3893,18983,2713,35326,2272,1137,1135
25320,39231,3897,18988,2716,35334,2273,1137,1136
25325,39235,3897,18990,2716,35338,2273,1137,1136
25330,39245,3898,18994,2716,35347,2273,1137,1136
25335,39251,3898,18996,2716,35353,2274,1138,1136
25340,39262,3898,19000,2716,35363,2275,1139,1136
25345,39266,3899,19000,2717,35367,2275,1139,1136
25350,39276,3901,19007,2718,35375,2275,1139,1136
25355,39282,3901,19009,2718,35381,2276,1139,1137
25360,39293,3903,19015,2720,35390,2277,1140,1137
25365,39297,3903,19018,2720,35393,2277,1140,1137
25370,39307,3905,19023,2721,35402,2277,1140,1137
25375,39313,3905,19026,2721,35408,2278,1141,1137
25380,39324,3907,19033,2723,35417,2279,1142,1137
25385,39328,3907,19036,2723,35421,2279,1142,1137
25390,39338,3908,19042,2724,35430,2279,1142,1137
25395,39344,3908,19046,2724,35436,2280,1143,1137
25400,39355,3909,19054,2725,35446,2280,1143,1137
25405,39359,3909,19058,2725,35450,2280,1143,1137
25410,39369,3910,19063,2725,35459,2280,1143,1137
25415,39375,3910,19066,2725,35465,2281,1144,1137
25420,39386,3910,19070,2725,35476,2281,1144,1137
25425,39390,3910,19072,2725,35480,2281,1144,1137
25430,39400,3912,19075,2725,35488,2281,1144,1137
25435,39406,3912,19079,2725,35493,2283,1145,1138
25440,39417,3915,19083,2727,35502,2284,1145,1139
25445,39421,3915,19085,2727,35506,2284,1145,1139
25450,39431,3917,19090,2728,35514,2284,1145,1139
25455,39437,3917,19092,2728,35520,2286,1146,1140
25460,39448,3919,19096,2730,35529,2286,1146,1140
25465,39452,3920,19098,2731,35532,2286,1146,1140
25470,39462,3921,19102,2731,35541,2286,1146,1140
25475,39468,3921,19108,2731,35546,2287,1147,1140
25480,39479,3925,19113,2735,35554,2287,1147,1140
25485,39483,3925,19114,2735,35558,2287,1147,1140
25490,39493,3926,19120,2735,35567,2287,1147,1140
25495,39499,3926,19125,2735,35572,2288,1148,1140
25500,39510,3930,19133,2739,35580,2288,1148,1140
25505,39514,3930,19134,2739,35584,2288,1148,1140
25510,39524,3932,19139,2741,35592,2288,1148,1140
25515,39530,3932,19144,2741,35597,2290,1149,1141
25520,39541,3935,19150,2744,35606,2290,1149,1141
25525,39545,3935,19152,2744,35610,2290,1149,1141
25530,39555,3936,19158,2745,35619,2290,1149,1141
25535,39561,3936,19162,2745,35624,2291,1150,1141
25540,39572,3939,19165,2748,35633,2291,1150,1141
25545,39576,3939,19167,2748,35637,2291,1150,1141
25550,39586,3941,19170,2749,35645,2291,1150,1141
25555,39592,3941,19172,2749,35651,2292,1151,1141
25560,39603,3942,19177,2750,35661,2293,1152,1141
25565,39607,3944,19179,2752,35663,2293,1152,1141
25570,39617,3946,19186,2753,35671,2293,1152,1141
25575,39623,3946,19191,2753,35677,2294,1153,1141
25580,39634,3947,19194,2754,35687,2295,1153,1142
25585,39638,3949,19196,2756,35689,2295,1153,1142
25590,39648,3951,19203,2757,35697,2295,1153,1142
25595,39654,3951,19206,2757,35703,2296,1154,1142
25600,39665,3953,19213,2758,35711,2297,1154,1143
25605,39669,3955,19215,2760,35714,2297,1154,1143
25610,39679,3957,19217,2761,35722,2297,1154,1143
25615,39685,3957,19221,2761,35728,2298,1154,1144
25620,39696,3960,19227,2763,35736,2299,1155,1144
25625,39700,3960,19229,2763,35740,2299,1155,1144
25630,39710,3961,19235,2764,35749,2299,1155,1144
25635,39716,3961,19237,2764,35755,2300,1156,1144
25640,39727,3962,19243,2765,35765,2300,1156,1144
25645,39731,3962,19246,2765,35769,2300,1156,1144
25650,39741,3963,19252,2766,35778,2300,1156,1144
25655,39747,3963,19255,2766,35784,2301,1156,1145
25660,39758,3963,19259,2766,35795,2301,1156,1145
25665,39762,3963,19260,2766,35799,2301,1156,1145
25670,39772,3964,19263,2767,35808,2301,1156,1145
25675,39778,3964,19265,2767,35814,2302,1157,1145
25680,39789,3964,19267,2767,35825,2302,1157,1145
25685,39793,3964,19268,2767,35829,2302,1157,1145
25690,39803,3966,19275,2768,35837,2302,1157,1145
25695,39809,3966,19277,2768,35843,2304,1157,1147
25700,39820,3967,19286,2769,35852,2305,1158,1147
25705,39824,3968,19287,2770,35856,2305,1158,1147
25710,39834,3970,19295,2771,35864,2305,1158,1147
25715,39840,3970,19297,2771,35870,2306,1158,1148
25720,39851,3972,19300,2772,35879,2307,1158,1149
25725,39855,3972,19302,2772,35883,2307,1158,1149
25730,39865,3974,19307,2773,35891,2307,1158,1149
25735,39871,3974,19307,2773,35897,2308,1158,1150
25740,39882,3975,19311,2774,35906,2309,1158,1151
25745,39886,3976,19314,2775,35910,2309,1158,1151
25750,39896,3977,19320,2776,35919,2309,1158,1151
25755,39902,3977,19325,2776,35925,2311,1160,1151
25760,39913,3978,19327,2776,35935,2311,1160,1151
25765,39917,3978,19329,2776,35939,2311,1160,1151
25770,39927,3979,19332,2777,35948,2311,1160,1151
25775,39933,3979,19335,2777,35954,2312,1161,1151
25780,39944,3980,19338,2777,35964,2312,1161,1151
25785,39948,3980,19340,2777,35968,2312,1161,1151
25790,39958,3981,19343,2778,35977,2312,1161,1151
25795,39964,3981,19346,2778,35983,2313,1161,1152
25800,39975,3982,19350,2778,35993,2313,1161,1152
25805,39979,3983,19352,2779,35996,2313,1161,1152
25810,39989,3985,19354,2780,36004,2313,1161,1152
25815,39995,3985,19357,2780,36010,2314,1162,1152
25820,40006,3987,19361,2781,36019,2315,1162,1153
25825,40010,3988,19363,2782,36022,2315,1162,1153
25830,40020,3991,19368,2783,36029,2315,1162,1153
25835,40026,3991,19369,2783,36035,2316,1162,1154
25840,40037,3992,19375,2784,36045,2317,1162,1155
25845,40041,3994,19378,2786,36047,2317,1162,1155
25850,40051,3997,19385,2789,36054,2317,1162,1155
25855,40057,3997,19391,2789,36059,2318,1163,1155
25860,40068,4001,19399,2793,36067,2319,1163,1156
25865,40072,4001,19402,2793,36071,2319,1163,1156
25870,40082,4001,19406,2793,36081,2319,1163,1156
25875,40088,4001,19407,2793,36087,2320,1163,1157
25880,40099,4001,19409,2793,36098,2320,1163,1157
25885,40103,4001,19411,2793,36102,2320,1163,1157
25890,40113,4001,19415,2793,36112,2320,1163,1157
25895,40119,4001,19418,2793,36118,2321,1163,1158
25900,40130,4001,19425,2793,36129,2321,1163,1158
25905,40134,4001,19428,2793,36133,2321,1163,1158
25910,40144,4001,19433,2793,36143,2321,1163,1158
25915,40150,4001,19435,2793,36149,2322,1163,1159
25920,40161,4001,19441,2793,36160,2322,1163,1159
25925,40165,4001,19442,2793,36164,2322,1163,1159
25930,40175,4001,19446,2793,36174,2322,1163,1159
25935,40181,4001,19449,2793,36180,2323,1163,1160
25940,40192,4001,19456,2793,36191,2323,1163,1160
25945,40196,4001,19456,2793,36195,2323,1163,1160
25950,40206,4001,19459,2793,36205,2323,1163,1160
25955,40212,4001,19462,2793,36211,2324,1164,1160
25960,40223,4001,19464,2793,36222,2324,1164,1160
25965,40227,4001,19467,2793,36226,2324,1164,1160
25970,40237,4003,19470,2793,36234,2324,1164,1160
25975,40243,4003,19474,2793,36240,2325,1164,1161
25980,40254,4005,19481,2795,36249,2326,1165,1161
25985,40258,4005,19482,2795,36253,2326,1165,1161
25990,40268,4006,19487,2795,36262,2326,1165,1161
25995,40274,4006,19490,2795,36267,2327,1165,1162
26000,40285,4008,19494,2796,36277,2328,1166,1162
26005,40289,4008,19496,2796,36281,2328,1166,1162
26010,40299,4009,19499,2797,36290,2328,1166,1162
26015,40305,4009,19504,2797,36296,2329,1167,1162
26020,40316,4011,19511,2799,36305,2330,1168,1162
26025,40320,4011,19512,2799,36309,2330,1168,1162
26030,40330,4012,19517,2799,36318,2330,1168,1162
26035,40336,4012,19519,2799,36323,2331,1168,1163
26040,40347,4014,19524,2800,36333,2332,1169,1163
26045,40351,4015,19528,2801,36336,2332,1169,1163
26050,40361,4016,19535,2802,36345,2332,1169,1163
26055,40367,4016,19537,2802,36350,2333,1169,1164
26060,40378,4018,19538,2803,36360,2334,1169,1165
26065,40382,4018,19538,2803,36364,2334,1169,1165
26070,40392,4019,19544,2804,36373,2334,1169,1165
26075,40398,4019,19547,2804,36379,2335,1170,1165
26080,40409,4021,19553,2805,36388,2336,1170,1166
26085,40413,4021,19554,2805,36392,2336,1170,1166
26090,40423,4023,19557,2806,36400,2336,1170,1166
26095,40429,4023,19560,2806,36406,2337,1171,1166
26100,40440,4026,19563,2808,36414,2338,1171,1167
26105,40444,4026,19564,2808,36418,2338,1171,1167
26110,40454,4026,19570,2808,36428,2338,1171,1167
26115,40460,4026,19573,2808,36434,2339,1171,1168
26120,40471,4026,19582,2808,36445,2339,1171,1168
26125,40475,4026,19583,2808,36449,2339,1171,1168
26130,40485,4026,19587,2808,36459,2339,1171,1168
26135,40491,4026,19592,2808,36465,2340,1172,1168
26140,40502,4026,19598,2808,36476,2340,1172,1168
26145,40506,4026,19598,2808,36480,2340,1172,1168
26150,40516,4026,19603,2808,36490,2340,1172,1168
26155,40522,4026,19605,2808,36496,2341,1173,1168
26160,40533,4026,19609,2808,36507,2341,1173,1168
26165,40537,4026,19610,2808,36511,2341,1173,1168
26170,40547,4026,19611,2808,36521,2341,1173,1168
26175,40553,4026,19615,2808,36527,2342,1174,1168
26180,40564,4026,19619,2808,36538,2342,1174,1168
26185,40568,4026,19621,2808,36542,2342,1174,1168
26190,40578,4026,19628,2808,36552,2342,1174,1168
26195,40584,4026,19631,2808,36558,2343,1174,1169
26200,40595,4026,19635,2808,36569,2343,1174,1169
26205,40599,4026,19637,2808,36573,2343,1174,1169
26210,40609,4028,19642,2809,36581,2343,1174,1169
26215,40615,4028,19644,2809,36587,2344,1174,1170
26220,40626,4032,19650,2812,36594,2344,1174,1170
26225,40630,4034,19653,2814,36596,2344,1174,1170
26230,40640,4036,19655,2814,36604,2344,1174,1170
26235,40646,4036,19657,2814,36610,2345,1174,1171
26240,40657,4038,19664,2816,36619,2345,1174,1171
26245,40661,4038,19664,2816,36623,2345,1174,1171
26250,40671,4040,19667,2816,36631,2345,1174,1171
26255,40677,4040,19669,2816,36637,2346,1174,1172
26260,40688,4041,19672,2816,36647,2346,1174,1172
26265,40692,4041,19675,2816,36651,2346,1174,1172
26270,40702,4043,19679,2816,36659,2346,1174,1172
26275,40708,4043,19681,2816,36665,2347,1175,1172
26280,40719,4044,19683,2816,36675,2348,1175,1173
26285,40723,4046,19686,2818,36677,2348,1175,1173
26290,40733,4047,19691,2818,36686,2348,1175,1173
26295,40739,4047,19693,2818,36692,2349,1175,1174
26300,40750,4049,19699,2820,36701,2350,1175,1175
26305,40754,4049,19700,2820,36705,2350,1175,1175
26310,40764,4050,19705,2821,36714,2350,1175,1175
26315,40770,4050,19708,2821,36720,2351,1175,1176
26320,40781,4052,19714,2823,36729,2352,1176,1176
26325,40785,4053,19716,2824,36732,2352,1176,1176
26330,40795,4054,19725,2824,36741,2352,1176,1176
26335,40801,4054,19727,2824,36747,2354,1177,1177
26340,40812,4056,19730,2825,36756,2355,1177,1178
26345,40816,4056,19732,2825,36760,2355,1177,1178
26350,40826,4056,19736,2825,36770,2355,1177,1178
26355,40832,4056,19737,2825,36776,2357,1178,1179
26360,40843,4056,19742,2825,36787,2357,1178,1179
26365,40847,4056,19746,2825,36791,2357,1178,1179
26370,40857,4056,19752,2825,36801,2357,1178,1179
26375,40863,4056,19757,2825,36807,2359,1180,1179
26380,40874,4056,19761,2825,36818,2359,1180,1179
26385,40878,4056,19763,2825,36822,2359,1180,1179
26390,40888,4056,19768,2825,36832,2359,1180,1179
26395,40894,4056,19772,2825,36838,2361,1181,1180
26400,40905,4056,19776,2825,36849,2361,1181,1180
26405,40909,4056,19778,2825,36853,2361,1181,1180
26410,40919,4056,19784,2825,36863,2361,1181,1180
26415,40925,4056,19788,2825,36869,2363,1182,1181
26420,40936,4056,19792,2825,36880,2363,1182,1181
26425,40940,4056,19796,2825,36884,2363,1182,1181
26430,40950,4056,19802,2825,36894,2363,1182,1181
26435,40956,4056,19804,2825,36900,2365,1182,1183
26440,40967,4056,19807,2825,36911,2365,1182,1183
26445,40971,4056,19808,2825,36915,2365,1182,1183
26450,40981,4058,19812,2826,36923,2365,1182,1183
26455,40987,4058,19815,2826,36929,2367,1183,1184
26460,40998,4062,19822,2830,36936,2368,1183,1185
26465,41002,4062,19824,2830,36940,2368,1183,1185
26470,41012,4063,19829,2830,36949,2368,1183,1185
26475,41018,4063,19831,2830,36955,2369,1183,1186
26480,41029,4065,19839,2831,36964,2369,1183,1186
26485,41033,4066,19842,2832,36967,2369,1183,1186
26490,41043,4067,19849,2833,36976,2369,1183,1186
26495,41049,4067,19852,2833,36982,2370,1183,1187
26500,41060,4068,19859,2834,36992,2370,1183,1187
26505,41064,4069,19863,2835,36995,2370,1183,1187
26510,41074,4070,19867,2836,37004,2370,1183,1187
26515,41080,4070,19870,2836,37010,2371,1184,1187
26520,41091,4071,19877,2837,37020,2371,1184,1187
26525,41095,4072,19880,2838,37023,2371,1184,1187
26530,41105,4073,19883,2839,37032,2371,1184,1187
26535,41111,4073,19886,2839,37038,2372,1184,1188
26540,41122,4075,19894,2841,37047,2372,1184,1188
26545,41126,4076,19897,2842,37050,2372,1184,1188
26550,41136,4077,19902,2843,37059,2372,1184,1188
26555,41142,4077,19905,2843,37065,2373,1184,1189
26560,41153,4079,19911,2845,37074,2373,1184,1189
26565,41157,4079,19912,2845,37078,2373,1184,1189
26570,41167,4081,19918,2846,37086,2373,1184,1189
26575,41173,4081,19923,2846,37091,2375,1185,1190
26580,41184,4085,19932,2850,37098,2376,1186,1190
26585,41188,4086,19935,2851,37102,2376,1186,1190
26590,41198,4087,19943,2852,37111,2376,1186,1190
26595,41204,4087,19944,2852,37117,2378,1186,1192
26600,41215,4087,19948,2852,37128,2378,1186,1192
26605,41219,4087,19951,2852,37132,2378,1186,1192
26610,41229,4088,19956,2852,37141,2378,1186,1192
26615,41235,4088,19960,2852,37147,2379,1187,1192
26620,41246,4088,19963,2852,37158,2379,1187,1192
26625,41250,4088,19964,2852,37162,2379,1187,1192
26630,41260,4089,19970,2853,37171,2379,1187,1192
26635,41266,4089,19973,2853,37176,2380,1188,1192
26640,41277,4090,19979,2854,37186,2380,1188,1192
26645,41281,4091,19980,2855,37190,2380,1188,1192
26650,41291,4092,19987,2855,37199,2380,1188,1192
26655,41297,4092,19989,2855,37205,2381,1189,1192
26660,41308,4093,19993,2856,37215,2382,1190,1192
26665,41312,4093,19995,2856,37219,2382,1190,1192
26670,41322,4094,19998,2857,37228,2382,1190,1192
26675,41328,4094,20000,2857,37234,2383,1190,1193
26680,41339,4095,20009,2858,37244,2384,1191,1193
26685,41343,4095,20011,2858,37248,2384,1191,1193
26690,41353,4097,20015,2859,37256,2384,1191,1193
26695,41359,4097,20018,2859,37262,2385,1192,1193
26700,41370,4099,20024,2861,37271,2386,1192,1194
26705,41374,4099,20026,2861,37275,2386,1192,1194
26710,41384,4100,20032,2861,37284,2386,1192,1194
26715,41390,4100,20033,2861,37290,2387,1192,1195
26720,41401,4101,20036,2862,37300,2387,1192,1195
26725,41405,4101,20037,2862,37304,2387,1192,1195
26730,41415,4102,20040,2862,37313,2387,1192,1195
26735,41421,4102,20045,2862,37319,2388,1193,1195
26740,41432,4104,20048,2863,37328,2388,1193,1195
26745,41436,4105,20050,2864,37331,2388,1193,1195
26750,41446,4106,20052,2864,37340,2388,1193,1195
26755,41452,4106,20056,2864,37346,2389,1194,1195
26760,41463,4107,20058,2864,37356,2389,1194,1195
26765,41467,4107,20058,2864,37360,2389,1194,1195
26770,41477,4109,20061,2864,37368,2389,1194,1195
26775,41483,4109,20064,2864,37373,2390,1194,1196
26780,41494,4111,20067,2866,37383,2391,1194,1197
26785,41498,4113,20070,2868,37385,2391,1194,1197
26790,41508,4115,20076,2868,37393,2391,1194,1197
26795,41514,4115,20078,2868,37399,2392,1194,1198
26800,41525,4117,20084,2869,37408,2393,1194,1199
26805,41529,4118,20086,2870,37411,2393,1194,1199
26810,41539,4120,20091,2870,37419,2393,1194,1199
26815,41545,4120,20094,2870,37424,2395,1195,1200
26820,41556,4122,20099,2872,37433,2396,1196,1200
26825,41560,4123,20102,2873,37437,2396,1196,1200
26830,41570,4124,20107,2874,37446,2396,1196,1200
26835,41576,4124,20109,2874,37452,2398,1197,1201
26840,41587,4125,20116,2875,37462,2398,1197,1201
26845,41591,4126,20120,2876,37465,2398,1197,1201
26850,41601,4127,20127,2877,37474,2398,1197,1201
26855,41607,4127,20131,2877,37480,2399,1198,1201
26860,41618,4129,20137,2879,37489,2399,1198,1201
26865,41622,4129,20139,2879,37493,2399,1198,1201
26870,41632,4130,20144,2880,37502,2399,1198,1201
26875,41638,4130,20146,2880,37508,2400,1198,1202
26880,41649,4132,20151,2882,37517,2400,1198,1202
26885,41653,4132,20153,2882,37521,2400,1198,1202
26890,41663,4133,20158,2883,37530,2400,1198,1202
26895,41669,4133,20160,2883,37536,2401,1198,1203
26900,41680,4135,20167,2884,37545,2401,1198,1203
26905,41684,4135,20169,2884,37549,2401,1198,1203
26910,41694,4136,20173,2884,37558,2401,1198,1203
26915,41700,4136,20176,2884,37564,2402,1199,1203
26920,41711,4138,20184,2886,37573,2402,1199,1203
26925,41715,4138,20186,2886,37577,2402,1199,1203
26930,41725,4140,20191,2886,37585,2402,1199,1203
26935,41731,4140,20195,2886,37591,2403,1200,1203
26940,41742,4144,20202,2890,37598,2404,1201,1203
26945,41746,4144,20204,2890,37602,2404,1201,1203
26950,41756,4144,20209,2890,37612,2404,1201,1203
26955,41762,4144,20213,2890,37618,2406,1202,1204
26960,41773,4145,20218,2890,37628,2407,1203,1204
26965,41777,4145,20219,2890,37632,2407,1203,1204
26970,41787,4145,20223,2890,37642,2407,1203,1204
26975,41793,4145,20226,2890,37648,2409,1205,1204
26980,41804,4146,20228,2890,37658,2409,1205,1204
26985,41808,4146,20232,2890,37662,2409,1205,1204
26990,41818,4146,20236,2890,37672,2409,1205,1204
26995,41824,4146,20238,2890,37678,2411,1205,1206
27000,41835,4147,20243,2890,37688,2411,1205,1206
27005,41839,4148,20246,2891,37691,2411,1205,1206
27010,41849,4148,20250,2891,37701,2411,1205,1206
27015,41855,4148,20253,2891,37707,2413,1207,1206
27020,41866,4149,20259,2892,37717,2413,1207,1206
27025,41870,4149,20261,2892,37721,2413,1207,1206
27030,41880,4149,20265,2892,37731,2413,1207,1206
27035,41886,4149,20267,2892,37737,2415,1208,1207
27040,41897,4150,20274,2893,37747,2415,1208,1207
27045,41901,4150,20275,2893,37751,2415,1208,1207
27050,41911,4152,20280,2894,37759,2415,1208,1207
27055,41917,4152,20283,2894,37765,2417,1209,1208
27060,41928,4154,20289,2896,37773,2418,1209,1209
27065,41932,4155,20290,2897,37777,2418,1209,1209
27070,41942,4157,20295,2897,37785,2418,1209,1209
27075,41948,4157,20297,2897,37791,2419,1209,1210
27080,41959,4157,20301,2897,37802,2420,1209,1211
27085,41963,4157,20302,2897,37806,2420,1209,1211
27090,41973,4159,20306,2898,37814,2420,1209,1211
27095,41979,4159,20309,2898,37820,2421,1210,1211
27100,41990,4159,20316,2898,37831,2422,1210,1212
27105,41994,4159,20317,2898,37835,2422,1210,1212
27110,42004,4161,20323,2899,37843,2422,1210,1212
27115,42010,4161,20327,2899,37849,2423,1211,1212
27120,42021,4161,20330,2899,37860,2424,1211,1213
27125,42025,4162,20332,2900,37863,2424,1211,1213
27130,42035,4164,20336,2901,37871,2424,1211,1213
27135,42041,4164,20338,2901,37877,2425,1211,1214
27140,42052,4165,20343,2902,37887,2426,1211,1215
27145,42056,4166,20344,2903,37890,2426,1211,1215
27150,42066,4168,20351,2905,37898,2426,1211,1215
27155,42072,4168,20354,2905,37904,2427,1212,1215
27160,42083,4168,20358,2905,37915,2427,1212,1215
27165,42087,4168,20359,2905,37919,2427,1212,1215
27170,42097,4170,20364,2907,37927,2427,1212,1215
27175,42103,4170,20366,2907,37932,2428,1212,1216
27180,42114,4175,20372,2912,37939,2429,1212,1217
27185,42118,4175,20374,2912,37943,2429,1212,1217
27190,42128,4177,20377,2913,37951,2429,1212,1217
27195,42134,4177,20381,2913,37957,2430,1213,1217
27200,42145,4178,20387,2914,37967,2430,1213,1217
27205,42149,4178,20388,2914,37971,2430,1213,1217
27210,42159,4180,20393,2914,37979,2430,1213,1217
27215,42165,4180,20396,2914,37985,2431,1214,1217
27220,42176,4181,20402,2915,37995,2431,1214,1217
27225,42180,4181,20406,2915,37999,2431,1214,1217
27230,42190,4183,20413,2917,38007,2431,1214,1217
27235,42196,4183,20415,2917,38013,2433,1215,1218
27240,42207,4183,20420,2917,38024,2433,1215,1218
27245,42211,4183,20424,2917,38028,2433,1215,1218
27250,42221,4185,20430,2918,38036,2433,1215,1218
27255,42227,4185,20432,2918,38042,2435,1217,1218
27260,42238,4186,20440,2919,38052,2435,1217,1218
27265,42242,4187,20443,2920,38055,2435,1217,1218
27270,42252,4189,20447,2920,38063,2435,1217,1218
27275,42258,4189,20450,2920,38069,2437,1218,1219
27280,42269,4189,20452,2920,38080,2437,1218,1219
27285,42273,4190,20455,2921,38083,2437,1218,1219
27290,42283,4192,20461,2922,38091,2437,1218,1219
27295,42289,4192,20464,2922,38097,2439,1219,1220
27300,42300,4195,20470,2925,38105,2440,1219,1221
27305,42304,4195,20471,2925,38109,2440,1219,1221
27310,42314,4196,20475,2925,38118,2440,1219,1221
27315,42320,4196,20478,2925,38124,2442,1220,1222
27320,42331,4198,20484,2926,38132,2442,1220,1222
27325,42335,4199,20486,2927,38136,2442,1220,1222
27330,42345,4200,20493,2928,38145,2442,1220,1222
27335,42351,4200,20494,2928,38151,2443,1220,1223
27340,42362,4201,20499,2929,38161,2443,1220,1223
27345,42366,4201,20501,2929,38165,2443,1220,1223
27350,42376,4202,20505,2930,38174,2443,1220,1223
27355,42382,4202,20508,2930,38180,2444,1220,1224
27360,42393,4203,20512,2930,38189,2444,1220,1224
27365,42397,4204,20513,2931,38193,2444,1220,1224
27370,42407,4205,20519,2932,38202,2444,1220,1224
27375,42413,4205,20522,2932,38208,2446,1221,1225
27380,42424,4206,20527,2932,38218,2446,1221,1225
27385,42428,4206,20527,2932,38222,2446,1221,1225
27390,42438,4207,20531,2933,38231,2446,1221,1225
27395,42444,4207,20534,2933,38237,2447,1221,1226
27400,42455,4208,20543,2933,38247,2447,1221,1226
27405,42459,4208,20544,2933,38251,2447,1221,1226
27410,42469,4210,20550,2934,38259,2447,1221,1226
27415,42475,4210,20552,2934,38265,2448,1222,1226
27420,42486,4212,20556,2936,38274,2449,1223,1226
27425,42490,4212,20557,2936,38278,2449,1223,1226
27430,42500,4213,20562,2936,38287,2449,1223,1226
27435,42506,4213,20565,2936,38293,2450,1224,1226
27440,42517,4213,20570,2936,38303,2450,1224,1226
27445,42521,4214,20572,2937,38307,2450,1224,1226
27450,42531,4215,20579,2938,38316,2450,1224,1226
27455,42537,4215,20583,2938,38322,2451,1225,1226
27460,42548,4215,20589,2938,38333,2451,1225,1226
27465,42552,4215,20591,2938,38337,2451,1225,1226
27470,42562,4216,20594,2938,38346,2451,1225,1226
27475,42568,4216,20598,2938,38352,2452,1226,1226
27480,42579,4216,20605,2938,38363,2452,1226,1226
27485,42583,4216,20608,2938,38367,2452,1226,1226
27490,42593,4217,20614,2939,38376,2452,1226,1226
27495,42599,4217,20618,2939,38382,2454,1227,1227
27500,42610,4217,20620,2939,38393,2454,1227,1227
27505,42614,4217,20621,2939,38397,2454,1227,1227
27510,42624,4218,20623,2939,38406,2454,1227,1227
27515,42630,4218,20625,2939,38412,2456,1228,1228
27520,42641,4218,20632,2939,38423,2456,1228,1228
27525,42645,4218,20635,2939,38427,2456,1228,1228
27530,42655,4220,20639,2940,38435,2456,1228,1228
27535,42661,4220,20643,2940,38441,2458,1229,1229
27540,42672,4222,20649,2942,38450,2459,1230,1229
27545,42676,4223,20651,2943,38453,2459,1230,1229
27550,42686,4224,20653,2943,38462,2459,1230,1229
27555,42692,4224,20656,2943,38468,2461,1231,1230
27560,42703,4224,20659,2943,38479,2462,1232,1230
27565,42707,4225,20662,2944,38482,2462,1232,1230
27570,42717,4226,20668,2945,38491,2462,1232,1230
27575,42723,4226,20669,2945,38497,2464,1232,1232
27580,42734,4226,20676,2945,38508,2464,1232,1232
27585,42738,4226,20679,2945,38512,2464,1232,1232
27590,42748,4227,20685,2946,38521,2464,1232,1232
27595,42754,4227,20687,2946,38527,2466,1234,1232
27600,42765,4227,20691,2946,38537,2466,1234,1232
27605,42769,4228,20693,2947,38541,2466,1234,1232
27610,42779,4229,20698,2947,38550,2466,1234,1232
27615,42785,4229,20700,2947,38556,2467,1235,1232
27620,42796,4229,20707,2947,38567,2467,1235,1232
27625,42800,4229,20708,2947,38571,2467,1235,1232
27630,42810,4230,20712,2947,38580,2467,1235,1232
27635,42816,4230,20717,2947,38586,2468,1236,1232
27640,42827,4230,20723,2947,38597,2468,1236,1232
27645,42831,4230,20725,2947,38601,2468,1236,1232
27650,42841,4232,20729,2947,38609,2468,1236,1232
27655,42847,4232,20733,2947,38615,2469,1237,1232
27660,42858,4236,20741,2951,38622,2470,1237,1233
27665,42862,4236,20742,2951,38626,2470,1237,1233
27670,42872,4238,20750,2953,38634,2470,1237,1233
27675,42878,4238,20752,2953,38640,2471,1238,1233
27680,42889,4238,20757,2953,38651,2471,1238,1233
27685,42893,4238,20757,2953,38655,2471,1238,1233
27690,42903,4240,20760,2953,38663,2471,1238,1233
27695,42909,4240,20762,2953,38669,2472,1239,1233
27700,42920,4241,20767,2954,38679,2473,1240,1233
27705,42924,4242,20768,2955,38682,2473,1240,1233
27710,42934,4244,20774,2956,38690,2473,1240,1233
27715,42940,4244,20776,2956,38696,2475,1241,1234
27720,42951,4245,20782,2957,38706,2476,1241,1235
27725,42955,4245,20784,2957,38710,2476,1241,1235
27730,42965,4247,20790,2958,38718,2476,1241,1235
27735,42971,4247,20792,2958,38724,2478,1242,1236
27740,42982,4247,20794,2958,38735,2478,1242,1236
27745,42986,4247,20794,2958,38739,2478,1242,1236
27750,42996,4249,20797,2959,38747,2478,1242,1236
27755,43002,4249,20800,2959,38753,2480,1243,1237
27760,43013,4249,20805,2959,38764,2480,1243,1237
27765,43017,4249,20807,2959,38768,2480,1243,1237
27770,43027,4251,20814,2960,38776,2480,1243,1237
27775,43033,4251,20817,2960,38782,2481,1243,1238
27780,43044,4253,20823,2961,38790,2482,1244,1238
27785,43048,4254,20824,2962,38794,2482,1244,1238
27790,43058,4254,20827,2962,38804,2482,1244,1238
27795,43064,4254,20829,2962,38810,2483,1244,1239
27800,43075,4255,20833,2963,38820,2483,1244,1239
27805,43079,4255,20836,2963,38824,2483,1244,1239
27810,43089,4255,20841,2963,38834,2483,1244,1239
27815,43095,4255,20845,2963,38840,2484,1245,1239
27820,43106,4256,20848,2963,38850,2484,1245,1239
27825,43110,4256,20851,2963,38854,2484,1245,1239
27830,43120,4256,20853,2963,38864,2484,1245,1239
27835,43126,4256,20854,2963,38870,2485,1245,1240
27840,43137,4257,20858,2963,38880,2485,1245,1240
27845,43141,4257,20860,2963,38884,2485,1245,1240
27850,43151,4257,20864,2963,38894,2485,1245,1240
27855,43157,4257,20867,2963,38900,2486,1245,1241
27860,43168,4258,20869,2964,38910,2486,1245,1241
27865,43172,4258,20872,2964,38914,2486,1245,1241
27870,43182,4258,20879,2964,38924,2486,1245,1241
27875,43188,4258,20881,2964,38930,2488,1245,1243
27880,43199,4259,20887,2965,38940,2488,1245,1243
27885,43203,4259,20889,2965,38944,2488,1245,1243
27890,43213,4261,20894,2965,38952,2488,1245,1243
27895,43219,4261,20898,2965,38957,2490,1246,1244
27900,43230,4263,20900,2967,38966,2491,1246,1245
27905,43234,4264,20901,2968,38970,2491,1246,1245
27910,43244,4265,20903,2968,38979,2491,1246,1245
27915,43250,4265,20905,2968,38985,2493,1247,1246
27920,43261,4265,20911,2968,38996,2493,1247,1246
27925,43265,4265,20913,2968,39000,2493,1247,1246
27930,43275,4266,20919,2969,39009,2493,1247,1246
27935,43281,4266,20924,2969,39015,2495,1248,1247
27940,43292,4266,20928,2969,39026,2495,1248,1247
27945,43296,4266,20930,2969,39030,2495,1248,1247
27950,43306,4267,20938,2969,39039,2495,1248,1247
27955,43312,4267,20939,2969,39045,2497,1248,1249
27960,43323,4268,20945,2970,39055,2497,1248,1249
27965,43327,4268,20946,2970,39059,2497,1248,1249
27970,43337,4270,20951,2972,39067,2497,1248,1249
27975,43343,4270,20955,2972,39073,2499,1250,1249
27980,43354,4270,20960,2972,39084,2499,1250,1249
27985,43358,4270,20961,2972,39088,2499,1250,1249
27990,43368,4272,20964,2972,39096,2499,1250,1249
27995,43374,4272,20966,2972,39102,2501,1250,1251
28000,43385,4273,20972,2973,39112,2501,1250,1251
28005,43389,4273,20972,2973,39116,2501,1250,1251
28010,43399,4275,20975,2974,39124,2501,1250,1251
28015,43405,4275,20976,2974,39130,2503,1250,1253
28020,43416,4278,20982,2976,39138,2504,1251,1253
28025,43420,4278,20983,2976,39142,2504,1251,1253
28030,43430,4279,20989,2977,39151,2504,1251,1253
28035,43436,4279,20995,2977,39157,2505,1252,1253
28040,43447,4280,21000,2977,39167,2505,1252,1253
28045,43451,4280,21002,2977,39171,2505,1252,1253
28050,43461,4280,21007,2977,39181,2505,1252,1253
28055,43467,4280,21009,2977,39187,2506,1252,1254
28060,43478,4281,21014,2978,39197,2506,1252,1254
28065,43482,4281,21015,2978,39201,2506,1252,1254
28070,43492,4281,21018,2978,39211,2506,1252,1254
28075,43498,4281,21020,2978,39217,2507,1253,1254
28080,43509,4282,21028,2979,39227,2507,1253,1254
28085,43513,4282,21030,2979,39231,2507,1253,1254
28090,43523,4283,21037,2980,39240,2507,1253,1254
28095,43529,4283,21041,2980,39246,2509,1255,1254
28100,43540,4284,21045,2980,39256,2509,1255,1254
28105,43544,4284,21047,2980,39260,2509,1255,1254
28110,43554,4285,21051,2981,39269,2509,1255,1254
28115,43560,4285,21055,2981,39275,2510,1255,1255
28120,43571,4287,21062,2982,39284,2510,1255,1255
28125,43575,4287,21065,2982,39288,2510,1255,1255
28130,43585,4289,21070,2984,39296,2510,1255,1255
28135,43591,4289,21071,2984,39302,2511,1256,1255
28140,43602,4291,21074,2986,39310,2512,1256,1256
28145,43606,4293,21077,2988,39313,2512,1256,1256
28150,43616,4295,21082,2989,39321,2512,1256,1256
28155,43622,4295,21086,2989,39327,2513,1257,1256
28160,43633,4296,21094,2990,39337,2514,1257,1257
28165,43637,4297,21096,2991,39340,2514,1257,1257
28170,43647,4299,21102,2993,39348,2514,1257,1257
28175,43653,4299,21106,2993,39354,2515,1257,1258
28180,43664,4300,21113,2994,39364,2516,1257,1259
28185,43668,4300,21115,2994,39368,2516,1257,1259
28190,43678,4302,21119,2995,39376,2516,1257,1259
28195,43684,4302,21121,2995,39382,2517,1257,1260
28200,43695,4302,21129,2995,39393,2517,1257,1260
28205,43699,4302,21130,2995,39397,2517,1257,1260
28210,43709,4304,21135,2995,39405,2517,1257,1260
28215,43715,4304,21136,2995,39411,2518,1257,1261
28220,43726,4304,21140,2995,39422,2518,1257,1261
28225,43730,4304,21141,2995,39426,2518,1257,1261
28230,43740,4306,21145,2996,39434,2518,1257,1261
28235,43746,4306,21149,2996,39440,2520,1259,1261
28240,43757,4307,21154,2997,39450,2520,1259,1261
28245,43761,4307,21157,2997,39454,2520,1259,1261
28250,43771,4309,21161,2998,39462,2520,1259,1261
28255,43777,4309,21165,2998,39467,2522,1261,1261
28260,43788,4312,21169,3000,39476,2523,1262,1261
28265,43792,4312,21172,3000,39480,2523,1262,1261
28270,43802,4313,21178,3001,39489,2523,1262,1261
28275,43808,4313,21181,3001,39495,2525,1263,1262
28280,43819,4313,21188,3001,39506,2525,1263,1262
28285,43823,4313,21191,3001,39510,2525,1263,1262
28290,43833,4314,21195,3001,39519,2525,1263,1262
28295,43839,4314,21197,3001,39525,2527,1265,1262
28300,43850,4314,21203,3001,39536,2528,1266,1262
28305,43854,4315,21205,3002,39539,2528,1266,1262
28310,43864,4316,21208,3002,39548,2528,1266,1262
28315,43870,4316,21209,3002,39554,2530,1266,1264
28320,43881,4317,21216,3003,39564,2531,1267,1264
28325,43885,4317,21217,3003,39568,2531,1267,1264
28330,43895,4318,21223,3003,39577,2531,1267,1264
28335,43901,4318,21225,3003,39583,2532,1267,1265
28340,43912,4318,21227,3003,39594,2532,1267,1265
28345,43916,4318,21228,3003,39598,2532,1267,1265
28350,43926,4319,21231,3003,39607,2532,1267,1265
28355,43932,4319,21232,3003,39613,2533,1267,1266
28360,43943,4319,21235,3003,39624,2533,1267,1266
28365,43947,4319,21236,3003,39628,2533,1267,1266
28370,43957,4321,21241,3005,39636,2533,1267,1266
28375,43963,4321,21244,3005,39642,2534,1268,1266
28380,43974,4322,21249,3006,39651,2535,1269,1266
28385,43978,4323,21250,3007,39655,2535,1269,1266
28390,43988,4324,21257,3007,39664,2535,1269,1266
28395,43994,4324,21260,3007,39670,2536,1269,1267
28400,44005,4325,21266,3008,39680,2537,1270,1267
28405,44009,4325,21267,3008,39684,2537,1270,1267
28410,44019,4326,21271,3008,39693,2537,1270,1267
28415,44025,4326,21274,3008,39699,2538,1271,1267
28420,44036,4328,21280,3010,39708,2539,1271,1268
28425,44040,4329,21282,3011,39711,2539,1271,1268
28430,44050,4330,21287,3011,39720,2539,1271,1268
28435,44056,4330,21290,3011,39726,2540,1272,1268
28440,44067,4331,21294,3011,39736,2541,1273,1268
28445,44071,4331,21297,3011,39740,2541,1273,1268
28450,44081,4333,21301,3012,39748,2541,1273,1268
28455,44087,4333,21303,3012,39754,2542,1274,1268
28460,44098,4334,21307,3013,39764,2542,1274,1268
28465,44102,4334,21311,3013,39768,2542,1274,1268
28470,44112,4336,21316,3015,39776,2542,1274,1268
28475,44118,4336,21320,3015,39782,2543,1275,1268
28480,44129,4338,21325,3016,39791,2543,1275,1268
28485,44133,4338,21327,3016,39795,2543,1275,1268
28490,44143,4340,21333,3017,39803,2543,1275,1268
28495,44149,4340,21337,3017,39809,2545,1277,1268
28500,44160,4342,21343,3018,39818,2545,1277,1268
28505,44164,4342,21347,3018,39822,2545,1277,1268
28510,44174,4344,21353,3019,39830,2545,1277,1268
28515,44180,4344,21355,3019,39836,2547,1279,1268
28520,44191,4346,21362,3021,39844,2547,1279,1268
28525,44195,4347,21364,3022,39848,2547,1279,1268
28530,44205,4349,21370,3024,39856,2547,1279,1268
28535,44211,4349,21374,3024,39862,2549,1280,1269
28540,44222,4350,21379,3025,39871,2549,1280,1269
28545,44226,4351,21381,3026,39875,2549,1280,1269
28550,44236,4353,21383,3026,39883,2549,1280,1269
28555,44242,4353,21386,3026,39889,2550,1280,1270
28560,44253,4355,21390,3027,39898,2551,1281,1270
28565,44257,4356,21394,3028,39901,2551,1281,1270
28570,44267,4357,21400,3029,39910,2551,1281,1270
28575,44273,4357,21402,3029,39916,2552,1281,1271
28580,44284,4358,21409,3030,39926,2553,1281,1272
28585,44288,4359,21413,3031,39929,2553,1281,1272
28590,44298,4360,21414,3031,39938,2553,1281,1272
28595,44304,4360,21418,3031,39943,2554,1282,1272
28600,44315,4361,21421,3032,39954,2555,1282,1273
28605,44319,4361,21424,3032,39958,2555,1282,1273
28610,44329,4362,21429,3032,39967,2555,1282,1273
28615,44335,4362,21431,3032,39972,2556,1283,1273
28620,44346,4363,21436,3033,39983,2557,1284,1273
28625,44350,4363,21439,3033,39987,2557,1284,1273
28630,44360,4363,21444,3033,39997,2557,1284,1273
28635,44366,4363,21448,3033,40003,2558,1284,1274
28640,44377,4363,21455,3033,40014,2559,1285,1274
28645,44381,4363,21458,3033,40018,2559,1285,1274
28650,44391,4363,21465,3033,40028,2559,1285,1274
28655,44397,4363,21470,3033,40034,2561,1287,1274
28660,44408,4363,21477,3033,40045,2562,1287,1275
28665,44412,4363,21478,3033,40049,2562,1287,1275
28670,44422,4364,21484,3033,40058,2562,1287,1275
28675,44428,4364,21486,3033,40064,2564,1289,1275
28680,44439,4365,21490,3034,40074,2565,1289,1276
28685,44443,4365,21493,3034,40078,2565,1289,1276
28690,44453,4366,21500,3035,40087,2565,1289,1276
28695,44459,4366,21503,3035,40093,2567,1290,1277
28700,44470,4366,21508,3035,40104,2568,1291,1277
28705,44474,4366,21510,3035,40108,2568,1291,1277
28710,44484,4367,21514,3036,40117,2568,1291,1277
28715,44490,4367,21517,3036,40123,2569,1292,1277
28720,44501,4367,21521,3036,40134,2570,1292,1278
28725,44505,4367,21524,3036,40138,2570,1292,1278
28730,44515,4369,21529,3037,40146,2570,1292,1278
28735,44521,4369,21533,3037,40152,2571,1293,1278
28740,44532,4371,21540,3039,40161,2572,1294,1278
28745,44536,4371,21541,3039,40165,2572,1294,1278
28750,44546,4373,21545,3041,40173,2572,1294,1278
28755,44552,4373,21548,3041,40179,2573,1294,1279
28760,44563,4375,21552,3042,40188,2574,1295,1279
28765,44567,4376,21553,3043,40191,2574,1295,1279
28770,44577,4378,21557,3043,40199,2574,1295,1279
28775,44583,4378,21560,3043,40205,2575,1296,1279
28780,44594,4379,21565,3043,40215,2576,1296,1280
28785,44598,4381,21568,3045,40217,2576,1296,1280
28790,44608,4383,21575,3046,40225,2576,1296,1280
28795,44614,4383,21577,3046,40231,2577,1296,1281
28800,44625,4384,21577,3046,40241,2578,1296,1282
28805,44629,4385,21580,3047,40244,2578,1296,1282
28810,44639,4387,21587,3048,40252,2578,1296,1282
28815,44645,4387,21590,3048,40258,2580,1297,1283
28820,44656,4389,21593,3049,40267,2580,1297,1283
28825,44660,4390,21595,3050,40270,2580,1297,1283
28830,44670,4392,21599,3050,40278,2580,1297,1283
28835,44676,4392,21602,3050,40284,2582,1298,1284
28840,44687,4393,21605,3051,40294,2582,1298,1284
28845,44691,4394,21608,3052,40297,2582,1298,1284
28850,44701,4396,21612,3054,40305,2582,1298,1284
28855,44707,4396,21615,3054,40311,2584,1299,1285
28860,44718,4400,21620,3057,40318,2585,1299,1286
28865,44722,4400,21621,3057,40322,2585,1299,1286
28870,44732,4401,21626,3057,40331,2585,1299,1286
28875,44738,4401,21629,3057,40336,2586,1299,1287
28880,44749,4402,21632,3058,40347,2586,1299,1287
28885,44753,4402,21634,3058,40351,2586,1299,1287
28890,44763,4403,21635,3058,40360,2586,1299,1287
28895,44769,4403,21640,3058,40365,2587,1300,1287
28900,44780,4404,21644,3059,40376,2587,1300,1287
28905,44784,4404,21646,3059,40380,2587,1300,1287
28910,44794,4405,21649,3060,40389,2587,1300,1287
28915,44800,4405,21650,3060,40395,2588,1300,1288
28920,44811,4405,21656,3060,40406,2589,1301,1288
28925,44815,4405,21657,3060,40410,2589,1301,1288
28930,44825,4405,21661,3060,40420,2589,1301,1288
28935,44831,4405,21664,3060,40426,2590,1302,1288
28940,44842,4405,21669,3060,40437,2590,1302,1288
28945,44846,4405,21671,3060,40441,2590,1302,1288
28950,44856,4405,21673,3060,40451,2590,1302,1288
28955,44862,4405,21674,3060,40457,2591,1303,1288
28960,44873,4405,21680,3060,40468,2591,1303,1288
28965,44877,4405,21682,3060,40472,2591,1303,1288
28970,44887,4406,21689,3061,40481,2591,1303,1288
28975,44893,4406,21692,3061,40487,2592,1304,1288
28980,44904,4407,21696,3061,40497,2593,1304,1289
28985,44908,4408,21697,3062,40500,2593,1304,1289
28990,44918,4410,21701,3063,40508,2593,1304,1289
28995,44924,4410,21706,3063,40514,2594,1305,1289
29000,44935,4413,21711,3065,40522,2595,1306,1289
29005,44939,4415,21715,3067,40524,2595,1306,1289
29010,44949,4417,21721,3068,40532,2595,1306,1289
29015,44955,4417,21726,3068,40538,2596,1307,1289
29020,44966,4421,21730,3071,40545,2597,1307,1290
29025,44970,4422,21733,3072,40548,2597,1307,1290
29030,44980,4424,21740,3074,40556,2597,1307,1290
29035,44986,4424,21742,3074,40562,2598,1307,1291
29040,44997,4428,21750,3077,40569,2599,1308,1291
29045,45001,4428,21751,3077,40573,2599,1308,1291
29050,45011,4428,21759,3077,40583,2599,1308,1291
29055,45017,4428,21763,3077,40589,2600,1308,1292
29060,45028,4428,21766,3077,40600,2601,1308,1293
29065,45032,4428,21767,3077,40604,2601,1308,1293
29070,45042,4428,21771,3077,40614,2601,1308,1293
29075,45048,4428,21774,3077,40620,2602,1308,1294
29080,45059,4428,21777,3077,40631,2602,1308,1294
29085,45063,4428,21778,3077,40635,2602,1308,1294
29090,45073,4428,21781,3077,40645,2602,1308,1294
29095,45079,4428,21783,3077,40651,2603,1308,1295
29100,45090,4428,21789,3077,40662,2603,1308,1295
29105,45094,4428,21791,3077,40666,2603,1308,1295
29110,45104,4430,21796,3078,40674,2603,1308,1295
29115,45110,4430,21799,3078,40680,2605,1308,1297
29120,45121,4431,21804,3079,40689,2605,1308,1297
29125,45125,4432,21806,3080,40693,2605,1308,1297
29130,45135,4434,21811,3080,40701,2605,1308,1297
29135,45141,4434,21812,3080,40707,2607,1309,1298
29140,45152,4436,21817,3082,40715,2607,1309,1298
29145,45156,4437,21817,3083,40719,2607,1309,1298
29150,45166,4439,21822,3085,40727,2607,1309,1298
29155,45172,4439,21825,3085,40732,2609,1310,1299
29160,45183,4444,21832,3090,40739,2610,1311,1299
29165,45187,4444,21835,3090,40743,2610,1311,1299
29170,45197,4444,21837,3090,40753,2610,1311,1299
29175,45203,4444,21839,3090,40759,2611,1311,1300
29180,45214,4445,21846,3090,40769,2611,1311,1300
29185,45218,4446,21849,3091,40772,2611,1311,1300
29190,45228,4446,21854,3091,40782,2611,1311,1300
29195,45234,4446,21857,3091,40788,2612,1312,1300
29200,45245,4447,21864,3092,40798,2612,1312,1300
29205,45249,4447,21865,3092,40802,2612,1312,1300
29210,45259,4447,21868,3092,40812,2612,1312,1300
29215,45265,4447,21870,3092,40818,2613,1312,1301
29220,45276,4448,21877,3092,40827,2614,1312,1302
29225,45280,4449,21880,3093,40831,2614,1312,1302
29230,45290,4449,21883,3093,40841,2614,1312,1302
29235,45296,4449,21884,3093,40847,2615,1312,1303
29240,45307,4450,21889,3093,40857,2616,1312,1304
29245,45311,4450,21890,3093,40861,2616,1312,1304
29250,45321,4450,21893,3093,40871,2616,1312,1304
29255,45327,4450,21896,3093,40877,2617,1312,1305
29260,45338,4451,21903,3094,40887,2618,1312,1306
29265,45342,4451,21905,3094,40891,2618,1312,1306
29270,45352,4453,21914,3095,40899,2618,1312,1306
29275,45358,4453,21918,3095,40904,2620,1313,1307
29280,45369,4456,21921,3098,40913,2621,1314,1307
29285,45373,4457,21923,3099,40916,2621,1314,1307
29290,45383,4457,21929,3099,40926,2621,1314,1307
29295,45389,4457,21931,3099,40932,2623,1316,1307
29300,45400,4458,21937,3100,40942,2623,1316,1307
29305,45404,4458,21939,3100,40946,2623,1316,1307
29310,45414,4458,21946,3100,40956,2623,1316,1307
29315,45420,4458,21948,3100,40962,2624,1316,1308
29320,45431,4459,21955,3101,40972,2624,1316,1308
29325,45435,4459,21958,3101,40976,2624,1316,1308
29330,45445,4459,21961,3101,40986,2624,1316,1308
29335,45451,4459,21963,3101,40992,2625,1316,1309
29340,45462,4461,21967,3102,41001,2625,1316,1309
29345,45466,4461,21969,3102,41005,2625,1316,1309
29350,45476,4461,21972,3102,41015,2625,1316,1309
29355,45482,4461,21974,3102,41021,2626,1317,1309
29360,45493,4463,21980,3103,41030,2626,1317,1309
29365,45497,4463,21982,3103,41034,2626,1317,1309
29370,45507,4463,21988,3103,41044,2626,1317,1309
29375,45513,4463,21990,3103,41050,2627,1317,1310
29380,45524,4465,21996,3104,41059,2627,1317,1310
29385,45528,4465,21997,3104,41063,2627,1317,1310
29390,45538,4467,22001,3104,41071,2627,1317,1310
29395,45544,4467,22006,3104,41077,2628,1318,1310
29400,45555,4468,22011,3105,41087,2629,1319,1310
29405,45559,4470,22014,3107,41089,2629,1319,1310
29410,45569,4472,22019,3108,41097,2629,1319,1310
29415,45575,4472,22023,3108,41103,2630,1320,1310
29420,45586,4473,22030,3108,41113,2630,1320,1310
29425,45590,4473,22032,3108,41117,2630,1320,1310
29430,45600,4475,22038,3109,41125,2630,1320,1310
29435,45606,4475,22042,3109,41131,2631,1321,1310
29440,45617,4476,22048,3110,41141,2631,1321,1310
29445,45621,4477,22051,3111,41144,2631,1321,1310
29450,45631,4479,22056,3112,41152,2631,1321,1310
29455,45637,4479,22060,3112,41158,2632,1322,1310
29460,45648,4480,22065,3112,41168,2632,1322,1310
29465,45652,4480,22065,3112,41172,2632,1322,1310
29470,45662,4482,22069,3113,41180,2632,1322,1310
29475,45668,4482,22073,3113,41186,2634,1324,1310
29480,45679,4483,22076,3113,41196,2634,1324,1310
29485,45683,4483,22077,3113,41200,2634,1324,1310
29490,45693,4485,22081,3114,41208,2634,1324,1310
29495,45699,4485,22084,3114,41214,2636,1325,1311
29500,45710,4486,22088,3114,41224,2636,1325,1311
29505,45714,4487,22092,3115,41227,2636,1325,1311
29510,45724,4489,22096,3115,41235,2636,1325,1311
29515,45730,4489,22100,3115,41240,2638,1327,1311
29520,45741,4492,22103,3117,41249,2638,1327,1311
29525,45745,4492,22106,3117,41253,2638,1327,1311
29530,45755,4493,22108,3117,41262,2638,1327,1311
29535,45761,4493,22110,3117,41268,2639,1328,1311
29540,45772,4495,22117,3119,41277,2640,1329,1311
29545,45776,4495,22121,3119,41281,2640,1329,1311
29550,45786,4496,22126,3120,41290,2640,1329,1311
29555,45792,4496,22130,3120,41295,2641,1329,1312
29560,45803,4498,22135,3122,41305,2642,1329,1313
29565,45807,4498,22138,3122,41309,2642,1329,1313
29570,45817,4499,22142,3122,41318,2642,1329,1313
29575,45823,4499,22146,3122,41324,2643,1330,1313
29580,45834,4499,22149,3122,41335,2644,1330,1314
29585,45838,4500,22153,3123,41338,2644,1330,1314
29590,45848,4502,22159,3124,41346,2644,1330,1314
29595,45854,4502,22162,3124,41352,2646,1330,1316
29600,45865,4504,22169,3126,41361,2647,1331,1316
29605,45869,4505,22171,3127,41364,2647,1331,1316
29610,45879,4507,22178,3128,41372,2647,1331,1316
29615,45885,4507,22181,3128,41378,2649,1332,1317
29620,45896,4509,22188,3130,41387,2650,1332,1318
29625,45900,4509,22190,3130,41391,2650,1332,1318
29630,45910,4511,22197,3132,41399,2650,1332,1318
29635,45916,4511,22199,3132,41405,2652,1333,1319
29640,45927,4514,22206,3135,41412,2653,1334,1319
29645,45931,4516,22208,3137,41415,2653,1334,1319
29650,45941,4517,22212,3138,41424,2653,1334,1319
29655,45947,4517,22217,3138,41430,2654,1335,1319
29660,45958,4519,22225,3140,41438,2654,1335,1319
29665,45962,4520,22225,3141,41442,2654,1335,1319
29670,45972,4521,22229,3141,41451,2654,1335,1319
29675,45978,4521,22232,3141,41457,2655,1335,1320
29680,45989,4522,22236,3141,41466,2655,1335,1320
29685,45993,4523,22239,3142,41470,2655,1335,1320
29690,46003,4524,22245,3142,41479,2655,1335,1320
29695,46009,4524,22246,3142,41485,2656,1335,1321
29700,46020,4525,22251,3143,41494,2656,1335,1321
29705,46024,4526,22254,3144,41498,2656,1335,1321
29710,46034,4527,22260,3144,41507,2656,1335,1321
29715,46040,4527,22261,3144,41513,2657,1335,1322
29720,46051,4528,22266,3144,41523,2657,1335,1322
29725,46055,4529,22267,3145,41526,2657,1335,1322
29730,46065,4530,22271,3145,41535,2657,1335,1322
29735,46071,4530,22274,3145,41541,2658,1335,1323
29740,46082,4531,22276,3145,41551,2658,1335,1323
29745,46086,4531,22278,3145,41555,2658,1335,1323
29750,46096,4532,22283,3146,41564,2658,1335,1323
29755,46102,4532,22286,3146,41570,2660,1335,1325
29760,46113,4534,22294,3148,41578,2661,1336,1325
29765,46117,4535,22297,3149,41582,2661,1336,1325
29770,46127,4536,22299,3149,41591,2661,1336,1325
29775,46133,4536,22304,3149,41597,2662,1337,1325
29780,46144,4538,22308,3150,41606,2663,1338,1325
29785,46148,4538,22310,3150,41610,2663,1338,1325
29790,46158,4539,22315,3151,41619,2663,1338,1325
29795,46164,4539,22318,3151,41625,2664,1339,1325
29800,46175,4541,22321,3152,41634,2665,1340,1325
29805,46179,4541,22324,3152,41638,2665,1340,1325
29810,46189,4542,22330,3153,41647,2665,1340,1325
29815,46195,4542,22335,3153,41653,2666,1341,1325
29820,46206,4545,22343,3155,41661,2667,1342,1325
29825,46210,4545,22344,3155,41665,2667,1342,1325
29830,46220,4547,22349,3156,41673,2667,1342,1325
29835,46226,4547,22350,3156,41679,2668,1342,1326
29840,46237,4549,22357,3158,41688,2668,1342,1326
29845,46241,4549,22361,3158,41692,2668,1342,1326
29850,46251,4551,22366,3160,41700,2668,1342,1326
29855,46257,4551,22369,3160,41706,2669,1342,1327
29860,46268,4552,22374,3160,41716,2669,1342,1327
29865,46272,4553,22376,3161,41719,2669,1342,1327
29870,46282,4555,22381,3162,41727,2669,1342,1327
29875,46288,4555,22384,3162,41733,2671,1343,1328
29880,46299,4557,22391,3164,41742,2671,1343,1328
29885,46303,4557,22393,3164,41746,2671,1343,1328
29890,46313,4559,22398,3165,41754,2671,1343,1328
29895,46319,4559,22401,3165,41760,2673,1345,1328
29900,46330,4561,22408,3166,41769,2673,1345,1328
29905,46334,4561,22410,3166,41773,2673,1345,1328
29910,46344,4563,22417,3167,41781,2673,1345,1328
29915,46350,4563,22418,3167,41787,2675,1346,1329
29920,46361,4565,22424,3169,41796,2675,1346,1329
29925,46365,4566,22426,3170,41799,2675,1346,1329
29930,46375,4568,22430,3170,41807,2675,1346,1329
29935,46381,4568,22433,3170,41813,2677,1347,1330
29940,46392,4570,22437,3172,41822,2678,1347,1331
29945,46396,4570,22440,3172,41826,2678,1347,1331
29950,46406,4570,22444,3172,41836,2678,1347,1331
29955,46412,4570,22446,3172,41842,2679,1348,1331
29960,46423,4570,22451,3172,41853,2679,1348,1331
29965,46427,4570,22453,3172,41857,2679,1348,1331
29970,46437,4570,22460,3172,41867,2679,1348,1331
29975,46443,4570,22463,3172,41873,2680,1348,1332
29980,46454,4570,22472,3172,41884,2680,1348,1332
29985,46458,4570,22472,3172,41888,2680,1348,1332
29990,46468,4570,22476,3172,41898,2680,1348,1332
29995,46474,4570,22478,3172,41904,2681,1348,1333
30000,46485,4570,22480,3172,41915,2681,1348,1333
30005,46489,4570,22483,3172,41919,2681,1348,1333
30010,46499,4570,22489,3172,41929,2681,1348,1333
30015,46505,4570,22490,3172,41935,2682,1348,1334
30020,46516,4570,22496,3172,41946,2682,1348,1334
30025,46520,4570,22498,3172,41950,2682,1348,1334
30030,46530,4570,22503,3172,41960,2682,1348,1334
30035,46536,4570,22505,3172,41966,2683,1348,1335
30040,46547,4570,22509,3172,41977,2683,1348,1335
30045,46551,4570,22510,3172,41981,2683,1348,1335
30050,46561,4572,22517,3173,41989,2683,1348,1335
30055,46567,4572,22519,3173,41995,2685,1348,1337
30060,46578,4573,22524,3174,42005,2686,1348,1338
30065,46582,4573,22526,3174,42009,2686,1348,1338
30070,46592,4575,22533,3175,42017,2686,1348,1338
30075,46598,4575,22536,3175,42023,2688,1349,1339
30080,46609,4576,22540,3176,42033,2688,1349,1339
30085,46613,4577,22543,3177,42036,2688,1349,1339
30090,46623,4578,22545,3177,42045,2688,1349,1339
30095,46629,4578,22549,3177,42051,2690,1350,1340
30100,46640,4580,22553,3178,42060,2690,1350,1340
30105,46644,4581,22555,3179,42063,2690,1350,1340
30110,46654,4582,22561,3179,42072,2690,1350,1340
30115,46660,4582,22563,3179,42078,2692,1350,1342
30120,46671,4584,22571,3181,42087,2692,1350,1342
30125,46675,4584,22572,3181,42091,2692,1350,1342
30130,46685,4585,22577,3182,42100,2692,1350,1342
30135,46691,4585,22580,3182,42106,2693,1350,1343
30140,46702,4586,22587,3183,42116,2693,1350,1343
30145,46706,4587,22588,3184,42119,2693,1350,1343
30150,46716,4588,22595,3185,42128,2693,1350,1343
30155,46722,4588,22597,3185,42134,2694,1350,1344
30160,46733,4589,22602,3185,42144,2694,1350,1344
30165,46737,4590,22605,3186,42147,2694,1350,1344
30170,46747,4592,22610,3187,42155,2694,1350,1344
30175,46753,4592,22612,3187,42161,2695,1350,1345
30180,46764,4595,22617,3189,42169,2696,1351,1345
30185,46768,4595,22619,3189,42173,2696,1351,1345
30190,46778,4595,22628,3189,42183,2696,1351,1345
30195,46784,4595,22630,3189,42189,2697,1352,1345
30200,46795,4595,22636,3189,42200,2697,1352,1345
30205,46799,4595,22637,3189,42204,2697,1352,1345
30210,46809,4595,22640,3189,42214,2697,1352,1345
30215,46815,4595,22641,3189,42220,2698,1352,1346
30220,46826,4595,22644,3189,42231,2698,1352,1346
30225,46830,4595,22646,3189,42235,2698,1352,1346
30230,46840,4595,22651,3189,42245,2698,1352,1346
30235,46846,4595,22652,3189,42251,2700,1352,1348
30240,46857,4595,22659,3189,42262,2700,1352,1348
30245,46861,4595,22662,3189,42266,2700,1352,1348
30250,46871,4595,22666,3189,42276,2700,1352,1348
30255,46877,4595,22668,3189,42282,2702,1352,1350
30260,46888,4595,22673,3189,42293,2702,1352,1350
30265,46892,4595,22675,3189,42297,2702,1352,1350
30270,46902,4595,22680,3189,42307,2702,1352,1350
30275,46908,4595,22684,3189,42313,2704,1353,1351
30280,46919,4595,22688,3189,42324,2704,1353,1351
30285,46923,4595,22691,3189,42328,2704,1353,1351
30290,46933,4597,22697,3189,42336,2704,1353,1351
30295,46939,4597,22702,3189,42342,2705,1354,1351
30300,46950,4598,22706,3190,42352,2705,1354,1351
30305,46954,4599,22710,3191,42355,2705,1354,1351
30310,46964,4601,22715,3192,42363,2705,1354,1351
30315,46970,4601,22720,3192,42369,2706,1355,1351
30320,46981,4603,22725,3193,42378,2706,1355,1351
30325,46985,4604,22728,3194,42381,2706,1355,1351
30330,46995,4606,22732,3194,42389,2706,1355,1351
30335,47001,4606,22736,3194,42395,2707,1356,1351
30340,47012,4607,22742,3195,42405,2707,1356,1351
30345,47016,4607,22742,3195,42409,2707,1356,1351
30350,47026,4609,22747,3196,42417,2707,1356,1351
30355,47032,4609,22748,3196,42423,2708,1356,1352
30360,47043,4610,22751,3197,42433,2708,1356,1352
30365,47047,4610,22752,3197,42437,2708,1356,1352
30370,47057,4612,22758,3199,42445,2708,1356,1352
30375,47063,4612,22762,3199,42451,2709,1356,1353
30380,47074,4613,22767,3199,42461,2709,1356,1353
30385,47078,4614,22769,3200,42464,2709,1356,1353
30390,47088,4616,22773,3200,42472,2709,1356,1353
30395,47094,4616,22777,3200,42478,2710,1357,1353
30400,47105,4618,22781,3201,42487,2710,1357,1353
30405,47109,4619,22784,3202,42490,2710,1357,1353
30410,47119,4622,22790,3205,42497,2710,1357,1353
30415,47125,4622,22792,3205,42502,2711,1357,1354
30420,47136,4627,22797,3209,42508,2712,1357,1355
30425,47140,4628,22797,3210,42512,2712,1357,1355
30430,47150,4628,22802,3210,42522,2712,1357,1355
30435,47156,4628,22805,3210,42528,2713,1357,1356
30440,47167,4628,22807,3210,42539,2714,1357,1357
30445,47171,4628,22809,3210,42543,2714,1357,1357
30450,47181,4628,22812,3210,42553,2714,1357,1357
30455,47187,4628,22814,3210,42559,2715,1358,1357
30460,47198,4628,22820,3210,42570,2716,1359,1357
30465,47202,4628,22821,3210,42574,2716,1359,1357
30470,47212,4628,22828,3210,42584,2716,1359,1357
30475,47218,4628,22834,3210,42590,2718,1361,1357
30480,47229,4628,22839,3210,42601,2719,1362,1357
30485,47233,4629,22841,3211,42604,2719,1362,1357
30490,47243,4630,22849,3212,42613,2719,1362,1357
30495,47249,4630,22850,3212,42619,2720,1362,1358
30500,47260,4630,22855,3212,42630,2721,1363,1358
30505,47264,4630,22855,3212,42634,2721,1363,1358
30510,47274,4631,22859,3213,42643,2721,1363,1358
30515,47280,4631,22860,3213,42649,2722,1363,1359
30520,47291,4631,22866,3213,42660,2723,1364,1359
30525,47295,4631,22867,3213,42664,2723,1364,1359
30530,47305,4633,22872,3214,42672,2723,1364,1359
30535,47311,4633,22874,3214,42678,2724,1364,1360
30540,47322,4635,22879,3215,42687,2725,1364,1361
30545,47326,4635,22881,3215,42691,2725,1364,1361
30550,47336,4637,22886,3216,42699,2725,1364,1361
30555,47342,4637,22889,3216,42704,2727,1366,1361
30560,47353,4640,22894,3218,42713,2727,1366,1361
30565,47357,4640,22896,3218,42717,2727,1366,1361
30570,47367,4642,22901,3219,42725,2727,1366,1361
30575,47373,4642,22902,3219,42731,2728,1366,1362
30580,47384,4643,22907,3220,42741,2728,1366,1362
30585,47388,4644,22909,3221,42744,2728,1366,1362
30590,47398,4646,22915,3222,42752,2728,1366,1362
30595,47404,4646,22916,3222,42758,2729,1366,1363
30600,47415,4648,22920,3223,42767,2729,1366,1363
30605,47419,4648,22921,3223,42771,2729,1366,1363
30610,47429,4650,22925,3224,42779,2729,1366,1363
30615,47435,4650,22925,3224,42785,2730,1366,1364
30620,47446,4652,22929,3225,42794,2730,1366,1364
30625,47450,4652,22930,3225,42798,2730,1366,1364
30630,47460,4654,22934,3225,42806,2730,1366,1364
30635,47466,4654,22938,3225,42812,2731,1367,1364
30640,47477,4655,22942,3226,42822,2731,1367,1364
30645,47481,4655,22944,3226,42826,2731,1367,1364
30650,47491,4657,22949,3227,42834,2731,1367,1364
30655,47497,4657,22954,3227,42840,2732,1368,1364
30660,47508,4659,22959,3229,42848,2733,1369,1364
30665,47512,4660,22960,3230,42852,2733,1369,1364
30670,47522,4660,22961,3230,42862,2733,1369,1364
30675,47528,4660,22962,3230,42868,2735,1370,1365
30680,47539,4660,22965,3230,42879,2736,1370,1366
30685,47543,4660,22968,3230,42883,2736,1370,1366
30690,47553,4660,22970,3230,42893,2736,1370,1366
30695,47559,4660,22973,3230,42899,2738,1372,1366
30700,47570,4660,22976,3230,42910,2739,1372,1367
30705,47574,4660,22978,3230,42914,2739,1372,1367
30710,47584,4660,22985,3230,42924,2739,1372,1367
30715,47590,4660,22987,3230,42930,2741,1373,1368
30720,47601,4660,22994,3230,42941,2741,1373,1368
30725,47605,4660,22997,3230,42945,2741,1373,1368
30730,47615,4660,23003,3230,42955,2741,1373,1368
30735,47621,4660,23005,3230,42961,2743,1374,1369
30740,47632,4660,23011,3230,42972,2743,1374,1369
30745,47636,4660,23014,3230,42976,2743,1374,1369
30750,47646,4660,23019,3230,42986,2743,1374,1369
30755,47652,4660,23021,3230,42992,2745,1374,1371
30760,47663,4660,23026,3230,43003,2745,1374,1371
30765,47667,4660,23028,3230,43007,2745,1374,1371
30770,47677,4662,23034,3231,43015,2745,1374,1371
30775,47683,4662,23038,3231,43021,2747,1376,1371
30780,47694,4664,23044,3233,43030,2748,1377,1371
30785,47698,4664,23046,3233,43034,2748,1377,1371
30790,47708,4666,23052,3234,43042,2748,1377,1371
30795,47714,4666,23057,3234,43048,2750,1378,1372
30800,47725,4667,23062,3234,43058,2750,1378,1372
30805,47729,4667,23066,3234,43062,2750,1378,1372
30810,47739,4669,23071,3235,43070,2750,1378,1372
30815,47745,4669,23075,3235,43076,2752,1379,1373
30820,47756,4671,23081,3237,43085,2752,1379,1373
30825,47760,4671,23083,3237,43089,2752,1379,1373
30830,47770,4673,23088,3238,43097,2752,1379,1373
30835,47776,4673,23091,3238,43103,2754,1380,1374
30840,47787,4675,23096,3240,43112,2754,1380,1374
30845,47791,4676,23098,3241,43115,2754,1380,1374
30850,47801,4678,23104,3242,43123,2754,1380,1374
30855,47807,4678,23107,3242,43129,2755,1381,1374
30860,47818,4680,23112,3244,43138,2755,1381,1374
30865,47822,4680,23114,3244,43142,2755,1381,1374
30870,47832,4682,23121,3245,43150,2755,1381,1374
30875,47838,4682,23124,3245,43156,2756,1382,1374
30880,47849,4684,23130,3247,43165,2756,1382,1374
30885,47853,4685,23131,3248,43168,2756,1382,1374
30890,47863,4688,23136,3249,43175,2756,1382,1374
30895,47869,4688,23139,3249,43181,2757,1383,1374
30900,47880,4690,23143,3250,43190,2758,1383,1375
30905,47884,4690,23143,3250,43194,2758,1383,1375
30910,47894,4690,23146,3250,43204,2758,1383,1375
30915,47900,4690,23148,3250,43210,2759,1383,1376
30920,47911,4690,23149,3250,43221,2759,1383,1376
30925,47915,4690,23151,3250,43225,2759,1383,1376
30930,47925,4690,23156,3250,43235,2759,1383,1376
30935,47931,4690,23158,3250,43241,2760,1384,1376
30940,47942,4690,23166,3250,43252,2760,1384,1376
30945,47946,4690,23168,3250,43256,2760,1384,1376
30950,47956,4690,23174,3250,43266,2760,1384,1376
30955,47962,4690,23177,3250,43272,2761,1384,1377
30960,47973,4690,23180,3250,43283,2761,1384,1377
30965,47977,4690,23182,3250,43287,2761,1384,1377
30970,47987,4690,23188,3250,43297,2761,1384,1377
30975,47993,4690,23191,3250,43303,2762,1384,1378
30980,48004,4690,23195,3250,43314,2762,1384,1378
30985,48008,4690,23197,3250,43318,2762,1384,1378
30990,48018,4690,23202,3250,43328,2762,1384,1378
30995,48024,4690,23206,3250,43334,2763,1385,1378
31000,48035,4690,23209,3250,43345,2763,1385,1378
31005,48039,4690,23213,3250,43349,2763,1385,1378
31010,48049,4692,23219,3252,43357,2763,1385,1378
31015,48055,4692,23221,3252,43362,2765,1385,1380
31020,48066,4696,23226,3256,43370,2766,1386,1380
31025,48070,4697,23229,3257,43373,2766,1386,1380
31030,48080,4699,23234,3258,43381,2766,1386,1380
31035,48086,4699,23235,3258,43387,2768,1387,1381
31040,48097,4700,23241,3258,43397,2769,1388,1381
31045,48101,4701,23243,3259,43400,2769,1388,1381
31050,48111,4703,23248,3260,43408,2769,1388,1381
31055,48117,4703,23251,3260,43414,2771,1389,1382
31060,48128,4705,23256,3262,43423,2772,1389,1383
31065,48132,4707,23259,3264,43425,2772,1389,1383
31070,48142,4709,23265,3264,43433,2772,1389,1383
31075,48148,4709,23270,3264,43439,2774,1391,1383
31080,48159,4710,23277,3265,43449,2775,1391,1384
31085,48163,4710,23278,3265,43453,2775,1391,1384
31090,48173,4712,23286,3266,43461,2775,1391,1384
31095,48179,4712,23288,3266,43467,2776,1391,1385
31100,48190,4714,23291,3268,43476,2776,1391,1385
31105,48194,4714,23294,3268,43480,2776,1391,1385
31110,48204,4716,23296,3268,43488,2776,1391,1385
31115,48210,4716,23297,3268,43494,2777,1391,1386
31120,48221,4718,23302,3269,43503,2777,1391,1386
31125,48225,4718,23303,3269,43507,2777,1391,1386
31130,48235,4720,23307,3269,43515,2777,1391,1386
31135,48241,4720,23312,3269,43520,2778,1391,1387
31140,48252,4723,23317,3272,43528,2779,1391,1388
31145,48256,4724,23319,3273,43532,2779,1391,1388
31150,48266,4725,23323,3273,43541,2779,1391,1388
31155,48272,4725,23329,3273,43546,2780,1392,1388
31160,48283,4726,23333,3274,43557,2780,1392,1388
31165,48287,4726,23336,3274,43561,2780,1392,1388
31170,48297,4727,23339,3274,43570,2780,1392,1388
31175,48303,4727,23342,3274,43575,2781,1393,1388
31180,48314,4728,23348,3275,43586,2781,1393,1388
31185,48318,4728,23350,3275,43590,2781,1393,1388
31190,48328,4729,23354,3275,43599,2781,1393,1388
31195,48334,4729,23357,3275,43605,2782,1394,1388
31200,48345,4729,23364,3275,43616,2783,1395,1388
31205,48349,4729,23366,3275,43620,2783,1395,1388
31210,48359,4729,23372,3275,43630,2783,1395,1388
31215,48365,4729,23373,3275,43636,2785,1396,1389
31220,48376,4729,23376,3275,43647,2785,1396,1389
31225,48380,4729,23377,3275,43651,2785,1396,1389
31230,48390,4729,23382,3275,43661,2785,1396,1389
31235,48396,4729,23384,3275,43667,2787,1396,1391
31240,48407,4729,23389,3275,43678,2787,1396,1391
31245,48411,4729,23389,3275,43682,2787,1396,1391
31250,48421,4730,23396,3276,43691,2787,1396,1391
31255,48427,4730,23399,3276,43697,2788,1396,1392
31260,48438,4732,23404,3277,43706,2789,1397,1392
31265,48442,4733,23405,3278,43709,2789,1397,1392
31270,48452,4735,23411,3279,43717,2789,1397,1392
31275,48458,4735,23415,3279,43722,2790,1397,1393
31280,48469,4738,23420,3281,43731,2791,1397,1394
31285,48473,4739,23422,3282,43734,2791,1397,1394
31290,48483,4741,23427,3283,43742,2791,1397,1394
31295,48489,4741,23430,3283,43748,2792,1398,1394
31300,48500,4743,23436,3285,43757,2793,1399,1394
31305,48504,4744,23438,3286,43760,2793,1399,1394
31310,48514,4746,23442,3287,43768,2793,1399,1394
31315,48520,4746,23445,3287,43774,2794,1400,1394
31320,48531,4748,23451,3289,43783,2795,1401,1394
31325,48535,4749,23454,3290,43786,2795,1401,1394
31330,48545,4751,23459,3291,43794,2795,1401,1394
31335,48551,4751,23461,3291,43800,2796,1402,1394
31340,48562,4752,23467,3292,43810,2796,1402,1394
31345,48566,4752,23470,3292,43814,2796,1402,1394
31350,48576,4754,23472,3292,43822,2796,1402,1394
31355,48582,4754,23473,3292,43828,2798,1403,1395
31360,48593,4754,23477,3292,43839,2798,1403,1395
31365,48597,4754,23479,3292,43843,2798,1403,1395
31370,48607,4756,23482,3293,43851,2798,1403,1395
31375,48613,4756,23486,3293,43857,2800,1404,1396
31380,48624,4757,23493,3294,43867,2800,1404,1396
31385,48628,4757,23495,3294,43871,2800,1404,1396
31390,48638,4759,23501,3295,43879,2800,1404,1396
31395,48644,4759,23504,3295,43885,2802,1404,1398
31400,48655,4761,23509,3297,43894,2802,1404,1398
31405,48659,4761,23512,3297,43898,2802,1404,1398
31410,48669,4763,23515,3298,43906,2802,1404,1398
31415,48675,4763,23519,3298,43912,2804,1405,1399
31420,48686,4765,23527,3300,43921,2804,1405,1399
31425,48690,4765,23528,3300,43925,2804,1405,1399
31430,48700,4767,23533,3302,43933,2804,1405,1399
31435,48706,4767,23536,3302,43939,2806,1406,1400
31440,48717,4770,23541,3304,43947,2807,1406,1401
31445,48721,4770,23542,3304,43951,2807,1406,1401
31450,48731,4771,23549,3305,43960,2807,1406,1401
31455,48737,4771,23553,3305,43966,2808,1407,1401
31460,48748,4771,23560,3305,43977,2808,1407,1401
31465,48752,4771,23562,3305,43981,2808,1407,1401
31470,48762,4772,23566,3305,43990,2808,1407,1401
31475,48768,4772,23569,3305,43996,2809,1407,1402
31480,48779,4772,23574,3305,44007,2809,1407,1402
31485,48783,4772,23577,3305,44011,2809,1407,1402
31490,48793,4773,23579,3305,44020,2809,1407,1402
31495,48799,4773,23580,3305,44026,2810,1407,1403
31500,48810,4773,23584,3305,44037,2810,1407,1403
31505,48814,4774,23587,3306,44040,2810,1407,1403
31510,48824,4775,23593,3307,44049,2810,1407,1403
31515,48830,4775,23597,3307,44055,2811,1408,1403
31520,48841,4776,23602,3308,44065,2811,1408,1403
31525,48845,4776,23604,3308,44069,2811,1408,1403
31530,48855,4777,23607,3308,44078,2811,1408,1403
31535,48861,4777,23608,3308,44084,2812,1408,1404
31540,48872,4778,23610,3308,44094,2812,1408,1404
31545,48876,4779,23611,3309,44097,2812,1408,1404
31550,48886,4781,23617,3311,44105,2812,1408,1404
31555,48892,4781,23619,3311,44110,2813,1408,1405
31560,48903,4784,23623,3313,44118,2814,1408,1406
31565,48907,4785,23623,3314,44122,2814,1408,1406
31570,48917,4786,23627,3314,44131,2814,1408,1406
31575,48923,4786,23629,3314,44137,2815,1409,1406
31580,48934,4787,23638,3315,44147,2815,1409,1406
31585,48938,4787,23641,3315,44151,2815,1409,1406
31590,48948,4788,23642,3315,44160,2815,1409,1406
31595,48954,4788,23646,3315,44166,2816,1409,1407
31600,48965,4789,23651,3316,44176,2816,1409,1407
31605,48969,4789,23653,3316,44180,2816,1409,1407
31610,48979,4790,23656,3316,44189,2816,1409,1407
31615,48985,4790,23657,3316,44195,2818,1409,1409
31620,48996,4790,23661,3316,44206,2818,1409,1409
31625,49000,4790,23662,3316,44210,2818,1409,1409
31630,49010,4792,23671,3317,44218,2818,1409,1409
31635,49016,4792,23676,3317,44224,2819,1410,1409
31640,49027,4793,23681,3318,44234,2819,1410,1409
31645,49031,4793,23683,3318,44238,2819,1410,1409
31650,49041,4795,23687,3320,44246,2819,1410,1409
31655,49047,4795,23692,3320,44252,2820,1411,1409
31660,49058,4795,23700,3320,44263,2820,1411,1409
31665,49062,4795,23702,3320,44267,2820,1411,1409
31670,49072,4797,23706,3321,44275,2820,1411,1409
31675,49078,4797,23708,3321,44281,2821,1411,1410
31680,49089,4800,23715,3324,44289,2822,1412,1410
31685,49093,4800,23717,3324,44293,2822,1412,1410
31690,49103,4802,23724,3326,44301,2822,1412,1410
31695,49109,4802,23727,3326,44307,2823,1413,1410
31700,49120,4803,23733,3327,44317,2823,1413,1410
31705,49124,4803,23734,3327,44321,2823,1413,1410
31710,49134,4805,23739,3328,44329,2823,1413,1410
31715,49140,4805,23743,3328,44335,2824,1414,1410
31720,49151,4805,23748,3328,44346,2824,1414,1410
31725,49155,4805,23750,3328,44350,2824,1414,1410
31730,49165,4807,23759,3330,44358,2824,1414,1410
31735,49171,4807,23762,3330,44364,2825,1415,1410
31740,49182,4807,23764,3330,44375,2826,1415,1411
31745,49186,4807,23767,3330,44379,2826,1415,1411
31750,49196,4809,23770,3331,44387,2826,1415,1411
31755,49202,4809,23771,3331,44393,2827,1415,1412
31760,49213,4810,23776,3332,44403,2828,1415,1413
31765,49217,4810,23778,3332,44407,2828,1415,1413
31770,49227,4812,23785,3333,44415,2828,1415,1413
31775,49233,4812,23789,3333,44421,2829,1416,1413
31780,49244,4813,23796,3334,44431,2830,1416,1414
31785,49248,4813,23797,3334,44435,2830,1416,1414
31790,49258,4815,23801,3335,44443,2830,1416,1414
31795,49264,4815,23805,3335,44448,2832,1418,1414
31800,49275,4818,23811,3338,44457,2833,1419,1414
31805,49279,4818,23813,3338,44461,2833,1419,1414
31810,49289,4819,23816,3339,44470,2833,1419,1414
31815,49295,4819,23820,3339,44476,2835,1420,1415
31820,49306,4819,23823,3339,44487,2835,1420,1415
31825,49310,4819,23825,3339,44491,2835,1420,1415
31830,49320,4820,23829,3340,44500,2835,1420,1415
31835,49326,4820,23833,3340,44506,2836,1421,1415
31840,49337,4820,23835,3340,44517,2836,1421,1415
31845,49341,4820,23837,3340,44521,2836,1421,1415
31850,49351,4821,23841,3340,44530,2836,1421,1415
31855,49357,4821,23845,3340,44536,2837,1422,1415
31860,49368,4821,23850,3340,44547,2837,1422,1415
31865,49372,4821,23853,3340,44551,2837,1422,1415
31870,49382,4822,23860,3341,44560,2837,1422,1415
31875,49388,4822,23863,3341,44566,2838,1422,1416
31880,49399,4822,23869,3341,44577,2838,1422,1416
31885,49403,4822,23870,3341,44581,2838,1422,1416
31890,49413,4823,23876,3341,44590,2838,1422,1416
31895,49419,4823,23881,3341,44596,2839,1422,1417
31900,49430,4823,23884,3341,44607,2839,1422,1417
31905,49434,4824,23886,3342,44610,2839,1422,1417
31910,49444,4825,23892,3343,44619,2839,1422,1417
31915,49450,4825,23894,3343,44624,2840,1422,1418
31920,49461,4829,23899,3346,44631,2841,1422,1419
31925,49465,4831,23901,3348,44634,2841,1422,1419
31930,49475,4832,23904,3348,44643,2841,1422,1419
31935,49481,4832,23908,3348,44649,2842,1422,1420
31940,49492,4833,23912,3348,44659,2842,1422,1420
31945,49496,4833,23913,3348,44663,2842,1422,1420
31950,49506,4834,23919,3349,44672,2842,1422,1420
31955,49512,4834,23922,3349,44678,2843,1423,1420
31960,49523,4836,23928,3351,44687,2843,1423,1420
31965,49527,4836,23930,3351,44691,2843,1423,1420
31970,49537,4837,23931,3351,44700,2843,1423,1420
31975,49543,4837,23937,3351,44706,2844,1424,1420
31980,49554,4839,23942,3352,44715,2844,1424,1420
31985,49558,4839,23944,3352,44719,2844,1424,1420
31990,49568,4840,23947,3352,44728,2844,1424,1420
31995,49574,4840,23949,3352,44734,2845,1425,1420
32000,49585,4841,23954,3353,44744,2845,1425,1420
32005,49589,4841,23956,3353,44748,2845,1425,1420
32010,49599,4842,23964,3353,44757,2845,1425,1420
32015,49605,4842,23967,3353,44763,2846,1426,1420
32020,49616,4843,23971,3354,44773,2846,1426,1420
32025,49620,4843,23973,3354,44777,2846,1426,1420
32030,49630,4845,23978,3355,44785,2846,1426,1420
32035,49636,4845,23982,3355,44791,2848,1428,1420
32040,49647,4847,23985,3356,44800,2849,1429,1420
32045,49651,4847,23988,3356,44804,2849,1429,1420
32050,49661,4848,23993,3356,44813,2849,1429,1420
32055,49667,4848,23997,3356,44819,2851,1430,1421
32060,49678,4848,24004,3356,44829,2852,1430,1422
32065,49682,4849,24006,3357,44833,2852,1430,1422
32070,49692,4850,24011,3358,44842,2852,1430,1422
32075,49698,4850,24014,3358,44848,2853,1431,1422
32080,49709,4851,24022,3359,44858,2854,1432,1422
32085,49713,4851,24023,3359,44862,2854,1432,1422
32090,49723,4852,24027,3359,44871,2854,1432,1422
32095,49729,4852,24030,3359,44877,2855,1433,1422
32100,49740,4853,24035,3360,44887,2856,1434,1422
32105,49744,4853,24036,3360,44891,2856,1434,1422
32110,49754,4854,24040,3361,44900,2856,1434,1422
32115,49760,4854,24042,3361,44906,2857,1434,1423
32120,49771,4854,24045,3361,44917,2857,1434,1423
32125,49775,4854,24048,3361,44921,2857,1434,1423
32130,49785,4855,24053,3362,44930,2857,1434,1423
32135,49791,4855,24057,3362,44936,2858,1435,1423
32140,49802,4855,24063,3362,44947,2858,1435,1423
32145,49806,4856,24065,3363,44950,2858,1435,1423
32150,49816,4858,24068,3363,44958,2858,1435,1423
32155,49822,4858,24071,3363,44963,2859,1436,1423
32160,49833,4861,24076,3366,44971,2860,1436,1424
32165,49837,4862,24079,3367,44975,2860,1436,1424
32170,49847,4863,24083,3367,44984,2860,1436,1424
32175,49853,4863,24086,3367,44990,2862,1436,1426
32180,49864,4864,24087,3367,45000,2863,1436,1427
32185,49868,4864,24088,3367,45004,2863,1436,1427
32190,49878,4865,24092,3367,45013,2863,1436,1427
32195,49884,4865,24096,3367,45019,2865,1436,1429
32200,49895,4867,24102,3368,45028,2866,1436,1430
32205,49899,4867,24103,3368,45032,2866,1436,1430
32210,49909,4868,24107,3368,45041,2866,1436,1430
32215,49915,4868,24109,3368,45047,2868,1437,1431
32220,49926,4870,24117,3370,45056,2869,1437,1432
32225,49930,4870,24118,3370,45060,2869,1437,1432
32230,49940,4870,24124,3370,45070,2869,1437,1432
32235,49946,4870,24127,3370,45076,2870,1438,1432
32240,49957,4871,24134,3371,45086,2871,1439,1432
32245,49961,4871,24138,3371,45090,2871,1439,1432
32250,49971,4871,24142,3371,45100,2871,1439,1432
32255,49977,4871,24145,3371,45106,2872,1439,1433
32260,49988,4872,24150,3371,45116,2872,1439,1433
32265,49992,4872,24151,3371,45120,2872,1439,1433
32270,50002,4872,24153,3371,45130,2872,1439,1433
32275,50008,4872,24159,3371,45136,2873,1440,1433
32280,50019,4873,24163,3371,45146,2873,1440,1433
32285,50023,4873,24164,3371,45150,2873,1440,1433
32290,50033,4873,24168,3371,45160,2873,1440,1433
32295,50039,4873,24169,3371,45166,2874,1440,1434
32300,50050,4875,24173,3372,45175,2874,1440,1434
32305,50054,4875,24174,3372,45179,2874,1440,1434
32310,50064,4875,24179,3372,45189,2874,1440,1434
32315,50070,4875,24181,3372,45195,2875,1440,1435
32320,50081,4876,24185,3372,45205,2875,1440,1435
32325,50085,4876,24187,3372,45209,2875,1440,1435
32330,50095,4877,24190,3372,45218,2875,1440,1435
32335,50101,4877,24192,3372,45224,2877,1441,1436
32340,50112,4878,24196,3373,45234,2878,1441,1437
32345,50116,4878,24197,3373,45238,2878,1441,1437
32350,50126,4879,24202,3373,45247,2878,1441,1437
32355,50132,4879,24206,3373,45252,2879,1442,1437
32360,50143,4881,24213,3375,45262,2879,1442,1437
32365,50147,4882,24215,3376,45265,2879,1442,1437
32370,50157,4883,24219,3376,45274,2879,1442,1437
32375,50163,4883,24223,3376,45280,2880,1443,1437
32380,50174,4884,24227,3377,45290,2880,1443,1437
32385,50178,4884,24228,3377,45294,2880,1443,1437
32390,50188,4885,24231,3377,45303,2880,1443,1437
32395,50194,4885,24234,3377,45309,2881,1444,1437
32400,50205,4887,24239,3379,45318,2882,1445,1437
32405,50209,4887,24241,3379,45322,2882,1445,1437
32410,50219,4889,24243,3380,45330,2882,1445,1437
32415,50225,4889,24248,3380,45336,2883,1446,1437
32420,50236,4890,24254,3381,45345,2884,1446,1438
32425,50240,4891,24257,3382,45349,2884,1446,1438
32430,50250,4893,24264,3384,45357,2884,1446,1438
32435,50256,4893,24268,3384,45363,2885,1447,1438
32440,50267,4894,24274,3385,45373,2886,1448,1438
32445,50271,4894,24276,3385,45377,2886,1448,1438
32450,50281,4896,24282,3385,45385,2886,1448,1438
32455,50287,4896,24285,3385,45391,2887,1448,1439
32460,50298,4898,24289,3387,45399,2888,1448,1440
32465,50302,4899,24290,3388,45403,2888,1448,1440
32470,50312,4901,24297,3390,45411,2888,1448,1440
32475,50318,4901,24300,3390,45417,2889,1448,1441
32480,50329,4902,24304,3391,45427,2890,1448,1442
32485,50333,4903,24307,3392,45430,2890,1448,1442
32490,50343,4905,24312,3394,45438,2890,1448,1442
32495,50349,4905,24313,3394,45444,2891,1448,1443
32500,50360,4906,24320,3395,45454,2892,1449,1443
32505,50364,4906,24323,3395,45458,2892,1449,1443
32510,50374,4908,24328,3395,45466,2892,1449,1443
32515,50380,4908,24331,3395,45472,2893,1449,1444
32520,50391,4909,24336,3396,45481,2894,1449,1445
32525,50395,4911,24339,3398,45484,2894,1449,1445
32530,50405,4911,24342,3398,45494,2894,1449,1445
32535,50411,4911,24346,3398,45500,2895,1450,1445
32540,50422,4914,24352,3401,45508,2896,1451,1445
32545,50426,4914,24354,3401,45512,2896,1451,1445
32550,50436,4914,24360,3401,45522,2896,1451,1445
32555,50442,4914,24363,3401,45528,2897,1451,1446
32560,50453,4916,24369,3402,45537,2898,1452,1446
32565,50457,4916,24371,3402,45541,2898,1452,1446
32570,50467,4916,24376,3402,45551,2898,1452,1446
32575,50473,4916,24380,3402,45557,2900,1454,1446
32580,50484,4917,24384,3402,45567,2901,1455,1446
32585,50488,4918,24386,3403,45570,2901,1455,1446
32590,50498,4918,24390,3403,45580,2901,1455,1446
32595,50504,4918,24394,3403,45586,2902,1456,1446
32600,50515,4919,24397,3404,45596,2902,1456,1446
32605,50519,4919,24397,3404,45600,2902,1456,1446
32610,50529,4919,24402,3404,45610,2902,1456,1446
32615,50535,4919,24403,3404,45616,2903,1456,1447
32620,50546,4920,24408,3404,45626,2903,1456,1447
32625,50550,4920,24410,3404,45630,2903,1456,1447
32630,50560,4921,24413,3404,45639,2903,1456,1447
32635,50566,4921,24416,3404,45645,2904,1457,1447
32640,50577,4923,24419,3406,45654,2904,1457,1447
32645,50581,4923,24421,3406,45658,2904,1457,1447
32650,50591,4925,24425,3406,45666,2904,1457,1447
32655,50597,4925,24429,3406,45672,2905,1458,1447
32660,50608,4928,24436,3408,45680,2906,1459,1447
32665,50612,4928,24440,3408,45684,2906,1459,1447
32670,50622,4930,24445,3410,45692,2906,1459,1447
32675,50628,4930,24447,3410,45698,2907,1459,1448
32680,50639,4931,24450,3410,45708,2908,1460,1448
32685,50643,4931,24452,3410,45712,2908,1460,1448
32690,50653,4933,24457,3412,45720,2908,1460,1448
32695,50659,4933,24459,3412,45726,2910,1460,1450
32700,50670,4936,24466,3415,45734,2911,1461,1450
32705,50674,4937,24468,3416,45737,2911,1461,1450
32710,50684,4939,24474,3417,45745,2911,1461,1450
32715,50690,4939,24477,3417,45751,2912,1462,1450
32720,50701,4940,24481,3417,45761,2913,1462,1451
32725,50705,4942,24483,3419,45763,2913,1462,1451
32730,50715,4944,24489,3420,45771,2913,1462,1451
32735,50721,4944,24494,3420,45777,2914,1463,1451
32740,50732,4945,24501,3420,45787,2915,1464,1451
32745,50736,4946,24503,3421,45790,2915,1464,1451
32750,50746,4948,24509,3421,45798,2915,1464,1451
32755,50752,4948,24511,3421,45804,2916,1465,1451
32760,50763,4949,24514,3422,45814,2917,1465,1452
32765,50767,4949,24515,3422,45818,2917,1465,1452
32770,50777,4950,24519,3422,45827,2917,1465,1452
32775,50783,4950,24521,3422,45833,2918,1465,1453
32780,50794,4951,24526,3423,45843,2919,1466,1453
32785,50798,4952,24528,3424,45846,2919,1466,1453
32790,50808,4953,24535,3425,45855,2919,1466,1453
32795,50814,4953,24540,3425,45861,2920,1467,1453
32800,50825,4956,24546,3427,45869,2921,1468,1453
32805,50829,4956,24549,3427,45873,2921,1468,1453
32810,50839,4957,24553,3427,45882,2921,1468,1453
32815,50845,4957,24557,3427,45887,2923,1469,1454
32820,50856,4960,24562,3429,45896,2924,1470,1454
32825,50860,4960,24565,3429,45900,2924,1470,1454
32830,50870,4961,24569,3430,45909,2924,1470,1454
32835,50876,4961,24573,3430,45915,2925,1471,1454
32840,50887,4962,24579,3431,45924,2925,1471,1454
32845,50891,4963,24581,3432,45928,2925,1471,1454
32850,50901,4964,24585,3432,45937,2925,1471,1454
32855,50907,4964,24587,3432,45943,2926,1471,1455
32860,50918,4964,24590,3432,45954,2926,1471,1455
32865,50922,4964,24590,3432,45958,2926,1471,1455
32870,50932,4965,24597,3433,45967,2926,1471,1455
32875,50938,4965,24598,3433,45973,2927,1471,1456
32880,50949,4967,24602,3435,45982,2927,1471,1456
32885,50953,4967,24604,3435,45986,2927,1471,1456
32890,50963,4967,24608,3435,45996,2927,1471,1456
32895,50969,4967,24613,3435,46002,2928,1472,1456
32900,50980,4967,24618,3435,46013,2928,1472,1456
32905,50984,4967,24621,3435,46017,2928,1472,1456
32910,50994,4967,24625,3435,46027,2928,1472,1456
32915,51000,4967,24630,3435,46033,2929,1472,1457
32920,51011,4967,24633,3435,46044,2929,1472,1457
32925,51015,4967,24634,3435,46048,2929,1472,1457
32930,51025,4968,24640,3436,46057,2929,1472,1457
32935,51031,4968,24641,3436,46063,2931,1473,1458
32940,51042,4969,24646,3436,46073,2932,1474,1458
32945,51046,4970,24649,3437,46076,2932,1474,1458
32950,51056,4971,24655,3438,46085,2932,1474,1458
32955,51062,4971,24658,3438,46091,2934,1475,1459
32960,51073,4974,24664,3441,46099,2935,1475,1460
32965,51077,4975,24666,3442,46102,2935,1475,1460
32970,51087,4976,24673,3443,46111,2935,1475,1460
32975,51093,4976,24675,3443,46117,2936,1475,1461
32980,51104,4979,24680,3445,46125,2937,1475,1462
32985,51108,4980,24682,3446,46128,2937,1475,1462
32990,51118,4981,24687,3447,46137,2937,1475,1462
32995,51124,4981,24689,3447,46142,2938,1475,1463
33000,51135,4983,24692,3448,46152,2939,1475,1464
33005,51139,4983,24692,3448,46156,2939,1475,1464
33010,51149,4983,24699,3448,46166,2939,1475,1464
33015,51155,4983,24702,3448,46172,2940,1476,1464
33020,51166,4984,24709,3448,46182,2941,1476,1465
33025,51170,4985,24713,3449,46185,2941,1476,1465
33030,51180,4985,24717,3449,46195,2941,1476,1465
33035,51186,4985,24719,3449,46201,2942,1477,1465
33040,51197,4987,24725,3451,46210,2943,1477,1466
33045,51201,4987,24726,3451,46214,2943,1477,1466
33050,51211,4988,24733,3452,46223,2943,1477,1466
33055,51217,4988,24736,3452,46228,2944,1477,1467
33060,51228,4991,24740,3455,46236,2945,1477,1468
33065,51232,4992,24741,3456,46240,2945,1477,1468
33070,51242,4993,24746,3456,46249,2945,1477,1468
33075,51248,4993,24749,3456,46255,2946,1478,1468
33080,51259,4994,24752,3456,46265,2946,1478,1468
33085,51263,4994,24756,3456,46269,2946,1478,1468
33090,51273,4995,24760,3457,46278,2946,1478,1468
33095,51279,4995,24765,3457,46284,2947,1479,1468
33100,51290,4997,24770,3458,46293,2947,1479,1468
33105,51294,4997,24771,3458,46297,2947,1479,1468
33110,51304,4998,24778,3459,46306,2947,1479,1468
33115,51310,4998,24781,3459,46312,2948,1480,1468
33120,51321,5000,24787,3461,46321,2948,1480,1468
33125,51325,5000,24790,3461,46325,2948,1480,1468
33130,51335,5001,24794,3461,46334,2948,1480,1468
33135,51341,5001,24798,3461,46340,2949,1480,1469
33140,51352,5002,24800,3462,46350,2949,1480,1469
33145,51356,5002,24803,3462,46354,2949,1480,1469
33150,51366,5003,24809,3462,46363,2949,1480,1469
33155,51372,5003,24810,3462,46369,2950,1480,1470
33160,51383,5004,24815,3462,46379,2950,1480,1470
33165,51387,5004,24816,3462,46383,2950,1480,1470
33170,51397,5006,24821,3464,46391,2950,1480,1470
33175,51403,5006,24822,3464,46397,2951,1481,1470
33180,51414,5008,24827,3466,46406,2952,1481,1471
33185,51418,5009,24829,3467,46409,2952,1481,1471
33190,51428,5010,24837,3467,46418,2952,1481,1471
33195,51434,5010,24841,3467,46424,2953,1482,1471
33200,51445,5012,24847,3469,46433,2953,1482,1471
33205,51449,5012,24848,3469,46437,2953,1482,1471
33210,51459,5013,24852,3470,46446,2953,1482,1471
33215,51465,5013,24854,3470,46452,2954,1482,1472
33220,51476,5014,24858,3471,46462,2954,1482,1472
33225,51480,5014,24860,3471,46466,2954,1482,1472
33230,51490,5015,24866,3472,46475,2954,1482,1472
33235,51496,5015,24867,3472,46481,2955,1482,1473
33240,51507,5017,24872,3474,46490,2955,1482,1473
33245,51511,5017,24873,3474,46494,2955,1482,1473
33250,51521,5017,24876,3474,46504,2955,1482,1473
33255,51527,5017,24877,3474,46510,2956,1483,1473
33260,51538,5017,24883,3474,46521,2956,1483,1473
33265,51542,5017,24886,3474,46525,2956,1483,1473
33270,51552,5017,24888,3474,46535,2956,1483,1473
33275,51558,5017,24892,3474,46541,2957,1484,1473
33280,51569,5017,24898,3474,46552,2957,1484,1473
33285,51573,5017,24900,3474,46556,2957,1484,1473
33290,51583,5018,24903,3474,46565,2957,1484,1473
33295,51589,5018,24907,3474,46571,2958,1484,1474
33300,51600,5019,24914,3475,46581,2959,1484,1475
33305,51604,5019,24916,3475,46585,2959,1484,1475
33310,51614,5020,24919,3475,46594,2959,1484,1475
33315,51620,5020,24921,3475,46599,2960,1485,1475
33320,51631,5023,24925,3477,46608,2960,1485,1475
33325,51635,5023,24926,3477,46612,2960,1485,1475
33330,51645,5024,24931,3477,46621,2960,1485,1475
33335,51651,5024,24934,3477,46626,2961,1485,1476
33340,51662,5027,24940,3480,46635,2961,1485,1476
33345,51666,5027,24941,3480,46639,2961,1485,1476
33350,51676,5029,24945,3480,46647,2961,1485,1476
33355,51682,5029,24948,3480,46653,2962,1486,1476
33360,51693,5032,24953,3482,46661,2962,1486,1476
33365,51697,5032,24956,3482,46665,2962,1486,1476
33370,51707,5033,24959,3483,46674,2962,1486,1476
33375,51713,5033,24961,3483,46680,2963,1486,1477
33380,51724,5035,24966,3484,46689,2963,1486,1477
33385,51728,5035,24969,3484,46693,2963,1486,1477
33390,51738,5036,24974,3485,46702,2963,1486,1477
33395,51744,5036,24977,3485,46708,2964,1487,1477
33400,51755,5038,24982,3487,46717,2964,1487,1477
33405,51759,5038,24984,3487,46721,2964,1487,1477
33410,51769,5039,24992,3488,46730,2964,1487,1477
33415,51775,5039,24995,3488,46735,2965,1488,1477
33420,51786,5042,25000,3490,46744,2966,1488,1478
33425,51790,5043,25002,3491,46747,2966,1488,1478
33430,51800,5045,25008,3493,46755,2966,1488,1478
33435,51806,5045,25009,3493,46760,2967,1488,1479
33440,51817,5048,25014,3496,46769,2968,1488,1480
33445,51821,5049,25016,3497,46772,2968,1488,1480
33450,51831,5051,25023,3498,46780,2968,1488,1480
33455,51837,5051,25028,3498,46786,2969,1489,1480
33460,51848,5054,25036,3500,46794,2970,1490,1480
33465,51852,5055,25038,3501,46797,2970,1490,1480
33470,51862,5057,25043,3502,46805,2970,1490,1480
33475,51868,5057,25045,3502,46811,2971,1490,1481
33480,51879,5059,25048,3503,46820,2972,1490,1482
33485,51883,5060,25050,3504,46823,2972,1490,1482
33490,51893,5060,25053,3504,46833,2972,1490,1482
33495,51899,5060,25057,3504,46839,2973,1491,1482
33500,51910,5062,25061,3505,46848,2973,1491,1482
33505,51914,5063,25064,3506,46851,2973,1491,1482
33510,51924,5063,25068,3506,46861,2973,1491,1482
33515,51930,5063,25072,3506,46867,2974,1491,1483
33520,51941,5065,25075,3507,46876,2974,1491,1483
33525,51945,5065,25077,3507,46880,2974,1491,1483
33530,51955,5065,25083,3507,46890,2974,1491,1483
33535,51961,5065,25085,3507,46896,2975,1492,1483
33540,51972,5066,25092,3508,46906,2975,1492,1483
33545,51976,5066,25094,3508,46910,2975,1492,1483
33550,51986,5066,25099,3508,46920,2975,1492,1483
33555,51992,5066,25101,3508,46926,2976,1492,1484
33560,52003,5067,25105,3509,46936,2976,1492,1484
33565,52007,5067,25106,3509,46940,2976,1492,1484
33570,52017,5067,25112,3509,46950,2976,1492,1484
33575,52023,5067,25116,3509,46956,2977,1492,1485
33580,52034,5069,25120,3510,46965,2977,1492,1485
33585,52038,5069,25122,3510,46969,2977,1492,1485
33590,52048,5071,25129,3512,46977,2977,1492,1485
33595,52054,5071,25133,3512,46983,2978,1493,1485
33600,52065,5072,25138,3513,46993,2979,1494,1485
33605,52069,5073,25140,3514,46996,2979,1494,1485
33610,52079,5074,25148,3515,47005,2979,1494,1485
33615,52085,5074,25151,3515,47011,2981,1496,1485
33620,52096,5075,25154,3516,47021,2982,1497,1485
33625,52100,5075,25155,3516,47025,2982,1497,1485
33630,52110,5076,25158,3516,47034,2982,1497,1485
33635,52116,5076,25159,3516,47040,2983,1497,1486
33640,52127,5077,25162,3517,47050,2983,1497,1486
33645,52131,5077,25163,3517,47054,2983,1497,1486
33650,52141,5078,25167,3518,47063,2983,1497,1486
33655,52147,5078,25170,3518,47069,2984,1498,1486
33660,52158,5080,25176,3520,47078,2984,1498,1486
33665,52162,5080,25177,3520,47082,2984,1498,1486
33670,52172,5080,25182,3520,47092,2984,1498,1486
33675,52178,5080,25185,3520,47098,2985,1498,1487
33680,52189,5080,25190,3520,47109,2985,1498,1487
33685,52193,5080,25192,3520,47113,2985,1498,1487
33690,52203,5080,25196,3520,47123,2985,1498,1487
33695,52209,5080,25198,3520,47129,2986,1499,1487
33700,52220,5080,25204,3520,47140,2986,1499,1487
33705,52224,5080,25208,3520,47144,2986,1499,1487
33710,52234,5081,25216,3520,47153,2986,1499,1487
33715,52240,5081,25218,3520,47159,2987,1499,1488
33720,52251,5082,25221,3521,47169,2987,1499,1488
33725,52255,5082,25224,3521,47173,2987,1499,1488
33730,52265,5084,25231,3521,47181,2987,1499,1488
33735,52271,5084,25232,3521,47187,2988,1499,1489
33740,52282,5085,25241,3522,47197,2988,1499,1489
33745,52286,5086,25243,3523,47200,2988,1499,1489
33750,52296,5088,25250,3523,47208,2988,1499,1489
33755,52302,5088,25255,3523,47214,2989,1499,1490
33760,52313,5090,25261,3525,47223,2990,1500,1490
33765,52317,5090,25262,3525,47227,2990,1500,1490
33770,52327,5092,25266,3526,47235,2990,1500,1490
33775,52333,5092,25269,3526,47240,2991,1501,1490
33780,52344,5094,25272,3527,47250,2992,1501,1491
33785,52348,5096,25274,3529,47252,2992,1501,1491
33790,52358,5098,25280,3529,47260,2992,1501,1491
33795,52364,5098,25281,3529,47266,2994,1501,1493
33800,52375,5101,25286,3531,47274,2995,1502,1493
33805,52379,5103,25288,3533,47276,2995,1502,1493
33810,52389,5105,25293,3534,47284,2995,1502,1493
33815,52395,5105,25296,3534,47290,2996,1502,1494
33820,52406,5107,25301,3535,47299,2996,1502,1494
33825,52410,5107,25303,3535,47303,2996,1502,1494
33830,52420,5109,25307,3535,47311,2996,1502,1494
33835,52426,5109,25309,3535,47317,2997,1503,1494
33840,52437,5111,25314,3537,47326,2998,1504,1494
33845,52441,5111,25314,3537,47330,2998,1504,1494
33850,52451,5112,25318,3537,47339,2998,1504,1494
33855,52457,5112,25321,3537,47344,2999,1504,1495
33860,52468,5114,25327,3539,47354,3000,1504,1496
33865,52472,5114,25328,3539,47358,3000,1504,1496
33870,52482,5115,25334,3540,47367,3000,1504,1496
33875,52488,5115,25336,3540,47373,3001,1504,1497
33880,52499,5117,25343,3542,47382,3002,1504,1498
33885,52503,5117,25344,3542,47386,3002,1504,1498
33890,52513,5118,25347,3543,47395,3002,1504,1498
33895,52519,5118,25350,3543,47401,3003,1504,1499
33900,52530,5119,25357,3543,47411,3004,1504,1500
33905,52534,5119,25358,3543,47415,3004,1504,1500
33910,52544,5119,25359,3543,47425,3004,1504,1500
33915,52550,5119,25361,3543,47431,3005,1505,1500
33920,52561,5120,25366,3543,47441,3005,1505,1500
33925,52565,5120,25367,3543,47445,3005,1505,1500
33930,52575,5120,25373,3543,47455,3005,1505,1500
33935,52581,5120,25373,3543,47461,3006,1505,1501
33940,52592,5121,25379,3544,47471,3006,1505,1501
33945,52596,5121,25381,3544,47475,3006,1505,1501
33950,52606,5122,25387,3545,47484,3006,1505,1501
33955,52612,5122,25390,3545,47490,3007,1506,1501
33960,52623,5125,25395,3548,47498,3007,1506,1501
33965,52627,5126,25397,3549,47501,3007,1506,1501
33970,52637,5128,25403,3550,47509,3007,1506,1501
33975,52643,5128,25403,3550,47515,3008,1506,1502
33980,52654,5129,25406,3550,47525,3009,1506,1503
33985,52658,5129,25406,3550,47529,3009,1506,1503
33990,52668,5131,25412,3550,47537,3009,1506,1503
33995,52674,5131,25415,3550,47543,3010,1506,1504
34000,52685,5134,25420,3553,47550,3011,1506,1505
34005,52689,5136,25421,3555,47553,3011,1506,1505
34010,52699,5138,25426,3557,47561,3011,1506,1505
34015,52705,5138,25427,3557,47567,3013,1507,1506
34020,52716,5140,25431,3558,47576,3014,1508,1506
34025,52720,5140,25431,3558,47580,3014,1508,1506
34030,52730,5142,25435,3559,47588,3014,1508,1506
34035,52736,5142,25437,3559,47594,3015,1509,1506
34040,52747,5144,25444,3560,47603,3016,1509,1507
34045,52751,5145,25446,3561,47606,3016,1509,1507
34050,52761,5147,25453,3563,47614,3016,1509,1507
34055,52767,5147,25456,3563,47620,3017,1510,1507
34060,52778,5149,25461,3564,47629,3018,1511,1507
34065,52782,5149,25463,3564,47633,3018,1511,1507
34070,52792,5151,25467,3565,47641,3018,1511,1507
34075,52798,5151,25472,3565,47646,3019,1512,1507
34080,52809,5154,25477,3568,47654,3020,1512,1508
34085,52813,5156,25480,3570,47657,3020,1512,1508
34090,52823,5157,25483,3570,47666,3020,1512,1508
34095,52829,5157,25485,3570,47672,3021,1512,1509
34100,52840,5157,25492,3570,47683,3021,1512,1509
34105,52844,5157,25495,3570,47687,3021,1512,1509
34110,52854,5157,25499,3570,47697,3021,1512,1509
34115,52860,5157,25502,3570,47703,3022,1513,1509
34120,52871,5157,25507,3570,47714,3022,1513,1509
34125,52875,5157,25509,3570,47718,3022,1513,1509
34130,52885,5157,25515,3570,47728,3022,1513,1509
34135,52891,5157,25519,3570,47734,3024,1514,1510
34140,52902,5157,25525,3570,47745,3024,1514,1510
34145,52906,5157,25529,3570,47749,3024,1514,1510
34150,52916,5157,25531,3570,47759,3024,1514,1510
34155,52922,5157,25535,3570,47765,3025,1514,1511
34160,52933,5157,25538,3570,47776,3025,1514,1511
34165,52937,5157,25539,3570,47780,3025,1514,1511
34170,52947,5157,25545,3570,47790,3025,1514,1511
34175,52953,5157,25548,3570,47796,3026,1514,1512
34180,52964,5157,25553,3570,47807,3026,1514,1512
34185,52968,5157,25553,3570,47811,3026,1514,1512
34190,52978,5157,25557,3570,47821,3026,1514,1512
34195,52984,5157,25560,3570,47827,3027,1515,1512
34200,52995,5158,25566,3571,47836,3027,1515,1512
34205,52999,5159,25568,3572,47840,3027,1515,1512
34210,53009,5160,25575,3573,47849,3027,1515,1512
34215,53015,5160,25576,3573,47855,3028,1515,1513
34220,53026,5162,25583,3575,47864,3029,1515,1514
34225,53030,5163,25586,3576,47867,3029,1515,1514
34230,53040,5164,25593,3576,47876,3029,1515,1514
34235,53046,5164,25597,3576,47882,3030,1516,1514
34240,53057,5166,25603,3578,47891,3031,1516,1515
34245,53061,5166,25605,3578,47895,3031,1516,1515
34250,53071,5168,25609,3579,47903,3031,1516,1515
34255,53077,5168,25611,3579,47909,3032,1517,1515
34260,53088,5170,25616,3581,47918,3033,1517,1516
34265,53092,5171,25619,3582,47921,3033,1517,1516
34270,53102,5173,25623,3582,47929,3033,1517,1516
34275,53108,5173,25628,3582,47935,3034,1518,1516
34280,53119,5174,25632,3583,47945,3034,1518,1516
34285,53123,5175,25634,3584,47948,3034,1518,1516
34290,53133,5177,25638,3586,47956,3034,1518,1516
34295,53139,5177,25640,3586,47962,3035,1518,1517
34300,53150,5178,25644,3586,47972,3035,1518,1517
34305,53154,5178,25644,3586,47976,3035,1518,1517
34310,53164,5180,25650,3587,47984,3035,1518,1517
34315,53170,5180,25652,3587,47990,3036,1518,1518
34320,53181,5182,25657,3589,47999,3037,1518,1519
34325,53185,5182,25658,3589,48003,3037,1518,1519
34330,53195,5184,25660,3589,48011,3037,1518,1519
34335,53201,5184,25665,3589,48017,3038,1519,1519
34340,53212,5184,25671,3589,48028,3039,1520,1519
34345,53216,5184,25675,3589,48032,3039,1520,1519
34350,53226,5186,25681,3590,48040,3039,1520,1519
34355,53232,5186,25684,3590,48046,3040,1521,1519
34360,53243,5188,25690,3592,48055,3041,1521,1520
34365,53247,5188,25692,3592,48059,3041,1521,1520
34370,53257,5190,25698,3593,48067,3041,1521,1520
34375,53263,5190,25700,3593,48073,3043,1521,1522
34380,53274,5191,25706,3594,48083,3044,1522,1522
34385,53278,5191,25708,3594,48087,3044,1522,1522
34390,53288,5192,25711,3595,48096,3044,1522,1522
34395,53294,5192,25713,3595,48102,3045,1522,1523
34400,53305,5193,25718,3596,48112,3045,1522,1523
34405,53309,5193,25722,3596,48116,3045,1522,1523
34410,53319,5194,25726,3596,48125,3045,1522,1523
34415,53325,5194,25730,3596,48131,3046,1523,1523
34420,53336,5195,25737,3597,48141,3046,1523,1523
34425,53340,5195,25739,3597,48145,3046,1523,1523
34430,53350,5196,25746,3597,48154,3046,1523,1523
34435,53356,5196,25748,3597,48160,3047,1524,1523
34440,53367,5199,25753,3599,48168,3047,1524,1523
34445,53371,5199,25756,3599,48172,3047,1524,1523
34450,53381,5199,25759,3599,48182,3047,1524,1523
34455,53387,5199,25761,3599,48188,3048,1524,1524
34460,53398,5200,25763,3599,48198,3048,1524,1524
34465,53402,5201,25766,3600,48201,3048,1524,1524
34470,53412,5201,25770,3600,48211,3048,1524,1524
34475,53418,5201,25772,3600,48217,3049,1524,1525
34480,53429,5202,25774,3600,48227,3049,1524,1525
34485,53433,5202,25774,3600,48231,3049,1524,1525
34490,53443,5203,25781,3601,48240,3049,1524,1525
34495,53449,5203,25785,3601,48246,3051,1525,1526
34500,53460,5204,25790,3601,48256,3052,1526,1526
34505,53464,5204,25791,3601,48260,3052,1526,1526
34510,53474,5205,25796,3602,48269,3052,1526,1526
34515,53480,5205,25800,3602,48274,3054,1527,1527
34520,53491,5207,25808,3603,48284,3054,1527,1527
34525,53495,5207,25810,3603,48288,3054,1527,1527
34530,53505,5208,25816,3604,48297,3054,1527,1527
34535,53511,5208,25820,3604,48302,3056,1528,1528
34540,53522,5210,25825,3606,48312,3056,1528,1528
34545,53526,5210,25827,3606,48316,3056,1528,1528
34550,53536,5211,25831,3606,48325,3056,1528,1528
34555,53542,5211,25833,3606,48331,3058,1529,1529
34560,53553,5213,25840,3608,48340,3058,1529,1529
34565,53557,5213,25842,3608,48344,3058,1529,1529
34570,53567,5215,25849,3610,48352,3058,1529,1529
34575,53573,5215,25852,3610,48358,3060,1530,1530
34580,53584,5218,25857,3612,48366,3060,1530,1530
34585,53588,5218,25858,3612,48370,3060,1530,1530
34590,53598,5220,25860,3613,48378,3060,1530,1530
34595,53604,5220,25861,3613,48384,3062,1531,1531
34600,53615,5223,25868,3616,48391,3062,1531,1531
34605,53619,5225,25869,3618,48394,3062,1531,1531
34610,53629,5227,25871,3619,48402,3062,1531,1531
34615,53635,5227,25872,3619,48408,3063,1531,1532
34620,53646,5232,25882,3624,48414,3064,1532,1532
34625,53650,5232,25886,3624,48418,3064,1532,1532
34630,53660,5232,25890,3624,48428,3064,1532,1532
34635,53666,5232,25893,3624,48434,3065,1532,1533
34640,53677,5232,25899,3624,48445,3066,1533,1533
34645,53681,5232,25901,3624,48449,3066,1533,1533
34650,53691,5232,25907,3624,48459,3066,1533,1533
34655,53697,5232,25912,3624,48465,3067,1534,1533
34660,53708,5232,25916,3624,48476,3067,1534,1533
34665,53712,5232,25918,3624,48480,3067,1534,1533
34670,53722,5232,25925,3624,48490,3067,1534,1533
34675,53728,5232,25929,3624,48496,3068,1534,1534
34680,53739,5232,25936,3624,48507,3068,1534,1534
34685,53743,5232,25939,3624,48511,3068,1534,1534
34690,53753,5232,25945,3624,48521,3068,1534,1534
34695,53759,5232,25948,3624,48527,3069,1534,1535
34700,53770,5232,25953,3624,48538,3069,1534,1535
34705,53774,5232,25956,3624,48542,3069,1534,1535
34710,53784,5232,25963,3624,48552,3069,1534,1535
34715,53790,5232,25964,3624,48558,3071,1535,1536
34720,53801,5232,25969,3624,48569,3071,1535,1536
34725,53805,5232,25972,3624,48573,3071,1535,1536
34730,53815,5234,25978,3625,48581,3071,1535,1536
34735,53821,5234,25980,3625,48586,3073,1535,1538
34740,53832,5238,25984,3628,48594,3073,1535,1538
34745,53836,5238,25984,3628,48598,3073,1535,1538
34750,53846,5240,25990,3629,48606,3073,1535,1538
34755,53852,5240,25991,3629,48612,3075,1535,1540
34760,53863,5243,25999,3631,48619,3076,1535,1541
34765,53867,5244,26001,3632,48623,3076,1535,1541
34770,53877,5246,26005,3633,48631,3076,1535,1541
34775,53883,5246,26008,3633,48637,3078,1536,1542
34780,53894,5249,26014,3636,48645,3079,1536,1543
34785,53898,5250,26015,3637,48648,3079,1536,1543
34790,53908,5252,26018,3637,48656,3079,1536,1543
34795,53914,5252,26020,3637,48662,3081,1537,1544
34800,53925,5254,26025,3638,48671,3082,1538,1544
34805,53929,5254,26025,3638,48675,3082,1538,1544
34810,53939,5255,26030,3639,48684,3082,1538,1544
34815,53945,5255,26032,3639,48690,3083,1538,1545
34820,53956,5257,26037,3640,48699,3084,1538,1546
34825,53960,5257,26040,3640,48703,3084,1538,1546
34830,53970,5258,26042,3641,48712,3084,1538,1546
34835,53976,5258,26042,3641,48718,3085,1538,1547
34840,53987,5260,26047,3643,48727,3086,1539,1547
34845,53991,5260,26049,3643,48731,3086,1539,1547
34850,54001,5261,26054,3643,48740,3086,1539,1547
34855,54007,5261,26056,3643,48746,3087,1540,1547
34860,54018,5263,26062,3644,48755,3088,1541,1547
34865,54022,5263,26064,3644,48759,3088,1541,1547
34870,54032,5264,26066,3644,48768,3088,1541,1547
34875,54038,5264,26069,3644,48773,3089,1542,1547
34880,54049,5267,26074,3646,48781,3089,1542,1547
34885,54053,5268,26077,3647,48785,3089,1542,1547
34890,54063,5269,26083,3647,48794,3089,1542,1547
34895,54069,5269,26085,3647,48800,3090,1542,1548
34900,54080,5271,26092,3649,48809,3090,1542,1548
34905,54084,5272,26094,3650,48812,3090,1542,1548
34910,54094,5273,26100,3651,48821,3090,1542,1548
34915,54100,5273,26103,3651,48826,3092,1543,1549
34920,54111,5276,26107,3653,48835,3093,1543,1550
34925,54115,5276,26110,3653,48839,3093,1543,1550
34930,54125,5276,26117,3653,48849,3093,1543,1550
34935,54131,5276,26117,3653,48855,3094,1543,1551
34940,54142,5277,26122,3654,48865,3094,1543,1551
34945,54146,5277,26124,3654,48869,3094,1543,1551
34950,54156,5277,26129,3654,48879,3094,1543,1551
34955,54162,5277,26133,3654,48885,3095,1544,1551
34960,54173,5279,26139,3656,48894,3095,1544,1551
34965,54177,5279,26141,3656,48898,3095,1544,1551
34970,54187,5280,26143,3656,48907,3095,1544,1551
34975,54193,5280,26146,3656,48912,3096,1544,1552
34980,54204,5285,26152,3661,48919,3097,1545,1552
34985,54208,5285,26154,3661,48923,3097,1545,1552
34990,54218,5286,26160,3661,48932,3097,1545,1552
34995,54224,5286,26164,3661,48938,3098,1546,1552
35000,54235,5287,26167,3662,48948,3099,1546,1553
35005,54239,5287,26168,3662,48952,3099,1546,1553
35010,54249,5288,26173,3663,48961,3099,1546,1553
35015,54255,5288,26175,3663,48967,3100,1546,1554
35020,54266,5288,26181,3663,48978,3101,1546,1555
35025,54270,5288,26182,3663,48982,3101,1546,1555
35030,54280,5290,26187,3664,48990,3101,1546,1555
35035,54286,5290,26191,3664,48996,3102,1547,1555
35040,54297,5290,26193,3664,49007,3103,1547,1556
35045,54301,5290,26196,3664,49011,3103,1547,1556
35050,54311,5292,26199,3664,49019,3103,1547,1556
35055,54317,5292,26202,3664,49025,3104,1548,1556
35060,54328,5292,26207,3664,49036,3104,1548,1556
35065,54332,5292,26208,3664,49040,3104,1548,1556
35070,54342,5294,26214,3664,49048,3104,1548,1556
35075,54348,5294,26217,3664,49053,3105,1548,1557
35080,54359,5296,26223,3666,49063,3105,1548,1557
35085,54363,5296,26224,3666,49067,3105,1548,1557
35090,54373,5298,26226,3667,49075,3105,1548,1557
35095,54379,5298,26230,3667,49081,3106,1549,1557
35100,54390,5300,26234,3668,49089,3106,1549,1557
35105,54394,5301,26234,3669,49093,3106,1549,1557
35110,54404,5303,26240,3671,49101,3106,1549,1557
35115,54410,5303,26243,3671,49107,3107,1550,1557
35120,54421,5304,26246,3671,49117,3108,1550,1558
35125,54425,5305,26247,3672,49120,3108,1550,1558
35130,54435,5307,26250,3673,49128,3108,1550,1558
35135,54441,5307,26253,3673,49134,3109,1550,1559
35140,54452,5310,26260,3676,49142,3110,1551,1559
35145,54456,5312,26263,3678,49144,3110,1551,1559
35150,54466,5314,26269,3679,49152,3110,1551,1559
35155,54472,5314,26271,3679,49158,3111,1551,1560
35160,54483,5316,26280,3681,49167,3112,1552,1560
35165,54487,5316,26281,3681,49171,3112,1552,1560
35170,54497,5318,26283,3681,49179,3112,1552,1560
35175,54503,5318,26286,3681,49185,3113,1553,1560
35180,54514,5319,26291,3682,49195,3113,1553,1560
35185,54518,5319,26294,3682,49199,3113,1553,1560
35190,54528,5321,26300,3684,49207,3113,1553,1560
35195,54534,5321,26303,3684,49213,3114,1554,1560
35200,54545,5321,26305,3684,49224,3114,1554,1560
35205,54549,5321,26306,3684,49228,3114,1554,1560
35210,54559,5323,26309,3685,49236,3114,1554,1560
35215,54565,5323,26313,3685,49241,3116,1555,1561
35220,54576,5324,26316,3686,49252,3116,1555,1561
35225,54580,5324,26317,3686,49256,3116,1555,1561
35230,54590,5325,26324,3687,49265,3116,1555,1561
35235,54596,5325,26327,3687,49270,3118,1557,1561
35240,54607,5326,26332,3688,49281,3118,1557,1561
35245,54611,5326,26333,3688,49285,3118,1557,1561
35250,54621,5327,26336,3689,49294,3118,1557,1561
35255,54627,5327,26339,3689,49300,3119,1557,1562
35260,54638,5327,26343,3689,49311,3119,1557,1562
35265,54642,5327,26346,3689,49315,3119,1557,1562
35270,54652,5328,26349,3690,49324,3119,1557,1562
35275,54658,5328,26353,3690,49329,3120,1558,1562
35280,54669,5330,26359,3692,49338,3121,1558,1563
35285,54673,5331,26361,3693,49342,3121,1558,1563
35290,54683,5331,26366,3693,49352,3121,1558,1563
35295,54689,5331,26372,3693,49358,3122,1559,1563
35300,54700,5332,26375,3693,49368,3122,1559,1563
35305,54704,5333,26377,3694,49371,3122,1559,1563
35310,54714,5333,26382,3694,49381,3122,1559,1563
35315,54720,5333,26383,3694,49387,3123,1559,1564
35320,54731,5334,26388,3695,49397,3123,1559,1564
35325,54735,5335,26391,3696,49400,3123,1559,1564
35330,54745,5335,26395,3696,49410,3123,1559,1564
35335,54751,5335,26397,3696,49416,3124,1559,1565
35340,54762,5336,26403,3696,49426,3124,1559,1565
35345,54766,5336,26405,3696,49430,3124,1559,1565
35350,54776,5337,26408,3696,49439,3124,1559,1565
35355,54782,5337,26410,3696,49444,3125,1559,1566
35360,54793,5340,26415,3698,49453,3126,1559,1567
35365,54797,5340,26415,3698,49457,3126,1559,1567
35370,54807,5341,26418,3698,49466,3126,1559,1567
35375,54813,5341,26420,3698,49472,3127,1559,1568
35380,54824,5342,26427,3699,49481,3128,1559,1569
35385,54828,5343,26429,3700,49485,3128,1559,1569
35390,54838,5345,26434,3701,49493,3128,1559,1569
35395,54844,5345,26436,3701,49499,3130,1559,1571
35400,54855,5347,26442,3702,49507,3131,1559,1572
35405,54859,5349,26445,3704,49510,3131,1559,1572
35410,54869,5351,26450,3706,49518,3131,1559,1572
35415,54875,5351,26454,3706,49524,3132,1560,1572
35420,54886,5354,26460,3709,49532,3132,1560,1572
35425,54890,5355,26463,3710,49535,3132,1560,1572
35430,54900,5357,26468,3712,49543,3132,1560,1572
35435,54906,5357,26472,3712,49549,3133,1561,1572
35440,54917,5359,26478,3713,49558,3134,1562,1572
35445,54921,5360,26479,3714,49561,3134,1562,1572
35450,54931,5362,26481,3714,49569,3134,1562,1572
35455,54937,5362,26483,3714,49575,3135,1563,1572
35460,54948,5363,26486,3714,49585,3136,1563,1573
35465,54952,5364,26490,3715,49588,3136,1563,1573
35470,54962,5366,26497,3717,49596,3136,1563,1573
35475,54968,5366,26503,3717,49602,3137,1564,1573
35480,54979,5368,26510,3718,49611,3137,1564,1573
35485,54983,5368,26510,3718,49615,3137,1564,1573
35490,54993,5370,26515,3720,49623,3137,1564,1573
35495,54999,5370,26520,3720,49629,3138,1565,1573
35500,55010,5372,26525,3721,49638,3138,1565,1573
35505,55014,5372,26528,3721,49642,3138,1565,1573
35510,55024,5374,26533,3723,49650,3138,1565,1573
35515,55030,5374,26535,3723,49656,3140,1565,1575
35520,55041,5377,26542,3726,49663,3141,1566,1575
35525,55045,5378,26545,3727,49667,3141,1566,1575
35530,55055,5378,26548,3727,49677,3141,1566,1575
35535,55061,5378,26553,3727,49683,3142,1567,1575
35540,55072,5378,26560,3727,49694,3143,1567,1576
35545,55076,5378,26561,3727,49698,3143,1567,1576
35550,55086,5378,26567,3727,49708,3143,1567,1576
35555,55092,5378,26570,3727,49714,3144,1567,1577
35560,55103,5378,26576,3727,49725,3145,1568,1577
35565,55107,5378,26578,3727,49729,3145,1568,1577
35570,55117,5378,26583,3727,49739,3145,1568,1577
35575,55123,5378,26584,3727,49745,3146,1568,1578
35580,55134,5378,26588,3727,49756,3147,1568,1579
35585,55138,5378,26589,3727,49760,3147,1568,1579
35590,55148,5379,26596,3728,49769,3147,1568,1579
35595,55154,5379,26599,3728,49775,3149,1568,1581
35600,55165,5379,26602,3728,49786,3150,1569,1581
35605,55169,5379,26603,3728,49790,3150,1569,1581
35610,55179,5380,26607,3729,49799,3150,1569,1581
35615,55185,5380,26608,3729,49805,3152,1569,1583
35620,55196,5380,26616,3729,49816,3153,1570,1583
35625,55200,5381,26618,3730,49819,3153,1570,1583
35630,55210,5383,26620,3731,49827,3153,1570,1583
35635,55216,5383,26623,3731,49833,3155,1571,1584
35640,55227,5385,26628,3732,49842,3156,1572,1584
35645,55231,5385,26629,3732,49846,3156,1572,1584
35650,55241,5387,26632,3733,49854,3156,1572,1584
35655,55247,5387,26634,3733,49860,3157,1572,1585
35660,55258,5390,26638,3735,49868,3157,1572,1585
35665,55262,5390,26638,3735,49872,3157,1572,1585
35670,55272,5392,26645,3737,49880,3157,1572,1585
35675,55278,5392,26647,3737,49886,3158,1572,1586
35680,55289,5395,26657,3740,49894,3158,1572,1586
35685,55293,5396,26660,3741,49897,3158,1572,1586
35690,55303,5398,26664,3742,49905,3158,1572,1586
35695,55309,5398,26668,3742,49910,3159,1573,1586
35700,55320,5401,26672,3745,49919,3159,1573,1586
35705,55324,5401,26675,3745,49923,3159,1573,1586
35710,55334,5401,26678,3745,49933,3159,1573,1586
35715,55340,5401,26682,3745,49939,3161,1573,1588
35720,55351,5401,26687,3745,49950,3161,1573,1588
35725,55355,5401,26688,3745,49954,3161,1573,1588
35730,55365,5401,26690,3745,49964,3161,1573,1588
35735,55371,5401,26692,3745,49970,3162,1574,1588
35740,55382,5401,26698,3745,49981,3162,1574,1588
35745,55386,5401,26699,3745,49985,3162,1574,1588
35750,55396,5401,26703,3745,49995,3162,1574,1588
35755,55402,5401,26707,3745,50001,3163,1574,1589
35760,55413,5401,26710,3745,50012,3163,1574,1589
35765,55417,5401,26713,3745,50016,3163,1574,1589
35770,55427,5401,26719,3745,50026,3163,1574,1589
35775,55433,5401,26724,3745,50032,3164,1575,1589
35780,55444,5401,26731,3745,50043,3164,1575,1589
35785,55448,5401,26732,3745,50047,3164,1575,1589
35790,55458,5401,26737,3745,50057,3164,1575,1589
35795,55464,5401,26740,3745,50063,3165,1575,1590
35800,55475,5401,26745,3745,50074,3165,1575,1590
35805,55479,5401,26747,3745,50078,3165,1575,1590
35810,55489,5403,26753,3746,50086,3165,1575,1590
35815,55495,5403,26755,3746,50092,3166,1576,1590
35820,55506,5406,26763,3749,50100,3166,1576,1590
35825,55510,5408,26765,3751,50102,3166,1576,1590
35830,55520,5410,26767,3751,50110,3166,1576,1590
35835,55526,5410,26769,3751,50116,3168,1576,1592
35840,55537,5411,26774,3752,50126,3168,1576,1592
35845,55541,5411,26778,3752,50130,3168,1576,1592
35850,55551,5413,26781,3752,50138,3168,1576,1592
35855,55557,5413,26784,3752,50144,3170,1576,1594
35860,55568,5414,26788,3753,50154,3170,1576,1594
35865,55572,5414,26790,3753,50158,3170,1576,1594
35870,55582,5416,26794,3753,50166,3170,1576,1594
35875,55588,5416,26796,3753,50172,3172,1577,1595
35880,55599,5416,26801,3753,50183,3172,1577,1595
35885,55603,5416,26804,3753,50187,3172,1577,1595
35890,55613,5418,26810,3754,50195,3172,1577,1595
35895,55619,5418,26814,3754,50201,3173,1578,1595
35900,55630,5419,26818,3755,50211,3173,1578,1595
35905,55634,5419,26820,3755,50215,3173,1578,1595
35910,55644,5421,26824,3756,50223,3173,1578,1595
35915,55650,5421,26826,3756,50229,3174,1578,1596
35920,55661,5421,26831,3756,50240,3174,1578,1596
35925,55665,5421,26833,3756,50244,3174,1578,1596
35930,55675,5423,26837,3757,50252,3174,1578,1596
35935,55681,5423,26837,3757,50258,3175,1578,1597
35940,55692,5426,26842,3760,50266,3176,1578,1598
35945,55696,5426,26844,3760,50270,3176,1578,1598
35950,55706,5427,26847,3760,50279,3176,1578,1598
35955,55712,5427,26849,3760,50285,3178,1578,1600
35960,55723,5428,26854,3760,50295,3178,1578,1600
35965,55727,5428,26855,3760,50299,3178,1578,1600
35970,55737,5429,26858,3760,50308,3178,1578,1600
35975,55743,5429,26862,3760,50314,3180,1579,1601
35980,55754,5430,26866,3760,50324,3180,1579,1601
35985,55758,5431,26869,3761,50327,3180,1579,1601
35990,55768,5432,26874,3761,50336,3180,1579,1601
35995,55774,5432,26879,3761,50342,3182,1581,1601
36000,55785,5433,26884,3762,50352,3182,1581,1601
36005,55789,5434,26886,3763,50355,3182,1581,1601
36010,55799,5435,26891,3763,50364,3182,1581,1601
36015,55805,5435,26894,3763,50370,3184,1582,1602
36020,55816,5436,26899,3763,50380,3184,1582,1602
36025,55820,5437,26901,3764,50383,3184,1582,1602
36030,55830,5438,26907,3764,50392,3184,1582,1602
36035,55836,5438,26910,3764,50398,3186,1582,1604
36040,55847,5439,26914,3765,50408,3186,1582,1604
36045,55851,5440,26915,3766,50411,3186,1582,1604
36050,55861,5442,26920,3767,50419,3186,1582,1604
36055,55867,5442,26922,3767,50425,3188,1583,1605
36060,55878,5444,26928,3768,50434,3189,1584,1605
36065,55882,5444,26931,3768,50438,3189,1584,1605
36070,55892,5445,26935,3769,50447,3189,1584,1605
36075,55898,5445,26939,3769,50452,3190,1585,1605
36080,55909,5449,26947,3773,50460,3191,1585,1606
36085,55913,5449,26947,3773,50464,3191,1585,1606
36090,55923,5450,26950,3773,50473,3191,1585,1606
36095,55929,5450,26951,3773,50479,3192,1586,1606
36100,55940,5451,26956,3773,50489,3193,1587,1606
36105,55944,5451,26957,3773,50493,3193,1587,1606
36110,55954,5452,26963,3773,50502,3193,1587,1606
36115,55960,5452,26966,3773,50508,3194,1588,1606
36120,55971,5453,26970,3773,50518,3195,1588,1607
36125,55975,5453,26971,3773,50522,3195,1588,1607
36130,55985,5454,26975,3773,50531,3195,1588,1607
36135,55991,5454,26979,3773,50536,3196,1588,1608
36140,56002,5455,26983,3774,50547,3197,1588,1609
36145,56006,5455,26985,3774,50551,3197,1588,1609
36150,56016,5456,26987,3774,50560,3197,1588,1609
36155,56022,5456,26990,3774,50566,3198,1589,1609
36160,56033,5456,26994,3774,50577,3199,1589,1610
36165,56037,5456,26996,3774,50581,3199,1589,1610
36170,56047,5458,26998,3774,50589,3199,1589,1610
36175,56053,5458,27000,3774,50595,3201,1589,1612
36180,56064,5458,27003,3774,50606,3202,1590,1612
36185,56068,5458,27005,3774,50610,3202,1590,1612
36190,56078,5460,27009,3775,50618,3202,1590,1612
36195,56084,5460,27014,3775,50624,3203,1590,1613
36200,56095,5462,27018,3776,50633,3203,1590,1613
36205,56099,5462,27020,3776,50637,3203,1590,1613
36210,56109,5464,27026,3777,50645,3203,1590,1613
36215,56115,5464,27029,3777,50651,3204,1591,1613
36220,56126,5466,27034,3778,50660,3204,1591,1613
36225,56130,5466,27036,3778,50664,3204,1591,1613
36230,56140,5468,27037,3778,50672,3204,1591,1613
36235,56146,5468,27038,3778,50678,3205,1592,1613
36240,56157,5470,27042,3779,50687,3205,1592,1613
36245,56161,5470,27045,3779,50691,3205,1592,1613
36250,56171,5471,27050,3779,50700,3205,1592,1613
36255,56177,5471,27053,3779,50706,3206,1593,1613
36260,56188,5472,27059,3780,50715,3207,1594,1613
36265,56192,5474,27062,3782,50718,3207,1594,1613
36270,56202,5475,27068,3783,50727,3207,1594,1613
36275,56208,5475,27072,3783,50733,3208,1595,1613
36280,56219,5478,27076,3785,50741,3209,1596,1613
36285,56223,5478,27078,3785,50745,3209,1596,1613
36290,56233,5479,27082,3785,50754,3209,1596,1613
36295,56239,5479,27086,3785,50759,3210,1596,1614
36300,56250,5483,27091,3788,50766,3211,1596,1615
36305,56254,5485,27095,3790,50769,3211,1596,1615
36310,56264,5485,27101,3790,50779,3211,1596,1615
36315,56270,5485,27104,3790,50785,3212,1597,1615
36320,56281,5486,27110,3790,50795,3212,1597,1615
36325,56285,5487,27111,3791,50798,3212,1597,1615
36330,56295,5487,27114,3791,50808,3212,1597,1615
36335,56301,5487,27116,3791,50814,3213,1598,1615
36340,56312,5488,27119,3791,50824,3213,1598,1615
36345,56316,5489,27122,3792,50827,3213,1598,1615
36350,56326,5489,27127,3792,50837,3213,1598,1615
36355,56332,5489,27129,3792,50843,3215,1599,1616
36360,56343,5490,27136,3792,50853,3215,1599,1616
36365,56347,5490,27137,3792,50857,3215,1599,1616
36370,56357,5491,27143,3793,50866,3215,1599,1616
36375,56363,5491,27145,3793,50872,3217,1600,1617
36380,56374,5492,27150,3793,50882,3217,1600,1617
36385,56378,5492,27151,3793,50886,3217,1600,1617
36390,56388,5493,27156,3793,50895,3217,1600,1617
36395,56394,5493,27160,3793,50901,3219,1602,1617
36400,56405,5494,27165,3794,50911,3219,1602,1617
36405,56409,5494,27167,3794,50915,3219,1602,1617
36410,56419,5496,27172,3794,50923,3219,1602,1617
36415,56425,5496,27176,3794,50929,3221,1602,1619
36420,56436,5500,27183,3797,50936,3221,1602,1619
36425,56440,5500,27186,3797,50940,3221,1602,1619
36430,56450,5501,27193,3798,50949,3221,1602,1619
36435,56456,5501,27195,3798,50955,3222,1602,1620
36440,56467,5504,27204,3801,50963,3223,1603,1620
36445,56471,5504,27205,3801,50967,3223,1603,1620
36450,56481,5505,27210,3801,50976,3223,1603,1620
36455,56487,5505,27211,3801,50982,3224,1603,1621
36460,56498,5507,27215,3803,50991,3225,1603,1622
36465,56502,5507,27218,3803,50995,3225,1603,1622
36470,56512,5508,27224,3803,51004,3225,1603,1622
36475,56518,5508,27227,3803,51010,3226,1603,1623
36480,56529,5510,27235,3805,51019,3227,1604,1623
36485,56533,5510,27236,3805,51023,3227,1604,1623
36490,56543,5511,27241,3806,51032,3227,1604,1623
36495,56549,5511,27244,3806,51038,3228,1605,1623
36500,56560,5511,27248,3806,51049,3228,1605,1623
36505,56564,5511,27250,3806,51053,3228,1605,1623
36510,56574,5512,27255,3807,51062,3228,1605,1623
36515,56580,5512,27258,3807,51068,3229,1606,1623
36520,56591,5512,27265,3807,51079,3229,1606,1623
36525,56595,5512,27267,3807,51083,3229,1606,1623
36530,56605,5514,27273,3809,51091,3229,1606,1623
36535,56611,5514,27277,3809,51097,3230,1607,1623
36540,56622,5514,27282,3809,51108,3230,1607,1623
36545,56626,5514,27283,3809,51112,3230,1607,1623
36550,56636,5515,27289,3810,51121,3230,1607,1623
36555,56642,5515,27293,3810,51127,3231,1608,1623
36560,56653,5516,27295,3810,51137,3232,1608,1624
36565,56657,5516,27297,3810,51141,3232,1608,1624
36570,56667,5517,27303,3810,51150,3232,1608,1624
36575,56673,5517,27309,3810,51155,3233,1609,1624
36580,56684,5521,27317,3814,51163,3234,1610,1624
36585,56688,5521,27318,3814,51167,3234,1610,1624
36590,56698,5522,27325,3815,51176,3234,1610,1624
36595,56704,5522,27326,3815,51181,3236,1610,1626
36600,56715,5525,27331,3818,51190,3237,1610,1627
36605,56719,5525,27332,3818,51194,3237,1610,1627
36610,56729,5526,27336,3819,51203,3237,1610,1627
36615,56735,5526,27337,3819,51209,3239,1611,1628
36620,56746,5528,27344,3820,51218,3239,1611,1628
36625,56750,5528,27346,3820,51222,3239,1611,1628
36630,56760,5529,27350,3820,51231,3239,1611,1628
36635,56766,5529,27353,3820,51237,3241,1613,1628
36640,56777,5530,27359,3820,51247,3241,1613,1628
36645,56781,5531,27361,3821,51250,3241,1613,1628
36650,56791,5533,27368,3823,51258,3241,1613,1628
36655,56797,5533,27369,3823,51264,3243,1614,1629
36660,56808,5535,27375,3825,51273,3244,1615,1629
36665,56812,5536,27376,3826,51276,3244,1615,1629
36670,56822,5538,27382,3826,51284,3244,1615,1629
36675,56828,5538,27382,3826,51290,3245,1615,1630
36680,56839,5540,27389,3828,51299,3246,1616,1630
36685,56843,5541,27391,3829,51302,3246,1616,1630
36690,56853,5543,27395,3830,51310,3246,1616,1630
36695,56859,5543,27398,3830,51316,3247,1617,1630
36700,56870,5544,27405,3831,51326,3248,1617,1631
36705,56874,5545,27407,3832,51329,3248,1617,1631
36710,56884,5547,27411,3832,51337,3248,1617,1631
36715,56890,5547,27413,3832,51343,3249,1617,1632
36720,56901,5548,27417,3832,51353,3250,1618,1632
36725,56905,5548,27418,3832,51357,3250,1618,1632
36730,56915,5549,27425,3833,51366,3250,1618,1632
36735,56921,5549,27426,3833,51372,3252,1618,1634
36740,56932,5550,27431,3834,51382,3252,1618,1634
36745,56936,5550,27431,3834,51386,3252,1618,1634
36750,56946,5551,27434,3834,51395,3252,1618,1634
36755,56952,5551,27437,3834,51401,3253,1619,1634
36760,56963,5552,27442,3835,51411,3253,1619,1634
36765,56967,5552,27444,3835,51415,3253,1619,1634
36770,56977,5553,27450,3835,51424,3253,1619,1634
36775,56983,5553,27451,3835,51430,3254,1619,1635
36780,56994,5554,27453,3836,51440,3254,1619,1635
36785,56998,5554,27455,3836,51444,3254,1619,1635
36790,57008,5555,27458,3836,51453,3254,1619,1635
36795,57014,5555,27461,3836,51459,3255,1619,1636
36800,57025,5556,27465,3837,51469,3255,1619,1636
36805,57029,5556,27466,3837,51473,3255,1619,1636
36810,57039,5557,27470,3837,51482,3255,1619,1636
36815,57045,5557,27472,3837,51488,3256,1620,1636
36820,57056,5558,27480,3838,51498,3256,1620,1636
36825,57060,5558,27482,3838,51502,3256,1620,1636
36830,57070,5560,27486,3838,51510,3256,1620,1636
36835,57076,5560,27488,3838,51516,3257,1621,1636
36840,57087,5562,27492,3840,51525,3257,1621,1636
36845,57091,5563,27494,3841,51528,3257,1621,1636
36850,57101,5564,27500,3842,51537,3257,1621,1636
36855,57107,5564,27503,3842,51542,3259,1622,1637
36860,57118,5567,27508,3844,51551,3259,1622,1637
36865,57122,5567,27510,3844,51555,3259,1622,1637
36870,57132,5568,27517,3844,51564,3259,1622,1637
36875,57138,5568,27518,3844,51569,3260,1622,1638
36880,57149,5570,27523,3845,51579,3260,1622,1638
36885,57153,5570,27523,3845,51583,3260,1622,1638
36890,57163,5571,27530,3846,51592,3260,1622,1638
36895,57169,5571,27531,3846,51598,3261,1622,1639
36900,57180,5572,27533,3846,51608,3261,1622,1639
36905,57184,5572,27534,3846,51612,3261,1622,1639
36910,57194,5573,27539,3846,51621,3261,1622,1639
36915,57200,5573,27541,3846,51627,3262,1623,1639
36920,57211,5575,27546,3847,51636,3262,1623,1639
36925,57215,5575,27548,3847,51640,3262,1623,1639
36930,57225,5576,27552,3848,51649,3262,1623,1639
36935,57231,5576,27555,3848,51655,3263,1624,1639
36940,57242,5578,27564,3850,51664,3263,1624,1639
36945,57246,5578,27566,3850,51668,3263,1624,1639
36950,57256,5580,27571,3852,51676,3263,1624,1639
36955,57262,5580,27573,3852,51682,3264,1624,1640
36960,57273,5581,27577,3853,51692,3264,1624,1640
36965,57277,5581,27580,3853,51696,3264,1624,1640
36970,57287,5583,27585,3854,51704,3264,1624,1640
36975,57293,5583,27589,3854,51710,3265,1624,1641
36980,57304,5584,27596,3855,51720,3265,1624,1641
36985,57308,5584,27597,3855,51724,3265,1624,1641
36990,57318,5586,27601,3855,51732,3265,1624,1641
36995,57324,5586,27603,3855,51738,3266,1624,1642
37000,57335,5588,27606,3856,51747,3266,1624,1642
37005,57339,5588,27609,3856,51751,3266,1624,1642
37010,57349,5590,27613,3856,51759,3266,1624,1642
37015,57355,5590,27616,3856,51765,3267,1625,1642
37020,57366,5592,27621,3858,51774,3267,1625,1642
37025,57370,5593,27624,3859,51777,3267,1625,1642
37030,57380,5595,27628,3859,51785,3267,1625,1642
37035,57386,5595,27632,3859,51791,3268,1626,1642
37040,57397,5597,27637,3860,51800,3268,1626,1642
37045,57401,5597,27639,3860,51804,3268,1626,1642
37050,57411,5599,27644,3860,51812,3268,1626,1642
37055,57417,5599,27648,3860,51818,3269,1626,1643
37060,57428,5600,27652,3861,51828,3269,1626,1643
37065,57432,5600,27653,3861,51832,3269,1626,1643
37070,57442,5602,27657,3861,51840,3269,1626,1643
37075,57448,5602,27658,3861,51846,3271,1626,1645
37080,57459,5605,27666,3864,51854,3272,1627,1645
37085,57463,5605,27669,3864,51858,3272,1627,1645
37090,57473,5606,27676,3865,51867,3272,1627,1645
37095,57479,5606,27680,3865,51873,3273,1628,1645
37100,57490,5607,27685,3866,51883,3273,1628,1645
37105,57494,5607,27685,3866,51887,3273,1628,1645
37110,57504,5608,27690,3867,51896,3273,1628,1645
37115,57510,5608,27693,3867,51902,3274,1629,1645
37120,57521,5608,27694,3867,51913,3274,1629,1645
37125,57525,5608,27695,3867,51917,3274,1629,1645
37130,57535,5609,27699,3867,51926,3274,1629,1645
37135,57541,5609,27701,3867,51932,3275,1630,1645
37140,57552,5609,27705,3867,51943,3275,1630,1645
37145,57556,5609,27707,3867,51947,3275,1630,1645
37150,57566,5610,27712,3868,51956,3275,1630,1645
37155,57572,5610,27715,3868,51962,3276,1630,1646
37160,57583,5610,27721,3868,51973,3276,1630,1646
37165,57587,5610,27724,3868,51977,3276,1630,1646
37170,57597,5611,27728,3868,51986,3276,1630,1646
37175,57603,5611,27730,3868,51992,3277,1631,1646
37180,57614,5612,27737,3869,52002,3277,1631,1646
37185,57618,5612,27737,3869,52006,3277,1631,1646
37190,57628,5614,27740,3869,52014,3277,1631,1646
37195,57634,5614,27743,3869,52019,3279,1632,1647
37200,57645,5616,27744,3870,52029,3280,1632,1648
37205,57649,5616,27744,3870,52033,3280,1632,1648
37210,57659,5617,27748,3871,52042,3280,1632,1648
37215,57665,5617,27752,3871,52048,3281,1633,1648
37220,57676,5619,27758,3873,52057,3282,1633,1649
37225,57680,5620,27759,3874,52060,3282,1633,1649
37230,57690,5621,27766,3875,52069,3282,1633,1649
37235,57696,5621,27771,3875,52074,3283,1633,1650
37240,57707,5624,27775,3877,52083,3284,1633,1651
37245,57711,5625,27777,3878,52086,3284,1633,1651
37250,57721,5626,27782,3878,52095,3284,1633,1651
37255,57727,5626,27785,3878,52101,3285,1633,1652
37260,57738,5628,27791,3880,52110,3286,1634,1652
37265,57742,5628,27793,3880,52114,3286,1634,1652
37270,57752,5629,27795,3881,52123,3286,1634,1652
37275,57758,5629,27800,3881,52129,3287,1635,1652
37280,57769,5630,27803,3881,52139,3287,1635,1652
37285,57773,5631,27804,3882,52142,3287,1635,1652
37290,57783,5632,27809,3882,52151,3287,1635,1652
37295,57789,5632,27812,3882,52156,3288,1636,1652
37300,57800,5634,27818,3884,52166,3288,1636,1652
37305,57804,5634,27819,3884,52170,3288,1636,1652
37310,57814,5636,27826,3886,52178,3288,1636,1652
37315,57820,5636,27829,3886,52183,3290,1636,1654
37320,57831,5638,27834,3887,52192,3290,1636,1654
37325,57835,5640,27835,3889,52195,3290,1636,1654
37330,57845,5641,27839,3889,52204,3290,1636,1654
37335,57851,5641,27842,3889,52210,3291,1637,1654
37340,57862,5643,27846,3890,52219,3292,1638,1654
37345,57866,5643,27848,3890,52223,3292,1638,1654
37350,57876,5644,27855,3890,52232,3292,1638,1654
37355,57882,5644,27858,3890,52238,3293,1638,1655
37360,57893,5647,27864,3893,52246,3294,1639,1655
37365,57897,5647,27866,3893,52250,3294,1639,1655
37370,57907,5648,27869,3893,52259,3294,1639,1655
37375,57913,5648,27873,3893,52265,3295,1640,1655
37380,57924,5651,27877,3895,52273,3296,1641,1655
37385,57928,5651,27878,3895,52277,3296,1641,1655
37390,57938,5652,27884,3896,52286,3296,1641,1655
37395,57944,5652,27887,3896,52292,3297,1642,1655
37400,57955,5653,27891,3896,52302,3297,1642,1655
37405,57959,5653,27891,3896,52306,3297,1642,1655
37410,57969,5654,27897,3896,52315,3297,1642,1655
37415,57975,5654,27899,3896,52321,3298,1643,1655
37420,57986,5655,27904,3896,52331,3298,1643,1655
37425,57990,5655,27907,3896,52335,3298,1643,1655
37430,58000,5656,27912,3897,52344,3298,1643,1655
37435,58006,5656,27915,3897,52350,3299,1644,1655
37440,58017,5657,27923,3898,52360,3299,1644,1655
37445,58021,5658,27927,3899,52363,3299,1644,1655
37450,58031,5659,27933,3900,52372,3299,1644,1655
37455,58037,5659,27937,3900,52378,3300,1645,1655
37460,58048,5660,27941,3900,52388,3300,1645,1655
37465,58052,5661,27945,3901,52391,3300,1645,1655
37470,58062,5662,27949,3901,52400,3300,1645,1655
37475,58068,5662,27954,3901,52406,3301,1646,1655
37480,58079,5663,27960,3901,52416,3301,1646,1655
37485,58083,5664,27961,3902,52419,3301,1646,1655
37490,58093,5666,27966,3903,52427,3301,1646,1655
37495,58099,5666,27968,3903,52432,3302,1646,1656
37500,58110,5668,27971,3904,52442,3303,1646,1657
37505,58114,5668,27974,3904,52446,3303,1646,1657
37510,58124,5669,27978,3904,52455,3303,1646,1657
37515,58130,5669,27981,3904,52461,3304,1647,1657
37520,58141,5670,27985,3905,52471,3304,1647,1657
37525,58145,5670,27985,3905,52475,3304,1647,1657
37530,58155,5671,27990,3905,52484,3304,1647,1657
37535,58161,5671,27992,3905,52490,3305,1647,1658
37540,58172,5674,27997,3908,52498,3305,1647,1658
37545,58176,5674,27999,3908,52502,3305,1647,1658
37550,58186,5675,28004,3908,52511,3305,1647,1658
37555,58192,5675,28008,3908,52517,3306,1648,1658
37560,58203,5678,28015,3911,52525,3306,1648,1658
37565,58207,5678,28017,3911,52529,3306,1648,1658
37570,58217,5679,28023,3912,52538,3306,1648,1658
37575,58223,5679,28027,3912,52544,3307,1649,1658
37580,58234,5680,28032,3912,52554,3307,1649,1658
37585,58238,5680,28033,3912,52558,3307,1649,1658
37590,58248,5681,28037,3913,52567,3307,1649,1658
37595,58254,5681,28043,3913,52573,3308,1650,1658
37600,58265,5683,28049,3915,52582,3308,1650,1658
37605,58269,5683,28050,3915,52586,3308,1650,1658
37610,58279,5685,28057,3917,52594,3308,1650,1658
37615,58285,5685,28061,3917,52599,3310,1651,1659
37620,58296,5691,28069,3923,52605,3311,1651,1660
37625,58300,5691,28070,3923,52609,3311,1651,1660
37630,58310,5691,28075,3923,52619,3311,1651,1660
37635,58316,5691,28079,3923,52625,3312,1652,1660
37640,58327,5691,28082,3923,52636,3312,1652,1660
37645,58331,5691,28086,3923,52640,3312,1652,1660
37650,58341,5691,28090,3923,52650,3312,1652,1660
37655,58347,5691,28095,3923,52656,3313,1653,1660
37660,58358,5691,28104,3923,52667,3313,1653,1660
37665,58362,5691,28106,3923,52671,3313,1653,1660
37670,58372,5691,28111,3923,52681,3313,1653,1660
37675,58378,5691,28114,3923,52687,3314,1653,1661
37680,58389,5691,28119,3923,52698,3314,1653,1661
37685,58393,5691,28120,3923,52702,3314,1653,1661
37690,58403,5691,28124,3923,52712,3314,1653,1661
37695,58409,5691,28126,3923,52718,3315,1653,1662
37700,58420,5691,28132,3923,52729,3315,1653,1662
37705,58424,5691,28133,3923,52733,3315,1653,1662
37710,58434,5691,28141,3923,52743,3315,1653,1662
37715,58440,5691,28143,3923,52749,3316,1653,1663
37720,58451,5691,28149,3923,52760,3316,1653,1663
37725,58455,5691,28151,3923,52764,3316,1653,1663
37730,58465,5692,28155,3924,52773,3316,1653,1663
37735,58471,5692,28157,3924,52779,3318,1654,1664
37740,58482,5694,28161,3925,52788,3319,1655,1664
37745,58486,5694,28164,3925,52792,3319,1655,1664
37750,58496,5695,28173,3926,52801,3319,1655,1664
37755,58502,5695,28176,3926,52807,3320,1655,1665
37760,58513,5696,28181,3927,52817,3320,1655,1665
37765,58517,5696,28184,3927,52821,3320,1655,1665
37770,58527,5697,28188,3927,52830,3320,1655,1665
37775,58533,5697,28190,3927,52836,3321,1655,1666
37780,58544,5699,28196,3929,52845,3321,1655,1666
37785,58548,5699,28198,3929,52849,3321,1655,1666
37790,58558,5700,28205,3930,52858,3321,1655,1666
37795,58564,5700,28209,3930,52864,3322,1656,1666
37800,58575,5702,28214,3931,52873,3322,1656,1666
37805,58579,5702,28215,3931,52877,3322,1656,1666
37810,58589,5703,28218,3931,52886,3322,1656,1666
37815,58595,5703,28220,3931,52892,3323,1657,1666
37820,58606,5705,28225,3932,52901,3323,1657,1666
37825,58610,5706,28226,3933,52904,3323,1657,1666
37830,58620,5707,28232,3934,52913,3323,1657,1666
37835,58626,5707,28234,3934,52919,3324,1657,1667
37840,58637,5709,28239,3935,52928,3324,1657,1667
37845,58641,5709,28239,3935,52932,3324,1657,1667
37850,58651,5711,28246,3937,52940,3324,1657,1667
37855,58657,5711,28249,3937,52946,3326,1658,1668
37860,58668,5714,28252,3939,52953,3327,1658,1669
37865,58672,5716,28253,3941,52956,3327,1658,1669
37870,58682,5716,28256,3941,52966,3327,1658,1669
37875,58688,5716,28258,3941,52972,3328,1659,1669
37880,58699,5718,28265,3943,52981,3328,1659,1669
37885,58703,5718,28266,3943,52985,3328,1659,1669
37890,58713,5718,28272,3943,52995,3328,1659,1669
37895,58719,5718,28276,3943,53001,3329,1659,1670
37900,58730,5719,28281,3943,53011,3329,1659,1670
37905,58734,5720,28284,3944,53014,3329,1659,1670
37910,58744,5720,28287,3944,53024,3329,1659,1670
37915,58750,5720,28288,3944,53030,3330,1659,1671
37920,58761,5721,28291,3945,53040,3330,1659,1671
37925,58765,5721,28293,3945,53044,3330,1659,1671
37930,58775,5722,28295,3945,53053,3330,1659,1671
37935,58781,5722,28299,3945,53058,3331,1660,1671
37940,58792,5724,28305,3946,53068,3331,1660,1671
37945,58796,5724,28308,3946,53072,3331,1660,1671
37950,58806,5725,28313,3946,53081,3331,1660,1671
37955,58812,5725,28316,3946,53087,3332,1661,1671
37960,58823,5726,28320,3947,53097,3332,1661,1671
37965,58827,5726,28321,3947,53101,3332,1661,1671
37970,58837,5727,28325,3948,53110,3332,1661,1671
37975,58843,5727,28329,3948,53115,3334,1662,1672
37980,58854,5730,28334,3951,53123,3335,1663,1672
37985,58858,5731,28335,3952,53127,3335,1663,1672
37990,58868,5733,28341,3952,53135,3335,1663,1672
37995,58874,5733,28344,3952,53141,3336,1664,1672
38000,58885,5736,28350,3955,53149,3337,1664,1673
38005,58889,5737,28354,3956,53152,3337,1664,1673
38010,58899,5739,28359,3958,53160,3337,1664,1673
38015,58905,5739,28362,3958,53166,3338,1665,1673
38020,58916,5742,28369,3960,53174,3339,1666,1673
38025,58920,5742,28370,3960,53178,3339,1666,1673
38030,58930,5744,28374,3961,53186,3339,1666,1673
38035,58936,5744,28377,3961,53192,3340,1667,1673
38040,58947,5747,28384,3964,53200,3341,1667,1674
38045,58951,5747,28385,3964,53204,3341,1667,1674
38050,58961,5749,28387,3964,53212,3341,1667,1674
38055,58967,5749,28390,3964,53218,3342,1667,1675
38060,58978,5749,28396,3964,53229,3342,1667,1675
38065,58982,5749,28398,3964,53233,3342,1667,1675
38070,58992,5751,28402,3964,53241,3342,1667,1675
38075,58998,5751,28407,3964,53247,3343,1668,1675
38080,59009,5751,28411,3964,53258,3343,1668,1675
38085,59013,5751,28413,3964,53262,3343,1668,1675
38090,59023,5753,28420,3966,53270,3343,1668,1675
38095,59029,5753,28421,3966,53276,3345,1669,1676
38100,59040,5753,28426,3966,53287,3345,1669,1676
38105,59044,5753,28429,3966,53291,3345,1669,1676
38110,59054,5754,28431,3967,53300,3345,1669,1676
38115,59060,5754,28433,3967,53305,3346,1669,1677
38120,59071,5755,28438,3968,53316,3346,1669,1677
38125,59075,5755,28440,3968,53320,3346,1669,1677
38130,59085,5756,28444,3968,53329,3346,1669,1677
38135,59091,5756,28450,3968,53334,3347,1670,1677
38140,59102,5758,28457,3970,53344,3347,1670,1677
38145,59106,5758,28458,3970,53348,3347,1670,1677
38150,59116,5759,28462,3970,53357,3347,1670,1677
38155,59122,5759,28464,3970,53362,3348,1671,1677
38160,59133,5763,28473,3974,53370,3348,1671,1677
38165,59137,5763,28474,3974,53374,3348,1671,1677
38170,59147,5763,28477,3974,53384,3348,1671,1677
38175,59153,5763,28481,3974,53390,3349,1672,1677
38180,59164,5764,28484,3975,53400,3349,1672,1677
38185,59168,5765,28485,3976,53403,3349,1672,1677
38190,59178,5765,28490,3976,53413,3349,1672,1677
38195,59184,5765,28491,3976,53419,3350,1672,1678
38200,59195,5766,28497,3976,53429,3350,1672,1678
38205,59199,5767,28501,3977,53432,3350,1672,1678
38210,59209,5768,28503,3977,53441,3350,1672,1678
38215,59215,5768,28505,3977,53447,3352,1673,1679
38220,59226,5769,28509,3978,53456,3352,1673,1679
38225,59230,5771,28512,3980,53459,3352,1673,1679
38230,59240,5773,28516,3980,53467,3352,1673,1679
38235,59246,5773,28516,3980,53473,3353,1673,1680
38240,59257,5775,28524,3982,53482,3354,1674,1680
38245,59261,5775,28525,3982,53486,3354,1674,1680
38250,59271,5777,28530,3982,53494,3354,1674,1680
38255,59277,5777,28531,3982,53500,3355,1674,1681
38260,59288,5778,28534,3982,53510,3356,1675,1681
38265,59292,5779,28537,3983,53513,3356,1675,1681
38270,59302,5781,28542,3984,53521,3356,1675,1681
38275,59308,5781,28547,3984,53527,3357,1676,1681
38280,59319,5782,28551,3985,53537,3358,1676,1682
38285,59323,5782,28553,3985,53541,3358,1676,1682
38290,59333,5784,28560,3987,53549,3358,1676,1682
38295,59339,5784,28563,3987,53555,3359,1677,1682
38300,59350,5785,28568,3988,53565,3359,1677,1682
38305,59354,5785,28570,3988,53569,3359,1677,1682
38310,59364,5787,28573,3989,53577,3359,1677,1682
38315,59370,5787,28576,3989,53583,3360,1677,1683
38320,59381,5789,28580,3990,53592,3360,1677,1683
38325,59385,5789,28580,3990,53596,3360,1677,1683
38330,59395,5791,28585,3991,53604,3360,1677,1683
38335,59401,5791,28587,3991,53609,3362,1677,1685
38340,59412,5796,28593,3996,53616,3362,1677,1685
38345,59416,5796,28594,3996,53620,3362,1677,1685
38350,59426,5796,28599,3996,53630,3362,1677,1685
38355,59432,5796,28603,3996,53636,3363,1677,1686
38360,59443,5799,28608,3998,53644,3363,1677,1686
38365,59447,5800,28612,3999,53647,3363,1677,1686
38370,59457,5800,28614,3999,53657,3363,1677,1686
38375,59463,5800,28616,3999,53663,3364,1677,1687
38380,59474,5801,28622,4000,53673,3364,1677,1687
38385,59478,5802,28626,4001,53676,3364,1677,1687
38390,59488,5802,28631,4001,53686,3364,1677,1687
38395,59494,5802,28634,4001,53692,3365,1677,1688
38400,59505,5805,28638,4003,53700,3365,1677,1688
38405,59509,5805,28641,4003,53704,3365,1677,1688
38410,59519,5805,28648,4003,53714,3365,1677,1688
38415,59525,5805,28649,4003,53720,3366,1677,1689
38420,59536,5807,28656,4004,53729,3366,1677,1689
38425,59540,5807,28658,4004,53733,3366,1677,1689
38430,59550,5807,28662,4004,53743,3366,1677,1689
38435,59556,5807,28666,4004,53749,3367,1677,1690
38440,59567,5808,28674,4005,53759,3367,1677,1690
38445,59571,5808,28678,4005,53763,3367,1677,1690
38450,59581,5809,28682,4006,53772,3367,1677,1690
38455,59587,5809,28686,4006,53778,3369,1678,1691
38460,59598,5811,28691,4008,53787,3370,1678,1692
38465,59602,5812,28694,4009,53790,3370,1678,1692
38470,59612,5814,28699,4009,53798,3370,1678,1692
38475,59618,5814,28703,4009,53804,3372,1678,1694
38480,59629,5816,28710,4011,53813,3373,1679,1694
38485,59633,5817,28714,4012,53816,3373,1679,1694
38490,59643,5819,28718,4012,53824,3373,1679,1694
38495,59649,5819,28721,4012,53830,3374,1679,1695
38500,59660,5821,28726,4013,53839,3374,1679,1695
38505,59664,5822,28729,4014,53842,3374,1679,1695
38510,59674,5824,28735,4016,53850,3374,1679,1695
38515,59680,5824,28737,4016,53856,3375,1680,1695
38520,59691,5827,28743,4019,53864,3375,1680,1695
38525,59695,5827,28743,4019,53868,3375,1680,1695
38530,59705,5829,28749,4021,53876,3375,1680,1695
38535,59711,5829,28751,4021,53882,3376,1680,1696
38540,59722,5830,28760,4022,53892,3376,1680,1696
38545,59726,5831,28763,4023,53895,3376,1680,1696
38550,59736,5833,28767,4023,53903,3376,1680,1696
38555,59742,5833,28771,4023,53909,3377,1681,1696
38560,59753,5834,28773,4023,53919,3377,1681,1696
38565,59757,5834,28776,4023,53923,3377,1681,1696
38570,59767,5836,28780,4024,53931,3377,1681,1696
38575,59773,5836,28785,4024,53936,3378,1681,1697
38580,59784,5838,28788,4025,53945,3378,1681,1697
38585,59788,5839,28790,4026,53949,3378,1681,1697
38590,59798,5840,28797,4027,53958,3378,1681,1697
38595,59804,5840,28800,4027,53964,3379,1681,1698
38600,59815,5840,28803,4027,53975,3379,1681,1698
38605,59819,5840,28806,4027,53979,3379,1681,1698
38610,59829,5841,28810,4027,53988,3379,1681,1698
38615,59835,5841,28812,4027,53994,3380,1681,1699
38620,59846,5842,28820,4028,54004,3380,1681,1699
38625,59850,5842,28821,4028,54008,3380,1681,1699
38630,59860,5843,28825,4028,54017,3380,1681,1699
38635,59866,5843,28827,4028,54023,3381,1682,1699
38640,59877,5843,28832,4028,54034,3381,1682,1699
38645,59881,5844,28834,4029,54037,3381,1682,1699
38650,59891,5846,28834,4029,54045,3381,1682,1699
38655,59897,5846,28836,4029,54051,3382,1683,1699
38660,59908,5848,28841,4030,54060,3383,1684,1699
38665,59912,5848,28842,4030,54064,3383,1684,1699
38670,59922,5850,28846,4030,54072,3383,1684,1699
38675,59928,5850,28852,4030,54078,3384,1685,1699
38680,59939,5851,28855,4031,54088,3385,1685,1700
38685,59943,5852,28857,4032,54091,3385,1685,1700
38690,59953,5854,28859,4032,54099,3385,1685,1700
38695,59959,5854,28861,4032,54105,3387,1685,1702
38700,59970,5857,28866,4035,54113,3388,1686,1702
38705,59974,5857,28868,4035,54117,3388,1686,1702
38710,59984,5859,28876,4036,54125,3388,1686,1702
38715,59990,5859,28879,4036,54131,3389,1687,1702
38720,60001,5860,28882,4036,54141,3389,1687,1702
38725,60005,5860,28884,4036,54145,3389,1687,1702
38730,60015,5862,28889,4038,54153,3389,1687,1702
38735,60021,5862,28893,4038,54159,3390,1688,1702
38740,60032,5864,28897,4039,54168,3390,1688,1702
38745,60036,5864,28901,4039,54172,3390,1688,1702
38750,60046,5866,28907,4041,54180,3390,1688,1702
38755,60052,5866,28910,4041,54186,3391,1689,1702
38760,60063,5868,28917,4043,54195,3391,1689,1702
38765,60067,5868,28919,4043,54199,3391,1689,1702
38770,60077,5869,28923,4044,54208,3391,1689,1702
38775,60083,5869,28924,4044,54214,3392,1689,1703
38780,60094,5870,28930,4045,54223,3392,1689,1703
38785,60098,5871,28932,4046,54227,3392,1689,1703
38790,60108,5872,28942,4047,54236,3392,1689,1703
38795,60114,5872,28942,4047,54242,3393,1689,1704
38800,60125,5872,28946,4047,54253,3393,1689,1704
38805,60129,5872,28946,4047,54257,3393,1689,1704
38810,60139,5873,28953,4048,54266,3393,1689,1704
38815,60145,5873,28955,4048,54272,3394,1689,1705
38820,60156,5874,28962,4049,54282,3395,1690,1705
38825,60160,5874,28965,4049,54286,3395,1690,1705
38830,60170,5874,28969,4049,54296,3395,1690,1705
38835,60176,5874,28969,4049,54302,3397,1690,1707
38840,60187,5874,28973,4049,54313,3397,1690,1707
38845,60191,5874,28976,4049,54317,3397,1690,1707
38850,60201,5874,28982,4049,54327,3397,1690,1707
38855,60207,5874,28984,4049,54333,3398,1690,1708
38860,60218,5874,28990,4049,54344,3398,1690,1708
38865,60222,5874,28992,4049,54348,3398,1690,1708
38870,60232,5875,28998,4049,54357,3398,1690,1708
38875,60238,5875,29002,4049,54363,3399,1691,1708
38880,60249,5876,29008,4050,54373,3399,1691,1708
38885,60253,5877,29009,4051,54376,3399,1691,1708
38890,60263,5879,29011,4052,54384,3399,1691,1708
38895,60269,5879,29012,4052,54390,3401,1691,1710
38900,60280,5880,29017,4053,54400,3402,1692,1710
38905,60284,5880,29019,4053,54404,3402,1692,1710
38910,60294,5881,29024,4053,54413,3402,1692,1710
38915,60300,5881,29028,4053,54419,3404,1693,1711
38920,60311,5883,29033,4055,54428,3404,1693,1711
38925,60315,5883,29036,4055,54432,3404,1693,1711
38930,60325,5884,29042,4055,54441,3404,1693,1711
38935,60331,5884,29044,4055,54447,3405,1693,1712
38940,60342,5886,29051,4057,54456,3405,1693,1712
38945,60346,5886,29053,4057,54460,3405,1693,1712
38950,60356,5887,29059,4058,54469,3405,1693,1712
38955,60362,5887,29062,4058,54475,3406,1694,1712
38960,60373,5889,29069,4060,54484,3406,1694,1712
38965,60377,5889,29069,4060,54488,3406,1694,1712
38970,60387,5890,29073,4060,54497,3406,1694,1712
38975,60393,5890,29076,4060,54503,3407,1694,1713
38980,60404,5893,29082,4062,54511,3407,1694,1713
38985,60408,5893,29085,4062,54515,3407,1694,1713
38990,60418,5894,29088,4062,54524,3407,1694,1713
38995,60424,5894,29092,4062,54530,3408,1695,1713
39000,60435,5897,29097,4064,54537,3408,1695,1713
39005,60439,5900,29101,4067,54539,3408,1695,1713
39010,60449,5902,29105,4067,54547,3408,1695,1713
39015,60455,5902,29110,4067,54553,3409,1696,1713
39020,60466,5904,29113,4068,54562,3410,1697,1713
39025,60470,5905,29115,4069,54565,3410,1697,1713
39030,60480,5906,29120,4069,54574,3410,1697,1713
39035,60486,5906,29122,4069,54580,3412,1697,1715
39040,60497,5908,29127,4070,54589,3412,1697,1715
39045,60501,5908,29129,4070,54593,3412,1697,1715
39050,60511,5909,29135,4071,54602,3412,1697,1715
39055,60517,5909,29140,4071,54608,3414,1698,1716
39060,60528,5911,29147,4072,54617,3414,1698,1716
39065,60532,5912,29149,4073,54620,3414,1698,1716
39070,60542,5913,29153,4074,54629,3414,1698,1716
39075,60548,5913,29156,4074,54635,3416,1698,1718
39080,60559,5913,29162,4074,54646,3417,1698,1719
39085,60563,5914,29164,4075,54649,3417,1698,1719
39090,60573,5915,29169,4075,54658,3417,1698,1719
39095,60579,5915,29171,4075,54664,3419,1700,1719
39100,60590,5915,29174,4075,54675,3419,1700,1719
39105,60594,5915,29175,4075,54679,3419,1700,1719
39110,60604,5916,29179,4076,54688,3419,1700,1719
39115,60610,5916,29182,4076,54694,3420,1701,1719
39120,60621,5917,29186,4077,54704,3420,1701,1719
39125,60625,5917,29189,4077,54708,3420,1701,1719
39130,60635,5918,29193,4077,54717,3420,1701,1719
39135,60641,5918,29197,4077,54723,3421,1702,1719
39140,60652,5918,29202,4077,54734,3421,1702,1719
39145,60656,5918,29206,4077,54738,3421,1702,1719
39150,60666,5919,29212,4078,54747,3421,1702,1719
39155,60672,5919,29215,4078,54753,3422,1703,1719
39160,60683,5920,29221,4079,54763,3422,1703,1719
39165,60687,5920,29223,4079,54767,3422,1703,1719
39170,60697,5921,29230,4080,54776,3422,1703,1719
39175,60703,5921,29233,4080,54781,3423,1703,1720
39180,60714,5924,29237,4082,54790,3423,1703,1720
39185,60718,5924,29239,4082,54794,3423,1703,1720
39190,60728,5925,29247,4083,54803,3423,1703,1720
39195,60734,5925,29251,4083,54809,3424,1704,1720
39200,60745,5927,29255,4085,54818,3425,1705,1720
39205,60749,5928,29257,4086,54821,3425,1705,1720
39210,60759,5929,29262,4087,54830,3425,1705,1720
39215,60765,5929,29267,4087,54836,3427,1707,1720
39220,60776,5932,29274,4089,54844,3428,1708,1720
39225,60780,5933,29277,4090,54847,3428,1708,1720
39230,60790,5934,29282,4090,54856,3428,1708,1720
39235,60796,5934,29283,4090,54862,3430,1708,1722
39240,60807,5937,29290,4093,54870,3431,1708,1723
39245,60811,5938,29293,4094,54873,3431,1708,1723
39250,60821,5939,29300,4095,54882,3431,1708,1723
39255,60827,5939,29303,4095,54888,3433,1710,1723
39260,60838,5940,29306,4095,54898,3433,1710,1723
39265,60842,5940,29307,4095,54902,3433,1710,1723
39270,60852,5941,29313,4096,54911,3433,1710,1723
39275,60858,5941,29317,4096,54917,3435,1711,1724
39280,60869,5942,29320,4097,54927,3435,1711,1724
39285,60873,5943,29323,4098,54930,3435,1711,1724
39290,60883,5945,29326,4099,54938,3435,1711,1724
39295,60889,5945,29328,4099,54944,3437,1712,1725
39300,60900,5947,29336,4101,54953,3437,1712,1725
39305,60904,5947,29337,4101,54957,3437,1712,1725
39310,60914,5948,29341,4101,54966,3437,1712,1725
39315,60920,5948,29343,4101,54972,3438,1712,1726
39320,60931,5949,29348,4102,54982,3438,1712,1726
39325,60935,5949,29348,4102,54986,3438,1712,1726
39330,60945,5950,29351,4102,54995,3438,1712,1726
39335,60951,5950,29354,4102,55001,3439,1712,1727
39340,60962,5950,29360,4102,55012,3439,1712,1727
39345,60966,5950,29364,4102,55016,3439,1712,1727
39350,60976,5951,29369,4102,55025,3439,1712,1727
39355,60982,5951,29371,4102,55031,3440,1713,1727
39360,60993,5951,29377,4102,55042,3441,1713,1728
39365,60997,5952,29380,4103,55045,3441,1713,1728
39370,61007,5954,29383,4105,55053,3441,1713,1728
39375,61013,5954,29386,4105,55059,3442,1713,1729
39380,61024,5954,29391,4105,55070,3442,1713,1729
39385,61028,5954,29392,4105,55074,3442,1713,1729
39390,61038,5956,29396,4107,55082,3442,1713,1729
39395,61044,5956,29399,4107,55088,3443,1713,1730
39400,61055,5958,29403,4109,55097,3443,1713,1730
39405,61059,5958,29403,4109,55101,3443,1713,1730
39410,61069,5960,29408,4110,55109,3443,1713,1730
39415,61075,5960,29412,4110,55115,3444,1714,1730
39420,61086,5961,29415,4110,55125,3444,1714,1730
39425,61090,5961,29418,4110,55129,3444,1714,1730
39430,61100,5962,29424,4110,55138,3444,1714,1730
39435,61106,5962,29424,4110,55144,3445,1714,1731
39440,61117,5963,29431,4111,55154,3445,1714,1731
39445,61121,5963,29432,4111,55158,3445,1714,1731
39450,61131,5964,29436,4111,55167,3445,1714,1731
39455,61137,5964,29437,4111,55173,3446,1714,1732
39460,61148,5965,29441,4111,55183,3446,1714,1732
39465,61152,5966,29445,4112,55186,3446,1714,1732
39470,61162,5967,29449,4112,55195,3446,1714,1732
39475,61168,5967,29451,4112,55201,3448,1715,1733
39480,61179,5969,29457,4113,55210,3449,1715,1734
39485,61183,5969,29459,4113,55214,3449,1715,1734
39490,61193,5970,29463,4113,55223,3449,1715,1734
39495,61199,5970,29464,4113,55229,3450,1715,1735
39500,61210,5971,29470,4114,55239,3450,1715,1735
39505,61214,5971,29470,4114,55243,3450,1715,1735
39510,61224,5972,29476,4115,55252,3450,1715,1735
39515,61230,5972,29478,4115,55258,3451,1715,1736
39520,61241,5974,29482,4116,55267,3451,1715,1736
39525,61245,5974,29484,4116,55271,3451,1715,1736
39530,61255,5976,29487,4117,55279,3451,1715,1736
39535,61261,5976,29492,4117,55284,3452,1716,1736
39540,61272,5980,29496,4120,55291,3452,1716,1736
39545,61276,5981,29496,4121,55295,3452,1716,1736
39550,61286,5982,29503,4121,55304,3452,1716,1736
39555,61292,5982,29507,4121,55310,3453,1716,1737
39560,61303,5984,29513,4123,55319,3454,1717,1737
39565,61307,5985,29515,4124,55322,3454,1717,1737
39570,61317,5986,29521,4125,55331,3454,1717,1737
39575,61323,5986,29525,4125,55337,3455,1718,1737
39580,61334,5989,29531,4127,55345,3456,1719,1737
39585,61338,5989,29533,4127,55349,3456,1719,1737
39590,61348,5990,29541,4128,55358,3456,1719,1737
39595,61354,5990,29542,4128,55364,3457,1720,1737
39600,61365,5991,29546,4129,55374,3458,1721,1737
39605,61369,5991,29547,4129,55378,3458,1721,1737
39610,61379,5991,29550,4129,55388,3458,1721,1737
39615,61385,5991,29553,4129,55394,3459,1722,1737
39620,61396,5993,29561,4130,55403,3460,1723,1737
39625,61400,5993,29564,4130,55407,3460,1723,1737
39630,61410,5993,29569,4130,55417,3460,1723,1737
39635,61416,5993,29570,4130,55423,3461,1723,1738
39640,61427,5994,29577,4131,55433,3462,1724,1738
39645,61431,5994,29577,4131,55437,3462,1724,1738
39650,61441,5994,29581,4131,55447,3462,1724,1738
39655,61447,5994,29584,4131,55453,3463,1725,1738
39660,61458,5996,29590,4132,55462,3464,1725,1739
39665,61462,5996,29592,4132,55466,3464,1725,1739
39670,61472,5996,29598,4132,55476,3464,1725,1739
39675,61478,5996,29601,4132,55482,3465,1725,1740
39680,61489,5997,29603,4132,55492,3465,1725,1740
39685,61493,5997,29604,4132,55496,3465,1725,1740
39690,61503,5997,29610,4132,55506,3465,1725,1740
39695,61509,5997,29616,4132,55512,3466,1726,1740
39700,61520,5998,29621,4132,55522,3466,1726,1740
39705,61524,5998,29623,4132,55526,3466,1726,1740
39710,61534,5999,29628,4133,55535,3466,1726,1740
39715,61540,5999,29632,4133,55540,3467,1727,1740
39720,61551,6001,29636,4134,55549,3467,1727,1740
39725,61555,6003,29639,4136,55552,3467,1727,1740
39730,61565,6005,29645,4138,55560,3467,1727,1740
39735,61571,6005,29648,4138,55566,3468,1728,1740
39740,61582,6007,29654,4140,55575,3468,1728,1740
39745,61586,6007,29655,4140,55579,3468,1728,1740
39750,61596,6009,29662,4142,55587,3468,1728,1740
39755,61602,6009,29663,4142,55593,3469,1729,1740
39760,61613,6012,29669,4145,55601,3469,1729,1740
39765,61617,6012,29670,4145,55605,3469,1729,1740
39770,61627,6014,29674,4147,55613,3469,1729,1740
39775,61633,6014,29678,4147,55619,3471,1730,1741
39780,61644,6016,29684,4149,55628,3471,1730,1741
39785,61648,6016,29685,4149,55632,3471,1730,1741
39790,61658,6018,29692,4150,55640,3471,1730,1741
39795,61664,6018,29694,4150,55646,3472,1731,1741
39800,61675,6019,29697,4150,55656,3472,1731,1741
39805,61679,6020,29699,4151,55659,3472,1731,1741
39810,61689,6022,29705,4152,55667,3472,1731,1741
39815,61695,6022,29707,4152,55673,3473,1731,1742
39820,61706,6024,29713,4154,55682,3473,1731,1742
39825,61710,6024,29713,4154,55686,3473,1731,1742
39830,61720,6026,29717,4155,55694,3473,1731,1742
39835,61726,6026,29722,4155,55699,3474,1732,1742
39840,61737,6029,29726,4158,55708,3475,1733,1742
39845,61741,6029,29729,4158,55712,3475,1733,1742
39850,61751,6030,29732,4159,55721,3475,1733,1742
39855,61757,6030,29736,4159,55727,3477,1734,1743
39860,61768,6031,29742,4159,55737,3478,1734,1744
39865,61772,6031,29743,4159,55741,3478,1734,1744
39870,61782,6032,29747,4159,55750,3478,1734,1744
39875,61788,6032,29751,4159,55756,3480,1735,1745
39880,61799,6034,29758,4161,55765,3481,1735,1746
39885,61803,6034,29759,4161,55769,3481,1735,1746
39890,61813,6035,29763,4161,55778,3481,1735,1746
39895,61819,6035,29767,4161,55784,3483,1737,1746
39900,61830,6036,29769,4161,55794,3484,1737,1747
39905,61834,6036,29769,4161,55798,3484,1737,1747
39910,61844,6037,29775,4162,55807,3484,1737,1747
39915,61850,6037,29777,4162,55813,3485,1738,1747
39920,61861,6038,29783,4163,55823,3486,1738,1748
39925,61865,6038,29783,4163,55827,3486,1738,1748
39930,61875,6039,29789,4164,55836,3486,1738,1748
39935,61881,6039,29791,4164,55842,3487,1738,1749
39940,61892,6040,29795,4164,55852,3488,1739,1749
39945,61896,6040,29797,4164,55856,3488,1739,1749
39950,61906,6041,29803,4164,55865,3488,1739,1749
39955,61912,6041,29803,4164,55871,3489,1739,1750
39960,61923,6043,29809,4166,55880,3490,1740,1750
39965,61927,6043,29810,4166,55884,3490,1740,1750
39970,61937,6045,29816,4168,55892,3490,1740,1750
39975,61943,6045,29820,4168,55898,3491,1741,1750
39980,61954,6046,29826,4168,55908,3491,1741,1750
39985,61958,6047,29828,4169,55911,3491,1741,1750
39990,61968,6049,29836,4170,55919,3491,1741,1750
39995,61974,6049,29840,4170,55925,3492,1742,1750
40000,61985,6050,29844,4171,55935,3492,1742,1750
40005,61989,6051,29846,4172,55938,3492,1742,1750
40010,61999,6053,29848,4173,55946,3492,1742,1750
40015,62005,6053,29852,4173,55952,3493,1743,1750
40020,62016,6055,29859,4175,55961,3493,1743,1750
40025,62020,6056,29861,4176,55964,3493,1743,1750
40030,62030,6058,29863,4176,55972,3493,1743,1750
40035,62036,6058,29866,4176,55978,3494,1744,1750
40040,62047,6060,29872,4177,55987,3494,1744,1750
40045,62051,6060,29873,4177,55991,3494,1744,1750
40050,62061,6062,29880,4178,55999,3494,1744,1750
40055,62067,6062,29884,4178,56005,3495,1744,1751
40060,62078,6064,29890,4180,56014,3495,1744,1751
40065,62082,6064,29892,4180,56018,3495,1744,1751
40070,62092,6066,29898,4181,56026,3495,1744,1751
40075,62098,6066,29902,4181,56031,3497,1745,1752
40080,62109,6070,29908,4184,56039,3498,1746,1752
40085,62113,6070,29910,4184,56043,3498,1746,1752
40090,62123,6070,29915,4184,56053,3498,1746,1752
40095,62129,6070,29918,4184,56059,3499,1746,1753
40100,62140,6070,29926,4184,56070,3499,1746,1753
40105,62144,6070,29928,4184,56074,3499,1746,1753
40110,62154,6070,29932,4184,56084,3499,1746,1753
40115,62160,6070,29933,4184,56090,3500,1747,1753
40120,62171,6070,29938,4184,56101,3500,1747,1753
40125,62175,6070,29939,4184,56105,3500,1747,1753
40130,62185,6070,29943,4184,56115,3500,1747,1753
40135,62191,6070,29946,4184,56121,3501,1747,1754
40140,62202,6070,29951,4184,56132,3501,1747,1754
40145,62206,6070,29953,4184,56136,3501,1747,1754
40150,62216,6070,29959,4184,56146,3501,1747,1754
40155,62222,6070,29963,4184,56152,3502,1748,1754
40160,62233,6070,29965,4184,56163,3502,1748,1754
40165,62237,6070,29968,4184,56167,3502,1748,1754
40170,62247,6070,29971,4184,56177,3502,1748,1754
40175,62253,6070,29973,4184,56183,3503,1748,1755
40180,62264,6070,29979,4184,56194,3503,1748,1755
40185,62268,6070,29979,4184,56198,3503,1748,1755
40190,62278,6072,29982,4185,56206,3503,1748,1755
40195,62284,6072,29987,4185,56212,3505,1750,1755
40200,62295,6075,29990,4187,56220,3506,1751,1755
40205,62299,6075,29991,4187,56224,3506,1751,1755
40210,62309,6076,29998,4187,56233,3506,1751,1755
40215,62315,6076,30001,4187,56238,3507,1752,1755
40220,62326,6079,30005,4190,56247,3507,1752,1755
40225,62330,6079,30006,4190,56251,3507,1752,1755
40230,62340,6080,30012,4191,56260,3507,1752,1755
40235,62346,6080,30013,4191,56266,3508,1752,1756
40240,62357,6083,30019,4193,56274,3508,1752,1756
40245,62361,6084,30021,4194,56277,3508,1752,1756
40250,62371,6085,30026,4195,56286,3508,1752,1756
40255,62377,6085,30028,4195,56292,3509,1752,1757
40260,62388,6086,30033,4195,56302,3509,1752,1757
40265,62392,6086,30033,4195,56306,3509,1752,1757
40270,62402,6087,30040,4196,56315,3509,1752,1757
40275,62408,6087,30042,4196,56321,3510,1753,1757
40280,62419,6089,30047,4197,56330,3510,1753,1757
40285,62423,6089,30047,4197,56334,3510,1753,1757
40290,62433,6090,30052,4198,56343,3510,1753,1757
40295,62439,6090,30055,4198,56349,3511,1753,1758
40300,62450,6093,30061,4200,56357,3511,1753,1758
40305,62454,6094,30062,4201,56360,3511,1753,1758
40310,62464,6096,30066,4202,56368,3511,1753,1758
40315,62470,6096,30067,4202,56374,3513,1753,1760
40320,62481,6098,30073,4204,56383,3514,1753,1761
40325,62485,6098,30074,4204,56387,3514,1753,1761
40330,62495,6099,30083,4204,56396,3514,1753,1761
40335,62501,6099,30085,4204,56401,3515,1753,1762
40340,62512,6100,30090,4205,56411,3515,1753,1762
40345,62516,6101,30091,4206,56415,3515,1753,1762
40350,62526,6102,30095,4207,56424,3515,1753,1762
40355,62532,6102,30100,4207,56430,3516,1754,1762
40360,62543,6102,30106,4207,56440,3516,1754,1762
40365,62547,6103,30108,4208,56444,3516,1754,1762
40370,62557,6104,30115,4209,56453,3516,1754,1762
40375,62563,6104,30119,4209,56458,3517,1755,1762
40380,62574,6105,30123,4210,56468,3517,1755,1762
40385,62578,6106,30125,4211,56472,3517,1755,1762
40390,62588,6107,30130,4212,56481,3517,1755,1762
40395,62594,6107,30131,4212,56487,3518,1755,1763
40400,62605,6107,30136,4212,56498,3518,1755,1763
40405,62609,6107,30138,4212,56502,3518,1755,1763
40410,62619,6108,30141,4213,56511,3518,1755,1763
40415,62625,6108,30143,4213,56517,3519,1756,1763
40420,62636,6108,30147,4213,56528,3519,1756,1763
40425,62640,6108,30150,4213,56532,3519,1756,1763
40430,62650,6110,30154,4214,56540,3519,1756,1763
40435,62656,6110,30156,4214,56546,3521,1757,1764
40440,62667,6114,30161,4218,56553,3522,1757,1765
40445,62671,6115,30163,4219,56556,3522,1757,1765
40450,62681,6116,30166,4219,56565,3522,1757,1765
40455,62687,6116,30170,4219,56570,3523,1757,1766
40460,62698,6120,30177,4223,56578,3523,1757,1766
40465,62702,6121,30179,4224,56581,3523,1757,1766
40470,62712,6122,30187,4225,56590,3523,1757,1766
40475,62718,6122,30190,4225,56596,3524,1757,1767
40480,62729,6124,30195,4226,56605,3524,1757,1767
40485,62733,6125,30197,4227,56608,3524,1757,1767
40490,62743,6126,30201,4227,56617,3524,1757,1767
40495,62749,6126,30205,4227,56623,3525,1758,1767
40500,62760,6129,30211,4230,56631,3525,1758,1767
40505,62764,6129,30212,4230,56635,3525,1758,1767
40510,62774,6130,30216,4231,56644,3525,1758,1767
40515,62780,6130,30217,4231,56650,3526,1759,1767
40520,62791,6130,30222,4231,56661,3526,1759,1767
40525,62795,6130,30225,4231,56665,3526,1759,1767
40530,62805,6131,30229,4231,56674,3526,1759,1767
40535,62811,6131,30231,4231,56680,3527,1759,1768
40540,62822,6132,30236,4232,56690,3527,1759,1768
40545,62826,6132,30237,4232,56694,3527,1759,1768
40550,62836,6134,30242,4234,56702,3527,1759,1768
40555,62842,6134,30243,4234,56708,3529,1759,1770
40560,62853,6135,30249,4235,56717,3530,1760,1770
40565,62857,6136,30253,4236,56721,3530,1760,1770
40570,62867,6137,30257,4236,56730,3530,1760,1770
40575,62873,6137,30260,4236,56736,3531,1761,1770
40580,62884,6137,30264,4236,56747,3531,1761,1770
40585,62888,6137,30264,4236,56751,3531,1761,1770
40590,62898,6138,30267,4236,56760,3531,1761,1770
40595,62904,6138,30270,4236,56766,3532,1761,1771
40600,62915,6138,30274,4236,56777,3532,1761,1771
40605,62919,6138,30276,4236,56781,3532,1761,1771
40610,62929,6139,30279,4236,56790,3532,1761,1771
40615,62935,6139,30283,4236,56796,3533,1762,1771
40620,62946,6140,30285,4237,56806,3533,1762,1771
40625,62950,6140,30287,4237,56810,3533,1762,1771
40630,62960,6141,30292,4237,56819,3533,1762,1771
40635,62966,6141,30294,4237,56824,3534,1762,1772
40640,62977,6143,30300,4239,56833,3534,1762,1772
40645,62981,6144,30303,4240,56837,3534,1762,1772
40650,62991,6145,30309,4241,56846,3534,1762,1772
40655,62997,6145,30313,4241,56851,3535,1762,1773
40660,63008,6148,30317,4244,56859,3535,1762,1773
40665,63012,6149,30319,4245,56863,3535,1762,1773
40670,63022,6150,30322,4246,56872,3535,1762,1773
40675,63028,6150,30325,4246,56877,3537,1762,1775
40680,63039,6152,30331,4247,56886,3538,1762,1776
40685,63043,6153,30333,4248,56890,3538,1762,1776
40690,63053,6153,30336,4248,56900,3538,1762,1776
40695,63059,6153,30340,4248,56906,3539,1763,1776
40700,63070,6155,30347,4250,56915,3540,1764,1776
40705,63074,6156,30349,4251,56918,3540,1764,1776
40710,63084,6156,30353,4251,56928,3540,1764,1776
40715,63090,6156,30354,4251,56934,3541,1765,1776
40720,63101,6157,30362,4252,56944,3542,1765,1777
40725,63105,6157,30364,4252,56948,3542,1765,1777
40730,63115,6158,30370,4253,56957,3542,1765,1777
40735,63121,6158,30372,4253,56963,3543,1765,1778
40740,63132,6160,30378,4255,56972,3544,1766,1778
40745,63136,6160,30379,4255,56976,3544,1766,1778
40750,63146,6162,30383,4256,56984,3544,1766,1778
40755,63152,6162,30387,4256,56990,3545,1766,1779
40760,63163,6165,30397,4259,56998,3545,1766,1779
40765,63167,6165,30400,4259,57002,3545,1766,1779
40770,63177,6167,30405,4261,57010,3545,1766,1779
40775,63183,6167,30407,4261,57015,3546,1766,1780
40780,63194,6170,30413,4264,57024,3546,1766,1780
40785,63198,6170,30415,4264,57028,3546,1766,1780
40790,63208,6172,30418,4265,57036,3546,1766,1780
40795,63214,6172,30418,4265,57042,3548,1766,1782
40800,63225,6174,30421,4266,57051,3548,1766,1782
40805,63229,6175,30423,4267,57054,3548,1766,1782
40810,63239,6177,30428,4269,57062,3548,1766,1782
40815,63245,6177,30429,4269,57068,3550,1766,1784
40820,63256,6178,30437,4270,57078,3550,1766,1784
40825,63260,6178,30438,4270,57082,3550,1766,1784
40830,63270,6180,30442,4271,57090,3550,1766,1784
40835,63276,6180,30444,4271,57096,3551,1766,1785
40840,63287,6182,30447,4272,57105,3551,1766,1785
40845,63291,6182,30449,4272,57109,3551,1766,1785
40850,63301,6184,30454,4273,57117,3551,1766,1785
40855,63307,6184,30456,4273,57123,3552,1766,1786
40860,63318,6186,30461,4274,57132,3552,1766,1786
40865,63322,6187,30464,4275,57135,3552,1766,1786
40870,63332,6188,30469,4275,57144,3552,1766,1786
40875,63338,6188,30472,4275,57150,3553,1767,1786
40880,63349,6190,30477,4276,57159,3553,1767,1786
40885,63353,6190,30479,4276,57163,3553,1767,1786
40890,63363,6191,30482,4277,57172,3553,1767,1786
40895,63369,6191,30484,4277,57178,3554,1767,1787
40900,63380,6194,30490,4279,57186,3554,1767,1787
40905,63384,6194,30492,4279,57190,3554,1767,1787
40910,63394,6195,30497,4279,57199,3554,1767,1787
40915,63400,6195,30501,4279,57205,3555,1767,1788
40920,63411,6198,30507,4281,57213,3555,1767,1788
40925,63415,6198,30509,4281,57217,3555,1767,1788
40930,63425,6198,30514,4281,57227,3555,1767,1788
40935,63431,6198,30517,4281,57233,3557,1768,1789
40940,63442,6200,30521,4282,57242,3558,1768,1790
40945,63446,6201,30524,4283,57245,3558,1768,1790
40950,63456,6201,30530,4283,57255,3558,1768,1790
40955,63462,6201,30534,4283,57261,3560,1770,1790
40960,63473,6203,30537,4284,57270,3561,1770,1791
40965,63477,6203,30538,4284,57274,3561,1770,1791
40970,63487,6204,30543,4284,57283,3561,1770,1791
40975,63493,6204,30547,4284,57289,3563,1771,1792
40980,63504,6206,30554,4286,57298,3564,1771,1793
40985,63508,6206,30556,4286,57302,3564,1771,1793
40990,63518,6207,30564,4287,57311,3564,1771,1793
40995,63524,6207,30566,4287,57317,3565,1772,1793
41000,63535,6207,30567,4287,57328,3565,1772,1793
41005,63539,6207,30570,4287,57332,3565,1772,1793
41010,63549,6208,30573,4287,57341,3565,1772,1793
41015,63555,6208,30577,4287,57347,3566,1773,1793
41020,63566,6208,30583,4287,57358,3566,1773,1793
41025,63570,6208,30585,4287,57362,3566,1773,1793
41030,63580,6209,30590,4287,57371,3566,1773,1793
41035,63586,6209,30593,4287,57376,3567,1773,1794
41040,63597,6210,30597,4288,57387,3567,1773,1794
41045,63601,6210,30599,4288,57391,3567,1773,1794
41050,63611,6211,30607,4288,57400,3567,1773,1794
41055,63617,6211,30610,4288,57405,3569,1774,1795
41060,63628,6213,30613,4289,57415,3569,1774,1795
41065,63632,6213,30615,4289,57419,3569,1774,1795
41070,63642,6214,30619,4289,57428,3569,1774,1795
41075,63648,6214,30620,4289,57434,3571,1775,1796
41080,63659,6216,30623,4290,57443,3571,1775,1796
41085,63663,6216,30624,4290,57447,3571,1775,1796
41090,63673,6218,30630,4291,57455,3571,1775,1796
41095,63679,6218,30634,4291,57460,3573,1776,1797
41100,63690,6222,30639,4295,57468,3573,1776,1797
41105,63694,6222,30640,4295,57472,3573,1776,1797
41110,63704,6223,30645,4296,57481,3573,1776,1797
41115,63710,6223,30647,4296,57487,3574,1776,1798
41120,63721,6224,30651,4297,57497,3575,1776,1799
41125,63725,6224,30652,4297,57501,3575,1776,1799
41130,63735,6225,30661,4298,57510,3575,1776,1799
41135,63741,6225,30662,4298,57516,3576,1777,1799
41140,63752,6227,30667,4300,57525,3577,1778,1799
41145,63756,6227,30670,4300,57529,3577,1778,1799
41150,63766,6228,30677,4301,57538,3577,1778,1799
41155,63772,6228,30680,4301,57544,3578,1778,1800
41160,63783,6229,30686,4302,57554,3578,1778,1800
41165,63787,6229,30688,4302,57558,3578,1778,1800
41170,63797,6230,30693,4302,57567,3578,1778,1800
41175,63803,6230,30694,4302,57573,3579,1778,1801
41180,63814,6230,30699,4302,57584,3579,1778,1801
41185,63818,6230,30702,4302,57588,3579,1778,1801
41190,63828,6231,30707,4302,57597,3579,1778,1801
41195,63834,6231,30712,4302,57603,3580,1779,1801
41200,63845,6231,30718,4302,57614,3580,1779,1801
41205,63849,6231,30721,4302,57618,3580,1779,1801
41210,63859,6233,30724,4302,57626,3580,1779,1801
41215,63865,6233,30725,4302,57632,3582,1779,1803
41220,63876,6236,30732,4304,57640,3582,1779,1803
41225,63880,6237,30735,4305,57643,3582,1779,1803
41230,63890,6238,30738,4306,57652,3582,1779,1803
41235,63896,6238,30741,4306,57658,3584,1781,1803
41240,63907,6240,30747,4307,57667,3585,1781,1804
41245,63911,6241,30749,4308,57670,3585,1781,1804
41250,63921,6242,30754,4308,57679,3585,1781,1804
41255,63927,6242,30756,4308,57685,3587,1782,1805
41260,63938,6243,30763,4308,57695,3588,1783,1805
41265,63942,6243,30765,4308,57699,3588,1783,1805
41270,63952,6244,30771,4309,57708,3588,1783,1805
41275,63958,6244,30773,4309,57714,3590,1784,1806
41280,63969,6245,30780,4310,57724,3590,1784,1806
41285,63973,6245,30782,4310,57728,3590,1784,1806
41290,63983,6246,30787,4311,57737,3590,1784,1806
41295,63989,6246,30789,4311,57743,3591,1784,1807
41300,64000,6247,30792,4311,57753,3591,1784,1807
41305,64004,6247,30796,4311,57757,3591,1784,1807
41310,64014,6248,30802,4311,57766,3591,1784,1807
41315,64020,6248,30804,4311,57772,3592,1785,1807
41320,64031,6249,30812,4312,57782,3592,1785,1807
41325,64035,6249,30815,4312,57786,3592,1785,1807
41330,64045,6250,30820,4313,57795,3592,1785,1807
41335,64051,6250,30821,4313,57801,3593,1785,1808
41340,64062,6252,30825,4314,57809,3593,1785,1808
41345,64066,6253,30827,4315,57813,3593,1785,1808
41350,64076,6255,30834,4317,57821,3593,1785,1808
41355,64082,6255,30837,4317,57827,3594,1786,1808
41360,64093,6257,30844,4319,57836,3594,1786,1808
41365,64097,6257,30846,4319,57840,3594,1786,1808
41370,64107,6259,30851,4321,57848,3594,1786,1808
41375,64113,6259,30853,4321,57854,3595,1786,1809
41380,64124,6260,30859,4322,57864,3595,1786,1809
41385,64128,6261,30862,4323,57867,3595,1786,1809
41390,64138,6263,30869,4324,57875,3595,1786,1809
41395,64144,6263,30871,4324,57881,3596,1786,1810
41400,64155,6266,30879,4326,57889,3596,1786,1810
41405,64159,6267,30880,4327,57892,3596,1786,1810
41410,64169,6268,30884,4328,57901,3596,1786,1810
41415,64175,6268,30887,4328,57907,3597,1787,1810
41420,64186,6269,30894,4329,57917,3597,1787,1810
41425,64190,6269,30897,4329,57921,3597,1787,1810
41430,64200,6270,30901,4329,57930,3597,1787,1810
41435,64206,6270,30904,4329,57936,3598,1788,1810
41440,64217,6271,30909,4330,57946,3598,1788,1810
41445,64221,6272,30911,4331,57949,3598,1788,1810
41450,64231,6273,30915,4332,57958,3598,1788,1810
41455,64237,6273,30916,4332,57964,3600,1788,1812
41460,64248,6276,30922,4335,57972,3600,1788,1812
41465,64252,6277,30924,4336,57975,3600,1788,1812
41470,64262,6278,30928,4337,57984,3600,1788,1812
41475,64268,6278,30929,4337,57990,3601,1788,1813
41480,64279,6281,30934,4339,57998,3601,1788,1813
41485,64283,6281,30935,4339,58002,3601,1788,1813
41490,64293,6282,30940,4339,58011,3601,1788,1813
41495,64299,6282,30944,4339,58017,3602,1788,1814
41500,64310,6285,30951,4342,58025,3602,1788,1814
41505,64314,6285,30953,4342,58029,3602,1788,1814
41510,64324,6287,30958,4343,58037,3602,1788,1814
41515,64330,6287,30961,4343,58042,3603,1788,1815
41520,64341,6289,30964,4344,58052,3604,1788,1816
41525,64345,6289,30967,4344,58056,3604,1788,1816
41530,64355,6289,30973,4344,58066,3604,1788,1816
41535,64361,6289,30975,4344,58072,3605,1789,1816
41540,64372,6289,30981,4344,58083,3605,1789,1816
41545,64376,6289,30983,4344,58087,3605,1789,1816
41550,64386,6289,30988,4344,58097,3605,1789,1816
41555,64392,6289,30990,4344,58103,3606,1790,1816
41560,64403,6289,30995,4344,58114,3606,1790,1816
41565,64407,6289,30998,4344,58118,3606,1790,1816
41570,64417,6289,31003,4344,58128,3606,1790,1816
41575,64423,6289,31006,4344,58134,3608,1791,1817
41580,64434,6289,31013,4344,58145,3608,1791,1817
41585,64438,6289,31014,4344,58149,3608,1791,1817
41590,64448,6289,31019,4344,58159,3608,1791,1817
41595,64454,6289,31023,4344,58165,3609,1792,1817
41600,64465,6289,31029,4344,58176,3609,1792,1817
41605,64469,6289,31032,4344,58180,3609,1792,1817
41610,64479,6289,31037,4344,58190,3609,1792,1817
41615,64485,6289,31040,4344,58196,3610,1792,1818
41620,64496,6289,31045,4344,58207,3610,1792,1818
41625,64500,6289,31047,4344,58211,3610,1792,1818
41630,64510,6290,31053,4344,58220,3610,1792,1818
41635,64516,6290,31056,4344,58226,3611,1792,1819
41640,64527,6292,31060,4345,58235,3611,1792,1819
41645,64531,6292,31064,4345,58239,3611,1792,1819
41650,64541,6294,31071,4346,58247,3611,1792,1819
41655,64547,6294,31074,4346,58253,3612,1793,1819
41660,64558,6295,31078,4346,58263,3612,1793,1819
41665,64562,6295,31081,4346,58267,3612,1793,1819
41670,64572,6297,31086,4347,58275,3612,1793,1819
41675,64578,6297,31090,4347,58281,3613,1793,1820
41680,64589,6299,31097,4349,58290,3613,1793,1820
41685,64593,6299,31098,4349,58294,3613,1793,1820
41690,64603,6301,31100,4349,58302,3613,1793,1820
41695,64609,6301,31102,4349,58308,3615,1794,1821
41700,64620,6304,31106,4351,58316,3616,1794,1822
41705,64624,6305,31108,4352,58319,3616,1794,1822
41710,64634,6307,31114,4353,58327,3616,1794,1822
41715,64640,6307,31116,4353,58333,3618,1795,1823
41720,64651,6309,31123,4354,58342,3619,1796,1823
41725,64655,6309,31125,4354,58346,3619,1796,1823
41730,64665,6311,31130,4356,58354,3619,1796,1823
41735,64671,6311,31132,4356,58360,3621,1797,1824
41740,64682,6313,31138,4358,58369,3622,1797,1825
41745,64686,6314,31141,4359,58372,3622,1797,1825
41750,64696,6316,31149,4360,58380,3622,1797,1825
41755,64702,6316,31150,4360,58386,3624,1798,1826
41760,64713,6320,31159,4364,58392,3625,1799,1826
41765,64717,6321,31160,4365,58396,3625,1799,1826
41770,64727,6321,31166,4365,58406,3625,1799,1826
41775,64733,6321,31171,4365,58412,3626,1800,1826
41780,64744,6324,31179,4368,58420,3626,1800,1826
41785,64748,6324,31181,4368,58424,3626,1800,1826
41790,64758,6324,31185,4368,58434,3626,1800,1826
41795,64764,6324,31188,4368,58440,3627,1801,1826
41800,64775,6326,31194,4370,58449,3627,1801,1826
41805,64779,6326,31195,4370,58453,3627,1801,1826
41810,64789,6326,31198,4370,58463,3627,1801,1826
41815,64795,6326,31200,4370,58469,3628,1802,1826
41820,64806,6327,31204,4370,58479,3628,1802,1826
41825,64810,6328,31207,4371,58482,3628,1802,1826
41830,64820,6329,31213,4372,58491,3628,1802,1826
41835,64826,6329,31218,4372,58497,3629,1803,1826
41840,64837,6333,31222,4375,58504,3629,1803,1826
41845,64841,6334,31224,4376,58507,3629,1803,1826
41850,64851,6335,31231,4377,58516,3629,1803,1826
41855,64857,6335,31233,4377,58522,3630,1804,1826
41860,64868,6338,31239,4379,58530,3630,1804,1826
41865,64872,6338,31240,4379,58534,3630,1804,1826
41870,64882,6340,31245,4381,58542,3630,1804,1826
41875,64888,6340,31247,4381,58548,3632,1804,1828
41880,64899,6344,31254,4384,58554,3633,1805,1828
41885,64903,6345,31257,4385,58558,3633,1805,1828
41890,64913,6346,31264,4386,58567,3633,1805,1828
41895,64919,6346,31268,4386,58573,3635,1806,1829
41900,64930,6347,31274,4387,58583,3636,1807,1829
41905,64934,6347,31275,4387,58587,3636,1807,1829
41910,64944,6348,31279,4387,58596,3636,1807,1829
41915,64950,6348,31282,4387,58602,3638,1808,1830
41920,64961,6349,31286,4388,58612,3639,1808,1831
41925,64965,6349,31287,4388,58616,3639,1808,1831
41930,64975,6350,31291,4388,58625,3639,1808,1831
41935,64981,6350,31295,4388,58631,3641,1809,1832
41940,64992,6350,31300,4388,58642,3642,1810,1832
41945,64996,6350,31302,4388,58646,3642,1810,1832
41950,65006,6352,31308,4390,58654,3642,1810,1832
41955,65012,6352,31311,4390,58660,3643,1811,1832
41960,65023,6353,31316,4391,58670,3643,1811,1832
41965,65027,6353,31318,4391,58674,3643,1811,1832
41970,65037,6355,31322,4392,58682,3643,1811,1832
41975,65043,6355,31325,4392,58688,3644,1812,1832
41980,65054,6355,31330,4392,58699,3644,1812,1832
41985,65058,6355,31331,4392,58703,3644,1812,1832
41990,65068,6357,31335,4393,58711,3644,1812,1832
41995,65074,6357,31337,4393,58716,3645,1812,1833
42000,65085,6359,31339,4395,58726,3645,1812,1833
42005,65089,6359,31340,4395,58730,3645,1812,1833
42010,65099,6360,31345,4395,58739,3645,1812,1833
42015,65105,6360,31348,4395,58745,3646,1813,1833
42020,65116,6362,31350,4397,58754,3646,1813,1833
42025,65120,6363,31354,4398,58757,3646,1813,1833
42030,65130,6364,31360,4399,58766,3646,1813,1833
42035,65136,6364,31362,4399,58772,3647,1814,1833
42040,65147,6366,31368,4400,58781,3647,1814,1833
42045,65151,6366,31369,4400,58785,3647,1814,1833
42050,65161,6367,31375,4400,58794,3647,1814,1833
42055,65167,6367,31378,4400,58799,3648,1814,1834
42060,65178,6370,31382,4402,58808,3648,1814,1834
42065,65182,6370,31383,4402,58812,3648,1814,1834
42070,65192,6370,31388,4402,58822,3648,1814,1834
42075,65198,6370,31391,4402,58828,3649,1814,1835
42080,65209,6372,31396,4403,58837,3649,1814,1835
42085,65213,6372,31399,4403,58841,3649,1814,1835
42090,65223,6372,31403,4403,58851,3649,1814,1835
42095,65229,6372,31407,4403,58857,3650,1815,1835
42100,65240,6373,31412,4404,58867,3650,1815,1835
42105,65244,6373,31415,4404,58871,3650,1815,1835
42110,65254,6374,31422,4404,58880,3650,1815,1835
42115,65260,6374,31422,4404,58886,3651,1815,1836
42120,65271,6376,31426,4405,58894,3651,1815,1836
42125,65275,6377,31427,4406,58898,3651,1815,1836
42130,65285,6378,31434,4407,58907,3651,1815,1836
42135,65291,6378,31440,4407,58913,3652,1816,1836
42140,65302,6380,31445,4408,58922,3652,1816,1836
42145,65306,6381,31448,4409,58925,3652,1816,1836
42150,65316,6382,31453,4409,58934,3652,1816,1836
42155,65322,6382,31457,4409,58940,3653,1817,1836
42160,65333,6384,31462,4410,58949,3653,1817,1836
42165,65337,6384,31462,4410,58953,3653,1817,1836
42170,65347,6386,31466,4410,58961,3653,1817,1836
42175,65353,6386,31468,4410,58967,3655,1819,1836
42180,65364,6387,31472,4411,58977,3656,1819,1837
42185,65368,6387,31474,4411,58981,3656,1819,1837
42190,65378,6388,31479,4412,58990,3656,1819,1837
42195,65384,6388,31483,4412,58996,3658,1820,1838
42200,65395,6388,31490,4412,59007,3658,1820,1838
42205,65399,6388,31491,4412,59011,3658,1820,1838
42210,65409,6389,31498,4413,59020,3658,1820,1838
42215,65415,6389,31503,4413,59026,3660,1821,1839
42220,65426,6389,31509,4413,59037,3660,1821,1839
42225,65430,6389,31511,4413,59041,3660,1821,1839
42230,65440,6390,31518,4413,59050,3660,1821,1839
42235,65446,6390,31522,4413,59056,3662,1823,1839
42240,65457,6390,31526,4413,59067,3662,1823,1839
42245,65461,6390,31526,4413,59071,3662,1823,1839
42250,65471,6391,31533,4413,59080,3662,1823,1839
42255,65477,6391,31536,4413,59086,3663,1823,1840
42260,65488,6391,31540,4413,59097,3663,1823,1840
42265,65492,6391,31542,4413,59101,3663,1823,1840
42270,65502,6392,31545,4413,59110,3663,1823,1840
42275,65508,6392,31548,4413,59116,3664,1823,1841
42280,65519,6392,31552,4413,59127,3664,1823,1841
42285,65523,6392,31555,4413,59131,3664,1823,1841
42290,65533,6394,31560,4413,59139,3664,1823,1841
42295,65539,6394,31562,4413,59145,3665,1824,1841
42300,65550,6397,31567,4415,59153,3666,1825,1841
42305,65554,6398,31570,4416,59156,3666,1825,1841
42310,65564,6400,31575,4416,59164,3666,1825,1841
42315,65570,6400,31579,4416,59170,3667,1825,1842
42320,65581,6402,31583,4418,59179,3668,1826,1842
42325,65585,6403,31585,4419,59182,3668,1826,1842
42330,65595,6405,31591,4420,59190,3668,1826,1842
42335,65601,6405,31595,4420,59196,3669,1827,1842
42340,65612,6406,31603,4421,59206,3670,1828,1842
42345,65616,6406,31604,4421,59210,3670,1828,1842
42350,65626,6408,31608,4421,59218,3670,1828,1842
42355,65632,6408,31611,4421,59224,3671,1829,1842
42360,65643,6410,31618,4422,59233,3672,1830,1842
42365,65647,6411,31620,4423,59236,3672,1830,1842
42370,65657,6413,31625,4425,59244,3672,1830,1842
42375,65663,6413,31627,4425,59250,3673,1830,1843
42380,65674,6415,31633,4427,59259,3674,1831,1843
42385,65678,6415,31635,4427,59263,3674,1831,1843
42390,65688,6417,31641,4428,59271,3674,1831,1843
42395,65694,6417,31645,4428,59277,3675,1832,1843
42400,65705,6418,31650,4429,59287,3676,1832,1844
42405,65709,6420,31653,4431,59289,3676,1832,1844
42410,65719,6422,31659,4433,59297,3676,1832,1844
42415,65725,6422,31661,4433,59303,3677,1833,1844
42420,65736,6424,31663,4434,59312,3678,1833,1845
42425,65740,6424,31665,4434,59316,3678,1833,1845
42430,65750,6424,31667,4434,59326,3678,1833,1845
42435,65756,6424,31671,4434,59332,3679,1834,1845
42440,65767,6424,31676,4434,59343,3679,1834,1845
42445,65771,6424,31679,4434,59347,3679,1834,1845
42450,65781,6424,31683,4434,59357,3679,1834,1845
42455,65787,6424,31687,4434,59363,3680,1835,1845
42460,65798,6424,31692,4434,59374,3680,1835,1845
42465,65802,6424,31695,4434,59378,3680,1835,1845
42470,65812,6424,31702,4434,59388,3680,1835,1845
42475,65818,6424,31705,4434,59394,3682,1835,1847
42480,65829,6424,31708,4434,59405,3682,1835,1847
42485,65833,6424,31710,4434,59409,3682,1835,1847
42490,65843,6424,31716,4434,59419,3682,1835,1847
42495,65849,6424,31717,4434,59425,3683,1835,1848
42500,65860,6424,31723,4434,59436,3683,1835,1848
42505,65864,6424,31727,4434,59440,3683,1835,1848
42510,65874,6424,31733,4434,59450,3683,1835,1848
42515,65880,6424,31738,4434,59456,3684,1836,1848
42520,65891,6424,31744,4434,59467,3684,1836,1848
42525,65895,6424,31746,4434,59471,3684,1836,1848
42530,65905,6426,31752,4435,59479,3684,1836,1848
42535,65911,6426,31752,4435,59485,3685,1836,1849
42540,65922,6429,31756,4437,59493,3685,1836,1849
42545,65926,6429,31757,4437,59497,3685,1836,1849
42550,65936,6431,31757,4437,59505,3685,1836,1849
42555,65942,6431,31758,4437,59511,3686,1836,1850
42560,65953,6434,31767,4439,59519,3687,1837,1850
42565,65957,6436,31770,4441,59521,3687,1837,1850
42570,65967,6438,31773,4441,59529,3687,1837,1850
42575,65973,6438,31779,4441,59535,3688,1838,1850
42580,65984,6440,31785,4443,59544,3689,1838,1851
42585,65988,6440,31787,4443,59548,3689,1838,1851
42590,65998,6442,31792,4443,59556,3689,1838,1851
42595,66004,6442,31793,4443,59562,3690,1838,1852
42600,66015,6444,31799,4444,59571,3691,1839,1852
42605,66019,6444,31800,4444,59575,3691,1839,1852
42610,66029,6446,31805,4446,59583,3691,1839,1852
42615,66035,6446,31808,4446,59589,3692,1839,1853
42620,66046,6448,31813,4448,59598,3692,1839,1853
42625,66050,6448,31816,4448,59602,3692,1839,1853
42630,66060,6450,31821,4450,59610,3692,1839,1853
42635,66066,6450,31824,4450,59616,3693,1840,1853
42640,66077,6452,31827,4451,59625,3693,1840,1853
42645,66081,6453,31828,4452,59628,3693,1840,1853
42650,66091,6455,31833,4453,59636,3693,1840,1853
42655,66097,6455,31837,4453,59641,3695,1841,1854
42660,66108,6458,31844,4456,59650,3695,1841,1854
42665,66112,6458,31847,4456,59654,3695,1841,1854
42670,66122,6459,31850,4456,59663,3695,1841,1854
42675,66128,6459,31852,4456,59669,3697,1841,1856
42680,66139,6460,31859,4457,59679,3697,1841,1856
42685,66143,6460,31860,4457,59683,3697,1841,1856
42690,66153,6461,31866,4457,59692,3697,1841,1856
42695,66159,6461,31869,4457,59698,3698,1841,1857
42700,66170,6461,31871,4457,59709,3698,1841,1857
42705,66174,6462,31873,4458,59712,3698,1841,1857
42710,66184,6463,31876,4459,59721,3698,1841,1857
42715,66190,6463,31878,4459,59726,3699,1841,1858
42720,66201,6464,31882,4460,59737,3700,1842,1858
42725,66205,6464,31883,4460,59741,3700,1842,1858
42730,66215,6465,31887,4461,59750,3700,1842,1858
42735,66221,6465,31890,4461,59756,3702,1844,1858
42740,66232,6466,31895,4462,59766,3703,1845,1858
42745,66236,6466,31897,4462,59770,3703,1845,1858
42750,66246,6467,31903,4463,59779,3703,1845,1858
42755,66252,6467,31905,4463,59785,3705,1846,1859
42760,66263,6468,31912,4464,59795,3705,1846,1859
42765,66267,6468,31913,4464,59799,3705,1846,1859
42770,66277,6470,31920,4465,59807,3705,1846,1859
42775,66283,6470,31924,4465,59812,3707,1846,1861
42780,66294,6474,31929,4468,59820,3707,1846,1861
42785,66298,6475,31932,4469,59823,3707,1846,1861
42790,66308,6476,31937,4470,59832,3707,1846,1861
42795,66314,6476,31941,4470,59838,3708,1847,1861
42800,66325,6478,31946,4471,59847,3708,1847,1861
42805,66329,6479,31948,4472,59850,3708,1847,1861
42810,66339,6480,31951,4473,59859,3708,1847,1861
42815,66345,6480,31953,4473,59865,3709,1847,1862
42820,66356,6482,31956,4474,59874,3709,1847,1862
42825,66360,6483,31957,4475,59877,3709,1847,1862
42830,66370,6484,31963,4475,59886,3709,1847,1862
42835,66376,6484,31966,4475,59892,3710,1847,1863
42840,66387,6486,31970,4477,59901,3710,1847,1863
42845,66391,6486,31972,4477,59905,3710,1847,1863
42850,66401,6487,31977,4477,59914,3710,1847,1863
42855,66407,6487,31978,4477,59920,3711,1847,1864
42860,66418,6488,31983,4478,59930,3712,1847,1865
42865,66422,6488,31985,4478,59934,3712,1847,1865
42870,66432,6489,31989,4479,59943,3712,1847,1865
42875,66438,6489,31992,4479,59949,3713,1848,1865
42880,66449,6490,31999,4480,59959,3714,1848,1866
42885,66453,6490,32000,4480,59963,3714,1848,1866
42890,66463,6492,32004,4480,59971,3714,1848,1866
42895,66469,6492,32007,4480,59977,3715,1849,1866
42900,66480,6494,32014,4482,59986,3716,1849,1867
42905,66484,6494,32017,4482,59990,3716,1849,1867
42910,66494,6494,32021,4482,60000,3716,1849,1867
42915,66500,6494,32021,4482,60006,3718,1849,1869
42920,66511,6494,32029,4482,60017,3718,1849,1869
42925,66515,6494,32032,4482,60021,3718,1849,1869
42930,66525,6494,32036,4482,60031,3718,1849,1869
42935,66531,6494,32038,4482,60037,3720,1849,1871
42940,66542,6494,32042,4482,60048,3720,1849,1871
42945,66546,6494,32042,4482,60052,3720,1849,1871
42950,66556,6494,32046,4482,60062,3720,1849,1871
42955,66562,6494,32048,4482,60068,3722,1850,1872
42960,66573,6496,32053,4483,60077,3722,1850,1872
42965,66577,6496,32056,4483,60081,3722,1850,1872
42970,66587,6496,32061,4483,60091,3722,1850,1872
42975,66593,6496,32064,4483,60097,3723,1851,1872
42980,66604,6497,32069,4483,60107,3723,1851,1872
42985,66608,6497,32071,4483,60111,3723,1851,1872
42990,66618,6497,32076,4483,60121,3723,1851,1872
42995,66624,6497,32079,4483,60127,3724,1851,1873
43000,66635,6498,32084,4484,60137,3724,1851,1873
43005,66639,6498,32087,4484,60141,3724,1851,1873
43010,66649,6500,32091,4486,60149,3724,1851,1873
43015,66655,6500,32095,4486,60154,3725,1851,1874
43020,66666,6504,32100,4489,60162,3726,1851,1875
43025,66670,6504,32101,4489,60166,3726,1851,1875
43030,66680,6505,32106,4489,60175,3726,1851,1875
43035,66686,6505,32111,4489,60181,3727,1852,1875
43040,66697,6508,32119,4492,60189,3727,1852,1875
43045,66701,6508,32120,4492,60193,3727,1852,1875
43050,66711,6509,32127,4492,60202,3727,1852,1875
43055,66717,6509,32129,4492,60208,3728,1853,1875
43060,66728,6513,32135,4495,60215,3728,1853,1875
43065,66732,6513,32135,4495,60219,3728,1853,1875
43070,66742,6514,32140,4495,60228,3728,1853,1875
43075,66748,6514,32144,4495,60234,3729,1854,1875
43080,66759,6515,32146,4496,60244,3729,1854,1875
43085,66763,6516,32148,4497,60247,3729,1854,1875
43090,66773,6517,32153,4498,60256,3729,1854,1875
43095,66779,6517,32157,4498,60262,3730,1855,1875
43100,66790,6518,32161,4498,60272,3730,1855,1875
43105,66794,6518,32163,4498,60276,3730,1855,1875
43110,66804,6519,32170,4499,60285,3730,1855,1875
43115,66810,6519,32173,4499,60291,3731,1855,1876
43120,66821,6520,32178,4499,60301,3731,1855,1876
43125,66825,6520,32179,4499,60305,3731,1855,1876
43130,66835,6522,32184,4501,60313,3731,1855,1876
43135,66841,6522,32189,4501,60319,3732,1856,1876
43140,66852,6525,32195,4503,60327,3733,1857,1876
43145,66856,6526,32197,4504,60330,3733,1857,1876
43150,66866,6528,32203,4505,60338,3733,1857,1876
43155,66872,6528,32206,4505,60344,3734,1858,1876
43160,66883,6529,32210,4506,60354,3734,1858,1876
43165,66887,6529,32212,4506,60358,3734,1858,1876
43170,66897,6531,32217,4508,60366,3734,1858,1876
43175,66903,6531,32221,4508,60372,3735,1858,1877
43180,66914,6532,32222,4508,60382,3735,1858,1877
43185,66918,6532,32224,4508,60386,3735,1858,1877
43190,66928,6534,32230,4510,60394,3735,1858,1877
43195,66934,6534,32232,4510,60400,3736,1858,1878
43200,66945,6538,32240,4514,60406,3736,1858,1878
43205,66949,6539,32241,4515,60410,3736,1858,1878
43210,66959,6540,32243,4516,60419,3736,1858,1878
43215,66965,6540,32246,4516,60425,3737,1859,1878
43220,66976,6542,32255,4517,60434,3737,1859,1878
43225,66980,6542,32257,4517,60438,3737,1859,1878
43230,66990,6543,32261,4518,60447,3737,1859,1878
43235,66996,6543,32263,4518,60453,3738,1859,1879
43240,67007,6545,32272,4520,60462,3738,1859,1879
43245,67011,6545,32273,4520,60466,3738,1859,1879
43250,67021,6546,32277,4520,60475,3738,1859,1879
43255,67027,6546,32280,4520,60481,3740,1859,1881
43260,67038,6549,32288,4522,60489,3741,1859,1882
43265,67042,6549,32290,4522,60493,3741,1859,1882
43270,67052,6550,32296,4523,60502,3741,1859,1882
43275,67058,6550,32300,4523,60508,3743,1861,1882
43280,67069,6550,32305,4523,60519,3743,1861,1882
43285,67073,6550,32308,4523,60523,3743,1861,1882
43290,67083,6551,32312,4524,60532,3743,1861,1882
43295,67089,6551,32315,4524,60538,3745,1861,1884
43300,67100,6551,32322,4524,60549,3745,1861,1884
43305,67104,6551,32323,4524,60553,3745,1861,1884
43310,67114,6553,32328,4525,60561,3745,1861,1884
43315,67120,6553,32329,4525,60567,3746,1862,1884
43320,67131,6555,32332,4527,60576,3746,1862,1884
43325,67135,6555,32333,4527,60580,3746,1862,1884
43330,67145,6557,32342,4529,60588,3746,1862,1884
43335,67151,6557,32345,4529,60594,3747,1863,1884
43340,67162,6558,32351,4530,60604,3747,1863,1884
43345,67166,6558,32354,4530,60608,3747,1863,1884
43350,67176,6560,32361,4531,60616,3747,1863,1884
43355,67182,6560,32364,4531,60622,3748,1864,1884
43360,67193,6563,32370,4534,60630,3748,1864,1884
43365,67197,6563,32372,4534,60634,3748,1864,1884
43370,67207,6565,32377,4534,60642,3748,1864,1884
43375,67213,6565,32378,4534,60648,3749,1864,1885
43380,67224,6566,32383,4535,60658,3750,1865,1885
43385,67228,6566,32384,4535,60662,3750,1865,1885
43390,67238,6567,32389,4535,60671,3750,1865,1885
43395,67244,6567,32391,4535,60677,3751,1865,1886
43400,67255,6569,32394,4537,60686,3752,1865,1887
43405,67259,6569,32398,4537,60690,3752,1865,1887
43410,67269,6570,32405,4538,60699,3752,1865,1887
43415,67275,6570,32406,4538,60705,3753,1865,1888
43420,67286,6571,32408,4538,60715,3754,1865,1889
43425,67290,6571,32410,4538,60719,3754,1865,1889
43430,67300,6572,32418,4538,60728,3754,1865,1889
43435,67306,6572,32422,4538,60734,3755,1866,1889
43440,67317,6573,32427,4539,60744,3756,1866,1890
43445,67321,6574,32429,4540,60747,3756,1866,1890
43450,67331,6575,32434,4541,60756,3756,1866,1890
43455,67337,6575,32437,4541,60762,3757,1866,1891
43460,67348,6577,32444,4543,60771,3758,1867,1891
43465,67352,6577,32447,4543,60775,3758,1867,1891
43470,67362,6578,32449,4543,60784,3758,1867,1891
43475,67368,6578,32453,4543,60790,3759,1868,1891
43480,67379,6579,32457,4543,60800,3760,1869,1891
43485,67383,6579,32457,4543,60804,3760,1869,1891
43490,67393,6581,32463,4544,60812,3760,1869,1891
43495,67399,6581,32466,4544,60817,3762,1870,1892
43500,67410,6584,32471,4546,60826,3763,1871,1892
43505,67414,6584,32472,4546,60830,3763,1871,1892
43510,67424,6584,32477,4546,60840,3763,1871,1892
43515,67430,6584,32479,4546,60846,3765,1871,1894
43520,67441,6585,32486,4546,60856,3765,1871,1894
43525,67445,6585,32487,4546,60860,3765,1871,1894
43530,67455,6585,32492,4546,60870,3765,1871,1894
43535,67461,6585,32495,4546,60876,3766,1872,1894
43540,67472,6586,32500,4546,60886,3766,1872,1894
43545,67476,6586,32502,4546,60890,3766,1872,1894
43550,67486,6586,32507,4546,60900,3766,1872,1894
43555,67492,6586,32511,4546,60906,3767,1873,1894
43560,67503,6587,32514,4546,60916,3767,1873,1894
43565,67507,6587,32515,4546,60920,3767,1873,1894
43570,67517,6587,32520,4546,60930,3767,1873,1894
43575,67523,6587,32523,4546,60936,3768,1874,1894
43580,67534,6588,32528,4547,60946,3768,1874,1894
43585,67538,6588,32530,4547,60950,3768,1874,1894
43590,67548,6588,32534,4547,60960,3768,1874,1894
43595,67554,6588,32537,4547,60966,3769,1874,1895
43600,67565,6589,32544,4547,60976,3769,1874,1895
43605,67569,6590,32546,4548,60979,3769,1874,1895
43610,67579,6592,32552,4549,60987,3769,1874,1895
43615,67585,6592,32556,4549,60992,3770,1875,1895
43620,67596,6596,32564,4553,61000,3770,1875,1895
43625,67600,6597,32565,4554,61003,3770,1875,1895
43630,67610,6597,32572,4554,61013,3770,1875,1895
43635,67616,6597,32576,4554,61019,3771,1875,1896
43640,67627,6599,32582,4556,61028,3771,1875,1896
43645,67631,6600,32586,4557,61031,3771,1875,1896
43650,67641,6600,32589,4557,61041,3771,1875,1896
43655,67647,6600,32593,4557,61047,3772,1876,1896
43660,67658,6602,32596,4558,61056,3772,1876,1896
43665,67662,6602,32597,4558,61060,3772,1876,1896
43670,67672,6602,32601,4558,61070,3772,1876,1896
43675,67678,6602,32605,4558,61076,3773,1876,1897
43680,67689,6604,32610,4560,61085,3773,1876,1897
43685,67693,6604,32612,4560,61089,3773,1876,1897
43690,67703,6604,32612,4560,61099,3773,1876,1897
43695,67709,6604,32615,4560,61105,3774,1876,1898
43700,67720,6604,32618,4560,61116,3774,1876,1898
43705,67724,6604,32620,4560,61120,3774,1876,1898
43710,67734,6604,32627,4560,61130,3774,1876,1898
43715,67740,6604,32632,4560,61136,3775,1876,1899
43720,67751,6604,32636,4560,61147,3775,1876,1899
43725,67755,6604,32638,4560,61151,3775,1876,1899
43730,67765,6606,32642,4561,61159,3775,1876,1899
43735,67771,6606,32645,4561,61165,3777,1877,1900
43740,67782,6606,32649,4561,61175,3778,1877,1901
43745,67786,6607,32651,4562,61179,3778,1877,1901
43750,67796,6609,32656,4564,61187,3778,1877,1901
43755,67802,6609,32659,4564,61193,3779,1878,1901
43760,67813,6611,32664,4566,61202,3779,1878,1901
43765,67817,6611,32665,4566,61206,3779,1878,1901
43770,67827,6613,32668,4567,61214,3779,1878,1901
43775,67833,6613,32672,4567,61220,3780,1879,1901
43780,67844,6613,32675,4567,61231,3780,1879,1901
43785,67848,6613,32678,4567,61235,3780,1879,1901
43790,67858,6615,32681,4568,61243,3780,1879,1901
43795,67864,6615,32684,4568,61249,3781,1879,1902
43800,67875,6616,32687,4569,61259,3781,1879,1902
43805,67879,6616,32690,4569,61263,3781,1879,1902
43810,67889,6618,32696,4570,61271,3781,1879,1902
43815,67895,6618,32698,4570,61277,3782,1880,1902
43820,67906,6620,32707,4572,61286,3782,1880,1902
43825,67910,6620,32709,4572,61290,3782,1880,1902
43830,67920,6622,32715,4573,61298,3782,1880,1902
43835,67926,6622,32718,4573,61304,3783,1880,1903
43840,67937,6623,32725,4574,61314,3783,1880,1903
43845,67941,6623,32726,4574,61318,3783,1880,1903
43850,67951,6625,32727,4574,61326,3783,1880,1903
43855,67957,6625,32730,4574,61331,3785,1880,1905
43860,67968,6627,32735,4575,61340,3786,1880,1906
43865,67972,6628,32736,4576,61344,3786,1880,1906
43870,67982,6629,32742,4576,61353,3786,1880,1906
43875,67988,6629,32745,4576,61359,3787,1881,1906
43880,67999,6631,32752,4577,61368,3788,1881,1907
43885,68003,6631,32754,4577,61372,3788,1881,1907
43890,68013,6632,32759,4577,61381,3788,1881,1907
43895,68019,6632,32764,4577,61387,3789,1882,1907
43900,68030,6634,32768,4579,61396,3790,1882,1908
43905,68034,6634,32770,4579,61400,3790,1882,1908
43910,68044,6635,32775,4579,61409,3790,1882,1908
43915,68050,6635,32777,4579,61415,3791,1882,1909
43920,68061,6637,32782,4580,61424,3792,1883,1909
43925,68065,6637,32784,4580,61428,3792,1883,1909
43930,68075,6639,32790,4581,61436,3792,1883,1909
43935,68081,6639,32792,4581,61441,3793,1883,1910
43940,68092,6641,32795,4583,61451,3793,1883,1910
43945,68096,6641,32797,4583,61455,3793,1883,1910
43950,68106,6643,32799,4583,61463,3793,1883,1910
43955,68112,6643,32802,4583,61468,3794,1883,1911
43960,68123,6646,32808,4586,61477,3794,1883,1911
43965,68127,6646,32811,4586,61481,3794,1883,1911
43970,68137,6648,32815,4587,61489,3794,1883,1911
43975,68143,6648,32817,4587,61494,3795,1883,1912
43980,68154,6651,32820,4589,61503,3795,1883,1912
43985,68158,6651,32822,4589,61507,3795,1883,1912
43990,68168,6651,32827,4589,61517,3795,1883,1912
43995,68174,6651,32832,4589,61523,3796,1884,1912
44000,68185,6651,32841,4589,61534,3796,1884,1912
44005,68189,6651,32842,4589,61538,3796,1884,1912
44010,68199,6651,32845,4589,61548,3796,1884,1912
44015,68205,6651,32846,4589,61554,3797,1884,1913
44020,68216,6651,32850,4589,61565,3797,1884,1913
44025,68220,6651,32852,4589,61569,3797,1884,1913
44030,68230,6651,32859,4589,61579,3797,1884,1913
44035,68236,6651,32860,4589,61585,3798,1884,1914
44040,68247,6651,32865,4589,61596,3798,1884,1914
44045,68251,6651,32868,4589,61600,3798,1884,1914
44050,68261,6651,32875,4589,61610,3798,1884,1914
44055,68267,6651,32877,4589,61616,3799,1884,1915
44060,68278,6651,32883,4589,61627,3799,1884,1915
44065,68282,6651,32884,4589,61631,3799,1884,1915
44070,68292,6651,32887,4589,61641,3799,1884,1915
44075,68298,6651,32888,4589,61647,3800,1884,1916
44080,68309,6651,32894,4589,61658,3800,1884,1916
44085,68313,6651,32896,4589,61662,3800,1884,1916
44090,68323,6653,32901,4590,61670,3800,1884,1916
44095,68329,6653,32903,4590,61675,3801,1884,1917
44100,68340,6658,32907,4594,61682,3801,1884,1917
44105,68344,6658,32909,4594,61686,3801,1884,1917
44110,68354,6659,32914,4595,61695,3801,1884,1917
44115,68360,6659,32916,4595,61701,3802,1884,1918
44120,68371,6660,32918,4595,61711,3803,1884,1919
44125,68375,6661,32920,4596,61714,3803,1884,1919
44130,68385,6662,32925,4596,61723,3803,1884,1919
44135,68391,6662,32927,4596,61729,3804,1885,1919
44140,68402,6664,32933,4598,61738,3805,1885,1920
44145,68406,6664,32936,4598,61742,3805,1885,1920
44150,68416,6665,32940,4598,61751,3805,1885,1920
44155,68422,6665,32941,4598,61757,3806,1886,1920
44160,68433,6667,32947,4600,61766,3807,1887,1920
44165,68437,6667,32951,4600,61770,3807,1887,1920
44170,68447,6668,32957,4601,61779,3807,1887,1920
44175,68453,6668,32961,4601,61785,3808,1888,1920
44180,68464,6669,32966,4602,61795,3808,1888,1920
44185,68468,6669,32968,4602,61799,3808,1888,1920
44190,68478,6670,32975,4603,61808,3808,1888,1920
44195,68484,6670,32978,4603,61814,3809,1889,1920
44200,68495,6671,32983,4604,61824,3809,1889,1920
44205,68499,6672,32984,4605,61827,3809,1889,1920
44210,68509,6674,32990,4607,61835,3809,1889,1920
44215,68515,6674,32994,4607,61840,3811,1891,1920
44220,68526,6677,32999,4609,61849,3811,1891,1920
44225,68530,6678,33001,4610,61852,3811,1891,1920
44230,68540,6680,33003,4610,61860,3811,1891,1920
44235,68546,6680,33006,4610,61866,3812,1891,1921
44240,68557,6682,33011,4611,61875,3813,1891,1922
44245,68561,6683,33012,4612,61878,3813,1891,1922
44250,68571,6685,33018,4612,61886,3813,1891,1922
44255,68577,6685,33019,4612,61892,3814,1891,1923
44260,68588,6686,33024,4613,61902,3814,1891,1923
44265,68592,6686,33024,4613,61906,3814,1891,1923
44270,68602,6688,33027,4613,61914,3814,1891,1923
44275,68608,6688,33031,4613,61920,3815,1891,1924
44280,68619,6689,33037,4614,61930,3815,1891,1924
44285,68623,6689,33039,4614,61934,3815,1891,1924
44290,68633,6691,33043,4615,61942,3815,1891,1924
44295,68639,6691,33047,4615,61948,3816,1892,1924
44300,68650,6693,33052,4616,61957,3816,1892,1924
44305,68654,6694,33055,4617,61960,3816,1892,1924
44310,68664,6696,33058,4617,61968,3816,1892,1924
44315,68670,6696,33063,4617,61974,3817,1893,1924
44320,68681,6698,33066,4618,61983,3817,1893,1924
44325,68685,6699,33068,4619,61986,3817,1893,1924
44330,68695,6701,33073,4621,61994,3817,1893,1924
44335,68701,6701,33077,4621,62000,3819,1895,1924
44340,68712,6705,33084,4624,62007,3819,1895,1924
44345,68716,6705,33088,4624,62011,3819,1895,1924
44350,68726,6706,33092,4624,62020,3819,1895,1924
44355,68732,6706,33097,4624,62025,3820,1896,1924
44360,68743,6707,33100,4625,62036,3821,1896,1925
44365,68747,6708,33103,4626,62039,3821,1896,1925
44370,68757,6709,33109,4627,62048,3821,1896,1925
44375,68763,6709,33112,4627,62053,3822,1896,1926
44380,68774,6710,33117,4628,62064,3823,1896,1927
44385,68778,6710,33119,4628,62068,3823,1896,1927
44390,68788,6711,33121,4628,62077,3823,1896,1927
44395,68794,6711,33123,4628,62082,3824,1896,1928
44400,68805,6712,33129,4629,62093,3825,1897,1928
44405,68809,6712,33131,4629,62097,3825,1897,1928
44410,68819,6712,33136,4629,62107,3825,1897,1928
44415,68825,6712,33138,4629,62113,3827,1899,1928
44420,68836,6712,33144,4629,62124,3827,1899,1928
44425,68840,6712,33146,4629,62128,3827,1899,1928
44430,68850,6712,33150,4629,62138,3827,1899,1928
44435,68856,6712,33152,4629,62144,3828,1899,1929
44440,68867,6712,33157,4629,62155,3828,1899,1929
44445,68871,6712,33159,4629,62159,3828,1899,1929
44450,68881,6713,33162,4630,62168,3828,1899,1929
44455,68887,6713,33165,4630,62173,3829,1900,1929
44460,68898,6718,33170,4634,62179,3829,1900,1929
44465,68902,6720,33172,4636,62182,3829,1900,1929
44470,68912,6722,33178,4638,62190,3829,1900,1929
44475,68918,6722,33180,4638,62196,3830,1901,1929
44480,68929,6723,33185,4639,62206,3830,1901,1929
44485,68933,6723,33187,4639,62210,3830,1901,1929
44490,68943,6725,33191,4639,62218,3830,1901,1929
44495,68949,6725,33193,4639,62224,3831,1901,1930
44500,68960,6726,33198,4640,62234,3831,1901,1930
44505,68964,6726,33199,4640,62238,3831,1901,1930
44510,68974,6728,33201,4641,62246,3831,1901,1930
44515,68980,6728,33202,4641,62252,3832,1901,1931
44520,68991,6729,33210,4642,62262,3832,1901,1931
44525,68995,6730,33212,4643,62265,3832,1901,1931
44530,69005,6732,33216,4643,62273,3832,1901,1931
44535,69011,6732,33217,4643,62279,3834,1902,1932
44540,69022,6734,33221,4645,62288,3835,1902,1933
44545,69026,6734,33223,4645,62292,3835,1902,1933
44550,69036,6736,33224,4645,62300,3835,1902,1933
44555,69042,6736,33227,4645,62306,3837,1903,1934
44560,69053,6737,33232,4646,62316,3838,1903,1935
44565,69057,6738,33235,4647,62319,3838,1903,1935
44570,69067,6740,33238,4648,62327,3838,1903,1935
44575,69073,6740,33240,4648,62333,3840,1903,1937
44580,69084,6742,33243,4650,62342,3841,1904,1937
44585,69088,6742,33245,4650,62346,3841,1904,1937
44590,69098,6742,33249,4650,62356,3841,1904,1937
44595,69104,6742,33251,4650,62362,3843,1904,1939
44600,69115,6743,33256,4651,62372,3843,1904,1939
44605,69119,6743,33258,4651,62376,3843,1904,1939
44610,69129,6743,33261,4651,62386,3843,1904,1939
44615,69135,6743,33264,4651,62392,3845,1904,1941
44620,69146,6745,33273,4653,62401,3845,1904,1941
44625,69150,6745,33276,4653,62405,3845,1904,1941
44630,69160,6745,33282,4653,62415,3845,1904,1941
44635,69166,6745,33286,4653,62421,3846,1904,1942
44640,69177,6746,33290,4653,62431,3846,1904,1942
44645,69181,6746,33290,4653,62435,3846,1904,1942
44650,69191,6746,33294,4653,62445,3846,1904,1942
44655,69197,6746,33297,4653,62451,3848,1905,1943
44660,69208,6748,33302,4654,62460,3848,1905,1943
44665,69212,6748,33304,4654,62464,3848,1905,1943
44670,69222,6748,33309,4654,62474,3848,1905,1943
44675,69228,6748,33314,4654,62480,3849,1906,1943
44680,69239,6750,33321,4656,62489,3849,1906,1943
44685,69243,6750,33324,4656,62493,3849,1906,1943
44690,69253,6752,33327,4657,62501,3849,1906,1943
44695,69259,6752,33329,4657,62507,3850,1906,1944
44700,69270,6753,33335,4657,62517,3851,1907,1944
44705,69274,6754,33336,4658,62520,3851,1907,1944
44710,69284,6756,33339,4658,62528,3851,1907,1944
44715,69290,6756,33340,4658,62534,3852,1907,1945
44720,69301,6758,33346,4659,62543,3853,1908,1945
44725,69305,6758,33346,4659,62547,3853,1908,1945
44730,69315,6760,33351,4659,62555,3853,1908,1945
44735,69321,6760,33353,4659,62561,3854,1908,1946
44740,69332,6762,33359,4661,62570,3855,1908,1947
44745,69336,6764,33362,4663,62572,3855,1908,1947
44750,69346,6766,33368,4664,62580,3855,1908,1947
44755,69352,6766,33371,4664,62586,3856,1909,1947
44760,69363,6768,33376,4665,62595,3857,1909,1948
44765,69367,6768,33379,4665,62599,3857,1909,1948
44770,69377,6769,33383,4666,62608,3857,1909,1948
44775,69383,6769,33384,4666,62614,3858,1909,1949
44780,69394,6770,33388,4666,62624,3859,1910,1949
44785,69398,6770,33391,4666,62628,3859,1910,1949
44790,69408,6771,33396,4667,62637,3859,1910,1949
44795,69414,6771,33399,4667,62643,3860,1911,1949
44800,69425,6772,33401,4668,62653,3861,1911,1950
44805,69429,6772,33402,4668,62657,3861,1911,1950
44810,69439,6773,33407,4668,62666,3861,1911,1950
44815,69445,6773,33411,4668,62672,3863,1912,1951
44820,69456,6777,33417,4671,62679,3864,1912,1952
44825,69460,6777,33417,4671,62683,3864,1912,1952
44830,69470,6778,33421,4671,62692,3864,1912,1952
44835,69476,6778,33423,4671,62698,3865,1912,1953
44840,69487,6779,33428,4671,62708,3865,1912,1953
44845,69491,6779,33430,4671,62712,3865,1912,1953
44850,69501,6780,33436,4671,62721,3865,1912,1953
44855,69507,6780,33441,4671,62727,3866,1913,1953
44860,69518,6781,33448,4672,62737,3866,1913,1953
44865,69522,6781,33450,4672,62741,3866,1913,1953
44870,69532,6782,33454,4673,62750,3866,1913,1953
44875,69538,6782,33456,4673,62756,3867,1914,1953
44880,69549,6783,33458,4673,62766,3867,1914,1953
44885,69553,6783,33459,4673,62770,3867,1914,1953
44890,69563,6784,33467,4674,62779,3867,1914,1953
44895,69569,6784,33470,4674,62785,3868,1914,1954
44900,69580,6785,33475,4675,62795,3868,1914,1954
44905,69584,6786,33476,4676,62798,3868,1914,1954
44910,69594,6787,33481,4677,62807,3868,1914,1954
44915,69600,6787,33483,4677,62813,3869,1914,1955
44920,69611,6788,33484,4677,62823,3869,1914,1955
44925,69615,6788,33486,4677,62827,3869,1914,1955
44930,69625,6790,33490,4677,62835,3869,1914,1955
44935,69631,6790,33493,4677,62841,3871,1914,1957
44940,69642,6792,33498,4679,62850,3872,1915,1957
44945,69646,6792,33502,4679,62854,3872,1915,1957
44950,69656,6793,33505,4679,62863,3872,1915,1957
44955,69662,6793,33508,4679,62869,3873,1916,1957
44960,69673,6794,33513,4680,62879,3873,1916,1957
44965,69677,6794,33516,4680,62883,3873,1916,1957
44970,69687,6795,33521,4680,62892,3873,1916,1957
44975,69693,6795,33524,4680,62897,3874,1916,1958
44980,69704,6797,33528,4682,62907,3874,1916,1958
44985,69708,6797,33531,4682,62911,3874,1916,1958
44990,69718,6798,33536,4682,62920,3874,1916,1958
44995,69724,6798,33538,4682,62926,3875,1917,1958
45000,69735,6799,33545,4683,62936,3875,1917,1958
45005,69739,6799,33546,4683,62940,3875,1917,1958
45010,69749,6799,33550,4683,62950,3875,1917,1958
45015,69755,6799,33553,4683,62956,3876,1918,1958
45020,69766,6799,33559,4683,62967,3876,1918,1958
45025,69770,6799,33559,4683,62971,3876,1918,1958
45030,69780,6799,33566,4683,62981,3876,1918,1958
45035,69786,6799,33570,4683,62987,3877,1919,1958
45040,69797,6799,33574,4683,62998,3877,1919,1958
45045,69801,6799,33576,4683,63002,3877,1919,1958
45050,69811,6800,33581,4683,63011,3877,1919,1958
45055,69817,6800,33584,4683,63017,3879,1920,1959
45060,69828,6802,33589,4685,63026,3880,1920,1960
45065,69832,6803,33590,4686,63029,3880,1920,1960
45070,69842,6804,33592,4686,63038,3880,1920,1960
45075,69848,6804,33596,4686,63044,3881,1921,1960
45080,69859,6806,33603,4688,63053,3882,1922,1960
45085,69863,6806,33604,4688,63057,3882,1922,1960
45090,69873,6807,33607,4688,63066,3882,1922,1960
45095,69879,6807,33612,4688,63072,3883,1923,1960
45100,69890,6808,33614,4688,63082,3884,1923,1961
45105,69894,6809,33617,4689,63085,3884,1923,1961
45110,69904,6811,33625,4691,63093,3884,1923,1961
45115,69910,6811,33629,4691,63099,3885,1923,1962
45120,69921,6812,33634,4692,63109,3886,1923,1963
45125,69925,6814,33636,4694,63111,3886,1923,1963
45130,69935,6816,33640,4695,63119,3886,1923,1963
45135,69941,6816,33644,4695,63125,3888,1924,1964
45140,69952,6817,33651,4696,63135,3888,1924,1964
45145,69956,6818,33653,4697,63138,3888,1924,1964
45150,69966,6820,33656,4698,63146,3888,1924,1964
45155,69972,6820,33661,4698,63152,3889,1925,1964
45160,69983,6822,33667,4699,63161,3889,1925,1964
45165,69987,6823,33671,4700,63164,3889,1925,1964
45170,69997,6825,33677,4700,63172,3889,1925,1964
45175,70003,6825,33681,4700,63177,3890,1925,1965
45180,70014,6829,33686,4703,63185,3890,1925,1965
45185,70018,6829,33687,4703,63189,3890,1925,1965
45190,70028,6831,33690,4704,63197,3890,1925,1965
45195,70034,6831,33693,4704,63203,3891,1925,1966
45200,70045,6832,33698,4704,63213,3891,1925,1966
45205,70049,6832,33702,4704,63217,3891,1925,1966
45210,70059,6834,33707,4705,63225,3891,1925,1966
45215,70065,6834,33711,4705,63231,3892,1926,1966
45220,70076,6835,33717,4706,63241,3892,1926,1966
45225,70080,6835,33718,4706,63245,3892,1926,1966
45230,70090,6837,33722,4708,63253,3892,1926,1966
45235,70096,6837,33725,4708,63259,3893,1927,1966
45240,70107,6841,33733,4711,63266,3894,1927,1967
45245,70111,6841,33735,4711,63270,3894,1927,1967
45250,70121,6842,33738,4712,63279,3894,1927,1967
45255,70127,6842,33739,4712,63285,3896,1927,1969
45260,70138,6845,33746,4714,63293,3897,1927,1970
45265,70142,6845,33748,4714,63297,3897,1927,1970
45270,70152,6846,33753,4715,63306,3897,1927,1970
45275,70158,6846,33756,4715,63312,3898,1927,1971
45280,70169,6847,33763,4715,63322,3899,1928,1971
45285,70173,6847,33765,4715,63326,3899,1928,1971
45290,70183,6848,33770,4715,63335,3899,1928,1971
45295,70189,6848,33771,4715,63341,3900,1928,1972
45300,70200,6849,33775,4716,63351,3901,1929,1972
45305,70204,6849,33777,4716,63355,3901,1929,1972
45310,70214,6850,33781,4717,63364,3901,1929,1972
45315,70220,6850,33783,4717,63370,3902,1929,1973
45320,70231,6852,33790,4718,63379,3902,1929,1973
45325,70235,6852,33791,4718,63383,3902,1929,1973
45330,70245,6853,33797,4719,63392,3902,1929,1973
45335,70251,6853,33799,4719,63398,3903,1930,1973
45340,70262,6855,33805,4721,63407,3903,1930,1973
45345,70266,6855,33805,4721,63411,3903,1930,1973
45350,70276,6857,33807,4721,63419,3903,1930,1973
45355,70282,6857,33810,4721,63425,3904,1930,1974
45360,70293,6859,33814,4722,63433,3904,1930,1974
45365,70297,6860,33815,4723,63437,3904,1930,1974
45370,70307,6861,33819,4724,63446,3904,1930,1974
45375,70313,6861,33821,4724,63452,3906,1932,1974
45380,70324,6862,33827,4725,63462,3906,1932,1974
45385,70328,6862,33829,4725,63466,3906,1932,1974
45390,70338,6863,33834,4726,63475,3906,1932,1974
45395,70344,6863,33835,4726,63481,3908,1932,1976
45400,70355,6863,33839,4726,63492,3908,1932,1976
45405,70359,6863,33841,4726,63496,3908,1932,1976
45410,70369,6864,33846,4727,63505,3908,1932,1976
45415,70375,6864,33851,4727,63511,3910,1934,1976
45420,70386,6864,33856,4727,63522,3911,1934,1977
45425,70390,6864,33858,4727,63526,3911,1934,1977
45430,70400,6865,33862,4728,63535,3911,1934,1977
45435,70406,6865,33865,4728,63541,3912,1935,1977
45440,70417,6866,33869,4729,63551,3913,1935,1978
45445,70421,6866,33872,4729,63555,3913,1935,1978
45450,70431,6867,33875,4729,63564,3913,1935,1978
45455,70437,6867,33877,4729,63570,3914,1935,1979
45460,70448,6867,33884,4729,63581,3915,1936,1979
45465,70452,6867,33887,4729,63585,3915,1936,1979
45470,70462,6869,33891,4730,63593,3915,1936,1979
45475,70468,6869,33892,4730,63598,3916,1936,1980
45480,70479,6872,33899,4732,63607,3916,1936,1980
45485,70483,6872,33899,4732,63611,3916,1936,1980
45490,70493,6873,33906,4733,63620,3916,1936,1980
45495,70499,6873,33909,4733,63626,3918,1937,1981
45500,70510,6874,33912,4733,63636,3918,1937,1981
45505,70514,6875,33914,4734,63639,3918,1937,1981
45510,70524,6876,33918,4734,63648,3918,1937,1981
45515,70530,6876,33921,4734,63654,3919,1937,1982
45520,70541,6878,33929,4735,63663,3919,1937,1982
45525,70545,6879,33931,4736,63666,3919,1937,1982
45530,70555,6880,33936,4737,63675,3919,1937,1982
45535,70561,6880,33940,4737,63681,3920,1937,1983
45540,70572,6881,33945,4738,63691,3920,1937,1983
45545,70576,6882,33946,4739,63694,3920,1937,1983
45550,70586,6883,33951,4739,63703,3920,1937,1983
45555,70592,6883,33954,4739,63709,3921,1937,1984
45560,70603,6885,33961,4741,63718,3921,1937,1984
45565,70607,6885,33962,4741,63722,3921,1937,1984
45570,70617,6886,33968,4742,63731,3921,1937,1984
45575,70623,6886,33971,4742,63737,3922,1937,1985
45580,70634,6887,33975,4743,63747,3922,1937,1985
45585,70638,6887,33975,4743,63751,3922,1937,1985
45590,70648,6889,33980,4744,63759,3922,1937,1985
45595,70654,6889,33981,4744,63765,3923,1938,1985
45600,70665,6892,33986,4746,63772,3924,1938,1986
45605,70669,6894,33987,4748,63775,3924,1938,1986
45610,70679,6894,33991,4748,63785,3924,1938,1986
45615,70685,6894,33993,4748,63791,3926,1940,1986
45620,70696,6894,33998,4748,63802,3927,1940,1987
45625,70700,6894,34000,4748,63806,3927,1940,1987
45630,70710,6894,34006,4748,63816,3927,1940,1987
45635,70716,6894,34008,4748,63822,3929,1940,1989
45640,70727,6894,34011,4748,63833,3930,1941,1989
45645,70731,6894,34014,4748,63837,3930,1941,1989
45650,70741,6894,34017,4748,63847,3930,1941,1989
45655,70747,6894,34019,4748,63853,3932,1942,1990
45660,70758,6894,34023,4748,63864,3932,1942,1990
45665,70762,6894,34026,4748,63868,3932,1942,1990
45670,70772,6895,34031,4749,63877,3932,1942,1990
45675,70778,6895,34035,4749,63883,3933,1942,1991
45680,70789,6895,34041,4749,63894,3933,1942,1991
45685,70793,6895,34043,4749,63898,3933,1942,1991
45690,70803,6896,34044,4749,63907,3933,1942,1991
45695,70809,6896,34048,4749,63913,3934,1943,1991
45700,70820,6896,34054,4749,63924,3934,1943,1991
45705,70824,6896,34057,4749,63928,3934,1943,1991
45710,70834,6897,34063,4749,63937,3934,1943,1991
45715,70840,6897,34066,4749,63943,3935,1944,1991
45720,70851,6899,34073,4751,63952,3935,1944,1991
45725,70855,6901,34076,4753,63954,3935,1944,1991
45730,70865,6903,34082,4754,63962,3935,1944,1991
45735,70871,6903,34085,4754,63968,3936,1944,1992
45740,70882,6904,34090,4755,63978,3937,1945,1992
45745,70886,6906,34094,4757,63980,3937,1945,1992
45750,70896,6908,34098,4757,63988,3937,1945,1992
45755,70902,6908,34101,4757,63994,3938,1946,1992
45760,70913,6910,34104,4759,64003,3939,1946,1993
45765,70917,6912,34106,4761,64005,3939,1946,1993
45770,70927,6914,34110,4763,64013,3939,1946,1993
45775,70933,6914,34114,4763,64019,3941,1948,1993
45780,70944,6917,34122,4765,64027,3942,1949,1993
45785,70948,6917,34123,4765,64031,3942,1949,1993
45790,70958,6918,34128,4766,64040,3942,1949,1993
45795,70964,6918,34129,4766,64046,3944,1950,1994
45800,70975,6921,34136,4769,64054,3944,1950,1994
45805,70979,6922,34139,4770,64057,3944,1950,1994
45810,70989,6923,34144,4770,64066,3944,1950,1994
45815,70995,6923,34147,4770,64072,3946,1951,1995
45820,71006,6925,34153,4772,64081,3946,1951,1995
45825,71010,6926,34154,4773,64084,3946,1951,1995
45830,71020,6927,34157,4773,64093,3946,1951,1995
45835,71026,6927,34160,4773,64099,3948,1952,1996
45840,71037,6929,34164,4774,64108,3948,1952,1996
45845,71041,6929,34167,4774,64112,3948,1952,1996
45850,71051,6930,34173,4775,64121,3948,1952,1996
45855,71057,6930,34176,4775,64127,3949,1952,1997
45860,71068,6930,34180,4775,64138,3949,1952,1997
45865,71072,6930,34182,4775,64142,3949,1952,1997
45870,71082,6931,34187,4775,64151,3949,1952,1997
45875,71088,6931,34188,4775,64157,3950,1952,1998
45880,71099,6933,34192,4777,64166,3950,1952,1998
45885,71103,6933,34194,4777,64170,3950,1952,1998
45890,71113,6934,34198,4777,64179,3950,1952,1998
45895,71119,6934,34201,4777,64185,3951,1953,1998
45900,71130,6935,34206,4778,64195,3952,1954,1998
45905,71134,6936,34209,4779,64198,3952,1954,1998
45910,71144,6937,34217,4780,64207,3952,1954,1998
45915,71150,6937,34221,4780,64213,3954,1955,1999
45920,71161,6937,34228,4780,64224,3954,1955,1999
45925,71165,6937,34231,4780,64228,3954,1955,1999
45930,71175,6938,34236,4780,64237,3954,1955,1999
45935,71181,6938,34238,4780,64243,3955,1956,1999
45940,71192,6938,34242,4780,64254,3955,1956,1999
45945,71196,6938,34244,4780,64258,3955,1956,1999
45950,71206,6940,34250,4780,64266,3955,1956,1999
45955,71212,6940,34255,4780,64271,3956,1957,1999
45960,71223,6942,34261,4782,64280,3956,1957,1999
45965,71227,6943,34262,4783,64284,3956,1957,1999
45970,71237,6944,34265,4783,64293,3956,1957,1999
45975,71243,6944,34266,4783,64299,3957,1957,2000
45980,71254,6946,34273,4784,64308,3957,1957,2000
45985,71258,6947,34277,4785,64311,3957,1957,2000
45990,71268,6948,34283,4785,64320,3957,1957,2000
45995,71274,6948,34286,4785,64326,3958,1958,2000
46000,71285,6952,34293,4788,64333,3958,1958,2000
46005,71289,6953,34296,4789,64336,3958,1958,2000
46010,71299,6954,34300,4789,64345,3958,1958,2000
46015,71305,6954,34302,4789,64351,3959,1959,2000
46020,71316,6956,34308,4790,64360,3960,1960,2000
46025,71320,6956,34308,4790,64364,3960,1960,2000
46030,71330,6956,34313,4790,64374,3960,1960,2000
46035,71336,6956,34317,4790,64380,3962,1962,2000
46040,71347,6956,34321,4790,64391,3962,1962,2000
46045,71351,6956,34324,4790,64395,3962,1962,2000
46050,71361,6956,34331,4790,64405,3962,1962,2000
46055,71367,6956,34334,4790,64411,3964,1964,2000
46060,71378,6956,34339,4790,64422,3964,1964,2000
46065,71382,6956,34341,4790,64426,3964,1964,2000
46070,71392,6956,34344,4790,64436,3964,1964,2000
46075,71398,6956,34348,4790,64442,3966,1964,2002
46080,71409,6956,34351,4790,64453,3966,1964,2002
46085,71413,6956,34352,4790,64457,3966,1964,2002
46090,71423,6956,34354,4790,64467,3966,1964,2002
46095,71429,6956,34355,4790,64473,3967,1964,2003
46100,71440,6956,34361,4790,64484,3967,1964,2003
46105,71444,6956,34363,4790,64488,3967,1964,2003
46110,71454,6956,34367,4790,64498,3967,1964,2003
46115,71460,6956,34371,4790,64504,3968,1965,2003
46120,71471,6956,34376,4790,64515,3968,1965,2003
46125,71475,6956,34377,4790,64519,3968,1965,2003
46130,71485,6958,34382,4791,64527,3968,1965,2003
46135,71491,6958,34385,4791,64532,3969,1965,2004
46140,71502,6961,34391,4794,64540,3969,1965,2004
46145,71506,6962,34393,4795,64544,3969,1965,2004
46150,71516,6963,34398,4796,64553,3969,1965,2004
46155,71522,6963,34402,4796,64559,3970,1966,2004
46160,71533,6965,34409,4797,64568,3971,1967,2004
46165,71537,6965,34411,4797,64572,3971,1967,2004
46170,71547,6966,34413,4797,64581,3971,1967,2004
46175,71553,6966,34414,4797,64587,3972,1967,2005
46180,71564,6968,34424,4799,64596,3973,1968,2005
46185,71568,6969,34426,4800,64599,3973,1968,2005
46190,71578,6970,34430,4801,64608,3973,1968,2005
46195,71584,6970,34431,4801,64614,3975,1969,2006
46200,71595,6971,34435,4801,64624,3976,1969,2007
46205,71599,6971,34437,4801,64628,3976,1969,2007
46210,71609,6972,34445,4802,64637,3976,1969,2007
46215,71615,6972,34450,4802,64643,3977,1970,2007
46220,71626,6973,34456,4803,64653,3977,1970,2007
46225,71630,6973,34457,4803,64657,3977,1970,2007
46230,71640,6974,34460,4804,64666,3977,1970,2007
46235,71646,6974,34461,4804,64672,3978,1970,2008
46240,71657,6976,34467,4806,64681,3978,1970,2008
46245,71661,6976,34470,4806,64685,3978,1970,2008
46250,71671,6977,34473,4806,64694,3978,1970,2008
46255,71677,6977,34475,4806,64700,3979,1970,2009
46260,71688,6979,34481,4808,64709,3979,1970,2009
46265,71692,6979,34483,4808,64713,3979,1970,2009
46270,71702,6979,34486,4808,64723,3979,1970,2009
46275,71708,6979,34489,4808,64729,3980,1971,2009
46280,71719,6980,34494,4808,64739,3980,1971,2009
46285,71723,6980,34497,4808,64743,3980,1971,2009
46290,71733,6980,34500,4808,64753,3980,1971,2009
46295,71739,6980,34501,4808,64759,3981,1971,2010
46300,71750,6982,34506,4810,64768,3981,1971,2010
46305,71754,6982,34507,4810,64772,3981,1971,2010
46310,71764,6983,34510,4810,64781,3981,1971,2010
46315,71770,6983,34513,4810,64787,3983,1973,2010
46320,71781,6985,34519,4812,64796,3984,1973,2011
46325,71785,6987,34522,4814,64798,3984,1973,2011
46330,71795,6988,34527,4814,64807,3984,1973,2011
46335,71801,6988,34529,4814,64813,3985,1973,2012
46340,71812,6989,34532,4814,64823,3986,1973,2013
46345,71816,6989,34534,4814,64827,3986,1973,2013
46350,71826,6990,34540,4815,64836,3986,1973,2013
46355,71832,6990,34542,4815,64841,3987,1973,2014
46360,71843,6992,34549,4816,64850,3987,1973,2014
46365,71847,6993,34550,4817,64854,3987,1973,2014
46370,71857,6994,34554,4817,64863,3987,1973,2014
46375,71863,6994,34556,4817,64868,3988,1973,2015
46380,71874,6997,34562,4820,64877,3988,1973,2015
46385,71878,6998,34565,4821,64880,3988,1973,2015
46390,71888,6999,34569,4822,64889,3988,1973,2015
46395,71894,6999,34573,4822,64895,3989,1974,2015
46400,71905,7000,34579,4822,64905,3989,1974,2015
46405,71909,7000,34580,4822,64909,3989,1974,2015
46410,71919,7001,34585,4822,64918,3989,1974,2015
46415,71925,7001,34587,4822,64924,3990,1974,2016
46420,71936,7003,34594,4824,64933,3990,1974,2016
46425,71940,7003,34595,4824,64937,3990,1974,2016
46430,71950,7005,34599,4825,64945,3990,1974,2016
46435,71956,7005,34602,4825,64951,3992,1975,2017
46440,71967,7008,34608,4827,64959,3992,1975,2017
46445,71971,7008,34611,4827,64963,3992,1975,2017
46450,71981,7010,34618,4829,64971,3992,1975,2017
46455,71987,7010,34621,4829,64977,3993,1976,2017
46460,71998,7011,34623,4829,64987,3994,1976,2018
46465,72002,7012,34624,4830,64990,3994,1976,2018
46470,72012,7014,34628,4832,64998,3994,1976,2018
46475,72018,7014,34630,4832,65004,3995,1977,2018
46480,72029,7015,34634,4833,65014,3996,1977,2019
46485,72033,7016,34635,4834,65017,3996,1977,2019
46490,72043,7018,34641,4835,65025,3996,1977,2019
46495,72049,7018,34643,4835,65031,3997,1978,2019
46500,72060,7020,34647,4836,65040,3998,1978,2020
46505,72064,7020,34649,4836,65044,3998,1978,2020
46510,72074,7022,34652,4837,65052,3998,1978,2020
46515,72080,7022,34655,4837,65058,4000,1978,2022
46520,72091,7024,34663,4839,65067,4001,1978,2023
46525,72095,7024,34664,4839,65071,4001,1978,2023
46530,72105,7026,34670,4840,65079,4001,1978,2023
46535,72111,7026,34671,4840,65085,4002,1979,2023
46540,72122,7027,34677,4840,65095,4003,1979,2024
46545,72126,7028,34680,4841,65098,4003,1979,2024
46550,72136,7030,34684,4841,65106,4003,1979,2024
46555,72142,7030,34685,4841,65112,4004,1979,2025
46560,72153,7032,34689,4843,65121,4005,1979,2026
46565,72157,7032,34693,4843,65125,4005,1979,2026
46570,72167,7032,34698,4843,65135,4005,1979,2026
46575,72173,7032,34700,4843,65141,4006,1979,2027
46580,72184,7032,34707,4843,65152,4006,1979,2027
46585,72188,7032,34708,4843,65156,4006,1979,2027
46590,72198,7032,34714,4843,65166,4006,1979,2027
46595,72204,7032,34717,4843,65172,4007,1980,2027
46600,72215,7032,34722,4843,65183,4007,1980,2027
46605,72219,7032,34723,4843,65187,4007,1980,2027
46610,72229,7032,34728,4843,65197,4007,1980,2027
46615,72235,7032,34730,4843,65203,4008,1980,2028
46620,72246,7032,34736,4843,65214,4008,1980,2028
46625,72250,7032,34738,4843,65218,4008,1980,2028
46630,72260,7032,34744,4843,65228,4008,1980,2028
46635,72266,7032,34747,4843,65234,4010,1981,2029
46640,72277,7032,34752,4843,65245,4010,1981,2029
46645,72281,7032,34755,4843,65249,4010,1981,2029
46650,72291,7032,34758,4843,65259,4010,1981,2029
46655,72297,7032,34763,4843,65265,4012,1983,2029
46660,72308,7032,34770,4843,65276,4012,1983,2029
46665,72312,7032,34774,4843,65280,4012,1983,2029
46670,72322,7033,34782,4844,65289,4012,1983,2029
46675,72328,7033,34783,4844,65295,4014,1983,2031
46680,72339,7035,34788,4846,65304,4015,1983,2032
46685,72343,7035,34788,4846,65308,4015,1983,2032
46690,72353,7037,34793,4848,65316,4015,1983,2032
46695,72359,7037,34794,4848,65322,4016,1983,2033
46700,72370,7038,34799,4849,65332,4016,1983,2033
46705,72374,7039,34803,4850,65335,4016,1983,2033
46710,72384,7041,34810,4851,65343,4016,1983,2033
46715,72390,7041,34813,4851,65349,4017,1984,2033
46720,72401,7043,34818,4853,65358,4017,1984,2033
46725,72405,7043,34820,4853,65362,4017,1984,2033
46730,72415,7045,34825,4853,65370,4017,1984,2033
46735,72421,7045,34828,4853,65376,4018,1984,2034
46740,72432,7048,34834,4856,65384,4018,1984,2034
46745,72436,7048,34835,4856,65388,4018,1984,2034
46750,72446,7050,34840,4857,65396,4018,1984,2034
46755,72452,7050,34842,4857,65402,4019,1984,2035
46760,72463,7051,34849,4857,65412,4019,1984,2035
46765,72467,7052,34851,4858,65415,4019,1984,2035
46770,72477,7054,34858,4859,65423,4019,1984,2035
46775,72483,7054,34862,4859,65429,4020,1985,2035
46780,72494,7056,34867,4861,65438,4020,1985,2035
46785,72498,7056,34869,4861,65442,4020,1985,2035
46790,72508,7058,34874,4861,65450,4020,1985,2035
46795,72514,7058,34878,4861,65455,4022,1986,2036
46800,72525,7061,34886,4863,65464,4023,1987,2036
46805,72529,7061,34888,4863,65468,4023,1987,2036
46810,72539,7061,34894,4863,65478,4023,1987,2036
46815,72545,7061,34896,4863,65484,4024,1987,2037
46820,72556,7063,34902,4864,65493,4024,1987,2037
46825,72560,7063,34904,4864,65497,4024,1987,2037
46830,72570,7063,34907,4864,65507,4024,1987,2037
46835,72576,7063,34911,4864,65513,4025,1988,2037
46840,72587,7064,34914,4864,65523,4025,1988,2037
46845,72591,7064,34915,4864,65527,4025,1988,2037
46850,72601,7064,34919,4864,65537,4025,1988,2037
46855,72607,7064,34923,4864,65543,4026,1989,2037
46860,72618,7065,34927,4865,65553,4026,1989,2037
46865,72622,7065,34928,4865,65557,4026,1989,2037
46870,72632,7065,34931,4865,65567,4026,1989,2037
46875,72638,7065,34935,4865,65573,4027,1989,2038
46880,72649,7067,34942,4867,65582,4027,1989,2038
46885,72653,7067,34944,4867,65586,4027,1989,2038
46890,72663,7067,34949,4867,65596,4027,1989,2038
46895,72669,7067,34953,4867,65602,4028,1989,2039
46900,72680,7068,34955,4867,65612,4028,1989,2039
46905,72684,7068,34958,4867,65616,4028,1989,2039
46910,72694,7070,34965,4869,65624,4028,1989,2039
46915,72700,7070,34969,4869,65630,4029,1990,2039
46920,72711,7074,34976,4872,65637,4030,1991,2039
46925,72715,7074,34978,4872,65641,4030,1991,2039
46930,72725,7076,34985,4873,65649,4030,1991,2039
46935,72731,7076,34988,4873,65655,4031,1991,2040
46940,72742,7078,34996,4875,65664,4031,1991,2040
46945,72746,7078,34999,4875,65668,4031,1991,2040
46950,72756,7080,35004,4876,65676,4031,1991,2040
46955,72762,7080,35006,4876,65682,4032,1991,2041
46960,72773,7081,35012,4877,65692,4032,1991,2041
46965,72777,7081,35015,4877,65696,4032,1991,2041
46970,72787,7083,35024,4879,65704,4032,1991,2041
46975,72793,7083,35027,4879,65710,4033,1992,2041
46980,72804,7085,35034,4881,65719,4033,1992,2041
46985,72808,7085,35037,4881,65723,4033,1992,2041
46990,72818,7087,35040,4881,65731,4033,1992,2041
46995,72824,7087,35042,4881,65737,4034,1992,2042
47000,72835,7088,35048,4882,65747,4034,1992,2042
47005,72839,7088,35051,4882,65751,4034,1992,2042
47010,72849,7090,35056,4883,65759,4034,1992,2042
47015,72855,7090,35058,4883,65765,4035,1993,2042
47020,72866,7092,35063,4885,65774,4035,1993,2042
47025,72870,7093,35065,4886,65777,4035,1993,2042
47030,72880,7095,35070,4887,65785,4035,1993,2042
47035,72886,7095,35071,4887,65790,4037,1993,2044
47040,72897,7099,35077,4890,65798,4038,1993,2045
47045,72901,7099,35079,4890,65802,4038,1993,2045
47050,72911,7100,35084,4890,65811,4038,1993,2045
47055,72917,7100,35088,4890,65816,4039,1993,2046
47060,72928,7104,35096,4894,65824,4040,1994,2046
47065,72932,7104,35098,4894,65828,4040,1994,2046
47070,72942,7105,35101,4895,65837,4040,1994,2046
47075,72948,7105,35103,4895,65843,4041,1995,2046
47080,72959,7107,35107,4896,65852,4042,1995,2047
47085,72963,7107,35109,4896,65856,4042,1995,2047
47090,72973,7108,35111,4897,65865,4042,1995,2047
47095,72979,7108,35116,4897,65870,4043,1996,2047
47100,72990,7112,35122,4900,65878,4044,1996,2048
47105,72994,7112,35123,4900,65882,4044,1996,2048
47110,73004,7112,35129,4900,65892,4044,1996,2048
47115,73010,7112,35129,4900,65898,4045,1996,2049
47120,73021,7113,35135,4901,65908,4046,1997,2049
47125,73025,7113,35136,4901,65912,4046,1997,2049
47130,73035,7113,35140,4901,65922,4046,1997,2049
47135,73041,7113,35144,4901,65928,4047,1998,2049
47140,73052,7114,35152,4902,65938,4048,1999,2049
47145,73056,7114,35155,4902,65942,4048,1999,2049
47150,73066,7115,35159,4903,65951,4048,1999,2049
47155,73072,7115,35162,4903,65957,4050,2000,2050
47160,73083,7116,35165,4904,65967,4051,2000,2051
47165,73087,7116,35165,4904,65971,4051,2000,2051
47170,73097,7117,35172,4904,65980,4051,2000,2051
47175,73103,7117,35174,4904,65986,4053,2001,2052
47180,73114,7118,35179,4904,65995,4053,2001,2052
47185,73118,7119,35180,4905,65999,4053,2001,2052
47190,73128,7120,35186,4906,66008,4053,2001,2052
47195,73134,7120,35189,4906,66013,4055,2002,2053
47200,73145,7123,35194,4909,66022,4055,2002,2053
47205,73149,7123,35196,4909,66026,4055,2002,2053
47210,73159,7125,35200,4911,66034,4055,2002,2053
47215,73165,7125,35204,4911,66040,4057,2003,2054
47220,73176,7128,35211,4914,66047,4057,2003,2054
47225,73180,7129,35213,4915,66051,4057,2003,2054
47230,73190,7131,35216,4915,66059,4057,2003,2054
47235,73196,7131,35219,4915,66065,4059,2004,2055
47240,73207,7132,35226,4916,66075,4059,2004,2055
47245,73211,7132,35227,4916,66079,4059,2004,2055
47250,73221,7134,35231,4916,66087,4059,2004,2055
47255,73227,7134,35234,4916,66093,4060,2005,2055
47260,73238,7135,35239,4917,66103,4060,2005,2055
47265,73242,7135,35241,4917,66107,4060,2005,2055
47270,73252,7137,35247,4919,66115,4060,2005,2055
47275,73258,7137,35248,4919,66121,4061,2005,2056
47280,73269,7139,35254,4920,66130,4062,2006,2056
47285,73273,7139,35256,4920,66134,4062,2006,2056
47290,73283,7141,35262,4921,66142,4062,2006,2056
47295,73289,7141,35265,4921,66148,4063,2006,2057
47300,73300,7142,35268,4921,66158,4064,2006,2058
47305,73304,7142,35270,4921,66162,4064,2006,2058
47310,73314,7144,35276,4922,66170,4064,2006,2058
47315,73320,7144,35279,4922,66176,4065,2006,2059
47320,73331,7146,35283,4923,66185,4066,2006,2060
47325,73335,7147,35286,4924,66188,4066,2006,2060
47330,73345,7149,35292,4926,66196,4066,2006,2060
47335,73351,7149,35294,4926,66202,4067,2007,2060
47340,73362,7151,35301,4928,66211,4068,2008,2060
47345,73366,7152,35303,4929,66214,4068,2008,2060
47350,73376,7153,35307,4930,66223,4068,2008,2060
47355,73382,7153,35308,4930,66229,4069,2009,2060
47360,73393,7155,35316,4932,66238,4069,2009,2060
47365,73397,7155,35318,4932,66242,4069,2009,2060
47370,73407,7156,35321,4933,66251,4069,2009,2060
47375,73413,7156,35324,4933,66257,4071,2011,2060
47380,73424,7157,35328,4933,66267,4071,2011,2060
47385,73428,7157,35329,4933,66271,4071,2011,2060
47390,73438,7158,35333,4933,66280,4071,2011,2060
47395,73444,7158,35338,4933,66286,4073,2013,2060
47400,73455,7159,35343,4934,66296,4073,2013,2060
47405,73459,7159,35345,4934,66300,4073,2013,2060
47410,73469,7160,35350,4934,66309,4073,2013,2060
47415,73475,7160,35354,4934,66315,4074,2014,2060
47420,73486,7161,35359,4934,66325,4075,2014,2061
47425,73490,7162,35362,4935,66328,4075,2014,2061
47430,73500,7163,35367,4936,66337,4075,2014,2061
47435,73506,7163,35371,4936,66343,4076,2015,2061
47440,73517,7164,35376,4937,66353,4077,2016,2061
47445,73521,7165,35378,4938,66356,4077,2016,2061
47450,73531,7167,35382,4939,66364,4077,2016,2061
47455,73537,7167,35386,4939,66370,4078,2016,2062
47460,73548,7171,35396,4943,66376,4079,2017,2062
47465,73552,7172,35399,4944,66380,4079,2017,2062
47470,73562,7173,35404,4944,66389,4079,2017,2062
47475,73568,7173,35405,4944,66395,4080,2017,2063
47480,73579,7174,35412,4945,66405,4080,2017,2063
47485,73583,7174,35414,4945,66409,4080,2017,2063
47490,73593,7175,35419,4946,66418,4080,2017,2063
47495,73599,7175,35422,4946,66424,4081,2017,2064
47500,73610,7177,35428,4948,66433,4081,2017,2064
47505,73614,7177,35430,4948,66437,4081,2017,2064
47510,73624,7178,35436,4948,66446,4081,2017,2064
47515,73630,7178,35438,4948,66452,4082,2018,2064
47520,73641,7180,35446,4950,66461,4082,2018,2064
47525,73645,7181,35449,4951,66464,4082,2018,2064
47530,73655,7183,35452,4951,66472,4082,2018,2064
47535,73661,7183,35457,4951,66478,4083,2019,2064
47540,73672,7186,35463,4953,66486,4084,2020,2064
47545,73676,7187,35465,4954,66489,4084,2020,2064
47550,73686,7189,35471,4955,66497,4084,2020,2064
47555,73692,7189,35471,4955,66503,4085,2020,2065
47560,73703,7191,35475,4956,66512,4086,2020,2066
47565,73707,7192,35476,4957,66515,4086,2020,2066
47570,73717,7194,35480,4959,66523,4086,2020,2066
47575,73723,7194,35482,4959,66529,4088,2021,2067
47580,73734,7197,35487,4962,66536,4089,2022,2067
47585,73738,7198,35490,4963,66540,4089,2022,2067
47590,73748,7198,35493,4963,66550,4089,2022,2067
47595,73754,7198,35498,4963,66556,4091,2023,2068
47600,73765,7198,35501,4963,66567,4091,2023,2068
47605,73769,7198,35502,4963,66571,4091,2023,2068
47610,73779,7198,35505,4963,66581,4091,2023,2068
47615,73785,7198,35508,4963,66587,4092,2023,2069
47620,73796,7198,35514,4963,66598,4092,2023,2069
47625,73800,7198,35517,4963,66602,4092,2023,2069
47630,73810,7198,35523,4963,66612,4092,2023,2069
47635,73816,7198,35526,4963,66618,4093,2024,2069
47640,73827,7198,35531,4963,66629,4093,2024,2069
47645,73831,7198,35535,4963,66633,4093,2024,2069
47650,73841,7199,35539,4963,66642,4093,2024,2069
47655,73847,7199,35542,4963,66648,4094,2024,2070
47660,73858,7199,35546,4963,66658,4094,2024,2070
47665,73862,7200,35546,4964,66662,4094,2024,2070
47670,73872,7201,35548,4965,66671,4094,2024,2070
47675,73878,7201,35553,4965,66676,4095,2025,2070
47680,73889,7204,35561,4968,66685,4095,2025,2070
47685,73893,7204,35563,4968,66689,4095,2025,2070
47690,73903,7206,35566,4968,66697,4095,2025,2070
47695,73909,7206,35570,4968,66702,4096,2026,2070
47700,73920,7209,35575,4971,66710,4097,2027,2070
47705,73924,7210,35577,4972,66714,4097,2027,2070
47710,73934,7211,35583,4973,66723,4097,2027,2070
47715,73940,7211,35585,4973,66729,4098,2028,2070
47720,73951,7213,35589,4974,66738,4099,2029,2070
47725,73955,7213,35590,4974,66742,4099,2029,2070
47730,73965,7214,35594,4974,66751,4099,2029,2070
47735,73971,7214,35596,4974,66757,4100,2030,2070
47740,73982,7216,35601,4975,66766,4101,2030,2071
47745,73986,7216,35604,4975,66770,4101,2030,2071
47750,73996,7217,35610,4976,66779,4101,2030,2071
47755,74002,7217,35614,4976,66785,4102,2030,2072
47760,74013,7219,35617,4977,66794,4103,2030,2073
47765,74017,7219,35619,4977,66798,4103,2030,2073
47770,74027,7221,35625,4978,66806,4103,2030,2073
47775,74033,7221,35629,4978,66811,4104,2030,2074
47780,74044,7224,35636,4981,66820,4105,2031,2074
47785,74048,7225,35638,4982,66823,4105,2031,2074
47790,74058,7227,35641,4983,66831,4105,2031,2074
47795,74064,7227,35644,4983,66836,4106,2031,2075
47800,74075,7230,35651,4986,66845,4107,2031,2076
47805,74079,7232,35653,4988,66847,4107,2031,2076
47810,74089,7234,35660,4989,66855,4107,2031,2076
47815,74095,7234,35660,4989,66861,4109,2031,2078
47820,74106,7238,35665,4993,66868,4110,2031,2079
47825,74110,7238,35666,4993,66872,4110,2031,2079
47830,74120,7238,35671,4993,66882,4110,2031,2079
47835,74126,7238,35674,4993,66888,4111,2031,2080
47840,74137,7239,35677,4994,66898,4111,2031,2080
47845,74141,7240,35678,4995,66901,4111,2031,2080
47850,74151,7240,35683,4995,66911,4111,2031,2080
47855,74157,7240,35686,4995,66917,4112,2031,2081
47860,74168,7241,35693,4995,66927,4112,2031,2081
47865,74172,7241,35695,4995,66931,4112,2031,2081
47870,74182,7241,35700,4995,66941,4112,2031,2081
47875,74188,7241,35704,4995,66947,4113,2032,2081
47880,74199,7242,35709,4995,66957,4113,2032,2081
47885,74203,7243,35710,4996,66960,4113,2032,2081
47890,74213,7243,35712,4996,66970,4113,2032,2081
47895,74219,7243,35716,4996,66976,4114,2033,2081
47900,74230,7244,35719,4996,66986,4114,2033,2081
47905,74234,7244,35721,4996,66990,4114,2033,2081
47910,74244,7244,35726,4996,67000,4114,2033,2081
47915,74250,7244,35726,4996,67006,4115,2033,2082
47920,74261,7245,35732,4997,67016,4115,2033,2082
47925,74265,7245,35733,4997,67020,4115,2033,2082
47930,74275,7247,35738,4999,67028,4115,2033,2082
47935,74281,7247,35740,4999,67034,4117,2033,2084
47940,74292,7250,35746,5001,67042,4118,2033,2085
47945,74296,7250,35748,5001,67046,4118,2033,2085
47950,74306,7252,35749,5001,67054,4118,2033,2085
47955,74312,7252,35750,5001,67060,4119,2033,2086
47960,74323,7254,35756,5003,67069,4119,2033,2086
47965,74327,7254,35757,5003,67073,4119,2033,2086
47970,74337,7256,35761,5003,67081,4119,2033,2086
47975,74343,7256,35764,5003,67087,4120,2034,2086
47980,74354,7258,35771,5005,67096,4120,2034,2086
47985,74358,7258,35774,5005,67100,4120,2034,2086
47990,74368,7260,35780,5006,67108,4120,2034,2086
47995,74374,7260,35784,5006,67114,4121,2034,2087
48000,74385,7262,35791,5008,67123,4121,2034,2087
48005,74389,7262,35793,5008,67127,4121,2034,2087
48010,74399,7264,35796,5009,67135,4121,2034,2087
48015,74405,7264,35800,5009,67141,4122,2034,2088
48020,74416,7266,35805,5011,67150,4122,2034,2088
48025,74420,7266,35807,5011,67154,4122,2034,2088
48030,74430,7268,35812,5012,67162,4122,2034,2088
48035,74436,7268,35816,5012,67168,4123,2035,2088
48040,74447,7270,35822,5014,67177,4123,2035,2088
48045,74451,7271,35825,5015,67180,4123,2035,2088
48050,74461,7273,35833,5017,67188,4123,2035,2088
48055,74467,7273,35835,5017,67194,4125,2036,2089
48060,74478,7276,35840,5019,67201,4126,2036,2090
48065,74482,7278,35844,5021,67204,4126,2036,2090
48070,74492,7278,35851,5021,67214,4126,2036,2090
48075,74498,7278,35852,5021,67220,4127,2036,2091
48080,74509,7280,35857,5023,67229,4128,2036,2092
48085,74513,7281,35859,5024,67232,4128,2036,2092
48090,74523,7281,35867,5024,67242,4128,2036,2092
48095,74529,7281,35869,5024,67248,4129,2036,2093
48100,74540,7282,35874,5025,67258,4130,2036,2094
48105,74544,7283,35877,5026,67261,4130,2036,2094
48110,74554,7283,35880,5026,67271,4130,2036,2094
48115,74560,7283,35882,5026,67277,4131,2036,2095
48120,74571,7284,35886,5027,67287,4132,2036,2096
48125,74575,7284,35888,5027,67291,4132,2036,2096
48130,74585,7284,35893,5027,67301,4132,2036,2096
48135,74591,7284,35896,5027,67307,4133,2037,2096
48140,74602,7284,35900,5027,67318,4134,2037,2097
48145,74606,7284,35900,5027,67322,4134,2037,2097
48150,74616,7284,35906,5027,67332,4134,2037,2097
48155,74622,7284,35908,5027,67338,4135,2038,2097
48160,74633,7284,35913,5027,67349,4135,2038,2097
48165,74637,7284,35916,5027,67353,4135,2038,2097
48170,74647,7285,35919,5027,67362,4135,2038,2097
48175,74653,7285,35922,5027,67368,4136,2039,2097
48180,74664,7285,35929,5027,67379,4136,2039,2097
48185,74668,7286,35932,5028,67382,4136,2039,2097
48190,74678,7288,35937,5030,67390,4136,2039,2097
48195,74684,7288,35941,5030,67396,4137,2039,2098
48200,74695,7289,35945,5030,67406,4137,2039,2098
48205,74699,7290,35949,5031,67409,4137,2039,2098
48210,74709,7292,35954,5031,67417,4137,2039,2098
48215,74715,7292,35958,5031,67423,4138,2039,2099
48220,74726,7294,35964,5033,67432,4138,2039,2099
48225,74730,7294,35965,5033,67436,4138,2039,2099
48230,74740,7296,35971,5033,67444,4138,2039,2099
48235,74746,7296,35973,5033,67450,4140,2039,2101
48240,74757,7298,35977,5034,67459,4140,2039,2101
48245,74761,7299,35979,5035,67462,4140,2039,2101
48250,74771,7301,35984,5036,67470,4140,2039,2101
48255,74777,7301,35987,5036,67476,4142,2041,2101
48260,74788,7304,35991,5039,67484,4142,2041,2101
48265,74792,7304,35993,5039,67488,4142,2041,2101
48270,74802,7306,35999,5041,67496,4142,2041,2101
48275,74808,7306,36002,5041,67502,4144,2042,2102
48280,74819,7309,36008,5044,67510,4144,2042,2102
48285,74823,7310,36010,5045,67513,4144,2042,2102
48290,74833,7312,36015,5046,67521,4144,2042,2102
48295,74839,7312,36018,5046,67527,4146,2043,2103
48300,74850,7315,36021,5049,67535,4147,2043,2104
48305,74854,7315,36022,5049,67539,4147,2043,2104
48310,74864,7315,36028,5049,67549,4147,2043,2104
48315,74870,7315,36031,5049,67555,4148,2044,2104
48320,74881,7315,36037,5049,67566,4148,2044,2104
48325,74885,7315,36040,5049,67570,4148,2044,2104
48330,74895,7315,36042,5049,67580,4148,2044,2104
48335,74901,7315,36043,5049,67586,4149,2044,2105
48340,74912,7315,36047,5049,67597,4149,2044,2105
48345,74916,7315,36050,5049,67601,4149,2044,2105
48350,74926,7315,36057,5049,67611,4149,2044,2105
48355,74932,7315,36061,5049,67617,4150,2045,2105
48360,74943,7315,36065,5049,67628,4150,2045,2105
48365,74947,7315,36068,5049,67632,4150,2045,2105
48370,74957,7315,36074,5049,67642,4150,2045,2105
48375,74963,7315,36077,5049,67648,4151,2045,2106
48380,74974,7315,36083,5049,67659,4151,2045,2106
48385,74978,7315,36085,5049,67663,4151,2045,2106
48390,74988,7315,36090,5049,67673,4151,2045,2106
48395,74994,7315,36091,5049,67679,4152,2045,2107
48400,75005,7315,36096,5049,67690,4152,2045,2107
48405,75009,7315,36098,5049,67694,4152,2045,2107
48410,75019,7317,36104,5051,67702,4152,2045,2107
48415,75025,7317,36107,5051,67708,4154,2047,2107
48420,75036,7320,36112,5053,67716,4155,2047,2108
48425,75040,7322,36114,5055,67718,4155,2047,2108
48430,75050,7324,36119,5056,67726,4155,2047,2108
48435,75056,7324,36123,5056,67732,4156,2048,2108
48440,75067,7327,36130,5059,67740,4156,2048,2108
48445,75071,7327,36130,5059,67744,4156,2048,2108
48450,75081,7329,36134,5059,67752,4156,2048,2108
48455,75087,7329,36137,5059,67758,4157,2048,2109
48460,75098,7331,36144,5060,67767,4157,2048,2109
48465,75102,7332,36146,5061,67770,4157,2048,2109
48470,75112,7334,36151,5062,67778,4157,2048,2109
48475,75118,7334,36153,5062,67784,4158,2048,2110
48480,75129,7335,36157,5062,67794,4158,2048,2110
48485,75133,7336,36158,5063,67797,4158,2048,2110
48490,75143,7338,36163,5063,67805,4158,2048,2110
48495,75149,7338,36167,5063,67811,4159,2049,2110
48500,75160,7339,36173,5064,67821,4159,2049,2110
48505,75164,7340,36175,5065,67824,4159,2049,2110
48510,75174,7342,36177,5066,67832,4159,2049,2110
48515,75180,7342,36180,5066,67838,4160,2049,2111
48520,75191,7343,36187,5067,67848,4160,2049,2111
48525,75195,7344,36189,5068,67851,4160,2049,2111
48530,75205,7346,36194,5069,67859,4160,2049,2111
48535,75211,7346,36197,5069,67865,4162,2050,2112
48540,75222,7347,36203,5070,67875,4163,2051,2112
48545,75226,7347,36205,5070,67879,4163,2051,2112
48550,75236,7348,36208,5070,67888,4163,2051,2112
48555,75242,7348,36212,5070,67894,4165,2052,2113
48560,75253,7348,36217,5070,67905,4165,2052,2113
48565,75257,7348,36218,5070,67909,4165,2052,2113
48570,75267,7349,36222,5071,67918,4165,2052,2113
48575,75273,7349,36227,5071,67924,4166,2053,2113
48580,75284,7351,36236,5073,67933,4166,2053,2113
48585,75288,7351,36240,5073,67937,4166,2053,2113
48590,75298,7352,36246,5074,67946,4166,2053,2113
48595,75304,7352,36249,5074,67951,4167,2054,2113
48600,75315,7356,36252,5077,67959,4167,2054,2113
48605,75319,7357,36255,5078,67962,4167,2054,2113
48610,75329,7357,36261,5078,67972,4167,2054,2113
48615,75335,7357,36266,5078,67978,4168,2055,2113
48620,75346,7358,36271,5079,67988,4168,2055,2113
48625,75350,7359,36274,5080,67991,4168,2055,2113
48630,75360,7359,36279,5080,68001,4168,2055,2113
48635,75366,7359,36283,5080,68007,4169,2056,2113
48640,75377,7360,36290,5080,68017,4169,2056,2113
48645,75381,7360,36291,5080,68021,4169,2056,2113
48650,75391,7361,36297,5081,68030,4169,2056,2113
48655,75397,7361,36299,5081,68036,4170,2057,2113
48660,75408,7362,36304,5081,68046,4171,2058,2113
48665,75412,7362,36306,5081,68050,4171,2058,2113
48670,75422,7363,36310,5082,68059,4171,2058,2113
48675,75428,7363,36312,5082,68065,4172,2058,2114
48680,75439,7364,36318,5082,68075,4173,2058,2115
48685,75443,7365,36321,5083,68078,4173,2058,2115
48690,75453,7366,36325,5083,68087,4173,2058,2115
48695,75459,7366,36327,5083,68093,4174,2058,2116
48700,75470,7367,36332,5083,68103,4175,2059,2116
48705,75474,7368,36334,5084,68106,4175,2059,2116
48710,75484,7370,36337,5085,68114,4175,2059,2116
48715,75490,7370,36338,5085,68120,4176,2059,2117
48720,75501,7373,36347,5088,68128,4177,2060,2117
48725,75505,7373,36347,5088,68132,4177,2060,2117
48730,75515,7375,36351,5088,68140,4177,2060,2117
48735,75521,7375,36353,5088,68145,4178,2060,2118
48740,75532,7378,36357,5090,68154,4178,2060,2118
48745,75536,7378,36358,5090,68158,4178,2060,2118
48750,75546,7380,36365,5092,68166,4178,2060,2118
48755,75552,7380,36368,5092,68172,4179,2060,2119
48760,75563,7384,36373,5095,68179,4179,2060,2119
48765,75567,7384,36377,5095,68183,4179,2060,2119
48770,75577,7386,36383,5096,68191,4179,2060,2119
48775,75583,7386,36386,5096,68196,4181,2060,2121
48780,75594,7390,36390,5100,68204,4181,2060,2121
48785,75598,7391,36393,5101,68207,4181,2060,2121
48790,75608,7392,36398,5101,68216,4181,2060,2121
48795,75614,7392,36399,5101,68222,4182,2060,2122
48800,75625,7393,36406,5101,68232,4182,2060,2122
48805,75629,7394,36407,5102,68235,4182,2060,2122
48810,75639,7395,36412,5103,68244,4182,2060,2122
48815,75645,7395,36415,5103,68250,4183,2061,2122
48820,75656,7396,36420,5104,68260,4183,2061,2122
48825,75660,7396,36421,5104,68264,4183,2061,2122
48830,75670,7397,36424,5104,68273,4183,2061,2122
48835,75676,7397,36428,5104,68279,4184,2062,2122
48840,75687,7398,36434,5104,68289,4184,2062,2122
48845,75691,7399,36436,5105,68292,4184,2062,2122
48850,75701,7401,36440,5105,68300,4184,2062,2122
48855,75707,7401,36440,5105,68306,4185,2062,2123
48860,75718,7404,36443,5107,68314,4185,2062,2123
48865,75722,7404,36447,5107,68318,4185,2062,2123
48870,75732,7406,36452,5107,68326,4185,2062,2123
48875,75738,7406,36456,5107,68331,4186,2062,2124
48880,75749,7410,36461,5111,68338,4186,2062,2124
48885,75753,7411,36464,5112,68342,4186,2062,2124
48890,75763,7413,36468,5112,68350,4186,2062,2124
48895,75769,7413,36470,5112,68356,4188,2062,2126
48900,75780,7416,36477,5115,68363,4189,2063,2126
48905,75784,7418,36480,5117,68366,4189,2063,2126
48910,75794,7418,36486,5117,68376,4189,2063,2126
48915,75800,7418,36489,5117,68382,4191,2065,2126
48920,75811,7421,36496,5119,68390,4191,2065,2126
48925,75815,7421,36498,5119,68394,4191,2065,2126
48930,75825,7421,36503,5119,68404,4191,2065,2126
48935,75831,7421,36506,5119,68410,4192,2066,2126
48940,75842,7422,36508,5120,68420,4192,2066,2126
48945,75846,7422,36509,5120,68424,4192,2066,2126
48950,75856,7422,36514,5120,68434,4192,2066,2126
48955,75862,7422,36516,5120,68440,4193,2067,2126
48960,75873,7425,36523,5123,68448,4193,2067,2126
48965,75877,7425,36524,5123,68452,4193,2067,2126
48970,75887,7427,36527,5123,68460,4193,2067,2126
48975,75893,7427,36529,5123,68466,4194,2068,2126
48980,75904,7428,36533,5124,68476,4194,2068,2126
48985,75908,7428,36535,5124,68480,4194,2068,2126
48990,75918,7430,36539,5125,68488,4194,2068,2126
48995,75924,7430,36541,5125,68494,4195,2068,2127
49000,75935,7432,36544,5127,68503,4195,2068,2127
49005,75939,7432,36547,5127,68507,4195,2068,2127
49010,75949,7434,36552,5128,68515,4195,2068,2127
49015,75955,7434,36555,5128,68520,4196,2069,2127
49020,75966,7436,36558,5130,68530,4197,2069,2128
49025,75970,7436,36560,5130,68534,4197,2069,2128
49030,75980,7436,36565,5130,68544,4197,2069,2128
49035,75986,7436,36568,5130,68550,4198,2069,2129
49040,75997,7436,36575,5130,68561,4198,2069,2129
49045,76001,7436,36578,5130,68565,4198,2069,2129
49050,76011,7436,36583,5130,68575,4198,2069,2129
49055,76017,7436,36584,5130,68581,4199,2069,2130
49060,76028,7436,36588,5130,68592,4199,2069,2130
49065,76032,7436,36589,5130,68596,4199,2069,2130
49070,76042,7436,36591,5130,68606,4199,2069,2130
49075,76048,7436,36592,5130,68612,4201,2069,2132
49080,76059,7437,36596,5130,68622,4201,2069,2132
49085,76063,7437,36597,5130,68626,4201,2069,2132
49090,76073,7437,36601,5130,68636,4201,2069,2132
49095,76079,7437,36604,5130,68642,4203,2069,2134
49100,76090,7438,36608,5131,68652,4204,2069,2135
49105,76094,7438,36610,5131,68656,4204,2069,2135
49110,76104,7438,36615,5131,68666,4204,2069,2135
49115,76110,7438,36619,5131,68672,4206,2070,2136
49120,76121,7440,36625,5132,68681,4207,2071,2136
49125,76125,7441,36628,5133,68684,4207,2071,2136
49130,76135,7442,36630,5133,68693,4207,2071,2136
49135,76141,7442,36633,5133,68699,4209,2072,2137
49140,76152,7444,36640,5135,68707,4209,2072,2137
49145,76156,7445,36642,5136,68711,4209,2072,2137
49150,76166,7446,36647,5137,68720,4209,2072,2137
49155,76172,7446,36649,5137,68726,4210,2072,2138
49160,76183,7448,36656,5139,68735,4210,2072,2138
49165,76187,7448,36658,5139,68739,4210,2072,2138
49170,76197,7449,36663,5140,68748,4210,2072,2138
49175,76203,7449,36665,5140,68754,4211,2072,2139
49180,76214,7450,36670,5141,68764,4211,2072,2139
49185,76218,7450,36670,5141,68768,4211,2072,2139
49190,76228,7452,36675,5143,68776,4211,2072,2139
49195,76234,7452,36680,5143,68782,4212,2073,2139
49200,76245,7454,36687,5144,68791,4212,2073,2139
49205,76249,7454,36689,5144,68795,4212,2073,2139
49210,76259,7456,36694,5146,68803,4212,2073,2139
49215,76265,7456,36698,5146,68809,4213,2074,2139
49220,76276,7458,36703,5148,68818,4213,2074,2139
49225,76280,7458,36705,5148,68822,4213,2074,2139
49230,76290,7460,36709,5149,68830,4213,2074,2139
49235,76296,7460,36710,5149,68836,4214,2074,2140
49240,76307,7461,36714,5150,68846,4214,2074,2140
49245,76311,7461,36715,5150,68850,4214,2074,2140
49250,76321,7463,36717,5150,68858,4214,2074,2140
49255,76327,7463,36721,5150,68863,4215,2075,2140
49260,76338,7466,36726,5152,68872,4216,2075,2141
49265,76342,7466,36728,5152,68876,4216,2075,2141
49270,76352,7468,36735,5153,68884,4216,2075,2141
49275,76358,7468,36737,5153,68890,4217,2075,2142
49280,76369,7470,36744,5154,68899,4218,2076,2142
49285,76373,7471,36747,5155,68902,4218,2076,2142
49290,76383,7473,36752,5157,68910,4218,2076,2142
49295,76389,7473,36755,5157,68916,4220,2076,2144
49300,76400,7474,36759,5158,68926,4221,2076,2145
49305,76404,7475,36761,5159,68929,4221,2076,2145
49310,76414,7477,36764,5161,68937,4221,2076,2145
49315,76420,7477,36764,5161,68943,4223,2076,2147
49320,76431,7479,36768,5162,68952,4224,2077,2147
49325,76435,7479,36769,5162,68956,4224,2077,2147
49330,76445,7480,36776,5163,68965,4224,2077,2147
49335,76451,7480,36778,5163,68971,4226,2077,2149
49340,76462,7480,36781,5163,68982,4226,2077,2149
49345,76466,7480,36783,5163,68986,4226,2077,2149
49350,76476,7481,36788,5163,68995,4226,2077,2149
49355,76482,7481,36792,5163,69001,4228,2078,2150
49360,76493,7482,36799,5164,69011,4228,2078,2150
49365,76497,7482,36800,5164,69015,4228,2078,2150
49370,76507,7483,36806,5164,69024,4228,2078,2150
49375,76513,7483,36809,5164,69030,4230,2079,2151
49380,76524,7484,36816,5165,69040,4230,2079,2151
49385,76528,7484,36819,5165,69044,4230,2079,2151
49390,76538,7485,36824,5166,69053,4230,2079,2151
49395,76544,7485,36827,5166,69059,4232,2079,2153
49400,76555,7485,36833,5166,69070,4232,2079,2153
49405,76559,7485,36834,5166,69074,4232,2079,2153
49410,76569,7486,36838,5167,69083,4232,2079,2153
49415,76575,7486,36842,5167,69089,4234,2079,2155
49420,76586,7487,36848,5168,69099,4234,2079,2155
49425,76590,7487,36851,5168,69103,4234,2079,2155
49430,76600,7489,36854,5168,69111,4234,2079,2155
49435,76606,7489,36856,5168,69116,4236,2080,2156
49440,76617,7491,36857,5169,69126,4237,2080,2157
49445,76621,7491,36859,5169,69130,4237,2080,2157
49450,76631,7492,36861,5169,69139,4237,2080,2157
49455,76637,7492,36863,5169,69145,4238,2080,2158
49460,76648,7494,36870,5170,69154,4239,2081,2158
49465,76652,7494,36871,5170,69158,4239,2081,2158
49470,76662,7495,36878,5171,69167,4239,2081,2158
49475,76668,7495,36881,5171,69173,4240,2082,2158
49480,76679,7497,36884,5172,69182,4240,2082,2158
49485,76683,7497,36888,5172,69186,4240,2082,2158
49490,76693,7498,36894,5172,69195,4240,2082,2158
49495,76699,7498,36896,5172,69201,4241,2082,2159
49500,76710,7499,36900,5172,69211,4241,2082,2159
49505,76714,7499,36902,5172,69215,4241,2082,2159
49510,76724,7500,36906,5172,69224,4241,2082,2159
49515,76730,7500,36910,5172,69230,4242,2083,2159
49520,76741,7501,36916,5172,69240,4242,2083,2159
49525,76745,7501,36919,5172,69244,4242,2083,2159
49530,76755,7502,36924,5173,69253,4242,2083,2159
49535,76761,7502,36927,5173,69259,4243,2084,2159
49540,76772,7504,36931,5175,69268,4243,2084,2159
49545,76776,7504,36934,5175,69272,4243,2084,2159
49550,76786,7506,36938,5176,69280,4243,2084,2159
49555,76792,7506,36943,5176,69285,4245,2086,2159
49560,76803,7512,36951,5182,69290,4245,2086,2159
49565,76807,7514,36953,5184,69293,4245,2086,2159
49570,76817,7514,36959,5184,69303,4245,2086,2159
49575,76823,7514,36963,5184,69309,4246,2087,2159
49580,76834,7516,36967,5185,69318,4247,2088,2159
49585,76838,7517,36970,5186,69321,4247,2088,2159
49590,76848,7517,36975,5186,69331,4247,2088,2159
49595,76854,7517,36980,5186,69337,4248,2089,2159
49600,76865,7518,36986,5186,69347,4249,2089,2160
49605,76869,7518,36986,5186,69351,4249,2089,2160
49610,76879,7518,36993,5186,69361,4249,2089,2160
49615,76885,7518,36996,5186,69367,4250,2090,2160
49620,76896,7519,37001,5187,69377,4251,2090,2161
49625,76900,7519,37003,5187,69381,4251,2090,2161
49630,76910,7520,37009,5187,69390,4251,2090,2161
49635,76916,7520,37011,5187,69396,4252,2090,2162
49640,76927,7521,37012,5187,69406,4252,2090,2162
49645,76931,7521,37015,5187,69410,4252,2090,2162
49650,76941,7522,37020,5187,69419,4252,2090,2162
49655,76947,7522,37024,5187,69424,4253,2091,2162
49660,76958,7525,37029,5190,69433,4253,2091,2162
49665,76962,7525,37031,5190,69437,4253,2091,2162
49670,76972,7527,37035,5191,69445,4253,2091,2162
49675,76978,7527,37037,5191,69451,4255,2092,2163
49680,76989,7530,37043,5193,69458,4255,2092,2163
49685,76993,7532,37047,5195,69461,4255,2092,2163
49690,77003,7534,37050,5196,69469,4255,2092,2163
49695,77009,7534,37052,5196,69475,4257,2094,2163
49700,77020,7536,37058,5198,69484,4257,2094,2163
49705,77024,7537,37060,5199,69487,4257,2094,2163
49710,77034,7539,37066,5200,69495,4257,2094,2163
49715,77040,7539,37068,5200,69501,4259,2095,2164
49720,77051,7542,37073,5203,69509,4259,2095,2164
49725,77055,7542,37073,5203,69513,4259,2095,2164
49730,77065,7544,37076,5204,69521,4259,2095,2164
49735,77071,7544,37077,5204,69527,4261,2095,2166
49740,77082,7545,37083,5205,69537,4262,2096,2166
49745,77086,7545,37084,5205,69541,4262,2096,2166
49750,77096,7547,37090,5207,69549,4262,2096,2166
49755,77102,7547,37094,5207,69555,4264,2097,2167
49760,77113,7547,37099,5207,69566,4265,2098,2167
49765,77117,7547,37101,5207,69570,4265,2098,2167
49770,77127,7549,37106,5207,69578,4265,2098,2167
49775,77133,7549,37108,5207,69584,4267,2099,2168
49780,77144,7550,37113,5208,69594,4268,2100,2168
49785,77148,7550,37115,5208,69598,4268,2100,2168
49790,77158,7552,37120,5208,69606,4268,2100,2168
49795,77164,7552,37122,5208,69612,4270,2101,2169
49800,77175,7553,37128,5209,69622,4270,2101,2169
49805,77179,7553,37132,5209,69626,4270,2101,2169
49810,77189,7554,37135,5210,69635,4270,2101,2169
49815,77195,7554,37137,5210,69641,4271,2102,2169
49820,77206,7555,37141,5211,69651,4271,2102,2169
49825,77210,7555,37143,5211,69655,4271,2102,2169
49830,77220,7556,37145,5211,69664,4271,2102,2169
49835,77226,7556,37146,5211,69670,4272,2103,2169
49840,77237,7557,37151,5212,69680,4272,2103,2169
49845,77241,7557,37152,5212,69684,4272,2103,2169
49850,77251,7558,37157,5212,69693,4272,2103,2169
49855,77257,7558,37158,5212,69699,4273,2103,2170
49860,77268,7560,37161,5214,69708,4273,2103,2170
49865,77272,7560,37162,5214,69712,4273,2103,2170
49870,77282,7561,37166,5214,69721,4273,2103,2170
49875,77288,7561,37169,5214,69727,4274,2104,2170
49880,77299,7563,37173,5216,69736,4274,2104,2170
49885,77303,7563,37173,5216,69740,4274,2104,2170
49890,77313,7564,37179,5216,69749,4274,2104,2170
49895,77319,7564,37182,5216,69755,4275,2104,2171
49900,77330,7567,37190,5219,69763,4276,2104,2172
49905,77334,7567,37191,5219,69767,4276,2104,2172
49910,77344,7569,37196,5220,69775,4276,2104,2172
49915,77350,7569,37198,5220,69781,4278,2105,2173
49920,77361,7571,37203,5221,69790,4279,2106,2173
49925,77365,7571,37206,5221,69794,4279,2106,2173
49930,77375,7572,37209,5221,69803,4279,2106,2173
49935,77381,7572,37213,5221,69809,4280,2107,2173
49940,77392,7572,37215,5221,69820,4280,2107,2173
49945,77396,7572,37218,5221,69824,4280,2107,2173
49950,77406,7573,37223,5221,69833,4280,2107,2173
49955,77412,7573,37228,5221,69839,4281,2108,2173
49960,77423,7573,37234,5221,69850,4281,2108,2173
49965,77427,7573,37236,5221,69854,4281,2108,2173
49970,77437,7574,37241,5221,69863,4281,2108,2173
49975,77443,7574,37243,5221,69869,4282,2108,2174
49980,77454,7576,37248,5223,69877,4282,2108,2174
49985,77458,7577,37250,5224,69881,4282,2108,2174
49990,77468,7579,37257,5225,69889,4282,2108,2174
49995,77474,7579,37258,5225,69895,4283,2108,2175
50000,77485,7580,37263,5226,69904,4283,2108,2175
50005,77489,7581,37264,5227,69908,4283,2108,2175
50010,77499,7583,37265,5228,69916,4283,2108,2175
50015,77505,7583,37269,5228,69921,4284,2109,2175
50020,77516,7585,37271,5230,69931,4284,2109,2175
50025,77520,7585,37273,5230,69935,4284,2109,2175
50030,77530,7587,37279,5232,69943,4284,2109,2175
50035,77536,7587,37285,5232,69948,4285,2110,2175
50040,77547,7592,37294,5237,69954,4286,2110,2176
50045,77551,7593,37296,5238,69958,4286,2110,2176
50050,77561,7593,37300,5238,69968,4286,2110,2176
50055,77567,7593,37303,5238,69974,4287,2111,2176
50060,77578,7595,37309,5239,69983,4288,2111,2177
50065,77582,7595,37311,5239,69987,4288,2111,2177
50070,77592,7595,37316,5239,69997,4288,2111,2177
50075,77598,7595,37318,5239,70003,4289,2111,2178
50080,77609,7597,37327,5241,70012,4290,2112,2178
50085,77613,7597,37331,5241,70016,4290,2112,2178
50090,77623,7597,37339,5241,70026,4290,2112,2178
50095,77629,7597,37341,5241,70032,4292,2112,2180
50100,77640,7600,37350,5244,70040,4293,2113,2180
50105,77644,7600,37354,5244,70044,4293,2113,2180
50110,77654,7601,37359,5245,70053,4293,2113,2180
50115,77660,7601,37362,5245,70059,4294,2114,2180
50120,77671,7602,37367,5245,70069,4294,2114,2180
50125,77675,7602,37367,5245,70073,4294,2114,2180
50130,77685,7603,37371,5246,70082,4294,2114,2180
50135,77691,7603,37375,5246,70088,4295,2115,2180
50140,77702,7604,37381,5247,70098,4295,2115,2180
50145,77706,7604,37382,5247,70102,4295,2115,2180
50150,77716,7606,37388,5248,70110,4295,2115,2180
50155,77722,7606,37392,5248,70115,4296,2116,2180
50160,77733,7608,37395,5249,70125,4296,2116,2180
50165,77737,7609,37399,5250,70128,4296,2116,2180
50170,77747,7611,37404,5251,70136,4296,2116,2180
50175,77753,7611,37410,5251,70141,4298,2118,2180
50180,77764,7613,37414,5253,70151,4298,2118,2180
50185,77768,7614,37417,5254,70154,4298,2118,2180
50190,77778,7616,37423,5254,70162,4298,2118,2180
50195,77784,7616,37427,5254,70168,4299,2119,2180
50200,77795,7618,37436,5255,70176,4299,2119,2180
50205,77799,7619,37439,5256,70180,4299,2119,2180
50210,77809,7621,37443,5256,70188,4299,2119,2180
50215,77815,7621,37445,5256,70194,4300,2120,2180
50220,77826,7622,37449,5256,70204,4301,2121,2180
50225,77830,7622,37450,5256,70208,4301,2121,2180
50230,77840,7624,37457,5257,70216,4301,2121,2180
50235,77846,7624,37461,5257,70222,4302,2122,2180
50240,77857,7626,37463,5258,70231,4303,2122,2181
50245,77861,7626,37463,5258,70235,4303,2122,2181
50250,77871,7628,37468,5259,70243,4303,2122,2181
50255,77877,7628,37471,5259,70249,4304,2123,2181
50260,77888,7629,37475,5259,70259,4305,2123,2182
50265,77892,7629,37476,5259,70263,4305,2123,2182
50270,77902,7631,37477,5259,70271,4305,2123,2182
50275,77908,7631,37480,5259,70277,4306,2124,2182
50280,77919,7632,37485,5259,70287,4307,2124,2183
50285,77923,7632,37487,5259,70291,4307,2124,2183
50290,77933,7634,37488,5260,70299,4307,2124,2183
50295,77939,7634,37489,5260,70305,4308,2125,2183
50300,77950,7635,37492,5261,70315,4309,2125,2184
50305,77954,7635,37493,5261,70319,4309,2125,2184
50310,77964,7637,37500,5263,70327,4309,2125,2184
50315,77970,7637,37502,5263,70333,4310,2125,2185
50320,77981,7639,37506,5265,70342,4311,2125,2186
50325,77985,7639,37506,5265,70346,4311,2125,2186
50330,77995,7641,37511,5266,70354,4311,2125,2186
50335,78001,7641,37514,5266,70360,4312,2125,2187
50340,78012,7644,37519,5269,70368,4313,2125,2188
50345,78016,7644,37521,5269,70372,4313,2125,2188
50350,78026,7644,37526,5269,70382,4313,2125,2188
50355,78032,7644,37528,5269,70388,4315,2125,2190
50360,78043,7644,37533,5269,70399,4315,2125,2190
50365,78047,7644,37535,5269,70403,4315,2125,2190
50370,78057,7644,37539,5269,70413,4315,2125,2190
50375,78063,7644,37541,5269,70419,4317,2126,2191
50380,78074,7644,37546,5269,70430,4317,2126,2191
50385,78078,7644,37547,5269,70434,4317,2126,2191
50390,78088,7644,37549,5269,70444,4317,2126,2191
50395,78094,7644,37554,5269,70450,4319,2127,2192
50400,78105,7646,37559,5271,70459,4319,2127,2192
50405,78109,7646,37560,5271,70463,4319,2127,2192
50410,78119,7646,37567,5271,70473,4319,2127,2192
50415,78125,7646,37568,5271,70479,4320,2127,2193
50420,78136,7647,37571,5271,70489,4320,2127,2193
50425,78140,7648,37575,5272,70492,4320,2127,2193
50430,78150,7648,37579,5272,70502,4320,2127,2193
50435,78156,7648,37583,5272,70508,4321,2128,2193
50440,78167,7649,37587,5272,70518,4321,2128,2193
50445,78171,7650,37589,5273,70521,4321,2128,2193
50450,78181,7652,37596,5275,70529,4321,2128,2193
50455,78187,7652,37601,5275,70534,4322,2129,2193
50460,78198,7655,37606,5278,70542,4323,2129,2194
50465,78202,7656,37608,5279,70546,4323,2129,2194
50470,78212,7658,37611,5280,70554,4323,2129,2194
50475,78218,7658,37614,5280,70560,4324,2130,2194
50480,78229,7660,37620,5281,70568,4325,2131,2194
50485,78233,7662,37623,5283,70571,4325,2131,2194
50490,78243,7664,37629,5285,70579,4325,2131,2194
50495,78249,7664,37634,5285,70585,4326,2132,2194
50500,78260,7667,37640,5287,70592,4327,2133,2194
50505,78264,7669,37642,5289,70595,4327,2133,2194
50510,78274,7671,37646,5290,70603,4327,2133,2194
50515,78280,7671,37647,5290,70609,4328,2133,2195
50520,78291,7672,37649,5290,70619,4329,2133,2196
50525,78295,7672,37651,5290,70623,4329,2133,2196
50530,78305,7673,37656,5290,70632,4329,2133,2196
50535,78311,7673,37659,5290,70638,4330,2133,2197
50540,78322,7676,37668,5293,70646,4330,2133,2197
50545,78326,7676,37672,5293,70650,4330,2133,2197
50550,78336,7677,37679,5293,70659,4330,2133,2197
50555,78342,7677,37682,5293,70665,4331,2134,2197
50560,78353,7678,37689,5293,70675,4331,2134,2197
50565,78357,7678,37692,5293,70679,4331,2134,2197
50570,78367,7679,37698,5294,70688,4331,2134,2197
50575,78373,7679,37702,5294,70694,4333,2136,2197
50580,78384,7681,37707,5295,70703,4333,2136,2197
50585,78388,7682,37709,5296,70706,4333,2136,2197
50590,78398,7683,37715,5297,70715,4333,2136,2197
50595,78404,7683,37716,5297,70721,4335,2136,2199
50600,78415,7685,37719,5298,70730,4335,2136,2199
50605,78419,7685,37719,5298,70734,4335,2136,2199
50610,78429,7686,37724,5298,70743,4335,2136,2199
50615,78435,7686,37727,5298,70749,4337,2137,2200
50620,78446,7688,37731,5299,70758,4337,2137,2200
50625,78450,7689,37732,5300,70761,4337,2137,2200
50630,78460,7691,37737,5300,70769,4337,2137,2200
50635,78466,7691,37739,5300,70775,4339,2138,2201
50640,78477,7694,37743,5302,70783,4340,2139,2201
50645,78481,7694,37746,5302,70787,4340,2139,2201
50650,78491,7694,37749,5302,70797,4340,2139,2201
50655,78497,7694,37753,5302,70803,4341,2139,2202
50660,78508,7694,37759,5302,70814,4341,2139,2202
50665,78512,7694,37761,5302,70818,4341,2139,2202
50670,78522,7694,37765,5302,70828,4341,2139,2202
50675,78528,7694,37767,5302,70834,4342,2139,2203
50680,78539,7694,37770,5302,70845,4342,2139,2203
50685,78543,7694,37772,5302,70849,4342,2139,2203
50690,78553,7694,37776,5302,70859,4342,2139,2203
50695,78559,7694,37778,5302,70865,4343,2140,2203
50700,78570,7694,37783,5302,70876,4343,2140,2203
50705,78574,7694,37784,5302,70880,4343,2140,2203
50710,78584,7694,37789,5302,70890,4343,2140,2203
50715,78590,7694,37791,5302,70896,4344,2140,2204
50720,78601,7694,37795,5302,70907,4344,2140,2204
50725,78605,7694,37797,5302,70911,4344,2140,2204
50730,78615,7694,37803,5302,70921,4344,2140,2204
50735,78621,7694,37806,5302,70927,4345,2141,2204
50740,78632,7694,37811,5302,70938,4345,2141,2204
50745,78636,7694,37814,5302,70942,4345,2141,2204
50750,78646,7696,37819,5304,70950,4345,2141,2204
50755,78652,7696,37821,5304,70956,4347,2142,2205
50760,78663,7698,37826,5306,70964,4348,2142,2206
50765,78667,7699,37828,5307,70968,4348,2142,2206
50770,78677,7701,37834,5309,70976,4348,2142,2206
50775,78683,7701,37837,5309,70982,4349,2143,2206
50780,78694,7702,37840,5310,70992,4350,2143,2207
50785,78698,7704,37842,5312,70994,4350,2143,2207
50790,78708,7706,37845,5312,71002,4350,2143,2207
50795,78714,7706,37847,5312,71007,4351,2143,2208
50800,78725,7708,37851,5313,71017,4352,2144,2208
50805,78729,7708,37853,5313,71021,4352,2144,2208
50810,78739,7710,37857,5314,71029,4352,2144,2208
50815,78745,7710,37860,5314,71035,4353,2145,2208
50820,78756,7712,37867,5315,71043,4354,2146,2208
50825,78760,7713,37870,5316,71047,4354,2146,2208
50830,78770,7713,37876,5316,71057,4354,2146,2208
50835,78776,7713,37878,5316,71063,4355,2146,2209
50840,78787,7714,37885,5317,71073,4355,2146,2209
50845,78791,7715,37888,5318,71076,4355,2146,2209
50850,78801,7715,37893,5318,71086,4355,2146,2209
50855,78807,7715,37896,5318,71092,4356,2147,2209
50860,78818,7717,37902,5319,71101,4356,2147,2209
50865,78822,7718,37905,5320,71104,4356,2147,2209
50870,78832,7718,37908,5320,71114,4356,2147,2209
50875,78838,7718,37910,5320,71120,4358,2148,2210
50880,78849,7720,37915,5322,71129,4358,2148,2210
50885,78853,7720,37916,5322,71133,4358,2148,2210
50890,78863,7720,37920,5322,71143,4358,2148,2210
50895,78869,7720,37921,5322,71149,4360,2148,2212
50900,78880,7720,37926,5322,71160,4360,2148,2212
50905,78884,7720,37928,5322,71164,4360,2148,2212
50910,78894,7720,37934,5322,71174,4360,2148,2212
50915,78900,7720,37938,5322,71180,4361,2148,2213
50920,78911,7720,37943,5322,71191,4361,2148,2213
50925,78915,7720,37945,5322,71195,4361,2148,2213
50930,78925,7721,37948,5322,71204,4361,2148,2213
50935,78931,7721,37949,5322,71210,4362,2148,2214
50940,78942,7722,37953,5323,71220,4363,2148,2215
50945,78946,7722,37955,5323,71224,4363,2148,2215
50950,78956,7724,37960,5324,71232,4363,2148,2215
50955,78962,7724,37965,5324,71237,4364,2149,2215
50960,78973,7727,37971,5327,71246,4364,2149,2215
50965,78977,7727,37974,5327,71250,4364,2149,2215
50970,78987,7729,37979,5328,71258,4364,2149,2215
50975,78993,7729,37983,5328,71263,4365,2150,2215
50980,79004,7732,37990,5331,71272,4365,2150,2215
50985,79008,7732,37993,5331,71276,4365,2150,2215
50990,79018,7734,37999,5331,71284,4365,2150,2215
50995,79024,7734,38001,5331,71290,4366,2150,2216
51000,79035,7736,38006,5332,71298,4366,2150,2216
51005,79039,7737,38008,5333,71302,4366,2150,2216
51010,79049,7738,38011,5333,71311,4366,2150,2216
51015,79055,7738,38016,5333,71317,4368,2152,2216
51020,79066,7740,38020,5334,71326,4368,2152,2216
51025,79070,7741,38022,5335,71329,4368,2152,2216
51030,79080,7742,38027,5335,71338,4368,2152,2216
51035,79086,7742,38032,5335,71344,4370,2154,2216
51040,79097,7743,38036,5335,71354,4370,2154,2216
51045,79101,7743,38036,5335,71358,4370,2154,2216
51050,79111,7744,38044,5336,71367,4370,2154,2216
51055,79117,7744,38047,5336,71373,4372,2155,2217
51060,79128,7745,38051,5336,71383,4373,2155,2218
51065,79132,7747,38055,5338,71385,4373,2155,2218
51070,79142,7748,38059,5338,71394,4373,2155,2218
51075,79148,7748,38062,5338,71400,4374,2156,2218
51080,79159,7749,38065,5338,71410,4375,2156,2219
51085,79163,7750,38067,5339,71413,4375,2156,2219
51090,79173,7751,38073,5340,71422,4375,2156,2219
51095,79179,7751,38077,5340,71428,4376,2156,2220
51100,79190,7752,38082,5340,71438,4377,2156,2221
51105,79194,7754,38086,5342,71440,4377,2156,2221
51110,79204,7756,38091,5343,71448,4377,2156,2221
51115,79210,7756,38094,5343,71453,4378,2156,2222
51120,79221,7759,38097,5345,71462,4379,2156,2223
51125,79225,7760,38099,5346,71465,4379,2156,2223
51130,79235,7761,38105,5346,71474,4379,2156,2223
51135,79241,7761,38108,5346,71479,4380,2157,2223
51140,79252,7763,38110,5348,71489,4380,2157,2223
51145,79256,7764,38113,5349,71492,4380,2157,2223
51150,79266,7765,38119,5349,71501,4380,2157,2223
51155,79272,7765,38122,5349,71506,4381,2157,2224
51160,79283,7768,38126,5351,71515,4381,2157,2224
51165,79287,7768,38129,5351,71519,4381,2157,2224
51170,79297,7769,38134,5351,71528,4381,2157,2224
51175,79303,7769,38134,5351,71534,4383,2157,2226
51180,79314,7771,38141,5352,71543,4383,2157,2226
51185,79318,7771,38142,5352,71547,4383,2157,2226
51190,79328,7772,38145,5352,71556,4383,2157,2226
51195,79334,7772,38148,5352,71562,4385,2158,2227
51200,79345,7773,38152,5353,71572,4386,2159,2227
51205,79349,7774,38154,5354,71575,4386,2159,2227
51210,79359,7775,38161,5355,71584,4386,2159,2227
51215,79365,7775,38163,5355,71590,4388,2159,2229
51220,79376,7778,38169,5357,71598,4388,2159,2229
51225,79380,7778,38173,5357,71602,4388,2159,2229
51230,79390,7779,38179,5358,71611,4388,2159,2229
51235,79396,7779,38183,5358,71617,4390,2161,2229
51240,79407,7780,38186,5358,71627,4390,2161,2229
51245,79411,7780,38188,5358,71631,4390,2161,2229
51250,79421,7781,38192,5358,71640,4390,2161,2229
51255,79427,7781,38197,5358,71646,4391,2162,2229
51260,79438,7782,38202,5358,71656,4391,2162,2229
51265,79442,7783,38205,5359,71659,4391,2162,2229
51270,79452,7784,38210,5360,71668,4391,2162,2229
51275,79458,7784,38212,5360,71674,4392,2163,2229
51280,79469,7785,38216,5360,71684,4392,2163,2229
51285,79473,7785,38219,5360,71688,4392,2163,2229
51290,79483,7787,38223,5361,71696,4392,2163,2229
51295,79489,7787,38226,5361,71701,4393,2163,2230
51300,79500,7789,38231,5363,71711,4393,2163,2230
51305,79504,7789,38232,5363,71715,4393,2163,2230
51310,79514,7791,38237,5364,71723,4393,2163,2230
51315,79520,7791,38239,5364,71729,4395,2163,2232
51320,79531,7793,38242,5366,71738,4396,2163,2233
51325,79535,7793,38243,5366,71742,4396,2163,2233
51330,79545,7795,38248,5366,71750,4396,2163,2233
51335,79551,7795,38252,5366,71755,4398,2164,2234
51340,79562,7798,38259,5368,71763,4399,2165,2234
51345,79566,7799,38259,5369,71767,4399,2165,2234
51350,79576,7801,38262,5370,71775,4399,2165,2234
51355,79582,7801,38266,5370,71780,4401,2167,2234
51360,79593,7804,38270,5373,71789,4402,2168,2234
51365,79597,7805,38271,5374,71792,4402,2168,2234
51370,79607,7806,38276,5375,71801,4402,2168,2234
51375,79613,7806,38276,5375,71807,4403,2168,2235
51380,79624,7806,38283,5375,71818,4404,2168,2236
51385,79628,7806,38284,5375,71822,4404,2168,2236
51390,79638,7807,38288,5376,71831,4404,2168,2236
51395,79644,7807,38290,5376,71837,4405,2169,2236
51400,79655,7807,38298,5376,71848,4406,2170,2236
51405,79659,7807,38300,5376,71852,4406,2170,2236
51410,79669,7808,38305,5377,71861,4406,2170,2236
51415,79675,7808,38308,5377,71867,4407,2171,2236
51420,79686,7809,38312,5378,71877,4408,2171,2237
51425,79690,7810,38314,5379,71880,4408,2171,2237
51430,79700,7811,38318,5379,71889,4408,2171,2237
51435,79706,7811,38319,5379,71895,4409,2171,2238
51440,79717,7813,38326,5381,71904,4409,2171,2238
51445,79721,7814,38327,5382,71907,4409,2171,2238
51450,79731,7815,38333,5382,71916,4409,2171,2238
51455,79737,7815,38336,5382,71922,4410,2172,2238
51460,79748,7817,38341,5383,71931,4410,2172,2238
51465,79752,7818,38344,5384,71934,4410,2172,2238
51470,79762,7820,38352,5385,71942,4410,2172,2238
51475,79768,7820,38356,5385,71947,4412,2174,2238
51480,79779,7823,38362,5387,71956,4412,2174,2238
51485,79783,7824,38365,5388,71959,4412,2174,2238
51490,79793,7826,38372,5389,71967,4412,2174,2238
51495,79799,7826,38375,5389,71972,4414,2175,2239
51500,79810,7830,38382,5392,71979,4414,2175,2239
51505,79814,7831,38383,5393,71983,4414,2175,2239
51510,79824,7832,38387,5394,71992,4414,2175,2239
51515,79830,7832,38389,5394,71998,4416,2176,2240
51520,79841,7834,38392,5396,72007,4416,2176,2240
51525,79845,7834,38394,5396,72011,4416,2176,2240
51530,79855,7835,38398,5397,72020,4416,2176,2240
51535,79861,7835,38400,5397,72026,4417,2176,2241
51540,79872,7838,38405,5399,72034,4418,2177,2241
51545,79876,7839,38407,5400,72037,4418,2177,2241
51550,79886,7840,38412,5400,72046,4418,2177,2241
51555,79892,7840,38416,5400,72052,4419,2178,2241
51560,79903,7840,38419,5400,72063,4420,2178,2242
51565,79907,7840,38421,5400,72067,4420,2178,2242
51570,79917,7841,38425,5400,72076,4420,2178,2242
51575,79923,7841,38428,5400,72082,4421,2178,2243
51580,79934,7841,38434,5400,72093,4421,2178,2243
51585,79938,7841,38437,5400,72097,4421,2178,2243
51590,79948,7842,38441,5400,72106,4421,2178,2243
51595,79954,7842,38443,5400,72112,4422,2179,2243
51600,79965,7842,38447,5400,72123,4422,2179,2243
51605,79969,7843,38449,5401,72126,4422,2179,2243
51610,79979,7844,38452,5402,72135,4422,2179,2243
51615,79985,7844,38455,5402,72141,4423,2179,2244
51620,79996,7844,38460,5402,72152,4424,2179,2245
51625,80000,7844,38462,5402,72156,4424,2179,2245
51630,80010,7845,38467,5402,72165,4424,2179,2245
51635,80016,7845,38470,5402,72171,4425,2180,2245
51640,80027,7845,38476,5402,72182,4425,2180,2245
51645,80031,7845,38477,5402,72186,4425,2180,2245
51650,80041,7847,38481,5404,72194,4425,2180,2245
51655,80047,7847,38482,5404,72200,4426,2181,2245
51660,80058,7850,38487,5407,72208,4426,2181,2245
51665,80062,7850,38488,5407,72212,4426,2181,2245
51670,80072,7852,38492,5407,72220,4426,2181,2245
51675,80078,7852,38496,5407,72226,4427,2181,2246
51680,80089,7854,38502,5409,72235,4427,2181,2246
51685,80093,7854,38502,5409,72239,4427,2181,2246
51690,80103,7856,38510,5410,72247,4427,2181,2246
51695,80109,7856,38512,5410,72253,4428,2182,2246
51700,80120,7857,38516,5410,72263,4428,2182,2246
51705,80124,7857,38516,5410,72267,4428,2182,2246
51710,80134,7859,38521,5411,72275,4428,2182,2246
51715,80140,7859,38525,5411,72281,4430,2184,2246
51720,80151,7862,38529,5413,72289,4430,2184,2246
51725,80155,7863,38531,5414,72292,4430,2184,2246
51730,80165,7865,38536,5416,72300,4430,2184,2246
51735,80171,7865,38540,5416,72306,4431,2185,2246
51740,80182,7866,38545,5416,72316,4432,2186,2246
51745,80186,7867,38548,5417,72319,4432,2186,2246
51750,80196,7869,38552,5418,72327,4432,2186,2246
51755,80202,7869,38555,5418,72333,4433,2187,2246
51760,80213,7872,38561,5420,72341,4434,2187,2247
51765,80217,7874,38565,5422,72343,4434,2187,2247
51770,80227,7876,38568,5423,72351,4434,2187,2247
51775,80233,7876,38572,5423,72357,4435,2188,2247
51780,80244,7881,38579,5427,72363,4436,2189,2247
51785,80248,7881,38580,5427,72367,4436,2189,2247
51790,80258,7881,38584,5427,72377,4436,2189,2247
51795,80264,7881,38589,5427,72383,4437,2190,2247
51800,80275,7881,38596,5427,72394,4437,2190,2247
51805,80279,7881,38598,5427,72398,4437,2190,2247
51810,80289,7881,38602,5427,72408,4437,2190,2247
51815,80295,7881,38603,5427,72414,4438,2190,2248
51820,80306,7881,38610,5427,72425,4438,2190,2248
51825,80310,7881,38612,5427,72429,4438,2190,2248
51830,80320,7881,38619,5427,72439,4438,2190,2248
51835,80326,7881,38621,5427,72445,4439,2191,2248
51840,80337,7881,38627,5427,72456,4439,2191,2248
51845,80341,7881,38628,5427,72460,4439,2191,2248
51850,80351,7881,38631,5427,72470,4439,2191,2248
51855,80357,7881,38635,5427,72476,4440,2192,2248
51860,80368,7881,38641,5427,72487,4440,2192,2248
51865,80372,7881,38644,5427,72491,4440,2192,2248
51870,80382,7881,38648,5427,72501,4440,2192,2248
51875,80388,7881,38652,5427,72507,4441,2193,2248
51880,80399,7881,38658,5427,72518,4441,2193,2248
51885,80403,7881,38660,5427,72522,4441,2193,2248
51890,80413,7883,38667,5429,72530,4441,2193,2248
51895,80419,7883,38669,5429,72536,4442,2193,2249
51900,80430,7884,38671,5429,72546,4442,2193,2249
51905,80434,7884,38674,5429,72550,4442,2193,2249
51910,80444,7886,38679,5429,72558,4442,2193,2249
51915,80450,7886,38682,5429,72564,4443,2193,2250
51920,80461,7889,38688,5431,72572,4443,2193,2250
51925,80465,7889,38690,5431,72576,4443,2193,2250
51930,80475,7891,38695,5433,72584,4443,2193,2250
51935,80481,7891,38698,5433,72590,4444,2194,2250
51940,80492,7892,38701,5433,72600,4444,2194,2250
51945,80496,7892,38703,5433,72604,4444,2194,2250
51950,80506,7894,38712,5435,72612,4444,2194,2250
51955,80512,7894,38714,5435,72618,4445,2195,2250
51960,80523,7895,38717,5435,72628,4445,2195,2250
51965,80527,7895,38718,5435,72632,4445,2195,2250
51970,80537,7897,38724,5437,72640,4445,2195,2250
51975,80543,7897,38726,5437,72646,4447,2195,2252
51980,80554,7898,38730,5437,72656,4448,2195,2253
51985,80558,7899,38732,5438,72659,4448,2195,2253
51990,80568,7901,38737,5438,72667,4448,2195,2253
51995,80574,7901,38741,5438,72673,4450,2197,2253
52000,80585,7902,38743,5439,72683,4451,2197,2254
52005,80589,7904,38745,5441,72685,4451,2197,2254
52010,80599,7906,38750,5441,72693,4451,2197,2254
52015,80605,7906,38754,5441,72698,4453,2198,2255
52020,80616,7909,38758,5444,72707,4454,2198,2256
52025,80620,7909,38759,5444,72711,4454,2198,2256
52030,80630,7911,38761,5444,72719,4454,2198,2256
52035,80636,7911,38764,5444,72725,4455,2199,2256
52040,80647,7912,38770,5445,72735,4455,2199,2256
52045,80651,7912,38772,5445,72739,4455,2199,2256
52050,80661,7914,38778,5447,72747,4455,2199,2256
52055,80667,7914,38781,5447,72753,4456,2200,2256
52060,80678,7914,38787,5447,72764,4456,2200,2256
52065,80682,7914,38790,5447,72768,4456,2200,2256
52070,80692,7916,38795,5448,72776,4456,2200,2256
52075,80698,7916,38799,5448,72781,4457,2200,2257
52080,80709,7917,38805,5449,72792,4457,2200,2257
52085,80713,7917,38806,5449,72796,4457,2200,2257
52090,80723,7919,38810,5450,72804,4457,2200,2257
52095,80729,7919,38813,5450,72810,4458,2200,2258
52100,80740,7920,38819,5451,72820,4458,2200,2258
52105,80744,7920,38821,5451,72824,4458,2200,2258
52110,80754,7922,38828,5453,72832,4458,2200,2258
52115,80760,7922,38831,5453,72838,4459,2201,2258
52120,80771,7922,38835,5453,72849,4459,2201,2258
52125,80775,7922,38837,5453,72853,4459,2201,2258
52130,80785,7924,38842,5453,72861,4459,2201,2258
52135,80791,7924,38847,5453,72867,4461,2203,2258
52140,80802,7926,38854,5455,72876,4462,2204,2258
52145,80806,7926,38855,5455,72880,4462,2204,2258
52150,80816,7926,38858,5455,72890,4462,2204,2258
52155,80822,7926,38861,5455,72896,4463,2205,2258
52160,80833,7928,38867,5456,72905,4464,2206,2258
52165,80837,7928,38870,5456,72909,4464,2206,2258
52170,80847,7928,38877,5456,72919,4464,2206,2258
52175,80853,7928,38880,5456,72925,4465,2207,2258
52180,80864,7930,38885,5458,72934,4466,2208,2258
52185,80868,7930,38887,5458,72938,4466,2208,2258
52190,80878,7930,38890,5458,72948,4466,2208,2258
52195,80884,7930,38892,5458,72954,4467,2208,2259
52200,80895,7933,38899,5460,72962,4468,2209,2259
52205,80899,7933,38900,5460,72966,4468,2209,2259
52210,80909,7933,38906,5460,72976,4468,2209,2259
52215,80915,7933,38912,5460,72982,4469,2210,2259
52220,80926,7934,38917,5460,72992,4469,2210,2259
52225,80930,7934,38919,5460,72996,4469,2210,2259
52230,80940,7934,38925,5460,73006,4469,2210,2259
52235,80946,7934,38927,5460,73012,4470,2210,2260
52240,80957,7935,38934,5461,73022,4470,2210,2260
52245,80961,7935,38936,5461,73026,4470,2210,2260
52250,80971,7936,38943,5462,73035,4470,2210,2260
52255,80977,7936,38945,5462,73041,4471,2210,2261
52260,80988,7937,38949,5463,73051,4471,2210,2261
52265,80992,7937,38950,5463,73055,4471,2210,2261
52270,81002,7939,38954,5465,73063,4471,2210,2261
52275,81008,7939,38958,5465,73068,4472,2211,2261
52280,81019,7942,38963,5467,73076,4473,2211,2262
52285,81023,7944,38965,5469,73079,4473,2211,2262
52290,81033,7946,38970,5470,73087,4473,2211,2262
52295,81039,7946,38973,5470,73093,4474,2211,2263
52300,81050,7947,38978,5471,73103,4475,2212,2263
52305,81054,7949,38981,5473,73105,4475,2212,2263
52310,81064,7951,38986,5473,73113,4475,2212,2263
52315,81070,7951,38990,5473,73119,4476,2213,2263
52320,81081,7953,38993,5474,73128,4477,2214,2263
52325,81085,7953,38994,5474,73132,4477,2214,2263
52330,81095,7955,38997,5474,73140,4477,2214,2263
52335,81101,7955,39001,5474,73146,4478,2215,2263
52340,81112,7955,39001,5474,73157,4478,2215,2263
52345,81116,7955,39004,5474,73161,4478,2215,2263
52350,81126,7957,39011,5475,73169,4478,2215,2263
52355,81132,7957,39013,5475,73175,4479,2216,2263
52360,81143,7959,39020,5477,73184,4479,2216,2263
52365,81147,7959,39021,5477,73188,4479,2216,2263
52370,81157,7961,39027,5478,73196,4479,2216,2263
52375,81163,7961,39028,5478,73202,4480,2216,2264
52380,81174,7962,39033,5479,73212,4480,2216,2264
52385,81178,7962,39035,5479,73216,4480,2216,2264
52390,81188,7963,39039,5480,73225,4480,2216,2264
52395,81194,7963,39044,5480,73231,4482,2218,2264
52400,81205,7964,39049,5481,73241,4482,2218,2264
52405,81209,7964,39050,5481,73245,4482,2218,2264
52410,81219,7965,39056,5481,73254,4482,2218,2264
52415,81225,7965,39062,5481,73260,4483,2219,2264
52420,81236,7965,39067,5481,73271,4483,2219,2264
52425,81240,7965,39070,5481,73275,4483,2219,2264
52430,81250,7966,39072,5481,73284,4483,2219,2264
52435,81256,7966,39077,5481,73290,4484,2220,2264
52440,81267,7967,39080,5481,73300,4484,2220,2264
52445,81271,7967,39082,5481,73304,4484,2220,2264
52450,81281,7967,39088,5481,73314,4484,2220,2264
52455,81287,7967,39091,5481,73320,4485,2221,2264
52460,81298,7969,39094,5482,73329,4485,2221,2264
52465,81302,7969,39094,5482,73333,4485,2221,2264
52470,81312,7969,39097,5482,73343,4485,2221,2264
52475,81318,7969,39099,5482,73349,4486,2221,2265
52480,81329,7970,39104,5483,73359,4486,2221,2265
52485,81333,7970,39105,5483,73363,4486,2221,2265
52490,81343,7971,39111,5484,73372,4486,2221,2265
52495,81349,7971,39113,5484,73378,4487,2221,2266
52500,81360,7973,39121,5486,73387,4488,2222,2266
52505,81364,7973,39124,5486,73391,4488,2222,2266
52510,81374,7974,39127,5486,73400,4488,2222,2266
52515,81380,7974,39129,5486,73406,4490,2223,2267
52520,81391,7975,39137,5487,73416,4491,2224,2267
52525,81395,7975,39138,5487,73420,4491,2224,2267
52530,81405,7976,39144,5488,73429,4491,2224,2267
52535,81411,7976,39147,5488,73435,4493,2225,2268
52540,81422,7978,39154,5489,73444,4494,2226,2268
52545,81426,7978,39156,5489,73448,4494,2226,2268
52550,81436,7979,39161,5489,73457,4494,2226,2268
52555,81442,7979,39163,5489,73463,4495,2226,2269
52560,81453,7981,39167,5490,73472,4496,2227,2269
52565,81457,7981,39168,5490,73476,4496,2227,2269
52570,81467,7983,39175,5491,73484,4496,2227,2269
52575,81473,7983,39179,5491,73490,4497,2228,2269
52580,81484,7984,39182,5491,73500,4498,2229,2269
52585,81488,7985,39184,5492,73503,4498,2229,2269
52590,81498,7987,39187,5492,73511,4498,2229,2269
52595,81504,7987,39189,5492,73517,4499,2230,2269
52600,81515,7989,39194,5493,73526,4500,2231,2269
52605,81519,7989,39195,5493,73530,4500,2231,2269
52610,81529,7991,39200,5494,73538,4500,2231,2269
52615,81535,7991,39202,5494,73544,4501,2231,2270
52620,81546,7993,39210,5496,73553,4502,2231,2271
52625,81550,7994,39213,5497,73556,4502,2231,2271
52630,81560,7995,39218,5497,73565,4502,2231,2271
52635,81566,7995,39223,5497,73571,4503,2232,2271
52640,81577,7997,39229,5498,73580,4504,2233,2271
52645,81581,7998,39230,5499,73583,4504,2233,2271
52650,81591,7999,39238,5499,73592,4504,2233,2271
52655,81597,7999,39241,5499,73598,4505,2233,2272
52660,81608,8000,39247,5499,73608,4506,2234,2272
52665,81612,8000,39249,5499,73612,4506,2234,2272
52670,81622,8001,39254,5500,73621,4506,2234,2272
52675,81628,8001,39255,5500,73627,4507,2234,2273
52680,81639,8003,39261,5501,73636,4508,2234,2274
52685,81643,8003,39265,5501,73640,4508,2234,2274
52690,81653,8005,39268,5502,73648,4508,2234,2274
52695,81659,8005,39272,5502,73654,4509,2234,2275
52700,81670,8008,39275,5504,73662,4509,2234,2275
52705,81674,8008,39279,5504,73666,4509,2234,2275
52710,81684,8010,39285,5505,73674,4509,2234,2275
52715,81690,8010,39285,5505,73680,4510,2234,2276
52720,81701,8013,39292,5507,73688,4510,2234,2276
52725,81705,8013,39294,5507,73692,4510,2234,2276
52730,81715,8015,39300,5508,73700,4510,2234,2276
52735,81721,8015,39304,5508,73706,4511,2235,2276
52740,81732,8019,39312,5512,73713,4511,2235,2276
52745,81736,8019,39316,5512,73717,4511,2235,2276
52750,81746,8021,39322,5513,73725,4511,2235,2276
52755,81752,8021,39325,5513,73731,4512,2235,2277
52760,81763,8024,39332,5516,73739,4512,2235,2277
52765,81767,8024,39333,5516,73743,4512,2235,2277
52770,81777,8026,39336,5517,73751,4512,2235,2277
52775,81783,8026,39340,5517,73757,4513,2236,2277
52780,81794,8028,39342,5518,73766,4513,2236,2277
52785,81798,8028,39344,5518,73770,4513,2236,2277
52790,81808,8030,39350,5518,73778,4513,2236,2277
52795,81814,8030,39351,5518,73784,4514,2236,2278
52800,81825,8033,39358,5520,73791,4515,2236,2279
52805,81829,8034,39359,5521,73795,4515,2236,2279
52810,81839,8034,39364,5521,73805,4515,2236,2279
52815,81845,8034,39367,5521,73811,4516,2236,2280
52820,81856,8034,39374,5521,73822,4516,2236,2280
52825,81860,8034,39376,5521,73826,4516,2236,2280
52830,81870,8034,39382,5521,73836,4516,2236,2280
52835,81876,8034,39384,5521,73842,4517,2236,2281
52840,81887,8034,39387,5521,73853,4517,2236,2281
52845,81891,8034,39387,5521,73857,4517,2236,2281
52850,81901,8034,39394,5521,73867,4517,2236,2281
52855,81907,8034,39396,5521,73873,4518,2237,2281
52860,81918,8034,39402,5521,73884,4518,2237,2281
52865,81922,8034,39405,5521,73888,4518,2237,2281
52870,81932,8035,39411,5522,73897,4518,2237,2281
52875,81938,8035,39413,5522,73903,4519,2238,2281
52880,81949,8035,39420,5522,73914,4519,2238,2281
52885,81953,8035,39423,5522,73918,4519,2238,2281
52890,81963,8036,39430,5522,73927,4519,2238,2281
52895,81969,8036,39432,5522,73933,4520,2238,2282
52900,81980,8036,39435,5522,73944,4520,2238,2282
52905,81984,8036,39436,5522,73948,4520,2238,2282
52910,81994,8038,39443,5523,73956,4520,2238,2282
52915,82000,8038,39444,5523,73962,4522,2239,2283
52920,82011,8040,39449,5524,73971,4523,2239,2284
52925,82015,8040,39451,5524,73975,4523,2239,2284
52930,82025,8041,39456,5524,73984,4523,2239,2284
52935,82031,8041,39460,5524,73989,4524,2239,2285
52940,82042,8044,39465,5527,73998,4524,2239,2285
52945,82046,8044,39467,5527,74002,4524,2239,2285
52950,82056,8045,39473,5528,74011,4524,2239,2285
52955,82062,8045,39478,5528,74017,4525,2240,2285
52960,82073,8047,39483,5529,74026,4525,2240,2285
52965,82077,8048,39486,5530,74029,4525,2240,2285
52970,82087,8049,39492,5531,74038,4525,2240,2285
52975,82093,8049,39498,5531,74043,4526,2241,2285
52980,82104,8051,39499,5532,74053,4526,2241,2285
52985,82108,8051,39503,5532,74057,4526,2241,2285
52990,82118,8052,39508,5533,74066,4526,2241,2285
52995,82124,8052,39513,5533,74071,4527,2242,2285
53000,82135,8054,39518,5534,74081,4527,2242,2285
53005,82139,8054,39519,5534,74085,4527,2242,2285
53010,82149,8055,39522,5534,74094,4527,2242,2285
53015,82155,8055,39528,5534,74099,4528,2243,2285
53020,82166,8057,39535,5536,74109,4528,2243,2285
53025,82170,8058,39536,5537,74112,4528,2243,2285
53030,82180,8060,39541,5538,74120,4528,2243,2285
53035,82186,8060,39543,5538,74126,4529,2243,2286
53040,82197,8062,39547,5539,74135,4530,2243,2287
53045,82201,8062,39550,5539,74139,4530,2243,2287
53050,82211,8063,39554,5539,74148,4530,2243,2287
53055,82217,8063,39557,5539,74154,4531,2244,2287
53060,82228,8065,39561,5540,74163,4531,2244,2287
53065,82232,8065,39563,5540,74167,4531,2244,2287
53070,82242,8066,39569,5541,74176,4531,2244,2287
53075,82248,8066,39570,5541,74182,4532,2245,2287
53080,82259,8069,39578,5544,74190,4532,2245,2287
53085,82263,8070,39580,5545,74193,4532,2245,2287
53090,82273,8071,39584,5546,74202,4532,2245,2287
53095,82279,8071,39587,5546,74208,4533,2245,2288
53100,82290,8075,39595,5549,74215,4533,2245,2288
53105,82294,8076,39597,5550,74218,4533,2245,2288
53110,82304,8077,39604,5551,74227,4533,2245,2288
53115,82310,8077,39609,5551,74233,4534,2246,2288
53120,82321,8080,39615,5553,74241,4534,2246,2288
53125,82325,8081,39618,5554,74244,4534,2246,2288
53130,82335,8082,39621,5554,74253,4534,2246,2288
53135,82341,8082,39625,5554,74259,4535,2247,2288
53140,82352,8084,39629,5556,74268,4535,2247,2288
53145,82356,8085,39631,5557,74271,4535,2247,2288
53150,82366,8087,39636,5558,74279,4535,2247,2288
53155,82372,8087,39639,5558,74284,4537,2248,2289
53160,82383,8091,39645,5562,74292,4538,2248,2290
53165,82387,8092,39646,5563,74295,4538,2248,2290
53170,82397,8093,39652,5564,74304,4538,2248,2290
53175,82403,8093,39653,5564,74310,4540,2249,2291
53180,82414,8093,39660,5564,74321,4541,2250,2291
53185,82418,8093,39661,5564,74325,4541,2250,2291
53190,82428,8094,39664,5564,74334,4541,2250,2291
53195,82434,8094,39665,5564,74340,4543,2251,2292
53200,82445,8094,39672,5564,74351,4544,2252,2292
53205,82449,8095,39675,5565,74354,4544,2252,2292
53210,82459,8096,39681,5566,74363,4544,2252,2292
53215,82465,8096,39686,5566,74369,4546,2254,2292
53220,82476,8096,39691,5566,74380,4547,2254,2293
53225,82480,8096,39693,5566,74384,4547,2254,2293
53230,82490,8097,39699,5567,74393,4547,2254,2293
53235,82496,8097,39700,5567,74399,4548,2254,2294
53240,82507,8097,39705,5567,74410,4548,2254,2294
53245,82511,8097,39707,5567,74414,4548,2254,2294
53250,82521,8098,39713,5567,74423,4548,2254,2294
53255,82527,8098,39715,5567,74429,4549,2254,2295
53260,82538,8098,39719,5567,74440,4549,2254,2295
53265,82542,8098,39719,5567,74444,4549,2254,2295
53270,82552,8100,39726,5569,74452,4549,2254,2295
53275,82558,8100,39729,5569,74457,4550,2254,2296
53280,82569,8106,39736,5575,74462,4550,2254,2296
53285,82573,8107,39738,5576,74466,4550,2254,2296
53290,82583,8109,39743,5578,74474,4550,2254,2296
53295,82589,8109,39747,5578,74479,4551,2255,2296
53300,82600,8112,39750,5581,74488,4551,2255,2296
53305,82604,8112,39753,5581,74492,4551,2255,2296
53310,82614,8113,39755,5581,74501,4551,2255,2296
53315,82620,8113,39759,5581,74506,4552,2256,2296
53320,82631,8117,39763,5584,74514,4552,2256,2296
53325,82635,8117,39765,5584,74518,4552,2256,2296
53330,82645,8118,39770,5585,74527,4552,2256,2296
53335,82651,8118,39773,5585,74532,4554,2257,2297
53340,82662,8122,39778,5589,74540,4555,2257,2298
53345,82666,8123,39782,5590,74543,4555,2257,2298
53350,82676,8123,39788,5590,74553,4555,2257,2298
53355,82682,8123,39790,5590,74559,4556,2257,2299
53360,82693,8123,39797,5590,74570,4556,2257,2299
53365,82697,8123,39797,5590,74574,4556,2257,2299
53370,82707,8123,39802,5590,74584,4556,2257,2299
53375,82713,8123,39805,5590,74590,4557,2257,2300
53380,82724,8123,39810,5590,74601,4557,2257,2300
53385,82728,8123,39812,5590,74605,4557,2257,2300
53390,82738,8123,39818,5590,74615,4557,2257,2300
53395,82744,8123,39820,5590,74621,4558,2257,2301
53400,82755,8123,39822,5590,74632,4558,2257,2301
53405,82759,8123,39825,5590,74636,4558,2257,2301
53410,82769,8124,39830,5590,74645,4558,2257,2301
53415,82775,8124,39833,5590,74651,4559,2258,2301
53420,82786,8126,39840,5591,74660,4559,2258,2301
53425,82790,8126,39843,5591,74664,4559,2258,2301
53430,82800,8127,39845,5592,74673,4559,2258,2301
53435,82806,8127,39849,5592,74679,4560,2259,2301
53440,82817,8128,39854,5592,74689,4560,2259,2301
53445,82821,8128,39858,5592,74693,4560,2259,2301
53450,82831,8130,39864,5594,74701,4560,2259,2301
53455,82837,8130,39867,5594,74707,4561,2259,2302
53460,82848,8131,39871,5595,74717,4561,2259,2302
53465,82852,8133,39873,5597,74719,4561,2259,2302
53470,82862,8134,39878,5597,74728,4561,2259,2302
53475,82868,8134,39883,5597,74733,4562,2260,2302
53480,82879,8136,39888,5598,74743,4562,2260,2302
53485,82883,8137,39891,5599,74746,4562,2260,2302
53490,82893,8138,39897,5600,74755,4562,2260,2302
53495,82899,8138,39900,5600,74761,4563,2260,2303
53500,82910,8139,39905,5601,74771,4563,2260,2303
53505,82914,8139,39905,5601,74775,4563,2260,2303
53510,82924,8140,39912,5601,74784,4563,2260,2303
53515,82930,8140,39914,5601,74790,4564,2261,2303
53520,82941,8141,39918,5601,74800,4564,2261,2303
53525,82945,8141,39921,5601,74804,4564,2261,2303
53530,82955,8142,39927,5601,74813,4564,2261,2303
53535,82961,8142,39931,5601,74819,4565,2261,2304
53540,82972,8143,39936,5601,74829,4565,2261,2304
53545,82976,8143,39937,5601,74833,4565,2261,2304
53550,82986,8144,39944,5601,74842,4565,2261,2304
53555,82992,8144,39945,5601,74848,4567,2261,2306
53560,83003,8145,39949,5601,74858,4567,2261,2306
53565,83007,8145,39953,5601,74862,4567,2261,2306
53570,83017,8147,39956,5602,74870,4567,2261,2306
53575,83023,8147,39958,5602,74876,4569,2262,2307
53580,83034,8149,39965,5603,74885,4569,2262,2307
53585,83038,8150,39968,5604,74888,4569,2262,2307
53590,83048,8152,39970,5604,74896,4569,2262,2307
53595,83054,8152,39974,5604,74902,4571,2264,2307
53600,83065,8155,39982,5606,74910,4571,2264,2307
53605,83069,8155,39984,5606,74914,4571,2264,2307
53610,83079,8157,39988,5608,74922,4571,2264,2307
53615,83085,8157,39992,5608,74928,4573,2265,2308
53620,83096,8159,39998,5609,74937,4573,2265,2308
53625,83100,8159,40000,5609,74941,4573,2265,2308
53630,83110,8161,40007,5611,74949,4573,2265,2308
53635,83116,8161,40010,5611,74955,4575,2266,2309
53640,83127,8163,40015,5612,74964,4575,2266,2309
53645,83131,8163,40016,5612,74968,4575,2266,2309
53650,83141,8165,40018,5612,74976,4575,2266,2309
53655,83147,8165,40019,5612,74982,4576,2266,2310
53660,83158,8166,40022,5612,74992,4576,2266,2310
53665,83162,8167,40024,5613,74995,4576,2266,2310
53670,83172,8169,40028,5614,75003,4576,2266,2310
53675,83178,8169,40032,5614,75009,4577,2266,2311
53680,83189,8170,40038,5615,75019,4577,2266,2311
53685,83193,8171,40041,5616,75022,4577,2266,2311
53690,83203,8173,40047,5617,75030,4577,2266,2311
53695,83209,8173,40050,5617,75036,4578,2266,2312
53700,83220,8177,40055,5620,75042,4579,2266,2313
53705,83224,8178,40058,5621,75046,4579,2266,2313
53710,83234,8178,40063,5621,75056,4579,2266,2313
53715,83240,8178,40065,5621,75062,4581,2266,2315
53720,83251,8178,40072,5621,75073,4582,2266,2316
53725,83255,8178,40073,5621,75077,4582,2266,2316
53730,83265,8178,40079,5621,75087,4582,2266,2316
53735,83271,8178,40082,5621,75093,4584,2268,2316
53740,83282,8178,40087,5621,75104,4585,2268,2317
53745,83286,8178,40088,5621,75108,4585,2268,2317
53750,83296,8178,40092,5621,75118,4585,2268,2317
53755,83302,8178,40097,5621,75124,4587,2269,2318
53760,83313,8178,40104,5621,75135,4588,2269,2319
53765,83317,8178,40107,5621,75139,4588,2269,2319
53770,83327,8179,40109,5621,75148,4588,2269,2319
53775,83333,8179,40112,5621,75153,4590,2271,2319
53780,83344,8180,40117,5622,75164,4590,2271,2319
53785,83348,8180,40119,5622,75168,4590,2271,2319
53790,83358,8181,40125,5623,75177,4590,2271,2319
53795,83364,8181,40129,5623,75183,4591,2272,2319
53800,83375,8181,40131,5623,75194,4591,2272,2319
53805,83379,8181,40134,5623,75198,4591,2272,2319
53810,83389,8183,40139,5624,75206,4591,2272,2319
53815,83395,8183,40142,5624,75212,4592,2272,2320
53820,83406,8187,40148,5628,75218,4592,2272,2320
53825,83410,8189,40151,5630,75221,4592,2272,2320
53830,83420,8190,40154,5630,75230,4592,2272,2320
53835,83426,8190,40157,5630,75236,4593,2273,2320
53840,83437,8191,40162,5631,75246,4593,2273,2320
53845,83441,8191,40165,5631,75250,4593,2273,2320
53850,83451,8192,40168,5632,75259,4593,2273,2320
53855,83457,8192,40171,5632,75265,4594,2274,2320
53860,83468,8193,40174,5633,75275,4594,2274,2320
53865,83472,8193,40176,5633,75279,4594,2274,2320
53870,83482,8194,40181,5634,75288,4594,2274,2320
53875,83488,8194,40184,5634,75294,4595,2275,2320
53880,83499,8196,40187,5635,75303,4596,2276,2320
53885,83503,8197,40188,5636,75306,4596,2276,2320
53890,83513,8199,40193,5637,75314,4596,2276,2320
53895,83519,8199,40196,5637,75320,4598,2277,2321
53900,83530,8201,40203,5638,75329,4599,2278,2321
53905,83534,8202,40204,5639,75332,4599,2278,2321
53910,83544,8204,40211,5640,75340,4599,2278,2321
53915,83550,8204,40213,5640,75346,4601,2278,2323
53920,83561,8207,40220,5643,75354,4602,2278,2324
53925,83565,8208,40223,5644,75357,4602,2278,2324
53930,83575,8210,40227,5646,75365,4602,2278,2324
53935,83581,8210,40228,5646,75371,4604,2278,2326
53940,83592,8213,40232,5649,75379,4605,2279,2326
53945,83596,8213,40234,5649,75383,4605,2279,2326
53950,83606,8214,40240,5650,75392,4605,2279,2326
53955,83612,8214,40243,5650,75398,4606,2280,2326
53960,83623,8215,40249,5651,75408,4606,2280,2326
53965,83627,8215,40252,5651,75412,4606,2280,2326
53970,83637,8216,40258,5652,75421,4606,2280,2326
53975,83643,8216,40260,5652,75427,4607,2281,2326
53980,83654,8216,40264,5652,75438,4607,2281,2326
53985,83658,8216,40266,5652,75442,4607,2281,2326
53990,83668,8217,40271,5652,75451,4607,2281,2326
53995,83674,8217,40275,5652,75456,4608,2282,2326
54000,83685,8219,40282,5654,75466,4608,2282,2326
54005,83689,8219,40283,5654,75470,4608,2282,2326
54010,83699,8220,40288,5654,75479,4608,2282,2326
54015,83705,8220,40292,5654,75485,4609,2283,2326
54020,83716,8221,40298,5655,75495,4609,2283,2326
54025,83720,8221,40301,5655,75499,4609,2283,2326
54030,83730,8222,40305,5655,75508,4609,2283,2326
54035,83736,8222,40309,5655,75513,4610,2283,2327
54040,83747,8224,40311,5657,75523,4610,2283,2327
54045,83751,8225,40314,5658,75526,4610,2283,2327
54050,83761,8227,40317,5658,75534,4610,2283,2327
54055,83767,8227,40319,5658,75540,4611,2283,2328
54060,83778,8229,40321,5659,75549,4612,2283,2329
54065,83782,8229,40325,5659,75553,4612,2283,2329
54070,83792,8230,40327,5659,75562,4612,2283,2329
54075,83798,8230,40329,5659,75568,4613,2284,2329
54080,83809,8232,40333,5660,75577,4613,2284,2329
54085,83813,8232,40334,5660,75581,4613,2284,2329
54090,83823,8233,40341,5661,75590,4613,2284,2329
54095,83829,8233,40343,5661,75596,4614,2284,2330
54100,83840,8236,40347,5663,75604,4614,2284,2330
54105,83844,8237,40349,5664,75607,4614,2284,2330
54110,83854,8238,40353,5665,75616,4614,2284,2330
54115,83860,8238,40354,5665,75622,4615,2285,2330
54120,83871,8241,40359,5667,75630,4615,2285,2330
54125,83875,8241,40362,5667,75634,4615,2285,2330
54130,83885,8242,40368,5667,75643,4615,2285,2330
54135,83891,8242,40373,5667,75649,4616,2286,2330
54140,83902,8243,40376,5668,75659,4616,2286,2330
54145,83906,8244,40377,5669,75662,4616,2286,2330
54150,83916,8245,40383,5669,75671,4616,2286,2330
54155,83922,8245,40386,5669,75677,4617,2287,2330
54160,83933,8246,40389,5669,75687,4617,2287,2330
54165,83937,8246,40391,5669,75691,4617,2287,2330
54170,83947,8248,40395,5670,75699,4617,2287,2330
54175,83953,8248,40400,5670,75704,4618,2288,2330
54180,83964,8252,40408,5674,75711,4619,2289,2330
54185,83968,8253,40410,5675,75715,4619,2289,2330
54190,83978,8254,40413,5676,75724,4619,2289,2330
54195,83984,8254,40416,5676,75730,4620,2290,2330
54200,83995,8255,40424,5677,75740,4620,2290,2330
54205,83999,8255,40426,5677,75744,4620,2290,2330
54210,84009,8256,40430,5677,75753,4620,2290,2330
54215,84015,8256,40433,5677,75759,4621,2290,2331
54220,84026,8257,40440,5678,75769,4621,2290,2331
54225,84030,8257,40441,5678,75773,4621,2290,2331
54230,84040,8258,40448,5678,75782,4621,2290,2331
54235,84046,8258,40449,5678,75788,4623,2290,2333
54240,84057,8259,40453,5679,75798,4623,2290,2333
54245,84061,8259,40453,5679,75802,4623,2290,2333
54250,84071,8261,40460,5680,75810,4623,2290,2333
54255,84077,8261,40463,5680,75816,4625,2291,2334
54260,84088,8263,40470,5682,75825,4625,2291,2334
54265,84092,8263,40473,5682,75829,4625,2291,2334
54270,84102,8265,40477,5683,75837,4625,2291,2334
54275,84108,8265,40478,5683,75843,4627,2292,2335
54280,84119,8266,40482,5684,75853,4627,2292,2335
54285,84123,8266,40484,5684,75857,4627,2292,2335
54290,84133,8268,40490,5686,75865,4627,2292,2335
54295,84139,8268,40493,5686,75870,4629,2293,2336
54300,84150,8270,40495,5687,75880,4630,2293,2337
54305,84154,8271,40498,5688,75883,4630,2293,2337
54310,84164,8271,40504,5688,75893,4630,2293,2337
54315,84170,8271,40509,5688,75899,4631,2294,2337
54320,84181,8272,40516,5688,75909,4631,2294,2337
54325,84185,8272,40518,5688,75913,4631,2294,2337
54330,84195,8272,40525,5688,75923,4631,2294,2337
54335,84201,8272,40527,5688,75929,4632,2294,2338
54340,84212,8273,40533,5688,75939,4632,2294,2338
54345,84216,8273,40537,5688,75943,4632,2294,2338
54350,84226,8273,40540,5688,75953,4632,2294,2338
54355,84232,8273,40542,5688,75959,4633,2294,2339
54360,84243,8274,40545,5688,75969,4633,2294,2339
54365,84247,8274,40547,5688,75973,4633,2294,2339
54370,84257,8274,40554,5688,75983,4633,2294,2339
54375,84263,8274,40558,5688,75989,4634,2294,2340
54380,84274,8275,40563,5688,75999,4634,2294,2340
54385,84278,8275,40564,5688,76003,4634,2294,2340
54390,84288,8275,40571,5688,76013,4634,2294,2340
54395,84294,8275,40575,5688,76019,4635,2294,2341
54400,84305,8276,40581,5689,76029,4635,2294,2341
54405,84309,8276,40583,5689,76033,4635,2294,2341
54410,84319,8278,40587,5691,76041,4635,2294,2341
54415,84325,8278,40591,5691,76046,4637,2295,2342
54420,84336,8280,40594,5693,76056,4638,2296,2342
54425,84340,8280,40596,5693,76060,4638,2296,2342
54430,84350,8282,40601,5694,76068,4638,2296,2342
54435,84356,8282,40604,5694,76074,4640,2296,2344
54440,84367,8284,40608,5695,76083,4640,2296,2344
54445,84371,8284,40609,5695,76087,4640,2296,2344
54450,84381,8286,40614,5696,76095,4640,2296,2344
54455,84387,8286,40616,5696,76101,4642,2297,2345
54460,84398,8287,40621,5696,76111,4642,2297,2345
54465,84402,8287,40621,5696,76115,4642,2297,2345
54470,84412,8289,40627,5698,76123,4642,2297,2345
54475,84418,8289,40631,5698,76129,4643,2298,2345
54480,84429,8292,40638,5701,76137,4643,2298,2345
54485,84433,8292,40640,5701,76141,4643,2298,2345
54490,84443,8294,40643,5702,76149,4643,2298,2345
54495,84449,8294,40646,5702,76155,4644,2299,2345
54500,84460,8295,40653,5702,76165,4644,2299,2345
54505,84464,8296,40657,5703,76168,4644,2299,2345
54510,84474,8298,40664,5705,76176,4644,2299,2345
54515,84480,8298,40667,5705,76182,4645,2300,2345
54520,84491,8299,40671,5705,76192,4645,2300,2345
54525,84495,8300,40672,5706,76195,4645,2300,2345
54530,84505,8302,40677,5707,76203,4645,2300,2345
54535,84511,8302,40678,5707,76209,4646,2300,2346
54540,84522,8305,40684,5709,76216,4647,2301,2346
54545,84526,8306,40684,5710,76220,4647,2301,2346
54550,84536,8307,40686,5710,76229,4647,2301,2346
54555,84542,8307,40690,5710,76235,4648,2302,2346
54560,84553,8308,40696,5711,76245,4649,2302,2347
54565,84557,8308,40698,5711,76249,4649,2302,2347
54570,84567,8309,40701,5711,76258,4649,2302,2347
54575,84573,8309,40706,5711,76264,4651,2303,2348
54580,84584,8310,40712,5712,76274,4652,2304,2348
54585,84588,8311,40713,5713,76277,4652,2304,2348
54590,84598,8312,40720,5714,76286,4652,2304,2348
54595,84604,8312,40722,5714,76292,4654,2305,2349
54600,84615,8314,40728,5715,76301,4655,2305,2350
54605,84619,8314,40731,5715,76305,4655,2305,2350
54610,84629,8314,40737,5715,76315,4655,2305,2350
54615,84635,8314,40739,5715,76321,4656,2306,2350
54620,84646,8315,40742,5715,76331,4656,2306,2350
54625,84650,8315,40743,5715,76335,4656,2306,2350
54630,84660,8315,40746,5715,76345,4656,2306,2350
54635,84666,8315,40749,5715,76351,4657,2307,2350
54640,84677,8316,40754,5715,76361,4657,2307,2350
54645,84681,8316,40757,5715,76365,4657,2307,2350
54650,84691,8316,40762,5715,76375,4657,2307,2350
54655,84697,8316,40767,5715,76381,4658,2308,2350
54660,84708,8317,40777,5716,76391,4658,2308,2350
54665,84712,8317,40778,5716,76395,4658,2308,2350
54670,84722,8317,40785,5716,76405,4658,2308,2350
54675,84728,8317,40787,5716,76411,4659,2308,2351
54680,84739,8318,40791,5716,76421,4659,2308,2351
54685,84743,8319,40794,5717,76424,4659,2308,2351
54690,84753,8319,40800,5717,76434,4659,2308,2351
54695,84759,8319,40803,5717,76440,4660,2308,2352
54700,84770,8321,40808,5718,76449,4660,2308,2352
54705,84774,8321,40811,5718,76453,4660,2308,2352
54710,84784,8323,40818,5720,76461,4660,2308,2352
54715,84790,8323,40820,5720,76466,4662,2308,2354
54720,84801,8329,40828,5725,76471,4663,2309,2354
54725,84805,8331,40829,5727,76474,4663,2309,2354
54730,84815,8332,40834,5728,76483,4663,2309,2354
54735,84821,8332,40836,5728,76489,4664,2309,2355
54740,84832,8333,40842,5729,76499,4665,2310,2355
54745,84836,8334,40844,5730,76502,4665,2310,2355
54750,84846,8335,40848,5730,76511,4665,2310,2355
54755,84852,8335,40850,5730,76517,4666,2310,2356
54760,84863,8336,40854,5730,76527,4667,2310,2357
54765,84867,8336,40855,5730,76531,4667,2310,2357
54770,84877,8337,40857,5730,76540,4667,2310,2357
54775,84883,8337,40859,5730,76546,4668,2310,2358
54780,84894,8338,40864,5730,76556,4669,2310,2359
54785,84898,8338,40866,5730,76560,4669,2310,2359
54790,84908,8340,40869,5730,76568,4669,2310,2359
54795,84914,8340,40872,5730,76574,4670,2311,2359
54800,84925,8341,40877,5730,76584,4670,2311,2359
54805,84929,8341,40878,5730,76588,4670,2311,2359
54810,84939,8343,40882,5730,76596,4670,2311,2359
54815,84945,8343,40885,5730,76602,4671,2311,2360
54820,84956,8345,40889,5731,76611,4671,2311,2360
54825,84960,8345,40890,5731,76615,4671,2311,2360
54830,84970,8347,40894,5731,76623,4671,2311,2360
54835,84976,8347,40896,5731,76628,4673,2311,2362
54840,84987,8351,40902,5734,76636,4673,2311,2362
54845,84991,8351,40903,5734,76640,4673,2311,2362
54850,85001,8352,40906,5734,76649,4673,2311,2362
54855,85007,8352,40910,5734,76654,4675,2313,2362
54860,85018,8355,40915,5736,76663,4675,2313,2362
54865,85022,8356,40918,5737,76666,4675,2313,2362
54870,85032,8357,40923,5737,76675,4675,2313,2362
54875,85038,8357,40925,5737,76681,4677,2313,2364
54880,85049,8358,40931,5738,76691,4677,2313,2364
54885,85053,8358,40933,5738,76695,4677,2313,2364
54890,85063,8359,40937,5738,76704,4677,2313,2364
54895,85069,8359,40941,5738,76710,4678,2313,2365
54900,85080,8362,40950,5741,76718,4678,2313,2365
54905,85084,8362,40953,5741,76722,4678,2313,2365
54910,85094,8363,40958,5741,76731,4678,2313,2365
54915,85100,8363,40960,5741,76737,4679,2314,2365
54920,85111,8363,40964,5741,76748,4679,2314,2365
54925,85115,8363,40966,5741,76752,4679,2314,2365
54930,85125,8364,40968,5742,76761,4679,2314,2365
54935,85131,8364,40971,5742,76767,4680,2315,2365
54940,85142,8364,40977,5742,76778,4680,2315,2365
54945,85146,8364,40979,5742,76782,4680,2315,2365
54950,85156,8366,40982,5742,76790,4680,2315,2365
54955,85162,8366,40984,5742,76796,4681,2316,2365
54960,85173,8368,40991,5744,76805,4682,2317,2365
54965,85177,8370,40994,5746,76807,4682,2317,2365
54970,85187,8372,40999,5748,76815,4682,2317,2365
54975,85193,8372,41002,5748,76821,4683,2317,2366
54980,85204,8375,41008,5750,76829,4684,2317,2367
54985,85208,8375,41009,5750,76833,4684,2317,2367
54990,85218,8377,41015,5752,76841,4684,2317,2367
54995,85224,8377,41019,5752,76847,4686,2319,2367
55000,85235,8380,41027,5754,76855,4687,2319,2368
55005,85239,8382,41029,5756,76857,4687,2319,2368
55010,85249,8384,41035,5757,76865,4687,2319,2368
55015,85255,8384,41037,5757,76871,4689,2319,2370
55020,85266,8386,41043,5759,76880,4690,2319,2371
55025,85270,8387,41045,5760,76883,4690,2319,2371
55030,85280,8388,41047,5760,76892,4690,2319,2371
55035,85286,8388,41049,5760,76898,4691,2319,2372
55040,85297,8390,41056,5762,76907,4691,2319,2372
55045,85301,8390,41057,5762,76911,4691,2319,2372
55050,85311,8391,41063,5762,76920,4691,2319,2372
55055,85317,8391,41066,5762,76926,4692,2319,2373
55060,85328,8393,41075,5764,76935,4692,2319,2373
55065,85332,8394,41077,5765,76938,4692,2319,2373
55070,85342,8395,41083,5766,76947,4692,2319,2373
55075,85348,8395,41087,5766,76953,4693,2320,2373
55080,85359,8397,41094,5767,76962,4693,2320,2373
55085,85363,8397,41097,5767,76966,4693,2320,2373
55090,85373,8397,41101,5767,76976,4693,2320,2373
55095,85379,8397,41106,5767,76982,4695,2321,2374
55100,85390,8397,41111,5767,76993,4695,2321,2374
55105,85394,8397,41112,5767,76997,4695,2321,2374
55110,85404,8397,41119,5767,77007,4695,2321,2374
55115,85410,8397,41119,5767,77013,4696,2321,2375
55120,85421,8397,41124,5767,77024,4696,2321,2375
55125,85425,8397,41125,5767,77028,4696,2321,2375
55130,85435,8398,41128,5767,77037,4696,2321,2375
55135,85441,8398,41131,5767,77042,4697,2322,2375
55140,85452,8400,41135,5769,77052,4698,2323,2375
55145,85456,8400,41138,5769,77056,4698,2323,2375
55150,85466,8401,41142,5770,77065,4698,2323,2375
55155,85472,8401,41144,5770,77071,4699,2324,2375
55160,85483,8404,41149,5773,77079,4700,2324,2376
55165,85487,8404,41152,5773,77083,4700,2324,2376
55170,85497,8405,41155,5773,77092,4700,2324,2376
55175,85503,8405,41159,5773,77097,4701,2324,2377
55180,85514,8407,41162,5774,77107,4702,2324,2378
55185,85518,8407,41164,5774,77111,4702,2324,2378
55190,85528,8409,41167,5774,77119,4702,2324,2378
55195,85534,8409,41169,5774,77125,4703,2325,2378
55200,85545,8413,41173,5777,77132,4704,2325,2379
55205,85549,8414,41174,5778,77135,4704,2325,2379
55210,85559,8415,41178,5779,77144,4704,2325,2379
55215,85565,8415,41181,5779,77150,4706,2327,2379
55220,85576,8416,41182,5779,77160,4707,2328,2379
55225,85580,8417,41185,5780,77163,4707,2328,2379
55230,85590,8418,41189,5780,77172,4707,2328,2379
55235,85596,8418,41192,5780,77178,4709,2329,2380
55240,85607,8420,41195,5782,77187,4710,2329,2381
55245,85611,8420,41196,5782,77191,4710,2329,2381
55250,85621,8421,41199,5783,77200,4710,2329,2381
55255,85627,8421,41202,5783,77206,4712,2331,2381
55260,85638,8423,41207,5784,77215,4713,2331,2382
55265,85642,8423,41209,5784,77219,4713,2331,2382
55270,85652,8424,41213,5784,77228,4713,2331,2382
55275,85658,8424,41217,5784,77234,4714,2331,2383
55280,85669,8425,41223,5784,77244,4714,2331,2383
55285,85673,8426,41226,5785,77247,4714,2331,2383
55290,85683,8427,41231,5785,77256,4714,2331,2383
55295,85689,8427,41235,5785,77262,4715,2332,2383
55300,85700,8429,41240,5787,77271,4715,2332,2383
55305,85704,8429,41242,5787,77275,4715,2332,2383
55310,85714,8431,41247,5788,77283,4715,2332,2383
55315,85720,8431,41248,5788,77289,4716,2332,2384
55320,85731,8434,41253,5790,77297,4716,2332,2384
55325,85735,8435,41254,5791,77300,4716,2332,2384
55330,85745,8437,41262,5792,77308,4716,2332,2384
55335,85751,8437,41265,5792,77314,4717,2333,2384
55340,85762,8437,41268,5792,77325,4717,2333,2384
55345,85766,8437,41268,5792,77329,4717,2333,2384
55350,85776,8439,41275,5792,77337,4717,2333,2384
55355,85782,8439,41279,5792,77343,4718,2333,2385
55360,85793,8440,41284,5793,77353,4718,2333,2385
55365,85797,8440,41285,5793,77357,4718,2333,2385
55370,85807,8442,41289,5794,77365,4718,2333,2385
55375,85813,8442,41293,5794,77371,4720,2335,2385
55380,85824,8443,41297,5795,77381,4720,2335,2385
55385,85828,8444,41299,5796,77384,4720,2335,2385
55390,85838,8446,41302,5796,77392,4720,2335,2385
55395,85844,8446,41304,5796,77398,4722,2336,2386
55400,85855,8447,41309,5797,77408,4722,2336,2386
55405,85859,8447,41311,5797,77412,4722,2336,2386
55410,85869,8449,41314,5797,77420,4722,2336,2386
55415,85875,8449,41317,5797,77426,4724,2337,2387
55420,85886,8450,41321,5798,77436,4724,2337,2387
55425,85890,8450,41325,5798,77440,4724,2337,2387
55430,85900,8452,41327,5799,77448,4724,2337,2387
55435,85906,8452,41330,5799,77454,4725,2337,2388
55440,85917,8456,41333,5802,77461,4725,2337,2388
55445,85921,8457,41335,5803,77464,4725,2337,2388
55450,85931,8457,41339,5803,77474,4725,2337,2388
55455,85937,8457,41342,5803,77480,4726,2337,2389
55460,85948,8458,41350,5804,77490,4726,2337,2389
55465,85952,8458,41350,5804,77494,4726,2337,2389
55470,85962,8458,41354,5804,77504,4726,2337,2389
55475,85968,8458,41357,5804,77510,4727,2337,2390
55480,85979,8459,41360,5804,77520,4727,2337,2390
55485,85983,8459,41362,5804,77524,4727,2337,2390
55490,85993,8459,41366,5804,77534,4727,2337,2390
55495,85999,8459,41370,5804,77540,4728,2337,2391
55500,86010,8460,41377,5805,77550,4728,2337,2391
55505,86014,8461,41379,5806,77553,4728,2337,2391
55510,86024,8462,41383,5806,77562,4728,2337,2391
55515,86030,8462,41388,5806,77567,4729,2338,2391
55520,86041,8465,41392,5808,77576,4729,2338,2391
55525,86045,8466,41395,5809,77579,4729,2338,2391
55530,86055,8467,41400,5809,77588,4729,2338,2391
55535,86061,8467,41405,5809,77593,4731,2340,2391
55540,86072,8470,41412,5811,77601,4731,2340,2391
55545,86076,8472,41415,5813,77604,4731,2340,2391
55550,86086,8473,41419,5813,77613,4731,2340,2391
55555,86092,8473,41422,5813,77618,4733,2341,2392
55560,86103,8479,41429,5818,77624,4733,2341,2392
55565,86107,8479,41431,5818,77628,4733,2341,2392
55570,86117,8480,41435,5818,77637,4733,2341,2392
55575,86123,8480,41439,5818,77643,4735,2341,2394
55580,86134,8482,41443,5819,77652,4736,2341,2395
55585,86138,8482,41444,5819,77656,4736,2341,2395
55590,86148,8483,41448,5819,77665,4736,2341,2395
55595,86154,8483,41450,5819,77671,4738,2342,2396
55600,86165,8484,41452,5819,77681,4739,2343,2396
55605,86169,8484,41453,5819,77685,4739,2343,2396
55610,86179,8485,41457,5819,77694,4739,2343,2396
55615,86185,8485,41460,5819,77700,4740,2343,2397
55620,86196,8487,41466,5821,77709,4741,2343,2398
55625,86200,8487,41467,5821,77713,4741,2343,2398
55630,86210,8488,41470,5822,77722,4741,2343,2398
55635,86216,8488,41475,5822,77728,4742,2344,2398
55640,86227,8489,41484,5823,77738,4742,2344,2398
55645,86231,8489,41488,5823,77742,4742,2344,2398
55650,86241,8490,41493,5824,77751,4742,2344,2398
55655,86247,8490,41495,5824,77757,4743,2344,2399
55660,86258,8490,41501,5824,77768,4743,2344,2399
55665,86262,8490,41503,5824,77772,4743,2344,2399
55670,86272,8492,41507,5825,77780,4743,2344,2399
55675,86278,8492,41510,5825,77786,4744,2344,2400
55680,86289,8494,41514,5827,77795,4744,2344,2400
55685,86293,8494,41518,5827,77799,4744,2344,2400
55690,86303,8495,41523,5827,77808,4744,2344,2400
55695,86309,8495,41527,5827,77814,4745,2344,2401
55700,86320,8495,41532,5827,77825,4745,2344,2401
55705,86324,8495,41534,5827,77829,4745,2344,2401
55710,86334,8496,41537,5827,77838,4745,2344,2401
55715,86340,8496,41543,5827,77844,4746,2345,2401
55720,86351,8496,41548,5827,77855,4746,2345,2401
55725,86355,8496,41548,5827,77859,4746,2345,2401
55730,86365,8497,41555,5828,77868,4746,2345,2401
55735,86371,8497,41558,5828,77874,4748,2347,2401
55740,86382,8498,41562,5829,77884,4749,2347,2402
55745,86386,8498,41563,5829,77888,4749,2347,2402
55750,86396,8499,41569,5830,77897,4749,2347,2402
55755,86402,8499,41572,5830,77903,4750,2348,2402
55760,86413,8501,41577,5831,77912,4750,2348,2402
55765,86417,8501,41580,5831,77916,4750,2348,2402
55770,86427,8502,41585,5832,77925,4750,2348,2402
55775,86433,8502,41589,5832,77931,4751,2349,2402
55780,86444,8504,41595,5833,77940,4751,2349,2402
55785,86448,8504,41596,5833,77944,4751,2349,2402
55790,86458,8506,41599,5834,77952,4751,2349,2402
55795,86464,8506,41600,5834,77958,4752,2349,2403
55800,86475,8509,41604,5836,77965,4752,2349,2403
55805,86479,8510,41606,5837,77969,4752,2349,2403
55810,86489,8512,41607,5837,77977,4752,2349,2403
55815,86495,8512,41609,5837,77982,4753,2350,2403
55820,86506,8515,41613,5840,77991,4753,2350,2403
55825,86510,8515,41614,5840,77995,4753,2350,2403
55830,86520,8517,41621,5842,78003,4753,2350,2403
55835,86526,8517,41622,5842,78009,4754,2350,2404
55840,86537,8520,41627,5844,78017,4754,2350,2404
55845,86541,8520,41630,5844,78021,4754,2350,2404
55850,86551,8522,41633,5846,78029,4754,2350,2404
55855,86557,8522,41637,5846,78034,4756,2351,2405
55860,86568,8525,41643,5848,78043,4757,2352,2405
55865,86572,8526,41646,5849,78046,4757,2352,2405
55870,86582,8527,41649,5849,78055,4757,2352,2405
55875,86588,8527,41651,5849,78061,4758,2352,2406
55880,86599,8530,41655,5851,78069,4758,2352,2406
55885,86603,8530,41657,5851,78073,4758,2352,2406
55890,86613,8531,41663,5851,78082,4758,2352,2406
55895,86619,8531,41667,5851,78088,4759,2353,2406
55900,86630,8533,41675,5853,78097,4759,2353,2406
55905,86634,8534,41678,5854,78100,4759,2353,2406
55910,86644,8535,41683,5854,78109,4759,2353,2406
55915,86650,8535,41687,5854,78115,4760,2353,2407
55920,86661,8536,41689,5854,78125,4760,2353,2407
55925,86665,8536,41692,5854,78129,4760,2353,2407
55930,86675,8536,41695,5854,78139,4760,2353,2407
55935,86681,8536,41698,5854,78145,4761,2354,2407
55940,86692,8536,41702,5854,78156,4761,2354,2407
55945,86696,8536,41704,5854,78160,4761,2354,2407
55950,86706,8536,41709,5854,78170,4761,2354,2407
55955,86712,8536,41712,5854,78176,4762,2354,2408
55960,86723,8536,41720,5854,78187,4762,2354,2408
55965,86727,8536,41720,5854,78191,4762,2354,2408
55970,86737,8537,41723,5854,78200,4762,2354,2408
55975,86743,8537,41726,5854,78206,4764,2355,2409
55980,86754,8537,41733,5854,78217,4765,2356,2409
55985,86758,8537,41735,5854,78221,4765,2356,2409
55990,86768,8538,41740,5855,78230,4765,2356,2409
55995,86774,8538,41744,5855,78236,4767,2357,2410
56000,86785,8538,41751,5855,78246,4767,2357,2410
56005,86789,8539,41753,5856,78250,4767,2357,2410
56010,86799,8540,41758,5856,78259,4767,2357,2410
56015,86805,8540,41759,5856,78265,4769,2358,2411
56020,86816,8541,41762,5857,78275,4769,2358,2411
56025,86820,8541,41764,5857,78279,4769,2358,2411
56030,86830,8542,41770,5857,78288,4769,2358,2411
56035,86836,8542,41774,5857,78293,4771,2359,2412
56040,86847,8547,41780,5861,78299,4771,2359,2412
56045,86851,8548,41782,5862,78303,4771,2359,2412
56050,86861,8550,41785,5863,78311,4771,2359,2412
56055,86867,8550,41789,5863,78317,4773,2359,2414
56060,86878,8551,41793,5863,78327,4773,2359,2414
56065,86882,8551,41796,5863,78331,4773,2359,2414
56070,86892,8553,41799,5864,78339,4773,2359,2414
56075,86898,8553,41801,5864,78345,4775,2360,2415
56080,86909,8555,41807,5866,78354,4775,2360,2415
56085,86913,8556,41809,5867,78357,4775,2360,2415
56090,86923,8558,41813,5867,78365,4775,2360,2415
56095,86929,8558,41816,5867,78371,4776,2361,2415
56100,86940,8562,41825,5870,78378,4777,2362,2415
56105,86944,8563,41826,5871,78381,4777,2362,2415
56110,86954,8565,41832,5872,78389,4777,2362,2415
56115,86960,8565,41835,5872,78395,4778,2363,2415
56120,86971,8567,41837,5873,78404,4779,2363,2416
56125,86975,8569,41840,5875,78406,4779,2363,2416
56130,86985,8571,41844,5875,78414,4779,2363,2416
56135,86991,8571,41845,5875,78420,4780,2363,2417
56140,87002,8573,41852,5876,78429,4781,2364,2417
56145,87006,8575,41854,5878,78431,4781,2364,2417
56150,87016,8577,41859,5879,78439,4781,2364,2417
56155,87022,8577,41863,5879,78444,4782,2365,2417
56160,87033,8581,41870,5882,78452,4783,2366,2417
56165,87037,8581,41873,5882,78456,4783,2366,2417
56170,87047,8581,41876,5882,78466,4783,2366,2417
56175,87053,8581,41879,5882,78472,4784,2367,2417
56180,87064,8581,41884,5882,78483,4785,2367,2418
56185,87068,8581,41885,5882,78487,4785,2367,2418
56190,87078,8581,41890,5882,78497,4785,2367,2418
56195,87084,8581,41893,5882,78503,4787,2368,2419
56200,87095,8581,41896,5882,78514,4787,2368,2419
56205,87099,8581,41900,5882,78518,4787,2368,2419
56210,87109,8581,41905,5882,78528,4787,2368,2419
56215,87115,8581,41909,5882,78534,4789,2370,2419
56220,87126,8581,41914,5882,78545,4789,2370,2419
56225,87130,8581,41918,5882,78549,4789,2370,2419
56230,87140,8581,41923,5882,78559,4789,2370,2419
56235,87146,8581,41927,5882,78565,4790,2371,2419
56240,87157,8581,41930,5882,78576,4791,2372,2419
56245,87161,8581,41934,5882,78580,4791,2372,2419
56250,87171,8581,41938,5882,78590,4791,2372,2419
56255,87177,8581,41940,5882,78596,4792,2372,2420
56260,87188,8581,41947,5882,78607,4792,2372,2420
56265,87192,8581,41950,5882,78611,4792,2372,2420
56270,87202,8583,41954,5882,78619,4792,2372,2420
56275,87208,8583,41956,5882,78625,4793,2372,2421
56280,87219,8586,41960,5884,78633,4793,2372,2421
56285,87223,8586,41962,5884,78637,4793,2372,2421
56290,87233,8586,41967,5884,78647,4793,2372,2421
56295,87239,8586,41970,5884,78653,4794,2373,2421
56300,87250,8588,41977,5886,78662,4794,2373,2421
56305,87254,8588,41979,5886,78666,4794,2373,2421
56310,87264,8588,41985,5886,78676,4794,2373,2421
56315,87270,8588,41987,5886,78682,4795,2373,2422
56320,87281,8589,41993,5886,78692,4795,2373,2422
56325,87285,8589,41995,5886,78696,4795,2373,2422
56330,87295,8589,42004,5886,78706,4795,2373,2422
56335,87301,8589,42005,5886,78712,4797,2374,2423
56340,87312,8590,42010,5886,78722,4797,2374,2423
56345,87316,8590,42011,5886,78726,4797,2374,2423
56350,87326,8590,42017,5886,78736,4797,2374,2423
56355,87332,8590,42021,5886,78742,4799,2375,2424
56360,87343,8591,42028,5887,78752,4799,2375,2424
56365,87347,8591,42032,5887,78756,4799,2375,2424
56370,87357,8591,42034,5887,78766,4799,2375,2424
56375,87363,8591,42036,5887,78772,4800,2375,2425
56380,87374,8592,42045,5887,78782,4800,2375,2425
56385,87378,8592,42045,5887,78786,4800,2375,2425
56390,87388,8594,42051,5888,78794,4800,2375,2425
56395,87394,8594,42053,5888,78800,4801,2375,2426
56400,87405,8596,42057,5890,78809,4801,2375,2426
56405,87409,8597,42058,5891,78812,4801,2375,2426
56410,87419,8599,42065,5892,78820,4801,2375,2426
56415,87425,8599,42069,5892,78826,4802,2375,2427
56420,87436,8601,42076,5894,78835,4803,2376,2427
56425,87440,8601,42077,5894,78839,4803,2376,2427
56430,87450,8603,42081,5895,78847,4803,2376,2427
56435,87456,8603,42083,5895,78853,4804,2377,2427
56440,87467,8606,42089,5898,78861,4805,2377,2428
56445,87471,8607,42091,5899,78864,4805,2377,2428
56450,87481,8609,42095,5901,78872,4805,2377,2428
56455,87487,8609,42099,5901,78878,4806,2378,2428
56460,87498,8611,42105,5902,78887,4807,2378,2429
56465,87502,8612,42108,5903,78890,4807,2378,2429
56470,87512,8614,42112,5905,78898,4807,2378,2429
56475,87518,8614,42114,5905,78904,4808,2378,2430
56480,87529,8615,42119,5905,78914,4808,2378,2430
56485,87533,8615,42122,5905,78918,4808,2378,2430
56490,87543,8617,42130,5907,78926,4808,2378,2430
56495,87549,8617,42135,5907,78932,4809,2379,2430
56500,87560,8618,42140,5908,78942,4809,2379,2430
56505,87564,8619,42142,5909,78945,4809,2379,2430
56510,87574,8621,42147,5910,78953,4809,2379,2430
56515,87580,8621,42152,5910,78959,4810,2380,2430
56520,87591,8623,42157,5911,78968,4810,2380,2430
56525,87595,8623,42157,5911,78972,4810,2380,2430
56530,87605,8625,42162,5912,78980,4810,2380,2430
56535,87611,8625,42166,5912,78986,4811,2381,2430
56540,87622,8627,42170,5913,78995,4811,2381,2430
56545,87626,8627,42172,5913,78999,4811,2381,2430
56550,87636,8629,42179,5913,79007,4811,2381,2430
56555,87642,8629,42180,5913,79013,4812,2381,2431
56560,87653,8630,42183,5914,79023,4812,2381,2431
56565,87657,8631,42184,5915,79026,4812,2381,2431
56570,87667,8633,42191,5917,79034,4812,2381,2431
56575,87673,8633,42195,5917,79040,4813,2382,2431
56580,87684,8636,42201,5920,79048,4813,2382,2431
56585,87688,8637,42203,5921,79051,4813,2382,2431
56590,87698,8639,42208,5922,79059,4813,2382,2431
56595,87704,8639,42209,5922,79065,4814,2382,2432
56600,87715,8640,42214,5923,79075,4814,2382,2432
56605,87719,8640,42217,5923,79079,4814,2382,2432
56610,87729,8642,42221,5924,79087,4814,2382,2432
56615,87735,8642,42225,5924,79093,4815,2383,2432
56620,87746,8642,42229,5924,79104,4815,2383,2432
56625,87750,8643,42231,5925,79107,4815,2383,2432
56630,87760,8645,42238,5927,79115,4815,2383,2432
56635,87766,8645,42242,5927,79121,4816,2383,2433
56640,87777,8646,42250,5928,79131,4816,2383,2433
56645,87781,8646,42251,5928,79135,4816,2383,2433
56650,87791,8648,42257,5930,79143,4816,2383,2433
56655,87797,8648,42261,5930,79149,4818,2384,2434
56660,87808,8649,42267,5931,79159,4818,2384,2434
56665,87812,8650,42271,5932,79162,4818,2384,2434
56670,87822,8652,42277,5934,79170,4818,2384,2434
56675,87828,8652,42279,5934,79176,4820,2385,2435
56680,87839,8653,42287,5935,79186,4820,2385,2435
56685,87843,8653,42289,5935,79190,4820,2385,2435
56690,87853,8655,42294,5936,79198,4820,2385,2435
56695,87859,8655,42297,5936,79203,4822,2386,2436
56700,87870,8659,42301,5939,79210,4823,2386,2437
56705,87874,8660,42304,5940,79214,4823,2386,2437
56710,87884,8661,42309,5941,79223,4823,2386,2437
56715,87890,8661,42312,5941,79229,4824,2386,2438
56720,87901,8662,42317,5941,79239,4824,2386,2438
56725,87905,8663,42318,5942,79242,4824,2386,2438
56730,87915,8664,42322,5943,79251,4824,2386,2438
56735,87921,8664,42323,5943,79257,4825,2386,2439
56740,87932,8666,42328,5944,79266,4825,2386,2439
56745,87936,8667,42329,5945,79269,4825,2386,2439
56750,87946,8668,42335,5945,79278,4825,2386,2439
56755,87952,8668,42336,5945,79284,4826,2387,2439
56760,87963,8670,42341,5946,79293,4826,2387,2439
56765,87967,8671,42344,5947,79296,4826,2387,2439
56770,87977,8672,42350,5948,79305,4826,2387,2439
56775,87983,8672,42355,5948,79310,4827,2387,2440
56780,87994,8673,42361,5949,79321,4828,2387,2441
56785,87998,8673,42363,5949,79325,4828,2387,2441
56790,88008,8674,42369,5950,79334,4828,2387,2441
56795,88014,8674,42369,5950,79340,4829,2387,2442
56800,88025,8674,42373,5950,79351,4830,2388,2442
56805,88029,8674,42374,5950,79355,4830,2388,2442
56810,88039,8675,42380,5950,79364,4830,2388,2442
56815,88045,8675,42382,5950,79370,4831,2388,2443
56820,88056,8676,42388,5951,79380,4832,2388,2444
56825,88060,8677,42390,5952,79383,4832,2388,2444
56830,88070,8679,42395,5953,79391,4832,2388,2444
56835,88076,8679,42397,5953,79397,4834,2388,2446
56840,88087,8681,42401,5954,79406,4834,2388,2446
56845,88091,8681,42402,5954,79410,4834,2388,2446
56850,88101,8683,42407,5955,79418,4834,2388,2446
56855,88107,8683,42409,5955,79424,4835,2389,2446
56860,88118,8684,42416,5955,79434,4835,2389,2446
56865,88122,8685,42420,5956,79437,4835,2389,2446
56870,88132,8687,42425,5958,79445,4835,2389,2446
56875,88138,8687,42425,5958,79451,4836,2389,2447
56880,88149,8689,42426,5959,79460,4836,2389,2447
56885,88153,8689,42427,5959,79464,4836,2389,2447
56890,88163,8691,42431,5959,79472,4836,2389,2447
56895,88169,8691,42436,5959,79478,4837,2390,2447
56900,88180,8692,42442,5960,79488,4837,2390,2447
56905,88184,8692,42444,5960,79492,4837,2390,2447
56910,88194,8694,42448,5960,79500,4837,2390,2447
56915,88200,8694,42450,5960,79506,4838,2390,2448
56920,88211,8695,42456,5961,79516,4838,2390,2448
56925,88215,8695,42457,5961,79520,4838,2390,2448
56930,88225,8697,42461,5962,79528,4838,2390,2448
56935,88231,8697,42463,5962,79533,4839,2390,2449
56940,88242,8699,42467,5964,79543,4839,2390,2449
56945,88246,8699,42470,5964,79547,4839,2390,2449
56950,88256,8700,42476,5964,79556,4839,2390,2449
56955,88262,8700,42478,5964,79562,4841,2391,2450
56960,88273,8701,42483,5965,79572,4841,2391,2450
56965,88277,8701,42484,5965,79576,4841,2391,2450
56970,88287,8702,42485,5965,79585,4841,2391,2450
56975,88293,8702,42490,5965,79590,4843,2392,2451
56980,88304,8704,42496,5967,79600,4843,2392,2451
56985,88308,8704,42496,5967,79604,4843,2392,2451
56990,88318,8705,42505,5968,79613,4843,2392,2451
56995,88324,8705,42507,5968,79619,4845,2394,2451
57000,88335,8708,42513,5971,79627,4846,2395,2451
57005,88339,8708,42516,5971,79631,4846,2395,2451
57010,88349,8708,42521,5971,79641,4846,2395,2451
57015,88355,8708,42523,5971,79647,4848,2396,2452
57020,88366,8710,42531,5973,79656,4849,2396,2453
57025,88370,8711,42533,5974,79659,4849,2396,2453
57030,88380,8711,42540,5974,79669,4849,2396,2453
57035,88386,8711,42545,5974,79675,4851,2398,2453
57040,88397,8712,42548,5974,79685,4852,2398,2454
57045,88401,8712,42549,5974,79689,4852,2398,2454
57050,88411,8713,42553,5975,79698,4852,2398,2454
57055,88417,8713,42554,5975,79704,4854,2398,2456
57060,88428,8714,42560,5976,79714,4855,2398,2457
57065,88432,8715,42562,5977,79717,4855,2398,2457
57070,88442,8716,42565,5977,79726,4855,2398,2457
57075,88448,8716,42567,5977,79732,4856,2398,2458
57080,88459,8717,42571,5978,79742,4857,2398,2459
57085,88463,8719,42574,5980,79744,4857,2398,2459
57090,88473,8720,42578,5980,79753,4857,2398,2459
57095,88479,8720,42583,5980,79759,4858,2399,2459
57100,88490,8723,42588,5983,79767,4859,2399,2460
57105,88494,8724,42590,5984,79770,4859,2399,2460
57110,88504,8726,42595,5985,79778,4859,2399,2460
57115,88510,8726,42598,5985,79784,4860,2399,2461
57120,88521,8728,42603,5987,79793,4861,2400,2461
57125,88525,8728,42606,5987,79797,4861,2400,2461
57130,88535,8730,42612,5989,79805,4861,2400,2461
57135,88541,8730,42616,5989,79811,4862,2400,2462
57140,88552,8730,42620,5989,79822,4862,2400,2462
57145,88556,8730,42622,5989,79826,4862,2400,2462
57150,88566,8732,42626,5990,79834,4862,2400,2462
57155,88572,8732,42629,5990,79840,4863,2401,2462
57160,88583,8733,42635,5991,79850,4863,2401,2462
57165,88587,8733,42637,5991,79854,4863,2401,2462
57170,88597,8735,42641,5992,79862,4863,2401,2462
57175,88603,8735,42643,5992,79867,4864,2402,2462
57180,88614,8737,42649,5994,79876,4864,2402,2462
57185,88618,8738,42650,5995,79880,4864,2402,2462
57190,88628,8740,42656,5996,79888,4864,2402,2462
57195,88634,8740,42660,5996,79893,4865,2403,2462
57200,88645,8742,42665,5997,79902,4865,2403,2462
57205,88649,8743,42666,5998,79906,4865,2403,2462
57210,88659,8745,42670,5998,79914,4865,2403,2462
57215,88665,8745,42673,5998,79920,4866,2404,2462
57220,88676,8746,42677,5998,79930,4866,2404,2462
57225,88680,8746,42678,5998,79934,4866,2404,2462
57230,88690,8748,42682,5998,79942,4866,2404,2462
57235,88696,8748,42683,5998,79948,4868,2405,2463
57240,88707,8749,42690,5998,79958,4869,2406,2463
57245,88711,8750,42692,5999,79961,4869,2406,2463
57250,88721,8752,42697,5999,79969,4869,2406,2463
57255,88727,8752,42702,5999,79975,4871,2407,2464
57260,88738,8753,42708,5999,79985,4872,2407,2465
57265,88742,8753,42709,5999,79989,4872,2407,2465
57270,88752,8755,42716,6000,79997,4872,2407,2465
57275,88758,8755,42719,6000,80003,4874,2407,2467
57280,88769,8756,42725,6001,80013,4875,2407,2468
57285,88773,8757,42727,6002,80016,4875,2407,2468
57290,88783,8759,42730,6002,80024,4875,2407,2468
57295,88789,8759,42731,6002,80030,4877,2407,2470
57300,88800,8762,42735,6004,80038,4878,2408,2470
57305,88804,8762,42735,6004,80042,4878,2408,2470
57310,88814,8763,42741,6004,80051,4878,2408,2470
57315,88820,8763,42744,6004,80057,4879,2409,2470
57320,88831,8765,42752,6006,80066,4880,2410,2470
57325,88835,8765,42755,6006,80070,4880,2410,2470
57330,88845,8766,42759,6007,80079,4880,2410,2470
57335,88851,8766,42760,6007,80085,4881,2411,2470
57340,88862,8768,42762,6008,80094,4882,2411,2471
57345,88866,8769,42765,6009,80097,4882,2411,2471
57350,88876,8770,42771,6010,80106,4882,2411,2471
57355,88882,8770,42774,6010,80112,4883,2411,2472
57360,88893,8773,42780,6013,80120,4884,2411,2473
57365,88897,8773,42780,6013,80124,4884,2411,2473
57370,88907,8775,42786,6014,80132,4884,2411,2473
57375,88913,8775,42789,6014,80138,4885,2412,2473
57380,88924,8776,42794,6015,80148,4885,2412,2473
57385,88928,8776,42796,6015,80152,4885,2412,2473
57390,88938,8778,42800,6015,80160,4885,2412,2473
57395,88944,8778,42803,6015,80165,4886,2413,2473
57400,88955,8780,42808,6017,80175,4886,2413,2473
57405,88959,8780,42809,6017,80179,4886,2413,2473
57410,88969,8782,42814,6019,80187,4886,2413,2473
57415,88975,8782,42818,6019,80193,4887,2414,2473
57420,88986,8782,42820,6019,80204,4887,2414,2473
57425,88990,8782,42822,6019,80208,4887,2414,2473
57430,89000,8783,42827,6020,80217,4887,2414,2473
57435,89006,8783,42829,6020,80223,4889,2415,2474
57440,89017,8784,42834,6021,80233,4889,2415,2474
57445,89021,8784,42836,6021,80237,4889,2415,2474
57450,89031,8785,42840,6022,80246,4889,2415,2474
57455,89037,8785,42842,6022,80252,4890,2415,2475
57460,89048,8786,42851,6023,80262,4890,2415,2475
57465,89052,8786,42853,6023,80266,4890,2415,2475
57470,89062,8787,42859,6024,80275,4890,2415,2475
57475,89068,8787,42862,6024,80280,4891,2416,2475
57480,89079,8791,42866,6028,80288,4891,2416,2475
57485,89083,8791,42866,6028,80292,4891,2416,2475
57490,89093,8792,42870,6029,80301,4891,2416,2475
57495,89099,8792,42873,6029,80307,4892,2416,2476
57500,89110,8794,42878,6031,80316,4892,2416,2476
57505,89114,8794,42879,6031,80320,4892,2416,2476
57510,89124,8795,42885,6032,80329,4892,2416,2476
57515,89130,8795,42887,6032,80335,4893,2416,2477
57520,89141,8796,42892,6033,80345,4893,2416,2477
57525,89145,8797,42894,6034,80348,4893,2416,2477
57530,89155,8799,42900,6036,80356,4893,2416,2477
57535,89161,8799,42903,6036,80362,4894,2416,2478
57540,89172,8800,42906,6036,80372,4894,2416,2478
57545,89176,8802,42910,6038,80374,4894,2416,2478
57550,89186,8804,42915,6039,80382,4894,2416,2478
57555,89192,8804,42919,6039,80387,4895,2417,2478
57560,89203,8806,42925,6041,80396,4896,2418,2478
57565,89207,8809,42928,6044,80398,4896,2418,2478
57570,89217,8811,42931,6044,80406,4896,2418,2478
57575,89223,8811,42936,6044,80411,4897,2418,2479
57580,89234,8813,42942,6046,80420,4898,2418,2480
57585,89238,8816,42945,6049,80422,4898,2418,2480
57590,89248,8818,42949,6050,80430,4898,2418,2480
57595,89254,8818,42954,6050,80436,4899,2419,2480
57600,89265,8819,42959,6051,80446,4900,2420,2480
57605,89269,8819,42961,6051,80450,4900,2420,2480
57610,89279,8821,42964,6052,80458,4900,2420,2480
57615,89285,8821,42967,6052,80464,4901,2420,2481
57620,89296,8821,42972,6052,80475,4902,2420,2482
57625,89300,8822,42974,6053,80478,4902,2420,2482
57630,89310,8824,42977,6054,80486,4902,2420,2482
57635,89316,8824,42980,6054,80492,4903,2420,2483
57640,89327,8824,42984,6054,80503,4903,2420,2483
57645,89331,8824,42985,6054,80507,4903,2420,2483
57650,89341,8826,42989,6054,80515,4903,2420,2483
57655,89347,8826,42992,6054,80521,4904,2421,2483
57660,89358,8827,42995,6055,80531,4904,2421,2483
57665,89362,8827,42997,6055,80535,4904,2421,2483
57670,89372,8828,43000,6055,80544,4904,2421,2483
57675,89378,8828,43004,6055,80550,4906,2423,2483
57680,89389,8830,43009,6056,80559,4906,2423,2483
57685,89393,8830,43010,6056,80563,4906,2423,2483
57690,89403,8831,43016,6056,80572,4906,2423,2483
57695,89409,8831,43018,6056,80578,4907,2423,2484
57700,89420,8832,43023,6056,80588,4907,2423,2484
57705,89424,8832,43024,6056,80592,4907,2423,2484
57710,89434,8833,43029,6057,80601,4907,2423,2484
57715,89440,8833,43031,6057,80607,4908,2424,2484
57720,89451,8834,43035,6058,80617,4908,2424,2484
57725,89455,8835,43038,6059,80620,4908,2424,2484
57730,89465,8836,43041,6059,80629,4908,2424,2484
57735,89471,8836,43045,6059,80635,4909,2424,2485
57740,89482,8837,43050,6060,80645,4909,2424,2485
57745,89486,8838,43052,6061,80648,4909,2424,2485
57750,89496,8839,43057,6062,80657,4909,2424,2485
57755,89502,8839,43062,6062,80663,4910,2425,2485
57760,89513,8841,43071,6063,80672,4910,2425,2485
57765,89517,8841,43074,6063,80676,4910,2425,2485
57770,89527,8843,43079,6064,80684,4910,2425,2485
57775,89533,8843,43082,6064,80689,4911,2425,2486
57780,89544,8847,43090,6068,80697,4911,2425,2486
57785,89548,8848,43094,6069,80700,4911,2425,2486
57790,89558,8849,43100,6069,80709,4911,2425,2486
57795,89564,8849,43102,6069,80715,4912,2425,2487
57800,89575,8850,43108,6070,80725,4912,2425,2487
57805,89579,8850,43110,6070,80729,4912,2425,2487
57810,89589,8851,43115,6071,80738,4912,2425,2487
57815,89595,8851,43119,6071,80744,4913,2426,2487
57820,89606,8851,43126,6071,80755,4913,2426,2487
57825,89610,8851,43129,6071,80759,4913,2426,2487
57830,89620,8852,43135,6071,80768,4913,2426,2487
57835,89626,8852,43138,6071,80774,4914,2427,2487
57840,89637,8852,43142,6071,80785,4914,2427,2487
57845,89641,8852,43144,6071,80789,4914,2427,2487
57850,89651,8853,43148,6072,80798,4914,2427,2487
57855,89657,8853,43152,6072,80804,4915,2427,2488
57860,89668,8853,43158,6072,80815,4915,2427,2488
57865,89672,8853,43160,6072,80819,4915,2427,2488
57870,89682,8854,43165,6073,80828,4915,2427,2488
57875,89688,8854,43167,6073,80834,4916,2427,2489
57880,89699,8854,43172,6073,80845,4916,2427,2489
57885,89703,8854,43174,6073,80849,4916,2427,2489
57890,89713,8855,43176,6073,80858,4916,2427,2489
57895,89719,8855,43180,6073,80864,4918,2428,2490
57900,89730,8858,43186,6075,80872,4918,2428,2490
57905,89734,8858,43187,6075,80876,4918,2428,2490
57910,89744,8859,43193,6075,80885,4918,2428,2490
57915,89750,8859,43194,6075,80891,4919,2428,2491
57920,89761,8862,43201,6077,80899,4919,2428,2491
57925,89765,8862,43203,6077,80903,4919,2428,2491
57930,89775,8863,43209,6077,80912,4919,2428,2491
57935,89781,8863,43211,6077,80918,4920,2429,2491
57940,89792,8865,43221,6079,80927,4920,2429,2491
57945,89796,8865,43223,6079,80931,4920,2429,2491
57950,89806,8866,43228,6080,80940,4920,2429,2491
57955,89812,8866,43232,6080,80946,4921,2430,2491
57960,89823,8867,43237,6081,80956,4921,2430,2491
57965,89827,8867,43238,6081,80960,4921,2430,2491
57970,89837,8868,43243,6082,80969,4921,2430,2491
57975,89843,8868,43243,6082,80975,4922,2430,2492
57980,89854,8869,43247,6082,80985,4922,2430,2492
57985,89858,8871,43250,6084,80987,4922,2430,2492
57990,89868,8872,43257,6085,80996,4922,2430,2492
57995,89874,8872,43259,6085,81002,4923,2430,2493
58000,89885,8873,43266,6085,81012,4923,2430,2493
58005,89889,8873,43266,6085,81016,4923,2430,2493
58010,89899,8875,43268,6086,81024,4923,2430,2493
58015,89905,8875,43273,6086,81030,4925,2432,2493
58020,89916,8877,43279,6087,81039,4925,2432,2493
58025,89920,8878,43281,6088,81042,4925,2432,2493
58030,89930,8880,43286,6090,81050,4925,2432,2493
58035,89936,8880,43290,6090,81055,4926,2433,2493
58040,89947,8884,43298,6094,81063,4926,2433,2493
58045,89951,8884,43299,6094,81067,4926,2433,2493
58050,89961,8886,43303,6095,81075,4926,2433,2493
58055,89967,8886,43307,6095,81080,4927,2434,2493
58060,89978,8888,43310,6096,81090,4927,2434,2493
58065,89982,8889,43312,6097,81093,4927,2434,2493
58070,89992,8891,43314,6098,81101,4927,2434,2493
58075,89998,8891,43316,6098,81107,4928,2434,2494
58080,90009,8894,43325,6101,81115,4928,2434,2494
58085,90013,8894,43326,6101,81119,4928,2434,2494
58090,90023,8895,43333,6102,81128,4928,2434,2494
58095,90029,8895,43337,6102,81133,4929,2435,2494
58100,90040,8896,43340,6103,81144,4929,2435,2494
58105,90044,8896,43342,6103,81148,4929,2435,2494
58110,90054,8897,43346,6104,81157,4929,2435,2494
58115,90060,8897,43348,6104,81162,4930,2435,2495
58120,90071,8898,43353,6105,81173,4930,2435,2495
58125,90075,8898,43355,6105,81177,4930,2435,2495
58130,90085,8899,43360,6106,81186,4930,2435,2495
58135,90091,8899,43364,6106,81191,4932,2437,2495
58140,90102,8901,43370,6108,81200,4932,2437,2495
58145,90106,8902,43372,6109,81204,4932,2437,2495
58150,90116,8903,43379,6110,81213,4932,2437,2495
58155,90122,8903,43382,6110,81219,4933,2438,2495
58160,90133,8904,43387,6111,81229,4933,2438,2495
58165,90137,8904,43389,6111,81233,4933,2438,2495
58170,90147,8905,43396,6112,81242,4933,2438,2495
58175,90153,8905,43401,6112,81247,4934,2439,2495
58180,90164,8906,43406,6113,81257,4934,2439,2495
58185,90168,8907,43407,6114,81261,4934,2439,2495
58190,90178,8908,43409,6114,81270,4934,2439,2495
58195,90184,8908,43412,6114,81275,4935,2440,2495
58200,90195,8911,43417,6117,81283,4935,2440,2495
58205,90199,8913,43419,6119,81286,4935,2440,2495
58210,90209,8915,43422,6119,81294,4935,2440,2495
58215,90215,8915,43423,6119,81300,4936,2441,2495
58220,90226,8916,43427,6120,81310,4936,2441,2495
58225,90230,8916,43429,6120,81314,4936,2441,2495
58230,90240,8918,43432,6121,81322,4936,2441,2495
58235,90246,8918,43433,6121,81328,4937,2441,2496
58240,90257,8919,43435,6121,81338,4937,2441,2496
58245,90261,8919,43437,6121,81342,4937,2441,2496
58250,90271,8921,43440,6121,81350,4937,2441,2496
58255,90277,8921,43445,6121,81356,4939,2443,2496
58260,90288,8923,43450,6122,81365,4939,2443,2496
58265,90292,8923,43451,6122,81369,4939,2443,2496
58270,90302,8925,43457,6123,81377,4939,2443,2496
58275,90308,8925,43460,6123,81383,4940,2444,2496
58280,90319,8927,43464,6124,81392,4940,2444,2496
58285,90323,8928,43467,6125,81395,4940,2444,2496
58290,90333,8930,43473,6126,81403,4940,2444,2496
58295,90339,8930,43475,6126,81409,4941,2444,2497
58300,90350,8932,43482,6128,81418,4941,2444,2497
58305,90354,8932,43482,6128,81422,4941,2444,2497
58310,90364,8934,43485,6128,81430,4941,2444,2497
58315,90370,8934,43487,6128,81435,4942,2444,2498
58320,90381,8938,43490,6131,81443,4942,2444,2498
58325,90385,8938,43490,6131,81447,4942,2444,2498
58330,90395,8940,43496,6132,81455,4942,2444,2498
58335,90401,8940,43498,6132,81461,4943,2445,2498
58340,90412,8940,43502,6132,81472,4943,2445,2498
58345,90416,8941,43505,6133,81475,4943,2445,2498
58350,90426,8943,43512,6135,81483,4943,2445,2498
58355,90432,8943,43516,6135,81489,4944,2446,2498
58360,90443,8944,43521,6136,81499,4944,2446,2498
58365,90447,8944,43524,6136,81503,4944,2446,2498
58370,90457,8946,43530,6138,81511,4944,2446,2498
58375,90463,8946,43531,6138,81517,4946,2446,2500
58380,90474,8947,43538,6139,81527,4946,2446,2500
58385,90478,8948,43540,6140,81530,4946,2446,2500
58390,90488,8950,43545,6141,81538,4946,2446,2500
58395,90494,8950,43549,6141,81544,4947,2447,2500
58400,90505,8951,43555,6142,81554,4947,2447,2500
58405,90509,8952,43558,6143,81557,4947,2447,2500
58410,90519,8954,43563,6143,81565,4947,2447,2500
58415,90525,8954,43566,6143,81571,4948,2447,2501
58420,90536,8954,43571,6143,81582,4948,2447,2501
58425,90540,8954,43574,6143,81586,4948,2447,2501
58430,90550,8956,43581,6144,81594,4948,2447,2501
58435,90556,8956,43583,6144,81599,4949,2447,2502
58440,90567,8958,43587,6145,81608,4949,2447,2502
58445,90571,8959,43588,6146,81612,4949,2447,2502
58450,90581,8959,43594,6146,81622,4949,2447,2502
58455,90587,8959,43596,6146,81628,4950,2448,2502
58460,90598,8960,43600,6147,81638,4950,2448,2502
58465,90602,8960,43601,6147,81642,4950,2448,2502
58470,90612,8960,43604,6147,81652,4950,2448,2502
58475,90618,8960,43606,6147,81658,4951,2448,2503
58480,90629,8961,43612,6147,81668,4951,2448,2503
58485,90633,8961,43613,6147,81672,4951,2448,2503
58490,90643,8961,43617,6147,81682,4951,2448,2503
58495,90649,8961,43620,6147,81688,4952,2448,2504
58500,90660,8962,43627,6148,81698,4952,2448,2504
58505,90664,8963,43629,6149,81701,4952,2448,2504
58510,90674,8964,43637,6150,81710,4952,2448,2504
58515,90680,8964,43639,6150,81716,4954,2449,2505
58520,90691,8966,43643,6152,81725,4954,2449,2505
58525,90695,8967,43645,6153,81728,4954,2449,2505
58530,90705,8968,43649,6153,81737,4954,2449,2505
58535,90711,8968,43652,6153,81743,4956,2450,2506
58540,90722,8969,43659,6154,81753,4956,2450,2506
58545,90726,8969,43661,6154,81757,4956,2450,2506
58550,90736,8971,43666,6156,81765,4956,2450,2506
58555,90742,8971,43670,6156,81771,4958,2452,2506
58560,90753,8973,43673,6157,81780,4958,2452,2506
58565,90757,8973,43674,6157,81784,4958,2452,2506
58570,90767,8975,43678,6157,81792,4958,2452,2506
58575,90773,8975,43681,6157,81798,4959,2452,2507
58580,90784,8975,43686,6157,81809,4959,2452,2507
58585,90788,8976,43688,6158,81812,4959,2452,2507
58590,90798,8978,43692,6159,81820,4959,2452,2507
58595,90804,8978,43695,6159,81826,4960,2453,2507
58600,90815,8978,43700,6159,81837,4960,2453,2507
58605,90819,8979,43702,6160,81840,4960,2453,2507
58610,90829,8981,43707,6160,81848,4960,2453,2507
58615,90835,8981,43711,6160,81854,4961,2453,2508
58620,90846,8982,43716,6161,81864,4961,2453,2508
58625,90850,8982,43717,6161,81868,4961,2453,2508
58630,90860,8983,43718,6161,81877,4961,2453,2508
58635,90866,8983,43721,6161,81883,4962,2454,2508
58640,90877,8983,43725,6161,81894,4962,2454,2508
58645,90881,8983,43726,6161,81898,4962,2454,2508
58650,90891,8984,43731,6162,81907,4962,2454,2508
58655,90897,8984,43733,6162,81913,4963,2454,2509
58660,90908,8984,43740,6162,81924,4963,2454,2509
58665,90912,8984,43743,6162,81928,4963,2454,2509
58670,90922,8985,43744,6162,81937,4963,2454,2509
58675,90928,8985,43746,6162,81943,4964,2455,2509
58680,90939,8988,43755,6165,81950,4964,2455,2509
58685,90943,8989,43756,6166,81954,4964,2455,2509
58690,90953,8990,43761,6166,81963,4964,2455,2509
58695,90959,8990,43764,6166,81969,4965,2456,2509
58700,90970,8991,43770,6167,81979,4965,2456,2509
58705,90974,8992,43772,6168,81982,4965,2456,2509
58710,90984,8993,43775,6169,81991,4965,2456,2509
58715,90990,8993,43776,6169,81997,4966,2457,2509
58720,91001,8994,43783,6170,82007,4966,2457,2509
58725,91005,8994,43784,6170,82011,4966,2457,2509
58730,91015,8995,43788,6170,82020,4966,2457,2509
58735,91021,8995,43791,6170,82026,4967,2458,2509
58740,91032,8996,43795,6170,82036,4967,2458,2509
58745,91036,8996,43798,6170,82040,4967,2458,2509
58750,91046,8998,43804,6172,82048,4967,2458,2509
58755,91052,8998,43806,6172,82054,4968,2459,2509
58760,91063,8999,43813,6172,82064,4968,2459,2509
58765,91067,8999,43815,6172,82068,4968,2459,2509
58770,91077,9001,43820,6173,82076,4968,2459,2509
58775,91083,9001,43825,6173,82082,4969,2460,2509
58780,91094,9002,43831,6173,82092,4969,2460,2509
58785,91098,9002,43832,6173,82096,4969,2460,2509
58790,91108,9004,43837,6174,82104,4969,2460,2509
58795,91114,9004,43838,6174,82110,4971,2460,2511
58800,91125,9006,43844,6175,82119,4971,2460,2511
58805,91129,9006,43847,6175,82123,4971,2460,2511
58810,91139,9008,43851,6176,82131,4971,2460,2511
58815,91145,9008,43856,6176,82137,4972,2461,2511
58820,91156,9009,43862,6177,82147,4972,2461,2511
58825,91160,9009,43864,6177,82151,4972,2461,2511
58830,91170,9011,43866,6177,82159,4972,2461,2511
58835,91176,9011,43869,6177,82165,4973,2462,2511
58840,91187,9012,43873,6178,82175,4973,2462,2511
58845,91191,9013,43877,6179,82178,4973,2462,2511
58850,91201,9015,43880,6180,82186,4973,2462,2511
58855,91207,9015,43885,6180,82191,4974,2463,2511
58860,91218,9020,43892,6184,82198,4974,2463,2511
58865,91222,9020,43893,6184,82202,4974,2463,2511
58870,91232,9021,43896,6184,82211,4974,2463,2511
58875,91238,9021,43901,6184,82216,4975,2463,2512
58880,91249,9023,43907,6186,82226,4975,2463,2512
58885,91253,9023,43910,6186,82230,4975,2463,2512
58890,91263,9024,43917,6187,82239,4975,2463,2512
58895,91269,9024,43923,6187,82244,4976,2464,2512
58900,91280,9026,43931,6189,82254,4976,2464,2512
58905,91284,9026,43933,6189,82258,4976,2464,2512
58910,91294,9027,43939,6190,82267,4976,2464,2512
58915,91300,9027,43942,6190,82273,4978,2465,2513
58920,91311,9028,43946,6191,82283,4978,2465,2513
58925,91315,9028,43948,6191,82287,4978,2465,2513
58930,91325,9029,43955,6192,82296,4978,2465,2513
58935,91331,9029,43958,6192,82302,4979,2466,2513
58940,91342,9029,43965,6192,82313,4979,2466,2513
58945,91346,9029,43967,6192,82317,4979,2466,2513
58950,91356,9030,43970,6192,82326,4979,2466,2513
58955,91362,9030,43974,6192,82332,4980,2466,2514
58960,91373,9030,43979,6192,82343,4980,2466,2514
58965,91377,9030,43980,6192,82347,4980,2466,2514
58970,91387,9032,43986,6194,82355,4980,2466,2514
58975,91393,9032,43989,6194,82361,4981,2466,2515
58980,91404,9034,43995,6196,82370,4981,2466,2515
58985,91408,9034,43995,6196,82374,4981,2466,2515
58990,91418,9035,44001,6197,82383,4981,2466,2515
58995,91424,9035,44003,6197,82389,4982,2466,2516
59000,91435,9036,44007,6197,82399,4982,2466,2516
59005,91439,9037,44009,6198,82402,4982,2466,2516
59010,91449,9038,44012,6198,82411,4982,2466,2516
59015,91455,9038,44014,6198,82417,4983,2466,2517
59020,91466,9039,44019,6199,82427,4983,2466,2517
59025,91470,9040,44022,6200,82430,4983,2466,2517
59030,91480,9041,44030,6201,82439,4983,2466,2517
59035,91486,9041,44035,6201,82445,4985,2467,2518
59040,91497,9042,44041,6202,82455,4985,2467,2518
59045,91501,9043,44042,6203,82458,4985,2467,2518
59050,91511,9044,44047,6204,82467,4985,2467,2518
59055,91517,9044,44049,6204,82473,4986,2468,2518
59060,91528,9045,44054,6205,82483,4986,2468,2518
59065,91532,9045,44056,6205,82487,4986,2468,2518
59070,91542,9046,44061,6206,82496,4986,2468,2518
59075,91548,9046,44065,6206,82502,4987,2469,2518
59080,91559,9047,44072,6207,82512,4987,2469,2518
59085,91563,9048,44074,6208,82515,4987,2469,2518
59090,91573,9050,44078,6209,82523,4987,2469,2518
59095,91579,9050,44080,6209,82529,4988,2470,2518
59100,91590,9051,44084,6209,82539,4988,2470,2518
59105,91594,9051,44085,6209,82543,4988,2470,2518
59110,91604,9052,44091,6209,82552,4988,2470,2518
59115,91610,9052,44094,6209,82557,4989,2470,2519
59120,91621,9055,44100,6211,82566,4989,2470,2519
59125,91625,9055,44101,6211,82570,4989,2470,2519
59130,91635,9056,44105,6212,82579,4989,2470,2519
59135,91641,9056,44109,6212,82584,4990,2471,2519
59140,91652,9059,44114,6215,82593,4990,2471,2519
59145,91656,9059,44116,6215,82597,4990,2471,2519
59150,91666,9060,44120,6215,82606,4990,2471,2519
59155,91672,9060,44124,6215,82611,4991,2472,2519
59160,91683,9063,44128,6217,82620,4991,2472,2519
59165,91687,9064,44129,6218,82623,4991,2472,2519
59170,91697,9066,44136,6220,82631,4991,2472,2519
59175,91703,9066,44140,6220,82637,4993,2473,2520
59180,91714,9067,44141,6220,82647,4993,2473,2520
59185,91718,9068,44142,6221,82650,4993,2473,2520
59190,91728,9070,44144,6221,82658,4993,2473,2520
59195,91734,9070,44146,6221,82664,4995,2473,2522
59200,91745,9072,44154,6223,82673,4995,2473,2522
59205,91749,9073,44157,6224,82676,4995,2473,2522
59210,91759,9075,44162,6225,82684,4995,2473,2522
59215,91765,9075,44165,6225,82690,4997,2474,2523
59220,91776,9077,44172,6227,82699,4997,2474,2523
59225,91780,9077,44174,6227,82703,4997,2474,2523
59230,91790,9079,44178,6228,82711,4997,2474,2523
59235,91796,9079,44182,6228,82717,4999,2474,2525
59240,91807,9080,44188,6229,82727,4999,2474,2525
59245,91811,9080,44190,6229,82731,4999,2474,2525
59250,91821,9082,44197,6230,82739,4999,2474,2525
59255,91827,9082,44202,6230,82745,5001,2476,2525
59260,91838,9082,44205,6230,82756,5001,2476,2525
59265,91842,9082,44208,6230,82760,5001,2476,2525
59270,91852,9084,44211,6231,82768,5001,2476,2525
59275,91858,9084,44212,6231,82774,5003,2477,2526
59280,91869,9085,44215,6232,82784,5003,2477,2526
59285,91873,9086,44217,6233,82787,5003,2477,2526
59290,91883,9087,44222,6234,82796,5003,2477,2526
59295,91889,9087,44225,6234,82802,5004,2478,2526
59300,91900,9088,44229,6234,82812,5004,2478,2526
59305,91904,9089,44233,6235,82815,5004,2478,2526
59310,91914,9090,44239,6236,82824,5004,2478,2526
59315,91920,9090,44245,6236,82829,5005,2479,2526
59320,91931,9092,44247,6237,82839,5005,2479,2526
59325,91935,9093,44250,6238,82842,5005,2479,2526
59330,91945,9094,44255,6239,82851,5005,2479,2526
59335,91951,9094,44257,6239,82857,5006,2480,2526
59340,91962,9095,44262,6239,82867,5006,2480,2526
59345,91966,9095,44263,6239,82871,5006,2480,2526
59350,91976,9095,44268,6239,82881,5006,2480,2526
59355,91982,9095,44271,6239,82887,5007,2480,2527
59360,91993,9097,44275,6240,82896,5007,2480,2527
59365,91997,9097,44275,6240,82900,5007,2480,2527
59370,92007,9097,44280,6240,82910,5007,2480,2527
59375,92013,9097,44284,6240,82916,5008,2480,2528
59380,92024,9099,44288,6242,82925,5008,2480,2528
59385,92028,9099,44289,6242,82929,5008,2480,2528
59390,92038,9100,44295,6242,82938,5008,2480,2528
59395,92044,9100,44300,6242,82943,5009,2481,2528
59400,92055,9103,44304,6245,82952,5009,2481,2528
59405,92059,9103,44305,6245,82956,5009,2481,2528
59410,92069,9104,44309,6245,82965,5009,2481,2528
59415,92075,9104,44310,6245,82971,5011,2481,2530
59420,92086,9104,44315,6245,82982,5011,2481,2530
59425,92090,9104,44317,6245,82986,5011,2481,2530
59430,92100,9105,44321,6246,82995,5011,2481,2530
59435,92106,9105,44321,6246,83001,5013,2481,2532
59440,92117,9106,44327,6247,83011,5013,2481,2532
59445,92121,9106,44329,6247,83015,5013,2481,2532
59450,92131,9108,44333,6247,83023,5013,2481,2532
59455,92137,9108,44336,6247,83029,5015,2483,2532
59460,92148,9108,44340,6247,83040,5015,2483,2532
59465,92152,9108,44340,6247,83044,5015,2483,2532
59470,92162,9110,44343,6248,83052,5015,2483,2532
59475,92168,9110,44346,6248,83058,5017,2484,2533
59480,92179,9111,44352,6249,83068,5017,2484,2533
59485,92183,9111,44356,6249,83072,5017,2484,2533
59490,92193,9113,44361,6249,83080,5017,2484,2533
59495,92199,9113,44363,6249,83086,5019,2485,2534
59500,92210,9114,44369,6250,83096,5019,2485,2534
59505,92214,9114,44371,6250,83100,5019,2485,2534
59510,92224,9116,44374,6250,83108,5019,2485,2534
59515,92230,9116,44375,6250,83113,5021,2485,2536
59520,92241,9119,44380,6252,83121,5021,2485,2536
59525,92245,9120,44380,6253,83125,5021,2485,2536
59530,92255,9121,44384,6253,83134,5021,2485,2536
59535,92261,9121,44384,6253,83140,5022,2485,2537
59540,92272,9122,44390,6254,83150,5022,2485,2537
59545,92276,9122,44393,6254,83154,5022,2485,2537
59550,92286,9123,44396,6254,83163,5022,2485,2537
59555,92292,9123,44398,6254,83169,5023,2486,2537
59560,92303,9125,44405,6255,83178,5023,2486,2537
59565,92307,9126,44409,6256,83181,5023,2486,2537
59570,92317,9127,44416,6257,83190,5023,2486,2537
59575,92323,9127,44418,6257,83196,5024,2486,2538
59580,92334,9129,44423,6258,83205,5024,2486,2538
59585,92338,9130,44425,6259,83208,5024,2486,2538
59590,92348,9131,44429,6259,83217,5024,2486,2538
59595,92354,9131,44432,6259,83222,5025,2487,2538
59600,92365,9132,44436,6260,83233,5025,2487,2538
59605,92369,9132,44439,6260,83237,5025,2487,2538
59610,92379,9133,44444,6261,83246,5025,2487,2538
59615,92385,9133,44446,6261,83252,5026,2487,2539
59620,92396,9133,44452,6261,83263,5026,2487,2539
59625,92400,9133,44453,6261,83267,5026,2487,2539
59630,92410,9134,44459,6262,83276,5026,2487,2539
59635,92416,9134,44462,6262,83282,5028,2488,2540
59640,92427,9134,44465,6262,83293,5028,2488,2540
59645,92431,9135,44466,6263,83296,5028,2488,2540
59650,92441,9136,44470,6263,83305,5028,2488,2540
59655,92447,9136,44473,6263,83311,5029,2489,2540
59660,92458,9138,44477,6264,83320,5029,2489,2540
59665,92462,9138,44478,6264,83324,5029,2489,2540
59670,92472,9139,44481,6264,83333,5029,2489,2540
59675,92478,9139,44483,6264,83339,5030,2489,2541
59680,92489,9141,44488,6265,83348,5030,2489,2541
59685,92493,9142,44491,6266,83351,5030,2489,2541
59690,92503,9144,44496,6266,83359,5030,2489,2541
59695,92509,9144,44500,6266,83365,5031,2490,2541
59700,92520,9146,44507,6267,83374,5031,2490,2541
59705,92524,9146,44510,6267,83378,5031,2490,2541
59710,92534,9148,44514,6268,83386,5031,2490,2541
59715,92540,9148,44514,6268,83392,5032,2490,2542
59720,92551,9149,44520,6269,83402,5032,2490,2542
59725,92555,9149,44522,6269,83406,5032,2490,2542
59730,92565,9151,44528,6269,83414,5032,2490,2542
59735,92571,9151,44532,6269,83420,5033,2491,2542
59740,92582,9152,44538,6270,83430,5033,2491,2542
59745,92586,9152,44538,6270,83434,5033,2491,2542
59750,92596,9154,44543,6271,83442,5033,2491,2542
59755,92602,9154,44545,6271,83447,5035,2492,2543
59760,92613,9156,44550,6273,83457,5035,2492,2543
59765,92617,9156,44552,6273,83461,5035,2492,2543
59770,92627,9158,44558,6274,83469,5035,2492,2543
59775,92633,9158,44559,6274,83475,5036,2492,2544
59780,92644,9158,44561,6274,83486,5036,2492,2544
59785,92648,9158,44561,6274,83490,5036,2492,2544
59790,92658,9160,44564,6274,83498,5036,2492,2544
59795,92664,9160,44566,6274,83504,5037,2493,2544
59800,92675,9161,44574,6275,83514,5037,2493,2544
59805,92679,9161,44575,6275,83518,5037,2493,2544
59810,92689,9163,44580,6277,83526,5037,2493,2544
59815,92695,9163,44583,6277,83532,5038,2493,2545
59820,92706,9165,44587,6278,83541,5038,2493,2545
59825,92710,9166,44588,6279,83544,5038,2493,2545
59830,92720,9168,44592,6281,83552,5038,2493,2545
59835,92726,9168,44593,6281,83558,5039,2493,2546
59840,92737,9169,44597,6281,83568,5039,2493,2546
59845,92741,9170,44599,6282,83571,5039,2493,2546
59850,92751,9172,44604,6283,83579,5039,2493,2546
59855,92757,9172,44606,6283,83585,5040,2493,2547
59860,92768,9174,44611,6285,83594,5040,2493,2547
59865,92772,9175,44612,6286,83597,5040,2493,2547
59870,92782,9177,44617,6287,83605,5040,2493,2547
59875,92788,9177,44621,6287,83610,5042,2495,2547
59880,92799,9179,44625,6288,83620,5042,2495,2547
59885,92803,9179,44626,6288,83624,5042,2495,2547
59890,92813,9180,44629,6288,83633,5042,2495,2547
59895,92819,9180,44630,6288,83639,5043,2495,2548
59900,92830,9180,44637,6288,83650,5043,2495,2548
59905,92834,9180,44639,6288,83654,5043,2495,2548
59910,92844,9181,44645,6289,83663,5043,2495,2548
59915,92850,9181,44646,6289,83669,5044,2495,2549
59920,92861,9181,44650,6289,83680,5044,2495,2549
59925,92865,9181,44651,6289,83684,5044,2495,2549
59930,92875,9182,44655,6289,83693,5044,2495,2549
59935,92881,9182,44659,6289,83699,5045,2496,2549
59940,92892,9182,44663,6289,83710,5045,2496,2549
59945,92896,9182,44666,6289,83714,5045,2496,2549
59950,92906,9183,44670,6290,83723,5045,2496,2549
59955,92912,9183,44674,6290,83729,5046,2497,2549
59960,92923,9183,44678,6290,83740,5046,2497,2549
59965,92927,9183,44680,6290,83744,5046,2497,2549
59970,92937,9184,44681,6290,83753,5046,2497,2549
59975,92943,9184,44686,6290,83758,5047,2498,2549
59980,92954,9185,44691,6291,83769,5047,2498,2549
59985,92958,9185,44694,6291,83773,5047,2498,2549
59990,92968,9187,44701,6293,83781,5047,2498,2549
59995,92974,9187,44703,6293,83787,5048,2499,2549
60000,92985,9188,44705,6293,83797,5048,2499,2549
60005,92989,9189,44707,6294,83800,5048,2499,2549
60010,92999,9191,44710,6294,83808,5048,2499,2549
60015,93005,9191,44712,6294,83814,5050,2500,2550
60020,93016,9192,44716,6294,83824,5050,2500,2550
60025,93020,9192,44717,6294,83828,5050,2500,2550
60030,93030,9194,44722,6295,83836,5050,2500,2550
60035,93036,9194,44723,6295,83842,5052,2500,2552
60040,93047,9195,44728,6295,83852,5052,2500,2552
60045,93051,9195,44729,6295,83856,5052,2500,2552
60050,93061,9197,44735,6296,83864,5052,2500,2552
60055,93067,9197,44738,6296,83870,5054,2501,2553
60060,93078,9199,44744,6298,83879,5054,2501,2553
60065,93082,9200,44745,6299,83882,5054,2501,2553
60070,93092,9202,44751,6300,83890,5054,2501,2553
60075,93098,9202,44756,6300,83896,5055,2502,2553
60080,93109,9204,44762,6302,83905,5055,2502,2553
60085,93113,9205,44763,6303,83908,5055,2502,2553
60090,93123,9207,44769,6305,83916,5055,2502,2553
60095,93129,9207,44772,6305,83922,5056,2502,2554
60100,93140,9208,44777,6305,83932,5056,2502,2554
60105,93144,9208,44778,6305,83936,5056,2502,2554
60110,93154,9210,44780,6307,83944,5056,2502,2554
60115,93160,9210,44783,6307,83950,5057,2503,2554
60120,93171,9213,44791,6309,83957,5057,2503,2554
60125,93175,9214,44793,6310,83961,5057,2503,2554
60130,93185,9215,44798,6310,83970,5057,2503,2554
60135,93191,9215,44799,6310,83975,5059,2503,2556
60140,93202,9216,44805,6311,83986,5059,2503,2556
60145,93206,9216,44808,6311,83990,5059,2503,2556
60150,93216,9217,44812,6311,83999,5059,2503,2556
60155,93222,9217,44814,6311,84004,5061,2504,2557
60160,93233,9218,44819,6312,84015,5061,2504,2557
60165,93237,9218,44821,6312,84019,5061,2504,2557
60170,93247,9219,44824,6312,84028,5061,2504,2557
60175,93253,9219,44828,6312,84034,5063,2505,2558
60180,93264,9220,44835,6313,84044,5063,2505,2558
60185,93268,9220,44837,6313,84048,5063,2505,2558
60190,93278,9221,44842,6313,84057,5063,2505,2558
60195,93284,9221,44845,6313,84063,5064,2505,2559
60200,93295,9222,44851,6314,84073,5064,2505,2559
60205,93299,9222,44854,6314,84077,5064,2505,2559
60210,93309,9223,44859,6315,84086,5064,2505,2559
60215,93315,9223,44863,6315,84092,5065,2506,2559
60220,93326,9224,44868,6316,84102,5065,2506,2559
60225,93330,9224,44870,6316,84106,5065,2506,2559
60230,93340,9226,44874,6317,84114,5065,2506,2559
60235,93346,9226,44875,6317,84120,5066,2506,2560
60240,93357,9229,44883,6320,84128,5066,2506,2560
60245,93361,9230,44886,6321,84131,5066,2506,2560
60250,93371,9232,44889,6321,84139,5066,2506,2560
60255,93377,9232,44893,6321,84145,5067,2507,2560
60260,93388,9233,44899,6322,84155,5067,2507,2560
60265,93392,9233,44900,6322,84159,5067,2507,2560
60270,93402,9235,44907,6324,84167,5067,2507,2560
60275,93408,9235,44911,6324,84173,5068,2508,2560
60280,93419,9237,44918,6325,84182,5068,2508,2560
60285,93423,9237,44920,6325,84186,5068,2508,2560
60290,93433,9239,44923,6325,84194,5068,2508,2560
60295,93439,9239,44925,6325,84200,5070,2509,2561
60300,93450,9240,44929,6325,84210,5070,2509,2561
60305,93454,9241,44932,6326,84213,5070,2509,2561
60310,93464,9243,44938,6328,84221,5070,2509,2561
60315,93470,9243,44943,6328,84227,5071,2510,2561
60320,93481,9244,44950,6329,84237,5071,2510,2561
60325,93485,9245,44953,6330,84240,5071,2510,2561
60330,93495,9247,44957,6332,84248,5071,2510,2561
60335,93501,9247,44959,6332,84254,5072,2510,2562
60340,93512,9248,44967,6333,84264,5072,2510,2562
60345,93516,9249,44969,6334,84267,5072,2510,2562
60350,93526,9251,44973,6335,84275,5072,2510,2562
60355,93532,9251,44977,6335,84280,5073,2511,2562
60360,93543,9254,44985,6338,84289,5073,2511,2562
60365,93547,9255,44988,6339,84292,5073,2511,2562
60370,93557,9256,44994,6340,84301,5073,2511,2562
60375,93563,9256,44997,6340,84306,5074,2511,2563
60380,93574,9257,45002,6341,84317,5074,2511,2563
60385,93578,9257,45005,6341,84321,5074,2511,2563
60390,93588,9258,45009,6342,84330,5074,2511,2563
60395,93594,9258,45013,6342,84336,5075,2512,2563
60400,93605,9258,45019,6342,84347,5075,2512,2563
60405,93609,9258,45020,6342,84351,5075,2512,2563
60410,93619,9259,45025,6342,84360,5075,2512,2563
60415,93625,9259,45028,6342,84365,5077,2513,2564
60420,93636,9260,45033,6343,84376,5077,2513,2564
60425,93640,9260,45034,6343,84380,5077,2513,2564
60430,93650,9261,45037,6343,84389,5077,2513,2564
60435,93656,9261,45039,6343,84395,5079,2513,2566
60440,93667,9261,45045,6343,84406,5079,2513,2566
60445,93671,9261,45048,6343,84410,5079,2513,2566
60450,93681,9262,45053,6343,84419,5079,2513,2566
60455,93687,9262,45058,6343,84424,5081,2515,2566
60460,93698,9263,45063,6344,84435,5081,2515,2566
60465,93702,9263,45065,6344,84439,5081,2515,2566
60470,93712,9265,45070,6344,84447,5081,2515,2566
60475,93718,9265,45072,6344,84452,5083,2516,2567
60480,93729,9268,45078,6347,84460,5083,2516,2567
60485,93733,9270,45081,6349,84463,5083,2516,2567
60490,93743,9272,45085,6351,84471,5083,2516,2567
60495,93749,9272,45089,6351,84477,5084,2517,2567
60500,93760,9274,45095,6353,84486,5084,2517,2567
60505,93764,9275,45097,6354,84489,5084,2517,2567
60510,93774,9277,45101,6354,84497,5084,2517,2567
60515,93780,9277,45103,6354,84503,5085,2518,2567
60520,93791,9278,45107,6354,84513,5085,2518,2567
60525,93795,9280,45110,6356,84515,5085,2518,2567
60530,93805,9282,45117,6357,84523,5085,2518,2567
60535,93811,9282,45120,6357,84529,5086,2518,2568
60540,93822,9284,45126,6359,84538,5086,2518,2568
60545,93826,9285,45128,6360,84541,5086,2518,2568
60550,93836,9287,45132,6361,84549,5086,2518,2568
60555,93842,9287,45134,6361,84555,5087,2518,2569
60560,93853,9287,45136,6361,84566,5087,2518,2569
60565,93857,9287,45137,6361,84570,5087,2518,2569
60570,93867,9289,45142,6362,84578,5087,2518,2569
60575,93873,9289,45147,6362,84584,5088,2519,2569
60580,93884,9290,45155,6363,84594,5088,2519,2569
60585,93888,9290,45157,6363,84598,5088,2519,2569
60590,93898,9292,45165,6365,84606,5088,2519,2569
60595,93904,9292,45170,6365,84611,5090,2520,2570
60600,93915,9294,45173,6367,84621,5090,2520,2570
60605,93919,9294,45173,6367,84625,5090,2520,2570
60610,93929,9295,45180,6368,84634,5090,2520,2570
60615,93935,9295,45184,6368,84640,5091,2521,2570
60620,93946,9297,45189,6369,84649,5091,2521,2570
60625,93950,9297,45191,6369,84653,5091,2521,2570
60630,93960,9298,45195,6369,84662,5091,2521,2570
60635,93966,9298,45198,6369,84668,5092,2522,2570
60640,93977,9300,45204,6371,84677,5092,2522,2570
60645,93981,9301,45206,6372,84680,5092,2522,2570
60650,93991,9302,45211,6373,84689,5092,2522,2570
60655,93997,9302,45214,6373,84695,5093,2523,2570
60660,94008,9305,45221,6376,84703,5093,2523,2570
60665,94012,9305,45223,6376,84707,5093,2523,2570
60670,94022,9306,45227,6376,84716,5093,2523,2570
60675,94028,9306,45230,6376,84722,5094,2523,2571
60680,94039,9306,45237,6376,84733,5094,2523,2571
60685,94043,9306,45239,6376,84737,5094,2523,2571
60690,94053,9307,45242,6376,84746,5094,2523,2571
60695,94059,9307,45243,6376,84751,5095,2523,2572
60700,94070,9308,45250,6377,84762,5095,2523,2572
60705,94074,9308,45252,6377,84766,5095,2523,2572
60710,94084,9310,45258,6378,84774,5095,2523,2572
60715,94090,9310,45260,6378,84780,5097,2524,2573
60720,94101,9311,45267,6379,84789,5097,2524,2573
60725,94105,9313,45270,6381,84792,5097,2524,2573
60730,94115,9315,45275,6382,84800,5097,2524,2573
60735,94121,9315,45278,6382,84806,5098,2524,2574
60740,94132,9316,45283,6383,84816,5098,2524,2574
60745,94136,9316,45284,6383,84820,5098,2524,2574
60750,94146,9318,45289,6384,84828,5098,2524,2574
60755,94152,9318,45293,6384,84834,5099,2525,2574
60760,94163,9319,45297,6385,84844,5099,2525,2574
60765,94167,9320,45301,6386,84847,5099,2525,2574
60770,94177,9322,45304,6387,84855,5099,2525,2574
60775,94183,9322,45307,6387,84861,5100,2526,2574
60780,94194,9323,45314,6387,84871,5100,2526,2574
60785,94198,9323,45315,6387,84875,5100,2526,2574
60790,94208,9325,45319,6388,84883,5100,2526,2574
60795,94214,9325,45321,6388,84889,5101,2527,2574
60800,94225,9327,45327,6389,84898,5101,2527,2574
60805,94229,9327,45328,6389,84902,5101,2527,2574
60810,94239,9329,45333,6390,84910,5101,2527,2574
60815,94245,9329,45335,6390,84916,5102,2527,2575
60820,94256,9330,45341,6391,84926,5102,2527,2575
60825,94260,9330,45343,6391,84930,5102,2527,2575
60830,94270,9332,45351,6393,84938,5102,2527,2575
60835,94276,9332,45354,6393,84944,5104,2529,2575
60840,94287,9334,45357,6394,84953,5104,2529,2575
60845,94291,9334,45359,6394,84957,5104,2529,2575
60850,94301,9336,45365,6396,84965,5104,2529,2575
60855,94307,9336,45368,6396,84971,5106,2530,2576
60860,94318,9337,45376,6397,84980,5106,2530,2576
60865,94322,9338,45378,6398,84984,5106,2530,2576
60870,94332,9340,45383,6399,84992,5106,2530,2576
60875,94338,9340,45388,6399,84997,5107,2531,2576
60880,94349,9342,45393,6401,85006,5107,2531,2576
60885,94353,9343,45394,6402,85010,5107,2531,2576
60890,94363,9345,45400,6402,85018,5107,2531,2576
60895,94369,9345,45402,6402,85024,5108,2531,2577
60900,94380,9346,45406,6402,85033,5108,2531,2577
60905,94384,9347,45408,6403,85037,5108,2531,2577
60910,94394,9348,45413,6403,85046,5108,2531,2577
60915,94400,9348,45418,6403,85052,5109,2532,2577
60920,94411,9349,45422,6403,85062,5109,2532,2577
60925,94415,9349,45424,6403,85066,5109,2532,2577
60930,94425,9350,45429,6403,85075,5109,2532,2577
60935,94431,9350,45432,6403,85081,5110,2533,2577
60940,94442,9351,45436,6403,85091,5110,2533,2577
60945,94446,9351,45439,6403,85095,5110,2533,2577
60950,94456,9352,45448,6404,85104,5110,2533,2577
60955,94462,9352,45452,6404,85110,5111,2534,2577
60960,94473,9353,45457,6404,85120,5111,2534,2577
60965,94477,9353,45460,6404,85124,5111,2534,2577
60970,94487,9355,45463,6404,85132,5111,2534,2577
60975,94493,9355,45468,6404,85138,5113,2536,2577
60980,94504,9355,45469,6404,85149,5113,2536,2577
60985,94508,9356,45472,6405,85152,5113,2536,2577
60990,94518,9358,45473,6405,85160,5113,2536,2577
60995,94524,9358,45476,6405,85166,5115,2537,2578
61000,94535,9358,45484,6405,85177,5115,2537,2578
61005,94539,9359,45487,6406,85180,5115,2537,2578
61010,94549,9361,45491,6408,85188,5115,2537,2578
61015,94555,9361,45493,6408,85194,5117,2538,2579
61020,94566,9361,45500,6408,85205,5117,2538,2579
61025,94570,9361,45500,6408,85209,5117,2538,2579
61030,94580,9363,45505,6409,85217,5117,2538,2579
61035,94586,9363,45508,6409,85223,5119,2539,2580
61040,94597,9364,45516,6410,85233,5119,2539,2580
61045,94601,9364,45519,6410,85237,5119,2539,2580
61050,94611,9366,45523,6411,85245,5119,2539,2580
61055,94617,9366,45527,6411,85251,5121,2540,2581
61060,94628,9366,45528,6411,85262,5121,2540,2581
61065,94632,9366,45529,6411,85266,5121,2540,2581
61070,94642,9368,45534,6412,85274,5121,2540,2581
61075,94648,9368,45539,6412,85280,5123,2542,2581
61080,94659,9369,45544,6412,85290,5123,2542,2581
61085,94663,9370,45548,6413,85293,5123,2542,2581
61090,94673,9371,45551,6414,85302,5123,2542,2581
61095,94679,9371,45554,6414,85307,5125,2543,2582
61100,94690,9373,45560,6416,85317,5125,2543,2582
61105,94694,9374,45561,6417,85320,5125,2543,2582
61110,94704,9375,45566,6417,85329,5125,2543,2582
61115,94710,9375,45568,6417,85335,5127,2544,2583
61120,94721,9376,45572,6417,85345,5127,2544,2583
61125,94725,9376,45574,6417,85349,5127,2544,2583
61130,94735,9377,45579,6417,85358,5127,2544,2583
61135,94741,9377,45582,6417,85363,5129,2544,2585
61140,94752,9380,45589,6419,85372,5129,2544,2585
61145,94756,9382,45592,6421,85374,5129,2544,2585
61150,94766,9384,45597,6422,85382,5129,2544,2585
61155,94772,9384,45599,6422,85388,5130,2545,2585
61160,94783,9385,45604,6423,85398,5130,2545,2585
61165,94787,9386,45606,6424,85401,5130,2545,2585
61170,94797,9388,45613,6426,85409,5130,2545,2585
61175,94803,9388,45617,6426,85414,5131,2546,2585
61180,94814,9390,45621,6427,85424,5131,2546,2585
61185,94818,9390,45623,6427,85428,5131,2546,2585
61190,94828,9392,45630,6429,85436,5131,2546,2585
61195,94834,9392,45634,6429,85441,5132,2547,2585
61200,94845,9395,45641,6432,85449,5132,2547,2585
61205,94849,9397,45643,6434,85452,5132,2547,2585
61210,94859,9398,45645,6434,85461,5132,2547,2585
61215,94865,9398,45648,6434,85467,5133,2548,2585
61220,94876,9399,45653,6435,85477,5133,2548,2585
61225,94880,9400,45654,6436,85480,5133,2548,2585
61230,94890,9401,45658,6437,85489,5133,2548,2585
61235,94896,9401,45664,6437,85495,5134,2549,2585
61240,94907,9401,45669,6437,85506,5134,2549,2585
61245,94911,9401,45672,6437,85510,5134,2549,2585
61250,94921,9402,45679,6437,85519,5134,2549,2585
61255,94927,9402,45681,6437,85525,5136,2549,2587
61260,94938,9403,45687,6438,85535,5136,2549,2587
61265,94942,9403,45690,6438,85539,5136,2549,2587
61270,94952,9404,45696,6439,85548,5136,2549,2587
61275,94958,9404,45699,6439,85554,5138,2550,2588
61280,94969,9404,45706,6439,85565,5138,2550,2588
61285,94973,9404,45708,6439,85569,5138,2550,2588
61290,94983,9405,45714,6440,85578,5138,2550,2588
61295,94989,9405,45720,6440,85584,5140,2552,2588
61300,95000,9405,45726,6440,85595,5140,2552,2588
61305,95004,9405,45728,6440,85599,5140,2552,2588
61310,95014,9406,45732,6440,85608,5140,2552,2588
61315,95020,9406,45735,6440,85614,5142,2553,2589
61320,95031,9406,45737,6440,85625,5142,2553,2589
61325,95035,9407,45739,6441,85628,5142,2553,2589
61330,95045,9409,45746,6443,85636,5142,2553,2589
61335,95051,9409,45750,6443,85641,5143,2554,2589
61340,95062,9413,45757,6447,85649,5143,2554,2589
61345,95066,9413,45758,6447,85653,5143,2554,2589
61350,95076,9415,45766,6448,85661,5143,2554,2589
61355,95082,9415,45768,6448,85667,5144,2554,2590
61360,95093,9416,45774,6449,85676,5144,2554,2590
61365,95097,9417,45775,6450,85680,5144,2554,2590
61370,95107,9419,45780,6451,85688,5144,2554,2590
61375,95113,9419,45785,6451,85693,5145,2555,2590
61380,95124,9422,45789,6453,85701,5145,2555,2590
61385,95128,9423,45791,6454,85705,5145,2555,2590
61390,95138,9423,45794,6454,85715,5145,2555,2590
61395,95144,9423,45797,6454,85721,5146,2555,2591
61400,95155,9424,45802,6455,85731,5146,2555,2591
61405,95159,9424,45804,6455,85735,5146,2555,2591
61410,95169,9424,45809,6455,85745,5146,2555,2591
61415,95175,9424,45811,6455,85751,5147,2555,2592
61420,95186,9425,45815,6456,85761,5147,2555,2592
61425,95190,9426,45816,6457,85764,5147,2555,2592
61430,95200,9426,45818,6457,85774,5147,2555,2592
61435,95206,9426,45820,6457,85780,5149,2555,2594
61440,95217,9427,45826,6457,85790,5149,2555,2594
61445,95221,9428,45827,6458,85793,5149,2555,2594
61450,95231,9429,45830,6458,85802,5149,2555,2594
61455,95237,9429,45832,6458,85808,5151,2555,2596
61460,95248,9431,45837,6460,85817,5151,2555,2596
61465,95252,9432,45838,6461,85820,5151,2555,2596
61470,95262,9433,45847,6462,85829,5151,2555,2596
61475,95268,9433,45850,6462,85834,5153,2555,2598
61480,95279,9435,45854,6464,85844,5153,2555,2598
61485,95283,9436,45856,6465,85847,5153,2555,2598
61490,95293,9438,45863,6466,85855,5153,2555,2598
61495,95299,9438,45867,6466,85861,5155,2557,2598
61500,95310,9440,45875,6468,85869,5155,2557,2598
61505,95314,9441,45878,6469,85873,5155,2557,2598
61510,95324,9443,45881,6470,85881,5155,2557,2598
61515,95330,9443,45883,6470,85887,5156,2557,2599
61520,95341,9444,45888,6471,85897,5156,2557,2599
61525,95345,9444,45889,6471,85901,5156,2557,2599
61530,95355,9446,45892,6472,85909,5156,2557,2599
61535,95361,9446,45895,6472,85915,5157,2557,2600
61540,95372,9446,45898,6472,85926,5157,2557,2600
61545,95376,9446,45899,6472,85930,5157,2557,2600
61550,95386,9448,45905,6474,85938,5157,2557,2600
61555,95392,9448,45907,6474,85944,5158,2557,2601
61560,95403,9449,45914,6475,85954,5158,2557,2601
61565,95407,9449,45917,6475,85958,5158,2557,2601
61570,95417,9451,45921,6475,85966,5158,2557,2601
61575,95423,9451,45923,6475,85972,5159,2557,2602
61580,95434,9452,45930,6476,85982,5159,2557,2602
61585,95438,9452,45933,6476,85986,5159,2557,2602
61590,95448,9454,45937,6476,85994,5159,2557,2602
61595,95454,9454,45939,6476,86000,5160,2557,2603
61600,95465,9455,45948,6477,86010,5160,2557,2603
61605,95469,9456,45952,6478,86013,5160,2557,2603
61610,95479,9458,45959,6480,86021,5160,2557,2603
61615,95485,9458,45963,6480,86027,5162,2559,2603
61620,95496,9459,45967,6481,86037,5162,2559,2603
61625,95500,9459,45969,6481,86041,5162,2559,2603
61630,95510,9460,45973,6481,86050,5162,2559,2603
61635,95516,9460,45977,6481,86055,5163,2559,2604
61640,95527,9462,45981,6482,86065,5163,2559,2604
61645,95531,9463,45983,6483,86068,5163,2559,2604
61650,95541,9464,45987,6483,86077,5163,2559,2604
61655,95547,9464,45990,6483,86082,5164,2559,2605
61660,95558,9466,45995,6484,86092,5164,2559,2605
61665,95562,9466,45997,6484,86096,5164,2559,2605
61670,95572,9467,46003,6485,86105,5164,2559,2605
61675,95578,9467,46006,6485,86111,5165,2559,2606
61680,95589,9469,46011,6486,86120,5165,2559,2606
61685,95593,9469,46013,6486,86124,5165,2559,2606
61690,95603,9469,46019,6486,86134,5165,2559,2606
61695,95609,9469,46022,6486,86140,5166,2560,2606
61700,95620,9471,46028,6487,86149,5166,2560,2606
61705,95624,9471,46031,6487,86153,5166,2560,2606
61710,95634,9471,46036,6487,86163,5166,2560,2606
61715,95640,9471,46036,6487,86169,5167,2560,2607
61720,95651,9472,46043,6488,86179,5167,2560,2607
61725,95655,9473,46046,6489,86182,5167,2560,2607
61730,95665,9474,46050,6489,86191,5167,2560,2607
61735,95671,9474,46055,6489,86196,5168,2561,2607
61740,95682,9478,46063,6492,86203,5168,2561,2607
61745,95686,9479,46065,6493,86207,5168,2561,2607
61750,95696,9479,46069,6493,86217,5168,2561,2607
61755,95702,9479,46072,6493,86223,5170,2562,2608
61760,95713,9479,46078,6493,86234,5170,2562,2608
61765,95717,9479,46081,6493,86238,5170,2562,2608
61770,95727,9479,46085,6493,86248,5170,2562,2608
61775,95733,9479,46088,6493,86254,5172,2563,2609
61780,95744,9479,46093,6493,86265,5172,2563,2609
61785,95748,9479,46095,6493,86269,5172,2563,2609
61790,95758,9480,46100,6494,86278,5172,2563,2609
61795,95764,9480,46104,6494,86284,5174,2565,2609
61800,95775,9480,46112,6494,86295,5174,2565,2609
61805,95779,9480,46115,6494,86299,5174,2565,2609
61810,95789,9482,46118,6495,86307,5174,2565,2609
61815,95795,9482,46121,6495,86313,5175,2565,2610
61820,95806,9483,46128,6496,86323,5175,2565,2610
61825,95810,9483,46130,6496,86327,5175,2565,2610
61830,95820,9485,46136,6496,86335,5175,2565,2610
61835,95826,9485,46140,6496,86340,5176,2566,2610
61840,95837,9487,46146,6498,86350,5176,2566,2610
61845,95841,9487,46147,6498,86354,5176,2566,2610
61850,95851,9489,46153,6500,86362,5176,2566,2610
61855,95857,9489,46157,6500,86367,5177,2567,2610
61860,95868,9491,46160,6501,86376,5177,2567,2610
61865,95872,9492,46162,6502,86380,5177,2567,2610
61870,95882,9493,46167,6503,86389,5177,2567,2610
61875,95888,9493,46171,6503,86394,5178,2567,2611
61880,95899,9496,46176,6506,86403,5178,2567,2611
61885,95903,9496,46180,6506,86407,5178,2567,2611
61890,95913,9497,46186,6506,86416,5178,2567,2611
61895,95919,9497,46189,6506,86422,5179,2567,2612
61900,95930,9499,46193,6507,86430,5179,2567,2612
61905,95934,9500,46195,6508,86434,5179,2567,2612
61910,95944,9501,46200,6508,86443,5179,2567,2612
61915,95950,9501,46201,6508,86448,5181,2567,2614
61920,95961,9504,46206,6511,86457,5181,2567,2614
61925,95965,9504,46208,6511,86461,5181,2567,2614
61930,95975,9505,46214,6511,86470,5181,2567,2614
61935,95981,9505,46216,6511,86476,5182,2568,2614
61940,95992,9506,46219,6511,86486,5182,2568,2614
61945,95996,9506,46220,6511,86490,5182,2568,2614
61950,96006,9507,46224,6511,86499,5182,2568,2614
61955,96012,9507,46226,6511,86505,5183,2568,2615
61960,96023,9509,46232,6512,86514,5183,2568,2615
61965,96027,9509,46233,6512,86518,5183,2568,2615
61970,96037,9511,46235,6514,86526,5183,2568,2615
61975,96043,9511,46237,6514,86531,5184,2568,2616
61980,96054,9515,46245,6518,86539,5184,2568,2616
61985,96058,9515,46246,6518,86543,5184,2568,2616
61990,96068,9517,46253,6519,86551,5184,2568,2616
61995,96074,9517,46254,6519,86557,5185,2568,2617
62000,96085,9518,46259,6520,86567,5185,2568,2617
62005,96089,9518,46261,6520,86571,5185,2568,2617
62010,96099,9520,46269,6522,86579,5185,2568,2617
62015,96105,9520,46271,6522,86585,5186,2569,2617
62020,96116,9521,46278,6523,86595,5186,2569,2617
62025,96120,9521,46279,6523,86599,5186,2569,2617
62030,96130,9523,46284,6523,86607,5186,2569,2617
62035,96136,9523,46286,6523,86613,5188,2570,2618
62040,96147,9523,46291,6523,86624,5188,2570,2618
62045,96151,9523,46292,6523,86628,5188,2570,2618
62050,96161,9525,46295,6524,86636,5188,2570,2618
62055,96167,9525,46299,6524,86642,5189,2570,2619
62060,96178,9526,46305,6525,86652,5189,2570,2619
62065,96182,9526,46307,6525,86656,5189,2570,2619
62070,96192,9528,46312,6526,86664,5189,2570,2619
62075,96198,9528,46317,6526,86670,5190,2571,2619
62080,96209,9529,46320,6527,86680,5190,2571,2619
62085,96213,9529,46322,6527,86684,5190,2571,2619
62090,96223,9531,46328,6527,86692,5190,2571,2619
62095,96229,9531,46330,6527,86698,5191,2571,2620
62100,96240,9532,46332,6527,86708,5191,2571,2620
62105,96244,9533,46334,6528,86711,5191,2571,2620
62110,96254,9535,46339,6530,86719,5191,2571,2620
62115,96260,9535,46342,6530,86725,5192,2571,2621
62120,96271,9536,46347,6531,86734,5192,2571,2621
62125,96275,9538,46349,6533,86737,5192,2571,2621
62130,96285,9540,46351,6533,86745,5192,2571,2621
62135,96291,9540,46353,6533,86751,5193,2571,2622
62140,96302,9541,46358,6533,86760,5193,2571,2622
62145,96306,9544,46361,6536,86762,5193,2571,2622
62150,96316,9546,46365,6536,86770,5193,2571,2622
62155,96322,9546,46368,6536,86775,5195,2572,2623
62160,96333,9549,46374,6539,86783,5195,2572,2623
62165,96337,9551,46377,6541,86786,5195,2572,2623
62170,96347,9552,46380,6541,86795,5195,2572,2623
62175,96353,9552,46383,6541,86801,5196,2572,2624
62180,96364,9552,46388,6541,86812,5196,2572,2624
62185,96368,9552,46390,6541,86816,5196,2572,2624
62190,96378,9553,46394,6542,86825,5196,2572,2624
62195,96384,9553,46396,6542,86831,5197,2572,2625
62200,96395,9553,46401,6542,86842,5197,2572,2625
62205,96399,9553,46404,6542,86846,5197,2572,2625
62210,96409,9554,46407,6543,86855,5197,2572,2625
62215,96415,9554,46410,6543,86861,5198,2573,2625
62220,96426,9554,46417,6543,86872,5198,2573,2625
62225,96430,9554,46418,6543,86876,5198,2573,2625
62230,96440,9555,46424,6544,86885,5198,2573,2625
62235,96446,9555,46426,6544,86891,5199,2573,2626
62240,96457,9557,46435,6546,86900,5199,2573,2626
62245,96461,9557,46438,6546,86904,5199,2573,2626
62250,96471,9558,46443,6546,86913,5199,2573,2626
62255,96477,9558,46444,6546,86919,5200,2573,2627
62260,96488,9559,46449,6546,86929,5200,2573,2627
62265,96492,9560,46452,6547,86932,5200,2573,2627
62270,96502,9562,46457,6547,86940,5200,2573,2627
62275,96508,9562,46459,6547,86945,5202,2574,2628
62280,96519,9565,46465,6549,86953,5202,2574,2628
62285,96523,9567,46468,6551,86956,5202,2574,2628
62290,96533,9569,46471,6551,86964,5202,2574,2628
62295,96539,9569,46475,6551,86970,5203,2574,2629
62300,96550,9570,46481,6552,86980,5203,2574,2629
62305,96554,9571,46484,6553,86983,5203,2574,2629
62310,96564,9573,46488,6555,86991,5203,2574,2629
62315,96570,9573,46492,6555,86997,5204,2574,2630
62320,96581,9574,46498,6556,87007,5204,2574,2630
62325,96585,9575,46500,6557,87010,5204,2574,2630
62330,96595,9577,46505,6558,87018,5204,2574,2630
62335,96601,9577,46507,6558,87024,5205,2575,2630
62340,96612,9577,46516,6558,87035,5205,2575,2630
62345,96616,9577,46518,6558,87039,5205,2575,2630
62350,96626,9578,46522,6558,87048,5205,2575,2630
62355,96632,9578,46525,6558,87054,5206,2576,2630
62360,96643,9578,46532,6558,87065,5206,2576,2630
62365,96647,9578,46534,6558,87069,5206,2576,2630
62370,96657,9579,46540,6559,87078,5206,2576,2630
62375,96663,9579,46545,6559,87084,5207,2577,2630
62380,96674,9579,46550,6559,87095,5207,2577,2630
62385,96678,9579,46553,6559,87099,5207,2577,2630
62390,96688,9580,46560,6560,87108,5207,2577,2630
62395,96694,9580,46565,6560,87114,5209,2579,2630
62400,96705,9583,46571,6563,87121,5209,2579,2630
62405,96709,9584,46572,6564,87125,5209,2579,2630
62410,96719,9586,46577,6564,87133,5209,2579,2630
62415,96725,9586,46582,6564,87139,5210,2580,2630
62420,96736,9588,46586,6565,87148,5210,2580,2630
62425,96740,9588,46586,6565,87152,5210,2580,2630
62430,96750,9590,46590,6565,87160,5210,2580,2630
62435,96756,9590,46592,6565,87165,5211,2580,2631
62440,96767,9593,46595,6567,87174,5211,2580,2631
62445,96771,9593,46596,6567,87178,5211,2580,2631
62450,96781,9595,46599,6568,87186,5211,2580,2631
62455,96787,9595,46601,6568,87192,5212,2580,2632
62460,96798,9596,46605,6569,87202,5212,2580,2632
62465,96802,9596,46607,6569,87206,5212,2580,2632
62470,96812,9597,46613,6569,87215,5212,2580,2632
62475,96818,9597,46616,6569,87221,5213,2581,2632
62480,96829,9597,46620,6569,87231,5213,2581,2632
62485,96833,9598,46622,6570,87235,5213,2581,2632
62490,96843,9599,46627,6571,87244,5213,2581,2632
62495,96849,9599,46630,6571,87250,5214,2582,2632
62500,96860,9599,46633,6571,87261,5214,2582,2632
62505,96864,9599,46635,6571,87265,5214,2582,2632
62510,96874,9600,46641,6571,87274,5214,2582,2632
62515,96880,9600,46644,6571,87280,5215,2582,2633
62520,96891,9600,46651,6571,87291,5215,2582,2633
62525,96895,9600,46653,6571,87295,5215,2582,2633
62530,96905,9602,46658,6571,87303,5215,2582,2633
62535,96911,9602,46661,6571,87309,5216,2582,2634
62540,96922,9603,46670,6572,87319,5216,2582,2634
62545,96926,9603,46673,6572,87323,5216,2582,2634
62550,96936,9605,46679,6574,87331,5216,2582,2634
62555,96942,9605,46681,6574,87336,5217,2582,2635
62560,96953,9607,46687,6576,87346,5217,2582,2635
62565,96957,9607,46688,6576,87350,5217,2582,2635
62570,96967,9609,46696,6578,87358,5217,2582,2635
62575,96973,9609,46700,6578,87364,5219,2583,2636
62580,96984,9611,46705,6580,87373,5219,2583,2636
62585,96988,9611,46707,6580,87377,5219,2583,2636
62590,96998,9612,46711,6580,87386,5219,2583,2636
62595,97004,9612,46714,6580,87392,5221,2584,2637
62600,97015,9614,46718,6581,87401,5221,2584,2637
62605,97019,9615,46721,6582,87404,5221,2584,2637
62610,97029,9616,46725,6583,87413,5221,2584,2637
62615,97035,9616,46728,6583,87418,5223,2585,2638
62620,97046,9618,46732,6585,87428,5223,2585,2638
62625,97050,9619,46733,6586,87431,5223,2585,2638
62630,97060,9620,46741,6586,87440,5223,2585,2638
62635,97066,9620,46743,6586,87446,5225,2586,2639
62640,97077,9623,46750,6589,87454,5225,2586,2639
62645,97081,9624,46753,6590,87457,5225,2586,2639
62650,97091,9625,46755,6590,87466,5225,2586,2639
62655,97097,9625,46759,6590,87472,5226,2587,2639
62660,97108,9626,46765,6591,87482,5226,2587,2639
62665,97112,9626,46768,6591,87486,5226,2587,2639
62670,97122,9627,46771,6591,87495,5226,2587,2639
62675,97128,9627,46776,6591,87501,5227,2588,2639
62680,97139,9627,46780,6591,87512,5227,2588,2639
62685,97143,9627,46782,6591,87516,5227,2588,2639
62690,97153,9628,46787,6591,87525,5227,2588,2639
62695,97159,9628,46791,6591,87531,5228,2589,2639
62700,97170,9628,46795,6591,87542,5228,2589,2639
62705,97174,9628,46799,6591,87546,5228,2589,2639
62710,97184,9629,46803,6591,87555,5228,2589,2639
62715,97190,9629,46804,6591,87561,5229,2589,2640
62720,97201,9630,46809,6592,87571,5229,2589,2640
62725,97205,9630,46811,6592,87575,5229,2589,2640
62730,97215,9631,46818,6592,87584,5229,2589,2640
62735,97221,9631,46821,6592,87590,5230,2589,2641
62740,97232,9631,46826,6592,87601,5230,2589,2641
62745,97236,9631,46830,6592,87605,5230,2589,2641
62750,97246,9633,46835,6593,87613,5230,2589,2641
62755,97252,9633,46836,6593,87619,5231,2589,2642
62760,97263,9635,46842,6595,87628,5231,2589,2642
62765,97267,9636,46843,6596,87631,5231,2589,2642
62770,97277,9638,46847,6596,87639,5231,2589,2642
62775,97283,9638,46851,6596,87645,5233,2590,2643
62780,97294,9639,46856,6596,87655,5233,2590,2643
62785,97298,9639,46858,6596,87659,5233,2590,2643
62790,97308,9641,46861,6597,87667,5233,2590,2643
62795,97314,9641,46863,6597,87672,5235,2590,2645
62800,97325,9643,46869,6598,87682,5235,2590,2645
62805,97329,9645,46872,6600,87684,5235,2590,2645
62810,97339,9647,46877,6600,87692,5235,2590,2645
62815,97345,9647,46880,6600,87697,5237,2591,2646
62820,97356,9649,46886,6601,87707,5237,2591,2646
62825,97360,9649,46889,6601,87711,5237,2591,2646
62830,97370,9650,46895,6602,87720,5237,2591,2646
62835,97376,9650,46901,6602,87726,5238,2592,2646
62840,97387,9650,46907,6602,87737,5238,2592,2646
62845,97391,9650,46911,6602,87741,5238,2592,2646
62850,97401,9651,46918,6603,87750,5238,2592,2646
62855,97407,9651,46923,6603,87756,5239,2593,2646
62860,97418,9651,46928,6603,87767,5239,2593,2646
62865,97422,9651,46930,6603,87771,5239,2593,2646
62870,97432,9652,46934,6603,87780,5239,2593,2646
62875,97438,9652,46936,6603,87786,5240,2593,2647
62880,97449,9652,46942,6603,87797,5240,2593,2647
62885,97453,9652,46943,6603,87801,5240,2593,2647
62890,97463,9653,46949,6603,87810,5240,2593,2647
62895,97469,9653,46952,6603,87816,5241,2594,2647
62900,97480,9653,46958,6603,87827,5241,2594,2647
62905,97484,9653,46959,6603,87831,5241,2594,2647
62910,97494,9654,46965,6604,87840,5241,2594,2647
62915,97500,9654,46968,6604,87846,5242,2594,2648
62920,97511,9654,46976,6604,87857,5242,2594,2648
62925,97515,9654,46977,6604,87861,5242,2594,2648
62930,97525,9656,46980,6604,87869,5242,2594,2648
62935,97531,9656,46981,6604,87875,5244,2595,2649
62940,97542,9658,46985,6605,87884,5244,2595,2649
62945,97546,9659,46987,6606,87887,5244,2595,2649
62950,97556,9661,46990,6607,87895,5244,2595,2649
62955,97562,9661,46994,6607,87901,5246,2596,2650
62960,97573,9663,47000,6608,87909,5246,2596,2650
62965,97577,9664,47004,6609,87913,5246,2596,2650
62970,97587,9666,47008,6611,87921,5246,2596,2650
62975,97593,9666,47009,6611,87927,5247,2597,2650
62980,97604,9669,47014,6613,87935,5247,2597,2650
62985,97608,9670,47016,6614,87938,5247,2597,2650
62990,97618,9672,47019,6614,87946,5247,2597,2650
62995,97624,9672,47023,6614,87951,5248,2597,2651
63000,97635,9674,47027,6615,87961,5248,2597,2651
63005,97639,9675,47030,6616,87964,5248,2597,2651
63010,97649,9676,47036,6617,87973,5248,2597,2651
63015,97655,9676,47039,6617,87979,5249,2597,2652
63020,97666,9677,47044,6618,87989,5249,2597,2652
63025,97670,9677,47045,6618,87993,5249,2597,2652
63030,97680,9678,47051,6618,88002,5249,2597,2652
63035,97686,9678,47054,6618,88008,5250,2597,2653
63040,97697,9679,47060,6618,88018,5250,2597,2653
63045,97701,9679,47061,6618,88022,5250,2597,2653
63050,97711,9680,47067,6619,88031,5250,2597,2653
63055,97717,9680,47069,6619,88037,5251,2597,2654
63060,97728,9681,47072,6619,88047,5251,2597,2654
63065,97732,9681,47073,6619,88051,5251,2597,2654
63070,97742,9683,47077,6619,88059,5251,2597,2654
63075,97748,9683,47080,6619,88065,5252,2597,2655
63080,97759,9684,47083,6620,88075,5252,2597,2655
63085,97763,9684,47086,6620,88079,5252,2597,2655
63090,97773,9686,47090,6621,88087,5252,2597,2655
63095,97779,9686,47092,6621,88093,5253,2597,2656
63100,97790,9687,47096,6622,88103,5253,2597,2656
63105,97794,9688,47097,6623,88106,5253,2597,2656
63110,97804,9690,47101,6623,88114,5253,2597,2656
63115,97810,9690,47104,6623,88120,5254,2598,2656
63120,97821,9691,47109,6624,88130,5254,2598,2656
63125,97825,9691,47112,6624,88134,5254,2598,2656
63130,97835,9693,47118,6625,88142,5254,2598,2656
63135,97841,9693,47123,6625,88148,5256,2600,2656
63140,97852,9693,47127,6625,88159,5256,2600,2656
63145,97856,9693,47129,6625,88163,5256,2600,2656
63150,97866,9695,47134,6625,88171,5256,2600,2656
63155,97872,9695,47139,6625,88177,5258,2601,2657
63160,97883,9695,47144,6625,88188,5258,2601,2657
63165,97887,9695,47148,6625,88192,5258,2601,2657
63170,97897,9697,47157,6627,88200,5258,2601,2657
63175,97903,9697,47159,6627,88206,5260,2602,2658
63180,97914,9699,47164,6629,88214,5260,2602,2658
63185,97918,9701,47166,6631,88217,5260,2602,2658
63190,97928,9703,47170,6633,88225,5260,2602,2658
63195,97934,9703,47176,6633,88230,5261,2603,2658
63200,97945,9706,47179,6635,88239,5261,2603,2658
63205,97949,9706,47180,6635,88243,5261,2603,2658
63210,97959,9708,47186,6636,88251,5261,2603,2658
63215,97965,9708,47190,6636,88256,5262,2603,2659
63220,97976,9710,47197,6638,88265,5262,2603,2659
63225,97980,9712,47200,6640,88268,5262,2603,2659
63230,97990,9714,47206,6641,88276,5262,2603,2659
63235,97996,9714,47208,6641,88282,5263,2604,2659
63240,98007,9715,47212,6641,88291,5263,2604,2659
63245,98011,9716,47213,6642,88295,5263,2604,2659
63250,98021,9716,47218,6642,88305,5263,2604,2659
63255,98027,9716,47218,6642,88311,5264,2604,2660
63260,98038,9716,47224,6642,88322,5264,2604,2660
63265,98042,9716,47226,6642,88326,5264,2604,2660
63270,98052,9716,47228,6642,88336,5264,2604,2660
63275,98058,9716,47231,6642,88342,5265,2605,2660
63280,98069,9716,47238,6642,88353,5265,2605,2660
63285,98073,9716,47241,6642,88357,5265,2605,2660
63290,98083,9716,47246,6642,88367,5265,2605,2660
63295,98089,9716,47250,6642,88373,5266,2606,2660
63300,98100,9716,47257,6642,88384,5266,2606,2660
63305,98104,9716,47259,6642,88388,5266,2606,2660
63310,98114,9717,47262,6642,88397,5266,2606,2660
63315,98120,9717,47266,6642,88403,5268,2608,2660
63320,98131,9717,47272,6642,88414,5268,2608,2660
63325,98135,9717,47275,6642,88418,5268,2608,2660
63330,98145,9718,47280,6643,88427,5268,2608,2660
63335,98151,9718,47282,6643,88433,5269,2608,2661
63340,98162,9719,47290,6644,88443,5269,2608,2661
63345,98166,9719,47293,6644,88447,5269,2608,2661
63350,98176,9721,47300,6646,88455,5269,2608,2661
63355,98182,9721,47301,6646,88461,5270,2608,2662
63360,98193,9724,47309,6649,88468,5270,2608,2662
63365,98197,9725,47310,6650,88472,5270,2608,2662
63370,98207,9727,47315,6651,88480,5270,2608,2662
63375,98213,9727,47318,6651,88486,5271,2608,2663
63380,98224,9728,47325,6651,88495,5271,2608,2663
63385,98228,9729,47325,6652,88499,5271,2608,2663
63390,98238,9731,47329,6652,88507,5271,2608,2663
63395,98244,9731,47330,6652,88513,5272,2609,2663
63400,98255,9732,47335,6652,88523,5272,2609,2663
63405,98259,9732,47337,6652,88527,5272,2609,2663
63410,98269,9734,47341,6653,88535,5272,2609,2663
63415,98275,9734,47343,6653,88541,5273,2609,2664
63420,98286,9735,47348,6654,88550,5273,2609,2664
63425,98290,9736,47349,6655,88554,5273,2609,2664
63430,98300,9738,47357,6657,88562,5273,2609,2664
63435,98306,9738,47361,6657,88567,5275,2610,2665
63440,98317,9740,47365,6659,88577,5275,2610,2665
63445,98321,9740,47365,6659,88581,5275,2610,2665
63450,98331,9742,47369,6660,88589,5275,2610,2665
63455,98337,9742,47372,6660,88595,5277,2611,2666
63460,98348,9743,47378,6660,88605,5277,2611,2666
63465,98352,9744,47380,6661,88608,5277,2611,2666
63470,98362,9746,47386,6662,88616,5277,2611,2666
63475,98368,9746,47389,6662,88622,5279,2611,2668
63480,98379,9747,47394,6663,88631,5279,2611,2668
63485,98383,9750,47398,6666,88633,5279,2611,2668
63490,98393,9751,47403,6667,88642,5279,2611,2668
63495,98399,9751,47408,6667,88648,5281,2612,2669
63500,98410,9752,47415,6668,88658,5281,2612,2669
63505,98414,9754,47417,6670,88660,5281,2612,2669
63510,98424,9755,47422,6670,88669,5281,2612,2669
63515,98430,9755,47422,6670,88675,5283,2612,2671
63520,98441,9756,47427,6671,88685,5283,2612,2671
63525,98445,9757,47430,6672,88688,5283,2612,2671
63530,98455,9758,47435,6672,88697,5283,2612,2671
63535,98461,9758,47438,6672,88703,5285,2612,2673
63540,98472,9760,47445,6673,88712,5285,2612,2673
63545,98476,9761,47447,6674,88715,5285,2612,2673
63550,98486,9763,47451,6674,88723,5285,2612,2673
63555,98492,9763,47453,6674,88729,5286,2612,2674
63560,98503,9763,47458,6674,88740,5286,2612,2674
63565,98507,9763,47461,6674,88744,5286,2612,2674
63570,98517,9765,47468,6676,88752,5286,2612,2674
63575,98523,9765,47470,6676,88758,5287,2612,2675
63580,98534,9766,47476,6677,88768,5287,2612,2675
63585,98538,9766,47477,6677,88772,5287,2612,2675
63590,98548,9768,47481,6678,88780,5287,2612,2675
63595,98554,9768,47484,6678,88785,5288,2613,2675
63600,98565,9770,47491,6680,88795,5288,2613,2675
63605,98569,9770,47493,6680,88799,5288,2613,2675
63610,98579,9771,47499,6681,88808,5288,2613,2675
63615,98585,9771,47502,6681,88813,5289,2613,2676
63620,98596,9774,47505,6683,88822,5289,2613,2676
63625,98600,9774,47505,6683,88826,5289,2613,2676
63630,98610,9775,47510,6684,88835,5289,2613,2676
63635,98616,9775,47512,6684,88841,5290,2614,2676
63640,98627,9777,47518,6686,88850,5290,2614,2676
63645,98631,9777,47519,6686,88854,5290,2614,2676
63650,98641,9778,47522,6686,88863,5290,2614,2676
63655,98647,9778,47525,6686,88869,5291,2615,2676
63660,98658,9780,47529,6687,88878,5291,2615,2676
63665,98662,9780,47531,6687,88882,5291,2615,2676
63670,98672,9781,47538,6688,88891,5291,2615,2676
63675,98678,9781,47540,6688,88897,5292,2615,2677
63680,98689,9782,47545,6689,88906,5292,2615,2677
63685,98693,9783,47547,6690,88910,5292,2615,2677
63690,98703,9784,47553,6690,88919,5292,2615,2677
63695,98709,9784,47557,6690,88924,5293,2616,2677
63700,98720,9786,47564,6692,88934,5293,2616,2677
63705,98724,9786,47565,6692,88938,5293,2616,2677
63710,98734,9788,47571,6693,88946,5293,2616,2677
63715,98740,9788,47573,6693,88951,5294,2617,2677
63720,98751,9791,47580,6696,88959,5294,2617,2677
63725,98755,9792,47581,6697,88963,5294,2617,2677
63730,98765,9793,47586,6698,88972,5294,2617,2677
63735,98771,9793,47587,6698,88978,5296,2617,2679
63740,98782,9793,47593,6698,88989,5296,2617,2679
63745,98786,9793,47594,6698,88993,5296,2617,2679
63750,98796,9794,47595,6699,89002,5296,2617,2679
63755,98802,9794,47599,6699,89008,5297,2618,2679
63760,98813,9794,47603,6699,89019,5297,2618,2679
63765,98817,9794,47605,6699,89023,5297,2618,2679
63770,98827,9795,47608,6699,89032,5297,2618,2679
63775,98833,9795,47611,6699,89038,5298,2619,2679
63780,98844,9796,47613,6699,89048,5298,2619,2679
63785,98848,9796,47615,6699,89052,5298,2619,2679
63790,98858,9797,47620,6700,89061,5298,2619,2679
63795,98864,9797,47625,6700,89067,5299,2619,2680
63800,98875,9799,47630,6702,89076,5299,2619,2680
63805,98879,9799,47633,6702,89080,5299,2619,2680
63810,98889,9800,47636,6702,89089,5299,2619,2680
63815,98895,9800,47639,6702,89095,5300,2620,2680
63820,98906,9801,47645,6702,89105,5300,2620,2680
63825,98910,9801,47647,6702,89109,5300,2620,2680
63830,98920,9802,47653,6702,89118,5300,2620,2680
63835,98926,9802,47655,6702,89124,5301,2621,2680
63840,98937,9804,47659,6704,89133,5301,2621,2680
63845,98941,9806,47662,6706,89135,5301,2621,2680
63850,98951,9808,47667,6708,89143,5301,2621,2680
63855,98957,9808,47669,6708,89149,5303,2621,2682
63860,98968,9810,47674,6709,89158,5303,2621,2682
63865,98972,9810,47674,6709,89162,5303,2621,2682
63870,98982,9812,47679,6710,89170,5303,2621,2682
63875,98988,9812,47683,6710,89176,5305,2622,2683
63880,98999,9813,47686,6710,89186,5305,2622,2683
63885,99003,9813,47687,6710,89190,5305,2622,2683
63890,99013,9815,47692,6710,89198,5305,2622,2683
63895,99019,9815,47692,6710,89204,5307,2622,2685
63900,99030,9817,47700,6712,89213,5307,2622,2685
63905,99034,9817,47703,6712,89217,5307,2622,2685
63910,99044,9819,47709,6713,89225,5307,2622,2685
63915,99050,9819,47711,6713,89230,5308,2622,2686
63920,99061,9820,47717,6714,89241,5308,2622,2686
63925,99065,9820,47719,6714,89245,5308,2622,2686
63930,99075,9822,47722,6715,89253,5308,2622,2686
63935,99081,9822,47724,6715,89259,5309,2623,2686
63940,99092,9822,47729,6715,89269,5309,2623,2686
63945,99096,9823,47730,6716,89273,5309,2623,2686
63950,99106,9825,47732,6716,89281,5309,2623,2686
63955,99112,9825,47733,6716,89287,5310,2623,2687
63960,99123,9825,47740,6716,89298,5310,2623,2687
63965,99127,9825,47741,6716,89302,5310,2623,2687
63970,99137,9827,47746,6716,89310,5310,2623,2687
63975,99143,9827,47749,6716,89316,5311,2624,2687
63980,99154,9827,47755,6716,89327,5311,2624,2687
63985,99158,9827,47758,6716,89331,5311,2624,2687
63990,99168,9829,47767,6717,89339,5311,2624,2687
63995,99174,9829,47769,6717,89345,5312,2624,2688
64000,99185,9829,47773,6717,89356,5312,2624,2688
64005,99189,9829,47774,6717,89360,5312,2624,2688
64010,99199,9831,47781,6719,89368,5312,2624,2688
64015,99205,9831,47785,6719,89373,5314,2625,2689
64020,99216,9834,47788,6721,89382,5314,2625,2689
64025,99220,9835,47791,6722,89385,5314,2625,2689
64030,99230,9836,47797,6722,89394,5314,2625,2689
64035,99236,9836,47802,6722,89400,5315,2626,2689
64040,99247,9839,47809,6725,89408,5315,2626,2689
64045,99251,9840,47810,6726,89411,5315,2626,2689
64050,99261,9841,47816,6727,89420,5315,2626,2689
64055,99267,9841,47819,6727,89426,5316,2626,2690
64060,99278,9843,47822,6728,89435,5316,2626,2690
64065,99282,9843,47824,6728,89439,5316,2626,2690
64070,99292,9844,47829,6728,89448,5316,2626,2690
64075,99298,9844,47833,6728,89454,5317,2626,2691
64080,99309,9847,47840,6731,89462,5317,2626,2691
64085,99313,9847,47843,6731,89466,5317,2626,2691
64090,99323,9848,47849,6732,89475,5317,2626,2691
64095,99329,9848,47854,6732,89481,5318,2627,2691
64100,99340,9849,47862,6733,89491,5318,2627,2691
64105,99344,9849,47863,6733,89495,5318,2627,2691
64110,99354,9850,47867,6734,89504,5318,2627,2691
64115,99360,9850,47870,6734,89510,5319,2627,2692
64120,99371,9850,47875,6734,89521,5319,2627,2692
64125,99375,9850,47876,6734,89525,5319,2627,2692
64130,99385,9852,47879,6734,89533,5319,2627,2692
64135,99391,9852,47883,6734,89539,5320,2628,2692
64140,99402,9853,47888,6735,89549,5320,2628,2692
64145,99406,9853,47890,6735,89553,5320,2628,2692
64150,99416,9855,47894,6736,89561,5320,2628,2692
64155,99422,9855,47896,6736,89567,5321,2629,2692
64160,99433,9855,47902,6736,89578,5321,2629,2692
64165,99437,9855,47904,6736,89582,5321,2629,2692
64170,99447,9857,47910,6737,89590,5321,2629,2692
64175,99453,9857,47912,6737,89596,5322,2630,2692
64180,99464,9857,47918,6737,89607,5322,2630,2692
64185,99468,9857,47921,6737,89611,5322,2630,2692
64190,99478,9859,47925,6738,89619,5322,2630,2692
64195,99484,9859,47929,6738,89625,5324,2632,2692
64200,99495,9860,47933,6739,89635,5324,2632,2692
64205,99499,9860,47934,6739,89639,5324,2632,2692
64210,99509,9862,47939,6740,89647,5324,2632,2692
64215,99515,9862,47943,6740,89653,5326,2633,2693
64220,99526,9863,47947,6740,89663,5326,2633,2693
64225,99530,9863,47948,6740,89667,5326,2633,2693
64230,99540,9865,47953,6740,89675,5326,2633,2693
64235,99546,9865,47956,6740,89681,5327,2634,2693
64240,99557,9866,47960,6740,89691,5327,2634,2693
64245,99561,9866,47962,6740,89695,5327,2634,2693
64250,99571,9868,47965,6740,89703,5327,2634,2693
64255,99577,9868,47969,6740,89709,5328,2635,2693
64260,99588,9869,47973,6740,89719,5328,2635,2693
64265,99592,9870,47976,6741,89722,5328,2635,2693
64270,99602,9872,47979,6741,89730,5328,2635,2693
64275,99608,9872,47981,6741,89736,5329,2636,2693
64280,99619,9875,47985,6743,89744,5329,2636,2693
64285,99623,9876,47986,6744,89747,5329,2636,2693
64290,99633,9878,47993,6744,89755,5329,2636,2693
64295,99639,9878,47995,6744,89761,5330,2637,2693
64300,99650,9880,48001,6745,89770,5330,2637,2693
64305,99654,9881,48002,6746,89773,5330,2637,2693
64310,99664,9883,48006,6746,89781,5330,2637,2693
64315,99670,9883,48010,6746,89786,5331,2637,2694
64320,99681,9887,48017,6750,89793,5331,2637,2694
64325,99685,9888,48019,6751,89797,5331,2637,2694
64330,99695,9889,48025,6752,89806,5331,2637,2694
64335,99701,9889,48026,6752,89812,5332,2637,2695
64340,99712,9889,48034,6752,89823,5332,2637,2695
64345,99716,9889,48037,6752,89827,5332,2637,2695
64350,99726,9890,48041,6752,89836,5332,2637,2695
64355,99732,9890,48044,6752,89842,5334,2638,2696
64360,99743,9890,48049,6752,89853,5334,2638,2696
64365,99747,9890,48050,6752,89857,5334,2638,2696
64370,99757,9891,48053,6753,89866,5334,2638,2696
64375,99763,9891,48057,6753,89872,5336,2640,2696
64380,99774,9891,48065,6753,89883,5336,2640,2696
64385,99778,9891,48068,6753,89887,5336,2640,2696
64390,99788,9893,48073,6754,89895,5336,2640,2696
64395,99794,9893,48074,6754,89901,5338,2640,2698
64400,99805,9893,48078,6754,89912,5338,2640,2698
64405,99809,9893,48081,6754,89916,5338,2640,2698
64410,99819,9895,48086,6756,89924,5338,2640,2698
64415,99825,9895,48089,6756,89929,5340,2640,2700
64420,99836,9897,48095,6758,89939,5340,2640,2700
64425,99840,9897,48097,6758,89943,5340,2640,2700
64430,99850,9899,48103,6760,89951,5340,2640,2700
64435,99856,9899,48105,6760,89957,5342,2642,2700
64440,99867,9901,48112,6762,89966,5342,2642,2700
64445,99871,9901,48114,6762,89970,5342,2642,2700
64450,99881,9903,48120,6764,89978,5342,2642,2700
64455,99887,9903,48122,6764,89984,5343,2643,2700
64460,99898,9905,48125,6765,89993,5343,2643,2700
64465,99902,9905,48127,6765,89997,5343,2643,2700
64470,99912,9906,48129,6765,90006,5343,2643,2700
64475,99918,9906,48130,6765,90012,5344,2643,2701
64480,99929,9908,48133,6767,90021,5344,2643,2701
64485,99933,9908,48133,6767,90025,5344,2643,2701
64490,99943,9909,48136,6767,90034,5344,2643,2701
64495,99949,9909,48137,6767,90040,5345,2643,2702
64500,99960,9911,48143,6769,90049,5345,2643,2702
64505,99964,9911,48146,6769,90053,5345,2643,2702
64510,99974,9912,48150,6770,90062,5345,2643,2702
64515,99980,9912,48152,6770,90068,5346,2643,2703
64520,99991,9915,48157,6772,90076,5346,2643,2703
64525,99995,9915,48160,6772,90080,5346,2643,2703
64530,100005,9916,48165,6773,90089,5346,2643,2703
64535,100011,9916,48167,6773,90095,5347,2644,2703
64540,100022,9918,48171,6774,90104,5347,2644,2703
64545,100026,9918,48173,6774,90108,5347,2644,2703
64550,100036,9919,48180,6775,90117,5347,2644,2703
64555,100042,9919,48183,6775,90123,5349,2646,2703
64560,100053,9921,48186,6776,90132,5349,2646,2703
64565,100057,9921,48186,6776,90136,5349,2646,2703
64570,100067,9923,48192,6777,90144,5349,2646,2703
64575,100073,9923,48193,6777,90150,5351,2646,2705
64580,100084,9923,48198,6777,90161,5351,2646,2705
64585,100088,9924,48200,6778,90164,5351,2646,2705
64590,100098,9926,48204,6779,90172,5351,2646,2705
64595,100104,9926,48208,6779,90177,5353,2647,2706
64600,100115,9927,48216,6780,90187,5353,2647,2706
64605,100119,9928,48218,6781,90191,5353,2647,2706
64610,100129,9930,48224,6782,90199,5353,2647,2706
64615,100135,9930,48228,6782,90205,5355,2648,2707
64620,100146,9931,48235,6783,90214,5355,2648,2707
64625,100150,9932,48237,6784,90218,5355,2648,2707
64630,100160,9934,48241,6784,90226,5355,2648,2707
64635,100166,9934,48244,6784,90232,5357,2649,2708
64640,100177,9934,48249,6784,90243,5357,2649,2708
64645,100181,9934,48252,6784,90247,5357,2649,2708
64650,100191,9936,48259,6785,90255,5357,2649,2708
64655,100197,9936,48263,6785,90261,5359,2650,2709
64660,100208,9936,48267,6785,90272,5359,2650,2709
64665,100212,9936,48268,6785,90276,5359,2650,2709
64670,100222,9938,48272,6785,90284,5359,2650,2709
64675,100228,9938,48274,6785,90290,5361,2651,2710
64680,100239,9940,48278,6786,90299,5361,2651,2710
64685,100243,9940,48278,6786,90303,5361,2651,2710
64690,100253,9942,48283,6787,90311,5361,2651,2710
64695,100259,9942,48286,6787,90317,5362,2651,2711
64700,100270,9943,48290,6787,90327,5362,2651,2711
64705,100274,9943,48291,6787,90331,5362,2651,2711
64710,100284,9945,48296,6789,90339,5362,2651,2711
64715,100290,9945,48299,6789,90345,5363,2651,2712
64720,100301,9947,48305,6791,90354,5363,2651,2712
64725,100305,9949,48309,6793,90356,5363,2651,2712
64730,100315,9951,48312,6794,90364,5363,2651,2712
64735,100321,9951,48316,6794,90370,5364,2652,2712
64740,100332,9952,48321,6794,90380,5364,2652,2712
64745,100336,9952,48323,6794,90384,5364,2652,2712
64750,100346,9954,48328,6795,90392,5364,2652,2712
64755,100352,9954,48329,6795,90398,5365,2652,2713
64760,100363,9954,48332,6795,90409,5365,2652,2713
64765,100367,9954,48333,6795,90413,5365,2652,2713
64770,100377,9956,48338,6796,90421,5365,2652,2713
64775,100383,9956,48339,6796,90427,5366,2653,2713
64780,100394,9957,48344,6797,90437,5366,2653,2713
64785,100398,9957,48345,6797,90441,5366,2653,2713
64790,100408,9959,48351,6798,90449,5366,2653,2713
64795,100414,9959,48355,6798,90454,5368,2655,2713
64800,100425,9961,48362,6800,90464,5368,2655,2713
64805,100429,9961,48364,6800,90468,5368,2655,2713
64810,100439,9962,48370,6801,90477,5368,2655,2713
64815,100445,9962,48374,6801,90483,5370,2656,2714
64820,100456,9962,48380,6801,90493,5370,2656,2714
64825,100460,9963,48381,6802,90497,5370,2656,2714
64830,100470,9964,48388,6803,90506,5370,2656,2714
64835,100476,9964,48389,6803,90512,5371,2656,2715
64840,100487,9965,48396,6804,90521,5371,2656,2715
64845,100491,9966,48398,6805,90525,5371,2656,2715
64850,100501,9967,48399,6805,90534,5371,2656,2715
64855,100507,9967,48404,6805,90540,5372,2657,2715
64860,100518,9968,48407,6805,90549,5372,2657,2715
64865,100522,9969,48410,6806,90553,5372,2657,2715
64870,100532,9970,48415,6806,90562,5372,2657,2715
64875,100538,9970,48418,6806,90567,5373,2658,2715
64880,100549,9972,48425,6807,90577,5373,2658,2715
64885,100553,9972,48428,6807,90581,5373,2658,2715
64890,100563,9973,48435,6807,90590,5373,2658,2715
64895,100569,9973,48438,6807,90595,5374,2658,2716
64900,100580,9976,48444,6810,90604,5374,2658,2716
64905,100584,9977,48446,6811,90607,5374,2658,2716
64910,100594,9979,48451,6813,90615,5374,2658,2716
64915,100600,9979,48454,6813,90621,5375,2659,2716
64920,100611,9981,48458,6815,90630,5375,2659,2716
64925,100615,9982,48459,6816,90633,5375,2659,2716
64930,100625,9983,48462,6817,90642,5375,2659,2716
64935,100631,9983,48465,6817,90648,5376,2660,2716
64940,100642,9985,48468,6819,90657,5376,2660,2716
64945,100646,9986,48469,6820,90660,5376,2660,2716
64950,100656,9987,48475,6820,90669,5376,2660,2716
64955,100662,9987,48478,6820,90675,5377,2661,2716
64960,100673,9989,48485,6822,90684,5377,2661,2716
64965,100677,9989,48487,6822,90688,5377,2661,2716
64970,100687,9990,48493,6823,90697,5377,2661,2716
64975,100693,9990,48495,6823,90703,5378,2661,2717
64980,100704,9991,48499,6824,90713,5378,2661,2717
64985,100708,9991,48500,6824,90717,5378,2661,2717
64990,100718,9992,48504,6825,90726,5378,2661,2717
64995,100724,9992,48506,6825,90732,5379,2661,2718
65000,100735,9993,48509,6826,90742,5379,2661,2718
65005,100739,9993,48511,6826,90746,5379,2661,2718
65010,100749,9994,48518,6826,90755,5379,2661,2718
65015,100755,9994,48519,6826,90761,5380,2662,2718
65020,100766,9994,48523,6826,90772,5380,2662,2718
65025,100770,9994,48524,6826,90776,5380,2662,2718
65030,100780,9996,48530,6826,90784,5380,2662,2718
65035,100786,9996,48531,6826,90790,5382,2662,2720
65040,100797,9997,48535,6827,90800,5382,2662,2720
65045,100801,9997,48537,6827,90804,5382,2662,2720
65050,100811,9999,48542,6828,90812,5382,2662,2720
65055,100817,9999,48544,6828,90817,5383,2662,2721
65060,100828,10001,48547,6830,90827,5383,2662,2721
65065,100832,10001,48548,6830,90831,5383,2662,2721
65070,100842,10003,48552,6830,90839,5383,2662,2721
65075,100848,10003,48555,6830,90844,5384,2662,2722
65080,100859,10004,48559,6831,90855,5384,2662,2722
65085,100863,10004,48562,6831,90859,5384,2662,2722
65090,100873,10006,48566,6831,90867,5384,2662,2722
65095,100879,10006,48567,6831,90873,5385,2663,2722
65100,100890,10008,48571,6832,90882,5385,2663,2722
65105,100894,10009,48573,6833,90885,5385,2663,2722
65110,100904,10011,48575,6833,90893,5385,2663,2722
65115,100910,10011,48578,6833,90899,5386,2664,2722
65120,100921,10013,48586,6834,90908,5386,2664,2722
65125,100925,10015,48588,6836,90910,5386,2664,2722
65130,100935,10017,48593,6837,90918,5386,2664,2722
65135,100941,10017,48596,6837,90924,5387,2665,2722
65140,100952,10018,48603,6837,90934,5387,2665,2722
65145,100956,10019,48606,6838,90937,5387,2665,2722
65150,100966,10021,48610,6839,90945,5387,2665,2722
65155,100972,10021,48613,6839,90950,5389,2666,2723
65160,100983,10023,48617,6840,90959,5389,2666,2723
65165,100987,10024,48619,6841,90963,5389,2666,2723
65170,100997,10025,48624,6841,90972,5389,2666,2723
65175,101003,10025,48627,6841,90978,5390,2667,2723
65180,101014,10025,48633,6841,90989,5390,2667,2723
65185,101018,10025,48636,6841,90993,5390,2667,2723
65190,101028,10026,48640,6842,91002,5390,2667,2723
65195,101034,10026,48645,6842,91008,5391,2667,2724
65200,101045,10026,48649,6842,91019,5391,2667,2724
65205,101049,10026,48652,6842,91023,5391,2667,2724
65210,101059,10027,48656,6843,91032,5391,2667,2724
65215,101065,10027,48657,6843,91038,5392,2667,2725
65220,101076,10027,48665,6843,91049,5392,2667,2725
65225,101080,10027,48665,6843,91053,5392,2667,2725
65230,101090,10029,48670,6843,91061,5392,2667,2725
65235,101096,10029,48671,6843,91067,5393,2667,2726
65240,101107,10029,48675,6843,91078,5393,2667,2726
65245,101111,10029,48677,6843,91082,5393,2667,2726
65250,101121,10031,48682,6843,91090,5393,2667,2726
65255,101127,10031,48683,6843,91096,5394,2668,2726
65260,101138,10032,48687,6844,91106,5394,2668,2726
65265,101142,10032,48690,6844,91110,5394,2668,2726
65270,101152,10034,48694,6844,91118,5394,2668,2726
65275,101158,10034,48695,6844,91124,5396,2669,2727
65280,101169,10037,48699,6846,91132,5396,2669,2727
65285,101173,10037,48700,6846,91136,5396,2669,2727
65290,101183,10039,48704,6847,91144,5396,2669,2727
65295,101189,10039,48708,6847,91150,5398,2671,2727
65300,101200,10040,48714,6847,91160,5398,2671,2727
65305,101204,10040,48716,6847,91164,5398,2671,2727
65310,101214,10042,48722,6848,91172,5398,2671,2727
65315,101220,10042,48726,6848,91178,5400,2672,2728
65320,101231,10043,48733,6849,91188,5400,2672,2728
65325,101235,10043,48735,6849,91192,5400,2672,2728
65330,101245,10045,48742,6851,91200,5400,2672,2728
65335,101251,10045,48746,6851,91205,5402,2674,2728
65340,101262,10047,48750,6853,91214,5402,2674,2728
65345,101266,10049,48753,6855,91217,5402,2674,2728
65350,101276,10051,48756,6856,91225,5402,2674,2728
65355,101282,10051,48759,6856,91230,5403,2674,2729
65360,101293,10054,48764,6859,91239,5403,2674,2729
65365,101297,10055,48766,6860,91242,5403,2674,2729
65370,101307,10057,48773,6862,91250,5403,2674,2729
65375,101313,10057,48776,6862,91255,5404,2674,2730
65380,101324,10059,48782,6864,91265,5404,2674,2730
65385,101328,10060,48785,6865,91268,5404,2674,2730
65390,101338,10062,48789,6866,91276,5404,2674,2730
65395,101344,10062,48793,6866,91281,5405,2675,2730
65400,101355,10065,48797,6868,91290,5405,2675,2730
65405,101359,10066,48799,6869,91293,5405,2675,2730
65410,101369,10067,48805,6869,91302,5405,2675,2730
65415,101375,10067,48808,6869,91307,5406,2676,2730
65420,101386,10070,48810,6871,91316,5406,2676,2730
65425,101390,10070,48811,6871,91320,5406,2676,2730
65430,101400,10071,48817,6871,91329,5406,2676,2730
65435,101406,10071,48818,6871,91335,5407,2676,2731
65440,101417,10074,48825,6873,91343,5407,2676,2731
65445,101421,10075,48827,6874,91346,5407,2676,2731
65450,101431,10076,48831,6874,91355,5407,2676,2731
65455,101437,10076,48833,6874,91361,5409,2676,2733
65460,101448,10079,48840,6877,91368,5409,2676,2733
65465,101452,10080,48842,6878,91372,5409,2676,2733
65470,101462,10080,48846,6878,91382,5409,2676,2733
65475,101468,10080,48848,6878,91388,5410,2676,2734
65480,101479,10080,48853,6878,91399,5410,2676,2734
65485,101483,10080,48854,6878,91403,5410,2676,2734
65490,101493,10080,48860,6878,91413,5410,2676,2734
65495,101499,10080,48865,6878,91419,5411,2677,2734
65500,101510,10080,48870,6878,91430,5411,2677,2734
65505,101514,10080,48872,6878,91434,5411,2677,2734
65510,101524,10081,48876,6879,91443,5411,2677,2734
65515,101530,10081,48881,6879,91449,5412,2678,2734
65520,101541,10082,48888,6880,91459,5412,2678,2734
65525,101545,10082,48889,6880,91463,5412,2678,2734
65530,101555,10084,48893,6880,91471,5412,2678,2734
65535,101561,10084,48896,6880,91477,5413,2679,2734
65540,101572,10085,48906,6881,91487,5413,2679,2734
65545,101576,10085,48909,6881,91491,5413,2679,2734
65550,101586,10087,48914,6882,91499,5413,2679,2734
65555,101592,10087,48915,6882,91505,5414,2679,2735
65560,101603,10088,48919,6883,91515,5414,2679,2735
65565,101607,10088,48920,6883,91519,5414,2679,2735
65570,101617,10090,48922,6883,91527,5414,2679,2735
65575,101623,10090,48925,6883,91533,5415,2680,2735
65580,101634,10093,48931,6885,91541,5415,2680,2735
65585,101638,10093,48931,6885,91545,5415,2680,2735
65590,101648,10095,48935,6885,91553,5415,2680,2735
65595,101654,10095,48939,6885,91559,5416,2681,2735
65600,101665,10097,48946,6886,91568,5416,2681,2735
65605,101669,10097,48948,6886,91572,5416,2681,2735
65610,101679,10099,48952,6888,91580,5416,2681,2735
65615,101685,10099,48954,6888,91586,5417,2682,2735
65620,101696,10100,48958,6889,91596,5417,2682,2735
65625,101700,10101,48961,6890,91599,5417,2682,2735
65630,101710,10103,48965,6891,91607,5417,2682,2735
65635,101716,10103,48970,6891,91613,5419,2683,2736
65640,101727,10105,48976,6892,91622,5419,2683,2736
65645,101731,10105,48978,6892,91626,5419,2683,2736
65650,101741,10107,48984,6893,91634,5419,2683,2736
65655,101747,10107,48987,6893,91640,5421,2684,2737
65660,101758,10108,48994,6894,91650,5421,2684,2737
65665,101762,10108,48994,6894,91654,5421,2684,2737
65670,101772,10110,48996,6895,91662,5421,2684,2737
65675,101778,10110,49000,6895,91668,5423,2686,2737
65680,101789,10111,49007,6895,91678,5423,2686,2737
65685,101793,10112,49009,6896,91681,5423,2686,2737
65690,101803,10114,49016,6898,91689,5423,2686,2737
65695,101809,10114,49020,6898,91695,5424,2687,2737
65700,101820,10115,49026,6899,91705,5424,2687,2737
65705,101824,10115,49028,6899,91709,5424,2687,2737
65710,101834,10116,49033,6899,91718,5424,2687,2737
65715,101840,10116,49034,6899,91724,5425,2687,2738
65720,101851,10118,49040,6901,91733,5425,2687,2738
65725,101855,10118,49043,6901,91737,5425,2687,2738
65730,101865,10119,49051,6902,91746,5425,2687,2738
65735,101871,10119,49054,6902,91752,5426,2687,2739
65740,101882,10121,49061,6904,91761,5426,2687,2739
65745,101886,10121,49061,6904,91765,5426,2687,2739
65750,101896,10122,49066,6905,91774,5426,2687,2739
65755,101902,10122,49069,6905,91779,5427,2687,2740
65760,101913,10125,49074,6907,91788,5427,2687,2740
65765,101917,10125,49076,6907,91792,5427,2687,2740
65770,101927,10126,49082,6907,91801,5427,2687,2740
65775,101933,10126,49084,6907,91806,5428,2687,2741
65780,101944,10129,49091,6909,91815,5428,2687,2741
65785,101948,10129,49093,6909,91819,5428,2687,2741
65790,101958,10130,49096,6909,91828,5428,2687,2741
65795,101964,10130,49099,6909,91834,5430,2689,2741
65800,101975,10132,49105,6910,91843,5430,2689,2741
65805,101979,10132,49108,6910,91847,5430,2689,2741
65810,101989,10134,49114,6912,91855,5430,2689,2741
65815,101995,10134,49117,6912,91861,5432,2690,2742
65820,102006,10137,49126,6915,91868,5432,2690,2742
65825,102010,10138,49128,6916,91872,5432,2690,2742
65830,102020,10139,49136,6917,91881,5432,2690,2742
65835,102026,10139,49138,6917,91887,5434,2691,2743
65840,102037,10141,49145,6919,91896,5434,2691,2743
65845,102041,10141,49148,6919,91900,5434,2691,2743
65850,102051,10142,49149,6919,91909,5434,2691,2743
65855,102057,10142,49150,6919,91915,5436,2691,2745
65860,102068,10143,49153,6919,91925,5436,2691,2745
65865,102072,10143,49154,6919,91929,5436,2691,2745
65870,102082,10144,49161,6920,91938,5436,2691,2745
65875,102088,10144,49162,6920,91944,5438,2691,2747
65880,102099,10146,49165,6922,91953,5438,2691,2747
65885,102103,10146,49165,6922,91957,5438,2691,2747
65890,102113,10148,49167,6922,91965,5438,2691,2747
65895,102119,10148,49169,6922,91971,5440,2692,2748
65900,102130,10149,49173,6923,91981,5440,2692,2748
65905,102134,10149,49175,6923,91985,5440,2692,2748
65910,102144,10151,49183,6924,91993,5440,2692,2748
65915,102150,10151,49185,6924,91998,5442,2692,2750
65920,102161,10153,49189,6926,92008,5442,2692,2750
65925,102165,10153,49191,6926,92012,5442,2692,2750
65930,102175,10155,49195,6928,92020,5442,2692,2750
65935,102181,10155,49197,6928,92026,5444,2692,2752
65940,102192,10156,49203,6929,92036,5444,2692,2752
65945,102196,10156,49204,6929,92040,5444,2692,2752
65950,102206,10157,49212,6930,92049,5444,2692,2752
65955,102212,10157,49213,6930,92055,5445,2692,2753
65960,102223,10157,49219,6930,92066,5445,2692,2753
65965,102227,10157,49221,6930,92070,5445,2692,2753
65970,102237,10158,49224,6931,92079,5445,2692,2753
65975,102243,10158,49225,6931,92085,5446,2692,2754
65980,102254,10159,49231,6932,92095,5446,2692,2754
65985,102258,10159,49232,6932,92099,5446,2692,2754
65990,102268,10160,49236,6933,92108,5446,2692,2754
65995,102274,10160,49237,6933,92114,5447,2692,2755
66000,102285,10162,49239,6935,92123,5447,2692,2755
66005,102289,10162,49241,6935,92127,5447,2692,2755
66010,102299,10162,49245,6935,92137,5447,2692,2755
66015,102305,10162,49247,6935,92143,5448,2692,2756
66020,102316,10163,49251,6935,92153,5448,2692,2756
66025,102320,10163,49251,6935,92157,5448,2692,2756
66030,102330,10163,49258,6935,92167,5448,2692,2756
66035,102336,10163,49260,6935,92173,5449,2693,2756
66040,102347,10164,49267,6935,92183,5449,2693,2756
66045,102351,10164,49269,6935,92187,5449,2693,2756
66050,102361,10165,49274,6936,92196,5449,2693,2756
66055,102367,10165,49277,6936,92201,5451,2694,2757
66060,102378,10167,49282,6938,92210,5451,2694,2757
66065,102382,10168,49284,6939,92214,5451,2694,2757
66070,102392,10169,49288,6939,92223,5451,2694,2757
66075,102398,10169,49291,6939,92229,5453,2696,2757
66080,102409,10171,49294,6940,92238,5453,2696,2757
66085,102413,10171,49297,6940,92242,5453,2696,2757
66090,102423,10172,49304,6941,92251,5453,2696,2757
66095,102429,10172,49309,6941,92257,5455,2697,2758
66100,102440,10174,49314,6942,92266,5455,2697,2758
66105,102444,10174,49315,6942,92270,5455,2697,2758
66110,102454,10176,49322,6943,92278,5455,2697,2758
66115,102460,10176,49325,6943,92284,5457,2697,2760
66120,102471,10178,49331,6944,92293,5457,2697,2760
66125,102475,10178,49333,6944,92297,5457,2697,2760
66130,102485,10180,49336,6944,92305,5457,2697,2760
66135,102491,10180,49339,6944,92310,5459,2698,2761
66140,102502,10184,49347,6948,92318,5459,2698,2761
66145,102506,10184,49347,6948,92322,5459,2698,2761
66150,102516,10186,49350,6948,92330,5459,2698,2761
66155,102522,10186,49351,6948,92336,5460,2698,2762
66160,102533,10188,49359,6950,92345,5460,2698,2762
66165,102537,10188,49362,6950,92349,5460,2698,2762
66170,102547,10190,49368,6951,92357,5460,2698,2762
66175,102553,10190,49370,6951,92363,5461,2699,2762
66180,102564,10191,49374,6952,92373,5461,2699,2762
66185,102568,10191,49376,6952,92377,5461,2699,2762
66190,102578,10192,49383,6953,92386,5461,2699,2762
66195,102584,10192,49384,6953,92392,5462,2700,2762
66200,102595,10193,49390,6954,92402,5462,2700,2762
66205,102599,10193,49391,6954,92406,5462,2700,2762
66210,102609,10194,49398,6955,92415,5462,2700,2762
66215,102615,10194,49400,6955,92421,5463,2700,2763
66220,102626,10195,49402,6955,92431,5463,2700,2763
66225,102630,10195,49402,6955,92435,5463,2700,2763
66230,102640,10196,49408,6955,92444,5463,2700,2763
66235,102646,10196,49410,6955,92450,5464,2701,2763
66240,102657,10198,49417,6957,92459,5464,2701,2763
66245,102661,10198,49420,6957,92463,5464,2701,2763
66250,102671,10200,49423,6958,92471,5464,2701,2763
66255,102677,10200,49429,6958,92476,5466,2703,2763
66260,102688,10203,49436,6961,92485,5466,2703,2763
66265,102692,10203,49438,6961,92489,5466,2703,2763
66270,102702,10205,49442,6962,92497,5466,2703,2763
66275,102708,10205,49444,6962,92503,5468,2704,2764
66280,102719,10207,49448,6963,92512,5468,2704,2764
66285,102723,10207,49450,6963,92516,5468,2704,2764
66290,102733,10209,49456,6965,92524,5468,2704,2764
66295,102739,10209,49457,6965,92530,5470,2705,2765
66300,102750,10212,49463,6968,92538,5470,2705,2765
66305,102754,10212,49465,6968,92542,5470,2705,2765
66310,102764,10214,49470,6969,92550,5470,2705,2765
66315,102770,10214,49473,6969,92556,5472,2706,2766
66320,102781,10215,49481,6970,92566,5472,2706,2766
66325,102785,10215,49484,6970,92570,5472,2706,2766
66330,102795,10217,49491,6972,92578,5472,2706,2766
66335,102801,10217,49492,6972,92584,5474,2707,2767
66340,102812,10219,49498,6974,92593,5474,2707,2767
66345,102816,10219,49499,6974,92597,5474,2707,2767
66350,102826,10221,49507,6976,92605,5474,2707,2767
66355,102832,10221,49508,6976,92611,5476,2707,2769
66360,102843,10223,49514,6978,92619,5476,2707,2769
66365,102847,10224,49517,6979,92623,5476,2707,2769
66370,102857,10225,49522,6979,92632,5476,2707,2769
66375,102863,10225,49528,6979,92638,5478,2709,2769
66380,102874,10226,49535,6980,92648,5478,2709,2769
66385,102878,10226,49538,6980,92652,5478,2709,2769
66390,102888,10227,49543,6980,92661,5478,2709,2769
66395,102894,10227,49546,6980,92667,5480,2710,2770
66400,102905,10228,49550,6980,92677,5480,2710,2770
66405,102909,10228,49551,6980,92681,5480,2710,2770
66410,102919,10229,49557,6980,92690,5480,2710,2770
66415,102925,10229,49560,6980,92696,5482,2711,2771
66420,102936,10230,49565,6981,92706,5482,2711,2771
66425,102940,10230,49567,6981,92710,5482,2711,2771
66430,102950,10231,49573,6982,92719,5482,2711,2771
66435,102956,10231,49574,6982,92725,5483,2711,2772
66440,102967,10232,49580,6982,92735,5483,2711,2772
66445,102971,10232,49583,6982,92739,5483,2711,2772
66450,102981,10233,49585,6982,92748,5483,2711,2772
66455,102987,10233,49589,6982,92754,5484,2712,2772
66460,102998,10234,49593,6982,92764,5484,2712,2772
66465,103002,10234,49593,6982,92768,5484,2712,2772
66470,103012,10236,49596,6983,92776,5484,2712,2772
66475,103018,10236,49600,6983,92781,5485,2712,2773
66480,103029,10239,49604,6985,92790,5485,2712,2773
66485,103033,10239,49604,6985,92794,5485,2712,2773
66490,103043,10240,49608,6986,92803,5485,2712,2773
66495,103049,10240,49614,6986,92808,5486,2713,2773
66500,103060,10241,49619,6987,92819,5486,2713,2773
66505,103064,10241,49622,6987,92823,5486,2713,2773
66510,103074,10242,49626,6987,92832,5486,2713,2773
66515,103080,10242,49630,6987,92837,5487,2713,2774
66520,103091,10244,49635,6989,92847,5487,2713,2774
66525,103095,10244,49637,6989,92851,5487,2713,2774
66530,103105,10245,49641,6990,92860,5487,2713,2774
66535,103111,10245,49645,6990,92865,5489,2714,2775
66540,103122,10247,49649,6992,92875,5489,2714,2775
66545,103126,10247,49650,6992,92879,5489,2714,2775
66550,103136,10247,49656,6992,92889,5489,2714,2775
66555,103142,10247,49659,6992,92895,5491,2715,2776
66560,103153,10247,49665,6992,92906,5491,2715,2776
66565,103157,10247,49667,6992,92910,5491,2715,2776
66570,103167,10247,49670,6992,92920,5491,2715,2776
66575,103173,10247,49674,6992,92926,5492,2716,2776
66580,103184,10247,49680,6992,92937,5492,2716,2776
66585,103188,10247,49681,6992,92941,5492,2716,2776
66590,103198,10248,49686,6993,92950,5492,2716,2776
66595,103204,10248,49689,6993,92956,5493,2716,2777
66600,103215,10250,49693,6995,92965,5493,2716,2777
66605,103219,10250,49694,6995,92969,5493,2716,2777
66610,103229,10251,49697,6996,92978,5493,2716,2777
66615,103235,10251,49702,6996,92983,5495,2717,2778
66620,103246,10253,49708,6998,92992,5495,2717,2778
66625,103250,10254,49711,6999,92996,5495,2717,2778
66630,103260,10255,49716,7000,93005,5495,2717,2778
66635,103266,10255,49720,7000,93010,5496,2718,2778
66640,103277,10257,49725,7002,93019,5496,2718,2778
66645,103281,10258,49727,7003,93023,5496,2718,2778
66650,103291,10260,49731,7004,93031,5496,2718,2778
66655,103297,10260,49734,7004,93037,5497,2719,2778
66660,103308,10262,49742,7005,93045,5497,2719,2778
66665,103312,10263,49744,7006,93049,5497,2719,2778
66670,103322,10265,49749,7007,93057,5497,2719,2778
66675,103328,10265,49753,7007,93063,5497,2719,2778
66680,103339,10266,49757,7007,93073,5497,2719,2778
66685,103343,10266,49759,7007,93077,5497,2719,2778
66690,103353,10268,49765,7009,93085,5497,2719,2778
66695,103359,10268,49767,7009,93091,5497,2719,2778
66700,103370,10270,49775,7010,93100,5497,2719,2778
66705,103374,10270,49777,7010,93104,5497,2719,2778
66710,103384,10272,49783,7011,93112,5497,2719,2778
66715,103390,10272,49785,7011,93118,5497,2719,2778
66720,103401,10275,49790,7013,93126,5497,2719,2778
66725,103405,10275,49791,7013,93130,5497,2719,2778
66730,103415,10277,49794,7014,93138,5497,2719,2778
66735,103421,10277,49797,7014,93144,5498,2719,2779
66740,103432,10280,49803,7017,93152,5498,2719,2779
66745,103436,10280,49805,7017,93156,5498,2719,2779
66750,103446,10282,49806,7017,93164,5498,2719,2779
66755,103452,10282,49809,7017,93170,5499,2719,2780
66760,103463,10284,49818,7019,93179,5499,2719,2780
66765,103467,10285,49821,7020,93182,5499,2719,2780
66770,103477,10287,49825,7020,93190,5499,2719,2780
66775,103483,10287,49828,7020,93196,5500,2720,2780
66780,103494,10289,49831,7021,93205,5500,2720,2780
66785,103498,10289,49834,7021,93209,5500,2720,2780
66790,103508,10290,49839,7021,93218,5500,2720,2780
66795,103514,10290,49841,7021,93224,5501,2721,2780
66800,103525,10292,49847,7023,93233,5501,2721,2780
66805,103529,10292,49850,7023,93237,5501,2721,2780
66810,103539,10293,49854,7024,93246,5501,2721,2780
66815,103545,10293,49855,7024,93252,5502,2721,2781
66820,103556,10295,49861,7025,93261,5502,2721,2781
66825,103560,10295,49862,7025,93265,5502,2721,2781
66830,103570,10296,49868,7025,93274,5502,2721,2781
66835,103576,10296,49871,7025,93280,5503,2721,2782
66840,103587,10299,49876,7028,93288,5503,2721,2782
66845,103591,10299,49879,7028,93292,5503,2721,2782
66850,103601,10300,49886,7029,93301,5503,2721,2782
66855,103607,10300,49889,7029,93306,5503,2721,2782
66860,103618,10301,49894,7030,93317,5503,2721,2782
66865,103622,10301,49896,7030,93321,5503,2721,2782
66870,103632,10302,49900,7030,93330,5503,2721,2782
66875,103638,10302,49903,7030,93336,5503,2721,2782
66880,103649,10303,49906,7031,93346,5503,2721,2782
66885,103653,10303,49908,7031,93350,5503,2721,2782
66890,103663,10305,49916,7033,93358,5503,2721,2782
66895,103669,10305,49917,7033,93364,5503,2721,2782
66900,103680,10307,49922,7035,93373,5503,2721,2782
66905,103684,10307,49923,7035,93377,5503,2721,2782
66910,103694,10309,49927,7036,93385,5503,2721,2782
66915,103700,10309,49929,7036,93391,5503,2721,2782
66920,103711,10310,49934,7037,93401,5503,2721,2782
66925,103715,10310,49936,7037,93405,5503,2721,2782
66930,103725,10312,49939,7037,93413,5503,2721,2782
66935,103731,10312,49943,7037,93419,5503,2721,2782
66940,103742,10314,49948,7039,93428,5503,2721,2782
66945,103746,10314,49950,7039,93432,5503,2721,2782
66950,103756,10316,49955,7039,93440,5503,2721,2782
66955,103762,10316,49957,7039,93446,5504,2722,2782
66960,103773,10318,49964,7041,93455,5504,2722,2782
66965,103777,10318,49966,7041,93459,5504,2722,2782
66970,103787,10320,49969,7041,93467,5504,2722,2782
66975,103793,10320,49974,7041,93473,5505,2722,2783
66980,103804,10321,49978,7042,93483,5505,2722,2783
66985,103808,10322,49980,7043,93486,5505,2722,2783
66990,103818,10324,49983,7045,93494,5505,2722,2783
66995,103824,10324,49986,7045,93500,5505,2722,2783
67000,103835,10326,49993,7047,93509,5505,2722,2783
67005,103839,10326,49995,7047,93513,5505,2722,2783
67010,103849,10328,50000,7048,93521,5505,2722,2783
67015,103855,10328,50004,7048,93526,5505,2722,2783
67020,103866,10330,50009,7050,93535,5505,2722,2783
67025,103870,10331,50009,7051,93539,5505,2722,2783
67030,103880,10332,50015,7052,93548,5505,2722,2783
67035,103886,10332,50018,7052,93554,5505,2722,2783
67040,103897,10333,50022,7052,93564,5505,2722,2783
67045,103901,10333,50024,7052,93568,5505,2722,2783
67050,103911,10334,50026,7052,93577,5505,2722,2783
67055,103917,10334,50028,7052,93583,5505,2722,2783
67060,103928,10335,50031,7053,93593,5505,2722,2783
67065,103932,10335,50033,7053,93597,5505,2722,2783
67070,103942,10336,50038,7054,93606,5505,2722,2783
67075,103948,10336,50044,7054,93612,5505,2722,2783
67080,103959,10338,50053,7056,93621,5505,2722,2783
67085,103963,10338,50055,7056,93625,5505,2722,2783
67090,103973,10339,50060,7057,93634,5505,2722,2783
67095,103979,10339,50060,7057,93640,5505,2722,2783
67100,103990,10341,50066,7058,93649,5505,2722,2783
67105,103994,10341,50067,7058,93653,5505,2722,2783
67110,104004,10342,50074,7058,93662,5505,2722,2783
67115,104010,10342,50077,7058,93668,5505,2722,2783
67120,104021,10343,50085,7059,93678,5505,2722,2783
67125,104025,10343,50087,7059,93682,5505,2722,2783
67130,104035,10344,50093,7059,93691,5505,2722,2783
67135,104041,10344,50096,7059,93697,5505,2722,2783
67140,104052,10346,50102,7060,93706,5505,2722,2783
67145,104056,10346,50103,7060,93710,5505,2722,2783
67150,104066,10347,50106,7060,93719,5505,2722,2783
67155,104072,10347,50108,7060,93725,5505,2722,2783
67160,104083,10350,50114,7062,93733,5505,2722,2783
67165,104087,10350,50116,7062,93737,5505,2722,2783
67170,104097,10351,50120,7063,93746,5505,2722,2783
67175,104103,10351,50124,7063,93752,5505,2722,2783
67180,104114,10353,50129,7065,93761,5505,2722,2783
67185,104118,10353,50131,7065,93765,5505,2722,2783
67190,104128,10355,50136,7066,93773,5505,2722,2783
67195,104134,10355,50137,7066,93779,5505,2722,2783
67200,104145,10357,50140,7067,93788,5505,2722,2783
67205,104149,10357,50142,7067,93792,5505,2722,2783
67210,104159,10359,50147,7068,93800,5505,2722,2783
67215,104165,10359,50151,7068,93805,5505,2722,2783
67220,104176,10361,50158,7070,93815,5505,2722,2783
67225,104180,10362,50161,7071,93818,5505,2722,2783
67230,104190,10364,50166,7072,93826,5505,2722,2783
67235,104196,10364,50167,7072,93832,5505,2722,2783
67240,104207,10365,50173,7073,93841,5505,2722,2783
67245,104211,10366,50174,7074,93845,5505,2722,2783
67250,104221,10368,50178,7075,93853,5505,2722,2783
67255,104227,10368,50180,7075,93859,5505,2722,2783
67260,104238,10370,50183,7077,93868,5505,2722,2783
67265,104242,10370,50185,7077,93872,5505,2722,2783
67270,104252,10371,50188,7077,93881,5505,2722,2783
67275,104258,10371,50191,7077,93887,5505,2722,2783
67280,104269,10371,50194,7077,93898,5505,2722,2783
67285,104273,10371,50196,7077,93902,5505,2722,2783
67290,104283,10372,50200,7077,93911,5505,2722,2783
67295,104289,10372,50204,7077,93916,5505,2722,2783
67300,104300,10373,50210,7078,93927,5505,2722,2783
67305,104304,10373,50211,7078,93931,5505,2722,2783
67310,104314,10374,50217,7078,93940,5505,2722,2783
67315,104320,10374,50218,7078,93946,5505,2722,2783
67320,104331,10374,50224,7078,93957,5505,2722,2783
67325,104335,10374,50227,7078,93961,5505,2722,2783
67330,104345,10375,50232,7078,93970,5505,2722,2783
67335,104351,10375,50234,7078,93975,5505,2722,2783
67340,104362,10376,50240,7079,93986,5505,2722,2783
67345,104366,10376,50242,7079,93990,5505,2722,2783
67350,104376,10377,50248,7080,93999,5505,2722,2783
67355,104382,10377,50251,7080,94004,5505,2722,2783
67360,104393,10378,50256,7081,94015,5505,2722,2783
67365,104397,10378,50258,7081,94019,5505,2722,2783
67370,104407,10380,50263,7083,94027,5505,2722,2783
67375,104413,10380,50266,7083,94033,5505,2722,2783
67380,104424,10380,50268,7083,94044,5505,2722,2783
67385,104428,10380,50270,7083,94048,5505,2722,2783
67390,104438,10382,50272,7083,94056,5505,2722,2783
67395,104444,10382,50274,7083,94061,5505,2722,2783
67400,104455,10384,50277,7085,94071,5505,2722,2783
67405,104459,10384,50279,7085,94075,5505,2722,2783
67410,104469,10386,50281,7085,94083,5505,2722,2783
67415,104475,10386,50283,7085,94089,5505,2722,2783
67420,104486,10387,50291,7086,94098,5505,2722,2783
67425,104490,10388,50292,7087,94102,5505,2722,2783
67430,104500,10390,50297,7089,94110,5505,2722,2783
67435,104506,10390,50301,7089,94115,5505,2722,2783
67440,104517,10392,50305,7091,94125,5505,2722,2783
67445,104521,10392,50308,7091,94129,5505,2722,2783
67450,104531,10394,50315,7093,94137,5505,2722,2783
67455,104537,10394,50318,7093,94143,5505,2722,2783
67460,104548,10395,50325,7094,94153,5505,2722,2783
67465,104552,10395,50326,7094,94157,5505,2722,2783
67470,104562,10397,50332,7095,94165,5505,2722,2783
67475,104568,10397,50336,7095,94171,5505,2722,2783
67480,104579,10397,50338,7095,94182,5505,2722,2783
67485,104583,10398,50341,7096,94185,5505,2722,2783
67490,104593,10400,50346,7097,94193,5505,2722,2783
67495,104599,10400,50347,7097,94199,5505,2722,2783
67500,104610,10401,50352,7098,94209,5505,2722,2783
67505,104614,10401,50353,7098,94213,5505,2722,2783
67510,104624,10403,50357,7098,94221,5505,2722,2783
67515,104630,10403,50359,7098,94227,5505,2722,2783
67520,104641,10404,50362,7099,94237,5505,2722,2783
67525,104645,10405,50365,7100,94240,5505,2722,2783
67530,104655,10407,50370,7101,94248,5505,2722,2783
67535,104661,10407,50374,7101,94254,5505,2722,2783
67540,104672,10408,50379,7102,94264,5505,2722,2783
67545,104676,10409,50382,7103,94267,5505,2722,2783
67550,104686,10410,50386,7104,94276,5505,2722,2783
67555,104692,10410,50390,7104,94282,5505,2722,2783
67560,104703,10411,50395,7105,94292,5505,2722,2783
67565,104707,10411,50398,7105,94296,5505,2722,2783
67570,104717,10412,50404,7105,94305,5505,2722,2783
67575,104723,10412,50406,7105,94311,5505,2722,2783
67580,104734,10412,50412,7105,94321,5505,2722,2783
67585,104738,10413,50415,7106,94325,5505,2722,2783
67590,104748,10414,50420,7107,94334,5505,2722,2783
67595,104754,10414,50424,7107,94339,5505,2722,2783
67600,104765,10415,50426,7108,94350,5505,2722,2783
67605,104769,10415,50428,7108,94354,5505,2722,2783
67610,104779,10416,50434,7109,94363,5505,2722,2783
67615,104785,10416,50437,7109,94369,5505,2722,2783
67620,104796,10417,50444,7110,94378,5505,2722,2783
67625,104800,10418,50446,7111,94382,5505,2722,2783
67630,104810,10418,50449,7111,94392,5505,2722,2783
67635,104816,10418,50451,7111,94398,5505,2722,2783
67640,104827,10418,50454,7111,94409,5505,2722,2783
67645,104831,10418,50456,7111,94413,5505,2722,2783
67650,104841,10418,50463,7111,94423,5505,2722,2783
67655,104847,10418,50467,7111,94429,5505,2722,2783
67660,104858,10418,50471,7111,94440,5505,2722,2783
67665,104862,10418,50473,7111,94444,5505,2722,2783
67670,104872,10418,50477,7111,94454,5505,2722,2783
67675,104878,10418,50480,7111,94460,5505,2722,2783
67680,104889,10418,50485,7111,94471,5505,2722,2783
67685,104893,10418,50486,7111,94475,5505,2722,2783
67690,104903,10419,50491,7111,94484,5505,2722,2783
67695,104909,10419,50493,7111,94490,5505,2722,2783
67700,104920,10419,50497,7111,94501,5505,2722,2783
67705,104924,10420,50498,7112,94504,5505,2722,2783
67710,104934,10421,50500,7113,94513,5505,2722,2783
67715,104940,10421,50502,7113,94518,5505,2722,2783
67720,104951,10422,50506,7114,94529,5505,2722,2783
67725,104955,10422,50508,7114,94533,5505,2722,2783
67730,104965,10423,50511,7114,94542,5505,2722,2783
67735,104971,10423,50514,7114,94547,5505,2722,2783
67740,104982,10424,50517,7115,94557,5505,2722,2783
67745,104986,10425,50520,7116,94561,5505,2722,2783
67750,104996,10425,50525,7116,94571,5505,2722,2783
67755,105002,10425,50528,7116,94577,5505,2722,2783
67760,105013,10425,50534,7116,94588,5505,2722,2783
67765,105017,10425,50536,7116,94592,5505,2722,2783
67770,105027,10425,50541,7116,94602,5505,2722,2783
67775,105033,10425,50542,7116,94608,5505,2722,2783
67780,105044,10425,50547,7116,94619,5505,2722,2783
67785,105048,10425,50549,7116,94623,5505,2722,2783
67790,105058,10425,50554,7116,94633,5505,2722,2783
67795,105064,10425,50556,7116,94639,5505,2722,2783
67800,105075,10425,50558,7116,94650,5505,2722,2783
67805,105079,10425,50562,7116,94654,5505,2722,2783
67810,105089,10426,50566,7117,94663,5505,2722,2783
67815,105095,10426,50570,7117,94669,5505,2722,2783
67820,105106,10426,50574,7117,94680,5505,2722,2783
67825,105110,10426,50578,7117,94684,5505,2722,2783
67830,105120,10427,50582,7117,94693,5505,2722,2783
67835,105126,10427,50584,7117,94699,5505,2722,2783
67840,105137,10427,50588,7117,94709,5505,2722,2783
67845,105141,10428,50591,7118,94713,5505,2722,2783
67850,105151,10429,50598,7118,94722,5505,2722,2783
67855,105157,10429,50600,7118,94727,5505,2722,2783
67860,105168,10430,50602,7119,94737,5505,2722,2783
67865,105172,10431,50602,7120,94741,5505,2722,2783
67870,105182,10432,50607,7121,94750,5505,2722,2783
67875,105188,10432,50610,7121,94756,5505,2722,2783
67880,105199,10432,50613,7121,94766,5505,2722,2783
67885,105203,10433,50614,7122,94770,5505,2722,2783
67890,105213,10434,50620,7123,94779,5505,2722,2783
67895,105219,10434,50621,7123,94785,5505,2722,2783
67900,105230,10434,50625,7123,94795,5505,2722,2783
67905,105234,10435,50627,7124,94799,5505,2722,2783
67910,105244,10436,50632,7125,94808,5505,2722,2783
67915,105250,10436,50637,7125,94814,5505,2722,2783
67920,105261,10437,50644,7126,94824,5505,2722,2783
67925,105265,10437,50645,7126,94828,5505,2722,2783
67930,105275,10437,50652,7126,94838,5505,2722,2783
67935,105281,10437,50654,7126,94844,5505,2722,2783
67940,105292,10437,50658,7126,94855,5505,2722,2783
67945,105296,10437,50659,7126,94859,5505,2722,2783
67950,105306,10437,50662,7126,94869,5505,2722,2783
67955,105312,10437,50663,7126,94875,5505,2722,2783
67960,105323,10437,50668,7126,94886,5505,2722,2783
67965,105327,10437,50670,7126,94890,5505,2722,2783
67970,105337,10437,50673,7126,94900,5505,2722,2783
67975,105343,10437,50677,7126,94906,5505,2722,2783
67980,105354,10437,50681,7126,94917,5505,2722,2783
67985,105358,10437,50683,7126,94921,5505,2722,2783
67990,105368,10437,50690,7126,94931,5505,2722,2783
67995,105374,10437,50694,7126,94937,5505,2722,2783
68000,105385,10437,50699,7126,94948,5505,2722,2783
68005,105389,10437,50700,7126,94952,5505,2722,2783
68010,105399,10437,50709,7126,94962,5505,2722,2783
68015,105405,10437,50713,7126,94968,5505,2722,2783
68020,105416,10437,50718,7126,94979,5505,2722,2783
68025,105420,10437,50721,7126,94983,5505,2722,2783
68030,105430,10438,50726,7126,94992,5505,2722,2783
68035,105436,10438,50730,7126,94998,5505,2722,2783
68040,105447,10438,50737,7126,95009,5505,2722,2783
68045,105451,10438,50740,7126,95013,5505,2722,2783
68050,105461,10439,50746,7126,95022,5505,2722,2783
68055,105467,10439,50749,7126,95028,5505,2722,2783
68060,105478,10439,50755,7126,95039,5505,2722,2783
68065,105482,10439,50759,7126,95043,5505,2722,2783
68070,105492,10440,50763,7127,95052,5505,2722,2783
68075,105498,10440,50765,7127,95057,5505,2722,2783
68080,105509,10442,50772,7129,95066,5505,2722,2783
68085,105513,10443,50773,7130,95070,5505,2722,2783
68090,105523,10444,50779,7130,95079,5505,2722,2783
68095,105529,10444,50782,7130,95084,5505,2722,2783
68100,105540,10446,50790,7132,95093,5505,2722,2783
68105,105544,10447,50790,7133,95097,5505,2722,2783
68110,105554,10448,50792,7133,95106,5505,2722,2783
68115,105560,10448,50794,7133,95112,5505,2722,2783
68120,105571,10449,50800,7134,95122,5505,2722,2783
68125,105575,10450,50802,7135,95125,5505,2722,2783
68130,105585,10451,50805,7135,95134,5505,2722,2783
68135,105591,10451,50807,7135,95140,5505,2722,2783
68140,105602,10452,50813,7136,95149,5505,2722,2783
68145,105606,10454,50814,7138,95152,5505,2722,2783
68150,105616,10455,50819,7138,95161,5505,2722,2783
68155,105622,10455,50823,7138,95167,5505,2722,2783
68160,105633,10455,50826,7138,95177,5505,2722,2783
68165,105637,10456,50828,7139,95181,5505,2722,2783
68170,105647,10456,50832,7139,95191,5505,2722,2783
68175,105653,10456,50837,7139,95197,5505,2722,2783
68180,105664,10456,50844,7139,95208,5505,2722,2783
68185,105668,10456,50848,7139,95212,5505,2722,2783
68190,105678,10456,50855,7139,95222,5505,2722,2783
68195,105684,10456,50857,7139,95228,5505,2722,2783
68200,105695,10456,50862,7139,95239,5505,2722,2783
68205,105699,10456,50863,7139,95243,5505,2722,2783
68210,105709,10456,50866,7139,95253,5505,2722,2783
68215,105715,10456,50870,7139,95259,5505,2722,2783
68220,105726,10456,50878,7139,95270,5505,2722,2783
68225,105730,10456,50880,7139,95274,5505,2722,2783
68230,105740,10457,50884,7139,95283,5505,2722,2783
68235,105746,10457,50887,7139,95288,5505,2722,2783
68240,105757,10458,50891,7140,95299,5505,2722,2783
68245,105761,10458,50893,7140,95303,5505,2722,2783
68250,105771,10459,50897,7141,95312,5505,2722,2783
68255,105777,10459,50899,7141,95317,5505,2722,2783
68260,105788,10460,50904,7142,95328,5505,2722,2783
68265,105792,10460,50906,7142,95332,5505,2722,2783
68270,105802,10461,50912,7143,95341,5505,2722,2783
68275,105808,10461,50915,7143,95346,5505,2722,2783
68280,105819,10462,50923,7144,95356,5505,2722,2783
68285,105823,10464,50926,7146,95359,5505,2722,2783
68290,105833,10465,50930,7147,95368,5505,2722,2783
68295,105839,10465,50933,7147,95374,5505,2722,2783
68300,105850,10465,50938,7147,95384,5505,2722,2783
68305,105854,10466,50939,7148,95388,5505,2722,2783
68310,105864,10467,50944,7148,95397,5505,2722,2783
68315,105870,10467,50945,7148,95403,5505,2722,2783
68320,105881,10467,50950,7148,95414,5505,2722,2783
68325,105885,10468,50954,7149,95417,5505,2722,2783
68330,105895,10469,50957,7150,95426,5505,2722,2783
68335,105901,10469,50960,7150,95432,5505,2722,2783
68340,105912,10470,50966,7151,95442,5505,2722,2783
68345,105916,10470,50969,7151,95446,5505,2722,2783
68350,105926,10470,50972,7151,95456,5505,2722,2783
68355,105932,10470,50977,7151,95462,5505,2722,2783
68360,105943,10470,50983,7151,95473,5505,2722,2783
68365,105947,10470,50986,7151,95477,5505,2722,2783
68370,105957,10470,50991,7151,95487,5505,2722,2783
68375,105963,10470,50995,7151,95493,5505,2722,2783
68380,105974,10470,51001,7151,95504,5505,2722,2783
68385,105978,10470,51002,7151,95508,5505,2722,2783
68390,105988,10470,51006,7151,95518,5505,2722,2783
68395,105994,10470,51010,7151,95524,5505,2722,2783
68400,106005,10470,51015,7151,95535,5505,2722,2783
68405,106009,10470,51016,7151,95539,5505,2722,2783
68410,106019,10470,51020,7151,95549,5505,2722,2783
68415,106025,10470,51023,7151,95555,5505,2722,2783
68420,106036,10470,51026,7151,95566,5505,2722,2783
68425,106040,10470,51028,7151,95570,5505,2722,2783
68430,106050,10470,51035,7151,95580,5505,2722,2783
68435,106056,10470,51037,7151,95586,5505,2722,2783
68440,106067,10470,51042,7151,95597,5505,2722,2783
68445,106071,10470,51044,7151,95601,5505,2722,2783
68450,106081,10471,51047,7151,95610,5505,2722,2783
68455,106087,10471,51049,7151,95615,5505,2722,2783
68460,106098,10472,51057,7152,95626,5505,2722,2783
68465,106102,10473,51059,7153,95629,5505,2722,2783
68470,106112,10474,51068,7154,95638,5505,2722,2783
68475,106118,10474,51071,7154,95644,5505,2722,2783
68480,106129,10474,51076,7154,95654,5505,2722,2783
68485,106133,10476,51077,7156,95657,5505,2722,2783
68490,106143,10477,51082,7157,95666,5505,2722,2783
68495,106149,10477,51086,7157,95672,5505,2722,2783
68500,106160,10477,51090,7157,95683,5505,2722,2783
68505,106164,10477,51090,7157,95687,5505,2722,2783
68510,106174,10478,51095,7157,95696,5505,2722,2783
68515,106180,10478,51097,7157,95702,5505,2722,2783
68520,106191,10478,51104,7157,95713,5505,2722,2783
68525,106195,10478,51105,7157,95717,5505,2722,2783
68530,106205,10479,51110,7158,95726,5505,2722,2783
68535,106211,10479,51113,7158,95731,5505,2722,2783
68540,106222,10480,51116,7159,95742,5505,2722,2783
68545,106226,10480,51120,7159,95746,5505,2722,2783
68550,106236,10481,51125,7160,95755,5505,2722,2783
68555,106242,10481,51128,7160,95760,5505,2722,2783
68560,106253,10483,51134,7162,95770,5505,2722,2783
68565,106257,10483,51136,7162,95774,5505,2722,2783
68570,106267,10484,51141,7163,95783,5505,2722,2783
68575,106273,10484,51147,7163,95788,5505,2722,2783
68580,106284,10486,51152,7165,95797,5505,2722,2783
68585,106288,10487,51154,7166,95801,5505,2722,2783
68590,106298,10487,51159,7166,95811,5505,2722,2783
68595,106304,10487,51164,7166,95817,5505,2722,2783
68600,106315,10487,51169,7166,95828,5505,2722,2783
68605,106319,10487,51170,7166,95832,5505,2722,2783
68610,106329,10487,51175,7166,95842,5505,2722,2783
68615,106335,10487,51177,7166,95848,5505,2722,2783
68620,106346,10487,51178,7166,95859,5505,2722,2783
68625,106350,10487,51181,7166,95863,5505,2722,2783
68630,106360,10487,51186,7166,95873,5505,2722,2783
68635,106366,10487,51188,7166,95879,5505,2722,2783
68640,106377,10487,51193,7166,95890,5505,2722,2783
68645,106381,10487,51193,7166,95894,5505,2722,2783
68650,106391,10487,51198,7166,95904,5505,2722,2783
68655,106397,10487,51201,7166,95910,5505,2722,2783
68660,106408,10487,51207,7166,95921,5505,2722,2783
68665,106412,10487,51208,7166,95925,5505,2722,2783
68670,106422,10487,51211,7166,95935,5505,2722,2783
68675,106428,10487,51215,7166,95941,5505,2722,2783
68680,106439,10487,51220,7166,95952,5505,2722,2783
68685,106443,10487,51220,7166,95956,5505,2722,2783
68690,106453,10487,51223,7166,95966,5505,2722,2783
68695,106459,10487,51225,7166,95972,5505,2722,2783
68700,106470,10487,51229,7166,95983,5505,2722,2783
68705,106474,10487,51229,7166,95987,5505,2722,2783
68710,106484,10487,51236,7166,95997,5505,2722,2783
68715,106490,10487,51238,7166,96003,5505,2722,2783
68720,106501,10487,51240,7166,96014,5505,2722,2783
68725,106505,10487,51242,7166,96018,5505,2722,2783
68730,106515,10487,51245,7166,96028,5505,2722,2783
68735,106521,10487,51249,7166,96034,5505,2722,2783
68740,106532,10487,51256,7166,96045,5505,2722,2783
68745,106536,10487,51258,7166,96049,5505,2722,2783
68750,106546,10488,51263,7166,96058,5505,2722,2783
68755,106552,10488,51264,7166,96064,5505,2722,2783
68760,106563,10489,51269,7167,96073,5505,2722,2783
68765,106567,10490,51270,7168,96077,5505,2722,2783
68770,106577,10491,51274,7169,96086,5505,2722,2783
68775,106583,10491,51279,7169,96091,5505,2722,2783
68780,106594,10493,51284,7171,96101,5505,2722,2783
68785,106598,10493,51287,7171,96105,5505,2722,2783
68790,106608,10494,51292,7171,96114,5505,2722,2783
68795,106614,10494,51293,7171,96120,5505,2722,2783
68800,106625,10494,51297,7171,96130,5505,2722,2783
68805,106629,10495,51299,7172,96134,5505,2722,2783
68810,106639,10496,51305,7173,96143,5505,2722,2783
68815,106645,10496,51309,7173,96148,5505,2722,2783
68820,106656,10498,51314,7175,96157,5505,2722,2783
68825,106660,10499,51316,7176,96161,5505,2722,2783
68830,106670,10499,51318,7176,96171,5505,2722,2783
68835,106676,10499,51321,7176,96177,5505,2722,2783
68840,106687,10499,51328,7176,96188,5505,2722,2783
68845,106691,10499,51330,7176,96192,5505,2722,2783
68850,106701,10499,51335,7176,96202,5505,2722,2783
68855,106707,10499,51338,7176,96208,5505,2722,2783
68860,106718,10499,51342,7176,96219,5505,2722,2783
68865,106722,10499,51345,7176,96223,5505,2722,2783
68870,106732,10499,51350,7176,96233,5505,2722,2783
68875,106738,10499,51353,7176,96239,5505,2722,2783
68880,106749,10499,51356,7176,96250,5505,2722,2783
68885,106753,10499,51357,7176,96254,5505,2722,2783
68890,106763,10500,51360,7176,96263,5505,2722,2783
68895,106769,10500,51362,7176,96269,5505,2722,2783
68900,106780,10500,51364,7176,96280,5505,2722,2783
68905,106784,10500,51366,7176,96284,5505,2722,2783
68910,106794,10501,51372,7176,96293,5505,2722,2783
68915,106800,10501,51375,7176,96299,5505,2722,2783
68920,106811,10501,51381,7176,96309,5505,2722,2783
68925,106815,10502,51382,7177,96313,5505,2722,2783
68930,106825,10503,51386,7177,96322,5505,2722,2783
68935,106831,10503,51388,7177,96327,5505,2722,2783
68940,106842,10504,51396,7178,96337,5505,2722,2783
68945,106846,10505,51398,7179,96341,5505,2722,2783
68950,106856,10506,51402,7180,96350,5505,2722,2783
68955,106862,10506,51405,7180,96356,5505,2722,2783
68960,106873,10506,51412,7180,96366,5505,2722,2783
68965,106877,10507,51413,7181,96370,5505,2722,2783
68970,106887,10508,51417,7182,96379,5505,2722,2783
68975,106893,10508,51419,7182,96385,5505,2722,2783
68980,106904,10508,51423,7182,96396,5505,2722,2783
68985,106908,10508,51425,7182,96400,5505,2722,2783
68990,106918,10509,51433,7183,96409,5505,2722,2783
68995,106924,10509,51438,7183,96414,5505,2722,2783
69000,106935,10510,51444,7184,96425,5505,2722,2783
69005,106939,10510,51446,7184,96429,5505,2722,2783
69010,106949,10510,51450,7184,96439,5505,2722,2783
69015,106955,10510,51454,7184,96445,5505,2722,2783
69020,106966,10510,51459,7184,96456,5505,2722,2783
69025,106970,10510,51463,7184,96460,5505,2722,2783
69030,106980,10510,51468,7184,96470,5505,2722,2783
69035,106986,10510,51469,7184,96476,5505,2722,2783
69040,106997,10510,51473,7184,96487,5505,2722,2783
69045,107001,10510,51475,7184,96491,5505,2722,2783
69050,107011,10510,51482,7184,96501,5505,2722,2783
69055,107017,10510,51484,7184,96507,5505,2722,2783
69060,107028,10510,51490,7184,96518,5505,2722,2783
69065,107032,10510,51493,7184,96522,5505,2722,2783
69070,107042,10510,51498,7184,96532,5505,2722,2783
69075,107048,10510,51500,7184,96538,5505,2722,2783
69080,107059,10510,51506,7184,96549,5505,2722,2783
69085,107063,10510,51509,7184,96553,5505,2722,2783
69090,107073,10510,51515,7184,96563,5505,2722,2783
69095,107079,10510,51518,7184,96569,5505,2722,2783
69100,107090,10510,51525,7184,96580,5505,2722,2783
69105,107094,10510,51528,7184,96584,5505,2722,2783
69110,107104,10511,51531,7184,96593,5505,2722,2783
69115,107110,10511,51535,7184,96599,5505,2722,2783
69120,107121,10511,51540,7184,96610,5505,2722,2783
69125,107125,10511,51541,7184,96614,5505,2722,2783
69130,107135,10512,51548,7185,96623,5505,2722,2783
69135,107141,10512,51550,7185,96628,5505,2722,2783
69140,107152,10514,51555,7187,96638,5505,2722,2783
69145,107156,10514,51557,7187,96642,5505,2722,2783
69150,107166,10515,51561,7188,96651,5505,2722,2783
69155,107172,10515,51566,7188,96656,5505,2722,2783
69160,107183,10516,51574,7189,96667,5505,2722,2783
69165,107187,10517,51576,7190,96670,5505,2722,2783
69170,107197,10518,51580,7190,96679,5505,2722,2783
69175,107203,10518,51585,7190,96684,5505,2722,2783
69180,107214,10520,51589,7192,96694,5505,2722,2783
69185,107218,10520,51591,7192,96698,5505,2722,2783
69190,107228,10521,51596,7193,96707,5505,2722,2783
69195,107234,10521,51598,7193,96713,5505,2722,2783
69200,107245,10521,51604,7193,96724,5505,2722,2783
69205,107249,10521,51605,7193,96728,5505,2722,2783
69210,107259,10522,51612,7194,96737,5505,2722,2783
69215,107265,10522,51615,7194,96743,5505,2722,2783
69220,107276,10522,51620,7194,96753,5505,2722,2783
69225,107280,10523,51621,7195,96757,5505,2722,2783
69230,107290,10524,51626,7195,96766,5505,2722,2783
69235,107296,10524,51628,7195,96771,5505,2722,2783
69240,107307,10525,51633,7196,96781,5505,2722,2783
69245,107311,10526,51634,7197,96785,5505,2722,2783
69250,107321,10527,51636,7197,96794,5505,2722,2783
69255,107327,10527,51640,7197,96799,5505,2722,2783
69260,107338,10528,51646,7198,96809,5505,2722,2783
69265,107342,10529,51647,7199,96813,5505,2722,2783
69270,107352,10530,51652,7200,96822,5505,2722,2783
69275,107358,10530,51655,7200,96827,5505,2722,2783
69280,107369,10531,51662,7201,96837,5505,2722,2783
69285,107373,10532,51665,7202,96841,5505,2722,2783
69290,107383,10533,51669,7202,96850,5505,2722,2783
69295,107389,10533,51674,7202,96855,5505,2722,2783
69300,107400,10534,51682,7203,96865,5505,2722,2783
69305,107404,10535,51684,7204,96869,5505,2722,2783
69310,107414,10535,51691,7204,96879,5505,2722,2783
69315,107420,10535,51692,7204,96885,5505,2722,2783
69320,107431,10535,51697,7204,96896,5505,2722,2783
69325,107435,10535,51700,7204,96900,5505,2722,2783
69330,107445,10535,51704,7204,96910,5505,2722,2783
69335,107451,10535,51707,7204,96916,5505,2722,2783
69340,107462,10535,51711,7204,96927,5505,2722,2783
69345,107466,10535,51711,7204,96931,5505,2722,2783
69350,107476,10535,51716,7204,96941,5505,2722,2783
69355,107482,10535,51719,7204,96947,5505,2722,2783
69360,107493,10535,51721,7204,96958,5505,2722,2783
69365,107497,10535,51723,7204,96962,5505,2722,2783
69370,107507,10535,51726,7204,96972,5505,2722,2783
69375,107513,10535,51727,7204,96978,5505,2722,2783
69380,107524,10535,51732,7204,96989,5505,2722,2783
69385,107528,10535,51734,7204,96993,5505,2722,2783
69390,107538,10535,51738,7204,97003,5505,2722,2783
69395,107544,10535,51742,7204,97009,5505,2722,2783
69400,107555,10535,51748,7204,97020,5505,2722,2783
69405,107559,10535,51749,7204,97024,5505,2722,2783
69410,107569,10535,51754,7204,97034,5505,2722,2783
69415,107575,10535,51758,7204,97040,5505,2722,2783
69420,107586,10535,51767,7204,97051,5505,2722,2783
69425,107590,10535,51769,7204,97055,5505,2722,2783
69430,107600,10535,51774,7204,97065,5505,2722,2783
69435,107606,10535,51777,7204,97071,5505,2722,2783
69440,107617,10535,51782,7204,97082,5505,2722,2783
69445,107621,10535,51783,7204,97086,5505,2722,2783
69450,107631,10535,51786,7204,97096,5505,2722,2783
69455,107637,10535,51791,7204,97102,5505,2722,2783
69460,107648,10535,51797,7204,97113,5505,2722,2783
69465,107652,10535,51799,7204,97117,5505,2722,2783
69470,107662,10536,51802,7204,97126,5505,2722,2783
69475,107668,10536,51805,7204,97131,5505,2722,2783
69480,107679,10537,51812,7205,97142,5505,2722,2783
69485,107683,10537,51814,7205,97146,5505,2722,2783
69490,107693,10538,51817,7205,97155,5505,2722,2783
69495,107699,10538,51819,7205,97160,5505,2722,2783
69500,107710,10539,51824,7206,97171,5505,2722,2783
69505,107714,10539,51824,7206,97175,5505,2722,2783
69510,107724,10540,51831,7207,97184,5505,2722,2783
69515,107730,10540,51834,7207,97190,5505,2722,2783
69520,107741,10540,51840,7207,97201,5505,2722,2783
69525,107745,10541,51843,7208,97204,5505,2722,2783
69530,107755,10542,51847,7209,97213,5505,2722,2783
69535,107761,10542,51848,7209,97219,5505,2722,2783
69540,107772,10542,51852,7209,97230,5505,2722,2783
69545,107776,10542,51853,7209,97234,5505,2722,2783
69550,107786,10542,51859,7209,97244,5505,2722,2783
69555,107792,10542,51862,7209,97250,5505,2722,2783
69560,107803,10542,51866,7209,97261,5505,2722,2783
69565,107807,10542,51868,7209,97265,5505,2722,2783
69570,107817,10542,51873,7209,97275,5505,2722,2783
69575,107823,10542,51877,7209,97281,5505,2722,2783
69580,107834,10542,51883,7209,97292,5505,2722,2783
69585,107838,10542,51884,7209,97296,5505,2722,2783
69590,107848,10542,51888,7209,97306,5505,2722,2783
69595,107854,10542,51889,7209,97312,5505,2722,2783
69600,107865,10542,51895,7209,97323,5505,2722,2783
69605,107869,10542,51895,7209,97327,5505,2722,2783
69610,107879,10542,51900,7209,97337,5505,2722,2783
69615,107885,10542,51902,7209,97343,5505,2722,2783
69620,107896,10542,51908,7209,97354,5505,2722,2783
69625,107900,10542,51910,7209,97358,5505,2722,2783
69630,107910,10542,51915,7209,97368,5505,2722,2783
69635,107916,10542,51919,7209,97374,5505,2722,2783
69640,107927,10542,51923,7209,97385,5505,2722,2783
69645,107931,10542,51924,7209,97389,5505,2722,2783
69650,107941,10542,51930,7209,97399,5505,2722,2783
69655,107947,10542,51933,7209,97405,5505,2722,2783
69660,107958,10542,51939,7209,97416,5505,2722,2783
69665,107962,10542,51941,7209,97420,5505,2722,2783
69670,107972,10542,51944,7209,97430,5505,2722,2783
69675,107978,10542,51948,7209,97436,5505,2722,2783
69680,107989,10542,51955,7209,97447,5505,2722,2783
69685,107993,10542,51956,7209,97451,5505,2722,2783
69690,108003,10542,51960,7209,97461,5505,2722,2783
69695,108009,10542,51964,7209,97467,5505,2722,2783
69700,108020,10542,51968,7209,97478,5505,2722,2783
69705,108024,10542,51969,7209,97482,5505,2722,2783
69710,108034,10542,51972,7209,97492,5505,2722,2783
69715,108040,10542,51976,7209,97498,5505,2722,2783
69720,108051,10542,51979,7209,97509,5505,2722,2783
69725,108055,10542,51980,7209,97513,5505,2722,2783
69730,108065,10542,51984,7209,97523,5505,2722,2783
69735,108071,10542,51987,7209,97529,5505,2722,2783
69740,108082,10542,51992,7209,97540,5505,2722,2783
69745,108086,10542,51993,7209,97544,5505,2722,2783
69750,108096,10542,51995,7209,97554,5505,2722,2783
69755,108102,10542,51997,7209,97560,5505,2722,2783
69760,108113,10542,52003,7209,97571,5505,2722,2783
69765,108117,10542,52004,7209,97575,5505,2722,2783
69770,108127,10542,52010,7209,97585,5505,2722,2783
69775,108133,10542,52012,7209,97591,5505,2722,2783
69780,108144,10542,52020,7209,97602,5505,2722,2783
69785,108148,10542,52021,7209,97606,5505,2722,2783
69790,108158,10542,52023,7209,97616,5505,2722,2783
69795,108164,10542,52026,7209,97622,5505,2722,2783
69800,108175,10542,52034,7209,97633,5505,2722,2783
69805,108179,10542,52035,7209,97637,5505,2722,2783
69810,108189,10542,52039,7209,97647,5505,2722,2783
69815,108195,10542,52042,7209,97653,5505,2722,2783
69820,108206,10542,52049,7209,97664,5505,2722,2783
69825,108210,10542,52052,7209,97668,5505,2722,2783
69830,108220,10542,52059,7209,97678,5505,2722,2783
69835,108226,10542,52064,7209,97684,5505,2722,2783
69840,108237,10542,52071,7209,97695,5505,2722,2783
69845,108241,10542,52073,7209,97699,5505,2722,2783
69850,108251,10542,52077,7209,97709,5505,2722,2783
69855,108257,10542,52081,7209,97715,5505,2722,2783
69860,108268,10542,52088,7209,97726,5505,2722,2783
69865,108272,10542,52090,7209,97730,5505,2722,2783
69870,108282,10542,52095,7209,97740,5505,2722,2783
69875,108288,10542,52098,7209,97746,5505,2722,2783
69880,108299,10542,52101,7209,97757,5505,2722,2783
69885,108303,10542,52103,7209,97761,5505,2722,2783
69890,108313,10542,52108,7209,97771,5505,2722,2783
69895,108319,10542,52112,7209,97777,5505,2722,2783
69900,108330,10542,52115,7209,97788,5505,2722,2783
69905,108334,10542,52117,7209,97792,5505,2722,2783
69910,108344,10542,52123,7209,97802,5505,2722,2783
69915,108350,10542,52125,7209,97808,5505,2722,2783
69920,108361,10542,52128,7209,97819,5505,2722,2783
69925,108365,10542,52128,7209,97823,5505,2722,2783
69930,108375,10542,52134,7209,97833,5505,2722,2783
69935,108381,10542,52135,7209,97839,5505,2722,2783
69940,108392,10542,52141,7209,97850,5505,2722,2783
69945,108396,10542,52143,7209,97854,5505,2722,2783
69950,108406,10542,52147,7209,97864,5505,2722,2783
69955,108412,10542,52151,7209,97870,5505,2722,2783
69960,108423,10542,52155,7209,97881,5505,2722,2783
69965,108427,10542,52156,7209,97885,5505,2722,2783
69970,108437,10542,52159,7209,97895,5505,2722,2783
69975,108443,10542,52162,7209,97901,5505,2722,2783
69980,108454,10542,52168,7209,97912,5505,2722,2783
69985,108458,10542,52169,7209,97916,5505,2722,2783
69990,108468,10542,52175,7209,97926,5505,2722,2783
69995,108474,10542,52180,7209,97932,5505,2722,2783
70000,108485,10542,52188,7209,97943,5505,2722,2783
70005,108489,10542,52191,7209,97947,5505,2722,2783
70010,108499,10542,52194,7209,97957,5505,2722,2783
70015,108505,10542,52198,7209,97963,5505,2722,2783
70020,108516,10542,52204,7209,97974,5505,2722,2783
70025,108520,10542,52206,7209,97978,5505,2722,2783
70030,108530,10542,52208,7209,97988,5505,2722,2783
70035,108536,10542,52209,7209,97994,5505,2722,2783
70040,108547,10542,52211,7209,98005,5505,2722,2783
70045,108551,10542,52213,7209,98009,5505,2722,2783
70050,108561,10542,52217,7209,98019,5505,2722,2783
70055,108567,10542,52221,7209,98025,5505,2722,2783
70060,108578,10542,52227,7209,98036,5505,2722,2783
70065,108582,10542,52230,7209,98040,5505,2722,2783
70070,108592,10542,52235,7209,98050,5505,2722,2783
70075,108598,10542,52238,7209,98056,5505,2722,2783
70080,108609,10542,52242,7209,98067,5505,2722,2783
70085,108613,10542,52245,7209,98071,5505,2722,2783
70090,108623,10542,52251,7209,98081,5505,2722,2783
70095,108629,10542,52252,7209,98087,5505,2722,2783
70100,108640,10542,52259,7209,98098,5505,2722,2783
70105,108644,10542,52261,7209,98102,5505,2722,2783
70110,108654,10542,52268,7209,98112,5505,2722,2783
70115,108660,10542,52270,7209,98118,5505,2722,2783
70120,108671,10542,52275,7209,98129,5505,2722,2783
70125,108675,10542,52277,7209,98133,5505,2722,2783
70130,108685,10542,52282,7209,98143,5505,2722,2783
70135,108691,10542,52285,7209,98149,5505,2722,2783
70140,108702,10542,52292,7209,98160,5505,2722,2783
70145,108706,10542,52293,7209,98164,5505,2722,2783
70150,108716,10542,52300,7209,98174,5505,2722,2783
70155,108722,10542,52301,7209,98180,5505,2722,2783
70160,108733,10542,52307,7209,98191,5505,2722,2783
70165,108737,10542,52310,7209,98195,5505,2722,2783
70170,108747,10542,52316,7209,98205,5505,2722,2783
70175,108753,10542,52318,7209,98211,5505,2722,2783
70180,108764,10542,52324,7209,98222,5505,2722,2783
70185,108768,10542,52328,7209,98226,5505,2722,2783
70190,108778,10542,52333,7209,98236,5505,2722,2783
70195,108784,10542,52338,7209,98242,5505,2722,2783
70200,108795,10542,52343,7209,98253,5505,2722,2783
70205,108799,10542,52344,7209,98257,5505,2722,2783
70210,108809,10542,52349,7209,98267,5505,2722,2783
70215,108815,10542,52352,7209,98273,5505,2722,2783
70220,108826,10542,52361,7209,98284,5505,2722,2783
70225,108830,10542,52363,7209,98288,5505,2722,2783
70230,108840,10542,52369,7209,98298,5505,2722,2783
70235,108846,10542,52373,7209,98304,5505,2722,2783
70240,108857,10542,52377,7209,98315,5505,2722,2783
70245,108861,10542,52380,7209,98319,5505,2722,2783
70250,108871,10542,52385,7209,98329,5505,2722,2783
70255,108877,10542,52389,7209,98335,5505,2722,2783
70260,108888,10542,52393,7209,98346,5505,2722,2783
70265,108892,10542,52396,7209,98350,5505,2722,2783
70270,108902,10542,52397,7209,98360,5505,2722,2783
70275,108908,10542,52402,7209,98366,5505,2722,2783
70280,108919,10542,52408,7209,98377,5505,2722,2783
70285,108923,10542,52408,7209,98381,5505,2722,2783
70290,108933,10542,52412,7209,98391,5505,2722,2783
70295,108939,10542,52415,7209,98397,5505,2722,2783
70300,108950,10542,52421,7209,98408,5505,2722,2783
70305,108954,10542,52422,7209,98412,5505,2722,2783
70310,108964,10542,52428,7209,98422,5505,2722,2783
70315,108970,10542,52429,7209,98428,5505,2722,2783
70320,108981,10542,52435,7209,98439,5505,2722,2783
70325,108985,10542,52437,7209,98443,5505,2722,2783
70330,108995,10542,52440,7209,98453,5505,2722,2783
70335,109001,10542,52442,7209,98459,5505,2722,2783
70340,109012,10542,52448,7209,98470,5505,2722,2783
70345,109016,10542,52448,7209,98474,5505,2722,2783
70350,109026,10542,52451,7209,98484,5505,2722,2783
70355,109032,10542,52454,7209,98490,5505,2722,2783
70360,109043,10542,52462,7209,98501,5505,2722,2783
70365,109047,10542,52463,7209,98505,5505,2722,2783
70370,109057,10542,52465,7209,98515,5505,2722,2783
70375,109063,10542,52466,7209,98521,5505,2722,2783
70380,109074,10542,52472,7209,98532,5505,2722,2783
70385,109078,10542,52472,7209,98536,5505,2722,2783
70390,109088,10542,52480,7209,98546,5505,2722,2783
70395,109094,10542,52481,7209,98552,5505,2722,2783
70400,109105,10542,52487,7209,98563,5505,2722,2783
70405,109109,10542,52489,7209,98567,5505,2722,2783
70410,109119,10542,52496,7209,98577,5505,2722,2783
70415,109125,10542,52499,7209,98583,5505,2722,2783
70420,109136,10542,52503,7209,98594,5505,2722,2783
70425,109140,10542,52505,7209,98598,5505,2722,2783
70430,109150,10542,52510,7209,98608,5505,2722,2783
70435,109156,10542,52515,7209,98614,5505,2722,2783
70440,109167,10542,52521,7209,98625,5505,2722,2783
70445,109171,10542,52525,7209,98629,5505,2722,2783
70450,109181,10542,52528,7209,98639,5505,2722,2783
70455,109187,10542,52531,7209,98645,5505,2722,2783
70460,109198,10542,52538,7209,98656,5505,2722,2783
70465,109202,10542,52541,7209,98660,5505,2722,2783
70470,109212,10542,52544,7209,98670,5505,2722,2783
70475,109218,10542,52546,7209,98676,5505,2722,2783
70480,109229,10542,52554,7209,98687,5505,2722,2783
70485,109233,10542,52557,7209,98691,5505,2722,2783
70490,109243,10542,52561,7209,98701,5505,2722,2783
70495,109249,10542,52564,7209,98707,5505,2722,2783
70500,109260,10542,52568,7209,98718,5505,2722,2783
70505,109264,10542,52570,7209,98722,5505,2722,2783
70510,109274,10542,52574,7209,98732,5505,2722,2783
70515,109280,10542,52578,7209,98738,5505,2722,2783
70520,109291,10542,52580,7209,98749,5505,2722,2783
70525,109295,10542,52583,7209,98753,5505,2722,2783
70530,109305,10542,52587,7209,98763,5505,2722,2783
70535,109311,10542,52588,7209,98769,5505,2722,2783
70540,109322,10542,52594,7209,98780,5505,2722,2783
70545,109326,10542,52594,7209,98784,5505,2722,2783
70550,109336,10542,52597,7209,98794,5505,2722,2783
70555,109342,10542,52597,7209,98800,5505,2722,2783
70560,109353,10542,52601,7209,98811,5505,2722,2783
70565,109357,10542,52603,7209,98815,5505,2722,2783
70570,109367,10542,52606,7209,98825,5505,2722,2783
70575,109373,10542,52610,7209,98831,5505,2722,2783
70580,109384,10542,52617,7209,98842,5505,2722,2783
70585,109388,10542,52620,7209,98846,5505,2722,2783
70590,109398,10542,52624,7209,98856,5505,2722,2783
70595,109404,10542,52626,7209,98862,5505,2722,2783
70600,109415,10542,52630,7209,98873,5505,2722,2783
70605,109419,10542,52634,7209,98877,5505,2722,2783
70610,109429,10542,52638,7209,98887,5505,2722,2783
70615,109435,10542,52641,7209,98893,5505,2722,2783
70620,109446,10542,52646,7209,98904,5505,2722,2783
70625,109450,10542,52647,7209,98908,5505,2722,2783
70630,109460,10542,52651,7209,98918,5505,2722,2783
70635,109466,10542,52654,7209,98924,5505,2722,2783
70640,109477,10542,52658,7209,98935,5505,2722,2783
70645,109481,10542,52659,7209,98939,5505,2722,2783
70650,109491,10542,52661,7209,98949,5505,2722,2783
70655,109497,10542,52664,7209,98955,5505,2722,2783
70660,109508,10542,52671,7209,98966,5505,2722,2783
70665,109512,10542,52673,7209,98970,5505,2722,2783
70670,109522,10542,52678,7209,98980,5505,2722,2783
70675,109528,10542,52684,7209,98986,5505,2722,2783
70680,109539,10542,52689,7209,98997,5505,2722,2783
70685,109543,10542,52690,7209,99001,5505,2722,2783
70690,109553,10542,52693,7209,99011,5505,2722,2783
70695,109559,10542,52697,7209,99017,5505,2722,2783
70700,109570,10542,52704,7209,99028,5505,2722,2783
70705,109574,10542,52706,7209,99032,5505,2722,2783
70710,109584,10542,52712,7209,99042,5505,2722,2783
70715,109590,10542,52718,7209,99048,5505,2722,2783
70720,109601,10542,52725,7209,99059,5505,2722,2783
70725,109605,10542,52726,7209,99063,5505,2722,2783
70730,109615,10542,52730,7209,99073,5505,2722,2783
70735,109621,10542,52733,7209,99079,5505,2722,2783
70740,109632,10542,52737,7209,99090,5505,2722,2783
70745,109636,10542,52738,7209,99094,5505,2722,2783
70750,109646,10542,52744,7209,99104,5505,2722,2783
70755,109652,10542,52749,7209,99110,5505,2722,2783
70760,109663,10542,52756,7209,99121,5505,2722,2783
70765,109667,10542,52758,7209,99125,5505,2722,2783
70770,109677,10542,52761,7209,99135,5505,2722,2783
70775,109683,10542,52764,7209,99141,5505,2722,2783
70780,109694,10542,52769,7209,99152,5505,2722,2783
70785,109698,10542,52772,7209,99156,5505,2722,2783
70790,109708,10542,52776,7209,99166,5505,2722,2783
70795,109714,10542,52778,7209,99172,5505,2722,2783
70800,109725,10542,52783,7209,99183,5505,2722,2783
70805,109729,10542,52784,7209,99187,5505,2722,2783
70810,109739,10542,52790,7209,99197,5505,2722,2783
70815,109745,10542,52792,7209,99203,5505,2722,2783
70820,109756,10542,52798,7209,99214,5505,2722,2783
70825,109760,10542,52800,7209,99218,5505,2722,2783
70830,109770,10542,52808,7209,99228,5505,2722,2783
70835,109776,10542,52813,7209,99234,5505,2722,2783
70840,109787,10542,52821,7209,99245,5505,2722,2783
70845,109791,10542,52823,7209,99249,5505,2722,2783
70850,109801,10542,52830,7209,99259,5505,2722,2783
70855,109807,10542,52834,7209,99265,5505,2722,2783
70860,109818,10542,52841,7209,99276,5505,2722,2783
70865,109822,10542,52844,7209,99280,5505,2722,2783
70870,109832,10542,52849,7209,99290,5505,2722,2783
70875,109838,10542,52853,7209,99296,5505,2722,2783
70880,109849,10542,52859,7209,99307,5505,2722,2783
70885,109853,10542,52860,7209,99311,5505,2722,2783
70890,109863,10542,52868,7209,99321,5505,2722,2783
70895,109869,10542,52872,7209,99327,5505,2722,2783
70900,109880,10542,52877,7209,99338,5505,2722,2783
70905,109884,10542,52879,7209,99342,5505,2722,2783
70910,109894,10542,52883,7209,99352,5505,2722,2783
70915,109900,10542,52884,7209,99358,5505,2722,2783
70920,109911,10542,52885,7209,99369,5505,2722,2783
70925,109915,10542,52886,7209,99373,5505,2722,2783
70930,109925,10542,52895,7209,99383,5505,2722,2783
70935,109931,10542,52896,7209,99389,5505,2722,2783
70940,109942,10542,52901,7209,99400,5505,2722,2783
70945,109946,10542,52904,7209,99404,5505,2722,2783
70950,109956,10542,52906,7209,99414,5505,2722,2783
70955,109962,10542,52909,7209,99420,5505,2722,2783
70960,109973,10542,52916,7209,99431,5505,2722,2783
70965,109977,10542,52919,7209,99435,5505,2722,2783
70970,109987,10542,52925,7209,99445,5505,2722,2783
70975,109993,10542,52930,7209,99451,5505,2722,2783
70980,110004,10542,52936,7209,99462,5505,2722,2783
70985,110008,10542,52938,7209,99466,5505,2722,2783
70990,110018,10542,52947,7209,99476,5505,2722,2783
70995,110024,10542,52950,7209,99482,5505,2722,2783
71000,110035,10542,52955,7209,99493,5505,2722,2783
71005,110039,10542,52956,7209,99497,5505,2722,2783
71010,110049,10542,52961,7209,99507,5505,2722,2783
71015,110055,10542,52962,7209,99513,5505,2722,2783
71020,110066,10542,52967,7209,99524,5505,2722,2783
71025,110070,10542,52968,7209,99528,5505,2722,2783
71030,110080,10542,52971,7209,99538,5505,2722,2783
71035,110086,10542,52974,7209,99544,5505,2722,2783
71040,110097,10542,52981,7209,99555,5505,2722,2783
71045,110101,10542,52982,7209,99559,5505,2722,2783
71050,110111,10542,52989,7209,99569,5505,2722,2783
71055,110117,10542,52995,7209,99575,5505,2722,2783
71060,110128,10542,53003,7209,99586,5505,2722,2783
71065,110132,10542,53006,7209,99590,5505,2722,2783
71070,110142,10542,53009,7209,99600,5505,2722,2783
71075,110148,10542,53012,7209,99606,5505,2722,2783
71080,110159,10542,53016,7209,99617,5505,2722,2783
71085,110163,10542,53018,7209,99621,5505,2722,2783
71090,110173,10542,53024,7209,99631,5505,2722,2783
71095,110179,10542,53029,7209,99637,5505,2722,2783
71100,110190,10542,53035,7209,99648,5505,2722,2783
71105,110194,10542,53035,7209,99652,5505,2722,2783
71110,110204,10542,53039,7209,99662,5505,2722,2783
71115,110210,10542,53041,7209,99668,5505,2722,2783
71120,110221,10542,53048,7209,99679,5505,2722,2783
71125,110225,10542,53051,7209,99683,5505,2722,2783
71130,110235,10542,53057,7209,99693,5505,2722,2783
71135,110241,10542,53061,7209,99699,5505,2722,2783
71140,110252,10542,53070,7209,99710,5505,2722,2783
71145,110256,10542,53071,7209,99714,5505,2722,2783
71150,110266,10542,53076,7209,99724,5505,2722,2783
71155,110272,10542,53077,7209,99730,5505,2722,2783
71160,110283,10542,53082,7209,99741,5505,2722,2783
71165,110287,10542,53085,7209,99745,5505,2722,2783
71170,110297,10542,53090,7209,99755,5505,2722,2783
71175,110303,10542,53094,7209,99761,5505,2722,2783
71180,110314,10542,53101,7209,99772,5505,2722,2783
71185,110318,10542,53102,7209,99776,5505,2722,2783
71190,110328,10542,53108,7209,99786,5505,2722,2783
71195,110334,10542,53113,7209,99792,5505,2722,2783
71200,110345,10542,53121,7209,99803,5505,2722,2783
71205,110349,10542,53124,7209,99807,5505,2722,2783
71210,110359,10542,53128,7209,99817,5505,2722,2783
71215,110365,10542,53131,7209,99823,5505,2722,2783
71220,110376,10542,53137,7209,99834,5505,2722,2783
71225,110380,10542,53140,7209,99838,5505,2722,2783
71230,110390,10542,53146,7209,99848,5505,2722,2783
71235,110396,10542,53151,7209,99854,5505,2722,2783
71240,110407,10542,53154,7209,99865,5505,2722,2783
71245,110411,10542,53157,7209,99869,5505,2722,2783
71250,110421,10542,53163,7209,99879,5505,2722,2783
71255,110427,10542,53167,7209,99885,5505,2722,2783
71260,110438,10542,53175,7209,99896,5505,2722,2783
71265,110442,10542,53176,7209,99900,5505,2722,2783
71270,110452,10542,53180,7209,99910,5505,2722,2783
71275,110458,10542,53183,7209,99916,5505,2722,2783
71280,110469,10542,53191,7209,99927,5505,2722,2783
71285,110473,10542,53193,7209,99931,5505,2722,2783
71290,110483,10542,53198,7209,99941,5505,2722,2783
71295,110489,10542,53201,7209,99947,5505,2722,2783
71300,110500,10542,53204,7209,99958,5505,2722,2783
71305,110504,10542,53205,7209,99962,5505,2722,2783
71310,110514,10542,53212,7209,99972,5505,2722,2783
71315,110520,10542,53215,7209,99978,5505,2722,2783
71320,110531,10542,53219,7209,99989,5505,2722,2783
71325,110535,10542,53221,7209,99993,5505,2722,2783
71330,110545,10542,53222,7209,100003,5505,2722,2783
71335,110551,10542,53223,7209,100009,5505,2722,2783
71340,110562,10542,53227,7209,100020,5505,2722,2783
71345,110566,10542,53229,7209,100024,5505,2722,2783
71350,110576,10542,53234,7209,100034,5505,2722,2783
71355,110582,10542,53236,7209,100040,5505,2722,2783
71360,110593,10542,53243,7209,100051,5505,2722,2783
71365,110597,10542,53243,7209,100055,5505,2722,2783
71370,110607,10542,53246,7209,100065,5505,2722,2783
71375,110613,10542,53249,7209,100071,5505,2722,2783
71380,110624,10542,53253,7209,100082,5505,2722,2783
71385,110628,10542,53254,7209,100086,5505,2722,2783
71390,110638,10542,53258,7209,100096,5505,2722,2783
71393,110641,10542,53259,7209,100099,5505,2722,2783
