source,gentime, athop, hopcount,priority, reachedTime
2,3,2,2,1, 5
1,6,1,1,0, 7
4,6,4,4,1, 10
3,7,3,3,1, 10
5,7,3,3,1, 10
6,10,2,2,1, 12
7,12,1,1,1, 13
8,16,1,1,1, 17
11,14,4,4,0, 18
9,17,2,2,0, 19
2,18,2,2,1, 20
16,19,2,2,1, 21
14,19,3,3,0, 22
17,19,3,3,1, 22
1,21,1,1,1, 22
13,19,4,4,0, 23
15,21,2,2,0, 23
12,20,5,5,0, 25
4,21,4,4,0, 25
3,22,3,3,0, 25
5,22,3,3,1, 25
6,25,2,2,0, 27
7,27,1,1,1, 28
20,23,6,6,0, 29
22,26,4,4,1, 30
24,29,1,1,1, 30
19,26,5,5,0, 31
23,28,3,3,1, 31
21,27,5,5,0, 32
8,31,1,1,1, 32
11,29,4,4,0, 33
9,32,2,2,0, 34
2,33,2,2,1, 35
27,32,4,4,0, 36
30,33,3,3,1, 36
16,34,2,2,0, 36
14,34,3,3,0, 37
17,34,3,3,0, 37
25,35,2,2,1, 37
1,36,1,1,0, 37
13,34,4,4,1, 38
15,36,2,2,1, 38
31,36,2,2,1, 38
28,34,5,5,0, 39
12,35,5,5,0, 40
4,36,4,4,1, 40
3,37,3,3,1, 40
5,37,3,3,1, 40
26,37,3,3,0, 40
29,38,4,4,1, 42
6,40,2,2,0, 42
7,42,1,1,0, 43
20,38,6,6,1, 44
22,41,4,4,1, 45
24,44,1,1,0, 45
19,41,5,5,0, 46
23,43,3,3,0, 46
21,42,5,5,0, 47
8,46,1,1,1, 47
11,44,4,4,1, 48
9,47,2,2,0, 49
2,48,2,2,0, 50
27,47,4,4,0, 51
30,48,3,3,1, 51
16,49,2,2,0, 51
14,49,3,3,1, 52
17,49,3,3,0, 52
25,50,2,2,0, 52
1,51,1,1,0, 52
13,49,4,4,1, 53
15,51,2,2,0, 53
31,51,2,2,0, 53
28,49,5,5,1, 54
12,50,5,5,0, 55
4,51,4,4,0, 55
3,52,3,3,1, 55
5,52,3,3,0, 55
26,52,3,3,0, 55
29,53,4,4,1, 57
6,55,2,2,1, 57
7,57,1,1,0, 58
20,53,6,6,1, 59
22,56,4,4,0, 60
24,59,1,1,1, 60
19,56,5,5,1, 61
23,58,3,3,1, 61
21,57,5,5,1, 62
8,61,1,1,0, 62
11,59,4,4,0, 63
9,62,2,2,0, 64
2,63,2,2,0, 65
27,62,4,4,0, 66
30,63,3,3,0, 66
16,64,2,2,1, 66
14,64,3,3,0, 67
17,64,3,3,1, 67
25,65,2,2,1, 67
1,66,1,1,0, 67
13,64,4,4,1, 68
15,66,2,2,1, 68
31,66,2,2,1, 68
28,64,5,5,0, 69
12,65,5,5,0, 70
4,66,4,4,1, 70
3,67,3,3,1, 70
5,67,3,3,1, 70
26,67,3,3,1, 70
18,68,4,4,1, 72
29,68,4,4,0, 72
6,70,2,2,0, 72
7,72,1,1,1, 73
22,71,4,4,1, 75
24,74,1,1,0, 75
23,73,3,3,0, 76
21,72,5,5,1, 77
8,76,1,1,1, 77
11,74,4,4,1, 78
2,78,2,2,1, 80
27,77,4,4,1, 81
30,78,3,3,0, 81
16,79,2,2,1, 81
14,79,3,3,0, 82
17,79,3,3,1, 82
25,80,2,2,1, 82
1,81,1,1,0, 82
13,79,4,4,1, 83
15,81,2,2,0, 83
31,81,2,2,1, 83
28,79,5,5,1, 84
3,82,3,3,1, 85
5,82,3,3,0, 85
26,82,3,3,1, 85
29,83,4,4,0, 87
6,85,2,2,1, 87
7,87,1,1,0, 88
20,83,6,6,1, 89
22,86,4,4,1, 90
24,89,1,1,1, 90
23,88,3,3,0, 91
21,87,5,5,1, 92
8,91,1,1,1, 92
11,89,4,4,1, 93
27,92,4,4,1, 96
30,93,3,3,0, 96
16,94,2,2,0, 96
14,94,3,3,1, 97
17,94,3,3,1, 97
25,95,2,2,1, 97
1,96,1,1,1, 97
13,94,4,4,0, 98
15,96,2,2,0, 98
31,96,2,2,1, 98
28,94,5,5,1, 99
3,97,3,3,1, 100
5,97,3,3,1, 100
26,97,3,3,1, 100
18,98,4,4,1, 102
29,98,4,4,1, 102
6,100,2,2,0, 102
7,102,1,1,1, 103
22,101,4,4,1, 105
24,104,1,1,0, 105
23,103,3,3,0, 106
21,102,5,5,1, 107
8,106,1,1,0, 107
9,107,2,2,1, 109
30,108,3,3,0, 111
16,109,2,2,0, 111
14,109,3,3,0, 112
17,109,3,3,1, 112
25,110,2,2,1, 112
1,111,1,1,0, 112
13,109,4,4,0, 113
15,111,2,2,1, 113
31,111,2,2,0, 113
28,109,5,5,1, 114
12,110,5,5,1, 115
4,111,4,4,1, 115
3,112,3,3,1, 115
5,112,3,3,1, 115
29,113,4,4,1, 117
6,115,2,2,0, 117
7,117,1,1,0, 118
20,113,6,6,1, 119
22,116,4,4,0, 120
24,119,1,1,1, 120
23,118,3,3,1, 121
21,117,5,5,0, 122
8,121,1,1,0, 122
9,122,2,2,1, 124
27,122,4,4,0, 126
16,124,2,2,1, 126
25,125,2,2,0, 127
31,126,2,2,1, 128
28,124,5,5,1, 129
4,126,4,4,1, 130
26,127,3,3,0, 130
18,128,4,4,1, 132
7,132,1,1,1, 133
20,128,6,6,1, 134
22,131,4,4,1, 135
24,134,1,1,1, 135
23,133,3,3,1, 136
8,136,1,1,0, 137
9,137,2,2,1, 139
27,137,4,4,1, 141
14,139,3,3,1, 142
17,139,3,3,1, 142
25,140,2,2,1, 142
28,139,5,5,1, 144
12,140,5,5,1, 145
4,141,4,4,1, 145
26,142,3,3,0, 145
6,145,2,2,1, 147
7,147,1,1,1, 148
20,143,6,6,1, 149
24,149,1,1,0, 150
19,146,5,5,1, 151
21,147,5,5,1, 152
8,151,1,1,0, 152
27,152,4,4,0, 156
16,154,2,2,1, 156
25,155,2,2,1, 157
13,154,4,4,1, 158
12,155,5,5,1, 160
5,157,3,3,1, 160
26,157,3,3,1, 160
18,158,4,4,1, 162
29,158,4,4,1, 162
6,160,2,2,1, 162
7,162,1,1,0, 163
22,161,4,4,1, 165
24,164,1,1,0, 165
23,163,3,3,1, 166
8,166,1,1,1, 167
9,167,2,4,1, 171
27,167,4,4,1, 171
16,169,2,2,1, 171
11,164,4,8,1, 172
17,169,3,3,0, 172
25,170,2,2,1, 172
31,171,2,2,1, 173
4,171,4,4,1, 175
26,172,3,3,0, 175
18,173,4,4,1, 177
29,173,4,4,1, 177
6,175,2,2,1, 177
7,177,1,1,1, 178
22,176,4,4,1, 180
24,179,1,1,0, 180
19,176,5,5,0, 181
23,178,3,3,1, 181
21,177,5,5,1, 182
27,182,4,4,1, 186
16,184,2,2,1, 186
17,184,3,3,1, 187
18,188,4,4,1, 192
24,194,1,1,1, 195
19,191,5,5,1, 196
17,199,3,3,1, 202
25,200,2,2,1, 202
28,199,5,5,1, 204
26,202,3,3,1, 205
18,203,4,4,1, 207
24,209,1,1,0, 210
16,214,2,2,1, 216
28,214,5,5,1, 219
4,216,4,6,1, 222
24,224,1,1,1, 225
9,227,2,4,1, 231
16,229,2,2,1, 231
25,230,2,2,1, 232
1,231,1,1,1, 232
28,229,5,5,1, 234
4,231,4,6,1, 237
3,232,3,5,1, 237
24,239,1,1,1, 240
25,245,2,2,1, 247
1,246,1,1,0, 247
29,248,4,4,1, 252
7,252,1,1,0, 253
22,251,4,4,1, 255
24,254,1,1,0, 255
9,257,2,2,1, 259
30,258,3,3,1, 261
16,259,2,2,1, 261
1,261,1,1,0, 262
28,259,5,5,1, 264
24,269,1,1,0, 270
8,271,1,1,0, 272
30,273,3,3,1, 276
1,276,1,1,0, 277
27,272,4,6,1, 278
28,274,5,5,1, 279
8,286,1,1,0, 287
1,291,1,1,1, 292
8,301,1,1,1, 302
9,302,2,2,1, 304
14,304,3,3,1, 307
31,306,2,2,1, 308
7,312,1,1,1, 313
22,311,4,4,1, 315
8,316,1,1,1, 317
14,319,3,3,1, 322
15,321,2,2,1, 323
21,327,5,5,1, 332
8,331,1,1,0, 332
9,332,2,2,1, 334
16,334,2,2,1, 336
14,334,3,3,1, 337
15,336,2,2,1, 338
8,346,1,1,0, 347
9,347,2,2,1, 349
14,349,3,3,1, 352
13,349,4,4,1, 353
31,366,2,2,1, 368
7,372,1,1,0, 373
31,381,2,2,1, 383
6,385,2,2,1, 387
7,387,1,1,0, 388
24,389,1,1,0, 390
16,394,2,2,1, 396
31,396,2,2,1, 398
7,402,1,1,0, 403
24,404,1,1,1, 405
25,410,2,2,1, 412
7,417,1,1,0, 418
24,419,1,1,1, 420
25,425,2,2,1, 427
24,434,1,1,0, 435
25,440,2,2,1, 442
24,449,1,1,1, 450
24,464,1,1,0, 465
2,468,2,2,1, 470
17,469,3,3,1, 472
25,470,2,2,1, 472
1,471,1,1,1, 472
26,472,3,3,1, 475
20,473,6,6,1, 479
24,479,1,1,1, 480
19,476,5,5,1, 481
11,479,4,4,1, 483
1,486,1,1,0, 487
18,488,4,4,1, 492
24,494,1,1,1, 495
9,497,2,2,1, 499
17,499,3,3,1, 502
1,501,1,1,0, 502
18,503,4,4,1, 507
24,509,1,1,0, 510
9,512,2,2,1, 514
17,514,3,3,1, 517
1,516,1,1,1, 517
31,516,2,2,1, 518
24,524,1,1,0, 525
8,526,1,1,0, 527
9,527,2,2,1, 529
16,529,2,2,1, 531
1,531,1,1,1, 532
31,531,2,2,1, 533
7,537,1,1,1, 538
24,539,1,1,0, 540
8,541,1,1,0, 542
16,544,2,2,1, 546
15,546,2,2,1, 548
7,552,1,1,0, 553
8,556,1,1,1, 557
16,559,2,2,1, 561
15,561,2,2,1, 563
7,567,1,1,1, 568
8,571,1,1,0, 572
16,574,2,2,1, 576
15,576,2,2,1, 578
7,582,1,1,1, 583
8,586,1,1,1, 587
16,589,2,2,1, 591
15,591,2,2,1, 593
13,589,4,6,1, 595
7,597,1,1,1, 598
3,592,3,7,1, 599
22,596,4,4,1, 600
18,593,4,8,1, 601
19,596,5,7,1, 603
1,606,1,1,0, 607
7,612,1,1,0, 613
1,621,1,1,0, 622
16,619,2,4,1, 623
7,627,1,1,0, 628
17,634,3,3,1, 637
25,635,2,2,1, 637
1,636,1,1,0, 637
7,642,1,1,1, 643
24,644,1,1,0, 645
9,647,2,2,1, 649
2,648,2,2,1, 650
17,649,3,3,1, 652
1,651,1,1,1, 652
7,657,1,1,1, 658
24,659,1,1,1, 660
6,670,2,2,1, 672
7,672,1,1,0, 673
24,674,1,1,1, 675
6,685,2,2,1, 687
7,687,1,1,0, 688
24,689,1,1,1, 690
25,695,2,2,1, 697
7,702,1,1,0, 703
24,704,1,1,1, 705
25,710,2,2,1, 712
31,711,2,2,1, 713
5,712,3,5,1, 717
6,715,2,2,1, 717
7,717,1,1,0, 718
24,719,1,1,1, 720
8,721,1,1,1, 722
27,722,4,4,1, 726
16,724,2,4,1, 728
22,731,4,4,1, 735
24,734,1,1,0, 735
23,733,3,3,1, 736
8,736,1,1,1, 737
17,739,3,3,1, 742
15,741,2,2,1, 743
31,741,2,4,1, 745
22,746,4,4,1, 750
8,751,1,1,0, 752
15,756,2,2,1, 758
8,766,1,1,0, 767
14,769,3,3,1, 772
1,771,1,1,0, 772
15,771,2,2,1, 773
22,776,4,4,1, 780
1,786,1,1,1, 787
13,784,4,4,1, 788
7,792,1,1,0, 793
24,794,1,1,0, 795
14,799,3,3,1, 802
1,801,1,1,1, 802
6,805,2,2,1, 807
7,807,1,1,0, 808
24,809,1,1,1, 810
1,816,1,1,1, 817
7,822,1,1,0, 823
24,824,1,1,1, 825
30,828,3,3,1, 831
14,829,3,3,1, 832
1,831,1,1,0, 832
6,835,2,2,1, 837
7,837,1,1,0, 838
24,839,1,1,0, 840
8,841,1,1,1, 842
9,842,2,2,1, 844
17,844,3,3,1, 847
25,845,2,2,1, 847
1,846,1,1,0, 847
7,852,1,1,0, 853
24,854,1,1,1, 855
8,856,1,1,0, 857
16,859,2,2,1, 861
17,859,3,3,1, 862
1,861,1,1,1, 862
7,867,1,1,0, 868
24,869,1,1,0, 870
8,871,1,1,1, 872
1,876,1,1,0, 877
7,882,1,1,1, 883
24,884,1,1,0, 885
8,886,1,1,0, 887
2,888,2,2,1, 890
16,889,2,2,1, 891
14,889,3,3,1, 892
1,891,1,1,0, 892
13,889,4,4,1, 893
15,891,2,2,1, 893
31,891,2,2,1, 893
27,887,4,8,1, 895
3,892,3,3,1, 895
7,897,1,1,1, 898
5,892,3,7,1, 899
29,893,4,6,1, 899
24,899,1,1,1, 900
31,906,2,2,1, 908
24,914,1,1,0, 915
16,919,2,2,1, 921
24,929,1,1,0, 930
16,934,2,2,1, 936
24,944,1,1,1, 945
24,959,1,1,0, 960
9,962,2,2,1, 964
2,963,2,2,1, 965
1,966,1,1,1, 967
31,966,2,2,1, 968
7,972,1,1,0, 973
9,977,2,2,1, 979
1,981,1,1,1, 982
31,981,2,2,1, 983
7,987,1,1,0, 988
9,992,2,2,1, 994
25,995,2,2,1, 997
1,996,1,1,0, 997
7,1002,1,1,1, 1003
8,1006,1,1,1, 1007
2,1008,2,2,1, 1010
17,1009,3,3,1, 1012
1,1011,1,1,0, 1012
31,1011,2,2,1, 1013
3,1012,3,3,1, 1015
7,1017,1,1,0, 1018
8,1021,1,1,0, 1022
8,1036,1,1,0, 1037
8,1051,1,1,0, 1052
24,1064,1,1,1, 1065
8,1066,1,1,1, 1067
27,1067,4,4,1, 1071
26,1072,3,3,1, 1075
4,1071,4,6,1, 1077
5,1072,3,7,1, 1079
20,1073,6,6,1, 1079
29,1073,4,6,1, 1079
24,1079,1,1,0, 1080
8,1081,1,1,1, 1082
17,1084,3,3,1, 1087
15,1086,2,2,1, 1088
31,1086,2,2,1, 1088
7,1092,1,1,1, 1093
24,1094,1,1,0, 1095
8,1096,1,1,0, 1097
16,1099,2,2,1, 1101
14,1099,3,3,1, 1102
17,1099,3,3,1, 1102
15,1101,2,2,1, 1103
31,1101,2,2,1, 1103
24,1109,1,1,1, 1110
8,1111,1,1,1, 1112
16,1114,2,2,1, 1116
15,1116,2,2,1, 1118
24,1124,1,1,1, 1125
8,1126,1,1,0, 1127
16,1129,2,2,1, 1131
1,1131,1,1,0, 1132
31,1131,2,2,1, 1133
24,1139,1,1,0, 1140
1,1146,1,1,0, 1147
24,1154,1,1,0, 1155
9,1157,2,2,1, 1159
1,1161,1,1,0, 1162
24,1169,1,1,0, 1170
1,1176,1,1,1, 1177
24,1184,1,1,0, 1185
9,1187,2,2,1, 1189
1,1191,1,1,0, 1192
24,1199,1,1,0, 1200
9,1202,2,2,1, 1204
1,1206,1,1,1, 1207
7,1212,1,1,0, 1213
24,1214,1,1,0, 1215
1,1221,1,1,1, 1222
31,1221,2,2,1, 1223
7,1227,1,1,1, 1228
24,1229,1,1,0, 1230
9,1232,2,2,1, 1234
1,1236,1,1,0, 1237
7,1242,1,1,0, 1243
24,1244,1,1,1, 1245
8,1246,1,1,1, 1247
17,1249,3,3,1, 1252
25,1250,2,2,1, 1252
1,1251,1,1,0, 1252
31,1251,2,2,1, 1253
26,1252,3,3,1, 1255
18,1253,4,4,1, 1257
7,1257,1,1,0, 1258
24,1259,1,1,0, 1260
8,1261,1,1,1, 1262
14,1264,3,3,1, 1267
30,1263,3,7,1, 1270
5,1267,3,5,1, 1272
7,1272,1,1,1, 1273
29,1268,4,6,1, 1274
22,1271,4,4,1, 1275
8,1276,1,1,1, 1277
14,1279,3,3,1, 1282
6,1285,2,2,1, 1287
7,1287,1,1,1, 1288
8,1291,1,1,0, 1292
14,1294,3,3,1, 1297
7,1302,1,1,0, 1303
8,1306,1,1,1, 1307
13,1309,4,4,1, 1313
6,1315,2,2,1, 1317
7,1317,1,1,1, 1318
21,1317,5,5,1, 1322
8,1321,1,1,1, 1322
7,1332,1,1,1, 1333
8,1336,1,1,1, 1337
7,1347,1,1,0, 1348
8,1351,1,1,1, 1352
7,1362,1,1,1, 1363
24,1364,1,1,0, 1365
8,1366,1,1,1, 1367
2,1368,2,2,1, 1370
16,1369,2,2,1, 1371
17,1369,3,3,1, 1372
1,1371,1,1,0, 1372
26,1372,3,3,1, 1375
7,1377,1,1,1, 1378
24,1379,1,1,0, 1380
23,1378,3,3,1, 1381
1,1386,1,1,1, 1387
30,1383,3,5,1, 1388
15,1386,2,2,1, 1388
5,1387,3,5,1, 1392
7,1392,1,1,1, 1393
24,1394,1,1,0, 1395
21,1392,5,5,1, 1397
1,1401,1,1,0, 1402
24,1409,1,1,0, 1410
1,1416,1,1,1, 1417
24,1424,1,1,0, 1425
25,1430,2,2,1, 1432
1,1431,1,1,1, 1432
24,1439,1,1,1, 1440
1,1446,1,1,1, 1447
24,1454,1,1,0, 1455
1,1461,1,1,1, 1462
24,1469,1,1,0, 1470
1,1476,1,1,1, 1477
24,1484,1,1,0, 1485
8,1486,1,1,0, 1487
1,1491,1,1,0, 1492
15,1491,2,2,1, 1493
24,1499,1,1,0, 1500
31,1506,2,2,1, 1508
8,1606,1,1,1, 1607
30,1608,3,3,1, 1611
17,1609,3,3,1, 1612
25,1610,2,2,1, 1612
1,1611,1,1,0, 1612
15,1611,2,2,1, 1613
31,1611,2,2,1, 1613
13,1609,4,6,1, 1615
26,1612,3,3,1, 1615
4,1611,4,6,1, 1617
5,1612,3,5,1, 1617
7,1617,1,1,1, 1618
3,1612,3,7,1, 1619
20,1613,6,6,1, 1619
6,1615,2,4,1, 1619
22,1616,4,4,1, 1620
24,1619,1,1,0, 1620
19,1616,5,5,1, 1621
8,1621,1,1,1, 1622
7,1632,1,1,1, 1633
8,1636,1,1,0, 1637
16,1639,2,2,1, 1641
7,1647,1,1,1, 1648
8,1651,1,1,1, 1652
7,1662,1,1,1, 1663
8,1666,1,1,1, 1667
7,1677,1,1,1, 1678
8,1681,1,1,1, 1682
7,1692,1,1,0, 1693
8,1696,1,1,1, 1697
16,1699,2,2,1, 1701
7,1707,1,1,0, 1708
8,1711,1,1,0, 1712
16,1714,2,2,1, 1716
17,1714,3,3,1, 1717
7,1722,1,1,0, 1723
24,1724,1,1,0, 1725
8,1726,1,1,1, 1727
9,1727,2,2,1, 1729
30,1728,3,3,1, 1731
14,1729,3,3,1, 1732
1,1731,1,1,1, 1732
15,1731,2,2,1, 1733
13,1729,4,6,1, 1735
4,1731,4,4,1, 1735
7,1737,1,1,0, 1738
24,1739,1,1,0, 1740
21,1737,5,5,1, 1742
7,1752,1,1,1, 1753
24,1754,1,1,0, 1755
7,1767,1,1,1, 1768
24,1769,1,1,1, 1770
7,1782,1,1,0, 1783
24,1784,1,1,1, 1785
7,1797,1,1,1, 1798
24,1799,1,1,0, 1800
8,1801,1,1,1, 1802
15,1806,2,2,1, 1808
7,1812,1,1,0, 1813
24,1814,1,1,1, 1815
8,1816,1,1,1, 1817
17,1819,3,3,1, 1822
15,1821,2,2,1, 1823
7,1827,1,1,0, 1828
24,1829,1,1,0, 1830
8,1831,1,1,1, 1832
9,1832,2,2,1, 1834
7,1842,1,1,1, 1843
22,1841,4,4,1, 1845
24,1844,1,1,0, 1845
21,1842,5,5,1, 1847
14,1849,3,3,1, 1852
25,1850,2,2,1, 1852
1,1851,1,1,1, 1852
28,1849,5,5,1, 1854
5,1852,3,3,1, 1855
26,1852,3,3,1, 1855
29,1853,4,4,1, 1857
6,1855,2,2,1, 1857
7,1857,1,1,1, 1858
20,1853,6,6,1, 1859
22,1856,4,4,1, 1860
24,1859,1,1,0, 1860
25,1865,2,2,1, 1867
1,1866,1,1,1, 1867
24,1874,1,1,0, 1875
25,1880,2,2,1, 1882
1,1881,1,1,0, 1882
24,1889,1,1,1, 1890
1,1896,1,1,1, 1897
24,1904,1,1,0, 1905
1,1911,1,1,0, 1912
24,1919,1,1,1, 1920
8,1921,1,1,1, 1922
16,1924,2,2,1, 1926
1,1926,1,1,1, 1927
15,1926,2,2,1, 1928
31,1926,2,2,1, 1928
28,1924,5,5,1, 1929
26,1927,3,3,1, 1930
6,1930,2,2,1, 1932
7,1932,1,1,1, 1933
20,1928,6,6,1, 1934
24,1934,1,1,1, 1935
8,1936,1,1,0, 1937
27,1937,4,4,1, 1941
30,1938,3,3,1, 1941
1,1941,1,1,0, 1942
15,1941,2,2,1, 1943
26,1942,3,3,1, 1945
7,1947,1,1,0, 1948
21,1947,5,5,1, 1952
8,1951,1,1,1, 1952
9,1952,2,2,1, 1954
2,1953,2,2,1, 1955
27,1952,4,4,1, 1956
30,1953,3,3,1, 1956
16,1954,2,2,1, 1956
1,1956,1,1,1, 1957
31,1956,2,2,1, 1958
29,1958,4,4,1, 1962
7,1962,1,1,1, 1963
20,1958,6,6,1, 1964
23,1963,3,3,1, 1966
21,1962,5,5,1, 1967
8,1966,1,1,1, 1967
27,1967,4,4,1, 1971
16,1969,2,2,1, 1971
14,1969,3,3,1, 1972
1,1971,1,1,0, 1972
13,1969,4,4,1, 1973
15,1971,2,2,1, 1973
31,1971,2,4,1, 1975
3,1972,3,9,1, 1981
21,1977,5,5,1, 1982
9,1982,2,2,1, 1984
1,1986,1,1,0, 1987
9,1997,2,2,1, 1999
1,2001,1,1,1, 2002
1,2016,1,1,1, 2017
1,2031,1,1,0, 2032
24,2039,1,1,0, 2040
25,2045,2,2,1, 2047
31,2046,2,2,1, 2048
24,2054,1,1,1, 2055
31,2061,2,2,1, 2063
7,2067,1,1,1, 2068
24,2069,1,1,1, 2070
14,2074,3,3,1, 2077
15,2076,2,2,1, 2078
6,2080,2,2,1, 2082
7,2082,1,1,1, 2083
24,2084,1,1,0, 2085
13,2089,4,4,1, 2093
31,2091,2,2,1, 2093
6,2095,2,2,1, 2097
7,2097,1,1,1, 2098
20,2093,6,6,1, 2099
29,2093,4,6,1, 2099
24,2099,1,1,1, 2100
26,2092,3,9,1, 2101
8,2101,1,1,0, 2102
19,2096,5,7,1, 2103
25,2105,2,2,1, 2107
7,2112,1,1,0, 2113
24,2114,1,1,1, 2115
8,2116,1,1,1, 2117
25,2120,2,2,1, 2122
7,2127,1,1,1, 2128
24,2129,1,1,1, 2130
8,2131,1,1,0, 2132
7,2142,1,1,0, 2143
24,2144,1,1,1, 2145
8,2146,1,1,1, 2147
9,2147,2,2,1, 2149
2,2148,2,2,1, 2150
17,2149,3,3,1, 2152
1,2151,1,1,0, 2152
7,2157,1,1,0, 2158
24,2159,1,1,1, 2160
8,2161,1,1,0, 2162
17,2164,3,3,1, 2167
1,2166,1,1,1, 2167
18,2168,4,4,1, 2172
7,2172,1,1,1, 2173
24,2174,1,1,0, 2175
8,2176,1,1,1, 2177
16,2179,2,2,1, 2181
1,2181,1,1,0, 2182
18,2183,4,4,1, 2187
6,2185,2,2,1, 2187
7,2187,1,1,1, 2188
24,2189,1,1,1, 2190
8,2191,1,1,1, 2192
16,2194,2,2,1, 2196
17,2194,3,3,1, 2197
1,2196,1,1,1, 2197
18,2198,4,4,1, 2202
6,2200,2,2,1, 2202
7,2202,1,1,0, 2203
24,2204,1,1,0, 2205
8,2206,1,1,0, 2207
30,2208,3,3,1, 2211
16,2209,2,2,1, 2211
17,2209,3,3,1, 2212
1,2211,1,1,0, 2212
15,2211,2,2,1, 2213
18,2213,4,4,1, 2217
29,2213,4,4,1, 2217
6,2215,2,2,1, 2217
7,2217,1,1,1, 2218
24,2219,1,1,1, 2220
1,2226,1,1,0, 2227
1,2241,1,1,0, 2242
1,2256,1,1,1, 2257
2,2268,2,2,1, 2270
1,2271,1,1,0, 2272
27,2267,4,6,1, 2273
12,2270,5,5,1, 2275
3,2272,3,3,1, 2275
13,2269,4,8,1, 2277
18,2273,4,4,1, 2277
29,2273,4,6,1, 2279
19,2276,5,5,1, 2281
7,2337,1,1,0, 2338
7,2352,1,1,1, 2353
23,2353,3,3,1, 2356
31,2361,2,2,1, 2363
6,2365,2,2,1, 2367
7,2367,1,1,0, 2368
15,2376,2,2,1, 2378
31,2376,2,2,1, 2378
7,2382,1,1,0, 2383
24,2384,1,1,1, 2385
23,2383,3,3,1, 2386
8,2386,1,1,1, 2387
27,2387,4,4,1, 2391
16,2389,2,2,1, 2391
2,2388,2,4,1, 2392
14,2389,3,3,1, 2392
17,2389,3,3,1, 2392
1,2391,1,1,0, 2392
31,2391,2,2,1, 2393
28,2389,5,5,1, 2394
26,2392,3,3,1, 2395
12,2390,5,7,1, 2397
7,2397,1,1,1, 2398
5,2392,3,7,1, 2399
29,2393,4,6,1, 2399
24,2399,1,1,1, 2400
19,2396,5,5,1, 2401
23,2398,3,3,1, 2401
8,2401,1,1,1, 2402
25,2405,2,2,1, 2407
1,2406,1,1,1, 2407
8,2416,1,1,0, 2417
25,2420,2,2,1, 2422
1,2421,1,1,0, 2422
8,2431,1,1,0, 2432
25,2435,2,2,1, 2437
1,2436,1,1,0, 2437
8,2446,1,1,1, 2447
25,2450,2,2,1, 2452
1,2451,1,1,0, 2452
8,2461,1,1,1, 2462
1,2466,1,1,1, 2467
8,2476,1,1,0, 2477
25,2480,2,2,1, 2482
1,2481,1,1,0, 2482
8,2491,1,1,1, 2492
1,2496,1,1,0, 2497
8,2506,1,1,1, 2507
2,2508,2,2,1, 2510
27,2507,4,4,1, 2511
17,2509,3,3,1, 2512
1,2511,1,1,1, 2512
15,2511,2,2,1, 2513
31,2511,2,2,1, 2513
12,2510,5,5,1, 2515
3,2512,3,3,1, 2515
13,2509,4,8,1, 2517
5,2512,3,5,1, 2517
7,2517,1,1,1, 2518
29,2513,4,6,1, 2519
22,2516,4,4,1, 2520
24,2519,1,1,0, 2520
19,2516,5,5,1, 2521
23,2518,3,3,1, 2521
24,2534,1,1,1, 2535
24,2549,1,1,0, 2550
24,2564,1,1,1, 2565
24,2579,1,1,1, 2580
24,2594,1,1,0, 2595
24,2609,1,1,0, 2610
24,2624,1,1,0, 2625
8,2626,1,1,0, 2627
9,2627,2,2,1, 2629
27,2627,4,4,1, 2631
1,2631,1,1,0, 2632
28,2629,5,5,1, 2634
26,2632,3,3,1, 2635
4,2631,4,6,1, 2637
18,2633,4,4,1, 2637
29,2633,4,4,1, 2637
7,2637,1,1,0, 2638
20,2633,6,6,1, 2639
6,2635,2,4,1, 2639
22,2636,4,4,1, 2640
24,2639,1,1,1, 2640
23,2638,3,3,1, 2641
21,2637,5,5,1, 2642
8,2641,1,1,1, 2642
1,2646,1,1,1, 2647
7,2652,1,1,0, 2653
8,2656,1,1,1, 2657
1,2661,1,1,0, 2662
7,2667,1,1,1, 2668
8,2671,1,1,1, 2672
2,2673,2,2,1, 2675
1,2676,1,1,1, 2677
7,2682,1,1,0, 2683
8,2686,1,1,0, 2687
2,2688,2,2,1, 2690
1,2691,1,1,1, 2692
7,2697,1,1,0, 2698
8,2701,1,1,0, 2702
1,2706,1,1,1, 2707
6,2710,2,2,1, 2712
7,2712,1,1,1, 2713
8,2716,1,1,1, 2717
1,2721,1,1,0, 2722
7,2727,1,1,0, 2728
8,2731,1,1,1, 2732
2,2733,2,2,1, 2735
1,2736,1,1,1, 2737
7,2742,1,1,1, 2743
24,2744,1,1,0, 2745
8,2746,1,1,0, 2747
27,2747,4,4,1, 2751
17,2749,3,3,1, 2752
1,2751,1,1,1, 2752
28,2749,5,5,1, 2754
13,2749,4,6,1, 2755
4,2751,4,4,1, 2755
3,2752,3,3,1, 2755
5,2752,3,3,1, 2755
18,2753,4,4,1, 2757
29,2753,4,4,1, 2757
7,2757,1,1,0, 2758
22,2756,4,4,1, 2760
24,2759,1,1,1, 2760
23,2758,3,3,1, 2761
21,2757,5,5,1, 2762
24,2774,1,1,0, 2775
24,2789,1,1,1, 2790
24,2804,1,1,1, 2805
31,2811,2,2,1, 2813
24,2819,1,1,0, 2820
8,2821,1,1,1, 2822
9,2822,2,2,1, 2824
24,2834,1,1,1, 2835
8,2836,1,1,0, 2837
24,2849,1,1,1, 2850
8,2851,1,1,0, 2852
24,2864,1,1,0, 2865
8,2866,1,1,0, 2867
2,2868,2,2,1, 2870
25,2870,2,2,1, 2872
1,2871,1,1,0, 2872
31,2871,2,2,1, 2873
14,2869,3,5,1, 2874
28,2869,5,5,1, 2874
3,2872,3,3,1, 2875
4,2871,4,6,1, 2877
5,2872,3,5,1, 2877
18,2873,4,4,1, 2877
7,2877,1,1,0, 2878
20,2873,6,6,1, 2879
24,2879,1,1,0, 2880
8,2881,1,1,1, 2882
7,2892,1,1,1, 2893
8,2896,1,1,0, 2897
7,2907,1,1,0, 2908
8,2911,1,1,1, 2912
7,2922,1,1,0, 2923
8,2926,1,1,0, 2927
7,2937,1,1,0, 2938
8,2941,1,1,0, 2942
7,2952,1,1,1, 2953
8,2956,1,1,0, 2957
7,2967,1,1,0, 2968
8,2971,1,1,0, 2972
7,2982,1,1,1, 2983
24,2984,1,1,0, 2985
8,2986,1,1,1, 2987
30,2988,3,3,1, 2991
11,2984,4,8,1, 2992
2,2988,2,4,1, 2992
1,2991,1,1,1, 2992
14,2989,3,5,1, 2994
28,2989,5,5,1, 2994
3,2992,3,3,1, 2995
5,2992,3,3,1, 2995
26,2992,3,3,1, 2995
29,2993,4,4,1, 2997
7,2997,1,1,1, 2998
20,2993,6,6,1, 2999
22,2996,4,4,1, 3000
24,2999,1,1,0, 3000
23,2998,3,3,1, 3001
7,3012,1,1,1, 3013
24,3014,1,1,0, 3015
7,3027,1,1,0, 3028
24,3029,1,1,0, 3030
7,3042,1,1,0, 3043
24,3044,1,1,1, 3045
16,3049,2,2,1, 3051
7,3057,1,1,1, 3058
24,3059,1,1,1, 3060
16,3064,2,2,1, 3066
1,3066,1,1,1, 3067
7,3072,1,1,1, 3073
24,3074,1,1,0, 3075
9,3077,2,2,1, 3079
2,3078,2,2,1, 3080
1,3081,1,1,0, 3082
7,3087,1,1,1, 3088
24,3089,1,1,1, 3090
9,3092,2,2,1, 3094
2,3093,2,2,1, 3095
1,3096,1,1,0, 3097
26,3097,3,3,1, 3100
7,3102,1,1,0, 3103
24,3104,1,1,0, 3105
8,3106,1,1,1, 3107
9,3107,2,2,1, 3109
2,3108,2,2,1, 3110
25,3110,2,2,1, 3112
1,3111,1,1,0, 3112
13,3109,4,4,1, 3113
15,3111,2,2,1, 3113
28,3109,5,5,1, 3114
12,3110,5,5,1, 3115
6,3115,2,2,1, 3117
7,3117,1,1,0, 3118
20,3113,6,6,1, 3119
22,3116,4,4,1, 3120
24,3119,1,1,1, 3120
21,3117,5,5,1, 3122
8,3121,1,1,0, 3122
8,3136,1,1,0, 3137
8,3151,1,1,1, 3152
8,3166,1,1,0, 3167
8,3181,1,1,0, 3182
6,3190,2,6,1, 3196
8,3196,1,1,1, 3197
30,3198,3,5,1, 3203
22,3206,4,4,1, 3210
23,3208,3,3,1, 3211
8,3211,1,1,0, 3212
15,3216,2,2,1, 3218
31,3216,2,4,1, 3220
24,3224,1,1,1, 3225
8,3226,1,1,0, 3227
9,3227,2,2,1, 3229
1,3231,1,1,0, 3232
30,3228,3,5,1, 3233
31,3231,2,4,1, 3235
7,3237,1,1,0, 3238
5,3232,3,7,1, 3239
29,3233,4,6,1, 3239
22,3236,4,4,1, 3240
24,3239,1,1,0, 3240
23,3238,3,3,1, 3241
1,3246,1,1,0, 3247
7,3252,1,1,1, 3253
24,3254,1,1,0, 3255
9,3257,2,2,1, 3259
1,3261,1,1,0, 3262
7,3267,1,1,0, 3268
24,3269,1,1,1, 3270
16,3274,2,2,1, 3276
1,3276,1,1,1, 3277
7,3282,1,1,1, 3283
24,3284,1,1,0, 3285
1,3291,1,1,0, 3292
7,3297,1,1,1, 3298
24,3299,1,1,1, 3300
16,3304,2,2,1, 3306
1,3306,1,1,1, 3307
7,3312,1,1,1, 3313
24,3314,1,1,0, 3315
16,3319,2,2,1, 3321
1,3321,1,1,1, 3322
7,3327,1,1,0, 3328
24,3329,1,1,1, 3330
9,3332,2,2,1, 3334
16,3334,2,2,1, 3336
1,3336,1,1,1, 3337
7,3342,1,1,0, 3343
24,3344,1,1,0, 3345
8,3346,1,1,0, 3347
2,3348,2,2,1, 3350
27,3347,4,4,1, 3351
14,3349,3,3,1, 3352
1,3351,1,1,1, 3352
31,3351,2,2,1, 3353
12,3350,5,5,1, 3355
4,3351,4,4,1, 3355
3,3352,3,3,1, 3355
7,3357,1,1,1, 3358
20,3353,6,6,1, 3359
22,3356,4,4,1, 3360
24,3359,1,1,0, 3360
21,3357,5,5,1, 3362
8,3361,1,1,0, 3362
7,3372,1,1,1, 3373
8,3376,1,1,0, 3377
7,3387,1,1,1, 3388
8,3391,1,1,1, 3392
7,3402,1,1,1, 3403
8,3406,1,1,0, 3407
7,3417,1,1,1, 3418
8,3421,1,1,0, 3422
17,3424,3,3,1, 3427
25,3425,2,4,1, 3429
7,3432,1,1,0, 3433
8,3436,1,1,0, 3437
16,3439,2,2,1, 3441
7,3447,1,1,1, 3448
8,3451,1,1,1, 3452
16,3454,2,2,1, 3456
17,3454,3,3,1, 3457
25,3455,2,4,1, 3459
7,3462,1,1,1, 3463
8,3466,1,1,0, 3467
9,3467,2,2,1, 3469
30,3468,3,3,1, 3471
14,3469,3,3,1, 3472
1,3471,1,1,1, 3472
15,3471,2,2,1, 3473
27,3467,4,8,1, 3475
12,3470,5,7,1, 3477
26,3472,3,5,1, 3477
18,3473,4,4,1, 3477
7,3477,1,1,1, 3478
22,3476,4,4,1, 3480
24,3479,1,1,1, 3480
3,3472,3,9,1, 3481
21,3477,5,5,1, 3482
24,3494,1,1,1, 3495
24,3509,1,1,0, 3510
24,3524,1,1,0, 3525
24,3539,1,1,1, 3540
7,3552,1,1,1, 3553
24,3554,1,1,0, 3555
31,3561,2,2,1, 3563
7,3567,1,1,0, 3568
24,3569,1,1,1, 3570
23,3568,3,3,1, 3571
31,3576,2,2,1, 3578
7,3582,1,1,0, 3583
24,3584,1,1,1, 3585
2,3588,2,2,1, 3590
30,3588,3,3,1, 3591
16,3589,2,2,1, 3591
1,3591,1,1,1, 3592
27,3587,4,6,1, 3593
13,3589,4,4,1, 3593
12,3590,5,5,1, 3595
5,3592,3,3,1, 3595
6,3595,2,2,1, 3597
7,3597,1,1,1, 3598
20,3593,6,6,1, 3599
22,3596,4,4,1, 3600
24,3599,1,1,0, 3600
21,3597,5,5,1, 3602
8,3601,1,1,0, 3602
24,3614,1,1,0, 3615
8,3616,1,1,1, 3617
24,3629,1,1,1, 3630
8,3631,1,1,1, 3632
24,3644,1,1,1, 3645
8,3646,1,1,1, 3647
24,3659,1,1,0, 3660
8,3661,1,1,0, 3662
24,3674,1,1,1, 3675
8,3676,1,1,1, 3677
24,3689,1,1,1, 3690
8,3691,1,1,1, 3692
24,3704,1,1,1, 3705
8,3706,1,1,0, 3707
30,3708,3,3,1, 3711
16,3709,2,2,1, 3711
14,3709,3,3,1, 3712
1,3711,1,1,0, 3712
13,3709,4,4,1, 3713
15,3711,2,2,1, 3713
12,3710,5,7,1, 3717
4,3711,4,6,1, 3717
3,3712,3,5,1, 3717
29,3713,4,4,1, 3717
6,3715,2,2,1, 3717
7,3717,1,1,0, 3718
24,3719,1,1,1, 3720
21,3717,5,5,1, 3722
7,3732,1,1,0, 3733
7,3747,1,1,1, 3748
7,3762,1,1,1, 3763
7,3777,1,1,1, 3778
7,3792,1,1,1, 3793
7,3807,1,1,1, 3808
7,3822,1,1,0, 3823
24,3824,1,1,1, 3825
8,3826,1,1,0, 3827
2,3828,2,2,1, 3830
16,3829,2,2,1, 3831
17,3829,3,3,1, 3832
1,3831,1,1,0, 3832
31,3831,2,2,1, 3833
26,3832,3,3,1, 3835
28,3829,5,7,1, 3836
29,3833,4,4,1, 3837
7,3837,1,1,0, 3838
20,3833,6,6,1, 3839
24,3839,1,1,1, 3840
19,3836,5,5,1, 3841
23,3838,3,3,1, 3841
24,3854,1,1,1, 3855
24,3869,1,1,1, 3870
24,3884,1,1,1, 3885
24,3899,1,1,1, 3900
24,3914,1,1,0, 3915
24,3929,1,1,0, 3930
7,3942,1,1,1, 3943
24,3944,1,1,1, 3945
8,3946,1,1,0, 3947
30,3948,3,3,1, 3951
16,3949,2,2,1, 3951
2,3948,2,4,1, 3952
25,3950,2,2,1, 3952
1,3951,1,1,1, 3952
27,3947,4,6,1, 3953
28,3949,5,5,1, 3954
26,3952,3,3,1, 3955
4,3951,4,6,1, 3957
5,3952,3,5,1, 3957
18,3953,4,4,1, 3957
7,3957,1,1,1, 3958
6,3955,2,4,1, 3959
24,3959,1,1,1, 3960
19,3956,5,5,1, 3961
21,3957,5,5,1, 3962
11,3959,4,4,1, 3963
1,3966,1,1,1, 3967
7,3972,1,1,1, 3973
1,3981,1,1,1, 3982
31,3981,2,2,1, 3983
7,3987,1,1,1, 3988
1,3996,1,1,1, 3997
7,4002,1,1,0, 4003
1,4011,1,1,1, 4012
7,4017,1,1,1, 4018
1,4026,1,1,0, 4027
7,4032,1,1,1, 4033
1,4041,1,1,0, 4042
7,4047,1,1,0, 4048
1,4056,1,1,0, 4057
31,4056,2,2,1, 4058
7,4062,1,1,0, 4063
24,4064,1,1,1, 4065
8,4066,1,1,0, 4067
30,4068,3,3,1, 4071
25,4070,2,2,1, 4072
1,4071,1,1,1, 4072
15,4071,2,2,1, 4073
31,4071,2,2,1, 4073
18,4073,4,4,1, 4077
6,4075,2,2,1, 4077
7,4077,1,1,1, 4078
20,4073,6,6,1, 4079
24,4079,1,1,0, 4080
23,4078,3,3,1, 4081
24,4094,1,1,0, 4095
24,4109,1,1,0, 4110
24,4124,1,1,1, 4125
24,4139,1,1,1, 4140
24,4154,1,1,1, 4155
24,4169,1,1,0, 4170
24,4184,1,1,1, 4185
8,4186,1,1,0, 4187
14,4189,3,3,1, 4192
17,4189,3,3,1, 4192
1,4191,1,1,1, 4192
15,4191,2,2,1, 4193
2,4188,2,6,1, 4194
25,4190,2,4,1, 4194
12,4190,5,5,1, 4195
4,4191,4,4,1, 4195
3,4192,3,3,1, 4195
28,4189,5,7,1, 4196
7,4197,1,1,0, 4198
20,4193,6,6,1, 4199
29,4193,4,6,1, 4199
22,4196,4,4,1, 4200
24,4199,1,1,0, 4200
23,4198,3,3,1, 4201
8,4201,1,1,1, 4202
8,4216,1,1,0, 4217
16,4219,2,2,1, 4221
8,4231,1,1,0, 4232
8,4246,1,1,1, 4247
16,4249,2,2,1, 4251
8,4261,1,1,1, 4262
17,4264,3,3,1, 4267
8,4276,1,1,0, 4277
25,4280,2,4,1, 4284
8,4291,1,1,0, 4292
17,4294,3,3,1, 4297
24,4304,1,1,0, 4305
8,4306,1,1,0, 4307
17,4309,3,3,1, 4312
1,4311,1,1,0, 4312
14,4309,3,5,1, 4314
25,4310,2,4,1, 4314
13,4309,4,6,1, 4315
12,4310,5,7,1, 4317
7,4317,1,1,0, 4318
24,4319,1,1,1, 4320
3,4312,3,9,1, 4321
23,4318,3,3,1, 4321
17,4324,3,3,1, 4327
1,4326,1,1,0, 4327
15,4326,2,2,1, 4328
31,4326,2,2,1, 4328
24,4334,1,1,1, 4335
9,4337,2,2,1, 4339
17,4339,3,3,1, 4342
1,4341,1,1,0, 4342
24,4349,1,1,0, 4350
1,4356,1,1,0, 4357
24,4364,1,1,0, 4365
9,4367,2,2,1, 4369
17,4369,3,3,1, 4372
1,4371,1,1,1, 4372
18,4373,4,4,1, 4377
24,4379,1,1,1, 4380
1,4386,1,1,0, 4387
31,4386,2,2,1, 4388
24,4394,1,1,1, 4395
1,4401,1,1,1, 4402
31,4401,2,2,1, 4403
24,4409,1,1,1, 4410
1,4416,1,1,1, 4417
31,4416,2,2,1, 4418
24,4424,1,1,1, 4425
8,4426,1,1,0, 4427
2,4428,2,2,1, 4430
30,4428,3,3,1, 4431
14,4429,3,3,1, 4432
1,4431,1,1,1, 4432
15,4431,2,2,1, 4433
31,4431,2,2,1, 4433
7,4437,1,1,0, 4438
22,4436,4,4,1, 4440
24,4439,1,1,0, 4440
23,4438,3,3,1, 4441
8,4441,1,1,1, 4442
25,4445,2,2,1, 4447
7,4452,1,1,1, 4453
24,4454,1,1,1, 4455
8,4456,1,1,0, 4457
9,4457,2,2,1, 4459
25,4460,2,2,1, 4462
7,4467,1,1,0, 4468
24,4469,1,1,0, 4470
8,4471,1,1,1, 4472
9,4472,2,2,1, 4474
25,4475,2,2,1, 4477
7,4482,1,1,0, 4483
24,4484,1,1,1, 4485
8,4486,1,1,1, 4487
25,4490,2,2,1, 4492
6,4495,2,2,1, 4497
7,4497,1,1,0, 4498
24,4499,1,1,0, 4500
8,4501,1,1,0, 4502
9,4502,2,2,1, 4504
7,4512,1,1,0, 4513
24,4514,1,1,1, 4515
8,4516,1,1,1, 4517
16,4519,2,2,1, 4521
25,4520,2,2,1, 4522
7,4527,1,1,0, 4528
24,4529,1,1,0, 4530
8,4531,1,1,1, 4532
25,4535,2,2,1, 4537
7,4542,1,1,1, 4543
24,4544,1,1,1, 4545
23,4543,3,3,1, 4546
8,4546,1,1,0, 4547
9,4547,2,2,1, 4549
16,4549,2,2,1, 4551
25,4550,2,2,1, 4552
1,4551,1,1,0, 4552
15,4551,2,2,1, 4553
14,4549,3,5,1, 4554
7,4557,1,1,1, 4558
24,4559,1,1,0, 4560
2,4563,2,2,1, 4565
1,4566,1,1,0, 4567
1,4581,1,1,1, 4582
1,4596,1,1,0, 4597
1,4611,1,1,1, 4612
1,4626,1,1,1, 4627
1,4641,1,1,1, 4642
26,4642,3,3,1, 4645
25,4655,2,2,1, 4657
1,4656,1,1,1, 4657
26,4657,3,3,1, 4660
7,4662,1,1,1, 4663
24,4664,1,1,1, 4665
25,4670,2,2,1, 4672
1,4671,1,1,0, 4672
31,4671,2,2,1, 4673
26,4672,3,3,1, 4675
7,4677,1,1,1, 4678
3,4672,3,7,1, 4679
22,4676,4,4,1, 4680
24,4679,1,1,1, 4680
8,4681,1,1,0, 4682
20,4673,6,10,1, 4683
9,4682,2,2,1, 4684
16,4684,2,2,1, 4686
15,4686,2,2,1, 4688
7,4692,1,1,1, 4693
24,4694,1,1,0, 4695
8,4696,1,1,0, 4697
9,4697,2,2,1, 4699
15,4701,2,2,1, 4703
7,4707,1,1,0, 4708
24,4709,1,1,1, 4710
21,4707,5,5,1, 4712
8,4711,1,1,0, 4712
16,4714,2,2,1, 4716
7,4722,1,1,1, 4723
24,4724,1,1,0, 4725
8,4726,1,1,1, 4727
9,4727,2,2,1, 4729
16,4729,2,2,1, 4731
15,4731,2,2,1, 4733
7,4737,1,1,0, 4738
24,4739,1,1,1, 4740
7,4752,1,1,0, 4753
24,4754,1,1,1, 4755
14,4759,3,3,1, 4762
15,4761,2,2,1, 4763
7,4767,1,1,0, 4768
24,4769,1,1,1, 4770
7,4782,1,1,1, 4783
24,4784,1,1,1, 4785
25,4790,2,2,1, 4792
1,4791,1,1,1, 4792
26,4792,3,3,1, 4795
7,4797,1,1,1, 4798
22,4796,4,4,1, 4800
24,4799,1,1,1, 4800
2,4803,2,2,1, 4805
1,4806,1,1,1, 4807
7,4812,1,1,0, 4813
24,4814,1,1,0, 4815
2,4818,2,2,1, 4820
25,4820,2,2,1, 4822
1,4821,1,1,0, 4822
7,4827,1,1,0, 4828
24,4829,1,1,0, 4830
1,4836,1,1,0, 4837
15,4836,2,2,1, 4838
7,4842,1,1,0, 4843
24,4844,1,1,0, 4845
8,4846,1,1,0, 4847
25,4850,2,2,1, 4852
1,4851,1,1,0, 4852
6,4855,2,2,1, 4857
7,4857,1,1,0, 4858
24,4859,1,1,1, 4860
21,4857,5,5,1, 4862
8,4861,1,1,1, 4862
8,4876,1,1,0, 4877
16,4879,2,2,1, 4881
8,4891,1,1,0, 4892
16,4894,2,2,1, 4896
8,4906,1,1,1, 4907
16,4909,2,2,1, 4911
8,4921,1,1,0, 4922
14,4924,3,3,1, 4927
13,4924,4,4,1, 4928
31,4926,2,2,1, 4928
6,4930,2,2,1, 4932
7,4932,1,1,0, 4933
8,4936,1,1,1, 4937
30,4938,3,3,1, 4941
15,4941,2,2,1, 4943
7,4947,1,1,0, 4948
22,4946,4,4,1, 4950
8,4951,1,1,0, 4952
31,4956,2,2,1, 4958
7,4962,1,1,0, 4963
24,4964,1,1,0, 4965
8,4966,1,1,0, 4967
30,4968,3,3,1, 4971
14,4969,3,3,1, 4972
25,4970,2,2,1, 4972
1,4971,1,1,1, 4972
15,4971,2,2,1, 4973
31,4971,2,2,1, 4973
28,4969,5,5,1, 4974
5,4972,3,5,1, 4977
29,4973,4,4,1, 4977
6,4975,2,4,1, 4979
24,4979,1,1,0, 4980
8,4981,1,1,0, 4982
1,4986,1,1,0, 4987
24,4994,1,1,1, 4995
8,4996,1,1,0, 4997
1,5001,1,1,0, 5002
24,5009,1,1,1, 5010
8,5011,1,1,0, 5012
1,5016,1,1,0, 5017
31,5016,2,2,1, 5018
24,5024,1,1,0, 5025
8,5026,1,1,0, 5027
1,5031,1,1,1, 5032
24,5039,1,1,1, 5040
8,5041,1,1,1, 5042
1,5046,1,1,1, 5047
24,5054,1,1,1, 5055
8,5056,1,1,1, 5057
1,5061,1,1,0, 5062
24,5069,1,1,1, 5070
8,5071,1,1,0, 5072
1,5076,1,1,1, 5077
31,5076,2,2,1, 5078
7,5082,1,1,1, 5083
24,5084,1,1,1, 5085
8,5086,1,1,0, 5087
30,5088,3,3,1, 5091
16,5089,2,2,1, 5091
17,5089,3,3,1, 5092
1,5091,1,1,0, 5092
28,5089,5,5,1, 5094
6,5095,2,2,1, 5097
7,5097,1,1,1, 5098
24,5099,1,1,1, 5100
23,5098,3,3,1, 5101
21,5097,5,5,1, 5102
25,5105,2,2,1, 5107
7,5112,1,1,0, 5113
24,5114,1,1,1, 5115
7,5127,1,1,0, 5128
24,5129,1,1,0, 5130
27,5132,4,4,1, 5136
2,5133,2,4,1, 5137
25,5135,2,2,1, 5137
7,5142,1,1,0, 5143
24,5144,1,1,1, 5145
27,5147,4,4,1, 5151
25,5150,2,2,1, 5152
18,5153,4,4,1, 5157
7,5157,1,1,1, 5158
24,5159,1,1,0, 5160
19,5156,5,5,1, 5161
7,5172,1,1,1, 5173
24,5174,1,1,0, 5175
7,5187,1,1,0, 5188
24,5189,1,1,1, 5190
7,5202,1,1,1, 5203
24,5204,1,1,1, 5205
8,5206,1,1,1, 5207
9,5207,2,2,1, 5209
1,5211,1,1,1, 5212
31,5211,2,2,1, 5213
29,5213,4,4,1, 5217
6,5215,2,2,1, 5217
7,5217,1,1,0, 5218
24,5219,1,1,0, 5220
21,5217,5,5,1, 5222
9,5222,2,2,1, 5224
1,5226,1,1,0, 5227
1,5241,1,1,1, 5242
1,5256,1,1,0, 5257
1,5271,1,1,1, 5272
1,5286,1,1,1, 5287
9,5297,2,2,1, 5299
1,5301,1,1,1, 5302
9,5312,2,2,1, 5314
1,5316,1,1,1, 5317
8,5326,1,1,1, 5327
9,5327,2,2,1, 5329
30,5328,3,3,1, 5331
17,5329,3,3,1, 5332
1,5331,1,1,1, 5332
15,5331,2,2,1, 5333
31,5331,2,2,1, 5333
3,5332,3,3,1, 5335
5,5332,3,5,1, 5337
29,5333,4,4,1, 5337
6,5335,2,2,1, 5337
7,5337,1,1,0, 5338
22,5336,4,4,1, 5340
24,5339,1,1,0, 5340
18,5333,4,8,1, 5341
23,5338,3,3,1, 5341
21,5337,5,5,1, 5342
8,5341,1,1,1, 5342
24,5354,1,1,1, 5355
8,5356,1,1,0, 5357
24,5369,1,1,0, 5370
8,5371,1,1,0, 5372
24,5384,1,1,1, 5385
8,5386,1,1,1, 5387
24,5399,1,1,1, 5400
8,5401,1,1,0, 5402
2,5403,2,2,1, 5405
1,5406,1,1,1, 5407
26,5407,3,3,1, 5410
18,5408,4,4,1, 5412
7,5412,1,1,0, 5413
24,5414,1,1,1, 5415
8,5416,1,1,1, 5417
11,5414,4,4,1, 5418
9,5417,2,2,1, 5419
14,5419,3,3,1, 5422
1,5421,1,1,0, 5422
31,5421,2,2,1, 5423
26,5422,3,3,1, 5425
7,5427,1,1,1, 5428
24,5429,1,1,1, 5430
8,5431,1,1,0, 5432
9,5432,2,2,1, 5434
2,5433,2,2,1, 5435
1,5436,1,1,1, 5437
31,5436,2,2,1, 5438
3,5437,3,3,1, 5440
7,5442,1,1,1, 5443
22,5441,4,4,1, 5445
24,5444,1,1,0, 5445
8,5446,1,1,1, 5447
9,5447,2,2,1, 5449
27,5447,4,4,1, 5451
17,5449,3,3,1, 5452
25,5450,2,2,1, 5452
16,5449,2,4,1, 5453
31,5451,2,2,1, 5453
28,5449,5,5,1, 5454
12,5450,5,7,1, 5457
3,5452,3,5,1, 5457
18,5453,4,4,1, 5457
6,5455,2,2,1, 5457
7,5457,1,1,0, 5458
20,5453,6,6,1, 5459
24,5459,1,1,1, 5460
21,5457,5,5,1, 5462
31,5526,2,2,1, 5528
6,5530,2,2,1, 5532
7,5532,1,1,0, 5533
23,5533,3,3,1, 5536
14,5539,3,3,1, 5542
1,5541,1,1,0, 5542
5,5542,3,3,1, 5545
7,5547,1,1,1, 5548
23,5548,3,3,1, 5551
9,5552,2,2,1, 5554
1,5556,1,1,0, 5557
8,5566,1,1,1, 5567
14,5569,3,3,1, 5572
1,5571,1,1,0, 5572
15,5571,2,2,1, 5573
28,5569,5,5,1, 5574
25,5570,2,4,1, 5574
27,5567,4,8,1, 5575
3,5572,3,3,1, 5575
31,5571,2,6,1, 5577
26,5572,3,5,1, 5577
18,5573,4,6,1, 5579
24,5579,1,1,0, 5580
29,5573,4,8,1, 5581
21,5577,5,5,1, 5582
8,5581,1,1,1, 5582
1,5586,1,1,0, 5587
6,5590,2,2,1, 5592
7,5592,1,1,0, 5593
22,5591,4,4,1, 5595
24,5594,1,1,0, 5595
8,5596,1,1,0, 5597
30,5598,3,3,1, 5601
1,5601,1,1,0, 5602
7,5607,1,1,1, 5608
24,5609,1,1,0, 5610
8,5611,1,1,0, 5612
16,5614,2,2,1, 5616
1,5616,1,1,1, 5617
7,5622,1,1,0, 5623
24,5624,1,1,0, 5625
8,5626,1,1,1, 5627
30,5628,3,3,1, 5631
1,5631,1,1,0, 5632
7,5637,1,1,1, 5638
22,5636,4,4,1, 5640
24,5639,1,1,1, 5640
8,5641,1,1,0, 5642
1,5646,1,1,1, 5647
24,5654,1,1,0, 5655
8,5656,1,1,0, 5657
16,5659,2,2,1, 5661
1,5661,1,1,0, 5662
24,5669,1,1,0, 5670
8,5671,1,1,0, 5672
1,5676,1,1,0, 5677
24,5684,1,1,1, 5685
8,5686,1,1,0, 5687
17,5689,3,3,1, 5692
25,5690,2,2,1, 5692
1,5691,1,1,0, 5692
27,5687,4,6,1, 5693
31,5691,2,2,1, 5693
28,5689,5,7,1, 5696
26,5692,3,5,1, 5697
18,5693,4,4,1, 5697
4,5691,4,8,1, 5699
3,5692,3,7,1, 5699
20,5693,6,6,1, 5699
24,5699,1,1,1, 5700
30,5703,3,3,1, 5706
1,5706,1,1,0, 5707
24,5714,1,1,0, 5715
1,5721,1,1,0, 5722
31,5721,2,2,1, 5723
24,5729,1,1,0, 5730
30,5733,3,3,1, 5736
1,5736,1,1,0, 5737
31,5736,2,2,1, 5738
13,5734,4,6,1, 5740
7,5742,1,1,0, 5743
5,5737,3,7,1, 5744
24,5744,1,1,0, 5745
1,5751,1,1,1, 5752
6,5755,2,2,1, 5757
7,5757,1,1,1, 5758
24,5759,1,1,0, 5760
1,5766,1,1,1, 5767
7,5772,1,1,1, 5773
24,5774,1,1,0, 5775
1,5781,1,1,1, 5782
6,5785,2,2,1, 5787
7,5787,1,1,1, 5788
24,5789,1,1,1, 5790
25,5795,2,2,1, 5797
1,5796,1,1,0, 5797
7,5802,1,1,1, 5803
24,5804,1,1,1, 5805
25,5810,2,2,1, 5812
1,5811,1,1,0, 5812
4,5811,4,4,1, 5815
3,5812,3,3,1, 5815
28,5809,5,7,1, 5816
6,5815,2,2,1, 5817
7,5817,1,1,0, 5818
20,5813,6,6,1, 5819
24,5819,1,1,0, 5820
7,5832,1,1,1, 5833
24,5834,1,1,1, 5835
23,5833,3,3,1, 5836
15,5841,2,2,1, 5843
7,5847,1,1,0, 5848
24,5849,1,1,1, 5850
23,5848,3,3,1, 5851
31,5856,2,2,1, 5858
7,5862,1,1,0, 5863
24,5864,1,1,1, 5865
23,5863,3,3,1, 5866
8,5866,1,1,1, 5867
9,5867,2,2,1, 5869
15,5871,2,2,1, 5873
7,5877,1,1,1, 5878
24,5879,1,1,1, 5880
23,5878,3,3,1, 5881
8,5881,1,1,1, 5882
9,5882,2,2,1, 5884
1,5886,1,1,1, 5887
8,5896,1,1,1, 5897
1,5901,1,1,1, 5902
8,5911,1,1,0, 5912
1,5916,1,1,0, 5917
8,5926,1,1,1, 5927
9,5927,2,2,1, 5929
1,5931,1,1,0, 5932
4,5931,4,4,1, 5935
19,5936,5,5,1, 5941
8,5941,1,1,0, 5942
16,5944,2,2,1, 5946
1,5946,1,1,1, 5947
7,5952,1,1,0, 5953
8,5956,1,1,0, 5957
16,5959,2,2,1, 5961
1,5961,1,1,0, 5962
7,5967,1,1,0, 5968
8,5971,1,1,0, 5972
16,5974,2,2,1, 5976
1,5976,1,1,0, 5977
7,5982,1,1,0, 5983
24,5984,1,1,0, 5985
8,5986,1,1,0, 5987
2,5988,2,2,1, 5990
1,5991,1,1,1, 5992
7,5997,1,1,1, 5998
24,5999,1,1,0, 6000
8,6001,1,1,1, 6002
17,6004,3,3,1, 6007
7,6012,1,1,0, 6013
24,6014,1,1,0, 6015
8,6016,1,1,0, 6017
7,6027,1,1,1, 6028
24,6029,1,1,0, 6030
8,6031,1,1,1, 6032
25,6035,2,2,1, 6037
26,6037,3,3,1, 6040
7,6042,1,1,1, 6043
24,6044,1,1,0, 6045
8,6046,1,1,0, 6047
15,6051,2,2,1, 6053
31,6051,2,2,1, 6053
26,6052,3,3,1, 6055
29,6053,4,4,1, 6057
6,6055,2,2,1, 6057
7,6057,1,1,0, 6058
22,6056,4,4,1, 6060
24,6059,1,1,0, 6060
21,6057,5,5,1, 6062
1,6066,1,1,0, 6067
24,6074,1,1,0, 6075
1,6081,1,1,1, 6082
24,6089,1,1,0, 6090
1,6096,1,1,0, 6097
24,6104,1,1,1, 6105
1,6111,1,1,1, 6112
24,6119,1,1,0, 6120
1,6126,1,1,1, 6127
13,6124,4,6,1, 6130
12,6125,5,5,1, 6130
4,6126,4,4,1, 6130
5,6127,3,5,1, 6132
28,6124,5,9,1, 6133
18,6128,4,6,1, 6134
24,6134,1,1,0, 6135
1,6141,1,1,1, 6142
24,6149,1,1,1, 6150
1,6156,1,1,0, 6157
24,6164,1,1,0, 6165
8,6166,1,1,1, 6167
9,6167,2,2,1, 6169
25,6170,2,2,1, 6172
1,6171,1,1,0, 6172
15,6171,2,2,1, 6173
31,6171,2,2,1, 6173
7,6177,1,1,1, 6178
24,6179,1,1,1, 6180
8,6181,1,1,0, 6182
7,6192,1,1,0, 6193
24,6194,1,1,1, 6195
8,6196,1,1,0, 6197
7,6207,1,1,1, 6208
24,6209,1,1,0, 6210
8,6211,1,1,1, 6212
6,6220,2,2,1, 6222
7,6222,1,1,1, 6223
24,6224,1,1,0, 6225
8,6226,1,1,1, 6227
7,6237,1,1,0, 6238
24,6239,1,1,0, 6240
8,6241,1,1,0, 6242
7,6252,1,1,1, 6253
24,6254,1,1,1, 6255
8,6256,1,1,1, 6257
6,6265,2,2,1, 6267
7,6267,1,1,1, 6268
24,6269,1,1,0, 6270
8,6271,1,1,1, 6272
7,6282,1,1,1, 6283
24,6284,1,1,0, 6285
8,6286,1,1,0, 6287
16,6289,2,2,1, 6291
17,6289,3,3,1, 6292
1,6291,1,1,0, 6292
15,6291,2,2,1, 6293
31,6291,2,2,1, 6293
26,6292,3,3,1, 6295
18,6293,4,4,1, 6297
6,6295,2,2,1, 6297
7,6297,1,1,1, 6298
22,6296,4,4,1, 6300
24,6299,1,1,1, 6300
1,6306,1,1,1, 6307
1,6321,1,1,0, 6322
1,6336,1,1,1, 6337
1,6351,1,1,1, 6352
2,6363,2,2,1, 6365
1,6366,1,1,1, 6367
1,6381,1,1,0, 6382
1,6396,1,1,1, 6397
7,6402,1,1,0, 6403
24,6404,1,1,0, 6405
8,6406,1,1,1, 6407
1,6411,1,1,0, 6412
15,6411,2,2,1, 6413
7,6417,1,1,1, 6418
6,6415,2,4,1, 6419
24,6419,1,1,0, 6420
23,6418,3,3,1, 6421
8,6421,1,1,0, 6422
17,6424,3,3,1, 6427
6,6430,2,2,1, 6432
7,6432,1,1,0, 6433
24,6434,1,1,0, 6435
8,6436,1,1,0, 6437
17,6439,3,3,1, 6442
7,6447,1,1,0, 6448
24,6449,1,1,1, 6450
8,6451,1,1,1, 6452
26,6457,3,3,1, 6460
6,6460,2,2,1, 6462
7,6462,1,1,1, 6463
24,6464,1,1,1, 6465
8,6466,1,1,1, 6467
17,6469,3,3,1, 6472
25,6470,2,2,1, 6472
7,6477,1,1,0, 6478
24,6479,1,1,1, 6480
8,6481,1,1,1, 6482
2,6483,2,2,1, 6485
1,6486,1,1,1, 6487
3,6487,3,3,1, 6490
7,6492,1,1,0, 6493
24,6494,1,1,0, 6495
8,6496,1,1,1, 6497
11,6494,4,4,1, 6498
2,6498,2,2,1, 6500
1,6501,1,1,1, 6502
3,6502,3,3,1, 6505
26,6502,3,3,1, 6505
7,6507,1,1,1, 6508
24,6509,1,1,1, 6510
8,6511,1,1,0, 6512
2,6513,2,2,1, 6515
1,6516,1,1,1, 6517
3,6517,3,3,1, 6520
7,6522,1,1,0, 6523
24,6524,1,1,0, 6525
19,6521,5,5,1, 6526
8,6526,1,1,0, 6527
9,6527,2,2,1, 6529
17,6529,3,3,1, 6532
1,6531,1,1,0, 6532
15,6531,2,2,1, 6533
31,6531,2,2,1, 6533
3,6532,3,3,1, 6535
7,6537,1,1,0, 6538
24,6539,1,1,0, 6540
7,6642,1,1,0, 6643
24,6644,1,1,1, 6645
8,6646,1,1,1, 6647
14,6649,3,3,1, 6652
1,6651,1,1,0, 6652
31,6651,2,2,1, 6653
7,6657,1,1,0, 6658
24,6659,1,1,0, 6660
8,6661,1,1,1, 6662
9,6662,2,2,1, 6664
2,6663,2,2,1, 6665
16,6664,2,2,1, 6666
25,6665,2,2,1, 6667
1,6666,1,1,1, 6667
24,6674,1,1,0, 6675
9,6677,2,2,1, 6679
25,6680,2,2,1, 6682
1,6681,1,1,1, 6682
24,6689,1,1,0, 6690
16,6694,2,2,1, 6696
1,6696,1,1,0, 6697
24,6704,1,1,1, 6705
1,6711,1,1,1, 6712
24,6719,1,1,0, 6720
16,6724,2,2,1, 6726
24,6734,1,1,0, 6735
24,6749,1,1,1, 6750
7,6762,1,1,1, 6763
24,6764,1,1,1, 6765
15,6771,2,2,1, 6773
6,6775,2,2,1, 6777
7,6777,1,1,0, 6778
22,6776,4,4,1, 6780
24,6779,1,1,0, 6780
8,6781,1,1,0, 6782
9,6782,2,2,1, 6784
17,6784,3,3,1, 6787
1,6786,1,1,0, 6787
8,6796,1,1,1, 6797
9,6797,2,2,1, 6799
2,6798,2,2,1, 6800
1,6801,1,1,0, 6802
8,6811,1,1,1, 6812
1,6816,1,1,1, 6817
26,6817,3,3,1, 6820
8,6826,1,1,0, 6827
17,6829,3,3,1, 6832
25,6830,2,2,1, 6832
1,6831,1,1,1, 6832
26,6832,3,3,1, 6835
8,6841,1,1,0, 6842
8,6856,1,1,1, 6857
8,6871,1,1,0, 6872
7,6882,1,1,1, 6883
24,6884,1,1,0, 6885
8,6886,1,1,0, 6887
15,6891,2,2,1, 6893
31,6891,2,2,1, 6893
7,6897,1,1,0, 6898
24,6899,1,1,0, 6900
8,6901,1,1,1, 6902
14,6904,3,3,1, 6907
25,6905,2,2,1, 6907
13,6904,4,4,1, 6908
15,6906,2,2,1, 6908
31,6906,2,2,1, 6908
7,6912,1,1,1, 6913
24,6914,1,1,1, 6915
8,6916,1,1,1, 6917
9,6917,2,2,1, 6919
15,6921,2,2,1, 6923
31,6921,2,2,1, 6923
24,6929,1,1,0, 6930
8,6931,1,1,0, 6932
9,6932,2,2,1, 6934
24,6944,1,1,1, 6945
25,6950,2,2,1, 6952
1,6951,1,1,0, 6952
24,6959,1,1,0, 6960
2,6963,2,2,1, 6965
1,6966,1,1,0, 6967
24,6974,1,1,1, 6975
1,6981,1,1,0, 6982
24,6989,1,1,1, 6990
1,6996,1,1,0, 6997
24,7004,1,1,1, 7005
1,7011,1,1,1, 7012
15,7011,2,4,1, 7015
24,7019,1,1,1, 7020
23,7018,3,3,1, 7021
8,7021,1,1,0, 7022
1,7026,1,1,0, 7027
7,7032,1,1,0, 7033
8,7036,1,1,0, 7037
9,7037,2,2,1, 7039
1,7041,1,1,0, 7042
15,7041,2,2,1, 7043
7,7047,1,1,0, 7048
8,7051,1,1,0, 7052
30,7053,3,3,1, 7056
1,7056,1,1,1, 7057
15,7056,2,2,1, 7058
31,7056,2,2,1, 7058
7,7062,1,1,1, 7063
8,7066,1,1,0, 7067
9,7067,2,2,1, 7069
30,7068,3,3,1, 7071
14,7069,3,3,1, 7072
1,7071,1,1,1, 7072
15,7071,2,2,1, 7073
31,7071,2,2,1, 7073
5,7072,3,5,1, 7077
7,7077,1,1,0, 7078
8,7081,1,1,0, 7082
9,7082,2,2,1, 7084
1,7086,1,1,1, 7087
7,7092,1,1,1, 7093
1,7101,1,1,1, 7102
7,7107,1,1,0, 7108
1,7116,1,1,0, 7117
7,7122,1,1,0, 7123
2,7128,2,2,1, 7130
25,7130,2,2,1, 7132
1,7131,1,1,0, 7132
28,7129,5,5,1, 7134
3,7132,3,3,1, 7135
12,7130,5,7,1, 7137
4,7131,4,6,1, 7137
7,7137,1,1,1, 7138
24,7139,1,1,0, 7140
23,7138,3,3,1, 7141
8,7141,1,1,1, 7142
16,7144,2,2,1, 7146
14,7144,3,3,1, 7147
6,7150,2,2,1, 7152
7,7152,1,1,0, 7153
22,7151,4,4,1, 7155
24,7154,1,1,0, 7155
8,7156,1,1,1, 7157
16,7159,2,2,1, 7161
15,7161,2,2,1, 7163
31,7161,2,2,1, 7163
6,7165,2,2,1, 7167
7,7167,1,1,0, 7168
24,7169,1,1,1, 7170
16,7174,2,2,1, 7176
15,7176,2,2,1, 7178
7,7182,1,1,1, 7183
24,7184,1,1,0, 7185
7,7197,1,1,1, 7198
24,7199,1,1,0, 7200
15,7206,2,2,1, 7208
6,7210,2,2,1, 7212
7,7212,1,1,0, 7213
24,7214,1,1,0, 7215
16,7219,2,2,1, 7221
7,7227,1,1,1, 7228
24,7229,1,1,0, 7230
15,7236,2,2,1, 7238
6,7240,2,2,1, 7242
7,7242,1,1,1, 7243
24,7244,1,1,1, 7245
16,7249,2,2,1, 7251
1,7251,1,1,1, 7252
15,7251,2,2,1, 7253
2,7248,2,6,1, 7254
6,7255,2,2,1, 7257
7,7257,1,1,0, 7258
3,7252,3,7,1, 7259
24,7259,1,1,1, 7260
23,7258,3,3,1, 7261
16,7264,2,2,1, 7266
1,7266,1,1,0, 7267
31,7266,2,4,1, 7270
8,7276,1,1,0, 7277
14,7279,3,3,1, 7282
1,7281,1,1,1, 7282
15,7281,2,2,1, 7283
5,7282,3,5,1, 7287
23,7288,3,3,1, 7291
8,7291,1,1,0, 7292
9,7292,2,2,1, 7294
16,7294,2,2,1, 7296
14,7294,3,3,1, 7297
25,7295,2,2,1, 7297
1,7296,1,1,0, 7297
15,7296,2,2,1, 7298
31,7296,2,4,1, 7300
5,7297,3,5,1, 7302
23,7303,3,3,1, 7306
8,7306,1,1,0, 7307
25,7310,2,2,1, 7312
1,7311,1,1,1, 7312
31,7311,2,4,1, 7315
22,7316,4,4,1, 7320
14,7324,3,3,1, 7327
7,7332,1,1,1, 7333
22,7331,4,4,1, 7335
7,7347,1,1,0, 7348
7,7362,1,1,1, 7363
24,7364,1,1,1, 7365
3,7372,3,5,1, 7377
26,7372,3,5,1, 7377
7,7377,1,1,1, 7378
20,7373,6,6,1, 7379
24,7379,1,1,1, 7380
8,7381,1,1,0, 7382
2,7383,2,2,1, 7385
1,7386,1,1,1, 7387
7,7392,1,1,1, 7393
24,7394,1,1,1, 7395
8,7396,1,1,0, 7397
9,7397,2,2,1, 7399
1,7401,1,1,0, 7402
7,7407,1,1,1, 7408
24,7409,1,1,0, 7410
8,7411,1,1,0, 7412
9,7412,2,2,1, 7414
1,7416,1,1,1, 7417
7,7422,1,1,0, 7423
24,7424,1,1,0, 7425
8,7426,1,1,0, 7427
2,7428,2,2,1, 7430
1,7431,1,1,1, 7432
7,7437,1,1,0, 7438
24,7439,1,1,0, 7440
23,7438,3,3,1, 7441
8,7441,1,1,1, 7442
15,7446,2,2,1, 7448
6,7450,2,2,1, 7452
7,7452,1,1,0, 7453
24,7454,1,1,1, 7455
8,7456,1,1,0, 7457
7,7467,1,1,0, 7468
24,7469,1,1,1, 7470
8,7471,1,1,1, 7472
15,7476,2,2,1, 7478
6,7480,2,2,1, 7482
7,7482,1,1,0, 7483
24,7484,1,1,0, 7485
8,7486,1,1,1, 7487
2,7488,2,4,1, 7492
25,7490,2,2,1, 7492
28,7489,5,5,1, 7494
26,7492,3,3,1, 7495
13,7489,4,8,1, 7497
7,7497,1,1,1, 7498
20,7493,6,6,1, 7499
24,7499,1,1,1, 7500
8,7501,1,1,1, 7502
1,7506,1,1,1, 7507
8,7516,1,1,0, 7517
16,7519,2,2,1, 7521
1,7521,1,1,0, 7522
8,7531,1,1,0, 7532
16,7534,2,2,1, 7536
1,7536,1,1,1, 7537
8,7546,1,1,0, 7547
1,7551,1,1,1, 7552
8,7561,1,1,1, 7562
16,7564,2,2,1, 7566
1,7566,1,1,1, 7567
8,7576,1,1,1, 7577
16,7579,2,2,1, 7581
1,7581,1,1,1, 7582
8,7591,1,1,1, 7592
16,7594,2,2,1, 7596
1,7596,1,1,1, 7597
8,7606,1,1,1, 7607
14,7609,3,3,1, 7612
25,7610,2,2,1, 7612
1,7611,1,1,1, 7612
3,7612,3,5,1, 7617
18,7613,4,4,1, 7617
7,7617,1,1,0, 7618
20,7613,6,6,1, 7619
29,7613,4,6,1, 7619
24,7619,1,1,1, 7620
19,7616,5,5,1, 7621
21,7617,5,5,1, 7622
9,7622,2,2,1, 7624
24,7634,1,1,1, 7635
24,7649,1,1,0, 7650
24,7664,1,1,1, 7665
31,7671,2,2,1, 7673
24,7679,1,1,0, 7680
31,7686,2,2,1, 7688
24,7694,1,1,0, 7695
24,7709,1,1,0, 7710
24,7724,1,1,0, 7725
23,7723,3,3,1, 7726
9,7727,2,4,1, 7731
27,7727,4,4,1, 7731
16,7729,2,2,1, 7731
17,7729,3,3,1, 7732
25,7730,2,2,1, 7732
1,7731,1,1,1, 7732
26,7732,3,3,1, 7735
4,7731,4,6,1, 7737
7,7737,1,1,0, 7738
5,7732,3,7,1, 7739
6,7735,2,4,1, 7739
22,7736,4,4,1, 7740
24,7739,1,1,1, 7740
8,7741,1,1,1, 7742
7,7752,1,1,0, 7753
8,7756,1,1,0, 7757
7,7767,1,1,1, 7768
8,7771,1,1,0, 7772
7,7782,1,1,0, 7783
8,7786,1,1,1, 7787
7,7797,1,1,1, 7798
8,7801,1,1,1, 7802
7,7812,1,1,0, 7813
8,7816,1,1,0, 7817
7,7827,1,1,1, 7828
8,7831,1,1,0, 7832
7,7842,1,1,0, 7843
24,7844,1,1,0, 7845
8,7846,1,1,1, 7847
9,7847,2,4,1, 7851
1,7851,1,1,1, 7852
31,7851,2,2,1, 7853
12,7850,5,5,1, 7855
6,7855,2,2,1, 7857
7,7857,1,1,1, 7858
20,7853,6,6,1, 7859
24,7859,1,1,1, 7860
19,7856,5,5,1, 7861
11,7859,4,4,1, 7863
1,7866,1,1,0, 7867
31,7866,2,2,1, 7868
7,7872,1,1,1, 7873
24,7874,1,1,0, 7875
1,7881,1,1,1, 7882
31,7881,2,2,1, 7883
7,7887,1,1,0, 7888
24,7889,1,1,1, 7890
1,7896,1,1,0, 7897
31,7896,2,2,1, 7898
7,7902,1,1,1, 7903
24,7904,1,1,1, 7905
1,7911,1,1,0, 7912
7,7917,1,1,0, 7918
24,7919,1,1,1, 7920
8,7921,1,1,0, 7922
9,7922,2,2,1, 7924
1,7926,1,1,1, 7927
7,7932,1,1,0, 7933
24,7934,1,1,0, 7935
8,7936,1,1,0, 7937
1,7941,1,1,0, 7942
31,7941,2,2,1, 7943
7,7947,1,1,0, 7948
24,7949,1,1,1, 7950
8,7951,1,1,1, 7952
1,7956,1,1,0, 7957
31,7956,2,2,1, 7958
7,7962,1,1,1, 7963
24,7964,1,1,0, 7965
8,7966,1,1,0, 7967
30,7968,3,3,1, 7971
1,7971,1,1,0, 7972
15,7971,2,2,1, 7973
31,7971,2,2,1, 7973
7,7977,1,1,1, 7978
24,7979,1,1,1, 7980
25,7985,2,2,1, 7987
1,7986,1,1,0, 7987
1,8001,1,1,1, 8002
25,8015,2,2,1, 8017
1,8016,1,1,0, 8017
1,8031,1,1,0, 8032
19,8036,5,5,1, 8041
7,8082,1,1,1, 8083
24,8084,1,1,1, 8085
8,8086,1,1,0, 8087
9,8087,2,2,1, 8089
14,8089,3,3,1, 8092
17,8089,3,3,1, 8092
7,8097,1,1,0, 8098
22,8096,4,4,1, 8100
24,8099,1,1,1, 8100
8,8101,1,1,1, 8102
24,8114,1,1,0, 8115
8,8116,1,1,1, 8117
25,8120,2,2,1, 8122
24,8129,1,1,1, 8130
8,8131,1,1,1, 8132
25,8135,2,2,1, 8137
24,8144,1,1,1, 8145
8,8146,1,1,0, 8147
25,8150,2,2,1, 8152
1,8151,1,1,0, 8152
24,8159,1,1,1, 8160
8,8161,1,1,0, 8162
9,8162,2,2,1, 8164
1,8166,1,1,0, 8167
24,8174,1,1,1, 8175
8,8176,1,1,0, 8177
9,8177,2,2,1, 8179
1,8181,1,1,0, 8182
24,8189,1,1,0, 8190
8,8191,1,1,1, 8192
2,8193,2,2,1, 8195
1,8196,1,1,0, 8197
24,8204,1,1,0, 8205
8,8206,1,1,0, 8207
2,8208,2,2,1, 8210
1,8211,1,1,0, 8212
31,8211,2,2,1, 8213
7,8217,1,1,1, 8218
24,8219,1,1,1, 8220
2,8223,2,2,1, 8225
25,8225,2,2,1, 8227
1,8226,1,1,0, 8227
31,8226,2,2,1, 8228
6,8230,2,2,1, 8232
7,8232,1,1,0, 8233
1,8241,1,1,0, 8242
31,8241,2,2,1, 8243
6,8245,2,2,1, 8247
7,8247,1,1,0, 8248
1,8256,1,1,1, 8257
5,8257,3,3,1, 8260
6,8260,2,2,1, 8262
7,8262,1,1,1, 8263
1,8271,1,1,0, 8272
5,8272,3,3,1, 8275
26,8272,3,3,1, 8275
4,8271,4,6,1, 8277
3,8272,3,5,1, 8277
6,8275,2,2,1, 8277
7,8277,1,1,0, 8278
1,8286,1,1,0, 8287
1,8301,1,1,1, 8302
1,8316,1,1,0, 8317
24,8324,1,1,1, 8325
8,8326,1,1,1, 8327
9,8327,2,2,1, 8329
17,8329,3,3,1, 8332
1,8331,1,1,1, 8332
31,8331,2,2,1, 8333
24,8339,1,1,1, 8340
8,8341,1,1,0, 8342
9,8342,2,2,1, 8344
1,8346,1,1,0, 8347
24,8354,1,1,0, 8355
8,8356,1,1,0, 8357
1,8361,1,1,0, 8362
24,8369,1,1,1, 8370
8,8371,1,1,0, 8372
9,8372,2,2,1, 8374
1,8376,1,1,0, 8377
7,8382,1,1,1, 8383
24,8384,1,1,0, 8385
8,8386,1,1,1, 8387
9,8387,2,2,1, 8389
1,8391,1,1,1, 8392
7,8397,1,1,1, 8398
24,8399,1,1,1, 8400
8,8401,1,1,1, 8402
7,8412,1,1,0, 8413
24,8414,1,1,0, 8415
8,8416,1,1,0, 8417
7,8427,1,1,0, 8428
24,8429,1,1,0, 8430
8,8431,1,1,1, 8432
7,8442,1,1,1, 8443
24,8444,1,1,0, 8445
8,8446,1,1,0, 8447
7,8457,1,1,1, 8458
24,8459,1,1,0, 8460
8,8461,1,1,0, 8462
16,8464,2,2,1, 8466
31,8466,2,2,1, 8468
7,8472,1,1,0, 8473
24,8474,1,1,1, 8475
23,8473,3,3,1, 8476
8,8476,1,1,1, 8477
31,8481,2,2,1, 8483
7,8487,1,1,1, 8488
24,8489,1,1,0, 8490
23,8488,3,3,1, 8491
8,8491,1,1,0, 8492
31,8496,2,2,1, 8498
7,8502,1,1,0, 8503
24,8504,1,1,1, 8505
23,8503,3,3,1, 8506
8,8506,1,1,0, 8507
9,8507,2,2,1, 8509
1,8511,1,1,0, 8512
15,8511,2,2,1, 8513
31,8511,2,2,1, 8513
26,8512,3,3,1, 8515
7,8517,1,1,0, 8518
24,8519,1,1,0, 8520
19,8516,5,5,1, 8521
23,8518,3,3,1, 8521
15,8526,2,2,1, 8528
6,8530,2,2,1, 8532
7,8532,1,1,0, 8533
7,8547,1,1,0, 8548
7,8562,1,1,0, 8563
7,8577,1,1,1, 8578
9,8582,2,2,1, 8584
2,8583,2,2,1, 8585
1,8586,1,1,1, 8587
7,8592,1,1,1, 8593
9,8597,2,2,1, 8599
1,8601,1,1,1, 8602
7,8607,1,1,0, 8608
9,8612,2,2,1, 8614
2,8613,2,2,1, 8615
1,8616,1,1,0, 8617
7,8622,1,1,0, 8623
23,8623,3,3,1, 8626
8,8626,1,1,0, 8627
9,8627,2,2,1, 8629
16,8629,2,2,1, 8631
25,8630,2,2,1, 8632
1,8631,1,1,0, 8632
31,8631,2,2,1, 8633
7,8637,1,1,0, 8638
24,8639,1,1,1, 8640
23,8638,3,3,1, 8641
8,8641,1,1,0, 8642
16,8644,2,2,1, 8646
7,8652,1,1,0, 8653
24,8654,1,1,1, 8655
8,8656,1,1,1, 8657
7,8667,1,1,1, 8668
24,8669,1,1,1, 8670
8,8671,1,1,0, 8672
16,8674,2,2,1, 8676
7,8682,1,1,0, 8683
24,8684,1,1,0, 8685
8,8686,1,1,0, 8687
7,8697,1,1,0, 8698
24,8699,1,1,1, 8700
8,8701,1,1,0, 8702
16,8704,2,2,1, 8706
24,8714,1,1,0, 8715
8,8716,1,1,1, 8717
24,8729,1,1,1, 8730
8,8731,1,1,0, 8732
16,8734,2,2,1, 8736
24,8744,1,1,0, 8745
8,8746,1,1,1, 8747
9,8747,2,2,1, 8749
1,8751,1,1,1, 8752
24,8759,1,1,1, 8760
8,8761,1,1,0, 8762
9,8762,2,2,1, 8764
1,8766,1,1,1, 8767
7,8772,1,1,0, 8773
24,8774,1,1,1, 8775
9,8777,2,2,1, 8779
1,8781,1,1,0, 8782
6,8785,2,2,1, 8787
7,8787,1,1,0, 8788
24,8789,1,1,1, 8790
1,8796,1,1,0, 8797
31,8796,2,2,1, 8798
7,8802,1,1,1, 8803
24,8804,1,1,0, 8805
1,8811,1,1,1, 8812
15,8811,2,4,1, 8815
7,8817,1,1,1, 8818
22,8816,4,4,1, 8820
24,8819,1,1,1, 8820
8,8821,1,1,1, 8822
11,8819,4,6,1, 8825
2,8823,2,2,1, 8825
1,8826,1,1,0, 8827
31,8826,2,2,1, 8828
24,8834,1,1,1, 8835
8,8836,1,1,1, 8837
1,8841,1,1,0, 8842
15,8841,2,2,1, 8843
31,8841,2,2,1, 8843
24,8849,1,1,1, 8850
8,8851,1,1,0, 8852
2,8853,2,2,1, 8855
1,8856,1,1,1, 8857
15,8856,2,2,1, 8858
24,8864,1,1,0, 8865
8,8866,1,1,0, 8867
25,8870,2,2,1, 8872
1,8871,1,1,1, 8872
26,8872,3,3,1, 8875
18,8873,4,4,1, 8877
24,8879,1,1,0, 8880
7,8922,1,1,1, 8923
14,8929,3,3,1, 8932
6,8935,2,2,1, 8937
7,8937,1,1,1, 8938
15,8946,2,2,1, 8948
7,8952,1,1,0, 8953
30,8958,3,3,1, 8961
7,8967,1,1,1, 8968
30,8973,3,3,1, 8976
7,8982,1,1,0, 8983
24,8984,1,1,1, 8985
8,8986,1,1,1, 8987
16,8989,2,2,1, 8991
17,8989,3,3,1, 8992
1,8991,1,1,0, 8992
31,8991,2,2,1, 8993
7,8997,1,1,1, 8998
24,8999,1,1,1, 9000
23,8998,3,3,1, 9001
8,9001,1,1,1, 9002
16,9004,2,2,1, 9006
14,9004,3,3,1, 9007
1,9006,1,1,1, 9007
15,9006,2,2,1, 9008
24,9014,1,1,1, 9015
8,9016,1,1,1, 9017
14,9019,3,3,1, 9022
17,9019,3,3,1, 9022
1,9021,1,1,1, 9022
24,9029,1,1,1, 9030
8,9031,1,1,0, 9032
14,9034,3,3,1, 9037
17,9034,3,3,1, 9037
25,9035,2,2,1, 9037
1,9036,1,1,1, 9037
15,9036,2,2,1, 9038
24,9044,1,1,0, 9045
8,9046,1,1,0, 9047
16,9049,2,2,1, 9051
14,9049,3,3,1, 9052
25,9050,2,2,1, 9052
1,9051,1,1,0, 9052
24,9059,1,1,0, 9060
8,9061,1,1,1, 9062
1,9066,1,1,0, 9067
5,9067,3,3,1, 9070
8,9076,1,1,1, 9077
1,9081,1,1,1, 9082
8,9091,1,1,1, 9092
1,9096,1,1,0, 9097
8,9106,1,1,0, 9107
9,9107,2,2,1, 9109
16,9109,2,2,1, 9111
1,9111,1,1,1, 9112
24,9164,1,1,0, 9165
30,9168,3,5,1, 9173
7,9177,1,1,1, 9178
22,9176,4,4,1, 9180
24,9179,1,1,1, 9180
8,9181,1,1,1, 9182
9,9182,2,2,1, 9184
2,9183,2,2,1, 9185
1,9186,1,1,0, 9187
15,9186,2,2,1, 9188
7,9192,1,1,1, 9193
24,9194,1,1,0, 9195
8,9196,1,1,1, 9197
9,9197,2,2,1, 9199
1,9201,1,1,1, 9202
7,9207,1,1,0, 9208
24,9209,1,1,0, 9210
8,9211,1,1,0, 9212
2,9213,2,2,1, 9215
1,9216,1,1,0, 9217
15,9216,2,2,1, 9218
7,9222,1,1,0, 9223
24,9224,1,1,1, 9225
8,9226,1,1,0, 9227
9,9227,2,2,1, 9229
1,9231,1,1,0, 9232
7,9237,1,1,1, 9238
24,9239,1,1,1, 9240
7,9252,1,1,1, 9253
7,9267,1,1,1, 9268
7,9282,1,1,0, 9283
29,9293,4,4,1, 9297
6,9295,2,2,1, 9297
7,9297,1,1,0, 9298
1,9306,1,1,1, 9307
26,9307,3,3,1, 9310
7,9312,1,1,0, 9313
20,9308,6,6,1, 9314
25,9320,2,2,1, 9322
1,9321,1,1,0, 9322
18,9323,4,4,1, 9327
7,9327,1,1,0, 9328
1,9336,1,1,0, 9337
7,9342,1,1,1, 9343
24,9344,1,1,0, 9345
8,9346,1,1,0, 9347
9,9347,2,2,1, 9349
1,9351,1,1,1, 9352
15,9351,2,2,1, 9353
7,9357,1,1,0, 9358
24,9359,1,1,0, 9360
8,9361,1,1,1, 9362
16,9364,2,2,1, 9366
1,9366,1,1,1, 9367
7,9372,1,1,0, 9373
24,9374,1,1,0, 9375
8,9376,1,1,1, 9377
9,9377,2,2,1, 9379
1,9381,1,1,0, 9382
7,9387,1,1,1, 9388
24,9389,1,1,0, 9390
8,9391,1,1,0, 9392
9,9392,2,2,1, 9394
1,9396,1,1,1, 9397
7,9402,1,1,1, 9403
24,9404,1,1,1, 9405
8,9406,1,1,0, 9407
9,9407,2,2,1, 9409
16,9409,2,2,1, 9411
1,9411,1,1,1, 9412
6,9415,2,2,1, 9417
7,9417,1,1,1, 9418
24,9419,1,1,0, 9420
9,9422,2,2,1, 9424
16,9424,2,2,1, 9426
1,9426,1,1,1, 9427
24,9434,1,1,1, 9435
9,9437,2,2,1, 9439
16,9439,2,2,1, 9441
1,9441,1,1,0, 9442
24,9449,1,1,0, 9450
2,9453,2,2,1, 9455
1,9456,1,1,1, 9457
24,9464,1,1,1, 9465
16,9469,2,2,1, 9471
25,9470,2,2,1, 9472
1,9471,1,1,1, 9472
31,9471,2,2,1, 9473
17,9469,3,5,1, 9474
24,9479,1,1,1, 9480
15,9486,2,2,1, 9488
5,9487,3,3,1, 9490
6,9490,2,2,1, 9492
7,9492,1,1,1, 9493
7,9507,1,1,0, 9508
15,9516,2,2,1, 9518
7,9522,1,1,1, 9523
14,9529,3,3,1, 9532
15,9531,2,2,1, 9533
5,9532,3,3,1, 9535
6,9535,2,2,1, 9537
7,9537,1,1,0, 9538
8,9541,1,1,0, 9542
9,9542,2,2,1, 9544
8,9556,1,1,1, 9557
8,9571,1,1,1, 9572
24,9584,1,1,1, 9585
8,9586,1,1,0, 9587
9,9587,2,2,1, 9589
1,9591,1,1,1, 9592
31,9591,2,2,1, 9593
24,9599,1,1,0, 9600
8,9601,1,1,1, 9602
30,9603,3,3,1, 9606
1,9606,1,1,1, 9607
31,9606,2,2,1, 9608
24,9614,1,1,1, 9615
8,9616,1,1,1, 9617
2,9618,2,2,1, 9620
16,9619,2,2,1, 9621
1,9621,1,1,0, 9622
31,9621,2,2,1, 9623
24,9629,1,1,1, 9630
8,9631,1,1,1, 9632
1,9636,1,1,1, 9637
31,9636,2,2,1, 9638
7,9642,1,1,1, 9643
24,9644,1,1,0, 9645
8,9646,1,1,1, 9647
2,9648,2,2,1, 9650
1,9651,1,1,0, 9652
15,9651,2,2,1, 9653
31,9651,2,2,1, 9653
7,9657,1,1,0, 9658
24,9659,1,1,1, 9660
8,9661,1,1,0, 9662
1,9666,1,1,0, 9667
15,9666,2,2,1, 9668
5,9667,3,3,1, 9670
7,9672,1,1,0, 9673
24,9674,1,1,0, 9675
8,9676,1,1,0, 9677
2,9678,2,2,1, 9680
16,9679,2,2,1, 9681
1,9681,1,1,0, 9682
24,9689,1,1,1, 9690
8,9691,1,1,0, 9692
2,9693,2,2,1, 9695
16,9694,2,2,1, 9696
1,9696,1,1,1, 9697
15,9696,2,2,1, 9698
26,9697,3,3,1, 9700
20,9698,6,6,1, 9704
24,9704,1,1,0, 9705
8,9706,1,1,0, 9707
27,9707,4,4,1, 9711
17,9709,3,3,1, 9712
1,9711,1,1,1, 9712
3,9712,3,3,1, 9715
26,9712,3,3,1, 9715
24,9719,1,1,1, 9720
19,9716,5,5,1, 9721
7,9792,1,1,1, 9793
31,9801,2,2,1, 9803
6,9805,2,2,1, 9807
7,9807,1,1,0, 9808
7,9822,1,1,1, 9823
24,9824,1,1,1, 9825
8,9826,1,1,0, 9827
1,9831,1,1,0, 9832
26,9832,3,3,1, 9835
18,9833,4,4,1, 9837
7,9837,1,1,1, 9838
24,9839,1,1,1, 9840
8,9841,1,1,1, 9842
1,9846,1,1,0, 9847
26,9847,3,3,1, 9850
6,9850,2,2,1, 9852
7,9852,1,1,1, 9853
24,9854,1,1,1, 9855
8,9856,1,1,1, 9857
1,9861,1,1,1, 9862
26,9862,3,3,1, 9865
6,9865,2,2,1, 9867
7,9867,1,1,1, 9868
24,9869,1,1,1, 9870
8,9871,1,1,1, 9872
9,9872,2,2,1, 9874
16,9874,2,2,1, 9876
14,9874,3,3,1, 9877
1,9876,1,1,1, 9877
18,9878,4,4,1, 9882
6,9880,2,2,1, 9882
7,9882,1,1,1, 9883
24,9884,1,1,0, 9885
8,9886,1,1,1, 9887
16,9889,2,2,1, 9891
14,9889,3,3,1, 9892
1,9891,1,1,1, 9892
18,9893,4,4,1, 9897
7,9897,1,1,1, 9898
24,9899,1,1,0, 9900
8,9901,1,1,1, 9902
9,9902,2,2,1, 9904
7,9912,1,1,0, 9913
24,9914,1,1,1, 9915
8,9916,1,1,1, 9917
9,9917,2,2,1, 9919
7,9927,1,1,0, 9928
24,9929,1,1,1, 9930
8,9931,1,1,1, 9932
9,9932,2,2,1, 9934
7,9942,1,1,1, 9943
24,9944,1,1,1, 9945
8,9946,1,1,1, 9947
7,9957,1,1,1, 9958
24,9959,1,1,0, 9960
8,9961,1,1,1, 9962
14,9964,3,3,1, 9967
25,9965,2,2,1, 9967
1,9966,1,1,0, 9967
15,9966,2,2,1, 9968
7,9972,1,1,1, 9973
22,9971,4,4,1, 9975
24,9974,1,1,1, 9975
8,9976,1,1,0, 9977
17,9979,3,3,1, 9982
25,9980,2,2,1, 9982
1,9981,1,1,0, 9982
15,9981,2,2,1, 9983
7,9987,1,1,1, 9988
22,9986,4,4,1, 9990
24,9989,1,1,0, 9990
23,9988,3,3,1, 9991
8,9991,1,1,1, 9992
9,9992,2,2,1, 9994
14,9994,3,3,1, 9997
17,9994,3,3,1, 9997
25,9995,2,2,1, 9997
1,9996,1,1,0, 9997
7,10002,1,1,0, 10003
22,10001,4,4,1, 10005
24,10004,1,1,0, 10005
8,10006,1,1,1, 10007
1,10011,1,1,1, 10012
18,10013,4,4,1, 10017
24,10019,1,1,1, 10020
8,10021,1,1,0, 10022
1,10026,1,1,1, 10027
8,10036,1,1,0, 10037
1,10041,1,1,0, 10042
8,10051,1,1,1, 10052
1,10056,1,1,1, 10057
8,10066,1,1,1, 10067
1,10071,1,1,0, 10072
8,10081,1,1,0, 10082
1,10086,1,1,0, 10087
8,10096,1,1,1, 10097
1,10101,1,1,1, 10102
8,10111,1,1,0, 10112
2,10113,2,2,1, 10115
1,10116,1,1,1, 10117
7,10122,1,1,1, 10123
8,10126,1,1,0, 10127
2,10128,2,2,1, 10130
30,10128,3,3,1, 10131
16,10129,2,2,1, 10131
14,10129,3,3,1, 10132
17,10129,3,3,1, 10132
1,10131,1,1,0, 10132
15,10131,2,2,1, 10133
7,10137,1,1,1, 10138
22,10136,4,4,1, 10140
24,10139,1,1,1, 10140
7,10152,1,1,1, 10153
24,10154,1,1,0, 10155
16,10159,2,2,1, 10161
7,10167,1,1,1, 10168
24,10169,1,1,1, 10170
16,10174,2,2,1, 10176
7,10182,1,1,0, 10183
24,10184,1,1,0, 10185
7,10197,1,1,0, 10198
24,10199,1,1,0, 10200
7,10212,1,1,0, 10213
24,10214,1,1,0, 10215
16,10219,2,2,1, 10221
7,10227,1,1,0, 10228
24,10229,1,1,1, 10230
16,10234,2,2,1, 10236
7,10242,1,1,1, 10243
24,10244,1,1,0, 10245
8,10246,1,1,0, 10247
9,10247,2,2,1, 10249
14,10249,3,3,1, 10252
1,10251,1,1,1, 10252
15,10251,2,2,1, 10253
18,10253,4,4,1, 10257
7,10257,1,1,0, 10258
22,10256,4,4,1, 10260
24,10259,1,1,0, 10260
8,10261,1,1,1, 10262
1,10266,1,1,0, 10267
7,10272,1,1,1, 10273
8,10276,1,1,1, 10277
1,10281,1,1,1, 10282
7,10287,1,1,0, 10288
8,10291,1,1,0, 10292
1,10296,1,1,1, 10297
7,10302,1,1,0, 10303
8,10306,1,1,1, 10307
1,10311,1,1,0, 10312
31,10311,2,2,1, 10313
7,10317,1,1,0, 10318
8,10321,1,1,0, 10322
1,10326,1,1,0, 10327
7,10332,1,1,0, 10333
8,10336,1,1,0, 10337
1,10341,1,1,1, 10342
31,10341,2,2,1, 10343
7,10347,1,1,0, 10348
8,10351,1,1,1, 10352
1,10356,1,1,0, 10357
31,10356,2,2,1, 10358
7,10362,1,1,1, 10363
24,10364,1,1,1, 10365
8,10366,1,1,0, 10367
9,10367,2,2,1, 10369
14,10369,3,3,1, 10372
1,10371,1,1,1, 10372
13,10369,4,4,1, 10373
26,10372,3,3,1, 10375
6,10375,2,2,1, 10377
7,10377,1,1,0, 10378
24,10379,1,1,0, 10380
23,10378,3,3,1, 10381
24,10394,1,1,1, 10395
16,10399,2,2,1, 10401
24,10409,1,1,1, 10410
24,10424,1,1,0, 10425
24,10439,1,1,0, 10440
24,10454,1,1,0, 10455
24,10469,1,1,1, 10470
7,10482,1,1,0, 10483
24,10484,1,1,1, 10485
8,10486,1,1,1, 10487
2,10488,2,4,1, 10492
17,10489,3,3,1, 10492
1,10491,1,1,1, 10492
15,10491,2,2,1, 10493
26,10492,3,3,1, 10495
7,10497,1,1,1, 10498
24,10499,1,1,1, 10500
8,10501,1,1,0, 10502
1,10506,1,1,1, 10507
7,10512,1,1,0, 10513
8,10516,1,1,1, 10517
1,10521,1,1,0, 10522
31,10521,2,2,1, 10523
7,10527,1,1,1, 10528
8,10531,1,1,0, 10532
1,10536,1,1,0, 10537
7,10542,1,1,1, 10543
8,10546,1,1,0, 10547
1,10551,1,1,1, 10552
31,10551,2,2,1, 10553
7,10557,1,1,0, 10558
8,10561,1,1,0, 10562
16,10564,2,2,1, 10566
1,10566,1,1,1, 10567
7,10572,1,1,1, 10573
8,10576,1,1,1, 10577
16,10579,2,2,1, 10581
1,10581,1,1,1, 10582
31,10581,2,2,1, 10583
7,10587,1,1,0, 10588
8,10591,1,1,0, 10592
16,10594,2,2,1, 10596
1,10596,1,1,0, 10597
7,10602,1,1,1, 10603
8,10606,1,1,1, 10607
2,10608,2,2,1, 10610
30,10608,3,3,1, 10611
14,10609,3,3,1, 10612
25,10610,2,2,1, 10612
1,10611,1,1,0, 10612
18,10613,4,4,1, 10617
6,10615,2,2,1, 10617
7,10617,1,1,1, 10618
24,10619,1,1,1, 10620
23,10618,3,3,1, 10621
8,10621,1,1,0, 10622
9,10622,2,2,1, 10624
25,10625,2,2,1, 10627
31,10626,2,2,1, 10628
24,10634,1,1,0, 10635
8,10636,1,1,1, 10637
9,10637,2,2,1, 10639
24,10649,1,1,1, 10650
8,10651,1,1,0, 10652
24,10664,1,1,0, 10665
8,10666,1,1,1, 10667
9,10667,2,2,1, 10669
31,10671,2,2,1, 10673
24,10679,1,1,0, 10680
8,10681,1,1,0, 10682
9,10682,2,2,1, 10684
25,10685,2,2,1, 10687
31,10686,2,2,1, 10688
24,10694,1,1,0, 10695
8,10696,1,1,0, 10697
9,10697,2,2,1, 10699
24,10709,1,1,1, 10710
8,10711,1,1,0, 10712
9,10712,2,2,1, 10714
25,10715,2,2,1, 10717
7,10722,1,1,0, 10723
24,10724,1,1,1, 10725
8,10726,1,1,0, 10727
2,10728,2,4,1, 10732
14,10729,3,3,1, 10732
1,10731,1,1,0, 10732
15,10731,2,2,1, 10733
18,10733,4,4,1, 10737
6,10735,2,2,1, 10737
7,10737,1,1,0, 10738
24,10739,1,1,0, 10740
23,10738,3,3,1, 10741
1,10746,1,1,1, 10747
7,10752,1,1,1, 10753
1,10761,1,1,0, 10762
7,10767,1,1,0, 10768
1,10776,1,1,0, 10777
7,10782,1,1,1, 10783
1,10791,1,1,1, 10792
7,10797,1,1,0, 10798
1,10806,1,1,1, 10807
7,10812,1,1,0, 10813
1,10821,1,1,0, 10822
7,10827,1,1,0, 10828
1,10836,1,1,0, 10837
7,10842,1,1,1, 10843
24,10844,1,1,0, 10845
8,10846,1,1,1, 10847
9,10847,2,2,1, 10849
30,10848,3,3,1, 10851
16,10849,2,2,1, 10851
25,10850,2,2,1, 10852
1,10851,1,1,1, 10852
15,10851,2,2,1, 10853
3,10852,3,3,1, 10855
18,10853,4,4,1, 10857
6,10855,2,2,1, 10857
7,10857,1,1,0, 10858
24,10859,1,1,1, 10860
24,10874,1,1,1, 10875
31,10881,2,2,1, 10883
24,10889,1,1,1, 10890
31,10896,2,2,1, 10898
24,10904,1,1,1, 10905
24,10919,1,1,1, 10920
24,10934,1,1,0, 10935
31,10941,2,2,1, 10943
24,10949,1,1,0, 10950
31,10956,2,2,1, 10958
7,10962,1,1,0, 10963
24,10964,1,1,0, 10965
23,10963,3,3,1, 10966
8,10966,1,1,0, 10967
16,10969,2,2,1, 10971
25,10970,2,2,1, 10972
1,10971,1,1,1, 10972
15,10971,2,2,1, 10973
3,10972,3,3,1, 10975
7,10977,1,1,0, 10978
6,10975,2,4,1, 10979
24,10979,1,1,0, 10980
8,10981,1,1,1, 10982
9,10982,2,2,1, 10984
7,10992,1,1,0, 10993
8,10996,1,1,0, 10997
9,10997,2,2,1, 10999
31,11001,2,2,1, 11003
7,11007,1,1,1, 11008
8,11011,1,1,0, 11012
16,11014,2,2,1, 11016
31,11016,2,2,1, 11018
7,11022,1,1,0, 11023
8,11026,1,1,1, 11027
16,11029,2,2,1, 11031
7,11037,1,1,0, 11038
8,11041,1,1,1, 11042
16,11044,2,2,1, 11046
7,11052,1,1,1, 11053
8,11056,1,1,1, 11057
16,11059,2,2,1, 11061
31,11061,2,2,1, 11063
7,11067,1,1,0, 11068
8,11071,1,1,1, 11072
16,11074,2,2,1, 11076
31,11076,2,2,1, 11078
7,11082,1,1,0, 11083
24,11084,1,1,1, 11085
8,11086,1,1,0, 11087
2,11088,2,2,1, 11090
1,11091,1,1,1, 11092
15,11091,2,2,1, 11093
3,11092,3,3,1, 11095
26,11092,3,3,1, 11095
18,11093,4,4,1, 11097
7,11097,1,1,0, 11098
24,11099,1,1,1, 11100
23,11098,3,3,1, 11101
16,11104,2,2,1, 11106
1,11106,1,1,1, 11107
24,11114,1,1,1, 11115
16,11119,2,2,1, 11121
1,11121,1,1,0, 11122
24,11129,1,1,0, 11130
16,11134,2,2,1, 11136
1,11136,1,1,1, 11137
24,11144,1,1,0, 11145
16,11149,2,2,1, 11151
1,11151,1,1,1, 11152
24,11159,1,1,0, 11160
9,11162,2,2,1, 11164
1,11166,1,1,0, 11167
24,11174,1,1,0, 11175
16,11179,2,2,1, 11181
1,11181,1,1,0, 11182
24,11189,1,1,1, 11190
9,11192,2,2,1, 11194
16,11194,2,2,1, 11196
1,11196,1,1,0, 11197
24,11204,1,1,0, 11205
1,11211,1,1,1, 11212
31,11211,2,2,1, 11213
5,11212,3,3,1, 11215
26,11212,3,3,1, 11215
6,11215,2,2,1, 11217
7,11217,1,1,0, 11218
24,11219,1,1,1, 11220
23,11218,3,3,1, 11221
31,11226,2,2,1, 11228
7,11232,1,1,0, 11233
7,11247,1,1,1, 11248
7,11262,1,1,1, 11263
8,11266,1,1,1, 11267
16,11269,2,2,1, 11271
31,11271,2,2,1, 11273
7,11277,1,1,1, 11278
8,11281,1,1,1, 11282
9,11282,2,2,1, 11284
16,11284,2,2,1, 11286
31,11286,2,2,1, 11288
7,11292,1,1,0, 11293
8,11296,1,1,0, 11297
9,11297,2,2,1, 11299
16,11299,2,2,1, 11301
7,11307,1,1,1, 11308
8,11311,1,1,1, 11312
16,11314,2,2,1, 11316
31,11316,2,2,1, 11318
7,11322,1,1,0, 11323
8,11326,1,1,0, 11327
9,11327,2,2,1, 11329
25,11330,2,2,1, 11332
1,11331,1,1,0, 11332
3,11332,3,3,1, 11335
7,11337,1,1,1, 11338
24,11339,1,1,1, 11340
1,11346,1,1,1, 11347
24,11354,1,1,1, 11355
1,11361,1,1,1, 11362
24,11369,1,1,0, 11370
1,11376,1,1,0, 11377
24,11384,1,1,0, 11385
1,11391,1,1,1, 11392
24,11399,1,1,1, 11400
1,11406,1,1,1, 11407
24,11414,1,1,0, 11415
1,11421,1,1,0, 11422
24,11429,1,1,1, 11430
1,11436,1,1,0, 11437
24,11444,1,1,1, 11445
8,11446,1,1,1, 11447
30,11448,3,3,1, 11451
16,11449,2,2,1, 11451
17,11449,3,3,1, 11452
1,11451,1,1,0, 11452
13,11449,4,4,1, 11453
15,11451,2,2,1, 11453
31,11451,2,2,1, 11453
3,11452,3,3,1, 11455
26,11452,3,3,1, 11455
18,11453,4,4,1, 11457
6,11455,2,2,1, 11457
7,11457,1,1,1, 11458
24,11459,1,1,0, 11460
8,11461,1,1,0, 11462
31,11466,2,2,1, 11468
7,11472,1,1,0, 11473
24,11474,1,1,1, 11475
8,11476,1,1,0, 11477
7,11487,1,1,1, 11488
24,11489,1,1,1, 11490
8,11491,1,1,1, 11492
7,11502,1,1,0, 11503
24,11504,1,1,0, 11505
8,11506,1,1,1, 11507
7,11517,1,1,0, 11518
24,11519,1,1,0, 11520
8,11521,1,1,1, 11522
31,11526,2,2,1, 11528
7,11532,1,1,1, 11533
24,11534,1,1,1, 11535
8,11536,1,1,0, 11537
7,11547,1,1,1, 11548
24,11549,1,1,0, 11550
8,11551,1,1,0, 11552
31,11556,2,2,1, 11558
7,11562,1,1,1, 11563
24,11564,1,1,0, 11565
8,11566,1,1,1, 11567
9,11567,2,2,1, 11569
2,11568,2,2,1, 11570
30,11568,3,3,1, 11571
16,11569,2,2,1, 11571
17,11569,3,3,1, 11572
25,11570,2,2,1, 11572
1,11571,1,1,1, 11572
13,11569,4,4,1, 11573
26,11572,3,3,1, 11575
6,11575,2,2,1, 11577
7,11577,1,1,0, 11578
24,11579,1,1,1, 11580
24,11684,1,1,0, 11685
8,11686,1,1,0, 11687
9,11687,2,2,1, 11689
14,11689,3,3,1, 11692
1,11691,1,1,0, 11692
5,11692,3,3,1, 11695
26,11692,3,3,1, 11695
7,11697,1,1,0, 11698
24,11699,1,1,0, 11700
8,11701,1,1,0, 11702
7,11712,1,1,1, 11713
24,11714,1,1,0, 11715
8,11716,1,1,0, 11717
7,11727,1,1,0, 11728
24,11729,1,1,0, 11730
8,11731,1,1,0, 11732
9,11732,2,2,1, 11734
7,11742,1,1,1, 11743
24,11744,1,1,1, 11745
8,11746,1,1,1, 11747
7,11757,1,1,1, 11758
24,11759,1,1,0, 11760
8,11761,1,1,1, 11762
7,11772,1,1,0, 11773
24,11774,1,1,1, 11775
8,11776,1,1,1, 11777
15,11781,2,2,1, 11783
7,11787,1,1,1, 11788
24,11789,1,1,0, 11790
8,11791,1,1,0, 11792
7,11802,1,1,0, 11803
24,11804,1,1,1, 11805
8,11806,1,1,1, 11807
16,11809,2,2,1, 11811
14,11809,3,3,1, 11812
1,11811,1,1,1, 11812
15,11811,2,2,1, 11813
3,11812,3,3,1, 11815
18,11813,4,4,1, 11817
7,11817,1,1,0, 11818
24,11819,1,1,1, 11820
16,11824,2,2,1, 11826
1,11826,1,1,0, 11827
5,11827,3,3,1, 11830
7,11832,1,1,0, 11833
24,11834,1,1,0, 11835
16,11839,2,2,1, 11841
1,11841,1,1,0, 11842
31,11841,2,2,1, 11843
5,11842,3,3,1, 11845
6,11845,2,2,1, 11847
7,11847,1,1,1, 11848
24,11849,1,1,1, 11850
16,11854,2,2,1, 11856
1,11856,1,1,1, 11857
24,11864,1,1,1, 11865
16,11869,2,2,1, 11871
1,11871,1,1,1, 11872
31,11871,2,2,1, 11873
24,11879,1,1,0, 11880
1,11886,1,1,1, 11887
31,11886,2,2,1, 11888
24,11894,1,1,0, 11895
1,11901,1,1,0, 11902
24,11909,1,1,1, 11910
1,11916,1,1,1, 11917
24,11924,1,1,0, 11925
1,11931,1,1,1, 11932
30,11928,3,5,1, 11933
6,11935,2,4,1, 11939
24,11939,1,1,0, 11940
7,11952,1,1,0, 11953
15,11961,2,2,1, 11963
7,11967,1,1,1, 11968
7,11982,1,1,0, 11983
15,11991,2,2,1, 11993
7,11997,1,1,0, 11998
7,12012,1,1,1, 12013
6,12025,2,2,1, 12027
7,12027,1,1,0, 12028
7,12042,1,1,0, 12043
24,12044,1,1,1, 12045
8,12046,1,1,0, 12047
9,12047,2,2,1, 12049
2,12048,2,4,1, 12052
17,12049,3,3,1, 12052
25,12050,2,2,1, 12052
1,12051,1,1,0, 12052
7,12057,1,1,1, 12058
24,12059,1,1,0, 12060
8,12061,1,1,0, 12062
14,12064,3,3,1, 12067
24,12074,1,1,0, 12075
8,12076,1,1,0, 12077
16,12079,2,2,1, 12081
14,12079,3,3,1, 12082
24,12089,1,1,0, 12090
8,12091,1,1,1, 12092
31,12096,2,2,1, 12098
24,12104,1,1,1, 12105
8,12106,1,1,0, 12107
15,12111,2,2,1, 12113
24,12119,1,1,0, 12120
8,12121,1,1,1, 12122
16,12124,2,2,1, 12126
24,12134,1,1,0, 12135
31,12141,2,2,1, 12143
24,12149,1,1,0, 12150
16,12154,2,2,1, 12156
7,12162,1,1,0, 12163
24,12164,1,1,1, 12165
23,12163,3,3,1, 12166
9,12167,2,2,1, 12169
25,12170,2,2,1, 12172
1,12171,1,1,1, 12172
31,12171,2,2,1, 12173
26,12172,3,3,1, 12175
18,12173,4,4,1, 12177
6,12175,2,2,1, 12177
7,12177,1,1,0, 12178
24,12179,1,1,0, 12180
23,12178,3,3,1, 12181
24,12284,1,1,1, 12285
8,12286,1,1,1, 12287
14,12289,3,3,1, 12292
1,12291,1,1,1, 12292
26,12292,3,3,1, 12295
18,12293,4,4,1, 12297
7,12297,1,1,0, 12298
22,12296,4,4,1, 12300
24,12299,1,1,0, 12300
23,12298,3,3,1, 12301
8,12301,1,1,0, 12302
16,12304,2,2,1, 12306
1,12306,1,1,1, 12307
7,12312,1,1,1, 12313
24,12314,1,1,0, 12315
8,12316,1,1,1, 12317
1,12321,1,1,1, 12322
7,12327,1,1,1, 12328
24,12329,1,1,0, 12330
8,12331,1,1,1, 12332
1,12336,1,1,0, 12337
7,12342,1,1,1, 12343
24,12344,1,1,0, 12345
8,12346,1,1,0, 12347
1,12351,1,1,0, 12352
7,12357,1,1,0, 12358
24,12359,1,1,1, 12360
8,12361,1,1,0, 12362
16,12364,2,2,1, 12366
1,12366,1,1,0, 12367
7,12372,1,1,1, 12373
24,12374,1,1,1, 12375
8,12376,1,1,1, 12377
16,12379,2,2,1, 12381
1,12381,1,1,1, 12382
7,12387,1,1,1, 12388
24,12389,1,1,1, 12390
8,12391,1,1,0, 12392
16,12394,2,2,1, 12396
1,12396,1,1,1, 12397
7,12402,1,1,0, 12403
24,12404,1,1,1, 12405
8,12406,1,1,1, 12407
14,12409,3,3,1, 12412
1,12411,1,1,0, 12412
31,12411,2,2,1, 12413
5,12412,3,3,1, 12415
26,12412,3,3,1, 12415
6,12415,2,2,1, 12417
7,12417,1,1,0, 12418
24,12419,1,1,1, 12420
8,12421,1,1,0, 12422
25,12425,2,2,1, 12427
1,12426,1,1,1, 12427
8,12436,1,1,0, 12437
25,12440,2,2,1, 12442
1,12441,1,1,0, 12442
8,12451,1,1,0, 12452
25,12455,2,2,1, 12457
1,12456,1,1,0, 12457
8,12466,1,1,0, 12467
1,12471,1,1,0, 12472
8,12481,1,1,1, 12482
25,12485,2,2,1, 12487
1,12486,1,1,0, 12487
8,12496,1,1,0, 12497
25,12500,2,2,1, 12502
1,12501,1,1,1, 12502
8,12511,1,1,0, 12512
25,12515,2,2,1, 12517
1,12516,1,1,1, 12517
7,12522,1,1,0, 12523
24,12524,1,1,1, 12525
8,12526,1,1,0, 12527
2,12528,2,2,1, 12530
14,12529,3,3,1, 12532
25,12530,2,2,1, 12532
1,12531,1,1,0, 12532
15,12531,2,2,1, 12533
5,12532,3,5,1, 12537
7,12537,1,1,0, 12538
24,12539,1,1,1, 12540
8,12541,1,1,0, 12542
9,12542,2,2,1, 12544
7,12552,1,1,1, 12553
24,12554,1,1,1, 12555
8,12556,1,1,1, 12557
9,12557,2,2,1, 12559
7,12567,1,1,0, 12568
24,12569,1,1,1, 12570
8,12571,1,1,1, 12572
7,12582,1,1,0, 12583
24,12584,1,1,1, 12585
8,12586,1,1,0, 12587
9,12587,2,2,1, 12589
7,12597,1,1,0, 12598
24,12599,1,1,1, 12600
8,12601,1,1,1, 12602
9,12602,2,2,1, 12604
7,12612,1,1,0, 12613
24,12614,1,1,1, 12615
8,12616,1,1,0, 12617
7,12627,1,1,0, 12628
24,12629,1,1,1, 12630
8,12631,1,1,1, 12632
7,12642,1,1,1, 12643
24,12644,1,1,0, 12645
8,12646,1,1,0, 12647
9,12647,2,2,1, 12649
2,12648,2,4,1, 12652
17,12649,3,3,1, 12652
1,12651,1,1,0, 12652
30,12648,3,5,1, 12653
31,12651,2,2,1, 12653
18,12653,4,4,1, 12657
7,12657,1,1,1, 12658
24,12659,1,1,0, 12660
16,12664,2,2,1, 12666
1,12666,1,1,0, 12667
24,12674,1,1,0, 12675
9,12677,2,2,1, 12679
16,12679,2,2,1, 12681
1,12681,1,1,1, 12682
24,12689,1,1,1, 12690
9,12692,2,2,1, 12694
16,12694,2,2,1, 12696
1,12696,1,1,0, 12697
31,12696,2,2,1, 12698
24,12704,1,1,1, 12705
9,12707,2,2,1, 12709
16,12709,2,2,1, 12711
1,12711,1,1,1, 12712
31,12711,2,2,1, 12713
24,12719,1,1,0, 12720
1,12726,1,1,1, 12727
9,12737,2,2,1, 12739
1,12741,1,1,0, 12742
1,12756,1,1,0, 12757
7,12762,1,1,0, 12763
16,12769,2,2,1, 12771
1,12771,1,1,1, 12772
15,12771,2,2,1, 12773
26,12772,3,3,1, 12775
7,12777,1,1,1, 12778
23,12778,3,3,1, 12781
8,12781,1,1,1, 12782
7,12792,1,1,1, 12793
8,12796,1,1,0, 12797
5,12802,3,3,1, 12805
6,12805,2,2,1, 12807
7,12807,1,1,0, 12808
8,12811,1,1,0, 12812
6,12820,2,2,1, 12822
7,12822,1,1,1, 12823
8,12826,1,1,1, 12827
5,12832,3,3,1, 12835
7,12837,1,1,0, 12838
8,12841,1,1,1, 12842
6,12850,2,2,1, 12852
7,12852,1,1,1, 12853
8,12856,1,1,1, 12857
5,12862,3,3,1, 12865
7,12867,1,1,1, 12868
8,12871,1,1,0, 12872
7,12882,1,1,0, 12883
8,12886,1,1,1, 12887
16,12889,2,2,1, 12891
14,12889,3,3,1, 12892
1,12891,1,1,1, 12892
15,12891,2,2,1, 12893
3,12892,3,3,1, 12895
5,12892,3,3,1, 12895
6,12895,2,2,1, 12897
7,12897,1,1,1, 12898
24,12899,1,1,0, 12900
23,12898,3,3,1, 12901
31,12906,2,2,1, 12908
24,12914,1,1,1, 12915
24,12929,1,1,1, 12930
24,12944,1,1,0, 12945
24,12959,1,1,0, 12960
31,12966,2,2,1, 12968
24,12974,1,1,0, 12975
31,12981,2,2,1, 12983
24,12989,1,1,0, 12990
24,13004,1,1,1, 13005
8,13006,1,1,1, 13007
2,13008,2,2,1, 13010
16,13009,2,2,1, 13011
1,13011,1,1,1, 13012
3,13012,3,3,1, 13015
5,13012,3,3,1, 13015
26,13012,3,3,1, 13015
6,13015,2,2,1, 13017
7,13017,1,1,0, 13018
24,13019,1,1,0, 13020
8,13021,1,1,0, 13022
1,13026,1,1,0, 13027
8,13036,1,1,0, 13037
2,13038,2,2,1, 13040
1,13041,1,1,0, 13042
8,13051,1,1,0, 13052
1,13056,1,1,1, 13057
8,13066,1,1,1, 13067
1,13071,1,1,0, 13072
8,13081,1,1,0, 13082
2,13083,2,2,1, 13085
1,13086,1,1,0, 13087
8,13096,1,1,1, 13097
1,13101,1,1,1, 13102
8,13111,1,1,1, 13112
1,13116,1,1,0, 13117
8,13126,1,1,1, 13127
2,13128,2,2,1, 13130
16,13129,2,2,1, 13131
17,13129,3,3,1, 13132
1,13131,1,1,1, 13132
13,13129,4,4,1, 13133
15,13131,2,2,1, 13133
3,13132,3,3,1, 13135
26,13132,3,3,1, 13135
7,13137,1,1,1, 13138
6,13135,2,4,1, 13139
22,13136,4,4,1, 13140
24,13139,1,1,0, 13140
23,13138,3,3,1, 13141
7,13152,1,1,1, 13153
24,13154,1,1,1, 13155
7,13167,1,1,0, 13168
24,13169,1,1,0, 13170
7,13182,1,1,1, 13183
24,13184,1,1,0, 13185
7,13197,1,1,0, 13198
24,13199,1,1,0, 13200
7,13212,1,1,1, 13213
24,13214,1,1,1, 13215
7,13227,1,1,0, 13228
24,13229,1,1,1, 13230
7,13242,1,1,1, 13243
24,13244,1,1,0, 13245
8,13246,1,1,0, 13247
14,13249,3,3,1, 13252
17,13249,3,3,1, 13252
25,13250,2,2,1, 13252
1,13251,1,1,0, 13252
31,13251,2,2,1, 13253
3,13252,3,3,1, 13255
26,13252,3,3,1, 13255
18,13253,4,4,1, 13257
7,13257,1,1,1, 13258
6,13255,2,4,1, 13259
24,13259,1,1,0, 13260
8,13261,1,1,1, 13262
7,13272,1,1,0, 13273
8,13276,1,1,0, 13277
7,13287,1,1,0, 13288
8,13291,1,1,1, 13292
16,13294,2,2,1, 13296
7,13302,1,1,0, 13303
8,13306,1,1,0, 13307
7,13317,1,1,0, 13318
8,13321,1,1,1, 13322
16,13324,2,2,1, 13326
31,13326,2,2,1, 13328
7,13332,1,1,0, 13333
8,13336,1,1,0, 13337
16,13339,2,2,1, 13341
7,13347,1,1,0, 13348
8,13351,1,1,1, 13352
7,13362,1,1,1, 13363
24,13364,1,1,1, 13365
8,13366,1,1,0, 13367
2,13368,2,2,1, 13370
14,13369,3,3,1, 13372
17,13369,3,3,1, 13372
1,13371,1,1,0, 13372
26,13372,3,3,1, 13375
7,13377,1,1,0, 13378
22,13376,4,4,1, 13380
24,13379,1,1,1, 13380
7,13482,1,1,1, 13483
24,13484,1,1,1, 13485
23,13483,3,3,1, 13486
8,13486,1,1,1, 13487
14,13489,3,3,1, 13492
17,13489,3,3,1, 13492
25,13490,2,2,1, 13492
1,13491,1,1,1, 13492
3,13492,3,3,1, 13495
7,13497,1,1,1, 13498
24,13499,1,1,0, 13500
8,13501,1,1,0, 13502
16,13504,2,2,1, 13506
1,13506,1,1,1, 13507
31,13506,2,2,1, 13508
7,13512,1,1,1, 13513
24,13514,1,1,1, 13515
8,13516,1,1,0, 13517
25,13520,2,2,1, 13522
1,13521,1,1,1, 13522
31,13521,2,2,1, 13523
7,13527,1,1,1, 13528
8,13531,1,1,1, 13532
16,13534,2,2,1, 13536
25,13535,2,2,1, 13537
1,13536,1,1,1, 13537
7,13542,1,1,1, 13543
8,13546,1,1,0, 13547
1,13551,1,1,1, 13552
31,13551,2,2,1, 13553
7,13557,1,1,0, 13558
8,13561,1,1,0, 13562
25,13565,2,2,1, 13567
1,13566,1,1,0, 13567
7,13572,1,1,0, 13573
8,13576,1,1,0, 13577
25,13580,2,2,1, 13582
1,13581,1,1,1, 13582
31,13581,2,2,1, 13583
7,13587,1,1,1, 13588
8,13591,1,1,1, 13592
16,13594,2,2,1, 13596
1,13596,1,1,0, 13597
31,13596,2,2,1, 13598
7,13602,1,1,0, 13603
8,13606,1,1,1, 13607
2,13608,2,2,1, 13610
16,13609,2,2,1, 13611
17,13609,3,3,1, 13612
1,13611,1,1,1, 13612
15,13611,2,2,1, 13613
3,13612,3,3,1, 13615
7,13617,1,1,0, 13618
8,13621,1,1,0, 13622
31,13626,2,2,1, 13628
7,13632,1,1,1, 13633
24,13634,1,1,1, 13635
8,13636,1,1,0, 13637
9,13637,2,2,1, 13639
24,13649,1,1,0, 13650
8,13651,1,1,0, 13652
31,13656,2,2,1, 13658
24,13664,1,1,0, 13665
8,13666,1,1,0, 13667
31,13671,2,2,1, 13673
24,13679,1,1,1, 13680
8,13681,1,1,0, 13682
9,13682,2,2,1, 13684
25,13685,2,2,1, 13687
24,13694,1,1,1, 13695
8,13696,1,1,1, 13697
9,13697,2,2,1, 13699
16,13699,2,2,1, 13701
24,13709,1,1,0, 13710
8,13711,1,1,1, 13712
16,13714,2,2,1, 13716
24,13724,1,1,0, 13725
8,13726,1,1,0, 13727
16,13729,2,2,1, 13731
1,13731,1,1,0, 13732
26,13732,3,3,1, 13735
18,13733,4,4,1, 13737
24,13739,1,1,0, 13740
14,13744,3,3,1, 13747
1,13746,1,1,0, 13747
13,13744,4,4,1, 13748
7,13752,1,1,0, 13753
24,13754,1,1,0, 13755
1,13761,1,1,1, 13762
7,13767,1,1,0, 13768
24,13769,1,1,0, 13770
1,13776,1,1,1, 13777
7,13782,1,1,0, 13783
24,13784,1,1,1, 13785
1,13791,1,1,0, 13792
7,13797,1,1,0, 13798
24,13799,1,1,1, 13800
1,13806,1,1,0, 13807
13,13804,4,4,1, 13808
15,13806,2,2,1, 13808
6,13810,2,2,1, 13812
24,13814,1,1,1, 13815
1,13821,1,1,1, 13822
24,13829,1,1,0, 13830
1,13836,1,1,0, 13837
24,13844,1,1,0, 13845
1,13851,1,1,0, 13852
3,13852,3,3,1, 13855
18,13853,4,4,1, 13857
24,13859,1,1,1, 13860
8,13861,1,1,0, 13862
31,13866,2,2,1, 13868
7,13872,1,1,0, 13873
24,13874,1,1,0, 13875
8,13876,1,1,1, 13877
15,13881,2,2,1, 13883
7,13887,1,1,1, 13888
24,13889,1,1,0, 13890
8,13891,1,1,1, 13892
15,13896,2,2,1, 13898
7,13902,1,1,0, 13903
24,13904,1,1,1, 13905
8,13906,1,1,1, 13907
25,13910,2,2,1, 13912
15,13911,2,2,1, 13913
31,13911,2,2,1, 13913
7,13917,1,1,0, 13918
24,13919,1,1,0, 13920
23,13918,3,3,1, 13921
8,13921,1,1,1, 13922
8,13936,1,1,1, 13937
8,13951,1,1,0, 13952
8,13966,1,1,1, 13967
1,13971,1,1,0, 13972
3,13972,3,3,1, 13975
26,13972,3,3,1, 13975
18,13973,4,4,1, 13977
8,13981,1,1,1, 13982
9,13982,2,2,1, 13984
1,13986,1,1,1, 13987
24,13994,1,1,0, 13995
8,13996,1,1,0, 13997
1,14001,1,1,1, 14002
24,14009,1,1,1, 14010
8,14011,1,1,0, 14012
16,14014,2,2,1, 14016
1,14016,1,1,0, 14017
7,14022,1,1,1, 14023
24,14024,1,1,0, 14025
8,14026,1,1,0, 14027
16,14029,2,2,1, 14031
1,14031,1,1,0, 14032
31,14031,2,2,1, 14033
7,14037,1,1,1, 14038
24,14039,1,1,1, 14040
1,14046,1,1,0, 14047
7,14052,1,1,1, 14053
24,14054,1,1,0, 14055
16,14059,2,2,1, 14061
1,14061,1,1,0, 14062
7,14067,1,1,0, 14068
24,14069,1,1,1, 14070
16,14074,2,2,1, 14076
1,14076,1,1,0, 14077
31,14076,2,2,1, 14078
7,14082,1,1,1, 14083
24,14084,1,1,0, 14085
1,14091,1,1,1, 14092
7,14097,1,1,0, 14098
24,14099,1,1,1, 14100
6,14110,2,2,1, 14112
7,14112,1,1,0, 14113
31,14121,2,2,1, 14123
6,14125,2,2,1, 14127
7,14127,1,1,0, 14128
8,14206,1,1,1, 14207
2,14208,2,2,1, 14210
25,14210,2,2,1, 14212
1,14211,1,1,1, 14212
15,14211,2,2,1, 14213
26,14212,3,3,1, 14215
24,14219,1,1,1, 14220
23,14218,3,3,1, 14221
8,14221,1,1,0, 14222
1,14226,1,1,1, 14227
6,14230,2,2,1, 14232
7,14232,1,1,0, 14233
24,14234,1,1,1, 14235
8,14236,1,1,0, 14237
1,14241,1,1,1, 14242
7,14247,1,1,0, 14248
24,14249,1,1,1, 14250
8,14251,1,1,0, 14252
1,14256,1,1,1, 14257
31,14256,2,2,1, 14258
7,14262,1,1,0, 14263
24,14264,1,1,0, 14265
8,14266,1,1,1, 14267
1,14271,1,1,0, 14272
7,14277,1,1,0, 14278
24,14279,1,1,0, 14280
8,14281,1,1,0, 14282
1,14286,1,1,1, 14287
7,14292,1,1,1, 14293
24,14294,1,1,0, 14295
8,14296,1,1,0, 14297
1,14301,1,1,0, 14302
31,14301,2,2,1, 14303
7,14307,1,1,0, 14308
24,14309,1,1,0, 14310
8,14311,1,1,0, 14312
1,14316,1,1,0, 14317
7,14322,1,1,0, 14323
24,14324,1,1,1, 14325
8,14326,1,1,1, 14327
9,14327,2,2,1, 14329
16,14329,2,2,1, 14331
25,14330,2,2,1, 14332
1,14331,1,1,0, 14332
26,14332,3,3,1, 14335
7,14337,1,1,1, 14338
24,14339,1,1,1, 14340
23,14338,3,3,1, 14341
8,14341,1,1,1, 14342
8,14356,1,1,0, 14357
16,14359,2,2,1, 14361
8,14371,1,1,0, 14372
16,14374,2,2,1, 14376
8,14386,1,1,1, 14387
24,14444,1,1,0, 14445
9,14447,2,2,1, 14449
2,14448,2,2,1, 14450
1,14451,1,1,0, 14452
15,14451,2,2,1, 14453
31,14451,2,2,1, 14453
3,14452,3,3,1, 14455
6,14455,2,2,1, 14457
7,14457,1,1,0, 14458
22,14456,4,4,1, 14460
24,14459,1,1,1, 14460
1,14466,1,1,1, 14467
15,14466,2,2,1, 14468
7,14472,1,1,0, 14473
24,14474,1,1,0, 14475
1,14481,1,1,0, 14482
7,14487,1,1,0, 14488
24,14489,1,1,0, 14490
1,14496,1,1,1, 14497
15,14496,2,2,1, 14498
7,14502,1,1,1, 14503
24,14504,1,1,1, 14505
8,14506,1,1,0, 14507
1,14511,1,1,0, 14512
15,14511,2,2,1, 14513
7,14517,1,1,0, 14518
24,14519,1,1,1, 14520
8,14521,1,1,1, 14522
1,14526,1,1,0, 14527
7,14532,1,1,1, 14533
24,14534,1,1,1, 14535
8,14536,1,1,1, 14537
1,14541,1,1,1, 14542
7,14547,1,1,1, 14548
24,14549,1,1,1, 14550
8,14551,1,1,0, 14552
1,14556,1,1,1, 14557
7,14562,1,1,0, 14563
24,14564,1,1,0, 14565
8,14566,1,1,0, 14567
25,14570,2,2,1, 14572
1,14571,1,1,1, 14572
26,14572,3,3,1, 14575
7,14577,1,1,0, 14578
24,14579,1,1,1, 14580
8,14581,1,1,1, 14582
16,14584,2,2,1, 14586
24,14594,1,1,1, 14595
8,14596,1,1,0, 14597
31,14601,2,2,1, 14603
24,14609,1,1,0, 14610
8,14611,1,1,0, 14612
31,14616,2,2,1, 14618
24,14624,1,1,0, 14625
8,14626,1,1,1, 14627
31,14631,2,2,1, 14633
24,14639,1,1,0, 14640
8,14641,1,1,0, 14642
24,14654,1,1,1, 14655
8,14656,1,1,1, 14657
31,14661,2,2,1, 14663
24,14669,1,1,1, 14670
8,14671,1,1,0, 14672
7,14682,1,1,1, 14683
24,14684,1,1,1, 14685
8,14686,1,1,1, 14687
9,14687,2,2,1, 14689
14,14689,3,3,1, 14692
25,14690,2,2,1, 14692
1,14691,1,1,1, 14692
13,14689,4,4,1, 14693
15,14691,2,2,1, 14693
3,14692,3,3,1, 14695
7,14697,1,1,0, 14698
24,14699,1,1,1, 14700
6,14695,2,6,1, 14701
8,14701,1,1,0, 14702
25,14705,2,2,1, 14707
1,14706,1,1,1, 14707
7,14712,1,1,0, 14713
8,14716,1,1,1, 14717
25,14720,2,2,1, 14722
1,14721,1,1,1, 14722
7,14727,1,1,1, 14728
8,14731,1,1,0, 14732
1,14736,1,1,1, 14737
7,14742,1,1,0, 14743
8,14746,1,1,0, 14747
25,14750,2,2,1, 14752
1,14751,1,1,0, 14752
7,14757,1,1,0, 14758
8,14761,1,1,1, 14762
25,14765,2,2,1, 14767
1,14766,1,1,1, 14767
31,14766,2,2,1, 14768
7,14772,1,1,1, 14773
8,14776,1,1,0, 14777
1,14781,1,1,1, 14782
31,14781,2,2,1, 14783
7,14787,1,1,0, 14788
8,14791,1,1,0, 14792
1,14796,1,1,0, 14797
7,14802,1,1,0, 14803
8,14806,1,1,1, 14807
9,14807,2,2,1, 14809
2,14808,2,2,1, 14810
27,14807,4,4,1, 14811
25,14810,2,2,1, 14812
1,14811,1,1,0, 14812
30,14808,3,5,1, 14813
15,14811,2,2,1, 14813
31,14811,2,2,1, 14813
3,14812,3,3,1, 14815
26,14812,3,3,1, 14815
6,14815,2,2,1, 14817
7,14817,1,1,1, 14818
24,14819,1,1,1, 14820
21,14817,5,5,1, 14822
24,14834,1,1,0, 14835
24,14849,1,1,1, 14850
24,14864,1,1,0, 14865
24,14879,1,1,0, 14880
8,14881,1,1,1, 14882
16,14884,2,2,1, 14886
24,14894,1,1,0, 14895
8,14896,1,1,0, 14897
9,14897,2,2,1, 14899
16,14899,2,2,1, 14901
24,14909,1,1,1, 14910
7,14922,1,1,1, 14923
24,14924,1,1,1, 14925
9,14927,2,2,1, 14929
17,14929,3,3,1, 14932
25,14930,2,2,1, 14932
1,14931,1,1,0, 14932
26,14932,3,3,1, 14935
7,14937,1,1,1, 14938
24,14939,1,1,1, 14940
23,14938,3,3,1, 14941
1,14946,1,1,0, 14947
31,14946,2,2,1, 14948
7,14952,1,1,0, 14953
24,14954,1,1,0, 14955
1,14961,1,1,0, 14962
7,14967,1,1,1, 14968
24,14969,1,1,0, 14970
1,14976,1,1,0, 14977
7,14982,1,1,1, 14983
24,14984,1,1,0, 14985
1,14991,1,1,1, 14992
31,14991,2,2,1, 14993
7,14997,1,1,1, 14998
24,14999,1,1,1, 15000
1,15006,1,1,0, 15007
31,15006,2,2,1, 15008
7,15012,1,1,1, 15013
24,15014,1,1,1, 15015
8,15016,1,1,0, 15017
1,15021,1,1,1, 15022
31,15021,2,2,1, 15023
7,15027,1,1,1, 15028
24,15029,1,1,0, 15030
8,15031,1,1,0, 15032
1,15036,1,1,1, 15037
7,15042,1,1,0, 15043
24,15044,1,1,1, 15045
8,15046,1,1,1, 15047
2,15048,2,2,1, 15050
27,15047,4,4,1, 15051
1,15051,1,1,1, 15052
31,15051,2,2,1, 15053
6,15055,2,2,1, 15057
7,15057,1,1,1, 15058
24,15059,1,1,0, 15060
8,15061,1,1,0, 15062
16,15064,2,2,1, 15066
25,15065,2,2,1, 15067
1,15066,1,1,0, 15067
15,15066,2,2,1, 15068
8,15076,1,1,0, 15077
8,15091,1,1,0, 15092
8,15106,1,1,0, 15107
8,15121,1,1,0, 15122
16,15124,2,2,1, 15126
8,15136,1,1,0, 15137
16,15139,2,2,1, 15141
8,15151,1,1,0, 15152
16,15154,2,2,1, 15156
15,15156,2,2,1, 15158
24,15164,1,1,0, 15165
23,15163,3,3,1, 15166
8,15166,1,1,0, 15167
16,15169,2,2,1, 15171
15,15171,2,2,1, 15173
7,15177,1,1,0, 15178
29,15173,4,6,1, 15179
22,15176,4,4,1, 15180
24,15179,1,1,1, 15180
23,15178,3,3,1, 15181
21,15177,5,5,1, 15182
25,15185,2,2,1, 15187
1,15186,1,1,1, 15187
7,15192,1,1,1, 15193
24,15194,1,1,0, 15195
1,15201,1,1,1, 15202
7,15207,1,1,1, 15208
24,15209,1,1,0, 15210
1,15216,1,1,0, 15217
7,15222,1,1,0, 15223
24,15224,1,1,0, 15225
25,15230,2,2,1, 15232
1,15231,1,1,0, 15232
7,15237,1,1,1, 15238
24,15239,1,1,1, 15240
25,15245,2,2,1, 15247
1,15246,1,1,1, 15247
7,15252,1,1,0, 15253
1,15261,1,1,1, 15262
31,15261,2,2,1, 15263
7,15267,1,1,1, 15268
25,15275,2,2,1, 15277
1,15276,1,1,0, 15277
7,15282,1,1,1, 15283
2,15288,2,2,1, 15290
25,15290,2,2,1, 15292
1,15291,1,1,0, 15292
26,15292,3,3,1, 15295
7,15297,1,1,0, 15298
7,15312,1,1,1, 15313
7,15327,1,1,1, 15328
15,15336,2,2,1, 15338
7,15342,1,1,1, 15343
24,15344,1,1,0, 15345
8,15346,1,1,0, 15347
16,15349,2,2,1, 15351
15,15351,2,2,1, 15353
7,15357,1,1,1, 15358
24,15359,1,1,0, 15360
8,15361,1,1,1, 15362
9,15362,2,2,1, 15364
1,15366,1,1,1, 15367
31,15366,2,2,1, 15368
24,15374,1,1,1, 15375
8,15376,1,1,0, 15377
9,15377,2,2,1, 15379
1,15381,1,1,0, 15382
31,15381,2,2,1, 15383
26,15382,3,3,1, 15385
18,15383,4,4,1, 15387
24,15389,1,1,1, 15390
8,15391,1,1,1, 15392
1,15396,1,1,0, 15397
18,15398,4,4,1, 15402
24,15404,1,1,0, 15405
8,15406,1,1,0, 15407
2,15408,2,2,1, 15410
16,15409,2,2,1, 15411
1,15411,1,1,1, 15412
31,15411,2,2,1, 15413
26,15412,3,3,1, 15415
24,15419,1,1,0, 15420
14,15424,3,3,1, 15427
7,15432,1,1,0, 15433
24,15434,1,1,0, 15435
6,15445,2,2,1, 15447
7,15447,1,1,1, 15448
24,15449,1,1,1, 15450
16,15454,2,2,1, 15456
14,15454,3,3,1, 15457
7,15462,1,1,1, 15463
24,15464,1,1,0, 15465
14,15469,3,3,1, 15472
15,15471,2,2,1, 15473
31,15471,2,2,1, 15473
6,15475,2,2,1, 15477
7,15477,1,1,0, 15478
24,15479,1,1,0, 15480
8,15481,1,1,0, 15482
2,15483,2,2,1, 15485
17,15484,3,3,1, 15487
1,15486,1,1,0, 15487
24,15494,1,1,1, 15495
8,15496,1,1,1, 15497
9,15497,2,2,1, 15499
1,15501,1,1,0, 15502
24,15509,1,1,0, 15510
8,15511,1,1,0, 15512
9,15512,2,2,1, 15514
2,15513,2,2,1, 15515
25,15515,2,2,1, 15517
1,15516,1,1,1, 15517
24,15524,1,1,1, 15525
8,15526,1,1,0, 15527
9,15527,2,2,1, 15529
25,15530,2,2,1, 15532
1,15531,1,1,1, 15532
3,15532,3,3,1, 15535
26,15532,3,3,1, 15535
18,15533,4,4,1, 15537
24,15539,1,1,1, 15540
8,15541,1,1,1, 15542
9,15542,2,2,1, 15544
16,15544,2,2,1, 15546
8,15556,1,1,0, 15557
16,15559,2,2,1, 15561
14,15559,3,3,1, 15562
7,15582,1,1,0, 15583
6,15595,2,2,1, 15597
7,15597,1,1,0, 15598
6,15610,2,2,1, 15612
7,15612,1,1,1, 15613
7,15627,1,1,1, 15628
7,15642,1,1,0, 15643
24,15644,1,1,0, 15645
16,15649,2,2,1, 15651
1,15651,1,1,0, 15652
7,15657,1,1,0, 15658
24,15659,1,1,0, 15660
2,15663,2,2,1, 15665
1,15666,1,1,1, 15667
7,15672,1,1,0, 15673
24,15674,1,1,0, 15675
8,15676,1,1,0, 15677
17,15679,3,3,1, 15682
25,15680,2,2,1, 15682
1,15681,1,1,0, 15682
7,15687,1,1,1, 15688
24,15689,1,1,1, 15690
8,15691,1,1,0, 15692
17,15694,3,3,1, 15697
1,15696,1,1,0, 15697
7,15702,1,1,1, 15703
24,15704,1,1,1, 15705
8,15706,1,1,0, 15707
14,15709,3,3,1, 15712
25,15710,2,2,1, 15712
1,15711,1,1,0, 15712
15,15711,2,2,1, 15713
7,15717,1,1,1, 15718
24,15719,1,1,0, 15720
23,15718,3,3,1, 15721
8,15721,1,1,0, 15722
1,15726,1,1,1, 15727
31,15726,2,2,1, 15728
6,15730,2,2,1, 15732
7,15732,1,1,0, 15733
8,15736,1,1,1, 15737
1,15741,1,1,0, 15742
7,15747,1,1,1, 15748
8,15751,1,1,0, 15752
1,15756,1,1,0, 15757
31,15756,2,2,1, 15758
7,15762,1,1,1, 15763
8,15766,1,1,1, 15767
9,15767,2,2,1, 15769
1,15771,1,1,1, 15772
3,15772,3,3,1, 15775
7,15777,1,1,0, 15778
8,15781,1,1,0, 15782
9,15782,2,2,1, 15784
31,15786,2,2,1, 15788
7,15792,1,1,0, 15793
8,15796,1,1,0, 15797
9,15797,2,2,1, 15799
31,15801,2,2,1, 15803
7,15807,1,1,0, 15808
8,15811,1,1,1, 15812
31,15816,2,2,1, 15818
7,15822,1,1,0, 15823
24,15824,1,1,1, 15825
8,15826,1,1,0, 15827
16,15829,2,2,1, 15831
15,15831,2,2,1, 15833
7,15837,1,1,0, 15838
24,15839,1,1,1, 15840
23,15838,3,3,1, 15841
8,15841,1,1,0, 15842
24,15854,1,1,1, 15855
8,15856,1,1,0, 15857
24,15869,1,1,1, 15870
8,15871,1,1,1, 15872
31,15876,2,2,1, 15878
24,15884,1,1,1, 15885
8,15886,1,1,0, 15887
9,15887,2,2,1, 15889
2,15888,2,4,1, 15892
1,15891,1,1,1, 15892
31,15891,2,2,1, 15893
18,15893,4,4,1, 15897
24,15899,1,1,1, 15900
8,15901,1,1,1, 15902
1,15906,1,1,0, 15907
8,15916,1,1,0, 15917
1,15921,1,1,0, 15922
8,15931,1,1,1, 15932
1,15936,1,1,0, 15937
8,15946,1,1,0, 15947
1,15951,1,1,1, 15952
7,15957,1,1,1, 15958
22,15956,4,4,1, 15960
23,15958,3,3,1, 15961
8,15961,1,1,0, 15962
1,15966,1,1,0, 15967
31,15966,2,2,1, 15968
6,15970,2,2,1, 15972
7,15972,1,1,1, 15973
8,15976,1,1,0, 15977
1,15981,1,1,0, 15982
7,15987,1,1,0, 15988
8,15991,1,1,0, 15992
1,15996,1,1,0, 15997
7,16002,1,1,1, 16003
24,16004,1,1,0, 16005
8,16006,1,1,1, 16007
2,16008,2,2,1, 16010
25,16010,2,2,1, 16012
1,16011,1,1,0, 16012
31,16011,2,2,1, 16013
26,16012,3,3,1, 16015
7,16017,1,1,0, 16018
24,16019,1,1,0, 16020
8,16021,1,1,0, 16022
31,16026,2,2,1, 16028
7,16032,1,1,1, 16033
24,16034,1,1,1, 16035
8,16036,1,1,1, 16037
9,16037,2,2,1, 16039
31,16041,2,2,1, 16043
7,16047,1,1,0, 16048
24,16049,1,1,1, 16050
8,16051,1,1,1, 16052
9,16052,2,2,1, 16054
7,16062,1,1,1, 16063
24,16064,1,1,1, 16065
8,16066,1,1,0, 16067
31,16071,2,2,1, 16073
7,16077,1,1,1, 16078
22,16076,4,4,1, 16080
24,16079,1,1,1, 16080
15,16086,2,2,1, 16088
7,16092,1,1,0, 16093
24,16094,1,1,1, 16095
7,16107,1,1,0, 16108
24,16109,1,1,1, 16110
23,16108,3,3,1, 16111
7,16122,1,1,1, 16123
24,16124,1,1,0, 16125
2,16128,2,4,1, 16132
14,16129,3,3,1, 16132
25,16130,2,2,1, 16132
1,16131,1,1,1, 16132
3,16132,3,3,1, 16135
18,16133,4,4,1, 16137
7,16137,1,1,1, 16138
24,16139,1,1,0, 16140
8,16141,1,1,1, 16142
9,16142,2,2,1, 16144
1,16146,1,1,0, 16147
7,16152,1,1,0, 16153
24,16154,1,1,0, 16155
8,16156,1,1,0, 16157
1,16161,1,1,0, 16162
7,16167,1,1,1, 16168
24,16169,1,1,1, 16170
8,16171,1,1,0, 16172
9,16172,2,2,1, 16174
1,16176,1,1,1, 16177
7,16182,1,1,1, 16183
24,16184,1,1,0, 16185
8,16186,1,1,1, 16187
9,16187,2,2,1, 16189
1,16191,1,1,0, 16192
7,16197,1,1,0, 16198
24,16199,1,1,1, 16200
1,16206,1,1,1, 16207
31,16206,2,2,1, 16208
6,16210,2,2,1, 16212
7,16212,1,1,0, 16213
1,16221,1,1,0, 16222
7,16227,1,1,1, 16228
1,16236,1,1,1, 16237
31,16236,2,2,1, 16238
7,16242,1,1,0, 16243
1,16251,1,1,0, 16252
7,16257,1,1,0, 16258
8,16261,1,1,0, 16262
16,16264,2,2,1, 16266
1,16266,1,1,0, 16267
8,16276,1,1,1, 16277
1,16281,1,1,0, 16282
8,16291,1,1,1, 16292
16,16294,2,2,1, 16296
1,16296,1,1,0, 16297
15,16296,2,2,1, 16298
24,16304,1,1,0, 16305
8,16306,1,1,0, 16307
25,16310,2,2,1, 16312
1,16311,1,1,1, 16312
31,16311,2,2,1, 16313
26,16312,3,3,1, 16315
24,16319,1,1,0, 16320
9,16322,2,2,1, 16324
16,16324,2,2,1, 16326
1,16326,1,1,1, 16327
24,16334,1,1,1, 16335
1,16341,1,1,1, 16342
24,16349,1,1,0, 16350
9,16352,2,2,1, 16354
16,16354,2,2,1, 16356
1,16356,1,1,1, 16357
7,16362,1,1,0, 16363
24,16364,1,1,0, 16365
23,16363,3,3,1, 16366
2,16368,2,2,1, 16370
16,16369,2,2,1, 16371
14,16369,3,3,1, 16372
1,16371,1,1,1, 16372
15,16371,2,2,1, 16373
3,16372,3,3,1, 16375
6,16375,2,2,1, 16377
7,16377,1,1,0, 16378
22,16376,4,4,1, 16380
24,16379,1,1,0, 16380
23,16378,3,3,1, 16381
16,16384,2,2,1, 16386
24,16394,1,1,0, 16395
31,16401,2,2,1, 16403
24,16409,1,1,1, 16410
16,16414,2,2,1, 16416
24,16424,1,1,1, 16425
8,16426,1,1,1, 16427
9,16427,2,2,1, 16429
16,16429,2,2,1, 16431
25,16430,2,2,1, 16432
31,16431,2,2,1, 16433
24,16439,1,1,0, 16440
8,16441,1,1,1, 16442
9,16442,2,2,1, 16444
16,16444,2,2,1, 16446
8,16456,1,1,0, 16457
9,16457,2,2,1, 16459
8,16471,1,1,0, 16472
9,16472,2,2,1, 16474
8,16486,1,1,1, 16487
9,16487,2,2,1, 16489
16,16489,2,2,1, 16491
1,16491,1,1,0, 16492
15,16491,2,2,1, 16493
31,16491,2,2,1, 16493
26,16492,3,3,1, 16495
18,16493,4,4,1, 16497
7,16497,1,1,1, 16498
23,16498,3,3,1, 16501
8,16501,1,1,1, 16502
25,16505,2,2,1, 16507
1,16506,1,1,1, 16507
7,16512,1,1,1, 16513
17,16519,3,3,1, 16522
1,16521,1,1,1, 16522
7,16527,1,1,0, 16528
17,16534,3,3,1, 16537
25,16535,2,2,1, 16537
1,16536,1,1,0, 16537
16,16534,2,4,1, 16538
7,16542,1,1,0, 16543
24,16544,1,1,0, 16545
25,16550,2,2,1, 16552
1,16551,1,1,1, 16552
7,16557,1,1,0, 16558
24,16559,1,1,0, 16560
1,16566,1,1,1, 16567
7,16572,1,1,1, 16573
24,16574,1,1,0, 16575
16,16579,2,2,1, 16581
1,16581,1,1,0, 16582
7,16587,1,1,0, 16588
24,16589,1,1,0, 16590
16,16594,2,2,1, 16596
1,16596,1,1,0, 16597
7,16602,1,1,1, 16603
24,16604,1,1,1, 16605
1,16611,1,1,1, 16612
15,16611,2,2,1, 16613
31,16611,2,2,1, 16613
7,16617,1,1,1, 16618
24,16619,1,1,1, 16620
8,16621,1,1,0, 16622
1,16626,1,1,1, 16627
24,16634,1,1,0, 16635
8,16636,1,1,1, 16637
1,16641,1,1,1, 16642
31,16641,2,2,1, 16643
24,16649,1,1,0, 16650
8,16651,1,1,1, 16652
9,16652,2,2,1, 16654
1,16656,1,1,1, 16657
31,16656,2,2,1, 16658
24,16664,1,1,1, 16665
8,16666,1,1,1, 16667
9,16667,2,2,1, 16669
1,16671,1,1,1, 16672
31,16671,2,2,1, 16673
24,16679,1,1,1, 16680
8,16681,1,1,0, 16682
1,16686,1,1,0, 16687
31,16686,2,2,1, 16688
24,16694,1,1,1, 16695
8,16696,1,1,0, 16697
9,16697,2,2,1, 16699
1,16701,1,1,1, 16702
24,16709,1,1,0, 16710
8,16711,1,1,1, 16712
1,16716,1,1,1, 16717
31,16716,2,2,1, 16718
7,16722,1,1,1, 16723
24,16724,1,1,1, 16725
8,16726,1,1,1, 16727
2,16728,2,2,1, 16730
25,16730,2,2,1, 16732
1,16731,1,1,0, 16732
31,16731,2,2,1, 16733
7,16737,1,1,0, 16738
6,16735,2,4,1, 16739
22,16736,4,4,1, 16740
24,16739,1,1,0, 16740
23,16738,3,3,1, 16741
7,16752,1,1,0, 16753
7,16767,1,1,0, 16768
7,16782,1,1,1, 16783
7,16797,1,1,1, 16798
7,16812,1,1,0, 16813
7,16827,1,1,1, 16828
7,16842,1,1,0, 16843
24,16844,1,1,0, 16845
8,16846,1,1,1, 16847
14,16849,3,3,1, 16852
25,16850,2,2,1, 16852
1,16851,1,1,1, 16852
31,16851,2,2,1, 16853
3,16852,3,3,1, 16855
6,16855,2,2,1, 16857
7,16857,1,1,0, 16858
24,16859,1,1,1, 16860
23,16858,3,3,1, 16861
8,16861,1,1,1, 16862
7,16872,1,1,1, 16873
24,16874,1,1,1, 16875
8,16876,1,1,0, 16877
25,16880,2,2,1, 16882
6,16885,2,2,1, 16887
7,16887,1,1,0, 16888
24,16889,1,1,0, 16890
8,16891,1,1,0, 16892
6,16900,2,2,1, 16902
7,16902,1,1,0, 16903
24,16904,1,1,1, 16905
8,16906,1,1,1, 16907
6,16915,2,2,1, 16917
7,16917,1,1,1, 16918
24,16919,1,1,0, 16920
8,16921,1,1,1, 16922
7,16932,1,1,0, 16933
24,16934,1,1,1, 16935
8,16936,1,1,0, 16937
25,16940,2,2,1, 16942
7,16947,1,1,1, 16948
24,16949,1,1,0, 16950
8,16951,1,1,1, 16952
6,16960,2,2,1, 16962
7,16962,1,1,0, 16963
24,16964,1,1,0, 16965
8,16966,1,1,0, 16967
9,16967,2,2,1, 16969
2,16968,2,2,1, 16970
14,16969,3,3,1, 16972
1,16971,1,1,0, 16972
26,16972,3,3,1, 16975
7,16977,1,1,1, 16978
24,16979,1,1,0, 16980
16,16984,2,2,1, 16986
1,16986,1,1,1, 16987
31,16986,2,2,1, 16988
1,17001,1,1,0, 17002
1,17016,1,1,0, 17017
1,17031,1,1,1, 17032
1,17046,1,1,1, 17047
7,17052,1,1,1, 17053
1,17061,1,1,0, 17062
31,17061,2,2,1, 17063
7,17067,1,1,1, 17068
1,17076,1,1,0, 17077
31,17076,2,2,1, 17078
7,17082,1,1,0, 17083
8,17086,1,1,0, 17087
9,17087,2,2,1, 17089
14,17089,3,3,1, 17092
17,17089,3,3,1, 17092
1,17091,1,1,0, 17092
13,17089,4,4,1, 17093
6,17095,2,2,1, 17097
7,17097,1,1,0, 17098
24,17099,1,1,0, 17100
23,17098,3,3,1, 17101
8,17101,1,1,1, 17102
7,17112,1,1,0, 17113
24,17114,1,1,1, 17115
8,17116,1,1,0, 17117
7,17127,1,1,1, 17128
24,17129,1,1,1, 17130
8,17131,1,1,0, 17132
7,17142,1,1,0, 17143
24,17144,1,1,1, 17145
8,17146,1,1,1, 17147
7,17157,1,1,0, 17158
24,17159,1,1,0, 17160
8,17161,1,1,1, 17162
7,17172,1,1,1, 17173
24,17174,1,1,0, 17175
8,17176,1,1,1, 17177
7,17187,1,1,0, 17188
24,17189,1,1,1, 17190
8,17191,1,1,1, 17192
7,17202,1,1,1, 17203
24,17204,1,1,0, 17205
8,17206,1,1,1, 17207
9,17207,2,2,1, 17209
2,17208,2,2,1, 17210
14,17209,3,3,1, 17212
1,17211,1,1,0, 17212
3,17212,3,3,1, 17215
18,17213,4,4,1, 17217
6,17215,2,2,1, 17217
7,17217,1,1,0, 17218
24,17219,1,1,0, 17220
1,17226,1,1,1, 17227
24,17234,1,1,0, 17235
1,17241,1,1,1, 17242
31,17241,2,2,1, 17243
24,17249,1,1,1, 17250
1,17256,1,1,0, 17257
31,17256,2,2,1, 17258
24,17264,1,1,0, 17265
1,17271,1,1,0, 17272
24,17279,1,1,0, 17280
1,17286,1,1,1, 17287
24,17294,1,1,1, 17295
1,17301,1,1,1, 17302
24,17309,1,1,1, 17310
1,17316,1,1,0, 17317
24,17324,1,1,1, 17325
8,17326,1,1,1, 17327
9,17327,2,2,1, 17329
2,17328,2,2,1, 17330
16,17329,2,2,1, 17331
17,17329,3,3,1, 17332
25,17330,2,2,1, 17332
1,17331,1,1,0, 17332
31,17331,2,2,1, 17333
3,17332,3,3,1, 17335
26,17332,3,3,1, 17335
18,17333,4,4,1, 17337
6,17335,2,2,1, 17337
7,17337,1,1,0, 17338
24,17339,1,1,0, 17340
8,17341,1,1,0, 17342
7,17352,1,1,0, 17353
31,17361,2,2,1, 17363
7,17367,1,1,0, 17368
31,17376,2,2,1, 17378
7,17382,1,1,1, 17383
7,17397,1,1,0, 17398
7,17412,1,1,0, 17413
31,17421,2,2,1, 17423
7,17427,1,1,1, 17428
31,17436,2,2,1, 17438
7,17442,1,1,0, 17443
24,17444,1,1,0, 17445
9,17447,2,2,1, 17449
16,17449,2,2,1, 17451
17,17449,3,3,1, 17452
1,17451,1,1,1, 17452
15,17451,2,2,1, 17453
3,17452,3,3,1, 17455
26,17452,3,3,1, 17455
7,17457,1,1,1, 17458
24,17459,1,1,0, 17460
23,17458,3,3,1, 17461
8,17461,1,1,1, 17462
6,17470,2,2,1, 17472
7,17472,1,1,0, 17473
24,17474,1,1,1, 17475
8,17476,1,1,0, 17477
6,17485,2,2,1, 17487
7,17487,1,1,0, 17488
24,17489,1,1,0, 17490
8,17491,1,1,1, 17492
6,17500,2,2,1, 17502
7,17502,1,1,1, 17503
24,17504,1,1,0, 17505
8,17506,1,1,0, 17507
7,17517,1,1,0, 17518
24,17519,1,1,0, 17520
8,17521,1,1,0, 17522
7,17532,1,1,1, 17533
24,17534,1,1,1, 17535
8,17536,1,1,1, 17537
6,17545,2,2,1, 17547
7,17547,1,1,0, 17548
24,17549,1,1,1, 17550
8,17551,1,1,1, 17552
6,17560,2,2,1, 17562
7,17562,1,1,1, 17563
24,17564,1,1,1, 17565
8,17566,1,1,0, 17567
9,17567,2,2,1, 17569
2,17568,2,2,1, 17570
16,17569,2,2,1, 17571
14,17569,3,3,1, 17572
25,17570,2,2,1, 17572
1,17571,1,1,0, 17572
31,17571,2,2,1, 17573
3,17572,3,3,1, 17575
18,17573,4,4,1, 17577
7,17577,1,1,1, 17578
24,17579,1,1,1, 17580
23,17578,3,3,1, 17581
8,17581,1,1,1, 17582
8,17596,1,1,1, 17597
8,17611,1,1,0, 17612
8,17626,1,1,0, 17627
8,17641,1,1,1, 17642
7,17652,1,1,1, 17653
8,17656,1,1,0, 17657
31,17661,2,2,1, 17663
7,17667,1,1,1, 17668
8,17671,1,1,1, 17672
31,17676,2,2,1, 17678
7,17682,1,1,1, 17683
24,17684,1,1,1, 17685
8,17686,1,1,0, 17687
2,17688,2,2,1, 17690
16,17689,2,2,1, 17691
1,17691,1,1,0, 17692
31,17691,2,2,1, 17693
26,17692,3,3,1, 17695
7,17697,1,1,1, 17698
24,17699,1,1,0, 17700
24,17714,1,1,1, 17715
31,17721,2,2,1, 17723
24,17729,1,1,1, 17730
24,17744,1,1,1, 17745
31,17751,2,2,1, 17753
24,17759,1,1,1, 17760
24,17774,1,1,0, 17775
24,17789,1,1,0, 17790
7,17802,1,1,1, 17803
24,17804,1,1,0, 17805
8,17806,1,1,0, 17807
2,17808,2,2,1, 17810
16,17809,2,2,1, 17811
14,17809,3,3,1, 17812
25,17810,2,2,1, 17812
1,17811,1,1,0, 17812
13,17809,4,4,1, 17813
15,17811,2,2,1, 17813
31,17811,2,2,1, 17813
3,17812,3,3,1, 17815
26,17812,3,3,1, 17815
18,17813,4,4,1, 17817
7,17817,1,1,0, 17818
22,17816,4,4,1, 17820
24,17819,1,1,0, 17820
8,17821,1,1,1, 17822
16,17824,2,2,1, 17826
25,17825,2,2,1, 17827
1,17826,1,1,0, 17827
7,17832,1,1,0, 17833
8,17836,1,1,0, 17837
25,17840,2,2,1, 17842
1,17841,1,1,1, 17842
7,17847,1,1,1, 17848
8,17851,1,1,1, 17852
16,17854,2,2,1, 17856
25,17855,2,2,1, 17857
1,17856,1,1,0, 17857
31,17856,2,2,1, 17858
7,17862,1,1,1, 17863
8,17866,1,1,0, 17867
25,17870,2,2,1, 17872
1,17871,1,1,1, 17872
7,17877,1,1,0, 17878
8,17881,1,1,0, 17882
1,17886,1,1,1, 17887
7,17892,1,1,0, 17893
8,17896,1,1,0, 17897
16,17899,2,2,1, 17901
1,17901,1,1,0, 17902
7,17907,1,1,0, 17908
8,17911,1,1,0, 17912
1,17916,1,1,0, 17917
6,17920,2,2,1, 17922
7,17922,1,1,0, 17923
24,17924,1,1,0, 17925
8,17926,1,1,1, 17927
9,17927,2,2,1, 17929
16,17929,2,2,1, 17931
14,17929,3,3,1, 17932
25,17930,2,2,1, 17932
1,17931,1,1,1, 17932
15,17931,2,2,1, 17933
31,17931,2,2,1, 17933
3,17932,3,3,1, 17935
26,17932,3,3,1, 17935
7,17937,1,1,0, 17938
22,17936,4,4,1, 17940
24,17939,1,1,0, 17940
31,17946,2,2,1, 17948
24,17954,1,1,0, 17955
31,17961,2,2,1, 17963
24,17969,1,1,1, 17970
24,17984,1,1,0, 17985
24,17999,1,1,0, 18000
31,18006,2,2,1, 18008
24,18014,1,1,0, 18015
24,18029,1,1,1, 18030
7,18042,1,1,1, 18043
24,18044,1,1,1, 18045
8,18046,1,1,1, 18047
9,18047,2,2,1, 18049
16,18049,2,2,1, 18051
2,18048,2,4,1, 18052
25,18050,2,2,1, 18052
1,18051,1,1,1, 18052
15,18051,2,2,1, 18053
3,18052,3,3,1, 18055
26,18052,3,3,1, 18055
18,18053,4,4,1, 18057
7,18057,1,1,0, 18058
24,18059,1,1,1, 18060
8,18061,1,1,1, 18062
16,18064,2,2,1, 18066
1,18066,1,1,0, 18067
7,18072,1,1,0, 18073
8,18076,1,1,0, 18077
16,18079,2,2,1, 18081
1,18081,1,1,1, 18082
31,18081,2,2,1, 18083
7,18087,1,1,1, 18088
8,18091,1,1,0, 18092
16,18094,2,2,1, 18096
1,18096,1,1,0, 18097
31,18096,2,2,1, 18098
6,18100,2,2,1, 18102
7,18102,1,1,1, 18103
8,18106,1,1,0, 18107
16,18109,2,2,1, 18111
1,18111,1,1,1, 18112
6,18115,2,2,1, 18117
7,18117,1,1,1, 18118
8,18121,1,1,0, 18122
16,18124,2,2,1, 18126
1,18126,1,1,1, 18127
31,18126,2,2,1, 18128
6,18130,2,2,1, 18132
7,18132,1,1,0, 18133
8,18136,1,1,1, 18137
16,18139,2,2,1, 18141
1,18141,1,1,0, 18142
6,18145,2,2,1, 18147
7,18147,1,1,0, 18148
8,18151,1,1,0, 18152
1,18156,1,1,0, 18157
31,18156,2,2,1, 18158
7,18162,1,1,0, 18163
24,18164,1,1,0, 18165
8,18166,1,1,1, 18167
16,18169,2,2,1, 18171
25,18170,2,2,1, 18172
1,18171,1,1,0, 18172
13,18169,4,4,1, 18173
18,18173,4,4,1, 18177
7,18177,1,1,0, 18178
22,18176,4,4,1, 18180
24,18179,1,1,0, 18180
23,18178,3,3,1, 18181
24,18194,1,1,1, 18195
24,18209,1,1,1, 18210
24,18224,1,1,1, 18225
24,18239,1,1,0, 18240
24,18254,1,1,1, 18255
24,18269,1,1,1, 18270
7,18282,1,1,1, 18283
24,18284,1,1,1, 18285
8,18286,1,1,0, 18287
16,18289,2,2,1, 18291
14,18289,3,3,1, 18292
1,18291,1,1,1, 18292
13,18289,4,4,1, 18293
15,18291,2,2,1, 18293
31,18291,2,2,1, 18293
18,18293,4,4,1, 18297
7,18297,1,1,0, 18298
24,18299,1,1,1, 18300
8,18301,1,1,1, 18302
7,18312,1,1,0, 18313
7,18327,1,1,0, 18328
6,18340,2,2,1, 18342
7,18342,1,1,0, 18343
31,18351,2,2,1, 18353
6,18355,2,2,1, 18357
7,18357,1,1,1, 18358
6,18370,2,2,1, 18372
7,18372,1,1,1, 18373
6,18385,2,2,1, 18387
7,18387,1,1,0, 18388
7,18402,1,1,0, 18403
24,18404,1,1,1, 18405
9,18407,2,2,1, 18409
25,18410,2,2,1, 18412
1,18411,1,1,0, 18412
15,18411,2,2,1, 18413
31,18411,2,2,1, 18413
3,18412,3,3,1, 18415
26,18412,3,3,1, 18415
18,18413,4,4,1, 18417
7,18417,1,1,0, 18418
24,18419,1,1,0, 18420
23,18418,3,3,1, 18421
8,18421,1,1,1, 18422
15,18426,2,2,1, 18428
31,18426,2,2,1, 18428
24,18434,1,1,0, 18435
8,18436,1,1,0, 18437
14,18439,3,3,1, 18442
15,18441,2,2,1, 18443
31,18441,2,2,1, 18443
24,18449,1,1,0, 18450
8,18451,1,1,0, 18452
14,18454,3,3,1, 18457
15,18456,2,2,1, 18458
24,18464,1,1,0, 18465
8,18466,1,1,0, 18467
14,18469,3,3,1, 18472
31,18471,2,2,1, 18473
24,18479,1,1,1, 18480
8,18481,1,1,1, 18482
24,18494,1,1,1, 18495
8,18496,1,1,0, 18497
24,18509,1,1,0, 18510
8,18511,1,1,1, 18512
24,18524,1,1,1, 18525
8,18526,1,1,1, 18527
16,18529,2,2,1, 18531
1,18531,1,1,0, 18532
31,18531,2,2,1, 18533
26,18532,3,3,1, 18535
6,18535,2,2,1, 18537
7,18537,1,1,1, 18538
24,18539,1,1,1, 18540
6,18550,2,2,1, 18552
7,18552,1,1,1, 18553
6,18565,2,2,1, 18567
7,18567,1,1,0, 18568
6,18580,2,2,1, 18582
7,18582,1,1,0, 18583
7,18597,1,1,0, 18598
6,18610,2,2,1, 18612
7,18612,1,1,0, 18613
7,18627,1,1,0, 18628
7,18642,1,1,1, 18643
8,18646,1,1,1, 18647
9,18647,2,2,1, 18649
17,18649,3,3,1, 18652
25,18650,2,2,1, 18652
1,18651,1,1,1, 18652
15,18651,2,2,1, 18653
31,18651,2,2,1, 18653
26,18652,3,3,1, 18655
18,18653,4,4,1, 18657
7,18657,1,1,0, 18658
24,18659,1,1,0, 18660
23,18658,3,3,1, 18661
8,18661,1,1,0, 18662
16,18664,2,2,1, 18666
31,18666,2,2,1, 18668
24,18674,1,1,1, 18675
8,18676,1,1,1, 18677
16,18679,2,2,1, 18681
31,18681,2,2,1, 18683
24,18689,1,1,1, 18690
8,18691,1,1,0, 18692
24,18704,1,1,0, 18705
8,18706,1,1,1, 18707
24,18719,1,1,1, 18720
8,18721,1,1,1, 18722
31,18726,2,2,1, 18728
24,18734,1,1,0, 18735
31,18741,2,2,1, 18743
24,18749,1,1,1, 18750
16,18754,2,2,1, 18756
7,18762,1,1,1, 18763
24,18764,1,1,0, 18765
9,18767,2,2,1, 18769
16,18769,2,2,1, 18771
17,18769,3,3,1, 18772
25,18770,2,2,1, 18772
1,18771,1,1,0, 18772
31,18771,2,2,1, 18773
3,18772,3,3,1, 18775
18,18773,4,4,1, 18777
6,18775,2,2,1, 18777
7,18777,1,1,0, 18778
24,18779,1,1,0, 18780
8,18781,1,1,0, 18782
2,18783,2,2,1, 18785
1,18786,1,1,0, 18787
7,18792,1,1,1, 18793
8,18796,1,1,1, 18797
17,18799,3,3,1, 18802
1,18801,1,1,0, 18802
18,18803,4,4,1, 18807
6,18805,2,2,1, 18807
7,18807,1,1,1, 18808
8,18811,1,1,0, 18812
2,18813,2,2,1, 18815
17,18814,3,3,1, 18817
1,18816,1,1,1, 18817
6,18820,2,2,1, 18822
7,18822,1,1,1, 18823
8,18826,1,1,0, 18827
6,18835,2,2,1, 18837
7,18837,1,1,1, 18838
8,18841,1,1,0, 18842
1,18846,1,1,1, 18847
7,18852,1,1,1, 18853
8,18856,1,1,1, 18857
2,18858,2,2,1, 18860
25,18860,2,2,1, 18862
1,18861,1,1,1, 18862
6,18865,2,2,1, 18867
7,18867,1,1,1, 18868
8,18871,1,1,0, 18872
2,18873,2,2,1, 18875
1,18876,1,1,1, 18877
18,18878,4,4,1, 18882
6,18880,2,2,1, 18882
7,18882,1,1,1, 18883
24,18884,1,1,0, 18885
8,18886,1,1,1, 18887
9,18887,2,2,1, 18889
15,18891,2,2,1, 18893
31,18891,2,2,1, 18893
26,18892,3,3,1, 18895
18,18893,4,4,1, 18897
7,18897,1,1,1, 18898
24,18899,1,1,1, 18900
23,18898,3,3,1, 18901
24,18914,1,1,0, 18915
24,18929,1,1,1, 18930
24,18944,1,1,1, 18945
24,18959,1,1,1, 18960
24,18974,1,1,1, 18975
24,18989,1,1,1, 18990
1,18996,1,1,0, 18997
31,18996,2,2,1, 18998
7,19002,1,1,1, 19003
24,19004,1,1,0, 19005
8,19006,1,1,0, 19007
16,19009,2,2,1, 19011
2,19008,2,4,1, 19012
1,19011,1,1,1, 19012
26,19012,3,3,1, 19015
7,19017,1,1,1, 19018
22,19016,4,4,1, 19020
24,19019,1,1,1, 19020
23,19018,3,3,1, 19021
8,19021,1,1,0, 19022
1,19026,1,1,0, 19027
7,19032,1,1,0, 19033
24,19034,1,1,0, 19035
1,19041,1,1,0, 19042
7,19047,1,1,1, 19048
24,19049,1,1,0, 19050
1,19056,1,1,1, 19057
7,19062,1,1,1, 19063
24,19064,1,1,0, 19065
1,19071,1,1,0, 19072
7,19077,1,1,1, 19078
24,19079,1,1,1, 19080
1,19086,1,1,0, 19087
7,19092,1,1,1, 19093
24,19094,1,1,1, 19095
1,19101,1,1,0, 19102
7,19107,1,1,0, 19108
24,19109,1,1,1, 19110
1,19116,1,1,0, 19117
6,19120,2,2,1, 19122
7,19122,1,1,0, 19123
24,19124,1,1,1, 19125
9,19127,2,2,1, 19129
2,19128,2,2,1, 19130
14,19129,3,3,1, 19132
25,19130,2,2,1, 19132
1,19131,1,1,1, 19132
3,19132,3,3,1, 19135
26,19132,3,3,1, 19135
6,19135,2,2,1, 19137
7,19137,1,1,1, 19138
24,19139,1,1,0, 19140
8,19141,1,1,1, 19142
6,19150,2,2,1, 19152
7,19152,1,1,0, 19153
24,19154,1,1,1, 19155
8,19156,1,1,1, 19157
7,19167,1,1,0, 19168
24,19169,1,1,0, 19170
8,19171,1,1,1, 19172
31,19176,2,2,1, 19178
7,19182,1,1,1, 19183
24,19184,1,1,1, 19185
8,19186,1,1,1, 19187
31,19191,2,2,1, 19193
6,19195,2,2,1, 19197
7,19197,1,1,1, 19198
24,19199,1,1,0, 19200
8,19201,1,1,0, 19202
15,19206,2,2,1, 19208
24,19214,1,1,1, 19215
8,19216,1,1,0, 19217
15,19221,2,2,1, 19223
24,19229,1,1,0, 19230
8,19231,1,1,0, 19232
31,19236,2,2,1, 19238
24,19244,1,1,1, 19245
8,19246,1,1,0, 19247
9,19247,2,2,1, 19249
2,19248,2,2,1, 19250
17,19249,3,3,1, 19252
1,19251,1,1,1, 19252
24,19259,1,1,0, 19260
7,19302,1,1,1, 19303
14,19309,3,3,1, 19312
15,19311,2,2,1, 19313
6,19315,2,2,1, 19317
7,19317,1,1,0, 19318
7,19332,1,1,1, 19333
31,19341,2,2,1, 19343
7,19347,1,1,0, 19348
7,19362,1,1,0, 19363
24,19364,1,1,0, 19365
8,19366,1,1,0, 19367
9,19367,2,2,1, 19369
2,19368,2,2,1, 19370
25,19370,2,2,1, 19372
1,19371,1,1,1, 19372
3,19372,3,3,1, 19375
18,19373,4,4,1, 19377
7,19377,1,1,1, 19378
24,19379,1,1,0, 19380
8,19381,1,1,0, 19382
13,19384,4,4,1, 19388
15,19386,2,2,1, 19388
31,19386,2,2,1, 19388
7,19392,1,1,1, 19393
24,19394,1,1,1, 19395
8,19396,1,1,1, 19397
9,19397,2,2,1, 19399
13,19399,4,4,1, 19403
31,19401,2,2,1, 19403
6,19405,2,2,1, 19407
7,19407,1,1,0, 19408
24,19409,1,1,0, 19410
8,19411,1,1,0, 19412
9,19412,2,2,1, 19414
7,19422,1,1,1, 19423
24,19424,1,1,1, 19425
8,19426,1,1,0, 19427
16,19429,2,2,1, 19431
31,19431,2,2,1, 19433
7,19437,1,1,0, 19438
24,19439,1,1,0, 19440
8,19441,1,1,1, 19442
7,19452,1,1,0, 19453
24,19454,1,1,0, 19455
8,19456,1,1,0, 19457
9,19457,2,2,1, 19459
16,19459,2,2,1, 19461
7,19467,1,1,1, 19468
24,19469,1,1,0, 19470
8,19471,1,1,0, 19472
31,19476,2,2,1, 19478
7,19482,1,1,1, 19483
24,19484,1,1,1, 19485
8,19486,1,1,1, 19487
9,19487,2,2,1, 19489
2,19488,2,2,1, 19490
16,19489,2,2,1, 19491
17,19489,3,3,1, 19492
1,19491,1,1,0, 19492
31,19491,2,2,1, 19493
18,19493,4,4,1, 19497
7,19497,1,1,1, 19498
24,19499,1,1,0, 19500
14,19504,3,3,1, 19507
1,19506,1,1,0, 19507
31,19506,2,2,1, 19508
7,19512,1,1,1, 19513
1,19521,1,1,1, 19522
1,19536,1,1,0, 19537
1,19551,1,1,0, 19552
8,19561,1,1,0, 19562
1,19566,1,1,0, 19567
8,19576,1,1,0, 19577
9,19577,2,2,1, 19579
1,19581,1,1,0, 19582
15,19581,2,2,1, 19583
8,19591,1,1,1, 19592
9,19592,2,2,1, 19594
16,19594,2,2,1, 19596
1,19596,1,1,1, 19597
15,19596,2,2,1, 19598
24,19604,1,1,1, 19605
8,19606,1,1,1, 19607
2,19608,2,2,1, 19610
17,19609,3,3,1, 19612
25,19610,2,2,1, 19612
1,19611,1,1,1, 19612
26,19612,3,3,1, 19615
18,19613,4,4,1, 19617
7,19617,1,1,0, 19618
24,19619,1,1,0, 19620
8,19621,1,1,0, 19622
6,19630,2,2,1, 19632
7,19632,1,1,0, 19633
24,19634,1,1,1, 19635
25,19640,2,2,1, 19642
7,19647,1,1,0, 19648
24,19649,1,1,1, 19650
16,19654,2,2,1, 19656
6,19660,2,2,1, 19662
7,19662,1,1,1, 19663
24,19664,1,1,0, 19665
16,19669,2,2,1, 19671
25,19670,2,2,1, 19672
7,19677,1,1,0, 19678
24,19679,1,1,1, 19680
8,19681,1,1,0, 19682
7,19692,1,1,0, 19693
22,19691,4,4,1, 19695
8,19696,1,1,1, 19697
31,19701,2,2,1, 19703
7,19707,1,1,0, 19708
23,19708,3,3,1, 19711
8,19711,1,1,0, 19712
15,19716,2,2,1, 19718
31,19716,2,2,1, 19718
7,19722,1,1,0, 19723
22,19721,4,4,1, 19725
8,19726,1,1,0, 19727
9,19727,2,2,1, 19729
2,19728,2,2,1, 19730
17,19729,3,3,1, 19732
25,19730,2,2,1, 19732
1,19731,1,1,0, 19732
26,19732,3,3,1, 19735
7,19737,1,1,0, 19738
8,19741,1,1,0, 19742
7,19752,1,1,1, 19753
8,19756,1,1,1, 19757
31,19761,2,2,1, 19763
7,19767,1,1,1, 19768
8,19771,1,1,0, 19772
31,19776,2,2,1, 19778
7,19782,1,1,1, 19783
24,19784,1,1,1, 19785
8,19786,1,1,0, 19787
7,19797,1,1,1, 19798
24,19799,1,1,1, 19800
8,19801,1,1,1, 19802
31,19806,2,2,1, 19808
7,19812,1,1,1, 19813
24,19814,1,1,1, 19815
8,19816,1,1,0, 19817
31,19821,2,2,1, 19823
6,19825,2,2,1, 19827
7,19827,1,1,0, 19828
24,19829,1,1,0, 19830
8,19831,1,1,1, 19832
31,19836,2,2,1, 19838
7,19842,1,1,0, 19843
24,19844,1,1,1, 19845
8,19846,1,1,0, 19847
2,19848,2,4,1, 19852
17,19849,3,3,1, 19852
25,19850,2,2,1, 19852
1,19851,1,1,0, 19852
31,19851,2,2,1, 19853
26,19852,3,3,1, 19855
6,19855,2,2,1, 19857
7,19857,1,1,0, 19858
22,19856,4,4,1, 19860
24,19859,1,1,1, 19860
24,19874,1,1,1, 19875
24,19889,1,1,0, 19890
24,19904,1,1,1, 19905
24,19919,1,1,0, 19920
24,19934,1,1,0, 19935
24,19949,1,1,0, 19950
24,19964,1,1,1, 19965
8,19966,1,1,1, 19967
1,19971,1,1,0, 19972
15,19971,2,2,1, 19973
26,19972,3,3,1, 19975
18,19973,4,4,1, 19977
7,19977,1,1,0, 19978
24,19979,1,1,1, 19980
23,19978,3,3,1, 19981
8,19981,1,1,0, 19982
1,19986,1,1,1, 19987
7,19992,1,1,1, 19993
24,19994,1,1,0, 19995
8,19996,1,1,1, 19997
1,20001,1,1,0, 20002
7,20007,1,1,1, 20008
24,20009,1,1,0, 20010
8,20011,1,1,1, 20012
25,20015,2,2,1, 20017
1,20016,1,1,1, 20017
7,20022,1,1,0, 20023
24,20024,1,1,1, 20025
8,20026,1,1,1, 20027
1,20031,1,1,1, 20032
7,20037,1,1,1, 20038
24,20039,1,1,0, 20040
8,20041,1,1,0, 20042
1,20046,1,1,0, 20047
7,20052,1,1,0, 20053
24,20054,1,1,0, 20055
8,20056,1,1,1, 20057
25,20060,2,2,1, 20062
1,20061,1,1,0, 20062
7,20067,1,1,1, 20068
24,20069,1,1,1, 20070
8,20071,1,1,1, 20072
1,20076,1,1,0, 20077
7,20082,1,1,1, 20083
24,20084,1,1,1, 20085
8,20086,1,1,1, 20087
2,20088,2,2,1, 20090
25,20090,2,2,1, 20092
1,20091,1,1,1, 20092
15,20091,2,2,1, 20093
31,20091,2,2,1, 20093
18,20093,4,4,1, 20097
7,20097,1,1,1, 20098
22,20096,4,4,1, 20100
24,20099,1,1,0, 20100
23,20098,3,3,1, 20101
7,20202,1,1,0, 20203
24,20204,1,1,1, 20205
8,20206,1,1,1, 20207
16,20209,2,2,1, 20211
14,20209,3,3,1, 20212
25,20210,2,2,1, 20212
1,20211,1,1,0, 20212
15,20211,2,2,1, 20213
26,20212,3,3,1, 20215
7,20217,1,1,0, 20218
6,20215,2,4,1, 20219
24,20219,1,1,1, 20220
1,20226,1,1,0, 20227
7,20232,1,1,0, 20233
24,20234,1,1,1, 20235
1,20241,1,1,0, 20242
7,20247,1,1,0, 20248
24,20249,1,1,0, 20250
1,20256,1,1,1, 20257
6,20260,2,2,1, 20262
7,20262,1,1,0, 20263
24,20264,1,1,1, 20265
1,20271,1,1,0, 20272
6,20275,2,2,1, 20277
7,20277,1,1,0, 20278
24,20279,1,1,1, 20280
1,20286,1,1,1, 20287
7,20292,1,1,1, 20293
24,20294,1,1,0, 20295
1,20301,1,1,1, 20302
7,20307,1,1,1, 20308
24,20309,1,1,1, 20310
1,20316,1,1,0, 20317
7,20322,1,1,0, 20323
24,20324,1,1,0, 20325
8,20326,1,1,0, 20327
9,20327,2,2,1, 20329
17,20329,3,3,1, 20332
25,20330,2,2,1, 20332
1,20331,1,1,1, 20332
15,20331,2,2,1, 20333
26,20332,3,3,1, 20335
18,20333,4,4,1, 20337
7,20337,1,1,0, 20338
24,20339,1,1,1, 20340
23,20338,3,3,1, 20341
24,20444,1,1,1, 20445
8,20446,1,1,0, 20447
14,20449,3,3,1, 20452
1,20451,1,1,1, 20452
13,20449,4,4,1, 20453
31,20451,2,2,1, 20453
3,20452,3,3,1, 20455
18,20453,4,4,1, 20457
7,20457,1,1,0, 20458
22,20456,4,4,1, 20460
24,20459,1,1,1, 20460
23,20458,3,3,1, 20461
8,20461,1,1,0, 20462
9,20462,2,2,1, 20464
6,20470,2,2,1, 20472
7,20472,1,1,1, 20473
24,20474,1,1,1, 20475
8,20476,1,1,0, 20477
9,20477,2,2,1, 20479
6,20485,2,2,1, 20487
7,20487,1,1,0, 20488
24,20489,1,1,1, 20490
8,20491,1,1,0, 20492
9,20492,2,2,1, 20494
6,20500,2,2,1, 20502
7,20502,1,1,1, 20503
24,20504,1,1,0, 20505
8,20506,1,1,1, 20507
7,20517,1,1,1, 20518
24,20519,1,1,1, 20520
8,20521,1,1,0, 20522
6,20530,2,2,1, 20532
7,20532,1,1,0, 20533
24,20534,1,1,1, 20535
8,20536,1,1,1, 20537
7,20547,1,1,0, 20548
24,20549,1,1,0, 20550
8,20551,1,1,0, 20552
9,20552,2,2,1, 20554
6,20560,2,2,1, 20562
7,20562,1,1,1, 20563
24,20564,1,1,0, 20565
8,20566,1,1,0, 20567
16,20569,2,2,1, 20571
1,20571,1,1,0, 20572
31,20571,2,2,1, 20573
18,20573,4,4,1, 20577
7,20577,1,1,1, 20578
24,20579,1,1,1, 20580
23,20578,3,3,1, 20581
16,20584,2,2,1, 20586
1,20586,1,1,1, 20587
31,20586,2,2,1, 20588
24,20594,1,1,0, 20595
1,20601,1,1,1, 20602
24,20609,1,1,0, 20610
16,20614,2,2,1, 20616
1,20616,1,1,1, 20617
31,20616,2,2,1, 20618
24,20624,1,1,0, 20625
1,20631,1,1,0, 20632
24,20639,1,1,1, 20640
1,20646,1,1,1, 20647
1,20661,1,1,1, 20662
1,20676,1,1,0, 20677
8,20686,1,1,0, 20687
9,20687,2,2,1, 20689
16,20689,2,2,1, 20691
14,20689,3,3,1, 20692
17,20689,3,3,1, 20692
25,20690,2,2,1, 20692
1,20691,1,1,0, 20692
15,20691,2,2,1, 20693
31,20691,2,2,1, 20693
26,20692,3,3,1, 20695
6,20695,2,2,1, 20697
7,20697,1,1,1, 20698
22,20696,4,4,1, 20700
23,20698,3,3,1, 20701
7,20712,1,1,1, 20713
24,20714,1,1,0, 20715
6,20725,2,2,1, 20727
7,20727,1,1,1, 20728
24,20729,1,1,1, 20730
6,20740,2,2,1, 20742
7,20742,1,1,1, 20743
24,20744,1,1,1, 20745
25,20750,2,2,1, 20752
6,20755,2,2,1, 20757
7,20757,1,1,0, 20758
24,20759,1,1,0, 20760
7,20772,1,1,0, 20773
24,20774,1,1,1, 20775
7,20787,1,1,1, 20788
24,20789,1,1,1, 20790
6,20800,2,2,1, 20802
7,20802,1,1,1, 20803
24,20804,1,1,0, 20805
8,20806,1,1,0, 20807
9,20807,2,2,1, 20809
1,20811,1,1,1, 20812
6,20815,2,2,1, 20817
7,20817,1,1,0, 20818
24,20819,1,1,1, 20820
8,20821,1,1,1, 20822
2,20823,2,2,1, 20825
16,20824,2,2,1, 20826
1,20826,1,1,1, 20827
15,20826,2,2,1, 20828
3,20827,3,3,1, 20830
24,20834,1,1,1, 20835
8,20836,1,1,0, 20837
16,20839,2,2,1, 20841
14,20839,3,3,1, 20842
31,20841,2,2,1, 20843
24,20849,1,1,0, 20850
8,20851,1,1,1, 20852
31,20856,2,2,1, 20858
24,20864,1,1,1, 20865
8,20866,1,1,1, 20867
15,20871,2,2,1, 20873
31,20871,2,2,1, 20873
24,20879,1,1,0, 20880
8,20881,1,1,0, 20882
14,20884,3,3,1, 20887
31,20886,2,2,1, 20888
24,20894,1,1,0, 20895
8,20896,1,1,1, 20897
16,20899,2,2,1, 20901
15,20901,2,2,1, 20903
24,20909,1,1,0, 20910
8,20911,1,1,1, 20912
14,20914,3,3,1, 20917
31,20916,2,2,1, 20918
24,20924,1,1,1, 20925
8,20926,1,1,1, 20927
27,20927,4,4,1, 20931
7,20937,1,1,0, 20938
22,20936,4,4,1, 20940
24,20939,1,1,0, 20940
9,20942,2,2,1, 20944
25,20945,2,2,1, 20947
1,20946,1,1,0, 20947
6,20950,2,2,1, 20952
7,20952,1,1,1, 20953
9,20957,2,2,1, 20959
1,20961,1,1,0, 20962
7,20967,1,1,1, 20968
25,20975,2,2,1, 20977
1,20976,1,1,0, 20977
7,20982,1,1,1, 20983
9,20987,2,2,1, 20989
1,20991,1,1,0, 20992
6,20995,2,2,1, 20997
7,20997,1,1,0, 20998
7,21012,1,1,0, 21013
7,21027,1,1,1, 21028
7,21042,1,1,0, 21043
24,21044,1,1,1, 21045
14,21049,3,3,1, 21052
31,21051,2,2,1, 21053
7,21057,1,1,0, 21058
24,21059,1,1,0, 21060
23,21058,3,3,1, 21061
8,21061,1,1,0, 21062
1,21066,1,1,1, 21067
31,21066,2,2,1, 21068
6,21070,2,2,1, 21072
7,21072,1,1,1, 21073
24,21074,1,1,1, 21075
8,21076,1,1,1, 21077
2,21078,2,2,1, 21080
1,21081,1,1,1, 21082
26,21082,3,3,1, 21085
24,21089,1,1,0, 21090
8,21091,1,1,1, 21092
2,21093,2,2,1, 21095
1,21096,1,1,0, 21097
26,21097,3,3,1, 21100
24,21104,1,1,0, 21105
8,21106,1,1,0, 21107
1,21111,1,1,1, 21112
31,21111,2,2,1, 21113
24,21119,1,1,1, 21120
8,21121,1,1,1, 21122
1,21126,1,1,1, 21127
31,21126,2,2,1, 21128
24,21134,1,1,1, 21135
8,21136,1,1,1, 21137
1,21141,1,1,1, 21142
31,21141,2,2,1, 21143
24,21149,1,1,0, 21150
8,21151,1,1,0, 21152
1,21156,1,1,0, 21157
24,21164,1,1,0, 21165
8,21166,1,1,0, 21167
17,21169,3,3,1, 21172
1,21171,1,1,1, 21172
31,21171,2,2,1, 21173
24,21179,1,1,1, 21180
8,21181,1,1,1, 21182
16,21184,2,2,1, 21186
7,21192,1,1,0, 21193
8,21196,1,1,0, 21197
9,21197,2,2,1, 21199
6,21205,2,2,1, 21207
7,21207,1,1,1, 21208
8,21211,1,1,0, 21212
9,21212,2,2,1, 21214
16,21214,2,2,1, 21216
31,21216,2,2,1, 21218
6,21220,2,2,1, 21222
7,21222,1,1,1, 21223
31,21231,2,2,1, 21233
7,21237,1,1,0, 21238
7,21252,1,1,1, 21253
7,21267,1,1,1, 21268
31,21276,2,2,1, 21278
7,21282,1,1,1, 21283
24,21284,1,1,0, 21285
16,21289,2,2,1, 21291
1,21291,1,1,1, 21292
31,21291,2,2,1, 21293
26,21292,3,3,1, 21295
6,21295,2,2,1, 21297
7,21297,1,1,1, 21298
24,21299,1,1,1, 21300
23,21298,3,3,1, 21301
24,21314,1,1,0, 21315
24,21329,1,1,1, 21330
31,21336,2,2,1, 21338
24,21344,1,1,1, 21345
31,21351,2,2,1, 21353
24,21359,1,1,0, 21360
24,21374,1,1,1, 21375
31,21381,2,2,1, 21383
24,21389,1,1,1, 21390
31,21396,2,2,1, 21398
24,21404,1,1,0, 21405
8,21406,1,1,1, 21407
9,21407,2,2,1, 21409
2,21408,2,2,1, 21410
16,21409,2,2,1, 21411
14,21409,3,3,1, 21412
1,21411,1,1,1, 21412
15,21411,2,2,1, 21413
7,21417,1,1,1, 21418
24,21419,1,1,1, 21420
8,21421,1,1,1, 21422
31,21426,2,2,1, 21428
7,21432,1,1,0, 21433
8,21436,1,1,0, 21437
31,21441,2,2,1, 21443
7,21447,1,1,0, 21448
8,21451,1,1,0, 21452
31,21456,2,2,1, 21458
7,21462,1,1,0, 21463
8,21466,1,1,0, 21467
16,21469,2,2,1, 21471
31,21471,2,2,1, 21473
7,21477,1,1,0, 21478
8,21481,1,1,1, 21482
16,21484,2,2,1, 21486
7,21492,1,1,1, 21493
8,21496,1,1,0, 21497
6,21505,2,2,1, 21507
7,21507,1,1,1, 21508
8,21511,1,1,0, 21512
31,21516,2,2,1, 21518
6,21520,2,2,1, 21522
7,21522,1,1,1, 21523
8,21526,1,1,1, 21527
2,21528,2,2,1, 21530
16,21529,2,2,1, 21531
14,21529,3,3,1, 21532
1,21531,1,1,1, 21532
31,21531,2,2,1, 21533
7,21537,1,1,1, 21538
24,21539,1,1,1, 21540
9,21542,2,2,1, 21544
31,21546,2,2,1, 21548
24,21554,1,1,0, 21555
24,21569,1,1,1, 21570
24,21584,1,1,1, 21585
31,21591,2,2,1, 21593
24,21599,1,1,1, 21600
31,21606,2,2,1, 21608
24,21614,1,1,0, 21615
24,21629,1,1,0, 21630
31,21636,2,2,1, 21638
7,21642,1,1,0, 21643
24,21644,1,1,0, 21645
8,21646,1,1,1, 21647
1,21651,1,1,0, 21652
15,21651,2,2,1, 21653
7,21657,1,1,0, 21658
22,21656,4,4,1, 21660
24,21659,1,1,0, 21660
23,21658,3,3,1, 21661
8,21661,1,1,1, 21662
16,21664,2,2,1, 21666
17,21664,3,3,1, 21667
1,21666,1,1,0, 21667
31,21666,2,2,1, 21668
7,21672,1,1,0, 21673
25,21680,2,2,1, 21682
1,21681,1,1,0, 21682
31,21681,2,2,1, 21683
6,21685,2,2,1, 21687
7,21687,1,1,1, 21688
1,21696,1,1,0, 21697
6,21700,2,2,1, 21702
7,21702,1,1,1, 21703
1,21711,1,1,0, 21712
7,21717,1,1,0, 21718
1,21726,1,1,1, 21727
6,21730,2,2,1, 21732
7,21732,1,1,1, 21733
1,21741,1,1,0, 21742
7,21747,1,1,0, 21748
1,21756,1,1,0, 21757
31,21756,2,2,1, 21758
6,21760,2,2,1, 21762
7,21762,1,1,1, 21763
1,21771,1,1,0, 21772
31,21771,2,2,1, 21773
3,21772,3,3,1, 21775
26,21772,3,3,1, 21775
6,21775,2,2,1, 21777
7,21777,1,1,0, 21778
22,21776,4,4,1, 21780
24,21779,1,1,0, 21780
23,21778,3,3,1, 21781
8,21781,1,1,1, 21782
25,21785,2,2,1, 21787
31,21786,2,2,1, 21788
24,21794,1,1,1, 21795
31,21801,2,2,1, 21803
24,21809,1,1,1, 21810
31,21816,2,2,1, 21818
24,21824,1,1,1, 21825
31,21831,2,2,1, 21833
24,21839,1,1,0, 21840
24,21854,1,1,0, 21855
24,21869,1,1,0, 21870
31,21876,2,2,1, 21878
24,21884,1,1,1, 21885
1,21891,1,1,1, 21892
15,21891,2,2,1, 21893
31,21891,2,2,1, 21893
6,21895,2,2,1, 21897
7,21897,1,1,1, 21898
22,21896,4,4,1, 21900
24,21899,1,1,1, 21900
8,21901,1,1,0, 21902
8,21916,1,1,1, 21917
8,21931,1,1,0, 21932
8,21946,1,1,0, 21947
8,21961,1,1,1, 21962
16,21964,2,2,1, 21966
8,21976,1,1,0, 21977
8,21991,1,1,0, 21992
16,21994,2,2,1, 21996
24,22004,1,1,0, 22005
8,22006,1,1,1, 22007
2,22008,2,4,1, 22012
25,22010,2,2,1, 22012
1,22011,1,1,0, 22012
15,22011,2,2,1, 22013
7,22017,1,1,0, 22018
24,22019,1,1,0, 22020
1,22026,1,1,0, 22027
31,22026,2,2,1, 22028
7,22032,1,1,0, 22033
1,22041,1,1,1, 22042
31,22041,2,2,1, 22043
7,22047,1,1,0, 22048
1,22056,1,1,0, 22057
31,22056,2,2,1, 22058
7,22062,1,1,1, 22063
1,22071,1,1,1, 22072
7,22077,1,1,1, 22078
1,22086,1,1,1, 22087
31,22086,2,2,1, 22088
7,22092,1,1,1, 22093
1,22101,1,1,1, 22102
7,22107,1,1,1, 22108
1,22116,1,1,0, 22117
31,22116,2,2,1, 22118
7,22122,1,1,0, 22123
24,22124,1,1,1, 22125
8,22126,1,1,1, 22127
16,22129,2,2,1, 22131
25,22130,2,2,1, 22132
1,22131,1,1,0, 22132
15,22131,2,2,1, 22133
31,22131,2,2,1, 22133
3,22132,3,3,1, 22135
7,22137,1,1,1, 22138
24,22139,1,1,1, 22140
24,22244,1,1,1, 22245
8,22246,1,1,1, 22247
9,22247,2,2,1, 22249
16,22249,2,2,1, 22251
2,22248,2,4,1, 22252
25,22250,2,2,1, 22252
1,22251,1,1,1, 22252
7,22257,1,1,0, 22258
24,22259,1,1,1, 22260
8,22261,1,1,0, 22262
1,22266,1,1,1, 22267
31,22266,2,2,1, 22268
6,22270,2,2,1, 22272
7,22272,1,1,1, 22273
8,22276,1,1,0, 22277
1,22281,1,1,1, 22282
31,22281,2,2,1, 22283
7,22287,1,1,0, 22288
8,22291,1,1,0, 22292
1,22296,1,1,1, 22297
6,22300,2,2,1, 22302
7,22302,1,1,0, 22303
8,22306,1,1,1, 22307
1,22311,1,1,1, 22312
6,22315,2,2,1, 22317
7,22317,1,1,0, 22318
8,22321,1,1,1, 22322
16,22324,2,2,1, 22326
1,22326,1,1,1, 22327
31,22326,2,2,1, 22328
7,22332,1,1,1, 22333
8,22336,1,1,1, 22337
16,22339,2,2,1, 22341
1,22341,1,1,0, 22342
31,22341,2,2,1, 22343
6,22345,2,2,1, 22347
7,22347,1,1,1, 22348
8,22351,1,1,0, 22352
16,22354,2,2,1, 22356
1,22356,1,1,0, 22357
31,22356,2,2,1, 22358
7,22362,1,1,1, 22363
24,22364,1,1,1, 22365
23,22363,3,3,1, 22366
8,22366,1,1,0, 22367
9,22367,2,2,1, 22369
2,22368,2,2,1, 22370
16,22369,2,2,1, 22371
17,22369,3,3,1, 22372
25,22370,2,2,1, 22372
1,22371,1,1,0, 22372
3,22372,3,3,1, 22375
26,22372,3,3,1, 22375
7,22377,1,1,1, 22378
22,22376,4,4,1, 22380
24,22379,1,1,0, 22380
31,22386,2,2,1, 22388
24,22394,1,1,1, 22395
24,22409,1,1,0, 22410
24,22424,1,1,1, 22425
31,22431,2,2,1, 22433
24,22439,1,1,1, 22440
24,22454,1,1,1, 22455
31,22461,2,2,1, 22463
24,22469,1,1,1, 22470
31,22476,2,2,1, 22478
24,22484,1,1,1, 22485
8,22486,1,1,1, 22487
2,22488,2,4,1, 22492
14,22489,3,3,1, 22492
17,22489,3,3,1, 22492
25,22490,2,2,1, 22492
1,22491,1,1,1, 22492
26,22492,3,3,1, 22495
7,22497,1,1,1, 22498
24,22499,1,1,0, 22500
8,22501,1,1,1, 22502
9,22502,2,2,1, 22504
1,22506,1,1,0, 22507
31,22506,2,2,1, 22508
7,22512,1,1,1, 22513
8,22516,1,1,0, 22517
16,22519,2,2,1, 22521
1,22521,1,1,0, 22522
31,22521,2,2,1, 22523
7,22527,1,1,1, 22528
8,22531,1,1,0, 22532
16,22534,2,2,1, 22536
1,22536,1,1,0, 22537
6,22540,2,2,1, 22542
7,22542,1,1,1, 22543
8,22546,1,1,0, 22547
1,22551,1,1,0, 22552
6,22555,2,2,1, 22557
7,22557,1,1,1, 22558
8,22561,1,1,0, 22562
1,22566,1,1,1, 22567
7,22572,1,1,0, 22573
8,22576,1,1,1, 22577
16,22579,2,2,1, 22581
1,22581,1,1,0, 22582
6,22585,2,2,1, 22587
7,22587,1,1,0, 22588
8,22591,1,1,0, 22592
16,22594,2,2,1, 22596
1,22596,1,1,1, 22597
6,22600,2,2,1, 22602
7,22602,1,1,0, 22603
24,22604,1,1,0, 22605
8,22606,1,1,0, 22607
2,22608,2,2,1, 22610
25,22610,2,2,1, 22612
1,22611,1,1,1, 22612
15,22611,2,2,1, 22613
26,22612,3,3,1, 22615
6,22615,2,2,1, 22617
7,22617,1,1,1, 22618
22,22616,4,4,1, 22620
24,22619,1,1,0, 22620
23,22618,3,3,1, 22621
1,22626,1,1,1, 22627
31,22626,2,2,1, 22628
24,22634,1,1,0, 22635
1,22641,1,1,0, 22642
24,22649,1,1,0, 22650
1,22656,1,1,1, 22657
31,22656,2,2,1, 22658
24,22664,1,1,1, 22665
1,22671,1,1,1, 22672
31,22671,2,2,1, 22673
24,22679,1,1,0, 22680
8,22681,1,1,1, 22682
8,22696,1,1,1, 22697
8,22711,1,1,1, 22712
15,22716,2,2,1, 22718
23,22723,3,3,1, 22726
8,22726,1,1,1, 22727
9,22727,2,2,1, 22729
14,22729,3,3,1, 22732
15,22731,2,2,1, 22733
31,22731,2,2,1, 22733
6,22735,2,2,1, 22737
7,22737,1,1,0, 22738
22,22736,4,4,1, 22740
23,22738,3,3,1, 22741
9,22742,2,2,1, 22744
2,22743,2,2,1, 22745
1,22746,1,1,0, 22747
31,22746,2,2,1, 22748
24,22754,1,1,0, 22755
1,22761,1,1,0, 22762
24,22769,1,1,0, 22770
9,22772,2,2,1, 22774
1,22776,1,1,1, 22777
24,22784,1,1,1, 22785
9,22787,2,2,1, 22789
25,22790,2,2,1, 22792
1,22791,1,1,0, 22792
24,22799,1,1,1, 22800
7,22842,1,1,0, 22843
7,22857,1,1,1, 22858
8,22861,1,1,1, 22862
9,22862,2,2,1, 22864
16,22864,2,2,1, 22866
25,22865,2,2,1, 22867
1,22866,1,1,1, 22867
8,22876,1,1,1, 22877
16,22879,2,2,1, 22881
25,22880,2,2,1, 22882
1,22881,1,1,1, 22882
8,22891,1,1,0, 22892
16,22894,2,2,1, 22896
1,22896,1,1,1, 22897
8,22906,1,1,0, 22907
17,22909,3,3,1, 22912
1,22911,1,1,0, 22912
31,22911,2,2,1, 22913
24,22919,1,1,1, 22920
8,22921,1,1,0, 22922
24,22934,1,1,0, 22935
8,22936,1,1,0, 22937
24,22949,1,1,0, 22950
8,22951,1,1,0, 22952
7,22962,1,1,1, 22963
24,22964,1,1,0, 22965
8,22966,1,1,0, 22967
7,22977,1,1,1, 22978
22,22976,4,4,1, 22980
24,22979,1,1,1, 22980
23,22978,3,3,1, 22981
2,22983,2,2,1, 22985
1,22986,1,1,0, 22987
7,22992,1,1,0, 22993
24,22994,1,1,1, 22995
1,23001,1,1,1, 23002
7,23007,1,1,0, 23008
24,23009,1,1,1, 23010
1,23016,1,1,0, 23017
7,23022,1,1,1, 23023
24,23024,1,1,1, 23025
1,23031,1,1,0, 23032
7,23037,1,1,0, 23038
24,23039,1,1,1, 23040
16,23044,2,2,1, 23046
1,23046,1,1,1, 23047
15,23046,2,2,1, 23048
6,23050,2,2,1, 23052
7,23052,1,1,0, 23053
24,23054,1,1,0, 23055
23,23053,3,3,1, 23056
16,23059,2,2,1, 23061
1,23061,1,1,1, 23062
15,23061,2,2,1, 23063
7,23067,1,1,1, 23068
24,23069,1,1,0, 23070
16,23074,2,2,1, 23076
1,23076,1,1,0, 23077
15,23076,2,2,1, 23078
6,23080,2,2,1, 23082
7,23082,1,1,1, 23083
24,23084,1,1,1, 23085
23,23083,3,3,1, 23086
16,23089,2,2,1, 23091
1,23091,1,1,0, 23092
31,23091,2,2,1, 23093
26,23092,3,3,1, 23095
6,23095,2,2,1, 23097
7,23097,1,1,1, 23098
24,23099,1,1,1, 23100
9,23102,2,2,1, 23104
1,23106,1,1,1, 23107
9,23117,2,2,1, 23119
1,23121,1,1,1, 23122
1,23136,1,1,1, 23137
8,23146,1,1,1, 23147
16,23149,2,2,1, 23151
1,23151,1,1,0, 23152
8,23161,1,1,0, 23162
1,23166,1,1,0, 23167
8,23176,1,1,0, 23177
1,23181,1,1,0, 23182
8,23191,1,1,0, 23192
1,23196,1,1,0, 23197
8,23206,1,1,1, 23207
14,23209,3,3,1, 23212
25,23210,2,2,1, 23212
1,23211,1,1,0, 23212
3,23212,3,3,1, 23215
18,23213,4,4,1, 23217
7,23217,1,1,0, 23218
24,23219,1,1,0, 23220
23,23218,3,3,1, 23221
8,23221,1,1,0, 23222
25,23225,2,2,1, 23227
1,23226,1,1,0, 23227
24,23234,1,1,1, 23235
8,23236,1,1,1, 23237
17,23239,3,3,1, 23242
1,23241,1,1,1, 23242
24,23249,1,1,1, 23250
8,23251,1,1,1, 23252
9,23252,2,2,1, 23254
17,23254,3,3,1, 23257
25,23255,2,2,1, 23257
1,23256,1,1,0, 23257
24,23264,1,1,0, 23265
8,23266,1,1,1, 23267
1,23271,1,1,0, 23272
24,23279,1,1,1, 23280
8,23281,1,1,0, 23282
25,23285,2,2,1, 23287
24,23294,1,1,0, 23295
8,23296,1,1,1, 23297
24,23309,1,1,1, 23310
8,23311,1,1,1, 23312
24,23324,1,1,1, 23325
8,23326,1,1,0, 23327
9,23327,2,2,1, 23329
16,23329,2,2,1, 23331
31,23331,2,2,1, 23333
7,23337,1,1,0, 23338
24,23339,1,1,1, 23340
8,23341,1,1,0, 23342
14,23344,3,3,1, 23347
1,23346,1,1,1, 23347
6,23350,2,2,1, 23352
7,23352,1,1,0, 23353
24,23354,1,1,1, 23355
9,23357,2,2,1, 23359
2,23358,2,2,1, 23360
1,23361,1,1,1, 23362
31,23361,2,2,1, 23363
6,23365,2,2,1, 23367
7,23367,1,1,0, 23368
24,23369,1,1,1, 23370
9,23372,2,2,1, 23374
2,23373,2,2,1, 23375
1,23376,1,1,1, 23377
31,23376,2,2,1, 23378
7,23382,1,1,1, 23383
24,23384,1,1,1, 23385
2,23388,2,2,1, 23390
16,23389,2,2,1, 23391
1,23391,1,1,1, 23392
31,23391,2,2,1, 23393
7,23397,1,1,0, 23398
24,23399,1,1,1, 23400
16,23404,2,2,1, 23406
31,23406,2,2,1, 23408
6,23410,2,2,1, 23412
7,23412,1,1,0, 23413
24,23414,1,1,1, 23415
31,23421,2,2,1, 23423
24,23429,1,1,0, 23430
24,23444,1,1,1, 23445
25,23450,2,2,1, 23452
26,23452,3,3,1, 23455
24,23459,1,1,1, 23460
8,23461,1,1,1, 23462
9,23462,2,2,1, 23464
8,23476,1,1,1, 23477
8,23491,1,1,1, 23492
8,23506,1,1,1, 23507
25,23510,2,2,1, 23512
1,23511,1,1,0, 23512
8,23521,1,1,0, 23522
1,23526,1,1,0, 23527
8,23536,1,1,1, 23537
1,23541,1,1,1, 23542
8,23551,1,1,0, 23552
1,23556,1,1,0, 23557
24,23564,1,1,0, 23565
8,23566,1,1,1, 23567
9,23567,2,2,1, 23569
14,23569,3,3,1, 23572
1,23571,1,1,1, 23572
7,23577,1,1,0, 23578
24,23579,1,1,0, 23580
23,23578,3,3,1, 23581
1,23586,1,1,0, 23587
7,23592,1,1,1, 23593
24,23594,1,1,1, 23595
16,23599,2,2,1, 23601
1,23601,1,1,1, 23602
31,23601,2,2,1, 23603
7,23607,1,1,1, 23608
24,23609,1,1,0, 23610
1,23616,1,1,0, 23617
6,23620,2,2,1, 23622
7,23622,1,1,1, 23623
24,23624,1,1,1, 23625
1,23631,1,1,1, 23632
31,23631,2,2,1, 23633
26,23632,3,3,1, 23635
6,23635,2,2,1, 23637
7,23637,1,1,0, 23638
24,23639,1,1,0, 23640
9,23642,2,2,1, 23644
1,23646,1,1,1, 23647
31,23646,2,2,1, 23648
7,23652,1,1,0, 23653
1,23661,1,1,0, 23662
31,23661,2,2,1, 23663
6,23665,2,2,1, 23667
7,23667,1,1,1, 23668
1,23676,1,1,1, 23677
7,23682,1,1,1, 23683
8,23686,1,1,0, 23687
2,23688,2,2,1, 23690
16,23689,2,2,1, 23691
1,23691,1,1,1, 23692
31,23691,2,2,1, 23693
3,23692,3,3,1, 23695
6,23695,2,2,1, 23697
7,23697,1,1,0, 23698
8,23701,1,1,1, 23702
1,23706,1,1,1, 23707
8,23716,1,1,0, 23717
2,23718,2,2,1, 23720
1,23721,1,1,1, 23722
8,23731,1,1,1, 23732
2,23733,2,2,1, 23735
1,23736,1,1,1, 23737
24,23744,1,1,0, 23745
8,23746,1,1,1, 23747
9,23747,2,2,1, 23749
2,23748,2,2,1, 23750
25,23750,2,2,1, 23752
1,23751,1,1,1, 23752
31,23751,2,2,1, 23753
24,23759,1,1,0, 23760
8,23761,1,1,0, 23762
16,23764,2,2,1, 23766
25,23765,2,2,1, 23767
31,23766,2,2,1, 23768
24,23774,1,1,0, 23775
8,23776,1,1,1, 23777
9,23777,2,2,1, 23779
25,23780,2,2,1, 23782
31,23781,2,2,1, 23783
24,23789,1,1,1, 23790
8,23791,1,1,0, 23792
9,23792,2,2,1, 23794
16,23794,2,2,1, 23796
25,23795,2,2,1, 23797
7,23802,1,1,1, 23803
24,23804,1,1,1, 23805
8,23806,1,1,0, 23807
14,23809,3,3,1, 23812
15,23811,2,2,1, 23813
7,23817,1,1,0, 23818
24,23819,1,1,0, 23820
9,23867,2,2,1, 23869
1,23871,1,1,0, 23872
26,23872,3,3,1, 23875
9,23882,2,2,1, 23884
1,23886,1,1,0, 23887
9,23897,2,2,1, 23899
1,23901,1,1,0, 23902
1,23916,1,1,0, 23917
7,23922,1,1,1, 23923
8,23926,1,1,1, 23927
9,23927,2,2,1, 23929
1,23931,1,1,0, 23932
31,23931,2,2,1, 23933
7,23937,1,1,0, 23938
22,23936,4,4,1, 23940
24,23939,1,1,1, 23940
23,23938,3,3,1, 23941
8,23941,1,1,0, 23942
2,23943,2,2,1, 23945
1,23946,1,1,1, 23947
31,23946,2,2,1, 23948
26,23947,3,3,1, 23950
7,23952,1,1,0, 23953
24,23954,1,1,0, 23955
8,23956,1,1,1, 23957
2,23958,2,2,1, 23960
16,23959,2,2,1, 23961
1,23961,1,1,0, 23962
31,23961,2,2,1, 23963
7,23967,1,1,0, 23968
24,23969,1,1,1, 23970
8,23971,1,1,0, 23972
1,23976,1,1,0, 23977
31,23976,2,2,1, 23978
7,23982,1,1,0, 23983
24,23984,1,1,1, 23985
8,23986,1,1,1, 23987
16,23989,2,2,1, 23991
1,23991,1,1,1, 23992
31,23991,2,2,1, 23993
6,23995,2,2,1, 23997
7,23997,1,1,0, 23998
24,23999,1,1,0, 24000
8,24001,1,1,0, 24002
17,24004,3,3,1, 24007
1,24006,1,1,0, 24007
6,24010,2,2,1, 24012
7,24012,1,1,1, 24013
8,24016,1,1,0, 24017
16,24019,2,2,1, 24021
1,24021,1,1,0, 24022
7,24027,1,1,0, 24028
8,24031,1,1,1, 24032
16,24034,2,2,1, 24036
25,24035,2,2,1, 24037
1,24036,1,1,0, 24037
7,24042,1,1,0, 24043
8,24046,1,1,1, 24047
17,24049,3,3,1, 24052
25,24050,2,2,1, 24052
1,24051,1,1,1, 24052
15,24051,2,2,1, 24053
31,24051,2,2,1, 24053
7,24057,1,1,1, 24058
24,24104,1,1,1, 24105
31,24111,2,2,1, 24113
24,24119,1,1,0, 24120
17,24124,3,3,1, 24127
31,24126,2,2,1, 24128
24,24134,1,1,0, 24135
24,24149,1,1,0, 24150
17,24154,3,3,1, 24157
25,24155,2,2,1, 24157
31,24156,2,2,1, 24158
7,24162,1,1,1, 24163
24,24164,1,1,0, 24165
8,24166,1,1,0, 24167
9,24167,2,2,1, 24169
17,24169,3,3,1, 24172
1,24171,1,1,0, 24172
3,24172,3,3,1, 24175
7,24177,1,1,1, 24178
24,24179,1,1,0, 24180
8,24181,1,1,1, 24182
16,24184,2,2,1, 24186
1,24186,1,1,1, 24187
7,24192,1,1,0, 24193
24,24194,1,1,0, 24195
8,24196,1,1,1, 24197
16,24199,2,2,1, 24201
1,24201,1,1,1, 24202
7,24207,1,1,0, 24208
24,24209,1,1,1, 24210
8,24211,1,1,1, 24212
16,24214,2,2,1, 24216
1,24216,1,1,0, 24217
7,24222,1,1,1, 24223
24,24224,1,1,1, 24225
8,24226,1,1,0, 24227
1,24231,1,1,0, 24232
7,24237,1,1,1, 24238
24,24239,1,1,1, 24240
8,24241,1,1,0, 24242
1,24246,1,1,0, 24247
6,24250,2,2,1, 24252
7,24252,1,1,1, 24253
24,24254,1,1,0, 24255
8,24256,1,1,0, 24257
1,24261,1,1,1, 24262
7,24267,1,1,1, 24268
24,24269,1,1,1, 24270
8,24271,1,1,0, 24272
16,24274,2,2,1, 24276
25,24275,2,2,1, 24277
1,24276,1,1,0, 24277
7,24282,1,1,1, 24283
24,24284,1,1,1, 24285
8,24286,1,1,0, 24287
9,24287,2,2,1, 24289
27,24287,4,4,1, 24291
1,24291,1,1,1, 24292
3,24292,3,3,1, 24295
7,24297,1,1,1, 24298
24,24299,1,1,0, 24300
31,24306,2,2,1, 24308
7,24312,1,1,0, 24313
15,24321,2,2,1, 24323
7,24327,1,1,0, 24328
15,24336,2,2,1, 24338
7,24342,1,1,0, 24343
14,24349,3,3,1, 24352
15,24351,2,2,1, 24353
7,24357,1,1,1, 24358
24,24404,1,1,0, 24405
8,24406,1,1,1, 24407
2,24408,2,2,1, 24410
16,24409,2,2,1, 24411
25,24410,2,2,1, 24412
1,24411,1,1,0, 24412
3,24412,3,3,1, 24415
26,24412,3,3,1, 24415
24,24419,1,1,1, 24420
8,24421,1,1,1, 24422
16,24424,2,2,1, 24426
7,24432,1,1,0, 24433
8,24436,1,1,0, 24437
16,24439,2,2,1, 24441
15,24441,2,2,1, 24443
7,24447,1,1,1, 24448
8,24451,1,1,1, 24452
7,24462,1,1,0, 24463
8,24466,1,1,0, 24467
31,24471,2,2,1, 24473
7,24477,1,1,1, 24478
8,24481,1,1,1, 24482
8,24496,1,1,1, 24497
16,24499,2,2,1, 24501
15,24501,2,2,1, 24503
8,24511,1,1,0, 24512
16,24514,2,2,1, 24516
24,24524,1,1,0, 24525
8,24526,1,1,0, 24527
9,24527,2,2,1, 24529
2,24528,2,2,1, 24530
16,24529,2,2,1, 24531
1,24531,1,1,0, 24532
31,24531,2,2,1, 24533
24,24539,1,1,1, 24540
31,24546,2,2,1, 24548
24,24554,1,1,0, 24555
24,24569,1,1,0, 24570
24,24584,1,1,0, 24585
7,24597,1,1,0, 24598
24,24599,1,1,1, 24600
31,24606,2,2,1, 24608
6,24610,2,2,1, 24612
7,24612,1,1,0, 24613
24,24614,1,1,1, 24615
6,24625,2,2,1, 24627
7,24627,1,1,0, 24628
24,24629,1,1,1, 24630
31,24636,2,2,1, 24638
6,24640,2,2,1, 24642
7,24642,1,1,1, 24643
24,24644,1,1,0, 24645
8,24646,1,1,0, 24647
9,24647,2,2,1, 24649
1,24651,1,1,0, 24652
26,24652,3,3,1, 24655
6,24655,2,2,1, 24657
7,24657,1,1,1, 24658
24,24659,1,1,0, 24660
8,24661,1,1,0, 24662
16,24664,2,2,1, 24666
8,24676,1,1,1, 24677
16,24679,2,2,1, 24681
8,24691,1,1,1, 24692
16,24694,2,2,1, 24696
8,24706,1,1,0, 24707
16,24709,2,2,1, 24711
8,24721,1,1,1, 24722
8,24736,1,1,0, 24737
8,24751,1,1,0, 24752
7,24762,1,1,0, 24763
24,24764,1,1,0, 24765
8,24766,1,1,1, 24767
9,24767,2,2,1, 24769
17,24769,3,3,1, 24772
25,24770,2,2,1, 24772
1,24771,1,1,1, 24772
15,24771,2,2,1, 24773
31,24771,2,2,1, 24773
3,24772,3,3,1, 24775
26,24772,3,3,1, 24775
7,24777,1,1,0, 24778
24,24779,1,1,0, 24780
6,24790,2,2,1, 24792
7,24792,1,1,1, 24793
7,24807,1,1,1, 24808
15,24816,2,2,1, 24818
31,24816,2,2,1, 24818
7,24822,1,1,0, 24823
6,24835,2,2,1, 24837
7,24837,1,1,0, 24838
24,24884,1,1,0, 24885
8,24886,1,1,0, 24887
17,24889,3,3,1, 24892
25,24890,2,2,1, 24892
1,24891,1,1,0, 24892
15,24891,2,2,1, 24893
24,24899,1,1,1, 24900
8,24901,1,1,1, 24902
16,24904,2,2,1, 24906
1,24906,1,1,0, 24907
8,24916,1,1,0, 24917
1,24921,1,1,0, 24922
8,24931,1,1,0, 24932
1,24936,1,1,0, 24937
7,24942,1,1,0, 24943
8,24946,1,1,0, 24947
1,24951,1,1,0, 24952
31,24951,2,2,1, 24953
6,24955,2,2,1, 24957
7,24957,1,1,0, 24958
8,24961,1,1,1, 24962
1,24966,1,1,0, 24967
31,24966,2,2,1, 24968
7,24972,1,1,1, 24973
8,24976,1,1,0, 24977
1,24981,1,1,0, 24982
7,24987,1,1,1, 24988
8,24991,1,1,0, 24992
1,24996,1,1,1, 24997
7,25002,1,1,0, 25003
24,25004,1,1,1, 25005
8,25006,1,1,1, 25007
2,25008,2,2,1, 25010
25,25010,2,2,1, 25012
1,25011,1,1,1, 25012
15,25011,2,2,1, 25013
7,25017,1,1,1, 25018
24,25019,1,1,0, 25020
15,25026,2,2,1, 25028
7,25032,1,1,1, 25033
24,25034,1,1,1, 25035
31,25041,2,2,1, 25043
7,25047,1,1,1, 25048
24,25049,1,1,0, 25050
31,25056,2,2,1, 25058
6,25060,2,2,1, 25062
7,25062,1,1,1, 25063
24,25064,1,1,1, 25065
31,25071,2,2,1, 25073
6,25075,2,2,1, 25077
7,25077,1,1,0, 25078
24,25079,1,1,0, 25080
31,25086,2,2,1, 25088
24,25094,1,1,1, 25095
31,25101,2,2,1, 25103
24,25109,1,1,0, 25110
31,25116,2,2,1, 25118
24,25124,1,1,1, 25125
8,25126,1,1,1, 25127
9,25127,2,2,1, 25129
1,25131,1,1,0, 25132
31,25131,2,2,1, 25133
26,25132,3,3,1, 25135
24,25139,1,1,1, 25140
8,25141,1,1,1, 25142
8,25156,1,1,0, 25157
9,25157,2,2,1, 25159
16,25159,2,2,1, 25161
8,25171,1,1,0, 25172
9,25172,2,2,1, 25174
16,25174,2,2,1, 25176
8,25186,1,1,1, 25187
9,25187,2,2,1, 25189
31,25191,2,2,1, 25193
6,25195,2,2,1, 25197
7,25197,1,1,0, 25198
15,25206,2,2,1, 25208
6,25210,2,2,1, 25212
7,25212,1,1,1, 25213
1,25251,1,1,1, 25252
3,25252,3,3,1, 25255
26,25252,3,3,1, 25255
24,25259,1,1,1, 25260
16,25264,2,2,1, 25266
1,25266,1,1,0, 25267
31,25266,2,2,1, 25268
24,25274,1,1,0, 25275
1,25281,1,1,0, 25282
31,25281,2,2,1, 25283
24,25289,1,1,1, 25290
16,25294,2,2,1, 25296
1,25296,1,1,0, 25297
24,25304,1,1,1, 25305
8,25306,1,1,0, 25307
16,25309,2,2,1, 25311
1,25311,1,1,0, 25312
24,25319,1,1,1, 25320
8,25321,1,1,1, 25322
9,25322,2,2,1, 25324
1,25326,1,1,0, 25327
7,25332,1,1,1, 25333
8,25336,1,1,0, 25337
1,25341,1,1,0, 25342
31,25341,2,2,1, 25343
6,25345,2,2,1, 25347
7,25347,1,1,1, 25348
8,25351,1,1,1, 25352
1,25356,1,1,0, 25357
15,25356,2,2,1, 25358
31,25356,2,2,1, 25358
6,25360,2,2,1, 25362
7,25362,1,1,1, 25363
8,25366,1,1,1, 25367
1,25371,1,1,0, 25372
31,25371,2,2,1, 25373
6,25375,2,2,1, 25377
7,25377,1,1,0, 25378
8,25381,1,1,1, 25382
8,25396,1,1,1, 25397
8,25411,1,1,0, 25412
24,25424,1,1,1, 25425
8,25426,1,1,0, 25427
25,25430,2,2,1, 25432
24,25439,1,1,0, 25440
8,25441,1,1,0, 25442
16,25444,2,2,1, 25446
24,25454,1,1,0, 25455
8,25456,1,1,0, 25457
24,25469,1,1,0, 25470
8,25471,1,1,0, 25472
16,25474,2,2,1, 25476
7,25482,1,1,0, 25483
24,25484,1,1,0, 25485
8,25486,1,1,0, 25487
1,25491,1,1,0, 25492
6,25495,2,2,1, 25497
7,25497,1,1,1, 25498
24,25499,1,1,1, 25500
9,25502,2,2,1, 25504
1,25506,1,1,1, 25507
15,25506,2,2,1, 25508
7,25512,1,1,0, 25513
24,25514,1,1,1, 25515
1,25521,1,1,0, 25522
7,25527,1,1,0, 25528
24,25529,1,1,0, 25530
1,25536,1,1,1, 25537
15,25536,2,2,1, 25538
7,25542,1,1,1, 25543
24,25544,1,1,0, 25545
9,25547,2,2,1, 25549
1,25551,1,1,0, 25552
7,25557,1,1,1, 25558
24,25559,1,1,1, 25560
1,25566,1,1,1, 25567
31,25566,2,2,1, 25568
7,25572,1,1,0, 25573
24,25574,1,1,0, 25575
1,25581,1,1,1, 25582
15,25581,2,2,1, 25583
31,25581,2,2,1, 25583
7,25587,1,1,0, 25588
24,25589,1,1,1, 25590
1,25596,1,1,1, 25597
15,25596,2,2,1, 25598
7,25602,1,1,1, 25603
24,25604,1,1,0, 25605
8,25606,1,1,0, 25607
9,25607,2,2,1, 25609
2,25608,2,2,1, 25610
16,25609,2,2,1, 25611
1,25611,1,1,0, 25612
15,25611,2,2,1, 25613
31,25611,2,2,1, 25613
3,25612,3,3,1, 25615
7,25617,1,1,0, 25618
24,25619,1,1,1, 25620
8,25621,1,1,1, 25622
9,25622,2,2,1, 25624
8,25636,1,1,1, 25637
8,25651,1,1,1, 25652
8,25666,1,1,0, 25667
8,25681,1,1,1, 25682
8,25696,1,1,1, 25697
8,25711,1,1,0, 25712
7,25722,1,1,0, 25723
24,25724,1,1,0, 25725
8,25726,1,1,0, 25727
27,25727,4,4,1, 25731
17,25729,3,3,1, 25732
1,25731,1,1,0, 25732
26,25732,3,3,1, 25735
7,25737,1,1,0, 25738
24,25739,1,1,1, 25740
1,25746,1,1,1, 25747
7,25752,1,1,1, 25753
24,25754,1,1,1, 25755
9,25757,2,2,1, 25759
16,25759,2,2,1, 25761
1,25761,1,1,1, 25762
31,25761,2,2,1, 25763
6,25765,2,2,1, 25767
7,25767,1,1,1, 25768
24,25769,1,1,1, 25770
1,25776,1,1,0, 25777
7,25782,1,1,1, 25783
24,25784,1,1,0, 25785
16,25789,2,2,1, 25791
1,25791,1,1,0, 25792
7,25797,1,1,1, 25798
24,25799,1,1,1, 25800
1,25806,1,1,0, 25807
31,25806,2,2,1, 25808
24,25814,1,1,1, 25815
9,25817,2,2,1, 25819
16,25819,2,2,1, 25821
1,25821,1,1,0, 25822
24,25829,1,1,0, 25830
16,25834,2,2,1, 25836
1,25836,1,1,0, 25837
31,25836,2,2,1, 25838
24,25844,1,1,1, 25845
8,25846,1,1,1, 25847
25,25850,2,2,1, 25852
1,25851,1,1,0, 25852
15,25851,2,2,1, 25853
3,25852,3,3,1, 25855
24,25859,1,1,1, 25860
8,25861,1,1,1, 25862
7,25872,1,1,1, 25873
8,25876,1,1,1, 25877
31,25881,2,2,1, 25883
7,25887,1,1,0, 25888
8,25891,1,1,1, 25892
31,25896,2,2,1, 25898
6,25900,2,2,1, 25902
7,25902,1,1,0, 25903
8,25906,1,1,0, 25907
31,25911,2,2,1, 25913
7,25917,1,1,0, 25918
8,25921,1,1,0, 25922
8,25936,1,1,0, 25937
8,25951,1,1,0, 25952
24,25964,1,1,0, 25965
8,25966,1,1,0, 25967
27,25967,4,4,1, 25971
16,25969,2,2,1, 25971
25,25970,2,2,1, 25972
1,25971,1,1,0, 25972
15,25971,2,2,1, 25973
31,25971,2,2,1, 25973
3,25972,3,3,1, 25975
26,25972,3,3,1, 25975
24,25979,1,1,0, 25980
7,25992,1,1,1, 25993
7,26007,1,1,0, 26008
31,26016,2,2,1, 26018
7,26022,1,1,1, 26023
7,26037,1,1,1, 26038
31,26046,2,2,1, 26048
6,26050,2,2,1, 26052
7,26052,1,1,0, 26053
7,26067,1,1,0, 26068
7,26082,1,1,1, 26083
24,26084,1,1,1, 26085
8,26086,1,1,1, 26087
1,26091,1,1,0, 26092
31,26091,2,2,1, 26093
6,26095,2,2,1, 26097
7,26097,1,1,0, 26098
24,26099,1,1,0, 26100
8,26101,1,1,1, 26102
1,26106,1,1,1, 26107
24,26114,1,1,0, 26115
8,26116,1,1,1, 26117
17,26119,3,3,1, 26122
1,26121,1,1,0, 26122
24,26129,1,1,0, 26130
8,26131,1,1,0, 26132
1,26136,1,1,0, 26137
31,26136,2,2,1, 26138
24,26144,1,1,1, 26145
8,26146,1,1,0, 26147
17,26149,3,3,1, 26152
1,26151,1,1,1, 26152
31,26151,2,2,1, 26153
24,26159,1,1,0, 26160
8,26161,1,1,1, 26162
1,26166,1,1,1, 26167
31,26166,2,2,1, 26168
24,26174,1,1,0, 26175
8,26176,1,1,0, 26177
17,26179,3,3,1, 26182
25,26180,2,2,1, 26182
1,26181,1,1,0, 26182
31,26181,2,2,1, 26183
8,26191,1,1,0, 26192
17,26194,3,3,1, 26197
1,26196,1,1,0, 26197
8,26206,1,1,0, 26207
17,26209,3,3,1, 26212
1,26211,1,1,0, 26212
3,26212,3,3,1, 26215
7,26217,1,1,1, 26218
9,26222,2,2,1, 26224
1,26226,1,1,1, 26227
1,26241,1,1,0, 26242
1,26256,1,1,0, 26257
1,26271,1,1,1, 26272
1,26286,1,1,0, 26287
1,26301,1,1,0, 26302
1,26316,1,1,0, 26317
24,26324,1,1,1, 26325
8,26326,1,1,0, 26327
9,26327,2,2,1, 26329
16,26329,2,2,1, 26331
1,26331,1,1,1, 26332
26,26332,3,3,1, 26335
6,26335,2,2,1, 26337
7,26337,1,1,1, 26338
24,26339,1,1,1, 26340
8,26341,1,1,1, 26342
7,26352,1,1,0, 26353
24,26354,1,1,0, 26355
8,26356,1,1,1, 26357
7,26367,1,1,1, 26368
24,26369,1,1,1, 26370
8,26371,1,1,0, 26372
7,26382,1,1,0, 26383
24,26384,1,1,0, 26385
8,26386,1,1,0, 26387
7,26397,1,1,1, 26398
24,26399,1,1,0, 26400
8,26401,1,1,1, 26402
7,26412,1,1,1, 26413
24,26414,1,1,1, 26415
8,26416,1,1,1, 26417
7,26427,1,1,1, 26428
24,26429,1,1,1, 26430
8,26431,1,1,0, 26432
7,26442,1,1,0, 26443
24,26444,1,1,1, 26445
8,26446,1,1,1, 26447
1,26451,1,1,0, 26452
15,26451,2,2,1, 26453
31,26451,2,2,1, 26453
3,26452,3,3,1, 26455
26,26452,3,3,1, 26455
7,26457,1,1,0, 26458
24,26459,1,1,0, 26460
31,26466,2,2,1, 26468
24,26474,1,1,1, 26475
31,26481,2,2,1, 26483
24,26489,1,1,0, 26490
24,26504,1,1,0, 26505
24,26519,1,1,1, 26520
24,26534,1,1,1, 26535
24,26549,1,1,0, 26550
7,26562,1,1,0, 26563
24,26564,1,1,0, 26565
8,26566,1,1,1, 26567
2,26568,2,2,1, 26570
17,26569,3,3,1, 26572
25,26570,2,2,1, 26572
1,26571,1,1,1, 26572
15,26571,2,2,1, 26573
3,26572,3,3,1, 26575
26,26572,3,3,1, 26575
18,26573,4,4,1, 26577
7,26577,1,1,0, 26578
24,26579,1,1,0, 26580
8,26581,1,1,1, 26582
16,26584,2,2,1, 26586
1,26586,1,1,1, 26587
7,26592,1,1,1, 26593
8,26596,1,1,0, 26597
1,26601,1,1,1, 26602
7,26607,1,1,1, 26608
8,26611,1,1,1, 26612
16,26614,2,2,1, 26616
1,26616,1,1,0, 26617
7,26622,1,1,0, 26623
8,26626,1,1,1, 26627
1,26631,1,1,1, 26632
7,26637,1,1,0, 26638
8,26641,1,1,0, 26642
16,26644,2,2,1, 26646
1,26646,1,1,1, 26647
6,26650,2,2,1, 26652
7,26652,1,1,0, 26653
8,26656,1,1,1, 26657
1,26661,1,1,1, 26662
6,26665,2,2,1, 26667
7,26667,1,1,1, 26668
8,26671,1,1,1, 26672
16,26674,2,2,1, 26676
1,26676,1,1,0, 26677
6,26680,2,2,1, 26682
7,26682,1,1,1, 26683
24,26684,1,1,1, 26685
8,26686,1,1,0, 26687
25,26690,2,2,1, 26692
1,26691,1,1,1, 26692
26,26692,3,3,1, 26695
6,26695,2,2,1, 26697
7,26697,1,1,0, 26698
24,26699,1,1,0, 26700
16,26704,2,2,1, 26706
24,26714,1,1,0, 26715
16,26719,2,2,1, 26721
31,26721,2,2,1, 26723
24,26729,1,1,1, 26730
16,26734,2,2,1, 26736
24,26744,1,1,0, 26745
24,26759,1,1,0, 26760
7,26802,1,1,1, 26803
8,26806,1,1,0, 26807
2,26808,2,2,1, 26810
25,26810,2,2,1, 26812
1,26811,1,1,1, 26812
31,26811,2,2,1, 26813
7,26817,1,1,0, 26818
8,26821,1,1,1, 26822
2,26823,2,2,1, 26825
1,26826,1,1,0, 26827
6,26830,2,2,1, 26832
7,26832,1,1,1, 26833
8,26836,1,1,1, 26837
2,26838,2,2,1, 26840
17,26839,3,3,1, 26842
25,26840,2,2,1, 26842
7,26847,1,1,0, 26848
8,26851,1,1,0, 26852
6,26860,2,2,1, 26862
7,26862,1,1,1, 26863
8,26866,1,1,1, 26867
7,26877,1,1,1, 26878
8,26881,1,1,0, 26882
6,26890,2,2,1, 26892
7,26892,1,1,1, 26893
8,26896,1,1,1, 26897
7,26907,1,1,1, 26908
8,26911,1,1,0, 26912
6,26920,2,2,1, 26922
7,26922,1,1,1, 26923
8,26926,1,1,0, 26927
31,26931,2,2,1, 26933
7,26937,1,1,0, 26938
24,26939,1,1,0, 26940
8,26941,1,1,1, 26942
27,26942,4,4,1, 26946
17,26944,3,3,1, 26947
1,26946,1,1,0, 26947
31,26946,2,2,1, 26948
3,26947,3,3,1, 26950
7,26952,1,1,0, 26953
24,26954,1,1,0, 26955
8,26956,1,1,0, 26957
1,26961,1,1,0, 26962
3,26962,3,3,1, 26965
7,26967,1,1,0, 26968
24,26969,1,1,0, 26970
8,26971,1,1,0, 26972
9,26972,2,2,1, 26974
2,26973,2,2,1, 26975
16,26974,2,2,1, 26976
1,26976,1,1,0, 26977
3,26977,3,3,1, 26980
7,26982,1,1,0, 26983
24,26984,1,1,1, 26985
8,26986,1,1,1, 26987
9,26987,2,2,1, 26989
16,26989,2,2,1, 26991
1,26991,1,1,1, 26992
31,26991,2,2,1, 26993
7,26997,1,1,0, 26998
24,26999,1,1,1, 27000
1,27006,1,1,0, 27007
31,27006,2,2,1, 27008
7,27012,1,1,1, 27013
24,27014,1,1,1, 27015
9,27017,2,2,1, 27019
1,27021,1,1,1, 27022
31,27021,2,2,1, 27023
7,27027,1,1,1, 27028
24,27029,1,1,0, 27030
9,27032,2,2,1, 27034
1,27036,1,1,0, 27037
31,27036,2,2,1, 27038
7,27042,1,1,1, 27043
24,27044,1,1,0, 27045
1,27051,1,1,0, 27052
31,27051,2,2,1, 27053
7,27057,1,1,0, 27058
24,27059,1,1,1, 27060
8,27106,1,1,1, 27107
8,27121,1,1,0, 27122
8,27136,1,1,1, 27137
16,27139,2,2,1, 27141
8,27151,1,1,1, 27152
7,27162,1,1,1, 27163
24,27164,1,1,0, 27165
8,27166,1,1,0, 27167
9,27167,2,2,1, 27169
16,27169,2,2,1, 27171
17,27169,3,3,1, 27172
1,27171,1,1,0, 27172
15,27171,2,2,1, 27173
7,27177,1,1,0, 27178
24,27179,1,1,0, 27180
8,27181,1,1,0, 27182
1,27186,1,1,0, 27187
7,27192,1,1,1, 27193
24,27194,1,1,0, 27195
8,27196,1,1,1, 27197
1,27201,1,1,1, 27202
7,27207,1,1,0, 27208
24,27209,1,1,1, 27210
8,27211,1,1,0, 27212
1,27216,1,1,0, 27217
7,27222,1,1,1, 27223
24,27224,1,1,1, 27225
8,27226,1,1,1, 27227
9,27227,2,2,1, 27229
2,27228,2,2,1, 27230
1,27231,1,1,1, 27232
7,27237,1,1,1, 27238
24,27239,1,1,0, 27240
8,27241,1,1,1, 27242
7,27252,1,1,0, 27253
24,27254,1,1,0, 27255
8,27256,1,1,1, 27257
7,27267,1,1,1, 27268
24,27269,1,1,0, 27270
8,27271,1,1,0, 27272
6,27280,2,2,1, 27282
7,27282,1,1,1, 27283
24,27284,1,1,0, 27285
8,27286,1,1,0, 27287
7,27297,1,1,1, 27298
24,27299,1,1,1, 27300
8,27301,1,1,1, 27302
16,27304,2,2,1, 27306
15,27306,2,2,1, 27308
31,27306,2,2,1, 27308
7,27312,1,1,1, 27313
24,27314,1,1,0, 27315
8,27316,1,1,1, 27317
31,27321,2,2,1, 27323
6,27325,2,2,1, 27327
7,27327,1,1,0, 27328
24,27329,1,1,0, 27330
8,27331,1,1,1, 27332
16,27334,2,2,1, 27336
7,27342,1,1,1, 27343
24,27344,1,1,0, 27345
8,27346,1,1,1, 27347
1,27351,1,1,0, 27352
31,27351,2,2,1, 27353
7,27357,1,1,1, 27358
24,27359,1,1,0, 27360
9,27362,2,2,1, 27364
2,27363,2,2,1, 27365
16,27364,2,2,1, 27366
1,27366,1,1,1, 27367
3,27367,3,3,1, 27370
7,27372,1,1,1, 27373
24,27374,1,1,1, 27375
9,27377,2,2,1, 27379
16,27379,2,2,1, 27381
25,27380,2,2,1, 27382
1,27381,1,1,0, 27382
31,27381,2,2,1, 27383
7,27387,1,1,1, 27388
24,27389,1,1,0, 27390
9,27392,2,2,1, 27394
16,27394,2,2,1, 27396
25,27395,2,2,1, 27397
1,27396,1,1,1, 27397
26,27397,3,3,1, 27400
7,27402,1,1,1, 27403
9,27407,2,2,1, 27409
25,27410,2,2,1, 27412
1,27411,1,1,1, 27412
26,27412,3,3,1, 27415
7,27417,1,1,1, 27418
8,27421,1,1,1, 27422
9,27422,2,2,1, 27424
6,27430,2,2,1, 27432
7,27432,1,1,1, 27433
8,27436,1,1,1, 27437
9,27437,2,2,1, 27439
16,27439,2,2,1, 27441
31,27441,2,2,1, 27443
6,27445,2,2,1, 27447
7,27447,1,1,1, 27448
8,27451,1,1,0, 27452
7,27462,1,1,0, 27463
8,27466,1,1,0, 27467
31,27471,2,2,1, 27473
6,27475,2,2,1, 27477
7,27477,1,1,0, 27478
8,27481,1,1,1, 27482
16,27484,2,2,1, 27486
8,27496,1,1,0, 27497
16,27499,2,2,1, 27501
24,27509,1,1,0, 27510
8,27511,1,1,0, 27512
16,27514,2,2,1, 27516
31,27516,2,2,1, 27518
24,27524,1,1,0, 27525
8,27526,1,1,1, 27527
25,27530,2,2,1, 27532
1,27531,1,1,1, 27532
3,27532,3,3,1, 27535
24,27539,1,1,1, 27540
16,27544,2,2,1, 27546
1,27546,1,1,0, 27547
31,27546,2,2,1, 27548
24,27554,1,1,0, 27555
9,27557,2,2,1, 27559
1,27561,1,1,1, 27562
24,27569,1,1,1, 27570
16,27574,2,2,1, 27576
1,27576,1,1,1, 27577
31,27576,2,2,1, 27578
24,27584,1,1,0, 27585
1,27591,1,1,0, 27592
7,27597,1,1,0, 27598
24,27599,1,1,1, 27600
1,27606,1,1,1, 27607
7,27612,1,1,1, 27613
24,27614,1,1,1, 27615
16,27619,2,2,1, 27621
1,27621,1,1,0, 27622
31,27621,2,2,1, 27623
7,27627,1,1,0, 27628
24,27629,1,1,0, 27630
1,27636,1,1,0, 27637
31,27636,2,2,1, 27638
7,27642,1,1,0, 27643
24,27644,1,1,0, 27645
2,27648,2,2,1, 27650
25,27650,2,2,1, 27652
1,27651,1,1,0, 27652
31,27651,2,2,1, 27653
3,27652,3,3,1, 27655
7,27657,1,1,1, 27658
24,27659,1,1,0, 27660
8,27661,1,1,0, 27662
7,27672,1,1,0, 27673
8,27676,1,1,1, 27677
7,27687,1,1,1, 27688
8,27691,1,1,0, 27692
9,27692,2,2,1, 27694
6,27700,2,2,1, 27702
7,27702,1,1,0, 27703
8,27706,1,1,0, 27707
6,27715,2,2,1, 27717
7,27717,1,1,0, 27718
7,27732,1,1,1, 27733
7,27747,1,1,1, 27748
31,27756,2,2,1, 27758
7,27762,1,1,1, 27763
25,27770,2,2,1, 27772
1,27771,1,1,0, 27772
31,27771,2,2,1, 27773
7,27777,1,1,1, 27778
24,27779,1,1,0, 27780
9,27782,2,2,1, 27784
1,27786,1,1,0, 27787
31,27786,2,2,1, 27788
24,27794,1,1,0, 27795
9,27797,2,2,1, 27799
1,27801,1,1,0, 27802
24,27809,1,1,0, 27810
9,27812,2,2,1, 27814
25,27815,2,2,1, 27817
1,27816,1,1,0, 27817
31,27816,2,2,1, 27818
24,27824,1,1,1, 27825
8,27826,1,1,0, 27827
9,27827,2,2,1, 27829
1,27831,1,1,0, 27832
24,27839,1,1,0, 27840
8,27841,1,1,1, 27842
8,27856,1,1,0, 27857
8,27871,1,1,0, 27872
8,27886,1,1,0, 27887
8,27901,1,1,0, 27902
1,27906,1,1,0, 27907
24,27914,1,1,1, 27915
8,27916,1,1,1, 27917
25,27920,2,2,1, 27922
1,27921,1,1,1, 27922
31,27921,2,2,1, 27923
24,27929,1,1,1, 27930
8,27931,1,1,1, 27932
9,27932,2,2,1, 27934
1,27936,1,1,0, 27937
24,27944,1,1,1, 27945
8,27946,1,1,1, 27947
9,27947,2,2,1, 27949
16,27949,2,2,1, 27951
1,27951,1,1,0, 27952
31,27951,2,2,1, 27953
7,27957,1,1,0, 27958
24,27959,1,1,1, 27960
8,27961,1,1,1, 27962
9,27962,2,2,1, 27964
1,27966,1,1,1, 27967
15,27966,2,2,1, 27968
7,27972,1,1,0, 27973
24,27974,1,1,0, 27975
8,27976,1,1,0, 27977
1,27981,1,1,0, 27982
31,27981,2,2,1, 27983
7,27987,1,1,0, 27988
24,27989,1,1,0, 27990
8,27991,1,1,1, 27992
9,27992,2,2,1, 27994
1,27996,1,1,1, 27997
15,27996,2,2,1, 27998
6,28000,2,2,1, 28002
7,28002,1,1,1, 28003
24,28004,1,1,0, 28005
8,28006,1,1,0, 28007
2,28008,2,2,1, 28010
1,28011,1,1,0, 28012
31,28011,2,2,1, 28013
26,28012,3,3,1, 28015
6,28015,2,2,1, 28017
7,28017,1,1,1, 28018
24,28019,1,1,1, 28020
8,28021,1,1,0, 28022
15,28026,2,2,1, 28028
8,28036,1,1,1, 28037
8,28051,1,1,0, 28052
8,28066,1,1,0, 28067
8,28081,1,1,0, 28082
2,28083,2,2,1, 28085
16,28084,2,2,1, 28086
1,28086,1,1,1, 28087
31,28086,2,2,1, 28088
7,28092,1,1,1, 28093
8,28096,1,1,1, 28097
1,28101,1,1,1, 28102
31,28101,2,2,1, 28103
7,28107,1,1,1, 28108
8,28111,1,1,0, 28112
1,28116,1,1,1, 28117
31,28116,2,2,1, 28118
7,28122,1,1,0, 28123
8,28126,1,1,0, 28127
9,28127,2,2,1, 28129
1,28131,1,1,0, 28132
31,28131,2,2,1, 28133
6,28135,2,2,1, 28137
7,28137,1,1,0, 28138
8,28141,1,1,0, 28142
1,28146,1,1,0, 28147
6,28150,2,2,1, 28152
7,28152,1,1,0, 28153
8,28156,1,1,0, 28157
9,28157,2,2,1, 28159
1,28161,1,1,0, 28162
31,28161,2,2,1, 28163
7,28167,1,1,1, 28168
8,28171,1,1,0, 28172
16,28174,2,2,1, 28176
1,28176,1,1,1, 28177
31,28176,2,2,1, 28178
6,28180,2,2,1, 28182
7,28182,1,1,1, 28183
24,28184,1,1,1, 28185
8,28186,1,1,0, 28187
2,28188,2,2,1, 28190
16,28189,2,2,1, 28191
25,28190,2,2,1, 28192
1,28191,1,1,0, 28192
15,28191,2,2,1, 28193
24,28199,1,1,1, 28200
26,28207,3,3,1, 28210
24,28214,1,1,0, 28215
25,28220,2,2,1, 28222
26,28222,3,3,1, 28225
24,28229,1,1,0, 28230
31,28236,2,2,1, 28238
24,28244,1,1,1, 28245
25,28250,2,2,1, 28252
24,28259,1,1,1, 28260
7,28302,1,1,0, 28303
1,28311,1,1,1, 28312
15,28311,2,2,1, 28313
3,28312,3,3,1, 28315
6,28315,2,2,1, 28317
7,28317,1,1,1, 28318
8,28321,1,1,1, 28322
2,28323,2,2,1, 28325
1,28326,1,1,0, 28327
31,28326,2,2,1, 28328
7,28332,1,1,0, 28333
24,28334,1,1,1, 28335
8,28336,1,1,0, 28337
1,28341,1,1,0, 28342
6,28345,2,2,1, 28347
7,28347,1,1,1, 28348
24,28349,1,1,1, 28350
8,28351,1,1,0, 28352
1,28356,1,1,0, 28357
7,28362,1,1,0, 28363
24,28364,1,1,0, 28365
8,28366,1,1,1, 28367
1,28371,1,1,0, 28372
6,28375,2,2,1, 28377
7,28377,1,1,0, 28378
24,28379,1,1,1, 28380
8,28381,1,1,0, 28382
16,28384,2,2,1, 28386
1,28386,1,1,1, 28387
7,28392,1,1,0, 28393
24,28394,1,1,1, 28395
8,28396,1,1,1, 28397
1,28401,1,1,1, 28402
7,28407,1,1,0, 28408
24,28409,1,1,0, 28410
8,28411,1,1,0, 28412
1,28416,1,1,0, 28417
31,28416,2,2,1, 28418
7,28422,1,1,1, 28423
24,28424,1,1,1, 28425
8,28426,1,1,1, 28427
9,28427,2,2,1, 28429
2,28428,2,2,1, 28430
16,28429,2,2,1, 28431
25,28430,2,2,1, 28432
1,28431,1,1,0, 28432
15,28431,2,2,1, 28433
26,28432,3,3,1, 28435
7,28437,1,1,1, 28438
24,28439,1,1,1, 28440
8,28441,1,1,0, 28442
8,28456,1,1,1, 28457
9,28457,2,2,1, 28459
8,28471,1,1,0, 28472
9,28472,2,2,1, 28474
8,28486,1,1,1, 28487
8,28501,1,1,1, 28502
8,28516,1,1,0, 28517
8,28531,1,1,0, 28532
7,28542,1,1,0, 28543
8,28546,1,1,1, 28547
1,28551,1,1,0, 28552
7,28557,1,1,0, 28558
24,28559,1,1,0, 28560
2,28563,2,2,1, 28565
1,28566,1,1,1, 28567
3,28567,3,3,1, 28570
6,28570,2,2,1, 28572
7,28572,1,1,1, 28573
24,28574,1,1,1, 28575
31,28581,2,2,1, 28583
7,28587,1,1,1, 28588
24,28589,1,1,0, 28590
7,28602,1,1,0, 28603
24,28604,1,1,1, 28605
16,28609,2,2,1, 28611
6,28615,2,2,1, 28617
7,28617,1,1,0, 28618
24,28619,1,1,0, 28620
16,28624,2,2,1, 28626
31,28626,2,2,1, 28628
6,28630,2,2,1, 28632
7,28632,1,1,0, 28633
24,28634,1,1,1, 28635
7,28647,1,1,1, 28648
24,28649,1,1,0, 28650
31,28656,2,2,1, 28658
6,28660,2,2,1, 28662
7,28662,1,1,0, 28663
24,28664,1,1,1, 28665
8,28666,1,1,0, 28667
16,28669,2,2,1, 28671
15,28671,2,2,1, 28673
31,28671,2,2,1, 28673
6,28675,2,2,1, 28677
7,28677,1,1,0, 28678
24,28679,1,1,0, 28680
8,28681,1,1,0, 28682
8,28696,1,1,0, 28697
8,28711,1,1,1, 28712
8,28726,1,1,0, 28727
9,28727,2,2,1, 28729
8,28741,1,1,0, 28742
9,28742,2,2,1, 28744
8,28756,1,1,0, 28757
9,28757,2,2,1, 28759
8,28771,1,1,1, 28772
9,28772,2,2,1, 28774
7,28782,1,1,0, 28783
24,28784,1,1,1, 28785
8,28786,1,1,1, 28787
16,28789,2,2,1, 28791
1,28791,1,1,1, 28792
15,28791,2,2,1, 28793
31,28791,2,2,1, 28793
3,28792,3,3,1, 28795
26,28792,3,3,1, 28795
6,28795,2,2,1, 28797
7,28797,1,1,1, 28798
24,28799,1,1,0, 28800
1,28806,1,1,1, 28807
31,28806,2,2,1, 28808
6,28810,2,2,1, 28812
7,28812,1,1,1, 28813
24,28814,1,1,1, 28815
16,28819,2,2,1, 28821
1,28821,1,1,0, 28822
15,28821,2,2,1, 28823
31,28821,2,2,1, 28823
7,28827,1,1,0, 28828
24,28829,1,1,0, 28830
16,28834,2,2,1, 28836
1,28836,1,1,1, 28837
15,28836,2,2,1, 28838
31,28836,2,2,1, 28838
24,28844,1,1,1, 28845
1,28851,1,1,0, 28852
31,28851,2,2,1, 28853
24,28859,1,1,0, 28860
16,28864,2,2,1, 28866
1,28866,1,1,0, 28867
31,28866,2,2,1, 28868
24,28874,1,1,1, 28875
16,28879,2,2,1, 28881
1,28881,1,1,0, 28882
24,28889,1,1,0, 28890
1,28896,1,1,0, 28897
24,28904,1,1,1, 28905
8,28906,1,1,0, 28907
25,28910,2,2,1, 28912
1,28911,1,1,1, 28912
15,28911,2,2,1, 28913
31,28911,2,2,1, 28913
24,28919,1,1,1, 28920
8,28921,1,1,1, 28922
8,28936,1,1,1, 28937
16,28939,2,2,1, 28941
31,28941,2,2,1, 28943
7,28947,1,1,1, 28948
8,28951,1,1,1, 28952
31,28956,2,2,1, 28958
6,28960,2,2,1, 28962
7,28962,1,1,0, 28963
8,28966,1,1,1, 28967
16,28969,2,2,1, 28971
7,28977,1,1,0, 28978
8,28981,1,1,0, 28982
16,28984,2,2,1, 28986
7,28992,1,1,0, 28993
8,28996,1,1,0, 28997
16,28999,2,2,1, 29001
7,29007,1,1,1, 29008
8,29011,1,1,1, 29012
31,29016,2,2,1, 29018
7,29022,1,1,0, 29023
24,29024,1,1,0, 29025
8,29026,1,1,0, 29027
9,29027,2,2,1, 29029
16,29029,2,2,1, 29031
1,29031,1,1,1, 29032
15,29031,2,2,1, 29033
26,29032,3,3,1, 29035
7,29037,1,1,1, 29038
24,29039,1,1,0, 29040
9,29042,2,2,1, 29044
16,29044,2,2,1, 29046
1,29046,1,1,0, 29047
15,29046,2,2,1, 29048
7,29052,1,1,1, 29053
24,29054,1,1,1, 29055
16,29059,2,2,1, 29061
1,29061,1,1,0, 29062
15,29061,2,2,1, 29063
31,29061,2,2,1, 29063
7,29067,1,1,1, 29068
24,29069,1,1,0, 29070
1,29076,1,1,0, 29077
15,29076,2,2,1, 29078
7,29082,1,1,0, 29083
24,29084,1,1,0, 29085
16,29089,2,2,1, 29091
1,29091,1,1,1, 29092
7,29097,1,1,1, 29098
24,29099,1,1,0, 29100
1,29106,1,1,0, 29107
24,29114,1,1,0, 29115
9,29117,2,2,1, 29119
16,29119,2,2,1, 29121
1,29121,1,1,0, 29122
31,29121,2,2,1, 29123
24,29129,1,1,0, 29130
1,29136,1,1,0, 29137
24,29144,1,1,1, 29145
8,29146,1,1,0, 29147
16,29149,2,2,1, 29151
1,29151,1,1,1, 29152
3,29152,3,3,1, 29155
26,29152,3,3,1, 29155
24,29159,1,1,1, 29160
8,29161,1,1,0, 29162
16,29164,2,2,1, 29166
31,29166,2,2,1, 29168
7,29172,1,1,0, 29173
8,29176,1,1,1, 29177
16,29179,2,2,1, 29181
31,29181,2,2,1, 29183
7,29187,1,1,0, 29188
8,29191,1,1,1, 29192
31,29196,2,2,1, 29198
7,29202,1,1,0, 29203
8,29206,1,1,0, 29207
16,29209,2,2,1, 29211
15,29211,2,2,1, 29213
7,29217,1,1,0, 29218
8,29221,1,1,0, 29222
16,29224,2,2,1, 29226
7,29232,1,1,0, 29233
8,29236,1,1,1, 29237
16,29239,2,2,1, 29241
31,29241,2,2,1, 29243
7,29247,1,1,1, 29248
8,29251,1,1,0, 29252
16,29254,2,2,1, 29256
31,29256,2,2,1, 29258
6,29260,2,2,1, 29262
7,29262,1,1,1, 29263
24,29264,1,1,1, 29265
8,29266,1,1,1, 29267
16,29269,2,2,1, 29271
1,29271,1,1,0, 29272
31,29271,2,2,1, 29273
6,29275,2,2,1, 29277
7,29277,1,1,0, 29278
24,29279,1,1,0, 29280
24,29294,1,1,1, 29295
31,29301,2,2,1, 29303
24,29309,1,1,0, 29310
31,29316,2,2,1, 29318
24,29324,1,1,1, 29325
24,29339,1,1,0, 29340
15,29346,2,2,1, 29348
31,29346,2,2,1, 29348
7,29352,1,1,1, 29353
24,29354,1,1,1, 29355
15,29361,2,2,1, 29363
31,29361,2,2,1, 29363
6,29365,2,2,1, 29367
7,29367,1,1,1, 29368
24,29369,1,1,1, 29370
15,29376,2,2,1, 29378
7,29382,1,1,1, 29383
24,29384,1,1,1, 29385
8,29386,1,1,0, 29387
9,29387,2,2,1, 29389
2,29388,2,2,1, 29390
25,29390,2,2,1, 29392
1,29391,1,1,0, 29392
15,29391,2,2,1, 29393
3,29392,3,3,1, 29395
26,29392,3,3,1, 29395
7,29397,1,1,1, 29398
24,29399,1,1,1, 29400
8,29401,1,1,1, 29402
16,29404,2,2,1, 29406
25,29405,2,2,1, 29407
1,29406,1,1,0, 29407
15,29406,2,2,1, 29408
8,29416,1,1,1, 29417
16,29419,2,2,1, 29421
25,29420,2,2,1, 29422
1,29421,1,1,1, 29422
8,29431,1,1,1, 29432
25,29435,2,2,1, 29437
1,29436,1,1,0, 29437
8,29446,1,1,0, 29447
1,29451,1,1,0, 29452
8,29461,1,1,1, 29462
1,29466,1,1,1, 29467
8,29476,1,1,1, 29477
16,29479,2,2,1, 29481
1,29481,1,1,1, 29482
8,29491,1,1,1, 29492
16,29494,2,2,1, 29496
1,29496,1,1,0, 29497
7,29502,1,1,1, 29503
24,29504,1,1,0, 29505
8,29506,1,1,0, 29507
9,29507,2,2,1, 29509
2,29508,2,2,1, 29510
16,29509,2,2,1, 29511
25,29510,2,2,1, 29512
1,29511,1,1,1, 29512
31,29511,2,2,1, 29513
26,29512,3,3,1, 29515
7,29517,1,1,1, 29518
24,29519,1,1,0, 29520
31,29526,2,2,1, 29528
7,29532,1,1,0, 29533
24,29534,1,1,1, 29535
7,29547,1,1,1, 29548
24,29549,1,1,1, 29550
7,29562,1,1,1, 29563
24,29564,1,1,1, 29565
31,29571,2,2,1, 29573
7,29577,1,1,1, 29578
24,29579,1,1,0, 29580
16,29584,2,2,1, 29586
7,29592,1,1,0, 29593
24,29594,1,1,0, 29595
16,29599,2,2,1, 29601
31,29601,2,2,1, 29603
6,29605,2,2,1, 29607
7,29607,1,1,1, 29608
24,29609,1,1,0, 29610
7,29622,1,1,0, 29623
24,29624,1,1,0, 29625
1,29631,1,1,0, 29632
6,29635,2,2,1, 29637
7,29637,1,1,1, 29638
24,29639,1,1,1, 29640
1,29646,1,1,1, 29647
31,29646,2,2,1, 29648
7,29652,1,1,0, 29653
1,29661,1,1,1, 29662
7,29667,1,1,1, 29668
1,29676,1,1,1, 29677
31,29676,2,2,1, 29678
7,29682,1,1,0, 29683
8,29686,1,1,0, 29687
16,29689,2,2,1, 29691
25,29690,2,2,1, 29692
1,29691,1,1,0, 29692
15,29691,2,2,1, 29693
6,29695,2,2,1, 29697
7,29697,1,1,0, 29698
8,29701,1,1,0, 29702
1,29706,1,1,0, 29707
8,29716,1,1,0, 29717
25,29720,2,2,1, 29722
1,29721,1,1,1, 29722
8,29731,1,1,0, 29732
1,29736,1,1,1, 29737
24,29744,1,1,1, 29745
8,29746,1,1,0, 29747
2,29748,2,2,1, 29750
25,29750,2,2,1, 29752
1,29751,1,1,1, 29752
26,29752,3,3,1, 29755
24,29759,1,1,1, 29760
8,29761,1,1,0, 29762
24,29774,1,1,1, 29775
8,29776,1,1,1, 29777
9,29777,2,2,1, 29779
24,29789,1,1,1, 29790
8,29791,1,1,0, 29792
9,29792,2,2,1, 29794
31,29796,2,2,1, 29798
24,29804,1,1,0, 29805
8,29806,1,1,1, 29807
7,29817,1,1,0, 29818
24,29819,1,1,0, 29820
8,29821,1,1,0, 29822
6,29830,2,2,1, 29832
7,29832,1,1,0, 29833
24,29834,1,1,1, 29835
8,29836,1,1,0, 29837
9,29837,2,2,1, 29839
31,29841,2,2,1, 29843
6,29845,2,2,1, 29847
7,29847,1,1,1, 29848
24,29849,1,1,0, 29850
8,29851,1,1,0, 29852
16,29854,2,2,1, 29856
6,29860,2,2,1, 29862
7,29862,1,1,0, 29863
24,29864,1,1,0, 29865
8,29866,1,1,0, 29867
9,29867,2,2,1, 29869
16,29869,2,2,1, 29871
1,29871,1,1,1, 29872
6,29875,2,2,1, 29877
7,29877,1,1,0, 29878
24,29879,1,1,0, 29880
16,29884,2,2,1, 29886
1,29886,1,1,0, 29887
24,29894,1,1,1, 29895
25,29900,2,2,1, 29902
1,29901,1,1,1, 29902
24,29909,1,1,1, 29910
25,29915,2,2,1, 29917
1,29916,1,1,1, 29917
24,29924,1,1,1, 29925
1,29931,1,1,0, 29932
24,29939,1,1,0, 29940
8,29941,1,1,0, 29942
1,29946,1,1,1, 29947
8,29956,1,1,0, 29957
9,29957,2,2,1, 29959
16,29959,2,2,1, 29961
1,29961,1,1,1, 29962
15,29961,2,2,1, 29963
8,29971,1,1,0, 29972
16,29974,2,2,1, 29976
1,29976,1,1,0, 29977
7,29982,1,1,0, 29983
8,29986,1,1,1, 29987
2,29988,2,2,1, 29990
16,29989,2,2,1, 29991
1,29991,1,1,1, 29992
15,29991,2,2,1, 29993
31,29991,2,2,1, 29993
26,29992,3,3,1, 29995
6,29995,2,2,1, 29997
7,29997,1,1,1, 29998
7,30012,1,1,0, 30013
31,30021,2,2,1, 30023
7,30027,1,1,0, 30028
31,30036,2,2,1, 30038
7,30042,1,1,1, 30043
7,30057,1,1,1, 30058
24,30059,1,1,0, 30060
16,30064,2,2,1, 30066
15,30066,2,2,1, 30068
7,30072,1,1,1, 30073
24,30074,1,1,0, 30075
16,30079,2,2,1, 30081
15,30081,2,2,1, 30083
7,30087,1,1,1, 30088
24,30089,1,1,0, 30090
31,30096,2,2,1, 30098
7,30102,1,1,0, 30103
24,30104,1,1,1, 30105
8,30106,1,1,0, 30107
9,30107,2,2,1, 30109
2,30108,2,2,1, 30110
16,30109,2,2,1, 30111
25,30110,2,2,1, 30112
1,30111,1,1,0, 30112
31,30111,2,2,1, 30113
6,30115,2,2,1, 30117
7,30117,1,1,1, 30118
24,30119,1,1,1, 30120
8,30121,1,1,0, 30122
1,30126,1,1,0, 30127
8,30136,1,1,1, 30137
1,30141,1,1,0, 30142
8,30151,1,1,0, 30152
25,30155,2,2,1, 30157
1,30156,1,1,0, 30157
8,30166,1,1,0, 30167
1,30171,1,1,0, 30172
8,30181,1,1,0, 30182
25,30185,2,2,1, 30187
1,30186,1,1,1, 30187
8,30196,1,1,0, 30197
1,30201,1,1,1, 30202
8,30211,1,1,0, 30212
25,30215,2,2,1, 30217
1,30216,1,1,1, 30217
8,30226,1,1,1, 30227
9,30227,2,2,1, 30229
25,30230,2,2,1, 30232
1,30231,1,1,1, 30232
7,30237,1,1,0, 30238
24,30239,1,1,0, 30240
8,30241,1,1,0, 30242
6,30250,2,2,1, 30252
7,30252,1,1,1, 30253
24,30254,1,1,0, 30255
8,30256,1,1,0, 30257
9,30257,2,2,1, 30259
7,30267,1,1,0, 30268
24,30269,1,1,1, 30270
8,30271,1,1,1, 30272
9,30272,2,2,1, 30274
16,30274,2,2,1, 30276
31,30276,2,2,1, 30278
7,30282,1,1,1, 30283
24,30284,1,1,1, 30285
8,30286,1,1,0, 30287
31,30291,2,2,1, 30293
6,30295,2,2,1, 30297
7,30297,1,1,0, 30298
24,30299,1,1,0, 30300
31,30306,2,2,1, 30308
7,30312,1,1,0, 30313
24,30314,1,1,0, 30315
31,30321,2,2,1, 30323
6,30325,2,2,1, 30327
7,30327,1,1,1, 30328
24,30329,1,1,1, 30330
6,30340,2,2,1, 30342
7,30342,1,1,0, 30343
24,30344,1,1,1, 30345
25,30350,2,2,1, 30352
1,30351,1,1,1, 30352
15,30351,2,2,1, 30353
26,30352,3,3,1, 30355
6,30355,2,2,1, 30357
7,30357,1,1,1, 30358
24,30359,1,1,1, 30360
8,30361,1,1,1, 30362
1,30366,1,1,0, 30367
15,30366,2,2,1, 30368
24,30374,1,1,0, 30375
8,30376,1,1,1, 30377
1,30381,1,1,0, 30382
31,30381,2,2,1, 30383
24,30389,1,1,0, 30390
8,30391,1,1,0, 30392
25,30395,2,2,1, 30397
1,30396,1,1,0, 30397
15,30396,2,2,1, 30398
31,30396,2,2,1, 30398
24,30404,1,1,1, 30405
8,30406,1,1,1, 30407
16,30409,2,2,1, 30411
1,30411,1,1,0, 30412
15,30411,2,2,1, 30413
24,30419,1,1,0, 30420
8,30421,1,1,0, 30422
16,30424,2,2,1, 30426
1,30426,1,1,1, 30427
15,30426,2,2,1, 30428
1,30441,1,1,1, 30442
25,30455,2,2,1, 30457
1,30456,1,1,1, 30457
2,30468,2,2,1, 30470
1,30471,1,1,0, 30472
15,30471,2,2,1, 30473
3,30472,3,3,1, 30475
7,30477,1,1,0, 30478
9,30482,2,2,1, 30484
7,30492,1,1,0, 30493
7,30507,1,1,0, 30508
31,30516,2,2,1, 30518
6,30520,2,2,1, 30522
7,30522,1,1,0, 30523
16,30529,2,2,1, 30531
7,30537,1,1,0, 30538
24,30539,1,1,0, 30540
1,30546,1,1,1, 30547
31,30546,2,2,1, 30548
6,30550,2,2,1, 30552
7,30552,1,1,0, 30553
24,30554,1,1,1, 30555
16,30559,2,2,1, 30561
1,30561,1,1,1, 30562
7,30567,1,1,1, 30568
24,30569,1,1,1, 30570
9,30572,2,2,1, 30574
16,30574,2,2,1, 30576
1,30576,1,1,1, 30577
7,30582,1,1,0, 30583
24,30584,1,1,0, 30585
8,30586,1,1,0, 30587
16,30589,2,2,1, 30591
1,30591,1,1,1, 30592
31,30591,2,2,1, 30593
26,30592,3,3,1, 30595
6,30595,2,2,1, 30597
7,30597,1,1,0, 30598
24,30599,1,1,0, 30600
8,30601,1,1,0, 30602
31,30606,2,2,1, 30608
24,30614,1,1,0, 30615
8,30616,1,1,1, 30617
25,30620,2,2,1, 30622
24,30629,1,1,0, 30630
8,30631,1,1,1, 30632
24,30644,1,1,1, 30645
8,30646,1,1,0, 30647
31,30651,2,2,1, 30653
24,30659,1,1,0, 30660
8,30661,1,1,1, 30662
31,30666,2,2,1, 30668
24,30674,1,1,0, 30675
8,30676,1,1,0, 30677
9,30677,2,2,1, 30679
25,30680,2,2,1, 30682
31,30681,2,2,1, 30683
24,30689,1,1,1, 30690
8,30691,1,1,1, 30692
25,30695,2,2,1, 30697
31,30696,2,2,1, 30698
8,30706,1,1,1, 30707
25,30710,2,2,1, 30712
1,30711,1,1,1, 30712
15,30711,2,2,1, 30713
3,30712,3,3,1, 30715
7,30717,1,1,1, 30718
8,30721,1,1,1, 30722
1,30726,1,1,0, 30727
31,30726,2,2,1, 30728
6,30730,2,2,1, 30732
7,30732,1,1,1, 30733
1,30741,1,1,1, 30742
31,30741,2,2,1, 30743
7,30747,1,1,1, 30748
1,30756,1,1,0, 30757
31,30756,2,2,1, 30758
7,30762,1,1,0, 30763
1,30771,1,1,1, 30772
31,30771,2,2,1, 30773
7,30777,1,1,1, 30778
1,30786,1,1,1, 30787
7,30792,1,1,1, 30793
1,30801,1,1,0, 30802
7,30807,1,1,0, 30808
1,30816,1,1,0, 30817
7,30822,1,1,0, 30823
24,30824,1,1,0, 30825
2,30828,2,2,1, 30830
16,30829,2,2,1, 30831
25,30830,2,2,1, 30832
1,30831,1,1,0, 30832
15,30831,2,2,1, 30833
7,30837,1,1,1, 30838
24,30839,1,1,1, 30840
8,30841,1,1,0, 30842
24,30854,1,1,0, 30855
8,30856,1,1,0, 30857
31,30861,2,2,1, 30863
24,30869,1,1,0, 30870
8,30871,1,1,0, 30872
24,30884,1,1,0, 30885
8,30886,1,1,0, 30887
24,30899,1,1,1, 30900
8,30901,1,1,1, 30902
24,30914,1,1,0, 30915
8,30916,1,1,0, 30917
31,30921,2,2,1, 30923
24,30929,1,1,1, 30930
8,30931,1,1,0, 30932
24,30944,1,1,0, 30945
8,30946,1,1,0, 30947
16,30949,2,2,1, 30951
25,30950,2,2,1, 30952
1,30951,1,1,1, 30952
15,30951,2,2,1, 30953
26,30952,3,3,1, 30955
7,30957,1,1,0, 30958
24,30959,1,1,1, 30960
7,30972,1,1,1, 30973
7,30987,1,1,0, 30988
7,31002,1,1,0, 31003
7,31017,1,1,0, 31018
7,31032,1,1,1, 31033
7,31047,1,1,1, 31048
6,31060,2,2,1, 31062
7,31062,1,1,0, 31063
24,31064,1,1,0, 31065
8,31066,1,1,1, 31067
16,31069,2,2,1, 31071
1,31071,1,1,1, 31072
31,31071,2,2,1, 31073
3,31072,3,3,1, 31075
7,31077,1,1,1, 31078
24,31079,1,1,0, 31080
8,31081,1,1,0, 31082
9,31082,2,2,1, 31084
16,31084,2,2,1, 31086
25,31085,2,2,1, 31087
1,31086,1,1,0, 31087
7,31092,1,1,0, 31093
24,31094,1,1,0, 31095
8,31096,1,1,0, 31097
9,31097,2,2,1, 31099
16,31099,2,2,1, 31101
25,31100,2,2,1, 31102
1,31101,1,1,0, 31102
31,31101,2,2,1, 31103
7,31107,1,1,0, 31108
24,31109,1,1,0, 31110
8,31111,1,1,0, 31112
25,31115,2,2,1, 31117
1,31116,1,1,1, 31117
31,31116,2,2,1, 31118
7,31122,1,1,0, 31123
24,31124,1,1,0, 31125
8,31126,1,1,1, 31127
9,31127,2,2,1, 31129
25,31130,2,2,1, 31132
1,31131,1,1,1, 31132
7,31137,1,1,0, 31138
24,31139,1,1,0, 31140
7,31152,1,1,0, 31153
7,31167,1,1,1, 31168
31,31176,2,2,1, 31178
7,31182,1,1,0, 31183
15,31191,2,2,1, 31193
6,31195,2,2,1, 31197
7,31197,1,1,1, 31198
1,31206,1,1,0, 31207
1,31221,1,1,1, 31222
1,31236,1,1,0, 31237
24,31244,1,1,0, 31245
16,31249,2,2,1, 31251
1,31251,1,1,0, 31252
31,31251,2,2,1, 31253
24,31259,1,1,1, 31260
1,31266,1,1,1, 31267
24,31274,1,1,0, 31275
1,31281,1,1,0, 31282
31,31281,2,2,1, 31283
24,31289,1,1,1, 31290
16,31294,2,2,1, 31296
1,31296,1,1,1, 31297
24,31304,1,1,1, 31305
8,31306,1,1,0, 31307
1,31311,1,1,1, 31312
15,31311,2,2,1, 31313
31,31311,2,2,1, 31313
26,31312,3,3,1, 31315
7,31317,1,1,1, 31318
24,31319,1,1,1, 31320
8,31321,1,1,0, 31322
1,31326,1,1,1, 31327
7,31332,1,1,1, 31333
24,31334,1,1,1, 31335
8,31336,1,1,1, 31337
9,31337,2,2,1, 31339
1,31341,1,1,0, 31342
7,31347,1,1,0, 31348
24,31349,1,1,0, 31350
8,31351,1,1,1, 31352
9,31352,2,2,1, 31354
1,31356,1,1,0, 31357
6,31360,2,2,1, 31362
7,31362,1,1,0, 31363
24,31364,1,1,0, 31365
8,31366,1,1,1, 31367
1,31371,1,1,1, 31372
15,31371,2,2,1, 31373
31,31371,2,2,1, 31373
7,31377,1,1,1, 31378
24,31379,1,1,1, 31380
1,31386,1,1,0, 31387
24,31394,1,1,0, 31395
1,31401,1,1,1, 31402
24,31409,1,1,0, 31410
1,31416,1,1,1, 31417
31,31416,2,2,1, 31418
24,31424,1,1,0, 31425
16,31429,2,2,1, 31431
1,31431,1,1,1, 31432
26,31432,3,3,1, 31435
24,31439,1,1,0, 31440
8,31441,1,1,1, 31442
25,31445,2,2,1, 31447
1,31446,1,1,1, 31447
8,31456,1,1,1, 31457
16,31459,2,2,1, 31461
1,31461,1,1,0, 31462
8,31471,1,1,1, 31472
16,31474,2,2,1, 31476
1,31476,1,1,0, 31477
7,31482,1,1,0, 31483
8,31486,1,1,0, 31487
9,31487,2,2,1, 31489
16,31489,2,2,1, 31491
1,31491,1,1,1, 31492
7,31497,1,1,0, 31498
8,31501,1,1,0, 31502
9,31502,2,2,1, 31504
1,31506,1,1,1, 31507
31,31506,2,2,1, 31508
7,31512,1,1,0, 31513
8,31516,1,1,0, 31517
9,31517,2,2,1, 31519
1,31521,1,1,0, 31522
31,31521,2,2,1, 31523
7,31527,1,1,0, 31528
8,31531,1,1,0, 31532
1,31536,1,1,1, 31537
7,31542,1,1,0, 31543
24,31544,1,1,1, 31545
8,31546,1,1,1, 31547
2,31548,2,2,1, 31550
16,31549,2,2,1, 31551
1,31551,1,1,0, 31552
31,31551,2,2,1, 31553
7,31557,1,1,1, 31558
24,31559,1,1,1, 31560
7,31572,1,1,0, 31573
24,31574,1,1,1, 31575
7,31587,1,1,1, 31588
24,31589,1,1,0, 31590
16,31594,2,2,1, 31596
7,31602,1,1,1, 31603
24,31604,1,1,1, 31605
7,31617,1,1,0, 31618
24,31619,1,1,1, 31620
16,31624,2,2,1, 31626
7,31632,1,1,0, 31633
24,31634,1,1,1, 31635
7,31647,1,1,0, 31648
24,31649,1,1,0, 31650
16,31654,2,2,1, 31656
7,31662,1,1,0, 31663
24,31664,1,1,1, 31665
8,31666,1,1,1, 31667
9,31667,2,2,1, 31669
25,31670,2,2,1, 31672
1,31671,1,1,1, 31672
31,31671,2,2,1, 31673
7,31677,1,1,1, 31678
24,31679,1,1,1, 31680
8,31681,1,1,1, 31682
9,31682,2,2,1, 31684
16,31684,2,2,1, 31686
1,31686,1,1,1, 31687
1,31701,1,1,0, 31702
9,31712,2,2,1, 31714
1,31716,1,1,1, 31717
1,31731,1,1,0, 31732
9,31742,2,2,1, 31744
1,31746,1,1,0, 31747
9,31757,2,2,1, 31759
1,31761,1,1,1, 31762
1,31776,1,1,0, 31777
2,31788,2,2,1, 31790
16,31789,2,2,1, 31791
25,31790,2,2,1, 31792
1,31791,1,1,0, 31792
3,31792,3,3,1, 31795
26,31792,3,3,1, 31795
7,31797,1,1,1, 31798
24,31799,1,1,0, 31800
8,31801,1,1,1, 31802
31,31806,2,2,1, 31808
7,31812,1,1,0, 31813
24,31814,1,1,1, 31815
8,31816,1,1,0, 31817
31,31821,2,2,1, 31823
7,31827,1,1,0, 31828
24,31829,1,1,1, 31830
8,31831,1,1,1, 31832
16,31834,2,2,1, 31836
31,31836,2,2,1, 31838
6,31840,2,2,1, 31842
7,31842,1,1,1, 31843
24,31844,1,1,1, 31845
8,31846,1,1,0, 31847
16,31849,2,2,1, 31851
31,31851,2,2,1, 31853
6,31855,2,2,1, 31857
7,31857,1,1,1, 31858
24,31859,1,1,0, 31860
8,31861,1,1,0, 31862
6,31870,2,2,1, 31872
7,31872,1,1,1, 31873
24,31874,1,1,0, 31875
8,31876,1,1,0, 31877
16,31879,2,2,1, 31881
31,31881,2,2,1, 31883
7,31887,1,1,1, 31888
24,31889,1,1,1, 31890
8,31891,1,1,1, 31892
16,31894,2,2,1, 31896
7,31902,1,1,1, 31903
24,31904,1,1,0, 31905
8,31906,1,1,0, 31907
25,31910,2,2,1, 31912
1,31911,1,1,0, 31912
7,31917,1,1,0, 31918
24,31919,1,1,0, 31920
25,31925,2,2,1, 31927
1,31926,1,1,0, 31927
9,31937,2,2,1, 31939
25,31940,2,2,1, 31942
1,31941,1,1,1, 31942
24,32024,1,1,1, 32025
8,32026,1,1,1, 32027
9,32027,2,2,1, 32029
31,32031,2,2,1, 32033
7,32037,1,1,0, 32038
24,32039,1,1,0, 32040
8,32041,1,1,0, 32042
2,32043,2,2,1, 32045
16,32044,2,2,1, 32046
1,32046,1,1,0, 32047
26,32047,3,3,1, 32050
7,32052,1,1,0, 32053
24,32054,1,1,1, 32055
8,32056,1,1,0, 32057
16,32059,2,2,1, 32061
1,32061,1,1,0, 32062
26,32062,3,3,1, 32065
7,32067,1,1,0, 32068
24,32069,1,1,1, 32070
8,32071,1,1,0, 32072
9,32072,2,2,1, 32074
16,32074,2,2,1, 32076
1,32076,1,1,0, 32077
7,32082,1,1,1, 32083
24,32084,1,1,0, 32085
8,32086,1,1,1, 32087
9,32087,2,2,1, 32089
2,32088,2,2,1, 32090
16,32089,2,2,1, 32091
1,32091,1,1,0, 32092
6,32095,2,2,1, 32097
7,32097,1,1,0, 32098
24,32099,1,1,0, 32100
1,32106,1,1,1, 32107
7,32112,1,1,1, 32113
1,32121,1,1,0, 32122
7,32127,1,1,1, 32128
1,32136,1,1,0, 32137
31,32136,2,2,1, 32138
7,32142,1,1,1, 32143
1,32151,1,1,1, 32152
31,32151,2,2,1, 32153
7,32157,1,1,1, 32158
8,32161,1,1,0, 32162
1,32166,1,1,1, 32167
8,32176,1,1,1, 32177
1,32181,1,1,1, 32182
15,32181,2,2,1, 32183
8,32191,1,1,0, 32192
1,32196,1,1,1, 32197
15,32196,2,2,1, 32198
24,32204,1,1,0, 32205
8,32206,1,1,1, 32207
9,32207,2,2,1, 32209
1,32211,1,1,1, 32212
26,32212,3,3,1, 32215
24,32219,1,1,1, 32220
25,32225,2,2,1, 32227
31,32226,2,2,1, 32228
24,32234,1,1,1, 32235
25,32240,2,2,1, 32242
31,32241,2,2,1, 32243
24,32249,1,1,0, 32250
25,32255,2,2,1, 32257
7,32262,1,1,0, 32263
24,32264,1,1,1, 32265
15,32271,2,2,1, 32273
7,32277,1,1,1, 32278
24,32279,1,1,1, 32280
8,32281,1,1,1, 32282
16,32284,2,2,1, 32286
6,32290,2,2,1, 32292
7,32292,1,1,0, 32293
24,32294,1,1,1, 32295
8,32296,1,1,0, 32297
16,32299,2,2,1, 32301
6,32305,2,2,1, 32307
7,32307,1,1,0, 32308
24,32309,1,1,1, 32310
8,32311,1,1,0, 32312
15,32316,2,2,1, 32318
31,32316,2,2,1, 32318
6,32320,2,2,1, 32322
7,32322,1,1,1, 32323
24,32324,1,1,1, 32325
8,32326,1,1,0, 32327
2,32328,2,2,1, 32330
1,32331,1,1,0, 32332
31,32331,2,2,1, 32333
26,32332,3,3,1, 32335
7,32337,1,1,0, 32338
24,32339,1,1,1, 32340
8,32341,1,1,0, 32342
9,32342,2,2,1, 32344
1,32346,1,1,1, 32347
8,32356,1,1,1, 32357
16,32359,2,2,1, 32361
1,32361,1,1,1, 32362
8,32371,1,1,0, 32372
1,32376,1,1,1, 32377
15,32376,2,2,1, 32378
8,32386,1,1,1, 32387
9,32387,2,2,1, 32389
1,32391,1,1,0, 32392
15,32391,2,2,1, 32393
25,32405,2,2,1, 32407
1,32406,1,1,1, 32407
7,32412,1,1,0, 32413
9,32417,2,2,1, 32419
25,32420,2,2,1, 32422
1,32421,1,1,1, 32422
7,32427,1,1,1, 32428
1,32436,1,1,1, 32437
7,32442,1,1,1, 32443
2,32448,2,2,1, 32450
25,32450,2,2,1, 32452
1,32451,1,1,0, 32452
3,32452,3,3,1, 32455
26,32452,3,3,1, 32455
7,32457,1,1,1, 32458
31,32466,2,2,1, 32468
7,32472,1,1,0, 32473
7,32487,1,1,0, 32488
31,32496,2,2,1, 32498
7,32502,1,1,1, 32503
16,32509,2,2,1, 32511
15,32511,2,2,1, 32513
31,32511,2,2,1, 32513
7,32517,1,1,1, 32518
24,32519,1,1,0, 32520
8,32521,1,1,1, 32522
24,32534,1,1,1, 32535
8,32536,1,1,0, 32537
15,32541,2,2,1, 32543
24,32549,1,1,0, 32550
8,32551,1,1,1, 32552
9,32552,2,2,1, 32554
15,32556,2,2,1, 32558
31,32556,2,2,1, 32558
24,32564,1,1,0, 32565
8,32566,1,1,0, 32567
1,32571,1,1,0, 32572
31,32571,2,2,1, 32573
3,32572,3,3,1, 32575
26,32572,3,3,1, 32575
24,32579,1,1,1, 32580
8,32581,1,1,1, 32582
1,32586,1,1,1, 32587
24,32594,1,1,1, 32595
8,32596,1,1,1, 32597
1,32601,1,1,0, 32602
31,32601,2,2,1, 32603
24,32609,1,1,1, 32610
8,32611,1,1,0, 32612
1,32616,1,1,0, 32617
7,32622,1,1,0, 32623
24,32624,1,1,0, 32625
8,32626,1,1,1, 32627
16,32629,2,2,1, 32631
1,32631,1,1,0, 32632
7,32637,1,1,0, 32638
24,32639,1,1,0, 32640
8,32641,1,1,0, 32642
16,32644,2,2,1, 32646
1,32646,1,1,1, 32647
7,32652,1,1,1, 32653
24,32654,1,1,1, 32655
1,32661,1,1,1, 32662
31,32661,2,2,1, 32663
7,32667,1,1,1, 32668
24,32669,1,1,1, 32670
16,32674,2,2,1, 32676
1,32676,1,1,0, 32677
7,32682,1,1,1, 32683
24,32684,1,1,0, 32685
16,32689,2,2,1, 32691
1,32691,1,1,0, 32692
6,32695,2,2,1, 32697
7,32697,1,1,0, 32698
24,32699,1,1,1, 32700
9,32702,2,2,1, 32704
25,32705,2,2,1, 32707
1,32706,1,1,1, 32707
31,32706,2,2,1, 32708
6,32710,2,2,1, 32712
7,32712,1,1,0, 32713
7,32727,1,1,1, 32728
31,32736,2,2,1, 32738
6,32740,2,2,1, 32742
7,32742,1,1,0, 32743
7,32757,1,1,0, 32758
8,32761,1,1,1, 32762
8,32776,1,1,0, 32777
8,32791,1,1,1, 32792
24,32804,1,1,1, 32805
8,32806,1,1,0, 32807
31,32811,2,2,1, 32813
24,32819,1,1,1, 32820
8,32821,1,1,0, 32822
1,32826,1,1,1, 32827
24,32834,1,1,1, 32835
8,32836,1,1,1, 32837
16,32839,2,2,1, 32841
1,32841,1,1,0, 32842
31,32841,2,2,1, 32843
24,32849,1,1,0, 32850
8,32851,1,1,0, 32852
1,32856,1,1,0, 32857
31,32856,2,2,1, 32858
7,32862,1,1,1, 32863
24,32864,1,1,0, 32865
8,32866,1,1,0, 32867
9,32867,2,2,1, 32869
16,32869,2,2,1, 32871
1,32871,1,1,0, 32872
15,32871,2,2,1, 32873
31,32871,2,2,1, 32873
7,32877,1,1,1, 32878
24,32879,1,1,1, 32880
9,32882,2,2,1, 32884
1,32886,1,1,1, 32887
7,32892,1,1,0, 32893
24,32894,1,1,0, 32895
9,32897,2,2,1, 32899
1,32901,1,1,1, 32902
31,32901,2,2,1, 32903
7,32907,1,1,1, 32908
24,32909,1,1,1, 32910
1,32916,1,1,1, 32917
15,32916,2,2,1, 32918
7,32922,1,1,0, 32923
24,32924,1,1,1, 32925
9,32927,2,2,1, 32929
2,32928,2,2,1, 32930
25,32930,2,2,1, 32932
1,32931,1,1,1, 32932
15,32931,2,2,1, 32933
31,32931,2,2,1, 32933
26,32932,3,3,1, 32935
6,32935,2,2,1, 32937
7,32937,1,1,1, 32938
24,32939,1,1,1, 32940
8,32986,1,1,0, 32987
8,33001,1,1,1, 33002
9,33002,2,2,1, 33004
16,33004,2,2,1, 33006
15,33006,2,2,1, 33008
6,33010,2,2,1, 33012
7,33012,1,1,1, 33013
8,33016,1,1,0, 33017
16,33019,2,2,1, 33021
7,33027,1,1,0, 33028
8,33031,1,1,0, 33032
31,33036,2,2,1, 33038
7,33042,1,1,0, 33043
24,33044,1,1,1, 33045
8,33046,1,1,0, 33047
2,33048,2,2,1, 33050
16,33049,2,2,1, 33051
1,33051,1,1,1, 33052
31,33051,2,2,1, 33053
7,33057,1,1,0, 33058
24,33059,1,1,0, 33060
8,33061,1,1,1, 33062
16,33064,2,2,1, 33066
25,33065,2,2,1, 33067
1,33066,1,1,0, 33067
31,33066,2,2,1, 33068
24,33074,1,1,0, 33075
8,33076,1,1,0, 33077
25,33080,2,2,1, 33082
1,33081,1,1,0, 33082
24,33089,1,1,1, 33090
8,33091,1,1,0, 33092
1,33096,1,1,1, 33097
31,33096,2,2,1, 33098
24,33104,1,1,0, 33105
8,33106,1,1,0, 33107
1,33111,1,1,0, 33112
24,33119,1,1,0, 33120
8,33121,1,1,0, 33122
16,33124,2,2,1, 33126
1,33126,1,1,0, 33127
8,33136,1,1,0, 33137
16,33139,2,2,1, 33141
1,33141,1,1,0, 33142
8,33151,1,1,0, 33152
1,33156,1,1,1, 33157
7,33162,1,1,1, 33163
8,33166,1,1,1, 33167
2,33168,2,2,1, 33170
1,33171,1,1,1, 33172
15,33171,2,2,1, 33173
3,33172,3,3,1, 33175
7,33177,1,1,0, 33178
25,33185,2,2,1, 33187
31,33186,2,2,1, 33188
7,33192,1,1,0, 33193
7,33207,1,1,0, 33208
7,33222,1,1,1, 33223
31,33231,2,2,1, 33233
6,33235,2,2,1, 33237
7,33237,1,1,1, 33238
6,33250,2,2,1, 33252
7,33252,1,1,0, 33253
31,33261,2,2,1, 33263
7,33267,1,1,0, 33268
31,33276,2,2,1, 33278
6,33280,2,2,1, 33282
7,33282,1,1,1, 33283
8,33286,1,1,1, 33287
2,33288,2,2,1, 33290
25,33290,2,2,1, 33292
1,33291,1,1,1, 33292
3,33292,3,3,1, 33295
6,33295,2,2,1, 33297
7,33297,1,1,0, 33298
24,33299,1,1,0, 33300
8,33301,1,1,1, 33302
16,33304,2,2,1, 33306
15,33306,2,2,1, 33308
24,33314,1,1,1, 33315
8,33316,1,1,0, 33317
15,33321,2,2,1, 33323
24,33329,1,1,1, 33330
8,33331,1,1,0, 33332
15,33336,2,2,1, 33338
24,33344,1,1,0, 33345
8,33346,1,1,0, 33347
16,33349,2,2,1, 33351
15,33351,2,2,1, 33353
31,33351,2,2,1, 33353
24,33359,1,1,1, 33360
24,33374,1,1,0, 33375
24,33389,1,1,0, 33390
31,33396,2,2,1, 33398
7,33402,1,1,1, 33403
24,33404,1,1,0, 33405
1,33411,1,1,0, 33412
15,33411,2,2,1, 33413
7,33417,1,1,0, 33418
24,33419,1,1,1, 33420
25,33425,2,2,1, 33427
1,33426,1,1,0, 33427
7,33432,1,1,1, 33433
1,33441,1,1,0, 33442
7,33447,1,1,0, 33448
1,33456,1,1,1, 33457
7,33462,1,1,0, 33463
8,33466,1,1,1, 33467
16,33469,2,2,1, 33471
25,33470,2,2,1, 33472
1,33471,1,1,1, 33472
15,33471,2,2,1, 33473
7,33477,1,1,0, 33478
8,33481,1,1,0, 33482
9,33482,2,2,1, 33484
1,33486,1,1,1, 33487
7,33492,1,1,1, 33493
8,33496,1,1,0, 33497
16,33499,2,2,1, 33501
25,33500,2,2,1, 33502
1,33501,1,1,0, 33502
31,33501,2,2,1, 33503
7,33507,1,1,1, 33508
8,33511,1,1,1, 33512
9,33512,2,2,1, 33514
25,33515,2,2,1, 33517
1,33516,1,1,1, 33517
7,33522,1,1,1, 33523
24,33524,1,1,0, 33525
8,33526,1,1,1, 33527
9,33527,2,2,1, 33529
16,33529,2,2,1, 33531
1,33531,1,1,0, 33532
31,33531,2,2,1, 33533
7,33537,1,1,0, 33538
24,33539,1,1,0, 33540
7,33552,1,1,1, 33553
24,33554,1,1,0, 33555
31,33561,2,2,1, 33563
6,33565,2,2,1, 33567
7,33567,1,1,1, 33568
24,33569,1,1,0, 33570
31,33576,2,2,1, 33578
7,33582,1,1,0, 33583
24,33584,1,1,0, 33585
15,33591,2,2,1, 33593
6,33595,2,2,1, 33597
7,33597,1,1,0, 33598
24,33599,1,1,0, 33600
8,33601,1,1,1, 33602
15,33606,2,2,1, 33608
24,33614,1,1,1, 33615
8,33616,1,1,1, 33617
24,33629,1,1,1, 33630
8,33631,1,1,1, 33632
24,33644,1,1,1, 33645
8,33646,1,1,0, 33647
9,33647,2,2,1, 33649
16,33649,2,2,1, 33651
25,33650,2,2,1, 33652
1,33651,1,1,0, 33652
3,33652,3,3,1, 33655
26,33652,3,3,1, 33655
24,33659,1,1,0, 33660
24,33674,1,1,0, 33675
24,33689,1,1,0, 33690
7,33702,1,1,0, 33703
24,33704,1,1,0, 33705
25,33710,2,2,1, 33712
15,33711,2,2,1, 33713
31,33711,2,2,1, 33713
6,33715,2,2,1, 33717
7,33717,1,1,0, 33718
24,33719,1,1,0, 33720
25,33725,2,2,1, 33727
31,33726,2,2,1, 33728
7,33732,1,1,0, 33733
24,33734,1,1,1, 33735
25,33740,2,2,1, 33742
31,33741,2,2,1, 33743
7,33747,1,1,1, 33748
24,33749,1,1,1, 33750
7,33762,1,1,1, 33763
24,33764,1,1,1, 33765
8,33766,1,1,1, 33767
25,33770,2,2,1, 33772
1,33771,1,1,0, 33772
26,33772,3,3,1, 33775
7,33777,1,1,1, 33778
24,33779,1,1,0, 33780
8,33781,1,1,1, 33782
1,33786,1,1,0, 33787
7,33792,1,1,1, 33793
8,33796,1,1,0, 33797
1,33801,1,1,0, 33802
31,33801,2,2,1, 33803
7,33807,1,1,0, 33808
8,33811,1,1,1, 33812
16,33814,2,2,1, 33816
1,33816,1,1,0, 33817
7,33822,1,1,1, 33823
8,33826,1,1,1, 33827
1,33831,1,1,0, 33832
15,33831,2,2,1, 33833
7,33837,1,1,1, 33838
8,33841,1,1,1, 33842
1,33846,1,1,0, 33847
15,33846,2,2,1, 33848
8,33856,1,1,1, 33857
16,33859,2,2,1, 33861
1,33861,1,1,1, 33862
15,33861,2,2,1, 33863
8,33871,1,1,1, 33872
1,33876,1,1,1, 33877
15,33876,2,2,1, 33878
24,33884,1,1,1, 33885
8,33886,1,1,1, 33887
9,33887,2,2,1, 33889
2,33888,2,2,1, 33890
16,33889,2,2,1, 33891
1,33891,1,1,0, 33892
24,33899,1,1,1, 33900
31,33906,2,2,1, 33908
24,33914,1,1,0, 33915
31,33921,2,2,1, 33923
24,33929,1,1,0, 33930
7,33942,1,1,0, 33943
24,33944,1,1,0, 33945
15,33951,2,2,1, 33953
6,33955,2,2,1, 33957
7,33957,1,1,1, 33958
24,33959,1,1,0, 33960
16,33964,2,2,1, 33966
7,33972,1,1,0, 33973
24,33974,1,1,0, 33975
16,33979,2,2,1, 33981
7,33987,1,1,0, 33988
24,33989,1,1,0, 33990
16,33994,2,2,1, 33996
6,34000,2,2,1, 34002
7,34002,1,1,0, 34003
24,34004,1,1,0, 34005
8,34006,1,1,0, 34007
25,34010,2,2,1, 34012
1,34011,1,1,0, 34012
7,34017,1,1,0, 34018
24,34019,1,1,1, 34020
8,34021,1,1,1, 34022
1,34026,1,1,1, 34027
31,34026,2,2,1, 34028
7,34032,1,1,0, 34033
8,34036,1,1,0, 34037
1,34041,1,1,0, 34042
31,34041,2,2,1, 34043
7,34047,1,1,1, 34048
8,34051,1,1,0, 34052
1,34056,1,1,1, 34057
7,34062,1,1,0, 34063
8,34066,1,1,1, 34067
1,34071,1,1,0, 34072
7,34077,1,1,1, 34078
8,34081,1,1,1, 34082
1,34086,1,1,1, 34087
15,34086,2,2,1, 34088
8,34096,1,1,1, 34097
16,34099,2,2,1, 34101
1,34101,1,1,1, 34102
15,34101,2,2,1, 34103
8,34111,1,1,0, 34112
16,34114,2,2,1, 34116
1,34116,1,1,1, 34117
24,34124,1,1,1, 34125
8,34126,1,1,0, 34127
1,34131,1,1,0, 34132
15,34131,2,2,1, 34133
26,34132,3,3,1, 34135
24,34139,1,1,1, 34140
1,34146,1,1,1, 34147
24,34154,1,1,1, 34155
1,34161,1,1,0, 34162
24,34169,1,1,1, 34170
1,34176,1,1,0, 34177
31,34176,2,2,1, 34178
7,34182,1,1,1, 34183
24,34184,1,1,1, 34185
1,34191,1,1,1, 34192
7,34197,1,1,0, 34198
24,34199,1,1,0, 34200
1,34206,1,1,1, 34207
7,34212,1,1,0, 34213
24,34214,1,1,1, 34215
1,34221,1,1,1, 34222
7,34227,1,1,0, 34228
24,34229,1,1,0, 34230
16,34234,2,2,1, 34236
1,34236,1,1,1, 34237
7,34242,1,1,1, 34243
24,34244,1,1,1, 34245
8,34246,1,1,0, 34247
2,34248,2,2,1, 34250
16,34249,2,2,1, 34251
1,34251,1,1,0, 34252
3,34252,3,3,1, 34255
26,34252,3,3,1, 34255
7,34257,1,1,1, 34258
24,34259,1,1,1, 34260
8,34261,1,1,1, 34262
9,34262,2,2,1, 34264
25,34265,2,2,1, 34267
7,34272,1,1,1, 34273
24,34274,1,1,1, 34275
8,34276,1,1,0, 34277
6,34285,2,2,1, 34287
7,34287,1,1,0, 34288
24,34289,1,1,0, 34290
8,34291,1,1,0, 34292
25,34295,2,2,1, 34297
7,34302,1,1,1, 34303
24,34304,1,1,1, 34305
8,34306,1,1,0, 34307
9,34307,2,2,1, 34309
25,34310,2,2,1, 34312
15,34311,2,2,1, 34313
6,34315,2,2,1, 34317
7,34317,1,1,0, 34318
24,34319,1,1,1, 34320
8,34321,1,1,0, 34322
9,34322,2,2,1, 34324
31,34326,2,2,1, 34328
24,34334,1,1,1, 34335
8,34336,1,1,0, 34337
25,34340,2,2,1, 34342
24,34349,1,1,1, 34350
8,34351,1,1,0, 34352
31,34356,2,2,1, 34358
24,34364,1,1,0, 34365
8,34366,1,1,1, 34367
25,34370,2,2,1, 34372
1,34371,1,1,0, 34372
24,34379,1,1,1, 34380
1,34386,1,1,0, 34387
1,34401,1,1,0, 34402
1,34416,1,1,1, 34417
1,34431,1,1,0, 34432
31,34431,2,2,1, 34433
6,34435,2,2,1, 34437
7,34437,1,1,0, 34438
1,34446,1,1,1, 34447
15,34446,2,2,1, 34448
31,34446,2,2,1, 34448
7,34452,1,1,1, 34453
1,34461,1,1,1, 34462
6,34465,2,2,1, 34467
7,34467,1,1,1, 34468
1,34476,1,1,1, 34477
6,34480,2,2,1, 34482
7,34482,1,1,0, 34483
24,34484,1,1,0, 34485
8,34486,1,1,1, 34487
16,34489,2,2,1, 34491
1,34491,1,1,1, 34492
15,34491,2,2,1, 34493
31,34491,2,2,1, 34493
3,34492,3,3,1, 34495
26,34492,3,3,1, 34495
6,34495,2,2,1, 34497
7,34497,1,1,1, 34498
24,34499,1,1,0, 34500
8,34501,1,1,0, 34502
9,34502,2,2,1, 34504
25,34505,2,2,1, 34507
24,34514,1,1,0, 34515
8,34516,1,1,1, 34517
24,34529,1,1,1, 34530
8,34531,1,1,1, 34532
9,34532,2,2,1, 34534
25,34535,2,2,1, 34537
24,34544,1,1,1, 34545
8,34546,1,1,0, 34547
9,34547,2,2,1, 34549
24,34559,1,1,0, 34560
8,34561,1,1,1, 34562
9,34562,2,2,1, 34564
24,34574,1,1,0, 34575
8,34576,1,1,0, 34577
9,34577,2,2,1, 34579
24,34589,1,1,1, 34590
8,34591,1,1,1, 34592
7,34602,1,1,1, 34603
24,34604,1,1,0, 34605
8,34606,1,1,1, 34607
9,34607,2,2,1, 34609
1,34611,1,1,1, 34612
31,34611,2,2,1, 34613
7,34617,1,1,0, 34618
24,34619,1,1,1, 34620
1,34626,1,1,1, 34627
7,34632,1,1,0, 34633
1,34641,1,1,1, 34642
15,34641,2,2,1, 34643
31,34641,2,2,1, 34643
7,34647,1,1,0, 34648
1,34656,1,1,0, 34657
7,34662,1,1,1, 34663
9,34667,2,2,1, 34669
1,34671,1,1,1, 34672
7,34677,1,1,0, 34678
1,34686,1,1,0, 34687
15,34686,2,2,1, 34688
31,34686,2,2,1, 34688
7,34692,1,1,0, 34693
1,34701,1,1,0, 34702
15,34701,2,2,1, 34703
7,34707,1,1,1, 34708
9,34712,2,2,1, 34714
1,34716,1,1,0, 34717
15,34716,2,2,1, 34718
31,34716,2,2,1, 34718
7,34722,1,1,1, 34723
24,34724,1,1,1, 34725
8,34726,1,1,0, 34727
16,34729,2,2,1, 34731
1,34731,1,1,0, 34732
31,34731,2,2,1, 34733
7,34737,1,1,1, 34738
24,34739,1,1,1, 34740
8,34741,1,1,0, 34742
31,34746,2,2,1, 34748
24,34754,1,1,1, 34755
8,34756,1,1,0, 34757
24,34769,1,1,1, 34770
8,34771,1,1,0, 34772
31,34776,2,2,1, 34778
24,34784,1,1,0, 34785
8,34786,1,1,0, 34787
31,34791,2,2,1, 34793
24,34799,1,1,1, 34800
8,34801,1,1,0, 34802
31,34806,2,2,1, 34808
24,34814,1,1,1, 34815
8,34816,1,1,0, 34817
24,34829,1,1,0, 34830
8,34831,1,1,1, 34832
31,34836,2,2,1, 34838
24,34844,1,1,0, 34845
8,34846,1,1,1, 34847
1,34851,1,1,1, 34852
31,34851,2,2,1, 34853
26,34852,3,3,1, 34855
7,34857,1,1,1, 34858
24,34859,1,1,1, 34860
8,34861,1,1,0, 34862
1,34866,1,1,0, 34867
31,34866,2,2,1, 34868
6,34870,2,2,1, 34872
7,34872,1,1,1, 34873
8,34876,1,1,0, 34877
1,34881,1,1,0, 34882
6,34885,2,2,1, 34887
7,34887,1,1,0, 34888
8,34891,1,1,0, 34892
1,34896,1,1,0, 34897
7,34902,1,1,1, 34903
8,34906,1,1,0, 34907
1,34911,1,1,1, 34912
31,34911,2,2,1, 34913
6,34915,2,2,1, 34917
7,34917,1,1,0, 34918
8,34921,1,1,0, 34922
1,34926,1,1,0, 34927
31,34926,2,2,1, 34928
7,34932,1,1,0, 34933
8,34936,1,1,0, 34937
16,34939,2,2,1, 34941
1,34941,1,1,1, 34942
31,34941,2,2,1, 34943
6,34945,2,2,1, 34947
7,34947,1,1,1, 34948
8,34951,1,1,0, 34952
16,34954,2,2,1, 34956
1,34956,1,1,0, 34957
7,34962,1,1,1, 34963
24,34964,1,1,0, 34965
8,34966,1,1,1, 34967
2,34968,2,2,1, 34970
16,34969,2,2,1, 34971
25,34970,2,2,1, 34972
1,34971,1,1,0, 34972
3,34972,3,3,1, 34975
6,34975,2,2,1, 34977
7,34977,1,1,1, 34978
24,34979,1,1,0, 34980
31,34986,2,2,1, 34988
24,34994,1,1,1, 34995
31,35001,2,2,1, 35003
24,35009,1,1,0, 35010
24,35024,1,1,1, 35025
31,35031,2,2,1, 35033
24,35039,1,1,0, 35040
24,35054,1,1,1, 35055
24,35069,1,1,1, 35070
25,35075,2,2,1, 35077
24,35084,1,1,1, 35085
8,35086,1,1,1, 35087
2,35088,2,2,1, 35090
1,35091,1,1,0, 35092
31,35091,2,2,1, 35093
3,35092,3,3,1, 35095
7,35097,1,1,1, 35098
24,35099,1,1,1, 35100
8,35101,1,1,0, 35102
9,35102,2,2,1, 35104
16,35104,2,2,1, 35106
31,35106,2,2,1, 35108
7,35112,1,1,0, 35113
8,35116,1,1,1, 35117
7,35127,1,1,0, 35128
8,35131,1,1,1, 35132
7,35142,1,1,0, 35143
8,35146,1,1,1, 35147
7,35157,1,1,1, 35158
8,35161,1,1,1, 35162
16,35164,2,2,1, 35166
31,35166,2,2,1, 35168
7,35172,1,1,1, 35173
8,35176,1,1,1, 35177
31,35181,2,2,1, 35183
7,35187,1,1,1, 35188
8,35191,1,1,1, 35192
16,35194,2,2,1, 35196
31,35196,2,2,1, 35198
7,35202,1,1,1, 35203
8,35206,1,1,1, 35207
2,35208,2,2,1, 35210
1,35211,1,1,0, 35212
15,35211,2,2,1, 35213
3,35212,3,3,1, 35215
26,35212,3,3,1, 35215
7,35217,1,1,1, 35218
24,35219,1,1,0, 35220
9,35222,2,2,1, 35224
16,35224,2,2,1, 35226
25,35225,2,2,1, 35227
31,35226,2,2,1, 35228
24,35234,1,1,1, 35235
16,35239,2,2,1, 35241
31,35241,2,2,1, 35243
24,35249,1,1,0, 35250
16,35254,2,2,1, 35256
25,35255,2,2,1, 35257
31,35256,2,2,1, 35258
24,35264,1,1,0, 35265
31,35271,2,2,1, 35273
24,35279,1,1,0, 35280
8,35326,1,1,0, 35327
9,35327,2,2,1, 35329
2,35328,2,2,1, 35330
1,35331,1,1,1, 35332
15,35331,2,2,1, 35333
7,35337,1,1,0, 35338
8,35341,1,1,0, 35342
1,35346,1,1,1, 35347
7,35352,1,1,1, 35353
8,35356,1,1,1, 35357
1,35361,1,1,1, 35362
7,35367,1,1,1, 35368
8,35371,1,1,0, 35372
1,35376,1,1,0, 35377
7,35382,1,1,1, 35383
24,35384,1,1,1, 35385
8,35386,1,1,0, 35387
1,35391,1,1,1, 35392
6,35395,2,2,1, 35397
7,35397,1,1,1, 35398
24,35399,1,1,1, 35400
8,35401,1,1,0, 35402
1,35406,1,1,0, 35407
7,35412,1,1,0, 35413
24,35414,1,1,0, 35415
8,35416,1,1,1, 35417
1,35421,1,1,1, 35422
15,35421,2,2,1, 35423
7,35427,1,1,0, 35428
24,35429,1,1,0, 35430
8,35431,1,1,1, 35432
1,35436,1,1,1, 35437
31,35436,2,2,1, 35438
7,35442,1,1,1, 35443
24,35444,1,1,0, 35445
8,35446,1,1,0, 35447
9,35447,2,2,1, 35449
16,35449,2,2,1, 35451
1,35451,1,1,1, 35452
31,35451,2,2,1, 35453
26,35452,3,3,1, 35455
7,35457,1,1,1, 35458
24,35459,1,1,0, 35460
8,35461,1,1,0, 35462
9,35462,2,2,1, 35464
16,35464,2,2,1, 35466
25,35465,2,2,1, 35467
6,35470,2,2,1, 35472
7,35472,1,1,1, 35473
24,35474,1,1,0, 35475
8,35476,1,1,1, 35477
9,35477,2,2,1, 35479
25,35480,2,2,1, 35482
7,35487,1,1,1, 35488
24,35489,1,1,1, 35490
8,35491,1,1,1, 35492
25,35495,2,2,1, 35497
31,35496,2,2,1, 35498
7,35502,1,1,0, 35503
24,35504,1,1,0, 35505
8,35506,1,1,0, 35507
16,35509,2,2,1, 35511
25,35510,2,2,1, 35512
7,35517,1,1,0, 35518
24,35519,1,1,0, 35520
31,35526,2,2,1, 35528
7,35532,1,1,1, 35533
7,35547,1,1,0, 35548
7,35562,1,1,1, 35563
1,35571,1,1,1, 35572
15,35571,2,2,1, 35573
31,35571,2,2,1, 35573
3,35572,3,3,1, 35575
26,35572,3,3,1, 35575
7,35577,1,1,0, 35578
8,35581,1,1,1, 35582
2,35583,2,2,1, 35585
1,35586,1,1,1, 35587
1,35601,1,1,1, 35602
1,35616,1,1,1, 35617
24,35624,1,1,1, 35625
16,35629,2,2,1, 35631
1,35631,1,1,0, 35632
31,35631,2,2,1, 35633
24,35639,1,1,0, 35640
25,35645,2,2,1, 35647
1,35646,1,1,1, 35647
31,35646,2,2,1, 35648
24,35654,1,1,1, 35655
1,35661,1,1,0, 35662
31,35661,2,2,1, 35663
24,35669,1,1,0, 35670
1,35676,1,1,0, 35677
31,35676,2,2,1, 35678
24,35684,1,1,1, 35685
25,35690,2,2,1, 35692
1,35691,1,1,1, 35692
31,35691,2,2,1, 35693
3,35692,3,3,1, 35695
7,35697,1,1,0, 35698
24,35699,1,1,0, 35700
8,35701,1,1,1, 35702
9,35702,2,2,1, 35704
6,35710,2,2,1, 35712
7,35712,1,1,0, 35713
7,35727,1,1,0, 35728
31,35736,2,2,1, 35738
6,35740,2,2,1, 35742
7,35742,1,1,1, 35743
7,35757,1,1,0, 35758
15,35766,2,2,1, 35768
7,35772,1,1,0, 35773
7,35787,1,1,1, 35788
15,35796,2,2,1, 35798
7,35802,1,1,0, 35803
24,35804,1,1,0, 35805
8,35806,1,1,1, 35807
1,35811,1,1,1, 35812
15,35811,2,2,1, 35813
3,35812,3,3,1, 35815
26,35812,3,3,1, 35815
7,35817,1,1,1, 35818
24,35819,1,1,1, 35820
8,35821,1,1,1, 35822
1,35826,1,1,1, 35827
24,35834,1,1,1, 35835
8,35836,1,1,1, 35837
16,35839,2,2,1, 35841
1,35841,1,1,1, 35842
24,35849,1,1,1, 35850
8,35851,1,1,0, 35852
25,35855,2,2,1, 35857
1,35856,1,1,1, 35857
31,35856,2,2,1, 35858
24,35864,1,1,0, 35865
8,35866,1,1,0, 35867
1,35871,1,1,0, 35872
31,35871,2,2,1, 35873
24,35879,1,1,0, 35880
8,35881,1,1,0, 35882
1,35886,1,1,1, 35887
8,35896,1,1,1, 35897
16,35899,2,2,1, 35901
1,35901,1,1,1, 35902
8,35911,1,1,0, 35912
25,35915,2,2,1, 35917
1,35916,1,1,1, 35917
8,35926,1,1,0, 35927
9,35927,2,2,1, 35929
16,35929,2,2,1, 35931
25,35930,2,2,1, 35932
1,35931,1,1,0, 35932
31,35931,2,2,1, 35933
7,35937,1,1,1, 35938
7,35952,1,1,0, 35953
15,35961,2,2,1, 35963
7,35967,1,1,0, 35968
15,35976,2,2,1, 35978
7,35982,1,1,1, 35983
24,35984,1,1,0, 35985
16,35989,2,2,1, 35991
15,35991,2,2,1, 35993
7,35997,1,1,1, 35998
24,35999,1,1,0, 36000
31,36006,2,2,1, 36008
7,36012,1,1,0, 36013
24,36014,1,1,1, 36015
31,36021,2,2,1, 36023
7,36027,1,1,0, 36028
24,36029,1,1,1, 36030
31,36036,2,2,1, 36038
7,36042,1,1,0, 36043
24,36044,1,1,0, 36045
8,36046,1,1,0, 36047
9,36047,2,2,1, 36049
25,36050,2,2,1, 36052
1,36051,1,1,1, 36052
31,36051,2,2,1, 36053
3,36052,3,3,1, 36055
26,36052,3,3,1, 36055
6,36055,2,2,1, 36057
7,36057,1,1,1, 36058
24,36059,1,1,1, 36060
8,36061,1,1,0, 36062
25,36065,2,2,1, 36067
1,36066,1,1,1, 36067
15,36066,2,2,1, 36068
24,36074,1,1,0, 36075
8,36076,1,1,0, 36077
1,36081,1,1,1, 36082
15,36081,2,2,1, 36083
31,36081,2,2,1, 36083
24,36089,1,1,1, 36090
8,36091,1,1,1, 36092
1,36096,1,1,0, 36097
15,36096,2,2,1, 36098
24,36104,1,1,1, 36105
8,36106,1,1,0, 36107
1,36111,1,1,0, 36112
24,36119,1,1,0, 36120
8,36121,1,1,0, 36122
1,36126,1,1,0, 36127
15,36126,2,2,1, 36128
7,36132,1,1,0, 36133
8,36136,1,1,0, 36137
16,36139,2,2,1, 36141
25,36140,2,2,1, 36142
1,36141,1,1,0, 36142
15,36141,2,2,1, 36143
7,36147,1,1,0, 36148
8,36151,1,1,1, 36152
25,36155,2,2,1, 36157
1,36156,1,1,0, 36157
15,36156,2,2,1, 36158
31,36156,2,2,1, 36158
7,36162,1,1,0, 36163
8,36166,1,1,0, 36167
9,36167,2,2,1, 36169
2,36168,2,2,1, 36170
16,36169,2,2,1, 36171
25,36170,2,2,1, 36172
1,36171,1,1,0, 36172
3,36172,3,3,1, 36175
7,36177,1,1,1, 36178
8,36181,1,1,0, 36182
9,36182,2,2,1, 36184
31,36186,2,2,1, 36188
7,36192,1,1,0, 36193
7,36207,1,1,1, 36208
31,36216,2,2,1, 36218
7,36222,1,1,1, 36223
24,36224,1,1,1, 36225
31,36231,2,2,1, 36233
7,36237,1,1,0, 36238
24,36239,1,1,1, 36240
31,36246,2,2,1, 36248
7,36252,1,1,0, 36253
24,36254,1,1,0, 36255
31,36261,2,2,1, 36263
6,36265,2,2,1, 36267
7,36267,1,1,0, 36268
24,36269,1,1,1, 36270
31,36276,2,2,1, 36278
24,36284,1,1,0, 36285
1,36291,1,1,1, 36292
3,36292,3,3,1, 36295
24,36299,1,1,0, 36300
8,36301,1,1,0, 36302
1,36306,1,1,1, 36307
24,36314,1,1,1, 36315
8,36316,1,1,1, 36317
25,36320,2,2,1, 36322
1,36321,1,1,0, 36322
24,36329,1,1,0, 36330
8,36331,1,1,0, 36332
25,36335,2,2,1, 36337
1,36336,1,1,0, 36337
24,36344,1,1,1, 36345
8,36346,1,1,0, 36347
1,36351,1,1,1, 36352
24,36359,1,1,0, 36360
8,36361,1,1,0, 36362
1,36366,1,1,0, 36367
24,36374,1,1,1, 36375
8,36376,1,1,1, 36377
1,36381,1,1,1, 36382
24,36389,1,1,1, 36390
8,36391,1,1,1, 36392
25,36395,2,2,1, 36397
1,36396,1,1,1, 36397
7,36402,1,1,1, 36403
24,36404,1,1,1, 36405
8,36406,1,1,1, 36407
16,36409,2,2,1, 36411
1,36411,1,1,0, 36412
15,36411,2,2,1, 36413
7,36417,1,1,0, 36418
24,36419,1,1,0, 36420
8,36421,1,1,1, 36422
9,36422,2,2,1, 36424
6,36430,2,2,1, 36432
7,36432,1,1,0, 36433
8,36436,1,1,1, 36437
31,36441,2,2,1, 36443
6,36445,2,2,1, 36447
7,36447,1,1,1, 36448
8,36451,1,1,1, 36452
8,36466,1,1,0, 36467
8,36481,1,1,1, 36482
8,36496,1,1,0, 36497
8,36511,1,1,0, 36512
8,36526,1,1,1, 36527
16,36529,2,2,1, 36531
1,36531,1,1,0, 36532
24,36539,1,1,0, 36540
8,36541,1,1,1, 36542
1,36546,1,1,1, 36547
6,36550,2,2,1, 36552
7,36552,1,1,0, 36553
24,36554,1,1,0, 36555
25,36560,2,2,1, 36562
1,36561,1,1,0, 36562
31,36561,2,2,1, 36563
7,36567,1,1,1, 36568
24,36569,1,1,1, 36570
25,36575,2,2,1, 36577
1,36576,1,1,0, 36577
31,36576,2,2,1, 36578
6,36580,2,2,1, 36582
7,36582,1,1,1, 36583
24,36584,1,1,0, 36585
1,36591,1,1,0, 36592
31,36591,2,2,1, 36593
7,36597,1,1,1, 36598
24,36599,1,1,0, 36600
1,36606,1,1,1, 36607
7,36612,1,1,1, 36613
24,36614,1,1,0, 36615
1,36621,1,1,1, 36622
6,36625,2,2,1, 36627
7,36627,1,1,0, 36628
24,36629,1,1,0, 36630
1,36636,1,1,1, 36637
31,36636,2,2,1, 36638
6,36640,2,2,1, 36642
7,36642,1,1,0, 36643
24,36644,1,1,0, 36645
1,36651,1,1,0, 36652
15,36651,2,2,1, 36653
31,36651,2,2,1, 36653
3,36652,3,3,1, 36655
7,36657,1,1,0, 36658
24,36659,1,1,1, 36660
8,36661,1,1,1, 36662
16,36664,2,2,1, 36666
15,36666,2,2,1, 36668
7,36762,1,1,1, 36763
24,36764,1,1,0, 36765
2,36768,2,2,1, 36770
1,36771,1,1,0, 36772
3,36772,3,3,1, 36775
26,36772,3,3,1, 36775
7,36777,1,1,1, 36778
24,36779,1,1,1, 36780
8,36781,1,1,0, 36782
9,36782,2,2,1, 36784
31,36786,2,2,1, 36788
7,36792,1,1,1, 36793
24,36794,1,1,0, 36795
8,36796,1,1,1, 36797
31,36801,2,2,1, 36803
7,36807,1,1,0, 36808
24,36809,1,1,0, 36810
8,36811,1,1,1, 36812
31,36816,2,2,1, 36818
7,36822,1,1,1, 36823
24,36824,1,1,0, 36825
8,36826,1,1,0, 36827
9,36827,2,2,1, 36829
7,36837,1,1,0, 36838
24,36839,1,1,0, 36840
8,36841,1,1,1, 36842
9,36842,2,2,1, 36844
7,36852,1,1,0, 36853
24,36854,1,1,0, 36855
8,36856,1,1,0, 36857
9,36857,2,2,1, 36859
31,36861,2,2,1, 36863
7,36867,1,1,0, 36868
24,36869,1,1,0, 36870
8,36871,1,1,0, 36872
31,36876,2,2,1, 36878
7,36882,1,1,0, 36883
24,36884,1,1,0, 36885
8,36886,1,1,1, 36887
1,36891,1,1,0, 36892
26,36892,3,3,1, 36895
7,36897,1,1,0, 36898
24,36899,1,1,0, 36900
31,36906,2,2,1, 36908
24,36914,1,1,0, 36915
31,36921,2,2,1, 36923
24,36929,1,1,0, 36930
24,36944,1,1,1, 36945
24,36959,1,1,1, 36960
31,36966,2,2,1, 36968
24,36974,1,1,0, 36975
31,36981,2,2,1, 36983
24,36989,1,1,0, 36990
7,37002,1,1,1, 37003
24,37004,1,1,0, 37005
8,37006,1,1,1, 37007
9,37007,2,2,1, 37009
16,37009,2,2,1, 37011
1,37011,1,1,0, 37012
31,37011,2,2,1, 37013
6,37015,2,2,1, 37017
7,37017,1,1,1, 37018
24,37019,1,1,0, 37020
1,37026,1,1,1, 37027
31,37026,2,2,1, 37028
6,37030,2,2,1, 37032
7,37032,1,1,1, 37033
1,37041,1,1,1, 37042
7,37047,1,1,1, 37048
1,37056,1,1,1, 37057
7,37062,1,1,0, 37063
1,37071,1,1,0, 37072
7,37077,1,1,1, 37078
1,37086,1,1,1, 37087
7,37092,1,1,0, 37093
1,37101,1,1,0, 37102
7,37107,1,1,0, 37108
1,37116,1,1,0, 37117
31,37116,2,2,1, 37118
7,37122,1,1,1, 37123
24,37124,1,1,0, 37125
8,37126,1,1,0, 37127
2,37128,2,2,1, 37130
25,37130,2,2,1, 37132
1,37131,1,1,0, 37132
31,37131,2,2,1, 37133
7,37137,1,1,0, 37138
24,37139,1,1,0, 37140
8,37141,1,1,0, 37142
9,37142,2,2,1, 37144
31,37146,2,2,1, 37148
24,37154,1,1,0, 37155
8,37156,1,1,1, 37157
9,37157,2,2,1, 37159
31,37161,2,2,1, 37163
24,37169,1,1,1, 37170
8,37171,1,1,1, 37172
9,37172,2,2,1, 37174
15,37176,2,2,1, 37178
31,37176,2,2,1, 37178
24,37184,1,1,0, 37185
8,37186,1,1,1, 37187
15,37191,2,2,1, 37193
24,37199,1,1,0, 37200
8,37201,1,1,1, 37202
9,37202,2,2,1, 37204
24,37214,1,1,0, 37215
8,37216,1,1,1, 37217
24,37229,1,1,1, 37230
8,37231,1,1,1, 37232
31,37236,2,2,1, 37238
24,37244,1,1,1, 37245
8,37246,1,1,1, 37247
1,37251,1,1,1, 37252
3,37252,3,3,1, 37255
26,37252,3,3,1, 37255
7,37257,1,1,1, 37258
24,37259,1,1,0, 37260
16,37264,2,2,1, 37266
1,37266,1,1,1, 37267
31,37266,2,2,1, 37268
7,37272,1,1,0, 37273
24,37274,1,1,1, 37275
25,37280,2,2,1, 37282
1,37281,1,1,0, 37282
6,37285,2,2,1, 37287
7,37287,1,1,1, 37288
24,37289,1,1,1, 37290
1,37296,1,1,1, 37297
6,37300,2,2,1, 37302
7,37302,1,1,0, 37303
24,37304,1,1,0, 37305
16,37309,2,2,1, 37311
1,37311,1,1,1, 37312
6,37315,2,2,1, 37317
7,37317,1,1,0, 37318
24,37319,1,1,1, 37320
1,37326,1,1,1, 37327
7,37332,1,1,0, 37333
1,37341,1,1,0, 37342
7,37347,1,1,0, 37348
25,37355,2,2,1, 37357
1,37356,1,1,0, 37357
31,37356,2,2,1, 37358
7,37362,1,1,0, 37363
8,37366,1,1,0, 37367
2,37368,2,2,1, 37370
1,37371,1,1,0, 37372
31,37371,2,2,1, 37373
7,37377,1,1,1, 37378
8,37381,1,1,0, 37382
16,37384,2,2,1, 37386
8,37396,1,1,0, 37397
8,37411,1,1,1, 37412
8,37426,1,1,1, 37427
9,37427,2,2,1, 37429
24,37439,1,1,0, 37440
8,37441,1,1,0, 37442
16,37444,2,2,1, 37446
31,37446,2,2,1, 37448
24,37454,1,1,1, 37455
31,37461,2,2,1, 37463
24,37469,1,1,1, 37470
7,37482,1,1,1, 37483
24,37484,1,1,1, 37485
25,37490,2,2,1, 37492
1,37491,1,1,1, 37492
7,37497,1,1,1, 37498
24,37499,1,1,1, 37500
8,37501,1,1,0, 37502
25,37505,2,2,1, 37507
1,37506,1,1,1, 37507
15,37506,2,2,1, 37508
7,37512,1,1,0, 37513
24,37514,1,1,1, 37515
8,37516,1,1,1, 37517
1,37521,1,1,0, 37522
15,37521,2,2,1, 37523
6,37525,2,2,1, 37527
7,37527,1,1,1, 37528
24,37529,1,1,1, 37530
8,37531,1,1,1, 37532
25,37535,2,2,1, 37537
1,37536,1,1,1, 37537
15,37536,2,2,1, 37538
31,37536,2,2,1, 37538
6,37540,2,2,1, 37542
7,37542,1,1,1, 37543
24,37544,1,1,0, 37545
8,37546,1,1,1, 37547
25,37550,2,2,1, 37552
1,37551,1,1,0, 37552
31,37551,2,2,1, 37553
6,37555,2,2,1, 37557
7,37557,1,1,1, 37558
24,37559,1,1,1, 37560
8,37561,1,1,0, 37562
9,37562,2,2,1, 37564
16,37564,2,2,1, 37566
25,37565,2,2,1, 37567
1,37566,1,1,1, 37567
8,37576,1,1,0, 37577
9,37577,2,2,1, 37579
16,37579,2,2,1, 37581
25,37580,2,2,1, 37582
1,37581,1,1,1, 37582
8,37591,1,1,0, 37592
16,37594,2,2,1, 37596
25,37595,2,2,1, 37597
1,37596,1,1,0, 37597
8,37606,1,1,1, 37607
2,37608,2,2,1, 37610
1,37611,1,1,1, 37612
26,37612,3,3,1, 37615
24,37664,1,1,0, 37665
16,37669,2,2,1, 37671
6,37675,2,2,1, 37677
7,37677,1,1,0, 37678
24,37679,1,1,1, 37680
8,37681,1,1,0, 37682
1,37686,1,1,0, 37687
7,37692,1,1,0, 37693
24,37694,1,1,0, 37695
8,37696,1,1,1, 37697
1,37701,1,1,1, 37702
7,37707,1,1,0, 37708
24,37709,1,1,0, 37710
8,37711,1,1,0, 37712
1,37716,1,1,0, 37717
15,37716,2,2,1, 37718
7,37722,1,1,0, 37723
24,37724,1,1,0, 37725
8,37726,1,1,0, 37727
1,37731,1,1,1, 37732
15,37731,2,2,1, 37733
7,37737,1,1,1, 37738
24,37739,1,1,0, 37740
8,37741,1,1,1, 37742
7,37752,1,1,0, 37753
24,37754,1,1,0, 37755
8,37756,1,1,1, 37757
9,37757,2,2,1, 37759
31,37761,2,2,1, 37763
7,37767,1,1,1, 37768
24,37769,1,1,0, 37770
8,37771,1,1,1, 37772
7,37782,1,1,1, 37783
24,37784,1,1,1, 37785
8,37786,1,1,0, 37787
16,37789,2,2,1, 37791
7,37797,1,1,0, 37798
24,37799,1,1,0, 37800
16,37804,2,2,1, 37806
6,37810,2,2,1, 37812
7,37812,1,1,1, 37813
24,37814,1,1,1, 37815
15,37821,2,2,1, 37823
31,37821,2,2,1, 37823
6,37825,2,2,1, 37827
7,37827,1,1,0, 37828
24,37829,1,1,0, 37830
15,37836,2,2,1, 37838
7,37842,1,1,1, 37843
24,37844,1,1,1, 37845
25,37850,2,2,1, 37852
1,37851,1,1,1, 37852
7,37857,1,1,1, 37858
24,37859,1,1,0, 37860
1,37866,1,1,1, 37867
9,37877,2,2,1, 37879
1,37881,1,1,1, 37882
1,37896,1,1,0, 37897
8,37906,1,1,0, 37907
16,37909,2,2,1, 37911
1,37911,1,1,1, 37912
15,37911,2,2,1, 37913
8,37921,1,1,0, 37922
16,37924,2,2,1, 37926
25,37925,2,2,1, 37927
1,37926,1,1,1, 37927
8,37936,1,1,0, 37937
25,37940,2,2,1, 37942
1,37941,1,1,0, 37942
8,37951,1,1,1, 37952
1,37956,1,1,0, 37957
24,37964,1,1,0, 37965
8,37966,1,1,0, 37967
1,37971,1,1,1, 37972
7,37977,1,1,1, 37978
24,37979,1,1,1, 37980
8,37981,1,1,0, 37982
1,37986,1,1,0, 37987
31,37986,2,2,1, 37988
7,37992,1,1,0, 37993
24,37994,1,1,1, 37995
8,37996,1,1,1, 37997
9,37997,2,2,1, 37999
1,38001,1,1,1, 38002
7,38007,1,1,0, 38008
24,38009,1,1,1, 38010
8,38011,1,1,0, 38012
2,38013,2,2,1, 38015
1,38016,1,1,0, 38017
7,38022,1,1,1, 38023
24,38024,1,1,1, 38025
8,38026,1,1,0, 38027
1,38031,1,1,1, 38032
7,38037,1,1,0, 38038
24,38039,1,1,1, 38040
8,38041,1,1,0, 38042
24,38054,1,1,1, 38055
8,38056,1,1,1, 38057
31,38061,2,2,1, 38063
24,38069,1,1,0, 38070
8,38071,1,1,0, 38072
24,38084,1,1,1, 38085
8,38086,1,1,0, 38087
31,38091,2,2,1, 38093
24,38099,1,1,0, 38100
8,38101,1,1,0, 38102
16,38104,2,2,1, 38106
1,38106,1,1,0, 38107
8,38116,1,1,0, 38117
16,38119,2,2,1, 38121
25,38120,2,2,1, 38122
1,38121,1,1,1, 38122
8,38131,1,1,0, 38132
16,38134,2,2,1, 38136
1,38136,1,1,1, 38137
15,38136,2,2,1, 38138
7,38142,1,1,0, 38143
8,38146,1,1,0, 38147
2,38148,2,2,1, 38150
1,38151,1,1,1, 38152
15,38151,2,2,1, 38153
31,38151,2,2,1, 38153
7,38157,1,1,0, 38158
9,38162,2,2,1, 38164
25,38165,2,2,1, 38167
1,38166,1,1,1, 38167
7,38172,1,1,0, 38173
1,38181,1,1,0, 38182
7,38187,1,1,0, 38188
1,38196,1,1,0, 38197
31,38196,2,2,1, 38198
7,38202,1,1,1, 38203
24,38204,1,1,0, 38205
1,38211,1,1,1, 38212
7,38217,1,1,1, 38218
24,38219,1,1,1, 38220
8,38221,1,1,1, 38222
9,38222,2,2,1, 38224
16,38224,2,2,1, 38226
31,38226,2,2,1, 38228
6,38230,2,2,1, 38232
7,38232,1,1,1, 38233
24,38234,1,1,0, 38235
8,38236,1,1,1, 38237
9,38237,2,2,1, 38239
16,38239,2,2,1, 38241
31,38241,2,2,1, 38243
7,38247,1,1,1, 38248
24,38249,1,1,1, 38250
8,38251,1,1,0, 38252
9,38252,2,2,1, 38254
16,38254,2,2,1, 38256
7,38262,1,1,0, 38263
24,38264,1,1,1, 38265
8,38266,1,1,1, 38267
31,38271,2,2,1, 38273
6,38275,2,2,1, 38277
7,38277,1,1,1, 38278
24,38279,1,1,1, 38280
9,38282,2,2,1, 38284
2,38283,2,2,1, 38285
1,38286,1,1,0, 38287
6,38290,2,2,1, 38292
7,38292,1,1,1, 38293
1,38301,1,1,0, 38302
31,38301,2,2,1, 38303
6,38305,2,2,1, 38307
7,38307,1,1,1, 38308
1,38316,1,1,0, 38317
6,38320,2,2,1, 38322
7,38322,1,1,0, 38323
9,38327,2,2,1, 38329
1,38331,1,1,0, 38332
31,38331,2,2,1, 38333
6,38335,2,2,1, 38337
7,38337,1,1,0, 38338
9,38342,2,2,1, 38344
1,38346,1,1,1, 38347
7,38352,1,1,0, 38353
1,38361,1,1,0, 38362
7,38367,1,1,1, 38368
9,38372,2,2,1, 38374
1,38376,1,1,0, 38377
7,38382,1,1,0, 38383
8,38386,1,1,0, 38387
16,38389,2,2,1, 38391
1,38391,1,1,1, 38392
7,38397,1,1,0, 38398
24,38399,1,1,1, 38400
8,38401,1,1,0, 38402
9,38402,2,2,1, 38404
31,38406,2,2,1, 38408
24,38414,1,1,0, 38415
8,38416,1,1,1, 38417
9,38417,2,2,1, 38419
31,38421,2,2,1, 38423
24,38429,1,1,1, 38430
8,38431,1,1,1, 38432
24,38444,1,1,1, 38445
8,38446,1,1,1, 38447
9,38447,2,2,1, 38449
31,38451,2,2,1, 38453
24,38459,1,1,1, 38460
8,38461,1,1,0, 38462
31,38466,2,2,1, 38468
24,38474,1,1,1, 38475
8,38476,1,1,1, 38477
24,38489,1,1,0, 38490
8,38491,1,1,1, 38492
9,38492,2,2,1, 38494
24,38504,1,1,1, 38505
8,38506,1,1,1, 38507
9,38507,2,2,1, 38509
16,38509,2,2,1, 38511
1,38511,1,1,1, 38512
7,38517,1,1,1, 38518
24,38519,1,1,1, 38520
15,38526,2,2,1, 38528
7,38532,1,1,0, 38533
7,38547,1,1,1, 38548
15,38556,2,2,1, 38558
7,38562,1,1,1, 38563
15,38571,2,2,1, 38573
6,38575,2,2,1, 38577
7,38577,1,1,1, 38578
24,38624,1,1,0, 38625
8,38626,1,1,0, 38627
9,38627,2,2,1, 38629
2,38628,2,2,1, 38630
16,38629,2,2,1, 38631
1,38631,1,1,1, 38632
31,38631,2,2,1, 38633
24,38639,1,1,0, 38640
8,38641,1,1,1, 38642
1,38646,1,1,0, 38647
24,38654,1,1,0, 38655
8,38656,1,1,1, 38657
25,38660,2,2,1, 38662
1,38661,1,1,1, 38662
31,38661,2,2,1, 38663
24,38669,1,1,0, 38670
8,38671,1,1,1, 38672
1,38676,1,1,0, 38677
7,38682,1,1,1, 38683
24,38684,1,1,1, 38685
8,38686,1,1,1, 38687
25,38690,2,2,1, 38692
1,38691,1,1,0, 38692
31,38691,2,2,1, 38693
7,38697,1,1,0, 38698
24,38699,1,1,1, 38700
8,38701,1,1,0, 38702
1,38706,1,1,0, 38707
7,38712,1,1,0, 38713
8,38716,1,1,1, 38717
1,38721,1,1,0, 38722
6,38725,2,2,1, 38727
7,38727,1,1,0, 38728
8,38731,1,1,1, 38732
25,38735,2,2,1, 38737
1,38736,1,1,1, 38737
7,38742,1,1,1, 38743
8,38746,1,1,0, 38747
16,38749,2,2,1, 38751
25,38750,2,2,1, 38752
1,38751,1,1,0, 38752
15,38751,2,2,1, 38753
6,38755,2,2,1, 38757
7,38757,1,1,1, 38758
6,38770,2,2,1, 38772
7,38772,1,1,1, 38773
6,38785,2,2,1, 38787
7,38787,1,1,0, 38788
7,38802,1,1,1, 38803
7,38817,1,1,0, 38818
7,38832,1,1,0, 38833
7,38847,1,1,0, 38848
7,38862,1,1,1, 38863
24,38864,1,1,0, 38865
8,38866,1,1,0, 38867
16,38869,2,2,1, 38871
25,38870,2,2,1, 38872
1,38871,1,1,1, 38872
15,38871,2,2,1, 38873
7,38877,1,1,1, 38878
24,38879,1,1,0, 38880
8,38881,1,1,1, 38882
1,38886,1,1,0, 38887
24,38894,1,1,1, 38895
8,38896,1,1,1, 38897
1,38901,1,1,0, 38902
31,38901,2,2,1, 38903
24,38909,1,1,1, 38910
8,38911,1,1,1, 38912
25,38915,2,2,1, 38917
1,38916,1,1,1, 38917
31,38916,2,2,1, 38918
24,38924,1,1,0, 38925
8,38926,1,1,1, 38927
25,38930,2,2,1, 38932
1,38931,1,1,0, 38932
31,38931,2,2,1, 38933
24,38939,1,1,1, 38940
8,38941,1,1,1, 38942
1,38946,1,1,1, 38947
31,38946,2,2,1, 38948
24,38954,1,1,1, 38955
8,38956,1,1,0, 38957
1,38961,1,1,1, 38962
31,38961,2,2,1, 38963
24,38969,1,1,0, 38970
8,38971,1,1,0, 38972
1,38976,1,1,1, 38977
7,38982,1,1,0, 38983
24,38984,1,1,0, 38985
8,38986,1,1,0, 38987
2,38988,2,2,1, 38990
1,38991,1,1,0, 38992
15,38991,2,2,1, 38993
6,38995,2,2,1, 38997
7,38997,1,1,0, 38998
24,38999,1,1,1, 39000
8,39001,1,1,0, 39002
31,39006,2,2,1, 39008
7,39012,1,1,1, 39013
8,39016,1,1,0, 39017
9,39017,2,2,1, 39019
31,39021,2,2,1, 39023
7,39027,1,1,1, 39028
8,39031,1,1,1, 39032
16,39034,2,2,1, 39036
7,39042,1,1,0, 39043
8,39046,1,1,1, 39047
16,39049,2,2,1, 39051
7,39057,1,1,0, 39058
8,39061,1,1,1, 39062
16,39064,2,2,1, 39066
7,39072,1,1,0, 39073
8,39076,1,1,1, 39077
9,39077,2,2,1, 39079
16,39079,2,2,1, 39081
6,39085,2,2,1, 39087
7,39087,1,1,0, 39088
8,39091,1,1,0, 39092
31,39096,2,2,1, 39098
6,39100,2,2,1, 39102
7,39102,1,1,0, 39103
24,39104,1,1,1, 39105
8,39106,1,1,1, 39107
16,39109,2,2,1, 39111
25,39110,2,2,1, 39112
1,39111,1,1,1, 39112
31,39111,2,2,1, 39113
6,39115,2,2,1, 39117
7,39117,1,1,0, 39118
24,39119,1,1,0, 39120
16,39124,2,2,1, 39126
1,39126,1,1,1, 39127
31,39126,2,2,1, 39128
24,39134,1,1,0, 39135
16,39139,2,2,1, 39141
1,39141,1,1,1, 39142
31,39141,2,2,1, 39143
1,39156,1,1,0, 39157
1,39171,1,1,1, 39172
1,39186,1,1,0, 39187
1,39201,1,1,0, 39202
1,39216,1,1,1, 39217
9,39227,2,2,1, 39229
16,39229,2,2,1, 39231
1,39231,1,1,0, 39232
15,39231,2,2,1, 39233
7,39237,1,1,1, 39238
8,39241,1,1,0, 39242
25,39245,2,2,1, 39247
1,39246,1,1,0, 39247
31,39246,2,2,1, 39248
24,39254,1,1,1, 39255
8,39256,1,1,1, 39257
15,39261,2,2,1, 39263
31,39261,2,2,1, 39263
24,39269,1,1,0, 39270
8,39271,1,1,0, 39272
25,39275,2,2,1, 39277
31,39276,2,2,1, 39278
24,39284,1,1,0, 39285
8,39286,1,1,0, 39287
15,39291,2,2,1, 39293
31,39291,2,2,1, 39293
24,39299,1,1,1, 39300
8,39301,1,1,1, 39302
8,39316,1,1,1, 39317
15,39321,2,2,1, 39323
8,39331,1,1,1, 39332
7,39342,1,1,0, 39343
8,39346,1,1,1, 39347
7,39357,1,1,0, 39358
9,39362,2,2,1, 39364
1,39366,1,1,0, 39367
7,39372,1,1,0, 39373
25,39380,2,2,1, 39382
1,39381,1,1,1, 39382
31,39381,2,2,1, 39383
7,39387,1,1,1, 39388
1,39396,1,1,1, 39397
31,39396,2,2,1, 39398
7,39402,1,1,1, 39403
25,39410,2,2,1, 39412
1,39411,1,1,1, 39412
7,39417,1,1,1, 39418
1,39426,1,1,0, 39427
7,39432,1,1,1, 39433
1,39441,1,1,0, 39442
31,39441,2,2,1, 39443
7,39447,1,1,0, 39448
1,39456,1,1,1, 39457
7,39462,1,1,1, 39463
24,39464,1,1,0, 39465
8,39466,1,1,0, 39467
2,39468,2,2,1, 39470
1,39471,1,1,1, 39472
31,39471,2,2,1, 39473
6,39475,2,2,1, 39477
7,39477,1,1,1, 39478
24,39479,1,1,1, 39480
8,39481,1,1,1, 39482
9,39482,2,2,1, 39484
15,39486,2,2,1, 39488
24,39494,1,1,1, 39495
8,39496,1,1,1, 39497
9,39497,2,2,1, 39499
24,39509,1,1,0, 39510
8,39511,1,1,0, 39512
15,39516,2,2,1, 39518
31,39516,2,2,1, 39518
24,39524,1,1,1, 39525
8,39526,1,1,1, 39527
9,39527,2,2,1, 39529
15,39531,2,2,1, 39533
31,39531,2,2,1, 39533
24,39539,1,1,0, 39540
24,39554,1,1,0, 39555
31,39561,2,2,1, 39563
24,39569,1,1,1, 39570
31,39576,2,2,1, 39578
24,39584,1,1,1, 39585
9,39587,2,2,1, 39589
2,39588,2,2,1, 39590
1,39591,1,1,0, 39592
15,39591,2,2,1, 39593
6,39595,2,2,1, 39597
7,39597,1,1,1, 39598
24,39599,1,1,0, 39600
8,39601,1,1,1, 39602
1,39606,1,1,1, 39607
7,39612,1,1,1, 39613
24,39614,1,1,1, 39615
8,39616,1,1,0, 39617
1,39621,1,1,1, 39622
7,39627,1,1,1, 39628
24,39629,1,1,0, 39630
8,39631,1,1,1, 39632
16,39634,2,2,1, 39636
1,39636,1,1,0, 39637
6,39640,2,2,1, 39642
7,39642,1,1,1, 39643
24,39644,1,1,1, 39645
8,39646,1,1,0, 39647
1,39651,1,1,0, 39652
7,39657,1,1,1, 39658
24,39659,1,1,0, 39660
8,39661,1,1,1, 39662
16,39664,2,2,1, 39666
1,39666,1,1,1, 39667
7,39672,1,1,1, 39673
24,39674,1,1,0, 39675
8,39676,1,1,0, 39677
16,39679,2,2,1, 39681
1,39681,1,1,0, 39682
7,39687,1,1,1, 39688
24,39689,1,1,1, 39690
8,39691,1,1,0, 39692
1,39696,1,1,0, 39697
7,39702,1,1,1, 39703
24,39704,1,1,0, 39705
8,39706,1,1,1, 39707
9,39707,2,2,1, 39709
2,39708,2,2,1, 39710
16,39709,2,2,1, 39711
25,39710,2,2,1, 39712
1,39711,1,1,1, 39712
31,39711,2,2,1, 39713
7,39717,1,1,1, 39718
24,39719,1,1,1, 39720
8,39721,1,1,1, 39722
9,39722,2,2,1, 39724
7,39732,1,1,1, 39733
31,39741,2,2,1, 39743
7,39747,1,1,0, 39748
31,39756,2,2,1, 39758
7,39762,1,1,0, 39763
31,39771,2,2,1, 39773
7,39777,1,1,1, 39778
31,39786,2,2,1, 39788
7,39792,1,1,1, 39793
31,39801,2,2,1, 39803
7,39807,1,1,1, 39808
31,39816,2,2,1, 39818
7,39822,1,1,0, 39823
24,39824,1,1,1, 39825
16,39829,2,2,1, 39831
25,39830,2,2,1, 39832
1,39831,1,1,0, 39832
15,39831,2,2,1, 39833
7,39837,1,1,1, 39838
24,39839,1,1,0, 39840
8,39841,1,1,1, 39842
2,39843,2,2,1, 39845
24,39854,1,1,0, 39855
8,39856,1,1,0, 39857
24,39869,1,1,1, 39870
8,39871,1,1,1, 39872
25,39875,2,2,1, 39877
31,39876,2,2,1, 39878
24,39884,1,1,1, 39885
8,39886,1,1,0, 39887
25,39890,2,2,1, 39892
24,39899,1,1,1, 39900
8,39901,1,1,0, 39902
31,39906,2,2,1, 39908
24,39914,1,1,1, 39915
8,39916,1,1,1, 39917
24,39929,1,1,1, 39930
8,39931,1,1,0, 39932
25,39935,2,2,1, 39937
31,39936,2,2,1, 39938
7,39942,1,1,1, 39943
24,39944,1,1,1, 39945
8,39946,1,1,0, 39947
16,39949,2,2,1, 39951
1,39951,1,1,0, 39952
6,39955,2,2,1, 39957
7,39957,1,1,1, 39958
24,39959,1,1,0, 39960
8,39961,1,1,1, 39962
2,39963,2,2,1, 39965
1,39966,1,1,1, 39967
31,39966,2,2,1, 39968
7,39972,1,1,0, 39973
8,39976,1,1,0, 39977
9,39977,2,2,1, 39979
2,39978,2,2,1, 39980
1,39981,1,1,1, 39982
31,39981,2,2,1, 39983
7,39987,1,1,0, 39988
8,39991,1,1,0, 39992
9,39992,2,2,1, 39994
2,39993,2,2,1, 39995
16,39994,2,2,1, 39996
1,39996,1,1,0, 39997
7,40002,1,1,0, 40003
8,40006,1,1,0, 40007
2,40008,2,2,1, 40010
1,40011,1,1,0, 40012
31,40011,2,2,1, 40013
6,40015,2,2,1, 40017
7,40017,1,1,0, 40018
8,40021,1,1,0, 40022
16,40024,2,2,1, 40026
1,40026,1,1,1, 40027
7,40032,1,1,0, 40033
1,40041,1,1,0, 40042
31,40041,2,2,1, 40043
7,40047,1,1,1, 40048
1,40056,1,1,0, 40057
31,40056,2,2,1, 40058
7,40062,1,1,0, 40063
24,40064,1,1,1, 40065
16,40069,2,2,1, 40071
25,40070,2,2,1, 40072
1,40071,1,1,1, 40072
15,40071,2,2,1, 40073
7,40077,1,1,1, 40078
24,40079,1,1,1, 40080
31,40086,2,2,1, 40088
24,40094,1,1,1, 40095
31,40101,2,2,1, 40103
24,40109,1,1,1, 40110
25,40115,2,2,1, 40117
31,40116,2,2,1, 40118
24,40124,1,1,1, 40125
24,40139,1,1,0, 40140
31,40146,2,2,1, 40148
24,40154,1,1,1, 40155
25,40160,2,2,1, 40162
24,40169,1,1,0, 40170
31,40176,2,2,1, 40178
24,40184,1,1,0, 40185
8,40186,1,1,0, 40187
16,40189,2,2,1, 40191
1,40191,1,1,1, 40192
15,40191,2,2,1, 40193
31,40191,2,2,1, 40193
7,40197,1,1,0, 40198
24,40199,1,1,1, 40200
8,40201,1,1,0, 40202
2,40203,2,2,1, 40205
1,40206,1,1,1, 40207
31,40206,2,2,1, 40208
7,40212,1,1,1, 40213
8,40216,1,1,1, 40217
1,40221,1,1,1, 40222
6,40225,2,2,1, 40227
7,40227,1,1,1, 40228
8,40231,1,1,0, 40232
2,40233,2,2,1, 40235
16,40234,2,2,1, 40236
1,40236,1,1,0, 40237
7,40242,1,1,1, 40243
8,40246,1,1,0, 40247
16,40249,2,2,1, 40251
1,40251,1,1,0, 40252
6,40255,2,2,1, 40257
7,40257,1,1,0, 40258
8,40261,1,1,1, 40262
16,40264,2,2,1, 40266
1,40266,1,1,1, 40267
31,40266,2,2,1, 40268
6,40270,2,2,1, 40272
7,40272,1,1,1, 40273
8,40276,1,1,0, 40277
1,40281,1,1,1, 40282
31,40281,2,2,1, 40283
7,40287,1,1,0, 40288
8,40291,1,1,0, 40292
1,40296,1,1,1, 40297
6,40300,2,2,1, 40302
7,40302,1,1,0, 40303
8,40306,1,1,1, 40307
1,40311,1,1,0, 40312
7,40317,1,1,1, 40318
24,40319,1,1,1, 40320
31,40326,2,2,1, 40328
24,40334,1,1,1, 40335
25,40340,2,2,1, 40342
24,40349,1,1,1, 40350
24,40364,1,1,1, 40365
25,40370,2,2,1, 40372
24,40379,1,1,1, 40380
7,40422,1,1,0, 40423
8,40426,1,1,0, 40427
16,40429,2,2,1, 40431
25,40430,2,2,1, 40432
1,40431,1,1,1, 40432
15,40431,2,2,1, 40433
6,40435,2,2,1, 40437
7,40437,1,1,1, 40438
8,40441,1,1,1, 40442
1,40446,1,1,0, 40447
7,40452,1,1,0, 40453
8,40456,1,1,0, 40457
16,40459,2,2,1, 40461
1,40461,1,1,0, 40462
31,40461,2,2,1, 40463
7,40467,1,1,0, 40468
8,40471,1,1,1, 40472
16,40474,2,2,1, 40476
1,40476,1,1,0, 40477
31,40476,2,2,1, 40478
6,40480,2,2,1, 40482
7,40482,1,1,0, 40483
24,40484,1,1,1, 40485
8,40486,1,1,0, 40487
1,40491,1,1,1, 40492
31,40491,2,2,1, 40493
7,40497,1,1,1, 40498
24,40499,1,1,1, 40500
8,40501,1,1,0, 40502
1,40506,1,1,0, 40507
6,40510,2,2,1, 40512
7,40512,1,1,0, 40513
24,40514,1,1,1, 40515
8,40516,1,1,0, 40517
1,40521,1,1,0, 40522
31,40521,2,2,1, 40523
6,40525,2,2,1, 40527
7,40527,1,1,1, 40528
24,40529,1,1,1, 40530
8,40531,1,1,1, 40532
1,40536,1,1,0, 40537
31,40536,2,2,1, 40538
7,40542,1,1,1, 40543
24,40544,1,1,0, 40545
8,40546,1,1,0, 40547
9,40547,2,2,1, 40549
1,40551,1,1,0, 40552
15,40551,2,2,1, 40553
31,40551,2,2,1, 40553
6,40555,2,2,1, 40557
7,40557,1,1,0, 40558
24,40559,1,1,0, 40560
31,40566,2,2,1, 40568
24,40574,1,1,0, 40575
31,40581,2,2,1, 40583
24,40589,1,1,0, 40590
31,40596,2,2,1, 40598
24,40604,1,1,0, 40605
24,40619,1,1,0, 40620
24,40634,1,1,1, 40635
24,40649,1,1,1, 40650
31,40656,2,2,1, 40658
24,40664,1,1,0, 40665
8,40666,1,1,0, 40667
9,40667,2,2,1, 40669
2,40668,2,2,1, 40670
1,40671,1,1,0, 40672
6,40675,2,2,1, 40677
7,40677,1,1,1, 40678
24,40679,1,1,0, 40680
8,40681,1,1,1, 40682
1,40686,1,1,0, 40687
6,40690,2,2,1, 40692
7,40692,1,1,1, 40693
8,40696,1,1,1, 40697
1,40701,1,1,1, 40702
31,40701,2,2,1, 40703
7,40707,1,1,0, 40708
8,40711,1,1,0, 40712
16,40714,2,2,1, 40716
1,40716,1,1,1, 40717
31,40716,2,2,1, 40718
7,40722,1,1,0, 40723
8,40726,1,1,0, 40727
1,40731,1,1,0, 40732
7,40737,1,1,1, 40738
8,40741,1,1,1, 40742
16,40744,2,2,1, 40746
1,40746,1,1,0, 40747
31,40746,2,2,1, 40748
6,40750,2,2,1, 40752
7,40752,1,1,1, 40753
8,40756,1,1,0, 40757
16,40759,2,2,1, 40761
1,40761,1,1,1, 40762
31,40761,2,2,1, 40763
7,40767,1,1,0, 40768
8,40771,1,1,0, 40772
16,40774,2,2,1, 40776
1,40776,1,1,0, 40777
6,40780,2,2,1, 40782
7,40782,1,1,0, 40783
24,40784,1,1,1, 40785
8,40786,1,1,1, 40787
2,40788,2,2,1, 40790
1,40791,1,1,0, 40792
7,40797,1,1,1, 40798
24,40799,1,1,0, 40800
8,40801,1,1,1, 40802
25,40805,2,2,1, 40807
1,40806,1,1,0, 40807
31,40806,2,2,1, 40808
24,40814,1,1,1, 40815
8,40816,1,1,1, 40817
16,40819,2,2,1, 40821
1,40821,1,1,0, 40822
15,40821,2,2,1, 40823
24,40829,1,1,0, 40830
8,40831,1,1,1, 40832
1,40836,1,1,1, 40837
24,40844,1,1,1, 40845
8,40846,1,1,0, 40847
16,40849,2,2,1, 40851
25,40850,2,2,1, 40852
1,40851,1,1,1, 40852
24,40859,1,1,0, 40860
8,40861,1,1,1, 40862
16,40864,2,2,1, 40866
25,40865,2,2,1, 40867
1,40866,1,1,0, 40867
1,40881,1,1,1, 40882
1,40896,1,1,1, 40897
1,40911,1,1,1, 40912
7,40917,1,1,0, 40918
7,40932,1,1,0, 40933
31,40941,2,2,1, 40943
7,40947,1,1,1, 40948
7,40962,1,1,1, 40963
24,40964,1,1,0, 40965
16,40969,2,2,1, 40971
7,40977,1,1,1, 40978
24,40979,1,1,1, 40980
31,40986,2,2,1, 40988
7,40992,1,1,1, 40993
24,40994,1,1,1, 40995
16,40999,2,2,1, 41001
31,41001,2,2,1, 41003
7,41007,1,1,1, 41008
24,41009,1,1,0, 41010
31,41016,2,2,1, 41018
7,41022,1,1,1, 41023
24,41024,1,1,1, 41025
8,41026,1,1,0, 41027
9,41027,2,2,1, 41029
25,41030,2,2,1, 41032
1,41031,1,1,0, 41032
31,41031,2,2,1, 41033
6,41035,2,2,1, 41037
7,41037,1,1,0, 41038
24,41039,1,1,0, 41040
8,41041,1,1,0, 41042
25,41045,2,2,1, 41047
1,41046,1,1,1, 41047
15,41046,2,2,1, 41048
24,41054,1,1,0, 41055
8,41056,1,1,1, 41057
25,41060,2,2,1, 41062
1,41061,1,1,0, 41062
15,41061,2,2,1, 41063
31,41061,2,2,1, 41063
24,41069,1,1,0, 41070
8,41071,1,1,1, 41072
1,41076,1,1,0, 41077
24,41084,1,1,1, 41085
8,41086,1,1,0, 41087
25,41090,2,2,1, 41092
1,41091,1,1,0, 41092
15,41091,2,2,1, 41093
31,41091,2,2,1, 41093
24,41099,1,1,1, 41100
8,41101,1,1,0, 41102
1,41106,1,1,1, 41107
31,41106,2,2,1, 41108
24,41114,1,1,1, 41115
8,41116,1,1,0, 41117
1,41121,1,1,0, 41122
31,41121,2,2,1, 41123
24,41129,1,1,0, 41130
8,41131,1,1,1, 41132
1,41136,1,1,0, 41137
7,41142,1,1,0, 41143
24,41144,1,1,1, 41145
8,41146,1,1,1, 41147
2,41148,2,2,1, 41150
1,41151,1,1,1, 41152
15,41151,2,2,1, 41153
31,41151,2,2,1, 41153
6,41155,2,2,1, 41157
7,41157,1,1,0, 41158
24,41159,1,1,0, 41160
8,41161,1,1,0, 41162
2,41163,2,2,1, 41165
16,41164,2,2,1, 41166
31,41166,2,2,1, 41168
7,41172,1,1,0, 41173
8,41176,1,1,1, 41177
9,41177,2,2,1, 41179
16,41179,2,2,1, 41181
31,41181,2,2,1, 41183
7,41187,1,1,0, 41188
7,41202,1,1,0, 41203
7,41217,1,1,0, 41218
31,41226,2,2,1, 41228
7,41232,1,1,0, 41233
7,41247,1,1,0, 41248
31,41256,2,2,1, 41258
7,41262,1,1,1, 41263
25,41270,2,2,1, 41272
1,41271,1,1,1, 41272
6,41275,2,2,1, 41277
7,41277,1,1,0, 41278
24,41279,1,1,1, 41280
8,41281,1,1,0, 41282
1,41286,1,1,0, 41287
31,41286,2,2,1, 41288
24,41294,1,1,1, 41295
8,41296,1,1,0, 41297
25,41300,2,2,1, 41302
1,41301,1,1,1, 41302
15,41301,2,2,1, 41303
31,41301,2,2,1, 41303
24,41309,1,1,1, 41310
8,41311,1,1,1, 41312
1,41316,1,1,1, 41317
15,41316,2,2,1, 41318
24,41324,1,1,1, 41325
8,41326,1,1,1, 41327
1,41331,1,1,1, 41332
24,41339,1,1,0, 41340
8,41341,1,1,0, 41342
1,41346,1,1,1, 41347
31,41346,2,2,1, 41348
24,41354,1,1,1, 41355
8,41356,1,1,0, 41357
1,41361,1,1,1, 41362
15,41361,2,2,1, 41363
24,41369,1,1,0, 41370
8,41371,1,1,1, 41372
1,41376,1,1,0, 41377
15,41376,2,2,1, 41378
24,41384,1,1,1, 41385
8,41386,1,1,1, 41387
2,41388,2,2,1, 41390
1,41391,1,1,1, 41392
15,41391,2,2,1, 41393
7,41397,1,1,1, 41398
24,41399,1,1,0, 41400
7,41412,1,1,0, 41413
24,41414,1,1,1, 41415
31,41421,2,2,1, 41423
7,41427,1,1,1, 41428
24,41429,1,1,1, 41430
31,41436,2,2,1, 41438
7,41442,1,1,0, 41443
24,41444,1,1,1, 41445
31,41451,2,2,1, 41453
6,41455,2,2,1, 41457
7,41457,1,1,1, 41458
24,41459,1,1,0, 41460
31,41466,2,2,1, 41468
6,41470,2,2,1, 41472
7,41472,1,1,1, 41473
24,41474,1,1,1, 41475
31,41481,2,2,1, 41483
6,41485,2,2,1, 41487
7,41487,1,1,1, 41488
24,41489,1,1,0, 41490
31,41496,2,2,1, 41498
6,41500,2,2,1, 41502
7,41502,1,1,1, 41503
24,41504,1,1,0, 41505
8,41506,1,1,0, 41507
9,41507,2,2,1, 41509
2,41508,2,2,1, 41510
1,41511,1,1,1, 41512
6,41515,2,2,1, 41517
7,41517,1,1,1, 41518
24,41519,1,1,1, 41520
8,41521,1,1,1, 41522
1,41526,1,1,1, 41527
8,41536,1,1,0, 41537
1,41541,1,1,1, 41542
8,41551,1,1,0, 41552
25,41555,2,2,1, 41557
1,41556,1,1,0, 41557
8,41566,1,1,1, 41567
16,41569,2,2,1, 41571
1,41571,1,1,0, 41572
8,41581,1,1,1, 41582
25,41585,2,2,1, 41587
1,41586,1,1,0, 41587
8,41596,1,1,1, 41597
16,41599,2,2,1, 41601
25,41600,2,2,1, 41602
1,41601,1,1,1, 41602
8,41611,1,1,1, 41612
16,41614,2,2,1, 41616
25,41615,2,2,1, 41617
1,41616,1,1,0, 41617
24,41624,1,1,1, 41625
8,41626,1,1,1, 41627
2,41628,2,2,1, 41630
16,41629,2,2,1, 41631
25,41630,2,2,1, 41632
1,41631,1,1,0, 41632
31,41631,2,2,1, 41633
6,41635,2,2,1, 41637
7,41637,1,1,0, 41638
24,41639,1,1,1, 41640
9,41642,2,2,1, 41644
2,41643,2,2,1, 41645
31,41646,2,2,1, 41648
6,41650,2,2,1, 41652
7,41652,1,1,0, 41653
24,41654,1,1,1, 41655
16,41659,2,2,1, 41661
31,41661,2,2,1, 41663
24,41669,1,1,1, 41670
16,41674,2,2,1, 41676
31,41676,2,2,1, 41678
24,41684,1,1,0, 41685
24,41699,1,1,0, 41700
24,41714,1,1,1, 41715
24,41729,1,1,1, 41730
31,41736,2,2,1, 41738
24,41744,1,1,0, 41745
8,41746,1,1,0, 41747
9,41747,2,2,1, 41749
1,41751,1,1,1, 41752
15,41751,2,2,1, 41753
24,41759,1,1,1, 41760
8,41761,1,1,1, 41762
1,41766,1,1,0, 41767
31,41766,2,2,1, 41768
7,41772,1,1,1, 41773
24,41774,1,1,1, 41775
8,41776,1,1,1, 41777
25,41780,2,2,1, 41782
1,41781,1,1,1, 41782
31,41781,2,2,1, 41783
7,41787,1,1,0, 41788
24,41789,1,1,1, 41790
8,41791,1,1,1, 41792
2,41793,2,2,1, 41795
1,41796,1,1,1, 41797
7,41802,1,1,1, 41803
24,41804,1,1,1, 41805
8,41806,1,1,1, 41807
1,41811,1,1,0, 41812
7,41817,1,1,0, 41818
24,41819,1,1,0, 41820
8,41821,1,1,1, 41822
25,41825,2,2,1, 41827
1,41826,1,1,0, 41827
31,41826,2,2,1, 41828
7,41832,1,1,1, 41833
8,41836,1,1,0, 41837
25,41840,2,2,1, 41842
1,41841,1,1,0, 41842
31,41841,2,2,1, 41843
7,41847,1,1,1, 41848
8,41851,1,1,0, 41852
25,41855,2,2,1, 41857
1,41856,1,1,1, 41857
7,41862,1,1,0, 41863
8,41866,1,1,0, 41867
1,41871,1,1,1, 41872
15,41871,2,2,1, 41873
7,41877,1,1,1, 41878
9,41882,2,2,1, 41884
1,41886,1,1,0, 41887
7,41892,1,1,0, 41893
9,41897,2,2,1, 41899
1,41901,1,1,1, 41902
7,41907,1,1,0, 41908
9,41912,2,2,1, 41914
1,41916,1,1,0, 41917
7,41922,1,1,0, 41923
1,41931,1,1,1, 41932
31,41931,2,2,1, 41933
7,41937,1,1,1, 41938
9,41942,2,2,1, 41944
1,41946,1,1,0, 41947
31,41946,2,2,1, 41948
7,41952,1,1,0, 41953
1,41961,1,1,0, 41962
31,41961,2,2,1, 41963
7,41967,1,1,0, 41968
9,41972,2,2,1, 41974
1,41976,1,1,0, 41977
7,41982,1,1,1, 41983
24,41984,1,1,0, 41985
8,41986,1,1,1, 41987
2,41988,2,2,1, 41990
16,41989,2,2,1, 41991
25,41990,2,2,1, 41992
1,41991,1,1,0, 41992
15,41991,2,2,1, 41993
31,41991,2,2,1, 41993
6,41995,2,2,1, 41997
7,41997,1,1,0, 41998
24,41999,1,1,1, 42000
8,42001,1,1,1, 42002
24,42014,1,1,1, 42015
8,42016,1,1,0, 42017
31,42021,2,2,1, 42023
24,42029,1,1,0, 42030
8,42031,1,1,1, 42032
16,42034,2,2,1, 42036
25,42035,2,2,1, 42037
24,42044,1,1,0, 42045
8,42046,1,1,1, 42047
31,42051,2,2,1, 42053
24,42059,1,1,0, 42060
8,42061,1,1,0, 42062
16,42064,2,2,1, 42066
8,42076,1,1,0, 42077
16,42079,2,2,1, 42081
8,42091,1,1,1, 42092
7,42102,1,1,1, 42103
8,42106,1,1,0, 42107
9,42107,2,2,1, 42109
16,42109,2,2,1, 42111
25,42110,2,2,1, 42112
1,42111,1,1,0, 42112
15,42111,2,2,1, 42113
31,42111,2,2,1, 42113
7,42117,1,1,0, 42118
9,42122,2,2,1, 42124
1,42126,1,1,1, 42127
31,42126,2,2,1, 42128
7,42132,1,1,0, 42133
1,42141,1,1,0, 42142
31,42141,2,2,1, 42143
7,42147,1,1,0, 42148
1,42156,1,1,1, 42157
31,42156,2,2,1, 42158
7,42162,1,1,1, 42163
24,42164,1,1,1, 42165
16,42169,2,2,1, 42171
1,42171,1,1,0, 42172
31,42171,2,2,1, 42173
7,42177,1,1,1, 42178
24,42179,1,1,0, 42180
9,42182,2,2,1, 42184
16,42184,2,2,1, 42186
1,42186,1,1,0, 42187
31,42186,2,2,1, 42188
7,42192,1,1,1, 42193
24,42194,1,1,1, 42195
16,42199,2,2,1, 42201
1,42201,1,1,1, 42202
31,42201,2,2,1, 42203
6,42205,2,2,1, 42207
7,42207,1,1,0, 42208
24,42209,1,1,1, 42210
9,42212,2,2,1, 42214
16,42214,2,2,1, 42216
1,42216,1,1,0, 42217
31,42216,2,2,1, 42218
7,42222,1,1,0, 42223
24,42224,1,1,1, 42225
16,42229,2,2,1, 42231
25,42230,2,2,1, 42232
1,42231,1,1,0, 42232
31,42231,2,2,1, 42233
6,42235,2,2,1, 42237
7,42237,1,1,1, 42238
24,42239,1,1,0, 42240
8,42241,1,1,0, 42242
25,42245,2,2,1, 42247
31,42246,2,2,1, 42248
8,42256,1,1,0, 42257
15,42261,2,2,1, 42263
8,42271,1,1,1, 42272
15,42276,2,2,1, 42278
8,42286,1,1,0, 42287
8,42301,1,1,0, 42302
8,42316,1,1,1, 42317
8,42331,1,1,0, 42332
7,42342,1,1,0, 42343
8,42346,1,1,0, 42347
9,42347,2,2,1, 42349
2,42348,2,2,1, 42350
25,42350,2,2,1, 42352
1,42351,1,1,1, 42352
7,42357,1,1,0, 42358
24,42359,1,1,0, 42360
8,42361,1,1,0, 42362
2,42363,2,2,1, 42365
16,42364,2,2,1, 42366
1,42366,1,1,0, 42367
31,42366,2,2,1, 42368
6,42370,2,2,1, 42372
7,42372,1,1,1, 42373
24,42374,1,1,1, 42375
8,42376,1,1,1, 42377
9,42377,2,2,1, 42379
1,42381,1,1,1, 42382
6,42385,2,2,1, 42387
7,42387,1,1,0, 42388
24,42389,1,1,1, 42390
8,42391,1,1,1, 42392
9,42392,2,2,1, 42394
16,42394,2,2,1, 42396
1,42396,1,1,0, 42397
6,42400,2,2,1, 42402
7,42402,1,1,0, 42403
24,42404,1,1,1, 42405
8,42406,1,1,0, 42407
9,42407,2,2,1, 42409
16,42409,2,2,1, 42411
1,42411,1,1,0, 42412
6,42415,2,2,1, 42417
7,42417,1,1,1, 42418
24,42419,1,1,1, 42420
1,42426,1,1,1, 42427
31,42426,2,2,1, 42428
7,42432,1,1,1, 42433
24,42434,1,1,1, 42435
9,42437,2,2,1, 42439
16,42439,2,2,1, 42441
1,42441,1,1,1, 42442
31,42441,2,2,1, 42443
7,42447,1,1,1, 42448
24,42449,1,1,0, 42450
1,42456,1,1,0, 42457
31,42456,2,2,1, 42458
7,42462,1,1,1, 42463
24,42464,1,1,1, 42465
1,42471,1,1,1, 42472
31,42471,2,2,1, 42473
7,42477,1,1,1, 42478
24,42479,1,1,1, 42480
8,42481,1,1,1, 42482
25,42485,2,2,1, 42487
24,42494,1,1,1, 42495
8,42496,1,1,0, 42497
25,42500,2,2,1, 42502
31,42501,2,2,1, 42503
24,42509,1,1,1, 42510
8,42511,1,1,1, 42512
25,42515,2,2,1, 42517
24,42524,1,1,0, 42525
8,42526,1,1,1, 42527
25,42530,2,2,1, 42532
31,42531,2,2,1, 42533
24,42539,1,1,0, 42540
8,42541,1,1,0, 42542
24,42554,1,1,0, 42555
8,42556,1,1,0, 42557
24,42569,1,1,0, 42570
8,42571,1,1,0, 42572
25,42575,2,2,1, 42577
31,42576,2,2,1, 42578
7,42582,1,1,1, 42583
24,42584,1,1,1, 42585
8,42586,1,1,1, 42587
9,42587,2,2,1, 42589
2,42588,2,2,1, 42590
25,42590,2,2,1, 42592
1,42591,1,1,1, 42592
15,42591,2,2,1, 42593
7,42597,1,1,1, 42598
24,42599,1,1,0, 42600
1,42606,1,1,0, 42607
7,42612,1,1,0, 42613
1,42621,1,1,1, 42622
7,42627,1,1,1, 42628
1,42636,1,1,0, 42637
7,42642,1,1,1, 42643
1,42651,1,1,1, 42652
31,42651,2,2,1, 42653
7,42657,1,1,0, 42658
1,42666,1,1,0, 42667
6,42670,2,2,1, 42672
7,42672,1,1,0, 42673
1,42681,1,1,0, 42682
6,42685,2,2,1, 42687
7,42687,1,1,1, 42688
1,42696,1,1,0, 42697
7,42702,1,1,1, 42703
24,42704,1,1,1, 42705
8,42706,1,1,0, 42707
2,42708,2,2,1, 42710
25,42710,2,2,1, 42712
1,42711,1,1,0, 42712
31,42711,2,2,1, 42713
6,42715,2,2,1, 42717
7,42717,1,1,1, 42718
24,42719,1,1,1, 42720
8,42721,1,1,0, 42722
24,42734,1,1,0, 42735
8,42736,1,1,1, 42737
24,42749,1,1,1, 42750
8,42751,1,1,0, 42752
31,42756,2,2,1, 42758
24,42764,1,1,1, 42765
8,42766,1,1,0, 42767
24,42779,1,1,1, 42780
8,42781,1,1,1, 42782
24,42794,1,1,0, 42795
8,42796,1,1,0, 42797
24,42809,1,1,1, 42810
8,42811,1,1,0, 42812
31,42816,2,2,1, 42818
24,42824,1,1,1, 42825
8,42826,1,1,1, 42827
9,42827,2,2,1, 42829
25,42830,2,2,1, 42832
1,42831,1,1,0, 42832
31,42831,2,2,1, 42833
7,42837,1,1,1, 42838
24,42839,1,1,0, 42840
8,42841,1,1,1, 42842
1,42846,1,1,0, 42847
31,42846,2,2,1, 42848
6,42850,2,2,1, 42852
7,42852,1,1,0, 42853
1,42861,1,1,1, 42862
7,42867,1,1,1, 42868
1,42876,1,1,1, 42877
31,42876,2,2,1, 42878
7,42882,1,1,1, 42883
1,42891,1,1,1, 42892
7,42897,1,1,1, 42898
1,42906,1,1,1, 42907
7,42912,1,1,0, 42913
1,42921,1,1,0, 42922
7,42927,1,1,1, 42928
1,42936,1,1,0, 42937
31,42936,2,2,1, 42938
7,42942,1,1,0, 42943
24,42944,1,1,1, 42945
2,42948,2,2,1, 42950
1,42951,1,1,0, 42952
7,42957,1,1,1, 42958
24,42959,1,1,0, 42960
8,42961,1,1,0, 42962
9,42962,2,2,1, 42964
1,42966,1,1,1, 42967
31,42966,2,2,1, 42968
24,42974,1,1,0, 42975
8,42976,1,1,1, 42977
1,42981,1,1,0, 42982
24,42989,1,1,1, 42990
8,42991,1,1,0, 42992
9,42992,2,2,1, 42994
1,42996,1,1,0, 42997
31,42996,2,2,1, 42998
24,43004,1,1,0, 43005
8,43006,1,1,0, 43007
1,43011,1,1,0, 43012
31,43011,2,2,1, 43013
24,43019,1,1,1, 43020
8,43021,1,1,1, 43022
1,43026,1,1,0, 43027
24,43034,1,1,1, 43035
8,43036,1,1,1, 43037
1,43041,1,1,1, 43042
24,43049,1,1,0, 43050
8,43051,1,1,0, 43052
1,43056,1,1,0, 43057
24,43064,1,1,1, 43065
8,43066,1,1,1, 43067
25,43070,2,2,1, 43072
1,43071,1,1,0, 43072
31,43071,2,2,1, 43073
6,43075,2,2,1, 43077
7,43077,1,1,1, 43078
24,43079,1,1,0, 43080
8,43081,1,1,0, 43082
16,43084,2,2,1, 43086
1,43086,1,1,1, 43087
7,43092,1,1,0, 43093
8,43096,1,1,0, 43097
16,43099,2,2,1, 43101
25,43100,2,2,1, 43102
1,43101,1,1,0, 43102
6,43105,2,2,1, 43107
7,43107,1,1,1, 43108
8,43111,1,1,0, 43112
25,43115,2,2,1, 43117
1,43116,1,1,0, 43117
6,43120,2,2,1, 43122
7,43122,1,1,0, 43123
8,43126,1,1,1, 43127
1,43131,1,1,1, 43132
7,43137,1,1,1, 43138
8,43141,1,1,1, 43142
9,43142,2,2,1, 43144
1,43146,1,1,0, 43147
31,43146,2,2,1, 43148
7,43152,1,1,1, 43153
8,43156,1,1,1, 43157
16,43159,2,2,1, 43161
1,43161,1,1,0, 43162
31,43161,2,2,1, 43163
7,43167,1,1,0, 43168
8,43171,1,1,0, 43172
9,43172,2,2,1, 43174
16,43174,2,2,1, 43176
1,43176,1,1,1, 43177
31,43176,2,2,1, 43178
7,43182,1,1,0, 43183
24,43184,1,1,1, 43185
8,43186,1,1,1, 43187
9,43187,2,2,1, 43189
2,43188,2,2,1, 43190
1,43191,1,1,1, 43192
15,43191,2,2,1, 43193
31,43191,2,2,1, 43193
6,43195,2,2,1, 43197
7,43197,1,1,0, 43198
24,43199,1,1,1, 43200
24,43214,1,1,1, 43215
31,43221,2,2,1, 43223
24,43229,1,1,0, 43230
24,43244,1,1,0, 43245
24,43259,1,1,1, 43260
24,43274,1,1,0, 43275
24,43289,1,1,0, 43290
24,43304,1,1,1, 43305
8,43306,1,1,1, 43307
9,43307,2,2,1, 43309
25,43310,2,2,1, 43312
1,43311,1,1,0, 43312
15,43311,2,2,1, 43313
24,43319,1,1,1, 43320
8,43321,1,1,1, 43322
7,43332,1,1,0, 43333
7,43347,1,1,0, 43348
7,43362,1,1,0, 43363
7,43377,1,1,1, 43378
7,43392,1,1,0, 43393
7,43407,1,1,0, 43408
7,43422,1,1,1, 43423
24,43424,1,1,1, 43425
8,43426,1,1,1, 43427
9,43427,2,2,1, 43429
16,43429,2,2,1, 43431
1,43431,1,1,0, 43432
7,43437,1,1,1, 43438
24,43439,1,1,0, 43440
1,43446,1,1,1, 43447
24,43454,1,1,0, 43455
1,43461,1,1,1, 43462
24,43469,1,1,0, 43470
1,43476,1,1,0, 43477
24,43484,1,1,0, 43485
1,43491,1,1,0, 43492
31,43491,2,2,1, 43493
24,43499,1,1,0, 43500
1,43506,1,1,1, 43507
24,43514,1,1,1, 43515
1,43521,1,1,0, 43522
24,43529,1,1,0, 43530
1,43536,1,1,0, 43537
7,43542,1,1,0, 43543
24,43544,1,1,1, 43545
8,43546,1,1,0, 43547
2,43548,2,2,1, 43550
1,43551,1,1,0, 43552
31,43551,2,2,1, 43553
7,43557,1,1,0, 43558
24,43559,1,1,0, 43560
8,43561,1,1,1, 43562
16,43564,2,2,1, 43566
6,43570,2,2,1, 43572
7,43572,1,1,1, 43573
24,43574,1,1,0, 43575
8,43576,1,1,1, 43577
31,43581,2,2,1, 43583
7,43587,1,1,0, 43588
24,43589,1,1,1, 43590
8,43591,1,1,0, 43592
16,43594,2,2,1, 43596
7,43602,1,1,1, 43603
24,43604,1,1,1, 43605
8,43606,1,1,0, 43607
31,43611,2,2,1, 43613
7,43617,1,1,0, 43618
24,43619,1,1,1, 43620
8,43621,1,1,1, 43622
16,43624,2,2,1, 43626
7,43632,1,1,1, 43633
8,43636,1,1,1, 43637
16,43639,2,2,1, 43641
31,43641,2,2,1, 43643
6,43645,2,2,1, 43647
7,43647,1,1,0, 43648
8,43651,1,1,0, 43652
16,43654,2,2,1, 43656
7,43662,1,1,1, 43663
8,43666,1,1,0, 43667
1,43671,1,1,1, 43672
7,43677,1,1,0, 43678
1,43686,1,1,0, 43687
9,43697,2,2,1, 43699
25,43700,2,2,1, 43702
1,43701,1,1,1, 43702
25,43715,2,2,1, 43717
1,43716,1,1,0, 43717
25,43730,2,2,1, 43732
1,43731,1,1,1, 43732
24,43784,1,1,0, 43785
8,43786,1,1,0, 43787
25,43790,2,2,1, 43792
31,43791,2,2,1, 43793
7,43797,1,1,0, 43798
24,43799,1,1,1, 43800
8,43801,1,1,1, 43802
1,43806,1,1,1, 43807
31,43806,2,2,1, 43808
6,43810,2,2,1, 43812
7,43812,1,1,1, 43813
24,43814,1,1,0, 43815
8,43816,1,1,1, 43817
1,43821,1,1,0, 43822
24,43829,1,1,0, 43830
8,43831,1,1,0, 43832
16,43834,2,2,1, 43836
1,43836,1,1,1, 43837
24,43844,1,1,0, 43845
8,43846,1,1,0, 43847
1,43851,1,1,0, 43852
31,43851,2,2,1, 43853
24,43859,1,1,0, 43860
8,43861,1,1,1, 43862
1,43866,1,1,1, 43867
31,43866,2,2,1, 43868
24,43874,1,1,1, 43875
8,43876,1,1,1, 43877
1,43881,1,1,0, 43882
24,43889,1,1,0, 43890
8,43891,1,1,0, 43892
1,43896,1,1,0, 43897
31,43896,2,2,1, 43898
24,43904,1,1,0, 43905
8,43906,1,1,0, 43907
9,43907,2,2,1, 43909
1,43911,1,1,1, 43912
31,43911,2,2,1, 43913
24,43919,1,1,1, 43920
8,43921,1,1,0, 43922
1,43926,1,1,0, 43927
15,43926,2,2,1, 43928
6,43930,2,2,1, 43932
7,43932,1,1,0, 43933
8,43936,1,1,1, 43937
25,43940,2,2,1, 43942
1,43941,1,1,0, 43942
15,43941,2,2,1, 43943
31,43941,2,2,1, 43943
7,43947,1,1,1, 43948
8,43951,1,1,1, 43952
1,43956,1,1,1, 43957
15,43956,2,2,1, 43958
31,43956,2,2,1, 43958
6,43960,2,2,1, 43962
7,43962,1,1,1, 43963
8,43966,1,1,1, 43967
25,43970,2,2,1, 43972
1,43971,1,1,0, 43972
31,43971,2,2,1, 43973
7,43977,1,1,0, 43978
8,43981,1,1,0, 43982
1,43986,1,1,1, 43987
6,43990,2,2,1, 43992
7,43992,1,1,1, 43993
8,43996,1,1,0, 43997
1,44001,1,1,1, 44002
31,44001,2,2,1, 44003
7,44007,1,1,1, 44008
8,44011,1,1,0, 44012
1,44016,1,1,1, 44017
31,44016,2,2,1, 44018
7,44022,1,1,1, 44023
8,44026,1,1,1, 44027
1,44031,1,1,0, 44032
7,44037,1,1,0, 44038
24,44039,1,1,0, 44040
7,44052,1,1,0, 44053
24,44054,1,1,0, 44055
31,44061,2,2,1, 44063
7,44067,1,1,1, 44068
24,44069,1,1,1, 44070
7,44082,1,1,0, 44083
24,44084,1,1,1, 44085
15,44091,2,2,1, 44093
7,44097,1,1,0, 44098
24,44099,1,1,0, 44100
15,44106,2,2,1, 44108
7,44112,1,1,0, 44113
24,44114,1,1,1, 44115
15,44121,2,2,1, 44123
7,44127,1,1,0, 44128
24,44129,1,1,1, 44130
15,44136,2,2,1, 44138
31,44136,2,2,1, 44138
7,44142,1,1,0, 44143
24,44144,1,1,1, 44145
8,44146,1,1,0, 44147
9,44147,2,2,1, 44149
16,44149,2,2,1, 44151
25,44150,2,2,1, 44152
1,44151,1,1,1, 44152
24,44159,1,1,1, 44160
8,44161,1,1,1, 44162
16,44164,2,2,1, 44166
1,44166,1,1,0, 44167
31,44166,2,2,1, 44168
24,44174,1,1,1, 44175
8,44176,1,1,1, 44177
16,44179,2,2,1, 44181
25,44180,2,2,1, 44182
1,44181,1,1,0, 44182
24,44189,1,1,1, 44190
8,44191,1,1,1, 44192
16,44194,2,2,1, 44196
1,44196,1,1,0, 44197
31,44196,2,2,1, 44198
24,44204,1,1,0, 44205
8,44206,1,1,1, 44207
16,44209,2,2,1, 44211
25,44210,2,2,1, 44212
1,44211,1,1,1, 44212
24,44219,1,1,1, 44220
8,44221,1,1,1, 44222
1,44226,1,1,1, 44227
8,44236,1,1,1, 44237
1,44241,1,1,0, 44242
8,44251,1,1,0, 44252
1,44256,1,1,1, 44257
6,44260,2,2,1, 44262
7,44262,1,1,0, 44263
8,44266,1,1,0, 44267
9,44267,2,2,1, 44269
16,44269,2,2,1, 44271
1,44271,1,1,1, 44272
15,44271,2,2,1, 44273
31,44271,2,2,1, 44273
7,44277,1,1,1, 44278
9,44282,2,2,1, 44284
2,44283,2,2,1, 44285
1,44286,1,1,1, 44287
1,44301,1,1,0, 44302
9,44312,2,2,1, 44314
1,44316,1,1,0, 44317
24,44324,1,1,0, 44325
9,44327,2,2,1, 44329
1,44331,1,1,1, 44332
24,44339,1,1,1, 44340
1,44346,1,1,1, 44347
24,44354,1,1,0, 44355
9,44357,2,2,1, 44359
1,44361,1,1,1, 44362
31,44361,2,2,1, 44363
24,44369,1,1,1, 44370
1,44376,1,1,0, 44377
7,44382,1,1,1, 44383
24,44384,1,1,0, 44385
8,44386,1,1,1, 44387
2,44388,2,2,1, 44390
1,44391,1,1,0, 44392
15,44391,2,2,1, 44393
6,44395,2,2,1, 44397
7,44397,1,1,0, 44398
24,44399,1,1,0, 44400
8,44401,1,1,0, 44402
9,44402,2,2,1, 44404
24,44414,1,1,0, 44415
8,44416,1,1,1, 44417
25,44420,2,2,1, 44422
24,44429,1,1,0, 44430
8,44431,1,1,1, 44432
25,44435,2,2,1, 44437
31,44436,2,2,1, 44438
24,44444,1,1,1, 44445
8,44446,1,1,1, 44447
25,44450,2,2,1, 44452
31,44451,2,2,1, 44453
24,44459,1,1,0, 44460
8,44461,1,1,0, 44462
24,44474,1,1,0, 44475
8,44476,1,1,1, 44477
31,44481,2,2,1, 44483
24,44489,1,1,1, 44490
8,44491,1,1,1, 44492
31,44496,2,2,1, 44498
7,44502,1,1,1, 44503
24,44504,1,1,0, 44505
8,44506,1,1,0, 44507
16,44509,2,2,1, 44511
1,44511,1,1,1, 44512
6,44515,2,2,1, 44517
7,44517,1,1,0, 44518
24,44519,1,1,1, 44520
8,44521,1,1,0, 44522
9,44522,2,2,1, 44524
2,44523,2,2,1, 44525
1,44526,1,1,0, 44527
7,44532,1,1,0, 44533
9,44537,2,2,1, 44539
1,44541,1,1,0, 44542
7,44547,1,1,0, 44548
9,44552,2,2,1, 44554
2,44553,2,2,1, 44555
1,44556,1,1,0, 44557
31,44556,2,2,1, 44558
7,44562,1,1,0, 44563
2,44568,2,2,1, 44570
1,44571,1,1,0, 44572
7,44577,1,1,0, 44578
1,44586,1,1,0, 44587
7,44592,1,1,0, 44593
9,44597,2,2,1, 44599
1,44601,1,1,1, 44602
7,44607,1,1,0, 44608
1,44616,1,1,0, 44617
31,44616,2,2,1, 44618
7,44622,1,1,1, 44623
24,44624,1,1,0, 44625
16,44629,2,2,1, 44631
1,44631,1,1,1, 44632
7,44637,1,1,0, 44638
24,44639,1,1,0, 44640
8,44641,1,1,0, 44642
24,44654,1,1,0, 44655
8,44656,1,1,0, 44657
25,44660,2,2,1, 44662
31,44661,2,2,1, 44663
24,44669,1,1,0, 44670
8,44671,1,1,1, 44672
25,44675,2,2,1, 44677
31,44676,2,2,1, 44678
24,44684,1,1,0, 44685
8,44686,1,1,1, 44687
24,44699,1,1,0, 44700
8,44701,1,1,0, 44702
9,44702,2,2,1, 44704
24,44714,1,1,0, 44715
8,44716,1,1,1, 44717
24,44729,1,1,0, 44730
8,44731,1,1,0, 44732
9,44732,2,2,1, 44734
7,44742,1,1,1, 44743
24,44744,1,1,0, 44745
8,44746,1,1,0, 44747
9,44747,2,2,1, 44749
1,44751,1,1,0, 44752
7,44757,1,1,1, 44758
24,44759,1,1,0, 44760
8,44761,1,1,0, 44762
1,44766,1,1,0, 44767
15,44766,2,2,1, 44768
31,44766,2,2,1, 44768
6,44770,2,2,1, 44772
7,44772,1,1,0, 44773
24,44774,1,1,0, 44775
8,44776,1,1,0, 44777
16,44779,2,2,1, 44781
1,44781,1,1,1, 44782
15,44781,2,2,1, 44783
31,44781,2,2,1, 44783
7,44787,1,1,0, 44788
24,44789,1,1,0, 44790
8,44791,1,1,0, 44792
1,44796,1,1,0, 44797
15,44796,2,2,1, 44798
6,44800,2,2,1, 44802
7,44802,1,1,0, 44803
24,44804,1,1,1, 44805
8,44806,1,1,1, 44807
16,44809,2,2,1, 44811
25,44810,2,2,1, 44812
1,44811,1,1,1, 44812
6,44815,2,2,1, 44817
7,44817,1,1,0, 44818
24,44819,1,1,1, 44820
25,44825,2,2,1, 44827
1,44826,1,1,0, 44827
31,44826,2,2,1, 44828
6,44830,2,2,1, 44832
1,44841,1,1,0, 44842
25,44855,2,2,1, 44857
1,44856,1,1,1, 44857
2,44868,2,2,1, 44870
25,44870,2,2,1, 44872
1,44871,1,1,1, 44872
25,44885,2,2,1, 44887
1,44886,1,1,1, 44887
31,44886,2,2,1, 44888
6,44890,2,2,1, 44892
7,44892,1,1,0, 44893
1,44901,1,1,0, 44902
15,44901,2,2,1, 44903
7,44907,1,1,1, 44908
25,44915,2,2,1, 44917
1,44916,1,1,0, 44917
31,44916,2,2,1, 44918
7,44922,1,1,1, 44923
24,44924,1,1,0, 44925
8,44926,1,1,0, 44927
9,44927,2,2,1, 44929
1,44931,1,1,0, 44932
15,44931,2,2,1, 44933
6,44935,2,2,1, 44937
7,44937,1,1,1, 44938
24,44939,1,1,0, 44940
8,44941,1,1,0, 44942
9,44942,2,2,1, 44944
24,44954,1,1,0, 44955
8,44956,1,1,1, 44957
9,44957,2,2,1, 44959
31,44961,2,2,1, 44963
24,44969,1,1,0, 44970
8,44971,1,1,1, 44972
9,44972,2,2,1, 44974
16,44974,2,2,1, 44976
31,44976,2,2,1, 44978
24,44984,1,1,1, 44985
8,44986,1,1,1, 44987
9,44987,2,2,1, 44989
16,44989,2,2,1, 44991
31,44991,2,2,1, 44993
24,44999,1,1,0, 45000
15,45006,2,2,1, 45008
6,45010,2,2,1, 45012
7,45012,1,1,0, 45013
7,45027,1,1,0, 45028
7,45042,1,1,1, 45043
9,45047,2,2,1, 45049
25,45050,2,2,1, 45052
1,45051,1,1,0, 45052
31,45051,2,2,1, 45053
7,45057,1,1,0, 45058
8,45061,1,1,1, 45062
25,45065,2,2,1, 45067
1,45066,1,1,0, 45067
31,45066,2,2,1, 45068
7,45072,1,1,1, 45073
24,45074,1,1,0, 45075
8,45076,1,1,0, 45077
9,45077,2,2,1, 45079
1,45081,1,1,0, 45082
7,45087,1,1,0, 45088
24,45089,1,1,1, 45090
8,45091,1,1,0, 45092
25,45095,2,2,1, 45097
1,45096,1,1,1, 45097
7,45102,1,1,1, 45103
24,45104,1,1,0, 45105
8,45106,1,1,0, 45107
16,45109,2,2,1, 45111
1,45111,1,1,1, 45112
15,45111,2,2,1, 45113
31,45111,2,2,1, 45113
7,45117,1,1,0, 45118
24,45119,1,1,1, 45120
7,45222,1,1,1, 45223
8,45226,1,1,0, 45227
16,45229,2,2,1, 45231
1,45231,1,1,0, 45232
15,45231,2,2,1, 45233
31,45231,2,2,1, 45233
7,45237,1,1,1, 45238
24,45239,1,1,1, 45240
8,45241,1,1,0, 45242
9,45242,2,2,1, 45244
2,45243,2,2,1, 45245
25,45245,2,2,1, 45247
1,45246,1,1,1, 45247
31,45246,2,2,1, 45248
7,45252,1,1,0, 45253
24,45254,1,1,0, 45255
2,45258,2,2,1, 45260
25,45260,2,2,1, 45262
1,45261,1,1,0, 45262
31,45261,2,2,1, 45263
7,45267,1,1,0, 45268
24,45269,1,1,1, 45270
9,45272,2,2,1, 45274
2,45273,2,2,1, 45275
25,45275,2,2,1, 45277
1,45276,1,1,0, 45277
31,45276,2,2,1, 45278
6,45280,2,2,1, 45282
7,45282,1,1,1, 45283
24,45284,1,1,1, 45285
9,45287,2,2,1, 45289
2,45288,2,2,1, 45290
1,45291,1,1,0, 45292
31,45291,2,2,1, 45293
6,45295,2,2,1, 45297
7,45297,1,1,0, 45298
24,45299,1,1,1, 45300
31,45306,2,2,1, 45308
6,45310,2,2,1, 45312
7,45312,1,1,0, 45313
24,45314,1,1,0, 45315
6,45325,2,2,1, 45327
7,45327,1,1,1, 45328
24,45329,1,1,0, 45330
6,45340,2,2,1, 45342
7,45342,1,1,1, 45343
24,45344,1,1,1, 45345
16,45349,2,2,1, 45351
6,45355,2,2,1, 45357
7,45357,1,1,0, 45358
24,45359,1,1,0, 45360
8,45361,1,1,0, 45362
24,45374,1,1,0, 45375
8,45376,1,1,1, 45377
16,45379,2,2,1, 45381
31,45381,2,2,1, 45383
24,45389,1,1,0, 45390
8,45391,1,1,0, 45392
16,45394,2,2,1, 45396
25,45395,2,2,1, 45397
31,45396,2,2,1, 45398
24,45404,1,1,1, 45405
8,45406,1,1,0, 45407
25,45410,2,2,1, 45412
1,45411,1,1,1, 45412
24,45419,1,1,1, 45420
8,45421,1,1,0, 45422
25,45425,2,2,1, 45427
1,45426,1,1,0, 45427
8,45436,1,1,1, 45437
2,45438,2,2,1, 45440
25,45440,2,2,1, 45442
1,45441,1,1,1, 45442
8,45451,1,1,1, 45452
2,45453,2,2,1, 45455
1,45456,1,1,0, 45457
7,45462,1,1,0, 45463
8,45466,1,1,1, 45467
9,45467,2,2,1, 45469
16,45469,2,2,1, 45471
25,45470,2,2,1, 45472
1,45471,1,1,0, 45472
31,45471,2,2,1, 45473
7,45477,1,1,0, 45478
31,45486,2,2,1, 45488
7,45492,1,1,1, 45493
7,45507,1,1,0, 45508
31,45516,2,2,1, 45518
7,45522,1,1,1, 45523
7,45537,1,1,1, 45538
24,45539,1,1,1, 45540
31,45546,2,2,1, 45548
7,45552,1,1,0, 45553
24,45554,1,1,1, 45555
7,45567,1,1,1, 45568
24,45569,1,1,1, 45570
31,45576,2,2,1, 45578
7,45582,1,1,0, 45583
24,45584,1,1,0, 45585
8,45586,1,1,1, 45587
2,45588,2,2,1, 45590
16,45589,2,2,1, 45591
1,45591,1,1,1, 45592
31,45591,2,2,1, 45593
7,45597,1,1,0, 45598
24,45599,1,1,1, 45600
8,45601,1,1,0, 45602
16,45604,2,2,1, 45606
1,45606,1,1,1, 45607
15,45606,2,2,1, 45608
24,45614,1,1,0, 45615
8,45616,1,1,1, 45617
16,45619,2,2,1, 45621
1,45621,1,1,0, 45622
15,45621,2,2,1, 45623
31,45621,2,2,1, 45623
24,45629,1,1,1, 45630
16,45634,2,2,1, 45636
1,45636,1,1,0, 45637
24,45644,1,1,0, 45645
16,45649,2,2,1, 45651
1,45651,1,1,1, 45652
24,45659,1,1,1, 45660
1,45666,1,1,1, 45667
31,45666,2,2,1, 45668
24,45674,1,1,1, 45675
1,45681,1,1,1, 45682
24,45689,1,1,1, 45690
1,45696,1,1,0, 45697
24,45704,1,1,1, 45705
2,45708,2,2,1, 45710
16,45709,2,2,1, 45711
25,45710,2,2,1, 45712
1,45711,1,1,0, 45712
31,45711,2,2,1, 45713
7,45717,1,1,1, 45718
24,45719,1,1,0, 45720
8,45721,1,1,1, 45722
9,45722,2,2,1, 45724
7,45732,1,1,0, 45733
8,45736,1,1,1, 45737
9,45737,2,2,1, 45739
31,45741,2,2,1, 45743
7,45747,1,1,0, 45748
8,45751,1,1,1, 45752
31,45756,2,2,1, 45758
6,45760,2,2,1, 45762
7,45762,1,1,0, 45763
8,45766,1,1,0, 45767
9,45767,2,2,1, 45769
6,45775,2,2,1, 45777
7,45777,1,1,1, 45778
8,45781,1,1,1, 45782
31,45786,2,2,1, 45788
6,45790,2,2,1, 45792
7,45792,1,1,0, 45793
8,45796,1,1,1, 45797
31,45801,2,2,1, 45803
6,45805,2,2,1, 45807
7,45807,1,1,1, 45808
8,45811,1,1,1, 45812
9,45812,2,2,1, 45814
31,45816,2,2,1, 45818
7,45822,1,1,0, 45823
8,45826,1,1,0, 45827
2,45828,2,2,1, 45830
25,45830,2,2,1, 45832
1,45831,1,1,0, 45832
15,45831,2,2,1, 45833
6,45835,2,2,1, 45837
7,45837,1,1,1, 45838
24,45839,1,1,0, 45840
1,45846,1,1,1, 45847
31,45846,2,2,1, 45848
24,45854,1,1,0, 45855
16,45859,2,2,1, 45861
1,45861,1,1,1, 45862
31,45861,2,2,1, 45863
24,45869,1,1,0, 45870
16,45874,2,2,1, 45876
1,45876,1,1,0, 45877
24,45884,1,1,0, 45885
16,45889,2,2,1, 45891
1,45891,1,1,0, 45892
24,45899,1,1,1, 45900
25,45905,2,2,1, 45907
1,45906,1,1,1, 45907
1,45921,1,1,0, 45922
25,45935,2,2,1, 45937
1,45936,1,1,1, 45937
8,45946,1,1,0, 45947
9,45947,2,2,1, 45949
25,45950,2,2,1, 45952
1,45951,1,1,0, 45952
15,45951,2,2,1, 45953
7,45957,1,1,0, 45958
8,45961,1,1,0, 45962
31,45966,2,2,1, 45968
7,45972,1,1,1, 45973
31,45981,2,2,1, 45983
7,45987,1,1,1, 45988
6,46000,2,2,1, 46002
7,46002,1,1,1, 46003
24,46004,1,1,0, 46005
6,46015,2,2,1, 46017
7,46017,1,1,1, 46018
24,46019,1,1,1, 46020
7,46032,1,1,0, 46033
24,46034,1,1,1, 46035
7,46047,1,1,0, 46048
24,46049,1,1,0, 46050
16,46054,2,2,1, 46056
6,46060,2,2,1, 46062
7,46062,1,1,0, 46063
24,46064,1,1,0, 46065
1,46071,1,1,0, 46072
15,46071,2,2,1, 46073
7,46077,1,1,1, 46078
24,46079,1,1,0, 46080
8,46081,1,1,0, 46082
9,46082,2,2,1, 46084
1,46086,1,1,1, 46087
15,46086,2,2,1, 46088
24,46094,1,1,0, 46095
8,46096,1,1,0, 46097
25,46100,2,2,1, 46102
1,46101,1,1,0, 46102
15,46101,2,2,1, 46103
24,46109,1,1,0, 46110
8,46111,1,1,1, 46112
1,46116,1,1,0, 46117
15,46116,2,2,1, 46118
24,46124,1,1,1, 46125
8,46126,1,1,0, 46127
25,46130,2,2,1, 46132
1,46131,1,1,1, 46132
15,46131,2,2,1, 46133
31,46131,2,2,1, 46133
24,46139,1,1,0, 46140
8,46141,1,1,1, 46142
1,46146,1,1,0, 46147
31,46146,2,2,1, 46148
24,46154,1,1,0, 46155
8,46156,1,1,1, 46157
1,46161,1,1,0, 46162
24,46169,1,1,0, 46170
8,46171,1,1,1, 46172
25,46175,2,2,1, 46177
1,46176,1,1,1, 46177
15,46176,2,2,1, 46178
31,46176,2,2,1, 46178
7,46182,1,1,1, 46183
24,46184,1,1,1, 46185
8,46186,1,1,0, 46187
25,46190,2,2,1, 46192
1,46191,1,1,1, 46192
15,46191,2,2,1, 46193
7,46197,1,1,0, 46198
24,46199,1,1,1, 46200
31,46206,2,2,1, 46208
6,46210,2,2,1, 46212
7,46212,1,1,1, 46213
31,46221,2,2,1, 46223
6,46225,2,2,1, 46227
7,46227,1,1,1, 46228
7,46242,1,1,1, 46243
31,46251,2,2,1, 46253
7,46257,1,1,1, 46258
7,46272,1,1,1, 46273
31,46281,2,2,1, 46283
7,46287,1,1,1, 46288
31,46296,2,2,1, 46298
7,46302,1,1,0, 46303
24,46304,1,1,1, 46305
8,46306,1,1,1, 46307
1,46311,1,1,1, 46312
7,46317,1,1,0, 46318
24,46319,1,1,0, 46320
8,46321,1,1,1, 46322
1,46326,1,1,1, 46327
31,46326,2,2,1, 46328
24,46334,1,1,0, 46335
8,46336,1,1,1, 46337
1,46341,1,1,0, 46342
15,46341,2,2,1, 46343
24,46349,1,1,1, 46350
8,46351,1,1,0, 46352
25,46355,2,2,1, 46357
1,46356,1,1,1, 46357
15,46356,2,2,1, 46358
31,46356,2,2,1, 46358
24,46364,1,1,1, 46365
8,46366,1,1,1, 46367
1,46371,1,1,1, 46372
15,46371,2,2,1, 46373
24,46379,1,1,1, 46380
8,46381,1,1,0, 46382
25,46385,2,2,1, 46387
1,46386,1,1,0, 46387
24,46394,1,1,0, 46395
8,46396,1,1,0, 46397
25,46400,2,2,1, 46402
1,46401,1,1,1, 46402
15,46401,2,2,1, 46403
24,46409,1,1,1, 46410
8,46411,1,1,1, 46412
1,46416,1,1,0, 46417
15,46416,2,2,1, 46418
31,46416,2,2,1, 46418
24,46424,1,1,1, 46425
8,46426,1,1,1, 46427
9,46427,2,2,1, 46429
1,46431,1,1,1, 46432
15,46431,2,2,1, 46433
31,46431,2,2,1, 46433
7,46437,1,1,1, 46438
24,46439,1,1,0, 46440
31,46446,2,2,1, 46448
6,46450,2,2,1, 46452
7,46452,1,1,0, 46453
7,46467,1,1,1, 46468
31,46476,2,2,1, 46478
7,46482,1,1,0, 46483
7,46497,1,1,0, 46498
7,46512,1,1,1, 46513
7,46527,1,1,1, 46528
7,46542,1,1,0, 46543
8,46546,1,1,1, 46547
9,46547,2,2,1, 46549
1,46551,1,1,1, 46552
31,46551,2,2,1, 46553
7,46557,1,1,1, 46558
24,46559,1,1,1, 46560
8,46561,1,1,1, 46562
1,46566,1,1,0, 46567
7,46572,1,1,0, 46573
24,46574,1,1,0, 46575
8,46576,1,1,1, 46577
1,46581,1,1,0, 46582
31,46581,2,2,1, 46583
7,46587,1,1,1, 46588
24,46589,1,1,1, 46590
8,46591,1,1,1, 46592
16,46594,2,2,1, 46596
1,46596,1,1,1, 46597
15,46596,2,2,1, 46598
7,46602,1,1,0, 46603
24,46604,1,1,1, 46605
8,46606,1,1,1, 46607
16,46609,2,2,1, 46611
1,46611,1,1,1, 46612
15,46611,2,2,1, 46613
31,46611,2,2,1, 46613
7,46617,1,1,1, 46618
24,46619,1,1,1, 46620
8,46621,1,1,0, 46622
1,46626,1,1,1, 46627
15,46626,2,2,1, 46628
31,46626,2,2,1, 46628
6,46630,2,2,1, 46632
7,46632,1,1,1, 46633
24,46634,1,1,1, 46635
8,46636,1,1,0, 46637
25,46640,2,2,1, 46642
1,46641,1,1,0, 46642
15,46641,2,2,1, 46643
31,46641,2,2,1, 46643
24,46649,1,1,1, 46650
8,46651,1,1,0, 46652
25,46655,2,2,1, 46657
1,46656,1,1,1, 46657
15,46656,2,2,1, 46658
24,46664,1,1,1, 46665
8,46666,1,1,0, 46667
1,46671,1,1,0, 46672
31,46671,2,2,1, 46673
24,46679,1,1,0, 46680
9,46682,2,2,1, 46684
1,46686,1,1,1, 46687
9,46697,2,2,1, 46699
1,46701,1,1,0, 46702
2,46713,2,2,1, 46715
1,46716,1,1,1, 46717
9,46727,2,2,1, 46729
2,46728,2,2,1, 46730
1,46731,1,1,1, 46732
1,46746,1,1,0, 46747
31,46746,2,2,1, 46748
7,46752,1,1,1, 46753
25,46760,2,2,1, 46762
1,46761,1,1,1, 46762
7,46767,1,1,0, 46768
1,46776,1,1,1, 46777
31,46776,2,2,1, 46778
7,46782,1,1,1, 46783
8,46786,1,1,1, 46787
1,46791,1,1,0, 46792
31,46791,2,2,1, 46793
6,46795,2,2,1, 46797
7,46797,1,1,0, 46798
24,46799,1,1,1, 46800
8,46801,1,1,1, 46802
31,46806,2,2,1, 46808
7,46812,1,1,1, 46813
24,46814,1,1,1, 46815
8,46816,1,1,1, 46817
16,46819,2,2,1, 46821
6,46825,2,2,1, 46827
7,46827,1,1,1, 46828
24,46829,1,1,1, 46830
8,46831,1,1,0, 46832
31,46836,2,2,1, 46838
6,46840,2,2,1, 46842
7,46842,1,1,0, 46843
24,46844,1,1,1, 46845
8,46846,1,1,0, 46847
15,46851,2,2,1, 46853
6,46855,2,2,1, 46857
7,46857,1,1,1, 46858
24,46859,1,1,0, 46860
8,46861,1,1,1, 46862
16,46864,2,2,1, 46866
15,46866,2,2,1, 46868
31,46866,2,2,1, 46868
24,46874,1,1,0, 46875
8,46876,1,1,1, 46877
16,46879,2,2,1, 46881
31,46881,2,2,1, 46883
24,46889,1,1,1, 46890
8,46891,1,1,1, 46892
16,46894,2,2,1, 46896
24,46904,1,1,1, 46905
8,46906,1,1,0, 46907
9,46907,2,2,1, 46909
16,46909,2,2,1, 46911
1,46911,1,1,1, 46912
31,46911,2,2,1, 46913
24,46919,1,1,0, 46920
1,46926,1,1,1, 46927
1,46941,1,1,0, 46942
25,46955,2,2,1, 46957
1,46956,1,1,1, 46957
7,46962,1,1,0, 46963
1,46971,1,1,0, 46972
6,46975,2,2,1, 46977
7,46977,1,1,1, 46978
25,46985,2,2,1, 46987
1,46986,1,1,0, 46987
31,46986,2,2,1, 46988
6,46990,2,2,1, 46992
7,46992,1,1,0, 46993
1,47001,1,1,0, 47002
7,47007,1,1,0, 47008
1,47016,1,1,0, 47017
6,47020,2,2,1, 47022
7,47022,1,1,0, 47023
2,47028,2,2,1, 47030
1,47031,1,1,0, 47032
15,47031,2,2,1, 47033
31,47031,2,2,1, 47033
7,47037,1,1,1, 47038
24,47039,1,1,0, 47040
8,47041,1,1,1, 47042
31,47046,2,2,1, 47048
24,47054,1,1,1, 47055
16,47059,2,2,1, 47061
31,47061,2,2,1, 47063
24,47069,1,1,0, 47070
16,47074,2,2,1, 47076
24,47084,1,1,0, 47085
16,47089,2,2,1, 47091
24,47099,1,1,0, 47100
7,47142,1,1,1, 47143
8,47146,1,1,1, 47147
1,47151,1,1,1, 47152
31,47151,2,2,1, 47153
6,47155,2,2,1, 47157
7,47157,1,1,0, 47158
8,47161,1,1,0, 47162
1,47166,1,1,1, 47167
8,47176,1,1,1, 47177
16,47179,2,2,1, 47181
25,47180,2,2,1, 47182
1,47181,1,1,0, 47182
8,47191,1,1,1, 47192
16,47194,2,2,1, 47196
1,47196,1,1,1, 47197
8,47206,1,1,0, 47207
1,47211,1,1,0, 47212
8,47221,1,1,1, 47222
1,47226,1,1,1, 47227
8,47236,1,1,0, 47237
25,47240,2,2,1, 47242
1,47241,1,1,0, 47242
8,47251,1,1,1, 47252
16,47254,2,2,1, 47256
1,47256,1,1,0, 47257
7,47262,1,1,0, 47263
24,47264,1,1,0, 47265
8,47266,1,1,1, 47267
2,47268,2,2,1, 47270
1,47271,1,1,0, 47272
7,47277,1,1,1, 47278
24,47279,1,1,1, 47280
8,47281,1,1,1, 47282
2,47283,2,2,1, 47285
1,47286,1,1,0, 47287
7,47292,1,1,1, 47293
24,47294,1,1,0, 47295
8,47296,1,1,1, 47297
2,47298,2,2,1, 47300
1,47301,1,1,0, 47302
15,47301,2,2,1, 47303
7,47307,1,1,1, 47308
24,47309,1,1,1, 47310
8,47311,1,1,0, 47312
9,47312,2,2,1, 47314
1,47316,1,1,0, 47317
15,47316,2,2,1, 47318
6,47320,2,2,1, 47322
7,47322,1,1,0, 47323
24,47324,1,1,1, 47325
8,47326,1,1,0, 47327
1,47331,1,1,0, 47332
31,47331,2,2,1, 47333
7,47337,1,1,1, 47338
24,47339,1,1,0, 47340
8,47341,1,1,0, 47342
1,47346,1,1,1, 47347
31,47346,2,2,1, 47348
7,47352,1,1,1, 47353
24,47354,1,1,1, 47355
8,47356,1,1,1, 47357
9,47357,2,2,1, 47359
1,47361,1,1,0, 47362
31,47361,2,2,1, 47363
6,47365,2,2,1, 47367
7,47367,1,1,1, 47368
24,47369,1,1,0, 47370
8,47371,1,1,1, 47372
9,47372,2,2,1, 47374
1,47376,1,1,1, 47377
31,47376,2,2,1, 47378
6,47380,2,2,1, 47382
7,47382,1,1,1, 47383
24,47384,1,1,0, 47385
8,47386,1,1,0, 47387
9,47387,2,2,1, 47389
25,47390,2,2,1, 47392
1,47391,1,1,1, 47392
31,47391,2,2,1, 47393
7,47397,1,1,0, 47398
24,47399,1,1,1, 47400
7,47502,1,1,0, 47503
24,47504,1,1,1, 47505
16,47509,2,2,1, 47511
25,47510,2,2,1, 47512
1,47511,1,1,0, 47512
31,47511,2,2,1, 47513
6,47515,2,2,1, 47517
7,47517,1,1,1, 47518
24,47519,1,1,0, 47520
8,47521,1,1,0, 47522
1,47526,1,1,1, 47527
6,47530,2,2,1, 47532
7,47532,1,1,0, 47533
24,47534,1,1,1, 47535
8,47536,1,1,0, 47537
9,47537,2,2,1, 47539
16,47539,2,2,1, 47541
1,47541,1,1,1, 47542
6,47545,2,2,1, 47547
7,47547,1,1,0, 47548
24,47549,1,1,0, 47550
8,47551,1,1,0, 47552
1,47556,1,1,0, 47557
31,47556,2,2,1, 47558
6,47560,2,2,1, 47562
7,47562,1,1,0, 47563
24,47564,1,1,1, 47565
8,47566,1,1,1, 47567
16,47569,2,2,1, 47571
1,47571,1,1,1, 47572
6,47575,2,2,1, 47577
7,47577,1,1,1, 47578
24,47579,1,1,1, 47580
8,47581,1,1,1, 47582
1,47586,1,1,0, 47587
7,47592,1,1,0, 47593
8,47596,1,1,1, 47597
1,47601,1,1,0, 47602
31,47601,2,2,1, 47603
6,47605,2,2,1, 47607
7,47607,1,1,1, 47608
8,47611,1,1,1, 47612
1,47616,1,1,1, 47617
31,47616,2,2,1, 47618
6,47620,2,2,1, 47622
7,47622,1,1,0, 47623
8,47626,1,1,1, 47627
2,47628,2,2,1, 47630
25,47630,2,2,1, 47632
1,47631,1,1,1, 47632
15,47631,2,2,1, 47633
8,47641,1,1,0, 47642
25,47645,2,2,1, 47647
1,47646,1,1,0, 47647
8,47656,1,1,1, 47657
25,47660,2,2,1, 47662
1,47661,1,1,1, 47662
8,47671,1,1,0, 47672
1,47676,1,1,0, 47677
8,47686,1,1,1, 47687
25,47690,2,2,1, 47692
1,47691,1,1,1, 47692
8,47701,1,1,0, 47702
9,47702,2,2,1, 47704
8,47716,1,1,0, 47717
9,47717,2,2,1, 47719
8,47731,1,1,0, 47732
31,47736,2,2,1, 47738
7,47742,1,1,0, 47743
24,47744,1,1,0, 47745
8,47746,1,1,1, 47747
9,47747,2,2,1, 47749
16,47749,2,2,1, 47751
15,47751,2,2,1, 47753
7,47757,1,1,1, 47758
24,47759,1,1,1, 47760
31,47766,2,2,1, 47768
6,47770,2,2,1, 47772
7,47772,1,1,0, 47773
24,47774,1,1,1, 47775
16,47779,2,2,1, 47781
7,47787,1,1,1, 47788
24,47789,1,1,0, 47790
16,47794,2,2,1, 47796
7,47802,1,1,1, 47803
24,47804,1,1,0, 47805
7,47817,1,1,0, 47818
24,47819,1,1,1, 47820
31,47826,2,2,1, 47828
7,47832,1,1,0, 47833
24,47834,1,1,0, 47835
31,47841,2,2,1, 47843
7,47847,1,1,0, 47848
24,47849,1,1,1, 47850
31,47856,2,2,1, 47858
7,47862,1,1,0, 47863
24,47864,1,1,0, 47865
8,47866,1,1,0, 47867
16,47869,2,2,1, 47871
1,47871,1,1,1, 47872
31,47871,2,2,1, 47873
7,47877,1,1,1, 47878
24,47879,1,1,0, 47880
8,47881,1,1,1, 47882
25,47885,2,2,1, 47887
1,47886,1,1,1, 47887
8,47896,1,1,1, 47897
1,47901,1,1,0, 47902
8,47911,1,1,1, 47912
25,47915,2,2,1, 47917
1,47916,1,1,0, 47917
8,47926,1,1,0, 47927
25,47930,2,2,1, 47932
1,47931,1,1,0, 47932
8,47941,1,1,0, 47942
1,47946,1,1,0, 47947
31,47946,2,2,1, 47948
7,47952,1,1,1, 47953
8,47956,1,1,1, 47957
1,47961,1,1,1, 47962
6,47965,2,2,1, 47967
7,47967,1,1,0, 47968
8,47971,1,1,1, 47972
1,47976,1,1,0, 47977
6,47980,2,2,1, 47982
7,47982,1,1,0, 47983
24,47984,1,1,1, 47985
8,47986,1,1,0, 47987
9,47987,2,2,1, 47989
16,47989,2,2,1, 47991
1,47991,1,1,0, 47992
15,47991,2,2,1, 47993
31,47991,2,2,1, 47993
6,47995,2,2,1, 47997
7,47997,1,1,1, 47998
24,47999,1,1,0, 48000
24,48014,1,1,0, 48015
31,48021,2,2,1, 48023
24,48029,1,1,1, 48030
24,48044,1,1,1, 48045
31,48051,2,2,1, 48053
24,48059,1,1,1, 48060
31,48066,2,2,1, 48068
24,48074,1,1,1, 48075
24,48089,1,1,1, 48090
7,48102,1,1,0, 48103
24,48104,1,1,1, 48105
8,48106,1,1,1, 48107
1,48111,1,1,0, 48112
31,48111,2,2,1, 48113
7,48117,1,1,1, 48118
24,48119,1,1,0, 48120
8,48121,1,1,0, 48122
16,48124,2,2,1, 48126
1,48126,1,1,0, 48127
15,48126,2,2,1, 48128
6,48130,2,2,1, 48132
7,48132,1,1,1, 48133
8,48136,1,1,1, 48137
16,48139,2,2,1, 48141
1,48141,1,1,0, 48142
15,48141,2,2,1, 48143
31,48141,2,2,1, 48143
6,48145,2,2,1, 48147
7,48147,1,1,0, 48148
8,48151,1,1,1, 48152
16,48154,2,2,1, 48156
1,48156,1,1,0, 48157
7,48162,1,1,1, 48163
8,48166,1,1,0, 48167
16,48169,2,2,1, 48171
1,48171,1,1,0, 48172
7,48177,1,1,0, 48178
8,48181,1,1,1, 48182
16,48184,2,2,1, 48186
1,48186,1,1,0, 48187
8,48196,1,1,1, 48197
16,48199,2,2,1, 48201
1,48201,1,1,0, 48202
8,48211,1,1,0, 48212
1,48216,1,1,0, 48217
24,48224,1,1,0, 48225
8,48226,1,1,0, 48227
9,48227,2,2,1, 48229
16,48229,2,2,1, 48231
1,48231,1,1,1, 48232
24,48239,1,1,1, 48240
16,48244,2,2,1, 48246
1,48246,1,1,1, 48247
31,48246,2,2,1, 48248
24,48254,1,1,0, 48255
1,48261,1,1,1, 48262
24,48269,1,1,1, 48270
1,48276,1,1,0, 48277
24,48284,1,1,1, 48285
16,48289,2,2,1, 48291
1,48291,1,1,1, 48292
7,48297,1,1,1, 48298
24,48299,1,1,0, 48300
1,48306,1,1,1, 48307
15,48306,2,2,1, 48308
31,48306,2,2,1, 48308
7,48312,1,1,1, 48313
9,48317,2,2,1, 48319
1,48321,1,1,1, 48322
15,48321,2,2,1, 48323
31,48321,2,2,1, 48323
7,48327,1,1,1, 48328
1,48336,1,1,1, 48337
31,48336,2,2,1, 48338
7,48342,1,1,1, 48343
25,48350,2,2,1, 48352
1,48351,1,1,0, 48352
31,48351,2,2,1, 48353
7,48357,1,1,0, 48358
6,48370,2,2,1, 48372
7,48372,1,1,0, 48373
31,48381,2,2,1, 48383
7,48387,1,1,0, 48388
31,48396,2,2,1, 48398
7,48402,1,1,1, 48403
8,48406,1,1,0, 48407
31,48411,2,2,1, 48413
6,48415,2,2,1, 48417
7,48417,1,1,1, 48418
8,48421,1,1,0, 48422
16,48424,2,2,1, 48426
25,48425,2,2,1, 48427
1,48426,1,1,0, 48427
8,48436,1,1,1, 48437
1,48441,1,1,0, 48442
8,48451,1,1,1, 48452
16,48454,2,2,1, 48456
1,48456,1,1,1, 48457
24,48464,1,1,0, 48465
8,48466,1,1,1, 48467
25,48470,2,2,1, 48472
1,48471,1,1,1, 48472
31,48471,2,2,1, 48473
24,48479,1,1,1, 48480
8,48481,1,1,0, 48482
9,48482,2,2,1, 48484
1,48486,1,1,1, 48487
15,48486,2,2,1, 48488
31,48486,2,2,1, 48488
7,48492,1,1,1, 48493
24,48494,1,1,0, 48495
8,48496,1,1,1, 48497
9,48497,2,2,1, 48499
1,48501,1,1,0, 48502
7,48507,1,1,0, 48508
24,48509,1,1,1, 48510
8,48511,1,1,0, 48512
1,48516,1,1,0, 48517
7,48522,1,1,1, 48523
24,48524,1,1,1, 48525
8,48526,1,1,0, 48527
9,48527,2,2,1, 48529
1,48531,1,1,1, 48532
7,48537,1,1,0, 48538
24,48539,1,1,1, 48540
8,48541,1,1,1, 48542
9,48542,2,2,1, 48544
1,48546,1,1,0, 48547
15,48546,2,2,1, 48548
31,48546,2,2,1, 48548
7,48552,1,1,0, 48553
24,48554,1,1,0, 48555
8,48556,1,1,0, 48557
9,48557,2,2,1, 48559
2,48558,2,2,1, 48560
1,48561,1,1,1, 48562
15,48561,2,2,1, 48563
6,48565,2,2,1, 48567
7,48567,1,1,0, 48568
24,48569,1,1,1, 48570
8,48571,1,1,0, 48572
1,48576,1,1,1, 48577
6,48580,2,2,1, 48582
7,48582,1,1,1, 48583
24,48584,1,1,0, 48585
8,48586,1,1,0, 48587
1,48591,1,1,0, 48592
15,48591,2,2,1, 48593
7,48597,1,1,1, 48598
24,48599,1,1,1, 48600
16,48604,2,2,1, 48606
31,48606,2,2,1, 48608
24,48614,1,1,1, 48615
16,48619,2,2,1, 48621
31,48621,2,2,1, 48623
24,48629,1,1,0, 48630
24,48644,1,1,1, 48645
31,48651,2,2,1, 48653
24,48659,1,1,0, 48660
1,48711,1,1,0, 48712
6,48715,2,2,1, 48717
7,48717,1,1,0, 48718
8,48721,1,1,0, 48722
9,48722,2,2,1, 48724
2,48723,2,2,1, 48725
25,48725,2,2,1, 48727
1,48726,1,1,1, 48727
7,48732,1,1,0, 48733
24,48734,1,1,0, 48735
8,48736,1,1,0, 48737
2,48738,2,2,1, 48740
1,48741,1,1,0, 48742
7,48747,1,1,1, 48748
24,48749,1,1,1, 48750
8,48751,1,1,0, 48752
1,48756,1,1,0, 48757
6,48760,2,2,1, 48762
7,48762,1,1,1, 48763
24,48764,1,1,0, 48765
8,48766,1,1,0, 48767
25,48770,2,2,1, 48772
1,48771,1,1,0, 48772
6,48775,2,2,1, 48777
7,48777,1,1,0, 48778
24,48779,1,1,0, 48780
8,48781,1,1,1, 48782
7,48792,1,1,0, 48793
24,48794,1,1,1, 48795
8,48796,1,1,0, 48797
7,48807,1,1,1, 48808
24,48809,1,1,1, 48810
8,48811,1,1,0, 48812
7,48822,1,1,0, 48823
24,48824,1,1,0, 48825
8,48826,1,1,0, 48827
25,48830,2,2,1, 48832
15,48831,2,2,1, 48833
7,48837,1,1,0, 48838
24,48839,1,1,1, 48840
8,48841,1,1,0, 48842
16,48844,2,2,1, 48846
8,48856,1,1,0, 48857
16,48859,2,2,1, 48861
8,48871,1,1,0, 48872
8,48886,1,1,0, 48887
9,48887,2,2,1, 48889
16,48889,2,2,1, 48891
1,48891,1,1,1, 48892
8,48901,1,1,1, 48902
1,48906,1,1,0, 48907
1,48921,1,1,1, 48922
1,48936,1,1,0, 48937
7,48942,1,1,1, 48943
24,48944,1,1,0, 48945
25,48950,2,2,1, 48952
1,48951,1,1,0, 48952
31,48951,2,2,1, 48953
7,48957,1,1,0, 48958
24,48959,1,1,0, 48960
8,48961,1,1,0, 48962
25,48965,2,2,1, 48967
1,48966,1,1,0, 48967
31,48966,2,2,1, 48968
7,48972,1,1,0, 48973
24,48974,1,1,1, 48975
8,48976,1,1,0, 48977
1,48981,1,1,0, 48982
31,48981,2,2,1, 48983
6,48985,2,2,1, 48987
7,48987,1,1,1, 48988
24,48989,1,1,1, 48990
8,48991,1,1,1, 48992
1,48996,1,1,1, 48997
6,49000,2,2,1, 49002
7,49002,1,1,1, 49003
24,49004,1,1,1, 49005
8,49006,1,1,0, 49007
1,49011,1,1,1, 49012
15,49011,2,2,1, 49013
31,49011,2,2,1, 49013
7,49017,1,1,1, 49018
24,49019,1,1,1, 49020
8,49021,1,1,1, 49022
1,49026,1,1,1, 49027
31,49026,2,2,1, 49028
7,49032,1,1,1, 49033
24,49034,1,1,0, 49035
8,49036,1,1,0, 49037
9,49037,2,2,1, 49039
1,49041,1,1,0, 49042
31,49041,2,2,1, 49043
6,49045,2,2,1, 49047
7,49047,1,1,0, 49048
24,49049,1,1,1, 49050
8,49051,1,1,0, 49052
9,49052,2,2,1, 49054
1,49056,1,1,1, 49057
6,49060,2,2,1, 49062
7,49062,1,1,1, 49063
24,49064,1,1,0, 49065
8,49066,1,1,1, 49067
2,49068,2,2,1, 49070
1,49071,1,1,0, 49072
7,49077,1,1,1, 49078
24,49079,1,1,0, 49080
25,49085,2,2,1, 49087
1,49086,1,1,0, 49087
1,49101,1,1,1, 49102
7,49182,1,1,0, 49183
8,49186,1,1,0, 49187
6,49195,2,2,1, 49197
7,49197,1,1,1, 49198
24,49199,1,1,1, 49200
8,49201,1,1,0, 49202
9,49202,2,2,1, 49204
1,49206,1,1,1, 49207
7,49212,1,1,0, 49213
24,49214,1,1,0, 49215
8,49216,1,1,0, 49217
9,49217,2,2,1, 49219
1,49221,1,1,0, 49222
31,49221,2,2,1, 49223
7,49227,1,1,0, 49228
24,49229,1,1,1, 49230
8,49231,1,1,1, 49232
9,49232,2,2,1, 49234
1,49236,1,1,0, 49237
6,49240,2,2,1, 49242
7,49242,1,1,0, 49243
24,49244,1,1,1, 49245
8,49246,1,1,1, 49247
9,49247,2,2,1, 49249
1,49251,1,1,0, 49252
7,49257,1,1,1, 49258
24,49259,1,1,1, 49260
8,49261,1,1,1, 49262
9,49262,2,2,1, 49264
1,49266,1,1,0, 49267
31,49266,2,2,1, 49268
7,49272,1,1,1, 49273
24,49274,1,1,1, 49275
8,49276,1,1,1, 49277
1,49281,1,1,0, 49282
31,49281,2,2,1, 49283
7,49287,1,1,0, 49288
24,49289,1,1,1, 49290
8,49291,1,1,0, 49292
1,49296,1,1,0, 49297
7,49302,1,1,1, 49303
24,49304,1,1,0, 49305
8,49306,1,1,1, 49307
9,49307,2,2,1, 49309
16,49309,2,2,1, 49311
25,49310,2,2,1, 49312
1,49311,1,1,0, 49312
7,49317,1,1,0, 49318
24,49319,1,1,0, 49320
7,49332,1,1,1, 49333
7,49347,1,1,1, 49348
31,49356,2,2,1, 49358
7,49362,1,1,1, 49363
15,49371,2,2,1, 49373
7,49377,1,1,1, 49378
31,49386,2,2,1, 49388
7,49392,1,1,0, 49393
7,49407,1,1,0, 49408
7,49422,1,1,0, 49423
24,49424,1,1,0, 49425
8,49426,1,1,0, 49427
16,49429,2,2,1, 49431
25,49430,2,2,1, 49432
1,49431,1,1,0, 49432
15,49431,2,2,1, 49433
31,49431,2,2,1, 49433
6,49435,2,2,1, 49437
7,49437,1,1,1, 49438
24,49439,1,1,0, 49440
8,49441,1,1,0, 49442
9,49442,2,2,1, 49444
25,49445,2,2,1, 49447
1,49446,1,1,1, 49447
24,49454,1,1,0, 49455
8,49456,1,1,0, 49457
9,49457,2,2,1, 49459
1,49461,1,1,0, 49462
31,49461,2,2,1, 49463
24,49469,1,1,0, 49470
8,49471,1,1,0, 49472
1,49476,1,1,1, 49477
24,49484,1,1,1, 49485
8,49486,1,1,0, 49487
25,49490,2,2,1, 49492
1,49491,1,1,1, 49492
24,49499,1,1,1, 49500
8,49501,1,1,0, 49502
1,49506,1,1,0, 49507
24,49514,1,1,0, 49515
8,49516,1,1,0, 49517
9,49517,2,2,1, 49519
1,49521,1,1,0, 49522
24,49529,1,1,0, 49530
8,49531,1,1,1, 49532
1,49536,1,1,0, 49537
24,49544,1,1,0, 49545
8,49546,1,1,0, 49547
2,49548,2,2,1, 49550
1,49551,1,1,1, 49552
31,49551,2,2,1, 49553
24,49559,1,1,1, 49560
1,49566,1,1,1, 49567
31,49566,2,2,1, 49568
7,49572,1,1,0, 49573
1,49581,1,1,1, 49582
31,49581,2,2,1, 49583
6,49585,2,2,1, 49587
7,49587,1,1,1, 49588
1,49596,1,1,1, 49597
7,49602,1,1,1, 49603
1,49611,1,1,0, 49612
7,49617,1,1,0, 49618
1,49626,1,1,0, 49627
15,49626,2,2,1, 49628
7,49632,1,1,0, 49633
1,49641,1,1,1, 49642
7,49647,1,1,1, 49648
1,49656,1,1,0, 49657
15,49656,2,2,1, 49658
7,49662,1,1,1, 49663
24,49664,1,1,0, 49665
8,49666,1,1,0, 49667
2,49668,2,2,1, 49670
1,49671,1,1,0, 49672
7,49677,1,1,0, 49678
24,49679,1,1,0, 49680
8,49681,1,1,1, 49682
24,49694,1,1,1, 49695
8,49696,1,1,1, 49697
9,49697,2,2,1, 49699
24,49709,1,1,1, 49710
8,49711,1,1,1, 49712
24,49724,1,1,0, 49725
8,49726,1,1,0, 49727
24,49739,1,1,0, 49740
8,49741,1,1,0, 49742
9,49742,2,2,1, 49744
24,49754,1,1,0, 49755
8,49756,1,1,0, 49757
24,49769,1,1,0, 49770
8,49771,1,1,1, 49772
7,49782,1,1,0, 49783
24,49784,1,1,1, 49785
8,49786,1,1,1, 49787
9,49787,2,2,1, 49789
2,49788,2,2,1, 49790
1,49791,1,1,0, 49792
15,49791,2,2,1, 49793
31,49791,2,2,1, 49793
6,49795,2,2,1, 49797
7,49797,1,1,0, 49798
24,49799,1,1,1, 49800
16,49804,2,2,1, 49806
1,49806,1,1,1, 49807
7,49812,1,1,1, 49813
24,49814,1,1,0, 49815
1,49821,1,1,1, 49822
15,49821,2,2,1, 49823
7,49827,1,1,0, 49828
24,49829,1,1,0, 49830
1,49836,1,1,1, 49837
7,49842,1,1,0, 49843
24,49844,1,1,0, 49845
16,49849,2,2,1, 49851
1,49851,1,1,0, 49852
7,49857,1,1,0, 49858
24,49859,1,1,0, 49860
16,49864,2,2,1, 49866
25,49865,2,2,1, 49867
1,49866,1,1,0, 49867
7,49872,1,1,1, 49873
1,49881,1,1,1, 49882
15,49881,2,2,1, 49883
7,49887,1,1,0, 49888
25,49895,2,2,1, 49897
1,49896,1,1,0, 49897
15,49896,2,2,1, 49898
7,49902,1,1,0, 49903
8,49906,1,1,1, 49907
2,49908,2,2,1, 49910
16,49909,2,2,1, 49911
1,49911,1,1,1, 49912
15,49911,2,2,1, 49913
7,49917,1,1,0, 49918
8,49921,1,1,0, 49922
1,49926,1,1,0, 49927
24,49934,1,1,1, 49935
8,49936,1,1,0, 49937
9,49937,2,2,1, 49939
1,49941,1,1,1, 49942
24,49949,1,1,0, 49950
8,49951,1,1,1, 49952
9,49952,2,2,1, 49954
1,49956,1,1,0, 49957
24,49964,1,1,1, 49965
8,49966,1,1,1, 49967
9,49967,2,2,1, 49969
1,49971,1,1,1, 49972
31,49971,2,2,1, 49973
24,49979,1,1,0, 49980
8,49981,1,1,0, 49982
9,49982,2,2,1, 49984
1,49986,1,1,1, 49987
31,49986,2,2,1, 49988
24,49994,1,1,0, 49995
8,49996,1,1,0, 49997
9,49997,2,2,1, 49999
1,50001,1,1,1, 50002
31,50001,2,2,1, 50003
24,50009,1,1,1, 50010
8,50011,1,1,0, 50012
9,50012,2,2,1, 50014
1,50016,1,1,0, 50017
7,50022,1,1,1, 50023
24,50024,1,1,0, 50025
8,50026,1,1,0, 50027
2,50028,2,2,1, 50030
16,50029,2,2,1, 50031
25,50030,2,2,1, 50032
1,50031,1,1,0, 50032
6,50035,2,2,1, 50037
7,50037,1,1,1, 50038
24,50039,1,1,1, 50040
6,50050,2,2,1, 50052
7,50052,1,1,0, 50053
6,50065,2,2,1, 50067
7,50067,1,1,0, 50068
31,50076,2,2,1, 50078
7,50082,1,1,0, 50083
31,50091,2,2,1, 50093
7,50097,1,1,0, 50098
24,50144,1,1,0, 50145
8,50146,1,1,1, 50147
1,50151,1,1,0, 50152
31,50151,2,2,1, 50153
24,50159,1,1,0, 50160
8,50161,1,1,0, 50162
9,50162,2,2,1, 50164
25,50165,2,2,1, 50167
1,50166,1,1,1, 50167
15,50166,2,2,1, 50168
24,50174,1,1,1, 50175
8,50176,1,1,0, 50177
16,50179,2,2,1, 50181
25,50180,2,2,1, 50182
1,50181,1,1,0, 50182
15,50181,2,2,1, 50183
24,50189,1,1,0, 50190
8,50191,1,1,1, 50192
1,50196,1,1,1, 50197
31,50196,2,2,1, 50198
7,50202,1,1,0, 50203
24,50204,1,1,1, 50205
8,50206,1,1,0, 50207
16,50209,2,2,1, 50211
25,50210,2,2,1, 50212
1,50211,1,1,0, 50212
15,50211,2,2,1, 50213
6,50215,2,2,1, 50217
7,50217,1,1,1, 50218
24,50219,1,1,1, 50220
8,50221,1,1,0, 50222
1,50226,1,1,0, 50227
7,50232,1,1,0, 50233
1,50241,1,1,0, 50242
31,50241,2,2,1, 50243
7,50247,1,1,0, 50248
1,50256,1,1,0, 50257
15,50256,2,2,1, 50258
7,50262,1,1,1, 50263
2,50268,2,2,1, 50270
1,50271,1,1,1, 50272
6,50275,2,2,1, 50277
7,50277,1,1,1, 50278
1,50286,1,1,1, 50287
9,50297,2,2,1, 50299
1,50301,1,1,0, 50302
9,50312,2,2,1, 50314
25,50315,2,2,1, 50317
1,50316,1,1,1, 50317
24,50324,1,1,0, 50325
1,50331,1,1,1, 50332
24,50339,1,1,1, 50340
16,50344,2,2,1, 50346
31,50346,2,2,1, 50348
24,50354,1,1,0, 50355
16,50359,2,2,1, 50361
24,50369,1,1,0, 50370
31,50376,2,2,1, 50378
7,50382,1,1,0, 50383
24,50384,1,1,1, 50385
8,50386,1,1,0, 50387
31,50391,2,2,1, 50393
7,50397,1,1,0, 50398
24,50399,1,1,0, 50400
8,50401,1,1,1, 50402
1,50406,1,1,0, 50407
7,50412,1,1,1, 50413
24,50414,1,1,0, 50415
8,50416,1,1,0, 50417
2,50418,2,2,1, 50420
25,50420,2,2,1, 50422
1,50421,1,1,0, 50422
15,50421,2,2,1, 50423
7,50427,1,1,1, 50428
24,50429,1,1,0, 50430
8,50431,1,1,1, 50432
1,50436,1,1,1, 50437
7,50442,1,1,0, 50443
24,50444,1,1,1, 50445
8,50446,1,1,1, 50447
25,50450,2,2,1, 50452
1,50451,1,1,0, 50452
15,50451,2,2,1, 50453
7,50457,1,1,0, 50458
24,50459,1,1,0, 50460
8,50461,1,1,1, 50462
1,50466,1,1,1, 50467
15,50466,2,2,1, 50468
7,50472,1,1,1, 50473
24,50474,1,1,1, 50475
8,50476,1,1,1, 50477
2,50478,2,2,1, 50480
1,50481,1,1,1, 50482
7,50487,1,1,1, 50488
24,50489,1,1,0, 50490
8,50491,1,1,0, 50492
16,50494,2,2,1, 50496
1,50496,1,1,1, 50497
15,50496,2,2,1, 50498
7,50502,1,1,0, 50503
24,50504,1,1,0, 50505
8,50506,1,1,1, 50507
2,50508,2,2,1, 50510
1,50511,1,1,1, 50512
6,50515,2,2,1, 50517
7,50517,1,1,0, 50518
24,50519,1,1,1, 50520
8,50521,1,1,0, 50522
9,50522,2,2,1, 50524
1,50526,1,1,0, 50527
31,50526,2,2,1, 50528
24,50534,1,1,1, 50535
8,50536,1,1,0, 50537
1,50541,1,1,0, 50542
24,50549,1,1,1, 50550
8,50551,1,1,0, 50552
1,50556,1,1,0, 50557
24,50564,1,1,1, 50565
8,50566,1,1,0, 50567
16,50569,2,2,1, 50571
25,50570,2,2,1, 50572
1,50571,1,1,1, 50572
31,50571,2,2,1, 50573
24,50579,1,1,0, 50580
8,50581,1,1,1, 50582
25,50585,2,2,1, 50587
24,50594,1,1,0, 50595
8,50596,1,1,1, 50597
25,50600,2,2,1, 50602
24,50609,1,1,1, 50610
8,50611,1,1,1, 50612
31,50616,2,2,1, 50618
7,50622,1,1,1, 50623
24,50624,1,1,0, 50625
8,50626,1,1,0, 50627
7,50637,1,1,0, 50638
24,50639,1,1,1, 50640
8,50641,1,1,1, 50642
15,50646,2,2,1, 50648
31,50646,2,2,1, 50648
7,50652,1,1,0, 50653
8,50656,1,1,0, 50657
15,50661,2,2,1, 50663
31,50661,2,2,1, 50663
7,50667,1,1,0, 50668
8,50671,1,1,0, 50672
15,50676,2,2,1, 50678
31,50676,2,2,1, 50678
7,50682,1,1,1, 50683
8,50686,1,1,1, 50687
16,50689,2,2,1, 50691
1,50691,1,1,1, 50692
15,50691,2,2,1, 50693
31,50691,2,2,1, 50693
7,50697,1,1,1, 50698
9,50702,2,2,1, 50704
2,50703,2,2,1, 50705
1,50706,1,1,0, 50707
7,50712,1,1,0, 50713
9,50717,2,2,1, 50719
1,50721,1,1,1, 50722
31,50721,2,2,1, 50723
7,50727,1,1,0, 50728
9,50732,2,2,1, 50734
2,50733,2,2,1, 50735
1,50736,1,1,0, 50737
31,50736,2,2,1, 50738
7,50742,1,1,1, 50743
24,50744,1,1,1, 50745
9,50747,2,2,1, 50749
2,50748,2,2,1, 50750
1,50751,1,1,0, 50752
7,50757,1,1,0, 50758
24,50759,1,1,1, 50760
8,50761,1,1,1, 50762
9,50762,2,2,1, 50764
7,50772,1,1,1, 50773
24,50774,1,1,1, 50775
8,50776,1,1,0, 50777
31,50781,2,2,1, 50783
7,50787,1,1,0, 50788
24,50789,1,1,0, 50790
8,50791,1,1,1, 50792
7,50802,1,1,1, 50803
24,50804,1,1,1, 50805
8,50806,1,1,0, 50807
31,50811,2,2,1, 50813
7,50817,1,1,0, 50818
24,50819,1,1,1, 50820
8,50821,1,1,0, 50822
25,50825,2,2,1, 50827
15,50826,2,2,1, 50828
7,50832,1,1,1, 50833
24,50834,1,1,0, 50835
8,50836,1,1,1, 50837
25,50840,2,2,1, 50842
7,50847,1,1,1, 50848
24,50849,1,1,0, 50850
8,50851,1,1,0, 50852
15,50856,2,2,1, 50858
31,50856,2,2,1, 50858
7,50862,1,1,1, 50863
24,50864,1,1,1, 50865
8,50866,1,1,1, 50867
1,50871,1,1,0, 50872
15,50871,2,2,1, 50873
31,50871,2,2,1, 50873
7,50877,1,1,1, 50878
24,50879,1,1,0, 50880
1,50886,1,1,1, 50887
1,50901,1,1,1, 50902
1,50916,1,1,1, 50917
1,50931,1,1,1, 50932
1,50946,1,1,0, 50947
1,50961,1,1,0, 50962
1,50976,1,1,0, 50977
8,50986,1,1,1, 50987
9,50987,2,2,1, 50989
1,50991,1,1,0, 50992
7,50997,1,1,0, 50998
24,50999,1,1,0, 51000
8,51001,1,1,1, 51002
9,51002,2,2,1, 51004
25,51005,2,2,1, 51007
1,51006,1,1,0, 51007
6,51010,2,2,1, 51012
7,51012,1,1,1, 51013
24,51014,1,1,1, 51015
8,51016,1,1,1, 51017
9,51017,2,2,1, 51019
1,51021,1,1,1, 51022
15,51021,2,2,1, 51023
31,51021,2,2,1, 51023
7,51027,1,1,0, 51028
24,51029,1,1,1, 51030
8,51031,1,1,1, 51032
25,51035,2,2,1, 51037
1,51036,1,1,1, 51037
15,51036,2,2,1, 51038
31,51036,2,2,1, 51038
7,51042,1,1,1, 51043
24,51044,1,1,1, 51045
8,51046,1,1,0, 51047
25,51050,2,2,1, 51052
1,51051,1,1,1, 51052
15,51051,2,2,1, 51053
31,51051,2,2,1, 51053
7,51057,1,1,1, 51058
24,51059,1,1,0, 51060
24,51074,1,1,0, 51075
24,51089,1,1,0, 51090
31,51096,2,2,1, 51098
24,51104,1,1,0, 51105
16,51109,2,2,1, 51111
31,51111,2,2,1, 51113
24,51119,1,1,0, 51120
8,51121,1,1,1, 51122
9,51122,2,2,1, 51124
1,51126,1,1,1, 51127
31,51126,2,2,1, 51128
7,51132,1,1,1, 51133
8,51136,1,1,1, 51137
9,51137,2,2,1, 51139
1,51141,1,1,0, 51142
15,51141,2,2,1, 51143
31,51141,2,2,1, 51143
7,51147,1,1,1, 51148
8,51151,1,1,1, 51152
16,51154,2,2,1, 51156
1,51156,1,1,1, 51157
31,51156,2,2,1, 51158
7,51162,1,1,0, 51163
8,51166,1,1,1, 51167
16,51169,2,2,1, 51171
1,51171,1,1,1, 51172
31,51171,2,2,1, 51173
7,51177,1,1,1, 51178
9,51182,2,2,1, 51184
1,51186,1,1,0, 51187
15,51186,2,2,1, 51188
31,51186,2,2,1, 51188
7,51192,1,1,0, 51193
1,51201,1,1,0, 51202
31,51201,2,2,1, 51203
6,51205,2,2,1, 51207
7,51207,1,1,0, 51208
9,51212,2,2,1, 51214
1,51216,1,1,1, 51217
31,51216,2,2,1, 51218
6,51220,2,2,1, 51222
7,51222,1,1,1, 51223
24,51224,1,1,1, 51225
1,51231,1,1,1, 51232
7,51237,1,1,1, 51238
24,51239,1,1,0, 51240
16,51244,2,2,1, 51246
31,51246,2,2,1, 51248
24,51254,1,1,1, 51255
16,51259,2,2,1, 51261
31,51261,2,2,1, 51263
8,51286,1,1,1, 51287
16,51289,2,2,1, 51291
8,51301,1,1,1, 51302
16,51304,2,2,1, 51306
8,51316,1,1,1, 51317
8,51331,1,1,0, 51332
7,51342,1,1,0, 51343
8,51346,1,1,0, 51347
16,51349,2,2,1, 51351
25,51350,2,2,1, 51352
1,51351,1,1,1, 51352
31,51351,2,2,1, 51353
6,51355,2,2,1, 51357
7,51357,1,1,1, 51358
8,51361,1,1,0, 51362
16,51364,2,2,1, 51366
1,51366,1,1,1, 51367
7,51372,1,1,0, 51373
24,51374,1,1,0, 51375
8,51376,1,1,1, 51377
9,51377,2,2,1, 51379
16,51379,2,2,1, 51381
1,51381,1,1,0, 51382
7,51387,1,1,1, 51388
24,51389,1,1,0, 51390
8,51391,1,1,1, 51392
9,51392,2,2,1, 51394
16,51394,2,2,1, 51396
25,51395,2,2,1, 51397
1,51396,1,1,0, 51397
7,51402,1,1,0, 51403
24,51404,1,1,0, 51405
8,51406,1,1,1, 51407
1,51411,1,1,0, 51412
15,51411,2,2,1, 51413
7,51417,1,1,1, 51418
24,51419,1,1,0, 51420
16,51424,2,2,1, 51426
25,51425,2,2,1, 51427
15,51426,2,2,1, 51428
7,51432,1,1,1, 51433
24,51434,1,1,1, 51435
15,51441,2,2,1, 51443
7,51447,1,1,0, 51448
24,51449,1,1,1, 51450
7,51462,1,1,0, 51463
24,51464,1,1,1, 51465
15,51471,2,2,1, 51473
31,51471,2,2,1, 51473
6,51475,2,2,1, 51477
7,51477,1,1,0, 51478
24,51479,1,1,0, 51480
1,51486,1,1,0, 51487
1,51501,1,1,0, 51502
9,51512,2,2,1, 51514
1,51516,1,1,0, 51517
8,51526,1,1,0, 51527
1,51531,1,1,0, 51532
8,51541,1,1,1, 51542
1,51546,1,1,1, 51547
8,51556,1,1,0, 51557
16,51559,2,2,1, 51561
1,51561,1,1,1, 51562
8,51571,1,1,1, 51572
16,51574,2,2,1, 51576
1,51576,1,1,1, 51577
7,51582,1,1,0, 51583
24,51584,1,1,0, 51585
8,51586,1,1,1, 51587
2,51588,2,2,1, 51590
25,51590,2,2,1, 51592
1,51591,1,1,0, 51592
31,51591,2,2,1, 51593
7,51597,1,1,0, 51598
24,51599,1,1,0, 51600
8,51601,1,1,1, 51602
1,51606,1,1,1, 51607
15,51606,2,2,1, 51608
6,51610,2,2,1, 51612
7,51612,1,1,1, 51613
24,51614,1,1,0, 51615
8,51616,1,1,1, 51617
1,51621,1,1,1, 51622
15,51621,2,2,1, 51623
7,51627,1,1,0, 51628
24,51629,1,1,1, 51630
8,51631,1,1,0, 51632
1,51636,1,1,1, 51637
15,51636,2,2,1, 51638
31,51636,2,2,1, 51638
7,51642,1,1,1, 51643
24,51644,1,1,1, 51645
8,51646,1,1,0, 51647
1,51651,1,1,0, 51652
15,51651,2,2,1, 51653
31,51651,2,2,1, 51653
6,51655,2,2,1, 51657
7,51657,1,1,1, 51658
24,51659,1,1,0, 51660
8,51661,1,1,1, 51662
1,51666,1,1,0, 51667
24,51674,1,1,0, 51675
8,51676,1,1,0, 51677
1,51681,1,1,0, 51682
24,51689,1,1,1, 51690
8,51691,1,1,1, 51692
1,51696,1,1,1, 51697
24,51704,1,1,0, 51705
8,51706,1,1,0, 51707
2,51708,2,2,1, 51710
25,51710,2,2,1, 51712
1,51711,1,1,1, 51712
31,51711,2,2,1, 51713
24,51719,1,1,0, 51720
24,51734,1,1,1, 51735
24,51749,1,1,1, 51750
16,51754,2,2,1, 51756
31,51756,2,2,1, 51758
7,51762,1,1,1, 51763
24,51764,1,1,1, 51765
15,51771,2,2,1, 51773
31,51771,2,2,1, 51773
6,51775,2,2,1, 51777
7,51777,1,1,0, 51778
24,51779,1,1,0, 51780
7,51792,1,1,1, 51793
24,51794,1,1,1, 51795
15,51801,2,2,1, 51803
7,51807,1,1,0, 51808
24,51809,1,1,0, 51810
31,51816,2,2,1, 51818
7,51822,1,1,0, 51823
24,51824,1,1,0, 51825
8,51826,1,1,1, 51827
9,51827,2,2,1, 51829
25,51830,2,2,1, 51832
1,51831,1,1,1, 51832
15,51831,2,2,1, 51833
7,51837,1,1,1, 51838
24,51839,1,1,1, 51840
8,51841,1,1,1, 51842
25,51845,2,2,1, 51847
1,51846,1,1,1, 51847
6,51850,2,2,1, 51852
7,51852,1,1,1, 51853
8,51856,1,1,0, 51857
16,51859,2,2,1, 51861
1,51861,1,1,0, 51862
6,51865,2,2,1, 51867
7,51867,1,1,0, 51868
8,51871,1,1,1, 51872
16,51874,2,2,1, 51876
25,51875,2,2,1, 51877
1,51876,1,1,0, 51877
31,51876,2,2,1, 51878
7,51882,1,1,1, 51883
8,51886,1,1,1, 51887
25,51890,2,2,1, 51892
1,51891,1,1,0, 51892
6,51895,2,2,1, 51897
7,51897,1,1,0, 51898
8,51901,1,1,1, 51902
25,51905,2,2,1, 51907
1,51906,1,1,0, 51907
6,51910,2,2,1, 51912
7,51912,1,1,0, 51913
8,51916,1,1,0, 51917
16,51919,2,2,1, 51921
1,51921,1,1,1, 51922
6,51925,2,2,1, 51927
7,51927,1,1,0, 51928
8,51931,1,1,1, 51932
16,51934,2,2,1, 51936
1,51936,1,1,1, 51937
31,51936,2,2,1, 51938
7,51942,1,1,1, 51943
24,51944,1,1,0, 51945
8,51946,1,1,1, 51947
2,51948,2,2,1, 51950
1,51951,1,1,1, 51952
31,51951,2,2,1, 51953
7,51957,1,1,1, 51958
24,51959,1,1,0, 51960
31,51966,2,2,1, 51968
24,51974,1,1,1, 51975
24,51989,1,1,0, 51990
24,52004,1,1,1, 52005
24,52019,1,1,0, 52020
24,52034,1,1,0, 52035
31,52041,2,2,1, 52043
24,52049,1,1,1, 52050
31,52056,2,2,1, 52058
24,52064,1,1,1, 52065
8,52066,1,1,0, 52067
9,52067,2,2,1, 52069
16,52069,2,2,1, 52071
25,52070,2,2,1, 52072
1,52071,1,1,0, 52072
15,52071,2,2,1, 52073
7,52077,1,1,0, 52078
24,52079,1,1,0, 52080
8,52081,1,1,0, 52082
2,52083,2,2,1, 52085
1,52086,1,1,1, 52087
6,52090,2,2,1, 52092
7,52092,1,1,1, 52093
24,52094,1,1,1, 52095
8,52096,1,1,0, 52097
9,52097,2,2,1, 52099
2,52098,2,2,1, 52100
1,52101,1,1,0, 52102
7,52107,1,1,0, 52108
24,52109,1,1,0, 52110
8,52111,1,1,0, 52112
9,52112,2,2,1, 52114
2,52113,2,2,1, 52115
16,52114,2,2,1, 52116
25,52115,2,2,1, 52117
1,52116,1,1,1, 52117
7,52122,1,1,1, 52123
24,52124,1,1,0, 52125
8,52126,1,1,1, 52127
2,52128,2,2,1, 52130
25,52130,2,2,1, 52132
1,52131,1,1,1, 52132
6,52135,2,2,1, 52137
7,52137,1,1,1, 52138
24,52139,1,1,1, 52140
16,52144,2,2,1, 52146
25,52145,2,2,1, 52147
6,52150,2,2,1, 52152
7,52152,1,1,0, 52153
24,52154,1,1,0, 52155
25,52160,2,2,1, 52162
6,52165,2,2,1, 52167
7,52167,1,1,0, 52168
24,52169,1,1,0, 52170
25,52175,2,2,1, 52177
6,52180,2,2,1, 52182
7,52182,1,1,1, 52183
24,52184,1,1,1, 52185
16,52189,2,2,1, 52191
25,52190,2,2,1, 52192
6,52195,2,2,1, 52197
7,52197,1,1,0, 52198
24,52199,1,1,0, 52200
8,52201,1,1,0, 52202
1,52206,1,1,1, 52207
8,52216,1,1,0, 52217
1,52221,1,1,0, 52222
8,52231,1,1,1, 52232
16,52234,2,2,1, 52236
1,52236,1,1,0, 52237
8,52246,1,1,0, 52247
2,52248,2,2,1, 52250
1,52251,1,1,1, 52252
2,52263,2,2,1, 52265
1,52266,1,1,0, 52267
9,52277,2,2,1, 52279
2,52278,2,2,1, 52280
1,52281,1,1,1, 52282
2,52293,2,2,1, 52295
1,52296,1,1,1, 52297
7,52302,1,1,0, 52303
24,52304,1,1,1, 52305
2,52308,2,2,1, 52310
1,52311,1,1,1, 52312
7,52317,1,1,1, 52318
24,52319,1,1,1, 52320
25,52325,2,2,1, 52327
7,52332,1,1,0, 52333
24,52334,1,1,0, 52335
7,52347,1,1,0, 52348
24,52349,1,1,0, 52350
25,52355,2,2,1, 52357
7,52362,1,1,1, 52363
24,52364,1,1,0, 52365
8,52366,1,1,1, 52367
31,52371,2,2,1, 52373
7,52377,1,1,1, 52378
24,52379,1,1,1, 52380
8,52381,1,1,1, 52382
9,52382,2,2,1, 52384
25,52385,2,2,1, 52387
1,52386,1,1,1, 52387
7,52392,1,1,0, 52393
24,52394,1,1,1, 52395
8,52396,1,1,1, 52397
9,52397,2,2,1, 52399
1,52401,1,1,0, 52402
31,52401,2,2,1, 52403
6,52405,2,2,1, 52407
7,52407,1,1,0, 52408
24,52409,1,1,1, 52410
8,52411,1,1,0, 52412
25,52415,2,2,1, 52417
1,52416,1,1,0, 52417
7,52422,1,1,1, 52423
24,52424,1,1,1, 52425
8,52426,1,1,0, 52427
9,52427,2,2,1, 52429
16,52429,2,2,1, 52431
1,52431,1,1,0, 52432
15,52431,2,2,1, 52433
31,52431,2,2,1, 52433
6,52435,2,2,1, 52437
7,52437,1,1,0, 52438
24,52439,1,1,1, 52440
8,52441,1,1,0, 52442
1,52446,1,1,0, 52447
7,52452,1,1,0, 52453
8,52456,1,1,0, 52457
1,52461,1,1,1, 52462
7,52467,1,1,0, 52468
8,52471,1,1,1, 52472
16,52474,2,2,1, 52476
1,52476,1,1,1, 52477
7,52482,1,1,0, 52483
8,52486,1,1,1, 52487
16,52489,2,2,1, 52491
1,52491,1,1,1, 52492
7,52497,1,1,0, 52498
8,52501,1,1,1, 52502
1,52506,1,1,1, 52507
7,52512,1,1,1, 52513
8,52516,1,1,1, 52517
1,52521,1,1,1, 52522
7,52527,1,1,0, 52528
8,52531,1,1,0, 52532
1,52536,1,1,0, 52537
7,52542,1,1,1, 52543
8,52546,1,1,1, 52547
1,52551,1,1,1, 52552
15,52551,2,2,1, 52553
31,52551,2,2,1, 52553
7,52557,1,1,0, 52558
24,52559,1,1,1, 52560
25,52565,2,2,1, 52567
31,52566,2,2,1, 52568
24,52574,1,1,0, 52575
16,52579,2,2,1, 52581
25,52580,2,2,1, 52582
24,52589,1,1,0, 52590
16,52594,2,2,1, 52596
24,52604,1,1,0, 52605
25,52610,2,2,1, 52612
24,52619,1,1,0, 52620
8,52666,1,1,1, 52667
16,52669,2,2,1, 52671
25,52670,2,2,1, 52672
1,52671,1,1,1, 52672
15,52671,2,2,1, 52673
31,52671,2,2,1, 52673
7,52677,1,1,0, 52678
8,52681,1,1,1, 52682
1,52686,1,1,1, 52687
7,52692,1,1,0, 52693
8,52696,1,1,0, 52697
16,52699,2,2,1, 52701
1,52701,1,1,0, 52702
31,52701,2,2,1, 52703
6,52705,2,2,1, 52707
7,52707,1,1,0, 52708
8,52711,1,1,1, 52712
16,52714,2,2,1, 52716
1,52716,1,1,1, 52717
6,52720,2,2,1, 52722
7,52722,1,1,0, 52723
24,52724,1,1,1, 52725
8,52726,1,1,0, 52727
1,52731,1,1,0, 52732
6,52735,2,2,1, 52737
7,52737,1,1,0, 52738
24,52739,1,1,0, 52740
8,52741,1,1,0, 52742
1,52746,1,1,1, 52747
7,52752,1,1,1, 52753
24,52754,1,1,0, 52755
8,52756,1,1,1, 52757
16,52759,2,2,1, 52761
1,52761,1,1,1, 52762
7,52767,1,1,1, 52768
24,52769,1,1,1, 52770
8,52771,1,1,0, 52772
16,52774,2,2,1, 52776
1,52776,1,1,0, 52777
7,52782,1,1,0, 52783
24,52784,1,1,0, 52785
8,52786,1,1,0, 52787
25,52790,2,2,1, 52792
1,52791,1,1,0, 52792
7,52797,1,1,0, 52798
24,52799,1,1,0, 52800
25,52805,2,2,1, 52807
31,52806,2,2,1, 52808
24,52814,1,1,0, 52815
25,52820,2,2,1, 52822
24,52829,1,1,1, 52830
25,52835,2,2,1, 52837
31,52836,2,2,1, 52838
24,52844,1,1,1, 52845
25,52850,2,2,1, 52852
24,52859,1,1,0, 52860
25,52865,2,2,1, 52867
24,52874,1,1,0, 52875
31,52881,2,2,1, 52883
24,52889,1,1,0, 52890
25,52895,2,2,1, 52897
31,52896,2,2,1, 52898
7,52902,1,1,1, 52903
24,52904,1,1,0, 52905
8,52906,1,1,0, 52907
9,52907,2,2,1, 52909
25,52910,2,2,1, 52912
1,52911,1,1,0, 52912
7,52917,1,1,0, 52918
24,52919,1,1,0, 52920
8,52921,1,1,0, 52922
1,52926,1,1,1, 52927
31,52926,2,2,1, 52928
6,52930,2,2,1, 52932
8,52936,1,1,1, 52937
9,52937,2,2,1, 52939
16,52939,2,2,1, 52941
1,52941,1,1,1, 52942
8,52951,1,1,0, 52952
9,52952,2,2,1, 52954
16,52954,2,2,1, 52956
1,52956,1,1,1, 52957
8,52966,1,1,1, 52967
9,52967,2,2,1, 52969
16,52969,2,2,1, 52971
1,52971,1,1,0, 52972
1,52986,1,1,0, 52987
1,53001,1,1,0, 53002
1,53016,1,1,0, 53017
24,53024,1,1,1, 53025
2,53028,2,2,1, 53030
16,53029,2,2,1, 53031
25,53030,2,2,1, 53032
1,53031,1,1,1, 53032
7,53037,1,1,0, 53038
24,53039,1,1,1, 53040
8,53041,1,1,1, 53042
2,53043,2,2,1, 53045
16,53044,2,2,1, 53046
25,53045,2,2,1, 53047
1,53046,1,1,0, 53047
6,53050,2,2,1, 53052
7,53052,1,1,0, 53053
8,53056,1,1,1, 53057
31,53061,2,2,1, 53063
7,53067,1,1,1, 53068
8,53071,1,1,1, 53072
16,53074,2,2,1, 53076
15,53076,2,2,1, 53078
31,53076,2,2,1, 53078
7,53082,1,1,0, 53083
8,53086,1,1,0, 53087
31,53091,2,2,1, 53093
7,53097,1,1,0, 53098
25,53105,2,2,1, 53107
1,53106,1,1,1, 53107
31,53151,2,2,1, 53153
24,53159,1,1,0, 53160
24,53174,1,1,1, 53175
31,53181,2,2,1, 53183
24,53189,1,1,0, 53190
31,53196,2,2,1, 53198
7,53202,1,1,1, 53203
24,53204,1,1,0, 53205
8,53206,1,1,0, 53207
15,53211,2,2,1, 53213
7,53217,1,1,0, 53218
24,53219,1,1,0, 53220
8,53221,1,1,1, 53222
1,53226,1,1,0, 53227
15,53226,2,2,1, 53228
6,53230,2,2,1, 53232
7,53232,1,1,1, 53233
24,53234,1,1,0, 53235
8,53236,1,1,1, 53237
1,53241,1,1,0, 53242
15,53241,2,2,1, 53243
31,53241,2,2,1, 53243
6,53245,2,2,1, 53247
7,53247,1,1,1, 53248
24,53249,1,1,0, 53250
8,53251,1,1,0, 53252
1,53256,1,1,0, 53257
15,53256,2,2,1, 53258
6,53260,2,2,1, 53262
7,53262,1,1,1, 53263
24,53264,1,1,0, 53265
8,53266,1,1,1, 53267
1,53271,1,1,0, 53272
31,53271,2,2,1, 53273
7,53277,1,1,0, 53278
24,53279,1,1,1, 53280
1,53286,1,1,0, 53287
7,53292,1,1,1, 53293
1,53301,1,1,1, 53302
31,53301,2,2,1, 53303
7,53307,1,1,0, 53308
1,53316,1,1,1, 53317
7,53322,1,1,0, 53323
2,53328,2,2,1, 53330
1,53331,1,1,1, 53332
7,53337,1,1,0, 53338
8,53341,1,1,0, 53342
9,53342,2,2,1, 53344
7,53352,1,1,1, 53353
24,53354,1,1,1, 53355
8,53356,1,1,1, 53357
9,53357,2,2,1, 53359
7,53367,1,1,1, 53368
24,53369,1,1,1, 53370
8,53371,1,1,0, 53372
7,53382,1,1,0, 53383
24,53384,1,1,1, 53385
8,53386,1,1,1, 53387
16,53389,2,2,1, 53391
31,53391,2,2,1, 53393
6,53395,2,2,1, 53397
7,53397,1,1,0, 53398
24,53399,1,1,1, 53400
16,53404,2,2,1, 53406
24,53414,1,1,0, 53415
16,53419,2,2,1, 53421
24,53429,1,1,1, 53430
24,53444,1,1,1, 53445
9,53447,2,2,1, 53449
16,53449,2,2,1, 53451
1,53451,1,1,1, 53452
24,53459,1,1,1, 53460
9,53462,2,2,1, 53464
25,53465,2,2,1, 53467
1,53466,1,1,0, 53467
9,53477,2,2,1, 53479
2,53478,2,2,1, 53480
25,53480,2,2,1, 53482
1,53481,1,1,0, 53482
25,53495,2,2,1, 53497
1,53496,1,1,1, 53497
8,53506,1,1,0, 53507
9,53507,2,2,1, 53509
1,53511,1,1,1, 53512
15,53511,2,2,1, 53513
7,53517,1,1,1, 53518
8,53521,1,1,0, 53522
16,53524,2,2,1, 53526
7,53532,1,1,0, 53533
8,53536,1,1,0, 53537
31,53541,2,2,1, 53543
7,53547,1,1,1, 53548
8,53551,1,1,0, 53552
16,53554,2,2,1, 53556
7,53562,1,1,1, 53563
8,53566,1,1,0, 53567
31,53571,2,2,1, 53573
7,53577,1,1,0, 53578
8,53581,1,1,0, 53582
2,53583,2,2,1, 53585
16,53584,2,2,1, 53586
1,53586,1,1,1, 53587
31,53586,2,2,1, 53588
7,53592,1,1,1, 53593
8,53596,1,1,0, 53597
2,53598,2,2,1, 53600
25,53600,2,2,1, 53602
1,53601,1,1,1, 53602
7,53607,1,1,0, 53608
8,53611,1,1,1, 53612
2,53613,2,2,1, 53615
16,53614,2,2,1, 53616
1,53616,1,1,0, 53617
31,53616,2,2,1, 53618
6,53620,2,2,1, 53622
7,53622,1,1,0, 53623
24,53624,1,1,0, 53625
8,53626,1,1,0, 53627
9,53627,2,2,1, 53629
2,53628,2,2,1, 53630
16,53629,2,2,1, 53631
25,53630,2,2,1, 53632
1,53631,1,1,0, 53632
31,53631,2,2,1, 53633
7,53637,1,1,1, 53638
24,53639,1,1,1, 53640
24,53654,1,1,1, 53655
31,53661,2,2,1, 53663
24,53669,1,1,1, 53670
16,53674,2,2,1, 53676
31,53676,2,2,1, 53678
24,53684,1,1,0, 53685
16,53689,2,2,1, 53691
24,53699,1,1,0, 53700
16,53704,2,2,1, 53706
31,53706,2,2,1, 53708
24,53714,1,1,1, 53715
31,53721,2,2,1, 53723
24,53729,1,1,0, 53730
16,53734,2,2,1, 53736
31,53736,2,2,1, 53738
24,53744,1,1,0, 53745
8,53746,1,1,1, 53747
9,53747,2,2,1, 53749
16,53749,2,2,1, 53751
1,53751,1,1,1, 53752
15,53751,2,2,1, 53753
31,53751,2,2,1, 53753
7,53757,1,1,0, 53758
24,53759,1,1,1, 53760
8,53761,1,1,0, 53762
25,53765,2,2,1, 53767
7,53772,1,1,1, 53773
8,53776,1,1,1, 53777
7,53787,1,1,1, 53788
8,53791,1,1,0, 53792
31,53796,2,2,1, 53798
7,53802,1,1,1, 53803
8,53806,1,1,0, 53807
31,53811,2,2,1, 53813
7,53817,1,1,1, 53818
8,53821,1,1,1, 53822
7,53832,1,1,1, 53833
8,53836,1,1,1, 53837
7,53847,1,1,0, 53848
8,53851,1,1,1, 53852
7,53862,1,1,0, 53863
24,53864,1,1,1, 53865
8,53866,1,1,1, 53867
1,53871,1,1,1, 53872
15,53871,2,2,1, 53873
31,53871,2,2,1, 53873
7,53877,1,1,1, 53878
24,53879,1,1,0, 53880
16,53884,2,2,1, 53886
1,53886,1,1,0, 53887
24,53894,1,1,1, 53895
16,53899,2,2,1, 53901
1,53901,1,1,1, 53902
24,53909,1,1,0, 53910
16,53914,2,2,1, 53916
1,53916,1,1,0, 53917
31,53916,2,2,1, 53918
24,53924,1,1,0, 53925
1,53931,1,1,1, 53932
24,53939,1,1,0, 53940
9,53942,2,2,1, 53944
25,53945,2,2,1, 53947
1,53946,1,1,1, 53947
25,53960,2,2,1, 53962
1,53961,1,1,1, 53962
1,53976,1,1,0, 53977
8,53986,1,1,1, 53987
9,53987,2,2,1, 53989
1,53991,1,1,0, 53992
15,53991,2,2,1, 53993
6,53995,2,2,1, 53997
7,53997,1,1,0, 53998
8,54001,1,1,1, 54002
2,54003,2,2,1, 54005
16,54004,2,2,1, 54006
1,54006,1,1,1, 54007
7,54012,1,1,0, 54013
24,54014,1,1,1, 54015
8,54016,1,1,1, 54017
1,54021,1,1,1, 54022
7,54027,1,1,1, 54028
24,54029,1,1,1, 54030
8,54031,1,1,1, 54032
16,54034,2,2,1, 54036
1,54036,1,1,1, 54037
7,54042,1,1,1, 54043
24,54044,1,1,1, 54045
8,54046,1,1,1, 54047
16,54049,2,2,1, 54051
1,54051,1,1,1, 54052
6,54055,2,2,1, 54057
7,54057,1,1,0, 54058
24,54059,1,1,0, 54060
8,54061,1,1,1, 54062
1,54066,1,1,1, 54067
7,54072,1,1,1, 54073
24,54074,1,1,0, 54075
8,54076,1,1,0, 54077
16,54079,2,2,1, 54081
1,54081,1,1,0, 54082
6,54085,2,2,1, 54087
7,54087,1,1,1, 54088
24,54089,1,1,1, 54090
8,54091,1,1,0, 54092
16,54094,2,2,1, 54096
1,54096,1,1,1, 54097
7,54102,1,1,1, 54103
24,54104,1,1,0, 54105
8,54106,1,1,1, 54107
9,54107,2,2,1, 54109
1,54111,1,1,1, 54112
6,54115,2,2,1, 54117
7,54117,1,1,1, 54118
24,54119,1,1,1, 54120
31,54126,2,2,1, 54128
7,54132,1,1,1, 54133
24,54134,1,1,0, 54135
7,54147,1,1,1, 54148
24,54149,1,1,1, 54150
7,54162,1,1,0, 54163
24,54164,1,1,0, 54165
7,54177,1,1,0, 54178
24,54179,1,1,1, 54180
7,54192,1,1,0, 54193
24,54194,1,1,1, 54195
31,54201,2,2,1, 54203
7,54207,1,1,1, 54208
24,54209,1,1,1, 54210
31,54216,2,2,1, 54218
7,54222,1,1,0, 54223
24,54224,1,1,0, 54225
8,54226,1,1,0, 54227
16,54229,2,2,1, 54231
1,54231,1,1,1, 54232
15,54231,2,2,1, 54233
7,54237,1,1,0, 54238
24,54239,1,1,1, 54240
8,54241,1,1,0, 54242
16,54244,2,2,1, 54246
1,54246,1,1,1, 54247
24,54254,1,1,1, 54255
8,54256,1,1,1, 54257
16,54259,2,2,1, 54261
25,54260,2,2,1, 54262
1,54261,1,1,0, 54262
24,54269,1,1,0, 54270
8,54271,1,1,1, 54272
16,54274,2,2,1, 54276
1,54276,1,1,0, 54277
24,54284,1,1,1, 54285
8,54286,1,1,1, 54287
1,54291,1,1,1, 54292
31,54291,2,2,1, 54293
24,54299,1,1,1, 54300
8,54301,1,1,0, 54302
1,54306,1,1,1, 54307
8,54316,1,1,0, 54317
1,54321,1,1,1, 54322
8,54331,1,1,1, 54332
1,54336,1,1,0, 54337
8,54346,1,1,1, 54347
16,54349,2,2,1, 54351
1,54351,1,1,0, 54352
15,54351,2,2,1, 54353
7,54357,1,1,1, 54358
8,54361,1,1,0, 54362
9,54362,2,2,1, 54364
16,54364,2,2,1, 54366
25,54365,2,2,1, 54367
1,54366,1,1,0, 54367
7,54372,1,1,0, 54373
9,54377,2,2,1, 54379
1,54381,1,1,0, 54382
31,54381,2,2,1, 54383
7,54387,1,1,1, 54388
9,54392,2,2,1, 54394
1,54396,1,1,1, 54397
31,54396,2,2,1, 54398
6,54400,2,2,1, 54402
7,54402,1,1,0, 54403
24,54404,1,1,1, 54405
9,54407,2,2,1, 54409
16,54409,2,2,1, 54411
1,54411,1,1,1, 54412
31,54411,2,2,1, 54413
7,54417,1,1,1, 54418
24,54419,1,1,1, 54420
9,54422,2,2,1, 54424
16,54424,2,2,1, 54426
1,54426,1,1,0, 54427
24,54434,1,1,1, 54435
25,54440,2,2,1, 54442
1,54441,1,1,1, 54442
24,54449,1,1,0, 54450
16,54454,2,2,1, 54456
1,54456,1,1,0, 54457
24,54464,1,1,1, 54465
2,54468,2,2,1, 54470
25,54470,2,2,1, 54472
1,54471,1,1,1, 54472
15,54471,2,2,1, 54473
31,54471,2,2,1, 54473
24,54479,1,1,1, 54480
8,54481,1,1,0, 54482
31,54486,2,2,1, 54488
7,54492,1,1,0, 54493
8,54496,1,1,0, 54497
6,54505,2,2,1, 54507
7,54507,1,1,1, 54508
8,54511,1,1,0, 54512
31,54516,2,2,1, 54518
7,54522,1,1,1, 54523
8,54526,1,1,0, 54527
7,54537,1,1,0, 54538
8,54541,1,1,1, 54542
8,54556,1,1,1, 54557
8,54571,1,1,0, 54572
24,54584,1,1,1, 54585
8,54586,1,1,1, 54587
1,54591,1,1,1, 54592
24,54599,1,1,0, 54600
8,54601,1,1,1, 54602
1,54606,1,1,0, 54607
15,54606,2,2,1, 54608
7,54612,1,1,0, 54613
24,54614,1,1,0, 54615
8,54616,1,1,0, 54617
16,54619,2,2,1, 54621
1,54621,1,1,0, 54622
15,54621,2,2,1, 54623
31,54621,2,2,1, 54623
6,54625,2,2,1, 54627
7,54627,1,1,0, 54628
24,54629,1,1,0, 54630
8,54631,1,1,1, 54632
16,54634,2,2,1, 54636
1,54636,1,1,1, 54637
7,54642,1,1,1, 54643
24,54644,1,1,0, 54645
8,54646,1,1,1, 54647
16,54649,2,2,1, 54651
1,54651,1,1,0, 54652
7,54657,1,1,1, 54658
24,54659,1,1,1, 54660
8,54661,1,1,0, 54662
1,54666,1,1,0, 54667
7,54672,1,1,1, 54673
8,54676,1,1,0, 54677
1,54681,1,1,0, 54682
31,54681,2,2,1, 54683
7,54687,1,1,1, 54688
8,54691,1,1,1, 54692
16,54694,2,2,1, 54696
1,54696,1,1,0, 54697
7,54702,1,1,0, 54703
8,54706,1,1,0, 54707
9,54707,2,2,1, 54709
2,54708,2,2,1, 54710
1,54711,1,1,1, 54712
31,54711,2,2,1, 54713
7,54717,1,1,1, 54718
6,54730,2,2,1, 54732
7,54732,1,1,1, 54733
8,54781,1,1,0, 54782
24,54794,1,1,1, 54795
8,54796,1,1,1, 54797
9,54797,2,2,1, 54799
24,54809,1,1,1, 54810
8,54811,1,1,0, 54812
9,54812,2,2,1, 54814
16,54814,2,2,1, 54816
24,54824,1,1,1, 54825
8,54826,1,1,1, 54827
9,54827,2,2,1, 54829
1,54831,1,1,1, 54832
31,54831,2,2,1, 54833
24,54839,1,1,1, 54840
1,54846,1,1,0, 54847
31,54846,2,2,1, 54848
7,54852,1,1,0, 54853
24,54854,1,1,1, 54855
25,54860,2,2,1, 54862
1,54861,1,1,0, 54862
6,54865,2,2,1, 54867
7,54867,1,1,1, 54868
24,54869,1,1,0, 54870
1,54876,1,1,0, 54877
31,54876,2,2,1, 54878
7,54882,1,1,1, 54883
24,54884,1,1,1, 54885
1,54891,1,1,1, 54892
31,54891,2,2,1, 54893
6,54895,2,2,1, 54897
7,54897,1,1,0, 54898
24,54899,1,1,1, 54900
8,54901,1,1,0, 54902
16,54904,2,2,1, 54906
1,54906,1,1,0, 54907
31,54906,2,2,1, 54908
6,54910,2,2,1, 54912
7,54912,1,1,1, 54913
8,54916,1,1,0, 54917
1,54921,1,1,0, 54922
6,54925,2,2,1, 54927
7,54927,1,1,1, 54928
8,54931,1,1,0, 54932
16,54934,2,2,1, 54936
1,54936,1,1,0, 54937
6,54940,2,2,1, 54942
7,54942,1,1,0, 54943
8,54946,1,1,0, 54947
9,54947,2,2,1, 54949
16,54949,2,2,1, 54951
1,54951,1,1,1, 54952
15,54951,2,2,1, 54953
6,54955,2,2,1, 54957
7,54957,1,1,1, 54958
1,54966,1,1,0, 54967
1,54981,1,1,1, 54982
9,54992,2,2,1, 54994
1,54996,1,1,0, 54997
1,55011,1,1,1, 55012
1,55026,1,1,0, 55027
1,55041,1,1,0, 55042
9,55052,2,2,1, 55054
1,55056,1,1,1, 55057
7,55062,1,1,0, 55063
24,55064,1,1,1, 55065
9,55067,2,2,1, 55069
25,55070,2,2,1, 55072
1,55071,1,1,0, 55072
15,55071,2,2,1, 55073
31,55071,2,2,1, 55073
7,55077,1,1,0, 55078
24,55079,1,1,0, 55080
8,55081,1,1,1, 55082
6,55090,2,2,1, 55092
7,55092,1,1,0, 55093
24,55094,1,1,0, 55095
8,55096,1,1,1, 55097
31,55101,2,2,1, 55103
6,55105,2,2,1, 55107
7,55107,1,1,0, 55108
24,55109,1,1,0, 55110
8,55111,1,1,0, 55112
9,55112,2,2,1, 55114
31,55116,2,2,1, 55118
6,55120,2,2,1, 55122
7,55122,1,1,0, 55123
24,55124,1,1,1, 55125
8,55126,1,1,1, 55127
16,55129,2,2,1, 55131
7,55137,1,1,1, 55138
24,55139,1,1,1, 55140
1,55146,1,1,0, 55147
7,55152,1,1,1, 55153
1,55161,1,1,0, 55162
7,55167,1,1,0, 55168
1,55176,1,1,1, 55177
7,55182,1,1,1, 55183
1,55191,1,1,0, 55192
31,55191,2,2,1, 55193
7,55197,1,1,1, 55198
1,55206,1,1,1, 55207
31,55206,2,2,1, 55208
7,55212,1,1,1, 55213
1,55221,1,1,0, 55222
31,55221,2,2,1, 55223
7,55227,1,1,1, 55228
1,55236,1,1,0, 55237
7,55242,1,1,0, 55243
24,55244,1,1,1, 55245
8,55246,1,1,0, 55247
9,55247,2,2,1, 55249
16,55249,2,2,1, 55251
1,55251,1,1,1, 55252
6,55255,2,2,1, 55257
7,55257,1,1,1, 55258
24,55259,1,1,0, 55260
8,55261,1,1,1, 55262
9,55262,2,2,1, 55264
1,55266,1,1,1, 55267
24,55274,1,1,1, 55275
1,55281,1,1,0, 55282
31,55281,2,2,1, 55283
24,55289,1,1,1, 55290
9,55292,2,2,1, 55294
1,55296,1,1,1, 55297
24,55304,1,1,1, 55305
2,55308,2,2,1, 55310
1,55311,1,1,0, 55312
24,55319,1,1,1, 55320
24,55334,1,1,1, 55335
24,55349,1,1,0, 55350
31,55356,2,2,1, 55358
7,55362,1,1,0, 55363
24,55364,1,1,1, 55365
16,55369,2,2,1, 55371
31,55371,2,2,1, 55373
7,55377,1,1,0, 55378
24,55379,1,1,1, 55380
8,55381,1,1,0, 55382
1,55386,1,1,0, 55387
31,55386,2,2,1, 55388
7,55392,1,1,0, 55393
8,55396,1,1,1, 55397
25,55400,2,2,1, 55402
1,55401,1,1,0, 55402
7,55407,1,1,1, 55408
8,55411,1,1,1, 55412
1,55416,1,1,1, 55417
31,55416,2,2,1, 55418
7,55422,1,1,1, 55423
8,55426,1,1,0, 55427
9,55427,2,2,1, 55429
2,55428,2,2,1, 55430
25,55430,2,2,1, 55432
1,55431,1,1,0, 55432
31,55431,2,2,1, 55433
7,55437,1,1,0, 55438
8,55441,1,1,0, 55442
31,55446,2,2,1, 55448
6,55450,2,2,1, 55452
7,55452,1,1,1, 55453
8,55456,1,1,1, 55457
9,55457,2,2,1, 55459
6,55465,2,2,1, 55467
7,55467,1,1,0, 55468
8,55471,1,1,0, 55472
6,55480,2,2,1, 55482
7,55482,1,1,0, 55483
8,55486,1,1,0, 55487
9,55487,2,2,1, 55489
16,55489,2,2,1, 55491
15,55491,2,2,1, 55493
7,55497,1,1,1, 55498
24,55499,1,1,0, 55500
8,55501,1,1,1, 55502
24,55514,1,1,1, 55515
8,55516,1,1,0, 55517
31,55521,2,2,1, 55523
24,55529,1,1,1, 55530
8,55531,1,1,0, 55532
9,55532,2,2,1, 55534
31,55536,2,2,1, 55538
24,55544,1,1,0, 55545
8,55546,1,1,0, 55547
9,55547,2,2,1, 55549
1,55551,1,1,0, 55552
15,55551,2,2,1, 55553
24,55559,1,1,1, 55560
24,55574,1,1,1, 55575
24,55589,1,1,0, 55590
24,55604,1,1,0, 55605
15,55611,2,2,1, 55613
7,55617,1,1,1, 55618
24,55619,1,1,1, 55620
7,55632,1,1,0, 55633
24,55634,1,1,0, 55635
7,55647,1,1,0, 55648
24,55649,1,1,1, 55650
7,55662,1,1,0, 55663
24,55664,1,1,1, 55665
16,55669,2,2,1, 55671
25,55670,2,2,1, 55672
1,55671,1,1,0, 55672
31,55671,2,2,1, 55673
7,55677,1,1,0, 55678
24,55679,1,1,0, 55680
8,55681,1,1,0, 55682
16,55684,2,2,1, 55686
25,55685,2,2,1, 55687
1,55686,1,1,1, 55687
6,55690,2,2,1, 55692
7,55692,1,1,1, 55693
8,55696,1,1,1, 55697
16,55699,2,2,1, 55701
1,55701,1,1,0, 55702
15,55701,2,2,1, 55703
31,55701,2,2,1, 55703
7,55707,1,1,0, 55708
8,55711,1,1,1, 55712
16,55714,2,2,1, 55716
1,55716,1,1,1, 55717
15,55716,2,2,1, 55718
6,55720,2,2,1, 55722
7,55722,1,1,1, 55723
8,55726,1,1,1, 55727
1,55731,1,1,0, 55732
6,55735,2,2,1, 55737
7,55737,1,1,0, 55738
8,55741,1,1,1, 55742
25,55745,2,2,1, 55747
1,55746,1,1,0, 55747
6,55750,2,2,1, 55752
7,55752,1,1,0, 55753
8,55756,1,1,1, 55757
16,55759,2,2,1, 55761
25,55760,2,2,1, 55762
1,55761,1,1,1, 55762
7,55767,1,1,0, 55768
8,55771,1,1,0, 55772
16,55774,2,2,1, 55776
25,55775,2,2,1, 55777
1,55776,1,1,1, 55777
7,55782,1,1,1, 55783
8,55786,1,1,1, 55787
9,55787,2,2,1, 55789
16,55789,2,2,1, 55791
1,55791,1,1,0, 55792
7,55797,1,1,0, 55798
24,55799,1,1,1, 55800
24,55814,1,1,0, 55815
31,55821,2,2,1, 55823
24,55829,1,1,1, 55830
24,55844,1,1,1, 55845
24,55859,1,1,0, 55860
31,55866,2,2,1, 55868
24,55874,1,1,0, 55875
31,55881,2,2,1, 55883
24,55889,1,1,1, 55890
24,55904,1,1,1, 55905
9,55907,2,2,1, 55909
16,55909,2,2,1, 55911
25,55910,2,2,1, 55912
1,55911,1,1,1, 55912
15,55911,2,2,1, 55913
31,55911,2,2,1, 55913
7,55917,1,1,1, 55918
24,55919,1,1,0, 55920
8,55921,1,1,0, 55922
2,55923,2,2,1, 55925
1,55926,1,1,1, 55927
6,55930,2,2,1, 55932
7,55932,1,1,0, 55933
8,55936,1,1,0, 55937
16,55939,2,2,1, 55941
1,55941,1,1,0, 55942
6,55945,2,2,1, 55947
7,55947,1,1,0, 55948
8,55951,1,1,0, 55952
16,55954,2,2,1, 55956
25,55955,2,2,1, 55957
1,55956,1,1,1, 55957
7,55962,1,1,1, 55963
8,55966,1,1,0, 55967
16,55969,2,2,1, 55971
1,55971,1,1,1, 55972
6,55975,2,2,1, 55977
7,55977,1,1,0, 55978
8,55981,1,1,1, 55982
16,55984,2,2,1, 55986
25,55985,2,2,1, 55987
1,55986,1,1,0, 55987
31,55986,2,2,1, 55988
6,55990,2,2,1, 55992
7,55992,1,1,0, 55993
8,55996,1,1,1, 55997
2,55998,2,2,1, 56000
16,55999,2,2,1, 56001
25,56000,2,2,1, 56002
1,56001,1,1,0, 56002
6,56005,2,2,1, 56007
7,56007,1,1,0, 56008
8,56011,1,1,1, 56012
1,56016,1,1,0, 56017
7,56022,1,1,1, 56023
8,56026,1,1,1, 56027
9,56027,2,2,1, 56029
16,56029,2,2,1, 56031
25,56030,2,2,1, 56032
1,56031,1,1,1, 56032
6,56035,2,2,1, 56037
7,56037,1,1,1, 56038
24,56039,1,1,1, 56040
16,56044,2,2,1, 56046
24,56054,1,1,0, 56055
16,56059,2,2,1, 56061
24,56069,1,1,0, 56070
16,56074,2,2,1, 56076
31,56076,2,2,1, 56078
24,56084,1,1,0, 56085
31,56091,2,2,1, 56093
24,56099,1,1,0, 56100
24,56114,1,1,0, 56115
31,56121,2,2,1, 56123
24,56129,1,1,1, 56130
31,56136,2,2,1, 56138
7,56142,1,1,0, 56143
24,56144,1,1,0, 56145
8,56146,1,1,1, 56147
9,56147,2,2,1, 56149
1,56151,1,1,0, 56152
31,56151,2,2,1, 56153
7,56157,1,1,0, 56158
24,56159,1,1,0, 56160
8,56161,1,1,0, 56162
2,56163,2,2,1, 56165
16,56164,2,2,1, 56166
1,56166,1,1,1, 56167
7,56172,1,1,1, 56173
8,56176,1,1,1, 56177
2,56178,2,2,1, 56180
16,56179,2,2,1, 56181
25,56180,2,2,1, 56182
1,56181,1,1,0, 56182
6,56185,2,2,1, 56187
7,56187,1,1,1, 56188
8,56191,1,1,1, 56192
2,56193,2,2,1, 56195
25,56195,2,2,1, 56197
1,56196,1,1,1, 56197
31,56196,2,2,1, 56198
6,56200,2,2,1, 56202
7,56202,1,1,0, 56203
8,56206,1,1,1, 56207
9,56207,2,2,1, 56209
25,56210,2,2,1, 56212
1,56211,1,1,0, 56212
31,56211,2,2,1, 56213
6,56215,2,2,1, 56217
7,56217,1,1,0, 56218
8,56221,1,1,0, 56222
16,56224,2,2,1, 56226
8,56236,1,1,0, 56237
8,56251,1,1,1, 56252
24,56264,1,1,0, 56265
8,56266,1,1,1, 56267
25,56270,2,2,1, 56272
31,56271,2,2,1, 56273
24,56279,1,1,0, 56280
8,56281,1,1,0, 56282
25,56285,2,2,1, 56287
31,56286,2,2,1, 56288
7,56292,1,1,1, 56293
24,56294,1,1,1, 56295
8,56296,1,1,1, 56297
31,56301,2,2,1, 56303
6,56305,2,2,1, 56307
7,56307,1,1,1, 56308
24,56309,1,1,0, 56310
8,56311,1,1,0, 56312
25,56315,2,2,1, 56317
7,56322,1,1,1, 56323
24,56324,1,1,1, 56325
8,56326,1,1,0, 56327
25,56330,2,2,1, 56332
1,56331,1,1,1, 56332
31,56331,2,2,1, 56333
7,56337,1,1,0, 56338
24,56339,1,1,1, 56340
1,56346,1,1,0, 56347
31,56346,2,2,1, 56348
7,56352,1,1,0, 56353
1,56361,1,1,1, 56362
31,56361,2,2,1, 56363
7,56367,1,1,0, 56368
1,56376,1,1,0, 56377
7,56382,1,1,0, 56383
1,56391,1,1,1, 56392
31,56391,2,2,1, 56393
7,56397,1,1,0, 56398
9,56402,2,2,1, 56404
2,56403,2,2,1, 56405
1,56406,1,1,1, 56407
9,56417,2,2,1, 56419
1,56421,1,1,0, 56422
1,56436,1,1,1, 56437
16,56449,2,2,1, 56451
25,56450,2,2,1, 56452
1,56451,1,1,0, 56452
24,56459,1,1,0, 56460
1,56466,1,1,0, 56467
31,56466,2,2,1, 56468
24,56474,1,1,1, 56475
1,56481,1,1,1, 56482
31,56481,2,2,1, 56483
24,56489,1,1,1, 56490
1,56496,1,1,0, 56497
31,56496,2,2,1, 56498
24,56504,1,1,0, 56505
8,56506,1,1,1, 56507
1,56511,1,1,1, 56512
31,56511,2,2,1, 56513
7,56517,1,1,1, 56518
24,56519,1,1,0, 56520
8,56521,1,1,0, 56522
1,56526,1,1,0, 56527
31,56526,2,2,1, 56528
6,56530,2,2,1, 56532
7,56532,1,1,1, 56533
8,56536,1,1,0, 56537
1,56541,1,1,0, 56542
6,56545,2,2,1, 56547
7,56547,1,1,0, 56548
8,56551,1,1,0, 56552
1,56556,1,1,1, 56557
31,56556,2,2,1, 56558
7,56562,1,1,1, 56563
8,56566,1,1,0, 56567
1,56571,1,1,0, 56572
31,56571,2,2,1, 56573
7,56577,1,1,1, 56578
8,56581,1,1,0, 56582
9,56582,2,2,1, 56584
7,56592,1,1,0, 56593
8,56596,1,1,1, 56597
9,56597,2,2,1, 56599
7,56607,1,1,0, 56608
8,56611,1,1,0, 56612
6,56620,2,2,1, 56622
7,56622,1,1,1, 56623
8,56626,1,1,0, 56627
9,56627,2,2,1, 56629
6,56635,2,2,1, 56637
7,56637,1,1,0, 56638
8,56641,1,1,1, 56642
16,56644,2,2,1, 56646
8,56656,1,1,0, 56657
8,56671,1,1,1, 56672
24,56684,1,1,0, 56685
8,56686,1,1,0, 56687
2,56688,2,2,1, 56690
1,56691,1,1,1, 56692
24,56699,1,1,0, 56700
8,56701,1,1,1, 56702
16,56704,2,2,1, 56706
25,56705,2,2,1, 56707
1,56706,1,1,0, 56707
6,56710,2,2,1, 56712
7,56712,1,1,1, 56713
24,56714,1,1,0, 56715
25,56720,2,2,1, 56722
1,56721,1,1,1, 56722
31,56721,2,2,1, 56723
7,56727,1,1,0, 56728
24,56729,1,1,0, 56730
16,56734,2,2,1, 56736
25,56735,2,2,1, 56737
1,56736,1,1,0, 56737
15,56736,2,2,1, 56738
7,56742,1,1,1, 56743
24,56744,1,1,1, 56745
25,56750,2,2,1, 56752
1,56751,1,1,1, 56752
7,56757,1,1,0, 56758
24,56759,1,1,0, 56760
8,56761,1,1,1, 56762
1,56766,1,1,0, 56767
31,56766,2,2,1, 56768
7,56772,1,1,0, 56773
8,56776,1,1,0, 56777
1,56781,1,1,0, 56782
7,56787,1,1,1, 56788
8,56791,1,1,1, 56792
1,56796,1,1,0, 56797
7,56802,1,1,0, 56803
8,56806,1,1,1, 56807
9,56807,2,2,1, 56809
1,56811,1,1,1, 56812
31,56811,2,2,1, 56813
7,56817,1,1,1, 56818
8,56821,1,1,1, 56822
25,56825,2,2,1, 56827
1,56826,1,1,1, 56827
31,56826,2,2,1, 56828
7,56832,1,1,1, 56833
24,56834,1,1,1, 56835
8,56836,1,1,1, 56837
25,56840,2,2,1, 56842
1,56841,1,1,0, 56842
15,56841,2,2,1, 56843
7,56847,1,1,1, 56848
24,56849,1,1,0, 56850
8,56851,1,1,0, 56852
25,56855,2,2,1, 56857
1,56856,1,1,1, 56857
7,56862,1,1,1, 56863
24,56864,1,1,0, 56865
8,56866,1,1,0, 56867
1,56871,1,1,0, 56872
31,56871,2,2,1, 56873
6,56875,2,2,1, 56877
7,56877,1,1,1, 56878
24,56879,1,1,1, 56880
8,56881,1,1,0, 56882
1,56886,1,1,0, 56887
8,56896,1,1,0, 56897
16,56899,2,2,1, 56901
1,56901,1,1,1, 56902
8,56911,1,1,0, 56912
1,56916,1,1,0, 56917
8,56926,1,1,0, 56927
2,56928,2,2,1, 56930
1,56931,1,1,1, 56932
8,56941,1,1,1, 56942
16,56944,2,2,1, 56946
8,56956,1,1,1, 56957
9,56957,2,2,1, 56959
16,56959,2,2,1, 56961
8,56971,1,1,0, 56972
9,56972,2,2,1, 56974
7,56982,1,1,1, 56983
24,56984,1,1,0, 56985
8,56986,1,1,0, 56987
7,56997,1,1,0, 56998
24,56999,1,1,1, 57000
16,57004,2,2,1, 57006
31,57006,2,2,1, 57008
7,57012,1,1,1, 57013
24,57014,1,1,1, 57015
15,57021,2,2,1, 57023
7,57027,1,1,0, 57028
24,57029,1,1,0, 57030
15,57036,2,2,1, 57038
6,57040,2,2,1, 57042
7,57042,1,1,0, 57043
24,57044,1,1,0, 57045
25,57050,2,2,1, 57052
1,57051,1,1,1, 57052
6,57055,2,2,1, 57057
7,57057,1,1,0, 57058
24,57059,1,1,1, 57060
9,57062,2,2,1, 57064
1,57066,1,1,0, 57067
24,57074,1,1,0, 57075
16,57079,2,2,1, 57081
1,57081,1,1,1, 57082
24,57089,1,1,1, 57090
9,57092,2,2,1, 57094
16,57094,2,2,1, 57096
1,57096,1,1,1, 57097
24,57104,1,1,0, 57105
8,57106,1,1,1, 57107
9,57107,2,2,1, 57109
1,57111,1,1,0, 57112
24,57119,1,1,0, 57120
8,57121,1,1,0, 57122
1,57126,1,1,0, 57127
24,57134,1,1,0, 57135
8,57136,1,1,1, 57137
16,57139,2,2,1, 57141
1,57141,1,1,1, 57142
24,57149,1,1,0, 57150
8,57151,1,1,1, 57152
16,57154,2,2,1, 57156
1,57156,1,1,1, 57157
31,57156,2,2,1, 57158
7,57162,1,1,1, 57163
24,57164,1,1,0, 57165
8,57166,1,1,0, 57167
25,57170,2,2,1, 57172
1,57171,1,1,1, 57172
7,57177,1,1,0, 57178
24,57179,1,1,0, 57180
8,57181,1,1,0, 57182
9,57182,2,2,1, 57184
25,57185,2,2,1, 57187
1,57186,1,1,0, 57187
31,57186,2,2,1, 57188
6,57190,2,2,1, 57192
7,57192,1,1,1, 57193
8,57196,1,1,1, 57197
16,57199,2,2,1, 57201
25,57200,2,2,1, 57202
1,57201,1,1,1, 57202
31,57201,2,2,1, 57203
7,57207,1,1,1, 57208
8,57211,1,1,1, 57212
16,57214,2,2,1, 57216
1,57216,1,1,1, 57217
31,57216,2,2,1, 57218
7,57222,1,1,0, 57223
8,57226,1,1,1, 57227
9,57227,2,2,1, 57229
16,57229,2,2,1, 57231
1,57231,1,1,0, 57232
15,57231,2,2,1, 57233
31,57231,2,2,1, 57233
6,57235,2,2,1, 57237
7,57237,1,1,1, 57238
8,57241,1,1,1, 57242
8,57256,1,1,0, 57257
15,57261,2,2,1, 57263
8,57271,1,1,0, 57272
15,57276,2,2,1, 57278
24,57284,1,1,1, 57285
8,57286,1,1,1, 57287
15,57291,2,2,1, 57293
31,57291,2,2,1, 57293
24,57299,1,1,0, 57300
8,57301,1,1,1, 57302
24,57314,1,1,1, 57315
8,57316,1,1,0, 57317
15,57321,2,2,1, 57323
31,57321,2,2,1, 57323
24,57329,1,1,0, 57330
8,57331,1,1,0, 57332
24,57344,1,1,1, 57345
8,57346,1,1,0, 57347
9,57347,2,2,1, 57349
1,57351,1,1,1, 57352
7,57357,1,1,0, 57358
24,57359,1,1,1, 57360
9,57362,2,2,1, 57364
16,57364,2,2,1, 57366
25,57365,2,2,1, 57367
1,57366,1,1,0, 57367
7,57372,1,1,0, 57373
24,57374,1,1,1, 57375
1,57381,1,1,0, 57382
7,57387,1,1,1, 57388
24,57389,1,1,1, 57390
16,57394,2,2,1, 57396
25,57395,2,2,1, 57397
1,57396,1,1,0, 57397
6,57400,2,2,1, 57402
7,57402,1,1,1, 57403
24,57404,1,1,1, 57405
25,57410,2,2,1, 57412
1,57411,1,1,0, 57412
6,57415,2,2,1, 57417
7,57417,1,1,0, 57418
24,57419,1,1,0, 57420
16,57424,2,2,1, 57426
1,57426,1,1,1, 57427
7,57432,1,1,0, 57433
24,57434,1,1,1, 57435
2,57438,2,2,1, 57440
16,57439,2,2,1, 57441
1,57441,1,1,1, 57442
7,57447,1,1,0, 57448
24,57449,1,1,0, 57450
2,57453,2,2,1, 57455
1,57456,1,1,0, 57457
7,57462,1,1,0, 57463
24,57464,1,1,0, 57465
8,57466,1,1,0, 57467
2,57468,2,2,1, 57470
1,57471,1,1,0, 57472
7,57477,1,1,0, 57478
24,57479,1,1,1, 57480
9,57482,2,2,1, 57484
1,57486,1,1,1, 57487
31,57486,2,2,1, 57488
6,57490,2,2,1, 57492
7,57492,1,1,1, 57493
1,57501,1,1,1, 57502
31,57501,2,2,1, 57503
7,57507,1,1,1, 57508
1,57516,1,1,1, 57517
6,57520,2,2,1, 57522
7,57522,1,1,1, 57523
1,57531,1,1,0, 57532
31,57531,2,2,1, 57533
7,57537,1,1,1, 57538
6,57550,2,2,1, 57552
7,57552,1,1,0, 57553
7,57567,1,1,0, 57568
6,57580,2,2,1, 57582
7,57582,1,1,1, 57583
8,57586,1,1,1, 57587
31,57591,2,2,1, 57593
6,57595,2,2,1, 57597
7,57597,1,1,0, 57598
8,57601,1,1,1, 57602
8,57616,1,1,0, 57617
8,57631,1,1,0, 57632
24,57644,1,1,0, 57645
8,57646,1,1,0, 57647
25,57650,2,2,1, 57652
1,57651,1,1,0, 57652
24,57659,1,1,0, 57660
8,57661,1,1,0, 57662
9,57662,2,2,1, 57664
1,57666,1,1,0, 57667
31,57666,2,2,1, 57668
7,57672,1,1,0, 57673
24,57674,1,1,0, 57675
8,57676,1,1,0, 57677
1,57681,1,1,1, 57682
31,57681,2,2,1, 57683
6,57685,2,2,1, 57687
7,57687,1,1,0, 57688
24,57689,1,1,1, 57690
8,57691,1,1,1, 57692
9,57692,2,2,1, 57694
1,57696,1,1,0, 57697
6,57700,2,2,1, 57702
7,57702,1,1,1, 57703
24,57704,1,1,1, 57705
8,57706,1,1,0, 57707
9,57707,2,2,1, 57709
1,57711,1,1,0, 57712
15,57711,2,2,1, 57713
31,57711,2,2,1, 57713
7,57717,1,1,1, 57718
24,57719,1,1,1, 57720
1,57726,1,1,0, 57727
24,57734,1,1,1, 57735
1,57741,1,1,1, 57742
24,57749,1,1,1, 57750
1,57756,1,1,0, 57757
31,57756,2,2,1, 57758
24,57764,1,1,0, 57765
9,57767,2,2,1, 57769
2,57768,2,2,1, 57770
1,57771,1,1,0, 57772
24,57779,1,1,0, 57780
24,57794,1,1,1, 57795
31,57801,2,2,1, 57803
24,57809,1,1,0, 57810
24,57824,1,1,0, 57825
8,57826,1,1,0, 57827
16,57829,2,2,1, 57831
15,57831,2,2,1, 57833
7,57837,1,1,1, 57838
24,57839,1,1,0, 57840
8,57841,1,1,0, 57842
1,57846,1,1,1, 57847
7,57852,1,1,0, 57853
8,57856,1,1,0, 57857
16,57859,2,2,1, 57861
1,57861,1,1,0, 57862
7,57867,1,1,0, 57868
8,57871,1,1,0, 57872
1,57876,1,1,1, 57877
7,57882,1,1,0, 57883
8,57886,1,1,1, 57887
2,57888,2,2,1, 57890
1,57891,1,1,0, 57892
31,57891,2,2,1, 57893
7,57897,1,1,0, 57898
8,57901,1,1,0, 57902
9,57902,2,2,1, 57904
16,57904,2,2,1, 57906
7,57912,1,1,1, 57913
8,57916,1,1,0, 57917
16,57919,2,2,1, 57921
7,57927,1,1,1, 57928
8,57931,1,1,1, 57932
7,57942,1,1,0, 57943
24,57944,1,1,1, 57945
8,57946,1,1,0, 57947
16,57949,2,2,1, 57951
15,57951,2,2,1, 57953
6,57955,2,2,1, 57957
7,57957,1,1,1, 57958
24,57959,1,1,0, 57960
16,57964,2,2,1, 57966
24,57974,1,1,0, 57975
16,57979,2,2,1, 57981
31,57981,2,2,1, 57983
24,57989,1,1,0, 57990
16,57994,2,2,1, 57996
31,57996,2,2,1, 57998
24,58004,1,1,1, 58005
16,58009,2,2,1, 58011
1,58011,1,1,1, 58012
24,58019,1,1,0, 58020
1,58026,1,1,1, 58027
1,58041,1,1,1, 58042
1,58056,1,1,1, 58057
7,58062,1,1,1, 58063
1,58071,1,1,0, 58072
15,58071,2,2,1, 58073
31,58071,2,2,1, 58073
7,58077,1,1,0, 58078
16,58084,2,2,1, 58086
1,58086,1,1,0, 58087
31,58086,2,2,1, 58088
7,58092,1,1,1, 58093
24,58094,1,1,0, 58095
16,58099,2,2,1, 58101
1,58101,1,1,0, 58102
31,58101,2,2,1, 58103
7,58107,1,1,1, 58108
24,58109,1,1,0, 58110
1,58116,1,1,1, 58117
31,58116,2,2,1, 58118
7,58122,1,1,0, 58123
24,58124,1,1,1, 58125
8,58126,1,1,0, 58127
9,58127,2,2,1, 58129
2,58128,2,2,1, 58130
1,58131,1,1,1, 58132
7,58137,1,1,1, 58138
24,58139,1,1,1, 58140
8,58141,1,1,0, 58142
16,58144,2,2,1, 58146
6,58150,2,2,1, 58152
7,58152,1,1,0, 58153
8,58156,1,1,1, 58157
16,58159,2,2,1, 58161
31,58161,2,2,1, 58163
7,58167,1,1,0, 58168
8,58171,1,1,0, 58172
9,58172,2,2,1, 58174
16,58174,2,2,1, 58176
31,58176,2,2,1, 58178
6,58180,2,2,1, 58182
7,58182,1,1,0, 58183
8,58186,1,1,1, 58187
16,58189,2,2,1, 58191
7,58197,1,1,0, 58198
1,58251,1,1,0, 58252
31,58251,2,2,1, 58253
24,58259,1,1,0, 58260
1,58266,1,1,1, 58267
31,58266,2,2,1, 58268
24,58274,1,1,1, 58275
1,58281,1,1,0, 58282
31,58281,2,2,1, 58283
24,58289,1,1,0, 58290
1,58296,1,1,0, 58297
24,58304,1,1,0, 58305
8,58306,1,1,1, 58307
16,58309,2,2,1, 58311
25,58310,2,2,1, 58312
1,58311,1,1,1, 58312
24,58319,1,1,1, 58320
8,58321,1,1,1, 58322
16,58324,2,2,1, 58326
25,58325,2,2,1, 58327
1,58326,1,1,1, 58327
7,58332,1,1,0, 58333
8,58336,1,1,1, 58337
1,58341,1,1,0, 58342
7,58347,1,1,1, 58348
8,58351,1,1,0, 58352
16,58354,2,2,1, 58356
1,58356,1,1,1, 58357
7,58362,1,1,0, 58363
8,58366,1,1,0, 58367
9,58367,2,2,1, 58369
2,58368,2,2,1, 58370
16,58369,2,2,1, 58371
1,58371,1,1,1, 58372
7,58377,1,1,0, 58378
8,58381,1,1,1, 58382
9,58382,2,2,1, 58384
1,58386,1,1,0, 58387
7,58392,1,1,0, 58393
8,58396,1,1,0, 58397
9,58397,2,2,1, 58399
16,58399,2,2,1, 58401
1,58401,1,1,0, 58402
6,58405,2,2,1, 58407
7,58407,1,1,0, 58408
8,58411,1,1,0, 58412
1,58416,1,1,0, 58417
6,58420,2,2,1, 58422
7,58422,1,1,0, 58423
24,58424,1,1,0, 58425
8,58426,1,1,0, 58427
9,58427,2,2,1, 58429
1,58431,1,1,0, 58432
7,58437,1,1,0, 58438
24,58439,1,1,1, 58440
16,58444,2,2,1, 58446
1,58446,1,1,1, 58447
15,58446,2,2,1, 58448
7,58452,1,1,1, 58453
24,58454,1,1,0, 58455
16,58459,2,2,1, 58461
1,58461,1,1,0, 58462
15,58461,2,2,1, 58463
7,58467,1,1,1, 58468
24,58469,1,1,0, 58470
1,58476,1,1,0, 58477
31,58476,2,2,1, 58478
7,58482,1,1,0, 58483
24,58484,1,1,0, 58485
16,58489,2,2,1, 58491
1,58491,1,1,0, 58492
31,58491,2,2,1, 58493
7,58497,1,1,0, 58498
24,58499,1,1,0, 58500
25,58505,2,2,1, 58507
1,58506,1,1,1, 58507
31,58506,2,2,1, 58508
25,58520,2,2,1, 58522
1,58521,1,1,0, 58522
25,58535,2,2,1, 58537
1,58536,1,1,0, 58537
8,58546,1,1,1, 58547
9,58547,2,2,1, 58549
16,58549,2,2,1, 58551
1,58551,1,1,0, 58552
8,58561,1,1,0, 58562
9,58562,2,2,1, 58564
8,58576,1,1,1, 58577
8,58591,1,1,0, 58592
24,58604,1,1,1, 58605
8,58606,1,1,0, 58607
9,58607,2,2,1, 58609
7,58617,1,1,0, 58618
24,58619,1,1,1, 58620
8,58621,1,1,0, 58622
9,58622,2,2,1, 58624
7,58632,1,1,1, 58633
24,58634,1,1,1, 58635
8,58636,1,1,1, 58637
7,58647,1,1,1, 58648
24,58649,1,1,0, 58650
8,58651,1,1,0, 58652
9,58652,2,2,1, 58654
25,58655,2,2,1, 58657
6,58660,2,2,1, 58662
7,58662,1,1,0, 58663
24,58664,1,1,0, 58665
8,58666,1,1,0, 58667
9,58667,2,2,1, 58669
1,58671,1,1,0, 58672
6,58675,2,2,1, 58677
7,58677,1,1,0, 58678
24,58679,1,1,0, 58680
9,58682,2,2,1, 58684
16,58684,2,2,1, 58686
1,58686,1,1,0, 58687
24,58694,1,1,0, 58695
9,58697,2,2,1, 58699
16,58699,2,2,1, 58701
1,58701,1,1,1, 58702
24,58709,1,1,0, 58710
1,58716,1,1,1, 58717
24,58724,1,1,0, 58725
16,58729,2,2,1, 58731
1,58731,1,1,1, 58732
24,58739,1,1,1, 58740
9,58742,2,2,1, 58744
1,58746,1,1,0, 58747
24,58754,1,1,0, 58755
9,58757,2,2,1, 58759
16,58759,2,2,1, 58761
1,58761,1,1,1, 58762
24,58769,1,1,1, 58770
9,58772,2,2,1, 58774
1,58776,1,1,1, 58777
7,58782,1,1,0, 58783
24,58784,1,1,0, 58785
8,58786,1,1,1, 58787
9,58787,2,2,1, 58789
2,58788,2,2,1, 58790
1,58791,1,1,1, 58792
31,58791,2,2,1, 58793
7,58797,1,1,0, 58798
24,58799,1,1,0, 58800
8,58801,1,1,1, 58802
24,58814,1,1,1, 58815
8,58816,1,1,0, 58817
24,58829,1,1,0, 58830
8,58831,1,1,0, 58832
25,58835,2,2,1, 58837
24,58844,1,1,1, 58845
8,58846,1,1,0, 58847
31,58851,2,2,1, 58853
24,58859,1,1,0, 58860
8,58861,1,1,0, 58862
24,58874,1,1,1, 58875
8,58876,1,1,0, 58877
31,58881,2,2,1, 58883
24,58889,1,1,1, 58890
8,58891,1,1,0, 58892
24,58904,1,1,1, 58905
8,58906,1,1,1, 58907
16,58909,2,2,1, 58911
1,58911,1,1,0, 58912
7,58917,1,1,1, 58918
24,58919,1,1,0, 58920
1,58926,1,1,0, 58927
7,58932,1,1,0, 58933
9,58937,2,2,1, 58939
1,58941,1,1,1, 58942
31,58941,2,2,1, 58943
7,58947,1,1,1, 58948
9,58952,2,2,1, 58954
1,58956,1,1,1, 58957
31,58956,2,2,1, 58958
6,58960,2,2,1, 58962
7,58962,1,1,0, 58963
1,58971,1,1,1, 58972
31,58971,2,2,1, 58973
6,58975,2,2,1, 58977
7,58977,1,1,1, 58978
16,58984,2,2,1, 58986
1,58986,1,1,1, 58987
7,58992,1,1,0, 58993
24,58994,1,1,0, 58995
16,58999,2,2,1, 59001
25,59000,2,2,1, 59002
1,59001,1,1,0, 59002
7,59007,1,1,0, 59008
25,59015,2,2,1, 59017
1,59016,1,1,1, 59017
6,59020,2,2,1, 59022
7,59022,1,1,1, 59023
8,59026,1,1,1, 59027
16,59029,2,2,1, 59031
1,59031,1,1,1, 59032
15,59031,2,2,1, 59033
6,59035,2,2,1, 59037
7,59037,1,1,0, 59038
8,59041,1,1,0, 59042
25,59045,2,2,1, 59047
1,59046,1,1,0, 59047
15,59046,2,2,1, 59048
7,59052,1,1,0, 59053
8,59056,1,1,0, 59057
25,59060,2,2,1, 59062
1,59061,1,1,1, 59062
7,59067,1,1,0, 59068
8,59071,1,1,0, 59072
16,59074,2,2,1, 59076
25,59075,2,2,1, 59077
1,59076,1,1,1, 59077
7,59082,1,1,0, 59083
8,59086,1,1,1, 59087
25,59090,2,2,1, 59092
1,59091,1,1,1, 59092
31,59091,2,2,1, 59093
7,59097,1,1,0, 59098
8,59101,1,1,0, 59102
9,59102,2,2,1, 59104
31,59106,2,2,1, 59108
6,59110,2,2,1, 59112
7,59112,1,1,1, 59113
24,59114,1,1,0, 59115
8,59116,1,1,1, 59117
31,59121,2,2,1, 59123
7,59127,1,1,0, 59128
24,59129,1,1,1, 59130
8,59131,1,1,1, 59132
31,59136,2,2,1, 59138
7,59142,1,1,0, 59143
24,59144,1,1,0, 59145
8,59146,1,1,0, 59147
9,59147,2,2,1, 59149
6,59155,2,2,1, 59157
7,59157,1,1,0, 59158
24,59159,1,1,1, 59160
8,59161,1,1,1, 59162
9,59162,2,2,1, 59164
6,59170,2,2,1, 59172
7,59172,1,1,0, 59173
24,59174,1,1,1, 59175
8,59176,1,1,1, 59177
6,59185,2,2,1, 59187
7,59187,1,1,1, 59188
24,59189,1,1,1, 59190
8,59191,1,1,0, 59192
9,59192,2,2,1, 59194
6,59200,2,2,1, 59202
7,59202,1,1,0, 59203
24,59204,1,1,0, 59205
8,59206,1,1,0, 59207
1,59211,1,1,1, 59212
7,59217,1,1,0, 59218
24,59219,1,1,0, 59220
24,59234,1,1,1, 59235
16,59239,2,2,1, 59241
24,59249,1,1,0, 59250
16,59254,2,2,1, 59256
24,59264,1,1,0, 59265
24,59279,1,1,1, 59280
24,59294,1,1,1, 59295
16,59299,2,2,1, 59301
24,59309,1,1,0, 59310
7,59322,1,1,1, 59323
24,59324,1,1,0, 59325
8,59326,1,1,1, 59327
1,59331,1,1,0, 59332
7,59337,1,1,1, 59338
24,59339,1,1,1, 59340
8,59341,1,1,0, 59342
1,59346,1,1,0, 59347
7,59352,1,1,1, 59353
24,59354,1,1,0, 59355
8,59356,1,1,0, 59357
1,59361,1,1,1, 59362
7,59367,1,1,0, 59368
24,59369,1,1,1, 59370
8,59371,1,1,1, 59372
2,59373,2,2,1, 59375
25,59375,2,2,1, 59377
1,59376,1,1,1, 59377
7,59382,1,1,1, 59383
24,59384,1,1,1, 59385
8,59386,1,1,1, 59387
2,59388,2,2,1, 59390
25,59390,2,2,1, 59392
1,59391,1,1,0, 59392
7,59397,1,1,0, 59398
24,59399,1,1,0, 59400
8,59401,1,1,1, 59402
7,59412,1,1,0, 59413
24,59414,1,1,0, 59415
8,59416,1,1,0, 59417
25,59420,2,2,1, 59422
7,59427,1,1,0, 59428
24,59429,1,1,0, 59430
8,59431,1,1,0, 59432
25,59435,2,2,1, 59437
7,59442,1,1,1, 59443
24,59444,1,1,0, 59445
8,59446,1,1,0, 59447
15,59451,2,2,1, 59453
7,59457,1,1,0, 59458
24,59459,1,1,0, 59460
8,59461,1,1,1, 59462
9,59462,2,2,1, 59464
15,59466,2,2,1, 59468
7,59472,1,1,0, 59473
24,59474,1,1,1, 59475
8,59476,1,1,1, 59477
9,59477,2,2,1, 59479
15,59481,2,2,1, 59483
7,59487,1,1,1, 59488
24,59489,1,1,0, 59490
8,59491,1,1,0, 59492
9,59492,2,2,1, 59494
6,59500,2,2,1, 59502
7,59502,1,1,1, 59503
24,59504,1,1,1, 59505
8,59506,1,1,1, 59507
15,59511,2,2,1, 59513
6,59515,2,2,1, 59517
7,59517,1,1,1, 59518
24,59519,1,1,1, 59520
8,59521,1,1,0, 59522
6,59530,2,2,1, 59532
7,59532,1,1,0, 59533
24,59534,1,1,1, 59535
6,59545,2,2,1, 59547
7,59547,1,1,0, 59548
24,59549,1,1,1, 59550
7,59562,1,1,0, 59563
24,59564,1,1,1, 59565
16,59569,2,2,1, 59571
1,59571,1,1,1, 59572
7,59577,1,1,1, 59578
24,59579,1,1,1, 59580
8,59581,1,1,0, 59582
1,59586,1,1,1, 59587
7,59592,1,1,0, 59593
24,59594,1,1,0, 59595
8,59596,1,1,0, 59597
16,59599,2,2,1, 59601
1,59601,1,1,1, 59602
7,59607,1,1,1, 59608
24,59609,1,1,0, 59610
8,59611,1,1,0, 59612
16,59614,2,2,1, 59616
25,59615,2,2,1, 59617
1,59616,1,1,1, 59617
7,59622,1,1,0, 59623
24,59624,1,1,0, 59625
8,59626,1,1,0, 59627
1,59631,1,1,1, 59632
7,59637,1,1,1, 59638
24,59639,1,1,1, 59640
8,59641,1,1,0, 59642
1,59646,1,1,1, 59647
15,59646,2,2,1, 59648
6,59650,2,2,1, 59652
7,59652,1,1,0, 59653
24,59654,1,1,1, 59655
8,59656,1,1,0, 59657
1,59661,1,1,0, 59662
7,59667,1,1,1, 59668
24,59669,1,1,1, 59670
8,59671,1,1,1, 59672
16,59674,2,2,1, 59676
1,59676,1,1,1, 59677
6,59680,2,2,1, 59682
7,59682,1,1,1, 59683
24,59684,1,1,1, 59685
8,59686,1,1,0, 59687
9,59687,2,2,1, 59689
2,59688,2,2,1, 59690
16,59689,2,2,1, 59691
25,59690,2,2,1, 59692
1,59691,1,1,0, 59692
15,59691,2,2,1, 59693
6,59695,2,2,1, 59697
7,59697,1,1,0, 59698
24,59699,1,1,0, 59700
16,59704,2,2,1, 59706
6,59710,2,2,1, 59712
7,59712,1,1,1, 59713
24,59714,1,1,0, 59715
7,59727,1,1,0, 59728
24,59729,1,1,0, 59730
6,59740,2,2,1, 59742
7,59742,1,1,0, 59743
24,59744,1,1,0, 59745
6,59755,2,2,1, 59757
7,59757,1,1,1, 59758
24,59759,1,1,1, 59760
7,59772,1,1,0, 59773
24,59774,1,1,1, 59775
7,59787,1,1,0, 59788
24,59789,1,1,1, 59790
7,59802,1,1,0, 59803
24,59804,1,1,1, 59805
8,59806,1,1,0, 59807
2,59808,2,2,1, 59810
25,59810,2,2,1, 59812
1,59811,1,1,1, 59812
7,59817,1,1,0, 59818
24,59819,1,1,0, 59820
8,59821,1,1,0, 59822
16,59824,2,2,1, 59826
1,59826,1,1,0, 59827
15,59826,2,2,1, 59828
6,59830,2,2,1, 59832
7,59832,1,1,1, 59833
24,59834,1,1,0, 59835
8,59836,1,1,0, 59837
16,59839,2,2,1, 59841
1,59841,1,1,1, 59842
6,59845,2,2,1, 59847
7,59847,1,1,1, 59848
24,59849,1,1,1, 59850
8,59851,1,1,0, 59852
16,59854,2,2,1, 59856
25,59855,2,2,1, 59857
1,59856,1,1,0, 59857
7,59862,1,1,1, 59863
24,59864,1,1,0, 59865
8,59866,1,1,0, 59867
16,59869,2,2,1, 59871
1,59871,1,1,0, 59872
6,59875,2,2,1, 59877
7,59877,1,1,0, 59878
24,59879,1,1,0, 59880
8,59881,1,1,1, 59882
25,59885,2,2,1, 59887
1,59886,1,1,1, 59887
6,59890,2,2,1, 59892
7,59892,1,1,1, 59893
24,59894,1,1,1, 59895
8,59896,1,1,0, 59897
25,59900,2,2,1, 59902
1,59901,1,1,0, 59902
6,59905,2,2,1, 59907
7,59907,1,1,1, 59908
24,59909,1,1,0, 59910
8,59911,1,1,0, 59912
1,59916,1,1,0, 59917
6,59920,2,2,1, 59922
7,59922,1,1,0, 59923
24,59924,1,1,0, 59925
8,59926,1,1,0, 59927
2,59928,2,2,1, 59930
16,59929,2,2,1, 59931
25,59930,2,2,1, 59932
1,59931,1,1,1, 59932
7,59937,1,1,0, 59938
24,59939,1,1,0, 59940
15,59946,2,2,1, 59948
7,59952,1,1,1, 59953
24,59954,1,1,0, 59955
7,59967,1,1,1, 59968
24,59969,1,1,1, 59970
7,59982,1,1,1, 59983
24,59984,1,1,0, 59985
7,59997,1,1,0, 59998
24,59999,1,1,0, 60000
7,60012,1,1,0, 60013
24,60014,1,1,0, 60015
7,60027,1,1,0, 60028
24,60029,1,1,1, 60030
15,60036,2,2,1, 60038
7,60042,1,1,0, 60043
24,60044,1,1,1, 60045
8,60046,1,1,1, 60047
9,60047,2,2,1, 60049
1,60051,1,1,0, 60052
15,60051,2,2,1, 60053
7,60057,1,1,0, 60058
24,60059,1,1,0, 60060
8,60061,1,1,0, 60062
25,60065,2,2,1, 60067
1,60066,1,1,0, 60067
7,60072,1,1,1, 60073
24,60074,1,1,0, 60075
8,60076,1,1,0, 60077
16,60079,2,2,1, 60081
25,60080,2,2,1, 60082
1,60081,1,1,1, 60082
6,60085,2,2,1, 60087
7,60087,1,1,1, 60088
24,60089,1,1,1, 60090
8,60091,1,1,0, 60092
25,60095,2,2,1, 60097
1,60096,1,1,0, 60097
6,60100,2,2,1, 60102
7,60102,1,1,1, 60103
24,60104,1,1,1, 60105
8,60106,1,1,0, 60107
16,60109,2,2,1, 60111
1,60111,1,1,1, 60112
7,60117,1,1,1, 60118
24,60119,1,1,0, 60120
8,60121,1,1,0, 60122
16,60124,2,2,1, 60126
25,60125,2,2,1, 60127
1,60126,1,1,0, 60127
6,60130,2,2,1, 60132
7,60132,1,1,1, 60133
24,60134,1,1,0, 60135
8,60136,1,1,0, 60137
1,60141,1,1,1, 60142
7,60147,1,1,0, 60148
24,60149,1,1,1, 60150
8,60151,1,1,1, 60152
1,60156,1,1,1, 60157
6,60160,2,2,1, 60162
7,60162,1,1,0, 60163
24,60164,1,1,0, 60165
8,60166,1,1,0, 60167
25,60170,2,2,1, 60172
1,60171,1,1,0, 60172
15,60171,2,2,1, 60173
6,60175,2,2,1, 60177
7,60177,1,1,1, 60178
24,60179,1,1,0, 60180
1,60186,1,1,0, 60187
6,60190,2,2,1, 60192
7,60192,1,1,0, 60193
24,60194,1,1,0, 60195
1,60201,1,1,1, 60202
15,60201,2,2,1, 60203
6,60205,2,2,1, 60207
7,60207,1,1,1, 60208
24,60209,1,1,0, 60210
9,60212,2,2,1, 60214
1,60216,1,1,1, 60217
7,60222,1,1,0, 60223
24,60224,1,1,0, 60225
9,60227,2,2,1, 60229
1,60231,1,1,0, 60232
7,60237,1,1,1, 60238
24,60239,1,1,1, 60240
1,60246,1,1,0, 60247
7,60252,1,1,0, 60253
24,60254,1,1,0, 60255
9,60257,2,2,1, 60259
1,60261,1,1,1, 60262
15,60261,2,2,1, 60263
7,60267,1,1,0, 60268
24,60269,1,1,0, 60270
9,60272,2,2,1, 60274
1,60276,1,1,0, 60277
7,60282,1,1,1, 60283
24,60284,1,1,0, 60285
8,60286,1,1,1, 60287
1,60291,1,1,0, 60292
15,60291,2,2,1, 60293
7,60297,1,1,1, 60298
24,60299,1,1,0, 60300
8,60301,1,1,1, 60302
7,60312,1,1,0, 60313
24,60314,1,1,0, 60315
8,60316,1,1,1, 60317
9,60317,2,2,1, 60319
16,60319,2,2,1, 60321
7,60327,1,1,0, 60328
24,60329,1,1,1, 60330
8,60331,1,1,0, 60332
16,60334,2,2,1, 60336
7,60342,1,1,0, 60343
24,60344,1,1,1, 60345
8,60346,1,1,0, 60347
9,60347,2,2,1, 60349
7,60357,1,1,1, 60358
24,60359,1,1,0, 60360
8,60361,1,1,1, 60362
25,60365,2,2,1, 60367
7,60372,1,1,1, 60373
24,60374,1,1,0, 60375
8,60376,1,1,0, 60377
16,60379,2,2,1, 60381
7,60387,1,1,0, 60388
24,60389,1,1,1, 60390
8,60391,1,1,0, 60392
9,60392,2,2,1, 60394
25,60395,2,2,1, 60397
7,60402,1,1,0, 60403
24,60404,1,1,1, 60405
8,60406,1,1,1, 60407
9,60407,2,2,1, 60409
16,60409,2,2,1, 60411
25,60410,2,2,1, 60412
1,60411,1,1,0, 60412
15,60411,2,2,1, 60413
6,60415,2,2,1, 60417
7,60417,1,1,1, 60418
24,60419,1,1,1, 60420
1,60426,1,1,1, 60427
7,60432,1,1,0, 60433
24,60434,1,1,0, 60435
9,60437,2,2,1, 60439
16,60439,2,2,1, 60441
1,60441,1,1,1, 60442
7,60447,1,1,0, 60448
24,60449,1,1,1, 60450
9,60452,2,2,1, 60454
1,60456,1,1,0, 60457
7,60462,1,1,1, 60463
24,60464,1,1,1, 60465
9,60467,2,2,1, 60469
1,60471,1,1,1, 60472
7,60477,1,1,0, 60478
24,60479,1,1,1, 60480
9,60482,2,2,1, 60484
16,60484,2,2,1, 60486
1,60486,1,1,1, 60487
6,60490,2,2,1, 60492
7,60492,1,1,1, 60493
24,60494,1,1,1, 60495
9,60497,2,2,1, 60499
16,60499,2,2,1, 60501
1,60501,1,1,1, 60502
6,60505,2,2,1, 60507
7,60507,1,1,1, 60508
24,60509,1,1,0, 60510
16,60514,2,2,1, 60516
1,60516,1,1,0, 60517
7,60522,1,1,0, 60523
24,60524,1,1,1, 60525
8,60526,1,1,1, 60527
16,60529,2,2,1, 60531
1,60531,1,1,0, 60532
15,60531,2,2,1, 60533
7,60537,1,1,1, 60538
24,60539,1,1,0, 60540
8,60541,1,1,0, 60542
25,60545,2,2,1, 60547
7,60552,1,1,0, 60553
24,60554,1,1,1, 60555
8,60556,1,1,0, 60557
7,60567,1,1,0, 60568
24,60569,1,1,0, 60570
8,60571,1,1,1, 60572
25,60575,2,2,1, 60577
7,60582,1,1,0, 60583
24,60584,1,1,0, 60585
8,60586,1,1,0, 60587
25,60590,2,2,1, 60592
7,60597,1,1,1, 60598
24,60599,1,1,0, 60600
8,60601,1,1,1, 60602
7,60612,1,1,0, 60613
24,60614,1,1,0, 60615
8,60616,1,1,0, 60617
25,60620,2,2,1, 60622
7,60627,1,1,1, 60628
24,60629,1,1,1, 60630
8,60631,1,1,0, 60632
7,60642,1,1,1, 60643
24,60644,1,1,1, 60645
8,60646,1,1,0, 60647
9,60647,2,2,1, 60649
25,60650,2,2,1, 60652
1,60651,1,1,1, 60652
15,60651,2,2,1, 60653
6,60655,2,2,1, 60657
7,60657,1,1,0, 60658
24,60659,1,1,1, 60660
8,60661,1,1,1, 60662
1,60666,1,1,1, 60667
6,60670,2,2,1, 60672
7,60672,1,1,0, 60673
24,60674,1,1,0, 60675
1,60681,1,1,1, 60682
7,60687,1,1,1, 60688
24,60689,1,1,1, 60690
1,60696,1,1,1, 60697
7,60702,1,1,0, 60703
24,60704,1,1,0, 60705
1,60711,1,1,1, 60712
6,60715,2,2,1, 60717
7,60717,1,1,0, 60718
24,60719,1,1,0, 60720
1,60726,1,1,0, 60727
6,60730,2,2,1, 60732
7,60732,1,1,0, 60733
24,60734,1,1,1, 60735
1,60741,1,1,1, 60742
6,60745,2,2,1, 60747
7,60747,1,1,1, 60748
24,60749,1,1,1, 60750
1,60756,1,1,1, 60757
6,60760,2,2,1, 60762
7,60762,1,1,1, 60763
24,60764,1,1,0, 60765
2,60768,2,2,1, 60770
16,60769,2,2,1, 60771
1,60771,1,1,0, 60772
7,60777,1,1,0, 60778
24,60779,1,1,1, 60780
8,60781,1,1,0, 60782
9,60782,2,2,1, 60784
7,60792,1,1,0, 60793
24,60794,1,1,1, 60795
8,60796,1,1,1, 60797
9,60797,2,2,1, 60799
7,60807,1,1,1, 60808
24,60809,1,1,0, 60810
8,60811,1,1,0, 60812
7,60822,1,1,1, 60823
24,60824,1,1,0, 60825
8,60826,1,1,1, 60827
7,60837,1,1,0, 60838
24,60839,1,1,0, 60840
8,60841,1,1,0, 60842
7,60852,1,1,0, 60853
24,60854,1,1,0, 60855
8,60856,1,1,1, 60857
9,60857,2,2,1, 60859
7,60867,1,1,0, 60868
24,60869,1,1,1, 60870
8,60871,1,1,0, 60872
6,60880,2,2,1, 60882
7,60882,1,1,1, 60883
24,60884,1,1,0, 60885
8,60886,1,1,0, 60887
2,60888,2,2,1, 60890
16,60889,2,2,1, 60891
25,60890,2,2,1, 60892
1,60891,1,1,0, 60892
15,60891,2,2,1, 60893
6,60895,2,2,1, 60897
7,60897,1,1,0, 60898
24,60899,1,1,0, 60900
16,60904,2,2,1, 60906
25,60905,2,2,1, 60907
1,60906,1,1,0, 60907
7,60912,1,1,1, 60913
24,60914,1,1,0, 60915
1,60921,1,1,0, 60922
6,60925,2,2,1, 60927
7,60927,1,1,0, 60928
24,60929,1,1,0, 60930
25,60935,2,2,1, 60937
1,60936,1,1,0, 60937
7,60942,1,1,0, 60943
24,60944,1,1,0, 60945
16,60949,2,2,1, 60951
25,60950,2,2,1, 60952
1,60951,1,1,0, 60952
6,60955,2,2,1, 60957
7,60957,1,1,1, 60958
24,60959,1,1,0, 60960
1,60966,1,1,1, 60967
6,60970,2,2,1, 60972
7,60972,1,1,0, 60973
24,60974,1,1,1, 60975
16,60979,2,2,1, 60981
1,60981,1,1,1, 60982
7,60987,1,1,1, 60988
24,60989,1,1,1, 60990
16,60994,2,2,1, 60996
1,60996,1,1,1, 60997
7,61002,1,1,0, 61003
24,61004,1,1,0, 61005
8,61006,1,1,0, 61007
2,61008,2,2,1, 61010
16,61009,2,2,1, 61011
1,61011,1,1,0, 61012
7,61017,1,1,0, 61018
24,61019,1,1,1, 61020
8,61021,1,1,1, 61022
1,61026,1,1,0, 61027
15,61026,2,2,1, 61028
7,61032,1,1,1, 61033
24,61034,1,1,1, 61035
8,61036,1,1,0, 61037
9,61037,2,2,1, 61039
1,61041,1,1,0, 61042
15,61041,2,2,1, 61043
7,61047,1,1,1, 61048
24,61049,1,1,0, 61050
8,61051,1,1,0, 61052
9,61052,2,2,1, 61054
1,61056,1,1,1, 61057
7,61062,1,1,1, 61063
24,61064,1,1,0, 61065
8,61066,1,1,0, 61067
1,61071,1,1,0, 61072
7,61077,1,1,1, 61078
24,61079,1,1,1, 61080
8,61081,1,1,0, 61082
9,61082,2,2,1, 61084
1,61086,1,1,0, 61087
7,61092,1,1,1, 61093
24,61094,1,1,0, 61095
8,61096,1,1,0, 61097
9,61097,2,2,1, 61099
1,61101,1,1,1, 61102
7,61107,1,1,1, 61108
24,61109,1,1,0, 61110
8,61111,1,1,0, 61112
9,61112,2,2,1, 61114
1,61116,1,1,1, 61117
15,61116,2,2,1, 61118
7,61122,1,1,1, 61123
24,61124,1,1,1, 61125
8,61126,1,1,0, 61127
9,61127,2,2,1, 61129
2,61128,2,2,1, 61130
16,61129,2,2,1, 61131
1,61131,1,1,1, 61132
15,61131,2,2,1, 61133
7,61137,1,1,0, 61138
24,61139,1,1,0, 61140
7,61152,1,1,1, 61153
24,61154,1,1,1, 61155
25,61160,2,2,1, 61162
7,61167,1,1,1, 61168
24,61169,1,1,0, 61170
7,61182,1,1,1, 61183
24,61184,1,1,0, 61185
6,61195,2,2,1, 61197
7,61197,1,1,0, 61198
24,61199,1,1,0, 61200
6,61210,2,2,1, 61212
7,61212,1,1,0, 61213
24,61214,1,1,1, 61215
7,61227,1,1,0, 61228
24,61229,1,1,0, 61230
16,61234,2,2,1, 61236
25,61235,2,2,1, 61237
7,61242,1,1,1, 61243
24,61244,1,1,1, 61245
1,61251,1,1,0, 61252
15,61251,2,2,1, 61253
7,61257,1,1,0, 61258
24,61259,1,1,0, 61260
8,61261,1,1,0, 61262
16,61264,2,2,1, 61266
1,61266,1,1,0, 61267
6,61270,2,2,1, 61272
7,61272,1,1,1, 61273
24,61274,1,1,0, 61275
8,61276,1,1,0, 61277
16,61279,2,2,1, 61281
1,61281,1,1,1, 61282
15,61281,2,2,1, 61283
7,61287,1,1,0, 61288
24,61289,1,1,1, 61290
8,61291,1,1,1, 61292
16,61294,2,2,1, 61296
1,61296,1,1,1, 61297
6,61300,2,2,1, 61302
7,61302,1,1,1, 61303
24,61304,1,1,0, 61305
8,61306,1,1,0, 61307
16,61309,2,2,1, 61311
1,61311,1,1,0, 61312
6,61315,2,2,1, 61317
7,61317,1,1,1, 61318
24,61319,1,1,0, 61320
8,61321,1,1,1, 61322
1,61326,1,1,0, 61327
15,61326,2,2,1, 61328
6,61330,2,2,1, 61332
7,61332,1,1,0, 61333
24,61334,1,1,1, 61335
8,61336,1,1,0, 61337
16,61339,2,2,1, 61341
1,61341,1,1,0, 61342
15,61341,2,2,1, 61343
6,61345,2,2,1, 61347
7,61347,1,1,0, 61348
24,61349,1,1,0, 61350
8,61351,1,1,1, 61352
1,61356,1,1,0, 61357
6,61360,2,2,1, 61362
7,61362,1,1,1, 61363
24,61364,1,1,1, 61365
8,61366,1,1,1, 61367
9,61367,2,2,1, 61369
2,61368,2,2,1, 61370
25,61370,2,2,1, 61372
1,61371,1,1,0, 61372
15,61371,2,2,1, 61373
6,61375,2,2,1, 61377
7,61377,1,1,0, 61378
24,61379,1,1,0, 61380
7,61392,1,1,0, 61393
24,61394,1,1,1, 61395
25,61400,2,2,1, 61402
7,61407,1,1,0, 61408
24,61409,1,1,0, 61410
6,61420,2,2,1, 61422
7,61422,1,1,0, 61423
24,61424,1,1,1, 61425
25,61430,2,2,1, 61432
7,61437,1,1,1, 61438
24,61439,1,1,1, 61440
6,61450,2,2,1, 61452
7,61452,1,1,0, 61453
24,61454,1,1,1, 61455
25,61460,2,2,1, 61462
6,61465,2,2,1, 61467
7,61467,1,1,0, 61468
24,61469,1,1,1, 61470
7,61482,1,1,0, 61483
24,61484,1,1,1, 61485
8,61486,1,1,1, 61487
16,61489,2,2,1, 61491
25,61490,2,2,1, 61492
1,61491,1,1,0, 61492
15,61491,2,2,1, 61493
7,61497,1,1,0, 61498
24,61499,1,1,1, 61500
8,61501,1,1,1, 61502
9,61502,2,2,1, 61504
16,61504,2,2,1, 61506
15,61506,2,2,1, 61508
7,61512,1,1,1, 61513
24,61514,1,1,1, 61515
16,61519,2,2,1, 61521
7,61527,1,1,0, 61528
24,61529,1,1,1, 61530
16,61534,2,2,1, 61536
15,61536,2,2,1, 61538
7,61542,1,1,1, 61543
24,61544,1,1,0, 61545
7,61557,1,1,1, 61558
24,61559,1,1,1, 61560
6,61570,2,2,1, 61572
7,61572,1,1,1, 61573
24,61574,1,1,0, 61575
7,61587,1,1,0, 61588
24,61589,1,1,0, 61590
7,61602,1,1,0, 61603
24,61604,1,1,1, 61605
8,61606,1,1,0, 61607
1,61611,1,1,0, 61612
6,61615,2,2,1, 61617
7,61617,1,1,0, 61618
24,61619,1,1,1, 61620
8,61621,1,1,1, 61622
25,61625,2,2,1, 61627
1,61626,1,1,1, 61627
7,61632,1,1,1, 61633
24,61634,1,1,1, 61635
8,61636,1,1,1, 61637
25,61640,2,2,1, 61642
1,61641,1,1,0, 61642
7,61647,1,1,1, 61648
24,61649,1,1,0, 61650
8,61651,1,1,1, 61652
16,61654,2,2,1, 61656
1,61656,1,1,0, 61657
7,61662,1,1,1, 61663
24,61664,1,1,1, 61665
8,61666,1,1,0, 61667
25,61670,2,2,1, 61672
1,61671,1,1,0, 61672
6,61675,2,2,1, 61677
7,61677,1,1,0, 61678
24,61679,1,1,1, 61680
8,61681,1,1,1, 61682
25,61685,2,2,1, 61687
1,61686,1,1,1, 61687
6,61690,2,2,1, 61692
7,61692,1,1,0, 61693
24,61694,1,1,1, 61695
8,61696,1,1,0, 61697
25,61700,2,2,1, 61702
1,61701,1,1,0, 61702
7,61707,1,1,0, 61708
24,61709,1,1,0, 61710
8,61711,1,1,1, 61712
1,61716,1,1,0, 61717
6,61720,2,2,1, 61722
7,61722,1,1,1, 61723
24,61724,1,1,1, 61725
8,61726,1,1,0, 61727
25,61730,2,2,1, 61732
1,61731,1,1,0, 61732
7,61737,1,1,0, 61738
24,61739,1,1,1, 61740
8,61741,1,1,1, 61742
1,61746,1,1,0, 61747
7,61752,1,1,0, 61753
24,61754,1,1,0, 61755
8,61756,1,1,1, 61757
1,61761,1,1,0, 61762
6,61765,2,2,1, 61767
7,61767,1,1,0, 61768
24,61769,1,1,1, 61770
8,61771,1,1,1, 61772
1,61776,1,1,1, 61777
6,61780,2,2,1, 61782
7,61782,1,1,1, 61783
24,61784,1,1,1, 61785
8,61786,1,1,0, 61787
1,61791,1,1,1, 61792
7,61797,1,1,0, 61798
24,61799,1,1,1, 61800
8,61801,1,1,1, 61802
1,61806,1,1,0, 61807
7,61812,1,1,1, 61813
24,61814,1,1,1, 61815
8,61816,1,1,0, 61817
1,61821,1,1,1, 61822
6,61825,2,2,1, 61827
7,61827,1,1,1, 61828
24,61829,1,1,1, 61830
8,61831,1,1,0, 61832
16,61834,2,2,1, 61836
1,61836,1,1,1, 61837
7,61842,1,1,1, 61843
24,61844,1,1,1, 61845
8,61846,1,1,1, 61847
9,61847,2,2,1, 61849
1,61851,1,1,1, 61852
15,61851,2,2,1, 61853
7,61857,1,1,1, 61858
24,61859,1,1,1, 61860
2,61863,2,2,1, 61865
1,61866,1,1,0, 61867
15,61866,2,2,1, 61868
7,61872,1,1,0, 61873
24,61874,1,1,1, 61875
7,61887,1,1,1, 61888
24,61889,1,1,0, 61890
7,61902,1,1,0, 61903
24,61904,1,1,1, 61905
6,61915,2,2,1, 61917
7,61917,1,1,0, 61918
24,61919,1,1,0, 61920
6,61930,2,2,1, 61932
7,61932,1,1,1, 61933
24,61934,1,1,0, 61935
6,61945,2,2,1, 61947
7,61947,1,1,1, 61948
24,61949,1,1,1, 61950
7,61962,1,1,0, 61963
24,61964,1,1,1, 61965
8,61966,1,1,1, 61967
6,61975,2,2,1, 61977
7,61977,1,1,1, 61978
24,61979,1,1,1, 61980
8,61981,1,1,0, 61982
25,61985,2,2,1, 61987
1,61986,1,1,0, 61987
15,61986,2,2,1, 61988
6,61990,2,2,1, 61992
7,61992,1,1,1, 61993
24,61994,1,1,0, 61995
8,61996,1,1,1, 61997
25,62000,2,2,1, 62002
1,62001,1,1,0, 62002
15,62001,2,2,1, 62003
7,62007,1,1,1, 62008
24,62009,1,1,1, 62010
8,62011,1,1,1, 62012
9,62012,2,2,1, 62014
2,62013,2,2,1, 62015
1,62016,1,1,0, 62017
6,62020,2,2,1, 62022
7,62022,1,1,0, 62023
24,62024,1,1,0, 62025
8,62026,1,1,1, 62027
9,62027,2,2,1, 62029
1,62031,1,1,1, 62032
15,62031,2,2,1, 62033
6,62035,2,2,1, 62037
7,62037,1,1,0, 62038
24,62039,1,1,1, 62040
8,62041,1,1,0, 62042
9,62042,2,2,1, 62044
7,62052,1,1,0, 62053
24,62054,1,1,1, 62055
8,62056,1,1,0, 62057
6,62065,2,2,1, 62067
7,62067,1,1,1, 62068
24,62069,1,1,0, 62070
8,62071,1,1,0, 62072
9,62072,2,2,1, 62074
6,62080,2,2,1, 62082
7,62082,1,1,1, 62083
24,62084,1,1,0, 62085
8,62086,1,1,1, 62087
9,62087,2,2,1, 62089
16,62089,2,2,1, 62091
6,62095,2,2,1, 62097
7,62097,1,1,0, 62098
24,62099,1,1,0, 62100
16,62104,2,2,1, 62106
7,62112,1,1,0, 62113
24,62114,1,1,0, 62115
6,62125,2,2,1, 62127
7,62127,1,1,1, 62128
24,62129,1,1,1, 62130
16,62134,2,2,1, 62136
6,62140,2,2,1, 62142
7,62142,1,1,1, 62143
24,62144,1,1,1, 62145
15,62151,2,2,1, 62153
7,62157,1,1,1, 62158
24,62159,1,1,0, 62160
8,62161,1,1,0, 62162
7,62172,1,1,1, 62173
24,62174,1,1,1, 62175
8,62176,1,1,1, 62177
7,62187,1,1,0, 62188
24,62189,1,1,1, 62190
8,62191,1,1,0, 62192
16,62194,2,2,1, 62196
6,62200,2,2,1, 62202
7,62202,1,1,1, 62203
24,62204,1,1,0, 62205
8,62206,1,1,1, 62207
9,62207,2,2,1, 62209
16,62209,2,2,1, 62211
1,62211,1,1,0, 62212
6,62215,2,2,1, 62217
7,62217,1,1,0, 62218
24,62219,1,1,0, 62220
9,62222,2,2,1, 62224
1,62226,1,1,1, 62227
6,62230,2,2,1, 62232
7,62232,1,1,0, 62233
24,62234,1,1,0, 62235
9,62237,2,2,1, 62239
25,62240,2,2,1, 62242
1,62241,1,1,1, 62242
6,62245,2,2,1, 62247
7,62247,1,1,1, 62248
24,62249,1,1,0, 62250
1,62256,1,1,1, 62257
6,62260,2,2,1, 62262
7,62262,1,1,0, 62263
24,62264,1,1,0, 62265
9,62267,2,2,1, 62269
25,62270,2,2,1, 62272
1,62271,1,1,0, 62272
15,62271,2,2,1, 62273
7,62277,1,1,0, 62278
24,62279,1,1,1, 62280
25,62285,2,2,1, 62287
15,62286,2,2,1, 62288
6,62290,2,2,1, 62292
7,62292,1,1,1, 62293
24,62294,1,1,0, 62295
25,62300,2,2,1, 62302
15,62301,2,2,1, 62303
6,62305,2,2,1, 62307
7,62307,1,1,0, 62308
24,62309,1,1,1, 62310
15,62316,2,2,1, 62318
6,62320,2,2,1, 62322
7,62322,1,1,1, 62323
24,62324,1,1,1, 62325
25,62330,2,2,1, 62332
15,62331,2,2,1, 62333
6,62335,2,2,1, 62337
7,62337,1,1,1, 62338
24,62339,1,1,0, 62340
16,62344,2,2,1, 62346
7,62352,1,1,0, 62353
24,62354,1,1,1, 62355
7,62367,1,1,1, 62368
24,62369,1,1,0, 62370
16,62374,2,2,1, 62376
6,62380,2,2,1, 62382
7,62382,1,1,1, 62383
24,62384,1,1,1, 62385
8,62386,1,1,1, 62387
7,62397,1,1,0, 62398
24,62399,1,1,0, 62400
8,62401,1,1,1, 62402
1,62406,1,1,1, 62407
6,62410,2,2,1, 62412
7,62412,1,1,1, 62413
24,62414,1,1,0, 62415
8,62416,1,1,0, 62417
2,62418,2,2,1, 62420
1,62421,1,1,1, 62422
7,62427,1,1,0, 62428
24,62429,1,1,0, 62430
8,62431,1,1,0, 62432
1,62436,1,1,0, 62437
6,62440,2,2,1, 62442
7,62442,1,1,1, 62443
24,62444,1,1,0, 62445
8,62446,1,1,1, 62447
9,62447,2,2,1, 62449
2,62448,2,2,1, 62450
1,62451,1,1,1, 62452
7,62457,1,1,0, 62458
24,62459,1,1,1, 62460
8,62461,1,1,1, 62462
25,62465,2,2,1, 62467
6,62470,2,2,1, 62472
7,62472,1,1,0, 62473
24,62474,1,1,0, 62475
8,62476,1,1,0, 62477
9,62477,2,2,1, 62479
7,62487,1,1,1, 62488
24,62489,1,1,1, 62490
8,62491,1,1,0, 62492
9,62492,2,2,1, 62494
6,62500,2,2,1, 62502
7,62502,1,1,0, 62503
24,62504,1,1,0, 62505
8,62506,1,1,0, 62507
7,62517,1,1,0, 62518
24,62519,1,1,1, 62520
8,62521,1,1,0, 62522
9,62522,2,2,1, 62524
16,62524,2,2,1, 62526
15,62526,2,2,1, 62528
7,62532,1,1,0, 62533
24,62534,1,1,1, 62535
8,62536,1,1,1, 62537
15,62541,2,2,1, 62543
7,62547,1,1,0, 62548
24,62549,1,1,1, 62550
8,62551,1,1,1, 62552
9,62552,2,2,1, 62554
6,62560,2,2,1, 62562
7,62562,1,1,1, 62563
24,62564,1,1,1, 62565
8,62566,1,1,1, 62567
1,62571,1,1,0, 62572
15,62571,2,2,1, 62573
7,62577,1,1,0, 62578
24,62579,1,1,0, 62580
2,62583,2,2,1, 62585
1,62586,1,1,1, 62587
7,62592,1,1,0, 62593
24,62594,1,1,1, 62595
1,62601,1,1,0, 62602
7,62607,1,1,0, 62608
24,62609,1,1,1, 62610
1,62616,1,1,1, 62617
7,62622,1,1,1, 62623
24,62624,1,1,1, 62625
16,62629,2,2,1, 62631
1,62631,1,1,0, 62632
6,62635,2,2,1, 62637
7,62637,1,1,0, 62638
24,62639,1,1,1, 62640
16,62644,2,2,1, 62646
1,62646,1,1,0, 62647
15,62646,2,2,1, 62648
7,62652,1,1,0, 62653
24,62654,1,1,1, 62655
2,62658,2,2,1, 62660
16,62659,2,2,1, 62661
25,62660,2,2,1, 62662
1,62661,1,1,1, 62662
7,62667,1,1,0, 62668
24,62669,1,1,0, 62670
1,62676,1,1,0, 62677
7,62682,1,1,0, 62683
24,62684,1,1,1, 62685
8,62686,1,1,0, 62687
9,62687,2,2,1, 62689
2,62688,2,2,1, 62690
1,62691,1,1,1, 62692
6,62695,2,2,1, 62697
7,62697,1,1,1, 62698
24,62699,1,1,0, 62700
8,62701,1,1,0, 62702
9,62702,2,2,1, 62704
6,62710,2,2,1, 62712
7,62712,1,1,0, 62713
24,62714,1,1,0, 62715
8,62716,1,1,1, 62717
9,62717,2,2,1, 62719
7,62727,1,1,0, 62728
24,62729,1,1,0, 62730
8,62731,1,1,0, 62732
9,62732,2,2,1, 62734
7,62742,1,1,0, 62743
24,62744,1,1,1, 62745
8,62746,1,1,0, 62747
9,62747,2,2,1, 62749
6,62755,2,2,1, 62757
7,62757,1,1,0, 62758
24,62759,1,1,1, 62760
8,62761,1,1,0, 62762
9,62762,2,2,1, 62764
15,62766,2,2,1, 62768
7,62772,1,1,1, 62773
24,62774,1,1,1, 62775
8,62776,1,1,1, 62777
9,62777,2,2,1, 62779
6,62785,2,2,1, 62787
7,62787,1,1,1, 62788
24,62789,1,1,1, 62790
8,62791,1,1,0, 62792
15,62796,2,2,1, 62798
6,62800,2,2,1, 62802
7,62802,1,1,0, 62803
24,62804,1,1,0, 62805
8,62806,1,1,1, 62807
9,62807,2,2,1, 62809
16,62809,2,2,1, 62811
1,62811,1,1,1, 62812
6,62815,2,2,1, 62817
7,62817,1,1,1, 62818
24,62819,1,1,1, 62820
25,62825,2,2,1, 62827
1,62826,1,1,1, 62827
6,62830,2,2,1, 62832
7,62832,1,1,0, 62833
24,62834,1,1,1, 62835
1,62841,1,1,0, 62842
7,62847,1,1,1, 62848
24,62849,1,1,0, 62850
25,62855,2,2,1, 62857
1,62856,1,1,0, 62857
6,62860,2,2,1, 62862
7,62862,1,1,0, 62863
24,62864,1,1,1, 62865
1,62871,1,1,0, 62872
6,62875,2,2,1, 62877
7,62877,1,1,1, 62878
24,62879,1,1,1, 62880
16,62884,2,2,1, 62886
1,62886,1,1,1, 62887
6,62890,2,2,1, 62892
7,62892,1,1,1, 62893
24,62894,1,1,1, 62895
25,62900,2,2,1, 62902
1,62901,1,1,0, 62902
6,62905,2,2,1, 62907
7,62907,1,1,0, 62908
24,62909,1,1,1, 62910
16,62914,2,2,1, 62916
1,62916,1,1,0, 62917
6,62920,2,2,1, 62922
7,62922,1,1,1, 62923
24,62924,1,1,0, 62925
9,62927,2,2,1, 62929
2,62928,2,2,1, 62930
16,62929,2,2,1, 62931
25,62930,2,2,1, 62932
1,62931,1,1,0, 62932
15,62931,2,2,1, 62933
6,62935,2,2,1, 62937
7,62937,1,1,0, 62938
24,62939,1,1,0, 62940
8,62941,1,1,0, 62942
6,62950,2,2,1, 62952
7,62952,1,1,1, 62953
24,62954,1,1,1, 62955
8,62956,1,1,0, 62957
7,62967,1,1,1, 62968
24,62969,1,1,0, 62970
8,62971,1,1,0, 62972
7,62982,1,1,1, 62983
24,62984,1,1,0, 62985
8,62986,1,1,1, 62987
6,62995,2,2,1, 62997
7,62997,1,1,1, 62998
24,62999,1,1,0, 63000
8,63001,1,1,0, 63002
7,63012,1,1,1, 63013
24,63014,1,1,0, 63015
8,63016,1,1,0, 63017
7,63027,1,1,0, 63028
24,63029,1,1,1, 63030
8,63031,1,1,0, 63032
6,63040,2,2,1, 63042
7,63042,1,1,1, 63043
24,63044,1,1,1, 63045
8,63046,1,1,1, 63047
16,63049,2,2,1, 63051
1,63051,1,1,1, 63052
15,63051,2,2,1, 63053
6,63055,2,2,1, 63057
7,63057,1,1,0, 63058
24,63059,1,1,0, 63060
16,63064,2,2,1, 63066
1,63066,1,1,1, 63067
6,63070,2,2,1, 63072
7,63072,1,1,0, 63073
24,63074,1,1,1, 63075
16,63079,2,2,1, 63081
1,63081,1,1,1, 63082
15,63081,2,2,1, 63083
6,63085,2,2,1, 63087
7,63087,1,1,0, 63088
24,63089,1,1,0, 63090
1,63096,1,1,0, 63097
7,63102,1,1,1, 63103
24,63104,1,1,1, 63105
1,63111,1,1,0, 63112
7,63117,1,1,1, 63118
24,63119,1,1,1, 63120
1,63126,1,1,1, 63127
7,63132,1,1,1, 63133
24,63134,1,1,0, 63135
1,63141,1,1,1, 63142
15,63141,2,2,1, 63143
6,63145,2,2,1, 63147
7,63147,1,1,0, 63148
24,63149,1,1,0, 63150
1,63156,1,1,0, 63157
15,63156,2,2,1, 63158
6,63160,2,2,1, 63162
7,63162,1,1,1, 63163
24,63164,1,1,0, 63165
8,63166,1,1,0, 63167
2,63168,2,2,1, 63170
16,63169,2,2,1, 63171
1,63171,1,1,1, 63172
6,63175,2,2,1, 63177
7,63177,1,1,0, 63178
24,63179,1,1,0, 63180
8,63181,1,1,1, 63182
25,63185,2,2,1, 63187
7,63192,1,1,0, 63193
24,63194,1,1,1, 63195
8,63196,1,1,0, 63197
6,63205,2,2,1, 63207
7,63207,1,1,1, 63208
24,63209,1,1,1, 63210
8,63211,1,1,0, 63212
9,63212,2,2,1, 63214
7,63222,1,1,1, 63223
24,63224,1,1,0, 63225
8,63226,1,1,0, 63227
25,63230,2,2,1, 63232
6,63235,2,2,1, 63237
7,63237,1,1,0, 63238
24,63239,1,1,1, 63240
8,63241,1,1,0, 63242
25,63245,2,2,1, 63247
7,63252,1,1,1, 63253
24,63254,1,1,1, 63255
8,63256,1,1,1, 63257
25,63260,2,2,1, 63262
6,63265,2,2,1, 63267
7,63267,1,1,0, 63268
24,63269,1,1,0, 63270
8,63271,1,1,0, 63272
9,63272,2,2,1, 63274
25,63275,2,2,1, 63277
7,63282,1,1,1, 63283
24,63284,1,1,0, 63285
8,63286,1,1,1, 63287
9,63287,2,2,1, 63289
25,63290,2,2,1, 63292
1,63291,1,1,1, 63292
7,63297,1,1,0, 63298
24,63299,1,1,0, 63300
16,63304,2,2,1, 63306
1,63306,1,1,1, 63307
7,63312,1,1,1, 63313
24,63314,1,1,1, 63315
1,63321,1,1,0, 63322
15,63321,2,2,1, 63323
6,63325,2,2,1, 63327
7,63327,1,1,1, 63328
24,63329,1,1,1, 63330
1,63336,1,1,1, 63337
7,63342,1,1,1, 63343
24,63344,1,1,0, 63345
16,63349,2,2,1, 63351
1,63351,1,1,0, 63352
15,63351,2,2,1, 63353
6,63355,2,2,1, 63357
7,63357,1,1,1, 63358
24,63359,1,1,1, 63360
1,63366,1,1,0, 63367
15,63366,2,2,1, 63368
6,63370,2,2,1, 63372
7,63372,1,1,1, 63373
24,63374,1,1,1, 63375
16,63379,2,2,1, 63381
1,63381,1,1,1, 63382
15,63381,2,2,1, 63383
6,63385,2,2,1, 63387
7,63387,1,1,0, 63388
24,63389,1,1,0, 63390
16,63394,2,2,1, 63396
1,63396,1,1,0, 63397
7,63402,1,1,0, 63403
24,63404,1,1,0, 63405
8,63406,1,1,0, 63407
16,63409,2,2,1, 63411
25,63410,2,2,1, 63412
1,63411,1,1,0, 63412
6,63415,2,2,1, 63417
7,63417,1,1,0, 63418
24,63419,1,1,1, 63420
8,63421,1,1,0, 63422
9,63422,2,2,1, 63424
16,63424,2,2,1, 63426
1,63426,1,1,1, 63427
7,63432,1,1,1, 63433
24,63434,1,1,1, 63435
8,63436,1,1,1, 63437
1,63441,1,1,0, 63442
7,63447,1,1,0, 63448
24,63449,1,1,1, 63450
8,63451,1,1,1, 63452
9,63452,2,2,1, 63454
1,63456,1,1,1, 63457
6,63460,2,2,1, 63462
7,63462,1,1,0, 63463
24,63464,1,1,0, 63465
8,63466,1,1,0, 63467
9,63467,2,2,1, 63469
16,63469,2,2,1, 63471
1,63471,1,1,1, 63472
6,63475,2,2,1, 63477
7,63477,1,1,1, 63478
24,63479,1,1,1, 63480
16,63484,2,2,1, 63486
1,63486,1,1,0, 63487
6,63490,2,2,1, 63492
7,63492,1,1,1, 63493
24,63494,1,1,0, 63495
16,63499,2,2,1, 63501
1,63501,1,1,0, 63502
6,63505,2,2,1, 63507
7,63507,1,1,1, 63508
24,63509,1,1,1, 63510
16,63514,2,2,1, 63516
1,63516,1,1,1, 63517
6,63520,2,2,1, 63522
7,63522,1,1,0, 63523
24,63524,1,1,0, 63525
2,63528,2,2,1, 63530
16,63529,2,2,1, 63531
1,63531,1,1,1, 63532
7,63537,1,1,1, 63538
24,63539,1,1,1, 63540
8,63541,1,1,0, 63542
2,63543,2,2,1, 63545
1,63546,1,1,0, 63547
15,63546,2,2,1, 63548
6,63550,2,2,1, 63552
7,63552,1,1,1, 63553
24,63554,1,1,0, 63555
8,63556,1,1,0, 63557
25,63560,2,2,1, 63562
1,63561,1,1,0, 63562
7,63567,1,1,0, 63568
24,63569,1,1,0, 63570
8,63571,1,1,0, 63572
25,63575,2,2,1, 63577
1,63576,1,1,0, 63577
6,63580,2,2,1, 63582
7,63582,1,1,0, 63583
24,63584,1,1,0, 63585
8,63586,1,1,0, 63587
1,63591,1,1,0, 63592
7,63597,1,1,1, 63598
24,63599,1,1,1, 63600
8,63601,1,1,0, 63602
9,63602,2,2,1, 63604
1,63606,1,1,1, 63607
15,63606,2,2,1, 63608
6,63610,2,2,1, 63612
7,63612,1,1,0, 63613
24,63614,1,1,1, 63615
8,63616,1,1,0, 63617
9,63617,2,2,1, 63619
1,63621,1,1,0, 63622
7,63627,1,1,1, 63628
24,63629,1,1,0, 63630
8,63631,1,1,1, 63632
1,63636,1,1,1, 63637
7,63642,1,1,1, 63643
24,63644,1,1,0, 63645
8,63646,1,1,0, 63647
9,63647,2,2,1, 63649
1,63651,1,1,1, 63652
15,63651,2,2,1, 63653
7,63657,1,1,1, 63658
24,63659,1,1,1, 63660
1,63666,1,1,0, 63667
7,63672,1,1,1, 63673
24,63674,1,1,1, 63675
16,63679,2,2,1, 63681
1,63681,1,1,0, 63682
7,63687,1,1,0, 63688
24,63689,1,1,0, 63690
1,63696,1,1,0, 63697
7,63702,1,1,0, 63703
24,63704,1,1,1, 63705
2,63708,2,2,1, 63710
1,63711,1,1,0, 63712
6,63715,2,2,1, 63717
7,63717,1,1,1, 63718
24,63719,1,1,0, 63720
16,63724,2,2,1, 63726
25,63725,2,2,1, 63727
6,63730,2,2,1, 63732
7,63732,1,1,0, 63733
24,63734,1,1,1, 63735
16,63739,2,2,1, 63741
25,63740,2,2,1, 63742
6,63745,2,2,1, 63747
7,63747,1,1,0, 63748
24,63749,1,1,0, 63750
7,63762,1,1,0, 63763
24,63764,1,1,1, 63765
8,63766,1,1,1, 63767
9,63767,2,2,1, 63769
16,63769,2,2,1, 63771
25,63770,2,2,1, 63772
6,63775,2,2,1, 63777
7,63777,1,1,1, 63778
24,63779,1,1,0, 63780
8,63781,1,1,1, 63782
6,63790,2,2,1, 63792
7,63792,1,1,1, 63793
24,63794,1,1,1, 63795
8,63796,1,1,0, 63797
16,63799,2,2,1, 63801
7,63807,1,1,0, 63808
24,63809,1,1,1, 63810
8,63811,1,1,1, 63812
6,63820,2,2,1, 63822
7,63822,1,1,0, 63823
24,63824,1,1,1, 63825
8,63826,1,1,1, 63827
9,63827,2,2,1, 63829
1,63831,1,1,0, 63832
6,63835,2,2,1, 63837
7,63837,1,1,0, 63838
24,63839,1,1,0, 63840
2,63843,2,2,1, 63845
1,63846,1,1,1, 63847
7,63852,1,1,1, 63853
24,63854,1,1,1, 63855
1,63861,1,1,0, 63862
7,63867,1,1,1, 63868
24,63869,1,1,0, 63870
1,63876,1,1,0, 63877
6,63880,2,2,1, 63882
7,63882,1,1,0, 63883
24,63884,1,1,1, 63885
2,63888,2,2,1, 63890
1,63891,1,1,0, 63892
6,63895,2,2,1, 63897
7,63897,1,1,1, 63898
24,63899,1,1,0, 63900
8,63901,1,1,1, 63902
1,63906,1,1,1, 63907
15,63906,2,2,1, 63908
6,63910,2,2,1, 63912
7,63912,1,1,1, 63913
24,63914,1,1,1, 63915
8,63916,1,1,0, 63917
2,63918,2,2,1, 63920
16,63919,2,2,1, 63921
1,63921,1,1,1, 63922
15,63921,2,2,1, 63923
6,63925,2,2,1, 63927
7,63927,1,1,0, 63928
24,63929,1,1,0, 63930
8,63931,1,1,1, 63932
2,63933,2,2,1, 63935
16,63934,2,2,1, 63936
1,63936,1,1,1, 63937
7,63942,1,1,1, 63943
24,63944,1,1,0, 63945
8,63946,1,1,1, 63947
16,63949,2,2,1, 63951
1,63951,1,1,1, 63952
15,63951,2,2,1, 63953
7,63957,1,1,1, 63958
24,63959,1,1,1, 63960
9,63962,2,2,1, 63964
25,63965,2,2,1, 63967
1,63966,1,1,0, 63967
15,63966,2,2,1, 63968
7,63972,1,1,1, 63973
24,63974,1,1,1, 63975
1,63981,1,1,0, 63982
15,63981,2,2,1, 63983
7,63987,1,1,0, 63988
24,63989,1,1,1, 63990
9,63992,2,2,1, 63994
25,63995,2,2,1, 63997
1,63996,1,1,0, 63997
15,63996,2,2,1, 63998
6,64000,2,2,1, 64002
7,64002,1,1,1, 64003
24,64004,1,1,1, 64005
1,64011,1,1,1, 64012
6,64015,2,2,1, 64017
7,64017,1,1,0, 64018
24,64019,1,1,0, 64020
9,64022,2,2,1, 64024
1,64026,1,1,1, 64027
24,64034,1,1,0, 64035
9,64037,2,2,1, 64039
1,64041,1,1,0, 64042
24,64049,1,1,1, 64050
1,64056,1,1,1, 64057
24,64064,1,1,1, 64065
16,64069,2,2,1, 64071
1,64071,1,1,0, 64072
24,64079,1,1,0, 64080
8,64081,1,1,1, 64082
1,64086,1,1,0, 64087
24,64094,1,1,1, 64095
8,64096,1,1,0, 64097
16,64099,2,2,1, 64101
1,64101,1,1,1, 64102
24,64109,1,1,0, 64110
8,64111,1,1,1, 64112
9,64112,2,2,1, 64114
1,64116,1,1,1, 64117
24,64124,1,1,1, 64125
8,64126,1,1,0, 64127
9,64127,2,2,1, 64129
25,64130,2,2,1, 64132
1,64131,1,1,0, 64132
6,64135,2,2,1, 64137
7,64137,1,1,1, 64138
24,64139,1,1,1, 64140
25,64145,2,2,1, 64147
7,64152,1,1,1, 64153
24,64154,1,1,0, 64155
7,64167,1,1,0, 64168
24,64169,1,1,0, 64170
6,64180,2,2,1, 64182
7,64182,1,1,1, 64183
24,64184,1,1,1, 64185
6,64195,2,2,1, 64197
7,64197,1,1,0, 64198
24,64199,1,1,0, 64200
7,64212,1,1,1, 64213
24,64214,1,1,0, 64215
25,64220,2,2,1, 64222
6,64225,2,2,1, 64227
7,64227,1,1,1, 64228
24,64229,1,1,0, 64230
25,64235,2,2,1, 64237
7,64242,1,1,0, 64243
24,64244,1,1,1, 64245
8,64246,1,1,1, 64247
9,64247,2,2,1, 64249
2,64248,2,2,1, 64250
25,64250,2,2,1, 64252
1,64251,1,1,0, 64252
7,64257,1,1,1, 64258
24,64259,1,1,0, 64260
8,64261,1,1,0, 64262
1,64266,1,1,1, 64267
6,64270,2,2,1, 64272
7,64272,1,1,1, 64273
24,64274,1,1,0, 64275
8,64276,1,1,1, 64277
1,64281,1,1,1, 64282
15,64281,2,2,1, 64283
6,64285,2,2,1, 64287
7,64287,1,1,0, 64288
24,64289,1,1,0, 64290
8,64291,1,1,1, 64292
1,64296,1,1,1, 64297
15,64296,2,2,1, 64298
7,64302,1,1,1, 64303
24,64304,1,1,1, 64305
8,64306,1,1,1, 64307
1,64311,1,1,1, 64312
7,64317,1,1,0, 64318
24,64319,1,1,1, 64320
8,64321,1,1,0, 64322
16,64324,2,2,1, 64326
1,64326,1,1,0, 64327
7,64332,1,1,0, 64333
24,64334,1,1,1, 64335
8,64336,1,1,1, 64337
1,64341,1,1,0, 64342
7,64347,1,1,1, 64348
24,64349,1,1,0, 64350
8,64351,1,1,0, 64352
1,64356,1,1,1, 64357
7,64362,1,1,0, 64363
24,64364,1,1,0, 64365
8,64366,1,1,0, 64367
25,64370,2,2,1, 64372
1,64371,1,1,0, 64372
7,64377,1,1,0, 64378
24,64379,1,1,0, 64380
25,64385,2,2,1, 64387
1,64386,1,1,1, 64387
15,64386,2,2,1, 64388
7,64392,1,1,0, 64393
24,64394,1,1,1, 64395
9,64397,2,2,1, 64399
1,64401,1,1,1, 64402
7,64407,1,1,1, 64408
24,64409,1,1,1, 64410
9,64412,2,2,1, 64414
25,64415,2,2,1, 64417
1,64416,1,1,1, 64417
6,64420,2,2,1, 64422
7,64422,1,1,1, 64423
24,64424,1,1,1, 64425
25,64430,2,2,1, 64432
1,64431,1,1,1, 64432
15,64431,2,2,1, 64433
7,64437,1,1,0, 64438
24,64439,1,1,1, 64440
6,64450,2,2,1, 64452
7,64452,1,1,1, 64453
24,64454,1,1,0, 64455
6,64465,2,2,1, 64467
7,64467,1,1,0, 64468
24,64469,1,1,1, 64470
6,64480,2,2,1, 64482
7,64482,1,1,0, 64483
24,64484,1,1,1, 64485
8,64486,1,1,1, 64487
9,64487,2,2,1, 64489
16,64489,2,2,1, 64491
6,64495,2,2,1, 64497
7,64497,1,1,0, 64498
24,64499,1,1,0, 64500
8,64501,1,1,1, 64502
25,64505,2,2,1, 64507
1,64506,1,1,1, 64507
7,64512,1,1,1, 64513
24,64514,1,1,0, 64515
8,64516,1,1,0, 64517
16,64519,2,2,1, 64521
1,64521,1,1,1, 64522
7,64527,1,1,0, 64528
24,64529,1,1,1, 64530
8,64531,1,1,0, 64532
2,64533,2,2,1, 64535
1,64536,1,1,0, 64537
6,64540,2,2,1, 64542
7,64542,1,1,0, 64543
24,64544,1,1,0, 64545
8,64546,1,1,0, 64547
2,64548,2,2,1, 64550
1,64551,1,1,0, 64552
7,64557,1,1,1, 64558
24,64559,1,1,0, 64560
8,64561,1,1,0, 64562
1,64566,1,1,1, 64567
7,64572,1,1,0, 64573
24,64574,1,1,0, 64575
8,64576,1,1,1, 64577
16,64579,2,2,1, 64581
1,64581,1,1,0, 64582
7,64587,1,1,0, 64588
24,64589,1,1,1, 64590
8,64591,1,1,1, 64592
16,64594,2,2,1, 64596
1,64596,1,1,0, 64597
7,64602,1,1,0, 64603
24,64604,1,1,1, 64605
8,64606,1,1,1, 64607
16,64609,2,2,1, 64611
1,64611,1,1,0, 64612
6,64615,2,2,1, 64617
7,64617,1,1,1, 64618
24,64619,1,1,1, 64620
1,64626,1,1,0, 64627
6,64630,2,2,1, 64632
7,64632,1,1,0, 64633
24,64634,1,1,1, 64635
9,64637,2,2,1, 64639
2,64638,2,2,1, 64640
1,64641,1,1,1, 64642
15,64641,2,2,1, 64643
7,64647,1,1,1, 64648
24,64649,1,1,0, 64650
9,64652,2,2,1, 64654
1,64656,1,1,1, 64657
15,64656,2,2,1, 64658
7,64662,1,1,0, 64663
24,64664,1,1,0, 64665
9,64667,2,2,1, 64669
1,64671,1,1,0, 64672
15,64671,2,2,1, 64673
7,64677,1,1,1, 64678
24,64679,1,1,1, 64680
16,64684,2,2,1, 64686
25,64685,2,2,1, 64687
6,64690,2,2,1, 64692
7,64692,1,1,1, 64693
24,64694,1,1,0, 64695
7,64707,1,1,0, 64708
24,64709,1,1,1, 64710
16,64714,2,2,1, 64716
25,64715,2,2,1, 64717
7,64722,1,1,0, 64723
24,64724,1,1,1, 64725
8,64726,1,1,1, 64727
6,64735,2,2,1, 64737
7,64737,1,1,0, 64738
24,64739,1,1,0, 64740
8,64741,1,1,1, 64742
25,64745,2,2,1, 64747
6,64750,2,2,1, 64752
7,64752,1,1,1, 64753
24,64754,1,1,1, 64755
8,64756,1,1,1, 64757
9,64757,2,2,1, 64759
25,64760,2,2,1, 64762
6,64765,2,2,1, 64767
7,64767,1,1,1, 64768
24,64769,1,1,0, 64770
8,64771,1,1,0, 64772
25,64775,2,2,1, 64777
6,64780,2,2,1, 64782
7,64782,1,1,1, 64783
24,64784,1,1,0, 64785
8,64786,1,1,1, 64787
1,64791,1,1,1, 64792
15,64791,2,2,1, 64793
6,64795,2,2,1, 64797
7,64797,1,1,0, 64798
24,64799,1,1,1, 64800
8,64801,1,1,1, 64802
2,64803,2,2,1, 64805
1,64806,1,1,1, 64807
7,64812,1,1,0, 64813
24,64814,1,1,0, 64815
8,64816,1,1,0, 64817
9,64817,2,2,1, 64819
2,64818,2,2,1, 64820
16,64819,2,2,1, 64821
1,64821,1,1,1, 64822
6,64825,2,2,1, 64827
7,64827,1,1,1, 64828
24,64829,1,1,1, 64830
8,64831,1,1,1, 64832
16,64834,2,2,1, 64836
1,64836,1,1,0, 64837
7,64842,1,1,1, 64843
24,64844,1,1,1, 64845
8,64846,1,1,0, 64847
1,64851,1,1,0, 64852
6,64855,2,2,1, 64857
7,64857,1,1,0, 64858
24,64859,1,1,1, 64860
1,64866,1,1,0, 64867
7,64872,1,1,0, 64873
24,64874,1,1,0, 64875
1,64881,1,1,1, 64882
6,64885,2,2,1, 64887
7,64887,1,1,0, 64888
24,64889,1,1,0, 64890
1,64896,1,1,0, 64897
6,64900,2,2,1, 64902
7,64902,1,1,0, 64903
24,64904,1,1,0, 64905
1,64911,1,1,1, 64912
7,64917,1,1,1, 64918
24,64919,1,1,1, 64920
1,64926,1,1,1, 64927
7,64932,1,1,0, 64933
24,64934,1,1,1, 64935
1,64941,1,1,0, 64942
7,64947,1,1,1, 64948
24,64949,1,1,0, 64950
2,64953,2,2,1, 64955
1,64956,1,1,0, 64957
7,64962,1,1,0, 64963
24,64964,1,1,0, 64965
8,64966,1,1,0, 64967
9,64967,2,2,1, 64969
1,64971,1,1,0, 64972
7,64977,1,1,1, 64978
24,64979,1,1,0, 64980
8,64981,1,1,0, 64982
9,64982,2,2,1, 64984
6,64990,2,2,1, 64992
7,64992,1,1,0, 64993
24,64994,1,1,1, 64995
7,65007,1,1,1, 65008
24,65009,1,1,0, 65010
7,65022,1,1,1, 65023
24,65024,1,1,0, 65025
7,65037,1,1,0, 65038
24,65039,1,1,0, 65040
7,65052,1,1,1, 65053
24,65054,1,1,0, 65055
6,65065,2,2,1, 65067
7,65067,1,1,0, 65068
24,65069,1,1,0, 65070
7,65082,1,1,0, 65083
24,65084,1,1,1, 65085
8,65086,1,1,1, 65087
9,65087,2,2,1, 65089
16,65089,2,2,1, 65091
1,65091,1,1,0, 65092
7,65097,1,1,0, 65098
24,65099,1,1,0, 65100
8,65101,1,1,0, 65102
25,65105,2,2,1, 65107
1,65106,1,1,0, 65107
7,65112,1,1,0, 65113
24,65114,1,1,1, 65115
16,65119,2,2,1, 65121
1,65121,1,1,1, 65122
6,65125,2,2,1, 65127
7,65127,1,1,0, 65128
24,65129,1,1,1, 65130
25,65135,2,2,1, 65137
1,65136,1,1,0, 65137
6,65140,2,2,1, 65142
7,65142,1,1,1, 65143
24,65144,1,1,0, 65145
2,65148,2,2,1, 65150
16,65149,2,2,1, 65151
1,65151,1,1,1, 65152
7,65157,1,1,1, 65158
24,65159,1,1,0, 65160
8,65161,1,1,0, 65162
2,65163,2,2,1, 65165
1,65166,1,1,0, 65167
7,65172,1,1,1, 65173
24,65174,1,1,0, 65175
8,65176,1,1,0, 65177
2,65178,2,2,1, 65180
1,65181,1,1,1, 65182
6,65185,2,2,1, 65187
7,65187,1,1,1, 65188
24,65189,1,1,1, 65190
8,65191,1,1,1, 65192
2,65193,2,2,1, 65195
1,65196,1,1,1, 65197
6,65200,2,2,1, 65202
7,65202,1,1,1, 65203
24,65204,1,1,1, 65205
8,65206,1,1,0, 65207
1,65211,1,1,1, 65212
6,65215,2,2,1, 65217
7,65217,1,1,0, 65218
24,65219,1,1,1, 65220
7,65232,1,1,0, 65233
24,65234,1,1,0, 65235
7,65247,1,1,0, 65248
24,65249,1,1,1, 65250
7,65262,1,1,1, 65263
24,65264,1,1,1, 65265
7,65277,1,1,1, 65278
24,65279,1,1,1, 65280
7,65292,1,1,1, 65293
24,65294,1,1,1, 65295
6,65305,2,2,1, 65307
7,65307,1,1,0, 65308
24,65309,1,1,0, 65310
6,65320,2,2,1, 65322
7,65322,1,1,0, 65323
24,65324,1,1,0, 65325
8,65326,1,1,1, 65327
9,65327,2,2,1, 65329
16,65329,2,2,1, 65331
1,65331,1,1,1, 65332
15,65331,2,2,1, 65333
6,65335,2,2,1, 65337
7,65337,1,1,0, 65338
24,65339,1,1,1, 65340
8,65341,1,1,1, 65342
2,65343,2,2,1, 65345
1,65346,1,1,0, 65347
6,65350,2,2,1, 65352
7,65352,1,1,0, 65353
24,65354,1,1,0, 65355
9,65357,2,2,1, 65359
2,65358,2,2,1, 65360
25,65360,2,2,1, 65362
1,65361,1,1,1, 65362
6,65365,2,2,1, 65367
7,65367,1,1,0, 65368
24,65369,1,1,0, 65370
2,65373,2,2,1, 65375
1,65376,1,1,0, 65377
7,65382,1,1,0, 65383
24,65384,1,1,0, 65385
9,65387,2,2,1, 65389
1,65391,1,1,1, 65392
6,65395,2,2,1, 65397
7,65397,1,1,0, 65398
24,65399,1,1,1, 65400
7,65412,1,1,0, 65413
24,65414,1,1,1, 65415
7,65427,1,1,1, 65428
24,65429,1,1,1, 65430
7,65442,1,1,1, 65443
24,65444,1,1,1, 65445
15,65451,2,2,1, 65453
6,65455,2,2,1, 65457
7,65457,1,1,1, 65458
24,65459,1,1,1, 65460
8,65461,1,1,1, 65462
7,65472,1,1,1, 65473
24,65474,1,1,0, 65475
8,65476,1,1,1, 65477
9,65477,2,2,1, 65479
15,65481,2,2,1, 65483
6,65485,2,2,1, 65487
7,65487,1,1,0, 65488
24,65489,1,1,0, 65490
8,65491,1,1,0, 65492
9,65492,2,2,1, 65494
25,65495,2,2,1, 65497
7,65502,1,1,1, 65503
24,65504,1,1,0, 65505
8,65506,1,1,0, 65507
9,65507,2,2,1, 65509
1,65511,1,1,1, 65512
6,65515,2,2,1, 65517
7,65517,1,1,0, 65518
24,65519,1,1,1, 65520
8,65521,1,1,1, 65522
1,65526,1,1,1, 65527
6,65530,2,2,1, 65532
7,65532,1,1,0, 65533
24,65534,1,1,0, 65535
8,65536,1,1,1, 65537
2,65538,2,2,1, 65540
1,65541,1,1,0, 65542
7,65547,1,1,0, 65548
24,65549,1,1,0, 65550
8,65551,1,1,1, 65552
2,65553,2,2,1, 65555
25,65555,2,2,1, 65557
1,65556,1,1,1, 65557
7,65562,1,1,0, 65563
24,65564,1,1,1, 65565
8,65566,1,1,1, 65567
2,65568,2,2,1, 65570
1,65571,1,1,1, 65572
6,65575,2,2,1, 65577
7,65577,1,1,0, 65578
24,65579,1,1,1, 65580
8,65581,1,1,0, 65582
16,65584,2,2,1, 65586
7,65592,1,1,1, 65593
24,65594,1,1,0, 65595
8,65596,1,1,0, 65597
16,65599,2,2,1, 65601
7,65607,1,1,1, 65608
24,65609,1,1,0, 65610
8,65611,1,1,0, 65612
6,65620,2,2,1, 65622
7,65622,1,1,0, 65623
24,65624,1,1,0, 65625
8,65626,1,1,0, 65627
7,65637,1,1,1, 65638
24,65639,1,1,0, 65640
8,65641,1,1,1, 65642
16,65644,2,2,1, 65646
7,65652,1,1,1, 65653
24,65654,1,1,0, 65655
8,65656,1,1,1, 65657
6,65665,2,2,1, 65667
7,65667,1,1,0, 65668
24,65669,1,1,1, 65670
8,65671,1,1,1, 65672
6,65680,2,2,1, 65682
7,65682,1,1,1, 65683
24,65684,1,1,0, 65685
8,65686,1,1,0, 65687
1,65691,1,1,1, 65692
15,65691,2,2,1, 65693
7,65697,1,1,0, 65698
24,65699,1,1,1, 65700
1,65706,1,1,0, 65707
15,65706,2,2,1, 65708
6,65710,2,2,1, 65712
7,65712,1,1,1, 65713
24,65714,1,1,1, 65715
9,65717,2,2,1, 65719
2,65718,2,2,1, 65720
1,65721,1,1,1, 65722
15,65721,2,2,1, 65723
7,65727,1,1,1, 65728
24,65729,1,1,1, 65730
2,65733,2,2,1, 65735
1,65736,1,1,0, 65737
15,65736,2,2,1, 65738
6,65740,2,2,1, 65742
7,65742,1,1,1, 65743
24,65744,1,1,0, 65745
1,65751,1,1,1, 65752
15,65751,2,2,1, 65753
7,65757,1,1,0, 65758
24,65759,1,1,1, 65760
9,65762,2,2,1, 65764
1,65766,1,1,0, 65767
6,65770,2,2,1, 65772
7,65772,1,1,0, 65773
24,65774,1,1,0, 65775
9,65777,2,2,1, 65779
1,65781,1,1,0, 65782
15,65781,2,2,1, 65783
6,65785,2,2,1, 65787
7,65787,1,1,1, 65788
24,65789,1,1,0, 65790
1,65796,1,1,1, 65797
6,65800,2,2,1, 65802
7,65802,1,1,0, 65803
24,65804,1,1,1, 65805
8,65806,1,1,1, 65807
1,65811,1,1,0, 65812
15,65811,2,2,1, 65813
6,65815,2,2,1, 65817
7,65817,1,1,1, 65818
24,65819,1,1,0, 65820
8,65821,1,1,1, 65822
16,65824,2,2,1, 65826
1,65826,1,1,1, 65827
24,65834,1,1,1, 65835
8,65836,1,1,1, 65837
9,65837,2,2,1, 65839
16,65839,2,2,1, 65841
1,65841,1,1,1, 65842
24,65849,1,1,1, 65850
8,65851,1,1,0, 65852
1,65856,1,1,0, 65857
24,65864,1,1,0, 65865
8,65866,1,1,0, 65867
9,65867,2,2,1, 65869
2,65868,2,2,1, 65870
16,65869,2,2,1, 65871
1,65871,1,1,1, 65872
24,65879,1,1,0, 65880
24,65894,1,1,1, 65895
24,65909,1,1,0, 65910
24,65924,1,1,0, 65925
7,65937,1,1,1, 65938
24,65939,1,1,0, 65940
25,65945,2,2,1, 65947
15,65946,2,2,1, 65948
7,65952,1,1,1, 65953
24,65954,1,1,1, 65955
15,65961,2,2,1, 65963
7,65967,1,1,0, 65968
24,65969,1,1,1, 65970
15,65976,2,2,1, 65978
6,65980,2,2,1, 65982
7,65982,1,1,0, 65983
24,65984,1,1,0, 65985
2,65988,2,2,1, 65990
1,65991,1,1,1, 65992
7,65997,1,1,0, 65998
24,65999,1,1,0, 66000
1,66006,1,1,1, 66007
6,66010,2,2,1, 66012
7,66012,1,1,0, 66013
24,66014,1,1,0, 66015
9,66017,2,2,1, 66019
1,66021,1,1,1, 66022
7,66027,1,1,1, 66028
24,66029,1,1,1, 66030
9,66032,2,2,1, 66034
1,66036,1,1,0, 66037
7,66042,1,1,1, 66043
24,66044,1,1,0, 66045
8,66046,1,1,1, 66047
9,66047,2,2,1, 66049
1,66051,1,1,1, 66052
7,66057,1,1,1, 66058
24,66059,1,1,1, 66060
8,66061,1,1,1, 66062
16,66064,2,2,1, 66066
1,66066,1,1,0, 66067
6,66070,2,2,1, 66072
7,66072,1,1,0, 66073
24,66074,1,1,0, 66075
8,66076,1,1,1, 66077
1,66081,1,1,1, 66082
6,66085,2,2,1, 66087
7,66087,1,1,1, 66088
24,66089,1,1,0, 66090
8,66091,1,1,1, 66092
1,66096,1,1,1, 66097
6,66100,2,2,1, 66102
7,66102,1,1,1, 66103
24,66104,1,1,1, 66105
8,66106,1,1,0, 66107
16,66109,2,2,1, 66111
1,66111,1,1,0, 66112
6,66115,2,2,1, 66117
7,66117,1,1,0, 66118
24,66119,1,1,1, 66120
8,66121,1,1,1, 66122
1,66126,1,1,1, 66127
6,66130,2,2,1, 66132
7,66132,1,1,1, 66133
24,66134,1,1,0, 66135
8,66136,1,1,0, 66137
2,66138,2,2,1, 66140
1,66141,1,1,1, 66142
7,66147,1,1,0, 66148
24,66149,1,1,1, 66150
8,66151,1,1,0, 66152
2,66153,2,2,1, 66155
1,66156,1,1,0, 66157
7,66162,1,1,1, 66163
24,66164,1,1,0, 66165
8,66166,1,1,1, 66167
16,66169,2,2,1, 66171
25,66170,2,2,0, 66172
1,66171,1,1,0, 66172
6,66175,2,2,1, 66177
7,66177,1,1,1, 66178
24,66179,1,1,1, 66180
25,66185,2,2,0, 66187
7,66192,1,1,1, 66193
24,66194,1,1,0, 66195
25,66200,2,2,0, 66202
6,66205,2,2,1, 66207
7,66207,1,1,1, 66208
24,66209,1,1,0, 66210
25,66215,2,2,1, 66217
15,66216,2,2,1, 66218
6,66220,2,2,1, 66222
7,66222,1,1,0, 66223
24,66224,1,1,1, 66225
25,66230,2,2,0, 66232
7,66237,1,1,1, 66238
24,66239,1,1,1, 66240
25,66245,2,2,0, 66247
6,66250,2,2,1, 66252
7,66252,1,1,1, 66253
24,66254,1,1,0, 66255
25,66260,2,2,1, 66262
6,66265,2,2,1, 66267
7,66267,1,1,0, 66268
24,66269,1,1,0, 66270
25,66275,2,2,1, 66277
7,66282,1,1,1, 66283
24,66284,1,1,0, 66285
8,66286,1,1,1, 66287
9,66287,2,2,1, 66289
16,66289,2,2,1, 66291
25,66290,2,2,1, 66292
1,66291,1,1,0, 66292
6,66295,2,2,1, 66297
7,66297,1,1,1, 66298
24,66299,1,1,0, 66300
8,66301,1,1,0, 66302
1,66306,1,1,0, 66307
7,66312,1,1,1, 66313
24,66314,1,1,0, 66315
8,66316,1,1,1, 66317
9,66317,2,2,1, 66319
16,66319,2,2,1, 66321
1,66321,1,1,1, 66322
7,66327,1,1,1, 66328
24,66329,1,1,0, 66330
8,66331,1,1,0, 66332
1,66336,1,1,1, 66337
15,66336,2,2,1, 66338
7,66342,1,1,0, 66343
24,66344,1,1,0, 66345
8,66346,1,1,1, 66347
9,66347,2,2,1, 66349
1,66351,1,1,0, 66352
7,66357,1,1,0, 66358
24,66359,1,1,0, 66360
16,66364,2,2,0, 66366
1,66366,1,1,0, 66367
7,66372,1,1,0, 66373
24,66374,1,1,1, 66375
9,66377,2,2,1, 66379
16,66379,2,2,0, 66381
1,66381,1,1,1, 66382
6,66385,2,2,1, 66387
7,66387,1,1,0, 66388
24,66389,1,1,1, 66390
9,66392,2,2,1, 66394
2,66393,2,2,1, 66395
16,66394,2,2,0, 66396
1,66396,1,1,0, 66397
6,66400,2,2,1, 66402
7,66402,1,1,1, 66403
24,66404,1,1,0, 66405
16,66409,2,2,1, 66411
25,66410,2,2,0, 66412
1,66411,1,1,1, 66412
7,66417,1,1,1, 66418
24,66419,1,1,1, 66420
16,66424,2,2,0, 66426
25,66425,2,2,0, 66427
6,66430,2,2,1, 66432
7,66432,1,1,1, 66433
24,66434,1,1,0, 66435
16,66439,2,2,1, 66441
25,66440,2,2,1, 66442
6,66445,2,2,1, 66447
7,66447,1,1,0, 66448
24,66449,1,1,0, 66450
16,66454,2,2,0, 66456
25,66455,2,2,0, 66457
7,66462,1,1,1, 66463
24,66464,1,1,1, 66465
8,66466,1,1,0, 66467
25,66470,2,2,1, 66472
6,66475,2,2,1, 66477
7,66477,1,1,1, 66478
24,66479,1,1,0, 66480
8,66481,1,1,1, 66482
6,66490,2,2,1, 66492
7,66492,1,1,0, 66493
24,66494,1,1,1, 66495
8,66496,1,1,0, 66497
6,66505,2,2,1, 66507
7,66507,1,1,1, 66508
24,66509,1,1,0, 66510
8,66511,1,1,1, 66512
6,66520,2,2,1, 66522
7,66522,1,1,0, 66523
24,66524,1,1,1, 66525
8,66526,1,1,0, 66527
2,66528,2,2,1, 66530
1,66531,1,1,1, 66532
7,66537,1,1,1, 66538
24,66539,1,1,0, 66540
8,66541,1,1,0, 66542
9,66542,2,2,1, 66544
2,66543,2,2,1, 66545
1,66546,1,1,1, 66547
6,66550,2,2,1, 66552
7,66552,1,1,1, 66553
24,66554,1,1,0, 66555
8,66556,1,1,0, 66557
1,66561,1,1,1, 66562
7,66567,1,1,0, 66568
24,66569,1,1,0, 66570
8,66571,1,1,1, 66572
1,66576,1,1,0, 66577
7,66582,1,1,0, 66583
24,66584,1,1,0, 66585
8,66586,1,1,0, 66587
9,66587,2,2,1, 66589
16,66589,2,2,1, 66591
25,66590,2,2,1, 66592
1,66591,1,1,0, 66592
7,66597,1,1,1, 66598
24,66599,1,1,0, 66600
8,66601,1,1,1, 66602
25,66605,2,2,1, 66607
1,66606,1,1,0, 66607
15,66606,2,2,1, 66608
7,66612,1,1,0, 66613
24,66614,1,1,1, 66615
8,66616,1,1,1, 66617
16,66619,2,2,1, 66621
25,66620,2,2,0, 66622
1,66621,1,1,0, 66622
7,66627,1,1,0, 66628
24,66629,1,1,0, 66630
8,66631,1,1,1, 66632
9,66632,2,2,1, 66634
25,66635,2,2,1, 66637
1,66636,1,1,1, 66637
6,66640,2,2,1, 66642
7,66642,1,1,1, 66643
24,66644,1,1,0, 66645
8,66646,1,1,0, 66647
16,66649,2,2,1, 66651
25,66650,2,2,1, 66652
1,66651,1,1,1, 66652
15,66651,2,2,1, 66653
6,66655,2,2,1, 66657
7,66657,1,1,0, 66658
24,66659,1,1,1, 66660
8,66661,1,1,1, 66662
2,66663,2,2,1, 66665
16,66664,2,2,1, 66666
25,66665,2,2,0, 66667
1,66666,1,1,0, 66667
6,66670,2,2,1, 66672
7,66672,1,1,0, 66673
24,66674,1,1,0, 66675
9,66677,2,2,1, 66679
16,66679,2,2,0, 66681
25,66680,2,2,0, 66682
1,66681,1,1,0, 66682
7,66687,1,1,0, 66688
24,66689,1,1,0, 66690
9,66692,2,2,1, 66694
2,66693,2,2,1, 66695
16,66694,2,2,0, 66696
25,66695,2,2,0, 66697
1,66696,1,1,0, 66697
6,66700,2,2,1, 66702
7,66702,1,1,1, 66703
24,66704,1,1,1, 66705
16,66709,2,2,1, 66711
25,66710,2,2,0, 66712
6,66715,2,2,1, 66717
7,66717,1,1,1, 66718
24,66719,1,1,1, 66720
7,66732,1,1,0, 66733
24,66734,1,1,1, 66735
6,66745,2,2,1, 66747
7,66747,1,1,1, 66748
24,66749,1,1,0, 66750
6,66760,2,2,1, 66762
7,66762,1,1,0, 66763
24,66764,1,1,1, 66765
6,66775,2,2,1, 66777
7,66777,1,1,1, 66778
24,66779,1,1,0, 66780
7,66792,1,1,1, 66793
24,66794,1,1,1, 66795
6,66805,2,2,1, 66807
7,66807,1,1,1, 66808
24,66809,1,1,0, 66810
9,66812,2,2,1, 66814
1,66816,1,1,0, 66817
6,66820,2,2,1, 66822
7,66822,1,1,1, 66823
24,66824,1,1,0, 66825
8,66826,1,1,0, 66827
16,66829,2,2,1, 66831
25,66830,2,2,0, 66832
1,66831,1,1,0, 66832
15,66831,2,2,1, 66833
7,66837,1,1,1, 66838
24,66839,1,1,1, 66840
8,66841,1,1,0, 66842
16,66844,2,2,1, 66846
25,66845,2,2,0, 66847
1,66846,1,1,0, 66847
7,66852,1,1,0, 66853
24,66854,1,1,0, 66855
8,66856,1,1,1, 66857
16,66859,2,2,0, 66861
25,66860,2,2,0, 66862
1,66861,1,1,1, 66862
6,66865,2,2,1, 66867
7,66867,1,1,0, 66868
24,66869,1,1,1, 66870
8,66871,1,1,0, 66872
2,66873,2,2,1, 66875
16,66874,2,2,0, 66876
25,66875,2,2,0, 66877
1,66876,1,1,1, 66877
7,66882,1,1,0, 66883
24,66884,1,1,1, 66885
8,66886,1,1,0, 66887
2,66888,2,2,1, 66890
16,66889,2,2,1, 66891
25,66890,2,2,0, 66892
1,66891,1,1,0, 66892
7,66897,1,1,1, 66898
24,66899,1,1,1, 66900
8,66901,1,1,0, 66902
25,66905,2,2,1, 66907
1,66906,1,1,1, 66907
6,66910,2,2,1, 66912
7,66912,1,1,1, 66913
24,66914,1,1,0, 66915
8,66916,1,1,0, 66917
1,66921,1,1,1, 66922
6,66925,2,2,1, 66927
7,66927,1,1,0, 66928
24,66929,1,1,0, 66930
8,66931,1,1,0, 66932
9,66932,2,2,1, 66934
2,66933,2,2,1, 66935
1,66936,1,1,1, 66937
7,66942,1,1,0, 66943
24,66944,1,1,0, 66945
8,66946,1,1,1, 66947
2,66948,2,2,1, 66950
1,66951,1,1,0, 66952
7,66957,1,1,1, 66958
24,66959,1,1,0, 66960
8,66961,1,1,1, 66962
9,66962,2,2,1, 66964
7,66972,1,1,0, 66973
24,66974,1,1,1, 66975
8,66976,1,1,0, 66977
9,66977,2,2,1, 66979
25,66980,2,2,1, 66982
7,66987,1,1,1, 66988
24,66989,1,1,1, 66990
8,66991,1,1,0, 66992
6,67000,2,2,1, 67002
7,67002,1,1,0, 67003
24,67004,1,1,1, 67005
8,67006,1,1,1, 67007
9,67007,2,2,1, 67009
25,67010,2,2,1, 67012
7,67017,1,1,0, 67018
24,67019,1,1,0, 67020
8,67021,1,1,1, 67022
9,67022,2,2,1, 67024
25,67025,2,2,1, 67027
7,67032,1,1,0, 67033
24,67034,1,1,0, 67035
8,67036,1,1,0, 67037
9,67037,2,2,1, 67039
6,67045,2,2,1, 67047
7,67047,1,1,0, 67048
24,67049,1,1,0, 67050
8,67051,1,1,1, 67052
9,67052,2,2,1, 67054
7,67062,1,1,1, 67063
24,67064,1,1,0, 67065
8,67066,1,1,1, 67067
9,67067,2,2,1, 67069
1,67071,1,1,0, 67072
15,67071,2,2,1, 67073
6,67075,2,2,1, 67077
7,67077,1,1,1, 67078
24,67079,1,1,0, 67080
1,67086,1,1,1, 67087
7,67092,1,1,0, 67093
24,67094,1,1,1, 67095
9,67097,2,2,1, 67099
25,67100,2,2,1, 67102
1,67101,1,1,0, 67102
7,67107,1,1,1, 67108
24,67109,1,1,0, 67110
25,67115,2,2,1, 67117
1,67116,1,1,1, 67117
7,67122,1,1,1, 67123
24,67124,1,1,0, 67125
1,67131,1,1,0, 67132
6,67135,2,2,1, 67137
7,67137,1,1,0, 67138
24,67139,1,1,1, 67140
1,67146,1,1,0, 67147
6,67150,2,2,1, 67152
7,67152,1,1,1, 67153
24,67154,1,1,0, 67155
9,67157,2,2,1, 67159
1,67161,1,1,0, 67162
15,67161,2,2,1, 67163
7,67167,1,1,0, 67168
24,67169,1,1,0, 67170
9,67172,2,2,1, 67174
1,67176,1,1,1, 67177
6,67180,2,2,1, 67182
7,67182,1,1,1, 67183
24,67184,1,1,1, 67185
8,67186,1,1,1, 67187
25,67190,2,2,1, 67192
1,67191,1,1,0, 67192
6,67195,2,2,1, 67197
7,67197,1,1,0, 67198
24,67199,1,1,1, 67200
8,67201,1,1,0, 67202
6,67210,2,2,1, 67212
7,67212,1,1,1, 67213
24,67214,1,1,1, 67215
8,67216,1,1,1, 67217
7,67227,1,1,1, 67228
24,67229,1,1,0, 67230
8,67231,1,1,1, 67232
9,67232,2,2,1, 67234
25,67235,2,2,1, 67237
7,67242,1,1,1, 67243
24,67244,1,1,0, 67245
8,67246,1,1,0, 67247
6,67255,2,2,1, 67257
7,67257,1,1,0, 67258
24,67259,1,1,1, 67260
8,67261,1,1,0, 67262
25,67265,2,2,1, 67267
7,67272,1,1,0, 67273
24,67274,1,1,1, 67275
8,67276,1,1,0, 67277
9,67277,2,2,1, 67279
6,67285,2,2,1, 67287
7,67287,1,1,1, 67288
24,67289,1,1,0, 67290
8,67291,1,1,1, 67292
9,67292,2,2,1, 67294
6,67300,2,2,1, 67302
7,67302,1,1,0, 67303
24,67304,1,1,0, 67305
8,67306,1,1,0, 67307
9,67307,2,2,1, 67309
25,67310,2,2,1, 67312
1,67311,1,1,1, 67312
15,67311,2,2,1, 67313
7,67317,1,1,1, 67318
24,67319,1,1,0, 67320
8,67321,1,1,0, 67322
9,67322,2,2,1, 67324
1,67326,1,1,0, 67327
15,67326,2,2,1, 67328
7,67332,1,1,1, 67333
24,67334,1,1,0, 67335
8,67336,1,1,0, 67337
25,67340,2,2,1, 67342
1,67341,1,1,0, 67342
6,67345,2,2,1, 67347
7,67347,1,1,1, 67348
24,67349,1,1,0, 67350
8,67351,1,1,0, 67352
9,67352,2,2,1, 67354
1,67356,1,1,0, 67357
15,67356,2,2,1, 67358
7,67362,1,1,1, 67363
24,67364,1,1,0, 67365
8,67366,1,1,1, 67367
1,67371,1,1,1, 67372
15,67371,2,2,1, 67373
6,67375,2,2,1, 67377
7,67377,1,1,1, 67378
24,67379,1,1,0, 67380
8,67381,1,1,1, 67382
1,67386,1,1,0, 67387
7,67392,1,1,1, 67393
24,67394,1,1,1, 67395
8,67396,1,1,0, 67397
9,67397,2,2,1, 67399
1,67401,1,1,1, 67402
6,67405,2,2,1, 67407
7,67407,1,1,0, 67408
8,67411,1,1,0, 67412
1,67416,1,1,1, 67417
7,67422,1,1,1, 67423
8,67426,1,1,0, 67427
9,67427,2,2,1, 67429
1,67431,1,1,0, 67432
7,67437,1,1,1, 67438
2,67443,2,2,1, 67445
6,67450,2,2,1, 67452
7,67452,1,1,1, 67453
6,67465,2,2,1, 67467
7,67467,1,1,1, 67468
7,67482,1,1,1, 67483
6,67495,2,2,1, 67497
7,67497,1,1,0, 67498
6,67510,2,2,1, 67512
7,67512,1,1,1, 67513
6,67525,2,2,1, 67527
7,67527,1,1,1, 67528
6,67540,2,2,1, 67542
7,67542,1,1,0, 67543
8,67546,1,1,1, 67547
1,67551,1,1,1, 67552
15,67551,2,2,1, 67553
7,67557,1,1,1, 67558
8,67561,1,1,0, 67562
25,67565,2,2,1, 67567
1,67566,1,1,0, 67567
15,67566,2,2,1, 67568
6,67570,2,2,1, 67572
7,67572,1,1,0, 67573
8,67576,1,1,1, 67577
25,67580,2,2,1, 67582
1,67581,1,1,1, 67582
15,67581,2,2,1, 67583
7,67587,1,1,1, 67588
8,67591,1,1,1, 67592
2,67593,2,2,1, 67595
25,67595,2,2,1, 67597
1,67596,1,1,0, 67597
7,67602,1,1,1, 67603
8,67606,1,1,1, 67607
9,67607,2,2,1, 67609
2,67608,2,2,1, 67610
25,67610,2,2,1, 67612
1,67611,1,1,0, 67612
15,67611,2,2,1, 67613
6,67615,2,2,1, 67617
7,67617,1,1,1, 67618
8,67621,1,1,0, 67622
9,67622,2,2,1, 67624
2,67623,2,2,1, 67625
1,67626,1,1,0, 67627
15,67626,2,2,1, 67628
7,67632,1,1,0, 67633
8,67636,1,1,1, 67637
2,67638,2,2,1, 67640
1,67641,1,1,0, 67642
15,67641,2,2,1, 67643
6,67645,2,2,1, 67647
7,67647,1,1,1, 67648
8,67651,1,1,0, 67652
2,67653,2,2,1, 67655
1,67656,1,1,1, 67657
7,67662,1,1,0, 67663
8,67666,1,1,1, 67667
25,67670,2,2,1, 67672
1,67671,1,1,0, 67672
6,67675,2,2,1, 67677
7,67677,1,1,1, 67678
8,67681,1,1,1, 67682
7,67692,1,1,0, 67693
8,67696,1,1,0, 67697
9,67697,2,2,1, 67699
6,67705,2,2,1, 67707
7,67707,1,1,1, 67708
8,67711,1,1,1, 67712
6,67720,2,2,1, 67722
7,67722,1,1,1, 67723
8,67726,1,1,0, 67727
6,67735,2,2,1, 67737
7,67737,1,1,0, 67738
8,67741,1,1,1, 67742
6,67750,2,2,1, 67752
7,67752,1,1,0, 67753
8,67756,1,1,1, 67757
6,67765,2,2,1, 67767
7,67767,1,1,0, 67768
8,67771,1,1,0, 67772
6,67780,2,2,1, 67782
7,67782,1,1,0, 67783
8,67786,1,1,1, 67787
9,67787,2,2,1, 67789
1,67791,1,1,0, 67792
6,67795,2,2,1, 67797
7,67797,1,1,0, 67798
8,67801,1,1,1, 67802
9,67802,2,2,1, 67804
1,67806,1,1,0, 67807
7,67812,1,1,0, 67813
8,67816,1,1,0, 67817
9,67817,2,2,1, 67819
25,67820,2,2,1, 67822
1,67821,1,1,1, 67822
15,67821,2,2,1, 67823
7,67827,1,1,0, 67828
8,67831,1,1,1, 67832
25,67835,2,2,1, 67837
1,67836,1,1,0, 67837
15,67836,2,2,1, 67838
7,67842,1,1,0, 67843
8,67846,1,1,1, 67847
25,67850,2,2,1, 67852
1,67851,1,1,0, 67852
15,67851,2,2,1, 67853
6,67855,2,2,1, 67857
7,67857,1,1,0, 67858
8,67861,1,1,0, 67862
2,67863,2,2,1, 67865
6,67870,2,2,1, 67872
7,67872,1,1,1, 67873
8,67876,1,1,0, 67877
7,67887,1,1,0, 67888
8,67891,1,1,1, 67892
6,67900,2,2,1, 67902
7,67902,1,1,0, 67903
8,67906,1,1,1, 67907
7,67917,1,1,0, 67918
8,67921,1,1,1, 67922
8,67936,1,1,0, 67937
8,67951,1,1,0, 67952
8,67966,1,1,0, 67967
9,67967,2,2,1, 67969
25,67970,2,2,1, 67972
1,67971,1,1,1, 67972
8,67981,1,1,1, 67982
9,67982,2,2,1, 67984
2,67983,2,2,1, 67985
1,67986,1,1,0, 67987
8,67996,1,1,0, 67997
9,67997,2,2,1, 67999
2,67998,2,2,1, 68000
1,68001,1,1,0, 68002
8,68011,1,1,0, 68012
1,68016,1,1,1, 68017
7,68022,1,1,0, 68023
8,68026,1,1,0, 68027
1,68031,1,1,1, 68032
6,68035,2,2,1, 68037
7,68037,1,1,0, 68038
8,68041,1,1,0, 68042
9,68042,2,2,1, 68044
1,68046,1,1,0, 68047
7,68052,1,1,0, 68053
1,68061,1,1,0, 68062
7,68067,1,1,1, 68068
9,68072,2,2,1, 68074
1,68076,1,1,1, 68077
6,68080,2,2,1, 68082
7,68082,1,1,1, 68083
9,68087,2,2,1, 68089
1,68091,1,1,1, 68092
15,68091,2,2,1, 68093
6,68095,2,2,1, 68097
7,68097,1,1,0, 68098
1,68106,1,1,1, 68107
15,68106,2,2,1, 68108
7,68112,1,1,0, 68113
2,68118,2,2,1, 68120
25,68120,2,2,1, 68122
1,68121,1,1,0, 68122
7,68127,1,1,0, 68128
1,68136,1,1,1, 68137
7,68142,1,1,0, 68143
25,68150,2,2,1, 68152
1,68151,1,1,0, 68152
6,68155,2,2,1, 68157
7,68157,1,1,1, 68158
8,68161,1,1,1, 68162
25,68165,2,2,1, 68167
1,68166,1,1,1, 68167
7,68172,1,1,0, 68173
8,68176,1,1,1, 68177
1,68181,1,1,1, 68182
7,68187,1,1,0, 68188
8,68191,1,1,0, 68192
1,68196,1,1,0, 68197
7,68202,1,1,0, 68203
8,68206,1,1,0, 68207
25,68210,2,2,1, 68212
1,68211,1,1,0, 68212
6,68215,2,2,1, 68217
7,68217,1,1,1, 68218
8,68221,1,1,1, 68222
2,68223,2,2,1, 68225
1,68226,1,1,0, 68227
15,68226,2,2,1, 68228
7,68232,1,1,1, 68233
8,68236,1,1,1, 68237
2,68238,2,2,1, 68240
1,68241,1,1,1, 68242
6,68245,2,2,1, 68247
7,68247,1,1,0, 68248
8,68251,1,1,0, 68252
2,68253,2,2,1, 68255
25,68255,2,2,1, 68257
1,68256,1,1,0, 68257
6,68260,2,2,1, 68262
7,68262,1,1,0, 68263
8,68266,1,1,1, 68267
1,68271,1,1,0, 68272
15,68271,2,2,1, 68273
7,68277,1,1,0, 68278
8,68281,1,1,1, 68282
1,68286,1,1,0, 68287
15,68286,2,2,1, 68288
6,68290,2,2,1, 68292
7,68292,1,1,0, 68293
8,68296,1,1,0, 68297
25,68300,2,2,1, 68302
1,68301,1,1,1, 68302
7,68307,1,1,1, 68308
8,68311,1,1,0, 68312
1,68316,1,1,1, 68317
7,68322,1,1,1, 68323
8,68326,1,1,1, 68327
25,68330,2,2,1, 68332
1,68331,1,1,1, 68332
7,68337,1,1,0, 68338
8,68341,1,1,0, 68342
1,68346,1,1,1, 68347
7,68352,1,1,0, 68353
8,68356,1,1,1, 68357
1,68361,1,1,1, 68362
7,68367,1,1,0, 68368
8,68371,1,1,1, 68372
1,68376,1,1,1, 68377
7,68382,1,1,0, 68383
8,68386,1,1,1, 68387
2,68388,2,2,1, 68390
25,68390,2,2,1, 68392
1,68391,1,1,0, 68392
8,68401,1,1,0, 68402
2,68403,2,2,1, 68405
1,68406,1,1,1, 68407
8,68416,1,1,1, 68417
1,68421,1,1,1, 68422
8,68431,1,1,1, 68432
2,68433,2,2,1, 68435
1,68436,1,1,0, 68437
8,68446,1,1,0, 68447
25,68450,2,2,1, 68452
1,68451,1,1,1, 68452
8,68461,1,1,1, 68462
1,68466,1,1,0, 68467
8,68476,1,1,1, 68477
1,68481,1,1,0, 68482
8,68491,1,1,1, 68492
2,68493,2,2,1, 68495
25,68495,2,2,1, 68497
1,68496,1,1,0, 68497
8,68506,1,1,1, 68507
1,68511,1,1,1, 68512
8,68521,1,1,0, 68522
1,68526,1,1,0, 68527
8,68536,1,1,1, 68537
25,68540,2,2,1, 68542
1,68541,1,1,0, 68542
8,68551,1,1,0, 68552
25,68555,2,2,1, 68557
1,68556,1,1,1, 68557
8,68566,1,1,1, 68567
1,68571,1,1,0, 68572
8,68581,1,1,1, 68582
25,68585,2,2,1, 68587
1,68586,1,1,1, 68587
8,68596,1,1,1, 68597
1,68601,1,1,0, 68602
8,68611,1,1,0, 68612
25,68615,2,2,1, 68617
1,68616,1,1,0, 68617
8,68626,1,1,0, 68627
1,68631,1,1,1, 68632
8,68641,1,1,0, 68642
25,68645,2,2,1, 68647
1,68646,1,1,0, 68647
8,68656,1,1,1, 68657
1,68661,1,1,0, 68662
8,68671,1,1,1, 68672
2,68673,2,2,1, 68675
1,68676,1,1,1, 68677
8,68686,1,1,0, 68687
2,68688,2,2,1, 68690
25,68690,2,2,1, 68692
1,68691,1,1,0, 68692
8,68701,1,1,1, 68702
8,68716,1,1,0, 68717
8,68731,1,1,0, 68732
8,68746,1,1,1, 68747
8,68761,1,1,0, 68762
8,68776,1,1,0, 68777
15,68781,2,2,1, 68783
8,68791,1,1,1, 68792
8,68806,1,1,0, 68807
1,68811,1,1,0, 68812
8,68821,1,1,1, 68822
2,68823,2,2,1, 68825
25,68825,2,2,1, 68827
1,68826,1,1,0, 68827
8,68836,1,1,0, 68837
2,68838,2,2,1, 68840
1,68841,1,1,0, 68842
8,68851,1,1,1, 68852
25,68855,2,2,1, 68857
1,68856,1,1,0, 68857
8,68866,1,1,0, 68867
25,68870,2,2,1, 68872
1,68871,1,1,0, 68872
8,68881,1,1,0, 68882
2,68883,2,2,1, 68885
1,68886,1,1,1, 68887
8,68896,1,1,0, 68897
1,68901,1,1,1, 68902
15,68901,2,2,1, 68903
8,68911,1,1,0, 68912
25,68915,2,2,1, 68917
1,68916,1,1,1, 68917
8,68926,1,1,0, 68927
1,68931,1,1,0, 68932
8,68941,1,1,0, 68942
25,68945,2,2,1, 68947
1,68946,1,1,0, 68947
8,68956,1,1,0, 68957
1,68961,1,1,0, 68962
8,68971,1,1,0, 68972
8,68986,1,1,0, 68987
8,69001,1,1,0, 69002
8,69016,1,1,0, 69017
8,69031,1,1,0, 69032
8,69046,1,1,1, 69047
8,69061,1,1,1, 69062
8,69076,1,1,1, 69077
8,69091,1,1,0, 69092
8,69106,1,1,1, 69107
15,69111,2,2,1, 69113
8,69121,1,1,1, 69122
15,69126,2,2,0, 69128
8,69136,1,1,0, 69137
8,69151,1,1,0, 69152
8,69166,1,1,0, 69167
8,69181,1,1,0, 69182
8,69196,1,1,1, 69197
8,69211,1,1,1, 69212
8,69226,1,1,1, 69227
8,69241,1,1,0, 69242
15,69246,2,2,0, 69248
8,69256,1,1,0, 69257
15,69261,2,2,0, 69263
8,69271,1,1,1, 69272
15,69276,2,2,1, 69278
8,69286,1,1,0, 69287
15,69291,2,2,0, 69293
8,69301,1,1,1, 69302
8,69316,1,1,1, 69317
8,69331,1,1,0, 69332
8,69346,1,1,0, 69347
8,69361,1,1,1, 69362
8,69376,1,1,0, 69377
8,69391,1,1,1, 69392
8,69406,1,1,1, 69407
15,69411,2,2,1, 69413
8,69421,1,1,1, 69422
15,69426,2,2,0, 69428
8,69436,1,1,0, 69437
15,69441,2,2,0, 69443
8,69451,1,1,1, 69452
8,69466,1,1,0, 69467
8,69481,1,1,1, 69482
8,69496,1,1,1, 69497
8,69511,1,1,1, 69512
8,69526,1,1,0, 69527
8,69541,1,1,1, 69542
8,69556,1,1,0, 69557
15,69561,2,2,0, 69563
8,69571,1,1,1, 69572
15,69576,2,2,1, 69578
8,69586,1,1,1, 69587
15,69591,2,2,0, 69593
8,69601,1,1,1, 69602
8,69616,1,1,0, 69617
8,69631,1,1,1, 69632
8,69646,1,1,1, 69647
8,69661,1,1,0, 69662
8,69676,1,1,0, 69677
8,69691,1,1,1, 69692
8,69706,1,1,1, 69707
15,69711,2,2,1, 69713
8,69721,1,1,1, 69722
15,69726,2,2,0, 69728
8,69736,1,1,1, 69737
8,69751,1,1,0, 69752
8,69766,1,1,1, 69767
8,69781,1,1,0, 69782
8,69796,1,1,0, 69797
8,69811,1,1,0, 69812
8,69826,1,1,0, 69827
8,69841,1,1,1, 69842
15,69846,2,2,0, 69848
8,69856,1,1,0, 69857
15,69861,2,2,0, 69863
8,69871,1,1,0, 69872
15,69876,2,2,1, 69878
8,69886,1,1,0, 69887
8,69901,1,1,1, 69902
8,69916,1,1,0, 69917
8,69931,1,1,0, 69932
8,69946,1,1,1, 69947
8,69961,1,1,1, 69962
8,69976,1,1,1, 69977
8,69991,1,1,0, 69992
15,69996,2,2,0, 69998
8,70006,1,1,1, 70007
15,70011,2,2,1, 70013
8,70021,1,1,1, 70022
15,70026,2,2,1, 70028
8,70036,1,1,0, 70037
15,70041,2,2,0, 70043
8,70051,1,1,0, 70052
8,70066,1,1,0, 70067
8,70081,1,1,0, 70082
8,70096,1,1,1, 70097
8,70111,1,1,0, 70112
8,70126,1,1,1, 70127
8,70141,1,1,0, 70142
8,70156,1,1,0, 70157
15,70161,2,2,1, 70163
8,70171,1,1,1, 70172
15,70176,2,2,1, 70178
8,70186,1,1,1, 70187
15,70191,2,2,1, 70193
8,70201,1,1,0, 70202
15,70206,2,2,1, 70208
8,70216,1,1,0, 70217
8,70231,1,1,1, 70232
