Time,  Packets Generated,  Packets Reached,High Priority Packets Generated, High Priority Packets reached, Packet Dropped, Packet Dropped due to Faulty Node, High Prio Packet Dropped due to Faulty Node, Low Prio Packet Dropped due to Faulty Node 
5,1,1,1,1,0,0,0,0
10,6,4,5,3,2,2,2,0
15,8,4,6,3,3,3,3,0
20,16,8,10,4,4,4,4,0
25,20,14,11,7,5,5,4,1
30,30,22,16,10,8,8,6,2
35,36,22,19,10,11,11,8,3
40,47,29,23,13,14,14,9,5
45,51,35,27,16,15,15,10,5
50,61,43,30,19,18,18,11,7
55,67,43,32,19,21,21,13,8
60,78,50,36,21,24,24,14,10
65,82,56,37,22,24,24,14,10
70,92,65,43,27,25,25,14,11
75,98,68,44,29,27,27,15,12
80,109,76,50,32,28,28,16,12
85,113,83,54,36,28,28,16,12
90,123,92,59,42,29,29,17,12
95,129,95,63,43,31,31,18,13
100,140,103,68,47,32,32,19,13
105,144,110,70,50,32,32,19,13
110,154,119,75,55,33,33,20,13
115,160,122,79,56,35,35,22,13
120,171,130,85,60,36,36,22,14
125,175,136,88,64,37,36,22,14
130,185,143,94,71,41,37,23,14
135,191,145,95,71,44,39,23,16
140,202,149,101,74,49,40,23,17
145,206,154,104,79,50,40,23,17
150,216,161,107,83,54,41,23,18
155,222,163,110,84,56,43,24,19
160,233,168,113,86,61,44,25,19
165,237,174,115,89,61,44,25,19
170,247,181,120,93,65,45,26,19
175,253,183,123,94,68,47,27,20
180,264,189,131,99,70,48,27,21
185,268,195,132,104,71,48,27,21
190,278,202,137,109,74,49,27,22
195,284,205,138,110,77,51,27,24
200,295,210,144,114,80,52,28,24
205,299,215,145,116,83,52,28,24
210,309,222,151,121,86,53,29,24
215,315,224,156,123,88,55,30,25
220,326,230,161,128,91,56,31,25
225,330,235,163,129,94,56,31,25
230,340,238,170,132,101,57,32,25
235,346,240,172,133,105,59,33,26
240,357,243,177,134,110,60,34,26
245,361,246,178,137,115,60,34,26
250,371,248,183,138,122,61,34,27
255,377,250,186,140,127,63,36,27
260,388,253,193,142,131,64,36,28
265,392,256,194,145,136,64,36,28
270,402,259,200,148,142,65,37,28
275,408,260,200,148,148,67,37,30
280,419,262,205,150,154,68,38,30
285,423,264,206,151,159,68,38,30
290,433,267,210,154,165,69,38,31
295,439,268,212,154,170,71,39,32
300,450,271,218,156,176,72,40,32
305,454,274,221,158,180,72,40,32
310,464,276,223,159,187,73,41,32
315,470,277,225,159,193,75,42,33
320,481,280,227,160,198,76,42,34
325,485,282,228,161,203,76,42,34
330,495,286,231,163,208,77,43,34
335,501,287,234,164,212,79,43,36
340,512,292,241,169,216,80,44,36
345,516,296,242,172,219,80,44,36
350,526,300,245,174,224,81,44,37
355,532,303,247,176,227,83,44,39
360,543,309,252,181,231,84,44,40
365,547,313,253,184,234,84,44,40
370,557,316,255,185,239,85,44,41
375,563,318,257,186,244,87,45,42
380,574,321,261,188,249,88,45,43
385,578,323,264,190,254,88,45,43
390,588,326,270,192,261,89,46,43
395,594,328,274,194,265,91,47,44
400,605,333,281,199,268,92,47,45
405,609,335,283,201,273,92,47,45
410,619,338,286,202,280,93,48,45
415,625,339,290,203,284,95,49,46
420,636,342,296,205,289,96,49,47
425,640,347,297,210,293,96,49,47
430,650,350,302,212,299,97,49,48
435,656,352,306,213,302,99,50,49
440,667,356,312,217,309,100,51,49
445,671,359,315,219,311,100,51,49
450,681,363,322,222,317,101,51,50
455,687,365,325,223,321,103,52,51
460,698,370,333,228,325,104,52,52
465,702,372,335,230,329,104,52,52
470,712,375,340,231,336,105,53,52
475,718,377,344,233,340,107,55,52
480,729,381,350,236,345,108,55,53
485,733,383,353,237,350,108,55,53
490,743,384,357,238,358,109,55,54
495,749,385,360,239,363,111,56,55
500,760,386,365,240,371,112,56,56
505,764,387,368,240,376,112,56,56
510,774,388,374,241,385,113,56,57
515,780,389,375,241,391,115,56,59
520,791,390,380,241,399,116,57,59
525,795,391,381,242,404,116,57,59
530,805,392,384,242,412,117,57,60
535,811,393,385,242,418,119,58,61
540,822,394,389,242,426,120,58,62
545,826,395,390,243,431,120,58,62
550,836,396,392,243,439,121,59,62
555,842,397,396,243,444,123,61,62
560,853,398,401,244,452,124,61,63
565,857,399,402,244,458,124,61,63
570,867,400,407,244,466,125,61,64
575,873,401,410,245,472,127,61,66
580,884,402,417,245,479,128,62,66
585,888,403,418,246,485,128,62,66
590,898,407,422,249,490,129,62,67
595,904,408,425,250,496,131,63,68
600,915,411,431,252,501,132,64,68
605,919,414,433,255,505,132,64,68
610,929,416,437,256,512,133,64,69
615,935,417,440,257,517,135,65,70
620,946,421,446,261,522,136,66,70
625,950,424,448,264,526,136,66,70
630,960,427,454,266,532,137,66,71
635,966,429,458,268,537,139,68,71
640,977,432,461,270,542,140,68,72
645,981,433,462,270,548,140,68,72
650,991,436,467,272,554,141,69,72
655,997,437,471,272,559,143,71,72
660,1008,442,478,276,563,144,72,72
665,1012,444,479,278,568,144,72,72
670,1022,446,483,280,575,145,72,73
675,1028,446,486,280,580,147,73,74
680,1039,452,492,285,583,148,73,75
685,1043,456,494,289,586,148,73,75
690,1053,461,497,292,591,149,74,75
695,1059,461,501,292,595,151,75,76
700,1070,468,509,299,599,152,76,76
705,1074,472,511,303,601,152,76,76
710,1084,478,515,307,604,153,76,77
715,1090,479,515,308,611,155,76,79
720,1101,480,520,309,619,156,77,79
725,1105,482,523,311,623,156,77,79
730,1115,483,527,311,631,157,78,79
735,1121,485,533,313,634,159,80,79
740,1132,487,539,314,643,160,81,79
745,1136,489,543,316,646,160,81,79
750,1146,492,548,318,653,161,82,79
755,1152,492,551,318,658,163,83,80
760,1163,493,556,318,667,164,84,80
765,1167,496,560,321,670,164,84,80
770,1177,497,565,321,679,165,84,81
775,1183,498,567,322,685,167,85,82
780,1194,498,571,322,696,168,86,82
785,1198,498,573,322,700,168,86,82
790,1208,499,579,322,708,169,87,82
795,1214,499,581,322,714,171,87,84
800,1225,499,585,322,725,172,87,85
805,1229,499,587,322,730,172,87,85
810,1239,500,593,323,738,173,87,86
815,1245,500,594,323,744,175,87,88
820,1256,501,598,324,754,176,88,88
825,1260,501,600,324,759,176,88,88
830,1270,503,607,325,766,177,89,88
835,1276,504,609,326,771,179,89,90
840,1287,505,615,327,780,180,89,91
845,1291,506,616,328,785,180,89,91
850,1301,508,619,328,792,181,89,92
855,1307,509,622,329,797,183,89,94
860,1318,511,627,331,804,184,89,95
865,1322,513,628,333,808,184,89,95
870,1332,517,631,336,814,185,89,96
875,1338,519,634,338,818,187,90,97
880,1349,522,639,340,823,188,90,98
885,1353,525,640,343,828,188,90,98
890,1363,528,648,346,834,189,90,99
895,1369,529,650,347,840,191,91,100
900,1380,532,656,350,845,192,91,101
905,1384,536,659,354,847,192,91,101
910,1394,539,662,356,854,193,91,102
915,1400,539,665,356,861,195,93,102
920,1411,543,671,360,867,196,94,102
925,1415,545,673,362,869,196,94,102
930,1425,548,678,364,876,197,94,103
935,1431,550,682,366,880,199,95,104
940,1442,555,687,370,885,200,95,105
945,1446,558,689,373,887,200,95,105
950,1456,563,693,377,892,201,95,106
955,1462,565,697,379,895,203,96,107
960,1473,570,701,383,902,204,97,107
965,1477,571,701,384,906,204,97,107
970,1487,575,706,387,911,205,98,107
975,1493,577,710,389,915,207,99,108
980,1504,580,717,392,921,208,99,109
985,1508,583,720,395,925,208,99,109
990,1518,585,726,396,932,209,100,109
995,1524,585,727,396,939,211,100,111
1000,1535,587,732,397,948,212,101,111
1005,1539,588,735,398,951,212,101,111
1010,1549,589,740,398,959,213,101,112
1015,1555,590,743,399,964,215,103,112
1020,1566,592,747,400,973,216,104,112
1025,1570,594,750,402,976,216,104,112
1030,1580,595,752,402,984,217,105,112
1035,1586,596,754,403,990,219,105,114
1040,1597,597,760,404,998,220,106,114
1045,1601,600,763,407,1000,220,106,114
1050,1611,601,766,407,1009,221,106,115
1055,1617,602,769,408,1014,223,106,117
1060,1628,603,774,409,1025,224,107,117
1065,1632,604,777,410,1028,224,107,117
1070,1642,605,781,411,1036,225,108,117
1075,1648,606,785,412,1041,227,110,117
1080,1659,610,792,415,1045,228,111,117
1085,1663,614,794,419,1048,228,111,117
1090,1673,616,799,420,1056,229,111,118
1095,1679,616,803,420,1061,231,113,118
1100,1690,619,809,423,1069,232,113,119
1105,1694,620,809,424,1074,232,113,119
1110,1704,622,813,425,1081,233,113,120
1115,1710,623,816,426,1086,235,113,122
1120,1721,624,822,427,1095,236,113,123
1125,1725,625,824,428,1100,236,113,123
1130,1735,627,829,429,1107,237,114,123
1135,1741,627,832,429,1113,239,115,124
1140,1752,629,838,431,1120,240,116,124
1145,1756,631,839,433,1125,240,116,124
1150,1766,633,843,433,1132,241,117,124
1155,1772,634,844,434,1138,243,117,126
1160,1783,635,846,435,1147,244,117,127
1165,1787,635,847,435,1152,244,117,127
1170,1797,637,853,435,1159,245,118,127
1175,1803,637,856,435,1165,247,119,128
1180,1814,640,860,438,1174,248,120,128
1185,1818,641,864,439,1176,248,120,128
1190,1828,646,870,442,1181,249,120,129
1195,1834,646,874,442,1187,251,122,129
1200,1845,649,876,444,1195,252,122,130
1205,1849,651,879,446,1197,252,122,130
1210,1859,654,886,449,1204,253,123,130
1215,1865,655,888,450,1210,255,123,132
1220,1876,659,895,454,1215,256,124,132
1225,1880,661,895,456,1219,256,124,132
1230,1890,665,900,458,1224,257,125,132
1235,1896,666,902,459,1229,259,125,134
1240,1907,671,911,464,1232,260,126,134
1245,1911,676,914,469,1234,260,126,134
1250,1921,681,920,473,1239,261,127,134
1255,1927,683,925,475,1243,263,129,134
1260,1938,686,929,478,1250,264,129,135
1265,1942,689,932,481,1253,264,129,135
1270,1952,690,937,482,1261,265,129,136
1275,1958,691,940,483,1266,267,129,138
1280,1969,693,946,484,1273,268,129,139
1285,1973,696,947,487,1277,268,129,139
1290,1983,698,951,488,1284,269,129,140
1295,1989,699,953,489,1289,271,129,142
1300,2000,700,956,489,1299,272,129,143
1305,2004,701,958,490,1303,272,129,143
1310,2014,702,960,490,1311,273,129,144
1315,2020,703,963,491,1316,275,131,144
1320,2031,706,972,494,1322,276,132,144
1325,2035,707,972,495,1328,276,132,144
1330,2045,708,980,496,1336,277,133,144
1335,2051,709,983,497,1342,279,134,145
1340,2062,710,989,498,1349,280,134,146
1345,2066,711,991,499,1355,280,134,146
1350,2076,712,994,499,1363,281,134,147
1355,2082,712,998,499,1368,283,135,148
1360,2093,713,1006,500,1377,284,136,148
1365,2097,714,1009,501,1383,284,136,148
1370,2107,716,1014,502,1390,285,136,149
1375,2113,716,1016,502,1396,287,137,150
1380,2124,717,1022,503,1405,288,138,150
1385,2128,718,1024,504,1410,288,138,150
1390,2138,720,1027,504,1417,289,138,151
1395,2144,720,1030,504,1422,291,139,152
1400,2155,723,1034,507,1431,292,139,153
1405,2159,724,1037,508,1434,292,139,153
1410,2169,726,1043,509,1442,293,140,153
1415,2175,727,1047,510,1447,295,141,154
1420,2186,728,1051,511,1456,296,141,155
1425,2190,729,1052,512,1460,296,141,155
1430,2200,733,1060,515,1466,297,142,155
1435,2206,735,1064,517,1470,299,143,156
1440,2217,738,1069,520,1476,300,143,157
1445,2221,742,1072,524,1479,300,143,157
1450,2231,746,1077,527,1484,301,144,157
1455,2237,747,1077,528,1490,303,144,159
1460,2248,751,1086,531,1493,304,145,159
1465,2252,756,1090,536,1495,304,145,159
1470,2262,759,1093,539,1502,305,145,160
1475,2268,760,1096,540,1508,307,146,161
1480,2279,763,1100,542,1515,308,147,161
1485,2283,765,1103,544,1517,308,147,161
1490,2293,769,1107,547,1523,309,148,161
1495,2299,770,1110,548,1529,311,150,161
1500,2310,773,1114,550,1536,312,151,161
1505,2314,774,1115,551,1540,312,151,161
1510,2324,776,1118,551,1547,313,152,161
1515,2330,777,1121,552,1552,315,153,162
1520,2341,779,1128,554,1559,316,153,163
1525,2345,781,1131,556,1563,316,153,163
1530,2355,784,1134,558,1570,317,153,164
1535,2361,784,1137,558,1574,319,153,166
1540,2372,788,1143,562,1582,320,153,167
1545,2376,791,1146,565,1584,320,153,167
1550,2386,796,1153,570,1588,321,153,168
1555,2392,797,1154,571,1594,323,153,170
1560,2403,800,1161,574,1600,324,153,171
1565,2407,801,1163,575,1605,324,153,171
1570,2417,802,1169,575,1614,325,154,171
1575,2423,803,1173,576,1618,327,154,173
1580,2434,803,1179,576,1629,328,154,174
1585,2438,804,1180,577,1634,328,154,174
1590,2448,805,1181,577,1643,329,154,175
1595,2454,806,1184,578,1646,331,154,177
1600,2465,806,1188,578,1659,332,154,178
1605,2469,806,1190,578,1663,332,154,178
1610,2479,807,1192,578,1671,333,154,179
1615,2485,809,1195,580,1676,335,155,180
1620,2496,810,1200,580,1684,336,155,181
1625,2500,812,1203,582,1688,336,155,181
1630,2510,814,1210,584,1695,337,156,181
1635,2516,816,1213,586,1700,339,156,183
1640,2527,818,1216,588,1709,340,156,184
1645,2531,818,1218,588,1713,340,156,184
1650,2541,819,1221,588,1722,341,156,185
1655,2547,820,1224,589,1727,343,157,186
1660,2558,823,1230,591,1733,344,157,187
1665,2562,825,1233,593,1737,344,157,187
1670,2572,827,1239,594,1745,345,158,187
1675,2578,828,1242,595,1749,347,158,189
1680,2589,833,1248,599,1755,348,159,189
1685,2593,834,1249,600,1759,348,159,189
1690,2603,838,1253,602,1765,349,160,189
1695,2609,839,1256,603,1769,351,160,191
1700,2620,843,1263,606,1774,352,161,191
1705,2624,846,1264,609,1778,352,161,191
1710,2634,850,1271,613,1784,353,162,191
1715,2640,850,1273,613,1789,355,163,192
1720,2651,856,1280,618,1792,356,163,193
1725,2655,860,1282,622,1794,356,163,193
1730,2665,863,1284,624,1801,357,163,194
1735,2671,865,1286,626,1805,359,163,196
1740,2682,869,1290,630,1813,360,164,196
1745,2686,871,1293,632,1814,360,164,196
1750,2696,876,1297,636,1820,361,165,196
1755,2702,877,1299,637,1824,363,165,198
1760,2713,882,1303,642,1831,364,165,199
1765,2717,883,1304,643,1834,364,165,199
1770,2727,888,1310,647,1839,365,165,200
1775,2733,889,1313,648,1843,367,165,202
1780,2744,891,1319,649,1850,368,165,203
1785,2748,894,1322,652,1854,368,165,203
1790,2758,895,1325,653,1862,369,165,204
1795,2764,896,1328,654,1868,371,166,205
1800,2775,896,1334,654,1878,372,167,205
1805,2779,897,1337,655,1882,372,167,205
1810,2789,898,1343,656,1891,373,167,206
1815,2795,899,1347,657,1896,375,168,207
1820,2806,900,1352,658,1905,376,169,207
1825,2810,901,1353,659,1909,376,169,207
1830,2820,901,1358,659,1918,377,169,208
1835,2826,901,1361,659,1925,379,170,209
1840,2837,901,1367,659,1935,380,171,209
1845,2841,901,1369,659,1940,380,171,209
1850,2851,901,1376,659,1950,381,172,209
1855,2857,901,1378,659,1956,383,173,210
1860,2868,901,1382,659,1966,384,174,210
1865,2872,901,1384,659,1971,384,174,210
1870,2882,901,1391,659,1981,385,175,210
1875,2888,901,1393,659,1987,387,175,212
1880,2899,902,1399,660,1995,388,176,212
1885,2903,904,1401,662,1998,388,176,212
1890,2913,906,1404,663,2007,389,177,212
1895,2919,906,1407,663,2013,391,178,213
1900,2930,909,1413,666,2019,392,178,214
1905,2934,911,1415,668,2022,392,178,214
1910,2944,913,1416,669,2030,393,178,215
1915,2950,914,1420,670,2034,395,179,216
1920,2961,917,1424,673,2042,396,180,216
1925,2965,921,1427,677,2043,396,180,216
1930,2975,927,1434,683,2047,397,181,216
1935,2981,929,1437,685,2050,399,181,218
1940,2992,934,1443,689,2055,400,182,218
1945,2996,938,1445,693,2057,400,182,218
1950,3006,943,1450,696,2063,401,182,219
1955,3012,944,1454,697,2067,403,183,220
1960,3023,946,1458,698,2076,404,184,220
1965,3027,946,1458,698,2081,404,184,220
1970,3037,948,1461,699,2089,405,185,220
1975,3043,948,1462,699,2095,407,185,222
1980,3054,949,1466,700,2103,408,185,223
1985,3058,952,1468,703,2106,408,185,223
1990,3068,954,1472,704,2114,409,185,224
1995,3074,955,1475,705,2118,411,186,225
2000,3085,956,1478,705,2128,412,186,226
2005,3089,958,1481,707,2130,412,186,226
2010,3099,960,1487,708,2138,413,187,226
2015,3105,961,1490,709,2143,415,188,227
2020,3116,963,1497,710,2149,416,189,227
2025,3120,966,1499,713,2154,416,189,227
2030,3130,967,1502,713,2162,417,189,228
2035,3136,968,1505,714,2168,419,191,228
2040,3147,969,1510,715,2176,420,191,229
2045,3151,969,1510,715,2182,420,191,229
2050,3161,970,1513,715,2190,421,192,229
2055,3167,971,1517,716,2195,423,193,230
2060,3178,972,1518,717,2206,424,194,230
2065,3182,973,1521,718,2208,424,194,230
2070,3192,976,1527,721,2216,425,195,230
2075,3198,976,1530,721,2222,427,196,231
2080,3209,976,1532,721,2231,428,196,232
2085,3213,977,1535,722,2235,428,196,232
2090,3223,980,1541,723,2242,429,197,232
2095,3229,981,1545,724,2247,431,198,233
2100,3240,983,1551,726,2255,432,198,234
2105,3244,984,1554,727,2259,432,198,234
2110,3254,987,1560,729,2267,433,199,234
2115,3260,988,1564,730,2272,435,201,234
2120,3271,988,1570,730,2281,436,201,235
2125,3275,990,1573,732,2284,436,201,235
2130,3285,994,1577,734,2290,437,202,235
2135,3291,996,1579,736,2294,439,202,237
2140,3302,1001,1584,740,2300,440,202,238
2145,3306,1004,1588,743,2301,440,202,238
2150,3316,1010,1594,748,2306,441,203,238
2155,3322,1011,1599,749,2309,443,204,239
2160,3333,1017,1605,754,2314,444,204,240
2165,3337,1021,1607,758,2316,444,204,240
2170,3347,1026,1613,761,2320,445,205,240
2175,3353,1027,1615,762,2325,447,205,242
2180,3364,1030,1623,765,2332,448,206,242
2185,3368,1033,1625,768,2335,448,206,242
2190,3378,1036,1634,771,2341,449,207,242
2195,3384,1038,1640,773,2345,451,209,242
2200,3395,1040,1646,775,2353,452,209,243
2205,3399,1043,1649,778,2356,452,209,243
2210,3409,1046,1654,780,2363,453,210,243
2215,3415,1047,1658,781,2368,455,211,244
2220,3426,1049,1663,782,2375,456,211,245
2225,3430,1049,1666,782,2380,456,211,245
2230,3440,1050,1669,782,2390,457,211,246
2235,3446,1051,1671,783,2394,459,211,248
2240,3457,1051,1676,783,2404,460,211,249
2245,3461,1051,1677,783,2410,460,211,249
2250,3471,1052,1679,783,2419,461,212,249
2255,3477,1053,1683,784,2423,463,214,249
2260,3488,1054,1689,785,2433,464,215,249
2265,3492,1054,1689,785,2438,464,215,249
2270,3502,1055,1693,786,2447,465,215,250
2275,3508,1055,1695,786,2453,467,217,250
2280,3519,1056,1701,787,2460,468,218,250
2285,3523,1058,1703,789,2465,468,218,250
2290,3533,1060,1705,789,2473,469,218,251
2295,3539,1061,1708,790,2477,471,218,253
2300,3550,1063,1713,792,2485,472,218,254
2305,3554,1064,1714,793,2490,472,218,254
2310,3564,1066,1716,794,2498,473,218,255
2315,3570,1067,1718,795,2503,475,219,256
2320,3581,1068,1723,796,2510,476,219,257
2325,3585,1069,1726,797,2515,476,219,257
2330,3595,1072,1728,798,2523,477,219,258
2335,3601,1072,1731,798,2528,479,220,259
2340,3612,1074,1737,800,2535,480,221,259
2345,3616,1076,1738,802,2540,480,221,259
2350,3626,1079,1743,803,2546,481,222,259
2355,3632,1080,1745,804,2552,483,223,260
2360,3643,1082,1751,806,2559,484,224,260
2365,3647,1085,1753,809,2562,484,224,260
2370,3657,1087,1758,810,2569,485,224,261
2375,3663,1088,1761,811,2575,487,226,261
2380,3674,1091,1767,814,2581,488,227,261
2385,3678,1095,1771,818,2582,488,227,261
2390,3688,1099,1775,822,2589,489,227,262
2395,3694,1100,1776,823,2594,491,227,264
2400,3705,1104,1781,827,2600,492,227,265
2405,3709,1106,1782,829,2603,492,227,265
2410,3719,1109,1788,832,2610,493,227,266
2415,3725,1110,1792,833,2614,495,228,267
2420,3736,1115,1797,837,2620,496,229,267
2425,3740,1117,1799,839,2622,496,229,267
2430,3750,1120,1801,841,2630,497,229,268
2435,3756,1121,1805,842,2634,499,230,269
2440,3767,1124,1809,844,2640,500,230,270
2445,3771,1128,1811,848,2642,500,230,270
2450,3781,1134,1816,853,2647,501,231,270
2455,3787,1134,1817,853,2653,503,232,271
2460,3798,1138,1823,857,2658,504,232,272
2465,3802,1141,1825,860,2660,504,232,272
2470,3812,1145,1832,863,2667,505,233,272
2475,3818,1146,1835,864,2671,507,234,273
2480,3829,1146,1842,864,2680,508,234,274
2485,3833,1147,1844,865,2685,508,234,274
2490,3843,1148,1851,866,2694,509,235,274
2495,3849,1149,1855,867,2698,511,235,276
2500,3860,1149,1862,867,2708,512,236,276
2505,3864,1150,1864,868,2714,512,236,276
2510,3874,1151,1870,869,2722,513,236,277
2515,3880,1152,1874,870,2728,515,238,277
2520,3891,1153,1880,871,2738,516,238,278
2525,3895,1153,1883,871,2742,516,238,278
2530,3905,1154,1885,872,2751,517,238,279
2535,3911,1155,1889,873,2755,519,239,280
2540,3922,1156,1894,874,2764,520,240,280
2545,3926,1156,1894,874,2770,520,240,280
2550,3936,1157,1896,875,2779,521,240,281
2555,3942,1158,1899,876,2784,523,242,281
2560,3953,1158,1906,876,2793,524,243,281
2565,3957,1158,1909,876,2798,524,243,281
2570,3967,1159,1914,876,2808,525,243,282
2575,3973,1159,1916,876,2813,527,244,283
2580,3984,1162,1921,878,2820,528,244,284
2585,3988,1164,1924,880,2824,528,244,284
2590,3998,1166,1928,882,2831,529,244,285
2595,4004,1168,1933,884,2835,531,245,286
2600,4015,1171,1938,887,2843,532,246,286
2605,4019,1172,1941,888,2847,532,246,286
2610,4029,1176,1948,891,2852,533,247,286
2615,4035,1178,1950,893,2857,535,247,288
2620,4046,1183,1956,898,2863,536,248,288
2625,4050,1185,1959,900,2864,536,248,288
2630,4060,1188,1962,903,2872,537,248,289
2635,4066,1188,1964,903,2878,539,249,290
2640,4077,1192,1971,907,2883,540,250,290
2645,4081,1196,1974,911,2885,540,250,290
2650,4091,1198,1976,912,2893,541,250,291
2655,4097,1199,1979,913,2897,543,250,293
2660,4108,1203,1982,916,2904,544,250,294
2665,4112,1206,1985,919,2906,544,250,294
2670,4122,1209,1991,921,2912,545,250,295
2675,4128,1210,1994,922,2917,547,251,296
2680,4139,1214,2001,926,2922,548,251,297
2685,4143,1218,2003,930,2924,548,251,297
2690,4153,1222,2006,933,2931,549,251,298
2695,4159,1222,2008,933,2936,551,252,299
2700,4170,1225,2012,936,2943,552,252,300
2705,4174,1229,2015,940,2944,552,252,300
2710,4184,1234,2020,945,2950,553,253,300
2715,4190,1235,2024,946,2953,555,254,301
2720,4201,1239,2031,950,2959,556,255,301
2725,4205,1241,2033,952,2963,556,255,301
2730,4215,1242,2037,953,2973,557,255,302
2735,4221,1242,2038,953,2979,559,256,303
2740,4232,1243,2043,954,2989,560,257,303
2745,4236,1243,2046,954,2992,560,257,303
2750,4246,1244,2051,954,3001,561,257,304
2755,4252,1244,2055,954,3006,563,259,304
2760,4263,1244,2059,954,3018,564,259,305
2765,4267,1244,2061,954,3023,564,259,305
2770,4277,1245,2067,955,3032,565,260,305
2775,4283,1246,2069,956,3036,567,260,307
2780,4294,1246,2073,956,3048,568,261,307
2785,4298,1246,2074,956,3052,568,261,307
2790,4308,1247,2083,956,3060,569,262,307
2795,4314,1247,2086,956,3066,571,263,308
2800,4325,1247,2092,956,3076,572,264,308
2805,4329,1248,2096,957,3080,572,264,308
2810,4339,1249,2100,957,3090,573,264,309
2815,4345,1250,2104,958,3094,575,266,309
2820,4356,1250,2110,958,3103,576,267,309
2825,4360,1252,2111,960,3108,576,267,309
2830,4370,1255,2116,962,3114,577,267,310
2835,4376,1256,2120,963,3119,579,269,310
2840,4387,1260,2125,967,3126,580,270,310
2845,4391,1261,2127,968,3130,580,270,310
2850,4401,1263,2130,968,3138,581,271,310
2855,4407,1264,2136,969,3142,583,273,310
2860,4418,1267,2142,971,3147,584,273,311
2865,4422,1271,2143,975,3151,584,273,311
2870,4432,1273,2145,976,3159,585,273,312
2875,4438,1273,2147,976,3165,587,274,313
2880,4449,1275,2154,978,3170,588,274,314
2885,4453,1279,2157,982,3174,588,274,314
2890,4463,1283,2163,984,3179,589,274,315
2895,4469,1285,2166,986,3184,591,275,316
2900,4480,1288,2170,988,3191,592,276,316
2905,4484,1289,2170,989,3195,592,276,316
2910,4494,1292,2178,992,3201,593,277,316
2915,4500,1293,2181,993,3207,595,278,317
2920,4511,1296,2188,995,3211,596,279,317
2925,4515,1301,2189,1000,3214,596,279,317
2930,4525,1304,2195,1002,3220,597,280,317
2935,4531,1304,2198,1002,3225,599,281,318
2940,4542,1309,2203,1006,3231,600,282,318
2945,4546,1312,2204,1009,3234,600,282,318
2950,4556,1318,2212,1014,3236,601,283,318
2955,4562,1321,2216,1017,3240,603,285,318
2960,4573,1325,2222,1020,3245,604,286,318
2965,4577,1328,2223,1023,3249,604,286,318
2970,4587,1330,2227,1024,3255,605,286,319
2975,4593,1331,2230,1025,3261,607,288,319
2980,4604,1334,2235,1028,3269,608,288,320
2985,4608,1335,2236,1029,3273,608,288,320
2990,4618,1336,2240,1030,3281,609,288,321
2995,4624,1336,2243,1030,3287,611,290,321
3000,4635,1336,2249,1030,3297,612,290,322
3005,4639,1336,2250,1030,3302,612,290,322
3010,4649,1337,2256,1031,3311,613,290,323
3015,4655,1337,2259,1031,3317,615,291,324
3020,4666,1337,2263,1031,3329,616,291,325
3025,4670,1337,2264,1031,3333,616,291,325
3030,4680,1338,2269,1031,3341,617,292,325
3035,4686,1339,2271,1032,3346,619,292,327
3040,4697,1340,2278,1033,3355,620,292,328
3045,4701,1341,2280,1034,3360,620,292,328
3050,4711,1342,2284,1035,3368,621,293,328
3055,4717,1342,2287,1035,3373,623,294,329
3060,4728,1343,2295,1036,3384,624,295,329
3065,4732,1343,2297,1036,3389,624,295,329
3070,4742,1345,2302,1038,3396,625,296,329
3075,4748,1346,2305,1039,3402,627,297,330
3080,4759,1348,2309,1040,3411,628,298,330
3085,4763,1348,2310,1040,3415,628,298,330
3090,4773,1351,2315,1043,3421,629,298,331
3095,4779,1353,2319,1045,3425,631,298,333
3100,4790,1356,2325,1048,3432,632,299,333
3105,4794,1359,2327,1051,3435,632,299,333
3110,4804,1361,2329,1051,3442,633,299,334
3115,4810,1361,2333,1051,3448,635,300,335
3120,4821,1365,2339,1055,3455,636,300,336
3125,4825,1366,2340,1056,3459,636,300,336
3130,4835,1370,2346,1058,3464,637,301,336
3135,4841,1371,2349,1059,3470,639,302,337
3140,4852,1373,2355,1061,3476,640,303,337
3145,4856,1376,2356,1064,3480,640,303,337
3150,4866,1378,2360,1064,3487,641,304,337
3155,4872,1378,2362,1064,3494,643,305,338
3160,4883,1379,2364,1064,3502,644,305,339
3165,4887,1382,2368,1067,3504,644,305,339
3170,4897,1388,2373,1071,3508,645,306,339
3175,4903,1390,2377,1073,3511,647,307,340
3180,4914,1394,2382,1076,3517,648,308,340
3185,4918,1398,2385,1080,3518,648,308,340
3190,4928,1404,2390,1085,3522,649,308,341
3195,4934,1407,2394,1088,3525,651,309,342
3200,4945,1414,2402,1095,3529,652,310,342
3205,4949,1416,2402,1097,3533,652,310,342
3210,4959,1418,2404,1098,3539,653,310,343
3215,4965,1419,2407,1099,3546,655,311,344
3220,4976,1421,2412,1101,3554,656,312,344
3225,4980,1421,2413,1101,3559,656,312,344
3230,4990,1421,2418,1101,3568,657,313,344
3235,4996,1421,2423,1101,3575,659,315,344
3240,5007,1423,2429,1102,3582,660,315,345
3245,5011,1425,2432,1104,3586,660,315,345
3250,5021,1427,2440,1106,3593,661,315,346
3255,5027,1428,2442,1107,3599,663,315,348
3260,5038,1430,2448,1108,3606,664,316,348
3265,5042,1431,2450,1109,3611,664,316,348
3270,5052,1431,2453,1109,3620,665,317,348
3275,5058,1431,2458,1109,3627,667,319,348
3280,5069,1431,2463,1109,3637,668,319,349
3285,5073,1431,2466,1109,3642,668,319,349
3290,5083,1431,2469,1109,3651,669,319,350
3295,5089,1431,2473,1109,3658,671,321,350
3300,5100,1431,2476,1109,3668,672,321,351
3305,5104,1431,2479,1109,3673,672,321,351
3310,5114,1432,2483,1109,3681,673,321,352
3315,5120,1433,2487,1110,3687,675,323,352
3320,5131,1434,2492,1111,3695,676,324,352
3325,5135,1436,2495,1113,3697,676,324,352
3330,5145,1443,2501,1118,3700,677,324,353
3335,5151,1445,2505,1120,3705,679,325,354
3340,5162,1447,2509,1122,3713,680,325,355
3345,5166,1449,2513,1124,3717,680,325,355
3350,5176,1451,2520,1125,3724,681,326,355
3355,5182,1452,2523,1126,3729,683,327,356
3360,5193,1454,2528,1128,3738,684,327,357
3365,5197,1454,2531,1128,3743,684,327,357
3370,5207,1457,2535,1131,3749,685,327,358
3375,5213,1458,2539,1132,3755,687,328,359
3380,5224,1461,2543,1134,3763,688,329,359
3385,5228,1461,2544,1134,3767,688,329,359
3390,5238,1464,2549,1137,3773,689,329,360
3395,5244,1464,2550,1137,3780,691,329,362
3400,5255,1468,2558,1141,3784,692,329,363
3405,5259,1472,2559,1145,3787,692,329,363
3410,5269,1476,2566,1149,3792,693,330,363
3415,5275,1477,2569,1150,3798,695,331,364
3420,5286,1480,2573,1153,3805,696,331,365
3425,5290,1481,2576,1154,3809,696,331,365
3430,5300,1484,2582,1157,3815,697,331,366
3435,5306,1485,2584,1158,3820,699,332,367
3440,5317,1489,2589,1161,3826,700,333,367
3445,5321,1492,2591,1164,3828,700,333,367
3450,5331,1499,2598,1170,3830,701,333,368
3455,5337,1502,2602,1173,3833,703,334,369
3460,5348,1504,2606,1174,3843,704,334,370
3465,5352,1505,2608,1175,3846,704,334,370
3470,5362,1507,2612,1176,3854,705,335,370
3475,5368,1509,2613,1178,3859,707,335,372
3480,5379,1510,2616,1179,3869,708,336,372
3485,5383,1511,2619,1180,3871,708,336,372
3490,5393,1512,2622,1180,3880,709,336,373
3495,5399,1513,2625,1181,3884,711,337,374
3500,5410,1514,2629,1181,3894,712,337,375
3505,5414,1515,2629,1182,3899,712,337,375
3510,5424,1517,2637,1184,3906,713,338,375
3515,5430,1519,2640,1186,3911,715,339,376
3520,5441,1521,2644,1187,3918,716,339,377
3525,5445,1524,2647,1190,3921,716,339,377
3530,5455,1526,2651,1191,3928,717,339,378
3535,5461,1528,2654,1193,3933,719,340,379
3540,5472,1530,2657,1194,3942,720,341,379
3545,5476,1530,2658,1194,3945,720,341,379
3550,5486,1531,2664,1195,3954,721,342,379
3555,5492,1532,2667,1196,3959,723,342,381
3560,5503,1533,2672,1197,3967,724,342,382
3565,5507,1535,2673,1199,3972,724,342,382
3570,5517,1537,2676,1200,3979,725,343,382
3575,5523,1537,2679,1200,3985,727,344,383
3580,5534,1539,2683,1202,3994,728,344,384
3585,5538,1540,2686,1203,3998,728,344,384
3590,5548,1542,2691,1204,4005,729,345,384
3595,5554,1542,2692,1204,4012,731,346,385
3600,5565,1544,2697,1206,4020,732,346,386
3605,5569,1546,2700,1208,4023,732,346,386
3610,5579,1548,2707,1208,4030,733,347,386
3615,5585,1549,2709,1209,4036,735,348,387
3620,5596,1550,2711,1210,4045,736,348,388
3625,5600,1552,2714,1212,4047,736,348,388
3630,5610,1555,2717,1214,4055,737,349,388
3635,5616,1556,2721,1215,4059,739,350,389
3640,5627,1558,2729,1217,4066,740,351,389
3645,5631,1560,2731,1219,4070,740,351,389
3650,5641,1564,2734,1222,4077,741,351,390
3655,5647,1564,2735,1222,4083,743,351,392
3660,5658,1566,2741,1224,4088,744,351,393
3665,5662,1570,2743,1228,4090,744,351,393
3670,5672,1576,2748,1233,4095,745,352,393
3675,5678,1577,2751,1234,4099,747,353,394
3680,5689,1581,2756,1237,4105,748,354,394
3685,5693,1584,2756,1240,4109,748,354,394
3690,5703,1587,2760,1242,4115,749,355,394
3695,5709,1588,2762,1243,4119,751,355,396
3700,5720,1593,2768,1247,4125,752,356,396
3705,5724,1594,2768,1248,4130,752,356,396
3710,5734,1597,2774,1250,4137,753,357,396
3715,5740,1597,2776,1250,4143,755,358,397
3720,5751,1599,2781,1252,4150,756,358,398
3725,5755,1600,2782,1253,4155,756,358,398
3730,5765,1602,2787,1254,4162,757,358,399
3735,5771,1604,2791,1256,4166,759,359,400
3740,5782,1606,2796,1258,4173,760,359,401
3745,5786,1609,2799,1261,4177,760,359,401
3750,5796,1610,2803,1261,4185,761,359,402
3755,5802,1611,2807,1262,4189,763,359,404
3760,5813,1611,2812,1262,4202,764,360,404
3765,5817,1611,2814,1262,4206,764,360,404
3770,5827,1612,2821,1263,4214,765,360,405
3775,5833,1612,2823,1263,4220,767,361,406
3780,5844,1613,2829,1264,4229,768,361,407
3785,5848,1614,2831,1265,4234,768,361,407
3790,5858,1615,2836,1265,4243,769,362,407
3795,5864,1615,2839,1265,4249,771,364,407
3800,5875,1616,2850,1266,4255,772,365,407
3805,5879,1618,2852,1268,4261,772,365,407
3810,5889,1620,2857,1270,4269,773,366,407
3815,5895,1620,2859,1270,4274,775,367,408
3820,5906,1621,2864,1271,4283,776,367,409
3825,5910,1621,2868,1271,4289,776,367,409
3830,5920,1623,2870,1271,4297,777,367,410
3835,5926,1624,2873,1272,4302,779,367,412
3840,5937,1624,2879,1272,4311,780,368,412
3845,5941,1624,2880,1272,4317,780,368,412
3850,5951,1628,2885,1275,4323,781,368,413
3855,5957,1628,2888,1275,4329,783,369,414
3860,5968,1632,2897,1278,4331,784,370,414
3865,5972,1636,2898,1282,4336,784,370,414
3870,5982,1639,2903,1285,4342,785,370,415
3875,5988,1641,2908,1287,4346,787,372,415
3880,5999,1646,2916,1292,4350,788,373,415
3885,6003,1649,2917,1295,4353,788,373,415
3890,6013,1654,2921,1298,4357,789,373,416
3895,6019,1656,2924,1300,4362,791,375,416
3900,6030,1659,2928,1303,4370,792,376,416
3905,6034,1662,2930,1306,4372,792,376,416
3910,6044,1665,2934,1309,4378,793,376,417
3915,6050,1666,2936,1310,4383,795,377,418
3920,6061,1671,2944,1315,4387,796,378,418
3925,6065,1674,2944,1318,4391,796,378,418
3930,6075,1680,2950,1322,4394,797,378,419
3935,6081,1681,2953,1323,4399,799,380,419
3940,6092,1683,2955,1324,4408,800,380,420
3945,6096,1685,2957,1326,4410,800,380,420
3950,6106,1689,2960,1328,4416,801,380,421
3955,6112,1690,2964,1329,4421,803,381,422
3960,6123,1692,2968,1330,4429,804,382,422
3965,6127,1695,2970,1333,4432,804,382,422
3970,6137,1698,2978,1336,4438,805,383,422
3975,6143,1699,2983,1337,4443,807,384,423
3980,6154,1700,2988,1338,4453,808,384,424
3985,6158,1700,2990,1338,4458,808,384,424
3990,6168,1701,2996,1338,4466,809,385,424
3995,6174,1701,2999,1338,4473,811,386,425
4000,6185,1702,3004,1339,4482,812,386,426
4005,6189,1703,3004,1340,4486,812,386,426
4010,6199,1704,3013,1341,4494,813,387,426
4015,6205,1704,3015,1341,4500,815,388,427
4020,6216,1705,3021,1342,4508,816,388,428
4025,6220,1706,3024,1343,4513,816,388,428
4030,6230,1707,3029,1344,4523,817,389,428
4035,6236,1707,3029,1344,4529,819,389,430
4040,6247,1708,3037,1345,4536,820,389,431
4045,6251,1709,3038,1346,4542,820,389,431
4050,6261,1710,3040,1346,4551,821,390,431
4055,6267,1711,3046,1347,4555,823,392,431
4060,6278,1711,3051,1347,4565,824,393,431
4065,6282,1713,3053,1349,4569,824,393,431
4070,6292,1715,3055,1350,4577,825,393,432
4075,6298,1715,3058,1350,4582,827,395,432
4080,6309,1718,3066,1353,4587,828,396,432
4085,6313,1722,3069,1357,4590,828,396,432
4090,6323,1726,3075,1359,4596,829,396,433
4095,6329,1728,3080,1361,4599,831,397,434
4100,6340,1730,3083,1362,4608,832,397,435
4105,6344,1732,3085,1364,4612,832,397,435
4110,6354,1736,3091,1367,4617,833,397,436
4115,6360,1738,3097,1369,4620,835,399,436
4120,6371,1742,3102,1372,4627,836,399,437
4125,6375,1744,3104,1374,4630,836,399,437
4130,6385,1746,3108,1376,4639,837,400,437
4135,6391,1747,3111,1377,4643,839,400,439
4140,6402,1752,3117,1382,4648,840,400,440
4145,6406,1755,3119,1385,4650,840,400,440
4150,6416,1758,3123,1387,4658,841,401,440
4155,6422,1758,3126,1387,4663,843,402,441
4160,6433,1762,3130,1391,4670,844,402,442
4165,6437,1765,3132,1394,4672,844,402,442
4170,6447,1767,3137,1395,4680,845,403,442
4175,6453,1767,3138,1395,4686,847,403,444
4180,6464,1767,3141,1395,4695,848,403,445
4185,6468,1769,3143,1397,4699,848,403,445
4190,6478,1771,3149,1399,4706,849,403,446
4195,6484,1772,3151,1400,4712,851,403,448
4200,6495,1773,3155,1401,4721,852,403,449
4205,6499,1775,3159,1403,4723,852,403,449
4210,6509,1778,3166,1404,4730,853,404,449
4215,6515,1778,3169,1404,4736,855,405,450
4220,6526,1781,3175,1407,4742,856,405,451
4225,6530,1783,3176,1409,4746,856,405,451
4230,6540,1786,3179,1411,4754,857,406,451
4235,6546,1786,3181,1411,4759,859,407,452
4240,6557,1787,3187,1412,4768,860,408,452
4245,6561,1789,3189,1414,4771,860,408,452
4250,6571,1793,3191,1417,4778,861,408,453
4255,6577,1794,3196,1418,4781,863,410,453
4260,6588,1799,3202,1423,4786,864,410,454
4265,6592,1801,3203,1425,4791,864,410,454
4270,6602,1803,3208,1426,4798,865,411,454
4275,6608,1804,3209,1427,4803,867,411,456
4280,6619,1806,3216,1429,4810,868,412,456
4285,6623,1809,3219,1432,4814,868,412,456
4290,6633,1811,3220,1433,4822,869,412,457
4295,6639,1811,3224,1433,4827,871,414,457
4300,6650,1813,3228,1435,4835,872,414,458
4305,6654,1815,3230,1437,4838,872,414,458
4310,6664,1817,3234,1439,4846,873,415,458
4315,6670,1818,3236,1440,4851,875,416,459
4320,6681,1819,3239,1440,4860,876,416,460
4325,6685,1822,3241,1443,4863,876,416,460
4330,6695,1825,3249,1446,4870,877,416,461
4335,6701,1826,3252,1447,4874,879,417,462
4340,6712,1829,3256,1449,4882,880,417,463
4345,6716,1830,3258,1450,4885,880,417,463
4350,6726,1832,3261,1451,4893,881,417,464
4355,6732,1833,3264,1452,4898,883,418,465
4360,6743,1835,3270,1454,4906,884,419,465
4365,6747,1836,3271,1455,4911,884,419,465
4370,6757,1840,3279,1459,4916,885,419,466
4375,6763,1842,3281,1461,4920,887,419,468
4380,6774,1843,3285,1462,4929,888,419,469
4385,6778,1844,3287,1463,4934,888,419,469
4390,6788,1846,3295,1465,4941,889,419,470
4395,6794,1846,3299,1465,4946,891,421,470
4400,6805,1848,3305,1467,4955,892,422,470
4405,6809,1850,3306,1469,4959,892,422,470
4410,6819,1852,3312,1470,4966,893,423,470
4415,6825,1853,3314,1471,4971,895,423,472
4420,6836,1856,3322,1474,4977,896,424,472
4425,6840,1857,3324,1475,4983,896,424,472
4430,6850,1859,3328,1476,4990,897,425,472
4435,6856,1859,3331,1476,4997,899,427,472
4440,6867,1859,3338,1476,5005,900,428,472
4445,6871,1861,3340,1478,5010,900,428,472
4450,6881,1863,3343,1479,5018,901,428,473
4455,6887,1863,3345,1479,5023,903,428,475
4460,6898,1865,3350,1481,5031,904,428,476
4465,6902,1867,3352,1483,5034,904,428,476
4470,6912,1870,3356,1485,5042,905,429,476
4475,6918,1870,3357,1485,5048,907,430,477
4480,6929,1872,3363,1487,5054,908,431,477
4485,6933,1876,3367,1491,5056,908,431,477
4490,6943,1880,3372,1495,5062,909,431,478
4495,6949,1881,3373,1496,5068,911,431,480
4500,6960,1884,3378,1498,5074,912,432,480
4505,6964,1887,3380,1501,5076,912,432,480
4510,6974,1892,3384,1505,5082,913,433,480
4515,6980,1893,3388,1506,5085,915,434,481
4520,6991,1897,3393,1510,5092,916,435,481
4525,6995,1900,3396,1513,5093,916,435,481
4530,7005,1906,3401,1518,5099,917,435,482
4535,7011,1906,3402,1518,5105,919,436,483
4540,7022,1908,3409,1520,5112,920,437,483
4545,7026,1910,3411,1522,5116,920,437,483
4550,7036,1913,3415,1524,5123,921,437,484
4555,7042,1913,3419,1524,5129,923,439,484
4560,7053,1915,3422,1525,5136,924,439,485
4565,7057,1918,3424,1528,5139,924,439,485
4570,7067,1919,3427,1529,5148,925,439,486
4575,7073,1919,3429,1529,5154,927,440,487
4580,7084,1920,3432,1530,5164,928,441,487
4585,7088,1920,3434,1530,5168,928,441,487
4590,7098,1923,3439,1532,5174,929,441,488
4595,7104,1925,3444,1534,5178,931,443,488
4600,7115,1927,3449,1535,5186,932,444,488
4605,7119,1929,3451,1537,5190,932,444,488
4610,7129,1931,3456,1538,5197,933,444,489
4615,7135,1932,3459,1539,5202,935,445,490
4620,7146,1934,3464,1541,5211,936,445,491
4625,7150,1935,3466,1542,5215,936,445,491
4630,7160,1936,3472,1543,5224,937,446,491
4635,7166,1937,3477,1544,5226,939,447,492
4640,7177,1940,3480,1547,5235,940,447,493
4645,7181,1942,3482,1549,5238,940,447,493
4650,7191,1945,3488,1552,5246,941,448,493
4655,7197,1946,3494,1553,5249,943,450,493
4660,7208,1949,3499,1556,5257,944,450,494
4665,7212,1951,3500,1558,5261,944,450,494
4670,7222,1953,3503,1558,5269,945,450,495
4675,7228,1953,3506,1558,5274,947,451,496
4680,7239,1955,3511,1560,5282,948,452,496
4685,7243,1956,3514,1561,5286,948,452,496
4690,7253,1958,3519,1561,5295,949,453,496
4695,7259,1959,3522,1562,5300,951,454,497
4700,7270,1959,3527,1562,5308,952,455,497
4705,7274,1960,3529,1563,5313,952,455,497
4710,7284,1962,3536,1564,5321,953,455,498
4715,7290,1963,3541,1565,5325,955,457,498
4720,7301,1965,3546,1567,5333,956,457,499
4725,7305,1967,3546,1569,5338,956,457,499
4730,7315,1970,3552,1571,5345,957,458,499
4735,7321,1971,3557,1572,5349,959,459,500
4740,7332,1973,3561,1574,5357,960,460,500
4745,7336,1976,3564,1577,5360,960,460,500
4750,7346,1978,3570,1579,5367,961,460,501
4755,7352,1980,3576,1581,5371,963,462,501
4760,7363,1985,3584,1585,5373,964,462,502
4765,7367,1991,3587,1591,5376,964,462,502
4770,7377,1993,3593,1593,5384,965,463,502
4775,7383,1994,3599,1594,5388,967,465,502
4780,7394,1998,3605,1598,5394,968,466,502
4785,7398,2001,3607,1601,5397,968,466,502
4790,7408,2003,3612,1602,5405,969,467,502
4795,7414,2003,3613,1602,5410,971,467,504
4800,7425,2008,3621,1607,5415,972,468,504
4805,7429,2011,3623,1610,5418,972,468,504
4810,7439,2013,3631,1612,5425,973,469,504
4815,7445,2014,3634,1613,5430,975,470,505
4820,7456,2018,3640,1617,5435,976,470,506
4825,7460,2020,3643,1619,5440,976,470,506
4830,7470,2022,3648,1621,5447,977,471,506
4835,7476,2023,3653,1622,5451,979,472,507
4840,7487,2023,3660,1622,5463,980,473,507
4845,7491,2023,3662,1622,5467,980,473,507
4850,7501,2023,3665,1622,5478,981,474,507
4855,7507,2023,3667,1622,5484,983,475,508
4860,7518,2023,3672,1622,5494,984,475,509
4865,7522,2023,3675,1622,5498,984,475,509
4870,7532,2023,3677,1622,5509,985,475,510
4875,7538,2023,3679,1622,5515,987,476,511
4880,7549,2023,3681,1622,5525,988,476,512
4885,7553,2023,3681,1622,5530,988,476,512
4890,7563,2024,3684,1623,5538,989,477,512
4895,7569,2025,3688,1624,5543,991,479,512
4900,7580,2026,3692,1625,5553,992,479,513
4905,7584,2027,3694,1626,5557,992,479,513
4910,7594,2028,3697,1627,5566,993,479,514
4915,7600,2029,3702,1628,5570,995,481,514
4920,7611,2029,3708,1628,5580,996,482,514
4925,7615,2031,3710,1630,5583,996,482,514
4930,7625,2036,3715,1634,5588,997,482,515
4935,7631,2037,3716,1635,5594,999,483,516
4940,7642,2042,3723,1639,5598,1000,484,516
4945,7646,2045,3725,1642,5600,1000,484,516
4950,7656,2050,3728,1646,5606,1001,484,517
4955,7662,2051,3731,1647,5611,1003,485,518
4960,7673,2052,3736,1648,5618,1004,486,518
4965,7677,2056,3740,1652,5620,1004,486,518
4970,7687,2059,3746,1654,5627,1005,487,518
4975,7693,2061,3750,1656,5631,1007,489,518
4980,7704,2065,3760,1660,5635,1008,490,518
4985,7708,2069,3763,1664,5638,1008,490,518
4990,7718,2072,3770,1666,5645,1009,491,518
4995,7724,2074,3772,1668,5649,1011,491,520
5000,7735,2078,3778,1671,5655,1012,492,520
5005,7739,2079,3779,1672,5659,1012,492,520
5010,7749,2082,3784,1674,5667,1013,493,520
5015,7755,2082,3786,1674,5673,1015,494,521
5020,7766,2085,3793,1677,5679,1016,495,521
5025,7770,2087,3793,1679,5683,1016,495,521
5030,7780,2090,3798,1682,5690,1017,496,521
5035,7786,2090,3798,1682,5696,1019,496,523
5040,7797,2092,3802,1683,5704,1020,497,523
5045,7801,2093,3803,1684,5708,1020,497,523
5050,7811,2096,3807,1685,5715,1021,498,523
5055,7817,2097,3810,1686,5720,1023,499,524
5060,7828,2101,3818,1690,5724,1024,500,524
5065,7832,2105,3821,1694,5727,1024,500,524
5070,7842,2107,3824,1694,5735,1025,500,525
5075,7848,2107,3829,1694,5740,1027,502,525
5080,7859,2111,3837,1698,5745,1028,502,526
5085,7863,2113,3840,1700,5750,1028,502,526
5090,7873,2115,3842,1700,5757,1029,502,527
5095,7879,2115,3844,1700,5763,1031,503,528
5100,7890,2117,3849,1702,5771,1032,504,528
5105,7894,2118,3852,1703,5776,1032,504,528
5110,7904,2119,3857,1703,5784,1033,504,529
5115,7910,2120,3862,1704,5790,1035,506,529
5120,7921,2120,3866,1704,5801,1036,507,529
5125,7925,2120,3868,1704,5805,1036,507,529
5130,7935,2121,3872,1705,5814,1037,507,530
5135,7941,2122,3877,1706,5818,1039,508,531
5140,7952,2123,3881,1707,5829,1040,508,532
5145,7956,2123,3883,1707,5833,1040,508,532
5150,7966,2124,3886,1707,5842,1041,508,533
5155,7972,2124,3889,1707,5847,1043,509,534
5160,7983,2125,3895,1708,5857,1044,509,535
5165,7987,2125,3895,1708,5862,1044,509,535
5170,7997,2128,3900,1710,5869,1045,510,535
5175,8003,2128,3902,1710,5875,1047,512,535
5180,8014,2129,3904,1710,5885,1048,512,536
5185,8018,2129,3906,1710,5889,1048,512,536
5190,8028,2131,3911,1712,5896,1049,512,537
5195,8034,2132,3913,1713,5902,1051,513,538
5200,8045,2134,3917,1714,5910,1052,513,539
5205,8049,2136,3919,1716,5913,1052,513,539
5210,8059,2139,3922,1718,5919,1053,513,540
5215,8065,2141,3924,1720,5924,1055,514,541
5220,8076,2144,3931,1722,5928,1056,515,541
5225,8080,2149,3932,1727,5931,1056,515,541
5230,8090,2152,3935,1729,5938,1057,516,541
5235,8096,2152,3937,1729,5942,1059,516,543
5240,8107,2158,3945,1734,5945,1060,517,543
5245,8111,2163,3947,1739,5947,1060,517,543
5250,8121,2171,3953,1745,5950,1061,518,543
5255,8127,2171,3957,1745,5954,1063,520,543
5260,8138,2176,3963,1749,5959,1064,521,543
5265,8142,2178,3964,1751,5963,1064,521,543
5270,8152,2180,3970,1753,5972,1065,521,544
5275,8158,2181,3975,1754,5975,1067,523,544
5280,8169,2184,3981,1756,5983,1068,524,544
5285,8173,2186,3983,1758,5986,1068,524,544
5290,8183,2188,3988,1760,5995,1069,524,545
5295,8189,2188,3989,1760,6000,1071,524,547
5300,8200,2189,3994,1761,6009,1072,524,548
5305,8204,2191,3997,1763,6012,1072,524,548
5310,8214,2192,4003,1763,6022,1073,525,548
5315,8220,2192,4005,1763,6028,1075,525,550
5320,8231,2193,4009,1764,6037,1076,525,551
5325,8235,2194,4011,1765,6040,1076,525,551
5330,8245,2195,4014,1765,6049,1077,525,552
5335,8251,2195,4015,1765,6056,1079,526,553
5340,8262,2195,4022,1765,6065,1080,527,553
5345,8266,2196,4023,1766,6070,1080,527,553
5350,8276,2197,4028,1767,6078,1081,528,553
5355,8282,2197,4031,1767,6085,1083,530,553
5360,8293,2198,4035,1768,6093,1084,530,554
5365,8297,2199,4037,1769,6098,1084,530,554
5370,8307,2201,4044,1771,6106,1085,531,554
5375,8313,2201,4048,1771,6112,1087,533,554
5380,8324,2203,4052,1773,6121,1088,534,554
5385,8328,2203,4053,1773,6125,1088,534,554
5390,8338,2205,4056,1773,6132,1089,534,555
5395,8344,2206,4060,1774,6138,1091,535,556
5400,8355,2207,4065,1775,6146,1092,536,556
5405,8359,2208,4067,1776,6151,1092,536,556
5410,8369,2210,4070,1778,6158,1093,536,557
5415,8375,2210,4073,1778,6165,1095,538,557
5420,8386,2214,4079,1782,6170,1096,538,558
5425,8390,2218,4082,1786,6171,1096,538,558
5430,8400,2222,4087,1788,6177,1097,538,559
5435,8406,2223,4089,1789,6182,1099,538,561
5440,8417,2227,4094,1793,6188,1100,538,562
5445,8421,2230,4098,1796,6190,1100,538,562
5450,8431,2235,4104,1800,6195,1101,539,562
5455,8437,2237,4107,1802,6199,1103,540,563
5460,8448,2241,4112,1805,6204,1104,540,564
5465,8452,2245,4114,1809,6206,1104,540,564
5470,8462,2251,4119,1815,6210,1105,540,565
5475,8468,2251,4119,1815,6217,1107,540,567
5480,8479,2254,4124,1817,6222,1108,540,568
5485,8483,2259,4127,1822,6223,1108,540,568
5490,8493,2265,4134,1826,6227,1109,540,569
5495,8499,2266,4138,1827,6231,1111,541,570
5500,8510,2269,4143,1829,6239,1112,541,571
5505,8514,2271,4146,1831,6243,1112,541,571
5510,8524,2274,4150,1833,6249,1113,541,572
5515,8530,2276,4153,1835,6253,1115,542,573
5520,8541,2276,4159,1835,6263,1116,543,573
5525,8545,2276,4160,1835,6269,1116,543,573
5530,8555,2277,4165,1836,6277,1117,544,573
5535,8561,2278,4169,1837,6283,1119,546,573
5540,8572,2279,4175,1838,6292,1120,547,573
5545,8576,2280,4177,1839,6295,1120,547,573
5550,8586,2281,4182,1839,6304,1121,548,573
5555,8592,2282,4186,1840,6309,1123,549,574
5560,8603,2283,4194,1841,6318,1124,550,574
5565,8607,2284,4196,1842,6323,1124,550,574
5570,8617,2285,4201,1843,6331,1125,550,575
5575,8623,2285,4203,1843,6338,1127,551,576
5580,8634,2286,4212,1844,6345,1128,551,577
5585,8638,2287,4214,1845,6351,1128,551,577
5590,8648,2288,4218,1845,6359,1129,552,577
5595,8654,2289,4220,1846,6365,1131,553,578
5600,8665,2290,4226,1847,6374,1132,553,579
5605,8669,2290,4228,1847,6379,1132,553,579
5610,8679,2292,4235,1848,6386,1133,554,579
5615,8685,2292,4236,1848,6393,1135,554,581
5620,8696,2296,4242,1851,6399,1136,555,581
5625,8700,2298,4245,1853,6401,1136,555,581
5630,8710,2303,4249,1857,6406,1137,555,582
5635,8716,2303,4250,1857,6413,1139,556,583
5640,8727,2305,4252,1858,6421,1140,556,584
5645,8731,2307,4253,1860,6424,1140,556,584
5650,8741,2312,4258,1863,6428,1141,556,585
5655,8747,2314,4259,1865,6433,1143,556,587
5660,8758,2317,4266,1868,6439,1144,557,587
5665,8762,2319,4267,1870,6442,1144,557,587
5670,8772,2323,4272,1873,6448,1145,558,587
5675,8778,2325,4277,1875,6451,1147,559,588
5680,8789,2330,4282,1880,6457,1148,559,589
5685,8793,2333,4284,1883,6460,1148,559,589
5690,8803,2338,4288,1887,6464,1149,559,590
5695,8809,2338,4291,1887,6469,1151,560,591
5700,8820,2344,4298,1893,6473,1152,560,592
5705,8824,2347,4300,1896,6476,1152,560,592
5710,8834,2350,4305,1898,6483,1153,560,593
5715,8840,2350,4305,1898,6490,1155,560,595
5720,8851,2352,4311,1900,6496,1156,560,596
5725,8855,2355,4312,1903,6500,1156,560,596
5730,8865,2357,4314,1904,6507,1157,560,597
5735,8871,2357,4316,1904,6513,1159,560,599
5740,8882,2359,4322,1906,6521,1160,560,600
5745,8886,2360,4324,1907,6526,1160,560,600
5750,8896,2361,4327,1907,6534,1161,560,601
5755,8902,2361,4330,1907,6541,1163,561,602
5760,8913,2361,4335,1907,6551,1164,562,602
5765,8917,2362,4339,1908,6555,1164,562,602
5770,8927,2363,4345,1909,6563,1165,563,602
5775,8933,2364,4350,1910,6569,1167,565,602
5780,8944,2364,4353,1910,6579,1168,566,602
5785,8948,2365,4354,1911,6583,1168,566,602
5790,8958,2366,4359,1911,6591,1169,566,603
5795,8964,2366,4361,1911,6598,1171,567,604
5800,8975,2367,4365,1912,6606,1172,567,605
5805,8979,2367,4365,1912,6612,1172,567,605
5810,8989,2369,4369,1914,6619,1173,567,606
5815,8995,2369,4370,1914,6625,1175,567,608
5820,9006,2371,4377,1916,6633,1176,567,609
5825,9010,2373,4378,1918,6637,1176,567,609
5830,9020,2375,4383,1920,6644,1177,568,609
5835,9026,2376,4387,1921,6649,1179,570,609
5840,9037,2377,4391,1922,6658,1180,570,610
5845,9041,2381,4395,1926,6658,1180,570,610
5850,9051,2386,4401,1931,6664,1181,571,610
5855,9057,2388,4405,1933,6668,1183,572,611
5860,9068,2391,4410,1935,6675,1184,573,611
5865,9072,2393,4413,1937,6678,1184,573,611
5870,9082,2396,4420,1940,6685,1185,574,611
5875,9088,2398,4426,1942,6688,1187,576,611
5880,9099,2401,4430,1945,6696,1188,576,612
5885,9103,2403,4432,1947,6700,1188,576,612
5890,9113,2406,4439,1950,6706,1189,576,613
5895,9119,2407,4442,1951,6711,1191,577,614
5900,9130,2411,4450,1955,6715,1192,577,615
5905,9134,2415,4453,1959,6719,1192,577,615
5910,9144,2417,4456,1959,6726,1193,578,615
5915,9150,2419,4457,1961,6731,1195,578,617
5920,9161,2422,4463,1963,6736,1196,578,618
5925,9165,2425,4464,1966,6740,1196,578,618
5930,9175,2428,4469,1968,6746,1197,579,618
5935,9181,2429,4473,1969,6750,1199,580,619
5940,9192,2433,4477,1972,6757,1200,580,620
5945,9196,2434,4480,1973,6762,1200,580,620
5950,9206,2436,4483,1974,6769,1201,580,621
5955,9212,2437,4487,1975,6774,1203,581,622
5960,9223,2439,4491,1977,6783,1204,581,623
5965,9227,2441,4495,1979,6785,1204,581,623
5970,9237,2444,4500,1981,6792,1205,582,623
5975,9243,2445,4504,1982,6798,1207,584,623
5980,9254,2446,4511,1983,6805,1208,584,624
5985,9258,2448,4513,1985,6810,1208,584,624
5990,9268,2450,4517,1985,6817,1209,584,625
5995,9274,2450,4519,1985,6824,1211,585,626
6000,9285,2453,4525,1988,6830,1212,585,627
6005,9289,2454,4525,1989,6835,1212,585,627
6010,9299,2455,4528,1989,6843,1213,585,628
6015,9305,2456,4531,1990,6849,1215,587,628
6020,9316,2456,4537,1990,6858,1216,588,628
6025,9320,2457,4538,1991,6863,1216,588,628
6030,9330,2458,4542,1991,6871,1217,588,629
6035,9336,2459,4545,1992,6877,1219,589,630
6040,9347,2459,4550,1992,6886,1220,589,631
6045,9351,2460,4551,1993,6891,1220,589,631
6050,9361,2462,4556,1994,6898,1221,590,631
6055,9367,2463,4558,1995,6903,1223,591,632
6060,9378,2465,4562,1997,6913,1224,592,632
6065,9382,2466,4565,1998,6915,1224,592,632
6070,9392,2469,4570,2001,6923,1225,592,633
6075,9398,2470,4574,2002,6926,1227,592,635
6080,9409,2472,4578,2003,6934,1228,592,636
6085,9413,2475,4580,2006,6938,1228,592,636
6090,9423,2477,4584,2008,6945,1229,592,637
6095,9429,2479,4588,2010,6949,1231,594,637
6100,9440,2481,4595,2011,6956,1232,595,637
6105,9444,2485,4598,2015,6957,1232,595,637
6110,9454,2493,4604,2021,6960,1233,596,637
6115,9460,2494,4608,2022,6963,1235,597,638
6120,9471,2501,4615,2029,6968,1236,598,638
6125,9475,2504,4617,2032,6970,1236,598,638
6130,9485,2505,4622,2033,6980,1237,598,639
6135,9491,2505,4628,2033,6984,1239,600,639
6140,9502,2506,4634,2034,6995,1240,601,639
6145,9506,2507,4635,2035,6999,1240,601,639
6150,9516,2508,4640,2035,7007,1241,601,640
6155,9522,2508,4645,2035,7013,1243,603,640
6160,9533,2509,4652,2036,7022,1244,604,640
6165,9537,2510,4653,2037,7027,1244,604,640
6170,9547,2511,4657,2037,7036,1245,604,641
6175,9553,2511,4659,2037,7042,1247,605,642
6180,9564,2512,4666,2038,7051,1248,606,642
6185,9568,2513,4667,2039,7055,1248,606,642
6190,9578,2514,4672,2040,7063,1249,606,643
6195,9584,2514,4675,2040,7069,1251,606,645
6200,9595,2516,4684,2042,7077,1252,606,646
6205,9599,2517,4686,2043,7082,1252,606,646
6210,9609,2518,4693,2044,7090,1253,606,647
6215,9615,2518,4697,2044,7096,1255,608,647
6220,9626,2520,4702,2046,7106,1256,608,648
6225,9630,2521,4704,2047,7108,1256,608,648
6230,9640,2525,4710,2050,7115,1257,609,648
6235,9646,2525,4713,2050,7121,1259,610,649
6240,9657,2527,4721,2052,7125,1260,611,649
6245,9661,2532,4723,2057,7129,1260,611,649
6250,9671,2534,4730,2059,7136,1261,612,649
6255,9677,2535,4731,2060,7141,1263,612,651
6260,9688,2537,4736,2062,7150,1264,612,652
6265,9692,2538,4738,2063,7153,1264,612,652
6270,9702,2539,4743,2064,7163,1265,613,652
6275,9708,2539,4744,2064,7169,1267,614,653
6280,9719,2541,4751,2066,7177,1268,615,653
6285,9723,2542,4753,2067,7180,1268,615,653
6290,9733,2544,4758,2069,7188,1269,615,654
6295,9739,2546,4761,2071,7192,1271,616,655
6300,9750,2548,4769,2073,7199,1272,617,655
6305,9754,2551,4771,2076,7203,1272,617,655
6310,9764,2552,4776,2077,7211,1273,618,655
6315,9770,2553,4779,2078,7217,1275,619,656
6320,9781,2555,4783,2079,7224,1276,619,657
6325,9785,2557,4784,2081,7228,1276,619,657
6330,9795,2558,4790,2081,7236,1277,620,657
6335,9801,2558,4793,2081,7242,1279,621,658
6340,9812,2558,4795,2081,7253,1280,621,659
6345,9816,2559,4796,2082,7257,1280,621,659
6350,9826,2561,4799,2082,7264,1281,621,660
6355,9832,2561,4803,2082,7269,1283,622,661
6360,9843,2563,4809,2084,7278,1284,622,662
6365,9847,2564,4810,2085,7283,1284,622,662
6370,9857,2566,4815,2085,7290,1285,622,663
6375,9863,2567,4818,2086,7296,1287,624,663
6380,9874,2569,4825,2088,7302,1288,624,664
6385,9878,2570,4827,2089,7308,1288,624,664
6390,9888,2572,4834,2091,7316,1289,625,664
6395,9894,2572,4837,2091,7321,1291,626,665
6400,9905,2574,4843,2093,7328,1292,627,665
6405,9909,2576,4845,2095,7333,1292,627,665
6410,9919,2578,4851,2096,7340,1293,628,665
6415,9925,2578,4853,2096,7346,1295,629,666
6420,9936,2581,4859,2099,7354,1296,629,667
6425,9940,2582,4861,2100,7357,1296,629,667
6430,9950,2585,4865,2102,7364,1297,629,668
6435,9956,2587,4867,2104,7369,1299,629,670
6440,9967,2589,4871,2105,7376,1300,630,670
6445,9971,2592,4872,2108,7379,1300,630,670
6450,9981,2594,4875,2110,7387,1301,630,671
6455,9987,2594,4877,2110,7393,1303,631,672
6460,9998,2596,4879,2112,7402,1304,631,673
6465,10002,2596,4880,2112,7405,1304,631,673
6470,10012,2601,4885,2117,7410,1305,631,674
6475,10018,2603,4889,2119,7413,1307,632,675
6480,10029,2609,4896,2124,7416,1308,632,676
6485,10033,2615,4898,2130,7418,1308,632,676
6490,10043,2619,4901,2133,7424,1309,632,677
6495,10049,2619,4903,2133,7428,1311,632,679
6500,10060,2624,4909,2138,7435,1312,633,679
6505,10064,2625,4912,2139,7438,1312,633,679
6510,10074,2626,4916,2139,7448,1313,633,680
6515,10080,2626,4919,2139,7453,1315,634,681
6520,10091,2629,4926,2142,7460,1316,635,681
6525,10095,2631,4926,2144,7464,1316,635,681
6530,10105,2632,4929,2145,7473,1317,635,682
6535,10111,2633,4931,2146,7477,1319,635,684
6540,10122,2636,4940,2149,7482,1320,636,684
6545,10126,2640,4943,2153,7485,1320,636,684
6550,10136,2642,4950,2155,7493,1321,637,684
6555,10142,2643,4952,2156,7499,1323,638,685
6560,10153,2644,4957,2156,7508,1324,639,685
6565,10157,2645,4960,2157,7512,1324,639,685
6570,10167,2646,4964,2158,7520,1325,639,686
6575,10173,2648,4968,2160,7525,1327,640,687
6580,10184,2651,4971,2163,7533,1328,640,688
6585,10188,2652,4973,2164,7536,1328,640,688
6590,10198,2653,4978,2164,7545,1329,641,688
6595,10204,2653,4980,2164,7551,1331,642,689
6600,10215,2654,4985,2165,7559,1332,643,689
6605,10219,2656,4987,2167,7563,1332,643,689
6610,10229,2659,4991,2169,7570,1333,643,690
6615,10235,2659,4993,2169,7576,1335,644,691
6620,10246,2662,5001,2172,7582,1336,645,691
6625,10250,2665,5004,2175,7585,1336,645,691
6630,10260,2668,5007,2176,7591,1337,645,692
6635,10266,2669,5007,2177,7597,1339,645,694
6640,10277,2671,5013,2179,7605,1340,646,694
6645,10281,2671,5014,2179,7610,1340,646,694
6650,10291,2673,5019,2180,7618,1341,647,694
6655,10297,2673,5021,2180,7624,1343,648,695
6660,10308,2675,5026,2182,7632,1344,648,696
6665,10312,2676,5028,2183,7635,1344,648,696
6670,10322,2681,5037,2188,7640,1345,649,696
6675,10328,2681,5040,2188,7647,1347,651,696
6680,10339,2683,5045,2190,7656,1348,652,696
6685,10343,2684,5048,2191,7659,1348,652,696
6690,10353,2687,5053,2193,7666,1349,652,697
6695,10359,2687,5055,2193,7671,1351,653,698
6700,10370,2690,5060,2196,7678,1352,653,699
6705,10374,2692,5063,2198,7681,1352,653,699
6710,10384,2697,5072,2203,7686,1353,654,699
6715,10390,2698,5077,2204,7690,1355,656,699
6720,10401,2702,5085,2208,7696,1356,657,699
6725,10405,2704,5086,2210,7700,1356,657,699
6730,10415,2709,5091,2213,7705,1357,658,699
6735,10421,2711,5095,2215,7709,1359,660,699
6740,10432,2713,5102,2217,7716,1360,660,700
6745,10436,2717,5104,2221,7718,1360,660,700
6750,10446,2718,5106,2221,7727,1361,660,701
6755,10452,2719,5107,2222,7733,1363,661,702
6760,10463,2721,5113,2224,7740,1364,661,703
6765,10467,2723,5114,2226,7744,1364,661,703
6770,10477,2725,5119,2228,7752,1365,661,704
6775,10483,2725,5121,2228,7758,1367,663,704
6780,10494,2727,5126,2229,7765,1368,664,704
6785,10498,2730,5127,2232,7768,1368,664,704
6790,10508,2732,5133,2234,7775,1369,664,705
6795,10514,2733,5136,2235,7780,1371,666,705
6800,10525,2735,5140,2237,7789,1372,667,705
6805,10529,2737,5143,2239,7792,1372,667,705
6810,10539,2739,5149,2241,7800,1373,668,705
6815,10545,2740,5154,2242,7804,1375,670,705
6820,10556,2741,5161,2243,7812,1376,671,705
6825,10560,2744,5164,2246,7816,1376,671,705
6830,10570,2745,5168,2246,7825,1377,672,705
6835,10576,2745,5171,2246,7829,1379,672,707
6840,10587,2749,5176,2250,7836,1380,672,708
6845,10591,2750,5176,2251,7841,1380,672,708
6850,10601,2753,5178,2252,7847,1381,672,709
6855,10607,2755,5182,2254,7851,1383,674,709
6860,10618,2759,5188,2257,7858,1384,675,709
6865,10622,2760,5191,2258,7862,1384,675,709
6870,10632,2762,5199,2259,7869,1385,675,710
6875,10638,2762,5202,2259,7874,1387,676,711
6880,10649,2763,5204,2260,7886,1388,676,712
6885,10653,2763,5205,2260,7890,1388,676,712
6890,10663,2765,5209,2260,7897,1389,676,713
6895,10669,2766,5213,2261,7901,1391,677,714
6900,10680,2770,5218,2265,7908,1392,678,714
6905,10684,2771,5219,2266,7912,1392,678,714
6910,10694,2774,5224,2267,7919,1393,678,715
6915,10700,2775,5227,2268,7925,1395,679,716
6920,10711,2778,5234,2271,7931,1396,679,717
6925,10715,2779,5235,2272,7936,1396,679,717
6930,10725,2781,5240,2273,7943,1397,679,718
6935,10731,2782,5245,2274,7949,1399,681,718
6940,10742,2784,5250,2276,7956,1400,681,719
6945,10746,2786,5252,2278,7959,1400,681,719
6950,10756,2789,5255,2280,7967,1401,681,720
6955,10762,2790,5259,2281,7972,1403,682,721
6960,10773,2792,5264,2283,7979,1404,682,722
6965,10777,2794,5265,2285,7983,1404,682,722
6970,10787,2798,5272,2289,7989,1405,683,722
6975,10793,2798,5275,2289,7995,1407,685,722
6980,10804,2802,5282,2293,7999,1408,685,723
6985,10808,2806,5285,2297,8001,1408,685,723
6990,10818,2810,5291,2300,8007,1409,686,723
6995,10824,2812,5294,2302,8011,1411,687,724
7000,10835,2816,5300,2305,8016,1412,688,724
7005,10839,2819,5302,2308,8019,1412,688,724
7010,10849,2822,5303,2310,8027,1413,688,725
7015,10855,2823,5304,2311,8032,1415,688,727
7020,10866,2826,5311,2313,8037,1416,689,727
7025,10870,2828,5313,2315,8041,1416,689,727
7030,10880,2829,5317,2315,8051,1417,689,728
7035,10886,2830,5321,2316,8056,1419,691,728
7040,10897,2832,5328,2318,8063,1420,692,728
7045,10901,2835,5332,2321,8065,1420,692,728
7050,10911,2837,5336,2322,8074,1421,693,728
7055,10917,2837,5339,2322,8078,1423,694,729
7060,10928,2839,5346,2324,8088,1424,695,729
7065,10932,2840,5348,2325,8091,1424,695,729
7070,10942,2843,5354,2328,8098,1425,695,730
7075,10948,2844,5358,2329,8102,1427,696,731
7080,10959,2847,5367,2332,8109,1428,697,731
7085,10963,2849,5368,2334,8114,1428,697,731
7090,10973,2850,5373,2335,8123,1429,697,732
7095,10979,2851,5376,2336,8128,1431,698,733
7100,10990,2852,5381,2337,8137,1432,699,733
7105,10994,2853,5385,2338,8141,1432,699,733
7110,11004,2854,5392,2339,8149,1433,700,733
7115,11010,2855,5395,2340,8155,1435,701,734
7120,11021,2856,5401,2341,8164,1436,701,735
7125,11025,2856,5402,2341,8169,1436,701,735
7130,11035,2858,5409,2342,8177,1437,702,735
7135,11041,2858,5410,2342,8183,1439,703,736
7140,11052,2859,5415,2343,8191,1440,704,736
7145,11056,2861,5417,2345,8195,1440,704,736
7150,11066,2863,5422,2345,8202,1441,705,736
7155,11072,2863,5425,2345,8208,1443,705,738
7160,11083,2865,5429,2347,8217,1444,706,738
7165,11087,2865,5432,2347,8222,1444,706,738
7170,11097,2867,5436,2348,8229,1445,706,739
7175,11103,2868,5439,2349,8235,1447,708,739
7180,11114,2868,5444,2349,8244,1448,709,739
7185,11118,2870,5446,2351,8248,1448,709,739
7190,11128,2874,5452,2355,8253,1449,709,740
7195,11134,2875,5455,2356,8258,1451,711,740
7200,11145,2877,5461,2358,8264,1452,712,740
7205,11149,2882,5463,2363,8266,1452,712,740
7210,11159,2887,5467,2368,8272,1453,712,741
7215,11165,2888,5471,2369,8276,1455,714,741
7220,11176,2893,5474,2373,8283,1456,714,742
7225,11180,2894,5475,2374,8286,1456,714,742
7230,11190,2898,5480,2378,8291,1457,714,743
7235,11196,2899,5484,2379,8294,1459,715,744
7240,11207,2905,5489,2385,8301,1460,716,744
7245,11211,2908,5492,2388,8302,1460,716,744
7250,11221,2914,5499,2393,8305,1461,717,744
7255,11227,2917,5502,2396,8310,1463,717,746
7260,11238,2919,5509,2398,8315,1464,718,746
7265,11242,2923,5511,2402,8319,1464,718,746
7270,11252,2924,5517,2403,8327,1465,718,747
7275,11258,2925,5522,2404,8333,1467,720,747
7280,11269,2927,5529,2406,8338,1468,720,748
7285,11273,2930,5530,2409,8343,1468,720,748
7290,11283,2932,5535,2411,8350,1469,720,749
7295,11289,2933,5538,2412,8356,1471,722,749
7300,11300,2934,5542,2413,8364,1472,722,750
7305,11304,2935,5544,2414,8369,1472,722,750
7310,11314,2936,5549,2415,8377,1473,722,751
7315,11320,2936,5553,2415,8384,1475,724,751
7320,11331,2936,5557,2415,8393,1476,724,752
7325,11335,2937,5560,2416,8398,1476,724,752
7330,11345,2938,5563,2416,8407,1477,724,753
7335,11351,2938,5564,2416,8413,1479,724,755
7340,11362,2938,5567,2416,8424,1480,724,756
7345,11366,2938,5569,2416,8428,1480,724,756
7350,11376,2939,5573,2416,8437,1481,724,757
7355,11382,2940,5576,2417,8442,1483,725,758
7360,11393,2940,5581,2417,8451,1484,726,758
7365,11397,2941,5583,2418,8455,1484,726,758
7370,11407,2945,5586,2420,8461,1485,726,759
7375,11413,2945,5589,2420,8467,1487,728,759
7380,11424,2948,5593,2423,8476,1488,728,760
7385,11428,2948,5595,2423,8478,1488,728,760
7390,11438,2952,5599,2427,8485,1489,728,761
7395,11444,2953,5604,2428,8488,1491,729,762
7400,11455,2958,5607,2432,8496,1492,729,763
7405,11459,2959,5609,2433,8499,1492,729,763
7410,11469,2963,5616,2436,8505,1493,729,764
7415,11475,2965,5618,2438,8509,1495,729,766
7420,11486,2968,5623,2441,8517,1496,729,767
7425,11490,2970,5626,2443,8520,1496,729,767
7430,11500,2973,5630,2446,8527,1497,729,768
7435,11506,2974,5633,2447,8531,1499,730,769
7440,11517,2978,5636,2450,8539,1500,730,770
7445,11521,2978,5637,2450,8543,1500,730,770
7450,11531,2980,5641,2451,8551,1501,731,770
7455,11537,2980,5643,2451,8555,1503,731,772
7460,11548,2983,5644,2453,8565,1504,731,773
7465,11552,2984,5646,2454,8567,1504,731,773
7470,11562,2988,5651,2456,8573,1505,731,774
7475,11568,2989,5653,2457,8579,1507,732,775
7480,11579,2990,5656,2457,8587,1508,733,775
7485,11583,2991,5656,2458,8592,1508,733,775
7490,11593,2993,5660,2458,8599,1509,733,776
7495,11599,2995,5663,2460,8603,1511,734,777
7500,11610,3000,5668,2464,8609,1512,734,778
7505,11614,3002,5671,2466,8610,1512,734,778
7510,11624,3009,5675,2471,8615,1513,735,778
7515,11630,3009,5677,2471,8621,1515,736,779
7520,11641,3012,5683,2474,8626,1516,736,780
7525,11645,3015,5685,2477,8629,1516,736,780
7530,11655,3020,5690,2481,8635,1517,737,780
7535,11661,3020,5691,2481,8641,1519,738,781
7540,11672,3024,5697,2484,8646,1520,739,781
7545,11676,3025,5699,2485,8650,1520,739,781
7550,11686,3030,5704,2489,8656,1521,739,782
7555,11692,3030,5705,2489,8662,1523,739,784
7560,11703,3031,5707,2489,8670,1524,739,785
7565,11707,3034,5710,2492,8672,1524,739,785
7570,11717,3036,5718,2493,8680,1525,740,785
7575,11723,3036,5720,2493,8687,1527,741,786
7580,11734,3036,5725,2493,8696,1528,741,787
7585,11738,3037,5728,2494,8701,1528,741,787
7590,11748,3038,5734,2495,8710,1529,742,787
7595,11754,3039,5738,2496,8715,1531,744,787
7600,11765,3040,5744,2497,8725,1532,745,787
7605,11769,3040,5745,2497,8729,1532,745,787
7610,11779,3041,5749,2497,8738,1533,745,788
7615,11785,3041,5752,2497,8744,1535,746,789
7620,11796,3041,5756,2497,8755,1536,746,790
7625,11800,3041,5758,2497,8759,1536,746,790
7630,11810,3042,5759,2497,8768,1537,746,791
7635,11816,3043,5762,2498,8773,1539,747,792
7640,11827,3044,5768,2499,8782,1540,747,793
7645,11831,3044,5772,2499,8787,1540,747,793
7650,11841,3045,5776,2499,8795,1541,747,794
7655,11847,3045,5778,2499,8802,1543,748,795
7660,11858,3045,5783,2499,8813,1544,749,795
7665,11862,3045,5787,2499,8817,1544,749,795
7670,11872,3048,5793,2501,8824,1545,749,796
7675,11878,3048,5796,2501,8828,1547,749,798
7680,11889,3053,5803,2506,8832,1548,749,799
7685,11893,3058,5806,2511,8833,1548,749,799
7690,11903,3064,5813,2517,8837,1549,750,799
7695,11909,3066,5814,2519,8843,1551,750,801
7700,11920,3068,5823,2521,8847,1552,751,801
7705,11924,3072,5825,2525,8852,1552,751,801
7710,11934,3075,5830,2527,8858,1553,751,802
7715,11940,3077,5832,2529,8863,1555,752,803
7720,11951,3079,5837,2530,8870,1556,753,803
7725,11955,3080,5839,2531,8874,1556,753,803
7730,11965,3084,5845,2535,8880,1557,753,804
7735,11971,3085,5846,2536,8886,1559,754,805
7740,11982,3088,5851,2538,8891,1560,754,806
7745,11986,3090,5853,2540,8896,1560,754,806
7750,11996,3093,5857,2542,8903,1561,754,807
7755,12002,3094,5860,2543,8907,1563,754,809
7760,12013,3099,5866,2547,8912,1564,755,809
7765,12017,3101,5868,2549,8916,1564,755,809
7770,12027,3105,5874,2552,8921,1565,756,809
7775,12033,3106,5877,2553,8927,1567,758,809
7780,12044,3107,5883,2554,8934,1568,758,810
7785,12048,3108,5885,2555,8940,1568,758,810
7790,12058,3110,5889,2556,8947,1569,759,810
7795,12064,3111,5894,2557,8951,1571,761,810
7800,12075,3114,5899,2560,8957,1572,761,811
7805,12079,3118,5901,2564,8960,1572,761,811
7810,12089,3123,5907,2568,8965,1573,762,811
7815,12095,3124,5913,2569,8968,1575,764,811
7820,12106,3126,5917,2571,8978,1576,764,812
7825,12110,3126,5918,2571,8984,1576,764,812
7830,12120,3127,5923,2572,8992,1577,765,812
7835,12126,3128,5928,2573,8996,1579,767,812
7840,12137,3128,5936,2573,9006,1580,768,812
7845,12141,3129,5937,2574,9012,1580,768,812
7850,12151,3130,5940,2575,9021,1581,768,813
7855,12157,3131,5944,2576,9026,1583,769,814
7860,12168,3131,5949,2576,9036,1584,770,814
7865,12172,3131,5952,2576,9041,1584,770,814
7870,12182,3132,5955,2576,9050,1585,771,814
7875,12188,3132,5958,2576,9056,1587,773,814
7880,12199,3133,5960,2577,9066,1588,773,815
7885,12203,3133,5962,2577,9070,1588,773,815
7890,12213,3135,5966,2578,9078,1589,773,816
7895,12219,3136,5971,2579,9083,1591,775,816
7900,12230,3138,5978,2581,9090,1592,776,816
7905,12234,3139,5978,2582,9095,1592,776,816
7910,12244,3142,5986,2585,9101,1593,776,817
7915,12250,3143,5987,2586,9107,1595,777,818
7920,12261,3145,5992,2587,9115,1596,778,818
7925,12265,3146,5992,2588,9119,1596,778,818
7930,12275,3148,5994,2589,9127,1597,779,818
7935,12281,3148,5996,2589,9133,1599,780,819
7940,12292,3150,6001,2590,9139,1600,781,819
7945,12296,3154,6003,2594,9141,1600,781,819
7950,12306,3157,6005,2596,9149,1601,782,819
7955,12312,3157,6005,2596,9155,1603,782,821
7960,12323,3159,6010,2598,9162,1604,783,821
7965,12327,3163,6013,2602,9163,1604,783,821
7970,12337,3167,6017,2606,9169,1605,783,822
7975,12343,3168,6020,2607,9173,1607,784,823
7980,12354,3174,6024,2612,9179,1608,784,824
7985,12358,3175,6024,2613,9183,1608,784,824
7990,12368,3179,6028,2616,9188,1609,784,825
7995,12374,3181,6031,2618,9191,1611,784,827
8000,12385,3184,6032,2620,9200,1612,784,828
8005,12389,3185,6032,2621,9204,1612,784,828
8010,12399,3189,6036,2623,9209,1613,785,828
8015,12405,3190,6037,2624,9214,1615,785,830
8020,12416,3194,6042,2628,9221,1616,786,830
8025,12420,3197,6044,2631,9223,1616,786,830
8030,12430,3201,6048,2634,9228,1617,786,831
8035,12436,3203,6049,2636,9233,1619,786,833
8040,12447,3206,6054,2639,9240,1620,787,833
8045,12451,3207,6056,2640,9243,1620,787,833
8050,12461,3210,6064,2642,9250,1621,788,833
8055,12467,3211,6065,2643,9256,1623,789,834
8060,12478,3212,6066,2643,9266,1624,790,834
8065,12482,3213,6068,2644,9269,1624,790,834
8070,12492,3215,6075,2646,9277,1625,791,834
8075,12498,3215,6078,2646,9282,1627,792,835
8080,12509,3218,6083,2648,9290,1628,793,835
8085,12513,3219,6084,2649,9294,1628,793,835
8090,12523,3221,6087,2651,9301,1629,793,836
8095,12529,3222,6090,2652,9306,1631,794,837
8100,12540,3225,6096,2655,9313,1632,794,838
8105,12544,3226,6098,2656,9317,1632,794,838
8110,12554,3227,6102,2656,9326,1633,794,839
8115,12560,3227,6103,2656,9333,1635,794,841
8120,12571,3228,6109,2657,9341,1636,794,842
8125,12575,3229,6111,2658,9345,1636,794,842
8130,12585,3230,6117,2658,9354,1637,795,842
8135,12591,3230,6119,2658,9361,1639,796,843
8140,12602,3230,6125,2658,9369,1640,796,844
8145,12606,3231,6127,2659,9375,1640,796,844
8150,12616,3233,6133,2660,9382,1641,796,845
8155,12622,3233,6136,2660,9389,1643,797,846
8160,12633,3235,6143,2662,9395,1644,797,847
8165,12637,3236,6145,2663,9401,1644,797,847
8170,12647,3238,6149,2664,9408,1645,797,848
8175,12653,3239,6152,2665,9414,1647,797,850
8180,12664,3240,6155,2666,9423,1648,797,851
8185,12668,3242,6158,2668,9425,1648,797,851
8190,12678,3245,6163,2669,9432,1649,798,851
8195,12684,3246,6166,2670,9438,1651,799,852
8200,12695,3247,6171,2671,9447,1652,799,853
8205,12699,3249,6175,2673,9449,1652,799,853
8210,12709,3252,6176,2675,9456,1653,799,854
8215,12715,3253,6179,2676,9462,1655,800,855
8220,12726,3255,6181,2677,9471,1656,800,856
8225,12730,3257,6184,2679,9473,1656,800,856
8230,12740,3261,6188,2681,9478,1657,800,857
8235,12746,3261,6189,2681,9485,1659,801,858
8240,12757,3263,6190,2682,9494,1660,801,859
8245,12761,3264,6192,2683,9496,1660,801,859
8250,12771,3268,6198,2687,9502,1661,802,859
8255,12777,3268,6200,2687,9508,1663,803,860
8260,12788,3272,6206,2690,9514,1664,804,860
8265,12792,3275,6208,2693,9517,1664,804,860
8270,12802,3278,6213,2695,9523,1665,805,860
8275,12808,3279,6216,2696,9529,1667,806,861
8280,12819,3282,6220,2698,9535,1668,806,862
8285,12823,3285,6223,2701,9536,1668,806,862
8290,12833,3294,6230,2709,9538,1669,806,863
8295,12839,3296,6231,2711,9543,1671,806,865
8300,12850,3300,6239,2715,9547,1672,807,865
8305,12854,3303,6241,2718,9551,1672,807,865
8310,12864,3305,6246,2720,9558,1673,808,865
8315,12870,3306,6250,2721,9562,1675,809,866
8320,12881,3308,6256,2723,9572,1676,810,866
8325,12885,3310,6259,2725,9574,1676,810,866
8330,12895,3312,6262,2726,9582,1677,810,867
8335,12901,3313,6266,2727,9587,1679,812,867
8340,12912,3315,6271,2728,9595,1680,813,867
8345,12916,3316,6272,2729,9600,1680,813,867
8350,12926,3317,6275,2729,9608,1681,813,868
8355,12932,3318,6277,2730,9614,1683,813,870
8360,12943,3319,6283,2731,9622,1684,813,871
8365,12947,3320,6286,2732,9626,1684,813,871
8370,12957,3321,6291,2733,9635,1685,814,871
8375,12963,3321,6293,2733,9642,1687,815,872
8380,12974,3322,6301,2734,9649,1688,816,872
8385,12978,3323,6303,2735,9655,1688,816,872
8390,12988,3324,6310,2735,9663,1689,817,872
8395,12994,3325,6314,2736,9669,1691,819,872
8400,13005,3326,6321,2737,9677,1692,820,872
8405,13009,3327,6324,2738,9681,1692,820,872
8410,13019,3328,6328,2738,9690,1693,820,873
8415,13025,3328,6331,2738,9696,1695,821,874
8420,13036,3330,6339,2740,9704,1696,822,874
8425,13040,3330,6342,2740,9710,1696,822,874
8430,13050,3331,6347,2740,9718,1697,823,874
8435,13056,3331,6351,2740,9724,1699,825,874
8440,13067,3332,6358,2741,9733,1700,826,874
8445,13071,3333,6359,2742,9738,1700,826,874
8450,13081,3334,6363,2742,9746,1701,827,874
8455,13087,3334,6366,2742,9752,1703,828,875
8460,13098,3337,6368,2744,9760,1704,828,876
8465,13102,3338,6368,2745,9764,1704,828,876
8470,13112,3340,6373,2747,9771,1705,829,876
8475,13118,3340,6376,2747,9777,1707,829,878
8480,13129,3344,6382,2750,9783,1708,830,878
8485,13133,3348,6385,2754,9785,1708,830,878
8490,13143,3350,6387,2755,9792,1709,831,878
8495,13149,3350,6389,2755,9799,1711,831,880
8500,13160,3353,6394,2757,9806,1712,831,881
8505,13164,3354,6396,2758,9810,1712,831,881
8510,13174,3358,6401,2761,9815,1713,831,882
8515,13180,3359,6404,2762,9821,1715,832,883
8520,13191,3363,6410,2766,9827,1716,833,883
8525,13195,3366,6413,2769,9828,1716,833,883
8530,13205,3371,6416,2772,9833,1717,834,883
8535,13211,3372,6419,2773,9838,1719,835,884
8540,13222,3375,6423,2776,9845,1720,835,885
8545,13226,3378,6425,2779,9847,1720,835,885
8550,13236,3385,6432,2785,9849,1721,835,886
8555,13242,3387,6433,2787,9854,1723,835,888
8560,13253,3391,6440,2790,9859,1724,836,888
8565,13257,3393,6442,2792,9864,1724,836,888
8570,13267,3395,6445,2793,9871,1725,836,889
8575,13273,3395,6445,2793,9878,1727,836,891
8580,13284,3396,6449,2794,9885,1728,836,892
8585,13288,3399,6452,2797,9888,1728,836,892
8590,13298,3400,6456,2798,9897,1729,837,892
8595,13304,3401,6461,2799,9902,1731,839,892
8600,13315,3402,6465,2800,9913,1732,839,893
8605,13319,3403,6466,2801,9916,1732,839,893
8610,13329,3405,6474,2803,9923,1733,840,893
8615,13335,3407,6478,2805,9928,1735,841,894
8620,13346,3409,6486,2807,9934,1736,842,894
8625,13350,3413,6488,2811,9937,1736,842,894
8630,13360,3414,6491,2812,9945,1737,842,895
8635,13366,3415,6495,2813,9951,1739,843,896
8640,13377,3415,6501,2813,9961,1740,844,896
8645,13381,3416,6503,2814,9965,1740,844,896
8650,13391,3417,6506,2815,9973,1741,844,897
8655,13397,3418,6511,2816,9979,1743,845,898
8660,13408,3419,6517,2817,9987,1744,845,899
8665,13412,3420,6520,2818,9992,1744,845,899
8670,13422,3422,6528,2820,9999,1745,846,899
8675,13428,3422,6530,2820,10005,1747,847,900
8680,13439,3424,6536,2822,10012,1748,848,900
8685,13443,3426,6538,2824,10017,1748,848,900
8690,13453,3428,6541,2824,10024,1749,849,900
8695,13459,3428,6543,2824,10031,1751,849,902
8700,13470,3429,6550,2825,10039,1752,850,902
8705,13474,3430,6554,2826,10043,1752,850,902
8710,13484,3432,6556,2826,10051,1753,851,902
8715,13490,3432,6558,2826,10057,1755,851,904
8720,13501,3434,6563,2828,10066,1756,852,904
8725,13505,3434,6566,2828,10071,1756,852,904
8730,13515,3437,6571,2831,10077,1757,853,904
8735,13521,3437,6575,2831,10082,1759,855,904
8740,13532,3443,6582,2836,10086,1760,856,904
8745,13536,3448,6586,2841,10086,1760,856,904
8750,13546,3454,6590,2846,10090,1761,856,905
8755,13552,3456,6592,2848,10096,1763,857,906
8760,13563,3459,6598,2850,10101,1764,858,906
8765,13567,3463,6600,2854,10103,1764,858,906
8770,13577,3469,6606,2859,10107,1765,858,907
8775,13583,3471,6611,2861,10111,1767,860,907
8780,13594,3475,6616,2865,10117,1768,860,908
8785,13598,3477,6619,2867,10121,1768,860,908
8790,13608,3478,6623,2868,10129,1769,860,909
8795,13614,3479,6624,2869,10135,1771,860,911
8800,13625,3481,6628,2870,10143,1772,861,911
8805,13629,3483,6632,2872,10146,1772,861,911
8810,13639,3484,6634,2872,10154,1773,861,912
8815,13645,3484,6637,2872,10161,1775,862,913
8820,13656,3487,6642,2875,10168,1776,862,914
8825,13660,3489,6644,2877,10171,1776,862,914
8830,13670,3490,6649,2878,10179,1777,862,915
8835,13676,3491,6652,2879,10185,1779,863,916
8840,13687,3493,6658,2880,10191,1780,863,917
8845,13691,3495,6660,2882,10196,1780,863,917
8850,13701,3496,6664,2882,10205,1781,864,917
8855,13707,3497,6667,2883,10210,1783,865,918
8860,13718,3498,6669,2883,10219,1784,865,919
8865,13722,3499,6671,2884,10223,1784,865,919
8870,13732,3500,6673,2884,10232,1785,865,920
8875,13738,3501,6677,2885,10237,1787,866,921
8880,13749,3503,6683,2886,10243,1788,867,921
8885,13753,3506,6684,2889,10246,1788,867,921
8890,13763,3510,6686,2891,10252,1789,867,922
8895,13769,3511,6688,2892,10257,1791,868,923
8900,13780,3514,6693,2894,10262,1792,868,924
8905,13784,3519,6695,2899,10264,1792,868,924
8910,13794,3526,6701,2905,10268,1793,869,924
8915,13800,3527,6704,2906,10271,1795,869,926
8920,13811,3533,6710,2912,10277,1796,870,926
8925,13815,3536,6713,2915,10278,1796,870,926
8930,13825,3540,6719,2918,10284,1797,871,926
8935,13831,3542,6721,2920,10289,1799,872,927
8940,13842,3544,6727,2921,10294,1800,872,928
8945,13846,3547,6728,2924,10299,1800,872,928
8950,13856,3549,6731,2924,10306,1801,873,928
8955,13862,3549,6732,2924,10313,1803,874,929
8960,13873,3550,6736,2925,10323,1804,875,929
8965,13877,3550,6737,2925,10327,1804,875,929
8970,13887,3552,6741,2925,10335,1805,876,929
8975,13893,3552,6743,2925,10340,1807,876,931
8980,13904,3553,6746,2926,10350,1808,876,932
8985,13908,3553,6747,2926,10355,1808,876,932
8990,13918,3555,6753,2927,10363,1809,877,932
8995,13924,3555,6754,2927,10369,1811,878,933
9000,13935,3556,6758,2928,10378,1812,878,934
9005,13939,3556,6760,2928,10382,1812,878,934
9010,13949,3558,6766,2929,10391,1813,878,935
9015,13955,3558,6769,2929,10396,1815,879,936
9020,13966,3559,6772,2930,10405,1816,879,937
9025,13970,3560,6773,2931,10410,1816,879,937
9030,13980,3562,6777,2931,10418,1817,880,937
9035,13986,3562,6781,2931,10423,1819,881,938
9040,13997,3565,6787,2934,10430,1820,882,938
9045,14001,3566,6788,2935,10435,1820,882,938
9050,14011,3568,6791,2935,10442,1821,882,939
9055,14017,3570,6794,2937,10446,1823,882,941
9060,14028,3574,6799,2941,10452,1824,882,942
9065,14032,3576,6800,2943,10456,1824,882,942
9070,14042,3580,6802,2945,10462,1825,882,943
9075,14048,3581,6804,2946,10467,1827,882,945
9080,14059,3584,6810,2949,10472,1828,882,946
9085,14063,3587,6812,2952,10475,1828,882,946
9090,14073,3592,6820,2957,10480,1829,883,946
9095,14079,3593,6821,2958,10486,1831,883,948
9100,14090,3596,6829,2961,10490,1832,884,948
9105,14094,3601,6832,2966,10492,1832,884,948
9110,14104,3604,6836,2969,10499,1833,884,949
9115,14110,3605,6838,2970,10505,1835,886,949
9120,14121,3606,6843,2970,10511,1836,887,949
9125,14125,3610,6843,2974,10515,1836,887,949
9130,14135,3614,6848,2977,10520,1837,887,950
9135,14141,3616,6853,2979,10525,1839,889,950
9140,14152,3617,6856,2979,10534,1840,890,950
9145,14156,3618,6856,2980,10538,1840,890,950
9150,14166,3621,6862,2983,10544,1841,890,951
9155,14172,3622,6864,2984,10550,1843,891,952
9160,14183,3623,6868,2984,10559,1844,892,952
9165,14187,3624,6868,2985,10563,1844,892,952
9170,14197,3626,6873,2987,10571,1845,893,952
9175,14203,3626,6874,2987,10577,1847,893,954
9180,14214,3628,6878,2988,10585,1848,893,955
9185,14218,3629,6880,2989,10589,1848,893,955
9190,14228,3630,6886,2989,10598,1849,894,955
9195,14234,3631,6887,2990,10603,1851,894,957
9200,14245,3632,6895,2991,10611,1852,894,958
9205,14249,3633,6898,2992,10616,1852,894,958
9210,14259,3634,6902,2993,10625,1853,895,958
9215,14265,3635,6908,2994,10629,1855,897,958
9220,14276,3636,6914,2995,10639,1856,897,959
9225,14280,3636,6917,2995,10644,1856,897,959
9230,14290,3636,6924,2995,10653,1857,898,959
9235,14296,3636,6926,2995,10658,1859,898,961
9240,14307,3640,6930,2999,10666,1860,898,962
9245,14311,3641,6931,3000,10670,1860,898,962
9250,14321,3643,6937,3002,10676,1861,898,963
9255,14327,3644,6941,3003,10681,1863,899,964
9260,14338,3647,6947,3006,10690,1864,899,965
9265,14342,3648,6948,3007,10694,1864,899,965
9270,14352,3651,6953,3010,10700,1865,900,965
9275,14358,3652,6955,3011,10704,1867,900,967
9280,14369,3654,6956,3013,10715,1868,900,968
9285,14373,3654,6958,3013,10719,1868,900,968
9290,14383,3656,6964,3014,10726,1869,901,968
9295,14389,3657,6967,3015,10732,1871,903,968
9300,14400,3658,6972,3015,10739,1872,904,968
9305,14404,3661,6975,3018,10742,1872,904,968
9310,14414,3662,6977,3018,10751,1873,904,969
9315,14420,3663,6978,3019,10757,1875,905,970
9320,14431,3666,6985,3022,10762,1876,905,971
9325,14435,3668,6986,3024,10767,1876,905,971
9330,14445,3671,6992,3027,10774,1877,906,971
9335,14451,3672,6995,3028,10779,1879,908,971
9340,14462,3675,7001,3031,10785,1880,908,972
9345,14466,3678,7004,3034,10787,1880,908,972
9350,14476,3682,7010,3036,10793,1881,908,973
9355,14482,3683,7012,3037,10798,1883,909,974
9360,14493,3687,7015,3040,10805,1884,909,975
9365,14497,3689,7016,3042,10808,1884,909,975
9370,14507,3692,7021,3045,10815,1885,910,975
9375,14513,3692,7023,3045,10820,1887,910,977
9380,14524,3693,7028,3046,10829,1888,911,977
9385,14528,3696,7030,3049,10831,1888,911,977
9390,14538,3701,7034,3053,10837,1889,912,977
9395,14544,3701,7037,3053,10842,1891,913,978
9400,14555,3706,7044,3058,10846,1892,913,979
9405,14559,3709,7047,3061,10850,1892,913,979
9410,14569,3710,7051,3061,10858,1893,913,980
9415,14575,3710,7055,3061,10865,1895,914,981
9420,14586,3711,7062,3062,10875,1896,915,981
9425,14590,3711,7066,3062,10879,1896,915,981
9430,14600,3712,7071,3063,10888,1897,915,982
9435,14606,3712,7076,3063,10894,1899,917,982
9440,14617,3712,7079,3063,10905,1900,918,982
9445,14621,3712,7080,3063,10909,1900,918,982
9450,14631,3713,7083,3063,10917,1901,918,983
9455,14637,3713,7085,3063,10924,1903,919,984
9460,14648,3713,7090,3063,10934,1904,920,984
9465,14652,3713,7091,3063,10939,1904,920,984
9470,14662,3714,7097,3064,10948,1905,920,985
9475,14668,3715,7099,3065,10953,1907,920,987
9480,14679,3716,7103,3066,10962,1908,921,987
9485,14683,3716,7105,3066,10967,1908,921,987
9490,14693,3717,7109,3066,10976,1909,922,987
9495,14699,3717,7111,3066,10982,1911,923,988
9500,14710,3718,7119,3067,10989,1912,924,988
9505,14714,3719,7120,3068,10994,1912,924,988
9510,14724,3724,7124,3072,10999,1913,924,989
9515,14730,3726,7127,3074,11002,1915,924,991
9520,14741,3731,7134,3079,11007,1916,925,991
9525,14745,3734,7135,3082,11010,1916,925,991
9530,14755,3739,7140,3086,11015,1917,926,991
9535,14761,3741,7144,3088,11018,1919,927,992
9540,14772,3745,7150,3092,11024,1920,928,992
9545,14776,3750,7154,3097,11024,1920,928,992
9550,14786,3757,7161,3103,11028,1921,928,993
9555,14792,3758,7163,3104,11033,1923,929,994
9560,14803,3760,7170,3106,11041,1924,930,994
9565,14807,3762,7172,3108,11045,1924,930,994
9570,14817,3764,7177,3110,11053,1925,931,994
9575,14823,3764,7180,3110,11058,1927,931,996
9580,14834,3766,7185,3112,11066,1928,931,997
9585,14838,3767,7186,3113,11071,1928,931,997
9590,14848,3769,7188,3115,11079,1929,931,998
9595,14854,3770,7192,3116,11083,1931,932,999
9600,14865,3772,7198,3117,11091,1932,932,1000
9605,14869,3774,7200,3119,11095,1932,932,1000
9610,14879,3775,7201,3119,11104,1933,932,1001
9615,14885,3776,7202,3120,11109,1935,932,1003
9620,14896,3778,7209,3122,11117,1936,933,1003
9625,14900,3779,7211,3123,11121,1936,933,1003
9630,14910,3782,7216,3125,11128,1937,933,1004
9635,14916,3782,7218,3125,11134,1939,934,1005
9640,14927,3783,7220,3125,11144,1940,934,1006
9645,14931,3784,7223,3126,11146,1940,934,1006
9650,14941,3786,7228,3128,11155,1941,934,1007
9655,14947,3786,7232,3128,11159,1943,936,1007
9660,14958,3788,7237,3130,11168,1944,937,1007
9665,14962,3790,7239,3132,11172,1944,937,1007
9670,14972,3792,7243,3132,11179,1945,937,1008
9675,14978,3794,7247,3134,11184,1947,939,1008
9680,14989,3797,7253,3137,11190,1948,940,1008
9685,14993,3800,7254,3140,11193,1948,940,1008
9690,15003,3803,7256,3141,11200,1949,941,1008
9695,15009,3803,7258,3141,11205,1951,942,1009
9700,15020,3807,7263,3145,11211,1952,942,1010
9705,15024,3810,7266,3148,11213,1952,942,1010
9710,15034,3814,7271,3150,11219,1953,942,1011
9715,15040,3815,7274,3151,11224,1955,943,1012
9720,15051,3819,7280,3154,11229,1956,944,1012
9725,15055,3822,7284,3157,11232,1956,944,1012
9730,15065,3825,7288,3159,11239,1957,944,1013
9735,15071,3825,7292,3159,11245,1959,946,1013
9740,15082,3828,7298,3162,11252,1960,946,1014
9745,15086,3830,7299,3164,11256,1960,946,1014
9750,15096,3832,7303,3164,11264,1961,947,1014
9755,15102,3833,7306,3165,11269,1963,948,1015
9760,15113,3835,7313,3167,11275,1964,948,1016
9765,15117,3837,7315,3169,11279,1964,948,1016
9770,15127,3842,7321,3173,11284,1965,949,1016
9775,15133,3843,7324,3174,11289,1967,950,1017
9780,15144,3845,7331,3176,11296,1968,951,1017
9785,15148,3846,7333,3177,11302,1968,951,1017
9790,15158,3847,7339,3178,11311,1969,952,1017
9795,15164,3848,7343,3179,11316,1971,954,1017
9800,15175,3849,7349,3180,11325,1972,954,1018
9805,15179,3849,7349,3180,11330,1972,954,1018
9810,15189,3850,7353,3180,11339,1973,954,1019
9815,15195,3850,7355,3180,11345,1975,956,1019
9820,15206,3850,7356,3180,11356,1976,956,1020
9825,15210,3850,7359,3180,11359,1976,956,1020
9830,15220,3853,7366,3183,11367,1977,957,1020
9835,15226,3853,7369,3183,11373,1979,959,1020
9840,15237,3855,7373,3185,11382,1980,959,1021
9845,15241,3855,7373,3185,11386,1980,959,1021
9850,15251,3857,7380,3187,11393,1981,960,1021
9855,15257,3858,7383,3188,11398,1983,962,1021
9860,15268,3859,7386,3189,11407,1984,962,1022
9865,15272,3861,7387,3191,11411,1984,962,1022
9870,15282,3863,7391,3192,11419,1985,962,1023
9875,15288,3863,7392,3192,11424,1987,962,1025
9880,15299,3864,7395,3192,11434,1988,963,1025
9885,15303,3866,7397,3194,11436,1988,963,1025
9890,15313,3871,7404,3198,11441,1989,964,1025
9895,15319,3872,7407,3199,11445,1991,965,1026
9900,15330,3877,7413,3203,11451,1992,966,1026
9905,15334,3880,7415,3206,11454,1992,966,1026
9910,15344,3883,7420,3208,11460,1993,967,1026
9915,15350,3885,7424,3210,11463,1995,968,1027
9920,15361,3888,7431,3213,11469,1996,969,1027
9925,15365,3892,7435,3217,11472,1996,969,1027
9930,15375,3894,7439,3219,11481,1997,970,1027
9935,15381,3894,7442,3219,11486,1999,971,1028
9940,15392,3897,7448,3222,11492,2000,971,1029
9945,15396,3900,7448,3225,11496,2000,971,1029
9950,15406,3903,7454,3228,11502,2001,971,1030
9955,15412,3905,7457,3230,11507,2003,972,1031
9960,15423,3906,7459,3230,11515,2004,972,1032
9965,15427,3907,7461,3231,11520,2004,972,1032
9970,15437,3909,7464,3231,11527,2005,972,1033
9975,15443,3910,7469,3232,11532,2007,973,1034
9980,15454,3912,7473,3234,11541,2008,973,1035
9985,15458,3912,7474,3234,11546,2008,973,1035
9990,15468,3914,7478,3235,11554,2009,974,1035
9995,15474,3915,7481,3236,11559,2011,975,1036
10000,15485,3918,7488,3239,11565,2012,976,1036
10005,15489,3919,7490,3240,11570,2012,976,1036
10010,15499,3921,7495,3241,11578,2013,977,1036
10015,15505,3921,7498,3241,11583,2015,978,1037
10020,15516,3924,7504,3244,11591,2016,979,1037
10025,15520,3926,7507,3246,11593,2016,979,1037
10030,15530,3929,7511,3248,11601,2017,979,1038
10035,15536,3929,7514,3248,11606,2019,980,1039
10040,15547,3931,7520,3250,11613,2020,981,1039
10045,15551,3934,7523,3253,11616,2020,981,1039
10050,15561,3937,7527,3255,11624,2021,982,1039
10055,15567,3937,7530,3255,11629,2023,984,1039
10060,15578,3939,7537,3257,11635,2024,984,1040
10065,15582,3941,7539,3259,11640,2024,984,1040
10070,15592,3943,7544,3260,11649,2025,985,1040
10075,15598,3944,7547,3261,11653,2027,986,1041
10080,15609,3947,7554,3264,11661,2028,987,1041
10085,15613,3949,7557,3266,11663,2028,987,1041
10090,15623,3951,7563,3268,11671,2029,988,1041
10095,15629,3953,7568,3270,11674,2031,989,1042
10100,15640,3956,7576,3272,11681,2032,990,1042
10105,15644,3959,7578,3275,11684,2032,990,1042
10110,15654,3961,7583,3277,11693,2033,990,1043
10115,15660,3962,7586,3278,11698,2035,991,1044
10120,15671,3965,7594,3280,11705,2036,992,1044
10125,15675,3967,7598,3282,11708,2036,992,1044
10130,15685,3969,7603,3284,11715,2037,992,1045
10135,15691,3971,7607,3286,11720,2039,994,1045
10140,15702,3973,7610,3287,11729,2040,994,1046
10145,15706,3973,7611,3287,11733,2040,994,1046
10150,15716,3975,7616,3289,11741,2041,994,1047
10155,15722,3975,7620,3289,11747,2043,996,1047
10160,15733,3978,7626,3292,11754,2044,996,1048
10165,15737,3980,7628,3294,11757,2044,996,1048
10170,15747,3983,7633,3296,11763,2045,996,1049
10175,15753,3985,7638,3298,11767,2047,998,1049
10180,15764,3986,7643,3299,11776,2048,998,1050
10185,15768,3987,7644,3300,11781,2048,998,1050
10190,15778,3989,7649,3300,11788,2049,998,1051
10195,15784,3990,7653,3301,11793,2051,999,1052
10200,15795,3991,7658,3302,11802,2052,999,1053
10205,15799,3992,7659,3303,11807,2052,999,1053
10210,15809,3994,7661,3304,11815,2053,999,1054
10215,15815,3994,7664,3304,11820,2055,1000,1055
10220,15826,3996,7673,3306,11827,2056,1001,1055
10225,15830,3998,7675,3308,11832,2056,1001,1055
10230,15840,4000,7680,3310,11840,2057,1001,1056
10235,15846,4001,7683,3311,11844,2059,1001,1058
10240,15857,4003,7689,3313,11852,2060,1001,1059
10245,15861,4004,7692,3314,11857,2060,1001,1059
10250,15871,4006,7699,3315,11864,2061,1002,1059
10255,15877,4006,7702,3315,11868,2063,1002,1061
10260,15888,4010,7705,3319,11878,2064,1002,1062
10265,15892,4010,7706,3319,11881,2064,1002,1062
10270,15902,4014,7710,3322,11886,2065,1002,1063
10275,15908,4016,7714,3324,11890,2067,1003,1064
10280,15919,4020,7718,3327,11897,2068,1004,1064
10285,15923,4022,7719,3329,11900,2068,1004,1064
10290,15933,4026,7722,3332,11906,2069,1004,1065
10295,15939,4028,7725,3334,11909,2071,1004,1067
10300,15950,4032,7730,3337,11915,2072,1005,1067
10305,15954,4035,7731,3340,11918,2072,1005,1067
10310,15964,4039,7736,3344,11924,2073,1006,1067
10315,15970,4041,7739,3346,11929,2075,1007,1068
10320,15981,4044,7747,3349,11934,2076,1007,1069
10325,15985,4047,7750,3352,11938,2076,1007,1069
10330,15995,4049,7758,3354,11946,2077,1008,1069
10335,16001,4049,7759,3354,11952,2079,1008,1071
10340,16012,4052,7767,3357,11958,2080,1009,1071
10345,16016,4054,7769,3359,11962,2080,1009,1071
10350,16026,4057,7776,3361,11968,2081,1010,1071
10355,16032,4058,7779,3362,11974,2083,1011,1072
10360,16043,4059,7783,3363,11983,2084,1011,1073
10365,16047,4061,7786,3365,11986,2084,1011,1073
10370,16057,4063,7793,3366,11993,2085,1012,1073
10375,16063,4065,7795,3368,11998,2087,1013,1074
10380,16074,4067,7800,3370,12006,2088,1013,1075
10385,16078,4068,7801,3371,12010,2088,1013,1075
10390,16088,4071,7808,3374,12016,2089,1013,1076
10395,16094,4073,7812,3376,12021,2091,1014,1077
10400,16105,4075,7818,3377,12028,2092,1015,1077
10405,16109,4076,7821,3378,12033,2092,1015,1077
10410,16119,4077,7825,3379,12042,2093,1015,1078
10415,16125,4077,7829,3379,12048,2095,1017,1078
10420,16136,4080,7839,3382,12053,2096,1018,1078
10425,16140,4083,7841,3385,12056,2096,1018,1078
10430,16150,4087,7847,3388,12062,2097,1019,1078
10435,16156,4088,7852,3389,12065,2099,1021,1078
10440,16167,4092,7857,3393,12073,2100,1022,1078
10445,16171,4093,7857,3394,12078,2100,1022,1078
10450,16181,4096,7861,3397,12085,2101,1022,1079
10455,16187,4097,7863,3398,12090,2103,1022,1081
10460,16198,4097,7866,3398,12100,2104,1022,1082
10465,16202,4098,7868,3399,12104,2104,1022,1082
10470,16212,4100,7873,3400,12112,2105,1022,1083
10475,16218,4101,7879,3401,12115,2107,1024,1083
10480,16229,4104,7884,3404,12124,2108,1025,1083
10485,16233,4104,7886,3404,12129,2108,1025,1083
10490,16243,4106,7890,3406,12137,2109,1025,1084
10495,16249,4107,7893,3407,12141,2111,1026,1085
10500,16260,4109,7899,3409,12147,2112,1027,1085
10505,16264,4111,7901,3411,12153,2112,1027,1085
10510,16274,4113,7904,3412,12161,2113,1028,1085
10515,16280,4113,7907,3412,12166,2115,1029,1086
10520,16291,4116,7912,3414,12173,2116,1029,1087
10525,16295,4119,7915,3417,12176,2116,1029,1087
10530,16305,4123,7920,3420,12181,2117,1029,1088
10535,16311,4124,7923,3421,12186,2119,1031,1088
10540,16322,4129,7930,3426,12191,2120,1032,1088
10545,16326,4132,7931,3429,12194,2120,1032,1088
10550,16336,4135,7937,3430,12200,2121,1033,1088
10555,16342,4136,7941,3431,12204,2123,1035,1088
10560,16353,4140,7944,3434,12212,2124,1036,1088
10565,16357,4141,7946,3435,12214,2124,1036,1088
10570,16367,4146,7951,3439,12220,2125,1037,1088
10575,16373,4147,7954,3440,12225,2127,1038,1089
10580,16384,4150,7959,3442,12233,2128,1038,1090
10585,16388,4151,7962,3443,12237,2128,1038,1090
10590,16398,4152,7967,3444,12246,2129,1039,1090
10595,16404,4153,7971,3445,12251,2131,1041,1090
10600,16415,4155,7977,3446,12257,2132,1042,1090
10605,16419,4158,7978,3449,12261,2132,1042,1090
10610,16429,4161,7985,3452,12268,2133,1043,1090
10615,16435,4161,7986,3452,12274,2135,1044,1091
10620,16446,4163,7990,3453,12281,2136,1044,1092
10625,16450,4166,7994,3456,12284,2136,1044,1092
10630,16460,4167,7998,3457,12293,2137,1044,1093
10635,16466,4167,8001,3457,12299,2139,1045,1094
10640,16477,4169,8007,3458,12306,2140,1045,1095
10645,16481,4171,8010,3460,12310,2140,1045,1095
10650,16491,4171,8013,3460,12319,2141,1045,1096
10655,16497,4171,8015,3460,12326,2143,1045,1098
10660,16508,4171,8019,3460,12337,2144,1045,1099
10665,16512,4171,8020,3460,12341,2144,1045,1099
10670,16522,4171,8027,3460,12350,2145,1046,1099
10675,16528,4171,8028,3460,12357,2147,1046,1101
10680,16539,4171,8032,3460,12367,2148,1046,1102
10685,16543,4171,8033,3460,12372,2148,1046,1102
10690,16553,4174,8040,3463,12379,2149,1047,1102
10695,16559,4174,8044,3463,12383,2151,1048,1103
10700,16570,4177,8048,3466,12391,2152,1048,1104
10705,16574,4179,8052,3468,12393,2152,1048,1104
10710,16584,4182,8054,3470,12401,2153,1048,1105
10715,16590,4183,8058,3471,12405,2155,1049,1106
10720,16601,4185,8060,3473,12415,2156,1049,1107
10725,16605,4187,8063,3475,12416,2156,1049,1107
10730,16615,4191,8068,3477,12423,2157,1049,1108
10735,16621,4191,8070,3477,12429,2159,1050,1109
10740,16632,4193,8075,3479,12438,2160,1050,1110
10745,16636,4194,8076,3480,12442,2160,1050,1110
10750,16646,4196,8082,3482,12449,2161,1050,1111
10755,16652,4197,8084,3483,12454,2163,1050,1113
10760,16663,4200,8090,3485,12461,2164,1051,1113
10765,16667,4202,8091,3487,12465,2164,1051,1113
10770,16677,4205,8096,3489,12471,2165,1052,1113
10775,16683,4205,8100,3489,12477,2167,1053,1114
10780,16694,4209,8105,3492,12483,2168,1053,1115
10785,16698,4211,8105,3494,12487,2168,1053,1115
10790,16708,4213,8108,3495,12494,2169,1054,1115
10795,16714,4214,8111,3496,12500,2171,1055,1116
10800,16725,4216,8114,3497,12507,2172,1055,1117
10805,16729,4218,8114,3499,12511,2172,1055,1117
10810,16739,4221,8118,3501,12517,2173,1055,1118
10815,16745,4222,8120,3502,12523,2175,1055,1120
10820,16756,4224,8125,3503,12530,2176,1056,1120
10825,16760,4227,8129,3506,12533,2176,1056,1120
10830,16770,4229,8131,3507,12540,2177,1056,1121
10835,16776,4230,8134,3508,12545,2179,1057,1122
10840,16787,4235,8139,3512,12550,2180,1057,1123
10845,16791,4237,8140,3514,12553,2180,1057,1123
10850,16801,4241,8145,3518,12559,2181,1057,1124
10855,16807,4242,8148,3519,12564,2183,1058,1125
10860,16818,4247,8154,3523,12569,2184,1059,1125
10865,16822,4248,8157,3524,12574,2184,1059,1125
10870,16832,4250,8162,3525,12581,2185,1060,1125
10875,16838,4250,8165,3525,12588,2187,1061,1126
10880,16849,4251,8169,3526,12597,2188,1062,1126
10885,16853,4253,8172,3528,12600,2188,1062,1126
10890,16863,4255,8175,3529,12607,2189,1062,1127
10895,16869,4255,8178,3529,12613,2191,1064,1127
10900,16880,4258,8183,3531,12619,2192,1064,1128
10905,16884,4261,8185,3534,12622,2192,1064,1128
10910,16894,4264,8191,3537,12629,2193,1065,1128
10915,16900,4265,8193,3538,12635,2195,1065,1130
10920,16911,4268,8200,3540,12640,2196,1065,1131
10925,16915,4270,8203,3542,12644,2196,1065,1131
10930,16925,4271,8208,3543,12653,2197,1065,1132
10935,16931,4271,8211,3543,12659,2199,1066,1133
10940,16942,4271,8215,3543,12669,2200,1066,1134
10945,16946,4272,8216,3544,12674,2200,1066,1134
10950,16956,4273,8221,3545,12682,2201,1066,1135
10955,16962,4274,8225,3546,12687,2203,1067,1136
10960,16973,4274,8229,3546,12698,2204,1068,1136
10965,16977,4274,8231,3546,12702,2204,1068,1136
10970,16987,4278,8236,3550,12708,2205,1068,1137
10975,16993,4278,8239,3550,12714,2207,1070,1137
10980,17004,4279,8244,3551,12723,2208,1070,1138
10985,17008,4279,8246,3551,12729,2208,1070,1138
10990,17018,4281,8251,3552,12736,2209,1071,1138
10995,17024,4282,8253,3553,12742,2211,1071,1140
11000,17035,4283,8258,3554,12750,2212,1071,1141
11005,17039,4284,8260,3555,12754,2212,1071,1141
11010,17049,4286,8266,3556,12762,2213,1072,1141
11015,17055,4287,8269,3557,12767,2215,1073,1142
11020,17066,4290,8276,3560,12773,2216,1073,1143
11025,17070,4291,8278,3561,12778,2216,1073,1143
11030,17080,4293,8284,3563,12786,2217,1073,1144
11035,17086,4294,8287,3564,12790,2219,1074,1145
11040,17097,4299,8293,3569,12797,2220,1074,1146
11045,17101,4301,8296,3571,12800,2220,1074,1146
11050,17111,4304,8302,3573,12806,2221,1075,1146
11055,17117,4306,8305,3575,12811,2223,1076,1147
11060,17128,4309,8310,3578,12818,2224,1076,1148
11065,17132,4310,8311,3579,12822,2224,1076,1148
11070,17142,4313,8315,3581,12828,2225,1076,1149
11075,17148,4314,8318,3582,12833,2227,1076,1151
11080,17159,4317,8322,3585,12841,2228,1076,1152
11085,17163,4320,8326,3588,12842,2228,1076,1152
11090,17173,4324,8333,3591,12848,2229,1077,1152
11095,17179,4326,8338,3593,12853,2231,1079,1152
11100,17190,4329,8343,3595,12858,2232,1079,1153
11105,17194,4334,8347,3600,12859,2232,1079,1153
11110,17204,4337,8350,3602,12866,2233,1079,1154
11115,17210,4337,8353,3602,12873,2235,1081,1154
11120,17221,4340,8356,3604,12881,2236,1082,1154
11125,17225,4341,8357,3605,12884,2236,1082,1154
11130,17235,4344,8362,3608,12890,2237,1083,1154
11135,17241,4344,8364,3608,12896,2239,1084,1155
11140,17252,4349,8369,3612,12902,2240,1084,1156
11145,17256,4351,8371,3614,12905,2240,1084,1156
11150,17266,4353,8372,3615,12912,2241,1084,1157
11155,17272,4353,8376,3615,12917,2243,1086,1157
11160,17283,4358,8380,3620,12924,2244,1086,1158
11165,17287,4360,8381,3622,12927,2244,1086,1158
11170,17297,4364,8386,3625,12932,2245,1087,1158
11175,17303,4366,8389,3627,12935,2247,1087,1160
11180,17314,4367,8394,3627,12944,2248,1087,1161
11185,17318,4369,8398,3629,12948,2248,1087,1161
11190,17328,4370,8404,3629,12957,2249,1088,1161
11195,17334,4371,8407,3630,12963,2251,1089,1162
11200,17345,4372,8411,3631,12972,2252,1089,1163
11205,17349,4373,8413,3632,12975,2252,1089,1163
11210,17359,4374,8417,3632,12984,2253,1089,1164
11215,17365,4374,8418,3632,12991,2255,1090,1165
11220,17376,4374,8421,3632,13002,2256,1091,1165
11225,17380,4374,8422,3632,13005,2256,1091,1165
11230,17390,4375,8425,3632,13014,2257,1091,1166
11235,17396,4376,8426,3633,13020,2259,1091,1168
11240,17407,4377,8432,3634,13029,2260,1091,1169
11245,17411,4378,8434,3635,13032,2260,1091,1169
11250,17421,4379,8441,3636,13041,2261,1092,1169
11255,17427,4379,8442,3636,13047,2263,1092,1171
11260,17438,4380,8448,3637,13055,2264,1092,1172
11265,17442,4381,8450,3638,13061,2264,1092,1172
11270,17452,4382,8455,3638,13069,2265,1092,1173
11275,17458,4382,8457,3638,13075,2267,1092,1175
11280,17469,4384,8461,3640,13083,2268,1093,1175
11285,17473,4385,8462,3641,13088,2268,1093,1175
11290,17483,4388,8469,3644,13094,2269,1094,1175
11295,17489,4390,8473,3646,13098,2271,1096,1175
11300,17500,4393,8476,3648,13106,2272,1096,1176
11305,17504,4395,8479,3650,13109,2272,1096,1176
11310,17514,4399,8485,3653,13114,2273,1096,1177
11315,17520,4400,8487,3654,13120,2275,1097,1178
11320,17531,4402,8490,3655,13128,2276,1097,1179
11325,17535,4404,8494,3657,13131,2276,1097,1179
11330,17545,4406,8499,3657,13138,2277,1098,1179
11335,17551,4407,8502,3658,13144,2279,1100,1179
11340,17562,4408,8506,3659,13151,2280,1100,1180
11345,17566,4411,8509,3662,13155,2280,1100,1180
11350,17576,4414,8515,3665,13161,2281,1100,1181
11355,17582,4415,8519,3666,13166,2283,1101,1182
11360,17593,4419,8523,3670,13174,2284,1102,1182
11365,17597,4420,8525,3671,13177,2284,1102,1182
11370,17607,4422,8532,3673,13184,2285,1103,1182
11375,17613,4424,8536,3675,13188,2287,1105,1182
11380,17624,4427,8539,3677,13195,2288,1105,1183
11385,17628,4429,8540,3679,13198,2288,1105,1183
11390,17638,4433,8545,3682,13203,2289,1106,1183
11395,17644,4435,8548,3684,13208,2291,1108,1183
11400,17655,4440,8556,3688,13211,2292,1109,1183
11405,17659,4445,8558,3693,13213,2292,1109,1183
11410,17669,4450,8562,3697,13217,2293,1109,1184
11415,17675,4452,8565,3699,13222,2295,1110,1185
11420,17686,4456,8571,3703,13228,2296,1111,1185
11425,17690,4458,8571,3705,13232,2296,1111,1185
11430,17700,4461,8574,3707,13238,2297,1112,1185
11435,17706,4461,8578,3707,13242,2299,1113,1186
11440,17717,4466,8583,3711,13249,2300,1113,1187
11445,17721,4468,8585,3713,13252,2300,1113,1187
11450,17731,4471,8590,3716,13259,2301,1113,1188
11455,17737,4472,8593,3717,13264,2303,1114,1189
11460,17748,4473,8597,3717,13273,2304,1114,1190
11465,17752,4474,8598,3718,13277,2304,1114,1190
11470,17762,4475,8603,3719,13287,2305,1114,1191
11475,17768,4475,8606,3719,13291,2307,1114,1193
11480,17779,4476,8611,3720,13300,2308,1115,1193
11485,17783,4477,8612,3721,13305,2308,1115,1193
11490,17793,4478,8617,3721,13314,2309,1116,1193
11495,17799,4478,8618,3721,13321,2311,1116,1195
11500,17810,4478,8624,3721,13331,2312,1117,1195
11505,17814,4478,8627,3721,13335,2312,1117,1195
11510,17824,4479,8631,3721,13344,2313,1117,1196
11515,17830,4479,8633,3721,13351,2315,1118,1197
11520,17841,4480,8638,3722,13359,2316,1119,1197
11525,17845,4481,8642,3723,13364,2316,1119,1197
11530,17855,4482,8646,3723,13372,2317,1119,1198
11535,17861,4483,8650,3724,13378,2319,1120,1199
11540,17872,4483,8655,3724,13389,2320,1120,1200
11545,17876,4483,8657,3724,13393,2320,1120,1200
11550,17886,4485,8663,3725,13400,2321,1120,1201
11555,17892,4485,8667,3725,13406,2323,1122,1201
11560,17903,4487,8674,3727,13413,2324,1123,1201
11565,17907,4489,8674,3729,13418,2324,1123,1201
11570,17917,4492,8678,3731,13425,2325,1123,1202
11575,17923,4492,8681,3731,13431,2327,1124,1203
11580,17934,4495,8688,3733,13436,2328,1124,1204
11585,17938,4498,8691,3736,13440,2328,1124,1204
11590,17948,4501,8695,3738,13446,2329,1125,1204
11595,17954,4502,8698,3739,13452,2331,1127,1204
11600,17965,4504,8705,3741,13458,2332,1128,1204
11605,17969,4508,8708,3745,13460,2332,1128,1204
11610,17979,4511,8713,3747,13467,2333,1128,1205
11615,17985,4513,8716,3749,13471,2335,1129,1206
11620,17996,4519,8723,3754,13474,2336,1129,1207
11625,18000,4523,8725,3758,13477,2336,1129,1207
11630,18010,4527,8730,3762,13483,2337,1130,1207
11635,18016,4527,8735,3762,13486,2339,1132,1207
11640,18027,4534,8743,3768,13489,2340,1133,1207
11645,18031,4539,8745,3773,13491,2340,1133,1207
11650,18041,4543,8750,3777,13497,2341,1134,1207
11655,18047,4545,8754,3779,13499,2343,1134,1209
11660,18058,4547,8759,3781,13509,2344,1134,1210
11665,18062,4550,8762,3784,13512,2344,1134,1210
11670,18072,4552,8769,3785,13519,2345,1135,1210
11675,18078,4553,8772,3786,13524,2347,1137,1210
11680,18089,4554,8774,3786,13534,2348,1137,1211
11685,18093,4555,8774,3787,13538,2348,1137,1211
11690,18103,4557,8777,3788,13546,2349,1138,1211
11695,18109,4558,8782,3789,13549,2351,1140,1211
11700,18120,4561,8786,3791,13558,2352,1140,1212
11705,18124,4561,8789,3791,13562,2352,1140,1212
11710,18134,4562,8793,3791,13571,2353,1140,1213
11715,18140,4563,8797,3792,13576,2355,1141,1214
11720,18151,4564,8802,3793,13585,2356,1141,1215
11725,18155,4564,8806,3793,13590,2356,1141,1215
11730,18165,4565,8809,3793,13600,2357,1141,1216
11735,18171,4565,8809,3793,13606,2359,1141,1218
11740,18182,4565,8815,3793,13616,2360,1142,1218
11745,18186,4565,8817,3793,13620,2360,1142,1218
11750,18196,4566,8823,3793,13630,2361,1143,1218
11755,18202,4567,8828,3794,13635,2363,1145,1218
11760,18213,4567,8832,3794,13645,2364,1145,1219
11765,18217,4567,8834,3794,13650,2364,1145,1219
11770,18227,4569,8840,3794,13657,2365,1145,1220
11775,18233,4570,8845,3795,13663,2367,1147,1220
11780,18244,4570,8850,3795,13672,2368,1148,1220
11785,18248,4570,8853,3795,13678,2368,1148,1220
11790,18258,4572,8858,3795,13685,2369,1148,1221
11795,18264,4572,8860,3795,13691,2371,1149,1222
11800,18275,4574,8867,3797,13697,2372,1150,1222
11805,18279,4576,8869,3799,13703,2372,1150,1222
11810,18289,4579,8872,3800,13710,2373,1151,1222
11815,18295,4579,8873,3800,13716,2375,1152,1223
11820,18306,4582,8878,3802,13721,2376,1152,1224
11825,18310,4585,8878,3805,13725,2376,1152,1224
11830,18320,4589,8884,3809,13731,2377,1153,1224
11835,18326,4589,8888,3809,13736,2379,1154,1225
11840,18337,4593,8893,3812,13742,2380,1155,1225
11845,18341,4596,8896,3815,13745,2380,1155,1225
11850,18351,4599,8900,3817,13752,2381,1155,1226
11855,18357,4599,8904,3817,13755,2383,1156,1227
11860,18368,4605,8910,3822,13759,2384,1156,1228
11865,18372,4610,8913,3827,13760,2384,1156,1228
11870,18382,4616,8918,3833,13766,2385,1157,1228
11875,18388,4616,8923,3833,13769,2387,1159,1228
11880,18399,4623,8930,3839,13773,2388,1160,1228
11885,18403,4627,8932,3843,13776,2388,1160,1228
11890,18413,4632,8938,3847,13780,2389,1161,1228
11895,18419,4633,8943,3848,13784,2391,1163,1228
11900,18430,4637,8950,3852,13792,2392,1164,1228
11905,18434,4638,8951,3853,13796,2392,1164,1228
11910,18444,4639,8956,3854,13805,2393,1164,1229
11915,18450,4640,8960,3855,13809,2395,1164,1231
11920,18461,4640,8967,3855,13820,2396,1164,1232
11925,18465,4641,8968,3856,13824,2396,1164,1232
11930,18475,4642,8971,3856,13833,2397,1164,1233
11935,18481,4643,8974,3857,13838,2399,1165,1234
11940,18492,4644,8978,3858,13848,2400,1166,1234
11945,18496,4644,8980,3858,13852,2400,1166,1234
11950,18506,4645,8985,3858,13860,2401,1167,1234
11955,18512,4645,8989,3858,13866,2403,1169,1234
11960,18523,4646,8993,3859,13877,2404,1169,1235
11965,18527,4646,8994,3859,13881,2404,1169,1235
11970,18537,4647,8999,3860,13890,2405,1170,1235
11975,18543,4648,9001,3861,13895,2407,1171,1236
11980,18554,4648,9005,3861,13905,2408,1172,1236
11985,18558,4649,9007,3862,13909,2408,1172,1236
11990,18568,4650,9014,3862,13917,2409,1172,1237
11995,18574,4651,9019,3863,13922,2411,1174,1237
12000,18585,4651,9025,3863,13932,2412,1175,1237
12005,18589,4652,9027,3864,13936,2412,1175,1237
12010,18599,4655,9032,3866,13944,2413,1176,1237
12015,18605,4656,9034,3867,13949,2415,1177,1238
12020,18616,4657,9038,3868,13957,2416,1177,1239
12025,18620,4659,9041,3870,13960,2416,1177,1239
12030,18630,4662,9044,3872,13968,2417,1178,1239
12035,18636,4662,9046,3872,13974,2419,1180,1239
12040,18647,4664,9053,3873,13978,2420,1180,1240
12045,18651,4669,9056,3878,13981,2420,1180,1240
12050,18661,4672,9060,3880,13989,2421,1180,1241
12055,18667,4672,9064,3880,13993,2423,1181,1242
12060,18678,4676,9072,3884,13999,2424,1182,1242
12065,18682,4678,9072,3886,14004,2424,1182,1242
12070,18692,4682,9076,3888,14010,2425,1182,1243
12075,18698,4683,9078,3889,14015,2427,1182,1245
12080,18709,4684,9082,3889,14022,2428,1182,1246
12085,18713,4686,9083,3891,14027,2428,1182,1246
12090,18723,4689,9088,3893,14033,2429,1183,1246
12095,18729,4691,9093,3895,14037,2431,1184,1247
12100,18740,4697,9101,3901,14040,2432,1184,1248
12105,18744,4701,9104,3905,14042,2432,1184,1248
12110,18754,4705,9109,3908,14049,2433,1185,1248
12115,18760,4706,9113,3909,14053,2435,1185,1250
12120,18771,4709,9115,3911,14061,2436,1185,1251
12125,18775,4712,9117,3914,14063,2436,1185,1251
12130,18785,4715,9119,3915,14069,2437,1185,1252
12135,18791,4716,9123,3916,14074,2439,1187,1252
12140,18802,4721,9132,3920,14076,2440,1188,1252
12145,18806,4724,9133,3923,14082,2440,1188,1252
12150,18816,4726,9137,3924,14090,2441,1189,1252
12155,18822,4726,9139,3924,14096,2443,1189,1254
12160,18833,4727,9142,3925,14105,2444,1189,1255
12165,18837,4729,9144,3927,14107,2444,1189,1255
12170,18847,4732,9152,3929,14114,2445,1190,1255
12175,18853,4733,9156,3930,14119,2447,1192,1255
12180,18864,4736,9162,3933,14126,2448,1193,1255
12185,18868,4739,9164,3936,14129,2448,1193,1255
12190,18878,4742,9172,3938,14135,2449,1194,1255
12195,18884,4743,9176,3939,14140,2451,1195,1256
12200,18895,4744,9179,3940,14151,2452,1195,1257
12205,18899,4744,9181,3940,14154,2452,1195,1257
12210,18909,4745,9189,3941,14164,2453,1196,1257
12215,18915,4745,9191,3941,14169,2455,1196,1259
12220,18926,4746,9195,3942,14179,2456,1196,1260
12225,18930,4746,9197,3942,14184,2456,1196,1260
12230,18940,4747,9201,3942,14193,2457,1197,1260
12235,18946,4748,9206,3943,14196,2459,1198,1261
12240,18957,4748,9209,3943,14208,2460,1198,1262
12245,18961,4748,9210,3943,14213,2460,1198,1262
12250,18971,4751,9217,3946,14219,2461,1199,1262
12255,18977,4753,9220,3948,14223,2463,1199,1264
12260,18988,4756,9226,3951,14232,2464,1200,1264
12265,18992,4756,9228,3951,14235,2464,1200,1264
12270,19002,4757,9230,3951,14244,2465,1200,1265
12275,19008,4758,9231,3952,14250,2467,1200,1267
12280,19019,4760,9236,3954,14257,2468,1201,1267
12285,19023,4763,9238,3957,14260,2468,1201,1267
12290,19033,4764,9243,3958,14268,2469,1201,1268
12295,19039,4765,9246,3959,14274,2471,1203,1268
12300,19050,4768,9252,3962,14280,2472,1204,1268
12305,19054,4770,9254,3964,14284,2472,1204,1268
12310,19064,4773,9256,3965,14291,2473,1204,1269
12315,19070,4773,9259,3965,14296,2475,1205,1270
12320,19081,4777,9266,3968,14300,2476,1206,1270
12325,19085,4781,9267,3972,14304,2476,1206,1270
12330,19095,4785,9276,3975,14309,2477,1207,1270
12335,19101,4787,9279,3977,14314,2479,1208,1271
12340,19112,4789,9283,3978,14320,2480,1208,1272
12345,19116,4792,9284,3981,14324,2480,1208,1272
12350,19126,4795,9292,3984,14330,2481,1209,1272
12355,19132,4796,9295,3985,14336,2483,1210,1273
12360,19143,4798,9302,3987,14342,2484,1211,1273
12365,19147,4800,9303,3989,14346,2484,1211,1273
12370,19157,4802,9306,3990,14354,2485,1212,1273
12375,19163,4802,9309,3990,14360,2487,1212,1275
12380,19174,4803,9312,3991,14370,2488,1212,1276
12385,19178,4804,9314,3992,14374,2488,1212,1276
12390,19188,4805,9321,3993,14382,2489,1213,1276
12395,19194,4805,9326,3993,14388,2491,1214,1277
12400,19205,4808,9333,3996,14395,2492,1214,1278
12405,19209,4810,9334,3998,14399,2492,1214,1278
12410,19219,4812,9339,4000,14405,2493,1214,1279
12415,19225,4813,9342,4001,14411,2495,1215,1280
12420,19236,4814,9346,4002,14421,2496,1215,1281
12425,19240,4814,9346,4002,14426,2496,1215,1281
12430,19250,4817,9350,4004,14433,2497,1215,1282
12435,19256,4817,9353,4004,14437,2499,1216,1283
12440,19267,4821,9358,4008,14446,2500,1217,1283
12445,19271,4821,9360,4008,14450,2500,1217,1283
12450,19281,4822,9365,4008,14459,2501,1217,1284
12455,19287,4822,9368,4008,14464,2503,1218,1285
12460,19298,4822,9371,4008,14476,2504,1218,1286
12465,19302,4822,9373,4008,14480,2504,1218,1286
12470,19312,4824,9377,4009,14487,2505,1219,1286
12475,19318,4825,9380,4010,14493,2507,1219,1288
12480,19329,4826,9385,4010,14503,2508,1220,1288
12485,19333,4826,9388,4010,14507,2508,1220,1288
12490,19343,4828,9394,4012,14514,2509,1221,1288
12495,19349,4829,9397,4013,14519,2511,1221,1290
12500,19360,4832,9402,4015,14528,2512,1221,1291
12505,19364,4832,9403,4015,14532,2512,1221,1291
12510,19374,4835,9409,4017,14539,2513,1221,1292
12515,19380,4835,9412,4017,14544,2515,1221,1294
12520,19391,4837,9417,4019,14554,2516,1221,1295
12525,19395,4837,9418,4019,14557,2516,1221,1295
12530,19405,4839,9423,4021,14566,2517,1221,1296
12535,19411,4839,9426,4021,14571,2519,1222,1297
12540,19422,4841,9433,4022,14579,2520,1223,1297
12545,19426,4844,9434,4025,14582,2520,1223,1297
12550,19436,4848,9439,4027,14588,2521,1224,1297
12555,19442,4849,9443,4028,14592,2523,1225,1298
12560,19453,4852,9449,4030,14599,2524,1226,1298
12565,19457,4854,9452,4032,14602,2524,1226,1298
12570,19467,4857,9456,4034,14609,2525,1226,1299
12575,19473,4859,9460,4036,14613,2527,1227,1300
12580,19484,4861,9464,4037,14621,2528,1228,1300
12585,19488,4863,9467,4039,14624,2528,1228,1300
12590,19498,4865,9472,4041,14633,2529,1228,1301
12595,19504,4865,9473,4041,14638,2531,1228,1303
12600,19515,4870,9478,4045,14643,2532,1228,1304
12605,19519,4873,9481,4048,14645,2532,1228,1304
12610,19529,4876,9487,4050,14652,2533,1228,1305
12615,19535,4878,9490,4052,14657,2535,1230,1305
12620,19546,4880,9496,4053,14663,2536,1231,1305
12625,19550,4884,9499,4057,14666,2536,1231,1305
12630,19560,4886,9502,4058,14674,2537,1232,1305
12635,19566,4886,9505,4058,14679,2539,1233,1306
12640,19577,4889,9510,4061,14686,2540,1234,1306
12645,19581,4890,9513,4062,14690,2540,1234,1306
12650,19591,4893,9517,4063,14698,2541,1234,1307
12655,19597,4893,9520,4063,14704,2543,1235,1308
12660,19608,4895,9525,4065,14712,2544,1235,1309
12665,19612,4895,9526,4065,14716,2544,1235,1309
12670,19622,4898,9529,4066,14724,2545,1236,1309
12675,19628,4899,9533,4067,14728,2547,1238,1309
12680,19639,4902,9540,4070,14734,2548,1238,1310
12685,19643,4904,9541,4072,14739,2548,1238,1310
12690,19653,4906,9544,4073,14747,2549,1238,1311
12695,19659,4907,9548,4074,14752,2551,1239,1312
12700,19670,4908,9554,4075,14759,2552,1239,1313
12705,19674,4910,9556,4077,14764,2552,1239,1313
12710,19684,4912,9559,4077,14772,2553,1239,1314
12715,19690,4912,9563,4077,14778,2555,1241,1314
12720,19701,4914,9570,4079,14785,2556,1242,1314
12725,19705,4915,9571,4080,14789,2556,1242,1314
12730,19715,4920,9577,4084,14793,2557,1243,1314
12735,19721,4923,9578,4087,14798,2559,1243,1316
12740,19732,4926,9585,4089,14802,2560,1244,1316
12745,19736,4931,9587,4094,14804,2560,1244,1316
12750,19746,4938,9595,4101,14808,2561,1245,1316
12755,19752,4939,9599,4102,14813,2563,1247,1316
12760,19763,4942,9604,4104,14820,2564,1248,1316
12765,19767,4943,9605,4105,14823,2564,1248,1316
12770,19777,4944,9610,4106,14832,2565,1248,1317
12775,19783,4945,9613,4107,14837,2567,1250,1317
12780,19794,4946,9617,4107,14846,2568,1250,1318
12785,19798,4947,9620,4108,14850,2568,1250,1318
12790,19808,4950,9627,4111,14857,2569,1251,1318
12795,19814,4952,9630,4113,14862,2571,1252,1319
12800,19825,4955,9634,4115,14869,2572,1252,1320
12805,19829,4956,9636,4116,14873,2572,1252,1320
12810,19839,4958,9641,4118,14881,2573,1253,1320
12815,19845,4959,9645,4119,14886,2575,1254,1321
12820,19856,4961,9651,4121,14893,2576,1255,1321
12825,19860,4963,9653,4123,14897,2576,1255,1321
12830,19870,4966,9659,4126,14904,2577,1255,1322
12835,19876,4967,9662,4127,14909,2579,1257,1322
12840,19887,4968,9666,4128,14917,2580,1257,1323
12845,19891,4971,9669,4131,14920,2580,1257,1323
12850,19901,4973,9674,4133,14928,2581,1258,1323
12855,19907,4974,9676,4134,14932,2583,1258,1325
12860,19918,4977,9680,4136,14939,2584,1258,1326
12865,19922,4978,9682,4137,14944,2584,1258,1326
12870,19932,4980,9686,4138,14952,2585,1259,1326
12875,19938,4980,9689,4138,14958,2587,1261,1326
12880,19949,4981,9693,4139,14968,2588,1261,1327
12885,19953,4981,9696,4139,14972,2588,1261,1327
12890,19963,4983,9698,4139,14979,2589,1261,1328
12895,19969,4983,9701,4139,14984,2591,1262,1329
12900,19980,4986,9707,4142,14992,2592,1263,1329
12905,19984,4987,9709,4143,14995,2592,1263,1329
12910,19994,4991,9711,4145,15001,2593,1263,1330
12915,20000,4992,9714,4146,15007,2595,1265,1330
12920,20011,4994,9720,4148,15015,2596,1266,1330
12925,20015,4996,9722,4150,15018,2596,1266,1330
12930,20025,5001,9728,4154,15023,2597,1267,1330
12935,20031,5002,9730,4155,15028,2599,1268,1331
12940,20042,5005,9735,4158,15035,2600,1268,1332
12945,20046,5007,9737,4160,15037,2600,1268,1332
12950,20056,5011,9743,4164,15043,2601,1269,1332
12955,20062,5013,9748,4166,15046,2603,1270,1333
12960,20073,5017,9754,4170,15054,2604,1271,1333
12965,20077,5017,9756,4170,15060,2604,1271,1333
12970,20087,5019,9762,4172,15067,2605,1271,1334
12975,20093,5020,9765,4173,15073,2607,1271,1336
12980,20104,5023,9772,4175,15079,2608,1271,1337
12985,20108,5026,9773,4178,15082,2608,1271,1337
12990,20118,5027,9774,4178,15091,2609,1271,1338
12995,20124,5027,9777,4178,15097,2611,1273,1338
13000,20135,5029,9781,4179,15104,2612,1273,1339
13005,20139,5032,9784,4182,15107,2612,1273,1339
13010,20149,5034,9787,4183,15115,2613,1274,1339
13015,20155,5035,9790,4184,15120,2615,1275,1340
13020,20166,5037,9794,4185,15127,2616,1275,1341
13025,20170,5038,9794,4186,15132,2616,1275,1341
13030,20180,5040,9799,4188,15140,2617,1275,1342
13035,20186,5041,9802,4189,15145,2619,1277,1342
13040,20197,5044,9808,4191,15150,2620,1277,1343
13045,20201,5047,9810,4194,15154,2620,1277,1343
13050,20211,5049,9814,4196,15162,2621,1278,1343
13055,20217,5049,9818,4196,15168,2623,1280,1343
13060,20228,5052,9822,4199,15176,2624,1280,1344
13065,20232,5052,9824,4199,15179,2624,1280,1344
13070,20242,5059,9829,4204,15182,2625,1281,1344
13075,20248,5059,9831,4204,15188,2627,1282,1345
13080,20259,5063,9836,4207,15194,2628,1283,1345
13085,20263,5065,9836,4209,15198,2628,1283,1345
13090,20273,5070,9841,4213,15202,2629,1284,1345
13095,20279,5070,9844,4213,15208,2631,1286,1345
13100,20290,5072,9846,4215,15217,2632,1286,1346
13105,20294,5073,9846,4216,15221,2632,1286,1346
13110,20304,5077,9851,4219,15226,2633,1287,1346
13115,20310,5079,9855,4221,15230,2635,1289,1346
13120,20321,5083,9858,4224,15237,2636,1289,1347
13125,20325,5085,9861,4226,15238,2636,1289,1347
13130,20335,5091,9867,4232,15243,2637,1290,1347
13135,20341,5092,9869,4233,15249,2639,1291,1348
13140,20352,5092,9873,4233,15258,2640,1291,1349
13145,20356,5095,9874,4236,15261,2640,1291,1349
13150,20366,5098,9879,4238,15267,2641,1292,1349
13155,20372,5099,9883,4239,15272,2643,1294,1349
13160,20383,5100,9890,4240,15282,2644,1295,1349
13165,20387,5101,9892,4241,15286,2644,1295,1349
13170,20397,5102,9899,4242,15294,2645,1296,1349
13175,20403,5103,9900,4243,15300,2647,1296,1351
13180,20414,5103,9906,4243,15310,2648,1297,1351
13185,20418,5104,9907,4244,15314,2648,1297,1351
13190,20428,5105,9912,4245,15322,2649,1297,1352
13195,20434,5106,9915,4246,15326,2651,1297,1354
13200,20445,5106,9920,4246,15337,2652,1298,1354
13205,20449,5107,9922,4247,15342,2652,1298,1354
13210,20459,5108,9924,4247,15350,2653,1298,1355
13215,20465,5109,9929,4248,15355,2655,1299,1356
13220,20476,5110,9934,4249,15365,2656,1299,1357
13225,20480,5110,9936,4249,15370,2656,1299,1357
13230,20490,5112,9941,4251,15377,2657,1299,1358
13235,20496,5113,9946,4252,15382,2659,1301,1358
13240,20507,5115,9951,4253,15389,2660,1302,1358
13245,20511,5117,9952,4255,15394,2660,1302,1358
13250,20521,5120,9958,4257,15400,2661,1302,1359
13255,20527,5121,9962,4258,15405,2663,1304,1359
13260,20538,5124,9964,4260,15413,2664,1304,1360
13265,20542,5126,9966,4262,15416,2664,1304,1360
13270,20552,5129,9972,4264,15422,2665,1304,1361
13275,20558,5131,9973,4266,15427,2667,1304,1363
13280,20569,5133,9978,4268,15435,2668,1305,1363
13285,20573,5135,9980,4270,15438,2668,1305,1363
13290,20583,5138,9984,4271,15444,2669,1306,1363
13295,20589,5138,9985,4271,15451,2671,1307,1364
13300,20600,5142,9992,4275,15455,2672,1307,1365
13305,20604,5146,9995,4279,15458,2672,1307,1365
13310,20614,5150,10005,4283,15463,2673,1308,1365
13315,20620,5152,10009,4285,15468,2675,1309,1366
13320,20631,5156,10016,4289,15472,2676,1309,1367
13325,20635,5159,10018,4292,15476,2676,1309,1367
13330,20645,5160,10021,4293,15484,2677,1310,1367
13335,20651,5160,10023,4293,15491,2679,1311,1368
13340,20662,5162,10029,4295,15498,2680,1311,1369
13345,20666,5163,10031,4296,15502,2680,1311,1369
13350,20676,5165,10036,4297,15510,2681,1311,1370
13355,20682,5165,10039,4297,15515,2683,1312,1371
13360,20693,5168,10043,4300,15524,2684,1312,1372
13365,20697,5170,10044,4302,15527,2684,1312,1372
13370,20707,5172,10049,4304,15533,2685,1313,1372
13375,20713,5173,10050,4305,15539,2687,1313,1374
13380,20724,5175,10054,4307,15548,2688,1313,1375
13385,20728,5176,10055,4308,15551,2688,1313,1375
13390,20738,5180,10062,4312,15557,2689,1313,1376
13395,20744,5180,10067,4312,15563,2691,1315,1376
13400,20755,5180,10070,4312,15575,2692,1315,1377
13405,20759,5180,10072,4312,15579,2692,1315,1377
13410,20769,5180,10078,4312,15588,2693,1315,1378
13415,20775,5180,10079,4312,15595,2695,1315,1380
13420,20786,5180,10083,4312,15605,2696,1316,1380
13425,20790,5180,10085,4312,15609,2696,1316,1380
13430,20800,5183,10091,4315,15616,2697,1316,1381
13435,20806,5184,10094,4316,15622,2699,1317,1382
13440,20817,5186,10101,4318,15628,2700,1318,1382
13445,20821,5188,10103,4320,15632,2700,1318,1382
13450,20831,5190,10108,4322,15640,2701,1319,1382
13455,20837,5192,10112,4324,15645,2703,1320,1383
13460,20848,5194,10119,4326,15652,2704,1321,1383
13465,20852,5197,10121,4329,15655,2704,1321,1383
13470,20862,5199,10126,4331,15662,2705,1321,1384
13475,20868,5200,10129,4332,15668,2707,1323,1384
13480,20879,5201,10133,4333,15676,2708,1323,1385
13485,20883,5204,10134,4336,15679,2708,1323,1385
13490,20893,5206,10138,4337,15686,2709,1324,1385
13495,20899,5206,10141,4337,15692,2711,1325,1386
13500,20910,5210,10149,4341,15697,2712,1326,1386
13505,20914,5214,10152,4345,15700,2712,1326,1386
13510,20924,5216,10155,4346,15707,2713,1327,1386
13515,20930,5216,10157,4346,15713,2715,1328,1387
13520,20941,5219,10163,4349,15721,2716,1328,1388
13525,20945,5220,10163,4350,15725,2716,1328,1388
13530,20955,5222,10168,4351,15732,2717,1328,1389
13535,20961,5222,10169,4351,15738,2719,1328,1391
13540,20972,5224,10175,4353,15747,2720,1329,1391
13545,20976,5225,10177,4354,15751,2720,1329,1391
13550,20986,5228,10181,4355,15757,2721,1329,1392
13555,20992,5228,10184,4355,15762,2723,1330,1393
13560,21003,5232,10189,4359,15770,2724,1331,1393
13565,21007,5234,10192,4361,15772,2724,1331,1393
13570,21017,5238,10193,4363,15778,2725,1331,1394
13575,21023,5239,10196,4364,15782,2727,1331,1396
13580,21034,5242,10200,4367,15791,2728,1331,1397
13585,21038,5242,10201,4367,15796,2728,1331,1397
13590,21048,5245,10207,4370,15802,2729,1332,1397
13595,21054,5246,10211,4371,15807,2731,1333,1398
13600,21065,5246,10216,4371,15817,2732,1333,1399
13605,21069,5246,10216,4371,15823,2732,1333,1399
13610,21079,5248,10221,4372,15830,2733,1334,1399
13615,21085,5250,10225,4374,15833,2735,1334,1401
13620,21096,5252,10230,4376,15843,2736,1335,1401
13625,21100,5253,10231,4377,15847,2736,1335,1401
13630,21110,5255,10235,4378,15854,2737,1335,1402
13635,21116,5257,10239,4380,15859,2739,1337,1402
13640,21127,5259,10244,4381,15867,2740,1338,1402
13645,21131,5261,10247,4383,15870,2740,1338,1402
13650,21141,5263,10252,4384,15877,2741,1338,1403
13655,21147,5263,10253,4384,15884,2743,1338,1405
13660,21158,5264,10259,4385,15892,2744,1338,1406
13665,21162,5267,10260,4388,15895,2744,1338,1406
13670,21172,5268,10263,4388,15903,2745,1339,1406
13675,21178,5269,10266,4389,15909,2747,1339,1408
13680,21189,5271,10272,4391,15914,2748,1339,1409
13685,21193,5274,10272,4394,15919,2748,1339,1409
13690,21203,5276,10276,4395,15926,2749,1340,1409
13695,21209,5277,10279,4396,15931,2751,1341,1410
13700,21220,5282,10286,4400,15934,2752,1341,1411
13705,21224,5287,10289,4405,15936,2752,1341,1411
13710,21234,5291,10296,4409,15942,2753,1341,1412
13715,21240,5292,10299,4410,15948,2755,1343,1412
13720,21251,5295,10306,4413,15953,2756,1344,1412
13725,21255,5298,10308,4416,15956,2756,1344,1412
13730,21265,5303,10314,4421,15961,2757,1344,1413
13735,21271,5304,10316,4422,15966,2759,1344,1415
13740,21282,5305,10317,4423,15977,2760,1344,1416
13745,21286,5306,10320,4424,15978,2760,1344,1416
13750,21296,5309,10327,4426,15986,2761,1344,1417
13755,21302,5309,10327,4426,15993,2763,1344,1419
13760,21313,5310,10333,4427,16002,2764,1345,1419
13765,21317,5311,10333,4428,16006,2764,1345,1419
13770,21327,5313,10335,4428,16014,2765,1345,1420
13775,21333,5313,10339,4428,16018,2767,1346,1421
13780,21344,5316,10346,4431,16026,2768,1347,1421
13785,21348,5317,10348,4432,16031,2768,1347,1421
13790,21358,5319,10351,4434,16039,2769,1347,1422
13795,21364,5320,10355,4435,16044,2771,1349,1422
13800,21375,5321,10360,4436,16052,2772,1350,1422
13805,21379,5322,10362,4437,16056,2772,1350,1422
13810,21389,5324,10367,4438,16065,2773,1351,1422
13815,21395,5324,10371,4438,16070,2775,1353,1422
13820,21406,5326,10377,4440,16077,2776,1353,1423
13825,21410,5328,10378,4442,16081,2776,1353,1423
13830,21420,5330,10382,4443,16089,2777,1353,1424
13835,21426,5331,10383,4444,16095,2779,1353,1426
13840,21437,5335,10391,4447,16098,2780,1353,1427
13845,21441,5338,10391,4450,16103,2780,1353,1427
13850,21451,5341,10398,4453,16109,2781,1353,1428
13855,21457,5343,10401,4455,16114,2783,1355,1428
13860,21468,5348,10409,4459,16117,2784,1356,1428
13865,21472,5351,10412,4462,16120,2784,1356,1428
13870,21482,5356,10419,4467,16126,2785,1356,1429
13875,21488,5356,10421,4467,16132,2787,1358,1429
13880,21499,5359,10424,4469,16139,2788,1358,1430
13885,21503,5361,10427,4471,16141,2788,1358,1430
13890,21513,5365,10429,4473,16148,2789,1359,1430
13895,21519,5365,10431,4473,16154,2791,1359,1432
13900,21530,5368,10438,4476,16159,2792,1360,1432
13905,21534,5371,10440,4479,16163,2792,1360,1432
13910,21544,5374,10443,4480,16170,2793,1361,1432
13915,21550,5374,10447,4480,16175,2795,1362,1433
13920,21561,5379,10452,4484,16180,2796,1362,1434
13925,21565,5381,10454,4486,16183,2796,1362,1434
13930,21575,5385,10462,4490,16190,2797,1363,1434
13935,21581,5385,10465,4490,16196,2799,1364,1435
13940,21592,5388,10472,4493,16202,2800,1364,1436
13945,21596,5389,10473,4494,16207,2800,1364,1436
13950,21606,5391,10479,4496,16214,2801,1365,1436
13955,21612,5393,10484,4498,16218,2803,1367,1436
13960,21623,5396,10490,4501,16226,2804,1367,1437
13965,21627,5397,10491,4502,16229,2804,1367,1437
13970,21637,5398,10494,4502,16239,2805,1367,1438
13975,21643,5399,10499,4503,16243,2807,1369,1438
13980,21654,5401,10506,4505,16250,2808,1369,1439
13985,21658,5403,10508,4507,16255,2808,1369,1439
13990,21668,5404,10514,4508,16264,2809,1370,1439
13995,21674,5404,10516,4508,16270,2811,1372,1439
14000,21685,5404,10521,4508,16280,2812,1372,1440
14005,21689,5404,10524,4508,16285,2812,1372,1440
14010,21699,5405,10528,4509,16294,2813,1372,1441
14015,21705,5406,10533,4510,16298,2815,1374,1441
14020,21716,5407,10537,4511,16309,2816,1374,1442
14025,21720,5407,10540,4511,16313,2816,1374,1442
14030,21730,5408,10543,4512,16322,2817,1374,1443
14035,21736,5408,10545,4512,16327,2819,1374,1445
14040,21747,5411,10550,4515,16334,2820,1374,1446
14045,21751,5412,10550,4516,16339,2820,1374,1446
14050,21761,5414,10556,4518,16347,2821,1375,1446
14055,21767,5414,10559,4518,16353,2823,1377,1446
14060,21778,5416,10565,4520,16361,2824,1377,1447
14065,21782,5418,10566,4522,16364,2824,1377,1447
14070,21792,5421,10570,4524,16371,2825,1377,1448
14075,21798,5421,10572,4524,16376,2827,1378,1449
14080,21809,5423,10575,4526,16385,2828,1379,1449
14085,21813,5424,10575,4527,16389,2828,1379,1449
14090,21823,5430,10581,4532,16392,2829,1379,1450
14095,21829,5432,10585,4534,16395,2831,1380,1451
14100,21840,5438,10593,4540,16399,2832,1381,1451
14105,21844,5442,10597,4544,16401,2832,1381,1451
14110,21854,5445,10603,4547,16408,2833,1381,1452
14115,21860,5446,10606,4548,16412,2835,1381,1454
14120,21871,5450,10612,4551,16419,2836,1382,1454
14125,21875,5451,10612,4552,16424,2836,1382,1454
14130,21885,5455,10619,4554,16429,2837,1383,1454
14135,21891,5457,10623,4556,16432,2839,1383,1456
14140,21902,5461,10629,4560,16439,2840,1383,1457
14145,21906,5462,10629,4561,16444,2840,1383,1457
14150,21916,5465,10635,4563,16450,2841,1384,1457
14155,21922,5466,10639,4564,16455,2843,1386,1457
14160,21933,5468,10645,4566,16463,2844,1387,1457
14165,21937,5470,10648,4568,16467,2844,1387,1457
14170,21947,5472,10653,4568,16475,2845,1388,1457
14175,21953,5473,10657,4569,16479,2847,1389,1458
14180,21964,5475,10661,4571,16489,2848,1390,1458
14185,21968,5475,10663,4571,16493,2848,1390,1458
14190,21978,5477,10667,4573,16501,2849,1390,1459
14195,21984,5477,10671,4573,16506,2851,1392,1459
14200,21995,5479,10675,4575,16514,2852,1392,1460
14205,21999,5480,10676,4576,16519,2852,1392,1460
14210,22009,5482,10681,4577,16527,2853,1393,1460
14215,22015,5483,10685,4578,16531,2855,1393,1462
14220,22026,5485,10689,4580,16540,2856,1394,1462
14225,22030,5486,10691,4581,16544,2856,1394,1462
14230,22040,5488,10695,4581,16551,2857,1394,1463
14235,22046,5488,10697,4581,16557,2859,1394,1465
14240,22057,5491,10703,4584,16565,2860,1395,1465
14245,22061,5491,10705,4584,16570,2860,1395,1465
14250,22071,5492,10709,4584,16578,2861,1395,1466
14255,22077,5492,10710,4584,16585,2863,1395,1468
14260,22088,5493,10715,4585,16593,2864,1396,1468
14265,22092,5493,10718,4585,16598,2864,1396,1468
14270,22102,5495,10721,4586,16607,2865,1396,1469
14275,22108,5495,10724,4586,16612,2867,1398,1469
14280,22119,5498,10731,4588,16618,2868,1398,1470
14285,22123,5501,10733,4591,16621,2868,1398,1470
14290,22133,5502,10736,4592,16631,2869,1399,1470
14295,22139,5502,10738,4592,16637,2871,1400,1471
14300,22150,5503,10741,4592,16645,2872,1400,1472
14305,22154,5506,10742,4595,16648,2872,1400,1472
14310,22164,5508,10747,4596,16655,2873,1400,1473
14315,22170,5510,10749,4598,16659,2875,1400,1475
14320,22181,5512,10754,4599,16668,2876,1401,1475
14325,22185,5514,10756,4601,16671,2876,1401,1475
14330,22195,5517,10759,4603,16678,2877,1401,1476
14335,22201,5517,10761,4603,16682,2879,1401,1478
14340,22212,5519,10768,4604,16690,2880,1402,1478
14345,22216,5522,10768,4607,16694,2880,1402,1478
14350,22226,5526,10772,4610,16700,2881,1403,1478
14355,22232,5527,10776,4611,16703,2883,1404,1479
14360,22243,5531,10779,4614,16710,2884,1404,1480
14365,22247,5535,10781,4618,16712,2884,1404,1480
14370,22257,5540,10785,4622,16717,2885,1404,1481
14375,22263,5540,10787,4622,16721,2887,1404,1483
14380,22274,5544,10793,4626,16726,2888,1404,1484
14385,22278,5549,10796,4631,16727,2888,1404,1484
14390,22288,5553,10801,4635,16734,2889,1405,1484
14395,22294,5554,10801,4636,16740,2891,1405,1486
14400,22305,5556,10805,4638,16748,2892,1405,1487
14405,22309,5557,10807,4639,16752,2892,1405,1487
14410,22319,5559,10812,4639,16759,2893,1406,1487
14415,22325,5560,10816,4640,16764,2895,1408,1487
14420,22336,5562,10821,4642,16773,2896,1409,1487
14425,22340,5563,10822,4643,16776,2896,1409,1487
14430,22350,5565,10826,4643,16785,2897,1409,1488
14435,22356,5565,10828,4643,16790,2899,1410,1489
14440,22367,5566,10832,4644,16799,2900,1411,1489
14445,22371,5567,10834,4645,16804,2900,1411,1489
14450,22381,5569,10841,4646,16811,2901,1411,1490
14455,22387,5570,10844,4647,16816,2903,1411,1492
14460,22398,5572,10852,4649,16824,2904,1412,1492
14465,22402,5573,10854,4650,16829,2904,1412,1492
14470,22412,5575,10859,4650,16836,2905,1413,1492
14475,22418,5575,10861,4650,16843,2907,1414,1493
14480,22429,5576,10867,4651,16851,2908,1414,1494
14485,22433,5578,10868,4653,16855,2908,1414,1494
14490,22443,5580,10873,4653,16862,2909,1414,1495
14495,22449,5581,10877,4654,16868,2911,1416,1495
14500,22460,5583,10882,4656,16876,2912,1416,1496
14505,22464,5585,10883,4658,16879,2912,1416,1496
14510,22474,5588,10888,4660,16885,2913,1416,1497
14515,22480,5589,10890,4661,16891,2915,1417,1498
14520,22491,5590,10894,4661,16898,2916,1418,1498
14525,22495,5593,10895,4664,16902,2916,1418,1498
14530,22505,5596,10899,4665,16909,2917,1418,1499
14535,22511,5597,10903,4666,16914,2919,1419,1500
14540,22522,5600,10908,4668,16920,2920,1420,1500
14545,22526,5602,10908,4670,16924,2920,1420,1500
14550,22536,5604,10912,4671,16931,2921,1421,1500
14555,22542,5606,10917,4673,16935,2923,1423,1500
14560,22553,5610,10923,4677,16941,2924,1424,1500
14565,22557,5612,10924,4679,16944,2924,1424,1500
14570,22567,5618,10930,4684,16949,2925,1424,1501
14575,22573,5619,10934,4685,16952,2927,1424,1503
14580,22584,5621,10940,4687,16961,2928,1425,1503
14585,22588,5624,10944,4690,16963,2928,1425,1503
14590,22598,5626,10947,4691,16972,2929,1425,1504
14595,22604,5627,10950,4692,16977,2931,1426,1505
14600,22615,5628,10953,4692,16986,2932,1426,1506
14605,22619,5629,10955,4693,16990,2932,1426,1506
14610,22629,5631,10962,4694,16997,2933,1427,1506
14615,22635,5632,10966,4695,17001,2935,1428,1507
14620,22646,5635,10972,4697,17010,2936,1429,1507
14625,22650,5637,10974,4699,17013,2936,1429,1507
14630,22660,5639,10976,4700,17021,2937,1429,1508
14635,22666,5640,10981,4701,17024,2939,1430,1509
14640,22677,5642,10987,4703,17033,2940,1430,1510
14645,22681,5643,10988,4704,17037,2940,1430,1510
14650,22691,5644,10993,4704,17046,2941,1430,1511
14655,22697,5644,10995,4704,17053,2943,1430,1513
14660,22708,5644,11001,4704,17062,2944,1430,1514
14665,22712,5644,11003,4704,17067,2944,1430,1514
14670,22722,5645,11007,4704,17077,2945,1430,1515
14675,22728,5645,11009,4704,17083,2947,1431,1516
14680,22739,5647,11015,4706,17090,2948,1432,1516
14685,22743,5648,11017,4707,17095,2948,1432,1516
14690,22753,5650,11022,4708,17102,2949,1432,1517
14695,22759,5651,11026,4709,17107,2951,1433,1518
14700,22770,5652,11032,4710,17115,2952,1434,1518
14705,22774,5654,11033,4712,17120,2952,1434,1518
14710,22784,5656,11037,4714,17128,2953,1434,1519
14715,22790,5657,11040,4715,17133,2955,1435,1520
14720,22801,5657,11046,4715,17142,2956,1436,1520
14725,22805,5658,11048,4716,17147,2956,1436,1520
14730,22815,5660,11053,4716,17155,2957,1437,1520
14735,22821,5661,11056,4717,17159,2959,1437,1522
14740,22832,5663,11062,4719,17167,2960,1438,1522
14745,22836,5664,11065,4720,17172,2960,1438,1522
14750,22846,5666,11067,4721,17180,2961,1439,1522
14755,22852,5667,11071,4722,17184,2963,1440,1523
14760,22863,5671,11078,4726,17189,2964,1441,1523
14765,22867,5675,11080,4730,17192,2964,1441,1523
14770,22877,5677,11086,4732,17200,2965,1442,1523
14775,22883,5677,11091,4732,17205,2967,1444,1523
14780,22894,5680,11096,4735,17211,2968,1444,1524
14785,22898,5684,11098,4739,17213,2968,1444,1524
14790,22908,5689,11104,4744,17218,2969,1445,1524
14795,22914,5691,11106,4746,17223,2971,1446,1525
14800,22925,5694,11112,4749,17229,2972,1447,1525
14805,22929,5697,11114,4752,17231,2972,1447,1525
14810,22939,5701,11120,4756,17236,2973,1448,1525
14815,22945,5703,11124,4758,17240,2975,1450,1525
14820,22956,5709,11131,4763,17244,2976,1451,1525
14825,22960,5713,11133,4767,17247,2976,1451,1525
14830,22970,5714,11135,4768,17255,2977,1451,1526
14835,22976,5716,11138,4770,17260,2979,1452,1527
14840,22987,5718,11145,4772,17267,2980,1453,1527
14845,22991,5720,11147,4774,17271,2980,1453,1527
14850,23001,5721,11151,4775,17280,2981,1453,1528
14855,23007,5721,11153,4775,17285,2983,1454,1529
14860,23018,5722,11161,4776,17294,2984,1455,1529
14865,23022,5724,11164,4778,17297,2984,1455,1529
14870,23032,5725,11168,4779,17307,2985,1455,1530
14875,23038,5725,11171,4779,17312,2987,1456,1531
14880,23049,5726,11175,4780,17322,2988,1456,1532
14885,23053,5728,11177,4782,17325,2988,1456,1532
14890,23063,5730,11182,4784,17333,2989,1457,1532
14895,23069,5730,11184,4784,17339,2991,1457,1534
14900,23080,5731,11190,4785,17348,2992,1458,1534
14905,23084,5731,11190,4785,17353,2992,1458,1534
14910,23094,5732,11196,4786,17361,2993,1459,1534
14915,23100,5733,11199,4787,17367,2995,1460,1535
14920,23111,5735,11207,4788,17374,2996,1461,1535
14925,23115,5736,11208,4789,17379,2996,1461,1535
14930,23125,5738,11213,4790,17386,2997,1461,1536
14935,23131,5739,11214,4791,17392,2999,1461,1538
14940,23142,5740,11219,4792,17401,3000,1461,1539
14945,23146,5741,11221,4793,17404,3000,1461,1539
14950,23156,5743,11226,4794,17412,3001,1462,1539
14955,23162,5744,11230,4795,17417,3003,1463,1540
14960,23173,5745,11234,4796,17427,3004,1463,1541
14965,23177,5746,11235,4797,17431,3004,1463,1541
14970,23187,5748,11238,4798,17439,3005,1463,1542
14975,23193,5748,11240,4798,17445,3007,1464,1543
14980,23204,5748,11243,4798,17455,3008,1464,1544
14985,23208,5748,11245,4798,17460,3008,1464,1544
14990,23218,5750,11252,4800,17468,3009,1464,1545
14995,23224,5751,11256,4801,17472,3011,1465,1546
15000,23235,5753,11259,4803,17481,3012,1465,1547
15005,23239,5753,11259,4803,17486,3012,1465,1547
15010,23249,5755,11261,4803,17494,3013,1466,1547
15015,23255,5756,11265,4804,17498,3015,1468,1547
15020,23266,5759,11273,4807,17504,3016,1469,1547
15025,23270,5762,11276,4810,17507,3016,1469,1547
15030,23280,5765,11282,4813,17514,3017,1470,1547
15035,23286,5766,11286,4814,17520,3019,1471,1548
15040,23297,5767,11291,4815,17528,3020,1472,1548
15045,23301,5771,11294,4819,17529,3020,1472,1548
15050,23311,5775,11296,4821,17536,3021,1472,1549
15055,23317,5775,11297,4821,17542,3023,1472,1551
15060,23328,5778,11304,4824,17547,3024,1473,1551
15065,23332,5782,11307,4828,17548,3024,1473,1551
15070,23342,5789,11312,4834,17552,3025,1473,1552
15075,23348,5791,11315,4836,17556,3027,1474,1553
15080,23359,5794,11319,4838,17563,3028,1475,1553
15085,23363,5797,11321,4841,17565,3028,1475,1553
15090,23373,5800,11324,4843,17572,3029,1476,1553
15095,23379,5801,11325,4844,17577,3031,1476,1555
15100,23390,5805,11331,4847,17581,3032,1476,1556
15105,23394,5809,11332,4851,17584,3032,1476,1556
15110,23404,5814,11335,4855,17590,3033,1476,1557
15115,23410,5815,11338,4856,17595,3035,1478,1557
15120,23421,5816,11345,4856,17601,3036,1478,1558
15125,23425,5819,11346,4859,17606,3036,1478,1558
15130,23435,5821,11353,4861,17613,3037,1478,1559
15135,23441,5823,11357,4863,17616,3039,1479,1560
15140,23452,5826,11363,4865,17624,3040,1479,1561
15145,23456,5828,11364,4867,17628,3040,1479,1561
15150,23466,5829,11367,4867,17636,3041,1480,1561
15155,23472,5831,11370,4869,17640,3043,1481,1562
15160,23483,5833,11376,4871,17647,3044,1482,1562
15165,23487,5836,11378,4874,17650,3044,1482,1562
15170,23497,5837,11384,4874,17659,3045,1483,1562
15175,23503,5838,11386,4875,17665,3047,1484,1563
15180,23514,5838,11392,4875,17673,3048,1484,1564
15185,23518,5839,11395,4876,17679,3048,1484,1564
15190,23528,5840,11400,4876,17688,3049,1485,1564
15195,23534,5841,11403,4877,17692,3051,1486,1565
15200,23545,5841,11409,4877,17703,3052,1487,1565
15205,23549,5841,11411,4877,17708,3052,1487,1565
15210,23559,5842,11418,4878,17716,3053,1488,1565
15215,23565,5842,11421,4878,17723,3055,1488,1567
15220,23576,5842,11424,4878,17733,3056,1488,1568
15225,23580,5842,11425,4878,17738,3056,1488,1568
15230,23590,5844,11430,4879,17745,3057,1489,1568
15235,23596,5845,11435,4880,17750,3059,1491,1568
15240,23607,5846,11439,4881,17760,3060,1492,1568
15245,23611,5847,11441,4882,17763,3060,1492,1568
15250,23621,5850,11446,4883,17770,3061,1493,1568
15255,23627,5851,11448,4884,17776,3063,1494,1569
15260,23638,5853,11454,4886,17782,3064,1495,1569
15265,23642,5855,11457,4888,17786,3064,1495,1569
15270,23652,5859,11462,4891,17792,3065,1495,1570
15275,23658,5860,11463,4892,17798,3067,1496,1571
15280,23669,5863,11468,4894,17804,3068,1497,1571
15285,23673,5867,11470,4898,17806,3068,1497,1571
15290,23683,5870,11473,4899,17813,3069,1497,1572
15295,23689,5870,11475,4899,17819,3071,1499,1572
15300,23700,5873,11481,4902,17824,3072,1499,1573
15305,23704,5876,11482,4905,17827,3072,1499,1573
15310,23714,5881,11488,4909,17832,3073,1499,1574
15315,23720,5883,11491,4911,17836,3075,1500,1575
15320,23731,5887,11495,4915,17843,3076,1500,1576
15325,23735,5888,11495,4916,17847,3076,1500,1576
15330,23745,5893,11500,4920,17852,3077,1501,1576
15335,23751,5894,11502,4921,17856,3079,1501,1578
15340,23762,5897,11506,4924,17863,3080,1501,1579
15345,23766,5899,11507,4926,17866,3080,1501,1579
15350,23776,5903,11508,4928,17873,3081,1501,1580
15355,23782,5904,11510,4929,17877,3083,1501,1582
15360,23793,5907,11514,4932,17884,3084,1501,1583
15365,23797,5911,11517,4936,17885,3084,1501,1583
15370,23807,5916,11521,4939,17891,3085,1501,1584
15375,23813,5916,11526,4939,17895,3087,1503,1584
15380,23824,5919,11534,4942,17902,3088,1504,1584
15385,23828,5920,11535,4943,17908,3088,1504,1584
15390,23838,5921,11543,4944,17916,3089,1505,1584
15395,23844,5921,11545,4944,17922,3091,1506,1585
15400,23855,5921,11551,4944,17933,3092,1506,1586
15405,23859,5921,11553,4944,17937,3092,1506,1586
15410,23869,5922,11559,4945,17947,3093,1507,1586
15415,23875,5923,11564,4946,17951,3095,1508,1587
15420,23886,5924,11571,4947,17961,3096,1509,1587
15425,23890,5925,11571,4948,17965,3096,1509,1587
15430,23900,5926,11575,4948,17973,3097,1509,1588
15435,23906,5927,11580,4949,17979,3099,1511,1588
15440,23917,5928,11586,4950,17989,3100,1511,1589
15445,23921,5928,11589,4950,17993,3100,1511,1589
15450,23931,5929,11594,4951,18002,3101,1511,1590
15455,23937,5930,11598,4952,18007,3103,1512,1591
15460,23948,5931,11604,4953,18016,3104,1513,1591
15465,23952,5932,11605,4954,18020,3104,1513,1591
15470,23962,5933,11609,4954,18028,3105,1514,1591
15475,23968,5933,11611,4954,18035,3107,1515,1592
15480,23979,5933,11615,4954,18045,3108,1515,1593
15485,23983,5933,11618,4954,18050,3108,1515,1593
15490,23993,5937,11626,4957,18055,3109,1516,1593
15495,23999,5939,11630,4959,18059,3111,1517,1594
15500,24010,5941,11634,4961,18068,3112,1518,1594
15505,24014,5942,11635,4962,18072,3112,1518,1594
15510,24024,5945,11641,4964,18078,3113,1519,1594
15515,24030,5946,11645,4965,18083,3115,1520,1595
15520,24041,5952,11653,4970,18087,3116,1521,1595
15525,24045,5956,11656,4974,18088,3116,1521,1595
15530,24055,5960,11659,4976,18094,3117,1521,1596
15535,24061,5960,11660,4976,18101,3119,1522,1597
15540,24072,5963,11664,4978,18107,3120,1522,1598
15545,24076,5966,11665,4981,18110,3120,1522,1598
15550,24086,5971,11670,4984,18114,3121,1523,1598
15555,24092,5972,11671,4985,18119,3123,1523,1600
15560,24103,5978,11677,4991,18125,3124,1524,1600
15565,24107,5979,11679,4992,18127,3124,1524,1600
15570,24117,5984,11684,4996,18131,3125,1524,1601
15575,24123,5986,11685,4998,18136,3127,1524,1603
15580,24134,5990,11690,5001,18142,3128,1525,1603
15585,24138,5992,11691,5003,18145,3128,1525,1603
15590,24148,5995,11695,5005,18152,3129,1526,1603
15595,24154,5996,11697,5006,18157,3131,1527,1604
15600,24165,5998,11700,5007,18166,3132,1527,1605
15605,24169,5999,11700,5008,18170,3132,1527,1605
15610,24179,6002,11707,5011,18176,3133,1528,1605
15615,24185,6003,11707,5012,18182,3135,1528,1607
15620,24196,6006,11715,5015,18188,3136,1529,1607
15625,24200,6007,11716,5016,18193,3136,1529,1607
15630,24210,6008,11720,5017,18201,3137,1529,1608
15635,24216,6008,11723,5017,18206,3139,1530,1609
15640,24227,6008,11728,5017,18217,3140,1530,1610
15645,24231,6008,11729,5017,18223,3140,1530,1610
15650,24241,6009,11732,5017,18231,3141,1531,1610
15655,24247,6010,11735,5018,18236,3143,1532,1611
15660,24258,6011,11741,5019,18245,3144,1532,1612
15665,24262,6011,11742,5019,18251,3144,1532,1612
15670,24272,6012,11748,5019,18259,3145,1533,1612
15675,24278,6013,11750,5020,18265,3147,1533,1614
15680,24289,6013,11754,5020,18275,3148,1533,1615
15685,24293,6014,11755,5021,18279,3148,1533,1615
15690,24303,6015,11763,5022,18287,3149,1534,1615
15695,24309,6016,11767,5023,18292,3151,1535,1616
15700,24320,6017,11771,5024,18301,3152,1535,1617
15705,24324,6018,11774,5025,18306,3152,1535,1617
15710,24334,6020,11781,5026,18313,3153,1536,1617
15715,24340,6020,11783,5026,18319,3155,1537,1618
15720,24351,6022,11788,5028,18327,3156,1537,1619
15725,24355,6022,11788,5028,18333,3156,1537,1619
15730,24365,6024,11794,5030,18340,3157,1537,1620
15735,24371,6025,11798,5031,18346,3159,1539,1620
15740,24382,6027,11806,5033,18352,3160,1540,1620
15745,24386,6029,11808,5035,18357,3160,1540,1620
15750,24396,6032,11814,5037,18363,3161,1541,1620
15755,24402,6032,11817,5037,18370,3163,1543,1620
15760,24413,6033,11819,5038,18380,3164,1544,1620
15765,24417,6033,11822,5038,18382,3164,1544,1620
15770,24427,6037,11824,5040,18388,3165,1545,1620
15775,24433,6039,11826,5042,18393,3167,1545,1622
15780,24444,6042,11831,5045,18402,3168,1546,1622
15785,24448,6043,11833,5046,18404,3168,1546,1622
15790,24458,6049,11836,5050,18408,3169,1546,1623
15795,24464,6049,11839,5050,18414,3171,1548,1623
15800,24475,6053,11846,5054,18419,3172,1549,1623
15805,24479,6056,11846,5057,18423,3172,1549,1623
15810,24489,6060,11850,5060,18428,3173,1549,1624
15815,24495,6061,11855,5061,18432,3175,1551,1624
15820,24506,6067,11863,5066,18436,3176,1552,1624
15825,24510,6069,11864,5068,18441,3176,1552,1624
15830,24520,6071,11869,5069,18448,3177,1553,1624
15835,24526,6072,11873,5070,18452,3179,1553,1626
15840,24537,6075,11878,5072,18460,3180,1553,1627
15845,24541,6077,11880,5074,18464,3180,1553,1627
15850,24551,6080,11886,5076,18470,3181,1554,1627
15855,24557,6081,11889,5077,18476,3183,1554,1629
15860,24568,6082,11892,5078,18486,3184,1554,1630
15865,24572,6083,11895,5079,18489,3184,1554,1630
15870,24582,6086,11899,5082,18495,3185,1554,1631
15875,24588,6087,11901,5083,18501,3187,1555,1632
15880,24599,6088,11905,5084,18511,3188,1555,1633
15885,24603,6089,11907,5085,18514,3188,1555,1633
15890,24613,6091,11911,5087,18521,3189,1556,1633
15895,24619,6091,11914,5087,18528,3191,1557,1634
15900,24630,6093,11918,5088,18537,3192,1558,1634
15905,24634,6093,11918,5088,18541,3192,1558,1634
15910,24644,6095,11922,5089,18548,3193,1558,1635
15915,24650,6097,11927,5091,18553,3195,1559,1636
15920,24661,6099,11931,5092,18561,3196,1560,1636
15925,24665,6100,11931,5093,18565,3196,1560,1636
15930,24675,6102,11935,5094,18572,3197,1561,1636
15935,24681,6102,11937,5094,18578,3199,1561,1638
15940,24692,6106,11941,5097,18585,3200,1562,1638
15945,24696,6108,11944,5099,18587,3200,1562,1638
15950,24706,6116,11951,5106,18588,3201,1562,1639
15955,24712,6117,11954,5107,18594,3203,1564,1639
15960,24723,6122,11961,5112,18599,3204,1565,1639
15965,24727,6125,11963,5115,18601,3204,1565,1639
15970,24737,6131,11968,5120,18605,3205,1566,1639
15975,24743,6132,11970,5121,18611,3207,1567,1640
15980,24754,6135,11977,5123,18615,3208,1568,1640
15985,24758,6140,11979,5128,18617,3208,1568,1640
15990,24768,6144,11982,5131,18623,3209,1568,1641
15995,24774,6144,11984,5131,18629,3211,1568,1643
16000,24785,6146,11991,5132,18636,3212,1569,1643
16005,24789,6149,11995,5135,18639,3212,1569,1643
16010,24799,6151,11999,5136,18647,3213,1569,1644
16015,24805,6151,12002,5136,18654,3215,1571,1644
16020,24816,6154,12009,5139,18661,3216,1572,1644
16025,24820,6155,12012,5140,18664,3216,1572,1644
16030,24830,6156,12017,5141,18673,3217,1572,1645
16035,24836,6157,12021,5142,18679,3219,1573,1646
16040,24847,6159,12026,5143,18686,3220,1574,1646
16045,24851,6162,12030,5146,18689,3220,1574,1646
16050,24861,6163,12033,5147,18697,3221,1574,1647
16055,24867,6164,12037,5148,18703,3223,1575,1648
16060,24878,6167,12041,5151,18710,3224,1575,1649
16065,24882,6168,12041,5152,18714,3224,1575,1649
16070,24892,6170,12046,5154,18721,3225,1576,1649
16075,24898,6170,12046,5154,18728,3227,1576,1651
16080,24909,6172,12054,5156,18734,3228,1576,1652
16085,24913,6173,12056,5157,18740,3228,1576,1652
16090,24923,6174,12059,5157,18748,3229,1577,1652
16095,24929,6174,12061,5157,18755,3231,1578,1653
16100,24940,6174,12066,5157,18765,3232,1579,1653
16105,24944,6175,12067,5158,18769,3232,1579,1653
16110,24954,6177,12073,5160,18776,3233,1579,1654
16115,24960,6178,12076,5161,18781,3235,1580,1655
16120,24971,6179,12081,5162,18790,3236,1580,1656
16125,24975,6182,12082,5165,18793,3236,1580,1656
16130,24985,6184,12084,5165,18800,3237,1581,1656
16135,24991,6184,12087,5165,18807,3239,1583,1656
16140,25002,6184,12089,5165,18817,3240,1583,1657
16145,25006,6185,12090,5166,18821,3240,1583,1657
16150,25016,6187,12091,5166,18829,3241,1584,1657
16155,25022,6188,12093,5167,18834,3243,1585,1658
16160,25033,6189,12098,5168,18842,3244,1586,1658
16165,25037,6190,12100,5169,18846,3244,1586,1658
16170,25047,6196,12106,5174,18850,3245,1586,1659
16175,25053,6196,12108,5174,18856,3247,1587,1660
16180,25064,6199,12113,5177,18863,3248,1587,1661
16185,25068,6201,12114,5179,18867,3248,1587,1661
16190,25078,6205,12119,5182,18872,3249,1588,1661
16195,25084,6207,12123,5184,18875,3251,1589,1662
16200,25095,6212,12128,5188,18881,3252,1590,1662
16205,25099,6214,12130,5190,18883,3252,1590,1662
16210,25109,6219,12135,5194,18888,3253,1591,1662
16215,25115,6221,12138,5196,18893,3255,1593,1662
16220,25126,6227,12146,5202,18897,3256,1593,1663
16225,25130,6228,12147,5203,18902,3256,1593,1663
16230,25140,6229,12151,5203,18910,3257,1593,1664
16235,25146,6231,12154,5205,18913,3259,1593,1666
16240,25157,6234,12159,5207,18922,3260,1594,1666
16245,25161,6236,12162,5209,18924,3260,1594,1666
16250,25171,6238,12168,5211,18933,3261,1595,1666
16255,25177,6239,12172,5212,18937,3263,1596,1667
16260,25188,6241,12176,5214,18945,3264,1596,1668
16265,25192,6242,12177,5215,18950,3264,1596,1668
16270,25202,6244,12181,5217,18958,3265,1597,1668
16275,25208,6244,12184,5217,18964,3267,1599,1668
16280,25219,6245,12189,5218,18973,3268,1600,1668
16285,25223,6247,12192,5220,18976,3268,1600,1668
16290,25233,6248,12197,5221,18985,3269,1600,1669
16295,25239,6248,12198,5221,18991,3271,1600,1671
16300,25250,6249,12205,5222,18998,3272,1600,1672
16305,25254,6251,12206,5224,19003,3272,1600,1672
16310,25264,6252,12211,5225,19011,3273,1601,1672
16315,25270,6254,12213,5227,19016,3275,1601,1674
16320,25281,6257,12219,5229,19021,3276,1601,1675
16325,25285,6260,12219,5232,19025,3276,1601,1675
16330,25295,6262,12222,5232,19032,3277,1602,1675
16335,25301,6262,12223,5232,19039,3279,1603,1676
16340,25312,6263,12227,5233,19048,3280,1604,1676
16345,25316,6264,12231,5234,19052,3280,1604,1676
16350,25326,6266,12234,5235,19059,3281,1604,1677
16355,25332,6266,12236,5235,19066,3283,1605,1678
16360,25343,6268,12243,5237,19072,3284,1605,1679
16365,25347,6269,12243,5238,19078,3284,1605,1679
16370,25357,6273,12249,5242,19083,3285,1605,1680
16375,25363,6274,12251,5243,19089,3287,1606,1681
16380,25374,6276,12256,5245,19096,3288,1606,1682
16385,25378,6278,12256,5247,19100,3288,1606,1682
16390,25388,6281,12261,5249,19106,3289,1607,1682
16395,25394,6281,12263,5249,19112,3291,1608,1683
16400,25405,6282,12268,5250,19121,3292,1609,1683
16405,25409,6284,12271,5252,19123,3292,1609,1683
16410,25419,6290,12274,5256,19129,3293,1609,1684
16415,25425,6291,12275,5257,19134,3295,1609,1686
16420,25436,6294,12280,5260,19141,3296,1609,1687
16425,25440,6295,12281,5261,19144,3296,1609,1687
16430,25450,6299,12284,5264,19150,3297,1609,1688
16435,25456,6301,12287,5266,19154,3299,1610,1689
16440,25467,6304,12290,5268,19161,3300,1610,1690
16445,25471,6308,12293,5272,19162,3300,1610,1690
16450,25481,6311,12300,5274,19170,3301,1611,1690
16455,25487,6311,12300,5274,19176,3303,1611,1692
16460,25498,6313,12305,5276,19183,3304,1611,1693
16465,25502,6315,12306,5278,19187,3304,1611,1693
16470,25512,6317,12312,5279,19194,3305,1612,1693
16475,25518,6318,12314,5280,19200,3307,1613,1694
16480,25529,6320,12319,5281,19207,3308,1614,1694
16485,25533,6323,12322,5284,19209,3308,1614,1694
16490,25543,6325,12326,5285,19218,3309,1615,1694
16495,25549,6326,12328,5286,19223,3311,1616,1695
16500,25560,6328,12333,5287,19232,3312,1617,1695
16505,25564,6328,12334,5287,19236,3312,1617,1695
16510,25574,6331,12338,5290,19243,3313,1617,1696
16515,25580,6331,12339,5290,19249,3315,1618,1697
16520,25591,6333,12347,5292,19256,3316,1619,1697
16525,25595,6336,12349,5295,19259,3316,1619,1697
16530,25605,6337,12353,5295,19267,3317,1620,1697
16535,25611,6339,12357,5297,19271,3319,1622,1697
16540,25622,6341,12362,5299,19279,3320,1622,1698
16545,25626,6343,12364,5301,19282,3320,1622,1698
16550,25636,6345,12371,5303,19291,3321,1622,1699
16555,25642,6345,12375,5303,19296,3323,1624,1699
16560,25653,6348,12381,5305,19302,3324,1625,1699
16565,25657,6351,12384,5308,19306,3324,1625,1699
16570,25667,6352,12389,5308,19314,3325,1626,1699
16575,25673,6352,12392,5308,19320,3327,1628,1699
16580,25684,6353,12400,5309,19329,3328,1629,1699
16585,25688,6354,12403,5310,19333,3328,1629,1699
16590,25698,6356,12407,5311,19342,3329,1630,1699
16595,25704,6356,12411,5311,19348,3331,1632,1699
16600,25715,6357,12418,5312,19357,3332,1632,1700
16605,25719,6357,12419,5312,19362,3332,1632,1700
16610,25729,6358,12424,5312,19370,3333,1633,1700
16615,25735,6358,12427,5312,19376,3335,1634,1701
16620,25746,6359,12428,5313,19386,3336,1634,1702
16625,25750,6359,12429,5313,19390,3336,1634,1702
16630,25760,6361,12433,5314,19399,3337,1635,1702
16635,25766,6361,12436,5314,19405,3339,1637,1702
16640,25777,6362,12441,5315,19414,3340,1637,1703
16645,25781,6363,12444,5316,19417,3340,1637,1703
16650,25791,6365,12451,5317,19425,3341,1637,1704
16655,25797,6365,12454,5317,19431,3343,1637,1706
16660,25808,6367,12462,5319,19439,3344,1638,1706
16665,25812,6369,12465,5321,19442,3344,1638,1706
16670,25822,6373,12468,5323,19448,3345,1639,1706
16675,25828,6374,12470,5324,19453,3347,1639,1708
16680,25839,6380,12477,5329,19457,3348,1639,1709
16685,25843,6382,12478,5331,19461,3348,1639,1709
16690,25853,6387,12483,5334,19465,3349,1640,1709
16695,25859,6388,12486,5335,19470,3351,1641,1710
16700,25870,6392,12490,5339,19478,3352,1641,1711
16705,25874,6393,12492,5340,19481,3352,1641,1711
16710,25884,6397,12494,5342,19487,3353,1641,1712
16715,25890,6397,12497,5342,19491,3355,1642,1713
16720,25901,6401,12502,5345,19498,3356,1643,1713
16725,25905,6404,12504,5348,19501,3356,1643,1713
16730,25915,6407,12508,5350,19507,3357,1643,1714
16735,25921,6409,12512,5352,19511,3359,1644,1715
16740,25932,6412,12518,5354,19518,3360,1644,1716
16745,25936,6414,12519,5356,19522,3360,1644,1716
16750,25946,6415,12523,5356,19531,3361,1645,1716
16755,25952,6416,12526,5357,19536,3363,1647,1716
16760,25963,6418,12532,5359,19543,3364,1647,1717
16765,25967,6420,12534,5361,19546,3364,1647,1717
16770,25977,6421,12538,5362,19556,3365,1648,1717
16775,25983,6421,12542,5362,19560,3367,1650,1717
16780,25994,6423,12546,5363,19570,3368,1650,1718
16785,25998,6425,12550,5365,19572,3368,1650,1718
16790,26008,6426,12553,5366,19582,3369,1650,1719
16795,26014,6427,12558,5367,19586,3371,1652,1719
16800,26025,6428,12564,5368,19597,3372,1653,1719
16805,26029,6428,12565,5368,19601,3372,1653,1719
16810,26039,6429,12571,5368,19609,3373,1654,1719
16815,26045,6429,12575,5368,19615,3375,1656,1719
16820,26056,6430,12582,5369,19626,3376,1657,1719
16825,26060,6430,12583,5369,19629,3376,1657,1719
16830,26070,6432,12587,5369,19637,3377,1657,1720
16835,26076,6433,12590,5370,19643,3379,1659,1720
16840,26087,6434,12594,5371,19651,3380,1659,1721
16845,26091,6436,12597,5373,19654,3380,1659,1721
16850,26101,6438,12601,5373,19663,3381,1659,1722
16855,26107,6438,12604,5373,19668,3383,1660,1723
16860,26118,6440,12608,5375,19676,3384,1660,1724
16865,26122,6441,12609,5376,19681,3384,1660,1724
16870,26132,6443,12613,5376,19689,3385,1661,1724
16875,26138,6443,12614,5376,19694,3387,1661,1726
16880,26149,6445,12619,5378,19703,3388,1662,1726
16885,26153,6445,12621,5378,19707,3388,1662,1726
16890,26163,6448,12625,5380,19715,3389,1662,1727
16895,26169,6448,12627,5380,19720,3391,1662,1729
16900,26180,6450,12633,5381,19726,3392,1663,1729
16905,26184,6453,12635,5384,19729,3392,1663,1729
16910,26194,6461,12641,5390,19732,3393,1663,1730
16915,26200,6462,12646,5391,19737,3395,1665,1730
16920,26211,6466,12652,5395,19743,3396,1666,1730
16925,26215,6469,12656,5398,19745,3396,1666,1730
16930,26225,6473,12661,5401,19751,3397,1666,1731
16935,26231,6474,12664,5402,19756,3399,1667,1732
16940,26242,6478,12671,5405,19760,3400,1668,1732
16945,26246,6482,12673,5409,19764,3400,1668,1732
16950,26256,6485,12677,5412,19771,3401,1668,1733
16955,26262,6485,12680,5412,19776,3403,1669,1734
16960,26273,6490,12687,5417,19781,3404,1670,1734
16965,26277,6493,12688,5420,19784,3404,1670,1734
16970,26287,6497,12693,5422,19790,3405,1670,1735
16975,26293,6497,12696,5422,19796,3407,1671,1736
16980,26304,6502,12703,5427,19801,3408,1672,1736
16985,26308,6502,12704,5427,19805,3408,1672,1736
16990,26318,6506,12709,5430,19812,3409,1672,1737
16995,26324,6506,12711,5430,19818,3411,1674,1737
17000,26335,6509,12718,5433,19823,3412,1675,1737
17005,26339,6512,12720,5436,19826,3412,1675,1737
17010,26349,6516,12725,5438,19832,3413,1675,1738
17015,26355,6518,12729,5440,19836,3415,1677,1738
17020,26366,6522,12733,5443,19844,3416,1678,1738
17025,26370,6523,12735,5444,19847,3416,1678,1738
17030,26380,6525,12739,5445,19854,3417,1678,1739
17035,26386,6527,12741,5447,19859,3419,1679,1740
17040,26397,6529,12746,5449,19866,3420,1680,1740
17045,26401,6529,12749,5449,19872,3420,1680,1740
17050,26411,6530,12755,5449,19881,3421,1681,1740
17055,26417,6530,12758,5449,19886,3423,1682,1741
17060,26428,6531,12765,5450,19896,3424,1683,1741
17065,26432,6532,12768,5451,19899,3424,1683,1741
17070,26442,6533,12771,5451,19909,3425,1683,1742
17075,26448,6533,12774,5451,19914,3427,1684,1743
17080,26459,6534,12781,5452,19923,3428,1684,1744
17085,26463,6534,12781,5452,19929,3428,1684,1744
17090,26473,6535,12785,5453,19938,3429,1684,1745
17095,26479,6536,12789,5454,19942,3431,1685,1746
17100,26490,6536,12795,5454,19951,3432,1686,1746
17105,26494,6537,12798,5455,19956,3432,1686,1746
17110,26504,6538,12802,5455,19966,3433,1686,1747
17115,26510,6539,12806,5456,19971,3435,1688,1747
17120,26521,6540,12809,5457,19981,3436,1688,1748
17125,26525,6540,12811,5457,19985,3436,1688,1748
17130,26535,6542,12819,5459,19993,3437,1688,1749
17135,26541,6543,12820,5460,19998,3439,1688,1751
17140,26552,6545,12828,5462,20006,3440,1689,1751
17145,26556,6545,12829,5462,20010,3440,1689,1751
17150,26566,6548,12832,5463,20017,3441,1689,1752
17155,26572,6549,12835,5464,20023,3443,1691,1752
17160,26583,6551,12839,5466,20030,3444,1691,1753
17165,26587,6553,12841,5468,20034,3444,1691,1753
17170,26597,6556,12847,5470,20040,3445,1691,1754
17175,26603,6558,12849,5472,20045,3447,1691,1756
17180,26614,6561,12854,5475,20052,3448,1692,1756
17185,26618,6563,12857,5477,20054,3448,1692,1756
17190,26628,6568,12863,5480,20059,3449,1692,1757
17195,26634,6569,12864,5481,20065,3451,1693,1758
17200,26645,6572,12870,5484,20072,3452,1694,1758
17205,26649,6574,12872,5486,20075,3452,1694,1758
17210,26659,6577,12876,5488,20082,3453,1694,1759
17215,26665,6578,12879,5489,20086,3455,1695,1760
17220,26676,6583,12885,5493,20091,3456,1695,1761
17225,26680,6586,12888,5496,20093,3456,1695,1761
17230,26690,6589,12892,5498,20100,3457,1696,1761
17235,26696,6591,12894,5500,20105,3459,1697,1762
17240,26707,6596,12900,5505,20111,3460,1697,1763
17245,26711,6596,12901,5505,20114,3460,1697,1763
17250,26721,6599,12907,5508,20121,3461,1697,1764
17255,26727,6600,12909,5509,20126,3463,1697,1766
17260,26738,6605,12915,5514,20132,3464,1698,1766
17265,26742,6607,12918,5516,20134,3464,1698,1766
17270,26752,6611,12923,5518,20140,3465,1698,1767
17275,26758,6613,12925,5520,20144,3467,1698,1769
17280,26769,6619,12934,5526,20146,3468,1698,1770
17285,26773,6623,12937,5530,20149,3468,1698,1770
17290,26783,6624,12942,5530,20158,3469,1699,1770
17295,26789,6624,12944,5530,20164,3471,1700,1771
17300,26800,6625,12952,5531,20173,3472,1701,1771
17305,26804,6626,12954,5532,20178,3472,1701,1771
17310,26814,6627,12960,5533,20186,3473,1701,1772
17315,26820,6627,12960,5533,20193,3475,1701,1774
17320,26831,6628,12967,5534,20202,3476,1702,1774
17325,26835,6629,12970,5535,20205,3476,1702,1774
17330,26845,6630,12979,5536,20214,3477,1703,1774
17335,26851,6631,12984,5537,20219,3479,1705,1774
17340,26862,6632,12991,5538,20229,3480,1706,1774
17345,26866,6632,12993,5538,20233,3480,1706,1774
17350,26876,6633,12997,5539,20243,3481,1706,1775
17355,26882,6633,12999,5539,20248,3483,1706,1777
17360,26893,6633,13002,5539,20260,3484,1707,1777
17365,26897,6633,13003,5539,20263,3484,1707,1777
17370,26907,6634,13009,5539,20272,3485,1708,1777
17375,26913,6634,13012,5539,20279,3487,1709,1778
17380,26924,6634,13017,5539,20288,3488,1709,1779
17385,26928,6634,13018,5539,20294,3488,1709,1779
17390,26938,6637,13024,5542,20301,3489,1709,1780
17395,26944,6637,13026,5542,20307,3491,1710,1781
17400,26955,6640,13034,5544,20311,3492,1711,1781
17405,26959,6644,13036,5548,20315,3492,1711,1781
17410,26969,6647,13041,5550,20321,3493,1711,1782
17415,26975,6649,13043,5552,20326,3495,1711,1784
17420,26986,6652,13049,5555,20332,3496,1711,1785
17425,26990,6655,13051,5558,20335,3496,1711,1785
17430,27000,6657,13056,5559,20342,3497,1712,1785
17435,27006,6658,13060,5560,20347,3499,1714,1785
17440,27017,6663,13065,5564,20352,3500,1714,1786
17445,27021,6665,13068,5566,20355,3500,1714,1786
17450,27031,6668,13071,5568,20362,3501,1714,1787
17455,27037,6670,13076,5570,20367,3503,1716,1787
17460,27048,6673,13084,5573,20371,3504,1717,1787
17465,27052,6677,13085,5577,20375,3504,1717,1787
17470,27062,6680,13093,5579,20381,3505,1718,1787
17475,27068,6682,13096,5581,20385,3507,1719,1788
17480,27079,6688,13103,5586,20389,3508,1720,1788
17485,27083,6691,13104,5589,20392,3508,1720,1788
17490,27093,6696,13108,5592,20397,3509,1721,1788
17495,27099,6697,13113,5593,20400,3511,1723,1788
17500,27110,6702,13120,5597,20404,3512,1724,1788
17505,27114,6708,13123,5603,20405,3512,1724,1788
17510,27124,6712,13128,5606,20411,3513,1725,1788
17515,27130,6713,13131,5607,20416,3515,1726,1789
17520,27141,6714,13138,5608,20425,3516,1727,1789
17525,27145,6715,13139,5609,20429,3516,1727,1789
17530,27155,6715,13144,5609,20440,3517,1728,1789
17535,27161,6715,13146,5609,20446,3519,1729,1790
17540,27172,6715,13154,5609,20456,3520,1729,1791
17545,27176,6715,13157,5609,20461,3520,1729,1791
17550,27186,6715,13158,5609,20471,3521,1729,1792
17555,27192,6715,13160,5609,20476,3523,1730,1793
17560,27203,6715,13163,5609,20488,3524,1730,1794
17565,27207,6715,13167,5609,20491,3524,1730,1794
17570,27217,6715,13172,5609,20501,3525,1730,1795
17575,27223,6715,13173,5609,20507,3527,1730,1797
17580,27234,6715,13182,5609,20517,3528,1731,1797
17585,27238,6715,13184,5609,20523,3528,1731,1797
17590,27248,6715,13189,5609,20532,3529,1732,1797
17595,27254,6715,13192,5609,20539,3531,1732,1799
17600,27265,6715,13199,5609,20550,3532,1732,1800
17605,27269,6715,13201,5609,20554,3532,1732,1800
17610,27279,6716,13207,5610,20562,3533,1733,1800
17615,27285,6717,13212,5611,20568,3535,1735,1800
17620,27296,6718,13215,5612,20577,3536,1735,1801
17625,27300,6720,13218,5614,20580,3536,1735,1801
17630,27310,6723,13223,5616,20586,3537,1736,1801
17635,27316,6724,13225,5617,20591,3539,1737,1802
17640,27327,6728,13229,5621,20599,3540,1737,1803
17645,27331,6729,13231,5622,20602,3540,1737,1803
17650,27341,6732,13235,5624,20609,3541,1737,1804
17655,27347,6732,13237,5624,20615,3543,1738,1805
17660,27358,6735,13242,5626,20622,3544,1738,1806
17665,27362,6736,13244,5627,20626,3544,1738,1806
17670,27372,6739,13249,5629,20633,3545,1738,1807
17675,27378,6740,13254,5630,20637,3547,1739,1808
17680,27389,6743,13258,5633,20645,3548,1739,1809
17685,27393,6745,13259,5635,20648,3548,1739,1809
17690,27403,6750,13264,5640,20653,3549,1739,1810
17695,27409,6750,13267,5640,20657,3551,1740,1811
17700,27420,6754,13269,5644,20666,3552,1740,1812
17705,27424,6755,13270,5645,20669,3552,1740,1812
17710,27434,6759,13275,5648,20674,3553,1741,1812
17715,27440,6761,13279,5650,20677,3555,1742,1813
17720,27451,6765,13283,5653,20684,3556,1743,1813
17725,27455,6767,13284,5655,20687,3556,1743,1813
17730,27465,6772,13286,5658,20693,3557,1743,1814
17735,27471,6772,13290,5658,20697,3559,1745,1814
17740,27482,6777,13294,5662,20703,3560,1745,1815
17745,27486,6780,13295,5665,20706,3560,1745,1815
17750,27496,6784,13301,5668,20711,3561,1746,1815
17755,27502,6786,13304,5670,20715,3563,1747,1816
17760,27513,6788,13310,5671,20722,3564,1748,1816
17765,27517,6790,13313,5673,20726,3564,1748,1816
17770,27527,6791,13316,5673,20736,3565,1749,1816
17775,27533,6791,13318,5673,20742,3567,1750,1817
17780,27544,6793,13322,5674,20750,3568,1751,1817
17785,27548,6795,13324,5676,20753,3568,1751,1817
17790,27558,6797,13329,5677,20760,3569,1751,1818
17795,27564,6799,13332,5679,20765,3571,1751,1820
17800,27575,6800,13334,5680,20774,3572,1751,1821
17805,27579,6800,13335,5680,20779,3572,1751,1821
17810,27589,6802,13340,5681,20787,3573,1752,1821
17815,27595,6802,13342,5681,20793,3575,1753,1822
17820,27606,6804,13347,5683,20800,3576,1753,1823
17825,27610,6806,13347,5685,20804,3576,1753,1823
17830,27620,6807,13351,5686,20812,3577,1754,1823
17835,27626,6807,13353,5686,20819,3579,1756,1823
17840,27637,6808,13355,5687,20829,3580,1756,1824
17845,27641,6808,13356,5687,20833,3580,1756,1824
17850,27651,6809,13362,5688,20841,3581,1757,1824
17855,27657,6809,13365,5688,20848,3583,1758,1825
17860,27668,6812,13370,5690,20855,3584,1759,1825
17865,27672,6814,13374,5692,20858,3584,1759,1825
17870,27682,6817,13378,5694,20864,3585,1760,1825
17875,27688,6819,13384,5696,20868,3587,1762,1825
17880,27699,6821,13387,5697,20876,3588,1763,1825
17885,27703,6824,13388,5700,20879,3588,1763,1825
17890,27713,6828,13392,5703,20884,3589,1763,1826
17895,27719,6830,13394,5705,20889,3591,1764,1827
17900,27730,6833,13396,5707,20897,3592,1764,1828
17905,27734,6833,13399,5707,20899,3592,1764,1828
17910,27744,6838,13402,5711,20905,3593,1765,1828
17915,27750,6838,13406,5711,20909,3595,1766,1829
17920,27761,6841,13408,5714,20918,3596,1766,1830
17925,27765,6844,13411,5717,20919,3596,1766,1830
17930,27775,6851,13420,5723,20922,3597,1767,1830
17935,27781,6853,13425,5725,20926,3599,1769,1830
17940,27792,6857,13427,5729,20935,3600,1769,1831
17945,27796,6857,13430,5729,20938,3600,1769,1831
17950,27806,6858,13431,5729,20947,3601,1769,1832
17955,27812,6858,13434,5729,20953,3603,1770,1833
17960,27823,6859,13439,5730,20963,3604,1770,1834
17965,27827,6859,13440,5730,20968,3604,1770,1834
17970,27837,6860,13447,5731,20976,3605,1771,1834
17975,27843,6861,13449,5732,20982,3607,1772,1835
17980,27854,6861,13454,5732,20992,3608,1772,1836
17985,27858,6862,13456,5733,20995,3608,1772,1836
17990,27868,6863,13460,5734,21004,3609,1772,1837
17995,27874,6863,13462,5734,21010,3611,1773,1838
18000,27885,6864,13469,5735,21020,3612,1774,1838
18005,27889,6864,13471,5735,21025,3612,1774,1838
18010,27899,6867,13479,5737,21031,3613,1775,1838
18015,27905,6868,13481,5738,21037,3615,1776,1839
18020,27916,6871,13488,5740,21044,3616,1776,1840
18025,27920,6872,13490,5741,21048,3616,1776,1840
18030,27930,6874,13494,5742,21055,3617,1777,1840
18035,27936,6875,13498,5743,21061,3619,1778,1841
18040,27947,6877,13503,5745,21070,3620,1779,1841
18045,27951,6878,13505,5746,21073,3620,1779,1841
18050,27961,6882,13510,5750,21078,3621,1779,1842
18055,27967,6882,13513,5750,21085,3623,1781,1842
18060,27978,6884,13520,5752,21090,3624,1781,1843
18065,27982,6889,13521,5757,21093,3624,1781,1843
18070,27992,6891,13525,5758,21100,3625,1782,1843
18075,27998,6892,13526,5759,21106,3627,1782,1845
18080,28009,6896,13531,5762,21111,3628,1782,1846
18085,28013,6899,13532,5765,21114,3628,1782,1846
18090,28023,6902,13538,5767,21120,3629,1783,1846
18095,28029,6903,13540,5768,21126,3631,1784,1847
18100,28040,6906,13545,5771,21132,3632,1784,1848
18105,28044,6909,13549,5774,21133,3632,1784,1848
18110,28054,6917,13555,5781,21135,3633,1784,1849
18115,28060,6919,13557,5783,21141,3635,1785,1850
18120,28071,6921,13561,5785,21149,3636,1786,1850
18125,28075,6923,13562,5787,21152,3636,1786,1850
18130,28085,6926,13565,5790,21158,3637,1786,1851
18135,28091,6927,13568,5791,21163,3639,1787,1852
18140,28102,6930,13574,5794,21169,3640,1788,1852
18145,28106,6934,13576,5798,21171,3640,1788,1852
18150,28116,6938,13578,5800,21177,3641,1789,1852
18155,28122,6938,13579,5800,21184,3643,1790,1853
18160,28133,6939,13584,5801,21191,3644,1791,1853
18165,28137,6944,13586,5806,21193,3644,1791,1853
18170,28147,6949,13591,5810,21197,3645,1791,1854
18175,28153,6949,13594,5810,21202,3647,1792,1855
18180,28164,6952,13599,5813,21210,3648,1793,1855
18185,28168,6953,13600,5814,21214,3648,1793,1855
18190,28178,6956,13604,5816,21221,3649,1793,1856
18195,28184,6956,13606,5816,21227,3651,1793,1858
18200,28195,6957,13617,5817,21235,3652,1794,1858
18205,28199,6958,13619,5818,21241,3652,1794,1858
18210,28209,6959,13624,5818,21249,3653,1795,1858
18215,28215,6959,13625,5818,21255,3655,1795,1860
18220,28226,6959,13628,5818,21267,3656,1795,1861
18225,28230,6959,13630,5818,21270,3656,1795,1861
18230,28240,6960,13636,5819,21279,3657,1795,1862
18235,28246,6960,13641,5819,21284,3659,1797,1862
18240,28257,6960,13645,5819,21296,3660,1797,1863
18245,28261,6960,13645,5819,21301,3660,1797,1863
18250,28271,6961,13649,5819,21309,3661,1797,1864
18255,28277,6962,13653,5820,21315,3663,1798,1865
18260,28288,6962,13660,5820,21324,3664,1799,1865
18265,28292,6963,13661,5821,21329,3664,1799,1865
18270,28302,6964,13668,5822,21337,3665,1800,1865
18275,28308,6965,13671,5823,21343,3667,1801,1866
18280,28319,6967,13674,5824,21352,3668,1802,1866
18285,28323,6968,13676,5825,21355,3668,1802,1866
18290,28333,6970,13679,5827,21362,3669,1802,1867
18295,28339,6971,13679,5828,21368,3671,1802,1869
18300,28350,6973,13683,5829,21376,3672,1803,1869
18305,28354,6973,13684,5829,21381,3672,1803,1869
18310,28364,6975,13688,5830,21388,3673,1803,1870
18315,28370,6976,13690,5831,21394,3675,1803,1872
18320,28381,6980,13696,5834,21400,3676,1804,1872
18325,28385,6980,13697,5834,21405,3676,1804,1872
18330,28395,6982,13700,5835,21412,3677,1804,1873
18335,28401,6983,13703,5836,21417,3679,1804,1875
18340,28412,6987,13708,5839,21423,3680,1805,1875
18345,28416,6990,13710,5842,21425,3680,1805,1875
18350,28426,6993,13714,5845,21432,3681,1805,1876
18355,28432,6995,13717,5847,21437,3683,1806,1877
18360,28443,6998,13723,5849,21441,3684,1806,1878
18365,28447,7003,13725,5854,21443,3684,1806,1878
18370,28457,7006,13731,5857,21450,3685,1807,1878
18375,28463,7008,13734,5859,21455,3687,1808,1879
18380,28474,7011,13740,5861,21460,3688,1809,1879
18385,28478,7013,13742,5863,21464,3688,1809,1879
18390,28488,7016,13745,5865,21471,3689,1809,1880
18395,28494,7017,13748,5866,21476,3691,1810,1881
18400,28505,7022,13754,5871,21481,3692,1810,1882
18405,28509,7024,13756,5873,21484,3692,1810,1882
18410,28519,7029,13763,5878,21489,3693,1811,1882
18415,28525,7029,13766,5878,21495,3695,1813,1882
18420,28536,7035,13773,5884,21499,3696,1813,1883
18425,28540,7039,13776,5888,21500,3696,1813,1883
18430,28550,7043,13779,5891,21505,3697,1813,1884
18435,28556,7044,13783,5892,21510,3699,1814,1885
18440,28567,7046,13787,5893,21519,3700,1814,1886
18445,28571,7047,13788,5894,21523,3700,1814,1886
18450,28581,7048,13791,5895,21532,3701,1814,1887
18455,28587,7048,13793,5895,21538,3703,1815,1888
18460,28598,7049,13798,5896,21547,3704,1815,1889
18465,28602,7050,13801,5897,21551,3704,1815,1889
18470,28612,7052,13807,5898,21559,3705,1816,1889
18475,28618,7053,13811,5899,21564,3707,1818,1889
18480,28629,7055,13816,5901,21574,3708,1818,1890
18485,28633,7055,13817,5901,21578,3708,1818,1890
18490,28643,7057,13820,5902,21586,3709,1818,1891
18495,28649,7058,13823,5903,21591,3711,1818,1893
18500,28660,7059,13825,5903,21600,3712,1818,1894
18505,28664,7060,13827,5904,21604,3712,1818,1894
18510,28674,7062,13831,5905,21612,3713,1818,1895
18515,28680,7063,13835,5906,21616,3715,1818,1897
18520,28691,7064,13840,5907,21625,3716,1819,1897
18525,28695,7067,13842,5910,21628,3716,1819,1897
18530,28705,7068,13847,5911,21637,3717,1820,1897
18535,28711,7069,13851,5912,21642,3719,1821,1898
18540,28722,7070,13857,5913,21650,3720,1822,1898
18545,28726,7070,13861,5913,21656,3720,1822,1898
18550,28736,7072,13867,5915,21663,3721,1822,1899
18555,28742,7073,13870,5916,21669,3723,1823,1900
18560,28753,7074,13874,5917,21679,3724,1824,1900
18565,28757,7074,13877,5917,21683,3724,1824,1900
18570,28767,7076,13882,5917,21690,3725,1824,1901
18575,28773,7077,13885,5918,21696,3727,1825,1902
18580,28784,7079,13890,5920,21704,3728,1825,1903
18585,28788,7081,13893,5922,21707,3728,1825,1903
18590,28798,7083,13899,5924,21715,3729,1826,1903
18595,28804,7083,13902,5924,21721,3731,1828,1903
18600,28815,7083,13906,5924,21731,3732,1829,1903
18605,28819,7084,13907,5925,21735,3732,1829,1903
18610,28829,7086,13913,5926,21742,3733,1830,1903
18615,28835,7087,13915,5927,21748,3735,1831,1904
18620,28846,7087,13918,5927,21758,3736,1831,1905
18625,28850,7088,13920,5928,21761,3736,1831,1905
18630,28860,7091,13923,5931,21769,3737,1831,1906
18635,28866,7092,13928,5932,21773,3739,1833,1906
18640,28877,7097,13935,5936,21776,3740,1833,1907
18645,28881,7101,13935,5940,21780,3740,1833,1907
18650,28891,7106,13939,5943,21784,3741,1833,1908
18655,28897,7107,13940,5944,21789,3743,1833,1910
18660,28908,7110,13945,5946,21794,3744,1833,1911
18665,28912,7115,13947,5951,21796,3744,1833,1911
18670,28922,7120,13951,5955,21801,3745,1833,1912
18675,28928,7121,13954,5956,21805,3747,1834,1913
18680,28939,7127,13960,5961,21810,3748,1835,1913
18685,28943,7129,13961,5963,21813,3748,1835,1913
18690,28953,7135,13968,5969,21816,3749,1835,1914
18695,28959,7137,13971,5971,21820,3751,1836,1915
18700,28970,7140,13976,5974,21829,3752,1837,1915
18705,28974,7141,13977,5975,21833,3752,1837,1915
18710,28984,7143,13979,5976,21841,3753,1838,1915
18715,28990,7143,13983,5976,21845,3755,1839,1916
18720,29001,7144,13986,5977,21856,3756,1839,1917
18725,29005,7145,13987,5978,21859,3756,1839,1917
18730,29015,7147,13990,5979,21868,3757,1839,1918
18735,29021,7147,13992,5979,21873,3759,1839,1920
18740,29032,7149,13995,5980,21882,3760,1840,1920
18745,29036,7149,13995,5980,21887,3760,1840,1920
18750,29046,7150,13998,5980,21895,3761,1841,1920
18755,29052,7152,14003,5982,21899,3763,1842,1921
18760,29063,7154,14010,5984,21907,3764,1843,1921
18765,29067,7156,14012,5986,21911,3764,1843,1921
18770,29077,7158,14017,5987,21918,3765,1843,1922
18775,29083,7160,14019,5989,21922,3767,1843,1924
18780,29094,7162,14024,5991,21931,3768,1843,1925
18785,29098,7162,14024,5991,21936,3768,1843,1925
18790,29108,7163,14030,5991,21944,3769,1844,1925
18795,29114,7164,14035,5992,21950,3771,1846,1925
18800,29125,7166,14041,5994,21956,3772,1846,1926
18805,29129,7170,14044,5998,21959,3772,1846,1926
18810,29139,7173,14048,6000,21966,3773,1846,1927
18815,29145,7173,14051,6000,21971,3775,1847,1928
18820,29156,7176,14054,6002,21980,3776,1848,1928
18825,29160,7177,14057,6003,21983,3776,1848,1928
18830,29170,7179,14062,6004,21991,3777,1848,1929
18835,29176,7180,14067,6005,21995,3779,1850,1929
18840,29187,7184,14072,6008,22000,3780,1850,1930
18845,29191,7187,14073,6011,22004,3780,1850,1930
18850,29201,7191,14080,6015,22009,3781,1850,1931
18855,29207,7192,14081,6016,22014,3783,1850,1933
18860,29218,7196,14091,6020,22019,3784,1851,1933
18865,29222,7198,14093,6022,22024,3784,1851,1933
18870,29232,7200,14100,6023,22031,3785,1852,1933
18875,29238,7201,14103,6024,22037,3787,1853,1934
18880,29249,7204,14108,6027,22045,3788,1854,1934
18885,29253,7205,14111,6028,22047,3788,1854,1934
18890,29263,7210,14115,6031,22052,3789,1854,1935
18895,29269,7211,14118,6032,22057,3791,1856,1935
18900,29280,7215,14125,6036,22065,3792,1857,1935
18905,29284,7216,14128,6037,22066,3792,1857,1935
18910,29294,7220,14131,6040,22074,3793,1857,1936
18915,29300,7220,14135,6040,22078,3795,1859,1936
18920,29311,7222,14139,6042,22087,3796,1859,1937
18925,29315,7223,14140,6043,22092,3796,1859,1937
18930,29325,7224,14145,6044,22100,3797,1859,1938
18935,29331,7225,14148,6045,22106,3799,1860,1939
18940,29342,7225,14152,6045,22115,3800,1860,1940
18945,29346,7225,14154,6045,22120,3800,1860,1940
18950,29356,7226,14157,6045,22129,3801,1860,1941
18955,29362,7226,14159,6045,22135,3803,1861,1942
18960,29373,7227,14167,6046,22143,3804,1862,1942
18965,29377,7229,14167,6048,22148,3804,1862,1942
18970,29387,7230,14171,6049,22157,3805,1862,1943
18975,29393,7230,14174,6049,22161,3807,1863,1944
18980,29404,7231,14179,6049,22171,3808,1864,1944
18985,29408,7232,14180,6050,22175,3808,1864,1944
18990,29418,7233,14184,6051,22184,3809,1864,1945
18995,29424,7234,14187,6052,22190,3811,1865,1946
19000,29435,7237,14194,6054,22196,3812,1865,1947
19005,29439,7239,14197,6056,22200,3812,1865,1947
19010,29449,7240,14202,6057,22208,3813,1865,1948
19015,29455,7242,14206,6059,22213,3815,1866,1949
19020,29466,7245,14213,6061,22219,3816,1866,1950
19025,29470,7247,14214,6063,22223,3816,1866,1950
19030,29480,7250,14219,6064,22229,3817,1867,1950
19035,29486,7251,14222,6065,22234,3819,1868,1951
19040,29497,7255,14227,6068,22239,3820,1868,1952
19045,29501,7259,14229,6072,22242,3820,1868,1952
19050,29511,7262,14236,6075,22249,3821,1869,1952
19055,29517,7262,14238,6075,22255,3823,1869,1954
19060,29528,7266,14248,6079,22259,3824,1870,1954
19065,29532,7270,14251,6083,22262,3824,1870,1954
19070,29542,7273,14257,6085,22269,3825,1871,1954
19075,29548,7273,14257,6085,22275,3827,1871,1956
19080,29559,7276,14265,6088,22280,3828,1872,1956
19085,29563,7279,14266,6091,22283,3828,1872,1956
19090,29573,7281,14270,6092,22291,3829,1872,1957
19095,29579,7281,14273,6092,22298,3831,1873,1958
19100,29590,7281,14277,6092,22309,3832,1874,1958
19105,29594,7281,14279,6092,22312,3832,1874,1958
19110,29604,7283,14284,6094,22320,3833,1874,1959
19115,29610,7283,14288,6094,22326,3835,1875,1960
19120,29621,7284,14292,6095,22336,3836,1876,1960
19125,29625,7285,14293,6096,22340,3836,1876,1960
19130,29635,7289,14299,6099,22346,3837,1877,1960
19135,29641,7289,14303,6099,22350,3839,1879,1960
19140,29652,7293,14309,6103,22358,3840,1880,1960
19145,29656,7295,14313,6105,22359,3840,1880,1960
19150,29666,7301,14320,6110,22364,3841,1881,1960
19155,29672,7301,14324,6110,22369,3843,1883,1960
19160,29683,7304,14330,6113,22377,3844,1884,1960
19165,29687,7304,14330,6113,22383,3844,1884,1960
19170,29697,7304,14336,6113,22392,3845,1884,1961
19175,29703,7304,14339,6113,22398,3847,1885,1962
19180,29714,7304,14343,6113,22409,3848,1885,1963
19185,29718,7304,14345,6113,22414,3848,1885,1963
19190,29728,7305,14350,6114,22423,3849,1886,1963
19195,29734,7305,14352,6114,22428,3851,1886,1965
19200,29745,7308,14359,6117,22436,3852,1887,1965
19205,29749,7309,14359,6118,22440,3852,1887,1965
19210,29759,7312,14367,6121,22446,3853,1888,1965
19215,29765,7313,14370,6122,22451,3855,1889,1966
19220,29776,7315,14376,6123,22458,3856,1889,1967
19225,29780,7319,14380,6127,22460,3856,1889,1967
19230,29790,7320,14386,6128,22470,3857,1890,1967
19235,29796,7320,14389,6128,22475,3859,1891,1968
19240,29807,7323,14396,6131,22482,3860,1891,1969
19245,29811,7325,14396,6133,22486,3860,1891,1969
19250,29821,7327,14401,6135,22494,3861,1892,1969
19255,29827,7328,14404,6136,22499,3863,1892,1971
19260,29838,7330,14411,6138,22504,3864,1892,1972
19265,29842,7334,14415,6142,22508,3864,1892,1972
19270,29852,7336,14419,6142,22516,3865,1893,1972
19275,29858,7337,14421,6143,22521,3867,1894,1973
19280,29869,7341,14426,6146,22526,3868,1894,1974
19285,29873,7343,14428,6148,22530,3868,1894,1974
19290,29883,7345,14430,6148,22538,3869,1894,1975
19295,29889,7346,14434,6149,22542,3871,1894,1977
19300,29900,7351,14440,6153,22547,3872,1895,1977
19305,29904,7354,14441,6156,22550,3872,1895,1977
19310,29914,7357,14447,6159,22557,3873,1896,1977
19315,29920,7358,14451,6160,22561,3875,1897,1978
19320,29931,7363,14456,6164,22567,3876,1898,1978
19325,29935,7365,14457,6166,22570,3876,1898,1978
19330,29945,7367,14461,6167,22578,3877,1898,1979
19335,29951,7367,14464,6167,22583,3879,1899,1980
19340,29962,7370,14472,6170,22589,3880,1899,1981
19345,29966,7372,14474,6172,22594,3880,1899,1981
19350,29976,7374,14478,6173,22601,3881,1899,1982
19355,29982,7375,14482,6174,22606,3883,1901,1982
19360,29993,7378,14487,6177,22614,3884,1901,1983
19365,29997,7380,14490,6179,22616,3884,1901,1983
19370,30007,7385,14496,6182,22621,3885,1902,1983
19375,30013,7386,14500,6183,22625,3887,1903,1984
19380,30024,7388,14506,6185,22633,3888,1904,1984
19385,30028,7391,14508,6188,22637,3888,1904,1984
19390,30038,7394,14515,6190,22644,3889,1905,1984
19395,30044,7394,14516,6190,22650,3891,1906,1985
19400,30055,7395,14518,6191,22660,3892,1906,1986
19405,30059,7395,14521,6191,22663,3892,1906,1986
19410,30069,7396,14527,6191,22672,3893,1906,1987
19415,30075,7396,14529,6191,22678,3895,1907,1988
19420,30086,7396,14533,6191,22688,3896,1907,1989
19425,30090,7396,14534,6191,22693,3896,1907,1989
19430,30100,7397,14541,6192,22702,3897,1907,1990
19435,30106,7399,14545,6194,22706,3899,1909,1990
19440,30117,7402,14552,6196,22713,3900,1910,1990
19445,30121,7403,14552,6197,22718,3900,1910,1990
19450,30131,7405,14555,6198,22726,3901,1911,1990
19455,30137,7405,14558,6198,22732,3903,1913,1990
19460,30148,7406,14563,6198,22740,3904,1914,1990
19465,30152,7407,14565,6199,22744,3904,1914,1990
19470,30162,7409,14567,6200,22753,3905,1914,1991
19475,30168,7409,14569,6200,22759,3907,1914,1993
19480,30179,7411,14574,6201,22766,3908,1915,1993
19485,30183,7414,14577,6204,22769,3908,1915,1993
19490,30193,7416,14582,6205,22777,3909,1915,1994
19495,30199,7417,14586,6206,22780,3911,1916,1995
19500,30210,7420,14591,6208,22788,3912,1917,1995
19505,30214,7422,14592,6210,22792,3912,1917,1995
19510,30224,7425,14595,6211,22798,3913,1918,1995
19515,30230,7426,14597,6212,22803,3915,1918,1997
19520,30241,7429,14604,6215,22809,3916,1919,1997
19525,30245,7432,14605,6218,22813,3916,1919,1997
19530,30255,7435,14611,6220,22819,3917,1919,1998
19535,30261,7437,14614,6222,22823,3919,1920,1999
19540,30272,7440,14617,6225,22831,3920,1920,2000
19545,30276,7441,14620,6226,22835,3920,1920,2000
19550,30286,7443,14624,6227,22842,3921,1921,2000
19555,30292,7444,14627,6228,22847,3923,1922,2001
19560,30303,7448,14631,6232,22854,3924,1922,2002
19565,30307,7449,14632,6233,22857,3924,1922,2002
19570,30317,7453,14637,6236,22864,3925,1922,2003
19575,30323,7454,14640,6237,22869,3927,1923,2004
19580,30334,7456,14647,6239,22875,3928,1923,2005
19585,30338,7458,14650,6241,22879,3928,1923,2005
19590,30348,7461,14652,6242,22887,3929,1923,2006
19595,30354,7461,14655,6242,22893,3931,1924,2007
19600,30365,7462,14662,6243,22901,3932,1925,2007
19605,30369,7463,14662,6244,22906,3932,1925,2007
19610,30379,7465,14667,6246,22914,3933,1926,2007
19615,30385,7466,14670,6247,22918,3935,1926,2009
19620,30396,7468,14676,6249,22927,3936,1927,2009
19625,30400,7469,14677,6250,22931,3936,1927,2009
19630,30410,7471,14683,6250,22938,3937,1928,2009
19635,30416,7471,14686,6250,22944,3939,1929,2010
19640,30427,7473,14693,6252,22952,3940,1930,2010
19645,30431,7475,14695,6254,22955,3940,1930,2010
19650,30441,7479,14700,6257,22962,3941,1931,2010
19655,30447,7479,14702,6257,22967,3943,1931,2012
19660,30458,7481,14707,6259,22976,3944,1931,2013
19665,30462,7481,14707,6259,22981,3944,1931,2013
19670,30472,7484,14711,6261,22987,3945,1931,2014
19675,30478,7486,14714,6263,22991,3947,1931,2016
19680,30489,7490,14720,6267,22996,3948,1931,2017
19685,30493,7494,14722,6271,22998,3948,1931,2017
19690,30503,7499,14727,6274,23004,3949,1932,2017
19695,30509,7499,14730,6274,23008,3951,1933,2018
19700,30520,7502,14733,6276,23017,3952,1933,2019
19705,30524,7504,14736,6278,23020,3952,1933,2019
19710,30534,7506,14742,6280,23028,3953,1933,2020
19715,30540,7506,14744,6280,23034,3955,1935,2020
19720,30551,7508,14748,6281,23042,3956,1935,2021
19725,30555,7508,14750,6281,23046,3956,1935,2021
19730,30565,7509,14755,6282,23056,3957,1935,2022
19735,30571,7510,14760,6283,23059,3959,1936,2023
19740,30582,7513,14768,6286,23065,3960,1936,2024
19745,30586,7517,14772,6290,23068,3960,1936,2024
19750,30596,7520,14779,6293,23075,3961,1936,2025
19755,30602,7522,14783,6295,23079,3963,1937,2026
19760,30613,7524,14789,6297,23088,3964,1937,2027
19765,30617,7524,14791,6297,23092,3964,1937,2027
19770,30627,7526,14796,6298,23100,3965,1938,2027
19775,30633,7528,14799,6300,23104,3967,1938,2029
19780,30644,7531,14805,6303,23111,3968,1938,2030
19785,30648,7533,14807,6305,23114,3968,1938,2030
19790,30658,7536,14812,6307,23122,3969,1939,2030
19795,30664,7536,14816,6307,23127,3971,1940,2031
19800,30675,7538,14823,6309,23134,3972,1941,2031
19805,30679,7539,14826,6310,23139,3972,1941,2031
19810,30689,7541,14831,6310,23148,3973,1942,2031
19815,30695,7542,14835,6311,23153,3975,1943,2032
19820,30706,7543,14840,6312,23161,3976,1944,2032
19825,30710,7544,14842,6313,23166,3976,1944,2032
19830,30720,7546,14843,6313,23174,3977,1944,2033
19835,30726,7547,14845,6314,23179,3979,1945,2034
19840,30737,7548,14850,6315,23187,3980,1946,2034
19845,30741,7549,14851,6316,23192,3980,1946,2034
19850,30751,7550,14853,6316,23201,3981,1946,2035
19855,30757,7550,14856,6316,23207,3983,1947,2036
19860,30768,7551,14866,6317,23214,3984,1948,2036
19865,30772,7552,14868,6318,23220,3984,1948,2036
19870,30782,7553,14871,6318,23229,3985,1948,2037
19875,30788,7553,14876,6318,23234,3987,1950,2037
19880,30799,7556,14882,6321,23243,3988,1950,2038
19885,30803,7557,14884,6322,23245,3988,1950,2038
19890,30813,7559,14889,6323,23254,3989,1950,2039
19895,30819,7559,14893,6323,23260,3991,1951,2040
19900,30830,7561,14898,6325,23268,3992,1951,2041
19905,30834,7561,14899,6325,23273,3992,1951,2041
19910,30844,7563,14904,6327,23280,3993,1951,2042
19915,30850,7564,14907,6328,23286,3995,1953,2042
19920,30861,7567,14911,6330,23292,3996,1953,2043
19925,30865,7571,14914,6334,23293,3996,1953,2043
19930,30875,7575,14918,6337,23300,3997,1954,2043
19935,30881,7575,14920,6337,23304,3999,1954,2045
19940,30892,7580,14924,6342,23311,4000,1954,2046
19945,30896,7582,14927,6344,23312,4000,1954,2046
19950,30906,7589,14932,6350,23317,4001,1955,2046
19955,30912,7589,14934,6350,23322,4003,1956,2047
19960,30923,7594,14942,6355,23326,4004,1957,2047
19965,30927,7597,14943,6358,23329,4004,1957,2047
19970,30937,7601,14950,6361,23335,4005,1957,2048
19975,30943,7602,14953,6362,23340,4007,1958,2049
19980,30954,7603,14956,6363,23350,4008,1958,2050
19985,30958,7604,14959,6364,23353,4008,1958,2050
19990,30968,7606,14962,6365,23362,4009,1958,2051
19995,30974,7607,14966,6366,23366,4011,1959,2052
20000,30985,7609,14971,6367,23375,4012,1960,2052
20005,30989,7611,14975,6369,23377,4012,1960,2052
20010,30999,7614,14982,6371,23384,4013,1960,2053
20015,31005,7615,14985,6372,23390,4015,1962,2053
20020,31016,7618,14993,6375,23396,4016,1962,2054
20025,31020,7620,14996,6377,23400,4016,1962,2054
20030,31030,7623,15000,6379,23407,4017,1962,2055
20035,31036,7623,15002,6379,23413,4019,1963,2056
20040,31047,7623,15007,6379,23423,4020,1964,2056
20045,31051,7624,15008,6380,23426,4020,1964,2056
20050,31061,7625,15013,6381,23435,4021,1965,2056
20055,31067,7626,15017,6382,23441,4023,1966,2057
20060,31078,7627,15020,6383,23451,4024,1966,2058
20065,31082,7627,15023,6383,23455,4024,1966,2058
20070,31092,7628,15027,6384,23463,4025,1966,2059
20075,31098,7628,15029,6384,23470,4027,1967,2060
20080,31109,7629,15034,6385,23480,4028,1968,2060
20085,31113,7629,15037,6385,23484,4028,1968,2060
20090,31123,7631,15040,6385,23491,4029,1969,2060
20095,31129,7631,15044,6385,23498,4031,1971,2060
20100,31140,7632,15048,6386,23508,4032,1971,2061
20105,31144,7633,15049,6387,23511,4032,1971,2061
20110,31154,7635,15054,6388,23518,4033,1971,2062
20115,31160,7635,15058,6388,23525,4035,1973,2062
20120,31171,7635,15060,6388,23535,4036,1973,2063
20125,31175,7636,15060,6389,23539,4036,1973,2063
20130,31185,7638,15064,6389,23546,4037,1974,2063
20135,31191,7638,15065,6389,23553,4039,1974,2065
20140,31202,7642,15071,6393,23559,4040,1974,2066
20145,31206,7643,15072,6394,23563,4040,1974,2066
20150,31216,7645,15073,6394,23570,4041,1974,2067
20155,31222,7645,15074,6394,23577,4043,1975,2068
20160,31233,7647,15079,6395,23583,4044,1976,2068
20165,31237,7650,15080,6398,23586,4044,1976,2068
20170,31247,7657,15087,6404,23589,4045,1977,2068
20175,31253,7658,15091,6405,23593,4047,1979,2068
20180,31264,7662,15098,6409,23598,4048,1980,2068
20185,31268,7667,15100,6414,23600,4048,1980,2068
20190,31278,7673,15106,6419,23603,4049,1980,2069
20195,31284,7675,15109,6421,23607,4051,1981,2070
20200,31295,7680,15117,6426,23611,4052,1982,2070
20205,31299,7685,15118,6431,23614,4052,1982,2070
20210,31309,7689,15123,6434,23619,4053,1983,2070
20215,31315,7690,15125,6435,23624,4055,1984,2071
20220,31326,7693,15131,6438,23630,4056,1985,2071
20225,31330,7696,15132,6441,23634,4056,1985,2071
20230,31340,7698,15138,6443,23641,4057,1986,2071
20235,31346,7699,15139,6444,23647,4059,1987,2072
20240,31357,7701,15145,6445,23654,4060,1987,2073
20245,31361,7703,15148,6447,23657,4060,1987,2073
20250,31371,7704,15152,6447,23666,4061,1987,2074
20255,31377,7705,15155,6448,23671,4063,1987,2076
20260,31388,7705,15157,6448,23683,4064,1987,2077
20265,31392,7705,15159,6448,23686,4064,1987,2077
20270,31402,7706,15166,6449,23695,4065,1987,2078
20275,31408,7707,15170,6450,23701,4067,1988,2079
20280,31419,7707,15173,6450,23710,4068,1988,2080
20285,31423,7708,15173,6451,23715,4068,1988,2080
20290,31433,7709,15177,6451,23723,4069,1988,2081
20295,31439,7710,15180,6452,23729,4071,1989,2082
20300,31450,7711,15186,6453,23738,4072,1989,2083
20305,31454,7711,15187,6453,23743,4072,1989,2083
20310,31464,7712,15193,6454,23751,4073,1990,2083
20315,31470,7713,15199,6455,23757,4075,1992,2083
20320,31481,7714,15206,6456,23766,4076,1993,2083
20325,31485,7715,15206,6457,23770,4076,1993,2083
20330,31495,7717,15210,6457,23777,4077,1993,2084
20335,31501,7718,15214,6458,23782,4079,1993,2086
20340,31512,7720,15218,6460,23790,4080,1993,2087
20345,31516,7721,15220,6461,23795,4080,1993,2087
20350,31526,7724,15225,6463,23801,4081,1993,2088
20355,31532,7724,15227,6463,23807,4083,1994,2089
20360,31543,7728,15232,6467,23813,4084,1994,2090
20365,31547,7729,15233,6468,23818,4084,1994,2090
20370,31557,7732,15238,6470,23824,4085,1995,2090
20375,31563,7732,15240,6470,23830,4087,1995,2092
20380,31574,7737,15244,6474,23836,4088,1995,2093
20385,31578,7739,15245,6476,23839,4088,1995,2093
20390,31588,7743,15250,6480,23844,4089,1995,2094
20395,31594,7745,15253,6482,23847,4091,1995,2096
20400,31605,7752,15262,6489,23850,4092,1996,2096
20405,31609,7756,15265,6493,23851,4092,1996,2096
20410,31619,7762,15269,6498,23856,4093,1997,2096
20415,31625,7762,15271,6498,23861,4095,1997,2098
20420,31636,7767,15274,6502,23868,4096,1997,2099
20425,31640,7768,15275,6503,23871,4096,1997,2099
20430,31650,7773,15279,6508,23876,4097,1997,2100
20435,31656,7773,15281,6508,23881,4099,1997,2102
20440,31667,7778,15287,6512,23888,4100,1997,2103
20445,31671,7780,15289,6514,23891,4100,1997,2103
20450,31681,7783,15295,6517,23897,4101,1998,2103
20455,31687,7783,15296,6517,23904,4103,1999,2104
20460,31698,7784,15300,6517,23913,4104,2000,2104
20465,31702,7786,15302,6519,23915,4104,2000,2104
20470,31712,7787,15308,6520,23924,4105,2001,2104
20475,31718,7788,15312,6521,23928,4107,2002,2105
20480,31729,7789,15320,6522,23939,4108,2002,2106
20485,31733,7790,15323,6523,23942,4108,2002,2106
20490,31743,7791,15328,6524,23951,4109,2002,2107
20495,31749,7791,15332,6524,23957,4111,2004,2107
20500,31760,7791,15336,6524,23968,4112,2004,2108
20505,31764,7791,15337,6524,23973,4112,2004,2108
20510,31774,7792,15344,6524,23981,4113,2004,2109
20515,31780,7793,15348,6525,23986,4115,2006,2109
20520,31791,7793,15351,6525,23998,4116,2006,2110
20525,31795,7793,15352,6525,24002,4116,2006,2110
20530,31805,7794,15355,6525,24010,4117,2006,2111
20535,31811,7794,15358,6525,24017,4119,2007,2112
20540,31822,7795,15363,6526,24026,4120,2008,2112
20545,31826,7795,15365,6526,24031,4120,2008,2112
20550,31836,7797,15371,6528,24038,4121,2008,2113
20555,31842,7798,15374,6529,24043,4123,2009,2114
20560,31853,7800,15380,6531,24051,4124,2009,2115
20565,31857,7801,15380,6532,24056,4124,2009,2115
20570,31867,7803,15382,6532,24063,4125,2009,2116
20575,31873,7804,15387,6533,24068,4127,2010,2117
20580,31884,7809,15391,6537,24074,4128,2010,2118
20585,31888,7810,15393,6538,24077,4128,2010,2118
20590,31898,7814,15399,6541,24083,4129,2010,2119
20595,31904,7815,15402,6542,24089,4131,2011,2120
20600,31915,7819,15409,6546,24095,4132,2012,2120
20605,31919,7820,15411,6547,24098,4132,2012,2120
20610,31929,7824,15416,6550,24104,4133,2013,2120
20615,31935,7825,15418,6551,24110,4135,2013,2122
20620,31946,7828,15424,6553,24115,4136,2013,2123
20625,31950,7833,15428,6558,24115,4136,2013,2123
20630,31960,7839,15433,6563,24120,4137,2014,2123
20635,31966,7840,15434,6564,24125,4139,2014,2125
20640,31977,7845,15442,6568,24128,4140,2015,2125
20645,31981,7851,15444,6574,24130,4140,2015,2125
20650,31991,7854,15448,6576,24136,4141,2016,2125
20655,31997,7856,15452,6578,24139,4143,2017,2126
20660,32008,7857,15457,6578,24149,4144,2018,2126
20665,32012,7858,15458,6579,24154,4144,2018,2126
20670,32022,7860,15461,6580,24161,4145,2019,2126
20675,32028,7860,15465,6580,24166,4147,2020,2127
20680,32039,7862,15471,6581,24175,4148,2020,2128
20685,32043,7864,15472,6583,24179,4148,2020,2128
20690,32053,7865,15477,6583,24187,4149,2020,2129
20695,32059,7866,15481,6584,24192,4151,2022,2129
20700,32070,7869,15489,6586,24198,4152,2023,2129
20705,32074,7871,15491,6588,24203,4152,2023,2129
20710,32084,7872,15495,6588,24212,4153,2023,2130
20715,32090,7873,15500,6589,24217,4155,2025,2130
20720,32101,7873,15504,6589,24226,4156,2026,2130
20725,32105,7874,15506,6590,24230,4156,2026,2130
20730,32115,7875,15511,6590,24240,4157,2026,2131
20735,32121,7875,15512,6590,24246,4159,2026,2133
20740,32132,7875,15515,6590,24256,4160,2027,2133
20745,32136,7875,15517,6590,24261,4160,2027,2133
20750,32146,7877,15524,6592,24268,4161,2028,2133
20755,32152,7878,15529,6593,24273,4163,2030,2133
20760,32163,7879,15533,6594,24281,4164,2030,2134
20765,32167,7880,15533,6595,24287,4164,2030,2134
20770,32177,7882,15538,6595,24295,4165,2031,2134
20775,32183,7883,15541,6596,24300,4167,2032,2135
20780,32194,7884,15545,6597,24308,4168,2032,2136
20785,32198,7885,15547,6598,24313,4168,2032,2136
20790,32208,7887,15552,6598,24320,4169,2033,2136
20795,32214,7888,15555,6599,24326,4171,2034,2137
20800,32225,7889,15561,6600,24334,4172,2035,2137
20805,32229,7890,15561,6601,24339,4172,2035,2137
20810,32239,7893,15566,6603,24345,4173,2035,2138
20815,32245,7895,15570,6605,24349,4175,2036,2139
20820,32256,7901,15576,6610,24353,4176,2036,2140
20825,32260,7904,15579,6613,24355,4176,2036,2140
20830,32270,7909,15586,6617,24360,4177,2037,2140
20835,32276,7910,15588,6618,24364,4179,2037,2142
20840,32287,7917,15596,6625,24368,4180,2038,2142
20845,32291,7919,15597,6627,24371,4180,2038,2142
20850,32301,7924,15602,6631,24376,4181,2039,2142
20855,32307,7926,15604,6633,24381,4183,2040,2143
20860,32318,7928,15609,6635,24388,4184,2041,2143
20865,32322,7930,15609,6637,24392,4184,2041,2143
20870,32332,7935,15613,6640,24397,4185,2042,2143
20875,32338,7935,15615,6640,24402,4187,2043,2144
20880,32349,7939,15620,6644,24409,4188,2044,2144
20885,32353,7940,15623,6645,24412,4188,2044,2144
20890,32363,7941,15626,6645,24421,4189,2045,2144
20895,32369,7942,15628,6646,24425,4191,2045,2146
20900,32380,7944,15633,6648,24434,4192,2045,2147
20905,32384,7946,15634,6650,24438,4192,2045,2147
20910,32394,7949,15641,6653,24444,4193,2046,2147
20915,32400,7950,15644,6654,24449,4195,2047,2148
20920,32411,7951,15652,6655,24456,4196,2048,2148
20925,32415,7954,15654,6658,24460,4196,2048,2148
20930,32425,7957,15661,6661,24468,4197,2049,2148
20935,32431,7957,15664,6661,24473,4199,2050,2149
20940,32442,7959,15668,6662,24482,4200,2050,2150
20945,32446,7959,15671,6662,24486,4200,2050,2150
20950,32456,7960,15677,6663,24495,4201,2050,2151
20955,32462,7960,15680,6663,24502,4203,2050,2153
20960,32473,7960,15687,6663,24511,4204,2050,2154
20965,32477,7961,15690,6664,24516,4204,2050,2154
20970,32487,7962,15694,6664,24524,4205,2050,2155
20975,32493,7963,15698,6665,24530,4207,2051,2156
20980,32504,7964,15705,6666,24539,4208,2051,2157
20985,32508,7965,15708,6667,24543,4208,2051,2157
20990,32518,7967,15715,6668,24550,4209,2052,2157
20995,32524,7967,15718,6668,24557,4211,2053,2158
21000,32535,7969,15727,6670,24565,4212,2054,2158
21005,32539,7970,15728,6671,24569,4212,2054,2158
21010,32549,7972,15735,6672,24576,4213,2055,2158
21015,32555,7973,15740,6673,24581,4215,2056,2159
21020,32566,7975,15744,6675,24590,4216,2056,2160
21025,32570,7976,15745,6676,24593,4216,2056,2160
21030,32580,7979,15746,6677,24601,4217,2056,2161
21035,32586,7979,15747,6677,24607,4219,2056,2163
21040,32597,7980,15751,6678,24616,4220,2056,2164
21045,32601,7982,15753,6680,24619,4220,2056,2164
21050,32611,7985,15756,6681,24626,4221,2057,2164
21055,32617,7985,15760,6681,24631,4223,2058,2165
21060,32628,7989,15764,6684,24637,4224,2058,2166
21065,32632,7993,15766,6688,24639,4224,2058,2166
21070,32642,7995,15771,6689,24646,4225,2059,2166
21075,32648,7997,15773,6691,24651,4227,2060,2167
21080,32659,7998,15777,6692,24658,4228,2060,2168
21085,32663,8001,15779,6695,24661,4228,2060,2168
21090,32673,8005,15783,6699,24668,4229,2060,2169
21095,32679,8005,15786,6699,24674,4231,2062,2169
21100,32690,8006,15791,6700,24681,4232,2063,2169
21105,32694,8010,15792,6704,24684,4232,2063,2169
21110,32704,8012,15795,6705,24691,4233,2063,2170
21115,32710,8013,15796,6706,24697,4235,2064,2171
21120,32721,8015,15802,6708,24702,4236,2064,2172
21125,32725,8020,15805,6713,24703,4236,2064,2172
21130,32735,8027,15811,6719,24707,4237,2065,2172
21135,32741,8028,15812,6720,24713,4239,2066,2173
21140,32752,8031,15816,6722,24719,4240,2066,2174
21145,32756,8033,15817,6724,24722,4240,2066,2174
21150,32766,8039,15824,6729,24727,4241,2067,2174
21155,32772,8040,15827,6730,24731,4243,2068,2175
21160,32783,8043,15832,6732,24739,4244,2069,2175
21165,32787,8045,15835,6734,24741,4244,2069,2175
21170,32797,8047,15839,6735,24750,4245,2070,2175
21175,32803,8047,15844,6735,24754,4247,2072,2175
21180,32814,8048,15850,6736,24764,4248,2073,2175
21185,32818,8051,15852,6739,24767,4248,2073,2175
21190,32828,8053,15857,6741,24775,4249,2073,2176
21195,32834,8054,15862,6742,24779,4251,2075,2176
21200,32845,8056,15867,6744,24788,4252,2076,2176
21205,32849,8057,15869,6745,24791,4252,2076,2176
21210,32859,8058,15872,6745,24801,4253,2076,2177
21215,32865,8058,15876,6745,24806,4255,2078,2177
21220,32876,8059,15882,6746,24814,4256,2079,2177
21225,32880,8060,15884,6747,24819,4256,2079,2177
21230,32890,8061,15889,6748,24828,4257,2079,2178
21235,32896,8062,15892,6749,24834,4259,2081,2178
21240,32907,8062,15896,6749,24843,4260,2082,2178
21245,32911,8063,15897,6750,24848,4260,2082,2178
21250,32921,8064,15901,6751,24857,4261,2083,2178
21255,32927,8064,15902,6751,24862,4263,2083,2180
21260,32938,8067,15909,6754,24869,4264,2084,2180
21265,32942,8068,15910,6755,24874,4264,2084,2180
21270,32952,8070,15918,6757,24881,4265,2085,2180
21275,32958,8070,15921,6757,24887,4267,2086,2181
21280,32969,8071,15925,6758,24897,4268,2086,2182
21285,32973,8072,15929,6759,24900,4268,2086,2182
21290,32983,8075,15938,6762,24907,4269,2087,2182
21295,32989,8075,15939,6762,24914,4271,2087,2184
21300,33000,8077,15945,6764,24920,4272,2087,2185
21305,33004,8078,15947,6765,24925,4272,2087,2185
21310,33014,8082,15949,6768,24932,4273,2087,2186
21315,33020,8082,15950,6768,24938,4275,2088,2187
21320,33031,8084,15955,6770,24945,4276,2088,2188
21325,33035,8087,15958,6773,24947,4276,2088,2188
21330,33045,8091,15962,6776,24953,4277,2088,2189
21335,33051,8093,15965,6778,24957,4279,2089,2190
21340,33062,8099,15973,6784,24961,4280,2089,2191
21345,33066,8102,15974,6787,24964,4280,2089,2191
21350,33076,8106,15980,6791,24970,4281,2090,2191
21355,33082,8106,15982,6791,24975,4283,2090,2193
21360,33093,8108,15987,6793,24982,4284,2091,2193
21365,33097,8113,15990,6798,24984,4284,2091,2193
21370,33107,8117,15994,6800,24990,4285,2092,2193
21375,33113,8118,15999,6801,24994,4287,2094,2193
21380,33124,8121,16003,6803,25002,4288,2095,2193
21385,33128,8123,16005,6805,25005,4288,2095,2193
21390,33138,8125,16009,6806,25012,4289,2096,2193
21395,33144,8127,16015,6808,25015,4291,2098,2193
21400,33155,8131,16017,6811,25023,4292,2098,2194
21405,33159,8132,16019,6812,25026,4292,2098,2194
21410,33169,8137,16024,6817,25031,4293,2098,2195
21415,33175,8138,16025,6818,25037,4295,2099,2196
21420,33186,8140,16028,6820,25045,4296,2099,2197
21425,33190,8142,16030,6822,25047,4296,2099,2197
21430,33200,8146,16037,6826,25054,4297,2100,2197
21435,33206,8147,16041,6827,25058,4299,2102,2197
21440,33217,8148,16045,6827,25067,4300,2103,2197
21445,33221,8150,16047,6829,25071,4300,2103,2197
21450,33231,8152,16051,6831,25079,4301,2103,2198
21455,33237,8153,16056,6832,25083,4303,2105,2198
21460,33248,8156,16061,6834,25091,4304,2106,2198
21465,33252,8157,16062,6835,25095,4304,2106,2198
21470,33262,8159,16064,6836,25102,4305,2106,2199
21475,33268,8161,16066,6838,25107,4307,2107,2200
21480,33279,8162,16073,6839,25115,4308,2108,2200
21485,33283,8162,16076,6839,25120,4308,2108,2200
21490,33293,8163,16080,6839,25130,4309,2108,2201
21495,33299,8164,16085,6840,25134,4311,2109,2202
21500,33310,8164,16090,6840,25145,4312,2109,2203
21505,33314,8164,16092,6840,25149,4312,2109,2203
21510,33324,8165,16097,6841,25159,4313,2110,2203
21515,33330,8166,16100,6842,25164,4315,2110,2205
21520,33341,8167,16103,6843,25174,4316,2110,2206
21525,33345,8167,16106,6843,25177,4316,2110,2206
21530,33355,8168,16113,6844,25187,4317,2110,2207
21535,33361,8168,16115,6844,25192,4319,2111,2208
21540,33372,8170,16119,6846,25201,4320,2111,2209
21545,33376,8170,16121,6846,25205,4320,2111,2209
21550,33386,8172,16127,6846,25214,4321,2112,2209
21555,33392,8172,16131,6846,25219,4323,2114,2209
21560,33403,8174,16136,6848,25226,4324,2114,2210
21565,33407,8176,16140,6850,25230,4324,2114,2210
21570,33417,8178,16146,6851,25238,4325,2115,2210
21575,33423,8179,16149,6852,25244,4327,2116,2211
21580,33434,8182,16155,6854,25249,4328,2116,2212
21585,33438,8184,16156,6856,25254,4328,2116,2212
21590,33448,8186,16162,6857,25262,4329,2117,2212
21595,33454,8186,16166,6857,25268,4331,2119,2212
21600,33465,8189,16175,6860,25271,4332,2120,2212
21605,33469,8195,16179,6866,25273,4332,2120,2212
21610,33479,8199,16186,6870,25279,4333,2120,2213
21615,33485,8201,16189,6872,25283,4335,2120,2215
21620,33496,8206,16195,6877,25288,4336,2120,2216
21625,33500,8207,16196,6878,25293,4336,2120,2216
21630,33510,8210,16201,6879,25299,4337,2120,2217
21635,33516,8212,16204,6881,25304,4339,2121,2218
21640,33527,8216,16212,6885,25308,4340,2122,2218
21645,33531,8219,16215,6888,25311,4340,2122,2218
21650,33541,8223,16220,6891,25317,4341,2122,2219
21655,33547,8224,16222,6892,25323,4343,2123,2220
21660,33558,8225,16224,6893,25333,4344,2124,2220
21665,33562,8225,16225,6893,25337,4344,2124,2220
21670,33572,8228,16232,6895,25343,4345,2124,2221
21675,33578,8229,16235,6896,25348,4347,2126,2221
21680,33589,8233,16240,6899,25355,4348,2127,2221
21685,33593,8234,16241,6900,25359,4348,2127,2221
21690,33603,8240,16250,6905,25362,4349,2128,2221
21695,33609,8242,16252,6907,25366,4351,2128,2223
21700,33620,8246,16257,6911,25372,4352,2128,2224
21705,33624,8249,16259,6914,25375,4352,2128,2224
21710,33634,8253,16263,6916,25380,4353,2128,2225
21715,33640,8254,16266,6917,25386,4355,2129,2226
21720,33651,8256,16271,6919,25394,4356,2130,2226
21725,33655,8257,16274,6920,25398,4356,2130,2226
21730,33665,8260,16279,6921,25404,4357,2131,2226
21735,33671,8260,16281,6921,25411,4359,2132,2227
21740,33682,8260,16287,6921,25421,4360,2132,2228
21745,33686,8260,16290,6921,25426,4360,2132,2228
21750,33696,8261,16296,6922,25434,4361,2133,2228
21755,33702,8262,16299,6923,25439,4363,2134,2229
21760,33713,8262,16304,6923,25451,4364,2135,2229
21765,33717,8262,16306,6923,25455,4364,2135,2229
21770,33727,8263,16308,6923,25464,4365,2135,2230
21775,33733,8264,16312,6924,25469,4367,2137,2230
21780,33744,8265,16319,6925,25477,4368,2137,2231
21785,33748,8265,16321,6925,25483,4368,2137,2231
21790,33758,8266,16325,6926,25491,4369,2137,2232
21795,33764,8266,16327,6926,25497,4371,2138,2233
21800,33775,8267,16335,6927,25505,4372,2139,2233
21805,33779,8268,16336,6928,25511,4372,2139,2233
21810,33789,8269,16339,6928,25519,4373,2139,2234
21815,33795,8270,16341,6929,25524,4375,2139,2236
21820,33806,8272,16348,6930,25532,4376,2140,2236
21825,33810,8275,16350,6933,25535,4376,2140,2236
21830,33820,8276,16357,6934,25543,4377,2141,2236
21835,33826,8277,16358,6935,25549,4379,2142,2237
21840,33837,8280,16364,6937,25554,4380,2143,2237
21845,33841,8284,16367,6941,25556,4380,2143,2237
21850,33851,8286,16373,6943,25564,4381,2143,2238
21855,33857,8288,16376,6945,25568,4383,2144,2239
21860,33868,8292,16383,6948,25573,4384,2144,2240
21865,33872,8295,16385,6951,25576,4384,2144,2240
21870,33882,8299,16388,6953,25583,4385,2144,2241
21875,33888,8299,16391,6953,25589,4387,2146,2241
21880,33899,8301,16396,6954,25596,4388,2147,2241
21885,33903,8304,16397,6957,25599,4388,2147,2241
21890,33913,8307,16402,6959,25606,4389,2148,2241
21895,33919,8308,16406,6960,25610,4391,2149,2242
21900,33930,8312,16411,6963,25616,4392,2150,2242
21905,33934,8315,16413,6966,25619,4392,2150,2242
21910,33944,8317,16419,6968,25626,4393,2151,2242
21915,33950,8318,16421,6969,25632,4395,2151,2244
21920,33961,8319,16429,6970,25639,4396,2152,2244
21925,33965,8320,16431,6971,25644,4396,2152,2244
21930,33975,8322,16434,6972,25653,4397,2153,2244
21935,33981,8322,16436,6972,25659,4399,2154,2245
21940,33992,8323,16442,6973,25666,4400,2154,2246
21945,33996,8324,16444,6974,25672,4400,2154,2246
21950,34006,8328,16449,6977,25678,4401,2155,2246
21955,34012,8328,16453,6977,25681,4403,2156,2247
21960,34023,8333,16457,6982,25689,4404,2156,2248
21965,34027,8333,16458,6982,25694,4404,2156,2248
21970,34037,8335,16461,6982,25701,4405,2157,2248
21975,34043,8336,16464,6983,25707,4407,2158,2249
21980,34054,8336,16468,6983,25716,4408,2159,2249
21985,34058,8337,16470,6984,25721,4408,2159,2249
21990,34068,8339,16476,6985,25728,4409,2160,2249
21995,34074,8340,16479,6986,25734,4411,2162,2249
22000,34085,8340,16482,6986,25744,4412,2162,2250
22005,34089,8342,16484,6988,25746,4412,2162,2250
22010,34099,8346,16489,6991,25752,4413,2163,2250
22015,34105,8348,16494,6993,25757,4415,2165,2250
22020,34116,8352,16499,6996,25762,4416,2165,2251
22025,34120,8355,16501,6999,25764,4416,2165,2251
22030,34130,8359,16505,7002,25770,4417,2165,2252
22035,34136,8361,16510,7004,25774,4419,2167,2252
22040,34147,8366,16518,7009,25778,4420,2168,2252
22045,34151,8369,16521,7012,25781,4420,2168,2252
22050,34161,8373,16526,7015,25788,4421,2168,2253
22055,34167,8373,16529,7015,25793,4423,2169,2254
22060,34178,8377,16535,7018,25799,4424,2169,2255
22065,34182,8380,16538,7021,25801,4424,2169,2255
22070,34192,8381,16543,7021,25811,4425,2170,2255
22075,34198,8382,16546,7022,25816,4427,2171,2256
22080,34209,8384,16551,7024,25824,4428,2171,2257
22085,34213,8385,16552,7025,25827,4428,2171,2257
22090,34223,8388,16560,7028,25835,4429,2172,2257
22095,34229,8389,16563,7029,25839,4431,2172,2259
22100,34240,8390,16570,7030,25846,4432,2173,2259
22105,34244,8394,16572,7034,25849,4432,2173,2259
22110,34254,8395,16577,7034,25858,4433,2174,2259
22115,34260,8396,16580,7035,25862,4435,2175,2260
22120,34271,8398,16588,7037,25870,4436,2176,2260
22125,34275,8400,16589,7039,25875,4436,2176,2260
22130,34285,8401,16594,7039,25883,4437,2177,2260
22135,34291,8401,16595,7039,25890,4439,2178,2261
22140,34302,8401,16601,7039,25899,4440,2178,2262
22145,34306,8402,16605,7040,25903,4440,2178,2262
22150,34316,8403,16606,7040,25913,4441,2178,2263
22155,34322,8403,16608,7040,25918,4443,2179,2264
22160,34333,8403,16613,7040,25930,4444,2180,2264
22165,34337,8403,16614,7040,25934,4444,2180,2264
22170,34347,8405,16623,7041,25941,4445,2181,2264
22175,34353,8406,16625,7042,25946,4447,2181,2266
22180,34364,8407,16629,7043,25956,4448,2181,2267
22185,34368,8408,16631,7044,25960,4448,2181,2267
22190,34378,8410,16635,7044,25968,4449,2181,2268
22195,34384,8411,16639,7045,25973,4451,2182,2269
22200,34395,8413,16645,7047,25980,4452,2182,2270
22205,34399,8414,16648,7048,25985,4452,2182,2270
22210,34409,8416,16650,7049,25992,4453,2182,2271
22215,34415,8417,16654,7050,25998,4455,2183,2272
22220,34426,8418,16660,7051,26007,4456,2184,2272
22225,34430,8420,16663,7053,26010,4456,2184,2272
22230,34440,8423,16670,7055,26016,4457,2185,2272
22235,34446,8424,16671,7056,26022,4459,2186,2273
22240,34457,8427,16677,7058,26027,4460,2187,2273
22245,34461,8431,16680,7062,26029,4460,2187,2273
22250,34471,8434,16684,7064,26036,4461,2187,2274
22255,34477,8435,16688,7065,26041,4463,2188,2275
22260,34488,8439,16695,7069,26047,4464,2189,2275
22265,34492,8442,16697,7072,26049,4464,2189,2275
22270,34502,8445,16701,7074,26057,4465,2190,2275
22275,34508,8446,16704,7075,26061,4467,2190,2277
22280,34519,8449,16710,7078,26067,4468,2190,2278
22285,34523,8453,16712,7082,26070,4468,2190,2278
22290,34533,8457,16716,7085,26075,4469,2190,2279
22295,34539,8459,16720,7087,26079,4471,2192,2279
22300,34550,8463,16726,7091,26086,4472,2193,2279
22305,34554,8465,16727,7093,26089,4472,2193,2279
22310,34564,8469,16731,7095,26094,4473,2194,2279
22315,34570,8470,16733,7096,26099,4475,2195,2280
22320,34581,8474,16738,7099,26106,4476,2196,2280
22325,34585,8475,16740,7100,26110,4476,2196,2280
22330,34595,8478,16745,7103,26117,4477,2196,2281
22335,34601,8478,16746,7103,26122,4479,2196,2283
22340,34612,8482,16750,7106,26129,4480,2196,2284
22345,34616,8482,16752,7106,26133,4480,2196,2284
22350,34626,8483,16758,7107,26142,4481,2196,2285
22355,34632,8483,16760,7107,26148,4483,2196,2287
22360,34643,8486,16765,7109,26156,4484,2196,2288
22365,34647,8486,16768,7109,26160,4484,2196,2288
22370,34657,8489,16775,7112,26167,4485,2197,2288
22375,34663,8490,16778,7113,26173,4487,2198,2289
22380,34674,8491,16784,7113,26183,4488,2199,2289
22385,34678,8491,16785,7113,26186,4488,2199,2289
22390,34688,8493,16789,7114,26194,4489,2200,2289
22395,34694,8493,16792,7114,26200,4491,2201,2290
22400,34705,8494,16797,7114,26209,4492,2202,2290
22405,34709,8495,16799,7115,26213,4492,2202,2290
22410,34719,8496,16803,7115,26222,4493,2203,2290
22415,34725,8497,16805,7116,26228,4495,2203,2292
22420,34736,8499,16811,7117,26236,4496,2204,2292
22425,34740,8500,16812,7118,26240,4496,2204,2292
22430,34750,8502,16816,7119,26248,4497,2205,2292
22435,34756,8503,16819,7120,26253,4499,2206,2293
22440,34767,8504,16823,7120,26260,4500,2207,2293
22445,34771,8507,16824,7123,26263,4500,2207,2293
22450,34781,8510,16830,7125,26271,4501,2208,2293
22455,34787,8511,16831,7126,26276,4503,2208,2295
22460,34798,8514,16836,7129,26283,4504,2208,2296
22465,34802,8515,16839,7130,26286,4504,2208,2296
22470,34812,8517,16843,7131,26294,4505,2209,2296
22475,34818,8519,16848,7133,26298,4507,2211,2296
22480,34829,8523,16853,7137,26304,4508,2211,2297
22485,34833,8525,16857,7139,26307,4508,2211,2297
22490,34843,8529,16863,7142,26314,4509,2212,2297
22495,34849,8529,16866,7142,26320,4511,2214,2297
22500,34860,8532,16872,7144,26325,4512,2214,2298
22505,34864,8533,16875,7145,26331,4512,2214,2298
22510,34874,8535,16878,7146,26339,4513,2214,2299
22515,34880,8535,16879,7146,26345,4515,2214,2301
22520,34891,8536,16882,7147,26354,4516,2215,2301
22525,34895,8537,16883,7148,26357,4516,2215,2301
22530,34905,8540,16888,7150,26365,4517,2216,2301
22535,34911,8541,16892,7151,26370,4519,2218,2301
22540,34922,8542,16896,7152,26378,4520,2218,2302
22545,34926,8544,16897,7154,26382,4520,2218,2302
22550,34936,8546,16904,7155,26389,4521,2218,2303
22555,34942,8547,16907,7156,26395,4523,2218,2305
22560,34953,8547,16911,7156,26404,4524,2219,2305
22565,34957,8549,16914,7158,26408,4524,2219,2305
22570,34967,8551,16918,7160,26416,4525,2219,2306
22575,34973,8551,16920,7160,26422,4527,2220,2307
22580,34984,8551,16923,7160,26431,4528,2220,2308
22585,34988,8553,16925,7162,26434,4528,2220,2308
22590,34998,8556,16931,7165,26442,4529,2220,2309
22595,35004,8557,16934,7166,26447,4531,2220,2311
22600,35015,8559,16939,7168,26453,4532,2220,2312
22605,35019,8560,16940,7169,26458,4532,2220,2312
22610,35029,8566,16946,7174,26461,4533,2220,2313
22615,35035,8568,16949,7176,26464,4535,2220,2315
22620,35046,8574,16953,7182,26471,4536,2220,2316
22625,35050,8575,16954,7183,26474,4536,2220,2316
22630,35060,8578,16958,7186,26482,4537,2221,2316
22635,35066,8578,16961,7186,26487,4539,2222,2317
22640,35077,8581,16972,7189,26492,4540,2223,2317
22645,35081,8584,16975,7192,26496,4540,2223,2317
22650,35091,8585,16978,7192,26506,4541,2223,2318
22655,35097,8586,16982,7193,26510,4543,2224,2319
22660,35108,8588,16987,7195,26519,4544,2225,2319
22665,35112,8589,16988,7196,26522,4544,2225,2319
22670,35122,8590,16991,7197,26532,4545,2225,2320
22675,35128,8590,16994,7197,26537,4547,2226,2321
22680,35139,8592,16998,7198,26545,4548,2227,2321
22685,35143,8594,17002,7200,26548,4548,2227,2321
22690,35153,8596,17006,7202,26557,4549,2227,2322
22695,35159,8597,17010,7203,26561,4551,2227,2324
22700,35170,8600,17017,7206,26569,4552,2227,2325
22705,35174,8602,17020,7208,26572,4552,2227,2325
22710,35184,8604,17024,7209,26580,4553,2228,2325
22715,35190,8604,17027,7209,26586,4555,2230,2325
22720,35201,8607,17035,7211,26592,4556,2231,2325
22725,35205,8610,17037,7214,26595,4556,2231,2325
22730,35215,8612,17040,7215,26603,4557,2231,2326
22735,35221,8612,17041,7215,26609,4559,2232,2327
22740,35232,8614,17047,7217,26615,4560,2233,2327
22745,35236,8617,17049,7220,26619,4560,2233,2327
22750,35246,8621,17054,7223,26624,4561,2234,2327
22755,35252,8622,17059,7224,26629,4563,2236,2327
22760,35263,8623,17062,7225,26639,4564,2236,2328
22765,35267,8623,17065,7225,26644,4564,2236,2328
22770,35277,8625,17069,7226,26652,4565,2236,2329
22775,35283,8625,17070,7226,26658,4567,2236,2331
22780,35294,8627,17076,7228,26665,4568,2236,2332
22785,35298,8628,17077,7229,26670,4568,2236,2332
22790,35308,8632,17081,7231,26675,4569,2237,2332
22795,35314,8633,17085,7232,26680,4571,2238,2333
22800,35325,8637,17091,7236,26685,4572,2238,2334
22805,35329,8639,17091,7238,26690,4572,2238,2334
22810,35339,8642,17096,7241,26696,4573,2238,2335
22815,35345,8643,17098,7242,26702,4575,2240,2335
22820,35356,8643,17099,7242,26712,4576,2240,2336
22825,35360,8645,17100,7244,26715,4576,2240,2336
22830,35370,8650,17109,7248,26718,4577,2241,2336
22835,35376,8651,17112,7249,26724,4579,2243,2336
22840,35387,8653,17117,7251,26733,4580,2244,2336
22845,35391,8653,17119,7251,26737,4580,2244,2336
22850,35401,8659,17125,7257,26742,4581,2244,2337
22855,35407,8660,17129,7258,26747,4583,2246,2337
22860,35418,8661,17134,7259,26755,4584,2247,2337
22865,35422,8664,17137,7262,26758,4584,2247,2337
22870,35432,8665,17141,7263,26767,4585,2248,2337
22875,35438,8666,17144,7264,26772,4587,2248,2339
22880,35449,8668,17148,7265,26779,4588,2248,2340
22885,35453,8669,17148,7266,26784,4588,2248,2340
22890,35463,8672,17153,7268,26791,4589,2248,2341
22895,35469,8673,17156,7269,26796,4591,2249,2342
22900,35480,8676,17164,7272,26801,4592,2249,2343
22905,35484,8680,17166,7276,26804,4592,2249,2343
22910,35494,8682,17169,7277,26811,4593,2249,2344
22915,35500,8684,17174,7279,26816,4595,2250,2345
22920,35511,8687,17182,7282,26821,4596,2250,2346
22925,35515,8689,17184,7284,26826,4596,2250,2346
22930,35525,8690,17187,7285,26835,4597,2250,2347
22935,35531,8690,17190,7285,26841,4599,2250,2349
22940,35542,8691,17195,7286,26850,4600,2251,2349
22945,35546,8692,17197,7287,26854,4600,2251,2349
22950,35556,8692,17202,7287,26864,4601,2252,2349
22955,35562,8692,17205,7287,26869,4603,2252,2351
22960,35573,8693,17211,7288,26878,4604,2253,2351
22965,35577,8694,17211,7289,26883,4604,2253,2351
22970,35587,8697,17217,7292,26888,4605,2254,2351
22975,35593,8699,17221,7294,26891,4607,2254,2353
22980,35604,8705,17227,7299,26898,4608,2255,2353
22985,35608,8707,17229,7301,26900,4608,2255,2353
22990,35618,8710,17235,7304,26906,4609,2256,2353
22995,35624,8712,17238,7306,26910,4611,2257,2354
23000,35635,8715,17240,7308,26919,4612,2257,2355
23005,35639,8717,17243,7310,26920,4612,2257,2355
23010,35649,8722,17247,7314,26926,4613,2258,2355
23015,35655,8723,17249,7315,26931,4615,2258,2357
23020,35666,8725,17256,7316,26938,4616,2259,2357
23025,35670,8727,17257,7318,26943,4616,2259,2357
23030,35680,8728,17262,7318,26952,4617,2260,2357
23035,35686,8728,17263,7318,26958,4619,2260,2359
23040,35697,8728,17270,7318,26966,4620,2261,2359
23045,35701,8729,17270,7319,26972,4620,2261,2359
23050,35711,8730,17274,7319,26981,4621,2261,2360
23055,35717,8731,17277,7320,26986,4623,2262,2361
23060,35728,8731,17282,7320,26995,4624,2262,2362
23065,35732,8732,17284,7321,26999,4624,2262,2362
23070,35742,8733,17290,7322,27008,4625,2262,2363
23075,35748,8733,17295,7322,27014,4627,2264,2363
23080,35759,8733,17301,7322,27024,4628,2265,2363
23085,35763,8734,17302,7323,27029,4628,2265,2363
23090,35773,8735,17305,7324,27037,4629,2265,2364
23095,35779,8736,17310,7325,27043,4631,2266,2365
23100,35790,8737,17317,7326,27051,4632,2267,2365
23105,35794,8738,17320,7327,27056,4632,2267,2365
23110,35804,8739,17326,7327,27064,4633,2268,2365
23115,35810,8739,17326,7327,27071,4635,2268,2367
23120,35821,8740,17330,7328,27078,4636,2268,2368
23125,35825,8741,17331,7329,27084,4636,2268,2368
23130,35835,8743,17338,7331,27091,4637,2268,2369
23135,35841,8744,17341,7332,27097,4639,2269,2370
23140,35852,8746,17346,7333,27102,4640,2269,2371
23145,35856,8750,17347,7337,27106,4640,2269,2371
23150,35866,8753,17353,7340,27112,4641,2270,2371
23155,35872,8754,17358,7341,27118,4643,2272,2371
23160,35883,8758,17363,7344,27124,4644,2273,2371
23165,35887,8760,17366,7346,27126,4644,2273,2371
23170,35897,8765,17372,7351,27131,4645,2273,2372
23175,35903,8767,17376,7353,27135,4647,2274,2373
23180,35914,8770,17380,7355,27141,4648,2274,2374
23185,35918,8774,17381,7359,27144,4648,2274,2374
23190,35928,8776,17384,7360,27151,4649,2274,2375
23195,35934,8777,17388,7361,27156,4651,2275,2376
23200,35945,8781,17395,7364,27160,4652,2276,2376
23205,35949,8785,17396,7368,27164,4652,2276,2376
23210,35959,8790,17403,7373,27168,4653,2276,2377
23215,35965,8792,17407,7375,27172,4655,2278,2377
23220,35976,8797,17413,7380,27178,4656,2278,2378
23225,35980,8800,17416,7383,27179,4656,2278,2378
23230,35990,8806,17421,7387,27183,4657,2279,2378
23235,35996,8807,17424,7388,27188,4659,2280,2379
23240,36007,8812,17430,7393,27194,4660,2281,2379
23245,36011,8814,17433,7395,27196,4660,2281,2379
23250,36021,8816,17436,7397,27204,4661,2281,2380
23255,36027,8817,17439,7398,27209,4663,2281,2382
23260,36038,8818,17444,7399,27219,4664,2282,2382
23265,36042,8820,17446,7401,27222,4664,2282,2382
23270,36052,8822,17451,7402,27229,4665,2282,2383
23275,36058,8824,17455,7404,27232,4667,2283,2384
23280,36069,8826,17460,7406,27242,4668,2284,2384
23285,36073,8826,17464,7406,27246,4668,2284,2384
23290,36083,8827,17469,7407,27255,4669,2284,2385
23295,36089,8827,17473,7407,27260,4671,2286,2385
23300,36100,8828,17479,7408,27271,4672,2286,2386
23305,36104,8828,17480,7408,27276,4672,2286,2386
23310,36114,8829,17488,7409,27284,4673,2287,2386
23315,36120,8830,17491,7410,27290,4675,2287,2388
23320,36131,8831,17496,7411,27300,4676,2288,2388
23325,36135,8831,17499,7411,27303,4676,2288,2388
23330,36145,8832,17505,7411,27312,4677,2289,2388
23335,36151,8832,17508,7411,27318,4679,2290,2389
23340,36162,8833,17514,7412,27328,4680,2290,2390
23345,36166,8834,17515,7413,27332,4680,2290,2390
23350,36176,8835,17517,7413,27340,4681,2290,2391
23355,36182,8835,17517,7413,27347,4683,2290,2393
23360,36193,8837,17523,7415,27353,4684,2290,2394
23365,36197,8839,17526,7417,27358,4684,2290,2394
23370,36207,8841,17530,7417,27365,4685,2290,2395
23375,36213,8842,17534,7418,27371,4687,2292,2395
23380,36224,8843,17541,7419,27378,4688,2293,2395
23385,36228,8844,17543,7420,27384,4688,2293,2395
23390,36238,8847,17548,7421,27390,4689,2294,2395
23395,36244,8848,17552,7422,27396,4691,2296,2395
23400,36255,8851,17557,7424,27402,4692,2297,2395
23405,36259,8853,17558,7426,27406,4692,2297,2395
23410,36269,8856,17566,7429,27412,4693,2298,2395
23415,36275,8856,17569,7429,27418,4695,2299,2396
23420,36286,8862,17577,7435,27422,4696,2300,2396
23425,36290,8864,17580,7437,27425,4696,2300,2396
23430,36300,8868,17583,7439,27431,4697,2300,2397
23435,36306,8870,17588,7441,27435,4699,2301,2398
23440,36317,8872,17590,7443,27444,4700,2301,2399
23445,36321,8874,17592,7445,27446,4700,2301,2399
23450,36331,8879,17597,7448,27451,4701,2301,2400
23455,36337,8881,17600,7450,27455,4703,2302,2401
23460,36348,8883,17602,7451,27463,4704,2302,2402
23465,36352,8886,17605,7454,27466,4704,2302,2402
23470,36362,8889,17609,7455,27472,4705,2303,2402
23475,36368,8890,17612,7456,27476,4707,2303,2404
23480,36379,8894,17618,7460,27483,4708,2304,2404
23485,36383,8898,17621,7464,27485,4708,2304,2404
23490,36393,8902,17628,7467,27490,4709,2305,2404
23495,36399,8903,17629,7468,27495,4711,2305,2406
23500,36410,8907,17634,7471,27501,4712,2305,2407
23505,36414,8908,17636,7472,27506,4712,2305,2407
23510,36424,8910,17642,7473,27513,4713,2306,2407
23515,36430,8911,17646,7474,27517,4715,2307,2408
23520,36441,8914,17650,7477,27526,4716,2308,2408
23525,36445,8915,17651,7478,27529,4716,2308,2408
23530,36455,8918,17653,7480,27536,4717,2308,2409
23535,36461,8918,17654,7480,27543,4719,2308,2411
23540,36472,8921,17660,7483,27550,4720,2308,2412
23545,36476,8922,17662,7484,27554,4720,2308,2412
23550,36486,8923,17666,7485,27562,4721,2309,2412
23555,36492,8924,17669,7486,27568,4723,2310,2413
23560,36503,8925,17674,7487,27577,4724,2311,2413
23565,36507,8926,17677,7488,27581,4724,2311,2413
23570,36517,8927,17682,7489,27589,4725,2311,2414
23575,36523,8927,17686,7489,27595,4727,2313,2414
23580,36534,8927,17691,7489,27605,4728,2314,2414
23585,36538,8927,17693,7489,27611,4728,2314,2414
23590,36548,8928,17696,7489,27619,4729,2314,2415
23595,36554,8929,17699,7490,27625,4731,2315,2416
23600,36565,8930,17704,7491,27633,4732,2315,2417
23605,36569,8931,17704,7492,27638,4732,2315,2417
23610,36579,8933,17709,7494,27645,4733,2315,2418
23615,36585,8934,17711,7495,27650,4735,2316,2419
23620,36596,8936,17717,7497,27657,4736,2316,2420
23625,36600,8939,17720,7500,27660,4736,2316,2420
23630,36610,8941,17724,7502,27668,4737,2317,2420
23635,36616,8941,17727,7502,27675,4739,2319,2420
23640,36627,8942,17730,7502,27684,4740,2319,2421
23645,36631,8944,17731,7504,27687,4740,2319,2421
23650,36641,8945,17733,7504,27694,4741,2319,2422
23655,36647,8946,17737,7505,27699,4743,2321,2422
23660,36658,8952,17743,7511,27704,4744,2321,2423
23665,36662,8955,17745,7514,27706,4744,2321,2423
23670,36672,8960,17748,7518,27711,4745,2321,2424
23675,36678,8961,17751,7519,27717,4747,2323,2424
23680,36689,8964,17758,7521,27720,4748,2323,2425
23685,36693,8969,17759,7526,27723,4748,2323,2425
23690,36703,8976,17765,7532,27725,4749,2323,2426
23695,36709,8978,17768,7534,27730,4751,2324,2427
23700,36720,8982,17771,7537,27737,4752,2324,2428
23705,36724,8982,17772,7537,27741,4752,2324,2428
23710,36734,8984,17777,7539,27749,4753,2324,2429
23715,36740,8985,17779,7540,27755,4755,2325,2430
23720,36751,8988,17786,7543,27761,4756,2326,2430
23725,36755,8989,17788,7544,27765,4756,2326,2430
23730,36765,8991,17792,7545,27773,4757,2326,2431
23735,36771,8992,17795,7546,27778,4759,2327,2432
23740,36782,8994,17799,7547,27788,4760,2328,2432
23745,36786,8995,17803,7548,27790,4760,2328,2432
23750,36796,8996,17810,7549,27799,4761,2329,2432
23755,36802,8997,17814,7550,27804,4763,2329,2434
23760,36813,8999,17817,7551,27814,4764,2330,2434
23765,36817,9000,17820,7552,27817,4764,2330,2434
23770,36827,9001,17824,7553,27825,4765,2330,2435
23775,36833,9001,17826,7553,27832,4767,2330,2437
23780,36844,9001,17829,7553,27843,4768,2330,2438
23785,36848,9001,17831,7553,27847,4768,2330,2438
23790,36858,9002,17837,7554,27855,4769,2330,2439
23795,36864,9003,17839,7555,27861,4771,2331,2440
23800,36875,9004,17844,7556,27870,4772,2332,2440
23805,36879,9004,17845,7556,27875,4772,2332,2440
23810,36889,9006,17849,7557,27882,4773,2332,2441
23815,36895,9006,17853,7557,27888,4775,2333,2442
23820,36906,9009,17859,7560,27895,4776,2333,2443
23825,36910,9010,17860,7561,27900,4776,2333,2443
23830,36920,9012,17866,7563,27907,4777,2333,2444
23835,36926,9012,17869,7563,27913,4779,2333,2446
23840,36937,9013,17871,7564,27923,4780,2333,2447
23845,36941,9014,17871,7565,27927,4780,2333,2447
23850,36951,9016,17876,7567,27935,4781,2333,2448
23855,36957,9016,17879,7567,27940,4783,2335,2448
23860,36968,9020,17885,7571,27948,4784,2336,2448
23865,36972,9020,17887,7571,27951,4784,2336,2448
23870,36982,9023,17890,7574,27959,4785,2336,2449
23875,36988,9023,17892,7574,27965,4787,2337,2450
23880,36999,9026,17897,7577,27972,4788,2337,2451
23885,37003,9028,17898,7579,27975,4788,2337,2451
23890,37013,9033,17905,7583,27979,4789,2337,2452
23895,37019,9035,17907,7585,27983,4791,2337,2454
23900,37030,9039,17914,7589,27989,4792,2338,2454
23905,37034,9043,17918,7593,27990,4792,2338,2454
23910,37044,9046,17920,7595,27998,4793,2339,2454
23915,37050,9046,17923,7595,28002,4795,2339,2456
23920,37061,9052,17930,7600,28006,4796,2340,2456
23925,37065,9057,17933,7605,28008,4796,2340,2456
23930,37075,9059,17940,7607,28015,4797,2341,2456
23935,37081,9060,17942,7608,28021,4799,2342,2457
23940,37092,9062,17947,7609,28028,4800,2343,2457
23945,37096,9063,17949,7610,28032,4800,2343,2457
23950,37106,9065,17954,7612,28040,4801,2343,2458
23955,37112,9066,17955,7613,28046,4803,2344,2459
23960,37123,9068,17962,7615,28054,4804,2345,2459
23965,37127,9069,17962,7616,28058,4804,2345,2459
23970,37137,9071,17966,7618,28065,4805,2345,2460
23975,37143,9073,17969,7620,28069,4807,2346,2461
23980,37154,9074,17976,7620,28077,4808,2347,2461
23985,37158,9076,17977,7622,28082,4808,2347,2461
23990,37168,9079,17980,7624,28089,4809,2347,2462
23995,37174,9079,17982,7624,28094,4811,2348,2463
24000,37185,9080,17986,7625,28104,4812,2349,2463
24005,37189,9082,17988,7627,28107,4812,2349,2463
24010,37199,9083,17991,7628,28116,4813,2349,2464
24015,37205,9083,17993,7628,28121,4815,2350,2465
24020,37216,9084,17996,7628,28130,4816,2350,2466
24025,37220,9085,17996,7629,28135,4816,2350,2466
24030,37230,9088,18001,7632,28142,4817,2351,2466
24035,37236,9088,18005,7632,28147,4819,2353,2466
24040,37247,9090,18011,7634,28154,4820,2353,2467
24045,37251,9092,18012,7636,28159,4820,2353,2467
24050,37261,9095,18016,7637,28166,4821,2354,2467
24055,37267,9096,18020,7638,28170,4823,2355,2468
24060,37278,9101,18025,7642,28176,4824,2356,2468
24065,37282,9102,18028,7643,28179,4824,2356,2468
24070,37292,9104,18033,7645,28188,4825,2356,2469
24075,37298,9105,18037,7646,28192,4827,2358,2469
24080,37309,9107,18045,7648,28199,4828,2359,2469
24085,37313,9108,18047,7649,28204,4828,2359,2469
24090,37323,9110,18053,7650,28212,4829,2360,2469
24095,37329,9110,18055,7650,28219,4831,2361,2470
24100,37340,9111,18061,7651,28227,4832,2362,2470
24105,37344,9112,18065,7652,28231,4832,2362,2470
24110,37354,9114,18071,7654,28240,4833,2363,2470
24115,37360,9114,18074,7654,28244,4835,2364,2471
24120,37371,9119,18081,7659,28251,4836,2365,2471
24125,37375,9120,18084,7660,28255,4836,2365,2471
24130,37385,9122,18091,7662,28262,4837,2365,2472
24135,37391,9122,18091,7662,28269,4839,2365,2474
24140,37402,9123,18099,7663,28276,4840,2366,2474
24145,37406,9124,18101,7664,28282,4840,2366,2474
24150,37416,9126,18106,7665,28289,4841,2366,2475
24155,37422,9126,18107,7665,28296,4843,2366,2477
24160,37433,9127,18114,7666,28303,4844,2367,2477
24165,37437,9130,18116,7669,28306,4844,2367,2477
24170,37447,9134,18120,7672,28313,4845,2368,2477
24175,37453,9135,18124,7673,28317,4847,2369,2478
24180,37464,9138,18129,7676,28324,4848,2370,2478
24185,37468,9140,18129,7678,28328,4848,2370,2478
24190,37478,9143,18133,7679,28334,4849,2370,2479
24195,37484,9144,18135,7680,28339,4851,2370,2481
24200,37495,9147,18137,7682,28347,4852,2370,2482
24205,37499,9149,18138,7684,28350,4852,2370,2482
24210,37509,9151,18140,7686,28358,4853,2370,2483
24215,37515,9152,18142,7687,28363,4855,2370,2485
24220,37526,9155,18147,7689,28369,4856,2371,2485
24225,37530,9156,18148,7690,28373,4856,2371,2485
24230,37540,9162,18154,7694,28376,4857,2372,2485
24235,37546,9165,18158,7697,28379,4859,2373,2486
24240,37557,9170,18165,7702,28384,4860,2374,2486
24245,37561,9174,18169,7706,28386,4860,2374,2486
24250,37571,9175,18172,7707,28395,4861,2374,2487
24255,37577,9176,18175,7708,28400,4863,2375,2488
24260,37588,9179,18182,7711,28407,4864,2375,2489
24265,37592,9182,18186,7714,28409,4864,2375,2489
24270,37602,9184,18190,7715,28417,4865,2376,2489
24275,37608,9185,18193,7716,28422,4867,2377,2490
24280,37619,9187,18197,7718,28430,4868,2377,2491
24285,37623,9190,18199,7721,28433,4868,2377,2491
24290,37633,9191,18203,7721,28442,4869,2378,2491
24295,37639,9191,18206,7721,28448,4871,2380,2491
24300,37650,9192,18209,7722,28456,4872,2380,2492
24305,37654,9193,18212,7723,28460,4872,2380,2492
24310,37664,9195,18219,7725,28468,4873,2381,2492
24315,37670,9196,18220,7726,28474,4875,2382,2493
24320,37681,9198,18227,7728,28482,4876,2383,2493
24325,37685,9199,18228,7729,28485,4876,2383,2493
24330,37695,9200,18233,7729,28495,4877,2383,2494
24335,37701,9200,18236,7729,28500,4879,2384,2495
24340,37712,9200,18239,7729,28511,4880,2385,2495
24345,37716,9200,18240,7729,28516,4880,2385,2495
24350,37726,9202,18247,7730,28523,4881,2385,2496
24355,37732,9202,18250,7730,28529,4883,2386,2497
24360,37743,9205,18257,7733,28537,4884,2387,2497
24365,37747,9206,18258,7734,28541,4884,2387,2497
24370,37757,9208,18264,7735,28548,4885,2387,2498
24375,37763,9208,18265,7735,28555,4887,2388,2499
24380,37774,9209,18272,7736,28563,4888,2389,2499
24385,37778,9210,18276,7737,28568,4888,2389,2499
24390,37788,9212,18280,7737,28576,4889,2389,2500
24395,37794,9213,18284,7738,28581,4891,2390,2501
24400,37805,9213,18288,7738,28589,4892,2390,2502
24405,37809,9215,18290,7740,28594,4892,2390,2502
24410,37819,9217,18293,7740,28601,4893,2390,2503
24415,37825,9217,18296,7740,28607,4895,2391,2504
24420,37836,9220,18304,7743,28613,4896,2392,2504
24425,37840,9221,18305,7744,28619,4896,2392,2504
24430,37850,9224,18310,7747,28625,4897,2392,2505
24435,37856,9225,18313,7748,28630,4899,2392,2507
24440,37867,9228,18316,7750,28638,4900,2392,2508
24445,37871,9230,18318,7752,28640,4900,2392,2508
24450,37881,9234,18324,7756,28646,4901,2392,2509
24455,37887,9235,18327,7757,28651,4903,2393,2510
24460,37898,9238,18331,7759,28658,4904,2393,2511
24465,37902,9241,18333,7762,28660,4904,2393,2511
24470,37912,9247,18338,7766,28664,4905,2393,2512
24475,37918,9249,18342,7768,28669,4907,2395,2512
24480,37929,9252,18348,7770,28675,4908,2396,2512
24485,37933,9254,18349,7772,28679,4908,2396,2512
24490,37943,9259,18354,7776,28684,4909,2397,2512
24495,37949,9259,18356,7776,28689,4911,2398,2513
24500,37960,9263,18361,7779,28695,4912,2398,2514
24505,37964,9266,18363,7782,28697,4912,2398,2514
24510,37974,9272,18368,7787,28702,4913,2399,2514
24515,37980,9272,18371,7787,28706,4915,2400,2515
24520,37991,9275,18378,7789,28713,4916,2401,2515
24525,37995,9278,18378,7792,28717,4916,2401,2515
24530,38005,9280,18384,7794,28725,4917,2402,2515
24535,38011,9280,18386,7794,28730,4919,2403,2516
24540,38022,9283,18392,7797,28737,4920,2403,2517
24545,38026,9285,18396,7799,28740,4920,2403,2517
24550,38036,9287,18403,7801,28748,4921,2403,2518
24555,38042,9289,18407,7803,28752,4923,2404,2519
24560,38053,9292,18411,7806,28760,4924,2404,2520
24565,38057,9293,18415,7807,28763,4924,2404,2520
24570,38067,9294,18419,7807,28773,4925,2404,2521
24575,38073,9294,18420,7807,28779,4927,2404,2523
24580,38084,9295,18429,7808,28788,4928,2405,2523
24585,38088,9295,18432,7808,28793,4928,2405,2523
24590,38098,9296,18436,7808,28801,4929,2405,2524
24595,38104,9296,18438,7808,28807,4931,2405,2526
24600,38115,9296,18446,7808,28816,4932,2406,2526
24605,38119,9297,18447,7809,28822,4932,2406,2526
24610,38129,9298,18453,7810,28831,4933,2406,2527
24615,38135,9298,18455,7810,28837,4935,2406,2529
24620,38146,9299,18460,7811,28845,4936,2406,2530
24625,38150,9299,18462,7811,28851,4936,2406,2530
24630,38160,9301,18466,7812,28859,4937,2407,2530
24635,38166,9302,18472,7813,28863,4939,2409,2530
24640,38177,9304,18477,7815,28872,4940,2409,2531
24645,38181,9304,18477,7815,28877,4940,2409,2531
24650,38191,9306,18482,7817,28885,4941,2409,2532
24655,38197,9306,18484,7817,28891,4943,2410,2533
24660,38208,9308,18489,7819,28899,4944,2411,2533
24665,38212,9309,18490,7820,28902,4944,2411,2533
24670,38222,9313,18494,7824,28909,4945,2411,2534
24675,38228,9314,18497,7825,28914,4947,2412,2535
24680,38239,9317,18503,7828,28920,4948,2413,2535
24685,38243,9320,18506,7831,28922,4948,2413,2535
24690,38253,9323,18510,7833,28929,4949,2413,2536
24695,38259,9325,18514,7835,28934,4951,2415,2536
24700,38270,9327,18518,7837,28942,4952,2416,2536
24705,38274,9329,18520,7839,28945,4952,2416,2536
24710,38284,9333,18526,7842,28951,4953,2416,2537
24715,38290,9334,18528,7843,28956,4955,2417,2538
24720,38301,9336,18533,7844,28961,4956,2417,2539
24725,38305,9340,18533,7848,28965,4956,2417,2539
24730,38315,9346,18539,7852,28968,4957,2418,2539
24735,38321,9347,18542,7853,28971,4959,2418,2541
24740,38332,9353,18547,7859,28977,4960,2418,2542
24745,38336,9356,18548,7862,28980,4960,2418,2542
24750,38346,9362,18554,7867,28983,4961,2418,2543
24755,38352,9364,18557,7869,28987,4963,2419,2544
24760,38363,9368,18561,7872,28994,4964,2420,2544
24765,38367,9370,18563,7874,28996,4964,2420,2544
24770,38377,9376,18568,7879,29001,4965,2421,2544
24775,38383,9377,18572,7880,29006,4967,2423,2544
24780,38394,9378,18577,7880,29013,4968,2424,2544
24785,38398,9380,18578,7882,29018,4968,2424,2544
24790,38408,9382,18583,7884,29025,4969,2424,2545
24795,38414,9384,18585,7886,29030,4971,2425,2546
24800,38425,9384,18591,7886,29039,4972,2425,2547
24805,38429,9385,18592,7887,29044,4972,2425,2547
24810,38439,9386,18597,7888,29052,4973,2425,2548
24815,38445,9387,18601,7889,29058,4975,2426,2549
24820,38456,9388,18608,7890,29067,4976,2427,2549
24825,38460,9389,18608,7891,29071,4976,2427,2549
24830,38470,9390,18611,7891,29079,4977,2427,2550
24835,38476,9390,18612,7891,29086,4979,2428,2551
24840,38487,9391,18614,7892,29096,4980,2428,2552
24845,38491,9391,18614,7892,29100,4980,2428,2552
24850,38501,9392,18621,7893,29109,4981,2429,2552
24855,38507,9393,18623,7894,29114,4983,2429,2554
24860,38518,9394,18629,7895,29122,4984,2429,2555
24865,38522,9395,18631,7896,29127,4984,2429,2555
24870,38532,9396,18636,7896,29135,4985,2429,2556
24875,38538,9396,18638,7896,29141,4987,2430,2557
24880,38549,9396,18642,7896,29152,4988,2431,2557
24885,38553,9397,18645,7897,29155,4988,2431,2557
24890,38563,9399,18650,7898,29163,4989,2432,2557
24895,38569,9400,18653,7899,29168,4991,2433,2558
24900,38580,9403,18658,7902,29175,4992,2434,2558
24905,38584,9406,18659,7905,29178,4992,2434,2558
24910,38594,9411,18664,7910,29183,4993,2434,2559
24915,38600,9411,18668,7910,29188,4995,2436,2559
24920,38611,9414,18671,7913,29196,4996,2436,2560
24925,38615,9415,18673,7914,29199,4996,2436,2560
24930,38625,9420,18680,7918,29205,4997,2437,2560
24935,38631,9421,18682,7919,29209,4999,2437,2562
24940,38642,9425,18687,7922,29214,5000,2437,2563
24945,38646,9427,18687,7924,29219,5000,2437,2563
24950,38656,9431,18693,7926,29224,5001,2438,2563
24955,38662,9433,18697,7928,29229,5003,2440,2563
24960,38673,9435,18700,7929,29236,5004,2440,2564
24965,38677,9438,18703,7932,29239,5004,2440,2564
24970,38687,9440,18705,7933,29247,5005,2441,2564
24975,38693,9440,18707,7933,29252,5007,2441,2566
24980,38704,9444,18711,7937,29259,5008,2441,2567
24985,38708,9446,18712,7939,29262,5008,2441,2567
24990,38718,9450,18717,7942,29268,5009,2441,2568
24995,38724,9451,18722,7943,29273,5011,2443,2568
25000,38735,9455,18730,7947,29277,5012,2444,2568
25005,38739,9457,18732,7949,29281,5012,2444,2568
25010,38749,9462,18738,7953,29287,5013,2444,2569
25015,38755,9463,18741,7954,29290,5015,2444,2571
25020,38766,9470,18749,7961,29294,5016,2445,2571
25025,38770,9473,18751,7964,29296,5016,2445,2571
25030,38780,9477,18756,7966,29302,5017,2446,2571
25035,38786,9478,18758,7967,29308,5019,2446,2573
25040,38797,9479,18760,7968,29317,5020,2446,2574
25045,38801,9480,18762,7969,29321,5020,2446,2574
25050,38811,9483,18766,7972,29328,5021,2447,2574
25055,38817,9484,18770,7973,29332,5023,2448,2575
25060,38828,9485,18774,7974,29341,5024,2448,2576
25065,38832,9486,18777,7975,29346,5024,2448,2576
25070,38842,9487,18783,7975,29355,5025,2449,2576
25075,38848,9487,18786,7975,29360,5027,2449,2578
25080,38859,9488,18794,7976,29369,5028,2450,2578
25085,38863,9489,18796,7977,29374,5028,2450,2578
25090,38873,9489,18804,7977,29383,5029,2450,2579
25095,38879,9489,18807,7977,29389,5031,2451,2580
25100,38890,9489,18813,7977,29401,5032,2452,2580
25105,38894,9489,18816,7977,29405,5032,2452,2580
25110,38904,9489,18822,7977,29414,5033,2452,2581
25115,38910,9489,18822,7977,29421,5035,2452,2583
25120,38921,9489,18827,7977,29431,5036,2453,2583
25125,38925,9489,18828,7977,29436,5036,2453,2583
25130,38935,9489,18834,7977,29446,5037,2454,2583
25135,38941,9489,18837,7977,29452,5039,2455,2584
25140,38952,9490,18845,7978,29459,5040,2456,2584
25145,38956,9493,18846,7981,29463,5040,2456,2584
25150,38966,9496,18851,7983,29469,5041,2456,2585
25155,38972,9496,18855,7983,29474,5043,2458,2585
25160,38983,9499,18859,7986,29482,5044,2458,2586
25165,38987,9502,18861,7989,29484,5044,2458,2586
25170,38997,9506,18868,7992,29491,5045,2459,2586
25175,39003,9506,18870,7992,29497,5047,2459,2588
25180,39014,9507,18872,7993,29506,5048,2459,2589
25185,39018,9508,18875,7994,29510,5048,2459,2589
25190,39028,9512,18881,7997,29515,5049,2459,2590
25195,39034,9513,18886,7998,29519,5051,2461,2590
25200,39045,9517,18895,8002,29524,5052,2462,2590
25205,39049,9521,18896,8006,29528,5052,2462,2590
25210,39059,9524,18900,8008,29535,5053,2463,2590
25215,39065,9525,18902,8009,29540,5055,2464,2591
25220,39076,9527,18908,8011,29545,5056,2464,2592
25225,39080,9531,18911,8015,29548,5056,2464,2592
25230,39090,9534,18915,8016,29555,5057,2465,2592
25235,39096,9536,18919,8018,29560,5059,2466,2593
25240,39107,9537,18923,8019,29567,5060,2466,2594
25245,39111,9539,18924,8021,29572,5060,2466,2594
25250,39121,9542,18929,8022,29579,5061,2466,2595
25255,39127,9542,18931,8022,29585,5063,2467,2596
25260,39138,9545,18938,8025,29589,5064,2467,2597
25265,39142,9548,18940,8028,29594,5064,2467,2597
25270,39152,9550,18942,8028,29602,5065,2467,2598
25275,39158,9551,18947,8029,29606,5067,2469,2598
25280,39169,9554,18953,8032,29613,5068,2470,2598
25285,39173,9555,18955,8033,29618,5068,2470,2598
25290,39183,9557,18961,8033,29625,5069,2471,2598
25295,39189,9557,18964,8033,29631,5071,2472,2599
25300,39200,9559,18971,8035,29638,5072,2473,2599
25305,39204,9560,18973,8036,29643,5072,2473,2599
25310,39214,9563,18979,8039,29650,5073,2473,2600
25315,39220,9563,18983,8039,29656,5075,2475,2600
25320,39231,9565,18988,8041,29663,5076,2475,2601
25325,39235,9567,18990,8043,29668,5076,2475,2601
25330,39245,9569,18994,8043,29675,5077,2475,2602
25335,39251,9569,18996,8043,29681,5079,2476,2603
25340,39262,9570,19000,8044,29690,5080,2477,2603
25345,39266,9571,19000,8045,29695,5080,2477,2603
25350,39276,9575,19007,8048,29700,5081,2478,2603
25355,39282,9575,19009,8048,29706,5083,2479,2604
25360,39293,9578,19015,8051,29713,5084,2480,2604
25365,39297,9580,19018,8053,29717,5084,2480,2604
25370,39307,9581,19023,8053,29725,5085,2480,2605
25375,39313,9583,19026,8055,29729,5087,2481,2606
25380,39324,9586,19033,8058,29736,5088,2482,2606
25385,39328,9589,19036,8061,29738,5088,2482,2606
25390,39338,9591,19042,8063,29746,5089,2483,2606
25395,39344,9593,19046,8065,29749,5091,2484,2607
25400,39355,9595,19054,8067,29756,5092,2484,2608
25405,39359,9599,19058,8071,29759,5092,2484,2608
25410,39369,9602,19063,8073,29767,5093,2484,2609
25415,39375,9603,19066,8074,29772,5095,2485,2610
25420,39386,9605,19070,8075,29781,5096,2486,2610
25425,39390,9605,19072,8075,29785,5096,2486,2610
25430,39400,9608,19075,8077,29792,5097,2486,2611
25435,39406,9609,19079,8078,29797,5099,2487,2612
25440,39417,9611,19083,8079,29804,5100,2487,2613
25445,39421,9614,19085,8082,29807,5100,2487,2613
25450,39431,9616,19090,8083,29814,5101,2487,2614
25455,39437,9617,19092,8084,29820,5103,2488,2615
25460,39448,9620,19096,8087,29828,5104,2488,2616
25465,39452,9621,19098,8088,29831,5104,2488,2616
25470,39462,9624,19102,8090,29837,5105,2488,2617
25475,39468,9626,19108,8092,29841,5107,2490,2617
25480,39479,9628,19113,8094,29850,5108,2491,2617
25485,39483,9629,19114,8095,29854,5108,2491,2617
25490,39493,9631,19120,8096,29861,5109,2491,2618
25495,39499,9632,19125,8097,29866,5111,2493,2618
25500,39510,9634,19133,8099,29874,5112,2493,2619
25505,39514,9636,19134,8101,29878,5112,2493,2619
25510,39524,9638,19139,8102,29886,5113,2494,2619
25515,39530,9639,19144,8103,29889,5115,2495,2620
25520,39541,9641,19150,8105,29899,5116,2495,2621
25525,39545,9641,19152,8105,29903,5116,2495,2621
25530,39555,9643,19158,8107,29912,5117,2496,2621
25535,39561,9644,19162,8108,29916,5119,2498,2621
25540,39572,9645,19165,8109,29927,5120,2499,2621
25545,39576,9645,19167,8109,29930,5120,2499,2621
25550,39586,9650,19170,8113,29936,5121,2499,2622
25555,39592,9651,19172,8114,29941,5123,2500,2623
25560,39603,9652,19177,8115,29950,5124,2501,2623
25565,39607,9653,19179,8116,29954,5124,2501,2623
25570,39617,9657,19186,8119,29958,5125,2501,2624
25575,39623,9659,19191,8121,29962,5127,2503,2624
25580,39634,9662,19194,8124,29970,5128,2503,2625
25585,39638,9665,19196,8127,29973,5128,2503,2625
25590,39648,9669,19203,8130,29978,5129,2503,2626
25595,39654,9669,19206,8130,29985,5131,2504,2627
25600,39665,9673,19213,8133,29988,5132,2504,2628
25605,39669,9677,19215,8137,29992,5132,2504,2628
25610,39679,9680,19217,8139,29998,5133,2504,2629
25615,39685,9680,19221,8139,30004,5135,2505,2630
25620,39696,9685,19227,8143,30009,5136,2506,2630
25625,39700,9688,19229,8146,30012,5136,2506,2630
25630,39710,9689,19235,8147,30020,5137,2507,2630
25635,39716,9690,19237,8148,30026,5139,2508,2631
25640,39727,9693,19243,8150,30032,5140,2508,2632
25645,39731,9694,19246,8151,30037,5140,2508,2632
25650,39741,9695,19252,8152,30045,5141,2509,2632
25655,39747,9695,19255,8152,30052,5143,2510,2633
25660,39758,9696,19259,8152,30059,5144,2510,2634
25665,39762,9699,19260,8155,30063,5144,2510,2634
25670,39772,9701,19263,8157,30070,5145,2510,2635
25675,39778,9701,19265,8157,30077,5147,2511,2636
25680,39789,9703,19267,8159,30086,5148,2511,2637
25685,39793,9703,19268,8159,30090,5148,2511,2637
25690,39803,9706,19275,8162,30096,5149,2511,2638
25695,39809,9708,19277,8164,30100,5151,2511,2640
25700,39820,9710,19286,8166,30106,5152,2512,2640
25705,39824,9712,19287,8168,30111,5152,2512,2640
25710,39834,9713,19295,8168,30120,5153,2513,2640
25715,39840,9714,19297,8169,30126,5155,2514,2641
25720,39851,9715,19300,8170,30135,5156,2514,2642
25725,39855,9716,19302,8171,30138,5156,2514,2642
25730,39865,9720,19307,8174,30143,5157,2514,2643
25735,39871,9721,19307,8175,30150,5159,2514,2645
25740,39882,9722,19311,8176,30158,5160,2514,2646
25745,39886,9724,19314,8178,30160,5160,2514,2646
25750,39896,9729,19320,8182,30166,5161,2515,2646
25755,39902,9730,19325,8183,30171,5163,2517,2646
25760,39913,9731,19327,8184,30181,5164,2517,2647
25765,39917,9732,19329,8185,30185,5164,2517,2647
25770,39927,9734,19332,8186,30192,5165,2517,2648
25775,39933,9734,19335,8186,30197,5167,2518,2649
25780,39944,9735,19338,8187,30208,5168,2518,2650
25785,39948,9736,19340,8188,30212,5168,2518,2650
25790,39958,9738,19343,8189,30219,5169,2518,2651
25795,39964,9739,19346,8190,30224,5171,2518,2653
25800,39975,9739,19350,8190,30234,5172,2519,2653
25805,39979,9740,19352,8191,30238,5172,2519,2653
25810,39989,9742,19354,8192,30246,5173,2519,2654
25815,39995,9742,19357,8192,30252,5175,2520,2655
25820,40006,9745,19361,8194,30259,5176,2520,2656
25825,40010,9747,19363,8196,30263,5176,2520,2656
25830,40020,9750,19368,8197,30269,5177,2520,2657
25835,40026,9750,19369,8197,30275,5179,2520,2659
25840,40037,9753,19375,8200,30280,5180,2520,2660
25845,40041,9757,19378,8204,30284,5180,2520,2660
25850,40051,9760,19385,8207,30290,5181,2521,2660
25855,40057,9762,19391,8209,30294,5183,2523,2660
25860,40068,9767,19399,8214,30297,5184,2523,2661
25865,40072,9771,19402,8218,30300,5184,2523,2661
25870,40082,9774,19406,8220,30307,5185,2523,2662
25875,40088,9775,19407,8221,30313,5187,2523,2664
25880,40099,9776,19409,8221,30322,5188,2523,2665
25885,40103,9777,19411,8222,30325,5188,2523,2665
25890,40113,9781,19415,8224,30331,5189,2523,2666
25895,40119,9782,19418,8225,30336,5191,2524,2667
25900,40130,9786,19425,8228,30341,5192,2525,2667
25905,40134,9791,19428,8233,30342,5192,2525,2667
25910,40144,9795,19433,8236,30348,5193,2525,2668
25915,40150,9797,19435,8238,30352,5195,2525,2670
25920,40161,9801,19441,8242,30357,5196,2525,2671
25925,40165,9804,19442,8245,30361,5196,2525,2671
25930,40175,9806,19446,8246,30368,5197,2525,2672
25935,40181,9807,19449,8247,30374,5199,2525,2674
25940,40192,9809,19456,8249,30381,5200,2526,2674
25945,40196,9811,19456,8251,30385,5200,2526,2674
25950,40206,9812,19459,8252,30393,5201,2526,2675
25955,40212,9812,19462,8252,30400,5203,2527,2676
25960,40223,9812,19464,8252,30410,5204,2527,2677
25965,40227,9812,19467,8252,30415,5204,2527,2677
25970,40237,9813,19470,8252,30423,5205,2528,2677
25975,40243,9814,19474,8253,30428,5207,2529,2678
25980,40254,9815,19481,8254,30437,5208,2530,2678
25985,40258,9816,19482,8255,30442,5208,2530,2678
25990,40268,9817,19487,8255,30450,5209,2531,2678
25995,40274,9817,19490,8255,30455,5211,2531,2680
26000,40285,9817,19494,8255,30467,5212,2532,2680
26005,40289,9818,19496,8256,30470,5212,2532,2680
26010,40299,9819,19499,8257,30479,5213,2532,2681
26015,40305,9820,19504,8258,30483,5215,2534,2681
26020,40316,9821,19511,8259,30494,5216,2535,2681
26025,40320,9821,19512,8259,30499,5216,2535,2681
26030,40330,9824,19517,8261,30504,5217,2536,2681
26035,40336,9825,19519,8262,30509,5219,2536,2683
26040,40347,9828,19524,8265,30518,5220,2537,2683
26045,40351,9830,19528,8267,30519,5220,2537,2683
26050,40361,9835,19535,8272,30525,5221,2538,2683
26055,40367,9836,19537,8273,30529,5223,2538,2685
26060,40378,9838,19538,8274,30539,5224,2538,2686
26065,40382,9839,19538,8275,30543,5224,2538,2686
26070,40392,9843,19544,8279,30548,5225,2538,2687
26075,40398,9843,19547,8279,30554,5227,2540,2687
26080,40409,9847,19553,8282,30560,5228,2540,2688
26085,40413,9848,19554,8283,30565,5228,2540,2688
26090,40423,9851,19557,8285,30571,5229,2540,2689
26095,40429,9851,19560,8285,30578,5231,2542,2689
26100,40440,9854,19563,8287,30585,5232,2542,2690
26105,40444,9856,19564,8289,30588,5232,2542,2690
26110,40454,9858,19570,8291,30595,5233,2543,2690
26115,40460,9860,19573,8293,30600,5235,2544,2691
26120,40471,9863,19582,8296,30603,5236,2545,2691
26125,40475,9868,19583,8301,30607,5236,2545,2691
26130,40485,9870,19587,8302,30614,5237,2545,2692
26135,40491,9871,19592,8303,30619,5239,2547,2692
26140,40502,9875,19598,8306,30623,5240,2547,2693
26145,40506,9879,19598,8310,30627,5240,2547,2693
26150,40516,9881,19603,8312,30634,5241,2547,2694
26155,40522,9881,19605,8312,30641,5243,2548,2695
26160,40533,9883,19609,8313,30647,5244,2548,2696
26165,40537,9886,19610,8316,30650,5244,2548,2696
26170,40547,9888,19611,8317,30658,5245,2548,2697
26175,40553,9888,19615,8317,30664,5247,2550,2697
26180,40564,9891,19619,8319,30671,5248,2550,2698
26185,40568,9895,19621,8323,30673,5248,2550,2698
26190,40578,9897,19628,8325,30680,5249,2550,2699
26195,40584,9898,19631,8326,30686,5251,2551,2700
26200,40595,9899,19635,8327,30694,5252,2552,2700
26205,40599,9902,19637,8330,30696,5252,2552,2700
26210,40609,9906,19642,8333,30702,5253,2552,2701
26215,40615,9906,19644,8333,30708,5255,2552,2703
26220,40626,9911,19650,8337,30715,5256,2553,2703
26225,40630,9912,19653,8338,30718,5256,2553,2703
26230,40640,9912,19655,8338,30727,5257,2553,2704
26235,40646,9912,19657,8338,30733,5259,2554,2705
26240,40657,9912,19664,8338,30744,5260,2554,2706
26245,40661,9912,19664,8338,30749,5260,2554,2706
26250,40671,9912,19667,8338,30758,5261,2555,2706
26255,40677,9912,19669,8338,30764,5263,2555,2708
26260,40688,9912,19672,8338,30775,5264,2555,2709
26265,40692,9912,19675,8338,30779,5264,2555,2709
26270,40702,9913,19679,8338,30788,5265,2555,2710
26275,40708,9913,19681,8338,30794,5267,2556,2711
26280,40719,9913,19683,8338,30805,5268,2556,2712
26285,40723,9913,19686,8338,30810,5268,2556,2712
26290,40733,9914,19691,8338,30819,5269,2557,2712
26295,40739,9914,19693,8338,30824,5271,2557,2714
26300,40750,9915,19699,8339,30833,5272,2557,2715
26305,40754,9916,19700,8340,30837,5272,2557,2715
26310,40764,9917,19705,8341,30847,5273,2557,2716
26315,40770,9917,19708,8341,30852,5275,2557,2718
26320,40781,9918,19714,8342,30863,5276,2558,2718
26325,40785,9918,19716,8342,30867,5276,2558,2718
26330,40795,9922,19725,8345,30872,5277,2559,2718
26335,40801,9924,19727,8347,30877,5279,2560,2719
26340,40812,9927,19730,8349,30884,5280,2560,2720
26345,40816,9928,19732,8350,30888,5280,2560,2720
26350,40826,9931,19736,8352,30894,5281,2560,2721
26355,40832,9932,19737,8353,30900,5283,2561,2722
26360,40843,9934,19742,8355,30906,5284,2561,2723
26365,40847,9938,19746,8359,30908,5284,2561,2723
26370,40857,9942,19752,8361,30914,5285,2561,2724
26375,40863,9943,19757,8362,30919,5287,2563,2724
26380,40874,9945,19761,8363,30926,5288,2564,2724
26385,40878,9948,19763,8366,30930,5288,2564,2724
26390,40888,9951,19768,8368,30936,5289,2565,2724
26395,40894,9953,19772,8370,30940,5291,2566,2725
26400,40905,9956,19776,8372,30947,5292,2567,2725
26405,40909,9957,19778,8373,30952,5292,2567,2725
26410,40919,9960,19784,8376,30959,5293,2567,2726
26415,40925,9960,19788,8376,30964,5295,2568,2727
26420,40936,9964,19792,8379,30970,5296,2568,2728
26425,40940,9967,19796,8382,30972,5296,2568,2728
26430,40950,9971,19802,8385,30978,5297,2569,2728
26435,40956,9973,19804,8387,30983,5299,2569,2730
26440,40967,9975,19807,8388,30990,5300,2569,2731
26445,40971,9977,19808,8390,30994,5300,2569,2731
26450,40981,9980,19812,8392,31001,5301,2570,2731
26455,40987,9980,19815,8392,31006,5303,2571,2732
26460,40998,9985,19822,8397,31010,5304,2571,2733
26465,41002,9987,19824,8399,31015,5304,2571,2733
26470,41012,9989,19829,8400,31023,5305,2572,2733
26475,41018,9989,19831,8400,31028,5307,2573,2734
26480,41029,9993,19839,8404,31034,5308,2574,2734
26485,41033,9996,19842,8407,31037,5308,2574,2734
26490,41043,10000,19849,8411,31042,5309,2574,2735
26495,41049,10001,19852,8412,31047,5311,2575,2736
26500,41060,10004,19859,8415,31055,5312,2575,2737
26505,41064,10005,19863,8416,31059,5312,2575,2737
26510,41074,10006,19867,8417,31067,5313,2575,2738
26515,41080,10007,19870,8418,31073,5315,2576,2739
26520,41091,10007,19877,8418,31083,5316,2576,2740
26525,41095,10007,19880,8418,31088,5316,2576,2740
26530,41105,10008,19883,8419,31097,5317,2576,2741
26535,41111,10009,19886,8420,31102,5319,2577,2742
26540,41122,10010,19894,8421,31111,5320,2577,2743
26545,41126,10011,19897,8422,31115,5320,2577,2743
26550,41136,10012,19902,8423,31124,5321,2577,2744
26555,41142,10013,19905,8424,31128,5323,2577,2746
26560,41153,10014,19911,8425,31139,5324,2578,2746
26565,41157,10014,19912,8425,31143,5324,2578,2746
26570,41167,10016,19918,8426,31150,5325,2578,2747
26575,41173,10018,19923,8428,31153,5327,2579,2748
26580,41184,10021,19932,8431,31160,5328,2580,2748
26585,41188,10024,19935,8434,31163,5328,2580,2748
26590,41198,10026,19943,8436,31171,5329,2581,2748
26595,41204,10028,19944,8438,31176,5331,2581,2750
26600,41215,10030,19948,8440,31183,5332,2581,2751
26605,41219,10033,19951,8443,31185,5332,2581,2751
26610,41229,10038,19956,8448,31190,5333,2581,2752
26615,41235,10040,19960,8450,31194,5335,2583,2752
26620,41246,10041,19963,8451,31204,5336,2583,2753
26625,41250,10042,19964,8452,31208,5336,2583,2753
26630,41260,10044,19970,8454,31215,5337,2583,2754
26635,41266,10045,19973,8455,31220,5339,2585,2754
26640,41277,10048,19979,8457,31226,5340,2586,2754
26645,41281,10050,19980,8459,31231,5340,2586,2754
26650,41291,10054,19987,8462,31236,5341,2586,2755
26655,41297,10056,19989,8464,31241,5343,2587,2756
26660,41308,10058,19993,8465,31248,5344,2588,2756
26665,41312,10060,19995,8467,31251,5344,2588,2756
26670,41322,10063,19998,8469,31259,5345,2588,2757
26675,41328,10064,20000,8470,31263,5347,2588,2759
26680,41339,10069,20009,8475,31267,5348,2589,2759
26685,41343,10071,20011,8477,31271,5348,2589,2759
26690,41353,10073,20015,8478,31280,5349,2590,2759
26695,41359,10074,20018,8479,31285,5351,2592,2759
26700,41370,10076,20024,8481,31291,5352,2592,2760
26705,41374,10078,20026,8483,31295,5352,2592,2760
26710,41384,10080,20032,8483,31303,5353,2593,2760
26715,41390,10080,20033,8483,31310,5355,2593,2762
26720,41401,10081,20036,8484,31320,5356,2593,2763
26725,41405,10082,20037,8485,31323,5356,2593,2763
26730,41415,10084,20040,8486,31331,5357,2594,2763
26735,41421,10085,20045,8487,31335,5359,2595,2764
26740,41432,10087,20048,8489,31345,5360,2595,2765
26745,41436,10087,20050,8489,31348,5360,2595,2765
26750,41446,10090,20052,8490,31356,5361,2595,2766
26755,41452,10091,20056,8491,31361,5363,2597,2766
26760,41463,10092,20058,8492,31371,5364,2597,2767
26765,41467,10092,20058,8492,31375,5364,2597,2767
26770,41477,10094,20061,8492,31383,5365,2597,2768
26775,41483,10095,20064,8493,31387,5367,2598,2769
26780,41494,10096,20067,8494,31397,5368,2598,2770
26785,41498,10098,20070,8496,31400,5368,2598,2770
26790,41508,10100,20076,8496,31407,5369,2599,2770
26795,41514,10101,20078,8497,31413,5371,2599,2772
26800,41525,10103,20084,8499,31419,5372,2599,2773
26805,41529,10105,20086,8501,31424,5372,2599,2773
26810,41539,10109,20091,8503,31430,5373,2599,2774
26815,41545,10109,20094,8503,31435,5375,2600,2775
26820,41556,10111,20099,8505,31442,5376,2601,2775
26825,41560,10115,20102,8509,31443,5376,2601,2775
26830,41570,10122,20107,8516,31448,5377,2601,2776
26835,41576,10122,20109,8516,31453,5379,2602,2777
26840,41587,10126,20116,8520,31457,5380,2602,2778
26845,41591,10132,20120,8526,31458,5380,2602,2778
26850,41601,10134,20127,8528,31466,5381,2603,2778
26855,41607,10136,20131,8530,31469,5383,2604,2779
26860,41618,10138,20137,8532,31478,5384,2605,2779
26865,41622,10139,20139,8533,31483,5384,2605,2779
26870,41632,10140,20144,8534,31492,5385,2605,2780
26875,41638,10140,20146,8534,31496,5387,2605,2782
26880,41649,10142,20151,8536,31506,5388,2605,2783
26885,41653,10143,20153,8537,31510,5388,2605,2783
26890,41663,10146,20158,8540,31516,5389,2606,2783
26895,41669,10147,20160,8541,31522,5391,2606,2785
26900,41680,10149,20167,8542,31528,5392,2607,2785
26905,41684,10151,20169,8544,31533,5392,2607,2785
26910,41694,10153,20173,8545,31541,5393,2608,2785
26915,41700,10153,20176,8545,31547,5395,2609,2786
26920,41711,10156,20184,8548,31554,5396,2610,2786
26925,41715,10158,20186,8550,31557,5396,2610,2786
26930,41725,10160,20191,8551,31564,5397,2611,2786
26935,41731,10162,20195,8553,31569,5399,2613,2786
26940,41742,10164,20202,8555,31577,5400,2614,2786
26945,41746,10166,20204,8557,31580,5400,2614,2786
26950,41756,10167,20209,8558,31589,5401,2615,2786
26955,41762,10168,20213,8559,31594,5403,2616,2787
26960,41773,10170,20218,8561,31602,5404,2617,2787
26965,41777,10170,20219,8561,31607,5404,2617,2787
26970,41787,10172,20223,8563,31615,5405,2617,2788
26975,41793,10172,20226,8563,31620,5407,2619,2788
26980,41804,10173,20228,8564,31630,5408,2619,2789
26985,41808,10173,20232,8564,31635,5408,2619,2789
26990,41818,10176,20236,8566,31641,5409,2619,2790
26995,41824,10176,20238,8566,31647,5411,2619,2792
27000,41835,10179,20243,8569,31655,5412,2620,2792
27005,41839,10180,20246,8570,31658,5412,2620,2792
27010,41849,10185,20250,8573,31664,5413,2621,2792
27015,41855,10185,20253,8573,31669,5415,2623,2792
27020,41866,10187,20259,8575,31678,5416,2624,2792
27025,41870,10187,20261,8575,31681,5416,2624,2792
27030,41880,10193,20265,8580,31687,5417,2625,2792
27035,41886,10193,20267,8580,31692,5419,2626,2793
27040,41897,10196,20274,8583,31699,5420,2626,2794
27045,41901,10199,20275,8586,31702,5420,2626,2794
27050,41911,10203,20280,8589,31707,5421,2626,2795
27055,41917,10204,20283,8590,31712,5423,2627,2796
27060,41928,10207,20289,8593,31719,5424,2627,2797
27065,41932,10208,20290,8594,31724,5424,2627,2797
27070,41942,10210,20295,8595,31731,5425,2628,2797
27075,41948,10211,20297,8596,31737,5427,2629,2798
27080,41959,10213,20301,8598,31745,5428,2629,2799
27085,41963,10214,20302,8599,31748,5428,2629,2799
27090,41973,10215,20306,8600,31757,5429,2630,2799
27095,41979,10216,20309,8601,31762,5431,2631,2800
27100,41990,10218,20316,8603,31769,5432,2631,2801
27105,41994,10221,20317,8606,31773,5432,2631,2801
27110,42004,10223,20323,8607,31780,5433,2631,2802
27115,42010,10224,20327,8608,31786,5435,2633,2802
27120,42021,10225,20330,8608,31794,5436,2633,2803
27125,42025,10228,20332,8611,31797,5436,2633,2803
27130,42035,10230,20336,8613,31805,5437,2633,2804
27135,42041,10230,20338,8613,31810,5439,2633,2806
27140,42052,10232,20343,8615,31818,5440,2633,2807
27145,42056,10233,20344,8616,31823,5440,2633,2807
27150,42066,10235,20351,8618,31830,5441,2634,2807
27155,42072,10236,20354,8619,31836,5443,2636,2807
27160,42083,10238,20358,8621,31845,5444,2637,2807
27165,42087,10238,20359,8621,31849,5444,2637,2807
27170,42097,10240,20364,8623,31857,5445,2638,2807
27175,42103,10240,20366,8623,31862,5447,2638,2809
27180,42114,10245,20372,8628,31867,5448,2638,2810
27185,42118,10247,20374,8630,31871,5448,2638,2810
27190,42128,10250,20377,8632,31878,5449,2638,2811
27195,42134,10251,20381,8633,31883,5451,2639,2812
27200,42145,10253,20387,8635,31889,5452,2640,2812
27205,42149,10256,20388,8638,31893,5452,2640,2812
27210,42159,10258,20393,8638,31900,5453,2640,2813
27215,42165,10258,20396,8638,31907,5455,2641,2814
27220,42176,10259,20402,8639,31914,5456,2641,2815
27225,42180,10261,20406,8641,31918,5456,2641,2815
27230,42190,10264,20413,8644,31925,5457,2642,2815
27235,42196,10265,20415,8645,31931,5459,2643,2816
27240,42207,10266,20420,8646,31939,5460,2643,2817
27245,42211,10269,20424,8649,31941,5460,2643,2817
27250,42221,10272,20430,8651,31949,5461,2644,2817
27255,42227,10272,20432,8651,31955,5463,2646,2817
27260,42238,10275,20440,8654,31960,5464,2646,2818
27265,42242,10278,20443,8657,31962,5464,2646,2818
27270,42252,10283,20447,8660,31968,5465,2647,2818
27275,42258,10283,20450,8660,31973,5467,2648,2819
27280,42269,10285,20452,8662,31983,5468,2648,2820
27285,42273,10286,20455,8663,31986,5468,2648,2820
27290,42283,10290,20461,8666,31993,5469,2649,2820
27295,42289,10290,20464,8666,31998,5471,2650,2821
27300,42300,10291,20470,8667,32007,5472,2650,2822
27305,42304,10291,20471,8667,32013,5472,2650,2822
27310,42314,10292,20475,8667,32021,5473,2651,2822
27315,42320,10293,20478,8668,32025,5475,2652,2823
27320,42331,10296,20484,8670,32033,5476,2652,2824
27325,42335,10298,20486,8672,32037,5476,2652,2824
27330,42345,10300,20493,8673,32044,5477,2652,2825
27335,42351,10302,20494,8675,32049,5479,2652,2827
27340,42362,10303,20499,8676,32058,5480,2653,2827
27345,42366,10304,20501,8677,32061,5480,2653,2827
27350,42376,10306,20505,8679,32070,5481,2653,2828
27355,42382,10306,20508,8679,32075,5483,2654,2829
27360,42393,10308,20512,8680,32084,5484,2654,2830
27365,42397,10309,20513,8681,32087,5484,2654,2830
27370,42407,10310,20519,8682,32096,5485,2654,2831
27375,42413,10312,20522,8684,32101,5487,2655,2832
27380,42424,10313,20527,8684,32109,5488,2655,2833
27385,42428,10315,20527,8686,32113,5488,2655,2833
27390,42438,10317,20531,8687,32120,5489,2655,2834
27395,42444,10318,20534,8688,32124,5491,2655,2836
27400,42455,10323,20543,8692,32128,5492,2656,2836
27405,42459,10327,20544,8696,32132,5492,2656,2836
27410,42469,10330,20550,8698,32138,5493,2657,2836
27415,42475,10331,20552,8699,32143,5495,2658,2837
27420,42486,10333,20556,8701,32152,5496,2659,2837
27425,42490,10334,20557,8702,32156,5496,2659,2837
27430,42500,10337,20562,8703,32162,5497,2659,2838
27435,42506,10338,20565,8704,32168,5499,2661,2838
27440,42517,10340,20570,8706,32175,5500,2662,2838
27445,42521,10344,20572,8710,32177,5500,2662,2838
27450,42531,10347,20579,8713,32183,5501,2663,2838
27455,42537,10349,20583,8715,32187,5503,2664,2839
27460,42548,10352,20589,8718,32192,5504,2664,2840
27465,42552,10355,20591,8721,32196,5504,2664,2840
27470,42562,10359,20594,8724,32203,5505,2664,2841
27475,42568,10360,20598,8725,32207,5507,2665,2842
27480,42579,10364,20605,8728,32211,5508,2666,2842
27485,42583,10367,20608,8731,32216,5508,2666,2842
27490,42593,10369,20614,8733,32223,5509,2666,2843
27495,42599,10370,20618,8734,32228,5511,2667,2844
27500,42610,10372,20620,8736,32238,5512,2667,2845
27505,42614,10372,20621,8736,32242,5512,2667,2845
27510,42624,10374,20623,8736,32250,5513,2668,2845
27515,42630,10374,20625,8736,32255,5515,2669,2846
27520,42641,10376,20632,8738,32261,5516,2670,2846
27525,42645,10379,20635,8741,32265,5516,2670,2846
27530,42655,10382,20639,8743,32272,5517,2671,2846
27535,42661,10382,20643,8743,32276,5519,2672,2847
27540,42672,10386,20649,8747,32284,5520,2673,2847
27545,42676,10387,20651,8748,32289,5520,2673,2847
27550,42686,10388,20653,8748,32298,5521,2674,2847
27555,42692,10388,20656,8748,32302,5523,2675,2848
27560,42703,10389,20659,8749,32313,5524,2676,2848
27565,42707,10389,20662,8749,32317,5524,2676,2848
27570,42717,10390,20668,8749,32326,5525,2677,2848
27575,42723,10390,20669,8749,32332,5527,2677,2850
27580,42734,10391,20676,8750,32342,5528,2678,2850
27585,42738,10392,20679,8751,32346,5528,2678,2850
27590,42748,10395,20685,8753,32352,5529,2679,2850
27595,42754,10396,20687,8754,32358,5531,2681,2850
27600,42765,10397,20691,8754,32366,5532,2682,2850
27605,42769,10400,20693,8757,32369,5532,2682,2850
27610,42779,10402,20698,8759,32377,5533,2683,2850
27615,42785,10402,20700,8759,32383,5535,2684,2851
27620,42796,10404,20707,8761,32390,5536,2685,2851
27625,42800,10406,20708,8763,32394,5536,2685,2851
27630,42810,10408,20712,8764,32402,5537,2686,2851
27635,42816,10409,20717,8765,32407,5539,2688,2851
27640,42827,10410,20723,8766,32416,5540,2689,2851
27645,42831,10411,20725,8767,32420,5540,2689,2851
27650,42841,10416,20729,8770,32425,5541,2690,2851
27655,42847,10416,20733,8770,32429,5543,2692,2851
27660,42858,10423,20741,8777,32433,5544,2692,2852
27665,42862,10426,20742,8780,32436,5544,2692,2852
27670,42872,10430,20750,8784,32441,5545,2693,2852
27675,42878,10431,20752,8785,32446,5547,2694,2853
27680,42889,10435,20757,8789,32452,5548,2694,2854
27685,42893,10437,20757,8791,32456,5548,2694,2854
27690,42903,10441,20760,8793,32461,5549,2694,2855
27695,42909,10442,20762,8794,32467,5551,2696,2855
27700,42920,10444,20767,8795,32473,5552,2697,2855
27705,42924,10448,20768,8799,32476,5552,2697,2855
27710,42934,10453,20774,8803,32480,5553,2698,2855
27715,42940,10454,20776,8804,32485,5555,2699,2856
27720,42951,10459,20782,8809,32490,5556,2699,2857
27725,42955,10460,20784,8810,32495,5556,2699,2857
27730,42965,10461,20790,8810,32504,5557,2700,2857
27735,42971,10461,20792,8810,32510,5559,2701,2858
27740,42982,10461,20794,8810,32521,5560,2701,2859
27745,42986,10461,20794,8810,32525,5560,2701,2859
27750,42996,10462,20797,8811,32534,5561,2702,2859
27755,43002,10463,20800,8812,32539,5563,2703,2860
27760,43013,10463,20805,8812,32549,5564,2704,2860
27765,43017,10464,20807,8813,32553,5564,2704,2860
27770,43027,10465,20814,8814,32561,5565,2705,2860
27775,43033,10465,20817,8814,32567,5567,2706,2861
27780,43044,10465,20823,8814,32577,5568,2707,2861
27785,43048,10466,20824,8815,32582,5568,2707,2861
27790,43058,10467,20827,8815,32591,5569,2708,2861
27795,43064,10468,20829,8816,32596,5571,2708,2863
27800,43075,10469,20833,8817,32604,5572,2708,2864
27805,43079,10469,20836,8817,32609,5572,2708,2864
27810,43089,10470,20841,8818,32618,5573,2709,2864
27815,43095,10471,20845,8819,32624,5575,2711,2864
27820,43106,10471,20848,8819,32634,5576,2711,2865
27825,43110,10471,20851,8819,32638,5576,2711,2865
27830,43120,10476,20853,8822,32644,5577,2711,2866
27835,43126,10476,20854,8822,32649,5579,2711,2868
27840,43137,10480,20858,8825,32655,5580,2711,2869
27845,43141,10482,20860,8827,32659,5580,2711,2869
27850,43151,10485,20864,8828,32665,5581,2712,2869
27855,43157,10487,20867,8830,32669,5583,2712,2871
27860,43168,10489,20869,8832,32679,5584,2713,2871
27865,43172,10490,20872,8833,32681,5584,2713,2871
27870,43182,10494,20879,8837,32687,5585,2714,2871
27875,43188,10496,20881,8839,32692,5587,2714,2873
27880,43199,10499,20887,8842,32697,5588,2714,2874
27885,43203,10502,20889,8845,32700,5588,2714,2874
27890,43213,10506,20894,8847,32706,5589,2715,2874
27895,43219,10508,20898,8849,32710,5591,2716,2875
27900,43230,10510,20900,8851,32719,5592,2716,2876
27905,43234,10511,20901,8852,32723,5592,2716,2876
27910,43244,10513,20903,8852,32731,5593,2717,2876
27915,43250,10513,20905,8852,32737,5595,2718,2877
27920,43261,10516,20911,8854,32741,5596,2718,2878
27925,43265,10520,20913,8858,32744,5596,2718,2878
27930,43275,10524,20919,8862,32751,5597,2719,2878
27935,43281,10525,20924,8863,32755,5599,2720,2879
27940,43292,10529,20928,8866,32761,5600,2720,2880
27945,43296,10531,20930,8868,32764,5600,2720,2880
27950,43306,10538,20938,8874,32766,5601,2721,2880
27955,43312,10541,20939,8877,32771,5603,2721,2882
27960,43323,10544,20945,8879,32777,5604,2722,2882
27965,43327,10547,20946,8882,32780,5604,2722,2882
27970,43337,10548,20951,8883,32788,5605,2722,2883
27975,43343,10548,20955,8883,32793,5607,2724,2883
27980,43354,10548,20960,8883,32804,5608,2725,2883
27985,43358,10548,20961,8883,32810,5608,2725,2883
27990,43368,10549,20964,8883,32819,5609,2725,2884
27995,43374,10550,20966,8884,32823,5611,2725,2886
28000,43385,10551,20972,8885,32833,5612,2726,2886
28005,43389,10551,20972,8885,32838,5612,2726,2886
28010,43399,10552,20975,8885,32846,5613,2726,2887
28015,43405,10552,20976,8885,32853,5615,2726,2889
28020,43416,10552,20982,8885,32862,5616,2727,2889
28025,43420,10553,20983,8886,32867,5616,2727,2889
28030,43430,10554,20989,8886,32875,5617,2727,2890
28035,43436,10555,20995,8887,32880,5619,2729,2890
28040,43447,10555,21000,8887,32890,5620,2730,2890
28045,43451,10556,21002,8888,32894,5620,2730,2890
28050,43461,10557,21007,8888,32903,5621,2730,2891
28055,43467,10558,21009,8889,32909,5623,2731,2892
28060,43478,10560,21014,8891,32918,5624,2731,2893
28065,43482,10560,21015,8891,32922,5624,2731,2893
28070,43492,10562,21018,8892,32929,5625,2731,2894
28075,43498,10563,21020,8893,32935,5627,2732,2895
28080,43509,10565,21028,8895,32940,5628,2733,2895
28085,43513,10568,21030,8898,32945,5628,2733,2895
28090,43523,10572,21037,8901,32950,5629,2733,2896
28095,43529,10574,21041,8903,32954,5631,2735,2896
28100,43540,10576,21045,8904,32962,5632,2736,2896
28105,43544,10577,21047,8905,32967,5632,2736,2896
28110,43554,10580,21051,8908,32974,5633,2737,2896
28115,43560,10581,21055,8909,32978,5635,2737,2898
28120,43571,10586,21062,8913,32982,5636,2737,2899
28125,43575,10589,21065,8916,32985,5636,2737,2899
28130,43585,10592,21070,8919,32992,5637,2738,2899
28135,43591,10593,21071,8920,32998,5639,2739,2900
28140,43602,10595,21074,8922,33006,5640,2739,2901
28145,43606,10598,21077,8925,33007,5640,2739,2901
28150,43616,10602,21082,8928,33013,5641,2739,2902
28155,43622,10604,21086,8930,33018,5643,2741,2902
28160,43633,10609,21094,8934,33020,5644,2741,2903
28165,43637,10615,21096,8940,33022,5644,2741,2903
28170,43647,10618,21102,8943,33029,5645,2741,2904
28175,43653,10619,21106,8944,33033,5647,2742,2905
28180,43664,10624,21113,8949,33037,5648,2742,2906
28185,43668,10627,21115,8952,33040,5648,2742,2906
28190,43678,10631,21119,8955,33045,5649,2742,2907
28195,43684,10633,21121,8957,33049,5651,2742,2909
28200,43695,10639,21129,8963,33053,5652,2743,2909
28205,43699,10641,21130,8965,33058,5652,2743,2909
28210,43709,10642,21135,8965,33066,5653,2743,2910
28215,43715,10642,21136,8965,33072,5655,2743,2912
28220,43726,10642,21140,8965,33082,5656,2743,2913
28225,43730,10643,21141,8966,33087,5656,2743,2913
28230,43740,10644,21145,8967,33096,5657,2743,2914
28235,43746,10645,21149,8968,33101,5659,2745,2914
28240,43757,10646,21154,8969,33109,5660,2746,2914
28245,43761,10647,21157,8970,33113,5660,2746,2914
28250,43771,10648,21161,8970,33123,5661,2746,2915
28255,43777,10648,21165,8970,33128,5663,2748,2915
28260,43788,10648,21169,8970,33139,5664,2749,2915
28265,43792,10648,21172,8970,33143,5664,2749,2915
28270,43802,10649,21178,8970,33153,5665,2750,2915
28275,43808,10649,21181,8970,33158,5667,2751,2916
28280,43819,10650,21188,8971,33167,5668,2752,2916
28285,43823,10651,21191,8972,33171,5668,2752,2916
28290,43833,10652,21195,8972,33180,5669,2752,2917
28295,43839,10652,21197,8972,33187,5671,2754,2917
28300,43850,10653,21203,8973,33196,5672,2755,2917
28305,43854,10653,21205,8973,33201,5672,2755,2917
28310,43864,10656,21208,8974,33208,5673,2756,2917
28315,43870,10657,21209,8975,33213,5675,2756,2919
28320,43881,10660,21216,8977,33218,5676,2757,2919
28325,43885,10663,21217,8980,33222,5676,2757,2919
28330,43895,10667,21223,8983,33228,5677,2758,2919
28335,43901,10668,21225,8984,33233,5679,2758,2921
28340,43912,10669,21227,8984,33241,5680,2758,2922
28345,43916,10671,21228,8986,33245,5680,2758,2922
28350,43926,10674,21231,8987,33251,5681,2758,2923
28355,43932,10675,21232,8988,33257,5683,2758,2925
28360,43943,10677,21235,8990,33265,5684,2758,2926
28365,43947,10678,21236,8991,33269,5684,2758,2926
28370,43957,10681,21241,8994,33276,5685,2759,2926
28375,43963,10681,21244,8994,33282,5687,2760,2927
28380,43974,10682,21249,8995,33290,5688,2761,2927
28385,43978,10685,21250,8998,33293,5688,2761,2927
28390,43988,10688,21257,9000,33299,5689,2762,2927
28395,43994,10689,21260,9001,33304,5691,2763,2928
28400,44005,10693,21266,9005,33310,5692,2764,2928
28405,44009,10695,21267,9007,33314,5692,2764,2928
28410,44019,10699,21271,9009,33319,5693,2764,2929
28415,44025,10701,21274,9011,33323,5695,2765,2930
28420,44036,10706,21280,9016,33328,5696,2765,2931
28425,44040,10709,21282,9019,33331,5696,2765,2931
28430,44050,10714,21287,9022,33335,5697,2765,2932
28435,44056,10715,21290,9023,33340,5699,2767,2932
28440,44067,10718,21294,9025,33347,5700,2768,2932
28445,44071,10721,21297,9028,33348,5700,2768,2932
28450,44081,10726,21301,9032,33355,5701,2769,2932
28455,44087,10726,21303,9032,33361,5703,2771,2932
28460,44098,10727,21307,9033,33370,5704,2771,2933
28465,44102,10728,21311,9034,33372,5704,2771,2933
28470,44112,10733,21316,9039,33378,5705,2771,2934
28475,44118,10735,21320,9041,33381,5707,2772,2935
28480,44129,10737,21325,9043,33391,5708,2772,2936
28485,44133,10738,21327,9044,33394,5708,2772,2936
28490,44143,10739,21333,9044,33403,5709,2773,2936
28495,44149,10740,21337,9045,33408,5711,2775,2936
28500,44160,10741,21343,9046,33417,5712,2776,2936
28505,44164,10741,21347,9046,33422,5712,2776,2936
28510,44174,10742,21353,9046,33431,5713,2777,2936
28515,44180,10742,21355,9046,33438,5715,2779,2936
28520,44191,10743,21362,9047,33446,5716,2779,2937
28525,44195,10744,21364,9048,33451,5716,2779,2937
28530,44205,10745,21370,9049,33460,5717,2780,2937
28535,44211,10746,21374,9050,33465,5719,2781,2938
28540,44222,10746,21379,9050,33475,5720,2782,2938
28545,44226,10747,21381,9051,33478,5720,2782,2938
28550,44236,10749,21383,9052,33487,5721,2782,2939
28555,44242,10750,21386,9053,33491,5723,2783,2940
28560,44253,10752,21390,9054,33499,5724,2784,2940
28565,44257,10754,21394,9056,33502,5724,2784,2940
28570,44267,10755,21400,9056,33511,5725,2785,2940
28575,44273,10756,21402,9057,33517,5727,2786,2941
28580,44284,10760,21409,9060,33521,5728,2786,2942
28585,44288,10763,21413,9063,33525,5728,2786,2942
28590,44298,10765,21414,9063,33533,5729,2786,2943
28595,44304,10765,21418,9063,33538,5731,2788,2943
28600,44315,10769,21421,9066,33545,5732,2788,2944
28605,44319,10770,21424,9067,33549,5732,2788,2944
28610,44329,10773,21429,9069,33555,5733,2788,2945
28615,44335,10774,21431,9070,33560,5735,2789,2946
28620,44346,10778,21436,9073,33566,5736,2790,2946
28625,44350,10780,21439,9075,33569,5736,2790,2946
28630,44360,10784,21444,9078,33576,5737,2791,2946
28635,44366,10785,21448,9079,33580,5739,2791,2948
28640,44377,10788,21455,9082,33585,5740,2792,2948
28645,44381,10792,21458,9086,33588,5740,2792,2948
28650,44391,10796,21465,9089,33594,5741,2793,2948
28655,44397,10797,21470,9090,33599,5743,2795,2948
28660,44408,10801,21477,9094,33604,5744,2795,2949
28665,44412,10804,21478,9097,33607,5744,2795,2949
28670,44422,10809,21484,9101,33612,5745,2795,2950
28675,44428,10810,21486,9102,33618,5747,2797,2950
28680,44439,10812,21490,9104,33625,5748,2797,2951
28685,44443,10815,21493,9107,33627,5748,2797,2951
28690,44453,10820,21500,9111,33632,5749,2797,2952
28695,44459,10821,21503,9112,33637,5751,2798,2953
28700,44470,10823,21508,9114,33646,5752,2799,2953
28705,44474,10825,21510,9116,33649,5752,2799,2953
28710,44484,10828,21514,9118,33656,5753,2799,2954
28715,44490,10828,21517,9118,33661,5755,2801,2954
28720,44501,10828,21521,9118,33672,5756,2801,2955
28725,44505,10828,21524,9118,33677,5756,2801,2955
28730,44515,10829,21529,9118,33686,5757,2802,2955
28735,44521,10830,21533,9119,33691,5759,2803,2956
28740,44532,10830,21540,9119,33701,5760,2804,2956
28745,44536,10831,21541,9120,33705,5760,2804,2956
28750,44546,10832,21545,9121,33713,5761,2804,2957
28755,44552,10832,21548,9121,33719,5763,2805,2958
28760,44563,10833,21552,9122,33729,5764,2806,2958
28765,44567,10833,21553,9122,33734,5764,2806,2958
28770,44577,10834,21557,9122,33743,5765,2807,2958
28775,44583,10834,21560,9122,33748,5767,2809,2958
28780,44594,10834,21565,9122,33759,5768,2809,2959
28785,44598,10834,21568,9122,33764,5768,2809,2959
28790,44608,10835,21575,9122,33772,5769,2810,2959
28795,44614,10837,21577,9124,33777,5771,2811,2960
28800,44625,10838,21577,9124,33787,5772,2811,2961
28805,44629,10839,21580,9125,33790,5772,2811,2961
28810,44639,10842,21587,9127,33796,5773,2811,2962
28815,44645,10843,21590,9128,33802,5775,2812,2963
28820,44656,10845,21593,9129,33809,5776,2812,2964
28825,44660,10848,21595,9132,33811,5776,2812,2964
28830,44670,10852,21599,9134,33817,5777,2812,2965
28835,44676,10852,21602,9134,33823,5779,2813,2966
28840,44687,10855,21605,9137,33832,5780,2813,2967
28845,44691,10856,21608,9138,33834,5780,2813,2967
28850,44701,10858,21612,9140,33842,5781,2813,2968
28855,44707,10859,21615,9141,33847,5783,2814,2969
28860,44718,10863,21620,9144,33853,5784,2814,2970
28865,44722,10865,21621,9146,33857,5784,2814,2970
28870,44732,10868,21626,9147,33863,5785,2815,2970
28875,44738,10870,21629,9149,33866,5787,2815,2972
28880,44749,10872,21632,9150,33875,5788,2816,2972
28885,44753,10874,21634,9152,33878,5788,2816,2972
28890,44763,10876,21635,9152,33886,5789,2816,2973
28895,44769,10876,21640,9152,33892,5791,2818,2973
28900,44780,10880,21644,9155,33898,5792,2818,2974
28905,44784,10881,21646,9156,33903,5792,2818,2974
28910,44794,10884,21649,9158,33909,5793,2818,2975
28915,44800,10884,21650,9158,33916,5795,2818,2977
28920,44811,10887,21656,9160,33921,5796,2819,2977
28925,44815,10890,21657,9163,33925,5796,2819,2977
28930,44825,10892,21661,9164,33932,5797,2819,2978
28935,44831,10893,21664,9165,33938,5799,2820,2979
28940,44842,10895,21669,9167,33946,5800,2821,2979
28945,44846,10895,21671,9167,33950,5800,2821,2979
28950,44856,10898,21673,9169,33957,5801,2821,2980
28955,44862,10898,21674,9169,33964,5803,2822,2981
28960,44873,10899,21680,9170,33972,5804,2823,2981
28965,44877,10901,21682,9172,33975,5804,2823,2981
28970,44887,10904,21689,9175,33982,5805,2823,2982
28975,44893,10904,21692,9175,33989,5807,2825,2982
28980,44904,10905,21696,9176,33997,5808,2825,2983
28985,44908,10906,21697,9177,34002,5808,2825,2983
28990,44918,10908,21701,9178,34009,5809,2825,2984
28995,44924,10908,21706,9178,34015,5811,2827,2984
29000,44935,10910,21711,9180,34023,5812,2828,2984
29005,44939,10912,21715,9182,34025,5812,2828,2984
29010,44949,10918,21721,9187,34030,5813,2829,2984
29015,44955,10919,21726,9188,34034,5815,2831,2984
29020,44966,10923,21730,9192,34043,5816,2831,2985
29025,44970,10924,21733,9193,34044,5816,2831,2985
29030,44980,10930,21740,9199,34048,5817,2832,2985
29035,44986,10933,21742,9202,34052,5819,2832,2987
29040,44997,10939,21750,9207,34055,5820,2833,2987
29045,45001,10941,21751,9209,34060,5820,2833,2987
29050,45011,10944,21759,9212,34066,5821,2833,2988
29055,45017,10945,21763,9213,34071,5823,2834,2989
29060,45028,10947,21766,9214,34080,5824,2834,2990
29065,45032,10948,21767,9215,34084,5824,2834,2990
29070,45042,10951,21771,9217,34090,5825,2835,2990
29075,45048,10952,21774,9218,34095,5827,2836,2991
29080,45059,10953,21777,9218,34104,5828,2836,2992
29085,45063,10954,21778,9219,34109,5828,2836,2992
29090,45073,10955,21781,9219,34117,5829,2837,2992
29095,45079,10957,21783,9221,34122,5831,2838,2993
29100,45090,10960,21789,9224,34128,5832,2838,2994
29105,45094,10962,21791,9226,34131,5832,2838,2994
29110,45104,10963,21796,9227,34140,5833,2839,2994
29115,45110,10965,21799,9229,34145,5835,2839,2996
29120,45121,10967,21804,9231,34153,5836,2840,2996
29125,45125,10969,21806,9233,34156,5836,2840,2996
29130,45135,10972,21811,9235,34162,5837,2840,2997
29135,45141,10972,21812,9235,34169,5839,2841,2998
29140,45152,10974,21817,9236,34177,5840,2842,2998
29145,45156,10975,21817,9237,34181,5840,2842,2998
29150,45166,10978,21822,9240,34187,5841,2843,2998
29155,45172,10978,21825,9240,34192,5843,2844,2999
29160,45183,10984,21832,9246,34198,5844,2845,2999
29165,45187,10986,21835,9248,34200,5844,2845,2999
29170,45197,10989,21837,9250,34207,5845,2845,3000
29175,45203,10990,21839,9251,34213,5847,2846,3001
29180,45214,10992,21846,9253,34219,5848,2847,3001
29185,45218,10995,21849,9256,34223,5848,2847,3001
29190,45228,10999,21854,9258,34228,5849,2848,3001
29195,45234,10999,21857,9258,34235,5851,2850,3001
29200,45245,11001,21864,9260,34242,5852,2850,3002
29205,45249,11003,21865,9262,34246,5852,2850,3002
29210,45259,11005,21868,9264,34253,5853,2850,3003
29215,45265,11005,21870,9264,34260,5855,2851,3004
29220,45276,11006,21877,9265,34267,5856,2851,3005
29225,45280,11009,21880,9268,34270,5856,2851,3005
29230,45290,11012,21883,9270,34277,5857,2852,3005
29235,45296,11012,21884,9270,34284,5859,2853,3006
29240,45307,11012,21889,9270,34294,5860,2853,3007
29245,45311,11012,21890,9270,34298,5860,2853,3007
29250,45321,11012,21893,9270,34308,5861,2854,3007
29255,45327,11012,21896,9270,34314,5863,2855,3008
29260,45338,11012,21903,9270,34324,5864,2855,3009
29265,45342,11012,21905,9270,34330,5864,2855,3009
29270,45352,11014,21914,9272,34337,5865,2856,3009
29275,45358,11015,21918,9273,34342,5867,2857,3010
29280,45369,11016,21921,9274,34353,5868,2858,3010
29285,45373,11017,21923,9275,34356,5868,2858,3010
29290,45383,11019,21929,9277,34363,5869,2858,3011
29295,45389,11019,21931,9277,34370,5871,2860,3011
29300,45400,11020,21937,9278,34378,5872,2860,3012
29305,45404,11023,21939,9281,34381,5872,2860,3012
29310,45414,11025,21946,9283,34388,5873,2861,3012
29315,45420,11026,21948,9284,34393,5875,2861,3014
29320,45431,11028,21955,9286,34401,5876,2862,3014
29325,45435,11030,21958,9288,34404,5876,2862,3014
29330,45445,11032,21961,9290,34412,5877,2862,3015
29335,45451,11033,21963,9291,34417,5879,2862,3017
29340,45462,11037,21967,9294,34424,5880,2862,3018
29345,45466,11038,21969,9295,34427,5880,2862,3018
29350,45476,11040,21972,9295,34435,5881,2862,3019
29355,45482,11040,21974,9295,34442,5883,2863,3020
29360,45493,11044,21980,9298,34446,5884,2863,3021
29365,45497,11046,21982,9300,34451,5884,2863,3021
29370,45507,11048,21988,9302,34458,5885,2864,3021
29375,45513,11048,21990,9302,34465,5887,2864,3023
29380,45524,11052,21996,9305,34469,5888,2864,3024
29385,45528,11055,21997,9308,34473,5888,2864,3024
29390,45538,11058,22001,9309,34479,5889,2865,3024
29395,45544,11060,22006,9311,34483,5891,2867,3024
29400,45555,11063,22011,9314,34490,5892,2868,3024
29405,45559,11066,22014,9317,34492,5892,2868,3024
29410,45569,11069,22019,9319,34499,5893,2869,3024
29415,45575,11070,22023,9320,34504,5895,2870,3025
29420,45586,11073,22030,9323,34511,5896,2871,3025
29425,45590,11074,22032,9324,34515,5896,2871,3025
29430,45600,11077,22038,9326,34522,5897,2872,3025
29435,45606,11078,22042,9327,34528,5899,2874,3025
29440,45617,11079,22048,9328,34535,5900,2875,3025
29445,45621,11082,22051,9331,34539,5900,2875,3025
29450,45631,11084,22056,9332,34546,5901,2875,3026
29455,45637,11084,22060,9332,34551,5903,2877,3026
29460,45648,11088,22065,9336,34558,5904,2877,3027
29465,45652,11090,22065,9338,34562,5904,2877,3027
29470,45662,11091,22069,9338,34571,5905,2877,3028
29475,45668,11092,22073,9339,34575,5907,2879,3028
29480,45679,11092,22076,9339,34585,5908,2879,3029
29485,45683,11092,22077,9339,34591,5908,2879,3029
29490,45693,11093,22081,9339,34600,5909,2880,3029
29495,45699,11094,22084,9340,34604,5911,2881,3030
29500,45710,11094,22088,9340,34615,5912,2882,3030
29505,45714,11094,22092,9340,34619,5912,2882,3030
29510,45724,11096,22096,9341,34628,5913,2882,3031
29515,45730,11096,22100,9341,34633,5915,2884,3031
29520,45741,11098,22103,9342,34642,5916,2884,3032
29525,45745,11100,22106,9344,34644,5916,2884,3032
29530,45755,11101,22108,9344,34654,5917,2884,3033
29535,45761,11102,22110,9345,34659,5919,2885,3034
29540,45772,11105,22117,9347,34665,5920,2886,3034
29545,45776,11107,22121,9349,34668,5920,2886,3034
29550,45786,11108,22126,9350,34677,5921,2887,3034
29555,45792,11110,22130,9352,34681,5923,2888,3035
29560,45803,11112,22135,9354,34690,5924,2888,3036
29565,45807,11113,22138,9355,34693,5924,2888,3036
29570,45817,11116,22142,9356,34700,5925,2889,3036
29575,45823,11118,22146,9358,34704,5927,2891,3036
29580,45834,11119,22149,9358,34713,5928,2891,3037
29585,45838,11122,22153,9361,34716,5928,2891,3037
29590,45848,11125,22159,9363,34722,5929,2892,3037
29595,45854,11127,22162,9365,34726,5931,2892,3039
29600,45865,11131,22169,9369,34732,5932,2893,3039
29605,45869,11134,22171,9372,34735,5932,2893,3039
29610,45879,11137,22178,9374,34742,5933,2894,3039
29615,45885,11138,22181,9375,34747,5935,2895,3040
29620,45896,11141,22188,9377,34752,5936,2895,3041
29625,45900,11144,22190,9380,34756,5936,2895,3041
29630,45910,11146,22197,9382,34763,5937,2896,3041
29635,45916,11147,22199,9383,34769,5939,2897,3042
29640,45927,11150,22206,9386,34775,5940,2898,3042
29645,45931,11153,22208,9389,34778,5940,2898,3042
29650,45941,11155,22212,9390,34785,5941,2898,3043
29655,45947,11156,22217,9391,34790,5943,2900,3043
29660,45958,11159,22225,9394,34797,5944,2901,3043
29665,45962,11160,22225,9395,34802,5944,2901,3043
29670,45972,11162,22229,9396,34810,5945,2901,3044
29675,45978,11162,22232,9396,34815,5947,2902,3045
29680,45989,11165,22236,9399,34823,5948,2902,3046
29685,45993,11167,22239,9401,34824,5948,2902,3046
29690,46003,11172,22245,9405,34830,5949,2903,3046
29695,46009,11173,22246,9406,34835,5951,2903,3048
29700,46020,11176,22251,9409,34842,5952,2903,3049
29705,46024,11178,22254,9411,34845,5952,2903,3049
29710,46034,11179,22260,9412,34855,5953,2904,3049
29715,46040,11179,22261,9412,34860,5955,2904,3051
29720,46051,11180,22266,9413,34869,5956,2904,3052
29725,46055,11181,22267,9414,34874,5956,2904,3052
29730,46065,11182,22271,9414,34882,5957,2904,3053
29735,46071,11183,22274,9415,34887,5959,2904,3055
29740,46082,11183,22276,9415,34899,5960,2904,3056
29745,46086,11183,22278,9415,34902,5960,2904,3056
29750,46096,11184,22283,9415,34911,5961,2904,3057
29755,46102,11186,22286,9417,34915,5963,2904,3059
29760,46113,11189,22294,9420,34921,5964,2905,3059
29765,46117,11191,22297,9422,34925,5964,2905,3059
29770,46127,11193,22299,9423,34934,5965,2905,3060
29775,46133,11194,22304,9424,34939,5967,2906,3061
29780,46144,11196,22308,9425,34947,5968,2907,3061
29785,46148,11198,22310,9427,34950,5968,2907,3061
29790,46158,11200,22315,9429,34958,5969,2907,3062
29795,46164,11200,22318,9429,34964,5971,2908,3063
29800,46175,11202,22321,9430,34973,5972,2909,3063
29805,46179,11202,22324,9430,34977,5972,2909,3063
29810,46189,11204,22330,9432,34984,5973,2909,3064
29815,46195,11205,22335,9433,34989,5975,2911,3064
29820,46206,11210,22343,9437,34993,5976,2912,3064
29825,46210,11212,22344,9439,34998,5976,2912,3064
29830,46220,11216,22349,9442,35004,5977,2913,3064
29835,46226,11217,22350,9443,35009,5979,2913,3066
29840,46237,11221,22357,9447,35014,5980,2914,3066
29845,46241,11223,22361,9449,35018,5980,2914,3066
29850,46251,11226,22366,9452,35025,5981,2914,3067
29855,46257,11227,22369,9453,35030,5983,2915,3068
29860,46268,11229,22374,9454,35036,5984,2916,3068
29865,46272,11232,22376,9457,35039,5984,2916,3068
29870,46282,11236,22381,9460,35045,5985,2916,3069
29875,46288,11238,22384,9462,35049,5987,2917,3070
29880,46299,11243,22391,9467,35054,5988,2918,3070
29885,46303,11244,22393,9468,35057,5988,2918,3070
29890,46313,11250,22398,9473,35063,5989,2919,3070
29895,46319,11250,22401,9473,35068,5991,2921,3070
29900,46330,11253,22408,9476,35074,5992,2921,3071
29905,46334,11257,22410,9480,35076,5992,2921,3071
29910,46344,11262,22417,9484,35082,5993,2922,3071
29915,46350,11262,22418,9484,35088,5995,2923,3072
29920,46361,11263,22424,9485,35097,5996,2924,3072
29925,46365,11263,22426,9485,35102,5996,2924,3072
29930,46375,11264,22430,9485,35111,5997,2925,3072
29935,46381,11264,22433,9485,35116,5999,2926,3073
29940,46392,11264,22437,9485,35127,6000,2926,3074
29945,46396,11265,22440,9486,35131,6000,2926,3074
29950,46406,11266,22444,9486,35140,6001,2927,3074
29955,46412,11266,22446,9486,35146,6003,2929,3074
29960,46423,11266,22451,9486,35157,6004,2930,3074
29965,46427,11266,22453,9486,35161,6004,2930,3074
29970,46437,11267,22460,9487,35169,6005,2930,3075
29975,46443,11268,22463,9488,35175,6007,2931,3076
29980,46454,11269,22472,9489,35184,6008,2931,3077
29985,46458,11270,22472,9490,35188,6008,2931,3077
29990,46468,11272,22476,9491,35196,6009,2931,3078
29995,46474,11273,22478,9492,35201,6011,2931,3080
30000,46485,11275,22480,9494,35210,6012,2931,3081
30005,46489,11275,22483,9494,35214,6012,2931,3081
30010,46499,11278,22489,9497,35221,6013,2932,3081
30015,46505,11278,22490,9497,35226,6015,2932,3083
30020,46516,11282,22496,9501,35232,6016,2933,3083
30025,46520,11283,22498,9502,35236,6016,2933,3083
30030,46530,11287,22503,9505,35243,6017,2934,3083
30035,46536,11287,22505,9505,35248,6019,2935,3084
30040,46547,11290,22509,9507,35256,6020,2936,3084
30045,46551,11291,22510,9508,35260,6020,2936,3084
30050,46561,11296,22517,9512,35263,6021,2937,3084
30055,46567,11298,22519,9514,35267,6023,2937,3086
30060,46578,11302,22524,9518,35273,6024,2937,3087
30065,46582,11305,22526,9521,35275,6024,2937,3087
30070,46592,11313,22533,9527,35277,6025,2938,3087
30075,46598,11315,22536,9529,35281,6027,2939,3088
30080,46609,11320,22540,9534,35288,6028,2939,3089
30085,46613,11322,22543,9536,35289,6028,2939,3089
30090,46623,11324,22545,9537,35299,6029,2939,3090
30095,46629,11325,22549,9538,35303,6031,2940,3091
30100,46640,11327,22553,9539,35312,6032,2941,3091
30105,46644,11328,22555,9540,35315,6032,2941,3091
30110,46654,11330,22561,9541,35323,6033,2942,3091
30115,46660,11331,22563,9542,35329,6035,2942,3093
30120,46671,11333,22571,9544,35336,6036,2943,3093
30125,46675,11335,22572,9546,35340,6036,2943,3093
30130,46685,11336,22577,9547,35348,6037,2944,3093
30135,46691,11337,22580,9548,35354,6039,2944,3095
30140,46702,11339,22587,9550,35361,6040,2944,3096
30145,46706,11341,22588,9552,35365,6040,2944,3096
30150,46716,11342,22595,9553,35373,6041,2945,3096
30155,46722,11343,22597,9554,35379,6043,2945,3098
30160,46733,11343,22602,9554,35390,6044,2945,3099
30165,46737,11343,22605,9554,35394,6044,2945,3099
30170,46747,11344,22610,9555,35402,6045,2945,3100
30175,46753,11345,22612,9556,35408,6047,2945,3102
30180,46764,11346,22617,9557,35417,6048,2946,3102
30185,46768,11347,22619,9558,35421,6048,2946,3102
30190,46778,11348,22628,9559,35430,6049,2947,3102
30195,46784,11348,22630,9559,35436,6051,2948,3103
30200,46795,11349,22636,9560,35443,6052,2948,3104
30205,46799,11352,22637,9563,35447,6052,2948,3104
30210,46809,11354,22640,9564,35455,6053,2948,3105
30215,46815,11354,22641,9564,35461,6055,2949,3106
30220,46826,11354,22644,9564,35469,6056,2949,3107
30225,46830,11357,22646,9567,35472,6056,2949,3107
30230,46840,11362,22651,9571,35477,6057,2949,3108
30235,46846,11363,22652,9572,35483,6059,2949,3110
30240,46857,11365,22659,9574,35489,6060,2950,3110
30245,46861,11369,22662,9578,35490,6060,2950,3110
30250,46871,11374,22666,9582,35496,6061,2950,3111
30255,46877,11376,22668,9584,35500,6063,2950,3113
30260,46888,11380,22673,9587,35505,6064,2950,3114
30265,46892,11383,22675,9590,35507,6064,2950,3114
30270,46902,11389,22680,9596,35512,6065,2950,3115
30275,46908,11391,22684,9598,35515,6067,2951,3116
30280,46919,11395,22688,9602,35522,6068,2951,3117
30285,46923,11398,22691,9605,35524,6068,2951,3117
30290,46933,11400,22697,9606,35532,6069,2951,3118
30295,46939,11402,22702,9608,35535,6071,2953,3118
30300,46950,11403,22706,9609,35546,6072,2953,3119
30305,46954,11405,22710,9611,35548,6072,2953,3119
30310,46964,11406,22715,9612,35557,6073,2954,3119
30315,46970,11407,22720,9613,35562,6075,2956,3119
30320,46981,11410,22725,9615,35569,6076,2956,3120
30325,46985,11412,22728,9617,35573,6076,2956,3120
30330,46995,11414,22732,9618,35581,6077,2957,3120
30335,47001,11415,22736,9619,35585,6079,2958,3121
30340,47012,11417,22742,9621,35593,6080,2958,3122
30345,47016,11418,22742,9622,35598,6080,2958,3122
30350,47026,11419,22747,9623,35606,6081,2958,3123
30355,47032,11420,22748,9624,35612,6083,2958,3125
30360,47043,11421,22751,9625,35621,6084,2958,3126
30365,47047,11422,22752,9626,35625,6084,2958,3126
30370,47057,11423,22758,9627,35633,6085,2958,3127
30375,47063,11425,22762,9629,35638,6087,2959,3128
30380,47074,11427,22767,9630,35646,6088,2959,3129
30385,47078,11428,22769,9631,35650,6088,2959,3129
30390,47088,11429,22773,9631,35658,6089,2960,3129
30395,47094,11430,22777,9632,35664,6091,2962,3129
30400,47105,11431,22781,9633,35674,6092,2963,3129
30405,47109,11432,22784,9634,35676,6092,2963,3129
30410,47119,11435,22790,9637,35683,6093,2963,3130
30415,47125,11435,22792,9637,35689,6095,2963,3132
30420,47136,11438,22797,9640,35696,6096,2963,3133
30425,47140,11439,22797,9641,35701,6096,2963,3133
30430,47150,11441,22802,9641,35708,6097,2963,3134
30435,47156,11441,22805,9641,35715,6099,2964,3135
30440,47167,11441,22807,9641,35726,6100,2964,3136
30445,47171,11441,22809,9641,35730,6100,2964,3136
30450,47181,11443,22812,9642,35738,6101,2964,3137
30455,47187,11443,22814,9642,35744,6103,2965,3138
30460,47198,11445,22820,9644,35752,6104,2966,3138
30465,47202,11445,22821,9644,35757,6104,2966,3138
30470,47212,11450,22828,9648,35761,6105,2966,3139
30475,47218,11452,22834,9650,35763,6107,2968,3139
30480,47229,11456,22839,9654,35772,6108,2969,3139
30485,47233,11458,22841,9656,35775,6108,2969,3139
30490,47243,11463,22849,9661,35778,6109,2970,3139
30495,47249,11466,22850,9664,35783,6111,2970,3141
30500,47260,11469,22855,9666,35789,6112,2971,3141
30505,47264,11471,22855,9668,35793,6112,2971,3141
30510,47274,11475,22859,9671,35798,6113,2971,3142
30515,47280,11476,22860,9672,35803,6115,2971,3144
30520,47291,11480,22866,9675,35808,6116,2972,3144
30525,47295,11483,22867,9678,35811,6116,2972,3144
30530,47305,11486,22872,9681,35819,6117,2973,3144
30535,47311,11486,22874,9681,35824,6119,2973,3146
30540,47322,11488,22879,9682,35831,6120,2973,3147
30545,47326,11491,22881,9685,35835,6120,2973,3147
30550,47336,11492,22886,9686,35843,6121,2974,3147
30555,47342,11493,22889,9687,35849,6123,2976,3147
30560,47353,11496,22894,9689,35855,6124,2977,3147
30565,47357,11498,22896,9691,35858,6124,2977,3147
30570,47367,11501,22901,9694,35866,6125,2978,3147
30575,47373,11501,22902,9694,35871,6127,2978,3149
30580,47384,11502,22907,9695,35880,6128,2979,3149
30585,47388,11504,22909,9697,35883,6128,2979,3149
30590,47398,11507,22915,9699,35890,6129,2980,3149
30595,47404,11508,22916,9700,35895,6131,2980,3151
30600,47415,11510,22920,9701,35903,6132,2981,3151
30605,47419,11512,22921,9703,35907,6132,2981,3151
30610,47429,11515,22925,9705,35914,6133,2981,3152
30615,47435,11515,22925,9705,35920,6135,2981,3154
30620,47446,11517,22929,9706,35928,6136,2982,3154
30625,47450,11518,22930,9707,35931,6136,2982,3154
30630,47460,11519,22934,9707,35940,6137,2983,3154
30635,47466,11519,22938,9707,35945,6139,2985,3154
30640,47477,11521,22942,9709,35955,6140,2986,3154
30645,47481,11521,22944,9709,35959,6140,2986,3154
30650,47491,11523,22949,9710,35967,6141,2986,3155
30655,47497,11523,22954,9710,35973,6143,2988,3155
30660,47508,11525,22959,9712,35982,6144,2989,3155
30665,47512,11526,22960,9713,35986,6144,2989,3155
30670,47522,11528,22961,9713,35994,6145,2989,3156
30675,47528,11528,22962,9713,36000,6147,2990,3157
30680,47539,11529,22965,9714,36010,6148,2990,3158
30685,47543,11529,22968,9714,36014,6148,2990,3158
30690,47553,11531,22970,9714,36022,6149,2991,3158
30695,47559,11531,22973,9714,36028,6151,2993,3158
30700,47570,11531,22976,9714,36038,6152,2993,3159
30705,47574,11531,22978,9714,36043,6152,2993,3159
30710,47584,11533,22985,9716,36050,6153,2994,3159
30715,47590,11533,22987,9716,36056,6155,2995,3160
30720,47601,11536,22994,9719,36063,6156,2996,3160
30725,47605,11538,22997,9721,36066,6156,2996,3160
30730,47615,11542,23003,9724,36072,6157,2997,3160
30735,47621,11544,23005,9726,36077,6159,2998,3161
30740,47632,11548,23011,9729,36082,6160,2999,3161
30745,47636,11552,23014,9733,36083,6160,2999,3161
30750,47646,11557,23019,9737,36089,6161,2999,3162
30755,47652,11558,23021,9738,36093,6163,2999,3164
30760,47663,11561,23026,9741,36100,6164,3000,3164
30765,47667,11564,23028,9744,36102,6164,3000,3164
30770,47677,11570,23034,9749,36105,6165,3000,3165
30775,47683,11573,23038,9752,36109,6167,3002,3165
30780,47694,11577,23044,9756,36115,6168,3003,3165
30785,47698,11579,23046,9758,36118,6168,3003,3165
30790,47708,11581,23052,9759,36126,6169,3004,3165
30795,47714,11583,23057,9761,36129,6171,3005,3166
30800,47725,11584,23062,9761,36139,6172,3005,3167
30805,47729,11587,23066,9764,36141,6172,3005,3167
30810,47739,11588,23071,9765,36151,6173,3005,3168
30815,47745,11588,23075,9765,36156,6175,3006,3169
30820,47756,11590,23081,9767,36163,6176,3006,3170
30825,47760,11592,23083,9769,36168,6176,3006,3170
30830,47770,11593,23088,9769,36176,6177,3006,3171
30835,47776,11595,23091,9771,36181,6179,3007,3172
30840,47787,11597,23096,9773,36189,6180,3008,3172
30845,47791,11599,23098,9775,36191,6180,3008,3172
30850,47801,11602,23104,9777,36199,6181,3008,3173
30855,47807,11603,23107,9778,36204,6183,3010,3173
30860,47818,11605,23112,9780,36212,6184,3011,3173
30865,47822,11606,23114,9781,36216,6184,3011,3173
30870,47832,11609,23121,9783,36222,6185,3012,3173
30875,47838,11610,23124,9784,36228,6187,3014,3173
30880,47849,11613,23130,9787,36235,6188,3015,3173
30885,47853,11614,23131,9788,36239,6188,3015,3173
30890,47863,11616,23136,9788,36246,6189,3015,3174
30895,47869,11616,23139,9788,36253,6191,3017,3174
30900,47880,11617,23143,9789,36261,6192,3017,3175
30905,47884,11617,23143,9789,36267,6192,3017,3175
30910,47894,11619,23146,9790,36275,6193,3017,3176
30915,47900,11619,23148,9790,36280,6195,3017,3178
30920,47911,11621,23149,9792,36290,6196,3017,3179
30925,47915,11621,23151,9792,36293,6196,3017,3179
30930,47925,11624,23156,9793,36301,6197,3018,3179
30935,47931,11625,23158,9794,36306,6199,3019,3180
30940,47942,11627,23166,9796,36313,6200,3020,3180
30945,47946,11627,23168,9796,36318,6200,3020,3180
30950,47956,11630,23174,9798,36325,6201,3021,3180
30955,47962,11630,23177,9798,36331,6203,3021,3182
30960,47973,11632,23180,9800,36341,6204,3021,3183
30965,47977,11632,23182,9800,36344,6204,3021,3183
30970,47987,11636,23188,9804,36349,6205,3021,3184
30975,47993,11638,23191,9806,36354,6207,3022,3185
30980,48004,11639,23195,9807,36363,6208,3023,3185
30985,48008,11641,23197,9809,36366,6208,3023,3185
30990,48018,11647,23202,9814,36370,6209,3023,3186
30995,48024,11649,23206,9816,36374,6211,3025,3186
31000,48035,11652,23209,9818,36381,6212,3025,3187
31005,48039,11656,23213,9822,36381,6212,3025,3187
31010,48049,11662,23219,9828,36386,6213,3026,3187
31015,48055,11664,23221,9830,36390,6215,3026,3189
31020,48066,11668,23226,9834,36397,6216,3027,3189
31025,48070,11669,23229,9835,36400,6216,3027,3189
31030,48080,11670,23234,9836,36409,6217,3027,3190
31035,48086,11671,23235,9837,36415,6219,3028,3191
31040,48097,11673,23241,9838,36422,6220,3029,3191
31045,48101,11674,23243,9839,36427,6220,3029,3191
31050,48111,11676,23248,9841,36434,6221,3029,3192
31055,48117,11678,23251,9843,36438,6223,3030,3193
31060,48128,11680,23256,9845,36447,6224,3030,3194
31065,48132,11682,23259,9847,36450,6224,3030,3194
31070,48142,11685,23265,9849,36457,6225,3030,3195
31075,48148,11686,23270,9850,36462,6227,3032,3195
31080,48159,11687,23277,9851,36469,6228,3032,3196
31085,48163,11689,23278,9853,36474,6228,3032,3196
31090,48173,11692,23286,9855,36480,6229,3033,3196
31095,48179,11693,23288,9856,36486,6231,3034,3197
31100,48190,11695,23291,9858,36495,6232,3035,3197
31105,48194,11695,23294,9858,36499,6232,3035,3197
31110,48204,11697,23296,9859,36507,6233,3035,3198
31115,48210,11697,23297,9859,36513,6235,3036,3199
31120,48221,11700,23302,9861,36521,6236,3036,3200
31125,48225,11700,23303,9861,36525,6236,3036,3200
31130,48235,11703,23307,9862,36531,6237,3037,3200
31135,48241,11705,23312,9864,36535,6239,3038,3201
31140,48252,11708,23317,9867,36542,6240,3038,3202
31145,48256,11710,23319,9869,36546,6240,3038,3202
31150,48266,11713,23323,9870,36553,6241,3038,3203
31155,48272,11714,23329,9871,36557,6243,3040,3203
31160,48283,11719,23333,9875,36563,6244,3040,3204
31165,48287,11721,23336,9877,36565,6244,3040,3204
31170,48297,11726,23339,9881,36571,6245,3040,3205
31175,48303,11726,23342,9881,36576,6247,3042,3205
31180,48314,11730,23348,9884,36581,6248,3043,3205
31185,48318,11733,23350,9887,36584,6248,3043,3205
31190,48328,11737,23354,9890,36591,6249,3044,3205
31195,48334,11737,23357,9890,36596,6251,3046,3205
31200,48345,11740,23364,9893,36603,6252,3047,3205
31205,48349,11743,23366,9896,36605,6252,3047,3205
31210,48359,11744,23372,9897,36614,6253,3047,3206
31215,48365,11744,23373,9897,36621,6255,3048,3207
31220,48376,11744,23376,9897,36631,6256,3048,3208
31225,48380,11745,23377,9898,36635,6256,3048,3208
31230,48390,11746,23382,9898,36643,6257,3048,3209
31235,48396,11746,23384,9898,36648,6259,3048,3211
31240,48407,11746,23389,9898,36660,6260,3049,3211
31245,48411,11746,23389,9898,36665,6260,3049,3211
31250,48421,11747,23396,9899,36673,6261,3050,3211
31255,48427,11747,23399,9899,36679,6263,3051,3212
31260,48438,11747,23404,9899,36690,6264,3052,3212
31265,48442,11747,23405,9899,36695,6264,3052,3212
31270,48452,11748,23411,9899,36703,6265,3052,3213
31275,48458,11749,23415,9900,36709,6267,3053,3214
31280,48469,11750,23420,9901,36717,6268,3053,3215
31285,48473,11751,23422,9902,36722,6268,3053,3215
31290,48483,11753,23427,9904,36729,6269,3054,3215
31295,48489,11754,23430,9905,36735,6271,3055,3216
31300,48500,11756,23436,9907,36741,6272,3056,3216
31305,48504,11759,23438,9910,36744,6272,3056,3216
31310,48514,11762,23442,9912,36751,6273,3056,3217
31315,48520,11763,23445,9913,36757,6275,3057,3218
31320,48531,11765,23451,9915,36764,6276,3058,3218
31325,48535,11767,23454,9917,36768,6276,3058,3218
31330,48545,11770,23459,9919,36774,6277,3059,3218
31335,48551,11771,23461,9920,36780,6279,3060,3219
31340,48562,11775,23467,9924,36786,6280,3061,3219
31345,48566,11777,23470,9926,36789,6280,3061,3219
31350,48576,11780,23472,9927,36795,6281,3061,3220
31355,48582,11781,23473,9928,36801,6283,3062,3221
31360,48593,11784,23477,9930,36809,6284,3063,3221
31365,48597,11784,23479,9930,36813,6284,3063,3221
31370,48607,11786,23482,9931,36820,6285,3063,3222
31375,48613,11787,23486,9932,36825,6287,3064,3223
31380,48624,11793,23493,9938,36829,6288,3064,3224
31385,48628,11795,23495,9940,36832,6288,3064,3224
31390,48638,11799,23501,9943,36838,6289,3065,3224
31395,48644,11800,23504,9944,36843,6291,3065,3226
31400,48655,11803,23509,9947,36850,6292,3066,3226
31405,48659,11806,23512,9950,36852,6292,3066,3226
31410,48669,11809,23515,9952,36859,6293,3067,3226
31415,48675,11810,23519,9953,36865,6295,3068,3227
31420,48686,11814,23527,9957,36869,6296,3069,3227
31425,48690,11817,23528,9960,36872,6296,3069,3227
31430,48700,11821,23533,9964,36877,6297,3069,3228
31435,48706,11824,23536,9967,36881,6299,3070,3229
31440,48717,11829,23541,9971,36886,6300,3070,3230
31445,48721,11832,23542,9974,36889,6300,3070,3230
31450,48731,11836,23549,9978,36894,6301,3070,3231
31455,48737,11836,23553,9978,36899,6303,3072,3231
31460,48748,11839,23560,9981,36908,6304,3073,3231
31465,48752,11839,23562,9981,36912,6304,3073,3231
31470,48762,11840,23566,9982,36921,6305,3073,3232
31475,48768,11841,23569,9983,36926,6307,3073,3234
31480,48779,11841,23574,9983,36936,6308,3073,3235
31485,48783,11842,23577,9984,36940,6308,3073,3235
31490,48793,11843,23579,9984,36949,6309,3073,3236
31495,48799,11843,23580,9984,36956,6311,3074,3237
31500,48810,11843,23584,9984,36966,6312,3074,3238
31505,48814,11844,23587,9985,36969,6312,3074,3238
31510,48824,11845,23593,9986,36978,6313,3074,3239
31515,48830,11845,23597,9986,36984,6315,3075,3240
31520,48841,11845,23602,9986,36995,6316,3075,3241
31525,48845,11845,23604,9986,37000,6316,3075,3241
31530,48855,11846,23607,9986,37008,6317,3076,3241
31535,48861,11846,23608,9986,37015,6319,3076,3243
31540,48872,11846,23610,9986,37025,6320,3076,3244
31545,48876,11846,23611,9986,37030,6320,3076,3244
31550,48886,11848,23617,9988,37037,6321,3077,3244
31555,48892,11848,23619,9988,37044,6323,3077,3246
31560,48903,11850,23623,9989,37051,6324,3077,3247
31565,48907,11851,23623,9990,37056,6324,3077,3247
31570,48917,11854,23627,9991,37062,6325,3078,3247
31575,48923,11854,23629,9991,37068,6327,3079,3248
31580,48934,11858,23638,9995,37072,6328,3080,3248
31585,48938,11861,23641,9998,37077,6328,3080,3248
31590,48948,11863,23642,9998,37084,6329,3080,3249
31595,48954,11864,23646,9999,37090,6331,3081,3250
31600,48965,11867,23651,10002,37097,6332,3082,3250
31605,48969,11869,23653,10004,37100,6332,3082,3250
31610,48979,11872,23656,10005,37106,6333,3083,3250
31615,48985,11872,23657,10005,37112,6335,3083,3252
31620,48996,11874,23661,10006,37119,6336,3084,3252
31625,49000,11878,23662,10010,37122,6336,3084,3252
31630,49010,11882,23671,10013,37127,6337,3085,3252
31635,49016,11884,23676,10015,37131,6339,3087,3252
31640,49027,11888,23681,10019,37137,6340,3087,3253
31645,49031,11891,23683,10022,37139,6340,3087,3253
31650,49041,11894,23687,10025,37146,6341,3088,3253
31655,49047,11895,23692,10026,37151,6343,3089,3254
31660,49058,11899,23700,10030,37154,6344,3089,3255
31665,49062,11904,23702,10035,37157,6344,3089,3255
31670,49072,11909,23706,10039,37162,6345,3089,3256
31675,49078,11910,23708,10040,37166,6347,3089,3258
31680,49089,11915,23715,10045,37171,6348,3090,3258
31685,49093,11918,23717,10048,37174,6348,3090,3258
31690,49103,11919,23724,10049,37183,6349,3091,3258
31695,49109,11920,23727,10050,37188,6351,3092,3259
31700,49120,11923,23733,10052,37195,6352,3092,3260
31705,49124,11925,23734,10054,37199,6352,3092,3260
31710,49134,11926,23739,10054,37207,6353,3093,3260
31715,49140,11926,23743,10054,37212,6355,3095,3260
31720,49151,11928,23748,10055,37221,6356,3096,3260
31725,49155,11930,23750,10057,37224,6356,3096,3260
31730,49165,11933,23759,10060,37231,6357,3097,3260
31735,49171,11934,23762,10061,37237,6359,3099,3260
31740,49182,11934,23764,10061,37248,6360,3099,3261
31745,49186,11934,23767,10061,37252,6360,3099,3261
31750,49196,11935,23770,10061,37260,6361,3099,3262
31755,49202,11935,23771,10061,37267,6363,3099,3264
31760,49213,11936,23776,10062,37277,6364,3099,3265
31765,49217,11936,23778,10062,37281,6364,3099,3265
31770,49227,11937,23785,10062,37289,6365,3099,3266
31775,49233,11938,23789,10063,37295,6367,3100,3267
31780,49244,11939,23796,10064,37305,6368,3100,3268
31785,49248,11939,23797,10064,37309,6368,3100,3268
31790,49258,11941,23801,10065,37316,6369,3101,3268
31795,49264,11942,23805,10066,37321,6371,3103,3268
31800,49275,11943,23811,10067,37331,6372,3104,3268
31805,49279,11943,23813,10067,37336,6372,3104,3268
31810,49289,11945,23816,10068,37343,6373,3105,3268
31815,49295,11946,23820,10069,37349,6375,3106,3269
31820,49306,11946,23823,10069,37359,6376,3106,3270
31825,49310,11946,23825,10069,37364,6376,3106,3270
31830,49320,11948,23829,10070,37371,6377,3107,3270
31835,49326,11948,23833,10070,37377,6379,3109,3270
31840,49337,11950,23835,10071,37386,6380,3110,3270
31845,49341,11952,23837,10073,37388,6380,3110,3270
31850,49351,11957,23841,10077,37393,6381,3111,3270
31855,49357,11958,23845,10078,37397,6383,3112,3271
31860,49368,11964,23850,10083,37402,6384,3112,3272
31865,49372,11967,23853,10086,37403,6384,3112,3272
31870,49382,11974,23860,10093,37406,6385,3112,3273
31875,49388,11977,23863,10096,37409,6387,3112,3275
31880,49399,11981,23869,10100,37415,6388,3113,3275
31885,49403,11984,23870,10103,37418,6388,3113,3275
31890,49413,11987,23876,10105,37425,6389,3114,3275
31895,49419,11988,23881,10106,37431,6391,3115,3276
31900,49430,11990,23884,10107,37439,6392,3115,3277
31905,49434,11990,23886,10107,37444,6392,3115,3277
31910,49444,11992,23892,10109,37451,6393,3116,3277
31915,49450,11993,23894,10110,37457,6395,3117,3278
31920,49461,11995,23899,10111,37464,6396,3117,3279
31925,49465,11998,23901,10114,37467,6396,3117,3279
31930,49475,11999,23904,10114,37475,6397,3117,3280
31935,49481,12001,23908,10116,37480,6399,3117,3282
31940,49492,12002,23912,10116,37488,6400,3118,3282
31945,49496,12003,23913,10117,37493,6400,3118,3282
31950,49506,12005,23919,10119,37501,6401,3118,3283
31955,49512,12005,23922,10119,37507,6403,3120,3283
31960,49523,12007,23928,10121,37513,6404,3120,3284
31965,49527,12010,23930,10124,37517,6404,3120,3284
31970,49537,12011,23931,10124,37526,6405,3121,3284
31975,49543,12012,23937,10125,37531,6407,3123,3284
31980,49554,12014,23942,10126,37539,6408,3124,3284
31985,49558,12015,23944,10127,37543,6408,3124,3284
31990,49568,12016,23947,10127,37552,6409,3125,3284
31995,49574,12016,23949,10127,37557,6411,3126,3285
32000,49585,12019,23954,10130,37563,6412,3126,3286
32005,49589,12022,23956,10133,37565,6412,3126,3286
32010,49599,12029,23964,10139,37569,6413,3127,3286
32015,49605,12030,23967,10140,37574,6415,3128,3287
32020,49616,12032,23971,10142,37583,6416,3129,3287
32025,49620,12033,23973,10143,37586,6416,3129,3287
32030,49630,12036,23978,10145,37593,6417,3129,3288
32035,49636,12038,23982,10147,37597,6419,3131,3288
32040,49647,12040,23985,10148,37606,6420,3132,3288
32045,49651,12040,23988,10148,37610,6420,3132,3288
32050,49661,12042,23993,10149,37619,6421,3132,3289
32055,49667,12043,23997,10150,37624,6423,3133,3290
32060,49678,12044,24004,10151,37631,6424,3133,3291
32065,49682,12046,24006,10153,37636,6424,3133,3291
32070,49692,12048,24011,10155,37644,6425,3133,3292
32075,49698,12048,24014,10155,37650,6427,3135,3292
32080,49709,12050,24022,10157,37657,6428,3136,3292
32085,49713,12051,24023,10158,37662,6428,3136,3292
32090,49723,12053,24027,10158,37669,6429,3137,3292
32095,49729,12053,24030,10158,37676,6431,3138,3293
32100,49740,12054,24035,10159,37684,6432,3139,3293
32105,49744,12056,24036,10161,37688,6432,3139,3293
32110,49754,12058,24040,10162,37696,6433,3140,3293
32115,49760,12058,24042,10162,37701,6435,3140,3295
32120,49771,12061,24045,10165,37709,6436,3140,3296
32125,49775,12063,24048,10167,37711,6436,3140,3296
32130,49785,12068,24053,10171,37717,6437,3141,3296
32135,49791,12069,24057,10172,37721,6439,3143,3296
32140,49802,12072,24063,10175,37728,6440,3144,3296
32145,49806,12075,24065,10178,37730,6440,3144,3296
32150,49816,12079,24068,10180,37736,6441,3144,3297
32155,49822,12080,24071,10181,37740,6443,3145,3298
32160,49833,12085,24076,10186,37746,6444,3145,3299
32165,49837,12088,24079,10189,37748,6444,3145,3299
32170,49847,12088,24083,10189,37758,6445,3146,3299
32175,49853,12089,24086,10190,37763,6447,3146,3301
32180,49864,12090,24087,10190,37773,6448,3146,3302
32185,49868,12090,24088,10190,37778,6448,3146,3302
32190,49878,12091,24092,10191,37787,6449,3146,3303
32195,49884,12091,24096,10191,37793,6451,3146,3305
32200,49895,12093,24102,10192,37800,6452,3146,3306
32205,49899,12094,24103,10193,37805,6452,3146,3306
32210,49909,12095,24107,10194,37814,6453,3147,3306
32215,49915,12095,24109,10194,37820,6455,3148,3307
32220,49926,12097,24117,10196,37827,6456,3148,3308
32225,49930,12098,24118,10197,37832,6456,3148,3308
32230,49940,12099,24124,10198,37841,6457,3148,3309
32235,49946,12099,24127,10198,37847,6459,3149,3310
32240,49957,12101,24134,10200,37854,6460,3150,3310
32245,49961,12103,24138,10202,37858,6460,3150,3310
32250,49971,12104,24142,10203,37866,6461,3151,3310
32255,49977,12105,24145,10204,37872,6463,3151,3312
32260,49988,12106,24150,10204,37882,6464,3152,3312
32265,49992,12106,24151,10204,37885,6464,3152,3312
32270,50002,12109,24153,10205,37892,6465,3152,3313
32275,50008,12111,24159,10207,37896,6467,3154,3313
32280,50019,12113,24163,10208,37903,6468,3155,3313
32285,50023,12115,24164,10210,37907,6468,3155,3313
32290,50033,12119,24168,10213,37914,6469,3155,3314
32295,50039,12119,24169,10213,37920,6471,3156,3315
32300,50050,12122,24173,10215,37926,6472,3156,3316
32305,50054,12124,24174,10217,37929,6472,3156,3316
32310,50064,12130,24179,10222,37934,6473,3157,3316
32315,50070,12130,24181,10222,37939,6475,3158,3317
32320,50081,12135,24185,10226,37945,6476,3158,3318
32325,50085,12137,24187,10228,37947,6476,3158,3318
32330,50095,12142,24190,10231,37953,6477,3158,3319
32335,50101,12142,24192,10231,37958,6479,3159,3320
32340,50112,12144,24196,10233,37967,6480,3159,3321
32345,50116,12145,24197,10234,37971,6480,3159,3321
32350,50126,12148,24202,10236,37978,6481,3160,3321
32355,50132,12148,24206,10236,37983,6483,3162,3321
32360,50143,12152,24213,10240,37988,6484,3163,3321
32365,50147,12155,24215,10243,37992,6484,3163,3321
32370,50157,12158,24219,10245,37999,6485,3163,3322
32375,50163,12158,24223,10245,38004,6487,3165,3322
32380,50174,12160,24227,10247,38012,6488,3165,3323
32385,50178,12161,24228,10248,38017,6488,3165,3323
32390,50188,12164,24231,10249,38024,6489,3165,3324
32395,50194,12164,24234,10249,38029,6491,3166,3325
32400,50205,12166,24239,10251,38037,6492,3167,3325
32405,50209,12167,24241,10252,38042,6492,3167,3325
32410,50219,12169,24243,10253,38050,6493,3168,3325
32415,50225,12170,24248,10254,38053,6495,3170,3325
32420,50236,12173,24254,10257,38059,6496,3170,3326
32425,50240,12177,24257,10261,38062,6496,3170,3326
32430,50250,12180,24264,10264,38069,6497,3171,3326
32435,50256,12181,24268,10265,38073,6499,3172,3327
32440,50267,12184,24274,10268,38080,6500,3173,3327
32445,50271,12186,24276,10270,38084,6500,3173,3327
32450,50281,12189,24282,10271,38091,6501,3174,3327
32455,50287,12190,24285,10272,38097,6503,3175,3328
32460,50298,12193,24289,10275,38104,6504,3175,3329
32465,50302,12194,24290,10276,38108,6504,3175,3329
32470,50312,12196,24297,10278,38116,6505,3176,3329
32475,50318,12196,24300,10278,38121,6507,3177,3330
32480,50329,12199,24304,10281,38130,6508,3177,3331
32485,50333,12200,24307,10282,38132,6508,3177,3331
32490,50343,12203,24312,10285,38140,6509,3177,3332
32495,50349,12203,24313,10285,38146,6511,3177,3334
32500,50360,12206,24320,10288,38153,6512,3178,3334
32505,50364,12206,24323,10288,38157,6512,3178,3334
32510,50374,12209,24328,10289,38164,6513,3179,3334
32515,50380,12210,24331,10290,38170,6515,3180,3335
32520,50391,12211,24336,10291,38178,6516,3180,3336
32525,50395,12212,24339,10292,38183,6516,3180,3336
32530,50405,12213,24342,10292,38192,6517,3180,3337
32535,50411,12214,24346,10293,38197,6519,3181,3338
32540,50422,12217,24352,10296,38205,6520,3182,3338
32545,50426,12217,24354,10296,38209,6520,3182,3338
32550,50436,12219,24360,10298,38216,6521,3183,3338
32555,50442,12221,24363,10300,38221,6523,3184,3339
32560,50453,12222,24369,10300,38229,6524,3185,3339
32565,50457,12224,24371,10302,38233,6524,3185,3339
32570,50467,12225,24376,10302,38241,6525,3186,3339
32575,50473,12226,24380,10303,38245,6527,3188,3339
32580,50484,12228,24384,10304,38254,6528,3189,3339
32585,50488,12230,24386,10306,38258,6528,3189,3339
32590,50498,12232,24390,10308,38266,6529,3190,3339
32595,50504,12233,24394,10309,38269,6531,3191,3340
32600,50515,12234,24397,10310,38281,6532,3191,3341
32605,50519,12234,24397,10310,38285,6532,3191,3341
32610,50529,12236,24402,10312,38292,6533,3191,3342
32615,50535,12237,24403,10313,38298,6535,3191,3344
32620,50546,12240,24408,10315,38304,6536,3191,3345
32625,50550,12242,24410,10317,38307,6536,3191,3345
32630,50560,12247,24413,10320,38312,6537,3191,3346
32635,50566,12249,24416,10322,38316,6539,3192,3347
32640,50577,12252,24419,10325,38324,6540,3192,3348
32645,50581,12254,24421,10327,38326,6540,3192,3348
32650,50591,12259,24425,10330,38332,6541,3192,3349
32655,50597,12260,24429,10331,38337,6543,3194,3349
32660,50608,12263,24436,10333,38341,6544,3195,3349
32665,50612,12267,24440,10337,38344,6544,3195,3349
32670,50622,12270,24445,10340,38352,6545,3196,3349
32675,50628,12270,24447,10340,38358,6547,3197,3350
32680,50639,12271,24450,10340,38367,6548,3198,3350
32685,50643,12272,24452,10341,38370,6548,3198,3350
32690,50653,12275,24457,10344,38378,6549,3198,3351
32695,50659,12275,24459,10344,38383,6551,3198,3353
32700,50670,12279,24466,10348,38388,6552,3199,3353
32705,50674,12282,24468,10351,38391,6552,3199,3353
32710,50684,12285,24474,10353,38399,6553,3200,3353
32715,50690,12285,24477,10353,38404,6555,3202,3353
32720,50701,12287,24481,10354,38411,6556,3202,3354
32725,50705,12291,24483,10358,38414,6556,3202,3354
32730,50715,12293,24489,10359,38422,6557,3203,3354
32735,50721,12294,24494,10360,38425,6559,3204,3355
32740,50732,12296,24501,10362,38434,6560,3205,3355
32745,50736,12296,24503,10362,38439,6560,3205,3355
32750,50746,12298,24509,10362,38447,6561,3206,3355
32755,50752,12298,24511,10362,38454,6563,3207,3356
32760,50763,12298,24514,10362,38464,6564,3207,3357
32765,50767,12298,24515,10362,38469,6564,3207,3357
32770,50777,12300,24519,10362,38476,6565,3207,3358
32775,50783,12300,24521,10362,38483,6567,3207,3360
32780,50794,12300,24526,10362,38492,6568,3208,3360
32785,50798,12301,24528,10363,38496,6568,3208,3360
32790,50808,12304,24535,10366,38503,6569,3209,3360
32795,50814,12305,24540,10367,38509,6571,3211,3360
32800,50825,12308,24546,10370,38515,6572,3212,3360
32805,50829,12310,24549,10372,38518,6572,3212,3360
32810,50839,12313,24553,10373,38526,6573,3213,3360
32815,50845,12314,24557,10374,38530,6575,3214,3361
32820,50856,12317,24562,10377,38538,6576,3215,3361
32825,50860,12318,24565,10378,38541,6576,3215,3361
32830,50870,12321,24569,10380,38549,6577,3216,3361
32835,50876,12321,24573,10380,38555,6579,3218,3361
32840,50887,12325,24579,10384,38561,6580,3219,3361
32845,50891,12328,24581,10387,38563,6580,3219,3361
32850,50901,12332,24585,10389,38569,6581,3219,3362
32855,50907,12332,24587,10389,38573,6583,3219,3364
32860,50918,12336,24590,10392,38580,6584,3219,3365
32865,50922,12338,24590,10394,38584,6584,3219,3365
32870,50932,12344,24597,10400,38587,6585,3219,3366
32875,50938,12345,24598,10401,38592,6587,3219,3368
32880,50949,12348,24602,10403,38601,6588,3220,3368
32885,50953,12348,24604,10403,38605,6588,3220,3368
32890,50963,12349,24608,10404,38613,6589,3220,3369
32895,50969,12351,24613,10406,38616,6591,3221,3370
32900,50980,12353,24618,10408,38627,6592,3222,3370
32905,50984,12354,24621,10409,38629,6592,3222,3370
32910,50994,12357,24625,10411,38637,6593,3222,3371
32915,51000,12358,24630,10412,38640,6595,3223,3372
32920,51011,12359,24633,10413,38651,6596,3224,3372
32925,51015,12360,24634,10414,38654,6596,3224,3372
32930,51025,12362,24640,10415,38662,6597,3225,3372
32935,51031,12363,24641,10416,38668,6599,3226,3373
32940,51042,12365,24646,10417,38675,6600,3227,3373
32945,51046,12368,24649,10420,38677,6600,3227,3373
32950,51056,12369,24655,10421,38686,6601,3228,3373
32955,51062,12371,24658,10423,38691,6603,3229,3374
32960,51073,12374,24664,10426,38697,6604,3229,3375
32965,51077,12376,24666,10428,38701,6604,3229,3375
32970,51087,12378,24673,10430,38708,6605,3230,3375
32975,51093,12379,24675,10431,38713,6607,3230,3377
32980,51104,12380,24680,10432,38721,6608,3230,3378
32985,51108,12381,24682,10433,38726,6608,3230,3378
32990,51118,12383,24687,10434,38735,6609,3230,3379
32995,51124,12383,24689,10434,38740,6611,3230,3381
33000,51135,12384,24692,10435,38748,6612,3230,3382
33005,51139,12386,24692,10437,38753,6612,3230,3382
33010,51149,12388,24699,10439,38760,6613,3230,3383
33015,51155,12389,24702,10440,38766,6615,3231,3384
33020,51166,12390,24709,10441,38773,6616,3231,3385
33025,51170,12392,24713,10443,38778,6616,3231,3385
33030,51180,12394,24717,10444,38786,6617,3231,3386
33035,51186,12394,24719,10444,38792,6619,3232,3387
33040,51197,12396,24725,10446,38800,6620,3232,3388
33045,51201,12397,24726,10447,38804,6620,3232,3388
33050,51211,12399,24733,10449,38812,6621,3232,3389
33055,51217,12399,24736,10449,38817,6623,3233,3390
33060,51228,12401,24740,10451,38826,6624,3233,3391
33065,51232,12402,24741,10452,38830,6624,3233,3391
33070,51242,12404,24746,10453,38838,6625,3233,3392
33075,51248,12405,24749,10454,38843,6627,3234,3393
33080,51259,12405,24752,10454,38852,6628,3235,3393
33085,51263,12409,24756,10458,38853,6628,3235,3393
33090,51273,12413,24760,10461,38860,6629,3235,3394
33095,51279,12413,24765,10461,38865,6631,3237,3394
33100,51290,12418,24770,10465,38871,6632,3238,3394
33105,51294,12419,24771,10466,38874,6632,3238,3394
33110,51304,12424,24778,10471,38878,6633,3239,3394
33115,51310,12426,24781,10473,38883,6635,3241,3394
33120,51321,12429,24787,10476,38888,6636,3241,3395
33125,51325,12435,24790,10482,38889,6636,3241,3395
33130,51335,12438,24794,10484,38896,6637,3242,3395
33135,51341,12440,24798,10486,38899,6639,3243,3396
33140,51352,12441,24800,10487,38910,6640,3243,3397
33145,51356,12443,24803,10489,38913,6640,3243,3397
33150,51366,12445,24809,10491,38920,6641,3244,3397
33155,51372,12447,24810,10493,38925,6643,3244,3399
33160,51383,12448,24815,10493,38932,6644,3245,3399
33165,51387,12451,24816,10496,38936,6644,3245,3399
33170,51397,12454,24821,10499,38943,6645,3246,3399
33175,51403,12454,24822,10499,38949,6647,3247,3400
33180,51414,12456,24827,10501,38956,6648,3247,3401
33185,51418,12459,24829,10504,38958,6648,3247,3401
33190,51428,12462,24837,10506,38965,6649,3247,3402
33195,51434,12464,24841,10508,38970,6651,3249,3402
33200,51445,12465,24847,10509,38978,6652,3250,3402
33205,51449,12466,24848,10510,38983,6652,3250,3402
33210,51459,12467,24852,10511,38992,6653,3250,3403
33215,51465,12467,24854,10511,38997,6655,3251,3404
33220,51476,12467,24858,10511,39007,6656,3251,3405
33225,51480,12468,24860,10512,39011,6656,3251,3405
33230,51490,12469,24866,10513,39020,6657,3251,3406
33235,51496,12469,24867,10513,39027,6659,3252,3407
33240,51507,12471,24872,10515,39035,6660,3252,3408
33245,51511,12471,24873,10515,39039,6660,3252,3408
33250,51521,12473,24876,10516,39048,6661,3252,3409
33255,51527,12473,24877,10516,39054,6663,3253,3410
33260,51538,12475,24883,10518,39060,6664,3253,3411
33265,51542,12476,24886,10519,39066,6664,3253,3411
33270,51552,12478,24888,10519,39074,6665,3254,3411
33275,51558,12479,24892,10520,39079,6667,3256,3411
33280,51569,12479,24898,10520,39088,6668,3256,3412
33285,51573,12480,24900,10521,39093,6668,3256,3412
33290,51583,12482,24903,10521,39101,6669,3256,3413
33295,51589,12482,24907,10521,39106,6671,3257,3414
33300,51600,12486,24914,10525,39110,6672,3257,3415
33305,51604,12490,24916,10529,39113,6672,3257,3415
33310,51614,12494,24919,10531,39120,6673,3257,3416
33315,51620,12494,24921,10531,39125,6675,3258,3417
33320,51631,12498,24925,10534,39131,6676,3258,3418
33325,51635,12501,24926,10537,39134,6676,3258,3418
33330,51645,12503,24931,10537,39141,6677,3258,3419
33335,51651,12505,24934,10539,39145,6679,3259,3420
33340,51662,12509,24940,10543,39150,6680,3259,3421
33345,51666,12512,24941,10546,39154,6680,3259,3421
33350,51676,12515,24945,10547,39161,6681,3260,3421
33355,51682,12515,24948,10547,39167,6683,3261,3422
33360,51693,12520,24953,10551,39173,6684,3262,3422
33365,51697,12521,24956,10552,39174,6684,3262,3422
33370,51707,12527,24959,10557,39179,6685,3262,3423
33375,51713,12527,24961,10557,39185,6687,3263,3424
33380,51724,12531,24966,10560,39191,6688,3264,3424
33385,51728,12534,24969,10563,39192,6688,3264,3424
33390,51738,12541,24974,10569,39196,6689,3265,3424
33395,51744,12541,24977,10569,39201,6691,3266,3425
33400,51755,12546,24982,10574,39208,6692,3267,3425
33405,51759,12548,24984,10576,39210,6692,3267,3425
33410,51769,12554,24992,10582,39214,6693,3267,3426
33415,51775,12555,24995,10583,39220,6695,3269,3426
33420,51786,12555,25000,10583,39228,6696,3269,3427
33425,51790,12556,25002,10584,39233,6696,3269,3427
33430,51800,12557,25008,10585,39242,6697,3269,3428
33435,51806,12557,25009,10585,39249,6699,3269,3430
33440,51817,12557,25014,10585,39258,6700,3269,3431
33445,51821,12557,25016,10585,39263,6700,3269,3431
33450,51831,12558,25023,10585,39272,6701,3270,3431
33455,51837,12559,25028,10586,39277,6703,3272,3431
33460,51848,12560,25036,10587,39286,6704,3273,3431
33465,51852,12561,25038,10588,39290,6704,3273,3431
33470,51862,12562,25043,10589,39299,6705,3273,3432
33475,51868,12562,25045,10589,39306,6707,3273,3434
33480,51879,12563,25048,10590,39315,6708,3273,3435
33485,51883,12563,25050,10590,39320,6708,3273,3435
33490,51893,12564,25053,10590,39328,6709,3273,3436
33495,51899,12565,25057,10591,39334,6711,3275,3436
33500,51910,12565,25061,10591,39342,6712,3275,3437
33505,51914,12566,25064,10592,39348,6712,3275,3437
33510,51924,12567,25068,10593,39356,6713,3275,3438
33515,51930,12568,25072,10594,39361,6715,3276,3439
33520,51941,12571,25075,10596,39369,6716,3276,3440
33525,51945,12573,25077,10598,39372,6716,3276,3440
33530,51955,12575,25083,10599,39379,6717,3277,3440
33535,51961,12576,25085,10600,39385,6719,3278,3441
33540,51972,12579,25092,10603,39391,6720,3279,3441
33545,51976,12582,25094,10606,39394,6720,3279,3441
33550,51986,12584,25099,10606,39401,6721,3280,3441
33555,51992,12584,25101,10606,39408,6723,3280,3443
33560,52003,12586,25105,10608,39416,6724,3281,3443
33565,52007,12587,25106,10609,39419,6724,3281,3443
33570,52017,12591,25112,10612,39425,6725,3282,3443
33575,52023,12592,25116,10613,39429,6727,3282,3445
33580,52034,12598,25120,10618,39435,6728,3282,3446
33585,52038,12600,25122,10620,39437,6728,3282,3446
33590,52048,12606,25129,10626,39441,6729,3282,3447
33595,52054,12608,25133,10628,39446,6731,3284,3447
33600,52065,12609,25138,10629,39454,6732,3285,3447
33605,52069,12612,25140,10632,39456,6732,3285,3447
33610,52079,12618,25148,10638,39460,6733,3286,3447
33615,52085,12619,25151,10639,39465,6735,3288,3447
33620,52096,12622,25154,10641,39473,6736,3289,3447
33625,52100,12623,25155,10642,39476,6736,3289,3447
33630,52110,12628,25158,10645,39481,6737,3290,3447
33635,52116,12628,25159,10645,39487,6739,3290,3449
33640,52127,12631,25162,10647,39494,6740,3290,3450
33645,52131,12633,25163,10649,39497,6740,3290,3450
33650,52141,12638,25167,10653,39502,6741,3290,3451
33655,52147,12639,25170,10654,39507,6743,3292,3451
33660,52158,12643,25176,10657,39513,6744,3292,3452
33665,52162,12644,25177,10658,39518,6744,3292,3452
33670,52172,12647,25182,10661,39524,6745,3292,3453
33675,52178,12648,25185,10662,39529,6747,3293,3454
33680,52189,12650,25190,10664,39538,6748,3294,3454
33685,52193,12650,25192,10664,39543,6748,3294,3454
33690,52203,12651,25196,10664,39551,6749,3295,3454
33695,52209,12652,25198,10665,39557,6751,3296,3455
33700,52220,12655,25204,10668,39562,6752,3296,3456
33705,52224,12658,25208,10671,39565,6752,3296,3456
33710,52234,12660,25216,10673,39573,6753,3297,3456
33715,52240,12662,25218,10675,39578,6755,3298,3457
33720,52251,12663,25221,10676,39588,6756,3299,3457
33725,52255,12664,25224,10677,39590,6756,3299,3457
33730,52265,12665,25231,10677,39599,6757,3300,3457
33735,52271,12665,25232,10677,39606,6759,3301,3458
33740,52282,12665,25241,10677,39614,6760,3302,3458
33745,52286,12666,25243,10678,39619,6760,3302,3458
33750,52296,12667,25250,10678,39628,6761,3303,3458
33755,52302,12668,25255,10679,39633,6763,3304,3459
33760,52313,12669,25261,10680,39642,6764,3305,3459
33765,52317,12670,25262,10681,39647,6764,3305,3459
33770,52327,12672,25266,10682,39654,6765,3305,3460
33775,52333,12672,25269,10682,39659,6767,3306,3461
33780,52344,12673,25272,10683,39670,6768,3306,3462
33785,52348,12673,25274,10683,39675,6768,3306,3462
33790,52358,12675,25280,10683,39682,6769,3306,3463
33795,52364,12676,25281,10684,39688,6771,3306,3465
33800,52375,12678,25286,10686,39696,6772,3307,3465
33805,52379,12680,25288,10688,39699,6772,3307,3465
33810,52389,12682,25293,10689,39706,6773,3308,3465
33815,52395,12683,25296,10690,39712,6775,3309,3466
33820,52406,12685,25301,10692,39719,6776,3310,3466
33825,52410,12686,25303,10693,39724,6776,3310,3466
33830,52420,12688,25307,10693,39731,6777,3310,3467
33835,52426,12689,25309,10694,39737,6779,3311,3468
33840,52437,12691,25314,10696,39744,6780,3312,3468
33845,52441,12693,25314,10698,39748,6780,3312,3468
33850,52451,12695,25318,10699,39755,6781,3313,3468
33855,52457,12696,25321,10700,39760,6783,3313,3470
33860,52468,12699,25327,10703,39766,6784,3313,3471
33865,52472,12702,25328,10706,39770,6784,3313,3471
33870,52482,12705,25334,10709,39776,6785,3314,3471
33875,52488,12705,25336,10709,39783,6787,3314,3473
33880,52499,12709,25343,10713,39788,6788,3314,3474
33885,52503,12711,25344,10715,39792,6788,3314,3474
33890,52513,12713,25347,10717,39798,6789,3314,3475
33895,52519,12714,25350,10718,39803,6791,3315,3476
33900,52530,12718,25357,10721,39808,6792,3315,3477
33905,52534,12723,25358,10726,39811,6792,3315,3477
33910,52544,12724,25359,10726,39819,6793,3316,3477
33915,52550,12724,25361,10726,39825,6795,3317,3478
33920,52561,12726,25366,10727,39832,6796,3318,3478
33925,52565,12729,25367,10730,39835,6796,3318,3478
33930,52575,12735,25373,10735,39838,6797,3318,3479
33935,52581,12737,25373,10737,39844,6799,3318,3481
33940,52592,12739,25379,10739,39851,6800,3318,3482
33945,52596,12742,25381,10742,39853,6800,3318,3482
33950,52606,12747,25387,10746,39857,6801,3318,3483
33955,52612,12748,25390,10747,39862,6803,3319,3484
33960,52623,12750,25395,10749,39872,6804,3320,3484
33965,52627,12750,25397,10749,39877,6804,3320,3484
33970,52637,12751,25403,10749,39885,6805,3321,3484
33975,52643,12751,25403,10749,39892,6807,3321,3486
33980,52654,12751,25406,10749,39901,6808,3321,3487
33985,52658,12752,25406,10750,39906,6808,3321,3487
33990,52668,12753,25412,10750,39914,6809,3321,3488
33995,52674,12753,25415,10750,39921,6811,3322,3489
34000,52685,12754,25420,10751,39931,6812,3322,3490
34005,52689,12754,25421,10751,39935,6812,3322,3490
34010,52699,12755,25426,10752,39943,6813,3322,3491
34015,52705,12755,25427,10752,39950,6815,3323,3492
34020,52716,12756,25431,10753,39959,6816,3324,3492
34025,52720,12756,25431,10753,39964,6816,3324,3492
34030,52730,12757,25435,10753,39972,6817,3324,3493
34035,52736,12757,25437,10753,39979,6819,3325,3494
34040,52747,12758,25444,10754,39987,6820,3325,3495
34045,52751,12758,25446,10754,39993,6820,3325,3495
34050,52761,12760,25453,10756,40000,6821,3325,3496
34055,52767,12761,25456,10757,40006,6823,3326,3497
34060,52778,12764,25461,10759,40013,6824,3327,3497
34065,52782,12765,25463,10760,40016,6824,3327,3497
34070,52792,12769,25467,10763,40022,6825,3327,3498
34075,52798,12771,25472,10765,40025,6827,3329,3498
34080,52809,12775,25477,10769,40031,6828,3329,3499
34085,52813,12779,25480,10773,40033,6828,3329,3499
34090,52823,12783,25483,10775,40040,6829,3329,3500
34095,52829,12783,25485,10775,40045,6831,3329,3502
34100,52840,12788,25492,10780,40050,6832,3330,3502
34105,52844,12792,25495,10784,40051,6832,3330,3502
34110,52854,12796,25499,10787,40058,6833,3331,3502
34115,52860,12796,25502,10787,40063,6835,3333,3502
34120,52871,12800,25507,10791,40069,6836,3333,3503
34125,52875,12803,25509,10794,40072,6836,3333,3503
34130,52885,12808,25515,10797,40076,6837,3333,3504
34135,52891,12809,25519,10798,40080,6839,3334,3505
34140,52902,12814,25525,10803,40087,6840,3335,3505
34145,52906,12816,25529,10805,40090,6840,3335,3505
34150,52916,12817,25531,10805,40098,6841,3335,3506
34155,52922,12819,25535,10807,40102,6843,3336,3507
34160,52933,12820,25538,10807,40111,6844,3336,3508
34165,52937,12823,25539,10810,40114,6844,3336,3508
34170,52947,12824,25545,10810,40122,6845,3336,3509
34175,52953,12825,25548,10811,40127,6847,3336,3511
34180,52964,12826,25553,10812,40137,6848,3336,3512
34185,52968,12827,25553,10813,40141,6848,3336,3512
34190,52978,12828,25557,10814,40149,6849,3337,3512
34195,52984,12829,25560,10815,40154,6851,3338,3513
34200,52995,12829,25566,10815,40165,6852,3338,3514
34205,52999,12829,25568,10815,40169,6852,3338,3514
34210,53009,12830,25575,10815,40178,6853,3338,3515
34215,53015,12830,25576,10815,40185,6855,3338,3517
34220,53026,12831,25583,10816,40193,6856,3338,3518
34225,53030,12831,25586,10816,40198,6856,3338,3518
34230,53040,12832,25593,10816,40207,6857,3339,3518
34235,53046,12833,25597,10817,40213,6859,3341,3518
34240,53057,12834,25603,10818,40220,6860,3341,3519
34245,53061,12835,25605,10819,40226,6860,3341,3519
34250,53071,12837,25609,10820,40233,6861,3341,3520
34255,53077,12838,25611,10821,40239,6863,3342,3521
34260,53088,12839,25616,10822,40248,6864,3342,3522
34265,53092,12840,25619,10823,40251,6864,3342,3522
34270,53102,12843,25623,10824,40259,6865,3343,3522
34275,53108,12843,25628,10824,40263,6867,3345,3522
34280,53119,12845,25632,10826,40272,6868,3346,3522
34285,53123,12848,25634,10829,40275,6868,3346,3522
34290,53133,12850,25638,10831,40282,6869,3346,3523
34295,53139,12851,25640,10832,40287,6871,3346,3525
34300,53150,12852,25644,10832,40294,6872,3346,3526
34305,53154,12855,25644,10835,40299,6872,3346,3526
34310,53164,12857,25650,10836,40307,6873,3347,3526
34315,53170,12858,25652,10837,40312,6875,3348,3527
34320,53181,12861,25657,10840,40318,6876,3348,3528
34325,53185,12864,25658,10843,40321,6876,3348,3528
34330,53195,12867,25660,10844,40327,6877,3348,3529
34335,53201,12869,25665,10846,40332,6879,3350,3529
34340,53212,12870,25671,10847,40338,6880,3351,3529
34345,53216,12875,25675,10852,40340,6880,3351,3529
34350,53226,12880,25681,10856,40345,6881,3351,3530
34355,53232,12881,25684,10857,40351,6883,3353,3530
34360,53243,12885,25690,10861,40356,6884,3353,3531
34365,53247,12886,25692,10862,40360,6884,3353,3531
34370,53257,12890,25698,10865,40366,6885,3354,3531
34375,53263,12892,25700,10867,40371,6887,3354,3533
34380,53274,12895,25706,10869,40376,6888,3355,3533
34385,53278,12897,25708,10871,40380,6888,3355,3533
34390,53288,12901,25711,10874,40387,6889,3355,3534
34395,53294,12901,25713,10874,40393,6891,3356,3535
34400,53305,12904,25718,10876,40398,6892,3356,3536
34405,53309,12908,25722,10880,40400,6892,3356,3536
34410,53319,12911,25726,10882,40408,6893,3357,3536
34415,53325,12911,25730,10882,40414,6895,3359,3536
34420,53336,12914,25737,10885,40419,6896,3360,3536
34425,53340,12917,25739,10888,40422,6896,3360,3536
34430,53350,12920,25746,10889,40430,6897,3361,3536
34435,53356,12921,25748,10890,40435,6899,3362,3537
34440,53367,12922,25753,10891,40444,6900,3363,3537
34445,53371,12923,25756,10892,40447,6900,3363,3537
34450,53381,12926,25759,10894,40454,6901,3363,3538
34455,53387,12927,25761,10895,40460,6903,3364,3539
34460,53398,12928,25763,10896,40470,6904,3364,3540
34465,53402,12928,25766,10896,40473,6904,3364,3540
34470,53412,12931,25770,10898,40481,6905,3365,3540
34475,53418,12932,25772,10899,40486,6907,3366,3541
34480,53429,12933,25774,10900,40496,6908,3366,3542
34485,53433,12933,25774,10900,40500,6908,3366,3542
34490,53443,12936,25781,10903,40507,6909,3367,3542
34495,53449,12937,25785,10904,40510,6911,3368,3543
34500,53460,12940,25790,10907,40518,6912,3369,3543
34505,53464,12942,25791,10909,40522,6912,3369,3543
34510,53474,12945,25796,10911,40529,6913,3370,3543
34515,53480,12946,25800,10912,40532,6915,3371,3544
34520,53491,12950,25808,10916,40538,6916,3371,3545
34525,53495,12951,25810,10917,40544,6916,3371,3545
34530,53505,12952,25816,10918,40553,6917,3371,3546
34535,53511,12952,25820,10918,40557,6919,3372,3547
34540,53522,12953,25825,10919,40566,6920,3373,3547
34545,53526,12956,25827,10922,40570,6920,3373,3547
34550,53536,12957,25831,10923,40578,6921,3374,3547
34555,53542,12958,25833,10924,40583,6923,3375,3548
34560,53553,12960,25840,10926,40590,6924,3376,3548
34565,53557,12962,25842,10928,40594,6924,3376,3548
34570,53567,12965,25849,10931,40601,6925,3376,3549
34575,53573,12966,25852,10932,40606,6927,3377,3550
34580,53584,12969,25857,10934,40613,6928,3378,3550
34585,53588,12970,25858,10935,40618,6928,3378,3550
34590,53598,12972,25860,10936,40626,6929,3378,3551
34595,53604,12972,25861,10936,40632,6931,3379,3552
34600,53615,12975,25868,10939,40639,6932,3380,3552
34605,53619,12977,25869,10941,40642,6932,3380,3552
34610,53629,12978,25871,10942,40651,6933,3381,3552
34615,53635,12978,25872,10942,40656,6935,3381,3554
34620,53646,12981,25882,10945,40661,6936,3382,3554
34625,53650,12985,25886,10949,40664,6936,3382,3554
34630,53660,12988,25890,10951,40672,6937,3382,3555
34635,53666,12988,25893,10951,40676,6939,3382,3557
34640,53677,12992,25899,10954,40683,6940,3383,3557
34645,53681,12993,25901,10955,40687,6940,3383,3557
34650,53691,12995,25907,10957,40695,6941,3383,3558
34655,53697,12995,25912,10957,40701,6943,3385,3558
34660,53708,12997,25916,10959,40708,6944,3385,3559
34665,53712,12998,25918,10960,40714,6944,3385,3559
34670,53722,13000,25925,10962,40721,6945,3385,3560
34675,53728,13001,25929,10963,40726,6947,3386,3561
34680,53739,13004,25936,10966,40732,6948,3387,3561
34685,53743,13007,25939,10969,40735,6948,3387,3561
34690,53753,13010,25945,10972,40742,6949,3387,3562
34695,53759,13011,25948,10973,40748,6951,3388,3563
34700,53770,13013,25953,10975,40757,6952,3389,3563
34705,53774,13013,25956,10975,40760,6952,3389,3563
34710,53784,13016,25963,10977,40767,6953,3389,3564
34715,53790,13016,25964,10977,40774,6955,3390,3565
34720,53801,13018,25969,10979,40781,6956,3390,3566
34725,53805,13020,25972,10981,40784,6956,3390,3566
34730,53815,13023,25978,10983,40791,6957,3391,3566
34735,53821,13024,25980,10984,40796,6959,3391,3568
34740,53832,13027,25984,10987,40804,6960,3391,3569
34745,53836,13028,25984,10988,40808,6960,3391,3569
34750,53846,13031,25990,10990,40814,6961,3392,3569
34755,53852,13032,25991,10991,40819,6963,3392,3571
34760,53863,13037,25999,10995,40821,6964,3392,3572
34765,53867,13042,26001,11000,40823,6964,3392,3572
34770,53877,13046,26005,11003,40830,6965,3392,3573
34775,53883,13048,26008,11005,40834,6967,3393,3574
34780,53894,13051,26014,11008,40841,6968,3393,3575
34785,53898,13053,26015,11010,40845,6968,3393,3575
34790,53908,13055,26018,11011,40853,6969,3393,3576
34795,53914,13056,26020,11012,40858,6971,3394,3577
34800,53925,13057,26025,11012,40866,6972,3395,3577
34805,53929,13059,26025,11014,40870,6972,3395,3577
34810,53939,13061,26030,11016,40878,6973,3396,3577
34815,53945,13062,26032,11017,40882,6975,3396,3579
34820,53956,13063,26037,11017,40890,6976,3396,3580
34825,53960,13067,26040,11021,40892,6976,3396,3580
34830,53970,13069,26042,11023,40901,6977,3396,3581
34835,53976,13069,26042,11023,40907,6979,3396,3583
34840,53987,13070,26047,11024,40916,6980,3397,3583
34845,53991,13071,26049,11025,40919,6980,3397,3583
34850,54001,13074,26054,11027,40927,6981,3397,3584
34855,54007,13074,26056,11027,40933,6983,3399,3584
34860,54018,13076,26062,11028,40940,6984,3400,3584
34865,54022,13078,26064,11030,40944,6984,3400,3584
34870,54032,13079,26066,11030,40953,6985,3400,3585
34875,54038,13080,26069,11031,40957,6987,3401,3586
34880,54049,13084,26074,11034,40963,6988,3401,3587
34885,54053,13087,26077,11037,40965,6988,3401,3587
34890,54063,13089,26083,11038,40973,6989,3402,3587
34895,54069,13090,26085,11039,40978,6991,3402,3589
34900,54080,13093,26092,11042,40983,6992,3402,3590
34905,54084,13096,26094,11045,40988,6992,3402,3590
34910,54094,13098,26100,11047,40996,6993,3402,3591
34915,54100,13098,26103,11047,41000,6995,3403,3592
34920,54111,13100,26107,11049,41010,6996,3403,3593
34925,54115,13101,26110,11050,41014,6996,3403,3593
34930,54125,13103,26117,11051,41022,6997,3404,3593
34935,54131,13103,26117,11051,41028,6999,3404,3595
34940,54142,13104,26122,11052,41036,7000,3404,3596
34945,54146,13105,26124,11053,41041,7000,3404,3596
34950,54156,13107,26129,11053,41048,7001,3404,3597
34955,54162,13107,26133,11053,41053,7003,3405,3598
34960,54173,13110,26139,11056,41061,7004,3405,3599
34965,54177,13113,26141,11059,41064,7004,3405,3599
34970,54187,13115,26143,11059,41072,7005,3406,3599
34975,54193,13115,26146,11059,41076,7007,3406,3601
34980,54204,13119,26152,11063,41085,7008,3407,3601
34985,54208,13120,26154,11064,41088,7008,3407,3601
34990,54218,13123,26160,11066,41094,7009,3407,3602
34995,54224,13124,26164,11067,41099,7011,3409,3602
35000,54235,13126,26167,11069,41108,7012,3409,3603
35005,54239,13126,26168,11069,41112,7012,3409,3603
35010,54249,13130,26173,11073,41118,7013,3409,3604
35015,54255,13131,26175,11074,41124,7015,3410,3605
35020,54266,13134,26181,11077,41130,7016,3410,3606
35025,54270,13136,26182,11079,41133,7016,3410,3606
35030,54280,13142,26187,11084,41137,7017,3410,3607
35035,54286,13143,26191,11085,41141,7019,3412,3607
35040,54297,13146,26193,11087,41149,7020,3412,3608
35045,54301,13150,26196,11091,41150,7020,3412,3608
35050,54311,13155,26199,11094,41155,7021,3412,3609
35055,54317,13156,26202,11095,41160,7023,3414,3609
35060,54328,13158,26207,11096,41167,7024,3414,3610
35065,54332,13160,26208,11098,41171,7024,3414,3610
35070,54342,13163,26214,11100,41178,7025,3415,3610
35075,54348,13164,26217,11101,41184,7027,3415,3612
35080,54359,13166,26223,11103,41191,7028,3416,3612
35085,54363,13168,26224,11105,41195,7028,3416,3612
35090,54373,13169,26226,11106,41203,7029,3416,3613
35095,54379,13170,26230,11107,41209,7031,3418,3613
35100,54390,13172,26234,11108,41217,7032,3419,3613
35105,54394,13173,26234,11109,41221,7032,3419,3613
35110,54404,13175,26240,11111,41229,7033,3420,3613
35115,54410,13176,26243,11112,41234,7035,3422,3613
35120,54421,13177,26246,11112,41242,7036,3422,3614
35125,54425,13180,26247,11115,41245,7036,3422,3614
35130,54435,13181,26250,11116,41253,7037,3423,3614
35135,54441,13183,26253,11118,41258,7039,3423,3616
35140,54452,13185,26260,11120,41266,7040,3424,3616
35145,54456,13187,26263,11122,41269,7040,3424,3616
35150,54466,13189,26269,11124,41276,7041,3425,3616
35155,54472,13190,26271,11125,41281,7043,3426,3617
35160,54483,13192,26280,11127,41287,7044,3427,3617
35165,54487,13195,26281,11130,41292,7044,3427,3617
35170,54497,13197,26283,11130,41299,7045,3428,3617
35175,54503,13197,26286,11130,41304,7047,3429,3618
35180,54514,13200,26291,11133,41311,7048,3430,3618
35185,54518,13203,26294,11136,41313,7048,3430,3618
35190,54528,13208,26300,11141,41319,7049,3430,3619
35195,54534,13209,26303,11142,41324,7051,3431,3620
35200,54545,13210,26305,11143,41334,7052,3431,3621
35205,54549,13212,26306,11145,41337,7052,3431,3621
35210,54559,13214,26309,11146,41345,7053,3432,3621
35215,54565,13215,26313,11147,41348,7055,3433,3622
35220,54576,13217,26316,11149,41358,7056,3433,3623
35225,54580,13218,26317,11150,41362,7056,3433,3623
35230,54590,13219,26324,11151,41371,7057,3434,3623
35235,54596,13219,26327,11151,41377,7059,3436,3623
35240,54607,13220,26332,11152,41385,7060,3436,3624
35245,54611,13220,26333,11152,41391,7060,3436,3624
35250,54621,13221,26336,11153,41400,7061,3436,3625
35255,54627,13222,26339,11154,41404,7063,3437,3626
35260,54638,13223,26343,11155,41413,7064,3437,3627
35265,54642,13225,26346,11157,41417,7064,3437,3627
35270,54652,13226,26349,11157,41426,7065,3438,3627
35275,54658,13227,26353,11158,41431,7067,3439,3628
35280,54669,13229,26359,11160,41437,7068,3439,3629
35285,54673,13231,26361,11162,41441,7068,3439,3629
35290,54683,13233,26366,11163,41450,7069,3440,3629
35295,54689,13234,26372,11164,41454,7071,3442,3629
35300,54700,13235,26375,11164,41464,7072,3443,3629
35305,54704,13237,26377,11166,41467,7072,3443,3629
35310,54714,13240,26382,11168,41474,7073,3443,3630
35315,54720,13240,26383,11168,41479,7075,3443,3632
35320,54731,13243,26388,11171,41487,7076,3444,3632
35325,54735,13245,26391,11173,41489,7076,3444,3632
35330,54745,13247,26395,11174,41497,7077,3445,3632
35335,54751,13248,26397,11175,41502,7079,3445,3634
35340,54762,13252,26403,11178,41508,7080,3446,3634
35345,54766,13254,26405,11180,41512,7080,3446,3634
35350,54776,13256,26408,11181,41520,7081,3447,3634
35355,54782,13256,26410,11181,41525,7083,3448,3635
35360,54793,13260,26415,11184,41532,7084,3448,3636
35365,54797,13261,26415,11185,41536,7084,3448,3636
35370,54807,13263,26418,11186,41543,7085,3449,3636
35375,54813,13264,26420,11187,41549,7087,3450,3637
35380,54824,13267,26427,11190,41554,7088,3450,3638
35385,54828,13271,26429,11194,41557,7088,3450,3638
35390,54838,13272,26434,11194,41565,7089,3450,3639
35395,54844,13273,26436,11195,41571,7091,3450,3641
35400,54855,13275,26442,11196,41577,7092,3450,3642
35405,54859,13279,26445,11200,41579,7092,3450,3642
35410,54869,13281,26450,11202,41588,7093,3451,3642
35415,54875,13281,26454,11202,41593,7095,3452,3643
35420,54886,13283,26460,11204,41602,7096,3452,3644
35425,54890,13285,26463,11206,41604,7096,3452,3644
35430,54900,13287,26468,11208,41612,7097,3452,3645
35435,54906,13287,26472,11208,41619,7099,3453,3646
35440,54917,13288,26478,11209,41628,7100,3454,3646
35445,54921,13290,26479,11211,41631,7100,3454,3646
35450,54931,13292,26481,11211,41639,7101,3455,3646
35455,54937,13292,26483,11211,41644,7103,3456,3647
35460,54948,13293,26486,11212,41653,7104,3456,3648
35465,54952,13296,26490,11215,41654,7104,3456,3648
35470,54962,13300,26497,11219,41662,7105,3457,3648
35475,54968,13301,26503,11220,41666,7107,3459,3648
35480,54979,13302,26510,11221,41676,7108,3460,3648
35485,54983,13303,26510,11222,41680,7108,3460,3648
35490,54993,13304,26515,11223,41688,7109,3461,3648
35495,54999,13305,26520,11224,41693,7111,3463,3648
35500,55010,13306,26525,11225,41703,7112,3463,3649
35505,55014,13307,26528,11226,41707,7112,3463,3649
35510,55024,13309,26533,11228,41714,7113,3463,3650
35515,55030,13310,26535,11229,41719,7115,3463,3652
35520,55041,13313,26542,11232,41728,7116,3464,3652
35525,55045,13314,26545,11233,41731,7116,3464,3652
35530,55055,13315,26548,11233,41739,7117,3464,3653
35535,55061,13317,26553,11235,41744,7119,3466,3653
35540,55072,13319,26560,11237,41750,7120,3466,3654
35545,55076,13322,26561,11240,41754,7120,3466,3654
35550,55086,13325,26567,11242,41760,7121,3466,3655
35555,55092,13327,26570,11244,41764,7123,3467,3656
35560,55103,13329,26576,11245,41772,7124,3468,3656
35565,55107,13331,26578,11247,41776,7124,3468,3656
35570,55117,13333,26583,11248,41784,7125,3469,3656
35575,55123,13333,26584,11248,41790,7127,3470,3657
35580,55134,13337,26588,11251,41796,7128,3470,3658
35585,55138,13338,26589,11252,41799,7128,3470,3658
35590,55148,13344,26596,11258,41803,7129,3470,3659
35595,55154,13346,26599,11260,41807,7131,3470,3661
35600,55165,13348,26602,11262,41817,7132,3471,3661
35605,55169,13349,26603,11263,41820,7132,3471,3661
35610,55179,13352,26607,11265,41826,7133,3471,3662
35615,55185,13353,26608,11266,41831,7135,3471,3664
35620,55196,13357,26616,11269,41835,7136,3472,3664
35625,55200,13359,26618,11271,41841,7136,3472,3664
35630,55210,13361,26620,11272,41849,7137,3472,3665
35635,55216,13361,26623,11272,41854,7139,3473,3666
35640,55227,13363,26628,11274,41863,7140,3474,3666
35645,55231,13364,26629,11275,41867,7140,3474,3666
35650,55241,13366,26632,11276,41875,7141,3474,3667
35655,55247,13367,26634,11277,41880,7143,3474,3669
35660,55258,13369,26638,11279,41888,7144,3474,3670
35665,55262,13370,26638,11280,41892,7144,3474,3670
35670,55272,13372,26645,11282,41899,7145,3475,3670
35675,55278,13373,26647,11283,41904,7147,3475,3672
35680,55289,13376,26657,11286,41909,7148,3476,3672
35685,55293,13378,26660,11288,41914,7148,3476,3672
35690,55303,13380,26664,11289,41923,7149,3476,3673
35695,55309,13380,26668,11289,41926,7151,3477,3674
35700,55320,13384,26672,11293,41936,7152,3478,3674
35705,55324,13385,26675,11294,41938,7152,3478,3674
35710,55334,13389,26678,11296,41945,7153,3479,3674
35715,55340,13390,26682,11297,41947,7155,3479,3676
35720,55351,13392,26687,11299,41957,7156,3479,3677
35725,55355,13393,26688,11300,41962,7156,3479,3677
35730,55365,13395,26690,11301,41970,7157,3479,3678
35735,55371,13395,26692,11301,41976,7159,3480,3679
35740,55382,13398,26698,11303,41983,7160,3480,3680
35745,55386,13399,26699,11304,41987,7160,3480,3680
35750,55396,13401,26703,11305,41994,7161,3480,3681
35755,55402,13403,26707,11307,41998,7163,3481,3682
35760,55413,13405,26710,11308,42008,7164,3482,3682
35765,55417,13406,26713,11309,42010,7164,3482,3682
35770,55427,13409,26719,11311,42018,7165,3483,3682
35775,55433,13410,26724,11312,42023,7167,3485,3682
35780,55444,13412,26731,11313,42028,7168,3486,3682
35785,55448,13415,26732,11316,42033,7168,3486,3682
35790,55458,13417,26737,11317,42040,7169,3487,3682
35795,55464,13418,26740,11318,42046,7171,3488,3683
35800,55475,13420,26745,11320,42053,7172,3488,3684
35805,55479,13422,26747,11322,42057,7172,3488,3684
35810,55489,13424,26753,11324,42065,7173,3489,3684
35815,55495,13425,26755,11325,42070,7175,3490,3685
35820,55506,13429,26763,11329,42074,7176,3491,3685
35825,55510,13433,26765,11333,42077,7176,3491,3685
35830,55520,13436,26767,11334,42083,7177,3491,3686
35835,55526,13437,26769,11335,42088,7179,3491,3688
35840,55537,13442,26774,11339,42093,7180,3491,3689
35845,55541,13444,26778,11341,42096,7180,3491,3689
35850,55551,13447,26781,11342,42103,7181,3491,3690
35855,55557,13448,26784,11343,42109,7183,3491,3692
35860,55568,13451,26788,11346,42117,7184,3491,3693
35865,55572,13452,26790,11347,42120,7184,3491,3693
35870,55582,13454,26794,11347,42128,7185,3491,3694
35875,55588,13454,26796,11347,42133,7187,3492,3695
35880,55599,13456,26801,11349,42141,7188,3492,3696
35885,55603,13458,26804,11351,42144,7188,3492,3696
35890,55613,13462,26810,11354,42151,7189,3493,3696
35895,55619,13462,26814,11354,42155,7191,3494,3697
35900,55630,13464,26818,11356,42166,7192,3494,3698
35905,55634,13464,26820,11356,42170,7192,3494,3698
35910,55644,13466,26824,11357,42177,7193,3495,3698
35915,55650,13467,26826,11358,42182,7195,3495,3700
35920,55661,13468,26831,11359,42191,7196,3495,3701
35925,55665,13469,26833,11360,42196,7196,3495,3701
35930,55675,13471,26837,11361,42203,7197,3495,3702
35935,55681,13471,26837,11361,42210,7199,3495,3704
35940,55692,13473,26842,11363,42218,7200,3495,3705
35945,55696,13473,26844,11363,42223,7200,3495,3705
35950,55706,13475,26847,11363,42230,7201,3496,3705
35955,55712,13476,26849,11364,42235,7203,3496,3707
35960,55723,13480,26854,11367,42241,7204,3497,3707
35965,55727,13482,26855,11369,42245,7204,3497,3707
35970,55737,13484,26858,11369,42252,7205,3497,3708
35975,55743,13486,26862,11371,42256,7207,3498,3709
35980,55754,13488,26866,11372,42264,7208,3499,3709
35985,55758,13491,26869,11375,42267,7208,3499,3709
35990,55768,13494,26874,11376,42274,7209,3500,3709
35995,55774,13495,26879,11377,42277,7211,3502,3709
36000,55785,13500,26884,11382,42284,7212,3502,3710
36005,55789,13502,26886,11384,42287,7212,3502,3710
36010,55799,13504,26891,11386,42295,7213,3503,3710
36015,55805,13504,26894,11386,42299,7215,3504,3711
36020,55816,13506,26899,11387,42309,7216,3505,3711
36025,55820,13507,26901,11388,42312,7216,3505,3711
36030,55830,13509,26907,11390,42320,7217,3506,3711
36035,55836,13510,26910,11391,42325,7219,3506,3713
36040,55847,13512,26914,11393,42334,7220,3506,3714
36045,55851,13512,26915,11393,42339,7220,3506,3714
36050,55861,13513,26920,11394,42347,7221,3506,3715
36055,55867,13514,26922,11395,42353,7223,3507,3716
36060,55878,13515,26928,11395,42361,7224,3508,3716
36065,55882,13516,26931,11396,42366,7224,3508,3716
36070,55892,13517,26935,11397,42375,7225,3508,3717
36075,55898,13517,26939,11397,42381,7227,3510,3717
36080,55909,13519,26947,11399,42388,7228,3510,3718
36085,55913,13521,26947,11401,42392,7228,3510,3718
36090,55923,13522,26950,11402,42401,7229,3510,3719
36095,55929,13522,26951,11402,42407,7231,3511,3720
36100,55940,13524,26956,11403,42414,7232,3512,3720
36105,55944,13526,26957,11405,42418,7232,3512,3720
36110,55954,13528,26963,11406,42425,7233,3513,3720
36115,55960,13530,26966,11408,42430,7235,3514,3721
36120,55971,13532,26970,11409,42436,7236,3514,3722
36125,55975,13534,26971,11411,42441,7236,3514,3722
36130,55985,13536,26975,11411,42448,7237,3514,3723
36135,55991,13537,26979,11412,42453,7239,3515,3724
36140,56002,13539,26983,11414,42463,7240,3515,3725
36145,56006,13539,26985,11414,42466,7240,3515,3725
36150,56016,13542,26987,11415,42474,7241,3515,3726
36155,56022,13542,26990,11415,42480,7243,3517,3726
36160,56033,13543,26994,11416,42489,7244,3517,3727
36165,56037,13544,26996,11417,42492,7244,3517,3727
36170,56047,13547,26998,11418,42499,7245,3517,3728
36175,56053,13548,27000,11419,42504,7247,3517,3730
36180,56064,13550,27003,11421,42514,7248,3518,3730
36185,56068,13551,27005,11422,42516,7248,3518,3730
36190,56078,13555,27009,11425,42523,7249,3519,3730
36195,56084,13556,27014,11426,42525,7251,3520,3731
36200,56095,13560,27018,11430,42533,7252,3520,3732
36205,56099,13561,27020,11431,42537,7252,3520,3732
36210,56109,13565,27026,11434,42542,7253,3520,3733
36215,56115,13566,27029,11435,42547,7255,3521,3734
36220,56126,13570,27034,11439,42554,7256,3522,3734
36225,56130,13571,27036,11440,42558,7256,3522,3734
36230,56140,13572,27037,11440,42568,7257,3522,3735
36235,56146,13572,27038,11440,42574,7259,3523,3736
36240,56157,13574,27042,11441,42582,7260,3523,3737
36245,56161,13576,27045,11443,42585,7260,3523,3737
36250,56171,13579,27050,11445,42591,7261,3524,3737
36255,56177,13580,27053,11446,42597,7263,3525,3738
36260,56188,13581,27059,11447,42604,7264,3526,3738
36265,56192,13584,27062,11450,42608,7264,3526,3738
36270,56202,13586,27068,11452,42615,7265,3526,3739
36275,56208,13587,27072,11453,42620,7267,3528,3739
36280,56219,13589,27076,11454,42630,7268,3529,3739
36285,56223,13589,27078,11454,42633,7268,3529,3739
36290,56233,13591,27082,11455,42641,7269,3530,3739
36295,56239,13592,27086,11456,42647,7271,3531,3740
36300,56250,13594,27091,11457,42654,7272,3531,3741
36305,56254,13597,27095,11460,42656,7272,3531,3741
36310,56264,13600,27101,11463,42663,7273,3531,3742
36315,56270,13601,27104,11464,42669,7275,3532,3743
36320,56281,13602,27110,11464,42676,7276,3532,3744
36325,56285,13605,27111,11467,42680,7276,3532,3744
36330,56295,13608,27114,11468,42686,7277,3532,3745
36335,56301,13609,27116,11469,42692,7279,3533,3746
36340,56312,13611,27119,11470,42699,7280,3533,3747
36345,56316,13614,27122,11473,42701,7280,3533,3747
36350,56326,13617,27127,11475,42708,7281,3534,3747
36355,56332,13617,27129,11475,42715,7283,3535,3748
36360,56343,13619,27136,11477,42720,7284,3536,3748
36365,56347,13621,27137,11479,42725,7284,3536,3748
36370,56357,13624,27143,11481,42732,7285,3537,3748
36375,56363,13624,27145,11481,42739,7287,3538,3749
36380,56374,13624,27150,11481,42747,7288,3538,3750
36385,56378,13625,27151,11482,42752,7288,3538,3750
36390,56388,13628,27156,11484,42759,7289,3539,3750
36395,56394,13629,27160,11485,42764,7291,3541,3750
36400,56405,13631,27165,11487,42773,7292,3542,3750
36405,56409,13632,27167,11488,42777,7292,3542,3750
36410,56419,13634,27172,11488,42784,7293,3543,3750
36415,56425,13635,27176,11489,42787,7295,3543,3752
36420,56436,13641,27183,11495,42793,7296,3543,3753
36425,56440,13644,27186,11498,42794,7296,3543,3753
36430,56450,13650,27193,11503,42798,7297,3544,3753
36435,56456,13652,27195,11505,42803,7299,3544,3755
36440,56467,13654,27204,11507,42811,7300,3545,3755
36445,56471,13655,27205,11508,42815,7300,3545,3755
36450,56481,13658,27210,11510,42822,7301,3546,3755
36455,56487,13660,27211,11512,42827,7303,3546,3757
36460,56498,13662,27215,11514,42834,7304,3546,3758
36465,56502,13663,27218,11515,42838,7304,3546,3758
36470,56512,13665,27224,11516,42846,7305,3547,3758
36475,56518,13667,27227,11518,42850,7307,3547,3760
36480,56529,13669,27235,11520,42858,7308,3548,3760
36485,56533,13671,27236,11522,42862,7308,3548,3760
36490,56543,13674,27241,11525,42868,7309,3548,3761
36495,56549,13674,27244,11525,42875,7311,3550,3761
36500,56560,13676,27248,11526,42883,7312,3551,3761
36505,56564,13677,27250,11527,42887,7312,3551,3761
36510,56574,13679,27255,11529,42894,7313,3552,3761
36515,56580,13680,27258,11530,42900,7315,3553,3762
36520,56591,13682,27265,11532,42908,7316,3554,3762
36525,56595,13684,27267,11534,42911,7316,3554,3762
36530,56605,13686,27273,11536,42918,7317,3554,3763
36535,56611,13687,27277,11537,42924,7319,3556,3763
36540,56622,13689,27282,11538,42931,7320,3556,3764
36545,56626,13690,27283,11539,42936,7320,3556,3764
36550,56636,13692,27289,11540,42943,7321,3557,3764
36555,56642,13693,27293,11541,42949,7323,3559,3764
36560,56653,13693,27295,11541,42958,7324,3559,3765
36565,56657,13694,27297,11542,42963,7324,3559,3765
36570,56667,13696,27303,11543,42970,7325,3559,3766
36575,56673,13697,27309,11544,42975,7327,3561,3766
36580,56684,13700,27317,11547,42982,7328,3562,3766
36585,56688,13701,27318,11548,42987,7328,3562,3766
36590,56698,13704,27325,11551,42992,7329,3562,3767
36595,56704,13705,27326,11552,42998,7331,3562,3769
36600,56715,13707,27331,11554,43007,7332,3562,3770
36605,56719,13707,27332,11554,43011,7332,3562,3770
36610,56729,13710,27336,11556,43018,7333,3563,3770
36615,56735,13710,27337,11556,43025,7335,3564,3771
36620,56746,13712,27344,11558,43031,7336,3564,3772
36625,56750,13715,27346,11561,43035,7336,3564,3772
36630,56760,13717,27350,11562,43042,7337,3564,3773
36635,56766,13718,27353,11563,43048,7339,3566,3773
36640,56777,13721,27359,11566,43054,7340,3567,3773
36645,56781,13723,27361,11568,43058,7340,3567,3773
36650,56791,13726,27368,11571,43064,7341,3568,3773
36655,56797,13727,27369,11572,43070,7343,3569,3774
36660,56808,13730,27375,11575,43076,7344,3570,3774
36665,56812,13733,27376,11578,43079,7344,3570,3774
36670,56822,13737,27382,11580,43084,7345,3571,3774
36675,56828,13738,27382,11581,43090,7347,3571,3776
36680,56839,13741,27389,11584,43095,7348,3572,3776
36685,56843,13744,27391,11587,43098,7348,3572,3776
36690,56853,13748,27395,11590,43104,7349,3572,3777
36695,56859,13750,27398,11592,43109,7351,3573,3778
36700,56870,13754,27405,11596,43113,7352,3573,3779
36705,56874,13758,27407,11600,43115,7352,3573,3779
36710,56884,13764,27411,11604,43118,7353,3573,3780
36715,56890,13765,27413,11605,43124,7355,3574,3781
36720,56901,13768,27417,11607,43131,7356,3575,3781
36725,56905,13769,27418,11608,43136,7356,3575,3781
36730,56915,13770,27425,11609,43144,7357,3575,3782
36735,56921,13771,27426,11610,43149,7359,3575,3784
36740,56932,13773,27431,11611,43157,7360,3575,3785
36745,56936,13775,27431,11613,43161,7360,3575,3785
36750,56946,13776,27434,11613,43169,7361,3576,3785
36755,56952,13777,27437,11614,43175,7363,3578,3785
36760,56963,13779,27442,11616,43183,7364,3579,3785
36765,56967,13780,27444,11617,43186,7364,3579,3785
36770,56977,13782,27450,11618,43194,7365,3580,3785
36775,56983,13782,27451,11618,43200,7367,3580,3787
36780,56994,13785,27453,11620,43209,7368,3580,3788
36785,56998,13786,27455,11621,43212,7368,3580,3788
36790,57008,13788,27458,11622,43219,7369,3580,3789
36795,57014,13789,27461,11623,43224,7371,3581,3790
36800,57025,13791,27465,11625,43233,7372,3581,3791
36805,57029,13793,27466,11627,43236,7372,3581,3791
36810,57039,13795,27470,11628,43243,7373,3581,3792
36815,57045,13796,27472,11629,43249,7375,3583,3792
36820,57056,13799,27480,11632,43255,7376,3584,3792
36825,57060,13800,27482,11633,43260,7376,3584,3792
36830,57070,13802,27486,11633,43267,7377,3585,3792
36835,57076,13802,27488,11633,43274,7379,3586,3793
36840,57087,13803,27492,11634,43283,7380,3586,3794
36845,57091,13803,27494,11634,43288,7380,3586,3794
36850,57101,13805,27500,11635,43295,7381,3587,3794
36855,57107,13805,27503,11635,43301,7383,3588,3795
36860,57118,13807,27508,11637,43309,7384,3588,3796
36865,57122,13808,27510,11638,43314,7384,3588,3796
36870,57132,13810,27517,11639,43321,7385,3588,3797
36875,57138,13810,27518,11639,43327,7387,3588,3799
36880,57149,13813,27523,11642,43334,7388,3588,3800
36885,57153,13813,27523,11642,43340,7388,3588,3800
36890,57163,13816,27530,11645,43345,7389,3589,3800
36895,57169,13818,27531,11647,43351,7391,3589,3802
36900,57180,13819,27533,11648,43360,7392,3589,3803
36905,57184,13819,27534,11648,43365,7392,3589,3803
36910,57194,13821,27539,11649,43372,7393,3590,3803
36915,57200,13821,27541,11649,43379,7395,3591,3804
36920,57211,13822,27546,11650,43388,7396,3592,3804
36925,57215,13822,27548,11650,43393,7396,3592,3804
36930,57225,13824,27552,11651,43400,7397,3593,3804
36935,57231,13824,27555,11651,43407,7399,3595,3804
36940,57242,13827,27564,11654,43410,7400,3596,3804
36945,57246,13831,27566,11658,43414,7400,3596,3804
36950,57256,13835,27571,11662,43420,7401,3596,3805
36955,57262,13836,27573,11663,43426,7403,3596,3807
36960,57273,13837,27577,11664,43433,7404,3596,3808
36965,57277,13840,27580,11667,43436,7404,3596,3808
36970,57287,13845,27585,11671,43442,7405,3597,3808
36975,57293,13846,27589,11672,43446,7407,3598,3809
36980,57304,13849,27596,11675,43451,7408,3599,3809
36985,57308,13853,27597,11679,43454,7408,3599,3809
36990,57318,13858,27601,11682,43460,7409,3599,3810
36995,57324,13859,27603,11683,43465,7411,3599,3812
37000,57335,13861,27606,11684,43472,7412,3599,3813
37005,57339,13865,27609,11688,43473,7412,3599,3813
37010,57349,13869,27613,11690,43478,7413,3600,3813
37015,57355,13871,27616,11692,43482,7415,3601,3814
37020,57366,13876,27621,11697,43488,7416,3601,3815
37025,57370,13880,27624,11701,43489,7416,3601,3815
37030,57380,13884,27628,11703,43495,7417,3601,3816
37035,57386,13886,27632,11705,43498,7419,3602,3817
37040,57397,13890,27637,11709,43505,7420,3602,3818
37045,57401,13890,27639,11709,43511,7420,3602,3818
37050,57411,13891,27644,11709,43520,7421,3603,3818
37055,57417,13892,27648,11710,43523,7423,3603,3820
37060,57428,13892,27652,11710,43534,7424,3603,3821
37065,57432,13893,27653,11711,43539,7424,3603,3821
37070,57442,13894,27657,11711,43547,7425,3603,3822
37075,57448,13894,27658,11711,43554,7427,3603,3824
37080,57459,13895,27666,11712,43562,7428,3604,3824
37085,57463,13896,27669,11713,43566,7428,3604,3824
37090,57473,13897,27676,11714,43576,7429,3605,3824
37095,57479,13897,27680,11714,43582,7431,3607,3824
37100,57490,13898,27685,11715,43590,7432,3607,3825
37105,57494,13898,27685,11715,43596,7432,3607,3825
37110,57504,13899,27690,11716,43605,7433,3608,3825
37115,57510,13900,27693,11717,43610,7435,3609,3826
37120,57521,13900,27694,11717,43621,7436,3609,3827
37125,57525,13900,27695,11717,43625,7436,3609,3827
37130,57535,13903,27699,11719,43632,7437,3610,3827
37135,57541,13903,27701,11719,43638,7439,3611,3828
37140,57552,13904,27705,11720,43645,7440,3611,3829
37145,57556,13906,27707,11722,43650,7440,3611,3829
37150,57566,13909,27712,11724,43656,7441,3611,3830
37155,57572,13910,27715,11725,43661,7443,3611,3832
37160,57583,13914,27721,11729,43667,7444,3611,3833
37165,57587,13917,27724,11732,43670,7444,3611,3833
37170,57597,13920,27728,11733,43676,7445,3612,3833
37175,57603,13921,27730,11734,43681,7447,3613,3834
37180,57614,13926,27737,11738,43686,7448,3614,3834
37185,57618,13928,27737,11740,43690,7448,3614,3834
37190,57628,13930,27740,11740,43698,7449,3615,3834
37195,57634,13930,27743,11740,43703,7451,3616,3835
37200,57645,13932,27744,11741,43712,7452,3616,3836
37205,57649,13933,27744,11742,43716,7452,3616,3836
37210,57659,13937,27748,11745,43722,7453,3616,3837
37215,57665,13938,27752,11746,43727,7455,3618,3837
37220,57676,13940,27758,11748,43733,7456,3618,3838
37225,57680,13944,27759,11752,43736,7456,3618,3838
37230,57690,13949,27766,11756,43740,7457,3618,3839
37235,57696,13951,27771,11758,43743,7459,3619,3840
37240,57707,13955,27775,11761,43750,7460,3619,3841
37245,57711,13958,27777,11764,43753,7460,3619,3841
37250,57721,13963,27782,11767,43757,7461,3619,3842
37255,57727,13965,27785,11769,43761,7463,3620,3843
37260,57738,13969,27791,11773,43767,7464,3621,3843
37265,57742,13972,27793,11776,43769,7464,3621,3843
37270,57752,13975,27795,11778,43777,7465,3621,3844
37275,57758,13976,27800,11779,43780,7467,3623,3844
37280,57769,13979,27803,11782,43788,7468,3623,3845
37285,57773,13981,27804,11784,43792,7468,3623,3845
37290,57783,13984,27809,11786,43798,7469,3623,3846
37295,57789,13984,27812,11786,43804,7471,3624,3847
37300,57800,13985,27818,11787,43812,7472,3624,3848
37305,57804,13986,27819,11788,43818,7472,3624,3848
37310,57814,13987,27826,11789,43826,7473,3625,3848
37315,57820,13988,27829,11790,43831,7475,3625,3850
37320,57831,13988,27834,11790,43841,7476,3625,3851
37325,57835,13989,27835,11791,43846,7476,3625,3851
37330,57845,13990,27839,11791,43855,7477,3626,3851
37335,57851,13990,27842,11791,43860,7479,3627,3852
37340,57862,13991,27846,11792,43871,7480,3628,3852
37345,57866,13991,27848,11792,43874,7480,3628,3852
37350,57876,13992,27855,11792,43883,7481,3629,3852
37355,57882,13992,27858,11792,43889,7483,3630,3853
37360,57893,13993,27864,11793,43898,7484,3631,3853
37365,57897,13994,27866,11794,43902,7484,3631,3853
37370,57907,13996,27869,11795,43911,7485,3632,3853
37375,57913,13997,27873,11796,43916,7487,3633,3854
37380,57924,13999,27877,11797,43925,7488,3634,3854
37385,57928,13999,27878,11797,43929,7488,3634,3854
37390,57938,14000,27884,11798,43938,7489,3635,3854
37395,57944,14000,27887,11798,43944,7491,3637,3854
37400,57955,14001,27891,11798,43952,7492,3637,3855
37405,57959,14002,27891,11799,43957,7492,3637,3855
37410,57969,14005,27897,11801,43963,7493,3637,3856
37415,57975,14006,27899,11802,43969,7495,3638,3857
37420,57986,14007,27904,11802,43976,7496,3639,3857
37425,57990,14009,27907,11804,43981,7496,3639,3857
37430,58000,14011,27912,11806,43988,7497,3640,3857
37435,58006,14012,27915,11807,43993,7499,3642,3857
37440,58017,14015,27923,11810,43999,7500,3643,3857
37445,58021,14019,27927,11814,44001,7500,3643,3857
37450,58031,14023,27933,11818,44008,7501,3644,3857
37455,58037,14023,27937,11818,44014,7503,3646,3857
37460,58048,14025,27941,11819,44021,7504,3646,3858
37465,58052,14028,27945,11822,44023,7504,3646,3858
37470,58062,14031,27949,11824,44030,7505,3646,3859
37475,58068,14032,27954,11825,44034,7507,3648,3859
37480,58079,14037,27960,11829,44040,7508,3648,3860
37485,58083,14040,27961,11832,44043,7508,3648,3860
37490,58093,14043,27966,11834,44050,7509,3649,3860
37495,58099,14043,27968,11834,44054,7511,3649,3862
37500,58110,14047,27971,11837,44062,7512,3649,3863
37505,58114,14050,27974,11840,44063,7512,3649,3863
37510,58124,14054,27978,11843,44069,7513,3649,3864
37515,58130,14055,27981,11844,44074,7515,3651,3864
37520,58141,14057,27985,11846,44082,7516,3651,3865
37525,58145,14059,27985,11848,44086,7516,3651,3865
37530,58155,14063,27990,11850,44091,7517,3652,3865
37535,58161,14064,27992,11851,44096,7519,3653,3866
37540,58172,14068,27997,11855,44103,7520,3653,3867
37545,58176,14069,27999,11856,44107,7520,3653,3867
37550,58186,14072,28004,11858,44113,7521,3653,3868
37555,58192,14073,28008,11859,44119,7523,3655,3868
37560,58203,14074,28015,11860,44127,7524,3656,3868
37565,58207,14075,28017,11861,44132,7524,3656,3868
37570,58217,14076,28023,11862,44140,7525,3656,3869
37575,58223,14076,28027,11862,44146,7527,3658,3869
37580,58234,14076,28032,11862,44156,7528,3659,3869
37585,58238,14076,28033,11862,44162,7528,3659,3869
37590,58248,14077,28037,11863,44170,7529,3659,3870
37595,58254,14078,28043,11864,44174,7531,3661,3870
37600,58265,14079,28049,11865,44183,7532,3662,3870
37605,58269,14080,28050,11866,44188,7532,3662,3870
37610,58279,14081,28057,11867,44197,7533,3663,3870
37615,58285,14082,28061,11868,44202,7535,3664,3871
37620,58296,14083,28069,11869,44211,7536,3664,3872
37625,58300,14084,28070,11870,44216,7536,3664,3872
37630,58310,14085,28075,11870,44224,7537,3665,3872
37635,58316,14086,28079,11871,44229,7539,3666,3873
37640,58327,14086,28082,11871,44240,7540,3666,3874
37645,58331,14087,28086,11872,44243,7540,3666,3874
37650,58341,14089,28090,11872,44251,7541,3666,3875
37655,58347,14090,28095,11873,44256,7543,3668,3875
37660,58358,14094,28104,11877,44260,7544,3668,3876
37665,58362,14097,28106,11880,44264,7544,3668,3876
37670,58372,14101,28111,11882,44271,7545,3669,3876
37675,58378,14102,28114,11883,44276,7547,3670,3877
37680,58389,14104,28119,11885,44283,7548,3670,3878
37685,58393,14105,28120,11886,44287,7548,3670,3878
37690,58403,14107,28124,11887,44296,7549,3671,3878
37695,58409,14107,28126,11887,44302,7551,3672,3879
37700,58420,14111,28132,11890,44307,7552,3673,3879
37705,58424,14113,28133,11892,44310,7552,3673,3879
37710,58434,14117,28141,11896,44316,7553,3673,3880
37715,58440,14118,28143,11897,44321,7555,3673,3882
37720,58451,14123,28149,11902,44326,7556,3673,3883
37725,58455,14126,28151,11905,44328,7556,3673,3883
37730,58465,14129,28155,11907,44336,7557,3674,3883
37735,58471,14129,28157,11907,44342,7559,3675,3884
37740,58482,14131,28161,11908,44349,7560,3676,3884
37745,58486,14135,28164,11912,44350,7560,3676,3884
37750,58496,14139,28173,11916,44356,7561,3677,3884
37755,58502,14141,28176,11918,44360,7563,3677,3886
37760,58513,14144,28181,11921,44366,7564,3677,3887
37765,58517,14148,28184,11925,44368,7564,3677,3887
37770,58527,14152,28188,11927,44375,7565,3678,3887
37775,58533,14152,28190,11927,44381,7567,3679,3888
37780,58544,14157,28196,11932,44386,7568,3679,3889
37785,58548,14158,28198,11933,44389,7568,3679,3889
37790,58558,14162,28205,11937,44395,7569,3680,3889
37795,58564,14163,28209,11938,44400,7571,3682,3889
37800,58575,14168,28214,11942,44405,7572,3682,3890
37805,58579,14169,28215,11943,44410,7572,3682,3890
37810,58589,14171,28218,11944,44418,7573,3682,3891
37815,58595,14172,28220,11945,44423,7575,3683,3892
37820,58606,14174,28225,11947,44430,7576,3683,3893
37825,58610,14175,28226,11948,44435,7576,3683,3893
37830,58620,14179,28232,11951,44440,7577,3684,3893
37835,58626,14179,28234,11951,44446,7579,3685,3894
37840,58637,14180,28239,11952,44456,7580,3686,3894
37845,58641,14180,28239,11952,44461,7580,3686,3894
37850,58651,14181,28246,11953,44470,7581,3687,3894
37855,58657,14182,28249,11954,44474,7583,3688,3895
37860,58668,14183,28252,11955,44485,7584,3688,3896
37865,58672,14183,28253,11955,44489,7584,3688,3896
37870,58682,14184,28256,11956,44498,7585,3689,3896
37875,58688,14184,28258,11956,44503,7587,3690,3897
37880,58699,14184,28265,11956,44513,7588,3690,3898
37885,58703,14184,28266,11956,44519,7588,3690,3898
37890,58713,14185,28272,11957,44528,7589,3691,3898
37895,58719,14186,28276,11958,44532,7591,3692,3899
37900,58730,14186,28281,11958,44542,7592,3693,3899
37905,58734,14187,28284,11959,44546,7592,3693,3899
37910,58744,14189,28287,11960,44555,7593,3693,3900
37915,58750,14189,28288,11960,44561,7595,3694,3901
37920,58761,14190,28291,11961,44571,7596,3695,3901
37925,58765,14190,28293,11961,44575,7596,3695,3901
37930,58775,14192,28295,11962,44583,7597,3696,3901
37935,58781,14193,28299,11963,44587,7599,3697,3902
37940,58792,14197,28305,11966,44592,7600,3697,3903
37945,58796,14200,28308,11969,44596,7600,3697,3903
37950,58806,14202,28313,11970,44604,7601,3698,3903
37955,58812,14202,28316,11970,44609,7603,3699,3904
37960,58823,14204,28320,11972,44617,7604,3699,3905
37965,58827,14207,28321,11975,44620,7604,3699,3905
37970,58837,14210,28325,11977,44626,7605,3699,3906
37975,58843,14212,28329,11979,44629,7607,3700,3907
37980,58854,14216,28334,11983,44637,7608,3701,3907
37985,58858,14217,28335,11984,44640,7608,3701,3907
37990,58868,14221,28341,11986,44647,7609,3701,3908
37995,58874,14222,28344,11987,44652,7611,3703,3908
38000,58885,14225,28350,11990,44658,7612,3703,3909
38005,58889,14228,28354,11993,44661,7612,3703,3909
38010,58899,14230,28359,11995,44668,7613,3704,3909
38015,58905,14231,28362,11996,44673,7615,3705,3910
38020,58916,14235,28369,11999,44679,7616,3706,3910
38025,58920,14238,28370,12002,44682,7616,3706,3910
38030,58930,14240,28374,12003,44690,7617,3707,3910
38035,58936,14240,28377,12003,44695,7619,3709,3910
38040,58947,14244,28384,12007,44700,7620,3709,3911
38045,58951,14247,28385,12010,44704,7620,3709,3911
38050,58961,14250,28387,12011,44711,7621,3709,3912
38055,58967,14251,28390,12012,44716,7623,3710,3913
38060,58978,14254,28396,12014,44721,7624,3710,3914
38065,58982,14258,28398,12018,44723,7624,3710,3914
38070,58992,14261,28402,12019,44731,7625,3711,3914
38075,58998,14262,28407,12020,44735,7627,3712,3915
38080,59009,14266,28411,12024,44742,7628,3712,3916
38085,59013,14267,28413,12025,44745,7628,3712,3916
38090,59023,14271,28420,12029,44752,7629,3713,3916
38095,59029,14271,28421,12029,44758,7631,3714,3917
38100,59040,14272,28426,12030,44764,7632,3714,3918
38105,59044,14277,28429,12035,44766,7632,3714,3918
38110,59054,14280,28431,12037,44774,7633,3714,3919
38115,59060,14280,28433,12037,44778,7635,3714,3921
38120,59071,14283,28438,12040,44785,7636,3714,3922
38125,59075,14286,28440,12043,44788,7636,3714,3922
38130,59085,14288,28444,12044,44797,7637,3715,3922
38135,59091,14289,28450,12045,44800,7639,3717,3922
38140,59102,14290,28457,12046,44810,7640,3718,3922
38145,59106,14291,28458,12047,44814,7640,3718,3922
38150,59116,14292,28462,12047,44823,7641,3718,3923
38155,59122,14292,28464,12047,44830,7643,3719,3924
38160,59133,14293,28473,12048,44837,7644,3720,3924
38165,59137,14294,28474,12049,44843,7644,3720,3924
38170,59147,14295,28477,12049,44852,7645,3720,3925
38175,59153,14295,28481,12049,44857,7647,3722,3925
38180,59164,14295,28484,12049,44868,7648,3722,3926
38185,59168,14295,28485,12049,44873,7648,3722,3926
38190,59178,14296,28490,12050,44881,7649,3723,3926
38195,59184,14296,28491,12050,44887,7651,3723,3928
38200,59195,14297,28497,12051,44898,7652,3723,3929
38205,59199,14297,28501,12051,44901,7652,3723,3929
38210,59209,14298,28503,12051,44911,7653,3723,3930
38215,59215,14298,28505,12051,44916,7655,3724,3931
38220,59226,14299,28509,12052,44926,7656,3725,3931
38225,59230,14301,28512,12054,44929,7656,3725,3931
38230,59240,14302,28516,12054,44938,7657,3726,3931
38235,59246,14302,28516,12054,44944,7659,3726,3933
38240,59257,14306,28524,12058,44948,7660,3727,3933
38245,59261,14308,28525,12060,44953,7660,3727,3933
38250,59271,14312,28530,12062,44958,7661,3727,3934
38255,59277,14313,28531,12063,44963,7663,3727,3936
38260,59288,14315,28534,12064,44972,7664,3728,3936
38265,59292,14316,28537,12065,44975,7664,3728,3936
38270,59302,14320,28542,12068,44982,7665,3728,3937
38275,59308,14321,28547,12069,44986,7667,3730,3937
38280,59319,14323,28551,12071,44994,7668,3730,3938
38285,59323,14325,28553,12073,44998,7668,3730,3938
38290,59333,14328,28560,12076,45004,7669,3731,3938
38295,59339,14329,28563,12077,45010,7671,3732,3939
38300,59350,14331,28568,12079,45016,7672,3732,3940
38305,59354,14335,28570,12083,45018,7672,3732,3940
38310,59364,14339,28573,12086,45024,7673,3732,3941
38315,59370,14340,28576,12087,45030,7675,3733,3942
38320,59381,14343,28580,12089,45037,7676,3734,3942
38325,59385,14344,28580,12090,45041,7676,3734,3942
38330,59395,14346,28585,12091,45048,7677,3734,3943
38335,59401,14347,28587,12092,45053,7679,3734,3945
38340,59412,14352,28593,12097,45058,7680,3734,3946
38345,59416,14355,28594,12100,45061,7680,3734,3946
38350,59426,14358,28599,12102,45067,7681,3735,3946
38355,59432,14360,28603,12104,45071,7683,3736,3947
38360,59443,14364,28608,12107,45077,7684,3737,3947
38365,59447,14366,28612,12109,45080,7684,3737,3947
38370,59457,14369,28614,12110,45088,7685,3737,3948
38375,59463,14370,28616,12111,45093,7687,3738,3949
38380,59474,14372,28622,12113,45100,7688,3739,3949
38385,59478,14374,28626,12115,45102,7688,3739,3949
38390,59488,14379,28631,12119,45108,7689,3740,3949
38395,59494,14381,28634,12121,45111,7691,3740,3951
38400,59505,14384,28638,12124,45120,7692,3740,3952
38405,59509,14386,28641,12126,45122,7692,3740,3952
38410,59519,14387,28648,12126,45131,7693,3741,3952
38415,59525,14387,28649,12126,45138,7695,3742,3953
38420,59536,14388,28656,12127,45147,7696,3743,3953
38425,59540,14389,28658,12128,45151,7696,3743,3953
38430,59550,14390,28662,12129,45160,7697,3744,3953
38435,59556,14391,28666,12130,45163,7699,3744,3955
38440,59567,14392,28674,12131,45173,7700,3745,3955
38445,59571,14392,28678,12131,45178,7700,3745,3955
38450,59581,14393,28682,12132,45188,7701,3745,3956
38455,59587,14394,28686,12133,45191,7703,3746,3957
38460,59598,14395,28691,12134,45203,7704,3746,3958
38465,59602,14395,28694,12134,45207,7704,3746,3958
38470,59612,14398,28699,12136,45213,7705,3746,3959
38475,59618,14400,28703,12138,45218,7707,3746,3961
38480,59629,14403,28710,12141,45225,7708,3747,3961
38485,59633,14405,28714,12143,45228,7708,3747,3961
38490,59643,14407,28718,12144,45236,7709,3747,3962
38495,59649,14407,28721,12144,45242,7711,3748,3963
38500,59660,14409,28726,12145,45248,7712,3749,3963
38505,59664,14413,28729,12149,45251,7712,3749,3963
38510,59674,14415,28735,12151,45258,7713,3749,3964
38515,59680,14416,28737,12152,45263,7715,3750,3965
38520,59691,14420,28743,12156,45270,7716,3750,3966
38525,59695,14421,28743,12157,45274,7716,3750,3966
38530,59705,14422,28749,12158,45283,7717,3750,3967
38535,59711,14422,28751,12158,45289,7719,3751,3968
38540,59722,14425,28760,12161,45294,7720,3751,3969
38545,59726,14429,28763,12165,45297,7720,3751,3969
38550,59736,14431,28767,12166,45305,7721,3751,3970
38555,59742,14431,28771,12166,45310,7723,3753,3970
38560,59753,14434,28773,12168,45318,7724,3753,3971
38565,59757,14436,28776,12170,45320,7724,3753,3971
38570,59767,14440,28780,12174,45326,7725,3754,3971
38575,59773,14440,28785,12174,45330,7727,3755,3972
38580,59784,14445,28788,12178,45338,7728,3756,3972
38585,59788,14448,28790,12181,45340,7728,3756,3972
38590,59798,14452,28797,12185,45345,7729,3757,3972
38595,59804,14452,28800,12185,45350,7731,3757,3974
38600,59815,14455,28803,12188,45360,7732,3757,3975
38605,59819,14456,28806,12189,45362,7732,3757,3975
38610,59829,14460,28810,12192,45367,7733,3758,3975
38615,59835,14461,28812,12193,45374,7735,3758,3977
38620,59846,14461,28820,12193,45383,7736,3759,3977
38625,59850,14461,28821,12193,45389,7736,3759,3977
38630,59860,14462,28825,12193,45397,7737,3760,3977
38635,59866,14462,28827,12193,45404,7739,3761,3978
38640,59877,14462,28832,12193,45414,7740,3762,3978
38645,59881,14462,28834,12193,45419,7740,3762,3978
38650,59891,14463,28834,12193,45427,7741,3762,3979
38655,59897,14463,28836,12193,45434,7743,3764,3979
38660,59908,14463,28841,12193,45444,7744,3765,3979
38665,59912,14463,28842,12193,45449,7744,3765,3979
38670,59922,14464,28846,12193,45457,7745,3766,3979
38675,59928,14465,28852,12194,45463,7747,3768,3979
38680,59939,14465,28855,12194,45473,7748,3768,3980
38685,59943,14465,28857,12194,45478,7748,3768,3980
38690,59953,14466,28859,12194,45486,7749,3768,3981
38695,59959,14466,28861,12194,45493,7751,3768,3983
38700,59970,14469,28866,12197,45501,7752,3769,3983
38705,59974,14470,28868,12198,45504,7752,3769,3983
38710,59984,14473,28876,12200,45510,7753,3770,3983
38715,59990,14474,28879,12201,45516,7755,3771,3984
38720,60001,14475,28882,12201,45524,7756,3772,3984
38725,60005,14478,28884,12204,45527,7756,3772,3984
38730,60015,14481,28889,12207,45533,7757,3772,3985
38735,60021,14482,28893,12208,45538,7759,3774,3985
38740,60032,14485,28897,12210,45545,7760,3775,3985
38745,60036,14488,28901,12213,45547,7760,3775,3985
38750,60046,14491,28907,12216,45554,7761,3776,3985
38755,60052,14492,28910,12217,45559,7763,3777,3986
38760,60063,14496,28917,12221,45563,7764,3777,3987
38765,60067,14501,28919,12226,45565,7764,3777,3987
38770,60077,14505,28923,12230,45571,7765,3778,3987
38775,60083,14506,28924,12231,45577,7767,3778,3989
38780,60094,14509,28930,12234,45583,7768,3779,3989
38785,60098,14511,28932,12236,45585,7768,3779,3989
38790,60108,14520,28942,12245,45586,7769,3780,3989
38795,60114,14522,28942,12247,45592,7771,3780,3991
38800,60125,14525,28946,12249,45598,7772,3780,3992
38805,60129,14527,28946,12251,45602,7772,3780,3992
38810,60139,14533,28953,12256,45605,7773,3781,3992
38815,60145,14534,28955,12257,45609,7775,3781,3994
38820,60156,14538,28962,12261,45616,7776,3782,3994
38825,60160,14540,28965,12263,45619,7776,3782,3994
38830,60170,14541,28969,12264,45628,7777,3782,3995
38835,60176,14541,28969,12264,45635,7779,3782,3997
38840,60187,14542,28973,12265,45645,7780,3782,3998
38845,60191,14542,28976,12265,45648,7780,3782,3998
38850,60201,14543,28982,12266,45657,7781,3783,3998
38855,60207,14543,28984,12266,45663,7783,3784,3999
38860,60218,14544,28990,12267,45673,7784,3785,3999
38865,60222,14544,28992,12267,45678,7784,3785,3999
38870,60232,14545,28998,12267,45686,7785,3786,3999
38875,60238,14545,29002,12267,45692,7787,3788,3999
38880,60249,14545,29008,12267,45702,7788,3789,3999
38885,60253,14545,29009,12267,45708,7788,3789,3999
38890,60263,14546,29011,12267,45716,7789,3789,4000
38895,60269,14547,29012,12268,45722,7791,3789,4002
38900,60280,14547,29017,12268,45732,7792,3790,4002
38905,60284,14547,29019,12268,45737,7792,3790,4002
38910,60294,14548,29024,12268,45745,7793,3791,4002
38915,60300,14549,29028,12269,45751,7795,3792,4003
38920,60311,14549,29033,12269,45760,7796,3792,4004
38925,60315,14551,29036,12271,45764,7796,3792,4004
38930,60325,14554,29042,12273,45770,7797,3793,4004
38935,60331,14555,29044,12274,45775,7799,3794,4005
38940,60342,14559,29051,12278,45780,7800,3795,4005
38945,60346,14562,29053,12281,45784,7800,3795,4005
38950,60356,14565,29059,12283,45790,7801,3795,4006
38955,60362,14566,29062,12284,45796,7803,3797,4006
38960,60373,14568,29069,12286,45802,7804,3798,4006
38965,60377,14571,29069,12289,45806,7804,3798,4006
38970,60387,14574,29073,12290,45812,7805,3798,4007
38975,60393,14576,29076,12292,45817,7807,3799,4008
38980,60404,14579,29082,12294,45822,7808,3800,4008
38985,60408,14584,29085,12299,45824,7808,3800,4008
38990,60418,14587,29088,12300,45830,7809,3800,4009
38995,60424,14587,29092,12300,45836,7811,3802,4009
39000,60435,14592,29097,12304,45842,7812,3803,4009
39005,60439,14595,29101,12307,45843,7812,3803,4009
39010,60449,14600,29105,12310,45848,7813,3803,4010
39015,60455,14601,29110,12311,45853,7815,3805,4010
39020,60466,14605,29113,12314,45861,7816,3806,4010
39025,60470,14607,29115,12316,45863,7816,3806,4010
39030,60480,14611,29120,12318,45868,7817,3806,4011
39035,60486,14612,29122,12319,45872,7819,3806,4013
39040,60497,14616,29127,12322,45879,7820,3806,4014
39045,60501,14618,29129,12324,45883,7820,3806,4014
39050,60511,14620,29135,12326,45890,7821,3807,4014
39055,60517,14621,29140,12327,45894,7823,3808,4015
39060,60528,14623,29147,12328,45902,7824,3809,4015
39065,60532,14625,29149,12330,45907,7824,3809,4015
39070,60542,14626,29153,12331,45915,7825,3810,4015
39075,60548,14627,29156,12332,45920,7827,3810,4017
39080,60559,14628,29162,12333,45930,7828,3810,4018
39085,60563,14628,29164,12333,45935,7828,3810,4018
39090,60573,14629,29169,12334,45943,7829,3810,4019
39095,60579,14629,29171,12334,45950,7831,3812,4019
39100,60590,14629,29174,12334,45961,7832,3812,4020
39105,60594,14629,29175,12334,45965,7832,3812,4020
39110,60604,14630,29179,12334,45973,7833,3812,4021
39115,60610,14631,29182,12335,45979,7835,3813,4022
39120,60621,14632,29186,12336,45987,7836,3813,4023
39125,60625,14633,29189,12337,45991,7836,3813,4023
39130,60635,14634,29193,12337,46000,7837,3814,4023
39135,60641,14635,29197,12338,46006,7839,3816,4023
39140,60652,14636,29202,12339,46014,7840,3817,4023
39145,60656,14636,29206,12339,46019,7840,3817,4023
39150,60666,14638,29212,12340,46027,7841,3817,4024
39155,60672,14638,29215,12340,46034,7843,3819,4024
39160,60683,14639,29221,12341,46041,7844,3819,4025
39165,60687,14641,29223,12343,46046,7844,3819,4025
39170,60697,14645,29230,12346,46051,7845,3820,4025
39175,60703,14646,29233,12347,46056,7847,3821,4026
39180,60714,14649,29237,12349,46063,7848,3821,4027
39185,60718,14651,29239,12351,46067,7848,3821,4027
39190,60728,14655,29247,12355,46072,7849,3822,4027
39195,60734,14657,29251,12357,46077,7851,3824,4027
39200,60745,14660,29255,12360,46085,7852,3825,4027
39205,60749,14661,29257,12361,46087,7852,3825,4027
39210,60759,14666,29262,12366,46092,7853,3825,4028
39215,60765,14668,29267,12368,46097,7855,3827,4028
39220,60776,14673,29274,12372,46101,7856,3828,4028
39225,60780,14675,29277,12374,46104,7856,3828,4028
39230,60790,14680,29282,12377,46109,7857,3828,4029
39235,60796,14681,29283,12378,46115,7859,3828,4031
39240,60807,14685,29290,12382,46119,7860,3828,4032
39245,60811,14689,29293,12386,46121,7860,3828,4032
39250,60821,14692,29300,12389,46128,7861,3829,4032
39255,60827,14692,29303,12389,46134,7863,3831,4032
39260,60838,14695,29306,12392,46142,7864,3831,4033
39265,60842,14696,29307,12393,46146,7864,3831,4033
39270,60852,14698,29313,12394,46153,7865,3832,4033
39275,60858,14699,29317,12395,46158,7867,3833,4034
39280,60869,14701,29320,12397,46167,7868,3833,4035
39285,60873,14703,29323,12399,46169,7868,3833,4035
39290,60883,14707,29326,12402,46175,7869,3833,4036
39295,60889,14708,29328,12403,46181,7871,3834,4037
39300,60900,14710,29336,12405,46187,7872,3835,4037
39305,60904,14712,29337,12407,46192,7872,3835,4037
39310,60914,14713,29341,12407,46201,7873,3835,4038
39315,60920,14714,29343,12408,46206,7875,3835,4040
39320,60931,14715,29348,12409,46215,7876,3836,4040
39325,60935,14716,29348,12410,46219,7876,3836,4040
39330,60945,14717,29351,12410,46227,7877,3836,4041
39335,60951,14717,29354,12410,46232,7879,3836,4043
39340,60962,14717,29360,12410,46245,7880,3837,4043
39345,60966,14717,29364,12410,46248,7880,3837,4043
39350,60976,14719,29369,12411,46257,7881,3838,4043
39355,60982,14719,29371,12411,46262,7883,3839,4044
39360,60993,14721,29377,12412,46269,7884,3839,4045
39365,60997,14724,29380,12415,46272,7884,3839,4045
39370,61007,14726,29383,12417,46281,7885,3839,4046
39375,61013,14727,29386,12418,46285,7887,3840,4047
39380,61024,14729,29391,12419,46292,7888,3840,4048
39385,61028,14731,29392,12421,46296,7888,3840,4048
39390,61038,14733,29396,12423,46305,7889,3841,4048
39395,61044,14734,29399,12424,46310,7891,3842,4049
39400,61055,14736,29403,12425,46318,7892,3842,4050
39405,61059,14737,29403,12426,46322,7892,3842,4050
39410,61069,14740,29408,12429,46329,7893,3842,4051
39415,61075,14741,29412,12430,46333,7895,3844,4051
39420,61086,14742,29415,12430,46342,7896,3845,4051
39425,61090,14743,29418,12431,46346,7896,3845,4051
39430,61100,14747,29424,12433,46352,7897,3846,4051
39435,61106,14748,29424,12434,46358,7899,3846,4053
39440,61117,14750,29431,12436,46364,7900,3847,4053
39445,61121,14752,29432,12438,46369,7900,3847,4053
39450,61131,14754,29436,12438,46376,7901,3847,4054
39455,61137,14756,29437,12440,46381,7903,3847,4056
39460,61148,14758,29441,12441,46388,7904,3848,4056
39465,61152,14761,29445,12444,46390,7904,3848,4056
39470,61162,14764,29449,12445,46397,7905,3849,4056
39475,61168,14765,29451,12446,46402,7907,3850,4057
39480,61179,14769,29457,12449,46406,7908,3850,4058
39485,61183,14772,29459,12452,46410,7908,3850,4058
39490,61193,14775,29463,12453,46417,7909,3851,4058
39495,61199,14775,29464,12453,46424,7911,3851,4060
39500,61210,14776,29470,12454,46431,7912,3851,4061
39505,61214,14777,29470,12455,46437,7912,3851,4061
39510,61224,14779,29476,12456,46444,7913,3851,4062
39515,61230,14779,29478,12456,46451,7915,3852,4063
39520,61241,14781,29482,12458,46459,7916,3853,4063
39525,61245,14783,29484,12460,46461,7916,3853,4063
39530,61255,14786,29487,12462,46469,7917,3853,4064
39535,61261,14787,29492,12463,46473,7919,3855,4064
39540,61272,14790,29496,12466,46481,7920,3856,4064
39545,61276,14791,29496,12467,46485,7920,3856,4064
39550,61286,14793,29503,12468,46493,7921,3857,4064
39555,61292,14794,29507,12469,46497,7923,3858,4065
39560,61303,14796,29513,12471,46504,7924,3859,4065
39565,61307,14799,29515,12474,46508,7924,3859,4065
39570,61317,14801,29521,12475,46515,7925,3860,4065
39575,61323,14801,29525,12475,46521,7927,3861,4066
39580,61334,14804,29531,12478,46528,7928,3862,4066
39585,61338,14805,29533,12479,46532,7928,3862,4066
39590,61348,14811,29541,12485,46535,7929,3863,4066
39595,61354,14813,29542,12487,46541,7931,3864,4067
39600,61365,14815,29546,12489,46549,7932,3865,4067
39605,61369,14816,29547,12490,46552,7932,3865,4067
39610,61379,14820,29550,12493,46559,7933,3865,4068
39615,61385,14820,29553,12493,46565,7935,3867,4068
39620,61396,14823,29561,12495,46570,7936,3868,4068
39625,61400,14826,29564,12498,46573,7936,3868,4068
39630,61410,14829,29569,12500,46581,7937,3869,4068
39635,61416,14829,29570,12500,46587,7939,3870,4069
39640,61427,14831,29577,12502,46594,7940,3871,4069
39645,61431,14833,29577,12504,46598,7940,3871,4069
39650,61441,14834,29581,12504,46607,7941,3871,4070
39655,61447,14834,29584,12504,46613,7943,3873,4070
39660,61458,14836,29590,12505,46620,7944,3873,4071
39665,61462,14839,29592,12508,46622,7944,3873,4071
39670,61472,14842,29598,12511,46630,7945,3873,4072
39675,61478,14842,29601,12511,46635,7947,3874,4073
39680,61489,14843,29603,12511,46645,7948,3874,4074
39685,61493,14844,29604,12512,46649,7948,3874,4074
39690,61503,14846,29610,12513,46656,7949,3875,4074
39695,61509,14848,29616,12515,46660,7951,3877,4074
39700,61520,14851,29621,12517,46668,7952,3877,4075
39705,61524,14852,29623,12518,46671,7952,3877,4075
39710,61534,14855,29628,12521,46678,7953,3877,4076
39715,61540,14856,29632,12522,46684,7955,3879,4076
39720,61551,14857,29636,12522,46690,7956,3879,4077
39725,61555,14859,29639,12524,46695,7956,3879,4077
39730,61565,14861,29645,12526,46703,7957,3879,4078
39735,61571,14862,29648,12527,46708,7959,3880,4079
39740,61582,14863,29654,12528,46717,7960,3880,4080
39745,61586,14864,29655,12529,46722,7960,3880,4080
39750,61596,14866,29662,12531,46730,7961,3881,4080
39755,61602,14866,29663,12531,46736,7963,3882,4081
39760,61613,14868,29669,12533,46744,7964,3882,4082
39765,61617,14868,29670,12533,46749,7964,3882,4082
39770,61627,14870,29674,12535,46757,7965,3882,4083
39775,61633,14870,29678,12535,46762,7967,3883,4084
39780,61644,14872,29684,12537,46770,7968,3883,4085
39785,61648,14874,29685,12539,46774,7968,3883,4085
39790,61658,14876,29692,12540,46781,7969,3883,4086
39795,61664,14876,29694,12540,46788,7971,3884,4087
39800,61675,14876,29697,12540,46799,7972,3885,4087
39805,61679,14876,29699,12540,46803,7972,3885,4087
39810,61689,14878,29705,12541,46811,7973,3886,4087
39815,61695,14878,29707,12541,46816,7975,3886,4089
39820,61706,14880,29713,12543,46824,7976,3887,4089
39825,61710,14882,29713,12545,46828,7976,3887,4089
39830,61720,14885,29717,12547,46835,7977,3887,4090
39835,61726,14886,29722,12548,46839,7979,3888,4091
39840,61737,14889,29726,12551,46847,7980,3889,4091
39845,61741,14891,29729,12553,46849,7980,3889,4091
39850,61751,14894,29732,12555,46857,7981,3889,4092
39855,61757,14895,29736,12556,46861,7983,3890,4093
39860,61768,14899,29742,12559,46865,7984,3890,4094
39865,61772,14904,29743,12564,46868,7984,3890,4094
39870,61782,14909,29747,12568,46873,7985,3890,4095
39875,61788,14910,29751,12569,46876,7987,3891,4096
39880,61799,14916,29758,12575,46880,7988,3891,4097
39885,61803,14919,29759,12578,46883,7988,3891,4097
39890,61813,14925,29763,12582,46888,7989,3892,4097
39895,61819,14925,29767,12582,46892,7991,3894,4097
39900,61830,14930,29769,12586,46900,7992,3894,4098
39905,61834,14930,29769,12586,46904,7992,3894,4098
39910,61844,14932,29775,12588,46912,7993,3895,4098
39915,61850,14932,29777,12588,46918,7995,3896,4099
39920,61861,14933,29783,12589,46926,7996,3896,4100
39925,61865,14935,29783,12591,46930,7996,3896,4100
39930,61875,14937,29789,12593,46938,7997,3896,4101
39935,61881,14937,29791,12593,46943,7999,3896,4103
39940,61892,14938,29795,12593,46953,8000,3897,4103
39945,61896,14940,29797,12595,46955,8000,3897,4103
39950,61906,14943,29803,12598,46962,8001,3898,4103
39955,61912,14944,29803,12599,46968,8003,3898,4105
39960,61923,14946,29809,12601,46975,8004,3899,4105
39965,61927,14947,29810,12602,46980,8004,3899,4105
39970,61937,14949,29816,12604,46988,8005,3900,4105
39975,61943,14950,29820,12605,46992,8007,3901,4106
39980,61954,14951,29826,12605,47000,8008,3902,4106
39985,61958,14954,29828,12608,47004,8008,3902,4106
39990,61968,14957,29836,12610,47011,8009,3903,4106
39995,61974,14958,29840,12611,47015,8011,3905,4106
40000,61985,14959,29844,12612,47024,8012,3905,4107
40005,61989,14961,29846,12614,47027,8012,3905,4107
40010,61999,14963,29848,12615,47036,8013,3905,4108
40015,62005,14964,29852,12616,47040,8015,3906,4109
40020,62016,14967,29859,12619,47045,8016,3907,4109
40025,62020,14970,29861,12622,47050,8016,3907,4109
40030,62030,14972,29863,12622,47057,8017,3908,4109
40035,62036,14973,29866,12623,47063,8019,3910,4109
40040,62047,14974,29872,12624,47070,8020,3911,4109
40045,62051,14975,29873,12625,47076,8020,3911,4109
40050,62061,14977,29880,12626,47083,8021,3912,4109
40055,62067,14978,29884,12627,47088,8023,3912,4111
40060,62078,14980,29890,12629,47096,8024,3912,4112
40065,62082,14982,29892,12631,47100,8024,3912,4112
40070,62092,14984,29898,12632,47108,8025,3913,4112
40075,62098,14985,29902,12633,47112,8027,3914,4113
40080,62109,14987,29908,12635,47120,8028,3915,4113
40085,62113,14988,29910,12636,47125,8028,3915,4113
40090,62123,14990,29915,12636,47133,8029,3915,4114
40095,62129,14991,29918,12637,47138,8031,3915,4116
40100,62140,14992,29926,12638,47145,8032,3916,4116
40105,62144,14994,29928,12640,47150,8032,3916,4116
40110,62154,14996,29932,12641,47158,8033,3917,4116
40115,62160,14996,29933,12641,47164,8035,3918,4117
40120,62171,14997,29938,12642,47171,8036,3918,4118
40125,62175,15000,29939,12645,47175,8036,3918,4118
40130,62185,15003,29943,12647,47181,8037,3918,4119
40135,62191,15004,29946,12648,47185,8039,3919,4120
40140,62202,15009,29951,12653,47192,8040,3920,4120
40145,62206,15011,29953,12655,47194,8040,3920,4120
40150,62216,15016,29959,12659,47198,8041,3921,4120
40155,62222,15018,29963,12661,47202,8043,3923,4120
40160,62233,15022,29965,12664,47210,8044,3923,4121
40165,62237,15025,29968,12667,47211,8044,3923,4121
40170,62247,15028,29971,12670,47218,8045,3923,4122
40175,62253,15029,29973,12671,47223,8047,3923,4124
40180,62264,15030,29979,12671,47231,8048,3924,4124
40185,62268,15032,29979,12673,47236,8048,3924,4124
40190,62278,15032,29982,12673,47246,8049,3925,4124
40195,62284,15032,29987,12673,47250,8051,3927,4124
40200,62295,15034,29990,12674,47261,8052,3928,4124
40205,62299,15034,29991,12674,47265,8052,3928,4124
40210,62309,15035,29998,12675,47273,8053,3929,4124
40215,62315,15036,30001,12676,47278,8055,3930,4125
40220,62326,15037,30005,12677,47288,8056,3930,4126
40225,62330,15038,30006,12678,47292,8056,3930,4126
40230,62340,15039,30012,12679,47301,8057,3931,4126
40235,62346,15039,30013,12679,47307,8059,3931,4128
40240,62357,15041,30019,12680,47314,8060,3931,4129
40245,62361,15043,30021,12682,47318,8060,3931,4129
40250,62371,15044,30026,12683,47326,8061,3931,4130
40255,62377,15045,30028,12684,47332,8063,3931,4132
40260,62388,15046,30033,12684,47340,8064,3932,4132
40265,62392,15048,30033,12686,47344,8064,3932,4132
40270,62402,15051,30040,12689,47350,8065,3933,4132
40275,62408,15052,30042,12690,47356,8067,3934,4133
40280,62419,15053,30047,12691,47364,8068,3934,4134
40285,62423,15054,30047,12692,47369,8068,3934,4134
40290,62433,15056,30052,12693,47376,8069,3935,4134
40295,62439,15057,30055,12694,47382,8071,3935,4136
40300,62450,15059,30061,12696,47389,8072,3935,4137
40305,62454,15061,30062,12698,47393,8072,3935,4137
40310,62464,15063,30066,12699,47400,8073,3935,4138
40315,62470,15063,30067,12699,47407,8075,3935,4140
40320,62481,15064,30073,12700,47414,8076,3935,4141
40325,62485,15065,30074,12701,47420,8076,3935,4141
40330,62495,15067,30083,12702,47427,8077,3936,4141
40335,62501,15067,30085,12702,47433,8079,3936,4143
40340,62512,15069,30090,12704,47440,8080,3936,4144
40345,62516,15071,30091,12706,47445,8080,3936,4144
40350,62526,15073,30095,12707,47452,8081,3937,4144
40355,62532,15074,30100,12708,47458,8083,3939,4144
40360,62543,15076,30106,12710,47465,8084,3940,4144
40365,62547,15079,30108,12713,47467,8084,3940,4144
40370,62557,15083,30115,12717,47473,8085,3941,4144
40375,62563,15084,30119,12718,47477,8087,3943,4144
40380,62574,15088,30123,12722,47484,8088,3943,4145
40385,62578,15092,30125,12726,47486,8088,3943,4145
40390,62588,15097,30130,12730,47491,8089,3943,4146
40395,62594,15098,30131,12731,47496,8091,3943,4148
40400,62605,15099,30136,12732,47505,8092,3944,4148
40405,62609,15099,30138,12732,47509,8092,3944,4148
40410,62619,15101,30141,12733,47518,8093,3944,4149
40415,62625,15101,30143,12733,47523,8095,3945,4150
40420,62636,15102,30147,12733,47533,8096,3946,4150
40425,62640,15103,30150,12734,47536,8096,3946,4150
40430,62650,15105,30154,12736,47545,8097,3946,4151
40435,62656,15105,30156,12736,47551,8099,3947,4152
40440,62667,15108,30161,12739,47559,8100,3947,4153
40445,62671,15109,30163,12740,47561,8100,3947,4153
40450,62681,15110,30166,12740,47571,8101,3948,4153
40455,62687,15110,30170,12740,47576,8103,3949,4154
40460,62698,15112,30177,12742,47584,8104,3950,4154
40465,62702,15115,30179,12745,47587,8104,3950,4154
40470,62712,15118,30187,12748,47593,8105,3950,4155
40475,62718,15120,30190,12750,47597,8107,3951,4156
40480,62729,15121,30195,12750,47605,8108,3952,4156
40485,62733,15124,30197,12753,47608,8108,3952,4156
40490,62743,15126,30201,12754,47616,8109,3953,4156
40495,62749,15128,30205,12756,47620,8111,3954,4157
40500,62760,15131,30211,12759,47627,8112,3955,4157
40505,62764,15133,30212,12761,47631,8112,3955,4157
40510,62774,15137,30216,12764,47636,8113,3955,4158
40515,62780,15138,30217,12765,47642,8115,3956,4159
40520,62791,15140,30222,12767,47649,8116,3956,4160
40525,62795,15143,30225,12770,47652,8116,3956,4160
40530,62805,15146,30229,12771,47659,8117,3957,4160
40535,62811,15147,30231,12772,47664,8119,3958,4161
40540,62822,15148,30236,12773,47672,8120,3959,4161
40545,62826,15149,30237,12774,47677,8120,3959,4161
40550,62836,15151,30242,12776,47685,8121,3959,4162
40555,62842,15151,30243,12776,47690,8123,3959,4164
40560,62853,15154,30249,12779,47697,8124,3960,4164
40565,62857,15157,30253,12782,47699,8124,3960,4164
40570,62867,15160,30257,12783,47707,8125,3961,4164
40575,62873,15160,30260,12783,47712,8127,3962,4165
40580,62884,15162,30264,12785,47720,8128,3963,4165
40585,62888,15164,30264,12787,47724,8128,3963,4165
40590,62898,15166,30267,12788,47732,8129,3963,4166
40595,62904,15166,30270,12788,47737,8131,3964,4167
40600,62915,15168,30274,12790,47745,8132,3964,4168
40605,62919,15170,30276,12792,47748,8132,3964,4168
40610,62929,15174,30279,12794,47754,8133,3964,4169
40615,62935,15175,30283,12795,47757,8135,3965,4170
40620,62946,15178,30285,12798,47767,8136,3965,4171
40625,62950,15179,30287,12799,47770,8136,3965,4171
40630,62960,15183,30292,12801,47775,8137,3966,4171
40635,62966,15185,30294,12803,47779,8139,3966,4173
40640,62977,15189,30300,12807,47785,8140,3967,4173
40645,62981,15193,30303,12811,47787,8140,3967,4173
40650,62991,15195,30309,12813,47795,8141,3967,4174
40655,62997,15197,30313,12815,47799,8143,3968,4175
40660,63008,15198,30317,12816,47810,8144,3969,4175
40665,63012,15198,30319,12816,47813,8144,3969,4175
40670,63022,15200,30322,12817,47822,8145,3969,4176
40675,63028,15201,30325,12818,47826,8147,3969,4178
40680,63039,15203,30331,12819,47833,8148,3969,4179
40685,63043,15206,30333,12822,47837,8148,3969,4179
40690,63053,15207,30336,12823,47846,8149,3969,4180
40695,63059,15208,30340,12824,47850,8151,3970,4181
40700,63070,15210,30347,12826,47858,8152,3971,4181
40705,63074,15212,30349,12828,47862,8152,3971,4181
40710,63084,15213,30353,12828,47870,8153,3971,4182
40715,63090,15214,30354,12829,47876,8155,3972,4183
40720,63101,15217,30362,12832,47881,8156,3972,4184
40725,63105,15219,30364,12834,47885,8156,3972,4184
40730,63115,15221,30370,12836,47893,8157,3972,4185
40735,63121,15222,30372,12837,47899,8159,3973,4186
40740,63132,15224,30378,12839,47907,8160,3974,4186
40745,63136,15225,30379,12840,47911,8160,3974,4186
40750,63146,15229,30383,12843,47917,8161,3975,4186
40755,63152,15230,30387,12844,47922,8163,3976,4187
40760,63163,15233,30397,12847,47926,8164,3977,4187
40765,63167,15237,30400,12851,47930,8164,3977,4187
40770,63177,15239,30405,12853,47938,8165,3977,4188
40775,63183,15239,30407,12853,47943,8167,3977,4190
40780,63194,15241,30413,12855,47951,8168,3978,4190
40785,63198,15244,30415,12858,47954,8168,3978,4190
40790,63208,15246,30418,12859,47961,8169,3978,4191
40795,63214,15246,30418,12859,47968,8171,3978,4193
40800,63225,15248,30421,12861,47976,8172,3978,4194
40805,63229,15250,30423,12863,47979,8172,3978,4194
40810,63239,15252,30428,12865,47987,8173,3979,4194
40815,63245,15253,30429,12866,47992,8175,3979,4196
40820,63256,15255,30437,12868,47999,8176,3980,4196
40825,63260,15256,30438,12869,48003,8176,3980,4196
40830,63270,15259,30442,12871,48011,8177,3981,4196
40835,63276,15260,30444,12872,48015,8179,3981,4198
40840,63287,15263,30447,12875,48024,8180,3982,4198
40845,63291,15263,30449,12875,48026,8180,3982,4198
40850,63301,15268,30454,12879,48032,8181,3983,4198
40855,63307,15269,30456,12880,48037,8183,3984,4199
40860,63318,15272,30461,12883,48044,8184,3985,4199
40865,63322,15274,30464,12885,48047,8184,3985,4199
40870,63332,15280,30469,12890,48051,8185,3985,4200
40875,63338,15282,30472,12892,48056,8187,3986,4201
40880,63349,15283,30477,12892,48063,8188,3987,4201
40885,63353,15285,30479,12894,48068,8188,3987,4201
40890,63363,15287,30482,12895,48075,8189,3987,4202
40895,63369,15287,30484,12895,48080,8191,3987,4204
40900,63380,15289,30490,12896,48089,8192,3988,4204
40905,63384,15290,30492,12897,48093,8192,3988,4204
40910,63394,15292,30497,12899,48101,8193,3988,4205
40915,63400,15294,30501,12901,48105,8195,3989,4206
40920,63411,15297,30507,12903,48111,8196,3989,4207
40925,63415,15299,30509,12905,48116,8196,3989,4207
40930,63425,15300,30514,12906,48124,8197,3990,4207
40935,63431,15302,30517,12908,48129,8199,3991,4208
40940,63442,15304,30521,12909,48137,8200,3991,4209
40945,63446,15306,30524,12911,48139,8200,3991,4209
40950,63456,15309,30530,12914,48146,8201,3992,4209
40955,63462,15311,30534,12916,48151,8203,3994,4209
40960,63473,15314,30537,12918,48158,8204,3994,4210
40965,63477,15315,30538,12919,48162,8204,3994,4210
40970,63487,15318,30543,12921,48168,8205,3994,4211
40975,63493,15319,30547,12922,48173,8207,3995,4212
40980,63504,15322,30554,12925,48178,8208,3995,4213
40985,63508,15325,30556,12928,48183,8208,3995,4213
40990,63518,15327,30564,12929,48190,8209,3996,4213
40995,63524,15327,30566,12929,48196,8211,3997,4214
41000,63535,15327,30567,12929,48208,8212,3997,4215
41005,63539,15327,30570,12929,48212,8212,3997,4215
41010,63549,15329,30573,12929,48219,8213,3997,4216
41015,63555,15330,30577,12930,48225,8215,3999,4216
41020,63566,15331,30583,12931,48234,8216,3999,4217
41025,63570,15333,30585,12933,48236,8216,3999,4217
41030,63580,15337,30590,12936,48241,8217,4000,4217
41035,63586,15338,30593,12937,48247,8219,4001,4218
41040,63597,15340,30597,12939,48254,8220,4001,4219
41045,63601,15342,30599,12941,48259,8220,4001,4219
41050,63611,15344,30607,12942,48266,8221,4002,4219
41055,63617,15344,30610,12942,48272,8223,4003,4220
41060,63628,15345,30613,12943,48281,8224,4004,4220
41065,63632,15345,30615,12943,48286,8224,4004,4220
41070,63642,15348,30619,12944,48293,8225,4005,4220
41075,63648,15348,30620,12944,48300,8227,4006,4221
41080,63659,15350,30623,12946,48309,8228,4006,4222
41085,63663,15350,30624,12946,48313,8228,4006,4222
41090,63673,15353,30630,12948,48319,8229,4007,4222
41095,63679,15355,30634,12950,48323,8231,4008,4223
41100,63690,15359,30639,12954,48330,8232,4009,4223
41105,63694,15361,30640,12956,48333,8232,4009,4223
41110,63704,15365,30645,12959,48338,8233,4009,4224
41115,63710,15366,30647,12960,48344,8235,4010,4225
41120,63721,15368,30651,12961,48350,8236,4010,4226
41125,63725,15371,30652,12964,48353,8236,4010,4226
41130,63735,15376,30661,12969,48358,8237,4011,4226
41135,63741,15377,30662,12970,48364,8239,4012,4227
41140,63752,15380,30667,12973,48371,8240,4013,4227
41145,63756,15382,30670,12975,48372,8240,4013,4227
41150,63766,15390,30677,12983,48375,8241,4013,4228
41155,63772,15391,30680,12984,48378,8243,4013,4230
41160,63783,15397,30686,12990,48385,8244,4014,4230
41165,63787,15398,30688,12991,48388,8244,4014,4230
41170,63797,15400,30693,12992,48396,8245,4014,4231
41175,63803,15401,30694,12993,48402,8247,4014,4233
41180,63814,15402,30699,12993,48411,8248,4015,4233
41185,63818,15403,30702,12994,48414,8248,4015,4233
41190,63828,15405,30707,12995,48422,8249,4015,4234
41195,63834,15407,30712,12997,48426,8251,4017,4234
41200,63845,15409,30718,12999,48433,8252,4017,4235
41205,63849,15411,30721,13001,48437,8252,4017,4235
41210,63859,15412,30724,13001,48446,8253,4018,4235
41215,63865,15412,30725,13001,48453,8255,4018,4237
41220,63876,15412,30732,13001,48461,8256,4018,4238
41225,63880,15413,30735,13002,48466,8256,4018,4238
41230,63890,15414,30738,13002,48475,8257,4018,4239
41235,63896,15414,30741,13002,48482,8259,4020,4239
41240,63907,15414,30747,13002,48492,8260,4020,4240
41245,63911,15414,30749,13002,48496,8260,4020,4240
41250,63921,15415,30754,13002,48505,8261,4021,4240
41255,63927,15415,30756,13002,48511,8263,4022,4241
41260,63938,15415,30763,13002,48523,8264,4023,4241
41265,63942,15415,30765,13002,48527,8264,4023,4241
41270,63952,15417,30771,13004,48534,8265,4024,4241
41275,63958,15417,30773,13004,48540,8267,4025,4242
41280,63969,15419,30780,13006,48548,8268,4026,4242
41285,63973,15420,30782,13007,48553,8268,4026,4242
41290,63983,15422,30787,13008,48560,8269,4026,4243
41295,63989,15422,30789,13008,48567,8271,4027,4244
41300,64000,15422,30792,13008,48577,8272,4028,4244
41305,64004,15422,30796,13008,48581,8272,4028,4244
41310,64014,15427,30802,13012,48586,8273,4028,4245
41315,64020,15428,30804,13013,48591,8275,4029,4246
41320,64031,15433,30812,13018,48596,8276,4030,4246
41325,64035,15437,30815,13022,48598,8276,4030,4246
41330,64045,15441,30820,13025,48603,8277,4031,4246
41335,64051,15442,30821,13026,48609,8279,4031,4248
41340,64062,15445,30825,13028,48615,8280,4031,4249
41345,64066,15448,30827,13031,48618,8280,4031,4249
41350,64076,15453,30834,13036,48622,8281,4031,4250
41355,64082,15454,30837,13037,48628,8283,4033,4250
41360,64093,15457,30844,13040,48633,8284,4034,4250
41365,64097,15461,30846,13044,48635,8284,4034,4250
41370,64107,15466,30851,13049,48640,8285,4034,4251
41375,64113,15466,30853,13049,48645,8287,4034,4253
41380,64124,15468,30859,13051,48654,8288,4035,4253
41385,64128,15471,30862,13054,48656,8288,4035,4253
41390,64138,15474,30869,13056,48663,8289,4036,4253
41395,64144,15476,30871,13058,48668,8291,4037,4254
41400,64155,15479,30879,13060,48673,8292,4037,4255
41405,64159,15482,30880,13063,48677,8292,4037,4255
41410,64169,15483,30884,13064,48685,8293,4038,4255
41415,64175,15484,30887,13065,48691,8295,4039,4256
41420,64186,15484,30894,13065,48700,8296,4040,4256
41425,64190,15485,30897,13066,48705,8296,4040,4256
41430,64200,15486,30901,13066,48713,8297,4041,4256
41435,64206,15486,30904,13066,48720,8299,4042,4257
41440,64217,15486,30909,13066,48730,8300,4043,4257
41445,64221,15486,30911,13066,48735,8300,4043,4257
41450,64231,15487,30915,13067,48743,8301,4044,4257
41455,64237,15487,30916,13067,48750,8303,4044,4259
41460,64248,15488,30922,13068,48759,8304,4045,4259
41465,64252,15488,30924,13068,48764,8304,4045,4259
41470,64262,15489,30928,13069,48772,8305,4045,4260
41475,64268,15489,30929,13069,48779,8307,4045,4262
41480,64279,15490,30934,13070,48787,8308,4045,4263
41485,64283,15492,30935,13072,48791,8308,4045,4263
41490,64293,15494,30940,13073,48798,8309,4045,4264
41495,64299,15495,30944,13074,48801,8311,4045,4266
41500,64310,15501,30951,13080,48807,8312,4045,4267
41505,64314,15502,30953,13081,48810,8312,4045,4267
41510,64324,15509,30958,13087,48814,8313,4046,4267
41515,64330,15509,30961,13087,48818,8315,4046,4269
41520,64341,15513,30964,13090,48825,8316,4046,4270
41525,64345,15517,30967,13094,48827,8316,4046,4270
41530,64355,15520,30973,13096,48834,8317,4046,4271
41535,64361,15521,30975,13097,48839,8319,4047,4272
41540,64372,15523,30981,13098,48845,8320,4047,4273
41545,64376,15526,30983,13101,48849,8320,4047,4273
41550,64386,15529,30988,13103,48857,8321,4048,4273
41555,64392,15529,30990,13103,48863,8323,4049,4274
41560,64403,15531,30995,13105,48870,8324,4050,4274
41565,64407,15533,30998,13107,48873,8324,4050,4274
41570,64417,15536,31003,13109,48881,8325,4051,4274
41575,64423,15536,31006,13109,48887,8327,4052,4275
41580,64434,15539,31013,13112,48892,8328,4053,4275
41585,64438,15543,31014,13116,48895,8328,4053,4275
41590,64448,15546,31019,13119,48901,8329,4053,4276
41595,64454,15547,31023,13120,48906,8331,4054,4277
41600,64465,15551,31029,13124,48913,8332,4055,4277
41605,64469,15553,31032,13126,48916,8332,4055,4277
41610,64479,15556,31037,13127,48923,8333,4056,4277
41615,64485,15557,31040,13128,48927,8335,4056,4279
41620,64496,15561,31045,13131,48933,8336,4057,4279
41625,64500,15564,31047,13134,48935,8336,4057,4279
41630,64510,15569,31053,13138,48940,8337,4058,4279
41635,64516,15571,31056,13140,48945,8339,4058,4281
41640,64527,15573,31060,13141,48951,8340,4058,4282
41645,64531,15576,31064,13144,48955,8340,4058,4282
41650,64541,15577,31071,13144,48963,8341,4058,4283
41655,64547,15578,31074,13145,48969,8343,4059,4284
41660,64558,15578,31078,13145,48979,8344,4060,4284
41665,64562,15578,31081,13145,48984,8344,4060,4284
41670,64572,15579,31086,13145,48992,8345,4061,4284
41675,64578,15580,31090,13146,48998,8347,4062,4285
41680,64589,15581,31097,13147,49007,8348,4062,4286
41685,64593,15581,31098,13147,49012,8348,4062,4286
41690,64603,15582,31100,13147,49021,8349,4062,4287
41695,64609,15582,31102,13147,49026,8351,4063,4288
41700,64620,15583,31106,13148,49036,8352,4063,4289
41705,64624,15584,31108,13149,49039,8352,4063,4289
41710,64634,15585,31114,13150,49048,8353,4064,4289
41715,64640,15585,31116,13150,49055,8355,4065,4290
41720,64651,15586,31123,13151,49063,8356,4066,4290
41725,64655,15587,31125,13152,49067,8356,4066,4290
41730,64665,15588,31130,13153,49077,8357,4066,4291
41735,64671,15588,31132,13153,49082,8359,4067,4292
41740,64682,15589,31138,13154,49092,8360,4067,4293
41745,64686,15589,31141,13154,49096,8360,4067,4293
41750,64696,15595,31149,13159,49101,8361,4068,4293
41755,64702,15595,31150,13159,49107,8363,4069,4294
41760,64713,15599,31159,13163,49110,8364,4070,4294
41765,64717,15602,31160,13166,49115,8364,4070,4294
41770,64727,15606,31166,13170,49121,8365,4071,4294
41775,64733,15607,31171,13171,49126,8367,4073,4294
41780,64744,15610,31179,13174,49131,8368,4074,4294
41785,64748,15613,31181,13177,49135,8368,4074,4294
41790,64758,15616,31185,13179,49141,8369,4074,4295
41795,64764,15618,31188,13181,49146,8371,4075,4296
41800,64775,15620,31194,13183,49152,8372,4076,4296
41805,64779,15623,31195,13186,49156,8372,4076,4296
41810,64789,15625,31198,13187,49164,8373,4076,4297
41815,64795,15626,31200,13188,49169,8375,4077,4298
41820,64806,15627,31204,13188,49177,8376,4077,4299
41825,64810,15630,31207,13191,49180,8376,4077,4299
41830,64820,15634,31213,13195,49185,8377,4077,4300
41835,64826,15636,31218,13197,49190,8379,4079,4300
41840,64837,15638,31222,13199,49199,8380,4079,4301
41845,64841,15638,31224,13199,49203,8380,4079,4301
41850,64851,15640,31231,13201,49210,8381,4080,4301
41855,64857,15640,31233,13201,49217,8383,4081,4302
41860,64868,15643,31239,13204,49223,8384,4081,4303
41865,64872,15644,31240,13205,49227,8384,4081,4303
41870,64882,15648,31245,13209,49233,8385,4081,4304
41875,64888,15649,31247,13210,49238,8387,4081,4306
41880,64899,15652,31254,13213,49245,8388,4082,4306
41885,64903,15655,31257,13216,49247,8388,4082,4306
41890,64913,15660,31264,13221,49252,8389,4083,4306
41895,64919,15662,31268,13223,49255,8391,4084,4307
41900,64930,15665,31274,13226,49262,8392,4085,4307
41905,64934,15667,31275,13228,49267,8392,4085,4307
41910,64944,15669,31279,13229,49275,8393,4086,4307
41915,64950,15670,31282,13230,49280,8395,4087,4308
41920,64961,15671,31286,13231,49288,8396,4087,4309
41925,64965,15673,31287,13233,49292,8396,4087,4309
41930,64975,15675,31291,13234,49300,8397,4087,4310
41935,64981,15676,31295,13235,49304,8399,4088,4311
41940,64992,15680,31300,13239,49311,8400,4089,4311
41945,64996,15681,31302,13240,49315,8400,4089,4311
41950,65006,15683,31308,13242,49322,8401,4090,4311
41955,65012,15685,31311,13244,49327,8403,4091,4312
41960,65023,15687,31316,13246,49334,8404,4092,4312
41965,65027,15688,31318,13247,49339,8404,4092,4312
41970,65037,15689,31322,13248,49347,8405,4092,4313
41975,65043,15690,31325,13249,49353,8407,4093,4314
41980,65054,15691,31330,13250,49361,8408,4094,4314
41985,65058,15693,31331,13252,49365,8408,4094,4314
41990,65068,15695,31335,13253,49372,8409,4095,4314
41995,65074,15696,31337,13254,49378,8411,4095,4316
42000,65085,15697,31339,13255,49388,8412,4095,4317
42005,65089,15697,31340,13255,49392,8412,4095,4317
42010,65099,15699,31345,13257,49399,8413,4095,4318
42015,65105,15700,31348,13258,49404,8415,4097,4318
42020,65116,15701,31350,13259,49415,8416,4097,4319
42025,65120,15702,31354,13260,49417,8416,4097,4319
42030,65130,15704,31360,13262,49425,8417,4098,4319
42035,65136,15705,31362,13263,49430,8419,4099,4320
42040,65147,15707,31368,13264,49437,8420,4099,4321
42045,65151,15710,31369,13267,49440,8420,4099,4321
42050,65161,15716,31375,13272,49443,8421,4099,4322
42055,65167,15719,31378,13275,49447,8423,4100,4323
42060,65178,15722,31382,13277,49454,8424,4101,4323
42065,65182,15723,31383,13278,49459,8424,4101,4323
42070,65192,15727,31388,13280,49464,8425,4101,4324
42075,65198,15728,31391,13281,49469,8427,4102,4325
42080,65209,15733,31396,13285,49474,8428,4102,4326
42085,65213,15735,31399,13287,49477,8428,4102,4326
42090,65223,15738,31403,13288,49485,8429,4102,4327
42095,65229,15738,31407,13288,49489,8431,4104,4327
42100,65240,15742,31412,13292,49496,8432,4104,4328
42105,65244,15745,31415,13295,49498,8432,4104,4328
42110,65254,15749,31422,13298,49505,8433,4105,4328
42115,65260,15749,31422,13298,49511,8435,4105,4330
42120,65271,15751,31426,13299,49518,8436,4106,4330
42125,65275,15753,31427,13301,49522,8436,4106,4330
42130,65285,15755,31434,13302,49529,8437,4107,4330
42135,65291,15756,31440,13303,49534,8439,4109,4330
42140,65302,15759,31445,13306,49541,8440,4109,4331
42145,65306,15760,31448,13307,49546,8440,4109,4331
42150,65316,15762,31453,13307,49553,8441,4109,4332
42155,65322,15763,31457,13308,49559,8443,4111,4332
42160,65333,15765,31462,13310,49568,8444,4112,4332
42165,65337,15765,31462,13310,49572,8444,4112,4332
42170,65347,15767,31466,13310,49580,8445,4113,4332
42175,65353,15767,31468,13310,49586,8447,4115,4332
42180,65364,15767,31472,13310,49595,8448,4115,4333
42185,65368,15768,31474,13311,49600,8448,4115,4333
42190,65378,15770,31479,13312,49607,8449,4116,4333
42195,65384,15771,31483,13313,49613,8451,4117,4334
42200,65395,15773,31490,13315,49620,8452,4118,4334
42205,65399,15774,31491,13316,49625,8452,4118,4334
42210,65409,15776,31498,13317,49632,8453,4119,4334
42215,65415,15777,31503,13318,49636,8455,4120,4335
42220,65426,15780,31509,13321,49642,8456,4120,4336
42225,65430,15784,31511,13325,49645,8456,4120,4336
42230,65440,15789,31518,13329,49650,8457,4120,4337
42235,65446,15791,31522,13331,49654,8459,4122,4337
42240,65457,15793,31526,13332,49664,8460,4123,4337
42245,65461,15793,31526,13332,49668,8460,4123,4337
42250,65471,15796,31533,13335,49675,8461,4124,4337
42255,65477,15796,31536,13335,49681,8463,4125,4338
42260,65488,15797,31540,13336,49689,8464,4126,4338
42265,65492,15800,31542,13339,49692,8464,4126,4338
42270,65502,15801,31545,13339,49700,8465,4126,4339
42275,65508,15803,31548,13341,49704,8467,4126,4341
42280,65519,15804,31552,13341,49714,8468,4127,4341
42285,65523,15806,31555,13343,49717,8468,4127,4341
42290,65533,15807,31560,13343,49725,8469,4127,4342
42295,65539,15808,31562,13344,49731,8471,4128,4343
42300,65550,15810,31567,13345,49739,8472,4129,4343
42305,65554,15812,31570,13347,49742,8472,4129,4343
42310,65564,15814,31575,13348,49749,8473,4130,4343
42315,65570,15816,31579,13350,49753,8475,4131,4344
42320,65581,15818,31583,13352,49763,8476,4132,4344
42325,65585,15819,31585,13353,49766,8476,4132,4344
42330,65595,15822,31591,13355,49772,8477,4133,4344
42335,65601,15823,31595,13356,49775,8479,4134,4345
42340,65612,15829,31603,13362,49779,8480,4135,4345
42345,65616,15833,31604,13366,49782,8480,4135,4345
42350,65626,15838,31608,13369,49786,8481,4135,4346
42355,65632,15840,31611,13371,49790,8483,4136,4347
42360,65643,15845,31618,13376,49797,8484,4137,4347
42365,65647,15845,31620,13376,49801,8484,4137,4347
42370,65657,15847,31625,13378,49810,8485,4138,4347
42375,65663,15847,31627,13378,49814,8487,4138,4349
42380,65674,15849,31633,13380,49823,8488,4139,4349
42385,65678,15850,31635,13381,49827,8488,4139,4349
42390,65688,15852,31641,13382,49836,8489,4140,4349
42395,65694,15853,31645,13383,49839,8491,4141,4350
42400,65705,15855,31650,13385,49848,8492,4141,4351
42405,65709,15857,31653,13387,49851,8492,4141,4351
42410,65719,15859,31659,13389,49860,8493,4142,4351
42415,65725,15859,31661,13389,49866,8495,4144,4351
42420,65736,15860,31663,13390,49875,8496,4144,4352
42425,65740,15861,31665,13391,49879,8496,4144,4352
42430,65750,15862,31667,13391,49888,8497,4144,4353
42435,65756,15862,31671,13391,49894,8499,4146,4353
42440,65767,15863,31676,13392,49904,8500,4147,4353
42445,65771,15863,31679,13392,49907,8500,4147,4353
42450,65781,15864,31683,13392,49917,8501,4148,4353
42455,65787,15864,31687,13392,49922,8503,4150,4353
42460,65798,15867,31692,13394,49929,8504,4151,4353
42465,65802,15868,31695,13395,49933,8504,4151,4353
42470,65812,15873,31702,13399,49937,8505,4152,4353
42475,65818,15875,31705,13401,49942,8507,4152,4355
42480,65829,15878,31708,13403,49950,8508,4152,4356
42485,65833,15880,31710,13405,49953,8508,4152,4356
42490,65843,15882,31716,13407,49960,8509,4153,4356
42495,65849,15883,31717,13408,49966,8511,4153,4358
42500,65860,15884,31723,13408,49973,8512,4154,4358
42505,65864,15887,31727,13411,49977,8512,4154,4358
42510,65874,15889,31733,13413,49985,8513,4154,4359
42515,65880,15889,31738,13413,49991,8515,4156,4359
42520,65891,15890,31744,13413,49999,8516,4157,4359
42525,65895,15892,31746,13415,50003,8516,4157,4359
42530,65905,15894,31752,13416,50010,8517,4157,4360
42535,65911,15895,31752,13417,50016,8519,4157,4362
42540,65922,15898,31756,13419,50022,8520,4157,4363
42545,65926,15900,31757,13421,50026,8520,4157,4363
42550,65936,15901,31757,13421,50035,8521,4157,4364
42555,65942,15901,31758,13421,50041,8523,4157,4366
42560,65953,15904,31767,13423,50045,8524,4158,4366
42565,65957,15907,31770,13426,50050,8524,4158,4366
42570,65967,15908,31773,13426,50059,8525,4158,4367
42575,65973,15909,31779,13427,50062,8527,4160,4367
42580,65984,15910,31785,13428,50073,8528,4160,4368
42585,65988,15911,31787,13429,50075,8528,4160,4368
42590,65998,15917,31792,13433,50080,8529,4160,4369
42595,66004,15918,31793,13434,50085,8531,4160,4371
42600,66015,15921,31799,13437,50091,8532,4161,4371
42605,66019,15923,31800,13439,50095,8532,4161,4371
42610,66029,15926,31805,13442,50102,8533,4162,4371
42615,66035,15926,31808,13442,50107,8535,4163,4372
42620,66046,15930,31813,13446,50115,8536,4163,4373
42625,66050,15932,31816,13448,50117,8536,4163,4373
42630,66060,15936,31821,13452,50124,8537,4163,4374
42635,66066,15936,31824,13452,50130,8539,4165,4374
42640,66077,15937,31827,13453,50139,8540,4166,4374
42645,66081,15937,31828,13453,50144,8540,4166,4374
42650,66091,15938,31833,13453,50153,8541,4166,4375
42655,66097,15939,31837,13454,50157,8543,4167,4376
42660,66108,15939,31844,13454,50168,8544,4168,4376
42665,66112,15939,31847,13454,50173,8544,4168,4376
42670,66122,15942,31850,13456,50180,8545,4168,4377
42675,66128,15943,31852,13457,50185,8547,4168,4379
42680,66139,15945,31859,13459,50192,8548,4168,4380
42685,66143,15947,31860,13461,50196,8548,4168,4380
42690,66153,15949,31866,13463,50204,8549,4168,4381
42695,66159,15950,31869,13464,50209,8551,4169,4382
42700,66170,15951,31871,13465,50218,8552,4169,4383
42705,66174,15952,31873,13466,50222,8552,4169,4383
42710,66184,15953,31876,13466,50230,8553,4170,4383
42715,66190,15954,31878,13467,50235,8555,4170,4385
42720,66201,15956,31882,13469,50244,8556,4171,4385
42725,66205,15957,31883,13470,50248,8556,4171,4385
42730,66215,15959,31887,13471,50256,8557,4171,4386
42735,66221,15959,31890,13471,50261,8559,4173,4386
42740,66232,15961,31895,13472,50269,8560,4174,4386
42745,66236,15963,31897,13474,50273,8560,4174,4386
42750,66246,15966,31903,13477,50280,8561,4175,4386
42755,66252,15966,31905,13477,50286,8563,4176,4387
42760,66263,15968,31912,13479,50292,8564,4177,4387
42765,66267,15971,31913,13482,50296,8564,4177,4387
42770,66277,15977,31920,13487,50299,8565,4177,4388
42775,66283,15979,31924,13489,50303,8567,4177,4390
42780,66294,15983,31929,13492,50309,8568,4178,4390
42785,66298,15986,31932,13495,50311,8568,4178,4390
42790,66308,15989,31937,13497,50318,8569,4178,4391
42795,66314,15990,31941,13498,50323,8571,4179,4392
42800,66325,15994,31946,13501,50328,8572,4179,4393
42805,66329,15998,31948,13505,50331,8572,4179,4393
42810,66339,16001,31951,13507,50338,8573,4180,4393
42815,66345,16001,31953,13507,50343,8575,4181,4394
42820,66356,16005,31956,13510,50351,8576,4182,4394
42825,66360,16006,31957,13511,50354,8576,4182,4394
42830,66370,16009,31963,13512,50360,8577,4183,4394
42835,66376,16010,31966,13513,50365,8579,4184,4395
42840,66387,16011,31970,13514,50375,8580,4184,4396
42845,66391,16012,31972,13515,50379,8580,4184,4396
42850,66401,16014,31977,13516,50386,8581,4185,4396
42855,66407,16014,31978,13516,50393,8583,4185,4398
42860,66418,16016,31983,13518,50401,8584,4185,4399
42865,66422,16018,31985,13520,50404,8584,4185,4399
42870,66432,16020,31989,13521,50411,8585,4185,4400
42875,66438,16020,31992,13521,50417,8587,4186,4401
42880,66449,16024,31999,13525,50422,8588,4186,4402
42885,66453,16026,32000,13527,50426,8588,4186,4402
42890,66463,16032,32004,13531,50431,8589,4187,4402
42895,66469,16033,32007,13532,50435,8591,4188,4403
42900,66480,16036,32014,13535,50443,8592,4188,4404
42905,66484,16036,32017,13535,50447,8592,4188,4404
42910,66494,16037,32021,13536,50457,8593,4188,4405
42915,66500,16037,32021,13536,50463,8595,4188,4407
42920,66511,16038,32029,13537,50472,8596,4189,4407
42925,66515,16038,32032,13537,50477,8596,4189,4407
42930,66525,16039,32036,13537,50486,8597,4189,4408
42935,66531,16040,32038,13538,50491,8599,4189,4410
42940,66542,16040,32042,13538,50502,8600,4190,4410
42945,66546,16040,32042,13538,50506,8600,4190,4410
42950,66556,16043,32046,13540,50513,8601,4190,4411
42955,66562,16043,32048,13540,50519,8603,4191,4412
42960,66573,16046,32053,13542,50527,8604,4192,4412
42965,66577,16046,32056,13542,50530,8604,4192,4412
42970,66587,16049,32061,13545,50538,8605,4192,4413
42975,66593,16049,32064,13545,50544,8607,4194,4413
42980,66604,16051,32069,13546,50552,8608,4194,4414
42985,66608,16053,32071,13548,50555,8608,4194,4414
42990,66618,16056,32076,13551,50561,8609,4194,4415
42995,66624,16058,32079,13553,50566,8611,4194,4417
43000,66635,16061,32084,13556,50573,8612,4195,4417
43005,66639,16063,32087,13558,50575,8612,4195,4417
43010,66649,16065,32091,13560,50584,8613,4195,4418
43015,66655,16066,32095,13561,50588,8615,4196,4419
43020,66666,16070,32100,13564,50594,8616,4196,4420
43025,66670,16073,32101,13567,50597,8616,4196,4420
43030,66680,16076,32106,13568,50603,8617,4197,4420
43035,66686,16078,32111,13570,50607,8619,4199,4420
43040,66697,16083,32119,13575,50611,8620,4200,4420
43045,66701,16086,32120,13578,50615,8620,4200,4420
43050,66711,16089,32127,13580,50621,8621,4201,4420
43055,66717,16090,32129,13581,50627,8623,4203,4420
43060,66728,16094,32135,13584,50632,8624,4204,4420
43065,66732,16096,32135,13586,50636,8624,4204,4420
43070,66742,16098,32140,13587,50643,8625,4205,4420
43075,66748,16099,32144,13588,50648,8627,4207,4420
43080,66759,16102,32146,13591,50657,8628,4207,4421
43085,66763,16103,32148,13592,50660,8628,4207,4421
43090,66773,16105,32153,13593,50668,8629,4207,4422
43095,66779,16105,32157,13593,50673,8631,4209,4422
43100,66790,16107,32161,13595,50682,8632,4209,4423
43105,66794,16109,32163,13597,50685,8632,4209,4423
43110,66804,16111,32170,13599,50693,8633,4210,4423
43115,66810,16111,32173,13599,50698,8635,4211,4424
43120,66821,16112,32178,13600,50707,8636,4212,4424
43125,66825,16114,32179,13602,50711,8636,4212,4424
43130,66835,16116,32184,13604,50719,8637,4213,4424
43135,66841,16117,32189,13605,50723,8639,4215,4424
43140,66852,16120,32195,13608,50730,8640,4216,4424
43145,66856,16122,32197,13610,50733,8640,4216,4424
43150,66866,16125,32203,13612,50740,8641,4216,4425
43155,66872,16125,32206,13612,50746,8643,4217,4426
43160,66883,16125,32210,13612,50757,8644,4217,4427
43165,66887,16125,32212,13612,50762,8644,4217,4427
43170,66897,16126,32217,13613,50770,8645,4217,4428
43175,66903,16127,32221,13614,50775,8647,4218,4429
43180,66914,16127,32222,13614,50787,8648,4218,4430
43185,66918,16127,32224,13614,50791,8648,4218,4430
43190,66928,16129,32230,13616,50798,8649,4219,4430
43195,66934,16130,32232,13617,50803,8651,4219,4432
43200,66945,16133,32240,13620,50810,8652,4219,4433
43205,66949,16134,32241,13621,50814,8652,4219,4433
43210,66959,16135,32243,13621,50823,8653,4219,4434
43215,66965,16135,32246,13621,50829,8655,4220,4435
43220,66976,16138,32255,13623,50834,8656,4221,4435
43225,66980,16142,32257,13627,50838,8656,4221,4435
43230,66990,16144,32261,13628,50845,8657,4221,4436
43235,66996,16144,32263,13628,50851,8659,4221,4438
43240,67007,16146,32272,13630,50858,8660,4222,4438
43245,67011,16148,32273,13632,50862,8660,4222,4438
43250,67021,16151,32277,13634,50869,8661,4223,4438
43255,67027,16153,32280,13636,50874,8663,4223,4440
43260,67038,16157,32288,13639,50877,8664,4223,4441
43265,67042,16160,32290,13642,50882,8664,4223,4441
43270,67052,16164,32296,13645,50887,8665,4224,4441
43275,67058,16164,32300,13645,50894,8667,4226,4441
43280,67069,16166,32305,13647,50901,8668,4227,4441
43285,67073,16169,32308,13650,50904,8668,4227,4441
43290,67083,16172,32312,13652,50910,8669,4227,4442
43295,67089,16173,32315,13653,50915,8671,4227,4444
43300,67100,16177,32322,13657,50921,8672,4228,4444
43305,67104,16179,32323,13659,50925,8672,4228,4444
43310,67114,16181,32328,13660,50932,8673,4228,4445
43315,67120,16181,32329,13660,50939,8675,4229,4446
43320,67131,16181,32332,13660,50949,8676,4229,4447
43325,67135,16182,32333,13661,50953,8676,4229,4447
43330,67145,16184,32342,13663,50960,8677,4230,4447
43335,67151,16185,32345,13664,50966,8679,4232,4447
43340,67162,16186,32351,13665,50974,8680,4233,4447
43345,67166,16188,32354,13667,50978,8680,4233,4447
43350,67176,16190,32361,13668,50985,8681,4234,4447
43355,67182,16191,32364,13669,50990,8683,4235,4448
43360,67193,16194,32370,13672,50998,8684,4236,4448
43365,67197,16194,32372,13672,51002,8684,4236,4448
43370,67207,16198,32377,13674,51008,8685,4237,4448
43375,67213,16198,32378,13674,51015,8687,4238,4449
43380,67224,16198,32383,13674,51024,8688,4239,4449
43385,67228,16199,32384,13675,51029,8688,4239,4449
43390,67238,16202,32389,13677,51035,8689,4240,4449
43395,67244,16203,32391,13678,51040,8691,4240,4451
43400,67255,16206,32394,13681,51049,8692,4240,4452
43405,67259,16207,32398,13682,51050,8692,4240,4452
43410,67269,16215,32405,13690,51052,8693,4240,4453
43415,67275,16216,32406,13691,51058,8695,4240,4455
43420,67286,16219,32408,13693,51066,8696,4240,4456
43425,67290,16221,32410,13695,51068,8696,4240,4456
43430,67300,16228,32418,13701,51071,8697,4240,4457
43435,67306,16230,32422,13703,51075,8699,4242,4457
43440,67317,16231,32427,13704,51084,8700,4242,4458
43445,67321,16233,32429,13706,51087,8700,4242,4458
43450,67331,16236,32434,13709,51094,8701,4243,4458
43455,67337,16238,32437,13711,51099,8703,4244,4459
43460,67348,16241,32444,13714,51105,8704,4245,4459
43465,67352,16243,32447,13716,51108,8704,4245,4459
43470,67362,16244,32449,13716,51117,8705,4245,4460
43475,67368,16244,32453,13716,51123,8707,4247,4460
43480,67379,16245,32457,13716,51132,8708,4248,4460
43485,67383,16246,32457,13717,51137,8708,4248,4460
43490,67393,16247,32463,13717,51145,8709,4249,4460
43495,67399,16248,32466,13718,51151,8711,4250,4461
43500,67410,16250,32471,13719,51158,8712,4251,4461
43505,67414,16251,32472,13720,51162,8712,4251,4461
43510,67424,16253,32477,13722,51170,8713,4251,4462
43515,67430,16253,32479,13722,51177,8715,4251,4464
43520,67441,16256,32486,13724,51184,8716,4252,4464
43525,67445,16256,32487,13724,51189,8716,4252,4464
43530,67455,16258,32492,13726,51196,8717,4252,4465
43535,67461,16258,32495,13726,51203,8719,4254,4465
43540,67472,16259,32500,13726,51208,8720,4254,4466
43545,67476,16263,32502,13730,51213,8720,4254,4466
43550,67486,16266,32507,13732,51219,8721,4255,4466
43555,67492,16266,32511,13732,51225,8723,4257,4466
43560,67503,16269,32514,13734,51233,8724,4258,4466
43565,67507,16271,32515,13736,51236,8724,4258,4466
43570,67517,16274,32520,13738,51242,8725,4259,4466
43575,67523,16275,32523,13739,51248,8727,4260,4467
43580,67534,16277,32528,13741,51255,8728,4261,4467
43585,67538,16280,32530,13744,51258,8728,4261,4467
43590,67548,16283,32534,13745,51264,8729,4262,4467
43595,67554,16283,32537,13745,51270,8731,4263,4468
43600,67565,16288,32544,13749,51273,8732,4263,4469
43605,67569,16292,32546,13753,51277,8732,4263,4469
43610,67579,16294,32552,13754,51284,8733,4264,4469
43615,67585,16295,32556,13755,51289,8735,4266,4469
43620,67596,16298,32564,13758,51296,8736,4267,4469
43625,67600,16300,32565,13760,51300,8736,4267,4469
43630,67610,16304,32572,13764,51304,8737,4268,4469
43635,67616,16306,32576,13766,51308,8739,4269,4470
43640,67627,16310,32582,13770,51315,8740,4269,4471
43645,67631,16313,32586,13773,51316,8740,4269,4471
43650,67641,16317,32589,13775,51323,8741,4269,4472
43655,67647,16318,32593,13776,51329,8743,4271,4472
43660,67658,16318,32596,13776,51340,8744,4272,4472
43665,67662,16318,32597,13776,51344,8744,4272,4472
43670,67672,16319,32601,13776,51352,8745,4273,4472
43675,67678,16320,32605,13777,51357,8747,4274,4473
43680,67689,16320,32610,13777,51369,8748,4274,4474
43685,67693,16320,32612,13777,51373,8748,4274,4474
43690,67703,16321,32612,13777,51381,8749,4274,4475
43695,67709,16321,32615,13777,51387,8751,4275,4476
43700,67720,16321,32618,13777,51399,8752,4275,4477
43705,67724,16321,32620,13777,51403,8752,4275,4477
43710,67734,16323,32627,13779,51410,8753,4276,4477
43715,67740,16324,32632,13780,51414,8755,4277,4478
43720,67751,16325,32636,13781,51424,8756,4277,4479
43725,67755,16327,32638,13783,51427,8756,4277,4479
43730,67765,16328,32642,13784,51436,8757,4278,4479
43735,67771,16328,32645,13784,51442,8759,4279,4480
43740,67782,16329,32649,13784,51451,8760,4279,4481
43745,67786,16331,32651,13786,51455,8760,4279,4481
43750,67796,16332,32656,13787,51463,8761,4279,4482
43755,67802,16333,32659,13788,51468,8763,4281,4482
43760,67813,16336,32664,13790,51474,8764,4281,4483
43765,67817,16338,32665,13792,51479,8764,4281,4483
43770,67827,16341,32668,13794,51485,8765,4281,4484
43775,67833,16342,32672,13795,51491,8767,4283,4484
43780,67844,16343,32675,13795,51499,8768,4284,4484
43785,67848,16345,32678,13797,51503,8768,4284,4484
43790,67858,16347,32681,13798,51510,8769,4284,4485
43795,67864,16347,32684,13798,51516,8771,4284,4487
43800,67875,16350,32687,13801,51524,8772,4284,4488
43805,67879,16351,32690,13802,51528,8772,4284,4488
43810,67889,16355,32696,13805,51533,8773,4284,4489
43815,67895,16356,32698,13806,51539,8775,4285,4490
43820,67906,16360,32707,13810,51544,8776,4286,4490
43825,67910,16363,32709,13813,51547,8776,4286,4490
43830,67920,16367,32715,13816,51553,8777,4287,4490
43835,67926,16367,32718,13816,51558,8779,4288,4491
43840,67937,16370,32725,13819,51564,8780,4289,4491
43845,67941,16373,32726,13822,51567,8780,4289,4491
43850,67951,16376,32727,13823,51574,8781,4289,4492
43855,67957,16378,32730,13825,51578,8783,4289,4494
43860,67968,16381,32735,13827,51584,8784,4289,4495
43865,67972,16385,32736,13831,51587,8784,4289,4495
43870,67982,16388,32742,13833,51593,8785,4289,4496
43875,67988,16389,32745,13834,51598,8787,4291,4496
43880,67999,16394,32752,13838,51602,8788,4291,4497
43885,68003,16398,32754,13842,51604,8788,4291,4497
43890,68013,16402,32759,13845,51611,8789,4292,4497
43895,68019,16403,32764,13846,51614,8791,4294,4497
43900,68030,16408,32768,13851,51621,8792,4294,4498
43905,68034,16411,32770,13854,51623,8792,4294,4498
43910,68044,16415,32775,13857,51628,8793,4294,4499
43915,68050,16417,32777,13859,51633,8795,4295,4500
43920,68061,16418,32782,13860,51641,8796,4296,4500
43925,68065,16419,32784,13861,51646,8796,4296,4500
43930,68075,16420,32790,13862,51655,8797,4297,4500
43935,68081,16420,32792,13862,51660,8799,4297,4502
43940,68092,16420,32795,13862,51670,8800,4297,4503
43945,68096,16420,32797,13862,51675,8800,4297,4503
43950,68106,16421,32799,13862,51685,8801,4297,4504
43955,68112,16421,32802,13862,51690,8803,4298,4505
43960,68123,16422,32808,13863,51700,8804,4299,4505
43965,68127,16423,32811,13864,51703,8804,4299,4505
43970,68137,16424,32815,13865,51713,8805,4300,4505
43975,68143,16424,32817,13865,51718,8807,4300,4507
43980,68154,16425,32820,13866,51727,8808,4300,4508
43985,68158,16426,32822,13867,51732,8808,4300,4508
43990,68168,16427,32827,13867,51740,8809,4301,4508
43995,68174,16428,32832,13868,51746,8811,4303,4508
44000,68185,16429,32841,13869,51755,8812,4304,4508
44005,68189,16430,32842,13870,51759,8812,4304,4508
44010,68199,16432,32845,13872,51767,8813,4304,4509
44015,68205,16432,32846,13872,51773,8815,4305,4510
44020,68216,16434,32850,13873,51780,8816,4306,4510
44025,68220,16435,32852,13874,51784,8816,4306,4510
44030,68230,16438,32859,13877,51792,8817,4307,4510
44035,68236,16438,32860,13877,51797,8819,4307,4512
44040,68247,16441,32865,13880,51804,8820,4307,4513
44045,68251,16443,32868,13882,51808,8820,4307,4513
44050,68261,16446,32875,13885,51814,8821,4308,4513
44055,68267,16447,32877,13886,51819,8823,4309,4514
44060,68278,16450,32883,13889,51825,8824,4310,4514
44065,68282,16453,32884,13892,51829,8824,4310,4514
44070,68292,16456,32887,13893,51836,8825,4310,4515
44075,68298,16457,32888,13894,51841,8827,4310,4517
44080,68309,16459,32894,13895,51847,8828,4311,4517
44085,68313,16461,32896,13897,51852,8828,4311,4517
44090,68323,16464,32901,13899,51858,8829,4311,4518
44095,68329,16465,32903,13900,51863,8831,4311,4520
44100,68340,16470,32907,13904,51869,8832,4311,4521
44105,68344,16472,32909,13906,51871,8832,4311,4521
44110,68354,16476,32914,13910,51878,8833,4311,4522
44115,68360,16476,32916,13910,51883,8835,4312,4523
44120,68371,16479,32918,13912,51891,8836,4312,4524
44125,68375,16481,32920,13914,51893,8836,4312,4524
44130,68385,16485,32925,13917,51899,8837,4312,4525
44135,68391,16486,32927,13918,51904,8839,4313,4526
44140,68402,16491,32933,13923,51909,8840,4313,4527
44145,68406,16494,32936,13926,51910,8840,4313,4527
44150,68416,16500,32940,13930,51916,8841,4314,4527
44155,68422,16500,32941,13930,51922,8843,4315,4528
44160,68433,16500,32947,13930,51931,8844,4316,4528
44165,68437,16502,32951,13932,51933,8844,4316,4528
44170,68447,16507,32957,13937,51938,8845,4316,4529
44175,68453,16508,32961,13938,51942,8847,4317,4530
44180,68464,16511,32966,13941,51952,8848,4318,4530
44185,68468,16511,32968,13941,51956,8848,4318,4530
44190,68478,16512,32975,13941,51965,8849,4318,4531
44195,68484,16512,32978,13941,51972,8851,4320,4531
44200,68495,16513,32983,13942,51981,8852,4320,4532
44205,68499,16513,32984,13942,51986,8852,4320,4532
44210,68509,16514,32990,13943,51995,8853,4321,4532
44215,68515,16515,32994,13944,52000,8855,4323,4532
44220,68526,16515,32999,13944,52009,8856,4323,4533
44225,68530,16516,33001,13945,52014,8856,4323,4533
44230,68540,16517,33003,13945,52023,8857,4323,4534
44235,68546,16517,33006,13945,52028,8859,4324,4535
44240,68557,16518,33011,13946,52037,8860,4324,4536
44245,68561,16519,33012,13947,52042,8860,4324,4536
44250,68571,16521,33018,13948,52049,8861,4325,4536
44255,68577,16522,33019,13949,52055,8863,4326,4537
44260,68588,16523,33024,13950,52064,8864,4327,4537
44265,68592,16524,33024,13951,52068,8864,4327,4537
44270,68602,16525,33027,13951,52077,8865,4328,4537
44275,68608,16526,33031,13952,52081,8867,4328,4539
44280,68619,16528,33037,13954,52088,8868,4329,4539
44285,68623,16530,33039,13956,52092,8868,4329,4539
44290,68633,16533,33043,13958,52099,8869,4329,4540
44295,68639,16535,33047,13960,52104,8871,4331,4540
44300,68650,16537,33052,13961,52110,8872,4332,4540
44305,68654,16540,33055,13964,52114,8872,4332,4540
44310,68664,16543,33058,13965,52121,8873,4333,4540
44315,68670,16544,33063,13966,52126,8875,4335,4540
44320,68681,16547,33066,13968,52133,8876,4335,4541
44325,68685,16549,33068,13970,52136,8876,4335,4541
44330,68695,16551,33073,13972,52143,8877,4336,4541
44335,68701,16553,33077,13974,52148,8879,4338,4541
44340,68712,16557,33084,13977,52152,8880,4339,4541
44345,68716,16562,33088,13982,52153,8880,4339,4541
44350,68726,16566,33092,13985,52160,8881,4340,4541
44355,68732,16567,33097,13986,52164,8883,4342,4541
44360,68743,16570,33100,13989,52172,8884,4342,4542
44365,68747,16573,33103,13992,52174,8884,4342,4542
44370,68757,16577,33109,13996,52180,8885,4343,4542
44375,68763,16578,33112,13997,52184,8887,4343,4544
44380,68774,16582,33117,14000,52190,8888,4343,4545
44385,68778,16584,33119,14002,52193,8888,4343,4545
44390,68788,16587,33121,14003,52201,8889,4343,4546
44395,68794,16588,33123,14004,52205,8891,4343,4548
44400,68805,16592,33129,14007,52210,8892,4344,4548
44405,68809,16595,33131,14010,52213,8892,4344,4548
44410,68819,16598,33136,14011,52220,8893,4345,4548
44415,68825,16598,33138,14011,52227,8895,4347,4548
44420,68836,16599,33144,14012,52235,8896,4347,4549
44425,68840,16600,33146,14013,52239,8896,4347,4549
44430,68850,16604,33150,14016,52246,8897,4347,4550
44435,68856,16604,33152,14016,52252,8899,4348,4551
44440,68867,16606,33157,14018,52260,8900,4348,4552
44445,68871,16607,33159,14019,52264,8900,4348,4552
44450,68881,16609,33162,14021,52272,8901,4348,4553
44455,68887,16609,33165,14021,52277,8903,4349,4554
44460,68898,16612,33170,14024,52285,8904,4350,4554
44465,68902,16614,33172,14026,52288,8904,4350,4554
44470,68912,16619,33178,14031,52292,8905,4350,4555
44475,68918,16620,33180,14032,52298,8907,4352,4555
44480,68929,16620,33185,14032,52307,8908,4353,4555
44485,68933,16621,33187,14033,52312,8908,4353,4555
44490,68943,16622,33191,14033,52320,8909,4354,4555
44495,68949,16622,33193,14033,52325,8911,4354,4557
44500,68960,16622,33198,14033,52337,8912,4355,4557
44505,68964,16623,33199,14034,52340,8912,4355,4557
44510,68974,16624,33201,14034,52350,8913,4355,4558
44515,68980,16624,33202,14034,52355,8915,4355,4560
44520,68991,16625,33210,14034,52362,8916,4356,4560
44525,68995,16628,33212,14037,52366,8916,4356,4560
44530,69005,16631,33216,14039,52373,8917,4356,4561
44535,69011,16632,33217,14040,52379,8919,4357,4562
44540,69022,16634,33221,14041,52386,8920,4357,4563
44545,69026,16637,33223,14044,52388,8920,4357,4563
44550,69036,16638,33224,14044,52397,8921,4357,4564
44555,69042,16639,33227,14045,52402,8923,4358,4565
44560,69053,16641,33232,14046,52410,8924,4358,4566
44565,69057,16643,33235,14048,52413,8924,4358,4566
44570,69067,16645,33238,14049,52422,8925,4358,4567
44575,69073,16646,33240,14050,52427,8927,4358,4569
44580,69084,16648,33243,14052,52436,8928,4359,4569
44585,69088,16648,33245,14052,52439,8928,4359,4569
44590,69098,16650,33249,14054,52448,8929,4359,4570
44595,69104,16651,33251,14055,52452,8931,4359,4572
44600,69115,16653,33256,14057,52460,8932,4360,4572
44605,69119,16655,33258,14059,52464,8932,4360,4572
44610,69129,16657,33261,14060,52472,8933,4361,4572
44615,69135,16658,33264,14061,52475,8935,4361,4574
44620,69146,16662,33273,14065,52480,8936,4362,4574
44625,69150,16666,33276,14069,52483,8936,4362,4574
44630,69160,16669,33282,14071,52490,8937,4362,4575
44635,69166,16670,33286,14072,52494,8939,4363,4576
44640,69177,16673,33290,14074,52501,8940,4363,4577
44645,69181,16675,33290,14076,52506,8940,4363,4577
44650,69191,16678,33294,14078,52513,8941,4364,4577
44655,69197,16678,33297,14078,52518,8943,4365,4578
44660,69208,16682,33302,14081,52525,8944,4366,4578
44665,69212,16682,33304,14081,52530,8944,4366,4578
44670,69222,16686,33309,14084,52536,8945,4367,4578
44675,69228,16687,33314,14085,52541,8947,4369,4578
44680,69239,16691,33321,14089,52545,8948,4369,4579
44685,69243,16694,33324,14092,52548,8948,4369,4579
44690,69253,16698,33327,14095,52554,8949,4369,4580
44695,69259,16700,33329,14097,52559,8951,4369,4582
44700,69270,16702,33335,14098,52564,8952,4370,4582
44705,69274,16705,33336,14101,52569,8952,4370,4582
44710,69284,16707,33339,14101,52577,8953,4370,4583
44715,69290,16707,33340,14101,52582,8955,4370,4585
44720,69301,16710,33346,14104,52588,8956,4371,4585
44725,69305,16712,33346,14106,52593,8956,4371,4585
44730,69315,16714,33351,14106,52600,8957,4372,4585
44735,69321,16714,33353,14106,52606,8959,4372,4587
44740,69332,16716,33359,14108,52614,8960,4372,4588
44745,69336,16718,33362,14110,52617,8960,4372,4588
44750,69346,16723,33368,14114,52622,8961,4373,4588
44755,69352,16723,33371,14114,52627,8963,4374,4589
44760,69363,16727,33376,14118,52634,8964,4374,4590
44765,69367,16728,33379,14119,52639,8964,4374,4590
44770,69377,16729,33383,14120,52648,8965,4375,4590
44775,69383,16729,33384,14120,52654,8967,4375,4592
44780,69394,16729,33388,14120,52664,8968,4376,4592
44785,69398,16729,33391,14120,52668,8968,4376,4592
44790,69408,16730,33396,14121,52678,8969,4377,4592
44795,69414,16731,33399,14122,52682,8971,4378,4593
44800,69425,16731,33401,14122,52694,8972,4378,4594
44805,69429,16731,33402,14122,52698,8972,4378,4594
44810,69439,16733,33407,14123,52706,8973,4378,4595
44815,69445,16734,33411,14124,52709,8975,4379,4596
44820,69456,16737,33417,14126,52718,8976,4379,4597
44825,69460,16737,33417,14126,52723,8976,4379,4597
44830,69470,16739,33421,14128,52730,8977,4379,4598
44835,69476,16741,33423,14130,52735,8979,4380,4599
44840,69487,16743,33428,14131,52740,8980,4380,4600
44845,69491,16746,33430,14134,52744,8980,4380,4600
44850,69501,16749,33436,14136,52752,8981,4381,4600
44855,69507,16749,33441,14136,52757,8983,4383,4600
44860,69518,16751,33448,14138,52764,8984,4384,4600
44865,69522,16753,33450,14140,52768,8984,4384,4600
44870,69532,16754,33454,14141,52778,8985,4384,4601
44875,69538,16754,33456,14141,52784,8987,4385,4602
44880,69549,16755,33458,14141,52792,8988,4385,4603
44885,69553,16757,33459,14143,52796,8988,4385,4603
44890,69563,16760,33467,14146,52802,8989,4386,4603
44895,69569,16762,33470,14148,52806,8991,4386,4605
44900,69580,16764,33475,14150,52813,8992,4387,4605
44905,69584,16767,33476,14153,52817,8992,4387,4605
44910,69594,16770,33481,14155,52824,8993,4387,4606
44915,69600,16771,33483,14156,52828,8995,4387,4608
44920,69611,16773,33484,14157,52837,8996,4387,4609
44925,69615,16774,33486,14158,52841,8996,4387,4609
44930,69625,16777,33490,14159,52847,8997,4387,4610
44935,69631,16779,33493,14161,52852,8999,4387,4612
44940,69642,16781,33498,14163,52859,9000,4388,4612
44945,69646,16785,33502,14167,52860,9000,4388,4612
44950,69656,16788,33505,14168,52868,9001,4389,4612
44955,69662,16788,33508,14168,52874,9003,4390,4613
44960,69673,16790,33513,14170,52881,9004,4390,4614
44965,69677,16793,33516,14173,52884,9004,4390,4614
44970,69687,16795,33521,14174,52891,9005,4390,4615
44975,69693,16796,33524,14175,52896,9007,4391,4616
44980,69704,16798,33528,14177,52904,9008,4391,4617
44985,69708,16800,33531,14179,52908,9008,4391,4617
44990,69718,16804,33536,14182,52914,9009,4391,4618
44995,69724,16804,33538,14182,52920,9011,4393,4618
45000,69735,16807,33545,14185,52926,9012,4393,4619
45005,69739,16809,33546,14187,52929,9012,4393,4619
45010,69749,16812,33550,14189,52937,9013,4393,4620
45015,69755,16813,33553,14190,52942,9015,4395,4620
45020,69766,16815,33559,14192,52950,9016,4395,4621
45025,69770,16815,33559,14192,52955,9016,4395,4621
45030,69780,16818,33566,14195,52962,9017,4396,4621
45035,69786,16819,33570,14196,52966,9019,4397,4622
45040,69797,16820,33574,14197,52976,9020,4397,4623
45045,69801,16820,33576,14197,52980,9020,4397,4623
45050,69811,16825,33581,14200,52984,9021,4397,4624
45055,69817,16826,33584,14201,52989,9023,4398,4625
45060,69828,16828,33589,14203,52998,9024,4398,4626
45065,69832,16830,33590,14205,53002,9024,4398,4626
45070,69842,16831,33592,14206,53011,9025,4398,4627
45075,69848,16832,33596,14207,53015,9027,4400,4627
45080,69859,16835,33603,14210,53022,9028,4401,4627
45085,69863,16837,33604,14212,53025,9028,4401,4627
45090,69873,16839,33607,14214,53033,9029,4401,4628
45095,69879,16841,33612,14216,53036,9031,4403,4628
45100,69890,16843,33614,14217,53046,9032,4403,4629
45105,69894,16845,33617,14219,53048,9032,4403,4629
45110,69904,16848,33625,14222,53055,9033,4404,4629
45115,69910,16850,33629,14224,53058,9035,4405,4630
45120,69921,16851,33634,14225,53068,9036,4405,4631
45125,69925,16854,33636,14228,53071,9036,4405,4631
45130,69935,16855,33640,14229,53080,9037,4405,4632
45135,69941,16856,33644,14230,53084,9039,4406,4633
45140,69952,16858,33651,14232,53092,9040,4407,4633
45145,69956,16860,33653,14234,53095,9040,4407,4633
45150,69966,16861,33656,14234,53104,9041,4408,4633
45155,69972,16863,33661,14236,53108,9043,4409,4634
45160,69983,16866,33667,14238,53116,9044,4409,4635
45165,69987,16868,33671,14240,53118,9044,4409,4635
45170,69997,16871,33677,14242,53125,9045,4409,4636
45175,70003,16873,33681,14244,53129,9047,4410,4637
45180,70014,16877,33686,14247,53135,9048,4411,4637
45185,70018,16878,33687,14248,53140,9048,4411,4637
45190,70028,16879,33690,14248,53149,9049,4412,4637
45195,70034,16879,33693,14248,53155,9051,4413,4638
45200,70045,16879,33698,14248,53164,9052,4413,4639
45205,70049,16880,33702,14249,53169,9052,4413,4639
45210,70059,16881,33707,14250,53177,9053,4413,4640
45215,70065,16881,33711,14250,53183,9055,4414,4641
45220,70076,16882,33717,14251,53192,9056,4414,4642
45225,70080,16884,33718,14253,53196,9056,4414,4642
45230,70090,16885,33722,14254,53205,9057,4415,4642
45235,70096,16885,33725,14254,53210,9059,4416,4643
45240,70107,16888,33733,14257,53217,9060,4416,4644
45245,70111,16889,33735,14258,53221,9060,4416,4644
45250,70121,16891,33738,14259,53230,9061,4417,4644
45255,70127,16891,33739,14259,53236,9063,4417,4646
45260,70138,16893,33746,14261,53242,9064,4417,4647
45265,70142,16894,33748,14262,53248,9064,4417,4647
45270,70152,16895,33753,14263,53257,9065,4417,4648
45275,70158,16895,33756,14263,53260,9067,4417,4650
45280,70169,16899,33763,14267,53267,9068,4418,4650
45285,70173,16902,33765,14270,53270,9068,4418,4650
45290,70183,16905,33770,14272,53277,9069,4419,4650
45295,70189,16907,33771,14274,53282,9071,4419,4652
45300,70200,16908,33775,14275,53291,9072,4420,4652
45305,70204,16909,33777,14276,53295,9072,4420,4652
45310,70214,16910,33781,14277,53304,9073,4420,4653
45315,70220,16910,33783,14277,53309,9075,4420,4655
45320,70231,16913,33790,14279,53316,9076,4421,4655
45325,70235,16915,33791,14281,53320,9076,4421,4655
45330,70245,16916,33797,14282,53328,9077,4421,4656
45335,70251,16917,33799,14283,53334,9079,4422,4657
45340,70262,16920,33805,14286,53341,9080,4422,4658
45345,70266,16921,33805,14287,53345,9080,4422,4658
45350,70276,16922,33807,14287,53353,9081,4422,4659
45355,70282,16924,33810,14289,53357,9083,4423,4660
45360,70293,16925,33814,14289,53367,9084,4424,4660
45365,70297,16926,33815,14290,53371,9084,4424,4660
45370,70307,16927,33819,14290,53379,9085,4425,4660
45375,70313,16928,33821,14291,53385,9087,4427,4660
45380,70324,16930,33827,14292,53393,9088,4428,4660
45385,70328,16932,33829,14294,53396,9088,4428,4660
45390,70338,16934,33834,14295,53403,9089,4429,4660
45395,70344,16935,33835,14296,53408,9091,4429,4662
45400,70355,16938,33839,14298,53414,9092,4429,4663
45405,70359,16942,33841,14302,53416,9092,4429,4663
45410,70369,16947,33846,14307,53421,9093,4429,4664
45415,70375,16949,33851,14309,53424,9095,4431,4664
45420,70386,16953,33856,14313,53430,9096,4431,4665
45425,70390,16956,33858,14316,53432,9096,4431,4665
45430,70400,16962,33862,14321,53437,9097,4431,4666
45435,70406,16964,33865,14323,53442,9099,4433,4666
45440,70417,16967,33869,14325,53448,9100,4433,4667
45445,70421,16969,33872,14327,53450,9100,4433,4667
45450,70431,16973,33875,14329,53458,9101,4434,4667
45455,70437,16974,33877,14330,53462,9103,4434,4669
45460,70448,16977,33884,14333,53469,9104,4435,4669
45465,70452,16978,33887,14334,53473,9104,4435,4669
45470,70462,16980,33891,14335,53482,9105,4435,4670
45475,70468,16980,33892,14335,53487,9107,4435,4672
45480,70479,16983,33899,14338,53493,9108,4436,4672
45485,70483,16985,33899,14340,53498,9108,4436,4672
45490,70493,16986,33906,14341,53506,9109,4437,4672
45495,70499,16986,33909,14341,53512,9111,4438,4673
45500,70510,16986,33912,14341,53523,9112,4438,4674
45505,70514,16986,33914,14341,53527,9112,4438,4674
45510,70524,16987,33918,14341,53537,9113,4438,4675
45515,70530,16987,33921,14341,53543,9115,4439,4676
45520,70541,16988,33929,14342,53550,9116,4440,4676
45525,70545,16989,33931,14343,53556,9116,4440,4676
45530,70555,16990,33936,14344,53564,9117,4440,4677
45535,70561,16991,33940,14345,53569,9119,4441,4678
45540,70572,16991,33945,14345,53579,9120,4441,4679
45545,70576,16992,33946,14346,53584,9120,4441,4679
45550,70586,16994,33951,14347,53591,9121,4441,4680
45555,70592,16995,33954,14348,53597,9123,4442,4681
45560,70603,16997,33961,14350,53603,9124,4443,4681
45565,70607,16999,33962,14352,53608,9124,4443,4681
45570,70617,17002,33968,14355,53615,9125,4443,4682
45575,70623,17003,33971,14356,53620,9127,4444,4683
45580,70634,17004,33975,14357,53630,9128,4445,4683
45585,70638,17004,33975,14357,53634,9128,4445,4683
45590,70648,17007,33980,14359,53640,9129,4446,4683
45595,70654,17008,33981,14360,53646,9131,4447,4684
45600,70665,17011,33986,14362,53651,9132,4447,4685
45605,70669,17015,33987,14366,53654,9132,4447,4685
45610,70679,17018,33991,14368,53660,9133,4447,4686
45615,70685,17018,33993,14368,53667,9135,4449,4686
45620,70696,17021,33998,14371,53673,9136,4449,4687
45625,70700,17024,34000,14374,53676,9136,4449,4687
45630,70710,17026,34006,14374,53683,9137,4450,4687
45635,70716,17028,34008,14376,53688,9139,4450,4689
45640,70727,17030,34011,14377,53696,9140,4451,4689
45645,70731,17032,34014,14379,53697,9140,4451,4689
45650,70741,17038,34017,14384,53702,9141,4451,4690
45655,70747,17038,34019,14384,53708,9143,4452,4691
45660,70758,17042,34023,14387,53715,9144,4453,4691
45665,70762,17044,34026,14389,53716,9144,4453,4691
45670,70772,17050,34031,14394,53721,9145,4454,4691
45675,70778,17052,34035,14396,53724,9147,4455,4692
45680,70789,17057,34041,14400,53728,9148,4455,4693
45685,70793,17061,34043,14404,53731,9148,4455,4693
45690,70803,17063,34044,14405,53739,9149,4455,4694
45695,70809,17063,34048,14405,53745,9151,4457,4694
45700,70820,17064,34054,14406,53754,9152,4457,4695
45705,70824,17066,34057,14408,53757,9152,4457,4695
45710,70834,17067,34063,14409,53766,9153,4458,4695
45715,70840,17068,34066,14410,53771,9155,4459,4696
45720,70851,17070,34073,14412,53777,9156,4459,4697
45725,70855,17072,34076,14414,53783,9156,4459,4697
45730,70865,17073,34082,14415,53791,9157,4460,4697
45735,70871,17073,34085,14415,53797,9159,4461,4698
45740,70882,17073,34090,14415,53809,9160,4462,4698
45745,70886,17073,34094,14415,53812,9160,4462,4698
45750,70896,17074,34098,14415,53821,9161,4463,4698
45755,70902,17074,34101,14415,53828,9163,4465,4698
45760,70913,17075,34104,14416,53838,9164,4465,4699
45765,70917,17075,34106,14416,53842,9164,4465,4699
45770,70927,17076,34110,14417,53850,9165,4465,4700
45775,70933,17076,34114,14417,53857,9167,4467,4700
45780,70944,17077,34122,14418,53865,9168,4468,4700
45785,70948,17078,34123,14419,53870,9168,4468,4700
45790,70958,17080,34128,14420,53877,9169,4469,4700
45795,70964,17080,34129,14420,53884,9171,4470,4701
45800,70975,17082,34136,14422,53892,9172,4471,4701
45805,70979,17082,34139,14422,53897,9172,4471,4701
45810,70989,17084,34144,14422,53904,9173,4471,4702
45815,70995,17085,34147,14423,53909,9175,4472,4703
45820,71006,17087,34153,14425,53918,9176,4472,4704
45825,71010,17087,34154,14425,53923,9176,4472,4704
45830,71020,17089,34157,14425,53930,9177,4473,4704
45835,71026,17091,34160,14427,53935,9179,4474,4705
45840,71037,17094,34164,14429,53942,9180,4475,4705
45845,71041,17096,34167,14431,53944,9180,4475,4705
45850,71051,17101,34173,14435,53949,9181,4475,4706
45855,71057,17103,34176,14437,53954,9183,4476,4707
45860,71068,17106,34180,14440,53961,9184,4476,4708
45865,71072,17108,34182,14442,53963,9184,4476,4708
45870,71082,17113,34187,14446,53968,9185,4476,4709
45875,71088,17113,34188,14446,53974,9187,4476,4711
45880,71099,17117,34192,14449,53980,9188,4476,4712
45885,71103,17119,34194,14451,53983,9188,4476,4712
45890,71113,17124,34198,14454,53988,9189,4477,4712
45895,71119,17126,34201,14456,53993,9191,4478,4713
45900,71130,17129,34206,14459,54000,9192,4479,4713
45905,71134,17132,34209,14462,54001,9192,4479,4713
45910,71144,17138,34217,14468,54004,9193,4480,4713
45915,71150,17140,34221,14470,54007,9195,4481,4714
45920,71161,17143,34228,14472,54016,9196,4482,4714
45925,71165,17146,34231,14475,54019,9196,4482,4714
45930,71175,17149,34236,14478,54025,9197,4483,4714
45935,71181,17151,34238,14480,54030,9199,4484,4715
45940,71192,17153,34242,14481,54038,9200,4485,4715
45945,71196,17154,34244,14482,54041,9200,4485,4715
45950,71206,17157,34250,14484,54048,9201,4486,4715
45955,71212,17159,34255,14486,54052,9203,4488,4715
45960,71223,17160,34261,14487,54062,9204,4489,4715
45965,71227,17161,34262,14488,54066,9204,4489,4715
45970,71237,17163,34265,14489,54073,9205,4489,4716
45975,71243,17164,34266,14490,54079,9207,4489,4718
45980,71254,17166,34273,14491,54084,9208,4490,4718
45985,71258,17170,34277,14495,54087,9208,4490,4718
45990,71268,17173,34283,14497,54094,9209,4491,4718
45995,71274,17173,34286,14497,54101,9211,4492,4719
46000,71285,17174,34293,14498,54108,9212,4493,4719
46005,71289,17175,34296,14499,54113,9212,4493,4719
46010,71299,17176,34300,14499,54122,9213,4494,4719
46015,71305,17177,34302,14500,54128,9215,4495,4720
46020,71316,17178,34308,14501,54136,9216,4496,4720
46025,71320,17179,34308,14502,54141,9216,4496,4720
46030,71330,17181,34313,14503,54148,9217,4496,4721
46035,71336,17182,34317,14504,54153,9219,4498,4721
46040,71347,17184,34321,14506,54162,9220,4498,4722
46045,71351,17186,34324,14508,54163,9220,4498,4722
46050,71361,17192,34331,14514,54167,9221,4498,4723
46055,71367,17193,34334,14515,54173,9223,4500,4723
46060,71378,17194,34339,14516,54182,9224,4501,4723
46065,71382,17197,34341,14519,54184,9224,4501,4723
46070,71392,17202,34344,14522,54189,9225,4501,4724
46075,71398,17203,34348,14523,54194,9227,4501,4726
46080,71409,17205,34351,14525,54203,9228,4502,4726
46085,71413,17206,34352,14526,54207,9228,4502,4726
46090,71423,17208,34354,14527,54214,9229,4503,4726
46095,71429,17208,34355,14527,54221,9231,4503,4728
46100,71440,17211,34361,14530,54226,9232,4503,4729
46105,71444,17215,34363,14534,54229,9232,4503,4729
46110,71454,17218,34367,14537,54235,9233,4503,4730
46115,71460,17219,34371,14538,54241,9235,4505,4730
46120,71471,17223,34376,14541,54247,9236,4506,4730
46125,71475,17224,34377,14542,54251,9236,4506,4730
46130,71485,17227,34382,14544,54257,9237,4506,4731
46135,71491,17229,34385,14546,54261,9239,4506,4733
46140,71502,17232,34391,14549,54266,9240,4506,4734
46145,71506,17235,34393,14552,54271,9240,4506,4734
46150,71516,17237,34398,14554,54278,9241,4507,4734
46155,71522,17239,34402,14556,54283,9243,4509,4734
46160,71533,17241,34409,14557,54289,9244,4510,4734
46165,71537,17244,34411,14560,54293,9244,4510,4734
46170,71547,17245,34413,14560,54301,9245,4511,4734
46175,71553,17245,34414,14560,54308,9247,4512,4735
46180,71564,17248,34424,14563,54313,9248,4513,4735
46185,71568,17251,34426,14566,54317,9248,4513,4735
46190,71578,17252,34430,14567,54325,9249,4513,4736
46195,71584,17253,34431,14568,54331,9251,4514,4737
46200,71595,17255,34435,14569,54339,9252,4514,4738
46205,71599,17255,34437,14569,54343,9252,4514,4738
46210,71609,17257,34445,14571,54351,9253,4515,4738
46215,71615,17259,34450,14573,54355,9255,4517,4738
46220,71626,17261,34456,14575,54363,9256,4517,4739
46225,71630,17262,34457,14576,54368,9256,4517,4739
46230,71640,17263,34460,14577,54376,9257,4517,4740
46235,71646,17264,34461,14578,54382,9259,4518,4741
46240,71657,17267,34467,14581,54387,9260,4518,4742
46245,71661,17270,34470,14584,54391,9260,4518,4742
46250,71671,17272,34473,14584,54398,9261,4518,4743
46255,71677,17273,34475,14585,54403,9263,4518,4745
46260,71688,17276,34481,14588,54410,9264,4518,4746
46265,71692,17277,34483,14589,54415,9264,4518,4746
46270,71702,17278,34486,14590,54424,9265,4518,4747
46275,71708,17278,34489,14590,54430,9267,4519,4748
46280,71719,17278,34494,14590,54439,9268,4520,4748
46285,71723,17278,34497,14590,54445,9268,4520,4748
46290,71733,17279,34500,14590,54454,9269,4521,4748
46295,71739,17279,34501,14590,54460,9271,4522,4749
46300,71750,17280,34506,14591,54470,9272,4523,4749
46305,71754,17280,34507,14591,54474,9272,4523,4749
46310,71764,17281,34510,14591,54483,9273,4523,4750
46315,71770,17281,34513,14591,54489,9275,4525,4750
46320,71781,17282,34519,14592,54497,9276,4525,4751
46325,71785,17283,34522,14593,54502,9276,4525,4751
46330,71795,17284,34527,14593,54509,9277,4525,4752
46335,71801,17285,34529,14594,54515,9279,4526,4753
46340,71812,17286,34532,14595,54525,9280,4526,4754
46345,71816,17286,34534,14595,54528,9280,4526,4754
46350,71826,17292,34540,14601,54534,9281,4526,4755
46355,71832,17292,34542,14601,54539,9283,4527,4756
46360,71843,17295,34549,14603,54544,9284,4528,4756
46365,71847,17299,34550,14607,54548,9284,4528,4756
46370,71857,17301,34554,14608,54555,9285,4529,4756
46375,71863,17302,34556,14609,54560,9287,4529,4758
46380,71874,17307,34562,14614,54566,9288,4530,4758
46385,71878,17310,34565,14617,54568,9288,4530,4758
46390,71888,17312,34569,14618,54575,9289,4530,4759
46395,71894,17313,34573,14619,54581,9291,4532,4759
46400,71905,17317,34579,14622,54585,9292,4532,4760
46405,71909,17320,34580,14625,54589,9292,4532,4760
46410,71919,17323,34585,14627,54595,9293,4532,4761
46415,71925,17324,34587,14628,54601,9295,4533,4762
46420,71936,17329,34594,14633,54605,9296,4533,4763
46425,71940,17330,34595,14634,54610,9296,4533,4763
46430,71950,17332,34599,14635,54617,9297,4534,4763
46435,71956,17334,34602,14637,54622,9299,4535,4764
46440,71967,17338,34608,14640,54627,9300,4535,4765
46445,71971,17341,34611,14643,54629,9300,4535,4765
46450,71981,17345,34618,14647,54635,9301,4535,4766
46455,71987,17347,34621,14649,54639,9303,4536,4767
46460,71998,17349,34623,14650,54647,9304,4536,4768
46465,72002,17352,34624,14653,54650,9304,4536,4768
46470,72012,17356,34628,14657,54656,9305,4536,4769
46475,72018,17356,34630,14657,54662,9307,4538,4769
46480,72029,17358,34634,14659,54670,9308,4538,4770
46485,72033,17360,34635,14661,54673,9308,4538,4770
46490,72043,17364,34641,14664,54678,9309,4539,4770
46495,72049,17365,34643,14665,54684,9311,4541,4770
46500,72060,17368,34647,14667,54691,9312,4541,4771
46505,72064,17369,34649,14668,54695,9312,4541,4771
46510,72074,17370,34652,14669,54703,9313,4541,4772
46515,72080,17370,34655,14669,54709,9315,4541,4774
46520,72091,17371,34663,14670,54718,9316,4541,4775
46525,72095,17372,34664,14671,54723,9316,4541,4775
46530,72105,17373,34670,14671,54731,9317,4541,4776
46535,72111,17373,34671,14671,54738,9319,4542,4777
46540,72122,17373,34677,14671,54746,9320,4542,4778
46545,72126,17374,34680,14672,54751,9320,4542,4778
46550,72136,17375,34684,14672,54760,9321,4543,4778
46555,72142,17375,34685,14672,54766,9323,4543,4780
46560,72153,17376,34689,14673,54775,9324,4543,4781
46565,72157,17377,34693,14674,54779,9324,4543,4781
46570,72167,17378,34698,14674,54788,9325,4544,4781
46575,72173,17378,34700,14674,54794,9327,4544,4783
46580,72184,17378,34707,14674,54805,9328,4545,4783
46585,72188,17378,34708,14674,54810,9328,4545,4783
46590,72198,17379,34714,14675,54819,9329,4546,4783
46595,72204,17379,34717,14675,54823,9331,4547,4784
46600,72215,17384,34722,14680,54831,9332,4548,4784
46605,72219,17384,34723,14680,54835,9332,4548,4784
46610,72229,17389,34728,14685,54840,9333,4548,4785
46615,72235,17390,34730,14686,54844,9335,4548,4787
46620,72246,17395,34736,14691,54850,9336,4549,4787
46625,72250,17396,34738,14692,54853,9336,4549,4787
46630,72260,17400,34744,14694,54859,9337,4550,4787
46635,72266,17402,34747,14696,54863,9339,4551,4788
46640,72277,17404,34752,14698,54870,9340,4551,4789
46645,72281,17407,34755,14701,54874,9340,4551,4789
46650,72291,17409,34758,14702,54882,9341,4551,4790
46655,72297,17409,34763,14702,54886,9343,4553,4790
46660,72308,17413,34770,14705,54891,9344,4553,4791
46665,72312,17418,34774,14710,54893,9344,4553,4791
46670,72322,17421,34782,14713,54900,9345,4554,4791
46675,72328,17422,34783,14714,54905,9347,4554,4793
46680,72339,17424,34788,14716,54912,9348,4554,4794
46685,72343,17427,34788,14719,54916,9348,4554,4794
46690,72353,17430,34793,14722,54923,9349,4554,4795
46695,72359,17430,34794,14722,54929,9351,4555,4796
46700,72370,17431,34799,14723,54936,9352,4555,4797
46705,72374,17435,34803,14727,54938,9352,4555,4797
46710,72384,17439,34810,14730,54944,9353,4556,4797
46715,72390,17441,34813,14732,54948,9355,4557,4798
46720,72401,17444,34818,14735,54955,9356,4558,4798
46725,72405,17445,34820,14736,54958,9356,4558,4798
46730,72415,17453,34825,14742,54961,9357,4558,4799
46735,72421,17455,34828,14744,54965,9359,4559,4800
46740,72432,17460,34834,14749,54970,9360,4559,4801
46745,72436,17461,34835,14750,54974,9360,4559,4801
46750,72446,17466,34840,14754,54980,9361,4560,4801
46755,72452,17466,34842,14754,54986,9363,4561,4802
46760,72463,17466,34849,14754,54995,9364,4562,4802
46765,72467,17467,34851,14755,55000,9364,4562,4802
46770,72477,17468,34858,14755,55009,9365,4563,4802
46775,72483,17469,34862,14756,55014,9367,4565,4802
46780,72494,17470,34867,14757,55022,9368,4565,4803
46785,72498,17470,34869,14757,55028,9368,4565,4803
46790,72508,17471,34874,14757,55037,9369,4566,4803
46795,72514,17471,34878,14757,55042,9371,4567,4804
46800,72525,17471,34886,14757,55051,9372,4568,4804
46805,72529,17472,34888,14758,55057,9372,4568,4804
46810,72539,17473,34894,14759,55066,9373,4569,4804
46815,72545,17474,34896,14760,55071,9375,4569,4806
46820,72556,17474,34902,14760,55081,9376,4569,4807
46825,72560,17474,34904,14760,55086,9376,4569,4807
46830,72570,17475,34907,14760,55094,9377,4569,4808
46835,72576,17476,34911,14761,55100,9379,4571,4808
46840,72587,17476,34914,14761,55109,9380,4571,4809
46845,72591,17477,34915,14762,55114,9380,4571,4809
46850,72601,17478,34919,14762,55123,9381,4572,4809
46855,72607,17479,34923,14763,55128,9383,4573,4810
46860,72618,17481,34927,14765,55136,9384,4573,4811
46865,72622,17483,34928,14767,55139,9384,4573,4811
46870,72632,17487,34931,14769,55145,9385,4573,4812
46875,72638,17488,34935,14770,55149,9387,4573,4814
46880,72649,17493,34942,14775,55155,9388,4574,4814
46885,72653,17495,34944,14777,55158,9388,4574,4814
46890,72663,17499,34949,14779,55163,9389,4575,4814
46895,72669,17501,34953,14781,55167,9391,4576,4815
46900,72680,17505,34955,14784,55175,9392,4576,4816
46905,72684,17507,34958,14786,55176,9392,4576,4816
46910,72694,17514,34965,14793,55180,9393,4577,4816
46915,72700,17515,34969,14794,55184,9395,4579,4816
46920,72711,17520,34976,14798,55188,9396,4580,4816
46925,72715,17524,34978,14802,55190,9396,4580,4816
46930,72725,17531,34985,14808,55193,9397,4581,4816
46935,72731,17533,34988,14810,55197,9399,4581,4818
46940,72742,17535,34996,14812,55204,9400,4581,4819
46945,72746,17538,34999,14815,55207,9400,4581,4819
46950,72756,17540,35004,14817,55215,9401,4581,4820
46955,72762,17541,35006,14818,55220,9403,4581,4822
46960,72773,17543,35012,14820,55229,9404,4582,4822
46965,72777,17543,35015,14820,55233,9404,4582,4822
46970,72787,17543,35024,14820,55243,9405,4583,4822
46975,72793,17543,35027,14820,55249,9407,4585,4822
46980,72804,17543,35034,14820,55259,9408,4586,4822
46985,72808,17543,35037,14820,55264,9408,4586,4822
46990,72818,17543,35040,14820,55275,9409,4587,4822
46995,72824,17543,35042,14820,55281,9411,4587,4824
47000,72835,17543,35048,14820,55292,9412,4588,4824
47005,72839,17543,35051,14820,55296,9412,4588,4824
47010,72849,17543,35056,14820,55305,9413,4589,4824
47015,72855,17543,35058,14820,55312,9415,4590,4825
47020,72866,17543,35063,14820,55323,9416,4590,4826
47025,72870,17543,35065,14820,55327,9416,4590,4826
47030,72880,17543,35070,14820,55337,9417,4590,4827
47035,72886,17543,35071,14820,55342,9419,4590,4829
47040,72897,17544,35077,14821,55353,9420,4590,4830
47045,72901,17544,35079,14821,55357,9420,4590,4830
47050,72911,17546,35084,14821,55365,9421,4591,4830
47055,72917,17547,35088,14822,55369,9423,4592,4831
47060,72928,17550,35096,14825,55376,9424,4593,4831
47065,72932,17551,35098,14826,55381,9424,4593,4831
47070,72942,17553,35101,14827,55389,9425,4593,4832
47075,72948,17553,35103,14827,55394,9427,4594,4833
47080,72959,17556,35107,14829,55400,9428,4594,4834
47085,72963,17560,35109,14833,55402,9428,4594,4834
47090,72973,17563,35111,14835,55410,9429,4594,4835
47095,72979,17563,35116,14835,55413,9431,4596,4835
47100,72990,17569,35122,14840,55417,9432,4596,4836
47105,72994,17574,35123,14845,55420,9432,4596,4836
47110,73004,17577,35129,14847,55427,9433,4597,4836
47115,73010,17577,35129,14847,55433,9435,4597,4838
47120,73021,17578,35135,14848,55439,9436,4598,4838
47125,73025,17582,35136,14852,55443,9436,4598,4838
47130,73035,17585,35140,14853,55449,9437,4599,4838
47135,73041,17587,35144,14855,55454,9439,4600,4839
47140,73052,17589,35152,14857,55458,9440,4601,4839
47145,73056,17594,35155,14862,55461,9440,4601,4839
47150,73066,17599,35159,14866,55467,9441,4601,4840
47155,73072,17599,35162,14866,55473,9443,4602,4841
47160,73083,17601,35165,14868,55481,9444,4602,4842
47165,73087,17602,35165,14869,55485,9444,4602,4842
47170,73097,17606,35172,14872,55490,9445,4602,4843
47175,73103,17607,35174,14873,55496,9447,4603,4844
47180,73114,17610,35179,14875,55501,9448,4603,4845
47185,73118,17612,35180,14877,55505,9448,4603,4845
47190,73128,17617,35186,14881,55511,9449,4604,4845
47195,73134,17617,35189,14881,55516,9451,4605,4846
47200,73145,17621,35194,14885,55522,9452,4605,4847
47205,73149,17623,35196,14887,55525,9452,4605,4847
47210,73159,17627,35200,14891,55531,9453,4605,4848
47215,73165,17629,35204,14893,55534,9455,4606,4849
47220,73176,17635,35211,14899,55539,9456,4607,4849
47225,73180,17637,35213,14901,55543,9456,4607,4849
47230,73190,17638,35216,14901,55551,9457,4607,4850
47235,73196,17639,35219,14902,55556,9459,4608,4851
47240,73207,17639,35226,14902,55565,9460,4608,4852
47245,73211,17640,35227,14903,55571,9460,4608,4852
47250,73221,17641,35231,14903,55580,9461,4609,4852
47255,73227,17641,35234,14903,55584,9463,4610,4853
47260,73238,17641,35239,14903,55596,9464,4611,4853
47265,73242,17641,35241,14903,55600,9464,4611,4853
47270,73252,17642,35247,14904,55610,9465,4612,4853
47275,73258,17642,35248,14904,55615,9467,4612,4855
47280,73269,17643,35254,14905,55624,9468,4613,4855
47285,73273,17644,35256,14906,55628,9468,4613,4855
47290,73283,17645,35262,14906,55638,9469,4613,4856
47295,73289,17646,35265,14907,55643,9471,4613,4858
47300,73300,17646,35268,14907,55653,9472,4613,4859
47305,73304,17647,35270,14908,55656,9472,4613,4859
47310,73314,17648,35276,14909,55666,9473,4614,4859
47315,73320,17649,35279,14910,55671,9475,4615,4860
47320,73331,17649,35283,14910,55681,9476,4615,4861
47325,73335,17649,35286,14910,55686,9476,4615,4861
47330,73345,17651,35292,14912,55693,9477,4616,4861
47335,73351,17652,35294,14913,55699,9479,4617,4862
47340,73362,17654,35301,14915,55706,9480,4618,4862
47345,73366,17657,35303,14918,55709,9480,4618,4862
47350,73376,17659,35307,14919,55717,9481,4619,4862
47355,73382,17659,35308,14919,55723,9483,4620,4863
47360,73393,17663,35316,14923,55728,9484,4621,4863
47365,73397,17665,35318,14925,55732,9484,4621,4863
47370,73407,17668,35321,14927,55739,9485,4621,4864
47375,73413,17668,35324,14927,55745,9487,4623,4864
47380,73424,17669,35328,14927,55752,9488,4623,4865
47385,73428,17672,35329,14930,55756,9488,4623,4865
47390,73438,17674,35333,14930,55763,9489,4624,4865
47395,73444,17676,35338,14932,55768,9491,4626,4865
47400,73455,17678,35343,14934,55775,9492,4626,4866
47405,73459,17680,35345,14936,55778,9492,4626,4866
47410,73469,17685,35350,14940,55784,9493,4627,4866
47415,73475,17685,35354,14940,55789,9495,4628,4867
47420,73486,17688,35359,14942,55794,9496,4628,4868
47425,73490,17694,35362,14948,55795,9496,4628,4868
47430,73500,17698,35367,14952,55802,9497,4628,4869
47435,73506,17699,35371,14953,55806,9499,4630,4869
47440,73517,17702,35376,14956,55813,9500,4631,4869
47445,73521,17705,35378,14959,55815,9500,4631,4869
47450,73531,17711,35382,14964,55820,9501,4631,4870
47455,73537,17712,35386,14965,55823,9503,4632,4871
47460,73548,17719,35396,14972,55825,9504,4633,4871
47465,73552,17725,35399,14978,55826,9504,4633,4871
47470,73562,17728,35404,14980,55833,9505,4634,4871
47475,73568,17730,35405,14982,55838,9507,4634,4873
47480,73579,17730,35412,14982,55847,9508,4635,4873
47485,73583,17730,35414,14982,55853,9508,4635,4873
47490,73593,17731,35419,14983,55861,9509,4635,4874
47495,73599,17732,35422,14984,55866,9511,4636,4875
47500,73610,17733,35428,14985,55875,9512,4637,4875
47505,73614,17733,35430,14985,55881,9512,4637,4875
47510,73624,17734,35436,14985,55890,9513,4638,4875
47515,73630,17734,35438,14985,55895,9515,4639,4876
47520,73641,17735,35446,14986,55905,9516,4640,4876
47525,73645,17735,35449,14986,55909,9516,4640,4876
47530,73655,17736,35452,14986,55919,9517,4641,4876
47535,73661,17737,35457,14987,55923,9519,4643,4876
47540,73672,17738,35463,14988,55932,9520,4644,4876
47545,73676,17738,35465,14988,55938,9520,4644,4876
47550,73686,17739,35471,14988,55946,9521,4644,4877
47555,73692,17739,35471,14988,55953,9523,4644,4879
47560,73703,17739,35475,14988,55963,9524,4644,4880
47565,73707,17740,35476,14989,55967,9524,4644,4880
47570,73717,17741,35480,14990,55975,9525,4644,4881
47575,73723,17742,35482,14991,55981,9527,4645,4882
47580,73734,17744,35487,14993,55989,9528,4646,4882
47585,73738,17745,35490,14994,55992,9528,4646,4882
47590,73748,17747,35493,14995,56000,9529,4646,4883
47595,73754,17749,35498,14997,56003,9531,4647,4884
47600,73765,17752,35501,14999,56011,9532,4647,4885
47605,73769,17753,35502,15000,56016,9532,4647,4885
47610,73779,17755,35505,15001,56024,9533,4648,4885
47615,73785,17756,35508,15002,56028,9535,4648,4887
47620,73796,17759,35514,15005,56035,9536,4648,4888
47625,73800,17762,35517,15008,56036,9536,4648,4888
47630,73810,17768,35523,15014,56041,9537,4648,4889
47635,73816,17770,35526,15016,56046,9539,4649,4890
47640,73827,17772,35531,15018,56053,9540,4650,4890
47645,73831,17776,35535,15022,56054,9540,4650,4890
47650,73841,17780,35539,15024,56061,9541,4651,4890
47655,73847,17781,35542,15025,56066,9543,4651,4892
47660,73858,17783,35546,15027,56073,9544,4651,4893
47665,73862,17785,35546,15029,56077,9544,4651,4893
47670,73872,17787,35548,15030,56085,9545,4651,4894
47675,73878,17788,35553,15031,56089,9547,4652,4895
47680,73889,17793,35561,15036,56093,9548,4653,4895
47685,73893,17796,35563,15039,56097,9548,4653,4895
47690,73903,17799,35566,15040,56104,9549,4654,4895
47695,73909,17800,35570,15041,56108,9551,4655,4896
47700,73920,17803,35575,15044,56115,9552,4656,4896
47705,73924,17805,35577,15046,56118,9552,4656,4896
47710,73934,17809,35583,15049,56124,9553,4657,4896
47715,73940,17810,35585,15050,56129,9555,4658,4897
47720,73951,17814,35589,15053,56136,9556,4659,4897
47725,73955,17815,35590,15054,56140,9556,4659,4897
47730,73965,17817,35594,15054,56148,9557,4659,4898
47735,73971,17818,35596,15055,56153,9559,4660,4899
47740,73982,17821,35601,15057,56158,9560,4660,4900
47745,73986,17825,35604,15061,56159,9560,4660,4900
47750,73996,17831,35610,15067,56163,9561,4660,4901
47755,74002,17834,35614,15070,56166,9563,4661,4902
47760,74013,17838,35617,15073,56174,9564,4661,4903
47765,74017,17838,35619,15073,56179,9564,4661,4903
47770,74027,17839,35625,15074,56187,9565,4662,4903
47775,74033,17840,35629,15075,56192,9567,4663,4904
47780,74044,17840,35636,15075,56203,9568,4664,4904
47785,74048,17841,35638,15076,56206,9568,4664,4904
47790,74058,17842,35641,15077,56215,9569,4664,4905
47795,74064,17842,35644,15077,56221,9571,4665,4906
47800,74075,17843,35651,15078,56231,9572,4665,4907
47805,74079,17843,35653,15078,56236,9572,4665,4907
47810,74089,17844,35660,15079,56244,9573,4665,4908
47815,74095,17844,35660,15079,56251,9575,4665,4910
47820,74106,17845,35665,15080,56261,9576,4665,4911
47825,74110,17845,35666,15080,56265,9576,4665,4911
47830,74120,17846,35671,15081,56274,9577,4666,4911
47835,74126,17846,35674,15081,56278,9579,4666,4913
47840,74137,17846,35677,15081,56291,9580,4666,4914
47845,74141,17846,35678,15081,56295,9580,4666,4914
47850,74151,17847,35683,15082,56303,9581,4666,4915
47855,74157,17848,35686,15083,56307,9583,4666,4917
47860,74168,17849,35693,15084,56315,9584,4667,4917
47865,74172,17851,35695,15086,56320,9584,4667,4917
47870,74182,17854,35700,15089,56327,9585,4667,4918
47875,74188,17855,35704,15090,56331,9587,4668,4919
47880,74199,17858,35709,15092,56338,9588,4668,4920
47885,74203,17861,35710,15095,56342,9588,4668,4920
47890,74213,17864,35712,15096,56349,9589,4669,4920
47895,74219,17864,35716,15096,56355,9591,4671,4920
47900,74230,17866,35719,15097,56363,9592,4672,4920
47905,74234,17867,35721,15098,56367,9592,4672,4920
47910,74244,17870,35726,15099,56373,9593,4673,4920
47915,74250,17871,35726,15100,56379,9595,4673,4922
47920,74261,17874,35732,15103,56385,9596,4673,4923
47925,74265,17876,35733,15105,56389,9596,4673,4923
47930,74275,17879,35738,15108,56396,9597,4673,4924
47935,74281,17880,35740,15109,56401,9599,4673,4926
47940,74292,17883,35746,15111,56406,9600,4673,4927
47945,74296,17887,35748,15115,56409,9600,4673,4927
47950,74306,17889,35749,15115,56416,9601,4673,4928
47955,74312,17890,35750,15116,56421,9603,4673,4930
47960,74323,17895,35756,15120,56426,9604,4673,4931
47965,74327,17898,35757,15123,56429,9604,4673,4931
47970,74337,17902,35761,15125,56434,9605,4673,4932
47975,74343,17904,35764,15127,56438,9607,4674,4933
47980,74354,17910,35771,15132,56442,9608,4675,4933
47985,74358,17912,35774,15134,56444,9608,4675,4933
47990,74368,17917,35780,15138,56450,9609,4676,4933
47995,74374,17918,35784,15139,56453,9611,4676,4935
48000,74385,17923,35791,15144,56459,9612,4677,4935
48005,74389,17926,35793,15147,56462,9612,4677,4935
48010,74399,17930,35796,15150,56469,9613,4677,4936
48015,74405,17931,35800,15151,56472,9615,4678,4937
48020,74416,17934,35805,15154,56482,9616,4678,4938
48025,74420,17934,35807,15154,56486,9616,4678,4938
48030,74430,17935,35812,15155,56495,9617,4678,4939
48035,74436,17936,35816,15156,56499,9619,4680,4939
48040,74447,17937,35822,15157,56510,9620,4681,4939
48045,74451,17937,35825,15157,56514,9620,4681,4939
48050,74461,17938,35833,15158,56522,9621,4682,4939
48055,74467,17938,35835,15158,56528,9623,4683,4940
48060,74478,17939,35840,15159,56538,9624,4683,4941
48065,74482,17939,35844,15159,56543,9624,4683,4941
48070,74492,17940,35851,15159,56551,9625,4683,4942
48075,74498,17940,35852,15159,56558,9627,4684,4943
48080,74509,17940,35857,15159,56569,9628,4684,4944
48085,74513,17940,35859,15159,56573,9628,4684,4944
48090,74523,17942,35867,15161,56580,9629,4685,4944
48095,74529,17943,35869,15162,56586,9631,4685,4946
48100,74540,17944,35874,15163,56594,9632,4685,4947
48105,74544,17947,35877,15166,56597,9632,4685,4947
48110,74554,17949,35880,15167,56605,9633,4685,4948
48115,74560,17950,35882,15168,56610,9635,4686,4949
48120,74571,17952,35886,15170,56618,9636,4686,4950
48125,74575,17954,35888,15172,56621,9636,4686,4950
48130,74585,17957,35893,15175,56628,9637,4687,4950
48135,74591,17957,35896,15175,56634,9639,4689,4950
48140,74602,17958,35900,15175,56640,9640,4689,4951
48145,74606,17961,35900,15178,56645,9640,4689,4951
48150,74616,17964,35906,15179,56652,9641,4690,4951
48155,74622,17964,35908,15179,56657,9643,4691,4952
48160,74633,17967,35913,15181,56664,9644,4691,4953
48165,74637,17969,35916,15183,56667,9644,4691,4953
48170,74647,17971,35919,15183,56675,9645,4692,4953
48175,74653,17972,35922,15184,56681,9647,4694,4953
48180,74664,17975,35929,15186,56686,9648,4695,4953
48185,74668,17978,35932,15189,56690,9648,4695,4953
48190,74678,17980,35937,15191,56697,9649,4696,4953
48195,74684,17982,35941,15193,56701,9651,4697,4954
48200,74695,17985,35945,15195,56707,9652,4697,4955
48205,74699,17989,35949,15199,56709,9652,4697,4955
48210,74709,17992,35954,15200,56717,9653,4698,4955
48215,74715,17992,35958,15200,56722,9655,4699,4956
48220,74726,17994,35964,15202,56731,9656,4700,4956
48225,74730,17994,35965,15202,56735,9656,4700,4956
48230,74740,17997,35971,15203,56742,9657,4701,4956
48235,74746,17997,35973,15203,56749,9659,4701,4958
48240,74757,17999,35977,15205,56757,9660,4701,4959
48245,74761,18001,35979,15207,56760,9660,4701,4959
48250,74771,18003,35984,15208,56768,9661,4702,4959
48255,74777,18003,35987,15208,56773,9663,4704,4959
48260,74788,18007,35991,15212,56781,9664,4704,4960
48265,74792,18007,35993,15212,56784,9664,4704,4960
48270,74802,18010,35999,15215,56791,9665,4705,4960
48275,74808,18010,36002,15215,56797,9667,4706,4961
48280,74819,18013,36008,15218,56804,9668,4706,4962
48285,74823,18015,36010,15220,56807,9668,4706,4962
48290,74833,18020,36015,15224,56812,9669,4706,4963
48295,74839,18021,36018,15225,56817,9671,4707,4964
48300,74850,18023,36021,15227,56827,9672,4707,4965
48305,74854,18024,36022,15228,56830,9672,4707,4965
48310,74864,18028,36028,15231,56834,9673,4707,4966
48315,74870,18030,36031,15233,56840,9675,4709,4966
48320,74881,18032,36037,15235,56846,9676,4709,4967
48325,74885,18034,36040,15237,56850,9676,4709,4967
48330,74895,18035,36042,15238,56860,9677,4709,4968
48335,74901,18036,36043,15239,56865,9679,4709,4970
48340,74912,18038,36047,15240,56873,9680,4710,4970
48345,74916,18039,36050,15241,56876,9680,4710,4970
48350,74926,18041,36057,15242,56884,9681,4710,4971
48355,74932,18043,36061,15244,56889,9683,4712,4971
48360,74943,18046,36065,15246,56896,9684,4713,4971
48365,74947,18048,36068,15248,56898,9684,4713,4971
48370,74957,18051,36074,15250,56905,9685,4713,4972
48375,74963,18053,36077,15252,56909,9687,4713,4974
48380,74974,18055,36083,15253,56916,9688,4714,4974
48385,74978,18057,36085,15255,56920,9688,4714,4974
48390,74988,18059,36090,15256,56928,9689,4714,4975
48395,74994,18060,36091,15257,56933,9691,4714,4977
48400,75005,18061,36096,15257,56941,9692,4715,4977
48405,75009,18065,36098,15261,56944,9692,4715,4977
48410,75019,18067,36104,15263,56951,9693,4715,4978
48415,75025,18069,36107,15265,56956,9695,4717,4978
48420,75036,18072,36112,15267,56962,9696,4717,4979
48425,75040,18074,36114,15269,56966,9696,4717,4979
48430,75050,18076,36119,15270,56973,9697,4718,4979
48435,75056,18076,36123,15270,56979,9699,4719,4980
48440,75067,18079,36130,15273,56987,9700,4719,4981
48445,75071,18079,36130,15273,56992,9700,4719,4981
48450,75081,18081,36134,15273,57000,9701,4720,4981
48455,75087,18081,36137,15273,57006,9703,4721,4982
48460,75098,18082,36144,15274,57013,9704,4722,4982
48465,75102,18084,36146,15276,57018,9704,4722,4982
48470,75112,18086,36151,15277,57026,9705,4722,4983
48475,75118,18086,36153,15277,57031,9707,4722,4985
48480,75129,18088,36157,15279,57039,9708,4723,4985
48485,75133,18090,36158,15281,57043,9708,4723,4985
48490,75143,18092,36163,15281,57050,9709,4723,4986
48495,75149,18093,36167,15282,57056,9711,4725,4986
48500,75160,18094,36173,15283,57063,9712,4726,4986
48505,75164,18097,36175,15286,57067,9712,4726,4986
48510,75174,18099,36177,15287,57075,9713,4726,4987
48515,75180,18100,36180,15288,57079,9715,4727,4988
48520,75191,18104,36187,15292,57086,9716,4728,4988
48525,75195,18106,36189,15294,57089,9716,4728,4988
48530,75205,18111,36194,15298,57094,9717,4728,4989
48535,75211,18112,36197,15299,57098,9719,4729,4990
48540,75222,18117,36203,15304,57104,9720,4730,4990
48545,75226,18119,36205,15306,57106,9720,4730,4990
48550,75236,18122,36208,15307,57113,9721,4730,4991
48555,75242,18124,36212,15309,57116,9723,4731,4992
48560,75253,18125,36217,15310,57126,9724,4732,4992
48565,75257,18126,36218,15311,57131,9724,4732,4992
48570,75267,18128,36222,15313,57139,9725,4732,4993
48575,75273,18129,36227,15314,57142,9727,4734,4993
48580,75284,18132,36236,15316,57148,9728,4735,4993
48585,75288,18136,36240,15320,57151,9728,4735,4993
48590,75298,18137,36246,15321,57160,9729,4735,4994
48595,75304,18137,36249,15321,57167,9731,4736,4995
48600,75315,18139,36252,15322,57175,9732,4736,4996
48605,75319,18141,36255,15324,57178,9732,4736,4996
48610,75329,18143,36261,15326,57185,9733,4737,4996
48615,75335,18143,36266,15326,57191,9735,4739,4996
48620,75346,18144,36271,15327,57199,9736,4739,4997
48625,75350,18147,36274,15330,57203,9736,4739,4997
48630,75360,18148,36279,15331,57211,9737,4739,4998
48635,75366,18148,36283,15331,57218,9739,4740,4999
48640,75377,18149,36290,15331,57225,9740,4740,5000
48645,75381,18151,36291,15333,57230,9740,4740,5000
48650,75391,18152,36297,15334,57238,9741,4741,5000
48655,75397,18152,36299,15334,57245,9743,4742,5001
48660,75408,18154,36304,15335,57254,9744,4743,5001
48665,75412,18154,36306,15335,57258,9744,4743,5001
48670,75422,18156,36310,15337,57265,9745,4744,5001
48675,75428,18156,36312,15337,57271,9747,4745,5002
48680,75439,18160,36318,15340,57277,9748,4745,5003
48685,75443,18161,36321,15341,57282,9748,4745,5003
48690,75453,18163,36325,15341,57289,9749,4746,5003
48695,75459,18164,36327,15342,57295,9751,4747,5004
48700,75470,18165,36332,15343,57303,9752,4748,5004
48705,75474,18166,36334,15344,57308,9752,4748,5004
48710,75484,18168,36337,15345,57315,9753,4748,5005
48715,75490,18169,36338,15346,57321,9755,4748,5007
48720,75501,18171,36347,15348,57326,9756,4749,5007
48725,75505,18173,36347,15350,57332,9756,4749,5007
48730,75515,18175,36351,15350,57339,9757,4749,5008
48735,75521,18175,36353,15350,57344,9759,4749,5010
48740,75532,18178,36357,15353,57352,9760,4749,5011
48745,75536,18180,36358,15355,57356,9760,4749,5011
48750,75546,18184,36365,15359,57361,9761,4749,5012
48755,75552,18185,36368,15360,57366,9763,4750,5013
48760,75563,18189,36373,15364,57373,9764,4750,5014
48765,75567,18191,36377,15366,57374,9764,4750,5014
48770,75577,18197,36383,15371,57379,9765,4751,5014
48775,75583,18197,36386,15371,57383,9767,4751,5016
48780,75594,18200,36390,15374,57393,9768,4751,5017
48785,75598,18200,36393,15374,57398,9768,4751,5017
48790,75608,18203,36398,15376,57404,9769,4752,5017
48795,75614,18203,36399,15376,57410,9771,4752,5019
48800,75625,18205,36406,15377,57417,9772,4753,5019
48805,75629,18209,36407,15381,57420,9772,4753,5019
48810,75639,18211,36412,15382,57427,9773,4754,5019
48815,75645,18213,36415,15384,57431,9775,4755,5020
48820,75656,18214,36420,15385,57440,9776,4755,5021
48825,75660,18216,36421,15387,57444,9776,4755,5021
48830,75670,18217,36424,15388,57452,9777,4756,5021
48835,75676,18218,36428,15389,57458,9779,4757,5022
48840,75687,18220,36434,15390,57465,9780,4757,5023
48845,75691,18223,36436,15393,57468,9780,4757,5023
48850,75701,18225,36440,15394,57475,9781,4757,5024
48855,75707,18225,36440,15394,57482,9783,4757,5026
48860,75718,18228,36443,15396,57490,9784,4757,5027
48865,75722,18229,36447,15397,57493,9784,4757,5027
48870,75732,18231,36452,15398,57500,9785,4758,5027
48875,75738,18233,36456,15400,57505,9787,4759,5028
48880,75749,18235,36461,15402,57513,9788,4760,5028
48885,75753,18238,36464,15405,57514,9788,4760,5028
48890,75763,18244,36468,15409,57518,9789,4760,5029
48895,75769,18246,36470,15411,57522,9791,4760,5031
48900,75780,18250,36477,15415,57527,9792,4761,5031
48905,75784,18253,36480,15418,57530,9792,4761,5031
48910,75794,18257,36486,15420,57536,9793,4762,5031
48915,75800,18257,36489,15420,57542,9795,4764,5031
48920,75811,18262,36496,15424,57546,9796,4765,5031
48925,75815,18264,36498,15426,57550,9796,4765,5031
48930,75825,18266,36503,15426,57558,9797,4766,5031
48935,75831,18266,36506,15426,57564,9799,4768,5031
48940,75842,18267,36508,15427,57574,9800,4768,5032
48945,75846,18268,36509,15428,57578,9800,4768,5032
48950,75856,18270,36514,15429,57585,9801,4768,5033
48955,75862,18270,36516,15429,57591,9803,4769,5034
48960,75873,18272,36523,15431,57599,9804,4770,5034
48965,75877,18272,36524,15431,57605,9804,4770,5034
48970,75887,18274,36527,15431,57612,9805,4771,5034
48975,75893,18274,36529,15431,57618,9807,4772,5035
48980,75904,18275,36533,15432,57628,9808,4772,5036
48985,75908,18275,36535,15432,57632,9808,4772,5036
48990,75918,18277,36539,15433,57640,9809,4772,5037
48995,75924,18277,36541,15433,57646,9811,4773,5038
49000,75935,18280,36544,15436,57655,9812,4773,5039
49005,75939,18280,36547,15436,57658,9812,4773,5039
49010,75949,18283,36552,15438,57664,9813,4773,5040
49015,75955,18284,36555,15439,57669,9815,4774,5041
49020,75966,18287,36558,15442,57678,9816,4774,5042
49025,75970,18288,36560,15443,57680,9816,4774,5042
49030,75980,18294,36565,15448,57684,9817,4775,5042
49035,75986,18295,36568,15449,57691,9819,4776,5043
49040,75997,18299,36575,15453,57697,9820,4777,5043
49045,76001,18301,36578,15455,57700,9820,4777,5043
49050,76011,18304,36583,15457,57706,9821,4778,5043
49055,76017,18305,36584,15458,57712,9823,4778,5045
49060,76028,18307,36588,15459,57720,9824,4779,5045
49065,76032,18308,36589,15460,57724,9824,4779,5045
49070,76042,18309,36591,15460,57732,9825,4779,5046
49075,76048,18311,36592,15462,57737,9827,4779,5048
49080,76059,18313,36596,15463,57744,9828,4780,5048
49085,76063,18314,36597,15464,57749,9828,4780,5048
49090,76073,18316,36601,15465,57756,9829,4781,5048
49095,76079,18316,36604,15465,57763,9831,4781,5050
49100,76090,18317,36608,15466,57771,9832,4781,5051
49105,76094,18319,36610,15468,57775,9832,4781,5051
49110,76104,18320,36615,15469,57783,9833,4781,5052
49115,76110,18322,36619,15471,57788,9835,4782,5053
49120,76121,18324,36625,15472,57794,9836,4783,5053
49125,76125,18328,36628,15476,57797,9836,4783,5053
49130,76135,18329,36630,15476,57805,9837,4783,5054
49135,76141,18329,36633,15476,57812,9839,4784,5055
49140,76152,18332,36640,15479,57817,9840,4785,5055
49145,76156,18336,36642,15483,57819,9840,4785,5055
49150,76166,18340,36647,15487,57824,9841,4785,5056
49155,76172,18342,36649,15489,57828,9843,4785,5058
49160,76183,18347,36656,15494,57833,9844,4786,5058
49165,76187,18351,36658,15498,57835,9844,4786,5058
49170,76197,18355,36663,15502,57840,9845,4786,5059
49175,76203,18358,36665,15505,57845,9847,4786,5061
49180,76214,18361,36670,15508,57851,9848,4786,5062
49185,76218,18363,36670,15510,57855,9848,4786,5062
49190,76228,18366,36675,15513,57861,9849,4787,5062
49195,76234,18368,36680,15515,57864,9851,4788,5063
49200,76245,18371,36687,15517,57871,9852,4789,5063
49205,76249,18374,36689,15520,57875,9852,4789,5063
49210,76259,18376,36694,15522,57882,9853,4790,5063
49215,76265,18378,36698,15524,57886,9855,4791,5064
49220,76276,18378,36703,15524,57896,9856,4792,5064
49225,76280,18379,36705,15525,57901,9856,4792,5064
49230,76290,18380,36709,15526,57909,9857,4793,5064
49235,76296,18380,36710,15526,57915,9859,4793,5066
49240,76307,18380,36714,15526,57927,9860,4793,5067
49245,76311,18380,36715,15526,57931,9860,4793,5067
49250,76321,18381,36717,15526,57939,9861,4793,5068
49255,76327,18381,36721,15526,57946,9863,4795,5068
49260,76338,18382,36726,15527,57955,9864,4795,5069
49265,76342,18382,36728,15527,57960,9864,4795,5069
49270,76352,18383,36735,15527,57968,9865,4796,5069
49275,76358,18383,36737,15527,57975,9867,4797,5070
49280,76369,18384,36744,15528,57983,9868,4798,5070
49285,76373,18385,36747,15529,57988,9868,4798,5070
49290,76383,18386,36752,15530,57996,9869,4799,5070
49295,76389,18386,36755,15530,58002,9871,4799,5072
49300,76400,18386,36759,15530,58013,9872,4799,5073
49305,76404,18386,36761,15530,58017,9872,4799,5073
49310,76414,18388,36764,15532,58025,9873,4799,5074
49315,76420,18388,36764,15532,58032,9875,4799,5076
49320,76431,18390,36768,15533,58040,9876,4800,5076
49325,76435,18391,36769,15534,58043,9876,4800,5076
49330,76445,18395,36776,15537,58049,9877,4800,5077
49335,76451,18397,36778,15539,58054,9879,4800,5079
49340,76462,18399,36781,15540,58062,9880,4801,5079
49345,76466,18400,36783,15541,58065,9880,4801,5079
49350,76476,18403,36788,15542,58073,9881,4802,5079
49355,76482,18404,36792,15543,58076,9883,4803,5080
49360,76493,18408,36799,15546,58082,9884,4804,5080
49365,76497,18410,36800,15548,58087,9884,4804,5080
49370,76507,18414,36806,15550,58092,9885,4805,5080
49375,76513,18415,36809,15551,58096,9887,4806,5081
49380,76524,18421,36816,15557,58101,9888,4807,5081
49385,76528,18424,36819,15560,58103,9888,4807,5081
49390,76538,18428,36824,15563,58109,9889,4807,5082
49395,76544,18430,36827,15565,58114,9891,4807,5084
49400,76555,18433,36833,15567,58119,9892,4808,5084
49405,76559,18436,36834,15570,58123,9892,4808,5084
49410,76569,18439,36838,15572,58129,9893,4809,5084
49415,76575,18441,36842,15574,58133,9895,4809,5086
49420,76586,18445,36848,15577,58137,9896,4809,5087
49425,76590,18449,36851,15581,58140,9896,4809,5087
49430,76600,18454,36854,15584,58145,9897,4809,5088
49435,76606,18455,36856,15585,58150,9899,4810,5089
49440,76617,18456,36857,15586,58160,9900,4810,5090
49445,76621,18457,36859,15587,58163,9900,4810,5090
49450,76631,18460,36861,15589,58170,9901,4810,5091
49455,76637,18460,36863,15589,58177,9903,4811,5092
49460,76648,18461,36870,15590,58184,9904,4812,5092
49465,76652,18462,36871,15591,58190,9904,4812,5092
49470,76662,18464,36878,15593,58197,9905,4812,5093
49475,76668,18465,36881,15594,58202,9907,4813,5094
49480,76679,18467,36884,15596,58212,9908,4813,5095
49485,76683,18468,36888,15597,58213,9908,4813,5095
49490,76693,18474,36894,15601,58218,9909,4814,5095
49495,76699,18475,36896,15602,58222,9911,4814,5097
49500,76710,18478,36900,15605,58230,9912,4814,5098
49505,76714,18479,36902,15606,58235,9912,4814,5098
49510,76724,18479,36906,15606,58244,9913,4814,5099
49515,76730,18479,36910,15606,58249,9915,4815,5100
49520,76741,18479,36916,15606,58260,9916,4815,5101
49525,76745,18479,36919,15606,58265,9916,4815,5101
49530,76755,18479,36924,15606,58275,9917,4816,5101
49535,76761,18479,36927,15606,58281,9919,4817,5102
49540,76772,18479,36931,15606,58292,9920,4817,5103
49545,76776,18480,36934,15607,58295,9920,4817,5103
49550,76786,18482,36938,15609,58304,9921,4818,5103
49555,76792,18482,36943,15609,58309,9923,4820,5103
49560,76803,18484,36951,15611,58319,9924,4821,5103
49565,76807,18485,36953,15612,58322,9924,4821,5103
49570,76817,18487,36959,15614,58329,9925,4821,5104
49575,76823,18488,36963,15615,58334,9927,4822,5105
49580,76834,18490,36967,15616,58342,9928,4823,5105
49585,76838,18492,36970,15618,58345,9928,4823,5105
49590,76848,18493,36975,15619,58354,9929,4824,5105
49595,76854,18494,36980,15620,58359,9931,4825,5106
49600,76865,18495,36986,15620,58367,9932,4825,5107
49605,76869,18497,36986,15622,58372,9932,4825,5107
49610,76879,18500,36993,15625,58379,9933,4825,5108
49615,76885,18501,36996,15626,58383,9935,4826,5109
49620,76896,18502,37001,15627,58391,9936,4826,5110
49625,76900,18505,37003,15630,58395,9936,4826,5110
49630,76910,18507,37009,15631,58403,9937,4827,5110
49635,76916,18508,37011,15632,58408,9939,4828,5111
49640,76927,18509,37012,15632,58417,9940,4828,5112
49645,76931,18510,37015,15633,58421,9940,4828,5112
49650,76941,18514,37020,15635,58427,9941,4828,5113
49655,76947,18515,37024,15636,58431,9943,4830,5113
49660,76958,18518,37029,15639,58438,9944,4830,5114
49665,76962,18519,37031,15640,58442,9944,4830,5114
49670,76972,18523,37035,15643,58448,9945,4830,5115
49675,76978,18524,37037,15644,58454,9947,4831,5116
49680,76989,18527,37043,15646,58459,9948,4832,5116
49685,76993,18531,37047,15650,58461,9948,4832,5116
49690,77003,18534,37050,15652,58469,9949,4832,5117
49695,77009,18534,37052,15652,58475,9951,4834,5117
49700,77020,18535,37058,15653,58483,9952,4834,5118
49705,77024,18536,37060,15654,58487,9952,4834,5118
49710,77034,18539,37066,15656,58494,9953,4834,5119
49715,77040,18539,37068,15656,58501,9955,4835,5120
49720,77051,18541,37073,15658,58509,9956,4835,5121
49725,77055,18542,37073,15659,58513,9956,4835,5121
49730,77065,18545,37076,15661,58520,9957,4835,5122
49735,77071,18546,37077,15662,58525,9959,4835,5124
49740,77082,18547,37083,15663,58533,9960,4836,5124
49745,77086,18548,37084,15664,58538,9960,4836,5124
49750,77096,18551,37090,15667,58544,9961,4837,5124
49755,77102,18551,37094,15667,58549,9963,4838,5125
49760,77113,18554,37099,15670,58557,9964,4839,5125
49765,77117,18555,37101,15671,58561,9964,4839,5125
49770,77127,18560,37106,15674,58566,9965,4840,5125
49775,77133,18560,37108,15674,58572,9967,4841,5126
49780,77144,18564,37113,15678,58579,9968,4842,5126
49785,77148,18564,37115,15678,58582,9968,4842,5126
49790,77158,18569,37120,15681,58589,9969,4843,5126
49795,77164,18569,37122,15681,58594,9971,4844,5127
49800,77175,18571,37128,15683,58602,9972,4844,5128
49805,77179,18574,37132,15686,58604,9972,4844,5128
49810,77189,18575,37135,15686,58613,9973,4845,5128
49815,77195,18576,37137,15687,58619,9975,4846,5129
49820,77206,18577,37141,15688,58627,9976,4846,5130
49825,77210,18578,37143,15689,58631,9976,4846,5130
49830,77220,18580,37145,15690,58639,9977,4846,5131
49835,77226,18581,37146,15691,58645,9979,4847,5132
49840,77237,18582,37151,15692,58653,9980,4848,5132
49845,77241,18583,37152,15693,58658,9980,4848,5132
49850,77251,18585,37157,15695,58666,9981,4848,5133
49855,77257,18585,37158,15695,58672,9983,4849,5134
49860,77268,18587,37161,15697,58680,9984,4849,5135
49865,77272,18588,37162,15698,58684,9984,4849,5135
49870,77282,18589,37166,15698,58692,9985,4849,5136
49875,77288,18591,37169,15700,58696,9987,4850,5137
49880,77299,18593,37173,15702,58705,9988,4850,5138
49885,77303,18593,37173,15702,58710,9988,4850,5138
49890,77313,18596,37179,15704,58716,9989,4850,5139
49895,77319,18598,37182,15706,58720,9991,4850,5141
49900,77330,18602,37190,15710,58725,9992,4850,5142
49905,77334,18605,37191,15713,58729,9992,4850,5142
49910,77344,18609,37196,15716,58735,9993,4851,5142
49915,77350,18609,37198,15716,58740,9995,4852,5143
49920,77361,18611,37203,15717,58748,9996,4853,5143
49925,77365,18612,37206,15718,58752,9996,4853,5143
49930,77375,18614,37209,15719,58760,9997,4853,5144
49935,77381,18615,37213,15720,58765,9999,4855,5144
49940,77392,18616,37215,15721,58775,10000,4855,5145
49945,77396,18617,37218,15722,58778,10000,4855,5145
49950,77406,18620,37223,15723,58784,10001,4855,5146
49955,77412,18621,37228,15724,58788,10003,4857,5146
49960,77423,18626,37234,15729,58795,10004,4857,5147
49965,77427,18627,37236,15730,58800,10004,4857,5147
49970,77437,18629,37241,15731,58807,10005,4857,5148
49975,77443,18630,37243,15732,58813,10007,4858,5149
49980,77454,18632,37248,15734,58820,10008,4858,5150
49985,77458,18633,37250,15735,58825,10008,4858,5150
49990,77468,18635,37257,15736,58833,10009,4859,5150
49995,77474,18635,37258,15736,58839,10011,4860,5151
50000,77485,18635,37263,15736,58847,10012,4861,5151
50005,77489,18636,37264,15737,58853,10012,4861,5151
50010,77499,18638,37265,15738,58861,10013,4861,5152
50015,77505,18639,37269,15739,58865,10015,4863,5152
50020,77516,18641,37271,15741,58875,10016,4863,5153
50025,77520,18641,37273,15741,58878,10016,4863,5153
50030,77530,18645,37279,15745,58884,10017,4863,5154
50035,77536,18647,37285,15747,58888,10019,4865,5154
50040,77547,18652,37294,15752,58890,10020,4865,5155
50045,77551,18658,37296,15758,58893,10020,4865,5155
50050,77561,18661,37300,15760,58899,10021,4865,5156
50055,77567,18663,37303,15762,58904,10023,4866,5157
50060,77578,18667,37309,15765,58908,10024,4866,5158
50065,77582,18671,37311,15769,58910,10024,4866,5158
50070,77592,18677,37316,15774,58914,10025,4866,5159
50075,77598,18678,37318,15775,58919,10027,4867,5160
50080,77609,18682,37327,15779,58922,10028,4868,5160
50085,77613,18688,37331,15785,58924,10028,4868,5160
50090,77623,18690,37339,15787,58932,10029,4869,5160
50095,77629,18691,37341,15788,58937,10031,4869,5162
50100,77640,18694,37350,15791,58944,10032,4870,5162
50105,77644,18695,37354,15792,58948,10032,4870,5162
50110,77654,18696,37359,15793,58958,10033,4871,5162
50115,77660,18696,37362,15793,58963,10035,4873,5162
50120,77671,18696,37367,15793,58974,10036,4874,5162
50125,77675,18697,37367,15794,58978,10036,4874,5162
50130,77685,18698,37371,15794,58987,10037,4875,5162
50135,77691,18699,37375,15795,58992,10039,4876,5163
50140,77702,18699,37381,15795,59001,10040,4876,5164
50145,77706,18700,37382,15796,59006,10040,4876,5164
50150,77716,18701,37388,15796,59014,10041,4877,5164
50155,77722,18701,37392,15796,59021,10043,4879,5164
50160,77733,18701,37395,15796,59032,10044,4880,5164
50165,77737,18701,37399,15796,59036,10044,4880,5164
50170,77747,18702,37404,15797,59045,10045,4881,5164
50175,77753,18703,37410,15798,59050,10047,4883,5164
50180,77764,18703,37414,15798,59061,10048,4883,5165
50185,77768,18703,37417,15798,59065,10048,4883,5165
50190,77778,18704,37423,15798,59073,10049,4883,5166
50195,77784,18704,37427,15798,59080,10051,4885,5166
50200,77795,18706,37436,15800,59086,10052,4886,5166
50205,77799,18708,37439,15802,59091,10052,4886,5166
50210,77809,18711,37443,15803,59097,10053,4887,5166
50215,77815,18712,37445,15804,59102,10055,4888,5167
50220,77826,18716,37449,15807,59109,10056,4889,5167
50225,77830,18717,37450,15808,59112,10056,4889,5167
50230,77840,18724,37457,15814,59114,10057,4889,5168
50235,77846,18726,37461,15816,59118,10059,4891,5168
50240,77857,18731,37463,15820,59126,10060,4891,5169
50245,77861,18731,37463,15820,59130,10060,4891,5169
50250,77871,18736,37468,15824,59134,10061,4891,5170
50255,77877,18738,37471,15826,59138,10063,4892,5171
50260,77888,18741,37475,15828,59144,10064,4892,5172
50265,77892,18744,37476,15831,59147,10064,4892,5172
50270,77902,18748,37477,15833,59154,10065,4892,5173
50275,77908,18748,37480,15833,59158,10067,4893,5174
50280,77919,18752,37485,15836,59163,10068,4893,5175
50285,77923,18756,37487,15840,59167,10068,4893,5175
50290,77933,18757,37488,15841,59176,10069,4893,5176
50295,77939,18757,37489,15841,59182,10071,4894,5177
50300,77950,18758,37492,15842,59192,10072,4894,5178
50305,77954,18759,37493,15843,59195,10072,4894,5178
50310,77964,18762,37500,15846,59201,10073,4894,5179
50315,77970,18764,37502,15848,59206,10075,4894,5181
50320,77981,18767,37506,15851,59213,10076,4894,5182
50325,77985,18768,37506,15852,59217,10076,4894,5182
50330,77995,18770,37511,15853,59224,10077,4894,5183
50335,78001,18772,37514,15855,59229,10079,4894,5185
50340,78012,18775,37519,15858,59236,10080,4894,5186
50345,78016,18776,37521,15859,59240,10080,4894,5186
50350,78026,18778,37526,15861,59247,10081,4894,5187
50355,78032,18780,37528,15863,59252,10083,4894,5189
50360,78043,18781,37533,15864,59261,10084,4895,5189
50365,78047,18782,37535,15865,59265,10084,4895,5189
50370,78057,18783,37539,15866,59273,10085,4895,5190
50375,78063,18783,37541,15866,59280,10087,4896,5191
50380,78074,18783,37546,15866,59290,10088,4897,5191
50385,78078,18783,37547,15866,59294,10088,4897,5191
50390,78088,18786,37549,15868,59302,10089,4897,5192
50395,78094,18787,37554,15869,59304,10091,4898,5193
50400,78105,18791,37559,15873,59313,10092,4899,5193
50405,78109,18792,37560,15874,59316,10092,4899,5193
50410,78119,18797,37567,15879,59321,10093,4900,5193
50415,78125,18797,37568,15879,59328,10095,4901,5194
50420,78136,18797,37571,15879,59337,10096,4901,5195
50425,78140,18799,37575,15881,59340,10096,4901,5195
50430,78150,18801,37579,15881,59348,10097,4902,5195
50435,78156,18802,37583,15882,59352,10099,4903,5196
50440,78167,18803,37587,15883,59362,10100,4903,5197
50445,78171,18803,37589,15883,59367,10100,4903,5197
50450,78181,18805,37596,15885,59376,10101,4904,5197
50455,78187,18806,37601,15886,59379,10103,4906,5197
50460,78198,18809,37606,15889,59387,10104,4906,5198
50465,78202,18810,37608,15890,59391,10104,4906,5198
50470,78212,18813,37611,15892,59399,10105,4906,5199
50475,78218,18814,37614,15893,59403,10107,4907,5200
50480,78229,18816,37620,15894,59410,10108,4908,5200
50485,78233,18820,37623,15898,59413,10108,4908,5200
50490,78243,18823,37629,15901,59420,10109,4909,5200
50495,78249,18824,37634,15902,59424,10111,4911,5200
50500,78260,18827,37640,15904,59430,10112,4912,5200
50505,78264,18829,37642,15906,59434,10112,4912,5200
50510,78274,18832,37646,15908,59441,10113,4912,5201
50515,78280,18833,37647,15909,59447,10115,4912,5203
50520,78291,18834,37649,15909,59455,10116,4912,5204
50525,78295,18836,37651,15911,59458,10116,4912,5204
50530,78305,18840,37656,15914,59465,10117,4913,5204
50535,78311,18840,37659,15914,59470,10119,4914,5205
50540,78322,18845,37668,15919,59473,10120,4915,5205
50545,78326,18850,37672,15924,59475,10120,4915,5205
50550,78336,18855,37679,15928,59480,10121,4916,5205
50555,78342,18856,37682,15929,59485,10123,4917,5206
50560,78353,18860,37689,15932,59489,10124,4918,5206
50565,78357,18865,37692,15937,59492,10124,4918,5206
50570,78367,18867,37698,15939,59500,10125,4919,5206
50575,78373,18867,37702,15939,59506,10127,4921,5206
50580,78384,18869,37707,15940,59513,10128,4921,5207
50585,78388,18871,37709,15942,59517,10128,4921,5207
50590,78398,18872,37715,15943,59525,10129,4922,5207
50595,78404,18873,37716,15944,59531,10131,4922,5209
50600,78415,18873,37719,15944,59541,10132,4922,5210
50605,78419,18873,37719,15944,59546,10132,4922,5210
50610,78429,18874,37724,15944,59555,10133,4923,5210
50615,78435,18874,37727,15944,59561,10135,4924,5211
50620,78446,18874,37731,15944,59571,10136,4924,5212
50625,78450,18875,37732,15945,59575,10136,4924,5212
50630,78460,18876,37737,15945,59584,10137,4925,5212
50635,78466,18876,37739,15945,59590,10139,4926,5213
50640,78477,18877,37743,15946,59600,10140,4927,5213
50645,78481,18877,37746,15946,59604,10140,4927,5213
50650,78491,18878,37749,15947,59613,10141,4927,5214
50655,78497,18879,37753,15948,59617,10143,4928,5215
50660,78508,18879,37759,15948,59628,10144,4929,5215
50665,78512,18879,37761,15948,59633,10144,4929,5215
50670,78522,18880,37765,15948,59641,10145,4929,5216
50675,78528,18880,37767,15948,59647,10147,4930,5217
50680,78539,18883,37770,15951,59656,10148,4930,5218
50685,78543,18883,37772,15951,59659,10148,4930,5218
50690,78553,18889,37776,15956,59664,10149,4930,5219
50695,78559,18889,37778,15956,59670,10151,4932,5219
50700,78570,18892,37783,15958,59676,10152,4933,5219
50705,78574,18894,37784,15960,59679,10152,4933,5219
50710,78584,18898,37789,15964,59685,10153,4934,5219
50715,78590,18899,37791,15965,59690,10155,4935,5220
50720,78601,18902,37795,15968,59697,10156,4935,5221
50725,78605,18905,37797,15971,59699,10156,4935,5221
50730,78615,18912,37803,15977,59703,10157,4936,5221
50735,78621,18913,37806,15978,59708,10159,4938,5221
50740,78632,18916,37811,15980,59714,10160,4939,5221
50745,78636,18920,37814,15984,59715,10160,4939,5221
50750,78646,18925,37819,15989,59720,10161,4939,5222
50755,78652,18926,37821,15990,59725,10163,4940,5223
50760,78663,18930,37826,15994,59731,10164,4940,5224
50765,78667,18931,37828,15995,59735,10164,4940,5224
50770,78677,18933,37834,15997,59743,10165,4940,5225
50775,78683,18934,37837,15998,59748,10167,4942,5225
50780,78694,18936,37840,16000,59757,10168,4942,5226
50785,78698,18938,37842,16002,59760,10168,4942,5226
50790,78708,18940,37845,16003,59767,10169,4943,5226
50795,78714,18941,37847,16004,59773,10171,4943,5228
50800,78725,18942,37851,16004,59781,10172,4944,5228
50805,78729,18944,37853,16006,59784,10172,4944,5228
50810,78739,18947,37857,16008,59792,10173,4944,5229
50815,78745,18947,37860,16008,59797,10175,4946,5229
50820,78756,18950,37867,16010,59804,10176,4947,5229
50825,78760,18951,37870,16011,59808,10176,4947,5229
50830,78770,18952,37876,16011,59817,10177,4948,5229
50835,78776,18952,37878,16011,59823,10179,4948,5231
50840,78787,18953,37885,16012,59832,10180,4949,5231
50845,78791,18954,37888,16013,59836,10180,4949,5231
50850,78801,18955,37893,16013,59846,10181,4950,5231
50855,78807,18955,37896,16013,59852,10183,4952,5231
50860,78818,18956,37902,16014,59860,10184,4952,5232
50865,78822,18956,37905,16014,59866,10184,4952,5232
50870,78832,18958,37908,16014,59873,10185,4953,5232
50875,78838,18958,37910,16014,59880,10187,4954,5233
50880,78849,18959,37915,16015,59888,10188,4954,5234
50885,78853,18960,37916,16016,59892,10188,4954,5234
50890,78863,18963,37920,16019,59900,10189,4954,5235
50895,78869,18964,37921,16020,59905,10191,4954,5237
50900,78880,18967,37926,16023,59913,10192,4955,5237
50905,78884,18967,37928,16023,59916,10192,4955,5237
50910,78894,18970,37934,16025,59924,10193,4956,5237
50915,78900,18971,37938,16026,59928,10195,4957,5238
50920,78911,18974,37943,16029,59935,10196,4958,5238
50925,78915,18976,37945,16031,59938,10196,4958,5238
50930,78925,18980,37948,16033,59944,10197,4958,5239
50935,78931,18981,37949,16034,59949,10199,4958,5241
50940,78942,18984,37953,16036,59955,10200,4958,5242
50945,78946,18987,37955,16039,59958,10200,4958,5242
50950,78956,18992,37960,16043,59964,10201,4959,5242
50955,78962,18993,37965,16044,59968,10203,4961,5242
50960,78973,18997,37971,16047,59973,10204,4962,5242
50965,78977,19001,37974,16051,59974,10204,4962,5242
50970,78987,19009,37979,16058,59978,10205,4962,5243
50975,78993,19010,37983,16059,59981,10207,4963,5244
50980,79004,19013,37990,16061,59987,10208,4964,5244
50985,79008,19017,37993,16065,59990,10208,4964,5244
50990,79018,19019,37999,16066,59998,10209,4965,5244
50995,79024,19020,38001,16067,60003,10211,4966,5245
51000,79035,19022,38006,16068,60011,10212,4967,5245
51005,79039,19023,38008,16069,60015,10212,4967,5245
51010,79049,19024,38011,16070,60025,10213,4967,5246
51015,79055,19025,38016,16071,60029,10215,4969,5246
51020,79066,19028,38020,16073,60038,10216,4969,5247
51025,79070,19029,38022,16074,60041,10216,4969,5247
51030,79080,19032,38027,16076,60048,10217,4970,5247
51035,79086,19032,38032,16076,60053,10219,4972,5247
51040,79097,19035,38036,16078,60061,10220,4972,5248
51045,79101,19035,38036,16078,60066,10220,4972,5248
51050,79111,19038,38044,16081,60072,10221,4972,5249
51055,79117,19039,38047,16082,60077,10223,4973,5250
51060,79128,19041,38051,16083,60086,10224,4973,5251
51065,79132,19042,38055,16084,60090,10224,4973,5251
51070,79142,19043,38059,16084,60099,10225,4974,5251
51075,79148,19044,38062,16085,60104,10227,4975,5252
51080,79159,19045,38065,16086,60114,10228,4975,5253
51085,79163,19045,38067,16086,60118,10228,4975,5253
51090,79173,19047,38073,16088,60126,10229,4976,5253
51095,79179,19048,38077,16089,60130,10231,4976,5255
51100,79190,19051,38082,16092,60137,10232,4976,5256
51105,79194,19052,38086,16093,60142,10232,4976,5256
51110,79204,19054,38091,16094,60149,10233,4976,5257
51115,79210,19054,38094,16094,60155,10235,4976,5259
51120,79221,19056,38097,16096,60163,10236,4976,5260
51125,79225,19057,38099,16097,60167,10236,4976,5260
51130,79235,19060,38105,16098,60174,10237,4977,5260
51135,79241,19061,38108,16099,60179,10239,4978,5261
51140,79252,19062,38110,16100,60190,10240,4978,5262
51145,79256,19062,38113,16100,60193,10240,4978,5262
51150,79266,19065,38119,16102,60200,10241,4978,5263
51155,79272,19066,38122,16103,60205,10243,4978,5265
51160,79283,19068,38126,16105,60214,10244,4979,5265
51165,79287,19069,38129,16106,60217,10244,4979,5265
51170,79297,19074,38134,16109,60222,10245,4979,5266
51175,79303,19075,38134,16110,60228,10247,4979,5268
51180,79314,19077,38141,16111,60233,10248,4980,5268
51185,79318,19081,38142,16115,60236,10248,4980,5268
51190,79328,19085,38145,16117,60243,10249,4981,5268
51195,79334,19085,38148,16117,60247,10251,4982,5269
51200,79345,19088,38152,16120,60255,10252,4983,5269
51205,79349,19092,38154,16124,60257,10252,4983,5269
51210,79359,19097,38161,16129,60262,10253,4984,5269
51215,79365,19098,38163,16130,60266,10255,4984,5271
51220,79376,19104,38169,16135,60270,10256,4984,5272
51225,79380,19108,38173,16139,60271,10256,4984,5272
51230,79390,19112,38179,16143,60278,10257,4985,5272
51235,79396,19113,38183,16144,60283,10259,4987,5272
51240,79407,19114,38186,16144,60292,10260,4988,5272
51245,79411,19116,38188,16146,60294,10260,4988,5272
51250,79421,19118,38192,16148,60302,10261,4988,5273
51255,79427,19120,38197,16150,60305,10263,4990,5273
51260,79438,19122,38202,16151,60314,10264,4991,5273
51265,79442,19125,38205,16154,60317,10264,4991,5273
51270,79452,19127,38210,16155,60325,10265,4992,5273
51275,79458,19127,38212,16155,60331,10267,4994,5273
51280,79469,19128,38216,16155,60340,10268,4994,5274
51285,79473,19129,38219,16156,60343,10268,4994,5274
51290,79483,19130,38223,16157,60353,10269,4994,5275
51295,79489,19131,38226,16158,60358,10271,4995,5276
51300,79500,19132,38231,16159,60365,10272,4996,5276
51305,79504,19134,38232,16161,60370,10272,4996,5276
51310,79514,19136,38237,16163,60377,10273,4996,5277
51315,79520,19138,38239,16165,60382,10275,4996,5279
51320,79531,19140,38242,16167,60391,10276,4996,5280
51325,79535,19140,38243,16167,60394,10276,4996,5280
51330,79545,19142,38248,16168,60403,10277,4996,5281
51335,79551,19143,38252,16169,60407,10279,4997,5282
51340,79562,19147,38259,16172,60412,10280,4998,5282
51345,79566,19150,38259,16175,60416,10280,4998,5282
51350,79576,19153,38262,16177,60422,10281,4998,5283
51355,79582,19154,38266,16178,60427,10283,5000,5283
51360,79593,19156,38270,16180,60436,10284,5001,5283
51365,79597,19157,38271,16181,60440,10284,5001,5283
51370,79607,19159,38276,16182,60447,10285,5002,5283
51375,79613,19159,38276,16182,60454,10287,5002,5285
51380,79624,19159,38283,16182,60461,10288,5002,5286
51385,79628,19161,38284,16184,60466,10288,5002,5286
51390,79638,19164,38288,16186,60473,10289,5002,5287
51395,79644,19165,38290,16187,60479,10291,5003,5288
51400,79655,19167,38298,16189,60484,10292,5004,5288
51405,79659,19169,38300,16191,60489,10292,5004,5288
51410,79669,19172,38305,16193,60496,10293,5004,5289
51415,79675,19172,38308,16193,60502,10295,5006,5289
51420,79686,19176,38312,16197,60510,10296,5006,5290
51425,79690,19176,38314,16197,60513,10296,5006,5290
51430,79700,19179,38318,16198,60521,10297,5006,5291
51435,79706,19179,38319,16198,60527,10299,5006,5293
51440,79717,19181,38326,16200,60534,10300,5007,5293
51445,79721,19182,38327,16201,60539,10300,5007,5293
51450,79731,19184,38333,16202,60547,10301,5008,5293
51455,79737,19185,38336,16203,60552,10303,5009,5294
51460,79748,19187,38341,16205,60559,10304,5009,5295
51465,79752,19189,38344,16207,60562,10304,5009,5295
51470,79762,19196,38352,16213,60564,10305,5010,5295
51475,79768,19198,38356,16215,60568,10307,5012,5295
51480,79779,19204,38362,16220,60572,10308,5012,5296
51485,79783,19207,38365,16223,60576,10308,5012,5296
51490,79793,19209,38372,16224,60583,10309,5012,5297
51495,79799,19210,38375,16225,60588,10311,5013,5298
51500,79810,19212,38382,16226,60595,10312,5014,5298
51505,79814,19214,38383,16228,60600,10312,5014,5298
51510,79824,19217,38387,16230,60607,10313,5014,5299
51515,79830,19218,38389,16231,60612,10315,5015,5300
51520,79841,19219,38392,16232,60621,10316,5015,5301
51525,79845,19220,38394,16233,60624,10316,5015,5301
51530,79855,19222,38398,16235,60633,10317,5015,5302
51535,79861,19223,38400,16236,60637,10319,5015,5304
51540,79872,19226,38405,16238,60646,10320,5016,5304
51545,79876,19226,38407,16238,60650,10320,5016,5304
51550,79886,19228,38412,16240,60658,10321,5017,5304
51555,79892,19229,38416,16241,60663,10323,5018,5305
51560,79903,19230,38419,16241,60671,10324,5018,5306
51565,79907,19232,38421,16243,60674,10324,5018,5306
51570,79917,19235,38425,16245,60681,10325,5018,5307
51575,79923,19237,38428,16247,60686,10327,5019,5308
51580,79934,19240,38434,16250,60693,10328,5020,5308
51585,79938,19240,38437,16250,60697,10328,5020,5308
51590,79948,19243,38441,16252,60705,10329,5021,5308
51595,79954,19243,38443,16252,60711,10331,5023,5308
51600,79965,19245,38447,16254,60718,10332,5023,5309
51605,79969,19246,38449,16255,60723,10332,5023,5309
51610,79979,19249,38452,16257,60729,10333,5023,5310
51615,79985,19251,38455,16259,60734,10335,5024,5311
51620,79996,19254,38460,16262,60741,10336,5024,5312
51625,80000,19255,38462,16263,60745,10336,5024,5312
51630,80010,19257,38467,16263,60752,10337,5025,5312
51635,80016,19259,38470,16265,60757,10339,5026,5313
51640,80027,19261,38476,16267,60763,10340,5026,5314
51645,80031,19263,38477,16269,60768,10340,5026,5314
51650,80041,19265,38481,16271,60775,10341,5026,5315
51655,80047,19265,38482,16271,60782,10343,5027,5316
51660,80058,19266,38487,16272,60792,10344,5028,5316
51665,80062,19266,38488,16272,60796,10344,5028,5316
51670,80072,19268,38492,16272,60804,10345,5028,5317
51675,80078,19269,38496,16273,60808,10347,5029,5318
51680,80089,19272,38502,16276,60815,10348,5029,5319
51685,80093,19274,38502,16278,60819,10348,5029,5319
51690,80103,19276,38510,16279,60826,10349,5030,5319
51695,80109,19276,38512,16279,60832,10351,5031,5320
51700,80120,19277,38516,16280,60840,10352,5031,5321
51705,80124,19279,38516,16282,60845,10352,5031,5321
51710,80134,19283,38521,16285,60851,10353,5032,5321
51715,80140,19283,38525,16285,60855,10355,5034,5321
51720,80151,19287,38529,16289,60863,10356,5034,5322
51725,80155,19288,38531,16290,60866,10356,5034,5322
51730,80165,19292,38536,16294,60872,10357,5034,5323
51735,80171,19293,38540,16295,60876,10359,5035,5324
51740,80182,19295,38545,16297,60884,10360,5036,5324
51745,80186,19297,38548,16299,60887,10360,5036,5324
51750,80196,19301,38552,16302,60894,10361,5036,5325
51755,80202,19303,38555,16304,60898,10363,5037,5326
51760,80213,19305,38561,16305,60905,10364,5037,5327
51765,80217,19308,38565,16308,60908,10364,5037,5327
51770,80227,19309,38568,16309,60917,10365,5038,5327
51775,80233,19310,38572,16310,60921,10367,5040,5327
51780,80244,19313,38579,16312,60929,10368,5041,5327
51785,80248,19316,38580,16315,60932,10368,5041,5327
51790,80258,19317,38584,16316,60940,10369,5042,5327
51795,80264,19317,38589,16316,60946,10371,5044,5327
51800,80275,19318,38596,16317,60954,10372,5045,5327
51805,80279,19322,38598,16321,60957,10372,5045,5327
51810,80289,19324,38602,16323,60964,10373,5045,5328
51815,80295,19325,38603,16324,60969,10375,5045,5330
51820,80306,19327,38610,16326,60976,10376,5046,5330
51825,80310,19330,38612,16329,60980,10376,5046,5330
51830,80320,19332,38619,16331,60987,10377,5046,5331
51835,80326,19333,38621,16332,60993,10379,5047,5332
51840,80337,19335,38627,16334,60999,10380,5048,5332
51845,80341,19339,38628,16338,61002,10380,5048,5332
51850,80351,19340,38631,16338,61010,10381,5049,5332
51855,80357,19342,38635,16340,61014,10383,5051,5332
51860,80368,19345,38641,16343,61021,10384,5052,5332
51865,80372,19348,38644,16346,61024,10384,5052,5332
51870,80382,19350,38648,16347,61031,10385,5052,5333
51875,80388,19352,38652,16349,61036,10387,5054,5333
51880,80399,19354,38658,16350,61041,10388,5054,5334
51885,80403,19358,38660,16354,61044,10388,5054,5334
51890,80413,19361,38667,16357,61051,10389,5054,5335
51895,80419,19362,38669,16358,61057,10391,5054,5337
51900,80430,19362,38671,16358,61067,10392,5054,5338
51905,80434,19364,38674,16360,61069,10392,5054,5338
51910,80444,19366,38679,16361,61077,10393,5055,5338
51915,80450,19366,38682,16361,61083,10395,5056,5339
51920,80461,19368,38688,16363,61091,10396,5057,5339
51925,80465,19370,38690,16365,61095,10396,5057,5339
51930,80475,19371,38695,16366,61103,10397,5057,5340
51935,80481,19371,38698,16366,61109,10399,5059,5340
51940,80492,19372,38701,16367,61119,10400,5059,5341
51945,80496,19374,38703,16369,61121,10400,5059,5341
51950,80506,19379,38712,16374,61125,10401,5059,5342
51955,80512,19380,38714,16375,61131,10403,5060,5343
51960,80523,19381,38717,16376,61140,10404,5060,5344
51965,80527,19382,38718,16377,61144,10404,5060,5344
51970,80537,19384,38724,16379,61152,10405,5061,5344
51975,80543,19384,38726,16379,61158,10407,5061,5346
51980,80554,19384,38730,16379,61169,10408,5061,5347
51985,80558,19384,38732,16379,61174,10408,5061,5347
51990,80568,19385,38737,16380,61182,10409,5062,5347
51995,80574,19385,38741,16380,61188,10411,5064,5347
52000,80585,19387,38743,16382,61198,10412,5064,5348
52005,80589,19388,38745,16383,61201,10412,5064,5348
52010,80599,19390,38750,16384,61208,10413,5065,5348
52015,80605,19390,38754,16384,61213,10415,5066,5349
52020,80616,19391,38758,16385,61223,10416,5066,5350
52025,80620,19393,38759,16387,61227,10416,5066,5350
52030,80630,19395,38761,16388,61234,10417,5067,5350
52035,80636,19396,38764,16389,61240,10419,5069,5350
52040,80647,19399,38770,16392,61248,10420,5070,5350
52045,80651,19400,38772,16393,61251,10420,5070,5350
52050,80661,19401,38778,16394,61259,10421,5070,5351
52055,80667,19402,38781,16395,61265,10423,5072,5351
52060,80678,19404,38787,16397,61273,10424,5073,5351
52065,80682,19406,38790,16399,61275,10424,5073,5351
52070,80692,19408,38795,16401,61283,10425,5073,5352
52075,80698,19409,38799,16402,61287,10427,5074,5353
52080,80709,19411,38805,16404,61294,10428,5075,5353
52085,80713,19416,38806,16409,61297,10428,5075,5353
52090,80723,19418,38810,16410,61304,10429,5076,5353
52095,80729,19420,38813,16412,61309,10431,5076,5355
52100,80740,19424,38819,16415,61315,10432,5077,5355
52105,80744,19425,38821,16416,61319,10432,5077,5355
52110,80754,19428,38828,16419,61325,10433,5077,5356
52115,80760,19429,38831,16420,61330,10435,5079,5356
52120,80771,19432,38835,16422,61336,10436,5079,5357
52125,80775,19436,38837,16426,61339,10436,5079,5357
52130,80785,19438,38842,16426,61346,10437,5080,5357
52135,80791,19440,38847,16428,61350,10439,5082,5357
52140,80802,19444,38854,16432,61355,10440,5083,5357
52145,80806,19447,38855,16435,61359,10440,5083,5357
52150,80816,19449,38858,16436,61366,10441,5083,5358
52155,80822,19449,38861,16436,61372,10443,5084,5359
52160,80833,19452,38867,16439,61379,10444,5085,5359
52165,80837,19455,38870,16442,61381,10444,5085,5359
52170,80847,19458,38877,16445,61388,10445,5086,5359
52175,80853,19459,38880,16446,61394,10447,5087,5360
52180,80864,19460,38885,16447,61403,10448,5088,5360
52185,80868,19462,38887,16449,61406,10448,5088,5360
52190,80878,19466,38890,16451,61411,10449,5088,5361
52195,80884,19467,38892,16452,61416,10451,5088,5363
52200,80895,19470,38899,16455,61423,10452,5089,5363
52205,80899,19471,38900,16456,61428,10452,5089,5363
52210,80909,19472,38906,16457,61436,10453,5090,5363
52215,80915,19473,38912,16458,61441,10455,5092,5363
52220,80926,19474,38917,16459,61452,10456,5092,5364
52225,80930,19474,38919,16459,61456,10456,5092,5364
52230,80940,19475,38925,16459,61464,10457,5092,5365
52235,80946,19475,38927,16459,61471,10459,5092,5367
52240,80957,19476,38934,16460,61479,10460,5093,5367
52245,80961,19477,38936,16461,61484,10460,5093,5367
52250,80971,19479,38943,16463,61491,10461,5094,5367
52255,80977,19480,38945,16464,61497,10463,5095,5368
52260,80988,19481,38949,16465,61504,10464,5095,5369
52265,80992,19483,38950,16467,61508,10464,5095,5369
52270,81002,19484,38954,16468,61517,10465,5096,5369
52275,81008,19485,38958,16469,61522,10467,5098,5369
52280,81019,19487,38963,16470,61531,10468,5098,5370
52285,81023,19488,38965,16471,61535,10468,5098,5370
52290,81033,19491,38970,16473,61541,10469,5098,5371
52295,81039,19492,38973,16474,61546,10471,5099,5372
52300,81050,19493,38978,16475,61554,10472,5100,5372
52305,81054,19498,38981,16480,61555,10472,5100,5372
52310,81064,19505,38986,16485,61557,10473,5100,5373
52315,81070,19506,38990,16486,61562,10475,5102,5373
52320,81081,19510,38993,16489,61570,10476,5103,5373
52325,81085,19511,38994,16490,61574,10476,5103,5373
52330,81095,19514,38997,16491,61580,10477,5103,5374
52335,81101,19516,39001,16493,61585,10479,5105,5374
52340,81112,19517,39001,16493,61595,10480,5105,5375
52345,81116,19518,39004,16494,61597,10480,5105,5375
52350,81126,19521,39011,16496,61604,10481,5105,5376
52355,81132,19522,39013,16497,61609,10483,5106,5377
52360,81143,19527,39020,16501,61614,10484,5107,5377
52365,81147,19529,39021,16503,61618,10484,5107,5377
52370,81157,19532,39027,16505,61624,10485,5108,5377
52375,81163,19532,39028,16505,61630,10487,5108,5379
52380,81174,19534,39033,16507,61638,10488,5109,5379
52385,81178,19537,39035,16510,61641,10488,5109,5379
52390,81188,19539,39039,16511,61649,10489,5110,5379
52395,81194,19540,39044,16512,61653,10491,5112,5379
52400,81205,19542,39049,16514,61663,10492,5113,5379
52405,81209,19542,39050,16514,61667,10492,5113,5379
52410,81219,19544,39056,16515,61674,10493,5114,5379
52415,81225,19545,39062,16516,61679,10495,5116,5379
52420,81236,19547,39067,16518,61688,10496,5116,5380
52425,81240,19547,39070,16518,61692,10496,5116,5380
52430,81250,19550,39072,16519,61700,10497,5116,5381
52435,81256,19551,39077,16520,61704,10499,5118,5381
52440,81267,19552,39080,16521,61713,10500,5118,5382
52445,81271,19553,39082,16522,61717,10500,5118,5382
52450,81281,19556,39088,16524,61725,10501,5119,5382
52455,81287,19557,39091,16525,61730,10503,5120,5383
52460,81298,19557,39094,16525,61739,10504,5120,5384
52465,81302,19558,39094,16526,61744,10504,5120,5384
52470,81312,19560,39097,16526,61751,10505,5120,5385
52475,81318,19560,39099,16526,61757,10507,5120,5387
52480,81329,19562,39104,16528,61765,10508,5121,5387
52485,81333,19563,39105,16529,61769,10508,5121,5387
52490,81343,19567,39111,16532,61776,10509,5122,5387
52495,81349,19568,39113,16533,61781,10511,5122,5389
52500,81360,19572,39121,16537,61785,10512,5123,5389
52505,81364,19577,39124,16542,61786,10512,5123,5389
52510,81374,19582,39127,16545,61791,10513,5123,5390
52515,81380,19583,39129,16546,61796,10515,5124,5391
52520,81391,19587,39137,16550,61800,10516,5125,5391
52525,81395,19591,39138,16554,61804,10516,5125,5391
52530,81405,19594,39144,16557,61811,10517,5125,5392
52535,81411,19595,39147,16558,61815,10519,5126,5393
52540,81422,19598,39154,16560,61823,10520,5127,5393
52545,81426,19599,39156,16561,61827,10520,5127,5393
52550,81436,19601,39161,16562,61834,10521,5128,5393
52555,81442,19602,39163,16563,61839,10523,5129,5394
52560,81453,19604,39167,16564,61847,10524,5130,5394
52565,81457,19606,39168,16566,61851,10524,5130,5394
52570,81467,19609,39175,16568,61857,10525,5130,5395
52575,81473,19611,39179,16570,61861,10527,5131,5396
52580,81484,19612,39182,16570,61870,10528,5132,5396
52585,81488,19613,39184,16571,61874,10528,5132,5396
52590,81498,19615,39187,16572,61882,10529,5132,5397
52595,81504,19617,39189,16574,61887,10531,5133,5398
52600,81515,19619,39194,16575,61895,10532,5134,5398
52605,81519,19619,39195,16575,61900,10532,5134,5398
52610,81529,19620,39200,16575,61908,10533,5135,5398
52615,81535,19620,39202,16575,61914,10535,5135,5400
52620,81546,19620,39210,16575,61924,10536,5135,5401
52625,81550,19620,39213,16575,61930,10536,5135,5401
52630,81560,19621,39218,16575,61939,10537,5135,5402
52635,81566,19622,39223,16576,61943,10539,5137,5402
52640,81577,19625,39229,16579,61951,10540,5138,5402
52645,81581,19626,39230,16580,61955,10540,5138,5402
52650,81591,19628,39238,16581,61962,10541,5139,5402
52655,81597,19629,39241,16582,61968,10543,5140,5403
52660,81608,19630,39247,16583,61975,10544,5141,5403
52665,81612,19631,39249,16584,61981,10544,5141,5403
52670,81622,19633,39254,16585,61988,10545,5141,5404
52675,81628,19633,39255,16585,61995,10547,5141,5406
52680,81639,19634,39261,16586,62002,10548,5141,5407
52685,81643,19636,39265,16588,62006,10548,5141,5407
52690,81653,19639,39268,16590,62014,10549,5142,5407
52695,81659,19640,39272,16591,62019,10551,5143,5408
52700,81670,19641,39275,16592,62028,10552,5143,5409
52705,81674,19642,39279,16593,62031,10552,5143,5409
52710,81684,19647,39285,16597,62037,10553,5143,5410
52715,81690,19647,39285,16597,62043,10555,5143,5412
52720,81701,19651,39292,16600,62048,10556,5144,5412
52725,81705,19654,39294,16603,62051,10556,5144,5412
52730,81715,19657,39300,16605,62058,10557,5145,5412
52735,81721,19658,39304,16606,62061,10559,5146,5413
52740,81732,19664,39312,16612,62066,10560,5147,5413
52745,81736,19668,39316,16616,62067,10560,5147,5413
52750,81746,19675,39322,16622,62071,10561,5147,5414
52755,81752,19675,39325,16622,62076,10563,5148,5415
52760,81763,19679,39332,16626,62081,10564,5148,5416
52765,81767,19682,39333,16629,62085,10564,5148,5416
52770,81777,19684,39336,16630,62093,10565,5148,5417
52775,81783,19684,39340,16630,62098,10567,5150,5417
52780,81794,19685,39342,16630,62109,10568,5150,5418
52785,81798,19686,39344,16631,62112,10568,5150,5418
52790,81808,19689,39350,16633,62119,10569,5151,5418
52795,81814,19690,39351,16634,62124,10571,5151,5420
52800,81825,19693,39358,16636,62129,10572,5151,5421
52805,81829,19695,39359,16638,62134,10572,5151,5421
52810,81839,19697,39364,16640,62141,10573,5152,5421
52815,81845,19698,39367,16641,62146,10575,5153,5422
52820,81856,19700,39374,16643,62154,10576,5153,5423
52825,81860,19701,39376,16644,62158,10576,5153,5423
52830,81870,19704,39382,16647,62165,10577,5153,5424
52835,81876,19705,39384,16648,62170,10579,5153,5426
52840,81887,19706,39387,16649,62181,10580,5154,5426
52845,81891,19706,39387,16649,62185,10580,5154,5426
52850,81901,19707,39394,16650,62193,10581,5154,5427
52855,81907,19707,39396,16650,62200,10583,5156,5427
52860,81918,19708,39402,16651,62208,10584,5156,5428
52865,81922,19708,39405,16651,62214,10584,5156,5428
52870,81932,19710,39411,16652,62222,10585,5157,5428
52875,81938,19711,39413,16653,62227,10587,5158,5429
52880,81949,19712,39420,16654,62234,10588,5159,5429
52885,81953,19714,39423,16656,62239,10588,5159,5429
52890,81963,19716,39430,16657,62247,10589,5160,5429
52895,81969,19716,39432,16657,62252,10591,5160,5431
52900,81980,19716,39435,16657,62263,10592,5161,5431
52905,81984,19716,39436,16657,62267,10592,5161,5431
52910,81994,19718,39443,16658,62275,10593,5162,5431
52915,82000,19718,39444,16658,62282,10595,5163,5432
52920,82011,19718,39449,16658,62291,10596,5163,5433
52925,82015,19719,39451,16659,62296,10596,5163,5433
52930,82025,19721,39456,16660,62304,10597,5163,5434
52935,82031,19722,39460,16661,62308,10599,5163,5436
52940,82042,19725,39465,16664,62315,10600,5164,5436
52945,82046,19728,39467,16667,62318,10600,5164,5436
52950,82056,19731,39473,16670,62324,10601,5165,5436
52955,82062,19733,39478,16672,62329,10603,5167,5436
52960,82073,19736,39483,16674,62334,10604,5167,5437
52965,82077,19739,39486,16677,62337,10604,5167,5437
52970,82087,19744,39492,16681,62342,10605,5168,5437
52975,82093,19746,39498,16683,62346,10607,5170,5437
52980,82104,19748,39499,16684,62355,10608,5170,5438
52985,82108,19751,39503,16687,62356,10608,5170,5438
52990,82118,19754,39508,16690,62364,10609,5171,5438
52995,82124,19755,39513,16691,62368,10611,5173,5438
53000,82135,19757,39518,16692,62374,10612,5174,5438
53005,82139,19761,39519,16696,62378,10612,5174,5438
53010,82149,19764,39522,16697,62385,10613,5175,5438
53015,82155,19765,39528,16698,62387,10615,5177,5438
53020,82166,19771,39535,16704,62392,10616,5178,5438
53025,82170,19775,39536,16708,62395,10616,5178,5438
53030,82180,19780,39541,16712,62399,10617,5178,5439
53035,82186,19782,39543,16714,62404,10619,5179,5440
53040,82197,19784,39547,16715,62410,10620,5179,5441
53045,82201,19788,39550,16719,62413,10620,5179,5441
53050,82211,19790,39554,16720,62420,10621,5180,5441
53055,82217,19791,39557,16721,62426,10623,5182,5441
53060,82228,19792,39561,16721,62435,10624,5182,5442
53065,82232,19793,39563,16722,62439,10624,5182,5442
53070,82242,19796,39569,16725,62445,10625,5183,5442
53075,82248,19797,39570,16726,62451,10627,5184,5443
53080,82259,19800,39578,16729,62457,10628,5185,5443
53085,82263,19803,39580,16732,62460,10628,5185,5443
53090,82273,19804,39584,16733,62469,10629,5185,5444
53095,82279,19805,39587,16734,62474,10631,5186,5445
53100,82290,19806,39595,16735,62483,10632,5187,5445
53105,82294,19807,39597,16736,62487,10632,5187,5445
53110,82304,19808,39604,16737,62495,10633,5187,5446
53115,82310,19809,39609,16738,62500,10635,5188,5447
53120,82321,19810,39615,16739,62509,10636,5188,5448
53125,82325,19811,39618,16740,62514,10636,5188,5448
53130,82335,19811,39621,16740,62523,10637,5189,5448
53135,82341,19811,39625,16740,62529,10639,5190,5449
53140,82352,19811,39629,16740,62541,10640,5190,5450
53145,82356,19811,39631,16740,62544,10640,5190,5450
53150,82366,19815,39636,16743,62551,10641,5191,5450
53155,82372,19815,39639,16743,62556,10643,5192,5451
53160,82383,19818,39645,16746,62564,10644,5192,5452
53165,82387,19819,39646,16747,62568,10644,5192,5452
53170,82397,19820,39652,16748,62576,10645,5193,5452
53175,82403,19820,39653,16748,62583,10647,5194,5453
53180,82414,19821,39660,16749,62590,10648,5195,5453
53185,82418,19823,39661,16751,62594,10648,5195,5453
53190,82428,19826,39664,16753,62602,10649,5195,5454
53195,82434,19826,39665,16753,62608,10651,5196,5455
53200,82445,19828,39672,16754,62615,10652,5197,5455
53205,82449,19830,39675,16756,62618,10652,5197,5455
53210,82459,19832,39681,16758,62627,10653,5198,5455
53215,82465,19832,39686,16758,62632,10655,5200,5455
53220,82476,19834,39691,16759,62639,10656,5200,5456
53225,82480,19836,39693,16761,62643,10656,5200,5456
53230,82490,19840,39699,16765,62649,10657,5200,5457
53235,82496,19841,39700,16766,62655,10659,5201,5458
53240,82507,19844,39705,16768,62662,10660,5202,5458
53245,82511,19845,39707,16769,62666,10660,5202,5458
53250,82521,19848,39713,16771,62672,10661,5203,5458
53255,82527,19849,39715,16772,62677,10663,5204,5459
53260,82538,19852,39719,16774,62686,10664,5205,5459
53265,82542,19852,39719,16774,62690,10664,5205,5459
53270,82552,19856,39726,16778,62695,10665,5205,5460
53275,82558,19858,39729,16780,62698,10667,5205,5462
53280,82569,19863,39736,16785,62704,10668,5205,5463
53285,82573,19864,39738,16786,62708,10668,5205,5463
53290,82583,19867,39743,16789,62715,10669,5205,5464
53295,82589,19868,39747,16790,62718,10671,5206,5465
53300,82600,19873,39750,16795,62726,10672,5206,5466
53305,82604,19875,39753,16797,62729,10672,5206,5466
53310,82614,19876,39755,16797,62737,10673,5206,5467
53315,82620,19877,39759,16798,62743,10675,5207,5468
53320,82631,19880,39763,16800,62750,10676,5208,5468
53325,82635,19881,39765,16801,62754,10676,5208,5468
53330,82645,19883,39770,16803,62762,10677,5209,5468
53335,82651,19883,39773,16803,62768,10679,5210,5469
53340,82662,19884,39778,16804,62776,10680,5210,5470
53345,82666,19886,39782,16806,62780,10680,5210,5470
53350,82676,19887,39788,16807,62789,10681,5211,5470
53355,82682,19887,39790,16807,62795,10683,5212,5471
53360,82693,19889,39797,16808,62802,10684,5213,5471
53365,82697,19890,39797,16809,62807,10684,5213,5471
53370,82707,19892,39802,16810,62815,10685,5214,5471
53375,82713,19893,39805,16811,62820,10687,5214,5473
53380,82724,19894,39810,16811,62827,10688,5215,5473
53385,82728,19897,39812,16814,62831,10688,5215,5473
53390,82738,19900,39818,16817,62838,10689,5215,5474
53395,82744,19900,39820,16817,62844,10691,5215,5476
53400,82755,19902,39822,16818,62852,10692,5215,5477
53405,82759,19903,39825,16819,62855,10692,5215,5477
53410,82769,19908,39830,16822,62859,10693,5215,5478
53415,82775,19909,39833,16823,62865,10695,5217,5478
53420,82786,19911,39840,16825,62873,10696,5218,5478
53425,82790,19912,39843,16826,62877,10696,5218,5478
53430,82800,19915,39845,16828,62885,10697,5218,5479
53435,82806,19916,39849,16829,62890,10699,5220,5479
53440,82817,19918,39854,16831,62896,10700,5220,5480
53445,82821,19921,39858,16834,62899,10700,5220,5480
53450,82831,19925,39864,16838,62906,10701,5220,5481
53455,82837,19925,39867,16838,62911,10703,5221,5482
53460,82848,19928,39871,16841,62920,10704,5222,5482
53465,82852,19929,39873,16842,62923,10704,5222,5482
53470,82862,19932,39878,16844,62930,10705,5222,5483
53475,82868,19933,39883,16845,62935,10707,5224,5483
53480,82879,19933,39888,16845,62944,10708,5225,5483
53485,82883,19934,39891,16846,62949,10708,5225,5483
53490,82893,19935,39897,16846,62957,10709,5225,5484
53495,82899,19935,39900,16846,62963,10711,5226,5485
53500,82910,19936,39905,16847,62973,10712,5226,5486
53505,82914,19937,39905,16848,62977,10712,5226,5486
53510,82924,19940,39912,16851,62983,10713,5226,5487
53515,82930,19941,39914,16852,62989,10715,5227,5488
53520,82941,19943,39918,16853,62996,10716,5227,5489
53525,82945,19944,39921,16854,63000,10716,5227,5489
53530,82955,19946,39927,16856,63009,10717,5227,5490
53535,82961,19947,39931,16857,63014,10719,5228,5491
53540,82972,19949,39936,16858,63021,10720,5228,5492
53545,82976,19951,39937,16860,63024,10720,5228,5492
53550,82986,19954,39944,16863,63032,10721,5228,5493
53555,82992,19954,39945,16863,63038,10723,5228,5495
53560,83003,19955,39949,16863,63046,10724,5228,5496
53565,83007,19958,39953,16866,63048,10724,5228,5496
53570,83017,19959,39956,16866,63057,10725,5228,5497
53575,83023,19960,39958,16867,63062,10727,5229,5498
53580,83034,19962,39965,16868,63068,10728,5230,5498
53585,83038,19967,39968,16873,63071,10728,5230,5498
53590,83048,19969,39970,16873,63079,10729,5230,5499
53595,83054,19969,39974,16873,63083,10731,5232,5499
53600,83065,19974,39982,16877,63087,10732,5232,5500
53605,83069,19977,39984,16880,63091,10732,5232,5500
53610,83079,19980,39988,16883,63099,10733,5232,5501
53615,83085,19981,39992,16884,63104,10735,5233,5502
53620,83096,19984,39998,16886,63109,10736,5233,5503
53625,83100,19986,40000,16888,63114,10736,5233,5503
53630,83110,19989,40007,16891,63120,10737,5233,5504
53635,83116,19990,40010,16892,63125,10739,5234,5505
53640,83127,19995,40015,16896,63131,10740,5235,5505
53645,83131,19996,40016,16897,63135,10740,5235,5505
53650,83141,19999,40018,16898,63142,10741,5235,5506
53655,83147,19999,40019,16898,63148,10743,5235,5508
53660,83158,20000,40022,16898,63156,10744,5236,5508
53665,83162,20002,40024,16900,63159,10744,5236,5508
53670,83172,20005,40028,16902,63167,10745,5236,5509
53675,83178,20006,40032,16903,63172,10747,5237,5510
53680,83189,20007,40038,16904,63180,10748,5238,5510
53685,83193,20009,40041,16906,63184,10748,5238,5510
53690,83203,20011,40047,16907,63191,10749,5238,5511
53695,83209,20011,40050,16907,63198,10751,5239,5512
53700,83220,20014,40055,16910,63205,10752,5239,5513
53705,83224,20016,40058,16912,63208,10752,5239,5513
53710,83234,20018,40063,16913,63216,10753,5240,5513
53715,83240,20018,40065,16913,63222,10755,5240,5515
53720,83251,20020,40072,16915,63229,10756,5240,5516
53725,83255,20022,40073,16917,63233,10756,5240,5516
53730,83265,20026,40079,16920,63239,10757,5240,5517
53735,83271,20027,40082,16921,63244,10759,5242,5517
53740,83282,20029,40087,16923,63251,10760,5242,5518
53745,83286,20030,40088,16924,63255,10760,5242,5518
53750,83296,20034,40092,16926,63262,10761,5242,5519
53755,83302,20035,40097,16927,63266,10763,5243,5520
53760,83313,20036,40104,16928,63275,10764,5243,5521
53765,83317,20037,40107,16929,63280,10764,5243,5521
53770,83327,20038,40109,16930,63289,10765,5243,5522
53775,83333,20038,40112,16930,63295,10767,5245,5522
53780,83344,20040,40117,16931,63302,10768,5245,5523
53785,83348,20043,40119,16934,63305,10768,5245,5523
53790,83358,20045,40125,16936,63313,10769,5246,5523
53795,83364,20045,40129,16936,63318,10771,5248,5523
53800,83375,20046,40131,16937,63328,10772,5248,5524
53805,83379,20048,40134,16939,63330,10772,5248,5524
53810,83389,20050,40139,16941,63338,10773,5248,5525
53815,83395,20052,40142,16943,63342,10775,5249,5526
53820,83406,20055,40148,16946,63350,10776,5249,5527
53825,83410,20057,40151,16948,63352,10776,5249,5527
53830,83420,20058,40154,16948,63362,10777,5250,5527
53835,83426,20058,40157,16948,63368,10779,5252,5527
53840,83437,20059,40162,16949,63375,10780,5253,5527
53845,83441,20061,40165,16951,63379,10780,5253,5527
53850,83451,20062,40168,16952,63389,10781,5253,5528
53855,83457,20062,40171,16952,63394,10783,5254,5529
53860,83468,20064,40174,16954,63403,10784,5254,5530
53865,83472,20064,40176,16954,63407,10784,5254,5530
53870,83482,20067,40181,16956,63415,10785,5255,5530
53875,83488,20067,40184,16956,63421,10787,5257,5530
53880,83499,20070,40187,16958,63429,10788,5258,5530
53885,83503,20071,40188,16959,63432,10788,5258,5530
53890,83513,20074,40193,16961,63439,10789,5259,5530
53895,83519,20074,40196,16961,63443,10791,5260,5531
53900,83530,20078,40203,16964,63448,10792,5261,5531
53905,83534,20082,40204,16968,63452,10792,5261,5531
53910,83544,20085,40211,16970,63458,10793,5261,5532
53915,83550,20087,40213,16972,63462,10795,5261,5534
53920,83561,20092,40220,16977,63467,10796,5261,5535
53925,83565,20095,40223,16980,63469,10796,5261,5535
53930,83575,20097,40227,16982,63477,10797,5261,5536
53935,83581,20098,40228,16983,63482,10799,5261,5538
53940,83592,20102,40232,16987,63490,10800,5262,5538
53945,83596,20104,40234,16989,63492,10800,5262,5538
53950,83606,20107,40240,16991,63498,10801,5263,5538
53955,83612,20109,40243,16993,63503,10803,5265,5538
53960,83623,20111,40249,16995,63511,10804,5266,5538
53965,83627,20113,40252,16997,63513,10804,5266,5538
53970,83637,20116,40258,16999,63521,10805,5267,5538
53975,83643,20116,40260,16999,63527,10807,5269,5538
53980,83654,20117,40264,17000,63536,10808,5269,5539
53985,83658,20119,40266,17002,63539,10808,5269,5539
53990,83668,20121,40271,17003,63547,10809,5270,5539
53995,83674,20121,40275,17003,63552,10811,5272,5539
54000,83685,20124,40282,17006,63558,10812,5272,5540
54005,83689,20125,40283,17007,63564,10812,5272,5540
54010,83699,20127,40288,17008,63571,10813,5273,5540
54015,83705,20127,40292,17008,63578,10815,5275,5540
54020,83716,20129,40298,17010,63584,10816,5275,5541
54025,83720,20131,40301,17012,63588,10816,5275,5541
54030,83730,20134,40305,17013,63595,10817,5275,5542
54035,83736,20135,40309,17014,63600,10819,5276,5543
54040,83747,20137,40311,17016,63609,10820,5276,5544
54045,83751,20139,40314,17018,63611,10820,5276,5544
54050,83761,20143,40317,17020,63617,10821,5276,5545
54055,83767,20143,40319,17020,63622,10823,5276,5547
54060,83778,20146,40321,17022,63631,10824,5276,5548
54065,83782,20147,40325,17023,63634,10824,5276,5548
54070,83792,20148,40327,17023,63643,10825,5276,5549
54075,83798,20148,40329,17023,63649,10827,5277,5550
54080,83809,20150,40333,17024,63658,10828,5278,5550
54085,83813,20151,40334,17025,63662,10828,5278,5550
54090,83823,20152,40341,17026,63670,10829,5279,5550
54095,83829,20153,40343,17027,63675,10831,5279,5552
54100,83840,20156,40347,17029,63684,10832,5280,5552
54105,83844,20157,40349,17030,63687,10832,5280,5552
54110,83854,20158,40353,17031,63695,10833,5281,5552
54115,83860,20159,40354,17032,63701,10835,5282,5553
54120,83871,20162,40359,17034,63708,10836,5282,5554
54125,83875,20163,40362,17035,63712,10836,5282,5554
54130,83885,20166,40368,17037,63718,10837,5283,5554
54135,83891,20167,40373,17038,63723,10839,5284,5555
54140,83902,20168,40376,17039,63733,10840,5284,5556
54145,83906,20170,40377,17041,63736,10840,5284,5556
54150,83916,20172,40383,17042,63743,10841,5285,5556
54155,83922,20173,40386,17043,63748,10843,5286,5557
54160,83933,20174,40389,17043,63757,10844,5286,5558
54165,83937,20176,40391,17045,63760,10844,5286,5558
54170,83947,20180,40395,17048,63766,10845,5287,5558
54175,83953,20182,40400,17050,63769,10847,5289,5558
54180,83964,20188,40408,17056,63773,10848,5290,5558
54185,83968,20192,40410,17060,63775,10848,5290,5558
54190,83978,20194,40413,17061,63783,10849,5291,5558
54195,83984,20195,40416,17062,63789,10851,5293,5558
54200,83995,20199,40424,17066,63793,10852,5294,5558
54205,83999,20202,40426,17069,63796,10852,5294,5558
54210,84009,20204,40430,17069,63804,10853,5294,5559
54215,84015,20205,40433,17070,63808,10855,5294,5561
54220,84026,20209,40440,17074,63814,10856,5295,5561
54225,84030,20211,40441,17076,63819,10856,5295,5561
54230,84040,20215,40448,17079,63824,10857,5295,5562
54235,84046,20216,40449,17080,63830,10859,5295,5564
54240,84057,20218,40453,17081,63836,10860,5295,5565
54245,84061,20220,40453,17083,63841,10860,5295,5565
54250,84071,20222,40460,17084,63848,10861,5295,5566
54255,84077,20223,40463,17085,63854,10863,5296,5567
54260,84088,20225,40470,17087,63860,10864,5296,5568
54265,84092,20227,40473,17089,63865,10864,5296,5568
54270,84102,20229,40477,17090,63872,10865,5296,5569
54275,84108,20229,40478,17090,63879,10867,5297,5570
54280,84119,20229,40482,17090,63888,10868,5298,5570
54285,84123,20230,40484,17091,63893,10868,5298,5570
54290,84133,20232,40490,17093,63900,10869,5298,5571
54295,84139,20232,40493,17093,63906,10871,5299,5572
54300,84150,20233,40495,17094,63916,10872,5299,5573
54305,84154,20233,40498,17094,63920,10872,5299,5573
54310,84164,20236,40504,17096,63927,10873,5300,5573
54315,84170,20237,40509,17097,63932,10875,5302,5573
54320,84181,20240,40516,17100,63939,10876,5303,5573
54325,84185,20242,40518,17102,63943,10876,5303,5573
54330,84195,20244,40525,17102,63950,10877,5304,5573
54335,84201,20244,40527,17102,63956,10879,5304,5575
54340,84212,20247,40533,17105,63962,10880,5305,5575
54345,84216,20249,40537,17107,63966,10880,5305,5575
54350,84226,20252,40540,17110,63973,10881,5305,5576
54355,84232,20252,40542,17110,63978,10883,5305,5578
54360,84243,20255,40545,17112,63986,10884,5306,5578
54365,84247,20257,40547,17114,63989,10884,5306,5578
54370,84257,20259,40554,17115,63997,10885,5307,5578
54375,84263,20261,40558,17117,64001,10887,5308,5579
54380,84274,20263,40563,17118,64008,10888,5308,5580
54385,84278,20265,40564,17120,64012,10888,5308,5580
54390,84288,20268,40571,17122,64019,10889,5309,5580
54395,84294,20270,40575,17124,64022,10891,5309,5582
54400,84305,20273,40581,17127,64029,10892,5309,5583
54405,84309,20276,40583,17130,64033,10892,5309,5583
54410,84319,20278,40587,17132,64040,10893,5309,5584
54415,84325,20279,40591,17133,64045,10895,5310,5585
54420,84336,20280,40594,17134,64055,10896,5311,5585
54425,84340,20282,40596,17136,64057,10896,5311,5585
54430,84350,20285,40601,17139,64064,10897,5311,5586
54435,84356,20286,40604,17140,64069,10899,5311,5588
54440,84367,20288,40608,17141,64077,10900,5311,5589
54445,84371,20289,40609,17142,64081,10900,5311,5589
54450,84381,20290,40614,17142,64090,10901,5312,5589
54455,84387,20291,40616,17143,64096,10903,5313,5590
54460,84398,20293,40621,17144,64105,10904,5314,5590
54465,84402,20293,40621,17144,64109,10904,5314,5590
54470,84412,20296,40627,17147,64115,10905,5315,5590
54475,84418,20298,40631,17149,64119,10907,5316,5591
54480,84429,20303,40638,17154,64125,10908,5317,5591
54485,84433,20304,40640,17155,64129,10908,5317,5591
54490,84443,20306,40643,17156,64136,10909,5317,5592
54495,84449,20307,40646,17157,64141,10911,5318,5593
54500,84460,20310,40653,17159,64146,10912,5319,5593
54505,84464,20315,40657,17164,64149,10912,5319,5593
54510,84474,20317,40664,17166,64156,10913,5319,5594
54515,84480,20318,40667,17167,64161,10915,5320,5595
54520,84491,20319,40671,17168,64171,10916,5321,5595
54525,84495,20320,40672,17169,64175,10916,5321,5595
54530,84505,20322,40677,17170,64182,10917,5322,5595
54535,84511,20323,40678,17171,64188,10919,5322,5597
54540,84522,20326,40684,17174,64195,10920,5323,5597
54545,84526,20327,40684,17175,64199,10920,5323,5597
54550,84536,20329,40686,17175,64206,10921,5323,5598
54555,84542,20330,40690,17176,64211,10923,5324,5599
54560,84553,20333,40696,17179,64218,10924,5324,5600
54565,84557,20334,40698,17180,64222,10924,5324,5600
54570,84567,20338,40701,17183,64228,10925,5324,5601
54575,84573,20339,40706,17184,64231,10927,5325,5602
54580,84584,20343,40712,17188,64239,10928,5326,5602
54585,84588,20346,40713,17191,64242,10928,5326,5602
54590,84598,20350,40720,17194,64247,10929,5326,5603
54595,84604,20350,40722,17194,64253,10931,5327,5604
54600,84615,20351,40728,17195,64261,10932,5327,5605
54605,84619,20352,40731,17196,64266,10932,5327,5605
54610,84629,20355,40737,17198,64273,10933,5328,5605
54615,84635,20355,40739,17198,64280,10935,5329,5606
54620,84646,20357,40742,17199,64289,10936,5330,5606
54625,84650,20357,40743,17199,64292,10936,5330,5606
54630,84660,20359,40746,17201,64300,10937,5330,5607
54635,84666,20359,40749,17201,64306,10939,5332,5607
54640,84677,20362,40754,17203,64313,10940,5332,5608
54645,84681,20365,40757,17206,64316,10940,5332,5608
54650,84691,20367,40762,17207,64323,10941,5333,5608
54655,84697,20368,40767,17208,64329,10943,5335,5608
54660,84708,20371,40777,17211,64333,10944,5336,5608
54665,84712,20374,40778,17214,64338,10944,5336,5608
54670,84722,20376,40785,17215,64345,10945,5337,5608
54675,84728,20378,40787,17217,64349,10947,5337,5610
54680,84739,20380,40791,17218,64357,10948,5337,5611
54685,84743,20382,40794,17220,64361,10948,5337,5611
54690,84753,20385,40800,17223,64367,10949,5337,5612
54695,84759,20386,40803,17224,64372,10951,5338,5613
54700,84770,20390,40808,17227,64378,10952,5338,5614
54705,84774,20392,40811,17229,64382,10952,5338,5614
54710,84784,20395,40818,17232,64388,10953,5338,5615
54715,84790,20396,40820,17233,64393,10955,5338,5617
54720,84801,20399,40828,17236,64399,10956,5339,5617
54725,84805,20401,40829,17238,64404,10956,5339,5617
54730,84815,20403,40834,17240,64412,10957,5340,5617
54735,84821,20404,40836,17241,64416,10959,5340,5619
54740,84832,20407,40842,17244,64425,10960,5341,5619
54745,84836,20408,40844,17245,64428,10960,5341,5619
54750,84846,20410,40848,17246,64435,10961,5342,5619
54755,84852,20411,40850,17247,64441,10963,5342,5621
54760,84863,20413,40854,17249,64448,10964,5342,5622
54765,84867,20413,40855,17249,64453,10964,5342,5622
54770,84877,20415,40857,17250,64462,10965,5342,5623
54775,84883,20415,40859,17250,64468,10967,5343,5624
54780,84894,20417,40864,17252,64476,10968,5343,5625
54785,84898,20418,40866,17253,64480,10968,5343,5625
54790,84908,20419,40869,17253,64488,10969,5343,5626
54795,84914,20419,40872,17253,64494,10971,5345,5626
54800,84925,20422,40877,17256,64501,10972,5345,5627
54805,84929,20425,40878,17259,64504,10972,5345,5627
54810,84939,20428,40882,17261,64510,10973,5345,5628
54815,84945,20429,40885,17262,64514,10975,5346,5629
54820,84956,20433,40889,17265,64521,10976,5346,5630
54825,84960,20434,40890,17266,64526,10976,5346,5630
54830,84970,20434,40894,17266,64536,10977,5347,5630
54835,84976,20434,40896,17266,64542,10979,5347,5632
54840,84987,20436,40902,17267,64549,10980,5348,5632
54845,84991,20437,40903,17268,64553,10980,5348,5632
54850,85001,20438,40906,17269,64563,10981,5348,5633
54855,85007,20438,40910,17269,64569,10983,5350,5633
54860,85018,20439,40915,17269,64576,10984,5350,5634
54865,85022,20442,40918,17272,64579,10984,5350,5634
54870,85032,20444,40923,17274,64587,10985,5351,5634
54875,85038,20445,40925,17275,64592,10987,5351,5636
54880,85049,20447,40931,17277,64600,10988,5352,5636
54885,85053,20449,40933,17279,64603,10988,5352,5636
54890,85063,20450,40937,17279,64612,10989,5353,5636
54895,85069,20452,40941,17281,64616,10991,5353,5638
54900,85080,20455,40950,17284,64623,10992,5354,5638
54905,85084,20458,40953,17287,64625,10992,5354,5638
54910,85094,20460,40958,17289,64634,10993,5354,5639
54915,85100,20461,40960,17290,64639,10995,5355,5640
54920,85111,20462,40964,17290,64646,10996,5356,5640
54925,85115,20465,40966,17293,64650,10996,5356,5640
54930,85125,20467,40968,17295,64658,10997,5356,5641
54935,85131,20467,40971,17295,64664,10999,5357,5642
54940,85142,20468,40977,17296,64671,11000,5358,5642
54945,85146,20471,40979,17299,64675,11000,5358,5642
54950,85156,20474,40982,17300,64682,11001,5358,5643
54955,85162,20474,40984,17300,64687,11003,5359,5644
54960,85173,20478,40991,17304,64693,11004,5360,5644
54965,85177,20481,40994,17307,64696,11004,5360,5644
54970,85187,20484,40999,17310,64703,11005,5360,5645
54975,85193,20484,41002,17310,64708,11007,5361,5646
54980,85204,20489,41008,17314,64713,11008,5361,5647
54985,85208,20491,41009,17316,64717,11008,5361,5647
54990,85218,20493,41015,17318,64724,11009,5361,5648
54995,85224,20495,41019,17320,64728,11011,5363,5648
55000,85235,20501,41027,17325,64731,11012,5363,5649
55005,85239,20504,41029,17328,64735,11012,5363,5649
55010,85249,20506,41035,17329,64743,11013,5363,5650
55015,85255,20507,41037,17330,64747,11015,5363,5652
55020,85266,20509,41043,17332,64754,11016,5363,5653
55025,85270,20511,41045,17334,64758,11016,5363,5653
55030,85280,20515,41047,17337,64765,11017,5363,5654
55035,85286,20515,41049,17337,64770,11019,5364,5655
55040,85297,20518,41056,17340,64777,11020,5365,5655
55045,85301,20520,41057,17342,64781,11020,5365,5655
55050,85311,20524,41063,17344,64786,11021,5366,5655
55055,85317,20525,41066,17345,64790,11023,5367,5656
55060,85328,20529,41075,17349,64796,11024,5368,5656
55065,85332,20530,41077,17350,64802,11024,5368,5656
55070,85342,20531,41083,17351,64810,11025,5369,5656
55075,85348,20532,41087,17352,64815,11027,5371,5656
55080,85359,20533,41094,17353,64824,11028,5372,5656
55085,85363,20533,41097,17353,64830,11028,5372,5656
55090,85373,20534,41101,17353,64838,11029,5373,5656
55095,85379,20535,41106,17354,64843,11031,5374,5657
55100,85390,20536,41111,17355,64853,11032,5375,5657
55105,85394,20536,41112,17355,64858,11032,5375,5657
55110,85404,20537,41119,17355,64866,11033,5376,5657
55115,85410,20538,41119,17356,64872,11035,5376,5659
55120,85421,20540,41124,17357,64880,11036,5377,5659
55125,85425,20541,41125,17358,64884,11036,5377,5659
55130,85435,20542,41128,17359,64892,11037,5377,5660
55135,85441,20543,41131,17360,64898,11039,5379,5660
55140,85452,20544,41135,17360,64907,11040,5380,5660
55145,85456,20546,41138,17362,64910,11040,5380,5660
55150,85466,20548,41142,17363,64918,11041,5380,5661
55155,85472,20549,41144,17364,64923,11043,5381,5662
55160,85483,20550,41149,17365,64931,11044,5381,5663
55165,85487,20553,41152,17368,64934,11044,5381,5663
55170,85497,20555,41155,17369,64941,11045,5381,5664
55175,85503,20557,41159,17371,64945,11047,5382,5665
55180,85514,20560,41162,17373,64953,11048,5382,5666
55185,85518,20562,41164,17375,64956,11048,5382,5666
55190,85528,20566,41167,17377,64962,11049,5382,5667
55195,85534,20566,41169,17377,64967,11051,5383,5668
55200,85545,20569,41173,17379,64975,11052,5383,5669
55205,85549,20571,41174,17381,64978,11052,5383,5669
55210,85559,20574,41178,17383,64985,11053,5383,5670
55215,85565,20574,41181,17383,64990,11055,5385,5670
55220,85576,20576,41182,17384,65000,11056,5386,5670
55225,85580,20578,41185,17386,65001,11056,5386,5670
55230,85590,20583,41189,17390,65006,11057,5386,5671
55235,85596,20585,41192,17392,65010,11059,5387,5672
55240,85607,20588,41195,17395,65018,11060,5387,5673
55245,85611,20590,41196,17397,65021,11060,5387,5673
55250,85621,20592,41199,17398,65028,11061,5388,5673
55255,85627,20593,41202,17399,65033,11063,5390,5673
55260,85638,20599,41207,17404,65038,11064,5390,5674
55265,85642,20601,41209,17406,65040,11064,5390,5674
55270,85652,20608,41213,17411,65044,11065,5390,5675
55275,85658,20609,41217,17412,65046,11067,5390,5677
55280,85669,20614,41223,17416,65051,11068,5391,5677
55285,85673,20620,41226,17422,65053,11068,5391,5677
55290,85683,20622,41231,17423,65060,11069,5391,5678
55295,85689,20624,41235,17425,65064,11071,5393,5678
55300,85700,20626,41240,17427,65073,11072,5393,5679
55305,85704,20626,41242,17427,65077,11072,5393,5679
55310,85714,20629,41247,17430,65085,11073,5393,5680
55315,85720,20629,41248,17430,65090,11075,5393,5682
55320,85731,20631,41253,17431,65098,11076,5394,5682
55325,85735,20633,41254,17433,65102,11076,5394,5682
55330,85745,20634,41262,17433,65110,11077,5395,5682
55335,85751,20634,41265,17433,65117,11079,5396,5683
55340,85762,20634,41268,17433,65127,11080,5397,5683
55345,85766,20634,41268,17433,65132,11080,5397,5683
55350,85776,20635,41275,17433,65140,11081,5398,5683
55355,85782,20636,41279,17434,65146,11083,5399,5684
55360,85793,20636,41284,17434,65156,11084,5399,5685
55365,85797,20637,41285,17435,65160,11084,5399,5685
55370,85807,20638,41289,17436,65168,11085,5399,5686
55375,85813,20638,41293,17436,65175,11087,5401,5686
55380,85824,20638,41297,17436,65185,11088,5401,5687
55385,85828,20638,41299,17436,65190,11088,5401,5687
55390,85838,20640,41302,17436,65197,11089,5402,5687
55395,85844,20640,41304,17436,65204,11091,5403,5688
55400,85855,20641,41309,17437,65213,11092,5403,5689
55405,85859,20642,41311,17438,65217,11092,5403,5689
55410,85869,20644,41314,17438,65225,11093,5404,5689
55415,85875,20645,41317,17439,65230,11095,5405,5690
55420,85886,20646,41321,17440,65239,11096,5406,5690
55425,85890,20647,41325,17441,65242,11096,5406,5690
55430,85900,20650,41327,17443,65250,11097,5406,5691
55435,85906,20651,41330,17444,65253,11099,5406,5693
55440,85917,20657,41333,17449,65260,11100,5406,5694
55445,85921,20658,41335,17450,65262,11100,5406,5694
55450,85931,20663,41339,17455,65268,11101,5406,5695
55455,85937,20664,41342,17456,65271,11103,5406,5697
55460,85948,20670,41350,17462,65275,11104,5407,5697
55465,85952,20673,41350,17465,65279,11104,5407,5697
55470,85962,20676,41354,17467,65285,11105,5408,5697
55475,85968,20678,41357,17469,65289,11107,5409,5698
55480,85979,20681,41360,17471,65297,11108,5410,5698
55485,85983,20683,41362,17473,65299,11108,5410,5698
55490,85993,20687,41366,17476,65305,11109,5411,5698
55495,85999,20689,41370,17478,65308,11111,5412,5699
55500,86010,20695,41377,17484,65313,11112,5413,5699
55505,86014,20698,41379,17487,65315,11112,5413,5699
55510,86024,20699,41383,17488,65325,11113,5414,5699
55515,86030,20699,41388,17488,65329,11115,5416,5699
55520,86041,20700,41392,17488,65340,11116,5416,5700
55525,86045,20702,41395,17490,65342,11116,5416,5700
55530,86055,20703,41400,17491,65351,11117,5417,5700
55535,86061,20704,41405,17492,65356,11119,5419,5700
55540,86072,20706,41412,17493,65365,11120,5420,5700
55545,86076,20708,41415,17495,65368,11120,5420,5700
55550,86086,20709,41419,17496,65376,11121,5420,5701
55555,86092,20710,41422,17497,65381,11123,5421,5702
55560,86103,20712,41429,17498,65389,11124,5422,5702
55565,86107,20714,41431,17500,65393,11124,5422,5702
55570,86117,20715,41435,17501,65402,11125,5422,5703
55575,86123,20715,41439,17501,65408,11127,5422,5705
55580,86134,20716,41443,17501,65416,11128,5422,5706
55585,86138,20717,41444,17502,65421,11128,5422,5706
55590,86148,20717,41448,17502,65431,11129,5422,5707
55595,86154,20717,41450,17502,65437,11131,5423,5708
55600,86165,20717,41452,17502,65448,11132,5424,5708
55605,86169,20717,41453,17502,65452,11132,5424,5708
55610,86179,20718,41457,17502,65460,11133,5424,5709
55615,86185,20719,41460,17503,65466,11135,5425,5710
55620,86196,20719,41466,17503,65475,11136,5425,5711
55625,86200,20720,41467,17504,65479,11136,5425,5711
55630,86210,20723,41470,17507,65487,11137,5425,5712
55635,86216,20724,41475,17508,65491,11139,5427,5712
55640,86227,20728,41484,17512,65495,11140,5427,5713
55645,86231,20731,41488,17515,65499,11140,5427,5713
55650,86241,20734,41493,17517,65506,11141,5428,5713
55655,86247,20734,41495,17517,65513,11143,5428,5715
55660,86258,20736,41501,17519,65519,11144,5428,5716
55665,86262,20738,41503,17521,65524,11144,5428,5716
55670,86272,20740,41507,17522,65531,11145,5428,5717
55675,86278,20741,41510,17523,65537,11147,5429,5718
55680,86289,20743,41514,17525,65545,11148,5430,5718
55685,86293,20745,41518,17527,65546,11148,5430,5718
55690,86303,20753,41523,17533,65550,11149,5431,5718
55695,86309,20754,41527,17534,65553,11151,5432,5719
55700,86320,20759,41532,17538,65558,11152,5432,5720
55705,86324,20763,41534,17542,65561,11152,5432,5720
55710,86334,20765,41537,17543,65569,11153,5432,5721
55715,86340,20766,41543,17544,65572,11155,5434,5721
55720,86351,20768,41548,17545,65581,11156,5434,5722
55725,86355,20769,41548,17546,65586,11156,5434,5722
55730,86365,20772,41555,17549,65592,11157,5435,5722
55735,86371,20774,41558,17551,65597,11159,5437,5722
55740,86382,20776,41562,17553,65604,11160,5437,5723
55745,86386,20777,41563,17554,65608,11160,5437,5723
55750,86396,20779,41569,17556,65616,11161,5438,5723
55755,86402,20781,41572,17558,65621,11163,5439,5724
55760,86413,20783,41577,17559,65628,11164,5440,5724
55765,86417,20785,41580,17561,65632,11164,5440,5724
55770,86427,20788,41585,17564,65639,11165,5440,5725
55775,86433,20788,41589,17564,65645,11167,5442,5725
55780,86444,20790,41595,17565,65652,11168,5443,5725
55785,86448,20792,41596,17567,65656,11168,5443,5725
55790,86458,20794,41599,17568,65664,11169,5443,5726
55795,86464,20794,41600,17568,65670,11171,5443,5728
55800,86475,20796,41604,17569,65679,11172,5444,5728
55805,86479,20797,41606,17570,65682,11172,5444,5728
55810,86489,20799,41607,17570,65690,11173,5444,5729
55815,86495,20799,41609,17570,65695,11175,5445,5730
55820,86506,20801,41613,17572,65704,11176,5445,5731
55825,86510,20802,41614,17573,65708,11176,5445,5731
55830,86520,20804,41621,17575,65715,11177,5446,5731
55835,86526,20804,41622,17575,65722,11179,5446,5733
55840,86537,20806,41627,17577,65729,11180,5446,5734
55845,86541,20807,41630,17578,65734,11180,5446,5734
55850,86551,20809,41633,17580,65742,11181,5446,5735
55855,86557,20810,41637,17581,65746,11183,5447,5736
55860,86568,20812,41643,17583,65754,11184,5448,5736
55865,86572,20813,41646,17584,65758,11184,5448,5736
55870,86582,20816,41649,17585,65766,11185,5449,5736
55875,86588,20816,41651,17585,65771,11187,5450,5737
55880,86599,20820,41655,17589,65779,11188,5450,5738
55885,86603,20820,41657,17589,65781,11188,5450,5738
55890,86613,20827,41663,17595,65785,11189,5450,5739
55895,86619,20828,41667,17596,65789,11191,5452,5739
55900,86630,20832,41675,17600,65795,11192,5453,5739
55905,86634,20835,41678,17603,65798,11192,5453,5739
55910,86644,20840,41683,17607,65804,11193,5454,5739
55915,86650,20841,41687,17608,65809,11195,5455,5740
55920,86661,20842,41689,17608,65818,11196,5455,5741
55925,86665,20843,41692,17609,65822,11196,5455,5741
55930,86675,20844,41695,17609,65831,11197,5455,5742
55935,86681,20845,41698,17610,65836,11199,5457,5742
55940,86692,20847,41702,17611,65844,11200,5458,5742
55945,86696,20848,41704,17612,65848,11200,5458,5742
55950,86706,20850,41709,17613,65855,11201,5458,5743
55955,86712,20852,41712,17615,65860,11203,5458,5745
55960,86723,20855,41720,17618,65865,11204,5458,5746
55965,86727,20858,41720,17621,65869,11204,5458,5746
55970,86737,20860,41723,17622,65876,11205,5458,5747
55975,86743,20862,41726,17624,65881,11207,5459,5748
55980,86754,20865,41733,17627,65887,11208,5460,5748
55985,86758,20868,41735,17630,65890,11208,5460,5748
55990,86768,20870,41740,17631,65898,11209,5460,5749
55995,86774,20871,41744,17632,65903,11211,5461,5750
56000,86785,20873,41751,17634,65909,11212,5461,5751
56005,86789,20875,41753,17636,65914,11212,5461,5751
56010,86799,20878,41758,17638,65921,11213,5461,5752
56015,86805,20878,41759,17638,65927,11215,5462,5753
56020,86816,20881,41762,17640,65934,11216,5462,5754
56025,86820,20884,41764,17643,65936,11216,5462,5754
56030,86830,20890,41770,17647,65939,11217,5463,5754
56035,86836,20892,41774,17649,65942,11219,5464,5755
56040,86847,20898,41780,17654,65947,11220,5465,5755
56045,86851,20900,41782,17656,65949,11220,5465,5755
56050,86861,20904,41785,17659,65957,11221,5465,5756
56055,86867,20905,41789,17660,65960,11223,5465,5758
56060,86878,20907,41793,17662,65969,11224,5465,5759
56065,86882,20908,41796,17663,65974,11224,5465,5759
56070,86892,20910,41799,17664,65982,11225,5465,5760
56075,86898,20910,41801,17664,65988,11227,5466,5761
56080,86909,20912,41807,17666,65995,11228,5467,5761
56085,86913,20913,41809,17667,65999,11228,5467,5761
56090,86923,20915,41813,17667,66008,11229,5468,5761
56095,86929,20915,41816,17667,66013,11231,5470,5761
56100,86940,20917,41825,17669,66019,11232,5471,5761
56105,86944,20919,41826,17671,66025,11232,5471,5761
56110,86954,20920,41832,17671,66034,11233,5471,5762
56115,86960,20920,41835,17671,66040,11235,5473,5762
56120,86971,20921,41837,17672,66050,11236,5473,5763
56125,86975,20921,41840,17672,66054,11236,5473,5763
56130,86985,20922,41844,17672,66063,11237,5474,5763
56135,86991,20922,41845,17672,66069,11239,5474,5765
56140,87002,20922,41852,17672,66078,11240,5475,5765
56145,87006,20922,41854,17672,66084,11240,5475,5765
56150,87016,20924,41859,17673,66091,11241,5476,5765
56155,87022,20925,41863,17674,66095,11243,5477,5766
56160,87033,20930,41870,17678,66100,11244,5478,5766
56165,87037,20934,41873,17682,66101,11244,5478,5766
56170,87047,20935,41876,17683,66112,11245,5478,5767
56175,87053,20935,41879,17683,66118,11247,5479,5768
56180,87064,20937,41884,17685,66126,11248,5479,5769
56185,87068,20937,41885,17685,66131,11248,5479,5769
56190,87078,20937,41890,17685,66140,11249,5479,5770
56195,87084,20937,41893,17685,66147,11251,5480,5771
56200,87095,20938,41896,17685,66157,11252,5480,5772
56205,87099,20938,41900,17685,66161,11252,5480,5772
56210,87109,20940,41905,17687,66169,11253,5481,5772
56215,87115,20941,41909,17688,66174,11255,5483,5772
56220,87126,20943,41914,17689,66181,11256,5484,5772
56225,87130,20945,41918,17691,66185,11256,5484,5772
56230,87140,20947,41923,17693,66192,11257,5484,5773
56235,87146,20949,41927,17695,66197,11259,5485,5774
56240,87157,20950,41930,17696,66206,11261,5486,5775
56245,87161,20950,41934,17696,66211,11261,5486,5775
56250,87171,20953,41938,17698,66217,11262,5486,5776
56255,87177,20953,41940,17698,66224,11264,5487,5777
56260,87188,20955,41947,17700,66231,11266,5489,5777
56265,87192,20956,41950,17701,66236,11266,5489,5777
56270,87202,20957,41954,17701,66244,11267,5489,5778
56275,87208,20958,41956,17702,66250,11269,5490,5779
56280,87219,20961,41960,17704,66257,11271,5491,5780
56285,87223,20963,41962,17706,66259,11271,5491,5780
56290,87233,20967,41967,17709,66265,11272,5492,5780
56295,87239,20969,41970,17711,66270,11274,5494,5780
56300,87250,20973,41977,17715,66274,11275,5495,5780
56305,87254,20976,41979,17718,66277,11275,5495,5780
56310,87264,20982,41985,17723,66281,11276,5496,5780
56315,87270,20983,41987,17724,66285,11278,5496,5782
56320,87281,20988,41993,17728,66289,11279,5497,5782
56325,87285,20992,41995,17732,66292,11279,5497,5782
56330,87295,20999,42004,17738,66295,11280,5498,5782
56335,87301,21000,42005,17739,66301,11282,5499,5783
56340,87312,21002,42010,17740,66307,11283,5499,5784
56345,87316,21002,42011,17740,66314,11283,5499,5784
56350,87326,21003,42017,17741,66322,11284,5500,5784
56355,87332,21004,42021,17742,66327,11286,5501,5785
56360,87343,21005,42028,17743,66334,11287,5502,5785
56365,87347,21006,42032,17744,66340,11287,5502,5785
56370,87357,21008,42034,17745,66348,11288,5502,5786
56375,87363,21008,42036,17745,66355,11290,5503,5787
56380,87374,21011,42045,17747,66359,11291,5504,5787
56385,87378,21013,42045,17749,66365,11291,5504,5787
56390,87388,21016,42051,17751,66371,11292,5504,5788
56395,87394,21017,42053,17752,66377,11294,5505,5789
56400,87405,21019,42057,17754,66384,11295,5505,5790
56405,87409,21020,42058,17755,66389,11295,5505,5790
56410,87419,21023,42065,17758,66395,11296,5505,5791
56415,87425,21025,42069,17760,66400,11298,5506,5792
56420,87436,21027,42076,17762,66406,11299,5507,5792
56425,87440,21029,42077,17764,66411,11299,5507,5792
56430,87450,21031,42081,17766,66418,11300,5507,5793
56435,87456,21031,42083,17766,66425,11302,5508,5794
56440,87467,21035,42089,17770,66429,11303,5508,5795
56445,87471,21038,42091,17773,66432,11303,5508,5795
56450,87481,21041,42095,17776,66439,11304,5509,5795
56455,87487,21042,42099,17777,66444,11306,5510,5796
56460,87498,21047,42105,17781,66448,11307,5510,5797
56465,87502,21049,42108,17783,66452,11307,5510,5797
56470,87512,21052,42112,17786,66459,11308,5510,5798
56475,87518,21052,42114,17786,66465,11310,5510,5800
56480,87529,21055,42119,17789,66471,11311,5511,5800
56485,87533,21057,42122,17791,66475,11311,5511,5800
56490,87543,21060,42130,17794,66482,11312,5512,5800
56495,87549,21062,42135,17796,66487,11314,5514,5800
56500,87560,21064,42140,17798,66494,11315,5514,5801
56505,87564,21065,42142,17799,66498,11315,5514,5801
56510,87574,21070,42147,17803,66503,11316,5514,5802
56515,87580,21071,42152,17804,66508,11318,5516,5802
56520,87591,21074,42157,17807,66516,11319,5517,5802
56525,87595,21074,42157,17807,66521,11319,5517,5802
56530,87605,21075,42162,17807,66529,11320,5517,5803
56535,87611,21076,42166,17808,66534,11322,5519,5803
56540,87622,21077,42170,17809,66544,11323,5520,5803
56545,87626,21077,42172,17809,66549,11323,5520,5803
56550,87636,21078,42179,17809,66557,11324,5521,5803
56555,87642,21078,42180,17809,66564,11326,5522,5804
56560,87653,21078,42183,17809,66574,11327,5522,5805
56565,87657,21078,42184,17809,66579,11327,5522,5805
56570,87667,21081,42191,17812,66585,11328,5522,5806
56575,87673,21082,42195,17813,66590,11330,5524,5806
56580,87684,21084,42201,17815,66599,11331,5525,5806
56585,87688,21085,42203,17816,66603,11331,5525,5806
56590,87698,21088,42208,17818,66609,11332,5526,5806
56595,87704,21089,42209,17819,66615,11334,5526,5808
56600,87715,21091,42214,17820,66621,11335,5526,5809
56605,87719,21092,42217,17821,66627,11335,5526,5809
56610,87729,21095,42221,17824,66633,11336,5526,5810
56615,87735,21095,42225,17824,66639,11338,5528,5810
56620,87746,21096,42229,17825,66647,11339,5528,5811
56625,87750,21099,42231,17828,66651,11339,5528,5811
56630,87760,21103,42238,17832,66656,11340,5529,5811
56635,87766,21105,42242,17834,66660,11342,5530,5812
56640,87777,21108,42250,17837,66666,11343,5531,5812
56645,87781,21111,42251,17840,66669,11343,5531,5812
56650,87791,21114,42257,17843,66676,11344,5532,5812
56655,87797,21114,42261,17843,66681,11346,5533,5813
56660,87808,21117,42267,17845,66688,11347,5533,5814
56665,87812,21119,42271,17847,66692,11347,5533,5814
56670,87822,21121,42277,17849,66700,11348,5534,5814
56675,87828,21121,42279,17849,66707,11350,5535,5815
56680,87839,21123,42287,17851,66713,11351,5535,5816
56685,87843,21125,42289,17853,66717,11351,5535,5816
56690,87853,21127,42294,17855,66725,11352,5536,5816
56695,87859,21127,42297,17855,66731,11354,5537,5817
56700,87870,21131,42301,17858,66737,11355,5537,5818
56705,87874,21132,42304,17859,66742,11355,5537,5818
56710,87884,21133,42309,17859,66750,11356,5537,5819
56715,87890,21133,42312,17859,66756,11358,5537,5821
56720,87901,21135,42317,17861,66765,11359,5538,5821
56725,87905,21135,42318,17861,66770,11359,5538,5821
56730,87915,21136,42322,17861,66778,11360,5538,5822
56735,87921,21136,42323,17861,66785,11362,5538,5824
56740,87932,21137,42328,17862,66792,11363,5539,5824
56745,87936,21138,42329,17863,66798,11363,5539,5824
56750,87946,21140,42335,17863,66805,11364,5540,5824
56755,87952,21140,42336,17863,66812,11366,5541,5825
56760,87963,21142,42341,17865,66818,11367,5541,5826
56765,87967,21144,42344,17867,66822,11367,5541,5826
56770,87977,21147,42350,17870,66829,11368,5541,5827
56775,87983,21149,42355,17872,66833,11370,5542,5828
56780,87994,21151,42361,17874,66838,11371,5542,5829
56785,87998,21153,42363,17876,66845,11371,5542,5829
56790,88008,21155,42369,17878,66852,11372,5542,5830
56795,88014,21155,42369,17878,66859,11374,5542,5832
56800,88025,21156,42373,17879,66868,11375,5543,5832
56805,88029,21156,42374,17879,66873,11375,5543,5832
56810,88039,21161,42380,17882,66876,11376,5544,5832
56815,88045,21164,42382,17885,66881,11378,5545,5833
56820,88056,21167,42388,17887,66885,11379,5545,5834
56825,88060,21171,42390,17891,66888,11379,5545,5834
56830,88070,21176,42395,17895,66893,11380,5545,5835
56835,88076,21178,42397,17897,66898,11382,5545,5837
56840,88087,21181,42401,17899,66904,11383,5545,5838
56845,88091,21182,42402,17900,66908,11383,5545,5838
56850,88101,21185,42407,17902,66915,11384,5545,5839
56855,88107,21185,42409,17902,66922,11386,5547,5839
56860,88118,21187,42416,17903,66930,11387,5548,5839
56865,88122,21188,42420,17904,66934,11387,5548,5839
56870,88132,21190,42425,17906,66941,11388,5548,5840
56875,88138,21191,42425,17907,66947,11390,5548,5842
56880,88149,21193,42426,17908,66955,11391,5548,5843
56885,88153,21193,42427,17908,66960,11391,5548,5843
56890,88163,21195,42431,17909,66967,11392,5548,5844
56895,88169,21197,42436,17911,66972,11394,5550,5844
56900,88180,21198,42442,17911,66981,11395,5551,5844
56905,88184,21199,42444,17912,66985,11395,5551,5844
56910,88194,21201,42448,17913,66992,11396,5551,5845
56915,88200,21201,42450,17913,66999,11398,5551,5847
56920,88211,21203,42456,17915,67006,11399,5551,5848
56925,88215,21204,42457,17916,67011,11399,5551,5848
56930,88225,21206,42461,17918,67018,11400,5552,5848
56935,88231,21206,42463,17918,67024,11402,5553,5849
56940,88242,21210,42467,17921,67030,11403,5553,5850
56945,88246,21212,42470,17923,67033,11403,5553,5850
56950,88256,21217,42476,17926,67038,11404,5554,5850
56955,88262,21218,42478,17927,67044,11406,5555,5851
56960,88273,21221,42483,17929,67050,11407,5556,5851
56965,88277,21221,42484,17929,67056,11407,5556,5851
56970,88287,21223,42485,17929,67063,11408,5556,5852
56975,88293,21224,42490,17930,67067,11410,5557,5853
56980,88304,21229,42496,17934,67072,11411,5557,5854
56985,88308,21230,42496,17935,67078,11411,5557,5854
56990,88318,21234,42505,17938,67083,11412,5558,5854
56995,88324,21235,42507,17939,67089,11414,5560,5854
57000,88335,21237,42513,17941,67096,11415,5561,5854
57005,88339,21239,42516,17943,67099,11415,5561,5854
57010,88349,21243,42521,17945,67105,11416,5561,5855
57015,88355,21243,42523,17945,67111,11418,5562,5856
57020,88366,21246,42531,17948,67116,11419,5562,5857
57025,88370,21248,42533,17950,67122,11419,5562,5857
57030,88380,21252,42540,17954,67127,11420,5563,5857
57035,88386,21254,42545,17956,67130,11422,5565,5857
57040,88397,21257,42548,17958,67138,11423,5565,5858
57045,88401,21259,42549,17960,67141,11423,5565,5858
57050,88411,21261,42553,17962,67149,11424,5566,5858
57055,88417,21261,42554,17962,67155,11426,5566,5860
57060,88428,21265,42560,17966,67160,11427,5566,5861
57065,88432,21267,42562,17968,67165,11427,5566,5861
57070,88442,21270,42565,17969,67171,11428,5567,5861
57075,88448,21270,42567,17969,67177,11430,5568,5862
57080,88459,21273,42571,17972,67183,11431,5568,5863
57085,88463,21275,42574,17974,67188,11431,5568,5863
57090,88473,21279,42578,17976,67193,11432,5568,5864
57095,88479,21280,42583,17977,67199,11434,5570,5864
57100,88490,21283,42588,17980,67204,11435,5570,5865
57105,88494,21284,42590,17981,67210,11435,5570,5865
57110,88504,21288,42595,17984,67215,11436,5571,5865
57115,88510,21289,42598,17985,67220,11438,5571,5867
57120,88521,21291,42603,17987,67227,11439,5572,5867
57125,88525,21292,42606,17988,67232,11439,5572,5867
57130,88535,21294,42612,17990,67240,11440,5573,5867
57135,88541,21295,42616,17991,67246,11442,5574,5868
57140,88552,21296,42620,17992,67255,11443,5574,5869
57145,88556,21296,42622,17992,67260,11443,5574,5869
57150,88566,21297,42626,17992,67268,11444,5574,5870
57155,88572,21298,42629,17993,67274,11446,5576,5870
57160,88583,21298,42635,17993,67283,11447,5576,5871
57165,88587,21299,42637,17994,67288,11447,5576,5871
57170,88597,21300,42641,17995,67296,11448,5576,5872
57175,88603,21300,42643,17995,67303,11450,5577,5873
57180,88614,21300,42649,17995,67313,11451,5577,5874
57185,88618,21300,42650,17995,67318,11451,5577,5874
57190,88628,21301,42656,17996,67326,11452,5578,5874
57195,88634,21302,42660,17997,67331,11454,5579,5875
57200,88645,21303,42665,17998,67340,11455,5580,5875
57205,88649,21304,42666,17999,67345,11455,5580,5875
57210,88659,21305,42670,17999,67353,11456,5580,5876
57215,88665,21307,42673,18001,67358,11458,5582,5876
57220,88676,21309,42677,18002,67365,11459,5582,5877
57225,88680,21310,42678,18003,67370,11459,5582,5877
57230,88690,21313,42682,18005,67376,11460,5583,5877
57235,88696,21314,42683,18006,67382,11462,5584,5878
57240,88707,21317,42690,18008,67386,11463,5585,5878
57245,88711,21322,42692,18013,67388,11463,5585,5878
57250,88721,21328,42697,18018,67392,11464,5585,5879
57255,88727,21328,42702,18018,67396,11466,5586,5880
57260,88738,21334,42708,18023,67402,11467,5586,5881
57265,88742,21336,42709,18025,67405,11467,5586,5881
57270,88752,21341,42716,18029,67410,11468,5587,5881
57275,88758,21341,42719,18029,67415,11470,5587,5883
57280,88769,21343,42725,18031,67424,11471,5587,5884
57285,88773,21343,42727,18031,67430,11471,5587,5884
57290,88783,21344,42730,18032,67438,11472,5587,5885
57295,88789,21344,42731,18032,67445,11474,5587,5887
57300,88800,21346,42735,18033,67453,11475,5588,5887
57305,88804,21346,42735,18033,67458,11475,5588,5887
57310,88814,21347,42741,18034,67466,11476,5589,5887
57315,88820,21347,42744,18034,67473,11478,5591,5887
57320,88831,21348,42752,18035,67480,11479,5592,5887
57325,88835,21349,42755,18036,67486,11479,5592,5887
57330,88845,21350,42759,18037,67494,11480,5593,5887
57335,88851,21350,42760,18037,67501,11482,5594,5888
57340,88862,21351,42762,18037,67510,11483,5594,5889
57345,88866,21352,42765,18038,67514,11483,5594,5889
57350,88876,21354,42771,18040,67521,11484,5595,5889
57355,88882,21356,42774,18042,67526,11486,5596,5890
57360,88893,21359,42780,18045,67531,11487,5596,5891
57365,88897,21359,42780,18045,67538,11487,5596,5891
57370,88907,21361,42786,18046,67545,11488,5597,5891
57375,88913,21363,42789,18048,67550,11490,5599,5891
57380,88924,21367,42794,18051,67554,11491,5599,5892
57385,88928,21368,42796,18052,67559,11491,5599,5892
57390,88938,21372,42800,18054,67566,11492,5600,5892
57395,88944,21372,42803,18054,67571,11494,5601,5893
57400,88955,21376,42808,18057,67577,11495,5602,5893
57405,88959,21377,42809,18058,67582,11495,5602,5893
57410,88969,21381,42814,18062,67588,11496,5602,5894
57415,88975,21382,42818,18063,67593,11498,5604,5894
57420,88986,21384,42820,18064,67600,11499,5604,5895
57425,88990,21385,42822,18065,67605,11499,5604,5895
57430,89000,21391,42827,18070,67609,11500,5604,5896
57435,89006,21391,42829,18070,67615,11502,5605,5897
57440,89017,21394,42834,18072,67620,11503,5606,5897
57445,89021,21396,42836,18074,67624,11503,5606,5897
57450,89031,21400,42840,18077,67630,11504,5607,5897
57455,89037,21401,42842,18078,67635,11506,5607,5899
57460,89048,21407,42851,18084,67639,11507,5608,5899
57465,89052,21408,42853,18085,67644,11507,5608,5899
57470,89062,21412,42859,18089,67649,11508,5609,5899
57475,89068,21413,42862,18090,67654,11510,5611,5899
57480,89079,21417,42866,18094,67661,11511,5611,5900
57485,89083,21417,42866,18094,67666,11511,5611,5900
57490,89093,21420,42870,18097,67673,11512,5611,5901
57495,89099,21421,42873,18098,67677,11514,5612,5902
57500,89110,21424,42878,18101,67684,11515,5612,5903
57505,89114,21426,42879,18103,67688,11515,5612,5903
57510,89124,21430,42885,18107,67693,11516,5613,5903
57515,89130,21432,42887,18109,67697,11518,5613,5905
57520,89141,21436,42892,18113,67704,11519,5613,5906
57525,89145,21437,42894,18114,67708,11519,5613,5906
57530,89155,21440,42900,18117,67714,11520,5613,5907
57535,89161,21442,42903,18119,67717,11522,5613,5909
57540,89172,21445,42906,18122,67726,11523,5614,5909
57545,89176,21445,42910,18122,67730,11523,5614,5909
57550,89186,21446,42915,18122,67739,11524,5614,5910
57555,89192,21447,42919,18123,67743,11526,5615,5911
57560,89203,21448,42925,18124,67753,11527,5616,5911
57565,89207,21448,42928,18124,67758,11527,5616,5911
57570,89217,21449,42931,18124,67767,11528,5616,5912
57575,89223,21451,42936,18126,67770,11530,5617,5913
57580,89234,21451,42942,18126,67781,11531,5617,5914
57585,89238,21452,42945,18127,67786,11531,5617,5914
57590,89248,21453,42949,18127,67795,11532,5617,5915
57595,89254,21454,42954,18128,67799,11534,5619,5915
57600,89265,21455,42959,18129,67808,11535,5620,5915
57605,89269,21455,42961,18129,67813,11535,5620,5915
57610,89279,21456,42964,18129,67823,11536,5620,5916
57615,89285,21456,42967,18129,67828,11538,5621,5917
57620,89296,21457,42972,18130,67837,11539,5621,5918
57625,89300,21457,42974,18130,67843,11539,5621,5918
57630,89310,21458,42977,18130,67852,11540,5621,5919
57635,89316,21459,42980,18131,67857,11542,5621,5921
57640,89327,21461,42984,18132,67863,11543,5622,5921
57645,89331,21462,42985,18133,67868,11543,5622,5921
57650,89341,21465,42989,18134,67876,11544,5622,5922
57655,89347,21465,42992,18134,67881,11546,5623,5923
57660,89358,21469,42995,18137,67888,11547,5624,5923
57665,89362,21469,42997,18137,67893,11547,5624,5923
57670,89372,21472,43000,18138,67900,11548,5624,5924
57675,89378,21473,43004,18139,67904,11550,5626,5924
57680,89389,21478,43009,18143,67909,11551,5626,5925
57685,89393,21478,43010,18143,67915,11551,5626,5925
57690,89403,21481,43016,18145,67921,11552,5627,5925
57695,89409,21482,43018,18146,67926,11554,5627,5927
57700,89420,21485,43023,18148,67931,11555,5628,5927
57705,89424,21487,43024,18150,67937,11555,5628,5927
57710,89434,21490,43029,18152,67944,11556,5628,5928
57715,89440,21490,43031,18152,67950,11558,5629,5929
57720,89451,21491,43035,18153,67956,11559,5629,5930
57725,89455,21493,43038,18155,67961,11559,5629,5930
57730,89465,21496,43041,18156,67969,11560,5630,5930
57735,89471,21497,43045,18157,67974,11562,5631,5931
57740,89482,21500,43050,18160,67981,11563,5631,5932
57745,89486,21501,43052,18161,67984,11563,5631,5932
57750,89496,21504,43057,18164,67991,11564,5631,5933
57755,89502,21504,43062,18164,67996,11566,5633,5933
57760,89513,21510,43071,18169,68001,11567,5634,5933
57765,89517,21513,43074,18172,68003,11567,5634,5933
57770,89527,21518,43079,18177,68009,11568,5635,5933
57775,89533,21518,43082,18177,68013,11570,5635,5935
57780,89544,21523,43090,18182,68020,11571,5635,5936
57785,89548,21525,43094,18184,68022,11571,5635,5936
57790,89558,21529,43100,18188,68028,11572,5635,5937
57795,89564,21529,43102,18188,68035,11574,5636,5938
57800,89575,21531,43108,18189,68043,11575,5637,5938
57805,89579,21532,43110,18190,68047,11575,5637,5938
57810,89589,21533,43115,18191,68056,11576,5638,5938
57815,89595,21533,43119,18191,68061,11578,5640,5938
57820,89606,21534,43126,18192,68072,11579,5641,5938
57825,89610,21534,43129,18192,68076,11579,5641,5938
57830,89620,21534,43135,18192,68085,11580,5642,5938
57835,89626,21534,43138,18192,68091,11582,5644,5938
57840,89637,21535,43142,18193,68101,11583,5644,5939
57845,89641,21535,43144,18193,68105,11583,5644,5939
57850,89651,21537,43148,18195,68113,11584,5644,5940
57855,89657,21539,43152,18197,68116,11586,5645,5941
57860,89668,21540,43158,18197,68124,11587,5646,5941
57865,89672,21542,43160,18199,68130,11587,5646,5941
57870,89682,21544,43165,18201,68138,11588,5646,5942
57875,89688,21544,43167,18201,68143,11590,5646,5944
57880,89699,21546,43172,18202,68152,11591,5646,5945
57885,89703,21547,43174,18203,68155,11591,5646,5945
57890,89713,21550,43176,18205,68163,11592,5646,5946
57895,89719,21551,43180,18206,68167,11594,5647,5947
57900,89730,21554,43186,18208,68174,11595,5648,5947
57905,89734,21556,43187,18210,68177,11595,5648,5947
57910,89744,21559,43193,18212,68184,11596,5649,5947
57915,89750,21560,43194,18213,68190,11598,5649,5949
57920,89761,21562,43201,18214,68196,11599,5650,5949
57925,89765,21564,43203,18216,68201,11599,5650,5949
57930,89775,21568,43209,18219,68206,11600,5651,5949
57935,89781,21568,43211,18219,68213,11602,5652,5950
57940,89792,21569,43221,18220,68219,11603,5653,5950
57945,89796,21570,43223,18221,68226,11603,5653,5950
57950,89806,21571,43228,18222,68234,11604,5653,5951
57955,89812,21571,43232,18222,68240,11606,5654,5952
57960,89823,21573,43237,18224,68249,11607,5655,5952
57965,89827,21573,43238,18224,68254,11607,5655,5952
57970,89837,21574,43243,18225,68263,11608,5656,5952
57975,89843,21574,43243,18225,68269,11610,5656,5954
57980,89854,21576,43247,18226,68278,11611,5657,5954
57985,89858,21577,43250,18227,68280,11611,5657,5954
57990,89868,21579,43257,18229,68289,11612,5658,5954
57995,89874,21579,43259,18229,68294,11614,5658,5956
58000,89885,21582,43266,18231,68300,11615,5659,5956
58005,89889,21583,43266,18232,68306,11615,5659,5956
58010,89899,21584,43268,18232,68315,11616,5659,5957
58015,89905,21584,43273,18232,68319,11618,5661,5957
58020,89916,21589,43279,18236,68326,11619,5662,5957
58025,89920,21590,43281,18237,68330,11619,5662,5957
58030,89930,21592,43286,18239,68337,11620,5662,5958
58035,89936,21592,43290,18239,68343,11622,5663,5959
58040,89947,21596,43298,18243,68350,11623,5664,5959
58045,89951,21596,43299,18243,68355,11623,5664,5959
58050,89961,21600,43303,18246,68361,11624,5664,5960
58055,89967,21600,43307,18246,68366,11626,5666,5960
58060,89978,21604,43310,18249,68374,11627,5667,5960
58065,89982,21605,43312,18250,68376,11627,5667,5960
58070,89992,21608,43314,18252,68384,11628,5667,5961
58075,89998,21609,43316,18253,68389,11630,5667,5963
58080,90009,21613,43325,18257,68393,11631,5668,5963
58085,90013,21616,43326,18260,68397,11631,5668,5963
58090,90023,21618,43333,18262,68404,11632,5669,5963
58095,90029,21620,43337,18264,68408,11634,5670,5964
58100,90040,21622,43340,18265,68418,11635,5670,5965
58105,90044,21622,43342,18265,68422,11635,5670,5965
58110,90054,21623,43346,18266,68431,11636,5670,5966
58115,90060,21623,43348,18266,68437,11638,5671,5967
58120,90071,21625,43353,18268,68445,11639,5672,5967
58125,90075,21626,43355,18269,68449,11639,5672,5967
58130,90085,21628,43360,18271,68457,11640,5673,5967
58135,90091,21628,43364,18271,68462,11642,5675,5967
58140,90102,21629,43370,18272,68471,11643,5675,5968
58145,90106,21630,43372,18273,68476,11643,5675,5968
58150,90116,21632,43379,18275,68483,11644,5676,5968
58155,90122,21634,43382,18277,68488,11646,5678,5968
58160,90133,21636,43387,18278,68495,11647,5679,5968
58165,90137,21637,43389,18279,68500,11647,5679,5968
58170,90147,21640,43396,18282,68507,11648,5680,5968
58175,90153,21641,43401,18283,68511,11650,5682,5968
58180,90164,21643,43406,18285,68521,11651,5683,5968
58185,90168,21643,43407,18285,68525,11651,5683,5968
58190,90178,21646,43409,18286,68532,11652,5683,5969
58195,90184,21646,43412,18286,68537,11654,5685,5969
58200,90195,21649,43417,18289,68544,11655,5686,5969
58205,90199,21651,43419,18291,68547,11655,5686,5969
58210,90209,21655,43422,18293,68553,11656,5686,5970
58215,90215,21655,43423,18293,68560,11658,5687,5971
58220,90226,21657,43427,18295,68568,11659,5687,5972
58225,90230,21658,43429,18296,68571,11659,5687,5972
58230,90240,21659,43432,18297,68581,11660,5688,5972
58235,90246,21659,43433,18297,68586,11662,5688,5974
58240,90257,21660,43435,18297,68595,11663,5688,5975
58245,90261,21660,43437,18297,68600,11663,5688,5975
58250,90271,21661,43440,18297,68610,11664,5688,5976
58255,90277,21661,43445,18297,68615,11666,5690,5976
58260,90288,21663,43450,18298,68623,11667,5690,5977
58265,90292,21664,43451,18299,68627,11667,5690,5977
58270,90302,21665,43457,18299,68637,11668,5691,5977
58275,90308,21665,43460,18299,68643,11670,5693,5977
58280,90319,21666,43464,18299,68652,11671,5693,5978
58285,90323,21666,43467,18299,68656,11671,5693,5978
58290,90333,21668,43473,18300,68665,11672,5694,5978
58295,90339,21668,43475,18300,68671,11674,5695,5979
58300,90350,21670,43482,18302,68677,11675,5695,5980
58305,90354,21671,43482,18303,68683,11675,5695,5980
58310,90364,21672,43485,18303,68692,11676,5695,5981
58315,90370,21672,43487,18303,68697,11678,5695,5983
58320,90381,21675,43490,18305,68705,11679,5695,5984
58325,90385,21675,43490,18305,68710,11679,5695,5984
58330,90395,21677,43496,18306,68718,11680,5696,5984
58335,90401,21677,43498,18306,68724,11682,5697,5985
58340,90412,21678,43502,18306,68732,11683,5697,5986
58345,90416,21680,43505,18308,68735,11683,5697,5986
58350,90426,21683,43512,18311,68743,11684,5698,5986
58355,90432,21683,43516,18311,68749,11686,5700,5986
58360,90443,21685,43521,18313,68757,11687,5701,5986
58365,90447,21686,43524,18314,68760,11687,5701,5986
58370,90457,21689,43530,18317,68768,11688,5702,5986
58375,90463,21689,43531,18317,68773,11690,5702,5988
58380,90474,21692,43538,18320,68782,11691,5702,5989
58385,90478,21693,43540,18321,68785,11691,5702,5989
58390,90488,21697,43545,18324,68791,11692,5703,5989
58395,90494,21698,43549,18325,68795,11694,5705,5989
58400,90505,21703,43555,18330,68801,11695,5705,5990
58405,90509,21705,43558,18332,68803,11695,5705,5990
58410,90519,21711,43563,18336,68807,11696,5706,5990
58415,90525,21713,43566,18338,68811,11698,5706,5992
58420,90536,21716,43571,18341,68820,11699,5706,5993
58425,90540,21716,43574,18341,68824,11699,5706,5993
58430,90550,21719,43581,18343,68830,11700,5706,5994
58435,90556,21720,43583,18344,68836,11702,5706,5996
58440,90567,21722,43587,18345,68845,11703,5707,5996
58445,90571,21722,43588,18345,68849,11703,5707,5996
58450,90581,21723,43594,18346,68857,11704,5707,5997
58455,90587,21724,43596,18347,68863,11706,5708,5998
58460,90598,21725,43600,18348,68873,11707,5708,5999
58465,90602,21725,43601,18348,68877,11707,5708,5999
58470,90612,21727,43604,18350,68884,11708,5708,6000
58475,90618,21729,43606,18352,68889,11710,5708,6002
58480,90629,21731,43612,18353,68897,11711,5708,6003
58485,90633,21731,43613,18353,68902,11711,5708,6003
58490,90643,21734,43617,18356,68908,11712,5708,6004
58495,90649,21736,43620,18358,68912,11714,5709,6005
58500,90660,21738,43627,18360,68919,11715,5709,6006
58505,90664,21739,43629,18361,68925,11715,5709,6006
58510,90674,21742,43637,18364,68932,11716,5710,6006
58515,90680,21742,43639,18364,68937,11718,5711,6007
58520,90691,21743,43643,18365,68947,11719,5711,6008
58525,90695,21745,43645,18367,68950,11719,5711,6008
58530,90705,21749,43649,18370,68955,11720,5711,6009
58535,90711,21750,43652,18371,68959,11722,5712,6010
58540,90722,21753,43659,18374,68965,11723,5712,6011
58545,90726,21755,43661,18376,68971,11723,5712,6011
58550,90736,21758,43666,18379,68978,11724,5712,6012
58555,90742,21758,43670,18379,68983,11726,5714,6012
58560,90753,21760,43673,18380,68992,11727,5714,6013
58565,90757,21761,43674,18381,68996,11727,5714,6013
58570,90767,21763,43678,18381,69004,11728,5714,6014
58575,90773,21763,43681,18381,69008,11730,5714,6016
58580,90784,21765,43686,18383,69019,11731,5715,6016
58585,90788,21765,43688,18383,69023,11731,5715,6016
58590,90798,21767,43692,18384,69030,11732,5716,6016
58595,90804,21767,43695,18384,69036,11734,5717,6017
58600,90815,21769,43700,18386,69043,11735,5717,6018
58605,90819,21770,43702,18387,69049,11735,5717,6018
58610,90829,21772,43707,18387,69056,11736,5717,6019
58615,90835,21772,43711,18387,69061,11738,5717,6021
58620,90846,21775,43716,18390,69070,11739,5717,6022
58625,90850,21775,43717,18390,69075,11739,5717,6022
58630,90860,21777,43718,18390,69083,11740,5717,6023
58635,90866,21777,43721,18390,69089,11742,5719,6023
58640,90877,21778,43725,18390,69097,11743,5720,6023
58645,90881,21779,43726,18391,69102,11743,5720,6023
58650,90891,21781,43731,18393,69110,11744,5721,6023
58655,90897,21781,43733,18393,69115,11746,5721,6025
58660,90908,21783,43740,18395,69124,11747,5722,6025
58665,90912,21785,43743,18397,69126,11747,5722,6025
58670,90922,21789,43744,18399,69133,11748,5722,6026
58675,90928,21789,43746,18399,69139,11750,5724,6026
58680,90939,21792,43755,18402,69144,11751,5725,6026
58685,90943,21795,43756,18405,69148,11751,5725,6026
58690,90953,21799,43761,18407,69153,11752,5726,6026
58695,90959,21801,43764,18409,69158,11754,5728,6026
58700,90970,21804,43770,18412,69163,11755,5728,6027
58705,90974,21805,43772,18413,69169,11755,5728,6027
58710,90984,21807,43775,18414,69177,11756,5728,6028
58715,90990,21807,43776,18414,69183,11758,5729,6029
58720,91001,21811,43783,18418,69188,11759,5729,6030
58725,91005,21812,43784,18419,69193,11759,5729,6030
58730,91015,21814,43788,18420,69200,11760,5729,6031
58735,91021,21815,43791,18421,69205,11762,5730,6032
58740,91032,21818,43795,18423,69212,11763,5730,6033
58745,91036,21821,43798,18426,69213,11763,5730,6033
58750,91046,21827,43804,18432,69219,11764,5730,6034
58755,91052,21827,43806,18432,69225,11766,5732,6034
58760,91063,21828,43813,18432,69235,11767,5732,6035
58765,91067,21828,43815,18432,69239,11767,5732,6035
58770,91077,21828,43820,18432,69249,11768,5733,6035
58775,91083,21828,43825,18432,69254,11770,5735,6035
58780,91094,21829,43831,18432,69265,11771,5736,6035
58785,91098,21829,43832,18432,69269,11771,5736,6035
58790,91108,21829,43837,18432,69278,11772,5736,6036
58795,91114,21829,43838,18432,69285,11774,5736,6038
58800,91125,21830,43844,18432,69295,11775,5737,6038
58805,91129,21830,43847,18432,69299,11775,5737,6038
58810,91139,21830,43851,18432,69308,11776,5737,6039
58815,91145,21830,43856,18432,69314,11778,5739,6039
58820,91156,21831,43862,18433,69325,11779,5740,6039
58825,91160,21831,43864,18433,69329,11779,5740,6039
58830,91170,21831,43866,18433,69339,11780,5741,6039
58835,91176,21831,43869,18433,69345,11782,5743,6039
58840,91187,21832,43873,18434,69355,11783,5744,6039
58845,91191,21832,43877,18434,69359,11783,5744,6039
58850,91201,21832,43880,18434,69368,11784,5744,6040
58855,91207,21832,43885,18434,69372,11786,5746,6040
58860,91218,21838,43892,18439,69378,11787,5747,6040
58865,91222,21840,43893,18441,69381,11787,5747,6040
58870,91232,21844,43896,18444,69387,11788,5747,6041
58875,91238,21846,43901,18446,69389,11790,5748,6042
58880,91249,21852,43907,18452,69395,11791,5749,6042
58885,91253,21853,43910,18453,69400,11791,5749,6042
58890,91263,21855,43917,18455,69407,11792,5750,6042
58895,91269,21857,43923,18457,69410,11794,5752,6042
58900,91280,21861,43931,18461,69417,11795,5753,6042
58905,91284,21861,43933,18461,69423,11795,5753,6042
58910,91294,21864,43939,18464,69430,11796,5753,6043
58915,91300,21865,43942,18465,69434,11798,5754,6044
58920,91311,21866,43946,18466,69444,11799,5755,6044
58925,91315,21867,43948,18467,69448,11799,5755,6044
58930,91325,21869,43955,18469,69456,11800,5756,6044
58935,91331,21869,43958,18469,69461,11802,5757,6045
58940,91342,21872,43965,18472,69469,11803,5758,6045
58945,91346,21873,43967,18473,69473,11803,5758,6045
58950,91356,21875,43970,18473,69480,11804,5759,6045
58955,91362,21875,43974,18473,69486,11806,5760,6046
58960,91373,21877,43979,18474,69494,11807,5760,6047
58965,91377,21878,43980,18475,69499,11807,5760,6047
58970,91387,21880,43986,18477,69506,11808,5760,6048
58975,91393,21880,43989,18477,69513,11810,5760,6050
58980,91404,21882,43995,18479,69521,11811,5760,6051
58985,91408,21882,43995,18479,69526,11811,5760,6051
58990,91418,21884,44001,18480,69533,11812,5760,6052
58995,91424,21884,44003,18480,69539,11814,5760,6054
59000,91435,21887,44007,18482,69547,11815,5760,6055
59005,91439,21888,44009,18483,69550,11815,5760,6055
59010,91449,21890,44012,18485,69559,11816,5760,6056
59015,91455,21890,44014,18485,69565,11818,5760,6058
59020,91466,21891,44019,18486,69575,11819,5761,6058
59025,91470,21891,44022,18486,69579,11819,5761,6058
59030,91480,21894,44030,18489,69585,11820,5762,6058
59035,91486,21896,44035,18491,69589,11822,5763,6059
59040,91497,21898,44041,18493,69598,11823,5764,6059
59045,91501,21899,44042,18494,69602,11823,5764,6059
59050,91511,21901,44047,18496,69610,11824,5765,6059
59055,91517,21901,44049,18496,69616,11826,5767,6059
59060,91528,21902,44054,18497,69626,11827,5767,6060
59065,91532,21902,44056,18497,69630,11827,5767,6060
59070,91542,21903,44061,18497,69639,11828,5768,6060
59075,91548,21903,44065,18497,69644,11830,5770,6060
59080,91559,21905,44072,18499,69654,11831,5771,6060
59085,91563,21905,44074,18499,69658,11831,5771,6060
59090,91573,21906,44078,18499,69667,11832,5772,6060
59095,91579,21906,44080,18499,69672,11834,5773,6061
59100,91590,21908,44084,18500,69681,11835,5773,6062
59105,91594,21908,44085,18500,69686,11835,5773,6062
59110,91604,21910,44091,18501,69694,11836,5774,6062
59115,91610,21910,44094,18501,69699,11838,5775,6063
59120,91621,21914,44100,18504,69705,11839,5775,6064
59125,91625,21916,44101,18506,69709,11839,5775,6064
59130,91635,21920,44105,18509,69715,11840,5775,6065
59135,91641,21920,44109,18509,69718,11842,5776,6066
59140,91652,21925,44114,18514,69726,11843,5776,6067
59145,91656,21927,44116,18516,69729,11843,5776,6067
59150,91666,21931,44120,18519,69734,11844,5776,6068
59155,91672,21933,44124,18521,69738,11846,5778,6068
59160,91683,21938,44128,18525,69745,11847,5778,6069
59165,91687,21938,44129,18525,69749,11847,5778,6069
59170,91697,21943,44136,18530,69754,11848,5779,6069
59175,91703,21944,44140,18531,69758,11850,5780,6070
59180,91714,21945,44141,18531,69768,11851,5780,6071
59185,91718,21945,44142,18531,69773,11851,5780,6071
59190,91728,21946,44144,18531,69782,11852,5780,6072
59195,91734,21946,44146,18531,69788,11854,5780,6074
59200,91745,21948,44154,18533,69796,11855,5781,6074
59205,91749,21949,44157,18534,69799,11855,5781,6074
59210,91759,21951,44162,18536,69807,11856,5781,6075
59215,91765,21953,44165,18538,69812,11858,5782,6076
59220,91776,21955,44172,18540,69820,11859,5783,6076
59225,91780,21955,44174,18540,69824,11859,5783,6076
59230,91790,21957,44178,18541,69832,11860,5783,6077
59235,91796,21959,44182,18543,69836,11862,5783,6079
59240,91807,21961,44188,18545,69845,11863,5783,6080
59245,91811,21961,44190,18545,69850,11863,5783,6080
59250,91821,21964,44197,18548,69856,11864,5783,6081
59255,91827,21966,44202,18550,69861,11866,5785,6081
59260,91838,21967,44205,18550,69870,11867,5785,6082
59265,91842,21967,44208,18550,69875,11867,5785,6082
59270,91852,21968,44211,18550,69884,11868,5785,6083
59275,91858,21968,44212,18550,69890,11870,5786,6084
59280,91869,21969,44215,18550,69899,11871,5786,6085
59285,91873,21970,44217,18551,69903,11871,5786,6085
59290,91883,21972,44222,18552,69910,11872,5786,6086
59295,91889,21974,44225,18554,69915,11874,5787,6087
59300,91900,21976,44229,18555,69922,11875,5787,6088
59305,91904,21978,44233,18557,69925,11875,5787,6088
59310,91914,21982,44239,18561,69932,11876,5787,6089
59315,91920,21983,44245,18562,69936,11878,5789,6089
59320,91931,21985,44247,18563,69945,11879,5789,6090
59325,91935,21986,44250,18564,69949,11879,5789,6090
59330,91945,21988,44255,18565,69956,11880,5790,6090
59335,91951,21988,44257,18565,69963,11882,5791,6091
59340,91962,21990,44262,18566,69969,11883,5792,6091
59345,91966,21991,44263,18567,69975,11883,5792,6091
59350,91976,21993,44268,18568,69983,11884,5793,6091
59355,91982,21993,44271,18568,69988,11886,5794,6092
59360,91993,21996,44275,18570,69997,11887,5794,6093
59365,91997,21996,44275,18570,70001,11887,5794,6093
59370,92007,21999,44280,18572,70007,11888,5794,6094
59375,92013,21999,44284,18572,70013,11890,5795,6095
59380,92024,22002,44288,18575,70022,11891,5795,6096
59385,92028,22002,44289,18575,70026,11891,5795,6096
59390,92038,22005,44295,18577,70032,11892,5796,6096
59395,92044,22005,44300,18577,70037,11894,5798,6096
59400,92055,22010,44304,18582,70045,11895,5798,6097
59405,92059,22011,44305,18583,70048,11895,5798,6097
59410,92069,22014,44309,18584,70054,11896,5799,6097
59415,92075,22014,44310,18584,70060,11898,5799,6099
59420,92086,22016,44315,18586,70070,11899,5800,6099
59425,92090,22016,44317,18586,70073,11899,5800,6099
59430,92100,22021,44321,18590,70079,11900,5800,6100
59435,92106,22021,44321,18590,70085,11902,5800,6102
59440,92117,22023,44327,18592,70094,11903,5800,6103
59445,92121,22023,44329,18592,70097,11903,5800,6103
59450,92131,22027,44333,18594,70103,11904,5800,6104
59455,92137,22027,44336,18594,70108,11906,5802,6104
59460,92148,22028,44340,18595,70119,11907,5802,6105
59465,92152,22028,44340,18595,70124,11907,5802,6105
59470,92162,22029,44343,18596,70132,11908,5802,6106
59475,92168,22029,44346,18596,70136,11910,5803,6107
59480,92179,22030,44352,18597,70147,11911,5804,6107
59485,92183,22030,44356,18597,70152,11911,5804,6107
59490,92193,22031,44361,18597,70159,11912,5805,6107
59495,92199,22031,44363,18597,70167,11914,5806,6108
59500,92210,22032,44369,18598,70176,11915,5807,6108
59505,92214,22032,44371,18598,70181,11915,5807,6108
59510,92224,22033,44374,18598,70190,11916,5807,6109
59515,92230,22033,44375,18598,70197,11918,5807,6111
59520,92241,22034,44380,18598,70206,11919,5807,6112
59525,92245,22034,44380,18598,70211,11919,5807,6112
59530,92255,22035,44384,18598,70219,11920,5808,6112
59535,92261,22035,44384,18598,70226,11922,5808,6114
59540,92272,22036,44390,18599,70236,11923,5809,6114
59545,92276,22036,44393,18599,70240,11923,5809,6114
59550,92286,22037,44396,18599,70248,11924,5810,6114
59555,92292,22037,44398,18599,70255,11926,5811,6115
59560,92303,22039,44405,18600,70264,11927,5812,6115
59565,92307,22039,44409,18600,70268,11927,5812,6115
59570,92317,22041,44416,18601,70275,11928,5813,6115
59575,92323,22041,44418,18601,70282,11930,5813,6117
59580,92334,22043,44423,18602,70291,11931,5813,6118
59585,92338,22043,44425,18602,70295,11931,5813,6118
59590,92348,22045,44429,18602,70302,11932,5814,6118
59595,92354,22045,44432,18602,70308,11934,5815,6119
59600,92365,22049,44436,18605,70315,11935,5815,6120
59605,92369,22050,44439,18606,70318,11935,5815,6120
59610,92379,22053,44444,18608,70325,11936,5816,6120
59615,92385,22053,44446,18608,70332,11938,5816,6122
59620,92396,22056,44452,18610,70340,11939,5816,6123
59625,92400,22056,44453,18610,70344,11939,5816,6123
59630,92410,22060,44459,18614,70348,11940,5816,6124
59635,92416,22062,44462,18616,70352,11942,5817,6125
59640,92427,22066,44465,18619,70359,11943,5817,6126
59645,92431,22068,44466,18621,70363,11943,5817,6126
59650,92441,22071,44470,18622,70368,11944,5818,6126
59655,92447,22072,44473,18623,70374,11946,5819,6127
59660,92458,22073,44477,18623,70382,11947,5819,6128
59665,92462,22073,44478,18623,70388,11947,5819,6128
59670,92472,22074,44481,18623,70396,11948,5819,6129
59675,92478,22074,44483,18623,70404,11950,5819,6131
59680,92489,22075,44488,18623,70413,11951,5819,6132
59685,92493,22075,44491,18623,70418,11951,5819,6132
59690,92503,22076,44496,18623,70427,11952,5819,6133
59695,92509,22076,44500,18623,70433,11954,5820,6134
59700,92520,22077,44507,18623,70443,11955,5821,6134
59705,92524,22077,44510,18623,70447,11955,5821,6134
59710,92534,22078,44514,18623,70456,11956,5821,6135
59715,92540,22078,44514,18623,70462,11958,5821,6137
59720,92551,22079,44520,18623,70472,11959,5821,6138
59725,92555,22079,44522,18623,70476,11959,5821,6138
59730,92565,22080,44528,18623,70484,11960,5822,6138
59735,92571,22080,44532,18623,70491,11962,5824,6138
59740,92582,22081,44538,18623,70501,11963,5825,6138
59745,92586,22081,44538,18623,70505,11963,5825,6138
59750,92596,22082,44543,18623,70513,11964,5825,6139
59755,92602,22082,44545,18623,70520,11966,5826,6140
59760,92613,22083,44550,18624,70530,11967,5827,6140
59765,92617,22083,44552,18624,70534,11967,5827,6140
59770,92627,22085,44558,18625,70540,11968,5827,6141
59775,92633,22085,44559,18625,70548,11970,5827,6143
59780,92644,22086,44561,18625,70558,11971,5828,6143
59785,92648,22086,44561,18625,70562,11971,5828,6143
59790,92658,22090,44564,18627,70567,11972,5828,6144
59795,92664,22090,44566,18627,70572,11974,5829,6145
59800,92675,22093,44574,18630,70578,11975,5830,6145
59805,92679,22098,44575,18635,70581,11975,5830,6145
59810,92689,22100,44580,18637,70588,11976,5831,6145
59815,92695,22101,44583,18638,70592,11978,5832,6146
59820,92706,22104,44587,18640,70600,11979,5833,6146
59825,92710,22106,44588,18642,70604,11979,5833,6146
59830,92720,22109,44592,18645,70610,11980,5833,6147
59835,92726,22109,44593,18645,70617,11982,5834,6148
59840,92737,22110,44597,18645,70625,11983,5834,6149
59845,92741,22113,44599,18648,70627,11983,5834,6149
59850,92751,22117,44604,18651,70633,11984,5834,6150
59855,92757,22117,44606,18651,70639,11986,5834,6152
59860,92768,22118,44611,18652,70649,11987,5835,6152
59865,92772,22118,44612,18652,70654,11987,5835,6152
59870,92782,22119,44617,18652,70662,11988,5836,6152
59875,92788,22119,44621,18652,70669,11990,5838,6152
59880,92799,22120,44625,18652,70678,11991,5838,6153
59885,92803,22120,44626,18652,70683,11991,5838,6153
59890,92813,22121,44629,18652,70691,11992,5839,6153
59895,92819,22121,44630,18652,70698,11994,5839,6155
59900,92830,22122,44637,18653,70706,11995,5839,6156
59905,92834,22122,44639,18653,70712,11995,5839,6156
59910,92844,22123,44645,18654,70720,11996,5839,6157
59915,92850,22123,44646,18654,70727,11998,5839,6159
59920,92861,22124,44650,18654,70734,11999,5839,6160
59925,92865,22124,44651,18654,70741,11999,5839,6160
59930,92875,22125,44655,18654,70749,12000,5840,6160
59935,92881,22125,44659,18654,70756,12002,5841,6161
59940,92892,22126,44663,18655,70765,12003,5841,6162
59945,92896,22126,44666,18655,70770,12003,5841,6162
59950,92906,22127,44670,18656,70778,12004,5841,6163
59955,92912,22127,44674,18656,70785,12006,5842,6164
59960,92923,22128,44678,18656,70794,12007,5843,6164
59965,92927,22128,44680,18656,70799,12007,5843,6164
59970,92937,22130,44681,18657,70806,12008,5843,6165
59975,92943,22130,44686,18657,70812,12010,5845,6165
59980,92954,22132,44691,18659,70822,12011,5846,6165
59985,92958,22133,44694,18660,70824,12011,5846,6165
59990,92968,22136,44701,18663,70831,12012,5846,6166
59995,92974,22136,44703,18663,70838,12014,5847,6167
60000,92985,22137,44705,18663,70848,12015,5847,6168
60005,92989,22137,44707,18663,70852,12015,5847,6168
60010,92999,22139,44710,18663,70859,12016,5847,6169
60015,93005,22139,44712,18663,70866,12018,5848,6170
60020,93016,22140,44716,18663,70876,12019,5849,6170
60025,93020,22140,44717,18663,70879,12019,5849,6170
60030,93030,22143,44722,18665,70886,12020,5850,6170
60035,93036,22143,44723,18665,70892,12022,5850,6172
60040,93047,22145,44728,18666,70901,12023,5851,6172
60045,93051,22146,44729,18667,70904,12023,5851,6172
60050,93061,22150,44735,18670,70910,12024,5851,6173
60055,93067,22150,44738,18670,70916,12026,5852,6174
60060,93078,22154,44744,18674,70924,12027,5852,6175
60065,93082,22155,44745,18675,70927,12027,5852,6175
60070,93092,22159,44751,18678,70932,12028,5853,6175
60075,93098,22160,44756,18679,70936,12030,5855,6175
60080,93109,22165,44762,18684,70944,12031,5856,6175
60085,93113,22166,44763,18685,70947,12031,5856,6175
60090,93123,22169,44769,18688,70953,12032,5857,6175
60095,93129,22169,44772,18688,70957,12034,5857,6177
60100,93140,22174,44777,18692,70963,12035,5857,6178
60105,93144,22176,44778,18694,70967,12035,5857,6178
60110,93154,22177,44780,18695,70976,12036,5857,6179
60115,93160,22177,44783,18695,70982,12038,5859,6179
60120,93171,22178,44791,18695,70991,12039,5860,6179
60125,93175,22178,44793,18695,70996,12039,5860,6179
60130,93185,22179,44798,18695,71005,12040,5860,6180
60135,93191,22179,44799,18695,71012,12042,5860,6182
60140,93202,22180,44805,18695,71021,12043,5861,6182
60145,93206,22180,44808,18695,71025,12043,5861,6182
60150,93216,22181,44812,18695,71034,12044,5861,6183
60155,93222,22181,44814,18695,71041,12046,5862,6184
60160,93233,22182,44819,18695,71050,12047,5863,6184
60165,93237,22182,44821,18695,71055,12047,5863,6184
60170,93247,22183,44824,18695,71063,12048,5863,6185
60175,93253,22183,44828,18695,71070,12050,5864,6186
60180,93264,22184,44835,18696,71080,12051,5864,6187
60185,93268,22184,44837,18696,71084,12051,5864,6187
60190,93278,22185,44842,18696,71092,12052,5865,6187
60195,93284,22185,44845,18696,71099,12054,5866,6188
60200,93295,22186,44851,18697,71109,12055,5867,6188
60205,93299,22186,44854,18697,71113,12055,5867,6188
60210,93309,22187,44859,18698,71121,12056,5868,6188
60215,93315,22187,44863,18698,71128,12058,5870,6188
60220,93326,22188,44868,18698,71138,12059,5871,6188
60225,93330,22188,44870,18698,71140,12059,5871,6188
60230,93340,22192,44874,18701,71147,12060,5872,6188
60235,93346,22192,44875,18701,71154,12062,5872,6190
60240,93357,22194,44883,18703,71163,12063,5873,6190
60245,93361,22195,44886,18704,71164,12063,5873,6190
60250,93371,22199,44889,18706,71171,12064,5874,6190
60255,93377,22199,44893,18706,71177,12066,5875,6191
60260,93388,22201,44899,18708,71184,12067,5876,6191
60265,93392,22204,44900,18711,71187,12067,5876,6191
60270,93402,22209,44907,18716,71192,12068,5877,6191
60275,93408,22209,44911,18716,71197,12070,5879,6191
60280,93419,22213,44918,18719,71204,12071,5880,6191
60285,93423,22215,44920,18721,71206,12071,5880,6191
60290,93433,22218,44923,18722,71214,12072,5881,6191
60295,93439,22218,44925,18722,71220,12074,5882,6192
60300,93450,22220,44929,18723,71228,12075,5883,6192
60305,93454,22221,44932,18724,71232,12075,5883,6192
60310,93464,22222,44938,18725,71241,12076,5884,6192
60315,93470,22222,44943,18725,71248,12078,5886,6192
60320,93481,22223,44950,18726,71258,12079,5887,6192
60325,93485,22223,44953,18726,71261,12079,5887,6192
60330,93495,22224,44957,18727,71270,12080,5887,6193
60335,93501,22224,44959,18727,71277,12082,5887,6195
60340,93512,22225,44967,18728,71287,12083,5887,6196
60345,93516,22225,44969,18728,71290,12083,5887,6196
60350,93526,22226,44973,18728,71299,12084,5887,6197
60355,93532,22226,44977,18728,71306,12086,5889,6197
60360,93543,22227,44985,18729,71316,12087,5890,6197
60365,93547,22227,44988,18729,71319,12087,5890,6197
60370,93557,22228,44994,18730,71328,12088,5890,6198
60375,93563,22228,44997,18730,71335,12090,5891,6199
60380,93574,22229,45002,18730,71345,12091,5892,6199
60385,93578,22229,45005,18730,71348,12091,5892,6199
60390,93588,22230,45009,18731,71357,12092,5892,6200
60395,93594,22230,45013,18731,71364,12094,5894,6200
60400,93605,22231,45019,18732,71374,12095,5894,6201
60405,93609,22231,45020,18732,71377,12095,5894,6201
60410,93619,22236,45025,18735,71381,12096,5895,6201
60415,93625,22237,45028,18736,71387,12098,5896,6202
60420,93636,22240,45033,18738,71396,12099,5897,6202
60425,93640,22240,45034,18738,71399,12099,5897,6202
60430,93650,22243,45037,18739,71406,12100,5897,6203
60435,93656,22244,45039,18740,71411,12102,5897,6205
60440,93667,22247,45045,18743,71417,12103,5897,6206
60445,93671,22250,45048,18746,71419,12103,5897,6206
60450,93681,22256,45053,18750,71424,12104,5898,6206
60455,93687,22256,45058,18750,71431,12106,5900,6206
60460,93698,22257,45063,18751,71441,12107,5901,6206
60465,93702,22257,45065,18751,71444,12107,5901,6206
60470,93712,22258,45070,18751,71453,12108,5902,6206
60475,93718,22258,45072,18751,71460,12110,5903,6207
60480,93729,22259,45078,18752,71469,12111,5903,6208
60485,93733,22259,45081,18752,71473,12111,5903,6208
60490,93743,22260,45085,18753,71482,12112,5903,6209
60495,93749,22260,45089,18753,71488,12114,5904,6210
60500,93760,22261,45095,18754,71498,12115,5905,6210
60505,93764,22261,45097,18754,71502,12115,5905,6210
60510,93774,22262,45101,18754,71511,12116,5906,6210
60515,93780,22262,45103,18754,71518,12118,5907,6211
60520,93791,22263,45107,18754,71527,12119,5908,6211
60525,93795,22263,45110,18754,71531,12119,5908,6211
60530,93805,22264,45117,18755,71540,12120,5909,6211
60535,93811,22264,45120,18755,71546,12122,5910,6212
60540,93822,22265,45126,18756,71555,12123,5910,6213
60545,93826,22265,45128,18756,71560,12123,5910,6213
60550,93836,22266,45132,18756,71569,12124,5911,6213
60555,93842,22266,45134,18756,71575,12126,5912,6214
60560,93853,22267,45136,18756,71586,12127,5912,6215
60565,93857,22267,45137,18756,71589,12127,5912,6215
60570,93867,22270,45142,18758,71596,12128,5913,6215
60575,93873,22270,45147,18758,71602,12130,5915,6215
60580,93884,22273,45155,18761,71608,12131,5915,6216
60585,93888,22274,45157,18762,71612,12131,5915,6216
60590,93898,22279,45165,18767,71618,12132,5915,6217
60595,93904,22279,45170,18767,71623,12134,5916,6218
60600,93915,22282,45173,18769,71633,12135,5916,6219
60605,93919,22282,45173,18769,71636,12135,5916,6219
60610,93929,22284,45180,18771,71644,12136,5917,6219
60615,93935,22284,45184,18771,71651,12138,5918,6220
60620,93946,22285,45189,18771,71661,12139,5919,6220
60625,93950,22285,45191,18771,71663,12139,5919,6220
60630,93960,22289,45195,18774,71670,12140,5919,6221
60635,93966,22289,45198,18774,71677,12142,5921,6221
60640,93977,22290,45204,18775,71686,12143,5921,6222
60645,93981,22292,45206,18777,71688,12143,5921,6222
60650,93991,22294,45211,18778,71696,12144,5921,6223
60655,93997,22294,45214,18778,71703,12146,5922,6224
60660,94008,22296,45221,18780,71712,12147,5922,6225
60665,94012,22296,45223,18780,71714,12147,5922,6225
60670,94022,22300,45227,18783,71721,12148,5922,6226
60675,94028,22300,45230,18783,71728,12150,5923,6227
60680,94039,22302,45237,18784,71737,12151,5924,6227
60685,94043,22303,45239,18785,71739,12151,5924,6227
60690,94053,22307,45242,18787,71745,12152,5924,6228
60695,94059,22307,45243,18787,71751,12154,5924,6230
60700,94070,22310,45250,18789,71758,12155,5924,6231
60705,94074,22312,45252,18791,71760,12155,5924,6231
60710,94084,22316,45258,18794,71767,12156,5924,6232
60715,94090,22316,45260,18794,71774,12158,5925,6233
60720,94101,22317,45267,18795,71783,12159,5926,6233
60725,94105,22317,45270,18795,71787,12159,5926,6233
60730,94115,22318,45275,18795,71796,12160,5926,6234
60735,94121,22318,45278,18795,71802,12162,5927,6235
60740,94132,22319,45283,18796,71813,12163,5927,6236
60745,94136,22319,45284,18796,71816,12163,5927,6236
60750,94146,22320,45289,18796,71825,12164,5928,6236
60755,94152,22320,45293,18796,71832,12166,5930,6236
60760,94163,22321,45297,18797,71842,12167,5930,6237
60765,94167,22321,45301,18797,71845,12167,5930,6237
60770,94177,22322,45304,18797,71854,12168,5931,6237
60775,94183,22322,45307,18797,71861,12170,5932,6238
60780,94194,22323,45314,18797,71870,12171,5933,6238
60785,94198,22323,45315,18797,71874,12171,5933,6238
60790,94208,22324,45319,18797,71883,12172,5933,6239
60795,94214,22324,45321,18797,71890,12174,5935,6239
60800,94225,22325,45327,18797,71900,12175,5936,6239
60805,94229,22325,45328,18797,71903,12175,5936,6239
60810,94239,22326,45333,18797,71912,12176,5937,6239
60815,94245,22326,45335,18797,71918,12178,5937,6241
60820,94256,22327,45341,18798,71928,12179,5938,6241
60825,94260,22329,45343,18800,71930,12179,5938,6241
60830,94270,22333,45351,18804,71935,12180,5939,6241
60835,94276,22335,45354,18806,71940,12182,5941,6241
60840,94287,22338,45357,18808,71948,12183,5942,6241
60845,94291,22339,45359,18809,71951,12183,5942,6241
60850,94301,22343,45365,18813,71957,12184,5943,6241
60855,94307,22343,45368,18813,71963,12186,5944,6242
60860,94318,22346,45376,18816,71970,12187,5945,6242
60865,94322,22348,45378,18818,71973,12187,5945,6242
60870,94332,22353,45383,18822,71978,12188,5945,6243
60875,94338,22353,45388,18822,71984,12190,5947,6243
60880,94349,22354,45393,18823,71994,12191,5947,6244
60885,94353,22354,45394,18823,71999,12191,5947,6244
60890,94363,22355,45400,18823,72007,12192,5948,6244
60895,94369,22355,45402,18823,72013,12194,5949,6245
60900,94380,22356,45406,18823,72023,12195,5949,6246
60905,94384,22356,45408,18823,72027,12195,5949,6246
60910,94394,22357,45413,18823,72036,12196,5949,6247
60915,94400,22357,45418,18823,72043,12198,5951,6247
60920,94411,22358,45422,18823,72053,12199,5951,6248
60925,94415,22358,45424,18823,72056,12199,5951,6248
60930,94425,22359,45429,18823,72065,12200,5952,6248
60935,94431,22359,45432,18823,72072,12202,5954,6248
60940,94442,22360,45436,18823,72082,12203,5955,6248
60945,94446,22360,45439,18823,72085,12203,5955,6248
60950,94456,22361,45448,18824,72094,12204,5956,6248
60955,94462,22361,45452,18824,72101,12206,5957,6249
60960,94473,22362,45457,18824,72111,12207,5957,6250
60965,94477,22362,45460,18824,72114,12207,5957,6250
60970,94487,22363,45463,18824,72123,12208,5958,6250
60975,94493,22363,45468,18824,72130,12210,5960,6250
60980,94504,22364,45469,18824,72140,12211,5960,6251
60985,94508,22364,45472,18824,72142,12211,5960,6251
60990,94518,22368,45473,18826,72149,12212,5960,6252
60995,94524,22368,45476,18826,72156,12214,5961,6253
61000,94535,22369,45484,18827,72165,12215,5962,6253
61005,94539,22370,45487,18828,72167,12215,5962,6253
61010,94549,22375,45491,18833,72173,12216,5962,6254
61015,94555,22375,45493,18833,72180,12218,5963,6255
61020,94566,22376,45500,18833,72188,12219,5963,6256
61025,94570,22378,45500,18835,72192,12219,5963,6256
61030,94580,22381,45505,18837,72198,12220,5963,6257
61035,94586,22382,45508,18838,72203,12222,5964,6258
61040,94597,22384,45516,18839,72210,12223,5965,6258
61045,94601,22388,45519,18843,72212,12223,5965,6258
61050,94611,22392,45523,18846,72217,12224,5965,6259
61055,94617,22394,45527,18848,72221,12226,5966,6260
61060,94628,22397,45528,18850,72230,12227,5966,6261
61065,94632,22397,45529,18850,72235,12227,5966,6261
61070,94642,22398,45534,18851,72243,12228,5966,6262
61075,94648,22398,45539,18851,72249,12230,5968,6262
61080,94659,22399,45544,18851,72258,12231,5968,6263
61085,94663,22399,45548,18851,72263,12231,5968,6263
61090,94673,22400,45551,18852,72272,12232,5968,6264
61095,94679,22400,45554,18852,72278,12234,5969,6265
61100,94690,22401,45560,18853,72288,12235,5969,6266
61105,94694,22401,45561,18853,72293,12235,5969,6266
61110,94704,22402,45566,18853,72301,12236,5970,6266
61115,94710,22402,45568,18853,72307,12238,5971,6267
61120,94721,22403,45572,18853,72317,12239,5971,6268
61125,94725,22403,45574,18853,72322,12239,5971,6268
61130,94735,22404,45579,18853,72330,12240,5971,6269
61135,94741,22404,45582,18853,72337,12242,5971,6271
61140,94752,22405,45589,18853,72346,12243,5972,6271
61145,94756,22405,45592,18853,72350,12243,5972,6271
61150,94766,22406,45597,18854,72359,12244,5972,6272
61155,94772,22406,45599,18854,72366,12246,5973,6273
61160,94783,22407,45604,18855,72375,12247,5974,6273
61165,94787,22407,45606,18855,72379,12247,5974,6273
61170,94797,22410,45613,18858,72386,12248,5975,6273
61175,94803,22410,45617,18858,72392,12250,5976,6274
61180,94814,22412,45621,18859,72401,12251,5977,6274
61185,94818,22412,45623,18859,72404,12251,5977,6274
61190,94828,22417,45630,18864,72410,12252,5977,6275
61195,94834,22417,45634,18864,72416,12254,5979,6275
61200,94845,22419,45641,18866,72425,12255,5980,6275
61205,94849,22420,45643,18867,72428,12255,5980,6275
61210,94859,22423,45645,18868,72435,12256,5980,6276
61215,94865,22423,45648,18868,72442,12258,5981,6277
61220,94876,22424,45653,18868,72452,12259,5982,6277
61225,94880,22425,45654,18869,72455,12259,5982,6277
61230,94890,22427,45658,18871,72462,12260,5982,6278
61235,94896,22427,45664,18871,72468,12262,5984,6278
61240,94907,22429,45669,18872,72477,12263,5984,6279
61245,94911,22430,45672,18873,72479,12263,5984,6279
61250,94921,22436,45679,18878,72484,12264,5985,6279
61255,94927,22436,45681,18878,72491,12266,5985,6281
61260,94938,22437,45687,18878,72501,12267,5985,6282
61265,94942,22438,45690,18879,72503,12267,5985,6282
61270,94952,22442,45696,18883,72509,12268,5986,6282
61275,94958,22442,45699,18883,72516,12270,5987,6283
61280,94969,22443,45706,18884,72526,12271,5987,6284
61285,94973,22444,45708,18885,72528,12271,5987,6284
61290,94983,22447,45714,18888,72535,12272,5988,6284
61295,94989,22447,45720,18888,72541,12274,5990,6284
61300,95000,22449,45726,18890,72549,12275,5991,6284
61305,95004,22452,45728,18893,72551,12275,5991,6284
61310,95014,22455,45732,18895,72558,12276,5992,6284
61315,95020,22455,45735,18895,72564,12278,5993,6285
61320,95031,22456,45737,18896,72575,12279,5993,6286
61325,95035,22456,45739,18896,72579,12279,5993,6286
61330,95045,22457,45746,18897,72587,12280,5994,6286
61335,95051,22457,45750,18897,72594,12282,5995,6287
61340,95062,22458,45757,18898,72602,12283,5995,6288
61345,95066,22458,45758,18898,72608,12283,5995,6288
61350,95076,22459,45766,18899,72616,12284,5996,6288
61355,95082,22459,45768,18899,72623,12286,5997,6289
61360,95093,22460,45774,18900,72632,12287,5997,6290
61365,95097,22460,45775,18900,72636,12287,5997,6290
61370,95107,22461,45780,18900,72645,12288,5998,6290
61375,95113,22461,45785,18900,72651,12290,6000,6290
61380,95124,22462,45789,18900,72661,12291,6000,6291
61385,95128,22462,45791,18900,72665,12291,6000,6291
61390,95138,22463,45794,18901,72675,12292,6000,6292
61395,95144,22463,45797,18901,72680,12294,6000,6294
61400,95155,22464,45802,18902,72691,12295,6001,6294
61405,95159,22464,45804,18902,72694,12295,6001,6294
61410,95169,22465,45809,18903,72703,12296,6001,6295
61415,95175,22465,45811,18903,72710,12298,6001,6297
61420,95186,22466,45815,18904,72719,12299,6001,6298
61425,95190,22467,45816,18905,72723,12299,6001,6298
61430,95200,22469,45818,18905,72731,12300,6001,6299
61435,95206,22469,45820,18905,72736,12302,6001,6301
61440,95217,22471,45826,18906,72744,12303,6002,6301
61445,95221,22473,45827,18908,72748,12303,6002,6301
61450,95231,22475,45830,18908,72754,12304,6002,6302
61455,95237,22477,45832,18910,72759,12306,6002,6304
61460,95248,22479,45837,18912,72769,12307,6003,6304
61465,95252,22479,45838,18912,72773,12307,6003,6304
61470,95262,22483,45847,18916,72778,12308,6004,6304
61475,95268,22483,45850,18916,72784,12310,6004,6306
61480,95279,22485,45854,18918,72794,12311,6004,6307
61485,95283,22485,45856,18918,72797,12311,6004,6307
61490,95293,22489,45863,18921,72803,12312,6005,6307
61495,95299,22489,45867,18921,72810,12314,6007,6307
61500,95310,22490,45875,18922,72819,12315,6008,6307
61505,95314,22492,45878,18924,72821,12315,6008,6307
61510,95324,22496,45881,18927,72827,12316,6008,6308
61515,95330,22496,45883,18927,72833,12318,6008,6310
61520,95341,22498,45888,18928,72843,12319,6009,6310
61525,95345,22499,45889,18929,72846,12319,6009,6310
61530,95355,22501,45892,18930,72854,12320,6010,6310
61535,95361,22501,45895,18930,72860,12322,6010,6312
61540,95372,22502,45898,18930,72870,12323,6011,6312
61545,95376,22502,45899,18930,72873,12323,6011,6312
61550,95386,22506,45905,18934,72879,12324,6011,6313
61555,95392,22506,45907,18934,72885,12326,6011,6315
61560,95403,22508,45914,18936,72894,12327,6012,6315
61565,95407,22510,45917,18938,72896,12327,6012,6315
61570,95417,22514,45921,18940,72903,12328,6013,6315
61575,95423,22514,45923,18940,72909,12330,6014,6316
61580,95434,22515,45930,18941,72918,12331,6014,6317
61585,95438,22515,45933,18941,72922,12331,6014,6317
61590,95448,22516,45937,18941,72932,12332,6015,6317
61595,95454,22516,45939,18941,72938,12334,6016,6318
61600,95465,22517,45948,18941,72946,12335,6017,6318
61605,95469,22517,45952,18941,72951,12335,6017,6318
61610,95479,22518,45959,18942,72961,12336,6018,6318
61615,95485,22518,45963,18942,72966,12338,6020,6318
61620,95496,22519,45967,18943,72977,12339,6020,6319
61625,95500,22519,45969,18943,72980,12339,6020,6319
61630,95510,22520,45973,18943,72989,12340,6021,6319
61635,95516,22520,45977,18943,72995,12342,6022,6320
61640,95527,22521,45981,18943,73005,12343,6023,6320
61645,95531,22521,45983,18943,73009,12343,6023,6320
61650,95541,22522,45987,18943,73018,12344,6023,6321
61655,95547,22522,45990,18943,73024,12346,6023,6323
61660,95558,22523,45995,18943,73034,12347,6023,6324
61665,95562,22523,45997,18943,73039,12347,6023,6324
61670,95572,22524,46003,18944,73047,12348,6024,6324
61675,95578,22524,46006,18944,73054,12350,6025,6325
61680,95589,22525,46011,18944,73063,12351,6025,6326
61685,95593,22526,46013,18945,73065,12351,6025,6326
61690,95603,22531,46019,18949,73072,12352,6026,6326
61695,95609,22531,46022,18949,73077,12354,6028,6326
61700,95620,22533,46028,18950,73086,12355,6029,6326
61705,95624,22534,46031,18951,73088,12355,6029,6326
61710,95634,22539,46036,18956,73095,12356,6029,6327
61715,95640,22539,46036,18956,73101,12358,6029,6329
61720,95651,22540,46043,18957,73109,12359,6029,6330
61725,95655,22542,46046,18959,73112,12359,6029,6330
61730,95665,22545,46050,18961,73120,12360,6029,6331
61735,95671,22545,46055,18961,73125,12362,6031,6331
61740,95682,22547,46063,18962,73133,12363,6031,6332
61745,95686,22548,46065,18963,73136,12363,6031,6332
61750,95696,22552,46069,18965,73143,12364,6032,6332
61755,95702,22552,46072,18965,73150,12366,6033,6333
61760,95713,22553,46078,18966,73158,12367,6033,6334
61765,95717,22555,46081,18968,73160,12367,6033,6334
61770,95727,22559,46085,18971,73168,12368,6033,6335
61775,95733,22559,46088,18971,73174,12370,6034,6336
61780,95744,22560,46093,18971,73183,12371,6035,6336
61785,95748,22561,46095,18972,73186,12371,6035,6336
61790,95758,22565,46100,18976,73193,12372,6035,6337
61795,95764,22565,46104,18976,73198,12374,6037,6337
61800,95775,22566,46112,18977,73208,12375,6038,6337
61805,95779,22566,46115,18977,73212,12375,6038,6337
61810,95789,22567,46118,18977,73222,12376,6038,6338
61815,95795,22567,46121,18977,73228,12378,6039,6339
61820,95806,22568,46128,18977,73236,12379,6039,6340
61825,95810,22568,46130,18977,73241,12379,6039,6340
61830,95820,22569,46136,18977,73251,12380,6040,6340
61835,95826,22569,46140,18977,73257,12382,6042,6340
61840,95837,22570,46146,18978,73267,12383,6042,6341
61845,95841,22570,46147,18978,73271,12383,6042,6341
61850,95851,22571,46153,18979,73279,12384,6043,6341
61855,95857,22571,46157,18979,73286,12386,6044,6342
61860,95868,22572,46160,18979,73296,12387,6044,6343
61865,95872,22572,46162,18979,73299,12387,6044,6343
61870,95882,22573,46167,18980,73309,12388,6044,6344
61875,95888,22573,46171,18980,73315,12390,6045,6345
61880,95899,22574,46176,18981,73325,12391,6045,6346
61885,95903,22574,46180,18981,73328,12391,6045,6346
61890,95913,22575,46186,18981,73338,12392,6046,6346
61895,95919,22575,46189,18981,73344,12394,6047,6347
61900,95930,22576,46193,18981,73353,12395,6047,6348
61905,95934,22578,46195,18983,73356,12395,6047,6348
61910,95944,22581,46200,18985,73363,12396,6047,6349
61915,95950,22581,46201,18985,73368,12398,6047,6351
61920,95961,22583,46206,18987,73378,12399,6048,6351
61925,95965,22584,46208,18988,73380,12399,6048,6351
61930,95975,22588,46214,18991,73387,12400,6049,6351
61935,95981,22588,46216,18991,73393,12402,6050,6352
61940,95992,22589,46219,18991,73401,12403,6050,6353
61945,95996,22591,46220,18993,73404,12403,6050,6353
61950,96006,22594,46224,18994,73410,12404,6050,6354
61955,96012,22596,46226,18996,73416,12406,6051,6355
61960,96023,22597,46232,18996,73425,12407,6052,6355
61965,96027,22599,46233,18998,73428,12407,6052,6355
61970,96037,22601,46235,19000,73436,12408,6052,6356
61975,96043,22601,46237,19000,73441,12410,6052,6358
61980,96054,22603,46245,19002,73449,12411,6052,6359
61985,96058,22605,46246,19004,73453,12411,6052,6359
61990,96068,22610,46253,19008,73457,12412,6053,6359
61995,96074,22611,46254,19009,73462,12414,6053,6361
62000,96085,22612,46259,19009,73472,12415,6054,6361
62005,96089,22612,46261,19009,73477,12415,6054,6361
62010,96099,22613,46269,19010,73485,12416,6055,6361
62015,96105,22613,46271,19010,73492,12418,6056,6362
62020,96116,22614,46278,19011,73501,12419,6057,6362
62025,96120,22614,46279,19011,73506,12419,6057,6362
62030,96130,22615,46284,19011,73515,12420,6058,6362
62035,96136,22615,46286,19011,73520,12422,6059,6363
62040,96147,22616,46291,19011,73530,12423,6060,6363
62045,96151,22616,46292,19011,73534,12423,6060,6363
62050,96161,22617,46295,19012,73544,12424,6060,6364
62055,96167,22617,46299,19012,73549,12426,6060,6366
62060,96178,22618,46305,19012,73559,12427,6061,6366
62065,96182,22618,46307,19012,73564,12427,6061,6366
62070,96192,22619,46312,19012,73573,12428,6062,6366
62075,96198,22619,46317,19012,73578,12430,6064,6366
62080,96209,22620,46320,19012,73589,12431,6064,6367
62085,96213,22620,46322,19012,73592,12431,6064,6367
62090,96223,22621,46328,19012,73601,12432,6065,6367
62095,96229,22621,46330,19012,73607,12434,6065,6369
62100,96240,22623,46332,19013,73615,12435,6065,6370
62105,96244,22623,46334,19013,73620,12435,6065,6370
62110,96254,22626,46339,19016,73628,12436,6065,6371
62115,96260,22626,46342,19016,73634,12438,6066,6372
62120,96271,22627,46347,19017,73643,12439,6067,6372
62125,96275,22628,46349,19018,73646,12439,6067,6372
62130,96285,22631,46351,19019,73654,12440,6068,6372
62135,96291,22631,46353,19019,73660,12442,6069,6373
62140,96302,22632,46358,19019,73669,12443,6070,6373
62145,96306,22633,46361,19020,73672,12443,6070,6373
62150,96316,22636,46365,19021,73679,12444,6070,6374
62155,96322,22636,46368,19021,73685,12446,6071,6375
62160,96333,22638,46374,19023,73694,12447,6071,6376
62165,96337,22639,46377,19024,73697,12447,6071,6376
62170,96347,22642,46380,19025,73705,12448,6071,6377
62175,96353,22642,46383,19025,73710,12450,6072,6378
62180,96364,22644,46388,19026,73720,12451,6072,6379
62185,96368,22644,46390,19026,73724,12451,6072,6379
62190,96378,22646,46394,19027,73732,12452,6073,6379
62195,96384,22646,46396,19027,73737,12454,6074,6380
62200,96395,22648,46401,19029,73746,12455,6074,6381
62205,96399,22649,46404,19030,73748,12455,6074,6381
62210,96409,22653,46407,19034,73756,12456,6074,6382
62215,96415,22653,46410,19034,73762,12458,6076,6382
62220,96426,22654,46417,19035,73772,12459,6076,6383
62225,96430,22655,46418,19036,73775,12459,6076,6383
62230,96440,22659,46424,19039,73781,12460,6077,6383
62235,96446,22659,46426,19039,73787,12462,6077,6385
62240,96457,22660,46435,19040,73796,12463,6078,6385
62245,96461,22662,46438,19042,73797,12463,6078,6385
62250,96471,22667,46443,19046,73804,12464,6079,6385
62255,96477,22667,46444,19046,73810,12466,6079,6387
62260,96488,22668,46449,19046,73820,12467,6079,6388
62265,96492,22669,46452,19047,73822,12467,6079,6388
62270,96502,22673,46457,19049,73827,12468,6080,6388
62275,96508,22675,46459,19051,73832,12470,6081,6389
62280,96519,22677,46465,19052,73840,12471,6082,6389
62285,96523,22677,46468,19052,73846,12471,6082,6389
62290,96533,22678,46471,19052,73854,12472,6083,6389
62295,96539,22678,46475,19052,73861,12474,6084,6390
62300,96550,22679,46481,19052,73871,12475,6084,6391
62305,96554,22679,46484,19052,73874,12475,6084,6391
62310,96564,22680,46488,19053,73884,12476,6085,6391
62315,96570,22680,46492,19053,73889,12478,6086,6392
62320,96581,22681,46498,19054,73899,12479,6087,6392
62325,96585,22681,46500,19054,73904,12479,6087,6392
62330,96595,22682,46505,19054,73912,12480,6088,6392
62335,96601,22682,46507,19054,73918,12482,6089,6393
62340,96612,22683,46516,19055,73927,12483,6090,6393
62345,96616,22683,46518,19055,73932,12483,6090,6393
62350,96626,22684,46522,19055,73941,12484,6090,6394
62355,96632,22684,46525,19055,73948,12486,6091,6395
62360,96643,22685,46532,19056,73957,12487,6091,6396
62365,96647,22685,46534,19056,73962,12487,6091,6396
62370,96657,22686,46540,19057,73971,12488,6091,6397
62375,96663,22686,46545,19057,73976,12490,6093,6397
62380,96674,22687,46550,19057,73985,12491,6093,6398
62385,96678,22689,46553,19059,73988,12491,6093,6398
62390,96688,22694,46560,19064,73992,12492,6093,6399
62395,96694,22696,46565,19066,73997,12494,6095,6399
62400,96705,22698,46571,19068,74005,12495,6095,6400
62405,96709,22699,46572,19069,74010,12495,6095,6400
62410,96719,22702,46577,19070,74016,12496,6095,6401
62415,96725,22702,46582,19070,74023,12498,6097,6401
62420,96736,22703,46586,19070,74033,12499,6098,6401
62425,96740,22703,46586,19070,74037,12499,6098,6401
62430,96750,22705,46590,19070,74044,12500,6099,6401
62435,96756,22705,46592,19070,74050,12502,6100,6402
62440,96767,22707,46595,19071,74060,12503,6100,6403
62445,96771,22707,46596,19071,74064,12503,6100,6403
62450,96781,22709,46599,19072,74072,12504,6100,6404
62455,96787,22709,46601,19072,74078,12506,6101,6405
62460,96798,22710,46605,19073,74088,12507,6101,6406
62465,96802,22710,46607,19073,74091,12507,6101,6406
62470,96812,22713,46613,19075,74098,12508,6101,6407
62475,96818,22713,46616,19075,74105,12510,6102,6408
62480,96829,22714,46620,19075,74114,12511,6103,6408
62485,96833,22715,46622,19076,74118,12511,6103,6408
62490,96843,22718,46627,19079,74125,12512,6103,6409
62495,96849,22718,46630,19079,74131,12514,6104,6410
62500,96860,22719,46633,19079,74141,12515,6105,6410
62505,96864,22720,46635,19080,74143,12515,6105,6410
62510,96874,22725,46641,19084,74147,12516,6105,6411
62515,96880,22727,46644,19086,74152,12518,6106,6412
62520,96891,22729,46651,19087,74161,12519,6107,6412
62525,96895,22730,46653,19088,74163,12519,6107,6412
62530,96905,22734,46658,19090,74170,12520,6107,6413
62535,96911,22734,46661,19090,74176,12522,6108,6414
62540,96922,22735,46670,19090,74185,12523,6109,6414
62545,96926,22735,46673,19090,74190,12523,6109,6414
62550,96936,22736,46679,19091,74200,12524,6110,6414
62555,96942,22736,46681,19091,74206,12526,6110,6416
62560,96953,22737,46687,19092,74216,12527,6111,6416
62565,96957,22737,46688,19092,74220,12527,6111,6416
62570,96967,22738,46696,19093,74228,12528,6111,6417
62575,96973,22738,46700,19093,74235,12530,6112,6418
62580,96984,22739,46705,19094,74244,12531,6112,6419
62585,96988,22739,46707,19094,74248,12531,6112,6419
62590,96998,22740,46711,19094,74258,12532,6113,6419
62595,97004,22740,46714,19094,74264,12534,6114,6420
62600,97015,22741,46718,19094,74274,12535,6114,6421
62605,97019,22741,46721,19094,74278,12535,6114,6421
62610,97029,22742,46725,19095,74286,12536,6114,6422
62615,97035,22742,46728,19095,74293,12538,6115,6423
62620,97046,22743,46732,19096,74303,12539,6115,6424
62625,97050,22743,46733,19096,74307,12539,6115,6424
62630,97060,22744,46741,19096,74315,12540,6115,6425
62635,97066,22744,46743,19096,74322,12542,6116,6426
62640,97077,22745,46750,19097,74331,12543,6117,6426
62645,97081,22746,46753,19098,74334,12543,6117,6426
62650,97091,22750,46755,19100,74341,12544,6118,6426
62655,97097,22750,46759,19100,74346,12546,6119,6427
62660,97108,22752,46765,19101,74355,12547,6120,6427
62665,97112,22753,46768,19102,74357,12547,6120,6427
62670,97122,22757,46771,19105,74364,12548,6121,6427
62675,97128,22757,46776,19105,74370,12550,6123,6427
62680,97139,22759,46780,19107,74380,12551,6123,6428
62685,97143,22759,46782,19107,74382,12551,6123,6428
62690,97153,22765,46787,19112,74388,12552,6123,6429
62695,97159,22765,46791,19112,74393,12554,6124,6430
62700,97170,22767,46795,19114,74403,12555,6124,6431
62705,97174,22768,46799,19115,74405,12555,6124,6431
62710,97184,22770,46803,19115,74413,12556,6124,6432
62715,97190,22770,46804,19115,74420,12558,6124,6434
62720,97201,22771,46809,19116,74430,12559,6124,6435
62725,97205,22772,46811,19117,74433,12559,6124,6435
62730,97215,22775,46818,19119,74439,12560,6125,6435
62735,97221,22775,46821,19119,74446,12562,6126,6436
62740,97232,22776,46826,19120,74456,12563,6127,6436
62745,97236,22777,46830,19121,74458,12563,6127,6436
62750,97246,22780,46835,19123,74466,12564,6127,6437
62755,97252,22780,46836,19123,74472,12566,6127,6439
62760,97263,22781,46842,19124,74482,12567,6128,6439
62765,97267,22781,46843,19124,74486,12567,6128,6439
62770,97277,22784,46847,19125,74492,12568,6129,6439
62775,97283,22785,46851,19126,74497,12570,6130,6440
62780,97294,22787,46856,19127,74505,12571,6131,6440
62785,97298,22789,46858,19129,74508,12571,6131,6440
62790,97308,22791,46861,19130,74516,12572,6131,6441
62795,97314,22792,46863,19131,74522,12574,6131,6443
62800,97325,22793,46869,19131,74531,12575,6131,6444
62805,97329,22795,46872,19133,74533,12575,6131,6444
62810,97339,22799,46877,19135,74540,12576,6131,6445
62815,97345,22799,46880,19135,74546,12578,6132,6446
62820,97356,22800,46886,19135,74555,12579,6132,6447
62825,97360,22800,46889,19135,74559,12579,6132,6447
62830,97370,22801,46895,19136,74568,12580,6132,6448
62835,97376,22801,46901,19136,74574,12582,6134,6448
62840,97387,22802,46907,19136,74584,12583,6134,6449
62845,97391,22802,46911,19136,74588,12583,6134,6449
62850,97401,22803,46918,19137,74598,12584,6135,6449
62855,97407,22803,46923,19137,74603,12586,6137,6449
62860,97418,22804,46928,19137,74612,12587,6138,6449
62865,97422,22804,46930,19137,74618,12587,6138,6449
62870,97432,22805,46934,19137,74626,12588,6138,6450
62875,97438,22805,46936,19137,74633,12590,6138,6452
62880,97449,22806,46942,19137,74642,12591,6138,6453
62885,97453,22806,46943,19137,74647,12591,6138,6453
62890,97463,22807,46949,19137,74656,12592,6139,6453
62895,97469,22807,46952,19137,74661,12594,6140,6454
62900,97480,22808,46958,19138,74671,12595,6141,6454
62905,97484,22808,46959,19138,74676,12595,6141,6454
62910,97494,22809,46965,19139,74685,12596,6142,6454
62915,97500,22809,46968,19139,74691,12598,6143,6455
62920,97511,22810,46976,19139,74698,12599,6144,6455
62925,97515,22811,46977,19140,74704,12599,6144,6455
62930,97525,22813,46980,19140,74711,12600,6144,6456
62935,97531,22813,46981,19140,74718,12602,6145,6457
62940,97542,22814,46985,19140,74728,12603,6145,6458
62945,97546,22814,46987,19140,74732,12603,6145,6458
62950,97556,22816,46990,19141,74740,12604,6145,6459
62955,97562,22816,46994,19141,74746,12606,6146,6460
62960,97573,22817,47000,19141,74755,12607,6146,6461
62965,97577,22818,47004,19142,74757,12607,6146,6461
62970,97587,22822,47008,19146,74765,12608,6146,6462
62975,97593,22822,47009,19146,74771,12610,6147,6463
62980,97604,22823,47014,19146,74781,12611,6147,6464
62985,97608,22824,47016,19147,74783,12611,6147,6464
62990,97618,22828,47019,19149,74790,12612,6148,6464
62995,97624,22828,47023,19149,74795,12614,6148,6466
63000,97635,22830,47027,19150,74805,12615,6149,6466
63005,97639,22831,47030,19151,74807,12615,6149,6466
63010,97649,22835,47036,19155,74813,12616,6150,6466
63015,97655,22835,47039,19155,74819,12618,6150,6468
63020,97666,22837,47044,19157,74829,12619,6150,6469
63025,97670,22837,47045,19157,74832,12619,6150,6469
63030,97680,22842,47051,19161,74836,12620,6150,6470
63035,97686,22844,47054,19163,74841,12622,6151,6471
63040,97697,22846,47060,19164,74850,12623,6152,6471
63045,97701,22847,47061,19165,74853,12623,6152,6471
63050,97711,22851,47067,19169,74859,12624,6152,6472
63055,97717,22852,47069,19170,74864,12626,6152,6474
63060,97728,22854,47072,19171,74874,12627,6153,6474
63065,97732,22854,47073,19171,74878,12627,6153,6474
63070,97742,22855,47077,19171,74886,12628,6154,6474
63075,97748,22855,47080,19171,74893,12630,6155,6475
63080,97759,22856,47083,19171,74903,12631,6155,6476
63085,97763,22856,47086,19171,74906,12631,6155,6476
63090,97773,22857,47090,19171,74916,12632,6155,6477
63095,97779,22857,47092,19171,74922,12634,6156,6478
63100,97790,22858,47096,19171,74930,12635,6156,6479
63105,97794,22858,47097,19171,74936,12635,6156,6479
63110,97804,22859,47101,19171,74945,12636,6156,6480
63115,97810,22859,47104,19171,74950,12638,6157,6481
63120,97821,22860,47109,19171,74961,12639,6157,6482
63125,97825,22860,47112,19171,74965,12639,6157,6482
63130,97835,22861,47118,19171,74973,12640,6158,6482
63135,97841,22861,47123,19171,74979,12642,6160,6482
63140,97852,22862,47127,19171,74990,12643,6161,6482
63145,97856,22862,47129,19171,74994,12643,6161,6482
63150,97866,22863,47134,19171,75002,12644,6162,6482
63155,97872,22863,47139,19171,75008,12646,6163,6483
63160,97883,22864,47144,19171,75019,12647,6163,6484
63165,97887,22865,47148,19172,75020,12647,6163,6484
63170,97897,22871,47157,19178,75024,12648,6164,6484
63175,97903,22872,47159,19179,75031,12650,6165,6485
63180,97914,22873,47164,19180,75041,12651,6165,6486
63185,97918,22874,47166,19181,75044,12651,6165,6486
63190,97928,22876,47170,19183,75051,12652,6166,6486
63195,97934,22877,47176,19184,75056,12654,6168,6486
63200,97945,22879,47179,19185,75066,12655,6168,6487
63205,97949,22880,47180,19186,75069,12655,6168,6487
63210,97959,22882,47186,19187,75076,12656,6169,6487
63215,97965,22883,47190,19188,75081,12658,6170,6488
63220,97976,22885,47197,19190,75089,12659,6171,6488
63225,97980,22888,47200,19193,75092,12659,6171,6488
63230,97990,22892,47206,19196,75097,12660,6172,6488
63235,97996,22892,47208,19196,75104,12662,6174,6488
63240,98007,22893,47212,19196,75113,12663,6175,6488
63245,98011,22893,47213,19196,75118,12663,6175,6488
63250,98021,22895,47218,19196,75125,12664,6176,6488
63255,98027,22895,47218,19196,75132,12666,6176,6490
63260,98038,22896,47224,19196,75142,12667,6177,6490
63265,98042,22896,47226,19196,75146,12667,6177,6490
63270,98052,22898,47228,19197,75153,12668,6177,6491
63275,98058,22898,47231,19197,75160,12670,6178,6492
63280,98069,22899,47238,19197,75168,12671,6179,6492
63285,98073,22900,47241,19198,75171,12671,6179,6492
63290,98083,22905,47246,19203,75177,12672,6179,6493
63295,98089,22905,47250,19203,75183,12674,6180,6494
63300,98100,22907,47257,19204,75192,12675,6181,6494
63305,98104,22907,47259,19204,75197,12675,6181,6494
63310,98114,22909,47262,19204,75204,12676,6182,6494
63315,98120,22909,47266,19204,75210,12678,6184,6494
63320,98131,22911,47272,19205,75218,12679,6184,6495
63325,98135,22912,47275,19206,75221,12679,6184,6495
63330,98145,22916,47280,19209,75228,12680,6185,6495
63335,98151,22916,47282,19209,75235,12682,6186,6496
63340,98162,22917,47290,19210,75245,12683,6187,6496
63345,98166,22918,47293,19211,75246,12683,6187,6496
63350,98176,22923,47300,19216,75252,12684,6187,6497
63355,98182,22923,47301,19216,75259,12686,6187,6499
63360,98193,22924,47309,19217,75269,12687,6187,6500
63365,98197,22924,47310,19217,75272,12687,6187,6500
63370,98207,22924,47315,19217,75282,12688,6187,6501
63375,98213,22924,47318,19217,75289,12690,6188,6502
63380,98224,22925,47325,19217,75299,12691,6189,6502
63385,98228,22925,47325,19217,75303,12691,6189,6502
63390,98238,22925,47329,19217,75312,12692,6189,6503
63395,98244,22925,47330,19217,75319,12694,6190,6504
63400,98255,22926,47335,19217,75329,12695,6190,6505
63405,98259,22926,47337,19217,75332,12695,6190,6505
63410,98269,22926,47341,19217,75342,12696,6191,6505
63415,98275,22926,47343,19217,75349,12698,6192,6506
63420,98286,22927,47348,19218,75359,12699,6193,6506
63425,98290,22927,47349,19218,75363,12699,6193,6506
63430,98300,22927,47357,19218,75372,12700,6194,6506
63435,98306,22927,47361,19218,75379,12702,6195,6507
63440,98317,22928,47365,19219,75388,12703,6195,6508
63445,98321,22928,47365,19219,75393,12703,6195,6508
63450,98331,22928,47369,19219,75402,12704,6195,6509
63455,98337,22929,47372,19220,75407,12706,6196,6510
63460,98348,22931,47378,19221,75415,12707,6196,6511
63465,98352,22934,47380,19224,75418,12707,6196,6511
63470,98362,22936,47386,19226,75424,12708,6197,6511
63475,98368,22937,47389,19227,75430,12710,6197,6513
63480,98379,22939,47394,19229,75439,12711,6198,6513
63485,98383,22941,47398,19231,75440,12711,6198,6513
63490,98393,22947,47403,19237,75445,12712,6198,6514
63495,98399,22948,47408,19238,75449,12714,6199,6515
63500,98410,22951,47415,19241,75458,12715,6199,6516
63505,98414,22951,47417,19241,75463,12715,6199,6516
63510,98424,22951,47422,19241,75472,12716,6199,6517
63515,98430,22951,47422,19241,75479,12718,6199,6519
63520,98441,22952,47427,19242,75488,12719,6199,6520
63525,98445,22952,47430,19242,75492,12719,6199,6520
63530,98455,22952,47435,19242,75502,12720,6199,6521
63535,98461,22952,47438,19242,75508,12722,6199,6523
63540,98472,22953,47445,19242,75518,12723,6199,6524
63545,98476,22953,47447,19242,75523,12723,6199,6524
63550,98486,22953,47451,19242,75532,12724,6199,6525
63555,98492,22953,47453,19242,75538,12726,6200,6526
63560,98503,22954,47458,19243,75548,12727,6200,6527
63565,98507,22954,47461,19243,75552,12727,6200,6527
63570,98517,22954,47468,19243,75562,12728,6201,6527
63575,98523,22954,47470,19243,75569,12730,6201,6529
63580,98534,22955,47476,19243,75578,12731,6202,6529
63585,98538,22955,47477,19243,75583,12731,6202,6529
63590,98548,22955,47481,19243,75592,12732,6202,6530
63595,98554,22955,47484,19243,75599,12734,6203,6531
63600,98565,22956,47491,19244,75609,12735,6203,6532
63605,98569,22956,47493,19244,75613,12735,6203,6532
63610,98579,22957,47499,19245,75621,12736,6204,6532
63615,98585,22957,47502,19245,75628,12738,6205,6533
63620,98596,22958,47505,19245,75638,12739,6205,6534
63625,98600,22958,47505,19245,75642,12739,6205,6534
63630,98610,22959,47510,19245,75650,12740,6205,6535
63635,98616,22959,47512,19245,75657,12742,6207,6535
63640,98627,22960,47518,19246,75666,12743,6208,6535
63645,98631,22960,47519,19246,75671,12743,6208,6535
63650,98641,22962,47522,19248,75678,12744,6208,6536
63655,98647,22962,47525,19248,75685,12746,6209,6537
63660,98658,22963,47529,19248,75694,12747,6210,6537
63665,98662,22964,47531,19249,75697,12747,6210,6537
63670,98672,22967,47538,19252,75703,12748,6211,6537
63675,98678,22968,47540,19253,75710,12750,6212,6538
63680,98689,22969,47545,19253,75718,12751,6212,6539
63685,98693,22971,47547,19255,75721,12751,6212,6539
63690,98703,22974,47553,19258,75728,12752,6212,6540
63695,98709,22974,47557,19258,75734,12754,6214,6540
63700,98720,22976,47564,19260,75744,12755,6215,6540
63705,98724,22976,47565,19260,75747,12755,6215,6540
63710,98734,22979,47571,19263,75754,12756,6216,6540
63715,98740,22979,47573,19263,75760,12758,6217,6541
63720,98751,22981,47580,19264,75768,12759,6218,6541
63725,98755,22982,47581,19265,75772,12759,6218,6541
63730,98765,22985,47586,19268,75779,12760,6218,6542
63735,98771,22985,47587,19268,75786,12762,6218,6544
63740,98782,22986,47593,19269,75796,12763,6218,6545
63745,98786,22986,47594,19269,75799,12763,6218,6545
63750,98796,22988,47595,19271,75807,12764,6218,6546
63755,98802,22988,47599,19271,75814,12766,6220,6546
63760,98813,22989,47603,19271,75824,12767,6220,6547
63765,98817,22990,47605,19272,75827,12767,6220,6547
63770,98827,22992,47608,19273,75834,12768,6220,6548
63775,98833,22992,47611,19273,75840,12770,6221,6549
63780,98844,22994,47613,19274,75850,12771,6221,6550
63785,98848,22995,47615,19275,75852,12771,6221,6550
63790,98858,22998,47620,19278,75859,12772,6222,6550
63795,98864,22998,47625,19278,75865,12774,6223,6551
63800,98875,23000,47630,19280,75874,12775,6223,6552
63805,98879,23002,47633,19282,75876,12775,6223,6552
63810,98889,23004,47636,19283,75884,12776,6223,6553
63815,98895,23004,47639,19283,75891,12778,6224,6554
63820,98906,23005,47645,19283,75901,12779,6225,6554
63825,98910,23005,47647,19283,75904,12779,6225,6554
63830,98920,23005,47653,19283,75914,12780,6226,6554
63835,98926,23005,47655,19283,75921,12782,6227,6555
63840,98937,23006,47659,19284,75931,12783,6228,6555
63845,98941,23006,47662,19284,75934,12783,6228,6555
63850,98951,23006,47667,19284,75944,12784,6228,6556
63855,98957,23006,47669,19284,75950,12786,6228,6558
63860,98968,23007,47674,19284,75960,12787,6228,6559
63865,98972,23007,47674,19284,75965,12787,6228,6559
63870,98982,23007,47679,19284,75974,12788,6229,6559
63875,98988,23007,47683,19284,75980,12790,6230,6560
63880,98999,23008,47686,19284,75991,12791,6230,6561
63885,99003,23008,47687,19284,75994,12791,6230,6561
63890,99013,23008,47692,19284,76005,12792,6231,6561
63895,99019,23008,47692,19284,76011,12794,6231,6563
63900,99030,23009,47700,19285,76020,12795,6231,6564
63905,99034,23009,47703,19285,76024,12795,6231,6564
63910,99044,23009,47709,19285,76034,12796,6231,6565
63915,99050,23010,47711,19286,76038,12798,6231,6567
63920,99061,23013,47717,19288,76046,12799,6231,6568
63925,99065,23016,47719,19291,76048,12799,6231,6568
63930,99075,23018,47722,19293,76056,12800,6231,6569
63935,99081,23019,47724,19294,76062,12802,6232,6570
63940,99092,23020,47729,19294,76069,12803,6233,6570
63945,99096,23023,47730,19297,76073,12803,6233,6570
63950,99106,23025,47732,19298,76081,12804,6233,6571
63955,99112,23025,47733,19298,76087,12806,6233,6573
63960,99123,23026,47740,19299,76096,12807,6233,6574
63965,99127,23027,47741,19300,76099,12807,6233,6574
63970,99137,23031,47746,19303,76104,12808,6234,6574
63975,99143,23033,47749,19305,76110,12810,6236,6574
63980,99154,23034,47755,19305,76119,12811,6237,6574
63985,99158,23036,47758,19307,76121,12811,6237,6574
63990,99168,23038,47767,19308,76129,12812,6238,6574
63995,99174,23038,47769,19308,76136,12814,6238,6576
64000,99185,23039,47773,19308,76145,12815,6239,6576
64005,99189,23039,47774,19308,76149,12815,6239,6576
64010,99199,23039,47781,19308,76159,12816,6240,6576
64015,99205,23039,47785,19308,76166,12818,6241,6577
64020,99216,23040,47788,19308,76176,12819,6241,6578
64025,99220,23040,47791,19308,76179,12819,6241,6578
64030,99230,23040,47797,19308,76190,12820,6241,6579
64035,99236,23040,47802,19308,76196,12822,6243,6579
64040,99247,23041,47809,19309,76206,12823,6243,6580
64045,99251,23041,47810,19309,76210,12823,6243,6580
64050,99261,23041,47816,19309,76220,12824,6244,6580
64055,99267,23041,47819,19309,76226,12826,6245,6581
64060,99278,23042,47822,19309,76236,12827,6245,6582
64065,99282,23042,47824,19309,76239,12827,6245,6582
64070,99292,23042,47829,19309,76250,12828,6246,6582
64075,99298,23042,47833,19309,76256,12830,6247,6583
64080,99309,23043,47840,19310,76266,12831,6247,6584
64085,99313,23043,47843,19310,76269,12831,6247,6584
64090,99323,23043,47849,19310,76280,12832,6248,6584
64095,99329,23043,47854,19310,76286,12834,6250,6584
64100,99340,23044,47862,19310,76296,12835,6251,6584
64105,99344,23044,47863,19310,76299,12835,6251,6584
64110,99354,23045,47867,19311,76308,12836,6252,6584
64115,99360,23046,47870,19312,76313,12838,6253,6585
64120,99371,23048,47875,19313,76322,12839,6254,6585
64125,99375,23049,47876,19314,76326,12839,6254,6585
64130,99385,23052,47879,19316,76332,12840,6254,6586
64135,99391,23053,47883,19317,76338,12842,6256,6586
64140,99402,23054,47888,19317,76346,12843,6256,6587
64145,99406,23057,47890,19320,76349,12843,6256,6587
64150,99416,23059,47894,19321,76357,12844,6256,6588
64155,99422,23059,47896,19321,76362,12846,6257,6589
64160,99433,23061,47902,19322,76371,12847,6258,6589
64165,99437,23062,47904,19323,76375,12847,6258,6589
64170,99447,23065,47910,19326,76381,12848,6259,6589
64175,99453,23066,47912,19327,76387,12850,6260,6590
64180,99464,23067,47918,19327,76395,12851,6261,6590
64185,99468,23069,47921,19329,76398,12851,6261,6590
64190,99478,23072,47925,19332,76406,12852,6261,6591
64195,99484,23072,47929,19332,76412,12854,6263,6591
64200,99495,23073,47933,19333,76420,12855,6264,6591
64205,99499,23073,47934,19333,76425,12855,6264,6591
64210,99509,23076,47939,19336,76433,12856,6264,6592
64215,99515,23076,47943,19336,76437,12858,6265,6593
64220,99526,23078,47947,19337,76447,12859,6266,6593
64225,99530,23078,47948,19337,76451,12859,6266,6593
64230,99540,23081,47953,19339,76458,12860,6266,6594
64235,99546,23081,47956,19339,76464,12862,6267,6595
64240,99557,23083,47960,19340,76474,12863,6268,6595
64245,99561,23083,47962,19340,76477,12863,6268,6595
64250,99571,23085,47965,19341,76486,12864,6268,6596
64255,99577,23085,47969,19341,76491,12866,6269,6597
64260,99588,23086,47973,19341,76501,12867,6270,6597
64265,99592,23086,47976,19341,76505,12867,6270,6597
64270,99602,23086,47979,19341,76516,12868,6270,6598
64275,99608,23086,47981,19341,76522,12870,6271,6599
64280,99619,23087,47985,19341,76532,12871,6271,6600
64285,99623,23087,47986,19341,76536,12871,6271,6600
64290,99633,23087,47993,19341,76545,12872,6272,6600
64295,99639,23087,47995,19341,76552,12874,6273,6601
64300,99650,23088,48001,19341,76562,12875,6274,6601
64305,99654,23088,48002,19341,76566,12875,6274,6601
64310,99664,23088,48006,19341,76575,12876,6275,6601
64315,99670,23088,48010,19341,76582,12878,6276,6602
64320,99681,23089,48017,19342,76592,12879,6277,6602
64325,99685,23089,48019,19342,76595,12879,6277,6602
64330,99695,23089,48025,19342,76605,12880,6278,6602
64335,99701,23089,48026,19342,76612,12882,6278,6604
64340,99712,23090,48034,19343,76622,12883,6278,6605
64345,99716,23090,48037,19343,76625,12883,6278,6605
64350,99726,23090,48041,19343,76636,12884,6278,6606
64355,99732,23090,48044,19343,76641,12886,6279,6607
64360,99743,23092,48049,19344,76651,12887,6279,6608
64365,99747,23092,48050,19344,76654,12887,6279,6608
64370,99757,23094,48053,19345,76662,12888,6279,6609
64375,99763,23094,48057,19345,76668,12890,6281,6609
64380,99774,23096,48065,19346,76677,12891,6282,6609
64385,99778,23097,48068,19347,76679,12891,6282,6609
64390,99788,23101,48073,19351,76687,12892,6282,6610
64395,99794,23101,48074,19351,76693,12894,6282,6612
64400,99805,23102,48078,19352,76702,12895,6282,6613
64405,99809,23104,48081,19354,76704,12895,6282,6613
64410,99819,23107,48086,19357,76712,12896,6282,6614
64415,99825,23107,48089,19357,76717,12898,6282,6616
64420,99836,23109,48095,19358,76726,12899,6283,6616
64425,99840,23111,48097,19360,76729,12899,6283,6616
64430,99850,23113,48103,19362,76736,12900,6284,6616
64435,99856,23114,48105,19363,76742,12902,6286,6616
64440,99867,23115,48112,19364,76749,12903,6287,6616
64445,99871,23119,48114,19368,76752,12903,6287,6616
64450,99881,23121,48120,19370,76760,12904,6287,6617
64455,99887,23121,48122,19370,76766,12906,6289,6617
64460,99898,23122,48125,19370,76775,12907,6289,6618
64465,99902,23122,48127,19370,76779,12907,6289,6618
64470,99912,23122,48129,19370,76789,12908,6289,6619
64475,99918,23122,48130,19370,76796,12910,6289,6621
64480,99929,23123,48133,19371,76806,12911,6289,6622
64485,99933,23123,48133,19371,76810,12911,6289,6622
64490,99943,23123,48136,19371,76820,12912,6290,6622
64495,99949,23123,48137,19371,76826,12914,6291,6623
64500,99960,23124,48143,19372,76835,12915,6291,6624
64505,99964,23124,48146,19372,76840,12915,6291,6624
64510,99974,23124,48150,19372,76850,12916,6292,6624
64515,99980,23124,48152,19372,76855,12918,6292,6626
64520,99991,23125,48157,19372,76865,12919,6293,6626
64525,99995,23125,48160,19372,76869,12919,6293,6626
64530,100005,23125,48165,19372,76880,12920,6294,6626
64535,100011,23125,48167,19372,76886,12922,6295,6627
64540,100022,23126,48171,19372,76895,12923,6295,6628
64545,100026,23126,48173,19372,76899,12923,6295,6628
64550,100036,23126,48180,19372,76909,12924,6295,6629
64555,100042,23126,48183,19372,76916,12926,6297,6629
64560,100053,23127,48186,19372,76926,12927,6298,6629
64565,100057,23127,48186,19372,76930,12927,6298,6629
64570,100067,23129,48192,19373,76937,12928,6299,6629
64575,100073,23130,48193,19374,76943,12930,6299,6631
64580,100084,23131,48198,19375,76953,12931,6299,6632
64585,100088,23132,48200,19376,76955,12931,6299,6632
64590,100098,23136,48204,19379,76962,12932,6299,6633
64595,100104,23136,48208,19379,76966,12934,6300,6634
64600,100115,23139,48216,19382,76973,12935,6301,6634
64605,100119,23142,48218,19385,76975,12935,6301,6634
64610,100129,23147,48224,19389,76980,12936,6302,6634
64615,100135,23149,48228,19391,76985,12938,6303,6635
64620,100146,23151,48235,19392,76992,12939,6303,6636
64625,100150,23152,48237,19393,76997,12939,6303,6636
64630,100160,23152,48241,19393,77007,12940,6303,6637
64635,100166,23152,48244,19393,77014,12942,6304,6638
64640,100177,23153,48249,19393,77024,12943,6304,6639
64645,100181,23153,48252,19393,77027,12943,6304,6639
64650,100191,23153,48259,19393,77037,12944,6304,6640
64655,100197,23153,48263,19393,77044,12946,6305,6641
64660,100208,23154,48267,19394,77054,12947,6305,6642
64665,100212,23154,48268,19394,77057,12947,6305,6642
64670,100222,23154,48272,19394,77067,12948,6306,6642
64675,100228,23154,48274,19394,77074,12950,6307,6643
64680,100239,23155,48278,19394,77084,12951,6307,6644
64685,100243,23155,48278,19394,77088,12951,6307,6644
64690,100253,23155,48283,19394,77098,12952,6307,6645
64695,100259,23155,48286,19394,77104,12954,6308,6646
64700,100270,23156,48290,19394,77114,12955,6309,6646
64705,100274,23156,48291,19394,77118,12955,6309,6646
64710,100284,23156,48296,19394,77128,12956,6310,6646
64715,100290,23156,48299,19394,77134,12958,6311,6647
64720,100301,23157,48305,19395,77144,12959,6312,6647
64725,100305,23157,48309,19395,77147,12959,6312,6647
64730,100315,23159,48312,19397,77156,12960,6312,6648
64735,100321,23159,48316,19397,77160,12962,6313,6649
64740,100332,23162,48321,19399,77168,12963,6314,6649
64745,100336,23164,48323,19401,77171,12963,6314,6649
64750,100346,23168,48328,19405,77177,12964,6314,6650
64755,100352,23169,48329,19406,77183,12966,6315,6651
64760,100363,23170,48332,19407,77192,12967,6315,6652
64765,100367,23171,48333,19408,77195,12967,6315,6652
64770,100377,23176,48338,19413,77201,12968,6315,6653
64775,100383,23176,48339,19413,77207,12970,6316,6654
64780,100394,23177,48344,19414,77216,12971,6316,6655
64785,100398,23178,48345,19415,77220,12971,6316,6655
64790,100408,23180,48351,19416,77227,12972,6317,6655
64795,100414,23181,48355,19417,77231,12974,6319,6655
64800,100425,23184,48362,19420,77240,12975,6320,6655
64805,100429,23184,48364,19420,77245,12975,6320,6655
64810,100439,23184,48370,19420,77254,12976,6320,6656
64815,100445,23184,48374,19420,77260,12978,6321,6657
64820,100456,23185,48380,19421,77270,12979,6322,6657
64825,100460,23185,48381,19421,77275,12979,6322,6657
64830,100470,23185,48388,19421,77284,12980,6323,6657
64835,100476,23185,48389,19421,77291,12982,6323,6659
64840,100487,23186,48396,19422,77299,12983,6323,6660
64845,100491,23186,48398,19422,77304,12983,6323,6660
64850,100501,23186,48399,19422,77315,12984,6324,6660
64855,100507,23186,48404,19422,77320,12986,6326,6660
64860,100518,23187,48407,19422,77330,12987,6326,6661
64865,100522,23187,48410,19422,77334,12987,6326,6661
64870,100532,23187,48415,19422,77344,12988,6326,6662
64875,100538,23187,48418,19422,77351,12990,6327,6663
64880,100549,23188,48425,19422,77360,12991,6328,6663
64885,100553,23188,48428,19422,77364,12991,6328,6663
64890,100563,23188,48435,19422,77374,12992,6329,6663
64895,100569,23188,48438,19422,77381,12994,6330,6664
64900,100580,23189,48444,19423,77391,12995,6330,6665
64905,100584,23189,48446,19423,77394,12995,6330,6665
64910,100594,23191,48451,19425,77403,12996,6331,6665
64915,100600,23191,48454,19425,77409,12998,6333,6665
64920,100611,23192,48458,19426,77419,12999,6333,6666
64925,100615,23192,48459,19426,77423,12999,6333,6666
64930,100625,23193,48462,19427,77432,13000,6334,6666
64935,100631,23193,48465,19427,77438,13002,6336,6666
64940,100642,23194,48468,19428,77448,13003,6336,6667
64945,100646,23194,48469,19428,77452,13003,6336,6667
64950,100656,23195,48475,19428,77460,13004,6337,6667
64955,100662,23195,48478,19428,77467,13006,6338,6668
64960,100673,23196,48485,19429,77476,13007,6338,6669
64965,100677,23196,48487,19429,77480,13007,6338,6669
64970,100687,23197,48493,19430,77490,13008,6339,6669
64975,100693,23197,48495,19430,77496,13010,6339,6671
64980,100704,23198,48499,19431,77506,13011,6339,6672
64985,100708,23198,48500,19431,77510,13011,6339,6672
64990,100718,23199,48504,19432,77519,13012,6340,6672
64995,100724,23199,48506,19432,77525,13014,6341,6673
65000,100735,23200,48509,19432,77535,13015,6342,6673
65005,100739,23200,48511,19432,77538,13015,6342,6673
65010,100749,23204,48518,19435,77544,13016,6342,6674
65015,100755,23204,48519,19435,77551,13018,6343,6675
65020,100766,23205,48523,19435,77561,13019,6344,6675
65025,100770,23206,48524,19436,77564,13019,6344,6675
65030,100780,23209,48530,19438,77570,13020,6344,6676
65035,100786,23209,48531,19438,77577,13022,6344,6678
65040,100797,23210,48535,19438,77587,13023,6344,6679
65045,100801,23210,48537,19438,77590,13023,6344,6679
65050,100811,23212,48542,19440,77598,13024,6344,6680
65055,100817,23212,48544,19440,77604,13026,6345,6681
65060,100828,23214,48547,19441,77614,13027,6346,6681
65065,100832,23214,48548,19441,77617,13027,6346,6681
65070,100842,23217,48552,19443,77625,13028,6347,6681
65075,100848,23217,48555,19443,77630,13030,6348,6682
65080,100859,23219,48559,19444,77638,13031,6349,6682
65085,100863,23222,48562,19447,77640,13031,6349,6682
65090,100873,23226,48566,19450,77646,13032,6349,6683
65095,100879,23227,48567,19451,77652,13034,6350,6684
65100,100890,23228,48571,19451,77662,13035,6350,6685
65105,100894,23228,48573,19451,77665,13035,6350,6685
65110,100904,23231,48575,19453,77672,13036,6350,6686
65115,100910,23232,48578,19454,77677,13038,6352,6686
65120,100921,23234,48586,19455,77684,13039,6353,6686
65125,100925,23238,48588,19459,77687,13039,6353,6686
65130,100935,23240,48593,19460,77694,13040,6354,6686
65135,100941,23241,48596,19461,77699,13042,6356,6686
65140,100952,23243,48603,19462,77707,13043,6357,6686
65145,100956,23245,48606,19464,77709,13043,6357,6686
65150,100966,23246,48610,19465,77720,13044,6358,6686
65155,100972,23246,48613,19465,77725,13046,6359,6687
65160,100983,23247,48617,19465,77736,13047,6359,6688
65165,100987,23247,48619,19465,77739,13047,6359,6688
65170,100997,23247,48624,19465,77749,13048,6360,6688
65175,101003,23247,48627,19465,77756,13050,6361,6689
65180,101014,23248,48633,19466,77764,13051,6362,6689
65185,101018,23248,48636,19466,77769,13051,6362,6689
65190,101028,23248,48640,19466,77779,13052,6362,6690
65195,101034,23248,48645,19466,77785,13054,6363,6691
65200,101045,23249,48649,19467,77795,13055,6364,6691
65205,101049,23249,48652,19467,77799,13055,6364,6691
65210,101059,23249,48656,19467,77810,13056,6364,6692
65215,101065,23249,48657,19467,77816,13058,6364,6694
65220,101076,23250,48665,19468,77825,13059,6364,6695
65225,101080,23250,48665,19468,77830,13059,6364,6695
65230,101090,23250,48670,19468,77839,13060,6365,6695
65235,101096,23250,48671,19468,77846,13062,6366,6696
65240,101107,23251,48675,19468,77855,13063,6366,6697
65245,101111,23251,48677,19468,77859,13063,6366,6697
65250,101121,23251,48682,19468,77870,13064,6366,6698
65255,101127,23251,48683,19468,77876,13066,6367,6699
65260,101138,23252,48687,19468,77885,13067,6367,6700
65265,101142,23254,48690,19470,77886,13067,6367,6700
65270,101152,23258,48694,19473,77892,13068,6367,6701
65275,101158,23260,48695,19475,77898,13070,6368,6702
65280,101169,23261,48699,19475,77908,13071,6368,6703
65285,101173,23261,48700,19475,77912,13071,6368,6703
65290,101183,23262,48704,19475,77921,13072,6369,6703
65295,101189,23262,48708,19475,77927,13074,6371,6703
65300,101200,23263,48714,19475,77937,13075,6371,6704
65305,101204,23263,48716,19475,77940,13075,6371,6704
65310,101214,23264,48722,19475,77949,13076,6371,6705
65315,101220,23264,48726,19475,77956,13078,6372,6706
65320,101231,23265,48733,19476,77966,13079,6372,6707
65325,101235,23265,48735,19476,77969,13079,6372,6707
65330,101245,23266,48742,19477,77978,13080,6372,6708
65335,101251,23266,48746,19477,77985,13082,6374,6708
65340,101262,23267,48750,19478,77995,13083,6374,6709
65345,101266,23267,48753,19478,77998,13083,6374,6709
65350,101276,23268,48756,19479,78008,13084,6374,6710
65355,101282,23268,48759,19479,78014,13086,6375,6711
65360,101293,23269,48764,19480,78024,13087,6376,6711
65365,101297,23269,48766,19480,78028,13087,6376,6711
65370,101307,23270,48773,19481,78037,13088,6377,6711
65375,101313,23270,48776,19481,78042,13090,6377,6713
65380,101324,23272,48782,19483,78051,13091,6378,6713
65385,101328,23272,48785,19483,78055,13091,6378,6713
65390,101338,23275,48789,19486,78062,13092,6378,6714
65395,101344,23276,48793,19487,78067,13094,6380,6714
65400,101355,23278,48797,19488,78075,13095,6380,6715
65405,101359,23280,48799,19490,78078,13095,6380,6715
65410,101369,23284,48805,19493,78083,13096,6380,6716
65415,101375,23286,48808,19495,78088,13098,6381,6717
65420,101386,23288,48810,19496,78098,13099,6381,6718
65425,101390,23288,48811,19496,78101,13099,6381,6718
65430,101400,23292,48817,19500,78107,13100,6381,6719
65435,101406,23293,48818,19501,78113,13102,6381,6721
65440,101417,23294,48825,19501,78121,13103,6381,6722
65445,101421,23296,48827,19503,78124,13103,6381,6722
65450,101431,23299,48831,19505,78130,13104,6381,6723
65455,101437,23301,48833,19507,78135,13106,6381,6725
65460,101448,23303,48840,19509,78144,13107,6381,6726
65465,101452,23303,48842,19509,78148,13107,6381,6726
65470,101462,23303,48846,19509,78158,13108,6382,6726
65475,101468,23303,48848,19509,78165,13110,6383,6727
65480,101479,23304,48853,19509,78174,13111,6384,6727
65485,101483,23304,48854,19509,78179,13111,6384,6727
65490,101493,23304,48860,19509,78189,13112,6385,6727
65495,101499,23304,48865,19509,78195,13114,6387,6727
65500,101510,23305,48870,19510,78205,13115,6387,6728
65505,101514,23305,48872,19510,78209,13115,6387,6728
65510,101524,23305,48876,19510,78219,13116,6387,6729
65515,101530,23305,48881,19510,78225,13118,6388,6730
65520,101541,23306,48888,19511,78234,13119,6389,6730
65525,101545,23306,48889,19511,78239,13119,6389,6730
65530,101555,23306,48893,19511,78249,13120,6390,6730
65535,101561,23306,48896,19511,78255,13122,6392,6730
65540,101572,23307,48906,19512,78265,13123,6393,6730
65545,101576,23307,48909,19512,78268,13123,6393,6730
65550,101586,23307,48914,19512,78279,13124,6393,6731
65555,101592,23307,48915,19512,78285,13126,6393,6733
65560,101603,23308,48919,19512,78295,13127,6393,6734
65565,101607,23309,48920,19513,78298,13127,6393,6734
65570,101617,23311,48922,19514,78306,13128,6393,6735
65575,101623,23311,48925,19514,78311,13130,6394,6736
65580,101634,23313,48931,19515,78320,13131,6395,6736
65585,101638,23314,48931,19516,78324,13131,6395,6736
65590,101648,23316,48935,19517,78331,13132,6395,6737
65595,101654,23316,48939,19517,78338,13134,6397,6737
65600,101665,23317,48946,19517,78347,13135,6397,6738
65605,101669,23318,48948,19518,78349,13135,6397,6738
65610,101679,23321,48952,19521,78357,13136,6397,6739
65615,101685,23321,48954,19521,78364,13138,6398,6740
65620,101696,23322,48958,19522,78374,13139,6399,6740
65625,101700,23323,48961,19523,78375,13139,6399,6740
65630,101710,23327,48965,19526,78382,13140,6399,6741
65635,101716,23327,48970,19526,78388,13142,6400,6742
65640,101727,23329,48976,19527,78398,13143,6401,6742
65645,101731,23329,48978,19527,78401,13143,6401,6742
65650,101741,23334,48984,19532,78406,13144,6401,6743
65655,101747,23335,48987,19533,78412,13146,6402,6744
65660,101758,23336,48994,19534,78422,13147,6402,6745
65665,101762,23336,48994,19534,78426,13147,6402,6745
65670,101772,23337,48996,19535,78434,13148,6402,6746
65675,101778,23337,49000,19535,78441,13150,6404,6746
65680,101789,23338,49007,19535,78449,13151,6405,6746
65685,101793,23341,49009,19538,78451,13151,6405,6746
65690,101803,23344,49016,19541,78458,13152,6405,6747
65695,101809,23344,49020,19541,78464,13154,6407,6747
65700,101820,23345,49026,19542,78473,13155,6408,6747
65705,101824,23345,49028,19542,78478,13155,6408,6747
65710,101834,23345,49033,19542,78488,13156,6409,6747
65715,101840,23345,49034,19542,78495,13158,6410,6748
65720,101851,23346,49040,19543,78504,13159,6411,6748
65725,101855,23346,49043,19543,78508,13159,6411,6748
65730,101865,23346,49051,19543,78518,13160,6412,6748
65735,101871,23346,49054,19543,78524,13162,6412,6750
65740,101882,23347,49061,19544,78534,13163,6413,6750
65745,101886,23347,49061,19544,78539,13163,6413,6750
65750,101896,23347,49066,19544,78548,13164,6414,6750
65755,101902,23347,49069,19544,78554,13166,6414,6752
65760,101913,23348,49074,19544,78564,13167,6414,6753
65765,101917,23348,49076,19544,78568,13167,6414,6753
65770,101927,23348,49082,19544,78578,13168,6414,6754
65775,101933,23348,49084,19544,78585,13170,6414,6756
65780,101944,23349,49091,19544,78595,13171,6415,6756
65785,101948,23349,49093,19544,78598,13171,6415,6756
65790,101958,23349,49096,19544,78608,13172,6415,6757
65795,101964,23349,49099,19544,78615,13174,6417,6757
65800,101975,23350,49105,19544,78625,13175,6418,6757
65805,101979,23350,49108,19544,78628,13175,6418,6757
65810,101989,23351,49114,19545,78637,13176,6418,6758
65815,101995,23351,49117,19545,78644,13178,6419,6759
65820,102006,23352,49126,19546,78654,13179,6420,6759
65825,102010,23352,49128,19546,78657,13179,6420,6759
65830,102020,23353,49136,19547,78666,13180,6421,6759
65835,102026,23353,49138,19547,78673,13182,6422,6760
65840,102037,23354,49145,19548,78683,13183,6423,6760
65845,102041,23354,49148,19548,78686,13183,6423,6760
65850,102051,23355,49149,19548,78695,13184,6424,6760
65855,102057,23355,49150,19548,78702,13186,6424,6762
65860,102068,23356,49153,19548,78712,13187,6425,6762
65865,102072,23356,49154,19548,78716,13187,6425,6762
65870,102082,23357,49161,19549,78724,13188,6426,6762
65875,102088,23358,49162,19550,78729,13190,6426,6764
65880,102099,23360,49165,19552,78739,13191,6426,6765
65885,102103,23360,49165,19552,78743,13191,6426,6765
65890,102113,23362,49167,19553,78750,13192,6426,6766
65895,102119,23362,49169,19553,78756,13194,6427,6767
65900,102130,23364,49173,19554,78765,13195,6428,6767
65905,102134,23366,49175,19556,78768,13195,6428,6767
65910,102144,23370,49183,19559,78773,13196,6429,6767
65915,102150,23371,49185,19560,78778,13198,6429,6769
65920,102161,23373,49189,19562,78786,13199,6429,6770
65925,102165,23375,49191,19564,78788,13199,6429,6770
65930,102175,23378,49195,19567,78796,13200,6430,6770
65935,102181,23378,49197,19567,78802,13202,6430,6772
65940,102192,23380,49203,19569,78811,13203,6430,6773
65945,102196,23382,49204,19571,78814,13203,6430,6773
65950,102206,23385,49212,19574,78819,13204,6431,6773
65955,102212,23387,49213,19576,78824,13206,6431,6775
65960,102223,23389,49219,19578,78832,13207,6431,6776
65965,102227,23391,49221,19580,78835,13207,6431,6776
65970,102237,23394,49224,19582,78842,13208,6431,6777
65975,102243,23394,49225,19582,78849,13210,6432,6778
65980,102254,23395,49231,19582,78859,13211,6432,6779
65985,102258,23395,49232,19582,78862,13211,6432,6779
65990,102268,23395,49236,19582,78872,13212,6433,6779
65995,102274,23395,49237,19582,78879,13214,6434,6780
66000,102285,23396,49239,19583,78889,13215,6434,6781
66005,102289,23396,49241,19583,78893,13215,6434,6781
66010,102299,23396,49245,19583,78902,13216,6434,6782
66015,102305,23396,49247,19583,78909,13218,6434,6784
66020,102316,23397,49251,19583,78918,13219,6435,6784
66025,102320,23397,49251,19583,78923,13219,6435,6784
66030,102330,23397,49258,19583,78932,13220,6436,6784
66035,102336,23397,49260,19583,78939,13222,6437,6785
66040,102347,23398,49267,19583,78948,13223,6438,6785
66045,102351,23398,49269,19583,78952,13223,6438,6785
66050,102361,23398,49274,19583,78962,13224,6438,6786
66055,102367,23398,49277,19583,78969,13226,6439,6787
66060,102378,23399,49282,19584,78978,13227,6439,6788
66065,102382,23399,49284,19584,78982,13227,6439,6788
66070,102392,23399,49288,19584,78992,13228,6439,6789
66075,102398,23400,49291,19585,78998,13230,6441,6789
66080,102409,23401,49294,19585,79007,13231,6441,6790
66085,102413,23403,49297,19587,79008,13231,6441,6790
66090,102423,23407,49304,19591,79014,13232,6442,6790
66095,102429,23409,49309,19593,79019,13234,6443,6791
66100,102440,23411,49314,19594,79028,13235,6443,6792
66105,102444,23413,49315,19596,79031,13235,6443,6792
66110,102454,23415,49322,19598,79038,13236,6444,6792
66115,102460,23415,49325,19598,79044,13238,6444,6794
66120,102471,23417,49331,19599,79053,13239,6444,6795
66125,102475,23418,49333,19600,79055,13239,6444,6795
66130,102485,23421,49336,19602,79063,13240,6444,6796
66135,102491,23421,49339,19602,79069,13242,6445,6797
66140,102502,23423,49347,19604,79079,13243,6445,6798
66145,102506,23423,49347,19604,79083,13243,6445,6798
66150,102516,23425,49350,19605,79090,13244,6445,6799
66155,102522,23425,49351,19605,79097,13246,6445,6801
66160,102533,23426,49359,19606,79107,13247,6446,6801
66165,102537,23426,49362,19606,79109,13247,6446,6801
66170,102547,23430,49368,19610,79116,13248,6446,6802
66175,102553,23430,49370,19610,79123,13250,6447,6803
66180,102564,23431,49374,19611,79132,13251,6447,6804
66185,102568,23432,49376,19612,79135,13251,6447,6804
66190,102578,23432,49383,19612,79145,13252,6448,6804
66195,102584,23432,49384,19612,79152,13254,6449,6805
66200,102595,23433,49390,19613,79162,13255,6450,6805
66205,102599,23433,49391,19613,79166,13255,6450,6805
66210,102609,23433,49398,19613,79175,13256,6450,6806
66215,102615,23433,49400,19613,79181,13258,6450,6808
66220,102626,23434,49402,19613,79192,13259,6450,6809
66225,102630,23434,49402,19613,79196,13259,6450,6809
66230,102640,23434,49408,19613,79205,13260,6451,6809
66235,102646,23434,49410,19613,79212,13262,6452,6810
66240,102657,23435,49417,19614,79221,13263,6452,6811
66245,102661,23435,49420,19614,79225,13263,6452,6811
66250,102671,23435,49423,19614,79235,13264,6452,6812
66255,102677,23435,49429,19614,79241,13266,6454,6812
66260,102688,23436,49436,19615,79251,13267,6455,6812
66265,102692,23436,49438,19615,79255,13267,6455,6812
66270,102702,23436,49442,19615,79265,13268,6456,6812
66275,102708,23436,49444,19615,79272,13270,6457,6813
66280,102719,23437,49448,19615,79282,13271,6457,6814
66285,102723,23437,49450,19615,79286,13271,6457,6814
66290,102733,23438,49456,19616,79293,13272,6457,6815
66295,102739,23440,49457,19618,79299,13274,6458,6816
66300,102750,23441,49463,19619,79307,13275,6458,6817
66305,102754,23444,49465,19622,79309,13275,6458,6817
66310,102764,23447,49470,19624,79316,13276,6458,6818
66315,102770,23448,49473,19625,79321,13278,6459,6819
66320,102781,23450,49481,19627,79329,13279,6460,6819
66325,102785,23453,49484,19630,79331,13279,6460,6819
66330,102795,23455,49491,19632,79340,13280,6461,6819
66335,102801,23455,49492,19632,79346,13282,6462,6820
66340,102812,23456,49498,19633,79355,13283,6462,6821
66345,102816,23457,49499,19634,79358,13283,6462,6821
66350,102826,23460,49507,19637,79364,13284,6463,6821
66355,102832,23461,49508,19638,79371,13286,6463,6823
66360,102843,23462,49514,19639,79379,13287,6464,6823
66365,102847,23463,49517,19640,79383,13287,6464,6823
66370,102857,23466,49522,19643,79391,13288,6465,6823
66375,102863,23466,49528,19643,79396,13290,6467,6823
66380,102874,23467,49535,19644,79406,13291,6468,6823
66385,102878,23467,49538,19644,79410,13291,6468,6823
66390,102888,23467,49543,19644,79420,13292,6469,6823
66395,102894,23467,49546,19644,79427,13294,6470,6824
66400,102905,23468,49550,19644,79437,13295,6471,6824
66405,102909,23468,49551,19644,79440,13295,6471,6824
66410,102919,23468,49557,19644,79451,13296,6471,6825
66415,102925,23468,49560,19644,79457,13298,6472,6826
66420,102936,23469,49565,19645,79466,13299,6472,6827
66425,102940,23469,49567,19645,79471,13299,6472,6827
66430,102950,23469,49573,19645,79480,13300,6473,6827
66435,102956,23469,49574,19645,79486,13302,6473,6829
66440,102967,23470,49580,19645,79497,13303,6473,6830
66445,102971,23470,49583,19645,79500,13303,6473,6830
66450,102981,23470,49585,19645,79511,13304,6473,6831
66455,102987,23470,49589,19645,79517,13306,6474,6832
66460,102998,23471,49593,19645,79527,13307,6475,6832
66465,103002,23471,49593,19645,79531,13307,6475,6832
66470,103012,23471,49596,19645,79541,13308,6475,6833
66475,103018,23471,49600,19645,79546,13310,6475,6835
66480,103029,23473,49604,19646,79556,13311,6476,6835
66485,103033,23473,49604,19646,79560,13311,6476,6835
66490,103043,23475,49608,19648,79567,13312,6476,6836
66495,103049,23475,49614,19648,79573,13314,6478,6836
66500,103060,23477,49619,19650,79582,13315,6478,6837
66505,103064,23479,49622,19652,79584,13315,6478,6837
66510,103074,23481,49626,19653,79593,13316,6478,6838
66515,103080,23481,49630,19653,79598,13318,6479,6839
66520,103091,23483,49635,19655,79608,13319,6479,6840
66525,103095,23483,49637,19655,79611,13319,6479,6840
66530,103105,23485,49641,19657,79620,13320,6480,6840
66535,103111,23485,49645,19657,79625,13322,6481,6841
66540,103122,23487,49649,19658,79634,13323,6482,6841
66545,103126,23488,49650,19659,79638,13323,6482,6841
66550,103136,23491,49656,19662,79643,13324,6482,6842
66555,103142,23493,49659,19664,79647,13326,6483,6843
66560,103153,23496,49665,19666,79655,13327,6484,6843
66565,103157,23498,49667,19668,79658,13327,6484,6843
66570,103167,23500,49670,19670,79667,13328,6485,6843
66575,103173,23500,49674,19670,79672,13330,6487,6843
66580,103184,23502,49680,19672,79680,13331,6487,6844
66585,103188,23504,49681,19674,79684,13331,6487,6844
66590,103198,23504,49686,19674,79694,13332,6487,6845
66595,103204,23504,49689,19674,79699,13334,6487,6847
66600,103215,23505,49693,19675,79709,13335,6487,6848
66605,103219,23505,49694,19675,79714,13335,6487,6848
66610,103229,23505,49697,19675,79723,13336,6487,6849
66615,103235,23505,49702,19675,79729,13338,6488,6850
66620,103246,23506,49708,19676,79739,13339,6489,6850
66625,103250,23506,49711,19676,79744,13339,6489,6850
66630,103260,23506,49716,19676,79753,13340,6490,6850
66635,103266,23506,49720,19676,79759,13342,6491,6851
66640,103277,23507,49725,19677,79769,13343,6491,6852
66645,103281,23507,49727,19677,79774,13343,6491,6852
66650,103291,23507,49731,19677,79784,13344,6492,6852
66655,103297,23507,49734,19677,79790,13346,6493,6853
66660,103308,23508,49742,19677,79800,13347,6494,6853
66665,103312,23508,49744,19677,79803,13347,6494,6853
66670,103322,23508,49749,19677,79814,13348,6495,6853
66675,103328,23508,49753,19677,79820,13350,6497,6853
66680,103339,23509,49757,19677,79830,13351,6498,6853
66685,103343,23509,49759,19677,79833,13351,6498,6853
66690,103353,23510,49765,19678,79843,13352,6498,6854
66695,103359,23510,49767,19678,79849,13355,6499,6856
66700,103370,23511,49775,19678,79859,13356,6500,6856
66705,103374,23511,49777,19678,79862,13356,6500,6856
66710,103384,23513,49783,19680,79871,13357,6500,6857
66715,103390,23513,49785,19680,79877,13360,6501,6859
66720,103401,23514,49790,19680,79887,13361,6501,6860
66725,103405,23514,49791,19680,79891,13361,6501,6860
66730,103415,23516,49794,19681,79899,13362,6501,6861
66735,103421,23516,49797,19681,79905,13364,6501,6863
66740,103432,23517,49803,19682,79915,13365,6501,6864
66745,103436,23517,49805,19682,79918,13365,6501,6864
66750,103446,23519,49806,19683,79927,13366,6501,6865
66755,103452,23519,49809,19683,79933,13368,6502,6866
66760,103463,23520,49818,19684,79943,13369,6503,6866
66765,103467,23521,49821,19685,79945,13369,6503,6866
66770,103477,23522,49825,19685,79955,13370,6504,6866
66775,103483,23522,49828,19685,79961,13372,6505,6867
66780,103494,23523,49831,19685,79971,13373,6505,6868
66785,103498,23524,49834,19686,79973,13373,6505,6868
66790,103508,23525,49839,19687,79983,13374,6506,6868
66795,103514,23525,49841,19687,79988,13376,6508,6868
66800,103525,23526,49847,19688,79999,13377,6509,6868
66805,103529,23527,49850,19689,80000,13377,6509,6868
66810,103539,23531,49854,19693,80008,13378,6509,6869
66815,103545,23531,49855,19693,80013,13380,6510,6870
66820,103556,23532,49861,19693,80023,13381,6511,6870
66825,103560,23533,49862,19694,80027,13381,6511,6870
66830,103570,23536,49868,19696,80034,13382,6512,6870
66835,103576,23536,49871,19696,80039,13384,6513,6871
66840,103587,23538,49876,19698,80049,13385,6513,6872
66845,103591,23538,49879,19698,80051,13385,6513,6872
66850,103601,23543,49886,19702,80058,13386,6513,6873
66855,103607,23543,49889,19702,80062,13388,6514,6874
66860,103618,23545,49894,19704,80073,13389,6514,6875
66865,103622,23546,49896,19705,80075,13389,6514,6875
66870,103632,23549,49900,19708,80083,13390,6514,6876
66875,103638,23549,49903,19708,80088,13392,6515,6877
66880,103649,23551,49906,19709,80097,13393,6515,6878
66885,103653,23552,49908,19710,80100,13393,6515,6878
66890,103663,23555,49916,19713,80108,13394,6516,6878
66895,103669,23555,49917,19713,80113,13396,6517,6879
66900,103680,23556,49922,19714,80124,13397,6518,6879
66905,103684,23556,49923,19714,80128,13397,6518,6879
66910,103694,23557,49927,19715,80137,13398,6519,6879
66915,103700,23557,49929,19715,80142,13400,6520,6880
66920,103711,23558,49934,19716,80152,13401,6520,6881
66925,103715,23560,49936,19718,80154,13401,6520,6881
66930,103725,23563,49939,19720,80162,13402,6520,6882
66935,103731,23563,49943,19720,80166,13404,6522,6882
66940,103742,23566,49948,19722,80176,13405,6523,6882
66945,103746,23566,49950,19722,80179,13405,6523,6882
66950,103756,23569,49955,19724,80187,13406,6523,6883
66955,103762,23569,49957,19724,80192,13408,6524,6884
66960,103773,23570,49964,19725,80203,13409,6525,6884
66965,103777,23570,49966,19725,80206,13409,6525,6884
66970,103787,23570,49969,19725,80217,13410,6526,6884
66975,103793,23570,49974,19725,80222,13412,6527,6885
66980,103804,23571,49978,19726,80233,13413,6527,6886
66985,103808,23571,49980,19726,80237,13413,6527,6886
66990,103818,23571,49983,19726,80247,13414,6527,6887
66995,103824,23571,49986,19726,80252,13416,6528,6888
67000,103835,23572,49993,19727,80263,13417,6529,6888
67005,103839,23572,49995,19727,80267,13417,6529,6888
67010,103849,23572,50000,19727,80277,13418,6530,6888
67015,103855,23572,50004,19727,80282,13420,6531,6889
67020,103866,23573,50009,19728,80293,13421,6531,6890
67025,103870,23573,50009,19728,80297,13421,6531,6890
67030,103880,23573,50015,19728,80307,13422,6532,6890
67035,103886,23573,50018,19728,80312,13424,6533,6891
67040,103897,23574,50022,19728,80323,13425,6533,6892
67045,103901,23574,50024,19728,80326,13425,6533,6892
67050,103911,23574,50026,19728,80337,13426,6533,6893
67055,103917,23574,50028,19728,80342,13428,6533,6895
67060,103928,23575,50031,19729,80353,13429,6533,6896
67065,103932,23576,50033,19730,80356,13429,6533,6896
67070,103942,23577,50038,19730,80365,13430,6534,6896
67075,103948,23577,50044,19730,80370,13432,6536,6896
67080,103959,23579,50053,19732,80379,13433,6537,6896
67085,103963,23580,50055,19733,80382,13433,6537,6896
67090,103973,23582,50060,19735,80391,13434,6537,6897
67095,103979,23582,50060,19735,80396,13436,6537,6899
67100,103990,23583,50066,19735,80406,13437,6537,6900
67105,103994,23584,50067,19736,80409,13437,6537,6900
67110,104004,23587,50074,19738,80417,13438,6538,6900
67115,104010,23587,50077,19738,80421,13440,6539,6901
67120,104021,23590,50085,19741,80430,13441,6540,6901
67125,104025,23592,50087,19743,80432,13441,6540,6901
67130,104035,23595,50093,19745,80440,13442,6540,6902
67135,104041,23595,50096,19745,80444,13444,6540,6904
67140,104052,23598,50102,19747,80454,13445,6541,6904
67145,104056,23598,50103,19747,80457,13445,6541,6904
67150,104066,23600,50106,19748,80466,13446,6541,6905
67155,104072,23600,50108,19748,80470,13448,6541,6907
67160,104083,23602,50114,19749,80481,13449,6541,6908
67165,104087,23603,50116,19750,80484,13449,6541,6908
67170,104097,23605,50120,19752,80492,13450,6541,6909
67175,104103,23605,50124,19752,80496,13452,6543,6909
67180,104114,23608,50129,19755,80506,13453,6543,6910
67185,104118,23609,50131,19756,80508,13453,6543,6910
67190,104128,23612,50136,19758,80516,13454,6543,6911
67195,104134,23612,50137,19758,80521,13456,6543,6913
67200,104145,23613,50140,19758,80532,13457,6543,6914
67205,104149,23613,50142,19758,80535,13457,6543,6914
67210,104159,23613,50147,19758,80546,13458,6543,6915
67215,104165,23613,50151,19758,80551,13460,6544,6916
67220,104176,23614,50158,19758,80562,13461,6545,6916
67225,104180,23614,50161,19758,80566,13461,6545,6916
67230,104190,23614,50166,19758,80576,13462,6545,6917
67235,104196,23614,50167,19758,80581,13464,6545,6919
67240,104207,23615,50173,19759,80592,13465,6546,6919
67245,104211,23615,50174,19759,80596,13465,6546,6919
67250,104221,23615,50178,19759,80606,13466,6546,6920
67255,104227,23615,50180,19759,80611,13468,6547,6921
67260,104238,23616,50183,19759,80622,13469,6548,6921
67265,104242,23616,50185,19759,80625,13469,6548,6921
67270,104252,23616,50188,19759,80636,13470,6548,6922
67275,104258,23616,50191,19759,80641,13472,6549,6923
67280,104269,23617,50194,19759,80652,13473,6549,6924
67285,104273,23617,50196,19759,80656,13473,6549,6924
67290,104283,23617,50200,19759,80666,13474,6550,6924
67295,104289,23617,50204,19759,80671,13476,6551,6925
67300,104300,23618,50210,19759,80681,13477,6552,6925
67305,104304,23619,50211,19760,80684,13477,6552,6925
67310,104314,23622,50217,19762,80692,13478,6553,6925
67315,104320,23622,50218,19762,80697,13480,6553,6927
67320,104331,23623,50224,19762,80708,13481,6554,6927
67325,104335,23624,50227,19763,80710,13481,6554,6927
67330,104345,23625,50232,19764,80720,13482,6555,6927
67335,104351,23625,50234,19764,80725,13484,6555,6929
67340,104362,23626,50240,19765,80736,13485,6555,6930
67345,104366,23626,50242,19765,80739,13485,6555,6930
67350,104376,23628,50248,19766,80748,13486,6556,6930
67355,104382,23628,50251,19766,80753,13488,6557,6931
67360,104393,23629,50256,19767,80764,13489,6557,6932
67365,104397,23630,50258,19768,80767,13489,6557,6932
67370,104407,23632,50263,19770,80775,13490,6557,6933
67375,104413,23632,50266,19770,80780,13492,6559,6933
67380,104424,23633,50268,19770,80791,13493,6559,6934
67385,104428,23633,50270,19770,80794,13493,6559,6934
67390,104438,23635,50272,19771,80803,13494,6560,6934
67395,104444,23635,50274,19771,80808,13496,6561,6935
67400,104455,23636,50277,19772,80819,13497,6561,6936
67405,104459,23636,50279,19772,80822,13497,6561,6936
67410,104469,23638,50281,19773,80831,13498,6562,6936
67415,104475,23638,50283,19773,80836,13500,6563,6937
67420,104486,23640,50291,19775,80845,13501,6564,6937
67425,104490,23642,50292,19777,80848,13501,6564,6937
67430,104500,23644,50297,19779,80856,13502,6564,6938
67435,104506,23644,50301,19779,80860,13504,6565,6939
67440,104517,23647,50305,19782,80870,13505,6565,6940
67445,104521,23647,50308,19782,80872,13505,6565,6940
67450,104531,23652,50315,19787,80879,13506,6565,6941
67455,104537,23652,50318,19787,80884,13508,6566,6942
67460,104548,23654,50325,19789,80893,13509,6566,6943
67465,104552,23655,50326,19790,80897,13509,6566,6943
67470,104562,23658,50332,19793,80904,13510,6566,6944
67475,104568,23658,50336,19793,80909,13512,6568,6944
67480,104579,23659,50338,19793,80919,13513,6568,6945
67485,104583,23661,50341,19795,80921,13513,6568,6945
67490,104593,23664,50346,19798,80929,13514,6569,6945
67495,104599,23664,50347,19798,80934,13516,6570,6946
67500,104610,23665,50352,19799,80945,13517,6571,6946
67505,104614,23665,50353,19799,80948,13517,6571,6946
67510,104624,23669,50357,19802,80955,13518,6572,6946
67515,104630,23669,50359,19802,80960,13520,6573,6947
67520,104641,23670,50362,19802,80971,13521,6573,6948
67525,104645,23671,50365,19803,80973,13521,6573,6948
67530,104655,23673,50370,19804,80982,13522,6573,6949
67535,104661,23673,50374,19804,80987,13524,6574,6950
67540,104672,23674,50379,19804,80998,13525,6574,6951
67545,104676,23674,50382,19804,81001,13525,6574,6951
67550,104686,23674,50386,19804,81012,13526,6574,6952
67555,104692,23674,50390,19804,81017,13528,6576,6952
67560,104703,23675,50395,19805,81028,13529,6576,6953
67565,104707,23675,50398,19805,81032,13529,6576,6953
67570,104717,23675,50404,19805,81042,13530,6577,6953
67575,104723,23675,50406,19805,81047,13532,6577,6955
67580,104734,23676,50412,19805,81058,13533,6578,6955
67585,104738,23676,50415,19805,81062,13533,6578,6955
67590,104748,23676,50420,19805,81072,13534,6579,6955
67595,104754,23676,50424,19805,81077,13536,6579,6957
67600,104765,23677,50426,19805,81088,13537,6579,6958
67605,104769,23677,50428,19805,81092,13537,6579,6958
67610,104779,23677,50434,19805,81102,13538,6579,6959
67615,104785,23677,50437,19805,81107,13540,6580,6960
67620,104796,23678,50444,19806,81118,13541,6581,6960
67625,104800,23678,50446,19806,81122,13541,6581,6960
67630,104810,23678,50449,19806,81132,13542,6581,6961
67635,104816,23678,50451,19806,81137,13544,6581,6963
67640,104827,23679,50454,19806,81148,13545,6582,6963
67645,104831,23680,50456,19807,81150,13545,6582,6963
67650,104841,23681,50463,19808,81160,13546,6583,6963
67655,104847,23681,50467,19808,81165,13548,6584,6964
67660,104858,23682,50471,19809,81176,13549,6584,6965
67665,104862,23682,50473,19809,81179,13549,6584,6965
67670,104872,23683,50477,19809,81189,13550,6584,6966
67675,104878,23683,50480,19809,81194,13552,6585,6967
67680,104889,23684,50485,19809,81205,13553,6586,6967
67685,104893,23684,50486,19809,81208,13553,6586,6967
67690,104903,23685,50491,19809,81218,13554,6587,6967
67695,104909,23685,50493,19809,81223,13556,6588,6968
67700,104920,23687,50497,19811,81233,13557,6588,6969
67705,104924,23688,50498,19812,81236,13557,6588,6969
67710,104934,23689,50500,19813,81245,13558,6588,6970
67715,104940,23689,50502,19813,81249,13560,6588,6972
67720,104951,23691,50506,19815,81260,13561,6588,6973
67725,104955,23691,50508,19815,81262,13561,6588,6973
67730,104965,23695,50511,19818,81270,13562,6588,6974
67735,104971,23695,50514,19818,81274,13564,6590,6974
67740,104982,23697,50517,19819,81284,13565,6591,6974
67745,104986,23699,50520,19821,81285,13565,6591,6974
67750,104996,23702,50525,19824,81294,13566,6592,6974
67755,105002,23702,50528,19824,81299,13568,6594,6974
67760,105013,23704,50534,19826,81309,13569,6595,6974
67765,105017,23704,50536,19826,81312,13569,6595,6974
67770,105027,23706,50541,19828,81321,13570,6595,6975
67775,105033,23706,50542,19828,81326,13572,6595,6977
67780,105044,23707,50547,19828,81337,13573,6596,6977
67785,105048,23707,50549,19828,81339,13573,6596,6977
67790,105058,23710,50554,19831,81348,13574,6597,6977
67795,105064,23710,50556,19831,81353,13576,6598,6978
67800,105075,23712,50558,19832,81363,13577,6598,6979
67805,105079,23713,50562,19833,81364,13577,6598,6979
67810,105089,23716,50566,19836,81373,13578,6599,6979
67815,105095,23716,50570,19836,81378,13580,6601,6979
67820,105106,23718,50574,19837,81388,13581,6601,6980
67825,105110,23719,50578,19838,81389,13581,6601,6980
67830,105120,23722,50582,19840,81398,13582,6602,6980
67835,105126,23722,50584,19840,81403,13584,6602,6982
67840,105137,23724,50588,19842,81412,13585,6602,6983
67845,105141,23726,50591,19844,81414,13585,6602,6983
67850,105151,23729,50598,19846,81422,13586,6603,6983
67855,105157,23729,50600,19846,81427,13588,6603,6985
67860,105168,23730,50602,19846,81438,13589,6603,6986
67865,105172,23730,50602,19846,81442,13589,6603,6986
67870,105182,23730,50607,19846,81452,13590,6603,6987
67875,105188,23730,50610,19846,81457,13592,6604,6988
67880,105199,23731,50613,19846,81468,13593,6604,6989
67885,105203,23731,50614,19846,81471,13593,6604,6989
67890,105213,23731,50620,19846,81482,13594,6604,6990
67895,105219,23731,50621,19846,81487,13596,6604,6992
67900,105230,23732,50625,19847,81498,13597,6604,6993
67905,105234,23732,50627,19847,81501,13597,6604,6993
67910,105244,23732,50632,19847,81512,13598,6605,6993
67915,105250,23732,50637,19847,81517,13600,6607,6993
67920,105261,23733,50644,19847,81528,13601,6608,6993
67925,105265,23733,50645,19847,81532,13601,6608,6993
67930,105275,23733,50652,19847,81542,13602,6609,6993
67935,105281,23733,50654,19847,81548,13604,6610,6994
67940,105292,23734,50658,19848,81558,13605,6610,6995
67945,105296,23734,50659,19848,81562,13605,6610,6995
67950,105306,23734,50662,19848,81572,13606,6611,6995
67955,105312,23734,50663,19848,81578,13608,6611,6997
67960,105323,23735,50668,19848,81588,13609,6611,6998
67965,105327,23736,50670,19849,81591,13609,6611,6998
67970,105337,23737,50673,19849,81600,13610,6611,6999
67975,105343,23737,50677,19849,81605,13612,6612,7000
67980,105354,23738,50681,19849,81616,13613,6612,7001
67985,105358,23738,50683,19849,81620,13613,6612,7001
67990,105368,23739,50690,19849,81629,13614,6613,7001
67995,105374,23739,50694,19849,81633,13616,6613,7003
68000,105385,23741,50699,19851,81644,13617,6613,7004
68005,105389,23741,50700,19851,81648,13617,6613,7004
68010,105399,23743,50709,19853,81656,13618,6614,7004
68015,105405,23743,50713,19853,81661,13620,6615,7005
68020,105416,23745,50718,19854,81671,13621,6616,7005
68025,105420,23746,50721,19855,81673,13621,6616,7005
68030,105430,23749,50726,19857,81681,13622,6617,7005
68035,105436,23749,50730,19857,81686,13624,6619,7005
68040,105447,23751,50737,19858,81695,13625,6620,7005
68045,105451,23753,50740,19860,81698,13625,6620,7005
68050,105461,23754,50746,19860,81707,13626,6621,7005
68055,105467,23754,50749,19860,81712,13628,6623,7005
68060,105478,23755,50755,19861,81722,13629,6623,7006
68065,105482,23757,50759,19863,81725,13629,6623,7006
68070,105492,23758,50763,19864,81734,13630,6623,7007
68075,105498,23758,50765,19864,81739,13632,6624,7008
68080,105509,23760,50772,19866,81748,13633,6624,7009
68085,105513,23761,50773,19867,81752,13633,6624,7009
68090,105523,23763,50779,19868,81760,13634,6625,7009
68095,105529,23763,50782,19868,81764,13636,6626,7010
68100,105540,23765,50790,19869,81774,13637,6627,7010
68105,105544,23766,50790,19870,81778,13637,6627,7010
68110,105554,23768,50792,19871,81786,13638,6628,7010
68115,105560,23768,50794,19871,81791,13640,6629,7011
68120,105571,23769,50800,19871,81802,13641,6629,7012
68125,105575,23770,50802,19872,81805,13641,6629,7012
68130,105585,23772,50805,19873,81813,13642,6629,7013
68135,105591,23772,50807,19873,81818,13644,6629,7015
68140,105602,23773,50813,19873,81828,13645,6630,7015
68145,105606,23775,50814,19875,81831,13645,6630,7015
68150,105616,23777,50819,19876,81839,13646,6630,7016
68155,105622,23777,50823,19876,81844,13648,6631,7017
68160,105633,23779,50826,19877,81853,13649,6631,7018
68165,105637,23781,50828,19879,81855,13649,6631,7018
68170,105647,23784,50832,19881,81863,13650,6632,7018
68175,105653,23784,50837,19881,81867,13652,6633,7019
68180,105664,23787,50844,19883,81877,13653,6633,7020
68185,105668,23788,50848,19884,81879,13653,6633,7020
68190,105678,23788,50855,19884,81890,13654,6633,7021
68195,105684,23788,50857,19884,81896,13656,6634,7022
68200,105695,23789,50862,19884,81906,13657,6635,7022
68205,105699,23789,50863,19884,81910,13657,6635,7022
68210,105709,23789,50866,19884,81920,13658,6635,7023
68215,105715,23789,50870,19884,81926,13660,6637,7023
68220,105726,23790,50878,19885,81936,13661,6638,7023
68225,105730,23790,50880,19885,81940,13661,6638,7023
68230,105740,23790,50884,19885,81950,13662,6638,7024
68235,105746,23790,50887,19885,81956,13664,6638,7026
68240,105757,23791,50891,19886,81966,13665,6638,7027
68245,105761,23791,50893,19886,81970,13665,6638,7027
68250,105771,23791,50897,19886,81980,13666,6639,7027
68255,105777,23791,50899,19886,81986,13668,6639,7029
68260,105788,23792,50904,19887,81996,13669,6640,7029
68265,105792,23792,50906,19887,82000,13669,6640,7029
68270,105802,23792,50912,19887,82010,13670,6640,7030
68275,105808,23792,50915,19887,82016,13672,6640,7032
68280,105819,23793,50923,19888,82026,13673,6641,7032
68285,105823,23793,50926,19888,82029,13673,6641,7032
68290,105833,23795,50930,19890,82038,13674,6641,7033
68295,105839,23795,50933,19890,82043,13676,6642,7034
68300,105850,23797,50938,19891,82052,13677,6642,7035
68305,105854,23798,50939,19892,82055,13677,6642,7035
68310,105864,23801,50944,19894,82063,13678,6643,7035
68315,105870,23801,50945,19894,82069,13680,6644,7036
68320,105881,23802,50950,19894,82079,13681,6645,7036
68325,105885,23803,50954,19895,82080,13681,6645,7036
68330,105895,23806,50957,19898,82089,13682,6645,7037
68335,105901,23806,50960,19898,82094,13684,6646,7038
68340,105912,23808,50966,19900,82104,13685,6647,7038
68345,105916,23809,50969,19901,82105,13685,6647,7038
68350,105926,23813,50972,19904,82113,13686,6647,7039
68355,105932,23813,50977,19904,82118,13688,6649,7039
68360,105943,23815,50983,19905,82127,13689,6650,7039
68365,105947,23817,50986,19907,82129,13689,6650,7039
68370,105957,23818,50991,19907,82139,13690,6651,7039
68375,105963,23818,50995,19907,82144,13692,6652,7040
68380,105974,23819,51001,19908,82155,13693,6653,7040
68385,105978,23820,51002,19909,82158,13693,6653,7040
68390,105988,23821,51006,19909,82167,13694,6654,7040
68395,105994,23821,51010,19909,82172,13696,6655,7041
68400,106005,23822,51015,19909,82183,13697,6656,7041
68405,106009,23822,51016,19909,82187,13697,6656,7041
68410,106019,23823,51020,19910,82196,13698,6656,7042
68415,106025,23823,51023,19910,82202,13700,6657,7043
68420,106036,23824,51026,19911,82212,13701,6657,7044
68425,106040,23824,51028,19911,82216,13701,6657,7044
68430,106050,23825,51035,19912,82225,13702,6658,7044
68435,106056,23825,51037,19912,82231,13704,6659,7045
68440,106067,23826,51042,19912,82241,13705,6659,7046
68445,106071,23826,51044,19912,82244,13705,6659,7046
68450,106081,23828,51047,19913,82253,13706,6659,7047
68455,106087,23828,51049,19913,82259,13708,6660,7048
68460,106098,23829,51057,19914,82269,13709,6661,7048
68465,106102,23830,51059,19915,82272,13709,6661,7048
68470,106112,23832,51068,19917,82280,13710,6662,7048
68475,106118,23832,51071,19917,82285,13712,6664,7048
68480,106129,23834,51076,19919,82294,13713,6665,7048
68485,106133,23836,51077,19921,82297,13713,6665,7048
68490,106143,23837,51082,19922,82306,13714,6666,7048
68495,106149,23837,51086,19922,82311,13716,6667,7049
68500,106160,23839,51090,19923,82321,13717,6668,7049
68505,106164,23839,51090,19923,82325,13717,6668,7049
68510,106174,23841,51095,19924,82333,13718,6668,7050
68515,106180,23841,51097,19924,82339,13720,6668,7052
68520,106191,23842,51104,19925,82349,13721,6669,7052
68525,106195,23842,51105,19925,82352,13721,6669,7052
68530,106205,23846,51110,19929,82359,13722,6669,7053
68535,106211,23846,51113,19929,82364,13724,6670,7054
68540,106222,23848,51116,19930,82374,13725,6670,7055
68545,106226,23849,51120,19931,82375,13725,6670,7055
68550,106236,23853,51125,19935,82383,13726,6670,7056
68555,106242,23853,51128,19935,82389,13728,6671,7057
68560,106253,23854,51134,19935,82399,13729,6672,7057
68565,106257,23854,51136,19935,82403,13729,6672,7057
68570,106267,23854,51141,19935,82413,13730,6673,7057
68575,106273,23854,51147,19935,82419,13732,6675,7057
68580,106284,23855,51152,19935,82429,13733,6675,7058
68585,106288,23855,51154,19935,82433,13733,6675,7058
68590,106298,23855,51159,19935,82443,13734,6676,7058
68595,106304,23855,51164,19935,82449,13736,6677,7059
68600,106315,23856,51169,19936,82459,13737,6678,7059
68605,106319,23856,51170,19936,82463,13737,6678,7059
68610,106329,23856,51175,19936,82473,13738,6679,7059
68615,106335,23856,51177,19936,82479,13740,6680,7060
68620,106346,23857,51178,19937,82489,13741,6680,7061
68625,106350,23857,51181,19937,82493,13741,6680,7061
68630,106360,23857,51186,19937,82503,13742,6680,7062
68635,106366,23857,51188,19937,82509,13744,6681,7063
68640,106377,23858,51193,19938,82519,13745,6681,7064
68645,106381,23858,51193,19938,82523,13745,6681,7064
68650,106391,23858,51198,19938,82533,13746,6682,7064
68655,106397,23858,51201,19938,82538,13748,6684,7064
68660,106408,23860,51207,19939,82548,13749,6685,7064
68665,106412,23860,51208,19939,82552,13749,6685,7064
68670,106422,23861,51211,19939,82561,13750,6685,7065
68675,106428,23861,51215,19939,82566,13752,6686,7066
68680,106439,23863,51220,19940,82576,13753,6686,7067
68685,106443,23863,51220,19940,82580,13753,6686,7067
68690,106453,23864,51223,19941,82589,13754,6686,7068
68695,106459,23864,51225,19941,82595,13756,6687,7069
68700,106470,23865,51229,19941,82605,13757,6687,7070
68705,106474,23865,51229,19941,82609,13757,6687,7070
68710,106484,23867,51236,19943,82617,13758,6688,7070
68715,106490,23867,51238,19943,82622,13760,6688,7072
68720,106501,23869,51240,19944,82632,13761,6688,7073
68725,106505,23870,51242,19945,82635,13761,6688,7073
68730,106515,23871,51245,19945,82644,13762,6689,7073
68735,106521,23871,51249,19945,82649,13764,6690,7074
68740,106532,23873,51256,19947,82659,13765,6691,7074
68745,106536,23874,51258,19948,82662,13765,6691,7074
68750,106546,23876,51263,19949,82670,13766,6691,7075
68755,106552,23876,51264,19949,82676,13768,6691,7077
68760,106563,23877,51269,19949,82686,13769,6692,7077
68765,106567,23877,51270,19949,82690,13769,6692,7077
68770,106577,23878,51274,19950,82699,13770,6692,7078
68775,106583,23878,51279,19950,82704,13772,6693,7079
68780,106594,23880,51284,19951,82714,13773,6693,7080
68785,106598,23881,51287,19952,82717,13773,6693,7080
68790,106608,23882,51292,19952,82726,13774,6694,7080
68795,106614,23882,51293,19952,82732,13776,6694,7082
68800,106625,23883,51297,19952,82742,13777,6694,7083
68805,106629,23883,51299,19952,82746,13777,6694,7083
68810,106639,23885,51305,19954,82754,13778,6695,7083
68815,106645,23885,51309,19954,82759,13780,6695,7085
68820,106656,23887,51314,19956,82769,13781,6695,7086
68825,106660,23887,51316,19956,82773,13781,6695,7086
68830,106670,23888,51318,19956,82782,13782,6695,7087
68835,106676,23888,51321,19956,82787,13784,6696,7088
68840,106687,23890,51328,19958,82797,13785,6696,7089
68845,106691,23891,51330,19959,82800,13785,6696,7089
68850,106701,23892,51335,19960,82809,13786,6696,7090
68855,106707,23892,51338,19960,82814,13788,6697,7091
68860,106718,23894,51342,19962,82824,13789,6697,7092
68865,106722,23895,51345,19963,82827,13789,6697,7092
68870,106732,23897,51350,19965,82835,13790,6697,7093
68875,106738,23897,51353,19965,82840,13792,6697,7095
68880,106749,23899,51356,19967,82850,13793,6697,7096
68885,106753,23899,51357,19967,82854,13793,6697,7096
68890,106763,23900,51360,19967,82863,13794,6697,7097
68895,106769,23900,51362,19967,82869,13796,6698,7098
68900,106780,23901,51364,19967,82879,13797,6699,7098
68905,106784,23901,51366,19967,82883,13797,6699,7098
68910,106794,23902,51372,19967,82892,13798,6700,7098
68915,106800,23902,51375,19967,82898,13800,6702,7098
68920,106811,23903,51381,19968,82908,13801,6702,7099
68925,106815,23903,51382,19968,82912,13801,6702,7099
68930,106825,23904,51386,19968,82921,13802,6702,7100
68935,106831,23904,51388,19968,82926,13804,6702,7102
68940,106842,23906,51396,19969,82936,13805,6703,7102
68945,106846,23907,51398,19970,82939,13805,6703,7102
68950,106856,23909,51402,19972,82947,13806,6704,7102
68955,106862,23909,51405,19972,82953,13808,6705,7103
68960,106873,23910,51412,19972,82963,13809,6705,7104
68965,106877,23910,51413,19972,82967,13809,6705,7104
68970,106887,23911,51417,19973,82976,13810,6705,7105
68975,106893,23911,51419,19973,82982,13812,6706,7106
68980,106904,23912,51423,19973,82992,13813,6706,7107
68985,106908,23912,51425,19973,82996,13813,6706,7107
68990,106918,23914,51433,19975,83004,13814,6707,7107
68995,106924,23914,51438,19975,83009,13816,6709,7107
69000,106935,23916,51444,19977,83019,13817,6710,7107
69005,106939,23917,51446,19978,83022,13817,6710,7107
69010,106949,23918,51450,19979,83031,13818,6710,7108
69015,106955,23918,51454,19979,83036,13820,6712,7108
69020,106966,23920,51459,19981,83046,13821,6712,7109
69025,106970,23921,51463,19982,83049,13821,6712,7109
69030,106980,23923,51468,19983,83057,13822,6712,7110
69035,106986,23923,51469,19983,83063,13824,6713,7111
69040,106997,23924,51473,19983,83073,13825,6714,7111
69045,107001,23924,51475,19983,83077,13825,6714,7111
69050,107011,23925,51482,19984,83086,13826,6715,7111
69055,107017,23925,51484,19984,83092,13828,6716,7112
69060,107028,23926,51490,19984,83102,13829,6717,7112
69065,107032,23926,51493,19984,83106,13829,6717,7112
69070,107042,23927,51498,19985,83115,13830,6717,7113
69075,107048,23927,51500,19985,83120,13832,6718,7114
69080,107059,23929,51506,19987,83130,13833,6718,7115
69085,107063,23930,51509,19988,83133,13833,6718,7115
69090,107073,23932,51515,19990,83141,13834,6719,7115
69095,107079,23932,51518,19990,83147,13836,6719,7117
69100,107090,23933,51525,19991,83157,13837,6719,7118
69105,107094,23933,51528,19991,83161,13837,6719,7118
69110,107104,23935,51531,19992,83169,13838,6719,7119
69115,107110,23935,51535,19992,83175,13840,6721,7119
69120,107121,23936,51540,19992,83185,13841,6721,7120
69125,107125,23936,51541,19992,83189,13841,6721,7120
69130,107135,23938,51548,19994,83197,13842,6721,7121
69135,107141,23938,51550,19994,83202,13844,6721,7123
69140,107152,23940,51555,19996,83212,13845,6722,7123
69145,107156,23940,51557,19996,83216,13845,6722,7123
69150,107166,23942,51561,19998,83224,13846,6723,7123
69155,107172,23942,51566,19998,83229,13848,6725,7123
69160,107183,23944,51574,19999,83239,13849,6726,7123
69165,107187,23945,51576,20000,83242,13849,6726,7123
69170,107197,23946,51580,20000,83251,13850,6726,7124
69175,107203,23946,51585,20000,83256,13852,6728,7124
69180,107214,23948,51589,20001,83266,13853,6728,7125
69185,107218,23948,51591,20001,83270,13853,6728,7125
69190,107228,23950,51596,20003,83278,13854,6729,7125
69195,107234,23950,51598,20003,83284,13856,6729,7127
69200,107245,23951,51604,20003,83294,13857,6729,7128
69205,107249,23951,51605,20003,83298,13857,6729,7128
69210,107259,23953,51612,20005,83306,13858,6730,7128
69215,107265,23953,51615,20005,83312,13860,6732,7128
69220,107276,23954,51620,20005,83322,13861,6733,7128
69225,107280,23954,51621,20005,83326,13861,6733,7128
69230,107290,23956,51626,20006,83334,13862,6734,7128
69235,107296,23956,51628,20006,83339,13864,6734,7130
69240,107307,23958,51633,20008,83349,13865,6735,7130
69245,107311,23959,51634,20009,83352,13865,6735,7130
69250,107321,23960,51636,20009,83361,13866,6735,7131
69255,107327,23960,51640,20009,83366,13868,6736,7132
69260,107338,23962,51646,20011,83376,13869,6736,7133
69265,107342,23963,51647,20012,83379,13869,6736,7133
69270,107352,23964,51652,20013,83388,13870,6736,7134
69275,107358,23964,51655,20013,83393,13872,6737,7135
69280,107369,23966,51662,20015,83403,13873,6737,7136
69285,107373,23967,51665,20016,83406,13873,6737,7136
69290,107383,23969,51669,20017,83414,13874,6737,7137
69295,107389,23969,51674,20017,83419,13876,6739,7137
69300,107400,23971,51682,20019,83429,13877,6740,7137
69305,107404,23971,51684,20019,83433,13877,6740,7137
69310,107414,23973,51691,20021,83441,13878,6741,7137
69315,107420,23973,51692,20021,83447,13880,6741,7139
69320,107431,23974,51697,20022,83457,13881,6742,7139
69325,107435,23974,51700,20022,83461,13881,6742,7139
69330,107445,23976,51704,20024,83469,13882,6742,7140
69335,107451,23976,51707,20024,83474,13884,6743,7141
69340,107462,23978,51711,20025,83484,13885,6743,7142
69345,107466,23978,51711,20025,83488,13885,6743,7142
69350,107476,23980,51716,20027,83496,13886,6743,7143
