Time,  Packets Generated,  Packets Reached,High Priority Packets Generated, High Priority Packets reached, Packet Dropped, Packet Dropped due to Faulty Node, High Prio Packet Dropped due to Faulty Node, Low Prio Packet Dropped due to Faulty Node 
5,1,1,1,1,0,0,0,0
10,7,5,6,4,2,2,2,0
15,15,9,9,5,5,5,4,1
20,31,17,16,10,9,9,5,4
25,50,30,26,16,14,14,7,7
30,74,48,36,24,20,20,9,11
35,102,66,46,30,28,28,13,15
40,133,87,64,41,38,38,18,20
45,164,108,81,50,48,48,24,24
50,195,127,96,66,62,58,28,30
55,226,143,110,77,77,68,32,36
60,257,153,125,83,96,78,37,41
65,288,167,140,94,111,85,42,43
70,319,183,157,106,126,91,45,46
75,350,198,173,117,142,97,47,50
80,381,212,188,128,158,103,49,54
85,412,228,202,137,172,111,53,58
90,443,242,213,146,195,121,56,65
95,474,248,226,152,220,131,60,71
100,505,254,237,158,246,141,65,76
105,536,263,250,167,268,151,66,85
110,567,269,259,172,294,162,70,92
115,598,274,278,177,321,173,78,95
120,629,274,292,177,355,181,83,98
125,660,275,310,177,385,184,84,100
130,691,276,329,178,415,186,86,100
135,722,277,347,178,445,187,87,100
140,753,278,363,178,475,188,88,100
145,784,279,377,178,505,189,89,100
150,815,280,385,179,535,190,89,101
155,846,281,398,179,565,191,90,101
160,877,282,412,179,595,192,91,101
165,908,283,427,180,625,193,91,102
170,939,284,442,181,655,194,91,103
175,970,285,460,182,685,195,91,104
180,1001,286,473,182,715,196,91,105
185,1032,287,488,183,745,198,92,106
190,1063,290,505,184,773,200,92,108
195,1094,292,518,186,802,201,92,109
200,1125,295,536,188,830,202,93,109
205,1156,298,552,190,858,203,94,109
210,1187,300,569,192,887,204,95,109
215,1218,303,583,194,915,205,96,109
220,1249,305,596,195,944,206,96,110
225,1280,308,612,196,972,207,97,110
230,1311,314,624,201,995,209,97,112
235,1342,320,635,206,1022,212,98,114
240,1373,326,653,211,1041,215,100,115
245,1404,330,668,215,1074,217,102,115
250,1435,330,684,215,1105,219,103,116
255,1466,330,699,215,1136,221,104,117
260,1497,330,713,215,1167,223,105,118
265,1528,330,730,215,1198,225,107,118
270,1559,330,744,215,1229,227,109,118
275,1590,330,756,215,1260,229,110,119
280,1621,330,772,215,1291,231,110,121
285,1652,330,786,215,1322,233,112,121
290,1683,330,806,215,1353,235,112,123
295,1714,330,819,215,1384,237,113,124
300,1745,330,833,215,1415,239,114,125
305,1776,333,845,216,1442,241,115,126
310,1807,336,859,218,1471,243,116,127
315,1838,338,875,219,1500,245,118,127
320,1869,339,891,219,1530,246,119,127
325,1900,339,905,219,1561,247,119,128
330,1931,339,927,219,1592,248,120,128
335,1962,339,942,219,1623,249,121,128
340,1993,340,954,219,1652,250,121,129
345,2024,342,967,220,1681,252,121,131
350,2055,346,986,224,1708,255,122,133
355,2086,349,1001,226,1735,258,124,134
360,2117,352,1017,229,1765,261,126,135
365,2148,355,1033,231,1793,263,126,137
370,2179,358,1049,232,1821,265,128,137
375,2210,360,1065,233,1850,267,129,138
380,2241,363,1080,236,1878,269,129,140
385,2272,364,1097,236,1908,270,130,140
390,2303,364,1111,236,1939,271,131,140
395,2334,364,1123,236,1970,272,131,141
400,2365,364,1139,236,2001,273,132,141
405,2396,364,1157,236,2032,275,133,142
410,2427,366,1175,238,2061,277,134,143
415,2458,368,1186,239,2090,279,134,145
420,2489,370,1197,241,2119,281,135,146
425,2520,374,1215,245,2146,283,136,147
430,2551,375,1226,245,2176,284,137,147
435,2582,376,1245,246,2206,285,138,147
440,2613,377,1258,247,2236,286,138,148
445,2644,378,1276,248,2266,287,138,149
450,2675,379,1289,248,2296,288,139,149
455,2706,380,1302,248,2326,289,140,149
460,2737,381,1316,249,2356,290,140,150
465,2768,382,1329,250,2386,291,141,150
470,2799,383,1350,251,2415,292,142,150
475,2830,385,1363,253,2444,293,143,150
480,2861,388,1380,255,2472,294,143,151
485,2892,391,1395,257,2501,296,144,152
490,2923,394,1409,259,2528,298,146,152
495,2954,398,1421,261,2555,299,146,153
500,2985,401,1438,264,2583,300,146,154
505,3016,402,1454,265,2614,301,146,155
510,3047,402,1464,265,2645,302,146,156
515,3078,402,1477,265,2676,303,147,156
520,3109,402,1491,265,2707,304,147,157
525,3140,402,1507,265,2738,305,147,158
530,3171,402,1517,265,2769,306,147,159
535,3202,402,1530,265,2800,307,148,159
540,3233,402,1547,265,2831,308,149,159
545,3264,402,1565,265,2862,309,150,159
550,3295,402,1581,265,2893,310,151,159
555,3326,402,1602,265,2924,311,152,159
560,3357,402,1618,265,2955,312,152,160
565,3388,402,1642,265,2986,313,152,161
570,3419,402,1660,265,3017,314,153,161
575,3450,402,1673,265,3048,315,153,162
580,3481,402,1686,265,3079,316,153,163
585,3512,402,1696,265,3110,317,153,164
590,3543,402,1711,265,3141,318,154,164
595,3574,402,1720,265,3172,320,154,166
600,3605,404,1733,267,3201,322,155,167
605,3636,407,1748,268,3229,323,156,167
610,3667,410,1763,269,3257,324,157,167
615,3698,413,1779,271,3285,325,158,167
620,3729,416,1794,272,3313,326,158,168
625,3760,419,1806,274,3341,327,159,168
630,3791,422,1820,275,3369,328,160,168
635,3822,425,1836,276,3397,329,160,169
640,3853,428,1856,278,3425,330,161,169
645,3884,431,1878,281,3453,331,162,169
650,3915,435,1890,282,3478,334,164,170
655,3946,441,1901,287,3501,338,165,173
660,3977,448,1919,294,3525,345,171,174
665,4008,451,1936,296,3556,347,172,175
670,4039,455,1954,300,3583,349,173,176
675,4070,457,1967,302,3612,351,174,177
680,4101,460,1980,305,3641,353,174,179
685,4132,460,1997,305,3672,355,174,181
690,4163,460,2009,305,3703,357,176,181
695,4194,460,2026,305,3734,358,177,181
700,4225,460,2040,305,3765,359,177,182
705,4256,460,2057,305,3796,360,177,183
710,4287,460,2071,305,3827,361,178,183
715,4318,460,2087,305,3858,362,178,184
720,4349,460,2105,305,3889,363,179,184
725,4380,460,2123,305,3920,364,179,185
730,4411,460,2138,305,3951,365,179,186
735,4442,460,2150,305,3982,366,179,187
740,4473,460,2167,305,4013,367,180,187
745,4504,460,2182,305,4044,368,180,188
750,4535,460,2200,305,4075,369,180,189
755,4566,460,2217,305,4106,370,180,190
760,4597,460,2232,305,4137,371,180,191
765,4628,460,2244,305,4168,372,180,192
770,4659,462,2262,307,4193,377,184,193
775,4690,468,2274,311,4213,382,187,195
780,4721,479,2290,321,4236,389,192,197
785,4752,482,2307,324,4270,392,193,199
790,4783,485,2321,326,4298,394,194,200
795,4814,489,2337,329,4324,396,195,201
800,4845,493,2350,331,4352,399,196,203
805,4876,495,2362,332,4381,402,197,205
810,4907,498,2378,334,4408,405,199,206
815,4938,502,2398,338,4435,408,200,208
820,4969,505,2409,340,4464,411,200,211
825,5000,508,2426,342,4491,414,201,213
830,5031,511,2443,344,4520,417,203,214
835,5062,514,2460,346,4547,420,203,217
840,5093,518,2473,348,4575,422,204,218
845,5124,520,2489,350,4601,424,205,219
850,5155,524,2506,354,4631,426,206,220
855,5186,524,2525,354,4662,427,207,220
860,5217,524,2540,354,4693,428,207,221
865,5248,524,2553,354,4724,429,207,222
870,5279,524,2572,354,4755,430,207,223
875,5310,524,2586,354,4786,431,208,223
880,5341,524,2604,354,4817,432,208,224
885,5372,524,2615,354,4848,433,209,224
890,5403,524,2627,354,4879,434,209,225
895,5434,524,2640,354,4910,435,209,226
900,5465,526,2655,355,4939,436,210,226
905,5496,530,2668,358,4966,438,211,227
910,5527,534,2681,360,4993,440,212,228
915,5558,537,2696,360,5021,442,214,228
920,5589,540,2710,360,5049,444,214,230
925,5620,543,2723,361,5077,446,216,230
930,5651,546,2737,362,5105,448,218,230
935,5682,550,2751,365,5132,450,219,231
940,5713,554,2764,369,5159,452,220,232
945,5744,557,2778,372,5187,454,221,233
950,5775,561,2792,374,5214,456,222,234
955,5806,565,2809,376,5241,458,223,235
960,5837,568,2825,377,5269,460,224,236
965,5868,570,2843,378,5298,462,226,236
970,5899,572,2861,380,5327,464,228,236
975,5930,575,2875,381,5355,466,229,237
980,5961,578,2890,383,5383,468,230,238
985,5992,581,2911,386,5411,470,231,239
990,6023,582,2926,387,5441,472,232,240
995,6054,583,2939,388,5471,474,233,241
1000,6085,584,2953,389,5501,476,233,243
1005,6116,585,2965,389,5529,478,235,243
1010,6147,591,2986,395,5550,481,237,244
1015,6178,591,3002,395,5587,482,238,244
1020,6209,591,3017,395,5618,483,238,245
1025,6240,592,3032,395,5648,484,239,245
1030,6271,593,3047,396,5678,485,240,245
1035,6302,594,3060,396,5708,486,240,246
1040,6333,595,3081,397,5738,487,240,247
1045,6364,596,3100,398,5768,488,240,248
1050,6395,597,3114,399,5798,489,240,249
1055,6426,598,3128,400,5828,490,241,249
1060,6457,599,3139,400,5858,491,241,250
1065,6488,600,3152,400,5888,492,241,251
1070,6519,602,3171,401,5917,493,242,251
1075,6550,604,3182,402,5946,494,243,251
1080,6581,606,3199,404,5975,495,244,251
1085,6612,607,3211,404,6005,496,245,251
1090,6643,608,3226,404,6035,497,246,251
1095,6674,609,3237,404,6065,498,246,252
1100,6705,610,3254,405,6095,499,246,253
1105,6736,611,3265,405,6125,500,246,254
1110,6767,612,3282,406,6155,502,248,254
1115,6798,613,3301,406,6185,504,250,254
1120,6829,617,3318,409,6208,507,250,257
1125,6860,623,3333,415,6229,511,251,260
1130,6891,634,3347,426,6250,515,253,262
1135,6922,641,3359,431,6274,519,255,264
1140,6953,648,3375,438,6305,523,258,265
1145,6984,650,3390,440,6334,524,258,266
1150,7015,652,3403,441,6363,525,259,266
1155,7046,654,3419,443,6392,526,260,266
1160,7077,656,3431,444,6421,527,260,267
1165,7108,658,3444,445,6450,528,261,267
1170,7139,660,3462,446,6479,529,262,267
1175,7170,662,3477,447,6508,530,263,267
1180,7201,664,3497,448,6537,531,264,267
1185,7232,666,3508,449,6566,532,265,267
1190,7263,668,3523,450,6595,533,266,267
1195,7294,670,3543,452,6624,534,266,268
1200,7325,672,3558,453,6653,535,266,269
1205,7356,674,3578,455,6682,536,267,269
1210,7387,676,3602,456,6711,537,267,270
1215,7418,678,3616,458,6740,538,267,271
1220,7449,680,3636,460,6769,539,267,272
1225,7480,682,3656,461,6798,540,268,272
1230,7511,684,3668,462,6827,541,268,273
1235,7542,686,3679,463,6856,542,269,273
1240,7573,688,3690,463,6885,543,269,274
1245,7604,690,3705,464,6906,546,271,275
1250,7635,696,3719,468,6934,550,275,275
1255,7666,701,3732,472,6961,554,277,277
1260,7697,708,3754,479,6979,558,279,279
1265,7728,712,3775,483,7016,558,279,279
1270,7759,712,3789,483,7047,558,279,279
1275,7790,712,3800,483,7078,558,279,279
1280,7821,712,3813,483,7109,558,279,279
1285,7852,712,3833,483,7140,558,279,279
1290,7883,712,3845,483,7171,558,279,279
1295,7914,712,3864,483,7202,558,279,279
1300,7945,712,3879,483,7233,558,279,279
1305,7976,712,3891,483,7264,558,279,279
1310,8007,712,3902,483,7295,558,279,279
1315,8038,712,3914,483,7326,558,279,279
1320,8069,712,3926,483,7357,558,279,279
1325,8100,712,3939,483,7388,558,279,279
1330,8131,712,3958,483,7419,558,279,279
1335,8162,712,3976,483,7450,558,279,279
1340,8193,712,3991,483,7481,558,279,279
1345,8224,712,4007,483,7512,558,279,279
1350,8255,712,4018,483,7543,558,279,279
1355,8286,712,4033,483,7574,558,279,279
1360,8317,713,4051,483,7604,558,279,279
1365,8348,714,4062,483,7634,558,279,279
1370,8379,716,4076,484,7658,562,282,280
1375,8410,725,4091,492,7681,566,285,281
1380,8441,735,4108,499,7699,570,287,283
1385,8472,739,4121,502,7733,572,288,284
1390,8503,741,4140,503,7762,573,289,284
1395,8534,743,4155,503,7791,574,290,284
1400,8565,745,4172,505,7820,575,290,285
1405,8596,747,4189,506,7849,576,290,286
1410,8627,749,4206,507,7878,577,291,286
1415,8658,751,4223,508,7907,578,292,286
1420,8689,753,4239,509,7936,579,292,287
1425,8720,755,4251,510,7965,580,293,287
1430,8751,757,4261,510,7994,581,293,288
1435,8782,759,4280,512,8023,582,294,288
1440,8813,761,4294,512,8052,583,294,289
1445,8844,763,4307,513,8081,584,295,289
1450,8875,765,4318,514,8110,585,295,290
1455,8906,767,4332,515,8139,586,296,290
1460,8937,769,4351,515,8168,587,297,290
1465,8968,771,4362,516,8197,588,297,291
1470,8999,773,4373,517,8226,589,297,292
1475,9030,775,4389,518,8255,590,298,292
1480,9061,777,4407,519,8284,591,299,292
1485,9092,780,4427,521,8311,592,300,292
1490,9123,786,4446,526,8329,593,300,293
1495,9154,786,4459,526,8367,594,301,293
1500,9185,788,4474,527,8397,595,301,294
1505,9216,790,4489,528,8426,597,302,295
1510,9247,792,4506,529,8455,599,303,296
1515,9278,793,4523,529,8485,600,303,297
1520,9309,794,4533,529,8515,601,303,298
1525,9340,795,4546,530,8545,603,304,299
1530,9371,796,4560,530,8575,605,305,300
1535,9402,797,4574,531,8605,607,306,301
1540,9433,798,4589,531,8635,609,307,302
1545,9464,799,4612,532,8665,611,308,303
1550,9495,800,4630,533,8695,613,309,304
1555,9526,801,4648,534,8725,615,309,306
1560,9557,802,4662,535,8755,617,309,308
1565,9588,803,4679,536,8785,619,310,309
1570,9619,804,4699,536,8815,621,311,310
1575,9650,805,4715,536,8845,623,313,310
1580,9681,806,4733,537,8875,625,314,311
1585,9712,807,4747,537,8905,627,315,312
1590,9743,808,4763,538,8935,630,317,313
1595,9774,810,4780,540,8964,633,318,315
1600,9805,812,4794,541,8989,636,321,315
1605,9836,817,4805,545,9010,638,321,317
1610,9867,826,4821,551,9032,640,322,318
1615,9898,837,4839,562,9059,641,323,318
1620,9929,840,4856,565,9089,642,324,318
1625,9960,842,4868,565,9118,643,325,318
1630,9991,843,4878,565,9148,644,325,319
1635,10022,844,4892,565,9178,645,326,319
1640,10053,845,4906,566,9208,646,326,320
1645,10084,847,4922,568,9237,647,327,320
1650,10115,848,4934,568,9267,648,327,321
1655,10146,850,4954,569,9296,649,328,321
1660,10177,851,4970,569,9326,650,329,321
1665,10208,852,4981,570,9356,651,330,321
1670,10239,853,4996,570,9386,652,330,322
1675,10270,855,5010,571,9415,654,331,323
1680,10301,857,5023,572,9444,655,331,324
1685,10332,858,5043,573,9474,657,333,324
1690,10363,858,5058,573,9505,659,333,326
1695,10394,858,5080,573,9536,660,334,326
1700,10425,858,5099,573,9567,661,334,327
1705,10456,858,5109,573,9598,662,334,328
1710,10487,858,5123,573,9629,663,334,329
1715,10518,858,5137,573,9660,664,334,330
1720,10549,858,5157,573,9691,665,335,330
1725,10580,858,5173,573,9722,666,336,330
1730,10611,860,5185,573,9747,667,336,331
1735,10642,866,5203,579,9772,668,337,331
1740,10673,875,5215,586,9794,669,338,331
1745,10704,877,5231,588,9827,669,338,331
1750,10735,878,5247,588,9857,669,338,331
1755,10766,879,5261,588,9887,669,338,331
1760,10797,880,5278,588,9917,669,338,331
1765,10828,881,5295,588,9947,669,338,331
1770,10859,882,5305,589,9977,669,338,331
1775,10890,883,5323,590,10007,669,338,331
1780,10921,884,5342,591,10037,669,338,331
1785,10952,885,5361,592,10067,669,338,331
1790,10983,886,5378,593,10097,669,338,331
1795,11014,887,5398,594,10127,669,338,331
1800,11045,888,5412,594,10157,669,338,331
1805,11076,889,5426,595,10187,670,338,332
1810,11107,889,5440,595,10218,671,338,333
1815,11138,889,5456,595,10249,672,338,334
1820,11169,889,5473,595,10280,673,338,335
1825,11200,889,5486,595,10311,674,338,336
1830,11231,889,5503,595,10342,675,339,336
1835,11262,889,5524,595,10373,676,340,336
1840,11293,889,5540,595,10404,677,341,336
1845,11324,889,5554,595,10435,678,341,337
1850,11355,889,5566,595,10466,679,342,337
1855,11386,889,5577,595,10497,682,344,338
1860,11417,889,5592,595,10528,685,345,340
1865,11448,889,5606,595,10557,686,346,340
1870,11479,889,5621,595,10589,687,347,340
1875,11510,889,5635,595,10621,688,348,340
1880,11541,889,5644,595,10652,689,348,341
1885,11572,889,5653,595,10683,690,348,342
1890,11603,889,5666,595,10714,691,348,343
1895,11634,889,5680,595,10745,692,349,343
1900,11665,889,5693,595,10776,693,350,343
1905,11696,889,5705,595,10807,694,351,343
1910,11727,892,5721,596,10833,695,352,343
1915,11758,898,5741,600,10857,696,353,343
1920,11789,906,5754,607,10881,697,354,343
1925,11820,909,5765,609,10911,698,354,344
1930,11851,910,5780,609,10941,699,355,344
1935,11882,911,5799,610,10971,700,356,344
1940,11913,912,5817,610,11001,701,357,344
1945,11944,913,5833,611,11031,702,358,344
1950,11975,914,5847,612,11061,703,358,345
1955,12006,915,5862,612,11091,704,359,345
1960,12037,916,5880,613,11121,705,360,345
1965,12068,917,5895,613,11151,706,361,345
1970,12099,918,5914,613,11181,707,362,345
1975,12130,919,5930,613,11211,708,362,346
1980,12161,920,5944,614,11241,709,362,347
1985,12192,922,5959,616,11270,709,362,347
1990,12223,925,5974,618,11298,709,362,347
1995,12254,927,5989,619,11327,709,362,347
2000,12285,929,5997,620,11356,709,362,347
2005,12316,931,6007,621,11385,709,362,347
2010,12347,933,6022,623,11414,709,362,347
2015,12378,935,6031,624,11443,709,362,347
2020,12409,938,6040,625,11471,709,362,347
2025,12440,940,6051,626,11500,709,362,347
2030,12471,946,6065,630,11525,710,363,347
2035,12502,951,6080,633,11550,712,365,347
2040,12533,953,6092,635,11579,714,365,349
2045,12564,956,6106,637,11608,714,365,349
2050,12595,957,6121,637,11638,714,365,349
2055,12626,958,6138,638,11668,714,365,349
2060,12657,959,6153,639,11698,714,365,349
2065,12688,960,6168,639,11728,714,365,349
2070,12719,961,6179,639,11758,714,365,349
2075,12750,962,6189,639,11788,714,365,349
2080,12781,963,6202,639,11818,714,365,349
2085,12812,964,6218,640,11848,714,365,349
2090,12843,965,6234,640,11877,716,366,350
2095,12874,966,6253,640,11907,718,367,351
2100,12905,967,6267,641,11937,720,367,353
2105,12936,971,6280,645,11965,721,367,354
2110,12967,971,6296,645,11996,722,367,355
2115,12998,971,6317,645,12027,723,367,356
2120,13029,971,6334,645,12058,724,367,357
2125,13060,971,6354,645,12088,725,368,357
2130,13091,971,6367,645,12120,726,368,358
2135,13122,971,6378,645,12150,727,368,359
2140,13153,971,6391,645,12181,728,368,360
2145,13184,973,6408,646,12210,730,369,361
2150,13215,975,6421,648,12240,732,370,362
2155,13246,977,6435,649,12268,735,371,364
2160,13277,980,6446,652,12296,738,373,365
2165,13308,982,6464,654,12326,740,373,367
2170,13339,983,6481,654,12356,741,373,368
2175,13370,984,6497,655,12386,742,374,368
2180,13401,985,6513,655,12416,743,375,368
2185,13432,986,6531,656,12446,744,376,368
2190,13463,987,6546,657,12476,745,377,368
2195,13494,988,6560,657,12506,746,378,368
2200,13525,989,6577,658,12536,747,379,368
2205,13556,990,6594,658,12566,748,380,368
2210,13587,993,6614,661,12594,749,381,368
2215,13618,995,6626,662,12622,750,382,368
2220,13649,997,6639,664,12652,751,383,368
2225,13680,1000,6653,666,12679,753,383,370
2230,13711,1003,6668,669,12707,755,384,371
2235,13742,1006,6677,672,12736,757,385,372
2240,13773,1010,6688,675,12763,759,385,374
2245,13804,1010,6708,675,12794,761,387,374
2250,13835,1010,6723,675,12825,762,388,374
2255,13866,1010,6734,675,12856,763,388,375
2260,13897,1010,6744,675,12887,764,388,376
2265,13928,1010,6756,675,12918,765,388,377
2270,13959,1013,6770,677,12946,768,388,380
2275,13990,1016,6784,679,12974,771,388,383
2280,14021,1017,6797,680,13004,774,389,385
2285,14052,1019,6807,681,13033,776,389,387
2290,14083,1021,6823,681,13062,777,389,388
2295,14114,1023,6838,683,13091,778,389,389
2300,14145,1025,6854,685,13120,779,389,390
2305,14176,1027,6865,687,13149,779,389,390
2310,14207,1029,6877,688,13178,779,389,390
2315,14238,1031,6890,688,13207,779,389,390
2320,14269,1033,6911,689,13236,779,389,390
2325,14300,1035,6928,690,13265,779,389,390
2330,14331,1037,6944,690,13293,779,389,390
2335,14362,1039,6955,690,13323,779,389,390
2340,14393,1041,6968,690,13352,779,389,390
2345,14424,1043,6980,692,13381,779,389,390
2350,14455,1045,6999,693,13410,779,389,390
2355,14486,1047,7013,694,13439,779,389,390
2360,14517,1049,7025,694,13468,779,389,390
2365,14548,1051,7040,695,13497,779,389,390
2370,14579,1053,7058,695,13526,779,389,390
2375,14610,1055,7076,696,13555,779,389,390
2380,14641,1057,7087,697,13584,779,389,390
2385,14672,1059,7101,699,13613,779,389,390
2390,14703,1063,7113,703,13640,781,390,391
2395,14734,1069,7130,709,13664,783,391,392
2400,14765,1074,7146,714,13691,785,392,393
2405,14796,1074,7167,714,13722,786,393,393
2410,14827,1074,7182,714,13753,787,394,393
2415,14858,1074,7195,714,13784,788,395,393
2420,14889,1074,7206,714,13815,789,396,393
2425,14920,1074,7220,714,13846,790,397,393
2430,14951,1074,7234,714,13877,791,398,393
2435,14982,1074,7250,714,13908,792,399,393
2440,15013,1074,7261,714,13939,793,399,394
2445,15044,1074,7275,714,13970,794,400,394
2450,15075,1074,7295,714,14000,795,401,394
2455,15106,1074,7308,714,14032,796,401,395
2460,15137,1074,7325,714,14063,797,401,396
2465,15168,1074,7347,714,14094,798,402,396
2470,15199,1074,7356,714,14125,799,402,397
2475,15230,1074,7372,714,14156,800,403,397
2480,15261,1074,7384,714,14187,801,403,398
2485,15292,1074,7393,714,14218,802,403,399
2490,15323,1074,7409,714,14249,803,403,400
2495,15354,1074,7425,714,14280,804,403,401
2500,15385,1076,7444,715,14309,805,404,401
2505,15416,1080,7457,717,14336,806,404,402
2510,15447,1085,7471,720,14360,808,405,403
2515,15478,1091,7484,724,14385,810,405,405
2520,15509,1099,7500,732,14409,812,406,406
2525,15540,1100,7515,733,14440,814,408,406
2530,15571,1101,7532,734,14470,816,410,406
2535,15602,1102,7550,734,14500,818,411,407
2540,15633,1103,7570,735,14530,820,411,409
2545,15664,1104,7589,736,14560,822,413,409
2550,15695,1106,7608,737,14589,824,414,410
2555,15726,1107,7623,737,14619,826,415,411
2560,15757,1108,7639,738,14649,828,415,413
2565,15788,1109,7654,739,14679,831,416,415
2570,15819,1109,7667,739,14710,833,416,417
2575,15850,1109,7686,739,14741,835,417,418
2580,15881,1109,7703,739,14772,837,418,419
2585,15912,1110,7715,739,14802,839,420,419
2590,15943,1111,7725,740,14832,840,421,419
2595,15974,1112,7742,741,14862,841,421,420
2600,16005,1113,7762,741,14892,842,421,421
2605,16036,1114,7781,742,14922,843,421,422
2610,16067,1115,7798,742,14952,844,421,423
2615,16098,1116,7813,742,14982,845,421,424
2620,16129,1117,7833,743,15012,846,422,424
2625,16160,1118,7853,744,15042,847,423,424
2630,16191,1122,7864,748,15069,848,423,425
2635,16222,1127,7881,751,15095,849,423,426
2640,16253,1131,7894,755,15122,850,424,426
2645,16284,1133,7909,756,15151,850,424,426
2650,16315,1135,7926,757,15180,850,424,426
2655,16346,1137,7941,759,15209,850,424,426
2660,16377,1139,7957,761,15238,850,424,426
2665,16408,1141,7973,762,15267,850,424,426
2670,16439,1143,7987,763,15296,850,424,426
2675,16470,1145,8003,763,15325,850,424,426
2680,16501,1147,8016,763,15354,850,424,426
2685,16532,1150,8028,764,15382,850,424,426
2690,16563,1152,8046,764,15411,852,426,426
2695,16594,1156,8058,766,15438,854,426,428
2700,16625,1159,8072,767,15466,856,426,430
2705,16656,1159,8086,767,15497,857,426,431
2710,16687,1159,8103,767,15528,858,426,432
2715,16718,1159,8112,767,15559,859,426,433
2720,16749,1159,8121,767,15590,860,426,434
2725,16780,1159,8136,767,15621,861,427,434
2730,16811,1159,8150,767,15652,862,428,434
2735,16842,1159,8167,767,15683,863,429,434
2740,16873,1159,8179,767,15714,864,430,434
2745,16904,1159,8196,767,15745,865,430,435
2750,16935,1160,8212,768,15775,866,431,435
2755,16966,1163,8226,771,15802,867,431,436
2760,16997,1165,8241,772,15832,868,432,436
2765,17028,1167,8255,773,15860,869,433,436
2770,17059,1169,8272,774,15890,870,434,436
2775,17090,1170,8291,774,15919,871,435,436
2780,17121,1172,8308,775,15949,872,436,436
2785,17152,1172,8319,775,15980,872,436,436
2790,17183,1172,8340,775,16011,872,436,436
2795,17214,1172,8355,775,16042,872,436,436
2800,17245,1172,8366,775,16073,872,436,436
2805,17276,1172,8379,775,16104,872,436,436
2810,17307,1172,8390,775,16135,872,436,436
2815,17338,1172,8409,775,16166,872,436,436
2820,17369,1172,8419,775,16197,872,436,436
2825,17400,1172,8429,775,16228,872,436,436
2830,17431,1172,8444,775,16259,872,436,436
2835,17462,1172,8458,775,16290,872,436,436
2840,17493,1172,8475,775,16321,872,436,436
2845,17524,1172,8489,775,16352,872,436,436
2850,17555,1172,8503,775,16383,872,436,436
2855,17586,1172,8522,775,16414,872,436,436
2860,17617,1172,8537,775,16445,872,436,436
2865,17648,1172,8550,775,16476,872,436,436
2870,17679,1176,8568,778,16498,875,437,438
2875,17710,1186,8580,788,16522,878,437,441
2880,17741,1193,8594,794,16548,881,439,442
2885,17772,1196,8607,796,16576,882,439,443
2890,17803,1199,8620,798,16604,883,439,444
2895,17834,1202,8634,800,16632,884,440,444
2900,17865,1204,8652,802,16661,885,441,444
2905,17896,1207,8669,804,16689,886,442,444
2910,17927,1210,8683,806,16717,887,442,445
2915,17958,1212,8700,806,16746,888,443,445
2920,17989,1216,8719,809,16773,889,444,445
2925,18020,1219,8737,811,16801,890,444,446
2930,18051,1223,8756,815,16828,891,444,447
2935,18082,1226,8772,816,16856,892,445,447
2940,18113,1227,8784,816,16886,893,445,448
2945,18144,1228,8799,816,16916,895,446,449
2950,18175,1229,8811,816,16946,897,447,450
2955,18206,1230,8830,817,16976,899,447,452
2960,18237,1231,8846,817,17006,900,447,453
2965,18268,1232,8861,818,17036,901,448,453
2970,18299,1233,8874,819,17066,902,448,454
2975,18330,1234,8889,819,17096,903,448,455
2980,18361,1235,8905,820,17126,904,448,456
2985,18392,1236,8925,820,17156,905,449,456
2990,18423,1241,8945,824,17180,907,450,457
2995,18454,1248,8963,830,17204,909,451,458
3000,18485,1253,8976,834,17231,911,452,459
3005,18516,1255,8990,835,17261,912,453,459
3010,18547,1256,9002,835,17291,913,454,459
3015,18578,1257,9022,835,17321,914,454,460
3020,18609,1258,9036,836,17351,915,454,461
3025,18640,1259,9047,836,17381,916,455,461
3030,18671,1260,9067,837,17411,917,456,461
3035,18702,1261,9079,838,17441,918,456,462
3040,18733,1263,9097,839,17470,919,456,463
3045,18764,1265,9113,840,17499,920,457,463
3050,18795,1267,9126,841,17528,921,457,464
3055,18826,1270,9140,843,17556,922,457,465
3060,18857,1272,9158,843,17585,924,459,465
3065,18888,1274,9178,845,17614,926,459,467
3070,18919,1276,9192,847,17643,927,459,468
3075,18950,1279,9208,850,17671,928,460,468
3080,18981,1281,9223,851,17700,929,460,469
3085,19012,1282,9232,852,17730,930,461,469
3090,19043,1284,9248,853,17759,932,462,470
3095,19074,1285,9261,854,17789,934,463,471
3100,19105,1286,9280,854,17819,936,464,472
3105,19136,1290,9298,856,17846,938,465,473
3110,19167,1295,9310,861,17871,940,466,474
3115,19198,1298,9329,863,17898,943,468,475
3120,19229,1301,9342,865,17927,946,469,477
3125,19260,1305,9356,868,17955,948,470,478
3130,19291,1306,9369,868,17985,949,471,478
3135,19322,1307,9382,868,18015,950,471,479
3140,19353,1308,9399,868,18045,951,472,479
3145,19384,1309,9415,869,18075,952,472,480
3150,19415,1310,9429,869,18105,953,472,481
3155,19446,1311,9445,869,18135,954,472,482
3160,19477,1312,9460,870,18165,955,473,482
3165,19508,1313,9475,871,18195,956,474,482
3170,19539,1314,9491,871,18225,957,474,483
3175,19570,1315,9507,872,18255,958,475,483
3180,19601,1316,9523,872,18285,959,476,483
3185,19632,1317,9535,872,18315,960,477,483
3190,19663,1318,9550,872,18345,961,477,484
3195,19694,1320,9566,873,18374,962,477,485
3200,19725,1321,9579,874,18404,963,478,485
3205,19756,1322,9600,875,18434,964,479,485
3210,19787,1324,9614,877,18463,965,479,486
3215,19818,1326,9631,878,18492,966,480,486
3220,19849,1327,9646,878,18522,967,481,486
3225,19880,1329,9663,880,18551,968,481,487
3230,19911,1331,9677,881,18580,969,481,488
3235,19942,1333,9692,881,18607,970,481,489
3240,19973,1337,9703,885,18636,971,482,489
3245,20004,1339,9716,887,18665,971,482,489
3250,20035,1341,9732,888,18694,971,482,489
3255,20066,1344,9750,890,18722,971,482,489
3260,20097,1344,9768,890,18753,971,482,489
3265,20128,1344,9777,890,18784,971,482,489
3270,20159,1344,9792,890,18815,971,482,489
3275,20190,1344,9803,890,18846,971,482,489
3280,20221,1344,9821,890,18877,971,482,489
3285,20252,1344,9833,890,18908,971,482,489
3290,20283,1344,9845,890,18939,971,482,489
3295,20314,1344,9856,890,18970,971,482,489
3300,20345,1344,9870,890,19001,971,482,489
3305,20376,1344,9885,890,19032,971,482,489
3310,20407,1344,9901,890,19063,971,482,489
3315,20438,1344,9916,890,19094,971,482,489
3320,20469,1344,9932,890,19125,971,482,489
3325,20500,1344,9947,890,19156,971,482,489
3330,20531,1344,9963,890,19187,971,482,489
3335,20562,1344,9975,890,19218,971,482,489
3340,20593,1344,9988,890,19249,971,482,489
3345,20624,1344,10012,890,19279,971,482,489
3350,20655,1348,10026,892,19305,973,482,491
3355,20686,1353,10041,895,19329,975,484,491
3360,20717,1359,10052,900,19355,977,484,493
3365,20748,1366,10068,906,19382,980,486,494
3370,20779,1368,10080,906,19411,982,487,495
3375,20810,1372,10096,909,19438,984,488,496
3380,20841,1374,10113,910,19467,986,489,497
3385,20872,1375,10130,911,19497,988,489,499
3390,20903,1376,10145,912,19527,990,489,501
3395,20934,1377,10161,913,19557,991,490,501
3400,20965,1378,10170,913,19587,992,490,502
3405,20996,1379,10187,913,19617,993,490,503
3410,21027,1380,10197,914,19647,994,491,503
3415,21058,1381,10212,915,19677,995,491,504
3420,21089,1382,10228,916,19707,996,491,505
3425,21120,1382,10240,916,19738,998,491,507
3430,21151,1382,10256,916,19769,1000,493,507
3435,21182,1382,10268,916,19800,1002,493,509
3440,21213,1382,10282,916,19831,1004,493,511
3445,21244,1382,10301,916,19862,1006,495,511
3450,21275,1382,10316,916,19893,1008,497,511
3455,21306,1382,10330,916,19924,1010,498,512
3460,21337,1382,10342,916,19955,1012,498,514
3465,21368,1382,10356,916,19986,1014,500,514
3470,21399,1384,10374,918,20014,1016,501,515
3475,21430,1386,10386,919,20043,1017,501,516
3480,21461,1388,10404,920,20071,1018,501,517
3485,21492,1392,10423,923,20100,1019,502,517
3490,21523,1394,10433,923,20129,1020,503,517
3495,21554,1396,10449,924,20158,1021,503,518
3500,21585,1398,10469,924,20187,1022,504,518
3505,21616,1400,10488,925,20216,1023,504,519
3510,21647,1402,10502,926,20245,1024,504,520
3515,21678,1404,10517,926,20274,1025,504,521
3520,21709,1406,10535,927,20303,1026,505,521
3525,21740,1408,10547,927,20332,1027,505,522
3530,21771,1410,10562,928,20361,1028,505,523
3535,21802,1412,10573,928,20390,1029,505,524
3540,21833,1414,10588,929,20419,1030,505,525
3545,21864,1417,10608,932,20447,1031,506,525
3550,21895,1420,10626,934,20475,1032,506,526
3555,21926,1421,10641,935,20505,1033,506,527
3560,21957,1422,10659,936,20535,1034,507,527
3565,21988,1423,10673,936,20565,1035,508,527
3570,22019,1424,10686,936,20595,1036,508,528
3575,22050,1425,10699,937,20625,1038,508,530
3580,22081,1426,10712,938,20655,1040,508,532
3585,22112,1429,10726,940,20683,1042,510,532
3590,22143,1433,10739,943,20710,1044,510,534
3595,22174,1437,10750,946,20736,1046,510,536
3600,22205,1442,10764,950,20763,1048,511,537
3605,22236,1445,10777,953,20791,1049,511,538
3610,22267,1449,10789,955,20818,1051,511,540
3615,22298,1453,10803,957,20845,1053,512,541
3620,22329,1454,10818,958,20875,1054,512,542
3625,22360,1455,10829,959,20905,1055,512,543
3630,22391,1457,10847,960,20934,1056,513,543
3635,22422,1459,10864,961,20963,1057,514,543
3640,22453,1460,10879,961,20993,1058,515,543
3645,22484,1461,10890,961,21023,1059,515,544
3650,22515,1463,10904,962,21052,1060,515,545
3655,22546,1464,10920,963,21081,1061,515,546
3660,22577,1465,10935,964,21112,1062,515,547
3665,22608,1466,10951,965,21142,1063,516,547
3670,22639,1467,10968,966,21172,1063,516,547
3675,22670,1468,10983,967,21202,1063,516,547
3680,22701,1469,10998,968,21232,1063,516,547
3685,22732,1470,11011,968,21262,1063,516,547
3690,22763,1471,11026,969,21292,1063,516,547
3695,22794,1472,11042,969,21322,1063,516,547
3700,22825,1473,11057,970,21352,1064,517,547
3705,22856,1474,11074,971,21382,1065,517,548
3710,22887,1476,11093,973,21411,1066,517,549
3715,22918,1479,11108,974,21439,1067,517,550
3720,22949,1481,11126,975,21468,1068,518,550
3725,22980,1484,11140,978,21495,1069,518,551
3730,23011,1488,11157,981,21521,1070,518,552
3735,23042,1492,11173,985,21550,1071,518,553
3740,23073,1495,11187,987,21576,1072,519,553
3745,23104,1498,11202,990,21605,1073,519,554
3750,23135,1500,11217,992,21635,1074,520,554
3755,23166,1501,11233,992,21663,1075,520,555
3760,23197,1504,11241,994,21692,1076,520,556
3765,23228,1506,11258,995,21720,1077,521,556
3770,23259,1509,11267,997,21749,1080,521,559
3775,23290,1512,11288,1000,21778,1083,523,560
3780,23321,1512,11300,1000,21809,1086,524,562
3785,23352,1512,11316,1000,21840,1088,525,563
3790,23383,1512,11326,1000,21871,1090,525,565
3795,23414,1512,11340,1000,21902,1092,526,566
3800,23445,1512,11359,1000,21933,1094,526,568
3805,23476,1512,11371,1000,21964,1096,527,569
3810,23507,1512,11388,1000,21995,1097,527,570
3815,23538,1512,11404,1000,22026,1098,528,570
3820,23569,1512,11421,1000,22057,1099,528,571
3825,23600,1512,11436,1000,22088,1100,528,572
3830,23631,1513,11450,1000,22118,1101,529,572
3835,23662,1514,11464,1000,22148,1102,530,572
3840,23693,1515,11477,1000,22178,1103,530,573
3845,23724,1516,11493,1001,22208,1104,531,573
3850,23755,1518,11503,1002,22235,1105,531,574
3855,23786,1522,11512,1006,22262,1106,532,574
3860,23817,1529,11529,1012,22288,1107,532,575
3865,23848,1533,11547,1015,22314,1108,532,576
3870,23879,1540,11566,1021,22339,1109,532,577
3875,23910,1545,11584,1024,22364,1110,532,578
3880,23941,1549,11600,1027,22392,1111,533,578
3885,23972,1550,11612,1028,22422,1112,534,578
3890,24003,1553,11632,1030,22450,1116,538,578
3895,24034,1555,11648,1032,22479,1120,540,580
3900,24065,1558,11662,1034,22507,1124,541,583
3905,24096,1560,11675,1034,22536,1125,541,584
3910,24127,1562,11687,1035,22565,1126,541,585
3915,24158,1565,11698,1038,22593,1128,541,587
3920,24189,1566,11710,1038,22623,1130,542,588
3925,24220,1567,11725,1039,22653,1132,543,589
3930,24251,1568,11738,1039,22683,1134,543,591
3935,24282,1569,11751,1039,22713,1136,545,591
3940,24313,1571,11767,1040,22742,1138,546,592
3945,24344,1573,11785,1041,22771,1140,547,593
3950,24375,1574,11801,1041,22801,1142,548,594
3955,24406,1575,11818,1042,22831,1144,549,595
3960,24437,1577,11828,1044,22860,1146,550,596
3965,24468,1578,11842,1045,22890,1146,550,596
3970,24499,1579,11857,1045,22920,1146,550,596
3975,24530,1581,11874,1047,22949,1146,550,596
3980,24561,1583,11892,1048,22978,1146,550,596
3985,24592,1584,11903,1048,23008,1146,550,596
3990,24623,1586,11916,1049,23037,1146,550,596
3995,24654,1588,11929,1050,23066,1146,550,596
4000,24685,1588,11938,1050,23097,1146,550,596
4005,24716,1588,11957,1050,23128,1147,551,596
4010,24747,1588,11972,1050,23159,1149,552,597
4015,24778,1588,11987,1050,23190,1151,553,598
4020,24809,1588,12005,1050,23221,1153,555,598
4025,24840,1590,12022,1052,23249,1156,557,599
4030,24871,1592,12039,1054,23279,1157,558,599
4035,24902,1592,12049,1054,23310,1158,558,600
4040,24933,1592,12063,1054,23341,1159,559,600
4045,24964,1592,12077,1054,23372,1160,560,600
4050,24995,1592,12087,1054,23403,1161,560,601
4055,25026,1592,12095,1054,23434,1162,560,602
4060,25057,1592,12111,1054,23465,1163,560,603
4065,25088,1594,12124,1055,23494,1164,560,604
4070,25119,1596,12142,1056,23523,1165,561,604
4075,25150,1599,12155,1058,23551,1166,561,605
4080,25181,1601,12173,1059,23580,1167,561,606
4085,25212,1604,12186,1061,23608,1170,563,607
4090,25243,1607,12201,1062,23636,1172,564,608
4095,25274,1610,12215,1064,23664,1174,564,610
4100,25305,1613,12225,1065,23692,1176,565,611
4105,25336,1616,12238,1066,23720,1178,566,612
4110,25367,1619,12253,1067,23748,1180,567,613
4115,25398,1622,12263,1067,23776,1182,567,615
4120,25429,1625,12278,1068,23804,1184,568,616
4125,25460,1628,12288,1069,23832,1186,568,618
4130,25491,1631,12302,1069,23860,1188,570,618
4135,25522,1634,12315,1070,23888,1190,571,619
4140,25553,1637,12330,1072,23916,1192,572,620
4145,25584,1640,12343,1073,23944,1194,572,622
4150,25615,1642,12360,1074,23973,1196,572,624
4155,25646,1644,12376,1074,24002,1198,573,625
4160,25677,1646,12394,1075,24031,1200,575,625
4165,25708,1648,12414,1076,24060,1201,576,625
4170,25739,1650,12427,1078,24089,1202,576,626
4175,25770,1652,12439,1078,24118,1203,577,626
4180,25801,1654,12456,1079,24147,1204,578,626
4185,25832,1656,12473,1081,24174,1205,579,626
4190,25863,1659,12488,1084,24201,1207,579,628
4195,25894,1664,12498,1088,24229,1210,580,630
4200,25925,1664,12514,1088,24261,1212,580,632
4205,25956,1665,12529,1088,24291,1212,580,632
4210,25987,1666,12543,1088,24321,1212,580,632
4215,26018,1667,12561,1088,24351,1212,580,632
4220,26049,1668,12578,1089,24381,1212,580,632
4225,26080,1669,12592,1090,24411,1212,580,632
4230,26111,1670,12606,1090,24441,1212,580,632
4235,26142,1671,12616,1090,24471,1212,580,632
4240,26173,1672,12627,1091,24501,1212,580,632
4245,26204,1673,12648,1092,24531,1212,580,632
4250,26235,1674,12666,1093,24561,1212,580,632
4255,26266,1675,12684,1094,24591,1212,580,632
4260,26297,1676,12700,1095,24621,1212,580,632
4265,26328,1677,12714,1096,24651,1212,580,632
4270,26359,1678,12731,1097,24681,1212,580,632
4275,26390,1679,12742,1098,24711,1212,580,632
4280,26421,1680,12761,1099,24741,1212,580,632
4285,26452,1681,12776,1100,24771,1212,580,632
4290,26483,1682,12791,1100,24801,1212,580,632
4295,26514,1683,12808,1101,24831,1212,580,632
4300,26545,1684,12824,1101,24861,1213,581,632
4305,26576,1687,12836,1104,24889,1215,581,634
4310,26607,1691,12852,1105,24911,1219,583,636
4315,26638,1701,12867,1113,24934,1223,586,637
4320,26669,1709,12881,1120,24958,1227,587,640
4325,26700,1712,12898,1122,24988,1228,588,640
4330,26731,1714,12912,1124,25017,1229,589,640
4335,26762,1715,12929,1125,25047,1230,590,640
4340,26793,1717,12946,1126,25076,1231,590,641
4345,26824,1718,12962,1126,25106,1232,590,642
4350,26855,1719,12987,1127,25136,1233,591,642
4355,26886,1721,13000,1128,25165,1234,592,642
4360,26917,1722,13013,1129,25195,1235,592,643
4365,26948,1723,13029,1129,25225,1236,592,644
4370,26979,1724,13046,1129,25255,1237,593,644
4375,27010,1726,13062,1131,25284,1238,594,644
4380,27041,1727,13079,1131,25314,1239,595,644
4385,27072,1727,13099,1131,25345,1240,595,645
4390,27103,1727,13115,1131,25376,1241,595,646
4395,27134,1727,13133,1131,25407,1242,596,646
4400,27165,1727,13150,1131,25438,1243,596,647
4405,27196,1727,13162,1131,25469,1244,597,647
4410,27227,1727,13175,1131,25500,1245,598,647
4415,27258,1727,13195,1131,25531,1246,598,648
4420,27289,1727,13213,1131,25562,1247,599,648
4425,27320,1728,13229,1131,25592,1249,599,650
4430,27351,1732,13239,1133,25616,1252,600,652
4435,27382,1740,13257,1139,25639,1255,603,652
4440,27413,1745,13269,1143,25665,1258,605,653
4445,27444,1750,13280,1147,25694,1260,606,654
4450,27475,1752,13291,1148,25723,1261,607,654
4455,27506,1754,13305,1148,25752,1262,607,655
4460,27537,1756,13318,1148,25781,1263,608,655
4465,27568,1758,13333,1148,25810,1264,608,656
4470,27599,1760,13345,1149,25839,1265,608,657
4475,27630,1762,13355,1149,25868,1266,608,658
4480,27661,1764,13367,1149,25897,1267,608,659
4485,27692,1766,13384,1151,25926,1268,609,659
4490,27723,1768,13395,1151,25955,1269,609,660
4495,27754,1770,13406,1152,25984,1270,610,660
4500,27785,1772,13427,1153,26013,1271,611,660
4505,27816,1775,13436,1154,26040,1273,612,661
4510,27847,1779,13451,1156,26067,1275,613,662
4515,27878,1783,13465,1158,26093,1277,614,663
4520,27909,1785,13484,1160,26124,1279,616,663
4525,27940,1785,13500,1160,26155,1281,617,664
4530,27971,1785,13515,1160,26186,1282,618,664
4535,28002,1785,13528,1160,26217,1283,618,665
4540,28033,1785,13542,1160,26248,1284,618,666
4545,28064,1785,13559,1160,26279,1285,619,666
4550,28095,1785,13570,1160,26310,1287,620,667
4555,28126,1785,13580,1160,26341,1289,621,668
4560,28157,1785,13595,1160,26372,1291,621,670
4565,28188,1789,13610,1164,26399,1292,621,671
4570,28219,1793,13626,1167,26426,1292,621,671
4575,28250,1796,13643,1168,26454,1293,622,671
4580,28281,1799,13655,1170,26482,1294,622,672
4585,28312,1802,13673,1173,26510,1295,623,672
4590,28343,1805,13680,1174,26538,1296,623,673
4595,28374,1809,13693,1176,26565,1297,624,673
4600,28405,1813,13705,1179,26592,1298,625,673
4605,28436,1816,13719,1181,26620,1299,625,674
4610,28467,1819,13736,1182,26648,1300,625,675
4615,28498,1822,13751,1185,26676,1301,625,676
4620,28529,1825,13770,1186,26703,1302,626,676
4625,28560,1828,13784,1188,26732,1303,626,677
4630,28591,1828,13796,1188,26763,1303,626,677
4635,28622,1828,13815,1188,26794,1304,626,678
4640,28653,1828,13824,1188,26825,1305,626,679
4645,28684,1828,13837,1188,26856,1306,627,679
4650,28715,1828,13853,1188,26887,1307,627,680
4655,28746,1828,13872,1188,26918,1308,628,680
4660,28777,1828,13887,1188,26949,1308,628,680
4665,28808,1828,13902,1188,26980,1308,628,680
4670,28839,1828,13915,1188,27011,1309,628,681
4675,28870,1828,13930,1188,27042,1311,630,681
4680,28901,1828,13941,1188,27073,1312,630,682
4685,28932,1830,13956,1188,27102,1313,631,682
4690,28963,1832,13973,1190,27131,1314,632,682
4695,28994,1834,13985,1192,27160,1315,632,683
4700,29025,1836,13993,1193,27189,1316,632,684
4705,29056,1838,14006,1195,27218,1317,632,685
4710,29087,1840,14022,1196,27247,1318,632,686
4715,29118,1842,14038,1197,27276,1319,632,687
4720,29149,1844,14053,1198,27305,1320,633,687
4725,29180,1846,14069,1200,27334,1321,634,687
4730,29211,1848,14085,1201,27363,1322,634,688
4735,29242,1850,14106,1202,27392,1323,634,689
4740,29273,1852,14122,1203,27421,1324,635,689
4745,29304,1852,14136,1203,27452,1326,636,690
4750,29335,1852,14148,1203,27483,1327,636,691
4755,29366,1852,14161,1203,27514,1328,636,692
4760,29397,1852,14175,1203,27545,1329,636,693
4765,29428,1852,14189,1203,27576,1330,636,694
4770,29459,1852,14209,1203,27607,1331,637,694
4775,29490,1852,14223,1203,27638,1332,638,694
4780,29521,1852,14242,1203,27669,1334,640,694
4785,29552,1852,14260,1203,27700,1336,640,696
4790,29583,1854,14275,1205,27728,1338,641,697
4795,29614,1857,14288,1207,27756,1340,643,697
4800,29645,1860,14306,1209,27785,1341,643,698
4805,29676,1861,14326,1209,27815,1342,644,698
4810,29707,1862,14341,1210,27845,1343,644,699
4815,29738,1864,14355,1212,27874,1344,645,699
4820,29769,1865,14371,1213,27904,1345,645,700
4825,29800,1866,14392,1214,27934,1346,646,700
4830,29831,1868,14407,1216,27963,1347,646,701
4835,29862,1869,14423,1217,27993,1348,647,701
4840,29893,1871,14436,1218,28022,1349,648,701
4845,29924,1874,14453,1221,28050,1350,648,702
4850,29955,1877,14467,1223,28076,1352,649,703
4855,29986,1882,14485,1226,28101,1354,650,704
4860,30017,1890,14500,1232,28126,1356,651,705
4865,30048,1894,14517,1235,28154,1358,651,707
4870,30079,1895,14529,1235,28184,1360,652,708
4875,30110,1896,14548,1235,28214,1361,652,709
4880,30141,1897,14560,1236,28244,1362,652,710
4885,30172,1898,14571,1237,28274,1363,652,711
4890,30203,1899,14588,1238,28304,1364,653,711
4895,30234,1900,14599,1238,28334,1365,653,712
4900,30265,1901,14616,1239,28364,1366,654,712
4905,30296,1902,14629,1240,28393,1368,655,713
4910,30327,1903,14643,1240,28423,1370,656,714
4915,30358,1905,14657,1241,28453,1372,657,715
4920,30389,1907,14671,1243,28482,1374,658,716
4925,30420,1909,14688,1245,28511,1374,658,716
4930,30451,1910,14703,1246,28541,1374,658,716
4935,30482,1911,14716,1246,28571,1374,658,716
4940,30513,1912,14730,1246,28601,1374,658,716
4945,30544,1914,14747,1247,28630,1374,658,716
4950,30575,1916,14763,1248,28659,1374,658,716
4955,30606,1918,14786,1249,28688,1374,658,716
4960,30637,1920,14801,1250,28717,1374,658,716
4965,30668,1921,14819,1250,28747,1374,658,716
4970,30699,1921,14836,1250,28778,1374,658,716
4975,30730,1921,14847,1250,28809,1374,658,716
4980,30761,1921,14859,1250,28840,1376,658,718
4985,30792,1925,14879,1254,28866,1377,659,718
4990,30823,1928,14895,1256,28893,1378,659,719
4995,30854,1930,14909,1258,28924,1379,659,720
5000,30885,1930,14923,1258,28955,1379,659,720
5005,30916,1930,14938,1258,28986,1379,659,720
5010,30947,1930,14954,1258,29017,1379,659,720
5015,30978,1930,14969,1258,29048,1379,659,720
5020,31009,1930,14989,1258,29079,1379,659,720
5025,31040,1930,15003,1258,29110,1379,659,720
5030,31071,1932,15019,1259,29138,1380,660,720
5035,31102,1936,15030,1262,29166,1381,660,721
5040,31133,1938,15046,1263,29195,1382,660,722
5045,31164,1939,15058,1263,29225,1383,660,723
5050,31195,1940,15069,1263,29255,1384,660,724
5055,31226,1941,15075,1263,29285,1385,660,725
5060,31257,1942,15092,1263,29315,1386,660,726
5065,31288,1943,15112,1264,29345,1387,661,726
5070,31319,1945,15126,1266,29374,1388,661,727
5075,31350,1947,15141,1268,29403,1389,661,728
5080,31381,1949,15155,1269,29432,1390,661,729
5085,31412,1951,15170,1269,29461,1391,662,729
5090,31443,1953,15183,1269,29490,1393,662,731
5095,31474,1956,15202,1270,29518,1395,663,732
5100,31505,1960,15216,1273,29544,1397,664,733
5105,31536,1963,15229,1275,29573,1398,664,734
5110,31567,1964,15242,1275,29603,1399,664,735
5115,31598,1965,15257,1275,29633,1400,664,736
5120,31629,1966,15273,1276,29663,1401,665,736
5125,31660,1967,15284,1276,29693,1402,665,737
5130,31691,1968,15298,1276,29723,1403,666,737
5135,31722,1969,15316,1277,29753,1405,666,739
5140,31753,1970,15334,1277,29783,1407,666,741
5145,31784,1971,15351,1277,29813,1409,667,742
5150,31815,1972,15359,1277,29843,1411,667,744
5155,31846,1973,15376,1278,29873,1412,667,745
5160,31877,1974,15389,1278,29903,1413,667,746
5165,31908,1977,15406,1279,29931,1414,668,746
5170,31939,1980,15420,1281,29958,1415,669,746
5175,31970,1984,15437,1283,29986,1416,670,746
5180,32001,1987,15454,1286,30014,1417,670,747
5185,32032,1988,15467,1287,30044,1418,670,748
5190,32063,1989,15483,1287,30074,1419,670,749
5195,32094,1990,15500,1288,30104,1420,671,749
5200,32125,1991,15513,1289,30134,1421,672,749
5205,32156,1993,15529,1291,30163,1422,672,750
5210,32187,1995,15542,1291,30191,1424,673,751
5215,32218,1999,15557,1293,30217,1426,675,751
5220,32249,2002,15573,1296,30246,1428,676,752
5225,32280,2004,15592,1298,30275,1431,678,753
5230,32311,2006,15605,1299,30305,1434,678,756
5235,32342,2007,15618,1300,30334,1437,679,758
5240,32373,2009,15630,1301,30364,1440,681,759
5245,32404,2010,15647,1302,30393,1443,683,760
5250,32435,2012,15666,1303,30422,1446,685,761
5255,32466,2014,15682,1305,30451,1448,685,763
5260,32497,2016,15702,1306,30480,1450,687,763
5265,32528,2018,15722,1307,30509,1451,688,763
5270,32559,2020,15741,1309,30539,1452,688,764
5275,32590,2021,15748,1309,30568,1453,689,764
5280,32621,2022,15761,1310,30599,1454,689,765
5285,32652,2022,15774,1310,30630,1455,689,766
5290,32683,2024,15787,1311,30659,1456,690,766
5295,32714,2026,15798,1313,30688,1458,690,768
5300,32745,2028,15814,1315,30717,1460,692,768
5305,32776,2029,15829,1316,30746,1461,693,768
5310,32807,2031,15846,1318,30776,1462,693,769
5315,32838,2033,15865,1319,30805,1463,693,770
5320,32869,2035,15877,1320,30834,1464,694,770
5325,32900,2036,15893,1321,30864,1465,694,771
5330,32931,2038,15905,1322,30892,1466,694,772
5335,32962,2040,15923,1323,30921,1467,694,773
5340,32993,2043,15942,1324,30949,1468,695,773
5345,33024,2045,15951,1324,30979,1469,695,774
5350,33055,2048,15969,1326,31007,1470,695,775
5355,33086,2050,15983,1327,31035,1471,695,776
5360,33117,2055,16000,1331,31061,1472,695,777
5365,33148,2060,16016,1336,31087,1474,696,778
5370,33179,2064,16026,1338,31115,1476,698,778
5375,33210,2066,16041,1338,31143,1478,700,778
5380,33241,2070,16058,1342,31171,1480,700,780
5385,33272,2072,16068,1343,31200,1482,700,782
5390,33303,2075,16086,1346,31228,1484,702,782
5395,33334,2077,16102,1347,31257,1486,702,784
5400,33365,2079,16118,1348,31286,1488,704,784
5405,33396,2082,16133,1351,31314,1488,704,784
5410,33427,2084,16152,1353,31343,1488,704,784
5415,33458,2086,16168,1355,31372,1488,704,784
5420,33489,2087,16192,1356,31402,1488,704,784
5425,33520,2088,16208,1356,31432,1488,704,784
5430,33551,2089,16223,1356,31462,1488,704,784
5435,33582,2090,16236,1356,31492,1488,704,784
5440,33613,2091,16255,1357,31522,1488,704,784
5445,33644,2092,16268,1358,31552,1489,704,785
5450,33675,2093,16283,1359,31582,1491,705,786
5455,33706,2094,16299,1360,31612,1493,706,787
5460,33737,2095,16314,1360,31642,1495,706,789
5465,33768,2095,16329,1360,31673,1497,708,789
5470,33799,2095,16343,1360,31704,1498,709,789
5475,33830,2095,16359,1360,31735,1499,710,789
5480,33861,2095,16379,1360,31766,1500,711,789
5485,33892,2095,16392,1360,31797,1501,711,790
5490,33923,2095,16407,1360,31828,1502,711,791
5495,33954,2095,16423,1360,31859,1503,711,792
5500,33985,2097,16438,1361,31888,1504,712,792
5505,34016,2099,16456,1363,31915,1505,713,792
5510,34047,2105,16464,1367,31942,1507,713,794
5515,34078,2108,16479,1369,31969,1509,714,795
5520,34109,2112,16497,1371,31994,1511,715,796
5525,34140,2118,16513,1375,32022,1512,716,796
5530,34171,2120,16531,1376,32051,1513,717,796
5535,34202,2122,16548,1378,32080,1514,717,797
5540,34233,2124,16565,1380,32109,1515,717,798
5545,34264,2126,16583,1381,32138,1516,717,799
5550,34295,2128,16596,1381,32167,1517,718,799
5555,34326,2130,16609,1382,32196,1518,719,799
5560,34357,2132,16626,1383,32225,1519,720,799
5565,34388,2134,16642,1383,32254,1520,720,800
5570,34419,2136,16657,1384,32283,1522,721,801
5575,34450,2138,16673,1384,32312,1524,722,802
5580,34481,2140,16691,1386,32341,1526,724,802
5585,34512,2143,16705,1388,32369,1528,726,802
5590,34543,2146,16722,1391,32397,1530,726,804
5595,34574,2149,16734,1394,32425,1531,726,805
5600,34605,2151,16748,1395,32454,1532,726,806
5605,34636,2152,16761,1395,32484,1533,727,806
5610,34667,2153,16780,1395,32514,1534,728,806
5615,34698,2154,16792,1396,32544,1535,728,807
5620,34729,2155,16807,1397,32574,1536,729,807
5625,34760,2156,16819,1398,32603,1537,730,807
5630,34791,2157,16834,1399,32632,1539,731,808
5635,34822,2160,16851,1401,32662,1541,732,809
5640,34853,2162,16868,1402,32690,1543,733,810
5645,34884,2164,16880,1403,32720,1544,734,810
5650,34915,2164,16894,1403,32751,1545,735,810
5655,34946,2164,16908,1403,32782,1546,735,811
5660,34977,2164,16920,1403,32813,1547,735,812
5665,35008,2164,16936,1403,32844,1548,736,812
5670,35039,2164,16952,1403,32875,1549,736,813
5675,35070,2164,16965,1403,32906,1550,737,813
5680,35101,2164,16985,1403,32937,1551,738,813
5685,35132,2164,16994,1403,32968,1552,738,814
5690,35163,2164,17013,1403,32999,1553,739,814
5695,35194,2164,17029,1403,33030,1555,740,815
5700,35225,2164,17043,1403,33061,1557,742,815
5705,35256,2164,17061,1403,33092,1560,743,817
5710,35287,2164,17073,1403,33123,1563,745,818
5715,35318,2164,17088,1403,33154,1566,746,820
5720,35349,2164,17098,1403,33185,1569,747,822
5725,35380,2164,17114,1403,33216,1571,748,823
5730,35411,2164,17131,1403,33247,1573,749,824
5735,35442,2165,17145,1403,33277,1575,750,825
5740,35473,2166,17160,1403,33307,1576,750,826
5745,35504,2168,17177,1405,33334,1577,750,827
5750,35535,2175,17193,1412,33357,1579,751,828
5755,35566,2184,17207,1420,33380,1581,753,828
5760,35597,2192,17224,1428,33403,1583,754,829
5765,35628,2194,17238,1430,33434,1584,755,829
5770,35659,2194,17251,1430,33465,1585,756,829
5775,35690,2194,17264,1430,33496,1586,757,829
5780,35721,2194,17279,1430,33527,1587,757,830
5785,35752,2194,17297,1430,33558,1588,757,831
5790,35783,2194,17312,1430,33589,1589,758,831
5795,35814,2194,17327,1430,33620,1590,759,831
5800,35845,2194,17341,1430,33651,1591,759,832
5805,35876,2194,17360,1430,33682,1592,759,833
5810,35907,2194,17376,1430,33713,1593,760,833
5815,35938,2194,17390,1430,33744,1594,760,834
5820,35969,2194,17410,1430,33775,1595,760,835
5825,36000,2194,17427,1430,33806,1597,761,836
5830,36031,2194,17440,1430,33837,1599,762,837
5835,36062,2194,17457,1430,33868,1601,764,837
5840,36093,2194,17476,1430,33899,1603,765,838
5845,36124,2194,17493,1430,33930,1605,766,839
5850,36155,2194,17511,1430,33961,1607,767,840
5855,36186,2194,17520,1430,33992,1609,767,842
5860,36217,2194,17536,1430,34023,1610,768,842
5865,36248,2195,17553,1430,34053,1611,769,842
5870,36279,2200,17573,1434,34076,1614,771,843
5875,36310,2211,17589,1445,34097,1617,772,845
5880,36341,2218,17600,1450,34120,1620,774,846
5885,36372,2222,17614,1453,34150,1620,774,846
5890,36403,2222,17630,1453,34181,1620,774,846
5895,36434,2222,17647,1453,34212,1620,774,846
5900,36465,2222,17658,1453,34243,1620,774,846
5905,36496,2222,17671,1453,34274,1620,774,846
5910,36527,2222,17687,1453,34305,1620,774,846
5915,36558,2222,17700,1453,34336,1620,774,846
5920,36589,2222,17713,1453,34367,1620,774,846
5925,36620,2222,17728,1453,34398,1620,774,846
5930,36651,2222,17740,1453,34429,1620,774,846
5935,36682,2222,17753,1453,34460,1620,774,846
5940,36713,2222,17769,1453,34491,1620,774,846
5945,36744,2222,17782,1453,34522,1621,775,846
5950,36775,2222,17797,1453,34553,1622,776,846
5955,36806,2222,17815,1453,34584,1622,776,846
5960,36837,2222,17826,1453,34615,1623,777,846
5965,36868,2222,17840,1453,34646,1624,778,846
5970,36899,2222,17855,1453,34677,1625,779,846
5975,36930,2222,17869,1453,34708,1626,780,846
5980,36961,2222,17883,1453,34739,1627,781,846
5985,36992,2222,17895,1453,34770,1628,782,846
5990,37023,2225,17909,1455,34797,1631,784,847
5995,37054,2230,17926,1460,34821,1634,786,848
6000,37085,2239,17944,1468,34843,1637,789,848
6005,37116,2242,17959,1470,34874,1639,789,850
6010,37147,2244,17971,1471,34903,1640,789,851
6015,37178,2245,17983,1471,34933,1641,790,851
6020,37209,2246,17993,1471,34963,1642,790,852
6025,37240,2248,18007,1473,34992,1643,790,853
6030,37271,2249,18022,1474,35022,1644,791,853
6035,37302,2250,18039,1474,35052,1645,792,853
6040,37333,2251,18056,1475,35082,1646,793,853
6045,37364,2252,18078,1476,35112,1647,794,853
6050,37395,2253,18093,1477,35142,1648,794,854
6055,37426,2254,18109,1478,35172,1649,794,855
6060,37457,2255,18126,1479,35202,1651,795,856
6065,37488,2257,18136,1481,35229,1652,795,857
6070,37519,2259,18143,1482,35260,1653,795,858
6075,37550,2260,18161,1483,35289,1654,795,859
6080,37581,2262,18179,1485,35318,1655,796,859
6085,37612,2264,18194,1486,35348,1656,797,859
6090,37643,2265,18207,1486,35378,1657,797,860
6095,37674,2266,18223,1486,35407,1658,798,860
6100,37705,2268,18236,1488,35437,1659,798,861
6105,37736,2270,18253,1490,35465,1660,798,862
6110,37767,2273,18268,1492,35493,1661,798,863
6115,37798,2278,18284,1496,35519,1663,799,864
6120,37829,2283,18299,1501,35545,1665,799,866
6125,37860,2286,18314,1504,35574,1667,800,867
6130,37891,2288,18328,1505,35603,1668,801,867
6135,37922,2289,18343,1505,35633,1669,802,867
6140,37953,2292,18357,1507,35661,1670,802,868
6145,37984,2294,18372,1508,35690,1671,803,868
6150,38015,2295,18389,1509,35720,1672,803,869
6155,38046,2295,18409,1509,35751,1673,804,869
6160,38077,2295,18424,1509,35782,1674,805,869
6165,38108,2295,18441,1509,35813,1675,806,869
6170,38139,2295,18457,1509,35844,1676,806,870
6175,38170,2295,18474,1509,35875,1677,807,870
6180,38201,2295,18486,1509,35906,1678,807,871
6185,38232,2299,18499,1511,35932,1680,809,871
6190,38263,2300,18516,1512,35963,1681,810,871
6195,38294,2300,18528,1512,35994,1682,810,872
6200,38325,2300,18544,1512,36025,1683,810,873
6205,38356,2300,18558,1512,36056,1684,810,874
6210,38387,2300,18573,1512,36087,1685,811,874
6215,38418,2300,18587,1512,36118,1686,812,874
6220,38449,2300,18605,1512,36149,1687,812,875
6225,38480,2300,18613,1512,36180,1688,812,876
6230,38511,2301,18625,1512,36210,1689,812,877
6235,38542,2302,18639,1512,36240,1690,812,878
6240,38573,2303,18655,1513,36270,1691,813,878
6245,38604,2304,18670,1514,36300,1692,813,879
6250,38635,2305,18683,1514,36330,1693,814,879
6255,38666,2306,18697,1514,36360,1694,814,880
6260,38697,2308,18710,1515,36389,1695,814,881
6265,38728,2309,18725,1515,36419,1696,814,882
6270,38759,2311,18745,1517,36448,1697,815,882
6275,38790,2312,18759,1518,36478,1698,816,882
6280,38821,2314,18771,1519,36507,1699,816,883
6285,38852,2315,18789,1519,36537,1700,817,883
6290,38883,2317,18809,1521,36566,1701,817,884
6295,38914,2320,18823,1523,36594,1702,818,884
6300,38945,2325,18840,1528,36620,1703,818,885
6305,38976,2328,18856,1531,36648,1703,818,885
6310,39007,2331,18871,1532,36676,1703,818,885
6315,39038,2334,18889,1534,36704,1703,818,885
6320,39069,2336,18904,1534,36733,1703,818,885
6325,39100,2338,18920,1535,36762,1703,818,885
6330,39131,2340,18933,1535,36791,1703,818,885
6335,39162,2342,18949,1537,36820,1703,818,885
6340,39193,2344,18966,1538,36849,1703,818,885
6345,39224,2346,18984,1540,36878,1703,818,885
6350,39255,2348,18996,1542,36907,1704,818,886
6355,39286,2350,19011,1543,36936,1705,819,886
6360,39317,2352,19029,1543,36965,1705,819,886
6365,39348,2354,19049,1544,36994,1705,819,886
6370,39379,2356,19067,1546,37023,1705,819,886
6375,39410,2358,19081,1547,37052,1705,819,886
6380,39441,2360,19095,1547,37081,1705,819,886
6385,39472,2362,19110,1548,37110,1705,819,886
6390,39503,2364,19128,1549,37139,1706,820,886
6395,39534,2366,19147,1550,37168,1707,821,886
6400,39565,2368,19163,1551,37197,1708,822,886
6405,39596,2370,19174,1551,37226,1709,822,887
6410,39627,2374,19192,1554,37252,1710,822,888
6415,39658,2381,19208,1559,37275,1712,823,889
6420,39689,2389,19224,1566,37298,1714,823,891
6425,39720,2391,19239,1568,37329,1716,823,893
6430,39751,2391,19255,1568,37360,1718,825,893
6435,39782,2391,19266,1568,37391,1720,826,894
6440,39813,2391,19279,1568,37422,1722,826,896
6445,39844,2391,19298,1568,37453,1724,827,897
6450,39875,2391,19309,1568,37484,1725,828,897
6455,39906,2391,19325,1568,37515,1726,829,897
6460,39937,2391,19336,1568,37546,1727,830,897
6465,39968,2391,19347,1568,37577,1728,830,898
6470,39999,2391,19358,1568,37608,1730,831,899
6475,40030,2391,19371,1568,37639,1732,832,900
6480,40061,2391,19395,1568,37670,1734,834,900
6485,40092,2391,19407,1568,37701,1735,835,900
6490,40123,2391,19420,1568,37732,1736,836,900
6495,40154,2391,19437,1568,37763,1737,837,900
6500,40185,2391,19451,1568,37794,1738,838,900
6505,40216,2391,19462,1568,37825,1739,838,901
6510,40247,2391,19477,1568,37856,1740,839,901
6515,40278,2391,19491,1568,37887,1741,839,902
6520,40309,2391,19506,1568,37918,1742,839,903
6525,40340,2391,19520,1568,37949,1743,839,904
6530,40371,2394,19537,1571,37976,1744,840,904
6535,40402,2398,19550,1573,38002,1745,840,905
6540,40433,2404,19561,1576,38028,1746,841,905
6545,40464,2407,19575,1577,38057,1747,841,906
6550,40495,2410,19593,1580,38085,1748,841,907
6555,40526,2412,19606,1581,38114,1749,841,908
6560,40557,2414,19615,1583,38143,1750,842,908
6565,40588,2416,19632,1584,38172,1751,842,909
6570,40619,2418,19647,1586,38201,1753,844,909
6575,40650,2420,19659,1586,38230,1755,845,910
6580,40681,2422,19670,1587,38259,1757,845,912
6585,40712,2424,19681,1588,38288,1759,846,913
6590,40743,2426,19696,1589,38317,1762,848,914
6595,40774,2428,19712,1590,38346,1765,850,915
6600,40805,2430,19729,1590,38375,1767,852,915
6605,40836,2432,19739,1591,38404,1768,853,915
6610,40867,2434,19757,1593,38433,1769,854,915
6615,40898,2436,19773,1595,38462,1770,855,915
6620,40929,2438,19790,1596,38491,1771,856,915
6625,40960,2440,19804,1596,38520,1772,857,915
6630,40991,2442,19818,1597,38549,1773,857,916
6635,41022,2444,19834,1599,38578,1774,857,917
6640,41053,2446,19855,1600,38607,1775,857,918
6645,41084,2448,19872,1602,38636,1776,858,918
6650,41115,2453,19890,1605,38660,1777,859,918
6655,41146,2459,19908,1609,38685,1778,859,919
6660,41177,2461,19926,1611,38714,1779,859,920
6665,41208,2465,19946,1615,38743,1780,860,920
6670,41239,2467,19962,1616,38770,1781,860,921
6675,41270,2470,19975,1618,38799,1782,860,922
6680,41301,2472,19990,1620,38829,1783,860,923
6685,41332,2473,20004,1621,38858,1784,860,924
6690,41363,2475,20021,1623,38887,1785,861,924
6695,41394,2477,20035,1624,38917,1786,862,924
6700,41425,2477,20046,1624,38948,1787,862,925
6705,41456,2477,20057,1624,38979,1789,863,926
6710,41487,2477,20065,1624,39010,1791,863,928
6715,41518,2477,20080,1624,39041,1793,863,930
6720,41549,2477,20095,1624,39072,1795,863,932
6725,41580,2477,20111,1624,39103,1797,865,932
6730,41611,2477,20133,1624,39134,1799,866,933
6735,41642,2477,20150,1624,39165,1800,867,933
6740,41673,2477,20162,1624,39196,1801,867,934
6745,41704,2477,20179,1624,39227,1802,867,935
6750,41735,2477,20198,1624,39258,1803,867,936
6755,41766,2477,20215,1624,39289,1804,867,937
6760,41797,2478,20226,1625,39319,1805,868,937
6765,41828,2479,20240,1626,39349,1806,869,937
6770,41859,2482,20255,1627,39377,1807,870,937
6775,41890,2485,20270,1630,39405,1808,871,937
6780,41921,2490,20285,1634,39431,1809,871,938
6785,41952,2493,20299,1636,39459,1810,871,939
6790,41983,2496,20311,1637,39487,1811,871,940
6795,42014,2498,20328,1638,39516,1811,871,940
6800,42045,2500,20340,1638,39545,1811,871,940
6805,42076,2502,20357,1638,39574,1811,871,940
6810,42107,2504,20369,1640,39603,1811,871,940
6815,42138,2507,20383,1641,39631,1811,871,940
6820,42169,2509,20397,1642,39660,1811,871,940
6825,42200,2512,20417,1643,39688,1811,871,940
6830,42231,2514,20436,1643,39717,1811,871,940
6835,42262,2517,20450,1645,39745,1812,871,941
6840,42293,2519,20466,1646,39774,1813,872,941
6845,42324,2521,20480,1646,39803,1814,872,942
6850,42355,2523,20497,1646,39832,1815,873,942
6855,42386,2525,20510,1648,39861,1816,873,943
6860,42417,2527,20524,1649,39890,1817,873,944
6865,42448,2529,20537,1650,39919,1818,873,945
6870,42479,2531,20554,1651,39948,1819,874,945
6875,42510,2533,20567,1652,39977,1820,874,946
6880,42541,2535,20585,1654,40006,1821,874,947
6885,42572,2538,20599,1656,40034,1822,875,947
6890,42603,2541,20620,1659,40061,1823,875,948
6895,42634,2545,20626,1661,40088,1824,875,949
6900,42665,2551,20645,1667,40113,1825,876,949
6905,42696,2555,20657,1671,40141,1826,877,949
6910,42727,2558,20672,1673,40169,1827,878,949
6915,42758,2558,20687,1673,40200,1828,878,950
6920,42789,2558,20703,1673,40231,1829,878,951
6925,42820,2558,20719,1673,40262,1830,879,951
6930,42851,2558,20737,1673,40293,1831,879,952
6935,42882,2558,20754,1673,40324,1832,879,953
6940,42913,2558,20763,1673,40355,1833,879,954
6945,42944,2558,20779,1673,40386,1834,879,955
6950,42975,2558,20792,1673,40417,1836,881,955
6955,43006,2558,20800,1673,40448,1838,881,957
6960,43037,2558,20818,1673,40479,1840,882,958
6965,43068,2561,20831,1675,40507,1842,882,960
6970,43099,2561,20845,1675,40538,1843,883,960
6975,43130,2561,20856,1675,40569,1844,884,960
6980,43161,2561,20868,1675,40600,1845,884,961
6985,43192,2561,20884,1675,40631,1846,885,961
6990,43223,2561,20899,1675,40662,1847,886,961
6995,43254,2561,20906,1675,40693,1848,886,962
7000,43285,2561,20926,1675,40724,1849,887,962
7005,43316,2562,20941,1675,40754,1850,888,962
7010,43347,2563,20956,1676,40784,1851,888,963
7015,43378,2564,20968,1677,40814,1852,889,963
7020,43409,2567,20977,1679,40842,1853,889,964
7025,43440,2570,20995,1681,40870,1854,889,965
7030,43471,2575,21013,1686,40896,1855,890,965
7035,43502,2578,21023,1687,40924,1856,890,966
7040,43533,2582,21042,1690,40951,1857,891,966
7045,43564,2583,21058,1690,40981,1858,892,966
7050,43595,2584,21073,1690,41011,1859,893,966
7055,43626,2585,21089,1690,41041,1860,894,966
7060,43657,2586,21109,1691,41071,1861,894,967
7065,43688,2587,21124,1691,41101,1862,895,967
7070,43719,2589,21136,1692,41130,1864,896,968
7075,43750,2591,21151,1694,41159,1866,896,970
7080,43781,2594,21166,1696,41187,1868,898,970
7085,43812,2597,21183,1698,41215,1868,898,970
7090,43843,2599,21199,1699,41244,1868,898,970
7095,43874,2601,21211,1700,41273,1868,898,970
7100,43905,2603,21225,1701,41302,1868,898,970
7105,43936,2605,21234,1701,41331,1868,898,970
7110,43967,2608,21245,1702,41359,1869,898,971
7115,43998,2610,21262,1704,41388,1870,899,971
7120,44029,2613,21277,1706,41416,1871,899,972
7125,44060,2615,21290,1706,41445,1872,899,973
7130,44091,2618,21305,1708,41473,1873,899,974
7135,44122,2621,21322,1710,41501,1874,899,975
7140,44153,2624,21339,1711,41529,1875,900,975
7145,44184,2626,21358,1713,41558,1876,900,976
7150,44215,2631,21376,1717,41584,1877,901,976
7155,44246,2634,21386,1719,41612,1877,901,976
7160,44277,2638,21405,1722,41639,1877,901,976
7165,44308,2640,21419,1723,41668,1877,901,976
7170,44339,2642,21432,1724,41697,1877,901,976
7175,44370,2644,21450,1726,41726,1877,901,976
7180,44401,2644,21473,1726,41757,1877,901,976
7185,44432,2644,21487,1726,41788,1877,901,976
7190,44463,2644,21505,1726,41819,1879,902,977
7195,44494,2644,21519,1726,41850,1881,902,979
7200,44525,2644,21536,1726,41881,1882,902,980
7205,44556,2644,21550,1726,41912,1883,903,980
7210,44587,2644,21562,1726,41943,1884,903,981
7215,44618,2644,21577,1726,41974,1885,904,981
7220,44649,2644,21591,1726,42005,1886,905,981
7225,44680,2644,21604,1726,42036,1887,905,982
7230,44711,2644,21617,1726,42067,1888,905,983
7235,44742,2644,21629,1726,42098,1889,905,984
7240,44773,2644,21641,1726,42129,1890,905,985
7245,44804,2644,21651,1726,42160,1891,905,986
7250,44835,2645,21666,1726,42189,1892,905,987
7255,44866,2647,21675,1727,42219,1893,906,987
7260,44897,2648,21693,1727,42248,1895,908,987
7265,44928,2652,21707,1730,42276,1897,908,989
7270,44959,2656,21728,1733,42303,1899,910,989
7275,44990,2658,21745,1734,42332,1901,912,989
7280,45021,2662,21764,1737,42359,1903,913,990
7285,45052,2666,21775,1739,42386,1905,913,992
7290,45083,2669,21786,1739,42414,1907,913,994
7295,45114,2674,21800,1741,42440,1909,913,996
7300,45145,2679,21813,1744,42466,1912,913,999
7305,45176,2684,21828,1749,42492,1915,915,1000
7310,45207,2689,21841,1752,42518,1918,916,1002
7315,45238,2693,21860,1755,42545,1920,917,1003
7320,45269,2697,21872,1757,42572,1922,918,1004
7325,45300,2698,21886,1758,42602,1923,919,1004
7330,45331,2700,21898,1760,42631,1924,919,1005
7335,45362,2701,21920,1761,42661,1925,919,1006
7340,45393,2702,21934,1761,42691,1926,920,1006
7345,45424,2703,21951,1762,42721,1927,920,1007
7350,45455,2704,21965,1763,42751,1928,921,1007
7355,45486,2705,21976,1763,42781,1929,921,1008
7360,45517,2706,21992,1763,42811,1930,922,1008
7365,45548,2707,22008,1764,42841,1931,922,1009
7370,45579,2708,22025,1764,42871,1932,923,1009
7375,45610,2709,22044,1764,42901,1933,924,1009
7380,45641,2710,22062,1765,42931,1934,924,1010
7385,45672,2711,22074,1765,42961,1935,924,1011
7390,45703,2712,22085,1766,42991,1936,924,1012
7395,45734,2713,22100,1766,43021,1937,925,1012
7400,45765,2714,22112,1766,43051,1938,926,1012
7405,45796,2715,22132,1767,43081,1939,927,1012
7410,45827,2716,22147,1767,43111,1940,928,1012
7415,45858,2717,22164,1767,43141,1942,930,1012
7420,45889,2718,22183,1768,43171,1944,931,1013
7425,45920,2719,22201,1769,43201,1946,933,1013
7430,45951,2723,22220,1772,43227,1949,935,1014
7435,45982,2728,22234,1777,43253,1951,936,1015
7440,46013,2736,22249,1782,43276,1953,938,1015
7445,46044,2737,22263,1783,43307,1954,939,1015
7450,46075,2737,22274,1783,43338,1955,939,1016
7455,46106,2737,22288,1783,43369,1956,940,1016
7460,46137,2737,22305,1783,43400,1957,941,1016
7465,46168,2737,22320,1783,43431,1958,941,1017
7470,46199,2737,22338,1783,43462,1959,942,1017
7475,46230,2737,22353,1783,43493,1960,943,1017
7480,46261,2737,22370,1783,43524,1961,944,1017
7485,46292,2737,22388,1783,43555,1962,945,1017
7490,46323,2737,22403,1783,43586,1963,946,1017
7495,46354,2737,22421,1783,43617,1964,947,1017
7500,46385,2737,22435,1783,43648,1965,948,1017
7505,46416,2737,22448,1783,43679,1966,949,1017
7510,46447,2737,22467,1783,43710,1967,949,1018
7515,46478,2737,22479,1783,43741,1968,949,1019
7520,46509,2737,22492,1783,43772,1969,950,1019
7525,46540,2737,22507,1783,43803,1970,950,1020
7530,46571,2737,22521,1783,43834,1971,951,1020
7535,46602,2737,22539,1783,43865,1973,952,1021
7540,46633,2737,22551,1783,43896,1975,953,1022
7545,46664,2739,22566,1785,43924,1977,954,1023
7550,46695,2745,22583,1790,43949,1979,954,1025
7555,46726,2750,22599,1793,43974,1980,954,1026
7560,46757,2756,22614,1796,44000,1981,955,1026
7565,46788,2759,22632,1797,44029,1982,955,1027
7570,46819,2762,22641,1798,44057,1983,955,1028
7575,46850,2765,22655,1800,44085,1984,955,1029
7580,46881,2767,22669,1801,44114,1985,956,1029
7585,46912,2768,22686,1801,44144,1987,957,1030
7590,46943,2770,22704,1802,44173,1989,959,1030
7595,46974,2772,22722,1804,44202,1991,961,1030
7600,47005,2773,22739,1804,44232,1993,963,1030
7605,47036,2775,22749,1806,44261,1994,963,1031
7610,47067,2777,22764,1808,44290,1995,963,1032
7615,47098,2778,22779,1808,44320,1996,963,1033
7620,47129,2779,22794,1808,44350,1997,964,1033
7625,47160,2781,22805,1810,44379,1998,964,1034
7630,47191,2782,22816,1810,44409,1999,964,1035
7635,47222,2782,22835,1810,44440,2000,964,1036
7640,47253,2782,22851,1810,44471,2001,964,1037
7645,47284,2782,22862,1810,44502,2002,964,1038
7650,47315,2782,22876,1810,44533,2003,965,1038
7655,47346,2782,22890,1810,44564,2005,966,1039
7660,47377,2782,22904,1810,44595,2007,966,1041
7665,47408,2782,22917,1810,44626,2009,967,1042
7670,47439,2783,22927,1811,44656,2011,969,1042
7675,47470,2785,22940,1813,44685,2013,969,1044
7680,47501,2788,22956,1816,44713,2015,970,1045
7685,47532,2792,22965,1818,44739,2015,970,1045
7690,47563,2794,22975,1819,44767,2015,970,1045
7695,47594,2797,22990,1822,44796,2015,970,1045
7700,47625,2799,23008,1823,44825,2015,970,1045
7705,47656,2801,23023,1825,44855,2015,970,1045
7710,47687,2802,23041,1825,44883,2015,970,1045
7715,47718,2805,23059,1828,44913,2015,970,1045
7720,47749,2805,23077,1828,44944,2015,970,1045
7725,47780,2805,23093,1828,44975,2015,970,1045
7730,47811,2805,23110,1828,45006,2015,970,1045
7735,47842,2805,23127,1828,45037,2015,970,1045
7740,47873,2805,23140,1828,45068,2015,970,1045
7745,47904,2807,23149,1830,45097,2015,970,1045
7750,47935,2808,23161,1830,45127,2015,970,1045
7755,47966,2809,23178,1831,45157,2015,970,1045
7760,47997,2809,23192,1831,45188,2015,970,1045
7765,48028,2809,23206,1831,45219,2015,970,1045
7770,48059,2809,23224,1831,45250,2015,970,1045
7775,48090,2809,23236,1831,45281,2015,970,1045
7780,48121,2809,23254,1831,45312,2015,970,1045
7785,48152,2809,23273,1831,45343,2016,970,1046
7790,48183,2811,23290,1833,45372,2019,972,1047
7795,48214,2815,23300,1836,45398,2022,973,1049
7800,48245,2820,23314,1839,45424,2025,974,1051
7805,48276,2823,23331,1840,45453,2028,975,1053
7810,48307,2824,23343,1840,45483,2030,976,1054
7815,48338,2825,23359,1841,45513,2031,977,1054
7820,48369,2826,23374,1841,45543,2032,977,1055
7825,48400,2827,23385,1841,45573,2033,977,1056
7830,48431,2828,23400,1841,45603,2034,977,1057
7835,48462,2829,23417,1841,45633,2035,977,1058
7840,48493,2830,23432,1842,45663,2036,978,1058
7845,48524,2831,23448,1843,45693,2037,978,1059
7850,48555,2832,23464,1844,45723,2038,979,1059
7855,48586,2834,23475,1845,45751,2039,980,1059
7860,48617,2837,23490,1847,45779,2040,981,1059
7865,48648,2841,23505,1851,45806,2041,982,1059
7870,48679,2846,23523,1854,45831,2042,983,1059
7875,48710,2851,23538,1858,45858,2043,983,1060
7880,48741,2856,23556,1862,45885,2044,983,1061
7885,48772,2856,23571,1862,45916,2045,983,1062
7890,48803,2856,23582,1862,45947,2046,984,1062
7895,48834,2856,23599,1862,45978,2047,984,1063
7900,48865,2856,23608,1862,46009,2048,985,1063
7905,48896,2856,23620,1862,46040,2049,985,1064
7910,48927,2856,23632,1862,46071,2050,985,1065
7915,48958,2858,23649,1864,46100,2053,987,1066
7920,48989,2859,23657,1865,46130,2056,988,1068
7925,49020,2862,23679,1868,46158,2059,989,1070
7930,49051,2864,23694,1868,46187,2061,991,1070
7935,49082,2866,23710,1869,46216,2063,993,1070
7940,49113,2868,23730,1871,46245,2065,994,1071
7945,49144,2870,23743,1871,46274,2067,995,1072
7950,49175,2873,23763,1874,46302,2069,996,1073
7955,49206,2875,23775,1874,46331,2071,998,1073
7960,49237,2878,23793,1875,46359,2073,1000,1073
7965,49268,2880,23807,1875,46388,2075,1000,1075
7970,49299,2882,23821,1877,46417,2077,1001,1076
7975,49330,2885,23833,1879,46445,2079,1003,1076
7980,49361,2887,23848,1881,46473,2081,1004,1077
7985,49392,2889,23865,1882,46503,2082,1005,1077
7990,49423,2891,23883,1884,46532,2083,1005,1078
7995,49454,2893,23895,1885,46561,2084,1006,1078
8000,49485,2895,23909,1886,46590,2085,1006,1079
8005,49516,2897,23924,1887,46619,2086,1006,1080
8010,49547,2900,23939,1889,46647,2087,1007,1080
8015,49578,2902,23951,1891,46676,2088,1008,1080
8020,49609,2906,23969,1893,46703,2089,1009,1080
8025,49640,2908,23982,1894,46732,2090,1010,1080
8030,49671,2912,24000,1897,46757,2091,1011,1080
8035,49702,2916,24017,1899,46785,2092,1011,1081
8040,49733,2921,24031,1903,46811,2094,1011,1083
8045,49764,2923,24044,1904,46841,2096,1011,1085
8050,49795,2924,24060,1904,46871,2098,1013,1085
8055,49826,2925,24074,1904,46901,2100,1014,1086
8060,49857,2927,24086,1905,46930,2102,1015,1087
8065,49888,2928,24097,1905,46960,2103,1016,1087
8070,49919,2928,24113,1905,46991,2104,1016,1088
8075,49950,2928,24129,1905,47022,2105,1017,1088
8080,49981,2928,24148,1905,47053,2106,1018,1088
8085,50012,2928,24159,1905,47084,2107,1019,1088
8090,50043,2928,24170,1905,47115,2109,1021,1088
8095,50074,2928,24184,1905,47146,2111,1023,1088
8100,50105,2928,24195,1905,47177,2113,1024,1089
8105,50136,2931,24208,1907,47205,2114,1024,1090
8110,50167,2935,24225,1910,47232,2115,1025,1090
8115,50198,2938,24236,1912,47260,2116,1026,1090
8120,50229,2939,24250,1913,47290,2117,1027,1090
8125,50260,2939,24270,1913,47321,2118,1028,1090
8130,50291,2939,24288,1913,47352,2119,1028,1091
8135,50322,2939,24303,1913,47383,2120,1028,1092
8140,50353,2939,24317,1913,47414,2121,1029,1092
8145,50384,2939,24333,1913,47445,2122,1030,1092
8150,50415,2940,24350,1913,47475,2123,1031,1092
8155,50446,2942,24364,1915,47504,2124,1032,1092
8160,50477,2943,24381,1916,47534,2125,1033,1092
8165,50508,2945,24396,1917,47563,2126,1034,1092
8170,50539,2947,24405,1918,47592,2127,1034,1093
8175,50570,2949,24418,1918,47621,2128,1034,1094
8180,50601,2951,24430,1918,47650,2129,1035,1094
8185,50632,2953,24448,1919,47679,2130,1036,1094
8190,50663,2955,24462,1921,47708,2132,1037,1095
8195,50694,2958,24478,1924,47736,2134,1038,1096
8200,50725,2960,24496,1925,47765,2136,1039,1097
8205,50756,2963,24512,1927,47793,2138,1040,1098
8210,50787,2966,24522,1928,47821,2141,1040,1101
8215,50818,2968,24543,1929,47849,2144,1042,1102
8220,50849,2972,24559,1933,47876,2147,1044,1103
8225,50880,2976,24576,1936,47904,2148,1044,1104
8230,50911,2978,24588,1937,47933,2149,1044,1105
8235,50942,2979,24600,1938,47963,2150,1045,1105
8240,50973,2979,24615,1938,47994,2151,1046,1105
8245,51004,2979,24631,1938,48025,2152,1046,1106
8250,51035,2979,24642,1938,48056,2153,1047,1106
8255,51066,2979,24661,1938,48087,2153,1047,1106
8260,51097,2979,24677,1938,48118,2153,1047,1106
8265,51128,2979,24689,1938,48149,2153,1047,1106
8270,51159,2979,24703,1938,48180,2153,1047,1106
8275,51190,2979,24722,1938,48211,2153,1047,1106
8280,51221,2979,24738,1938,48242,2153,1047,1106
8285,51252,2983,24749,1940,48268,2153,1047,1106
8290,51283,2987,24767,1944,48294,2153,1047,1106
8295,51314,2991,24782,1947,48323,2153,1047,1106
8300,51345,2994,24799,1948,48351,2153,1047,1106
8305,51376,2996,24811,1948,48380,2153,1047,1106
8310,51407,2999,24824,1950,48408,2153,1047,1106
8315,51438,3001,24843,1950,48437,2153,1047,1106
8320,51469,3003,24855,1951,48466,2153,1047,1106
8325,51500,3005,24870,1951,48495,2153,1047,1106
8330,51531,3007,24880,1951,48524,2155,1047,1108
8335,51562,3010,24894,1952,48552,2157,1049,1108
8340,51593,3015,24909,1956,48578,2159,1049,1110
8345,51624,3016,24922,1957,48608,2162,1050,1112
8350,51655,3017,24936,1957,48638,2165,1051,1114
8355,51686,3019,24951,1959,48667,2168,1052,1116
8360,51717,3022,24963,1961,48695,2171,1053,1118
8365,51748,3025,24979,1964,48723,2174,1054,1120
8370,51779,3026,24996,1964,48753,2177,1057,1120
8375,51810,3028,25011,1966,48782,2180,1059,1121
8380,51841,3030,25031,1968,48811,2183,1061,1122
8385,51872,3030,25046,1968,48842,2186,1062,1124
8390,51903,3030,25057,1968,48873,2188,1062,1126
8395,51934,3030,25072,1968,48904,2189,1062,1127
8400,51965,3030,25088,1968,48935,2190,1062,1128
8405,51996,3033,25103,1970,48962,2192,1063,1129
8410,52027,3037,25118,1974,48989,2194,1064,1130
8415,52058,3041,25134,1977,49017,2196,1066,1130
8420,52089,3042,25152,1978,49047,2198,1068,1130
8425,52120,3043,25160,1979,49077,2200,1070,1130
8430,52151,3045,25173,1980,49106,2201,1071,1130
8435,52182,3047,25188,1981,49135,2202,1072,1130
8440,52213,3048,25200,1982,49165,2203,1073,1130
8445,52244,3049,25220,1982,49195,2204,1074,1130
8450,52275,3051,25235,1984,49224,2205,1075,1130
8455,52306,3051,25258,1984,49255,2206,1075,1131
8460,52337,3051,25269,1984,49286,2207,1076,1131
8465,52368,3055,25283,1985,49313,2208,1076,1132
8470,52399,3057,25298,1985,49341,2209,1076,1133
8475,52430,3060,25311,1987,49370,2210,1076,1134
8480,52461,3063,25324,1989,49398,2211,1076,1135
8485,52492,3067,25340,1991,49425,2212,1076,1136
8490,52523,3070,25351,1992,49453,2213,1076,1137
8495,52554,3073,25362,1994,49481,2215,1076,1139
8500,52585,3075,25375,1995,49510,2217,1076,1141
8505,52616,3078,25392,1997,49538,2219,1077,1142
8510,52647,3081,25403,1998,49566,2221,1079,1142
8515,52678,3083,25418,1999,49595,2223,1079,1144
8520,52709,3083,25428,1999,49626,2225,1080,1145
8525,52740,3083,25439,1999,49657,2226,1080,1146
8530,52771,3083,25458,1999,49688,2227,1080,1147
8535,52802,3083,25473,1999,49719,2229,1081,1148
8540,52833,3083,25488,1999,49750,2231,1082,1149
8545,52864,3083,25504,1999,49781,2233,1083,1150
8550,52895,3083,25522,1999,49812,2235,1083,1152
8555,52926,3083,25536,1999,49843,2237,1084,1153
8560,52957,3083,25549,1999,49874,2239,1085,1154
8565,52988,3083,25562,1999,49905,2241,1085,1156
8570,53019,3084,25579,1999,49935,2243,1086,1157
8575,53050,3086,25599,2000,49964,2245,1086,1159
8580,53081,3087,25613,2000,49994,2247,1087,1160
8585,53112,3091,25629,2002,50019,2249,1088,1161
8590,53143,3096,25640,2005,50045,2251,1089,1162
8595,53174,3099,25654,2007,50075,2253,1090,1163
8600,53205,3102,25666,2008,50103,2255,1090,1165
8605,53236,3105,25687,2011,50130,2257,1092,1165
8610,53267,3108,25701,2012,50159,2259,1093,1166
8615,53298,3110,25715,2014,50187,2261,1094,1167
8620,53329,3114,25732,2016,50215,2263,1095,1168
8625,53360,3117,25749,2019,50243,2265,1097,1168
8630,53391,3120,25762,2022,50271,2268,1099,1169
8635,53422,3122,25773,2023,50300,2271,1100,1171
8640,53453,3123,25786,2023,50330,2274,1101,1173
8645,53484,3123,25802,2023,50361,2275,1101,1174
8650,53515,3123,25821,2023,50392,2276,1101,1175
8655,53546,3123,25835,2023,50423,2277,1101,1176
8660,53577,3123,25853,2023,50454,2278,1102,1176
8665,53608,3123,25864,2023,50485,2279,1102,1177
8670,53639,3123,25876,2023,50516,2280,1102,1178
8675,53670,3123,25895,2023,50547,2281,1103,1178
8680,53701,3123,25913,2023,50578,2282,1103,1179
8685,53732,3123,25931,2023,50609,2283,1104,1179
8690,53763,3123,25951,2023,50640,2284,1105,1179
8695,53794,3124,25966,2023,50670,2285,1106,1179
8700,53825,3126,25982,2025,50699,2286,1107,1179
8705,53856,3128,25994,2025,50728,2287,1107,1180
8710,53887,3130,26011,2026,50757,2288,1108,1180
8715,53918,3132,26021,2026,50786,2289,1108,1181
8720,53949,3134,26034,2027,50815,2290,1108,1182
8725,53980,3136,26045,2028,50844,2291,1109,1182
8730,54011,3138,26058,2028,50873,2292,1109,1183
8735,54042,3141,26072,2030,50900,2293,1110,1183
8740,54073,3145,26087,2032,50928,2294,1110,1184
8745,54104,3148,26105,2034,50955,2296,1112,1184
8750,54135,3153,26119,2036,50982,2299,1114,1185
8755,54166,3158,26135,2040,51006,2302,1115,1187
8760,54197,3165,26149,2045,51030,2305,1115,1190
8765,54228,3169,26165,2049,51059,2307,1116,1191
8770,54259,3170,26177,2049,51087,2308,1116,1192
8775,54290,3173,26191,2051,51117,2309,1117,1192
8780,54321,3173,26203,2051,51148,2310,1117,1193
8785,54352,3173,26220,2051,51179,2310,1117,1193
8790,54383,3173,26231,2051,51210,2310,1117,1193
8795,54414,3173,26243,2051,51241,2310,1117,1193
8800,54445,3173,26257,2051,51272,2310,1117,1193
8805,54476,3173,26273,2051,51303,2310,1117,1193
8810,54507,3173,26287,2051,51334,2310,1117,1193
8815,54538,3173,26303,2051,51365,2310,1117,1193
8820,54569,3173,26314,2051,51396,2310,1117,1193
8825,54600,3173,26328,2051,51427,2310,1117,1193
8830,54631,3173,26341,2051,51458,2310,1117,1193
8835,54662,3173,26355,2051,51489,2310,1117,1193
8840,54693,3173,26373,2051,51520,2310,1117,1193
8845,54724,3173,26385,2051,51551,2310,1117,1193
8850,54755,3173,26399,2051,51582,2310,1117,1193
8855,54786,3173,26412,2051,51613,2310,1117,1193
8860,54817,3173,26422,2051,51644,2310,1117,1193
8865,54848,3173,26438,2051,51675,2310,1117,1193
8870,54879,3175,26457,2053,51704,2312,1119,1193
8875,54910,3177,26474,2053,51732,2314,1121,1193
8880,54941,3182,26483,2056,51758,2316,1121,1195
8885,54972,3187,26506,2059,51783,2318,1123,1195
8890,55003,3194,26523,2064,51807,2321,1124,1197
8895,55034,3202,26539,2069,51831,2324,1126,1198
8900,55065,3207,26554,2073,51858,2327,1127,1200
8905,55096,3213,26571,2077,51882,2330,1128,1202
8910,55127,3217,26586,2079,51909,2333,1130,1203
8915,55158,3224,26601,2083,51934,2336,1132,1204
8920,55189,3227,26610,2085,51961,2339,1134,1205
8925,55220,3231,26626,2089,51988,2342,1136,1206
8930,55251,3235,26636,2092,52016,2344,1136,1208
8935,55282,3236,26651,2092,52046,2345,1136,1209
8940,55313,3238,26670,2094,52075,2346,1137,1209
8945,55344,3238,26684,2094,52106,2347,1137,1210
8950,55375,3238,26695,2094,52137,2348,1137,1211
8955,55406,3238,26709,2094,52168,2349,1137,1212
8960,55437,3238,26725,2094,52199,2350,1138,1212
8965,55468,3238,26742,2094,52230,2351,1139,1212
8970,55499,3238,26758,2094,52261,2352,1140,1212
8975,55530,3238,26771,2094,52292,2353,1140,1213
8980,55561,3238,26787,2094,52323,2354,1141,1213
8985,55592,3238,26798,2094,52354,2355,1141,1214
8990,55623,3238,26817,2094,52385,2356,1141,1215
8995,55654,3238,26829,2094,52416,2357,1142,1215
9000,55685,3238,26840,2094,52447,2358,1143,1215
9005,55716,3239,26851,2095,52477,2359,1144,1215
9010,55747,3240,26863,2095,52507,2360,1145,1215
9015,55778,3241,26881,2096,52537,2361,1146,1215
9020,55809,3243,26895,2097,52566,2362,1147,1215
9025,55840,3244,26911,2097,52596,2363,1147,1216
9030,55871,3246,26924,2098,52625,2364,1147,1217
9035,55902,3248,26943,2100,52654,2366,1149,1217
9040,55933,3249,26951,2100,52684,2368,1149,1219
9045,55964,3252,26967,2102,52712,2370,1150,1220
9050,55995,3256,26980,2105,52739,2373,1151,1222
9055,56026,3261,26992,2107,52763,2376,1152,1224
9060,56057,3267,27002,2111,52788,2379,1153,1226
9065,56088,3271,27015,2114,52817,2381,1154,1227
9070,56119,3273,27031,2116,52846,2383,1155,1228
9075,56150,3274,27040,2117,52876,2385,1155,1230
9080,56181,3275,27054,2117,52906,2387,1156,1231
9085,56212,3276,27074,2118,52936,2389,1158,1231
9090,56243,3278,27087,2119,52965,2390,1158,1232
9095,56274,3279,27106,2119,52995,2391,1159,1232
9100,56305,3280,27116,2120,53025,2392,1159,1233
9105,56336,3282,27131,2122,53054,2393,1160,1233
9110,56367,3284,27145,2124,53083,2394,1161,1233
9115,56398,3286,27162,2126,53111,2395,1162,1233
9120,56429,3290,27179,2130,53139,2396,1162,1234
9125,56460,3292,27198,2131,53167,2397,1163,1234
9130,56491,3295,27213,2134,53196,2398,1163,1235
9135,56522,3296,27230,2134,53226,2399,1164,1235
9140,56553,3298,27245,2136,53255,2400,1165,1235
9145,56584,3299,27260,2137,53285,2401,1165,1236
9150,56615,3300,27277,2138,53315,2402,1165,1237
9155,56646,3301,27293,2138,53345,2403,1165,1238
9160,56677,3303,27312,2139,53374,2404,1166,1238
9165,56708,3306,27328,2142,53402,2405,1166,1239
9170,56739,3308,27339,2142,53431,2406,1167,1239
9175,56770,3311,27356,2143,53459,2407,1167,1240
9180,56801,3313,27372,2144,53488,2408,1167,1241
9185,56832,3315,27385,2145,53517,2411,1168,1243
9190,56863,3318,27401,2147,53545,2414,1170,1244
9195,56894,3320,27414,2148,53574,2417,1171,1246
9200,56925,3324,27428,2150,53601,2420,1173,1247
9205,56956,3326,27439,2152,53630,2423,1173,1250
9210,56987,3329,27452,2153,53658,2426,1175,1251
9215,57018,3331,27463,2153,53687,2428,1176,1252
9220,57049,3333,27476,2153,53716,2430,1177,1253
9225,57080,3336,27490,2155,53744,2431,1177,1254
9230,57111,3340,27505,2159,53771,2432,1177,1255
9235,57142,3343,27520,2162,53799,2433,1178,1255
9240,57173,3347,27532,2165,53826,2434,1178,1256
9245,57204,3347,27542,2165,53857,2435,1178,1257
9250,57235,3347,27557,2165,53888,2436,1178,1258
9255,57266,3347,27574,2165,53919,2437,1179,1258
9260,57297,3347,27591,2165,53950,2438,1180,1258
9265,57328,3347,27604,2165,53981,2439,1181,1258
9270,57359,3347,27618,2165,54012,2440,1182,1258
9275,57390,3347,27635,2165,54043,2441,1182,1259
9280,57421,3347,27649,2165,54074,2442,1183,1259
9285,57452,3347,27661,2165,54105,2443,1184,1259
9290,57483,3348,27683,2166,54135,2444,1184,1260
9295,57514,3349,27694,2166,54165,2445,1184,1261
9300,57545,3351,27702,2167,54194,2446,1184,1262
9305,57576,3356,27718,2171,54218,2447,1185,1262
9310,57607,3361,27733,2175,54246,2448,1185,1263
9315,57638,3363,27743,2177,54275,2450,1185,1265
9320,57669,3366,27753,2178,54303,2452,1186,1266
9325,57700,3370,27772,2181,54330,2454,1187,1267
9330,57731,3373,27787,2183,54358,2456,1187,1269
9335,57762,3377,27801,2186,54385,2458,1188,1270
9340,57793,3378,27815,2186,54415,2460,1188,1272
9345,57824,3380,27831,2188,54444,2461,1188,1273
9350,57855,3380,27844,2188,54475,2462,1188,1274
9355,57886,3380,27861,2188,54506,2463,1188,1275
9360,57917,3380,27876,2188,54537,2464,1188,1276
9365,57948,3380,27889,2188,54568,2465,1188,1277
9370,57979,3380,27900,2188,54599,2466,1188,1278
9375,58010,3380,27918,2188,54630,2467,1189,1278
9380,58041,3380,27938,2188,54661,2468,1190,1278
9385,58072,3380,27956,2188,54692,2469,1191,1278
9390,58103,3380,27969,2188,54723,2470,1191,1279
9395,58134,3380,27982,2188,54754,2471,1192,1279
9400,58165,3380,27996,2188,54785,2472,1192,1280
9405,58196,3380,28011,2188,54816,2473,1192,1281
9410,58227,3381,28028,2189,54845,2474,1192,1282
9415,58258,3384,28045,2192,54873,2475,1192,1283
9420,58289,3386,28065,2194,54901,2476,1192,1284
9425,58320,3390,28080,2197,54928,2477,1193,1284
9430,58351,3395,28099,2201,54956,2478,1194,1284
9435,58382,3398,28116,2202,54984,2479,1195,1284
9440,58413,3399,28128,2202,55014,2480,1195,1285
9445,58444,3400,28146,2203,55044,2482,1196,1286
9450,58475,3401,28158,2203,55074,2484,1198,1286
9455,58506,3404,28178,2205,55102,2486,1200,1286
9460,58537,3407,28194,2206,55130,2488,1201,1287
9465,58568,3410,28211,2207,55158,2490,1203,1287
9470,58599,3412,28222,2207,55187,2491,1203,1288
9475,58630,3414,28235,2208,55216,2492,1203,1289
9480,58661,3416,28251,2210,55245,2493,1203,1290
9485,58692,3418,28261,2210,55274,2495,1203,1292
9490,58723,3421,28276,2212,55302,2497,1203,1294
9495,58754,3425,28290,2215,55329,2499,1204,1295
9500,58785,3427,28301,2216,55358,2501,1205,1296
9505,58816,3430,28317,2217,55386,2503,1207,1296
9510,58847,3432,28331,2217,55415,2505,1207,1298
9515,58878,3435,28347,2219,55443,2507,1208,1299
9520,58909,3439,28364,2221,55470,2509,1209,1300
9525,58940,3441,28379,2222,55499,2511,1210,1301
9530,58971,3444,28392,2224,55527,2513,1210,1303
9535,59002,3445,28409,2224,55557,2515,1211,1304
9540,59033,3448,28422,2226,55585,2517,1213,1304
9545,59064,3451,28434,2229,55612,2518,1214,1304
9550,59095,3454,28454,2232,55638,2519,1215,1304
9555,59126,3458,28466,2236,55668,2520,1215,1305
9560,59157,3459,28483,2237,55698,2521,1215,1306
9565,59188,3461,28494,2238,55727,2522,1215,1307
9570,59219,3462,28506,2238,55757,2524,1216,1308
9575,59250,3463,28519,2238,55787,2526,1217,1309
9580,59281,3464,28532,2238,55817,2528,1218,1310
9585,59312,3465,28549,2239,55847,2530,1219,1311
9590,59343,3467,28564,2240,55876,2532,1221,1311
9595,59374,3469,28577,2241,55905,2534,1222,1312
9600,59405,3471,28590,2243,55934,2536,1222,1314
9605,59436,3471,28604,2243,55965,2537,1222,1315
9610,59467,3471,28619,2243,55996,2538,1223,1315
9615,59498,3471,28635,2243,56027,2539,1224,1315
9620,59529,3471,28652,2243,56058,2540,1225,1315
9625,59560,3471,28669,2243,56089,2541,1225,1316
9630,59591,3471,28689,2243,56120,2542,1226,1316
9635,59622,3471,28707,2243,56151,2543,1227,1316
9640,59653,3471,28722,2243,56182,2544,1228,1316
9645,59684,3471,28740,2243,56213,2545,1229,1316
9650,59715,3472,28754,2243,56243,2547,1230,1317
9655,59746,3475,28771,2245,56271,2549,1230,1319
9660,59777,3480,28785,2248,56296,2551,1231,1320
9665,59808,3482,28802,2249,56326,2553,1231,1322
9670,59839,3484,28816,2250,56355,2554,1231,1323
9675,59870,3485,28830,2251,56385,2555,1231,1324
9680,59901,3486,28837,2251,56415,2556,1232,1324
9685,59932,3487,28854,2251,56445,2557,1232,1325
9690,59963,3488,28863,2251,56475,2558,1232,1326
9695,59994,3489,28879,2251,56505,2559,1232,1327
9700,60025,3490,28893,2251,56535,2560,1233,1327
9705,60056,3491,28913,2252,56565,2562,1235,1327
9710,60087,3492,28927,2253,56595,2564,1236,1328
9715,60118,3493,28944,2253,56625,2566,1238,1328
9720,60149,3494,28957,2253,56655,2568,1239,1329
9725,60180,3495,28971,2254,56685,2569,1239,1330
9730,60211,3496,28987,2254,56715,2570,1240,1330
9735,60242,3497,29003,2254,56745,2571,1241,1330
9740,60273,3498,29014,2255,56775,2572,1241,1331
9745,60304,3499,29031,2255,56805,2573,1241,1332
9750,60335,3500,29047,2255,56835,2574,1242,1332
9755,60366,3501,29064,2255,56865,2575,1242,1333
9760,60397,3502,29078,2256,56895,2576,1242,1334
9765,60428,3504,29095,2258,56924,2577,1242,1335
9770,60459,3509,29112,2261,56950,2579,1244,1335
9775,60490,3513,29124,2264,56975,2581,1245,1336
9780,60521,3522,29142,2272,56997,2583,1247,1336
9785,60552,3524,29159,2274,57028,2584,1248,1336
9790,60583,3524,29172,2274,57059,2584,1248,1336
9795,60614,3524,29184,2274,57090,2584,1248,1336
9800,60645,3524,29199,2274,57121,2584,1248,1336
9805,60676,3524,29218,2274,57152,2584,1248,1336
9810,60707,3524,29234,2274,57183,2584,1248,1336
9815,60738,3524,29253,2274,57214,2584,1248,1336
9820,60769,3524,29270,2274,57245,2584,1248,1336
9825,60800,3524,29286,2274,57276,2584,1248,1336
9830,60831,3524,29305,2274,57307,2584,1248,1336
9835,60862,3524,29319,2274,57338,2584,1248,1336
9840,60893,3524,29331,2274,57369,2584,1248,1336
9845,60924,3524,29346,2274,57400,2584,1248,1336
9850,60955,3524,29357,2274,57431,2584,1248,1336
9855,60986,3524,29372,2274,57462,2584,1248,1336
9860,61017,3524,29387,2274,57493,2584,1248,1336
9865,61048,3524,29401,2274,57524,2584,1248,1336
9870,61079,3524,29412,2274,57555,2584,1248,1336
9875,61110,3524,29427,2274,57586,2584,1248,1336
9880,61141,3524,29437,2274,57617,2584,1248,1336
9885,61172,3525,29452,2275,57647,2584,1248,1336
9890,61203,3532,29466,2280,57670,2587,1249,1338
9895,61234,3538,29480,2284,57694,2590,1250,1340
9900,61265,3544,29494,2289,57719,2593,1251,1342
9905,61296,3547,29509,2291,57749,2594,1251,1343
9910,61327,3548,29527,2292,57779,2595,1251,1344
9915,61358,3549,29544,2293,57809,2596,1252,1344
9920,61389,3550,29555,2294,57839,2597,1253,1344
9925,61420,3552,29573,2296,57868,2598,1254,1344
9930,61451,3553,29586,2297,57898,2599,1254,1345
9935,61482,3555,29602,2299,57927,2600,1254,1346
9940,61513,3556,29618,2299,57957,2601,1255,1346
9945,61544,3558,29632,2300,57986,2602,1256,1346
9950,61575,3560,29651,2302,58015,2603,1256,1347
9955,61606,3561,29667,2302,58045,2604,1257,1347
9960,61637,3562,29681,2303,58075,2605,1258,1347
9965,61668,3564,29694,2304,58104,2606,1258,1348
9970,61699,3567,29709,2306,58132,2607,1258,1349
9975,61730,3570,29724,2308,58160,2608,1258,1350
9980,61761,3572,29737,2309,58189,2609,1259,1350
9985,61792,3575,29754,2311,58217,2610,1259,1351
9990,61823,3577,29769,2313,58246,2611,1260,1351
9995,61854,3579,29780,2314,58275,2612,1260,1352
10000,61885,3581,29792,2316,58304,2613,1260,1353
10005,61916,3584,29806,2317,58332,2614,1260,1354
10010,61947,3589,29821,2321,58355,2617,1261,1356
10015,61978,3598,29842,2329,58377,2620,1263,1357
10020,62009,3603,29854,2333,58405,2623,1265,1358
10025,62040,3603,29867,2333,58437,2624,1265,1359
10030,62071,3603,29887,2333,58468,2625,1265,1360
10035,62102,3603,29903,2333,58499,2626,1266,1360
10040,62133,3603,29920,2333,58530,2627,1266,1361
10045,62164,3603,29935,2333,58561,2628,1266,1362
10050,62195,3603,29948,2333,58592,2629,1266,1363
10055,62226,3603,29964,2333,58623,2630,1267,1363
10060,62257,3603,29974,2333,58654,2631,1267,1364
10065,62288,3603,29988,2333,58685,2632,1267,1365
10070,62319,3603,30003,2333,58716,2633,1267,1366
10075,62350,3603,30014,2333,58747,2634,1267,1367
10080,62381,3603,30029,2333,58778,2635,1268,1367
10085,62412,3603,30044,2333,58809,2636,1268,1368
10090,62443,3603,30057,2333,58840,2637,1268,1369
10095,62474,3603,30069,2333,58871,2638,1268,1370
10100,62505,3603,30087,2333,58902,2639,1268,1371
10105,62536,3603,30102,2333,58933,2640,1269,1371
10110,62567,3603,30121,2333,58964,2641,1269,1372
10115,62598,3603,30134,2333,58995,2642,1269,1373
10120,62629,3603,30144,2333,59026,2643,1269,1374
10125,62660,3603,30160,2333,59057,2644,1270,1374
10130,62691,3607,30172,2335,59084,2646,1270,1376
10135,62722,3611,30191,2338,59111,2649,1273,1376
10140,62753,3616,30208,2342,59137,2652,1274,1378
10145,62784,3621,30219,2345,59162,2653,1274,1379
10150,62815,3627,30232,2348,59188,2654,1274,1380
10155,62846,3631,30246,2352,59214,2655,1274,1381
10160,62877,3633,30261,2354,59243,2656,1275,1381
10165,62908,3635,30271,2356,59273,2657,1275,1382
10170,62939,3636,30284,2357,59303,2658,1276,1382
10175,62970,3637,30296,2358,59333,2659,1277,1382
10180,63001,3638,30315,2359,59363,2660,1278,1382
10185,63032,3639,30326,2360,59392,2661,1279,1382
10190,63063,3641,30342,2361,59422,2662,1280,1382
10195,63094,3642,30357,2361,59451,2663,1281,1382
10200,63125,3644,30374,2363,59480,2664,1281,1383
10205,63156,3646,30391,2364,59510,2665,1282,1383
10210,63187,3647,30409,2365,59540,2666,1283,1383
10215,63218,3648,30420,2365,59570,2667,1283,1384
10220,63249,3649,30432,2365,59600,2668,1283,1385
10225,63280,3650,30446,2366,59630,2669,1284,1385
10230,63311,3651,30458,2366,59660,2670,1285,1385
10235,63342,3652,30473,2367,59690,2671,1286,1385
10240,63373,3653,30485,2367,59720,2672,1287,1385
10245,63404,3654,30503,2368,59750,2673,1287,1386
10250,63435,3655,30518,2369,59780,2675,1288,1387
10255,63466,3656,30535,2370,59810,2678,1289,1389
10260,63497,3658,30550,2371,59837,2681,1291,1390
10265,63528,3662,30566,2374,59866,2683,1292,1391
10270,63559,3665,30580,2375,59894,2685,1293,1392
10275,63590,3668,30594,2376,59922,2686,1293,1393
10280,63621,3670,30610,2376,59951,2687,1293,1394
10285,63652,3672,30622,2378,59980,2688,1294,1394
10290,63683,3674,30636,2378,60009,2689,1294,1395
10295,63714,3676,30648,2379,60038,2690,1294,1396
10300,63745,3679,30665,2381,60066,2691,1295,1396
10305,63776,3682,30683,2383,60094,2692,1296,1396
10310,63807,3685,30696,2385,60122,2693,1297,1396
10315,63838,3687,30714,2386,60151,2694,1298,1396
10320,63869,3689,30727,2387,60180,2695,1299,1396
10325,63900,3690,30743,2387,60210,2696,1300,1396
10330,63931,3691,30758,2387,60240,2697,1300,1397
10335,63962,3692,30775,2388,60270,2698,1300,1398
10340,63993,3693,30790,2389,60300,2699,1300,1399
10345,64024,3694,30807,2390,60330,2700,1301,1399
10350,64055,3695,30822,2391,60360,2701,1301,1400
10355,64086,3696,30840,2391,60390,2702,1301,1401
10360,64117,3697,30854,2392,60420,2703,1302,1401
10365,64148,3700,30874,2394,60447,2704,1303,1401
10370,64179,3702,30889,2395,60476,2706,1304,1402
10375,64210,3706,30905,2398,60502,2709,1305,1404
10380,64241,3710,30919,2401,60531,2712,1305,1407
10385,64272,3711,30930,2401,60561,2714,1306,1408
10390,64303,3712,30948,2402,60591,2716,1307,1409
10395,64334,3713,30961,2403,60621,2717,1307,1410
10400,64365,3714,30977,2403,60651,2718,1307,1411
10405,64396,3716,30991,2404,60680,2718,1307,1411
10410,64427,3718,31009,2405,60709,2718,1307,1411
10415,64458,3719,31027,2406,60739,2718,1307,1411
10420,64489,3720,31042,2407,60769,2718,1307,1411
10425,64520,3721,31056,2407,60799,2718,1307,1411
10430,64551,3722,31075,2407,60829,2718,1307,1411
10435,64582,3725,31093,2410,60857,2718,1307,1411
10440,64613,3726,31105,2411,60887,2718,1307,1411
10445,64644,3727,31117,2411,60917,2719,1307,1412
10450,64675,3729,31135,2412,60946,2720,1308,1412
10455,64706,3730,31153,2413,60976,2721,1308,1413
10460,64737,3732,31174,2414,61005,2722,1308,1414
10465,64768,3735,31189,2417,61033,2723,1309,1414
10470,64799,3737,31201,2419,61062,2724,1309,1415
10475,64830,3739,31221,2421,61091,2725,1310,1415
10480,64861,3740,31236,2421,61121,2726,1311,1415
10485,64892,3742,31249,2423,61150,2727,1312,1415
10490,64923,3746,31270,2426,61177,2728,1313,1415
10495,64954,3750,31283,2429,61204,2730,1314,1416
10500,64985,3751,31298,2429,61234,2732,1315,1417
10505,65016,3753,31313,2431,61263,2733,1316,1417
10510,65047,3754,31326,2432,61293,2734,1316,1418
10515,65078,3755,31338,2433,61323,2735,1316,1419
10520,65109,3756,31350,2433,61353,2736,1316,1420
10525,65140,3757,31364,2433,61383,2737,1317,1420
10530,65171,3758,31379,2433,61413,2738,1317,1421
10535,65202,3759,31393,2434,61443,2739,1317,1422
10540,65233,3760,31410,2434,61473,2740,1318,1422
10545,65264,3761,31423,2434,61503,2741,1319,1422
10550,65295,3762,31442,2435,61533,2742,1319,1423
10555,65326,3763,31460,2435,61563,2743,1320,1423
10560,65357,3764,31469,2436,61593,2744,1320,1424
10565,65388,3765,31486,2436,61623,2745,1320,1425
10570,65419,3766,31504,2437,61653,2746,1320,1426
10575,65450,3767,31523,2437,61683,2747,1320,1427
10580,65481,3768,31537,2438,61713,2748,1320,1428
10585,65512,3769,31548,2439,61743,2749,1320,1429
10590,65543,3770,31563,2440,61773,2751,1322,1429
10595,65574,3771,31581,2441,61803,2753,1323,1430
10600,65605,3772,31597,2442,61833,2755,1323,1432
10605,65636,3775,31614,2445,61860,2757,1325,1432
10610,65667,3781,31629,2451,61885,2760,1326,1434
10615,65698,3787,31648,2457,61909,2763,1329,1434
10620,65729,3792,31662,2460,61937,2766,1330,1436
10625,65760,3795,31674,2461,61965,2768,1330,1438
10630,65791,3797,31688,2462,61994,2770,1332,1438
10635,65822,3799,31706,2463,62023,2771,1333,1438
10640,65853,3800,31718,2463,62053,2772,1334,1438
10645,65884,3801,31740,2464,62083,2773,1335,1438
10650,65915,3802,31753,2465,62113,2774,1336,1438
10655,65946,3803,31761,2465,62143,2775,1336,1439
10660,65977,3805,31781,2467,62172,2776,1337,1439
10665,66008,3806,31795,2467,62202,2777,1338,1439
10670,66039,3808,31811,2469,62231,2778,1339,1439
10675,66070,3809,31825,2469,62261,2779,1340,1439
10680,66101,3811,31840,2471,62290,2780,1340,1440
10685,66132,3813,31855,2473,62319,2781,1341,1440
10690,66163,3815,31870,2474,62348,2782,1342,1440
10695,66194,3816,31879,2474,62378,2783,1343,1440
10700,66225,3817,31892,2474,62408,2784,1343,1441
10705,66256,3819,31908,2475,62437,2785,1344,1441
10710,66287,3820,31926,2475,62467,2786,1344,1442
10715,66318,3821,31942,2476,62497,2787,1345,1442
10720,66349,3822,31955,2477,62527,2788,1345,1443
10725,66380,3823,31967,2477,62557,2789,1345,1444
10730,66411,3825,31980,2477,62586,2791,1346,1445
10735,66442,3828,31995,2478,62614,2793,1346,1447
10740,66473,3831,32010,2479,62642,2794,1347,1447
10745,66504,3834,32025,2480,62669,2795,1348,1447
10750,66535,3839,32040,2484,62695,2796,1349,1447
10755,66566,3844,32050,2488,62722,2798,1350,1448
10760,66597,3848,32066,2492,62748,2800,1351,1449
10765,66628,3853,32081,2496,62775,2802,1351,1451
10770,66659,3856,32098,2499,62802,2804,1353,1451
10775,66690,3860,32114,2502,62829,2806,1353,1453
10780,66721,3862,32131,2503,62859,2808,1354,1454
10785,66752,3863,32146,2504,62888,2810,1355,1455
10790,66783,3865,32158,2506,62918,2812,1356,1456
10795,66814,3865,32173,2506,62949,2814,1356,1458
10800,66845,3865,32191,2506,62980,2815,1356,1459
10805,66876,3865,32207,2506,63011,2816,1356,1460
10810,66907,3865,32221,2506,63042,2817,1357,1460
10815,66938,3865,32236,2506,63073,2818,1358,1460
10820,66969,3865,32248,2506,63104,2819,1358,1461
10825,67000,3865,32267,2506,63135,2820,1359,1461
10830,67031,3865,32283,2506,63166,2821,1359,1462
10835,67062,3867,32302,2508,63195,2822,1360,1462
10840,67093,3870,32318,2510,63223,2824,1361,1463
10845,67124,3871,32330,2511,63253,2826,1363,1463
10850,67155,3872,32347,2511,63283,2828,1364,1464
10855,67186,3873,32367,2512,63313,2830,1365,1465
10860,67217,3875,32379,2514,63342,2832,1366,1466
10865,67248,3878,32394,2516,63370,2834,1367,1467
10870,67279,3880,32407,2516,63399,2836,1369,1467
10875,67310,3882,32424,2517,63428,2838,1371,1467
10880,67341,3886,32440,2519,63455,2840,1371,1469
10885,67372,3889,32454,2522,63483,2842,1372,1470
10890,67403,3893,32467,2525,63510,2844,1373,1471
10895,67434,3897,32482,2528,63536,2845,1373,1472
10900,67465,3903,32495,2532,63562,2846,1374,1472
10905,67496,3905,32512,2533,63590,2847,1375,1472
10910,67527,3908,32525,2535,63618,2848,1375,1473
10915,67558,3913,32539,2540,63644,2850,1376,1474
10920,67589,3918,32559,2544,63671,2852,1377,1475
10925,67620,3919,32579,2545,63701,2853,1377,1476
10930,67651,3920,32593,2545,63731,2854,1378,1476
10935,67682,3921,32608,2546,63760,2855,1379,1476
10940,67713,3923,32617,2547,63790,2856,1380,1476
10945,67744,3924,32634,2547,63820,2857,1381,1476
10950,67775,3925,32646,2547,63849,2858,1382,1476
10955,67806,3927,32661,2548,63879,2859,1382,1477
10960,67837,3928,32672,2548,63909,2860,1383,1477
10965,67868,3930,32686,2550,63938,2861,1384,1477
10970,67899,3932,32702,2551,63966,2862,1385,1477
10975,67930,3934,32720,2553,63996,2863,1385,1478
10980,67961,3934,32731,2553,64027,2864,1386,1478
10985,67992,3934,32747,2553,64058,2864,1386,1478
10990,68023,3934,32766,2553,64089,2864,1386,1478
10995,68054,3934,32778,2553,64120,2864,1386,1478
11000,68085,3934,32793,2553,64151,2864,1386,1478
11005,68116,3934,32805,2553,64182,2864,1386,1478
11010,68147,3935,32818,2553,64212,2864,1386,1478
11015,68178,3936,32836,2553,64242,2864,1386,1478
11020,68209,3938,32846,2554,64271,2864,1386,1478
11025,68240,3939,32862,2555,64301,2864,1386,1478
11030,68271,3942,32879,2558,64329,2865,1387,1478
11035,68302,3945,32889,2560,64354,2866,1387,1479
11040,68333,3953,32905,2567,64379,2868,1387,1481
11045,68364,3958,32917,2570,64406,2870,1388,1482
11050,68395,3960,32930,2571,64435,2872,1389,1483
11055,68426,3963,32942,2572,64463,2874,1391,1483
11060,68457,3967,32963,2576,64490,2876,1392,1484
11065,68488,3970,32981,2579,64518,2878,1393,1485
11070,68519,3972,32995,2580,64547,2880,1394,1486
11075,68550,3974,33007,2581,64576,2882,1395,1487
11080,68581,3976,33021,2581,64605,2884,1396,1488
11085,68612,3979,33032,2584,64633,2886,1397,1489
11090,68643,3982,33048,2586,64661,2888,1398,1490
11095,68674,3985,33064,2588,64689,2890,1400,1490
11100,68705,3989,33079,2590,64716,2892,1401,1491
11105,68736,3989,33099,2590,64747,2893,1402,1491
11110,68767,3989,33113,2590,64778,2894,1402,1492
11115,68798,3989,33124,2590,64809,2895,1403,1492
11120,68829,3989,33140,2590,64840,2896,1404,1492
11125,68860,3989,33155,2590,64871,2897,1405,1492
11130,68891,3989,33167,2590,64902,2898,1405,1493
11135,68922,3989,33182,2590,64933,2899,1405,1494
11140,68953,3989,33195,2590,64964,2900,1406,1494
11145,68984,3989,33204,2590,64995,2901,1406,1495
11150,69015,3991,33219,2592,65024,2903,1406,1497
11155,69046,3992,33229,2593,65054,2905,1406,1499
11160,69077,3994,33242,2594,65083,2907,1408,1499
11165,69108,3998,33253,2597,65110,2909,1409,1500
11170,69139,4001,33267,2600,65138,2911,1410,1501
11175,69170,4007,33287,2606,65163,2913,1411,1502
11180,69201,4011,33299,2608,65190,2915,1412,1503
11185,69232,4017,33317,2612,65215,2917,1413,1504
11190,69263,4021,33330,2615,65242,2919,1414,1505
11195,69294,4023,33342,2617,65271,2920,1414,1506
11200,69325,4026,33355,2620,65299,2921,1414,1507
11205,69356,4028,33373,2620,65328,2922,1414,1508
11210,69387,4030,33385,2621,65356,2923,1415,1508
11215,69418,4033,33401,2624,65384,2924,1416,1508
11220,69449,4035,33414,2625,65414,2925,1416,1509
11225,69480,4035,33424,2625,65445,2926,1416,1510
11230,69511,4035,33443,2625,65476,2927,1416,1511
11235,69542,4035,33456,2625,65507,2928,1417,1511
11240,69573,4035,33471,2625,65538,2929,1417,1512
11245,69604,4035,33483,2625,65569,2930,1417,1513
11250,69635,4035,33494,2625,65600,2931,1417,1514
11255,69666,4035,33509,2625,65631,2932,1418,1514
11260,69697,4035,33525,2625,65662,2933,1418,1515
11265,69728,4035,33541,2625,65693,2935,1419,1516
11270,69759,4035,33556,2625,65724,2937,1420,1517
11275,69790,4035,33571,2625,65755,2939,1421,1518
11280,69821,4035,33585,2625,65786,2941,1421,1520
11285,69852,4037,33599,2627,65815,2943,1421,1522
11290,69883,4040,33613,2629,65843,2944,1421,1523
11295,69914,4043,33632,2631,65870,2945,1422,1523
11300,69945,4047,33646,2634,65897,2946,1422,1524
11305,69976,4051,33664,2637,65924,2947,1422,1525
11310,70007,4055,33683,2641,65952,2948,1423,1525
11315,70038,4057,33694,2641,65980,2949,1423,1526
11320,70069,4061,33713,2644,66007,2950,1424,1526
11325,70100,4065,33728,2647,66034,2951,1424,1527
11330,70131,4068,33742,2649,66061,2953,1425,1528
11335,70162,4075,33757,2655,66085,2955,1426,1529
11340,70193,4080,33773,2660,66112,2957,1426,1531
11345,70224,4081,33785,2661,66143,2958,1426,1532
11350,70255,4081,33802,2661,66174,2959,1427,1532
11355,70286,4081,33811,2661,66205,2960,1427,1533
11360,70317,4081,33823,2661,66236,2961,1427,1534
11365,70348,4081,33836,2661,66267,2962,1427,1535
11370,70379,4081,33853,2661,66298,2963,1428,1535
11375,70410,4081,33866,2661,66329,2964,1429,1535
11380,70441,4081,33881,2661,66360,2965,1430,1535
11385,70472,4081,33894,2661,66391,2966,1430,1536
11390,70503,4081,33910,2661,66422,2968,1430,1538
11395,70534,4081,33922,2661,66453,2970,1431,1539
11400,70565,4081,33942,2661,66484,2971,1432,1539
11405,70596,4081,33957,2661,66515,2972,1432,1540
11410,70627,4081,33973,2661,66546,2973,1432,1541
11415,70658,4081,33983,2661,66577,2974,1432,1542
11420,70689,4081,33996,2661,66608,2975,1432,1543
11425,70720,4081,34008,2661,66639,2976,1432,1544
11430,70751,4081,34021,2661,66670,2977,1433,1544
11435,70782,4081,34036,2661,66701,2978,1434,1544
11440,70813,4081,34051,2661,66732,2979,1435,1544
11445,70844,4082,34068,2662,66762,2980,1435,1545
11450,70875,4087,34087,2665,66787,2982,1436,1546
11455,70906,4093,34104,2669,66811,2984,1438,1546
11460,70937,4098,34117,2672,66836,2986,1438,1548
11465,70968,4104,34133,2677,66864,2987,1438,1549
11470,70999,4108,34149,2681,66891,2988,1439,1549
11475,71030,4110,34162,2682,66920,2988,1439,1549
11480,71061,4111,34178,2682,66950,2988,1439,1549
11485,71092,4112,34190,2682,66980,2988,1439,1549
11490,71123,4113,34204,2682,67010,2988,1439,1549
11495,71154,4114,34224,2683,67040,2988,1439,1549
11500,71185,4115,34239,2683,67070,2988,1439,1549
11505,71216,4116,34258,2684,67100,2988,1439,1549
11510,71247,4117,34267,2684,67130,2988,1439,1549
11515,71278,4118,34288,2685,67160,2988,1439,1549
11520,71309,4119,34304,2685,67190,2988,1439,1549
11525,71340,4120,34319,2685,67220,2988,1439,1549
11530,71371,4121,34335,2685,67250,2988,1439,1549
11535,71402,4122,34349,2686,67280,2988,1439,1549
11540,71433,4123,34358,2686,67310,2988,1439,1549
11545,71464,4124,34374,2686,67340,2988,1439,1549
11550,71495,4125,34387,2687,67370,2988,1439,1549
11555,71526,4126,34404,2687,67400,2988,1439,1549
11560,71557,4127,34418,2687,67430,2988,1439,1549
11565,71588,4128,34433,2687,67459,2988,1439,1549
11570,71619,4132,34452,2690,67486,2989,1440,1549
11575,71650,4136,34463,2693,67514,2990,1441,1549
11580,71681,4140,34479,2695,67539,2991,1442,1549
11585,71712,4144,34491,2697,67568,2992,1443,1549
11590,71743,4147,34504,2700,67596,2993,1444,1549
11595,71774,4150,34516,2702,67624,2994,1444,1550
11600,71805,4154,34530,2704,67651,2996,1445,1551
11605,71836,4156,34542,2705,67680,2998,1446,1552
11610,71867,4159,34559,2708,67708,3000,1446,1554
11615,71898,4162,34575,2711,67736,3002,1447,1555
11620,71929,4165,34591,2713,67764,3003,1447,1556
11625,71960,4167,34604,2714,67793,3004,1447,1557
11630,71991,4169,34621,2714,67822,3005,1448,1557
11635,72022,4172,34632,2716,67850,3006,1448,1558
11640,72053,4174,34644,2716,67879,3007,1448,1559
11645,72084,4176,34659,2718,67908,3008,1449,1559
11650,72115,4176,34672,2718,67939,3009,1450,1559
11655,72146,4176,34687,2718,67970,3010,1451,1559
11660,72177,4176,34702,2718,68001,3011,1452,1559
11665,72208,4176,34720,2718,68032,3012,1452,1560
11670,72239,4176,34733,2718,68063,3013,1452,1561
11675,72270,4176,34749,2718,68094,3014,1453,1561
11680,72301,4176,34766,2718,68125,3015,1454,1561
11685,72332,4176,34785,2718,68156,3016,1455,1561
11690,72363,4176,34796,2718,68187,3017,1455,1562
11695,72394,4176,34815,2718,68218,3018,1456,1562
11700,72425,4176,34832,2718,68249,3019,1457,1562
11705,72456,4179,34843,2720,68277,3021,1458,1563
11710,72487,4183,34865,2724,68304,3022,1459,1563
11715,72518,4187,34880,2727,68331,3023,1460,1563
11720,72549,4190,34898,2730,68359,3024,1460,1564
11725,72580,4193,34911,2731,68387,3026,1461,1565
11730,72611,4197,34926,2732,68414,3028,1462,1566
11735,72642,4201,34939,2735,68441,3030,1462,1568
11740,72673,4205,34955,2738,68468,3032,1462,1570
11745,72704,4208,34971,2739,68496,3034,1463,1571
11750,72735,4210,34992,2741,68525,3036,1464,1572
11755,72766,4213,35008,2743,68553,3038,1465,1573
11760,72797,4215,35029,2744,68582,3039,1466,1573
11765,72828,4215,35044,2744,68613,3041,1466,1575
11770,72859,4215,35061,2744,68644,3042,1466,1576
11775,72890,4215,35073,2744,68675,3043,1466,1577
11780,72921,4215,35092,2744,68706,3044,1466,1578
11785,72952,4215,35103,2744,68737,3045,1467,1578
11790,72983,4215,35118,2744,68768,3046,1468,1578
11795,73014,4215,35130,2744,68799,3047,1468,1579
11800,73045,4215,35146,2744,68830,3048,1468,1580
11805,73076,4215,35164,2744,68861,3049,1469,1580
11810,73107,4215,35176,2744,68892,3050,1469,1581
11815,73138,4215,35191,2744,68923,3052,1470,1582
11820,73169,4215,35207,2744,68954,3054,1471,1583
11825,73200,4217,35221,2745,68983,3055,1472,1583
11830,73231,4217,35235,2745,69014,3056,1472,1584
11835,73262,4217,35249,2745,69045,3057,1472,1585
11840,73293,4217,35265,2745,69076,3058,1472,1586
11845,73324,4217,35280,2745,69107,3059,1473,1586
11850,73355,4217,35296,2745,69138,3060,1474,1586
11855,73386,4217,35312,2745,69169,3061,1474,1587
11860,73417,4217,35324,2745,69200,3062,1474,1588
11865,73448,4217,35340,2745,69231,3063,1475,1588
11870,73479,4218,35354,2745,69261,3065,1476,1589
11875,73510,4219,35373,2745,69291,3067,1478,1589
11880,73541,4220,35390,2746,69321,3069,1480,1589
11885,73572,4222,35407,2748,69350,3072,1482,1590
11890,73603,4224,35425,2750,69379,3073,1482,1591
11895,73634,4226,35441,2752,69408,3074,1483,1591
11900,73665,4227,35460,2753,69438,3075,1483,1592
11905,73696,4229,35473,2755,69467,3076,1484,1592
11910,73727,4230,35484,2755,69497,3077,1484,1593
11915,73758,4231,35499,2756,69527,3078,1485,1593
11920,73789,4232,35511,2756,69557,3079,1486,1593
11925,73820,4236,35528,2758,69583,3080,1487,1593
11930,73851,4241,35543,2762,69609,3082,1489,1593
11935,73882,4245,35557,2765,69635,3084,1490,1594
11940,73913,4253,35571,2773,69660,3086,1490,1596
11945,73944,4254,35586,2773,69690,3087,1490,1597
11950,73975,4255,35598,2773,69720,3088,1491,1597
11955,74006,4256,35615,2773,69750,3088,1491,1597
11960,74037,4257,35632,2774,69780,3088,1491,1597
11965,74068,4258,35647,2774,69810,3088,1491,1597
11970,74099,4259,35664,2774,69840,3088,1491,1597
11975,74130,4260,35675,2774,69870,3088,1491,1597
11980,74161,4261,35687,2774,69900,3088,1491,1597
11985,74192,4262,35705,2775,69930,3088,1491,1597
11990,74223,4263,35716,2776,69960,3089,1491,1598
11995,74254,4264,35729,2776,69990,3090,1492,1598
12000,74285,4265,35742,2776,70020,3091,1492,1599
12005,74316,4268,35753,2778,70048,3092,1492,1600
12010,74347,4270,35767,2778,70077,3093,1492,1601
12015,74378,4273,35786,2781,70105,3094,1492,1602
12020,74409,4276,35803,2784,70133,3095,1492,1603
12025,74440,4277,35818,2784,70163,3096,1492,1604
12030,74471,4278,35836,2785,70193,3097,1492,1605
12035,74502,4280,35854,2786,70222,3098,1493,1605
12040,74533,4281,35870,2786,70252,3099,1494,1605
12045,74564,4283,35885,2787,70280,3101,1495,1606
12050,74595,4286,35896,2788,70309,3103,1497,1606
12055,74626,4290,35911,2790,70333,3105,1498,1607
12060,74657,4296,35924,2794,70359,3107,1499,1608
12065,74688,4299,35941,2797,70389,3108,1500,1608
12070,74719,4299,35960,2797,70420,3109,1501,1608
12075,74750,4299,35975,2797,70451,3110,1502,1608
12080,74781,4299,35991,2797,70482,3111,1502,1609
12085,74812,4299,36005,2797,70513,3112,1503,1609
12090,74843,4299,36020,2797,70544,3113,1504,1609
12095,74874,4299,36034,2797,70575,3114,1504,1610
12100,74905,4299,36043,2797,70606,3115,1505,1610
12105,74936,4299,36062,2797,70637,3116,1506,1610
12110,74967,4299,36077,2797,70668,3117,1506,1611
12115,74998,4299,36091,2797,70699,3118,1507,1611
12120,75029,4299,36109,2797,70730,3119,1507,1612
12125,75060,4299,36126,2797,70761,3121,1507,1614
12130,75091,4299,36139,2797,70792,3123,1507,1616
12135,75122,4299,36154,2797,70823,3125,1508,1617
12140,75153,4299,36169,2797,70854,3127,1508,1619
12145,75184,4299,36184,2797,70885,3129,1509,1620
12150,75215,4299,36201,2797,70916,3131,1510,1621
12155,75246,4299,36214,2797,70947,3133,1510,1623
12160,75277,4299,36229,2797,70978,3135,1511,1624
12165,75308,4300,36250,2798,71008,3138,1514,1624
12170,75339,4303,36268,2800,71035,3140,1516,1624
12175,75370,4309,36285,2805,71059,3142,1518,1624
12180,75401,4316,36301,2810,71083,3144,1518,1626
12185,75432,4320,36313,2813,71112,3145,1519,1626
12190,75463,4323,36328,2814,71140,3146,1520,1626
12195,75494,4325,36341,2816,71169,3147,1520,1627
12200,75525,4329,36354,2820,71196,3148,1520,1628
12205,75556,4332,36371,2822,71224,3149,1520,1629
12210,75587,4336,36389,2824,71251,3150,1521,1629
12215,75618,4340,36400,2826,71278,3151,1522,1629
12220,75649,4340,36416,2826,71309,3152,1522,1630
12225,75680,4340,36431,2826,71340,3153,1523,1630
12230,75711,4340,36442,2826,71371,3154,1523,1631
12235,75742,4340,36459,2826,71402,3155,1524,1631
12240,75773,4340,36473,2826,71433,3156,1524,1632
12245,75804,4345,36491,2830,71459,3157,1524,1633
12250,75835,4349,36507,2834,71486,3158,1525,1633
12255,75866,4351,36519,2835,71515,3159,1526,1633
12260,75897,4352,36531,2835,71545,3160,1527,1633
12265,75928,4353,36544,2836,71575,3161,1527,1634
12270,75959,4354,36556,2837,71605,3164,1527,1637
12275,75990,4355,36571,2837,71635,3167,1529,1638
12280,76021,4356,36585,2837,71665,3170,1531,1639
12285,76052,4357,36593,2837,71695,3174,1532,1642
12290,76083,4358,36606,2838,71725,3178,1533,1645
12295,76114,4359,36619,2838,71755,3182,1536,1646
12300,76145,4360,36635,2838,71785,3186,1538,1648
12305,76176,4363,36651,2841,71812,3190,1541,1649
12310,76207,4366,36668,2844,71840,3193,1542,1651
12315,76238,4370,36682,2846,71867,3195,1543,1652
12320,76269,4374,36700,2850,71894,3197,1543,1654
12325,76300,4376,36712,2852,71924,3199,1544,1655
12330,76331,4377,36723,2852,71954,3200,1544,1656
12335,76362,4379,36739,2854,71983,3201,1545,1656
12340,76393,4381,36757,2856,72012,3202,1546,1656
12345,76424,4381,36765,2856,72043,3203,1546,1657
12350,76455,4381,36779,2856,72074,3204,1546,1658
12355,76486,4381,36795,2856,72105,3205,1546,1659
12360,76517,4381,36812,2856,72136,3206,1546,1660
12365,76548,4383,36828,2857,72165,3208,1548,1660
12370,76579,4384,36844,2858,72195,3209,1548,1661
12375,76610,4384,36856,2858,72226,3210,1549,1661
12380,76641,4384,36864,2858,72257,3211,1550,1661
12385,76672,4384,36882,2858,72288,3212,1550,1662
12390,76703,4384,36897,2858,72319,3213,1551,1662
12395,76734,4384,36912,2858,72350,3214,1551,1663
12400,76765,4384,36929,2858,72381,3215,1552,1663
12405,76796,4384,36947,2858,72412,3216,1553,1663
12410,76827,4384,36963,2858,72443,3217,1553,1664
12415,76858,4384,36982,2858,72474,3218,1554,1664
12420,76889,4384,36998,2858,72505,3219,1554,1665
12425,76920,4384,37011,2858,72536,3220,1555,1665
12430,76951,4385,37027,2858,72566,3221,1556,1665
12435,76982,4386,37039,2858,72596,3222,1557,1665
12440,77013,4387,37054,2859,72626,3223,1558,1665
12445,77044,4388,37071,2859,72656,3224,1559,1665
12450,77075,4389,37079,2859,72686,3225,1559,1666
12455,77106,4390,37095,2860,72716,3226,1559,1667
12460,77137,4391,37111,2861,72746,3227,1560,1667
12465,77168,4392,37125,2862,72776,3228,1561,1667
12470,77199,4394,37139,2863,72805,3231,1563,1668
12475,77230,4399,37148,2865,72831,3234,1563,1671
12480,77261,4402,37159,2866,72859,3237,1565,1672
12485,77292,4405,37170,2867,72887,3238,1566,1672
12490,77323,4410,37186,2869,72913,3239,1566,1673
12495,77354,4414,37199,2871,72940,3240,1567,1673
12500,77385,4419,37213,2875,72966,3241,1567,1674
12505,77416,4424,37230,2878,72992,3242,1568,1674
12510,77447,4427,37245,2880,73020,3243,1568,1675
12515,77478,4431,37258,2882,73047,3244,1568,1676
12520,77509,4434,37271,2885,73075,3245,1568,1677
12525,77540,4437,37288,2887,73103,3246,1569,1677
12530,77571,4440,37305,2889,73131,3247,1569,1678
12535,77602,4442,37320,2891,73160,3248,1570,1678
12540,77633,4443,37345,2892,73190,3249,1571,1678
12545,77664,4443,37363,2892,73221,3249,1571,1678
12550,77695,4443,37377,2892,73252,3249,1571,1678
12555,77726,4443,37392,2892,73283,3249,1571,1678
12560,77757,4443,37413,2892,73314,3249,1571,1678
12565,77788,4443,37430,2892,73345,3249,1571,1678
12570,77819,4443,37447,2892,73376,3249,1571,1678
12575,77850,4443,37463,2892,73407,3249,1571,1678
12580,77881,4443,37472,2892,73438,3249,1571,1678
12585,77912,4443,37481,2892,73469,3250,1571,1679
12590,77943,4443,37491,2892,73500,3251,1571,1680
12595,77974,4443,37504,2892,73531,3251,1571,1680
12600,78005,4443,37517,2892,73562,3251,1571,1680
12605,78036,4445,37530,2892,73591,3251,1571,1680
12610,78067,4447,37542,2893,73620,3251,1571,1680
12615,78098,4450,37556,2896,73648,3251,1571,1680
12620,78129,4452,37568,2897,73677,3251,1571,1680
12625,78160,4454,37584,2898,73706,3251,1571,1680
12630,78191,4456,37603,2899,73735,3251,1571,1680
12635,78222,4458,37616,2899,73764,3251,1571,1680
12640,78253,4461,37636,2901,73792,3251,1571,1680
12645,78284,4463,37647,2902,73821,3252,1571,1681
12650,78315,4466,37663,2904,73849,3253,1572,1681
12655,78346,4469,37683,2907,73877,3254,1573,1681
12660,78377,4472,37704,2909,73905,3255,1574,1681
12665,78408,4475,37717,2909,73933,3256,1574,1682
12670,78439,4478,37728,2910,73961,3257,1574,1683
12675,78470,4481,37740,2910,73989,3258,1574,1684
12680,78501,4484,37755,2911,74017,3259,1575,1684
12685,78532,4487,37769,2914,74045,3260,1576,1684
12690,78563,4490,37779,2914,74073,3261,1576,1685
12695,78594,4493,37793,2915,74101,3263,1577,1686
12700,78625,4497,37808,2916,74128,3265,1578,1687
12705,78656,4501,37824,2918,74155,3267,1580,1687
12710,78687,4506,37838,2921,74181,3270,1583,1687
12715,78718,4509,37848,2922,74209,3272,1583,1689
12720,78749,4513,37862,2926,74234,3274,1584,1690
12725,78780,4517,37881,2929,74263,3275,1585,1690
12730,78811,4518,37899,2930,74293,3276,1585,1691
12735,78842,4519,37912,2931,74323,3277,1586,1691
12740,78873,4520,37924,2932,74353,3278,1587,1691
12745,78904,4521,37940,2932,74383,3279,1588,1691
12750,78935,4522,37950,2932,74413,3280,1589,1691
12755,78966,4523,37967,2933,74443,3281,1590,1691
12760,78997,4524,37984,2934,74473,3282,1591,1691
12765,79028,4525,38002,2935,74503,3283,1591,1692
12770,79059,4526,38019,2936,74533,3284,1592,1692
12775,79090,4527,38034,2936,74563,3285,1592,1693
12780,79121,4528,38050,2936,74593,3286,1592,1694
12785,79152,4529,38064,2936,74623,3287,1593,1694
12790,79183,4530,38079,2936,74653,3288,1594,1694
12795,79214,4531,38095,2937,74683,3289,1595,1694
12800,79245,4532,38109,2937,74713,3290,1596,1694
12805,79276,4533,38123,2937,74743,3291,1597,1694
12810,79307,4534,38135,2937,74773,3292,1598,1694
12815,79338,4535,38149,2938,74803,3294,1599,1695
12820,79369,4536,38166,2939,74833,3296,1600,1696
12825,79400,4537,38184,2939,74863,3299,1603,1696
12830,79431,4543,38199,2943,74886,3302,1604,1698
12835,79462,4549,38214,2948,74911,3305,1605,1700
12840,79493,4554,38227,2952,74939,3307,1607,1700
12845,79524,4557,38242,2954,74967,3308,1608,1700
12850,79555,4559,38255,2956,74996,3309,1608,1701
12855,79586,4561,38268,2958,75025,3310,1608,1702
12860,79617,4562,38277,2958,75055,3311,1608,1703
12865,79648,4563,38292,2958,75085,3312,1609,1703
12870,79679,4564,38312,2959,75115,3313,1610,1703
12875,79710,4566,38322,2960,75144,3314,1611,1703
12880,79741,4567,38338,2960,75174,3315,1611,1704
12885,79772,4568,38358,2961,75204,3316,1611,1705
12890,79803,4570,38377,2963,75233,3317,1612,1705
12895,79834,4571,38391,2963,75263,3318,1612,1706
12900,79865,4572,38402,2963,75293,3319,1613,1706
12905,79896,4574,38417,2965,75322,3320,1614,1706
12910,79927,4574,38431,2965,75353,3321,1614,1707
12915,79958,4574,38445,2965,75384,3322,1615,1707
12920,79989,4574,38459,2965,75415,3323,1615,1708
12925,80020,4574,38472,2965,75446,3324,1616,1708
12930,80051,4574,38484,2965,75477,3326,1617,1709
12935,80082,4574,38499,2965,75508,3328,1617,1711
12940,80113,4574,38512,2965,75539,3331,1619,1712
12945,80144,4575,38527,2966,75569,3334,1620,1714
12950,80175,4578,38540,2967,75597,3336,1621,1715
12955,80206,4582,38558,2971,75622,3338,1623,1715
12960,80237,4586,38575,2974,75649,3340,1624,1716
12965,80268,4591,38592,2979,75677,3341,1624,1717
12970,80299,4595,38604,2982,75704,3342,1625,1717
12975,80330,4598,38623,2984,75732,3343,1626,1717
12980,80361,4601,38638,2987,75760,3344,1626,1718
12985,80392,4604,38653,2989,75788,3345,1627,1718
12990,80423,4607,38669,2990,75816,3346,1628,1718
12995,80454,4610,38684,2991,75844,3347,1629,1718
13000,80485,4613,38698,2994,75872,3348,1629,1719
13005,80516,4616,38714,2994,75900,3349,1629,1720
13010,80547,4619,38726,2996,75928,3350,1629,1721
13015,80578,4622,38742,2998,75956,3351,1630,1721
13020,80609,4625,38756,2999,75984,3352,1630,1722
13025,80640,4628,38767,2999,76012,3353,1630,1723
13030,80671,4631,38784,3000,76040,3354,1631,1723
13035,80702,4634,38800,3003,76068,3355,1632,1723
13040,80733,4638,38816,3006,76095,3356,1632,1724
13045,80764,4641,38831,3008,76123,3357,1633,1724
13050,80795,4644,38849,3009,76151,3360,1634,1726
13055,80826,4647,38863,3011,76179,3363,1635,1728
13060,80857,4651,38882,3013,76206,3366,1637,1729
13065,80888,4655,38894,3016,76232,3369,1638,1731
13070,80919,4660,38914,3021,76259,3371,1639,1732
13075,80950,4666,38930,3025,76283,3373,1639,1734
13080,80981,4671,38946,3029,76310,3374,1639,1735
13085,81012,4671,38960,3029,76341,3375,1639,1736
13090,81043,4671,38974,3029,76372,3376,1639,1737
13095,81074,4671,38990,3029,76403,3377,1640,1737
13100,81105,4671,39001,3029,76434,3378,1640,1738
13105,81136,4671,39016,3029,76465,3379,1640,1739
13110,81167,4671,39030,3029,76496,3380,1640,1740
13115,81198,4671,39046,3029,76527,3381,1640,1741
13120,81229,4671,39064,3029,76558,3382,1641,1741
13125,81260,4671,39077,3029,76589,3383,1642,1741
13130,81291,4671,39091,3029,76620,3384,1643,1741
13135,81322,4671,39101,3029,76651,3385,1643,1742
13140,81353,4671,39116,3029,76682,3386,1644,1742
13145,81384,4671,39132,3029,76713,3389,1644,1745
13150,81415,4671,39150,3029,76744,3391,1645,1746
13155,81446,4671,39164,3029,76775,3393,1647,1746
13160,81477,4671,39179,3029,76806,3394,1648,1746
13165,81508,4671,39190,3029,76837,3395,1648,1747
13170,81539,4671,39205,3029,76868,3397,1649,1748
13175,81570,4671,39225,3029,76899,3399,1651,1748
13180,81601,4671,39242,3029,76930,3401,1652,1749
13185,81632,4671,39256,3029,76961,3403,1654,1749
13190,81663,4676,39273,3032,76986,3405,1656,1749
13195,81694,4682,39287,3036,77011,3407,1658,1749
13200,81725,4689,39307,3042,77036,3409,1659,1750
13205,81756,4692,39328,3044,77064,3410,1660,1750
13210,81787,4695,39342,3045,77092,3411,1660,1751
13215,81818,4697,39353,3045,77121,3412,1660,1752
13220,81849,4700,39370,3047,77149,3413,1661,1752
13225,81880,4701,39385,3047,77179,3414,1662,1752
13230,81911,4702,39399,3048,77209,3415,1662,1753
13235,81942,4703,39415,3048,77239,3416,1663,1753
13240,81973,4704,39432,3049,77269,3417,1664,1753
13245,82004,4705,39445,3050,77299,3418,1664,1754
13250,82035,4706,39461,3050,77329,3420,1665,1755
13255,82066,4707,39480,3051,77359,3422,1666,1756
13260,82097,4708,39498,3051,77389,3424,1668,1756
13265,82128,4709,39513,3051,77419,3425,1669,1756
13270,82159,4710,39531,3052,77449,3426,1669,1757
13275,82190,4711,39544,3053,77479,3427,1669,1758
13280,82221,4712,39559,3053,77509,3428,1670,1758
13285,82252,4713,39572,3053,77539,3429,1671,1758
13290,82283,4714,39590,3054,77569,3430,1671,1759
13295,82314,4715,39611,3055,77599,3431,1672,1759
13300,82345,4716,39628,3055,77629,3432,1673,1759
13305,82376,4718,39642,3056,77658,3433,1673,1760
13310,82407,4721,39655,3057,77685,3434,1673,1761
13315,82438,4724,39668,3059,77713,3436,1673,1763
13320,82469,4728,39687,3062,77740,3438,1674,1764
13325,82500,4731,39702,3064,77769,3439,1675,1764
13330,82531,4733,39718,3065,77798,3440,1675,1765
13335,82562,4735,39733,3066,77827,3441,1676,1765
13340,82593,4739,39749,3069,77854,3441,1676,1765
13345,82624,4743,39760,3072,77881,3441,1676,1765
13350,82655,4746,39776,3074,77909,3441,1676,1765
13355,82686,4750,39793,3077,77936,3441,1676,1765
13360,82717,4753,39806,3079,77964,3441,1676,1765
13365,82748,4757,39820,3082,77991,3441,1676,1765
13370,82779,4760,39834,3084,78019,3442,1676,1766
13375,82810,4763,39851,3086,78047,3443,1676,1767
13380,82841,4766,39870,3088,78075,3444,1677,1767
13385,82872,4767,39883,3089,78105,3445,1677,1768
13390,82903,4768,39902,3089,78135,3446,1678,1768
13395,82934,4769,39915,3089,78165,3447,1678,1769
13400,82965,4770,39932,3090,78195,3448,1679,1769
13405,82996,4771,39947,3090,78225,3449,1679,1770
13410,83027,4772,39960,3090,78255,3450,1680,1770
13415,83058,4772,39977,3090,78286,3451,1681,1770
13420,83089,4773,39995,3090,78316,3452,1681,1771
13425,83120,4774,40012,3090,78346,3453,1682,1771
13430,83151,4775,40019,3091,78375,3454,1682,1772
13435,83182,4777,40034,3093,78401,3455,1683,1772
13440,83213,4782,40053,3098,78427,3456,1683,1773
13445,83244,4790,40068,3104,78454,3458,1683,1775
13450,83275,4790,40085,3104,78485,3459,1683,1776
13455,83306,4790,40100,3104,78516,3460,1684,1776
13460,83337,4790,40113,3104,78547,3461,1685,1776
13465,83368,4790,40130,3104,78578,3462,1686,1776
13470,83399,4790,40145,3104,78609,3463,1687,1776
13475,83430,4790,40158,3104,78640,3464,1688,1776
13480,83461,4790,40173,3104,78671,3465,1689,1776
13485,83492,4790,40185,3104,78702,3466,1689,1777
13490,83523,4790,40197,3104,78733,3468,1689,1779
13495,83554,4790,40217,3104,78764,3470,1689,1781
13500,83585,4790,40231,3104,78795,3472,1691,1781
13505,83616,4790,40246,3104,78826,3473,1691,1782
13510,83647,4790,40262,3104,78857,3474,1692,1782
13515,83678,4790,40277,3104,78888,3475,1692,1783
13520,83709,4790,40294,3104,78919,3476,1692,1784
13525,83740,4790,40310,3104,78950,3477,1693,1784
13530,83771,4790,40320,3104,78981,3478,1693,1785
13535,83802,4790,40330,3104,79012,3479,1694,1785
13540,83833,4790,40345,3104,79043,3480,1694,1786
13545,83864,4790,40355,3104,79074,3481,1694,1787
13550,83895,4790,40374,3104,79102,3483,1695,1788
13555,83926,4797,40386,3108,79127,3485,1695,1790
13560,83957,4805,40403,3114,79151,3487,1697,1790
13565,83988,4809,40419,3117,79179,3488,1697,1791
13570,84019,4812,40436,3120,79207,3488,1697,1791
13575,84050,4817,40450,3124,79233,3488,1697,1791
13580,84081,4821,40466,3126,79260,3488,1697,1791
13585,84112,4824,40478,3127,79288,3488,1697,1791
13590,84143,4827,40493,3130,79316,3488,1697,1791
13595,84174,4829,40511,3131,79345,3488,1697,1791
13600,84205,4831,40529,3133,79374,3488,1697,1791
13605,84236,4834,40542,3136,79402,3488,1697,1791
13610,84267,4836,40560,3138,79431,3489,1698,1791
13615,84298,4838,40577,3139,79460,3490,1698,1792
13620,84329,4840,40592,3140,79489,3491,1699,1792
13625,84360,4842,40605,3142,79518,3491,1699,1792
13630,84391,4844,40617,3142,79547,3491,1699,1792
13635,84422,4846,40634,3144,79576,3491,1699,1792
13640,84453,4848,40647,3146,79605,3491,1699,1792
13645,84484,4850,40667,3148,79634,3491,1699,1792
13650,84515,4852,40681,3149,79663,3491,1699,1792
13655,84546,4854,40693,3150,79692,3491,1699,1792
13660,84577,4856,40708,3151,79721,3491,1699,1792
13665,84608,4858,40724,3152,79750,3492,1700,1792
13670,84639,4861,40740,3154,79777,3495,1703,1792
13675,84670,4864,40751,3156,79805,3498,1704,1794
13680,84701,4865,40770,3157,79836,3500,1706,1794
13685,84732,4865,40787,3157,79867,3501,1706,1795
13690,84763,4867,40805,3158,79896,3502,1707,1795
13695,84794,4868,40823,3159,79926,3503,1708,1795
13700,84825,4869,40839,3160,79956,3504,1708,1796
13705,84856,4872,40852,3162,79984,3505,1708,1797
13710,84887,4874,40862,3164,80013,3506,1709,1797
13715,84918,4875,40874,3164,80043,3507,1709,1798
13720,84949,4878,40886,3166,80071,3508,1709,1799
13725,84980,4880,40897,3167,80099,3509,1709,1800
13730,85011,4883,40911,3169,80127,3510,1709,1801
13735,85042,4885,40928,3170,80157,3511,1709,1802
13740,85073,4887,40945,3171,80186,3512,1709,1803
13745,85104,4889,40960,3171,80215,3513,1709,1804
13750,85135,4891,40973,3172,80244,3514,1710,1804
13755,85166,4894,40987,3174,80272,3516,1711,1805
13760,85197,4895,41005,3175,80302,3518,1712,1806
13765,85228,4896,41022,3175,80332,3520,1713,1807
13770,85259,4897,41039,3175,80362,3522,1714,1808
13775,85290,4899,41052,3176,80391,3524,1716,1808
13780,85321,4902,41069,3179,80419,3527,1717,1810
13785,85352,4904,41089,3181,80448,3530,1718,1812
13790,85383,4907,41108,3184,80476,3533,1719,1814
13795,85414,4909,41120,3186,80505,3535,1721,1814
13800,85445,4911,41132,3187,80534,3537,1721,1816
13805,85476,4913,41147,3188,80563,3538,1722,1816
13810,85507,4915,41160,3189,80592,3539,1723,1816
13815,85538,4917,41171,3189,80621,3540,1724,1816
13820,85569,4919,41181,3189,80650,3541,1724,1817
13825,85600,4921,41194,3191,80679,3542,1724,1818
13830,85631,4923,41205,3192,80708,3543,1724,1819
13835,85662,4926,41217,3194,80736,3544,1724,1820
13840,85693,4928,41238,3195,80765,3545,1725,1820
13845,85724,4930,41249,3195,80794,3546,1725,1821
13850,85755,4933,41265,3198,80822,3547,1725,1822
13855,85786,4934,41281,3199,80852,3548,1725,1823
13860,85817,4935,41295,3199,80882,3549,1725,1824
13865,85848,4938,41307,3201,80910,3550,1726,1824
13870,85879,4941,41318,3202,80938,3551,1726,1825
13875,85910,4943,41332,3204,80967,3552,1727,1825
13880,85941,4945,41345,3204,80996,3553,1728,1825
13885,85972,4947,41357,3206,81025,3554,1728,1826
13890,86003,4949,41373,3208,81054,3555,1728,1827
13895,86034,4951,41390,3209,81083,3556,1729,1827
13900,86065,4953,41407,3210,81112,3558,1729,1829
13905,86096,4956,41425,3212,81140,3560,1730,1830
13910,86127,4957,41441,3213,81170,3562,1730,1832
13915,86158,4958,41450,3214,81200,3563,1730,1833
13920,86189,4959,41462,3214,81230,3564,1730,1834
13925,86220,4960,41479,3214,81259,3565,1731,1834
13930,86251,4962,41497,3215,81289,3566,1732,1834
13935,86282,4962,41512,3215,81320,3567,1732,1835
13940,86313,4962,41528,3215,81351,3568,1733,1835
13945,86344,4962,41545,3215,81382,3569,1734,1835
13950,86375,4962,41560,3215,81413,3570,1734,1836
13955,86406,4962,41573,3215,81444,3571,1734,1837
13960,86437,4963,41590,3216,81474,3572,1735,1837
13965,86468,4964,41601,3216,81504,3573,1735,1838
13970,86499,4965,41611,3217,81534,3574,1736,1838
13975,86530,4967,41624,3218,81563,3575,1736,1839
13980,86561,4969,41639,3220,81592,3576,1737,1839
13985,86592,4973,41654,3222,81619,3577,1738,1839
13990,86623,4975,41670,3223,81648,3578,1739,1839
13995,86654,4979,41688,3226,81675,3579,1739,1840
14000,86685,4981,41699,3227,81704,3580,1740,1840
14005,86716,4984,41716,3230,81732,3581,1740,1841
14010,86747,4986,41729,3232,81761,3582,1740,1842
14015,86778,4989,41747,3234,81789,3583,1740,1843
14020,86809,4992,41761,3235,81817,3585,1741,1844
14025,86840,4994,41776,3236,81846,3587,1742,1845
14030,86871,4997,41790,3238,81874,3590,1744,1846
14035,86902,4999,41804,3239,81903,3593,1747,1846
14040,86933,5001,41818,3241,81932,3596,1748,1848
14045,86964,5003,41836,3243,81961,3598,1748,1850
14050,86995,5004,41847,3243,81990,3599,1749,1850
14055,87026,5007,41865,3246,82019,3600,1749,1851
14060,87057,5009,41881,3248,82048,3601,1750,1851
14065,87088,5010,41895,3248,82077,3602,1750,1852
14070,87119,5013,41910,3250,82105,3603,1751,1852
14075,87150,5015,41929,3252,82134,3604,1752,1852
14080,87181,5016,41942,3253,82165,3605,1753,1852
14085,87212,5016,41958,3253,82196,3606,1753,1853
14090,87243,5016,41973,3253,82227,3607,1754,1853
14095,87274,5016,41988,3253,82258,3608,1755,1853
14100,87305,5016,42007,3253,82289,3609,1755,1854
14105,87336,5018,42023,3255,82318,3610,1755,1855
14110,87367,5020,42038,3257,82347,3611,1756,1855
14115,87398,5021,42054,3258,82377,3612,1756,1856
14120,87429,5022,42071,3258,82407,3613,1756,1857
14125,87460,5023,42086,3258,82437,3614,1757,1857
14130,87491,5024,42101,3258,82467,3615,1758,1857
14135,87522,5025,42116,3259,82497,3616,1759,1857
14140,87553,5027,42138,3259,82526,3617,1760,1857
14145,87584,5030,42154,3260,82554,3618,1761,1857
14150,87615,5033,42168,3262,82582,3621,1763,1858
14155,87646,5034,42182,3262,82612,3624,1765,1859
14160,87677,5036,42197,3263,82641,3627,1766,1861
14165,87708,5041,42211,3266,82667,3629,1767,1862
14170,87739,5043,42226,3267,82696,3630,1767,1863
14175,87770,5046,42245,3268,82724,3630,1767,1863
14180,87801,5048,42262,3270,82753,3630,1767,1863
14185,87832,5051,42282,3271,82781,3630,1767,1863
14190,87863,5054,42299,3273,82809,3630,1767,1863
14195,87894,5056,42315,3274,82838,3630,1767,1863
14200,87925,5058,42325,3275,82867,3630,1767,1863
14205,87956,5060,42338,3276,82896,3630,1767,1863
14210,87987,5063,42356,3278,82924,3630,1767,1863
14215,88018,5065,42370,3278,82953,3630,1767,1863
14220,88049,5067,42383,3279,82982,3630,1767,1863
14225,88080,5068,42398,3279,83012,3630,1767,1863
14230,88111,5069,42411,3279,83042,3630,1767,1863
14235,88142,5070,42425,3280,83072,3630,1767,1863
14240,88173,5071,42438,3280,83102,3630,1767,1863
14245,88204,5072,42454,3281,83132,3630,1767,1863
14250,88235,5073,42464,3281,83162,3630,1767,1863
14255,88266,5074,42480,3281,83192,3630,1767,1863
14260,88297,5075,42493,3282,83222,3630,1767,1863
14265,88328,5076,42510,3282,83252,3630,1767,1863
14270,88359,5079,42526,3284,83280,3633,1769,1864
14275,88390,5082,42546,3286,83308,3636,1771,1865
14280,88421,5086,42557,3288,83335,3639,1773,1866
14285,88452,5088,42569,3289,83364,3640,1773,1867
14290,88483,5091,42585,3291,83392,3641,1773,1868
14295,88514,5093,42600,3293,83421,3642,1773,1869
14300,88545,5094,42618,3294,83451,3643,1774,1869
14305,88576,5095,42632,3294,83481,3644,1774,1870
14310,88607,5096,42645,3295,83511,3645,1775,1870
14315,88638,5097,42661,3296,83541,3646,1775,1871
14320,88669,5098,42674,3296,83571,3647,1776,1871
14325,88700,5099,42685,3296,83601,3648,1776,1872
14330,88731,5100,42705,3297,83631,3649,1776,1873
14335,88762,5101,42722,3298,83661,3650,1776,1874
14340,88793,5102,42733,3298,83691,3651,1777,1874
14345,88824,5102,42748,3298,83722,3652,1777,1875
14350,88855,5102,42761,3298,83753,3653,1778,1875
14355,88886,5102,42777,3298,83784,3654,1779,1875
14360,88917,5102,42791,3298,83815,3655,1779,1876
14365,88948,5102,42804,3298,83846,3656,1780,1876
14370,88979,5102,42818,3298,83877,3657,1780,1877
14375,89010,5102,42831,3298,83908,3658,1780,1878
14380,89041,5102,42846,3298,83939,3659,1781,1878
14385,89072,5102,42864,3298,83970,3660,1781,1879
14390,89103,5102,42875,3298,84001,3663,1782,1881
14395,89134,5105,42889,3300,84029,3667,1783,1884
14400,89165,5108,42904,3301,84057,3670,1785,1885
14405,89196,5111,42922,3303,84085,3672,1787,1885
14410,89227,5115,42939,3306,84112,3673,1787,1886
14415,89258,5119,42957,3307,84139,3674,1788,1886
14420,89289,5122,42971,3310,84167,3675,1789,1886
14425,89320,5126,42981,3313,84194,3676,1789,1887
14430,89351,5130,42993,3317,84221,3677,1789,1888
14435,89382,5132,43007,3318,84250,3678,1790,1888
14440,89413,5135,43018,3320,84278,3679,1790,1889
14445,89444,5137,43032,3321,84307,3680,1790,1890
14450,89475,5140,43047,3323,84335,3681,1791,1890
14455,89506,5143,43064,3325,84363,3682,1792,1890
14460,89537,5146,43085,3328,84391,3683,1793,1890
14465,89568,5148,43104,3329,84420,3684,1794,1890
14470,89599,5151,43122,3331,84448,3685,1794,1891
14475,89630,5154,43140,3334,84476,3686,1795,1891
14480,89661,5157,43152,3336,84504,3687,1795,1892
14485,89692,5159,43169,3338,84533,3688,1795,1893
14490,89723,5162,43183,3339,84561,3689,1795,1894
14495,89754,5164,43196,3340,84590,3690,1795,1895
14500,89785,5168,43214,3344,84617,3692,1797,1895
14505,89816,5172,43235,3348,84644,3695,1799,1896
14510,89847,5174,43245,3349,84673,3699,1803,1896
14515,89878,5177,43261,3351,84699,3702,1805,1897
14520,89909,5180,43276,3354,84727,3704,1806,1898
14525,89940,5183,43294,3357,84757,3706,1807,1899
14530,89971,5184,43309,3358,84787,3707,1807,1900
14535,90002,5185,43320,3358,84817,3708,1808,1900
14540,90033,5187,43338,3360,84846,3709,1809,1900
14545,90064,5188,43350,3361,84876,3710,1810,1900
14550,90095,5190,43366,3363,84905,3711,1811,1900
14555,90126,5191,43384,3363,84935,3712,1811,1901
14560,90157,5192,43404,3364,84965,3713,1812,1901
14565,90188,5193,43414,3365,84995,3714,1812,1902
14570,90219,5194,43426,3365,85025,3715,1812,1903
14575,90250,5195,43433,3365,85055,3716,1813,1903
14580,90281,5197,43447,3366,85084,3717,1814,1903
14585,90312,5200,43460,3368,85112,3718,1814,1904
14590,90343,5202,43477,3369,85141,3719,1815,1904
14595,90374,5204,43488,3370,85170,3720,1815,1905
14600,90405,5205,43499,3370,85200,3721,1815,1906
14605,90436,5205,43519,3370,85231,3722,1816,1906
14610,90467,5205,43534,3370,85262,3723,1817,1906
14615,90498,5205,43553,3370,85293,3725,1818,1907
14620,90529,5206,43568,3370,85323,3728,1820,1908
14625,90560,5208,43584,3372,85352,3731,1823,1908
14630,90591,5209,43599,3373,85382,3733,1825,1908
14635,90622,5211,43609,3374,85411,3735,1825,1910
14640,90653,5213,43623,3376,85440,3737,1825,1912
14645,90684,5218,43641,3379,85466,3739,1827,1912
14650,90715,5221,43655,3379,85494,3740,1827,1913
14655,90746,5225,43672,3381,85521,3741,1828,1913
14660,90777,5229,43684,3383,85548,3742,1828,1914
14665,90808,5232,43696,3385,85576,3743,1828,1915
14670,90839,5236,43713,3388,85603,3744,1828,1916
14675,90870,5238,43722,3389,85632,3745,1828,1917
14680,90901,5240,43735,3390,85661,3746,1828,1918
14685,90932,5242,43749,3391,85690,3747,1829,1918
14690,90963,5245,43767,3394,85718,3748,1829,1919
14695,90994,5246,43780,3395,85748,3749,1829,1920
14700,91025,5247,43792,3395,85778,3750,1829,1921
14705,91056,5248,43808,3395,85808,3751,1830,1921
14710,91087,5249,43827,3396,85838,3752,1831,1921
14715,91118,5250,43839,3396,85868,3753,1831,1922
14720,91149,5251,43858,3396,85898,3754,1832,1922
14725,91180,5252,43870,3397,85928,3755,1832,1923
14730,91211,5253,43887,3397,85958,3757,1834,1923
14735,91242,5254,43904,3397,85988,3759,1835,1924
14740,91273,5255,43927,3398,86018,3761,1837,1924
14745,91304,5256,43944,3399,86048,3762,1838,1924
14750,91335,5257,43961,3399,86078,3764,1838,1926
14755,91366,5258,43975,3399,86108,3766,1839,1927
14760,91397,5261,43992,3401,86136,3768,1839,1929
14765,91428,5263,44004,3402,86165,3769,1839,1930
14770,91459,5266,44016,3403,86193,3770,1840,1930
14775,91490,5270,44038,3407,86220,3771,1840,1931
14780,91521,5272,44051,3408,86249,3772,1840,1932
14785,91552,5275,44069,3409,86277,3773,1841,1932
14790,91583,5278,44081,3411,86305,3774,1842,1932
14795,91614,5280,44096,3412,86334,3775,1842,1933
14800,91645,5284,44111,3415,86361,3776,1842,1934
14805,91676,5287,44127,3417,86389,3777,1842,1935
14810,91707,5290,44140,3419,86417,3778,1842,1936
14815,91738,5293,44150,3421,86445,3779,1842,1937
14820,91769,5296,44168,3424,86473,3780,1843,1937
14825,91800,5296,44185,3424,86504,3780,1843,1937
14830,91831,5296,44202,3424,86535,3780,1843,1937
14835,91862,5296,44213,3424,86566,3780,1843,1937
14840,91893,5296,44226,3424,86597,3780,1843,1937
14845,91924,5296,44245,3424,86628,3780,1843,1937
14850,91955,5296,44258,3424,86659,3781,1843,1938
14855,91986,5296,44272,3424,86690,3782,1844,1938
14860,92017,5296,44286,3424,86721,3783,1845,1938
14865,92048,5296,44303,3424,86752,3785,1846,1939
14870,92079,5297,44312,3424,86782,3788,1847,1941
14875,92110,5298,44323,3425,86812,3791,1850,1941
14880,92141,5300,44338,3427,86841,3794,1851,1943
14885,92172,5302,44348,3427,86869,3796,1851,1945
14890,92203,5306,44365,3430,86896,3798,1852,1946
14895,92234,5309,44377,3433,86925,3800,1854,1946
14900,92265,5311,44386,3433,86953,3802,1854,1948
14905,92296,5314,44401,3436,86981,3804,1855,1949
14910,92327,5317,44420,3439,87010,3806,1857,1949
14915,92358,5318,44435,3440,87040,3807,1858,1949
14920,92389,5319,44449,3440,87070,3808,1859,1949
14925,92420,5321,44463,3441,87099,3809,1859,1950
14930,92451,5323,44474,3442,87128,3810,1859,1951
14935,92482,5325,44485,3443,87157,3811,1859,1952
14940,92513,5327,44503,3444,87186,3812,1859,1953
14945,92544,5331,44517,3446,87213,3814,1860,1954
14950,92575,5333,44534,3447,87242,3815,1861,1954
14955,92606,5335,44547,3448,87271,3816,1861,1955
14960,92637,5337,44559,3448,87300,3817,1861,1956
14965,92668,5339,44568,3448,87329,3818,1861,1957
14970,92699,5343,44583,3452,87356,3819,1861,1958
14975,92730,5346,44594,3453,87384,3820,1861,1959
14980,92761,5348,44609,3455,87413,3821,1862,1959
14985,92792,5349,44622,3456,87443,3824,1863,1961
14990,92823,5351,44634,3457,87472,3827,1863,1964
14995,92854,5353,44646,3458,87501,3830,1866,1964
15000,92885,5355,44662,3459,87530,3833,1867,1966
15005,92916,5357,44674,3460,87559,3835,1869,1966
15010,92947,5358,44687,3461,87589,3837,1869,1968
15015,92978,5360,44703,3463,87618,3839,1871,1968
15020,93009,5361,44712,3463,87648,3841,1872,1969
15025,93040,5362,44724,3464,87678,3843,1874,1969
15030,93071,5364,44741,3466,87706,3845,1875,1970
15035,93102,5367,44760,3468,87734,3847,1875,1972
15040,93133,5370,44773,3471,87762,3849,1875,1974
15045,93164,5372,44786,3472,87791,3851,1875,1976
15050,93195,5375,44800,3475,87819,3854,1877,1977
15055,93226,5377,44814,3477,87849,3856,1877,1979
15060,93257,5378,44831,3478,87879,3858,1877,1981
15065,93288,5380,44846,3478,87908,3860,1879,1981
15070,93319,5382,44863,3478,87937,3862,1881,1981
15075,93350,5385,44878,3479,87965,3864,1882,1982
15080,93381,5388,44894,3481,87993,3866,1883,1983
15085,93412,5390,44914,3483,88021,3868,1884,1984
15090,93443,5393,44926,3486,88050,3870,1885,1985
15095,93474,5394,44946,3487,88080,3872,1886,1986
15100,93505,5395,44962,3487,88110,3874,1887,1987
15105,93536,5396,44980,3488,88140,3876,1887,1989
15110,93567,5398,44998,3490,88169,3878,1887,1991
15115,93598,5400,45017,3491,88198,3881,1888,1993
15120,93629,5401,45031,3491,88228,3884,1889,1995
15125,93660,5403,45041,3492,88257,3886,1889,1997
15130,93691,5405,45060,3493,88286,3887,1890,1997
15135,93722,5407,45074,3495,88315,3888,1891,1997
15140,93753,5409,45091,3496,88344,3889,1892,1997
15145,93784,5410,45103,3497,88374,3890,1893,1997
15150,93815,5412,45122,3499,88403,3891,1893,1998
15155,93846,5413,45134,3499,88433,3892,1894,1998
15160,93877,5414,45150,3499,88463,3894,1894,2000
15165,93908,5416,45172,3500,88492,3896,1895,2001
15170,93939,5417,45185,3500,88522,3897,1895,2002
15175,93970,5418,45201,3501,88552,3898,1896,2002
15180,94001,5419,45217,3501,88582,3899,1896,2003
15185,94032,5423,45233,3504,88609,3899,1896,2003
15190,94063,5425,45245,3506,88638,3899,1896,2003
15195,94094,5427,45261,3507,88667,3899,1896,2003
15200,94125,5429,45279,3508,88696,3899,1896,2003
15205,94156,5432,45295,3510,88724,3899,1896,2003
15210,94187,5434,45309,3511,88753,3899,1896,2003
15215,94218,5437,45323,3512,88781,3899,1896,2003
15220,94249,5440,45337,3513,88809,3899,1896,2003
15225,94280,5443,45355,3515,88837,3900,1897,2003
15230,94311,5445,45372,3516,88866,3902,1899,2003
15235,94342,5447,45390,3517,88895,3904,1901,2003
15240,94373,5449,45404,3517,88922,3906,1902,2004
15245,94404,5455,45419,3522,88949,3907,1902,2005
15250,94435,5457,45433,3523,88978,3907,1902,2005
15255,94466,5458,45454,3523,89008,3907,1902,2005
15260,94497,5459,45468,3523,89038,3907,1902,2005
15265,94528,5460,45479,3523,89068,3907,1902,2005
15270,94559,5461,45495,3524,89098,3907,1902,2005
15275,94590,5462,45510,3525,89128,3907,1902,2005
15280,94621,5463,45527,3526,89158,3907,1902,2005
15285,94652,5464,45541,3527,89188,3907,1902,2005
15290,94683,5465,45556,3528,89218,3908,1903,2005
15295,94714,5466,45569,3528,89248,3909,1903,2006
15300,94745,5466,45585,3528,89279,3910,1904,2006
15305,94776,5466,45601,3528,89310,3912,1904,2008
15310,94807,5466,45618,3528,89341,3913,1904,2009
15315,94838,5466,45636,3528,89372,3914,1905,2009
15320,94869,5466,45650,3528,89403,3915,1906,2009
15325,94900,5466,45666,3528,89434,3916,1906,2010
15330,94931,5466,45684,3528,89465,3917,1907,2010
15335,94962,5466,45703,3528,89496,3918,1907,2011
15340,94993,5466,45722,3528,89527,3919,1908,2011
15345,95024,5466,45736,3528,89558,3921,1908,2013
15350,95055,5467,45753,3529,89587,3923,1910,2013
15355,95086,5469,45770,3530,89617,3925,1912,2013
15360,95117,5473,45785,3533,89644,3927,1912,2015
15365,95148,5476,45801,3534,89672,3929,1913,2016
15370,95179,5477,45813,3535,89702,3931,1915,2016
15375,95210,5479,45821,3536,89731,3933,1915,2018
15380,95241,5480,45834,3537,89761,3935,1915,2020
15385,95272,5481,45852,3538,89791,3937,1916,2021
15390,95303,5483,45869,3539,89820,3939,1918,2021
15395,95334,5484,45885,3540,89850,3941,1920,2021
15400,95365,5485,45896,3541,89880,3943,1920,2023
15405,95396,5487,45909,3543,89909,3945,1922,2023
15410,95427,5491,45926,3546,89936,3947,1923,2024
15415,95458,5496,45941,3550,89962,3949,1924,2025
15420,95489,5502,45966,3556,89987,3951,1926,2025
15425,95520,5504,45978,3557,90016,3952,1926,2026
15430,95551,5507,45992,3559,90044,3953,1926,2027
15435,95582,5509,46007,3559,90073,3954,1927,2027
15440,95613,5511,46024,3560,90102,3955,1928,2027
15445,95644,5513,46039,3560,90131,3956,1929,2027
15450,95675,5516,46057,3563,90159,3957,1930,2027
15455,95706,5518,46075,3564,90188,3958,1931,2027
15460,95737,5520,46090,3565,90217,3959,1932,2027
15465,95768,5522,46107,3566,90245,3960,1933,2027
15470,95799,5525,46124,3567,90273,3961,1933,2028
15475,95830,5528,46142,3570,90302,3963,1934,2029
15480,95861,5530,46158,3571,90330,3965,1935,2030
15485,95892,5533,46174,3573,90359,3966,1935,2031
15490,95923,5535,46190,3574,90388,3967,1936,2031
15495,95954,5535,46205,3574,90419,3968,1936,2032
15500,95985,5535,46217,3574,90450,3969,1937,2032
15505,96016,5535,46229,3574,90481,3970,1938,2032
15510,96047,5535,46240,3574,90512,3971,1938,2033
15515,96078,5535,46255,3574,90543,3972,1938,2034
15520,96109,5535,46273,3574,90574,3973,1939,2034
15525,96140,5535,46288,3574,90605,3974,1940,2034
15530,96171,5538,46301,3577,90633,3976,1940,2036
15535,96202,5540,46317,3579,90662,3978,1941,2037
15540,96233,5543,46330,3581,90690,3980,1942,2038
15545,96264,5546,46343,3582,90718,3981,1942,2039
15550,96295,5550,46354,3585,90745,3982,1943,2039
15555,96326,5553,46372,3588,90773,3983,1944,2039
15560,96357,5555,46384,3589,90802,3984,1944,2040
15565,96388,5557,46398,3590,90831,3986,1944,2042
15570,96419,5558,46414,3590,90861,3988,1946,2042
15575,96450,5559,46430,3590,90891,3989,1946,2043
15580,96481,5560,46445,3591,90921,3990,1947,2043
15585,96512,5561,46459,3591,90951,3991,1947,2044
15590,96543,5562,46478,3592,90981,3992,1948,2044
15595,96574,5563,46496,3592,91011,3993,1949,2044
15600,96605,5564,46510,3593,91041,3994,1950,2044
15605,96636,5564,46528,3593,91072,3995,1950,2045
15610,96667,5564,46546,3593,91103,3996,1950,2046
15615,96698,5564,46568,3593,91134,3997,1951,2046
15620,96729,5564,46582,3593,91165,3998,1951,2047
15625,96760,5564,46594,3593,91196,3999,1951,2048
15630,96791,5564,46602,3593,91227,4000,1951,2049
15635,96822,5564,46616,3593,91258,4001,1952,2049
15640,96853,5564,46631,3593,91289,4002,1952,2050
15645,96884,5564,46647,3593,91320,4003,1952,2051
15650,96915,5564,46664,3593,91351,4005,1953,2052
15655,96946,5566,46684,3595,91380,4007,1955,2052
15660,96977,5567,46703,3595,91410,4009,1956,2053
15665,97008,5569,46715,3596,91439,4010,1957,2053
15670,97039,5571,46731,3597,91468,4011,1958,2053
15675,97070,5574,46746,3598,91496,4012,1958,2054
15680,97101,5577,46761,3600,91524,4013,1959,2054
15685,97132,5579,46778,3602,91553,4014,1960,2054
15690,97163,5582,46793,3604,91581,4016,1962,2054
15695,97194,5584,46806,3604,91610,4018,1964,2054
15700,97225,5586,46823,3605,91639,4020,1965,2055
15705,97256,5588,46838,3606,91668,4023,1968,2055
15710,97287,5592,46852,3609,91695,4026,1969,2057
15715,97318,5596,46865,3613,91721,4029,1970,2059
15720,97349,5601,46881,3617,91747,4031,1971,2060
15725,97380,5605,46902,3620,91775,4031,1971,2060
15730,97411,5606,46923,3620,91805,4031,1971,2060
15735,97442,5607,46939,3621,91835,4031,1971,2060
15740,97473,5608,46954,3621,91865,4031,1971,2060
15745,97504,5609,46971,3622,91895,4031,1971,2060
15750,97535,5610,46983,3623,91925,4031,1971,2060
15755,97566,5611,46996,3623,91955,4031,1971,2060
15760,97597,5612,47011,3623,91985,4031,1971,2060
15765,97628,5613,47024,3623,92015,4031,1971,2060
15770,97659,5614,47041,3624,92045,4032,1972,2060
15775,97690,5615,47057,3624,92075,4033,1973,2060
15780,97721,5616,47071,3625,92105,4034,1974,2060
15785,97752,5619,47082,3628,92132,4035,1974,2061
15790,97783,5622,47093,3630,92161,4035,1974,2061
15795,97814,5624,47106,3631,92189,4035,1974,2061
15800,97845,5628,47123,3633,92217,4035,1974,2061
15805,97876,5631,47141,3636,92245,4035,1974,2061
15810,97907,5632,47161,3636,92275,4035,1974,2061
15815,97938,5633,47177,3636,92304,4035,1974,2061
15820,97969,5635,47191,3637,92334,4036,1975,2061
15825,98000,5637,47209,3639,92363,4038,1976,2062
15830,98031,5639,47220,3640,92392,4040,1977,2063
15835,98062,5641,47232,3641,92421,4043,1978,2065
15840,98093,5644,47252,3644,92449,4046,1980,2066
15845,98124,5646,47268,3646,92478,4048,1980,2068
15850,98155,5648,47284,3647,92507,4049,1981,2068
15855,98186,5650,47304,3648,92536,4050,1982,2068
15860,98217,5652,47321,3648,92565,4051,1982,2069
15865,98248,5654,47332,3649,92594,4052,1982,2070
15870,98279,5656,47345,3650,92623,4053,1982,2071
15875,98310,5658,47363,3652,92652,4054,1983,2071
15880,98341,5660,47373,3652,92681,4055,1983,2072
15885,98372,5662,47391,3653,92710,4056,1983,2073
15890,98403,5665,47411,3655,92738,4057,1984,2073
15895,98434,5668,47424,3657,92766,4058,1984,2074
15900,98465,5671,47440,3659,92794,4059,1985,2074
15905,98496,5672,47456,3660,92824,4060,1986,2074
15910,98527,5672,47472,3660,92855,4061,1987,2074
15915,98558,5672,47487,3660,92886,4062,1988,2074
15920,98589,5672,47504,3660,92917,4063,1989,2074
15925,98620,5672,47515,3660,92948,4064,1989,2075
15930,98651,5672,47526,3660,92979,4065,1989,2076
15935,98682,5672,47541,3660,93010,4066,1989,2077
15940,98713,5672,47561,3660,93041,4067,1989,2078
15945,98744,5672,47575,3660,93072,4069,1991,2078
15950,98775,5672,47589,3660,93103,4072,1993,2079
15955,98806,5674,47600,3661,93130,4076,1994,2082
15960,98837,5677,47612,3663,93160,4080,1996,2084
15965,98868,5681,47627,3665,93187,4081,1997,2084
15970,98899,5684,47641,3666,93215,4082,1997,2085
15975,98930,5687,47656,3667,93243,4083,1997,2086
15980,98961,5690,47671,3668,93271,4084,1997,2087
15985,98992,5694,47684,3669,93298,4085,1997,2088
15990,99023,5697,47696,3669,93326,4086,1997,2089
15995,99054,5700,47714,3670,93354,4087,1997,2090
16000,99085,5703,47724,3671,93382,4088,1998,2090
16005,99116,5706,47736,3673,93410,4089,1998,2091
16010,99147,5711,47751,3675,93436,4090,1999,2091
16015,99178,5714,47769,3677,93464,4091,1999,2092
16020,99209,5716,47788,3679,93493,4092,1999,2093
16025,99240,5718,47805,3680,93522,4093,1999,2094
16030,99271,5720,47821,3681,93551,4094,1999,2095
16035,99302,5722,47837,3682,93580,4095,1999,2096
16040,99333,5724,47857,3683,93609,4096,1999,2097
16045,99364,5726,47872,3684,93638,4097,1999,2098
16050,99395,5729,47884,3686,93666,4098,1999,2099
16055,99426,5730,47898,3686,93696,4099,1999,2100
16060,99457,5731,47913,3687,93726,4100,2000,2100
16065,99488,5733,47930,3689,93755,4102,2001,2101
16070,99519,5736,47944,3692,93782,4106,2003,2103
16075,99550,5738,47958,3694,93812,4109,2005,2104
16080,99581,5738,47970,3694,93843,4110,2005,2105
16085,99612,5738,47983,3694,93874,4111,2006,2105
16090,99643,5738,47997,3694,93905,4112,2006,2106
16095,99674,5738,48012,3694,93936,4113,2006,2107
16100,99705,5738,48030,3694,93967,4114,2006,2108
16105,99736,5738,48047,3694,93998,4115,2007,2108
16110,99767,5738,48059,3694,94029,4116,2007,2109
16115,99798,5738,48076,3694,94060,4117,2008,2109
16120,99829,5739,48091,3694,94090,4118,2009,2109
16125,99860,5740,48106,3694,94120,4119,2009,2110
16130,99891,5741,48122,3695,94150,4120,2010,2110
16135,99922,5742,48133,3695,94180,4121,2010,2111
16140,99953,5743,48140,3695,94210,4122,2010,2112
16145,99984,5746,48153,3697,94238,4123,2011,2112
16150,100015,5748,48168,3698,94267,4124,2012,2112
16155,100046,5750,48183,3700,94296,4125,2012,2113
16160,100077,5752,48196,3700,94325,4126,2012,2114
16165,100108,5754,48210,3701,94354,4127,2013,2114
16170,100139,5757,48230,3703,94382,4128,2014,2114
16175,100170,5760,48246,3706,94410,4130,2014,2116
16180,100201,5763,48265,3708,94438,4132,2015,2117
16185,100232,5767,48276,3711,94465,4135,2016,2119
16190,100263,5772,48286,3714,94491,4138,2018,2120
16195,100294,5777,48302,3717,94516,4141,2020,2121
16200,100325,5784,48317,3723,94540,4144,2021,2123
16205,100356,5785,48330,3724,94571,4145,2021,2124
16210,100387,5785,48342,3724,94602,4146,2021,2125
16215,100418,5785,48359,3724,94633,4147,2021,2126
16220,100449,5785,48376,3724,94664,4148,2022,2126
16225,100480,5785,48391,3724,94695,4149,2022,2127
16230,100511,5785,48405,3724,94726,4150,2022,2128
16235,100542,5785,48420,3724,94757,4151,2023,2128
16240,100573,5785,48442,3724,94788,4152,2024,2128
16245,100604,5785,48457,3724,94819,4153,2025,2128
16250,100635,5785,48466,3724,94850,4154,2025,2129
16255,100666,5785,48481,3724,94881,4155,2025,2130
16260,100697,5785,48497,3724,94912,4156,2026,2130
16265,100728,5788,48507,3724,94940,4157,2026,2131
16270,100759,5791,48519,3725,94968,4158,2027,2131
16275,100790,5794,48533,3726,94996,4159,2027,2132
16280,100821,5797,48546,3727,95024,4160,2028,2132
16285,100852,5800,48556,3729,95052,4161,2028,2133
16290,100883,5803,48569,3730,95080,4162,2029,2133
16295,100914,5806,48580,3730,95108,4163,2030,2133
16300,100945,5809,48598,3732,95136,4164,2030,2134
16305,100976,5812,48615,3735,95163,4165,2031,2134
16310,101007,5816,48628,3737,95191,4166,2032,2134
16315,101038,5820,48647,3741,95217,4168,2033,2135
16320,101069,5825,48661,3746,95243,4170,2035,2135
16325,101100,5826,48672,3747,95274,4172,2036,2136
16330,101131,5826,48684,3747,95305,4174,2038,2136
16335,101162,5826,48697,3747,95336,4176,2040,2136
16340,101193,5826,48710,3747,95367,4178,2040,2138
16345,101224,5826,48730,3747,95398,4180,2041,2139
16350,101255,5826,48749,3747,95429,4182,2043,2139
16355,101286,5826,48760,3747,95460,4184,2043,2141
16360,101317,5826,48780,3747,95491,4186,2043,2143
16365,101348,5826,48794,3747,95522,4188,2044,2144
16370,101379,5826,48809,3747,95553,4190,2045,2145
16375,101410,5826,48820,3747,95584,4191,2045,2146
16380,101441,5826,48836,3747,95615,4192,2045,2147
16385,101472,5829,48849,3749,95643,4192,2045,2147
16390,101503,5830,48867,3750,95673,4192,2045,2147
16395,101534,5830,48883,3750,95704,4192,2045,2147
16400,101565,5830,48899,3750,95735,4192,2045,2147
16405,101596,5830,48917,3750,95766,4192,2045,2147
16410,101627,5830,48926,3750,95797,4193,2045,2148
16415,101658,5830,48942,3750,95828,4194,2045,2149
16420,101689,5830,48956,3750,95859,4195,2046,2149
16425,101720,5830,48972,3750,95890,4196,2046,2150
16430,101751,5831,48991,3751,95920,4196,2046,2150
16435,101782,5832,49001,3751,95950,4196,2046,2150
16440,101813,5833,49022,3752,95980,4196,2046,2150
16445,101844,5835,49036,3754,96009,4198,2047,2151
16450,101875,5837,49057,3756,96038,4199,2047,2152
16455,101906,5838,49071,3757,96068,4200,2047,2153
16460,101937,5839,49086,3757,96098,4201,2048,2153
16465,101968,5840,49099,3758,96128,4202,2048,2154
16470,101999,5841,49120,3759,96157,4203,2049,2154
16475,102030,5845,49140,3763,96185,4204,2049,2155
16480,102061,5847,49150,3765,96214,4205,2049,2156
16485,102092,5849,49165,3767,96243,4206,2049,2157
16490,102123,5852,49170,3768,96270,4207,2049,2158
16495,102154,5857,49186,3772,96297,4209,2050,2159
16500,102185,5860,49201,3773,96325,4210,2051,2159
16505,102216,5862,49216,3774,96354,4212,2052,2160
16510,102247,5864,49227,3775,96383,4214,2052,2162
16515,102278,5866,49239,3775,96412,4216,2052,2164
16520,102309,5868,49248,3776,96441,4218,2054,2164
16525,102340,5870,49263,3777,96470,4219,2054,2165
16530,102371,5872,49279,3779,96499,4220,2054,2166
16535,102402,5874,49293,3780,96528,4221,2054,2167
16540,102433,5876,49311,3781,96557,4222,2055,2167
16545,102464,5878,49328,3783,96586,4223,2055,2168
16550,102495,5880,49342,3784,96615,4224,2056,2168
16555,102526,5882,49354,3785,96644,4225,2056,2169
16560,102557,5884,49372,3786,96673,4226,2057,2169
16565,102588,5886,49388,3787,96702,4227,2058,2169
16570,102619,5888,49400,3788,96731,4228,2058,2170
16575,102650,5890,49414,3788,96760,4229,2058,2171
16580,102681,5892,49430,3790,96789,4230,2059,2171
16585,102712,5894,49446,3791,96818,4231,2059,2172
16590,102743,5896,49459,3791,96847,4232,2060,2172
16595,102774,5898,49476,3792,96876,4233,2060,2173
16600,102805,5900,49495,3793,96905,4234,2061,2173
16605,102836,5904,49509,3794,96932,4235,2061,2174
16610,102867,5909,49531,3798,96957,4237,2062,2175
16615,102898,5916,49547,3804,96981,4239,2063,2176
16620,102929,5922,49561,3808,97007,4241,2064,2177
16625,102960,5923,49576,3808,97036,4243,2066,2177
16630,102991,5925,49590,3809,97066,4245,2067,2178
16635,103022,5926,49601,3810,97096,4247,2067,2180
16640,103053,5927,49617,3811,97126,4248,2067,2181
16645,103084,5928,49633,3811,97156,4249,2067,2182
16650,103115,5929,49647,3811,97186,4250,2067,2183
16655,103146,5930,49661,3812,97216,4251,2067,2184
16660,103177,5931,49676,3813,97246,4252,2067,2185
16665,103208,5932,49692,3813,97276,4253,2067,2186
16670,103239,5933,49704,3813,97306,4254,2068,2186
16675,103270,5934,49722,3814,97336,4255,2069,2186
16680,103301,5935,49736,3814,97366,4256,2069,2187
16685,103332,5936,49755,3815,97396,4258,2070,2188
16690,103363,5937,49770,3816,97426,4260,2071,2189
16695,103394,5938,49787,3817,97456,4262,2073,2189
16700,103425,5939,49800,3817,97486,4263,2074,2189
16705,103456,5940,49812,3817,97516,4264,2074,2190
16710,103487,5941,49829,3818,97546,4265,2075,2190
16715,103518,5942,49843,3818,97576,4266,2076,2190
16720,103549,5943,49857,3819,97606,4267,2077,2190
16725,103580,5946,49874,3821,97634,4268,2077,2191
16730,103611,5949,49892,3823,97662,4270,2079,2191
16735,103642,5952,49904,3825,97689,4272,2080,2192
16740,103673,5956,49919,3827,97717,4274,2080,2194
16745,103704,5958,49932,3827,97745,4276,2080,2196
16750,103735,5961,49945,3829,97774,4278,2082,2196
16755,103766,5963,49961,3830,97803,4280,2083,2197
16760,103797,5966,49977,3833,97831,4282,2085,2197
16765,103828,5968,49989,3833,97860,4284,2086,2198
16770,103859,5971,50006,3836,97888,4285,2087,2198
16775,103890,5973,50020,3837,97917,4286,2087,2199
16780,103921,5976,50031,3839,97945,4287,2087,2200
16785,103952,5979,50047,3841,97973,4288,2088,2200
16790,103983,5981,50062,3842,98002,4289,2089,2200
16795,104014,5983,50080,3844,98031,4290,2089,2201
16800,104045,5985,50097,3846,98060,4292,2089,2203
16805,104076,5985,50110,3846,98091,4294,2089,2205
16810,104107,5985,50126,3846,98122,4295,2089,2206
16815,104138,5985,50138,3846,98153,4296,2089,2207
16820,104169,5985,50153,3846,98184,4297,2089,2208
16825,104200,5985,50171,3846,98215,4298,2090,2208
16830,104231,5985,50181,3846,98246,4299,2091,2208
16835,104262,5985,50192,3846,98277,4300,2091,2209
16840,104293,5985,50205,3846,98308,4301,2092,2209
16845,104324,5985,50218,3846,98339,4302,2092,2210
16850,104355,5986,50235,3847,98369,4303,2092,2211
16855,104386,5988,50253,3848,98398,4305,2094,2211
16860,104417,5989,50266,3848,98428,4307,2096,2211
16865,104448,5991,50275,3850,98457,4308,2097,2211
16870,104479,5993,50284,3850,98486,4309,2097,2212
16875,104510,5995,50302,3852,98515,4310,2097,2213
16880,104541,5997,50321,3852,98544,4311,2098,2213
16885,104572,6000,50336,3853,98572,4312,2098,2214
16890,104603,6002,50350,3854,98601,4313,2099,2214
16895,104634,6004,50359,3855,98630,4314,2100,2214
16900,104665,6007,50376,3858,98658,4315,2100,2215
16905,104696,6010,50393,3860,98686,4316,2100,2216
16910,104727,6011,50407,3860,98716,4318,2102,2216
16915,104758,6013,50424,3862,98745,4320,2104,2216
16920,104789,6015,50440,3863,98774,4322,2106,2216
16925,104820,6015,50451,3863,98805,4324,2107,2217
16930,104851,6015,50470,3863,98836,4326,2107,2219
16935,104882,6015,50482,3863,98867,4328,2108,2220
16940,104913,6015,50496,3863,98898,4330,2108,2222
16945,104944,6015,50505,3863,98929,4332,2108,2224
16950,104975,6015,50515,3863,98960,4334,2110,2224
16955,105006,6015,50531,3863,98991,4336,2111,2225
16960,105037,6015,50544,3863,99022,4338,2111,2227
16965,105068,6015,50557,3863,99053,4340,2112,2228
16970,105099,6016,50572,3863,99083,4342,2113,2229
16975,105130,6018,50586,3864,99112,4343,2114,2229
16980,105161,6019,50601,3864,99142,4344,2115,2229
16985,105192,6023,50611,3865,99169,4345,2115,2230
16990,105223,6027,50623,3866,99196,4346,2115,2231
16995,105254,6031,50638,3867,99223,4347,2116,2231
17000,105285,6034,50655,3869,99251,4348,2116,2232
17005,105316,6037,50664,3871,99279,4349,2116,2233
17010,105347,6041,50678,3872,99306,4350,2117,2233
17015,105378,6046,50697,3875,99332,4352,2118,2234
17020,105409,6050,50714,3877,99359,4354,2120,2234
17025,105440,6053,50731,3879,99387,4356,2121,2235
17030,105471,6054,50752,3880,99417,4357,2121,2236
17035,105502,6055,50767,3880,99447,4358,2122,2236
17040,105533,6056,50784,3880,99477,4359,2123,2236
17045,105564,6057,50795,3881,99507,4360,2123,2237
17050,105595,6058,50809,3881,99537,4361,2124,2237
17055,105626,6059,50824,3882,99567,4362,2124,2238
17060,105657,6060,50839,3882,99597,4363,2125,2238
17065,105688,6061,50857,3882,99627,4364,2126,2238
17070,105719,6062,50872,3883,99657,4365,2126,2239
17075,105750,6063,50889,3884,99687,4367,2128,2239
17080,105781,6064,50901,3884,99717,4369,2128,2241
17085,105812,6065,50917,3885,99747,4371,2130,2241
17090,105843,6066,50935,3886,99777,4373,2131,2242
17095,105874,6066,50946,3886,99808,4375,2133,2242
17100,105905,6066,50963,3886,99839,4377,2134,2243
17105,105936,6066,50979,3886,99870,4380,2136,2244
17110,105967,6066,50998,3886,99901,4382,2136,2246
17115,105998,6066,51012,3886,99932,4383,2136,2247
17120,106029,6066,51024,3886,99963,4384,2136,2248
17125,106060,6066,51039,3886,99994,4385,2137,2248
17130,106091,6068,51052,3888,100023,4386,2138,2248
17135,106122,6070,51073,3889,100052,4387,2139,2248
17140,106153,6073,51087,3891,100080,4388,2139,2249
17145,106184,6076,51100,3892,100108,4389,2139,2250
17150,106215,6078,51114,3893,100137,4390,2139,2251
17155,106246,6080,51130,3894,100166,4391,2140,2251
17160,106277,6083,51150,3896,100194,4392,2140,2252
17165,106308,6087,51166,3899,100221,4394,2142,2252
17170,106339,6089,51178,3900,100250,4396,2144,2252
17175,106370,6091,51192,3900,100279,4398,2146,2252
17180,106401,6093,51203,3901,100308,4400,2146,2254
17185,106432,6097,51216,3905,100335,4402,2146,2256
17190,106463,6100,51226,3907,100363,4404,2146,2258
17195,106494,6103,51239,3910,100391,4407,2148,2259
17200,106525,6104,51252,3911,100421,4409,2149,2260
17205,106556,6105,51265,3911,100451,4411,2151,2260
17210,106587,6107,51282,3913,100480,4413,2151,2262
17215,106618,6110,51295,3914,100508,4415,2152,2263
17220,106649,6113,51313,3916,100536,4417,2153,2264
17225,106680,6113,51324,3916,100567,4418,2153,2265
17230,106711,6113,51340,3916,100598,4419,2153,2266
17235,106742,6113,51354,3916,100629,4420,2153,2267
17240,106773,6113,51362,3916,100660,4421,2153,2268
17245,106804,6113,51378,3916,100691,4422,2153,2269
17250,106835,6113,51391,3916,100722,4423,2154,2269
17255,106866,6113,51407,3916,100753,4424,2154,2270
17260,106897,6113,51420,3916,100784,4425,2154,2271
17265,106928,6113,51440,3916,100815,4426,2154,2272
17270,106959,6113,51456,3916,100846,4427,2154,2273
17275,106990,6113,51469,3916,100877,4428,2155,2273
17280,107021,6113,51487,3916,100908,4429,2156,2273
17285,107052,6113,51504,3916,100939,4430,2157,2273
17290,107083,6113,51521,3916,100970,4430,2157,2273
17295,107114,6113,51536,3916,101001,4430,2157,2273
17300,107145,6113,51552,3916,101032,4430,2157,2273
17305,107176,6113,51568,3916,101063,4430,2157,2273
17310,107207,6113,51587,3916,101094,4430,2157,2273
17315,107238,6113,51601,3916,101125,4430,2157,2273
17320,107269,6113,51616,3916,101156,4430,2157,2273
17325,107300,6113,51631,3916,101187,4430,2157,2273
17330,107331,6115,51642,3917,101216,4431,2157,2274
17335,107362,6118,51657,3918,101244,4432,2157,2275
17340,107393,6121,51677,3920,101272,4433,2158,2275
17345,107424,6124,51693,3922,101300,4434,2159,2275
17350,107455,6126,51708,3924,101329,4434,2159,2275
17355,107486,6129,51719,3926,101357,4434,2159,2275
17360,107517,6131,51729,3926,101386,4434,2159,2275
17365,107548,6134,51745,3928,101414,4434,2159,2275
17370,107579,6137,51762,3929,101442,4434,2159,2275
17375,107610,6139,51780,3930,101471,4434,2159,2275
17380,107641,6142,51794,3931,101499,4434,2159,2275
17385,107672,6146,51807,3934,101526,4435,2159,2276
17390,107703,6149,51820,3937,101554,4436,2160,2276
17395,107734,6153,51836,3939,101581,4437,2160,2277
17400,107765,6158,51850,3942,101607,4438,2161,2277
17405,107796,6160,51864,3942,101634,4439,2161,2278
17410,107827,6164,51879,3945,101663,4440,2162,2278
17415,107858,6166,51892,3946,101691,4441,2162,2279
17420,107889,6169,51904,3947,101720,4442,2162,2280
17425,107920,6171,51920,3948,101749,4443,2163,2280
17430,107951,6172,51935,3949,101779,4444,2163,2281
17435,107982,6173,51952,3949,101809,4445,2163,2282
17440,108013,6174,51966,3950,101839,4446,2163,2283
17445,108044,6175,51976,3950,101869,4447,2164,2283
17450,108075,6177,51990,3951,101898,4448,2164,2284
17455,108106,6178,51999,3951,101928,4449,2165,2284
17460,108137,6181,52015,3954,101956,4450,2165,2285
17465,108168,6182,52030,3954,101985,4451,2166,2285
17470,108199,6184,52045,3956,102015,4452,2167,2285
17475,108230,6185,52068,3956,102044,4453,2167,2286
17480,108261,6186,52084,3957,102075,4454,2168,2286
17485,108292,6186,52098,3957,102106,4455,2169,2286
17490,108323,6186,52113,3957,102137,4456,2170,2286
17495,108354,6186,52126,3957,102168,4457,2170,2287
17500,108385,6186,52137,3957,102199,4458,2170,2288
17505,108416,6186,52152,3957,102230,4459,2171,2288
17510,108447,6186,52162,3957,102261,4460,2171,2289
17515,108478,6186,52183,3957,102292,4461,2171,2290
17520,108509,6186,52200,3957,102323,4462,2171,2291
17525,108540,6186,52211,3957,102354,4463,2172,2291
17530,108571,6186,52224,3957,102385,4464,2173,2291
17535,108602,6186,52240,3957,102416,4465,2173,2292
17540,108633,6186,52255,3957,102447,4466,2174,2292
17545,108664,6186,52272,3957,102478,4467,2175,2292
17550,108695,6186,52288,3957,102509,4469,2176,2293
17555,108726,6186,52302,3957,102540,4471,2176,2295
17560,108757,6186,52320,3957,102571,4473,2178,2295
17565,108788,6186,52340,3957,102602,4476,2180,2296
17570,108819,6188,52355,3958,102631,4479,2181,2298
17575,108850,6191,52375,3961,102659,4482,2181,2301
17580,108881,6195,52391,3964,102686,4484,2182,2302
17585,108912,6199,52405,3967,102713,4485,2183,2302
17590,108943,6202,52418,3969,102741,4486,2183,2303
17595,108974,6207,52431,3972,102767,4487,2184,2303
17600,109005,6212,52444,3975,102793,4488,2185,2303
17605,109036,6215,52457,3976,102821,4489,2185,2304
17610,109067,6219,52469,3978,102848,4490,2186,2304
17615,109098,6222,52485,3979,102876,4491,2186,2305
17620,109129,6226,52499,3982,102903,4492,2186,2306
17625,109160,6230,52517,3985,102930,4493,2187,2306
17630,109191,6231,52535,3985,102960,4494,2188,2306
17635,109222,6232,52550,3985,102990,4495,2189,2306
17640,109253,6233,52565,3985,103020,4496,2190,2306
17645,109284,6234,52578,3986,103050,4499,2190,2309
17650,109315,6235,52591,3986,103080,4502,2193,2309
17655,109346,6236,52598,3986,103110,4505,2193,2312
17660,109377,6238,52613,3987,103139,4508,2196,2312
17665,109408,6239,52627,3988,103169,4511,2198,2313
17670,109439,6239,52643,3988,103200,4514,2200,2314
17675,109470,6239,52655,3988,103231,4517,2202,2315
17680,109501,6239,52667,3988,103262,4519,2203,2316
17685,109532,6239,52685,3988,103293,4521,2204,2317
17690,109563,6239,52698,3988,103324,4523,2204,2319
17695,109594,6239,52721,3988,103355,4525,2206,2319
17700,109625,6239,52734,3988,103386,4526,2206,2320
17705,109656,6239,52751,3988,103417,4527,2206,2321
17710,109687,6239,52766,3988,103448,4528,2206,2322
17715,109718,6239,52779,3988,103479,4529,2207,2322
17720,109749,6239,52796,3988,103510,4530,2207,2323
17725,109780,6239,52816,3988,103541,4531,2207,2324
17730,109811,6239,52838,3988,103571,4532,2207,2325
17735,109842,6243,52854,3990,103598,4533,2207,2326
17740,109873,6247,52873,3993,103626,4534,2208,2326
17745,109904,6250,52885,3995,103654,4535,2208,2327
17750,109935,6252,52898,3995,103681,4536,2208,2328
17755,109966,6257,52911,3999,103708,4537,2209,2328
17760,109997,6263,52933,4005,103733,4538,2210,2328
17765,110028,6267,52953,4009,103761,4539,2210,2329
17770,110059,6271,52964,4012,103788,4540,2210,2330
17775,110090,6275,52977,4015,103815,4541,2210,2331
17780,110121,6279,52998,4018,103842,4542,2210,2332
17785,110152,6283,53014,4022,103869,4544,2211,2333
17790,110183,6286,53031,4023,103897,4546,2212,2334
17795,110214,6288,53044,4025,103926,4548,2212,2336
17800,110245,6290,53063,4027,103955,4551,2214,2337
17805,110276,6291,53077,4028,103985,4553,2214,2339
17810,110307,6292,53097,4029,104015,4555,2215,2340
17815,110338,6293,53115,4030,104045,4557,2215,2342
17820,110369,6294,53134,4031,104075,4558,2216,2342
17825,110400,6297,53152,4034,104103,4560,2217,2343
17830,110431,6299,53169,4035,104132,4561,2218,2343
17835,110462,6301,53186,4036,104161,4562,2218,2344
17840,110493,6303,53202,4037,104190,4563,2218,2345
17845,110524,6305,53216,4038,104219,4564,2219,2345
17850,110555,6307,53224,4038,104248,4565,2219,2346
17855,110586,6309,53237,4038,104277,4566,2220,2346
17860,110617,6311,53251,4039,104306,4567,2220,2347
17865,110648,6313,53261,4040,104335,4568,2220,2348
17870,110679,6315,53278,4042,104364,4569,2221,2348
17875,110710,6317,53295,4043,104393,4571,2221,2350
17880,110741,6319,53309,4045,104422,4573,2222,2351
17885,110772,6322,53323,4047,104450,4575,2222,2353
17890,110803,6326,53338,4051,104477,4577,2222,2355
17895,110834,6330,53357,4054,104504,4579,2223,2356
17900,110865,6333,53373,4055,104532,4581,2225,2356
17905,110896,6336,53389,4056,104560,4583,2225,2358
17910,110927,6339,53403,4058,104588,4584,2226,2358
17915,110958,6342,53418,4060,104616,4585,2226,2359
17920,110989,6345,53438,4062,104644,4587,2228,2359
17925,111020,6348,53452,4063,104671,4589,2229,2360
17930,111051,6354,53465,4069,104697,4592,2229,2363
17935,111082,6357,53476,4071,104725,4595,2230,2365
17940,111113,6359,53491,4072,104754,4597,2230,2367
17945,111144,6359,53499,4072,104785,4597,2230,2367
17950,111175,6359,53519,4072,104816,4597,2230,2367
17955,111206,6359,53538,4072,104847,4597,2230,2367
17960,111237,6359,53556,4072,104878,4597,2230,2367
17965,111268,6359,53568,4072,104909,4597,2230,2367
17970,111299,6359,53582,4072,104940,4597,2230,2367
17975,111330,6359,53595,4072,104971,4597,2230,2367
17980,111361,6359,53610,4072,105002,4597,2230,2367
17985,111392,6359,53627,4072,105033,4597,2230,2367
17990,111423,6359,53639,4072,105064,4597,2230,2367
17995,111454,6359,53652,4072,105095,4597,2230,2367
18000,111485,6359,53665,4072,105126,4597,2230,2367
18005,111516,6359,53680,4072,105157,4597,2230,2367
18010,111547,6359,53691,4072,105188,4597,2230,2367
18015,111578,6359,53705,4072,105219,4598,2231,2367
18020,111609,6359,53723,4072,105250,4599,2232,2367
18025,111640,6359,53737,4072,105281,4600,2232,2368
18030,111671,6359,53754,4072,105312,4601,2232,2369
18035,111702,6359,53775,4072,105343,4602,2232,2370
18040,111733,6361,53789,4074,105372,4604,2233,2371
18045,111764,6364,53805,4077,105399,4608,2234,2374
18050,111795,6370,53823,4082,105425,4612,2235,2377
18055,111826,6376,53837,4085,105450,4615,2237,2378
18060,111857,6381,53853,4089,105476,4618,2238,2380
18065,111888,6386,53870,4093,105502,4620,2239,2381
18070,111919,6391,53881,4097,105528,4622,2240,2382
18075,111950,6397,53895,4101,105553,4624,2241,2383
18080,111981,6400,53905,4102,105581,4626,2242,2384
18085,112012,6406,53927,4107,105606,4628,2242,2386
18090,112043,6408,53938,4108,105635,4630,2243,2387
18095,112074,6410,53954,4108,105664,4632,2244,2388
18100,112105,6414,53968,4110,105691,4633,2245,2388
18105,112136,6415,53983,4110,105721,4634,2246,2388
18110,112167,6416,53993,4110,105751,4635,2246,2389
18115,112198,6418,54010,4111,105780,4636,2246,2390
18120,112229,6420,54026,4113,105809,4637,2247,2390
18125,112260,6420,54043,4113,105840,4639,2248,2391
18130,112291,6420,54056,4113,105871,4641,2249,2392
18135,112322,6420,54072,4113,105902,4643,2249,2394
18140,112353,6420,54088,4113,105933,4645,2251,2394
18145,112384,6420,54099,4113,105964,4646,2251,2395
18150,112415,6420,54113,4113,105995,4647,2252,2395
18155,112446,6420,54130,4113,106026,4649,2254,2395
18160,112477,6420,54147,4113,106057,4651,2254,2397
18165,112508,6420,54160,4113,106088,4653,2255,2398
18170,112539,6420,54169,4113,106119,4655,2256,2399
18175,112570,6420,54187,4113,106150,4657,2258,2399
18180,112601,6420,54201,4113,106181,4659,2258,2401
18185,112632,6420,54217,4113,106212,4660,2259,2401
18190,112663,6420,54231,4113,106243,4661,2259,2402
18195,112694,6422,54247,4115,106272,4662,2260,2402
18200,112725,6423,54263,4116,106302,4663,2260,2403
18205,112756,6426,54277,4118,106330,4664,2260,2404
18210,112787,6427,54294,4119,106360,4665,2260,2405
18215,112818,6429,54305,4120,106389,4666,2261,2405
18220,112849,6432,54319,4122,106417,4667,2262,2405
18225,112880,6433,54334,4123,106447,4668,2262,2406
18230,112911,6438,54345,4126,106473,4669,2262,2407
18235,112942,6441,54357,4128,106501,4671,2263,2408
18240,112973,6444,54371,4130,106529,4673,2264,2409
18245,113004,6447,54393,4132,106557,4675,2265,2410
18250,113035,6451,54406,4135,106584,4677,2267,2410
18255,113066,6454,54417,4135,106612,4678,2268,2410
18260,113097,6457,54432,4137,106640,4679,2269,2410
18265,113128,6460,54446,4138,106668,4680,2269,2411
18270,113159,6463,54461,4140,106696,4681,2269,2412
18275,113190,6466,54474,4143,106724,4682,2269,2413
18280,113221,6470,54487,4145,106751,4683,2269,2414
18285,113252,6475,54501,4147,106777,4684,2269,2415
18290,113283,6481,54521,4151,106801,4685,2270,2415
18295,113314,6486,54539,4154,106827,4687,2271,2416
18300,113345,6491,54555,4158,106854,4689,2272,2417
18305,113376,6491,54569,4158,106885,4690,2273,2417
18310,113407,6491,54586,4158,106916,4691,2274,2417
18315,113438,6491,54603,4158,106947,4692,2275,2417
18320,113469,6491,54616,4158,106978,4693,2275,2418
18325,113500,6491,54628,4158,107009,4694,2276,2418
18330,113531,6491,54641,4158,107040,4695,2276,2419
18335,113562,6491,54659,4158,107071,4696,2277,2419
18340,113593,6491,54670,4158,107102,4697,2278,2419
18345,113624,6491,54689,4158,107133,4698,2279,2419
18350,113655,6491,54701,4158,107164,4699,2280,2419
18355,113686,6491,54714,4158,107195,4700,2280,2420
18360,113717,6491,54735,4158,107226,4702,2281,2421
18365,113748,6493,54748,4159,107255,4703,2281,2422
18370,113779,6495,54762,4160,107284,4704,2281,2423
18375,113810,6495,54777,4160,107315,4705,2281,2424
18380,113841,6495,54790,4160,107346,4706,2281,2425
18385,113872,6495,54805,4160,107377,4707,2282,2425
18390,113903,6495,54819,4160,107408,4708,2283,2425
18395,113934,6495,54837,4160,107439,4709,2283,2426
18400,113965,6495,54853,4160,107470,4710,2283,2427
18405,113996,6496,54864,4160,107499,4712,2284,2428
18410,114027,6500,54875,4162,107526,4714,2285,2429
18415,114058,6506,54894,4168,107551,4717,2287,2430
18420,114089,6511,54905,4171,107578,4720,2288,2432
18425,114120,6512,54917,4171,107608,4722,2288,2434
18430,114151,6513,54931,4172,107638,4724,2289,2435
18435,114182,6514,54944,4173,107668,4725,2289,2436
18440,114213,6515,54955,4173,107698,4726,2290,2436
18445,114244,6516,54971,4173,107728,4727,2291,2436
18450,114275,6517,54987,4173,107758,4728,2292,2436
18455,114306,6518,55000,4174,107788,4729,2292,2437
18460,114337,6519,55015,4174,107818,4730,2293,2437
18465,114368,6520,55027,4174,107848,4732,2294,2438
18470,114399,6521,55043,4175,107878,4734,2295,2439
18475,114430,6522,55062,4176,107908,4736,2297,2439
18480,114461,6524,55079,4177,107937,4738,2299,2439
18485,114492,6526,55093,4178,107966,4738,2299,2439
18490,114523,6528,55107,4178,107995,4738,2299,2439
18495,114554,6530,55119,4179,108024,4738,2299,2439
18500,114585,6532,55136,4179,108053,4738,2299,2439
18505,114616,6534,55152,4179,108082,4738,2299,2439
18510,114647,6536,55166,4179,108111,4738,2299,2439
18515,114678,6538,55185,4181,108140,4738,2299,2439
18520,114709,6540,55199,4181,108169,4738,2299,2439
18525,114740,6543,55213,4181,108196,4739,2299,2440
18530,114771,6548,55229,4183,108221,4740,2299,2441
18535,114802,6553,55247,4186,108246,4741,2300,2441
18540,114833,6559,55259,4192,108272,4742,2300,2442
18545,114864,6563,55275,4195,108301,4743,2301,2442
18550,114895,6564,55290,4196,108331,4745,2303,2442
18555,114926,6566,55305,4198,108360,4747,2304,2443
18560,114957,6568,55323,4200,108389,4749,2304,2445
18565,114988,6569,55334,4201,108419,4751,2306,2445
18570,115019,6571,55347,4203,108448,4753,2308,2445
18575,115050,6572,55364,4204,108478,4755,2310,2445
18580,115081,6574,55378,4206,108507,4757,2311,2446
18585,115112,6575,55392,4206,108537,4759,2312,2447
18590,115143,6577,55408,4207,108566,4761,2313,2448
18595,115174,6578,55423,4208,108596,4763,2313,2450
18600,115205,6578,55440,4208,108627,4765,2314,2451
18605,115236,6578,55455,4208,108658,4766,2314,2452
18610,115267,6578,55471,4208,108689,4767,2314,2453
18615,115298,6578,55483,4208,108720,4768,2314,2454
18620,115329,6578,55495,4208,108751,4769,2315,2454
18625,115360,6578,55510,4208,108782,4770,2315,2455
18630,115391,6578,55523,4208,108813,4771,2315,2456
18635,115422,6578,55536,4208,108844,4772,2316,2456
18640,115453,6578,55552,4208,108875,4773,2316,2457
18645,115484,6579,55567,4209,108905,4774,2317,2457
18650,115515,6581,55584,4210,108934,4776,2318,2458
18655,115546,6583,55600,4212,108961,4778,2319,2459
18660,115577,6587,55611,4214,108988,4780,2319,2461
18665,115608,6593,55626,4219,109015,4781,2320,2461
18670,115639,6597,55642,4221,109042,4782,2320,2462
18675,115670,6600,55660,4223,109070,4783,2321,2462
18680,115701,6603,55676,4226,109098,4784,2322,2462
18685,115732,6606,55689,4227,109126,4785,2322,2463
18690,115763,6610,55702,4229,109153,4786,2322,2464
18695,115794,6614,55716,4232,109180,4787,2322,2465
18700,115825,6617,55731,4234,109208,4788,2323,2465
18705,115856,6622,55748,4238,109234,4791,2325,2466
18710,115887,6625,55760,4239,109262,4794,2325,2469
18715,115918,6630,55780,4241,109288,4796,2326,2470
18720,115949,6634,55793,4243,109315,4798,2326,2472
18725,115980,6637,55813,4245,109343,4799,2326,2473
18730,116011,6640,55829,4246,109371,4800,2327,2473
18735,116042,6641,55840,4247,109401,4801,2327,2474
18740,116073,6642,55860,4248,109431,4802,2328,2474
18745,116104,6643,55879,4249,109461,4803,2328,2475
18750,116135,6645,55896,4250,109490,4804,2328,2476
18755,116166,6645,55908,4250,109521,4805,2328,2477
18760,116197,6645,55924,4250,109552,4806,2329,2477
18765,116228,6645,55944,4250,109583,4807,2329,2478
18770,116259,6645,55960,4250,109614,4808,2329,2479
18775,116290,6645,55974,4250,109645,4809,2330,2479
18780,116321,6645,55991,4250,109676,4810,2331,2479
18785,116352,6646,56004,4250,109706,4812,2333,2479
18790,116383,6647,56018,4250,109736,4814,2333,2481
18795,116414,6648,56034,4251,109766,4816,2333,2483
18800,116445,6649,56050,4252,109796,4818,2334,2484
18805,116476,6650,56066,4252,109826,4820,2335,2485
18810,116507,6651,56081,4252,109856,4822,2335,2487
18815,116538,6652,56096,4253,109886,4823,2335,2488
18820,116569,6653,56110,4254,109916,4824,2335,2489
18825,116600,6654,56123,4255,109946,4825,2335,2490
18830,116631,6657,56137,4258,109974,4826,2335,2491
18835,116662,6660,56155,4261,110002,4828,2335,2493
18840,116693,6662,56168,4261,110031,4830,2335,2495
18845,116724,6665,56178,4263,110059,4834,2336,2498
18850,116755,6668,56191,4265,110087,4836,2337,2499
18855,116786,6671,56205,4266,110115,4838,2337,2501
18860,116817,6674,56220,4267,110143,4840,2338,2502
18865,116848,6677,56232,4268,110171,4842,2339,2503
18870,116879,6680,56245,4269,110199,4844,2340,2504
18875,116910,6683,56260,4270,110227,4846,2341,2505
18880,116941,6686,56276,4271,110255,4848,2341,2507
18885,116972,6689,56286,4272,110283,4850,2341,2509
18890,117003,6693,56300,4275,110310,4851,2341,2510
18895,117034,6698,56315,4279,110336,4852,2341,2511
18900,117065,6700,56329,4280,110365,4853,2342,2511
18905,117096,6703,56344,4282,110393,4853,2342,2511
18910,117127,6703,56361,4282,110424,4854,2342,2512
18915,117158,6703,56377,4282,110455,4854,2342,2512
18920,117189,6703,56393,4282,110486,4854,2342,2512
18925,117220,6703,56408,4282,110517,4854,2342,2512
18930,117251,6703,56423,4282,110548,4854,2342,2512
18935,117282,6703,56438,4282,110579,4854,2342,2512
18940,117313,6703,56453,4282,110610,4854,2342,2512
18945,117344,6703,56467,4282,110641,4854,2342,2512
18950,117375,6703,56484,4282,110672,4855,2342,2513
18955,117406,6703,56499,4282,110703,4856,2342,2514
18960,117437,6703,56520,4282,110734,4857,2342,2515
18965,117468,6706,56532,4283,110762,4857,2342,2515
18970,117499,6709,56547,4285,110789,4857,2342,2515
18975,117530,6713,56561,4287,110817,4857,2342,2515
18980,117561,6717,56578,4290,110843,4857,2342,2515
18985,117592,6722,56592,4294,110869,4857,2342,2515
18990,117623,6725,56609,4296,110898,4858,2342,2516
18995,117654,6727,56623,4296,110927,4859,2342,2517
19000,117685,6730,56638,4298,110955,4860,2343,2517
19005,117716,6731,56655,4299,110985,4861,2343,2518
19010,117747,6733,56670,4300,111013,4862,2343,2519
19015,117778,6735,56681,4301,111043,4864,2344,2520
19020,117809,6736,56690,4302,111073,4867,2344,2523
19025,117840,6738,56703,4304,111102,4868,2344,2524
19030,117871,6740,56716,4305,111131,4869,2344,2525
19035,117902,6742,56734,4306,111160,4870,2344,2526
19040,117933,6744,56745,4306,111189,4871,2344,2527
19045,117964,6746,56763,4306,111218,4872,2344,2528
19050,117995,6748,56778,4307,111247,4873,2345,2528
19055,118026,6750,56789,4307,111276,4874,2345,2529
19060,118057,6752,56803,4307,111305,4875,2345,2530
19065,118088,6754,56816,4308,111334,4876,2345,2531
19070,118119,6757,56831,4309,111362,4878,2346,2532
19075,118150,6758,56846,4310,111392,4880,2347,2533
19080,118181,6759,56863,4310,111422,4882,2348,2534
19085,118212,6762,56880,4312,111449,4884,2349,2535
19090,118243,6766,56898,4316,111475,4885,2350,2535
19095,118274,6770,56911,4319,111504,4886,2350,2536
19100,118305,6771,56923,4319,111533,4887,2350,2537
19105,118336,6773,56941,4321,111561,4888,2350,2538
19110,118367,6776,56956,4323,111591,4889,2351,2538
19115,118398,6777,56972,4324,111621,4890,2351,2539
19120,118429,6778,56987,4324,111651,4891,2351,2540
19125,118460,6779,56999,4325,111681,4892,2351,2541
19130,118491,6780,57019,4326,111711,4893,2352,2541
19135,118522,6782,57038,4327,111740,4894,2353,2541
19140,118553,6784,57054,4329,111769,4895,2354,2541
19145,118584,6787,57072,4331,111797,4898,2356,2542
19150,118615,6789,57091,4332,111826,4900,2358,2542
19155,118646,6791,57106,4333,111855,4901,2358,2543
19160,118677,6791,57123,4333,111886,4902,2359,2543
19165,118708,6791,57140,4333,111917,4903,2360,2543
19170,118739,6791,57154,4333,111948,4904,2361,2543
19175,118770,6791,57168,4333,111979,4905,2361,2544
19180,118801,6791,57189,4333,112010,4906,2362,2544
19185,118832,6791,57204,4333,112041,4907,2362,2545
19190,118863,6792,57222,4334,112071,4908,2362,2546
19195,118894,6793,57235,4334,112101,4909,2362,2547
19200,118925,6794,57256,4335,112131,4910,2363,2547
19205,118956,6797,57275,4338,112159,4911,2364,2547
19210,118987,6799,57293,4339,112188,4912,2364,2548
19215,119018,6801,57309,4340,112217,4913,2364,2549
19220,119049,6805,57323,4342,112244,4914,2364,2550
19225,119080,6808,57339,4343,112272,4915,2364,2551
19230,119111,6810,57348,4343,112301,4916,2364,2552
19235,119142,6814,57366,4346,112328,4917,2365,2552
19240,119173,6816,57376,4348,112357,4918,2366,2552
19245,119204,6819,57395,4349,112384,4919,2366,2553
19250,119235,6825,57413,4353,112409,4921,2367,2554
19255,119266,6829,57424,4355,112437,4923,2368,2555
19260,119297,6831,57437,4357,112465,4924,2369,2555
19265,119328,6834,57452,4360,112494,4925,2370,2555
19270,119359,6837,57462,4362,112522,4926,2370,2556
19275,119390,6839,57477,4363,112551,4927,2370,2557
19280,119421,6841,57490,4365,112580,4928,2370,2558
19285,119452,6844,57506,4367,112608,4929,2371,2558
19290,119483,6847,57523,4368,112636,4930,2372,2558
19295,119514,6850,57539,4370,112664,4931,2373,2558
19300,119545,6851,57553,4371,112694,4932,2373,2559
19305,119576,6854,57569,4373,112722,4933,2373,2560
19310,119607,6856,57578,4375,112751,4934,2373,2561
19315,119638,6859,57588,4378,112779,4935,2373,2562
19320,119669,6859,57599,4378,112810,4936,2373,2563
19325,119700,6859,57618,4378,112841,4937,2374,2563
19330,119731,6859,57628,4378,112872,4938,2375,2563
19335,119762,6859,57645,4378,112903,4939,2376,2563
19340,119793,6859,57658,4378,112934,4940,2376,2564
19345,119824,6859,57673,4378,112965,4941,2377,2564
19350,119855,6859,57690,4378,112996,4942,2377,2565
19355,119886,6859,57703,4378,113027,4943,2377,2566
19360,119917,6861,57716,4379,113056,4945,2377,2568
19365,119948,6862,57730,4379,113086,4947,2377,2570
19370,119979,6863,57749,4380,113114,4950,2377,2573
19375,120010,6866,57763,4382,113143,4952,2378,2574
19380,120041,6869,57782,4385,113170,4954,2380,2574
19385,120072,6875,57802,4390,113197,4955,2381,2574
19390,120103,6879,57819,4393,113224,4956,2381,2575
19395,120134,6882,57829,4394,113251,4957,2381,2576
19400,120165,6886,57842,4396,113278,4958,2381,2577
19405,120196,6890,57852,4398,113306,4959,2382,2577
19410,120227,6893,57870,4401,113334,4960,2383,2577
19415,120258,6897,57882,4404,113361,4961,2383,2578
19420,120289,6901,57899,4405,113387,4962,2383,2579
19425,120320,6906,57912,4409,113414,4963,2383,2580
19430,120351,6909,57927,4410,113442,4964,2384,2580
19435,120382,6912,57938,4412,113470,4965,2385,2580
19440,120413,6916,57950,4416,113497,4966,2385,2581
19445,120444,6917,57968,4417,113527,4967,2386,2581
19450,120475,6918,57982,4418,113557,4968,2387,2581
19455,120506,6919,58001,4419,113587,4969,2387,2582
19460,120537,6920,58016,4419,113617,4970,2388,2582
19465,120568,6921,58028,4420,113647,4971,2388,2583
19470,120599,6923,58046,4422,113676,4972,2388,2584
19475,120630,6923,58058,4422,113707,4974,2388,2586
19480,120661,6923,58067,4422,113738,4976,2388,2588
19485,120692,6923,58074,4422,113769,4978,2389,2589
19490,120723,6923,58091,4422,113800,4980,2389,2591
19495,120754,6923,58100,4422,113831,4982,2390,2592
19500,120785,6923,58115,4422,113862,4984,2390,2594
19505,120816,6924,58126,4423,113892,4985,2390,2595
19510,120847,6925,58138,4423,113922,4986,2390,2596
19515,120878,6926,58154,4424,113952,4987,2391,2596
19520,120909,6928,58171,4426,113981,4988,2391,2597
19525,120940,6930,58186,4428,114010,4990,2391,2599
19530,120971,6932,58196,4429,114039,4992,2391,2601
19535,121002,6933,58215,4430,114069,4994,2392,2602
19540,121033,6934,58228,4430,114099,4996,2392,2604
19545,121064,6936,58239,4431,114128,4998,2394,2604
19550,121095,6939,58254,4434,114156,5000,2395,2605
19555,121126,6942,58271,4436,114184,5002,2396,2606
19560,121157,6944,58284,4437,114213,5004,2396,2608
19565,121188,6948,58297,4440,114240,5006,2397,2609
19570,121219,6951,58307,4441,114268,5008,2398,2610
19575,121250,6952,58322,4441,114298,5010,2400,2610
19580,121281,6953,58338,4442,114328,5011,2400,2611
19585,121312,6954,58358,4443,114358,5011,2400,2611
19590,121343,6955,58371,4443,114388,5011,2400,2611
19595,121374,6956,58388,4444,114418,5011,2400,2611
19600,121405,6957,58400,4445,114448,5011,2400,2611
19605,121436,6958,58419,4446,114478,5012,2401,2611
19610,121467,6959,58432,4447,114508,5013,2401,2612
19615,121498,6961,58447,4449,114537,5013,2401,2612
19620,121529,6963,58466,4451,114566,5013,2401,2612
19625,121560,6965,58484,4453,114594,5014,2402,2612
19630,121591,6967,58494,4455,114624,5015,2402,2613
19635,121622,6968,58510,4456,114654,5016,2403,2613
19640,121653,6969,58524,4457,114684,5017,2403,2614
19645,121684,6970,58540,4457,114713,5018,2403,2615
19650,121715,6972,58557,4459,114743,5019,2403,2616
19655,121746,6973,58567,4460,114773,5020,2403,2617
19660,121777,6974,58580,4461,114802,5021,2404,2617
19665,121808,6976,58598,4462,114831,5022,2404,2618
19670,121839,6978,58612,4463,114860,5023,2405,2618
19675,121870,6980,58625,4464,114890,5024,2405,2619
19680,121901,6982,58641,4465,114918,5025,2406,2619
19685,121932,6985,58657,4468,114947,5026,2407,2619
19690,121963,6987,58678,4470,114976,5029,2409,2620
19695,121994,6989,58695,4472,115005,5032,2411,2621
19700,122025,6991,58708,4473,115034,5035,2412,2623
19705,122056,6993,58720,4474,115063,5038,2413,2625
19710,122087,6995,58737,4475,115092,5041,2415,2626
19715,122118,6998,58750,4477,115120,5044,2415,2629
19720,122149,6998,58767,4477,115151,5047,2417,2630
19725,122180,6999,58783,4477,115180,5050,2419,2631
19730,122211,7001,58797,4479,115210,5052,2420,2632
19735,122242,7002,58812,4479,115240,5054,2422,2632
19740,122273,7003,58830,4480,115270,5057,2425,2632
19745,122304,7006,58842,4482,115298,5060,2425,2635
19750,122335,7008,58853,4484,115327,5063,2427,2636
19755,122366,7011,58867,4486,115355,5065,2427,2638
19760,122397,7013,58883,4486,115384,5066,2427,2639
19765,122428,7015,58897,4488,115413,5067,2428,2639
19770,122459,7018,58914,4490,115441,5068,2429,2639
19775,122490,7021,58930,4491,115469,5069,2429,2640
19780,122521,7023,58943,4491,115498,5070,2430,2640
19785,122552,7025,58957,4493,115527,5071,2430,2641
19790,122583,7028,58972,4495,115555,5072,2431,2641
19795,122614,7030,58983,4495,115584,5073,2432,2641
19800,122645,7032,58997,4496,115613,5074,2433,2641
19805,122676,7037,59014,4500,115639,5074,2433,2641
19810,122707,7040,59030,4502,115667,5074,2433,2641
19815,122738,7041,59046,4503,115697,5074,2433,2641
19820,122769,7042,59060,4503,115727,5074,2433,2641
19825,122800,7043,59075,4504,115757,5074,2433,2641
19830,122831,7044,59091,4504,115787,5074,2433,2641
19835,122862,7046,59104,4505,115816,5074,2433,2641
19840,122893,7048,59126,4507,115845,5074,2433,2641
19845,122924,7050,59142,4508,115874,5074,2433,2641
19850,122955,7050,59162,4508,115905,5075,2434,2641
19855,122986,7050,59172,4508,115936,5076,2435,2641
19860,123017,7050,59189,4508,115967,5079,2437,2642
19865,123048,7050,59202,4508,115998,5080,2438,2642
19870,123079,7050,59216,4508,116029,5081,2438,2643
19875,123110,7050,59232,4508,116060,5081,2438,2643
19880,123141,7050,59247,4508,116091,5081,2438,2643
19885,123172,7050,59261,4508,116122,5081,2438,2643
19890,123203,7050,59276,4508,116153,5081,2438,2643
19895,123234,7050,59288,4508,116184,5081,2438,2643
19900,123265,7050,59305,4508,116215,5081,2438,2643
19905,123296,7050,59322,4508,116246,5081,2438,2643
19910,123327,7051,59344,4509,116276,5082,2438,2644
19915,123358,7054,59365,4511,116304,5083,2439,2644
19920,123389,7056,59383,4513,116333,5084,2439,2645
19925,123420,7060,59394,4514,116360,5085,2439,2646
19930,123451,7062,59405,4515,116389,5086,2439,2647
19935,123482,7065,59423,4516,116417,5087,2440,2647
19940,123513,7067,59440,4518,116446,5088,2441,2647
19945,123544,7069,59454,4520,116475,5089,2441,2648
19950,123575,7071,59469,4521,116504,5090,2441,2649
19955,123606,7074,59486,4523,116532,5091,2442,2649
19960,123637,7077,59502,4525,116560,5092,2443,2649
19965,123668,7079,59514,4527,116589,5093,2443,2650
19970,123699,7081,59528,4528,116618,5094,2443,2651
19975,123730,7085,59541,4531,116645,5097,2444,2653
19980,123761,7089,59561,4533,116672,5100,2446,2654
19985,123792,7089,59578,4533,116703,5103,2448,2655
19990,123823,7089,59588,4533,116734,5105,2449,2656
19995,123854,7089,59605,4533,116765,5106,2450,2656
20000,123885,7089,59619,4533,116796,5107,2451,2656
20005,123916,7089,59631,4533,116827,5108,2451,2657
20010,123947,7089,59644,4533,116858,5109,2451,2658
20015,123978,7089,59653,4533,116889,5110,2451,2659
20020,124009,7089,59665,4533,116920,5111,2452,2659
20025,124040,7089,59681,4533,116951,5112,2452,2660
20030,124071,7089,59695,4533,116982,5113,2452,2661
20035,124102,7090,59703,4533,117012,5114,2452,2662
20040,124133,7092,59718,4535,117039,5115,2453,2662
20045,124164,7096,59737,4539,117067,5116,2454,2662
20050,124195,7098,59753,4540,117097,5117,2455,2662
20055,124226,7099,59766,4541,117127,5118,2455,2663
20060,124257,7100,59789,4542,117157,5119,2456,2663
20065,124288,7101,59803,4542,117187,5120,2457,2663
20070,124319,7102,59815,4542,117217,5121,2457,2664
20075,124350,7103,59833,4542,117246,5122,2458,2664
20080,124381,7105,59847,4543,117275,5123,2458,2665
20085,124412,7107,59867,4545,117305,5124,2459,2665
20090,124443,7109,59882,4547,117334,5125,2460,2665
20095,124474,7111,59893,4548,117363,5127,2460,2667
20100,124505,7113,59904,4550,117392,5130,2461,2669
20105,124536,7116,59921,4553,117420,5133,2462,2671
20110,124567,7118,59935,4553,117449,5136,2464,2672
20115,124598,7121,59953,4555,117477,5137,2465,2672
20120,124629,7124,59970,4556,117505,5138,2465,2673
20125,124660,7127,59987,4559,117533,5139,2466,2673
20130,124691,7128,60003,4559,117563,5140,2467,2673
20135,124722,7129,60017,4559,117593,5141,2467,2674
20140,124753,7130,60029,4559,117623,5142,2467,2675
20145,124784,7131,60042,4559,117653,5143,2468,2675
20150,124815,7133,60058,4560,117682,5144,2468,2676
20155,124846,7135,60071,4561,117711,5145,2468,2677
20160,124877,7138,60086,4562,117739,5146,2469,2677
20165,124908,7144,60102,4567,117763,5147,2469,2678
20170,124939,7150,60116,4571,117788,5148,2470,2678
20175,124970,7155,60135,4575,117814,5149,2470,2679
20180,125001,7159,60153,4578,117841,5150,2471,2679
20185,125032,7161,60170,4579,117871,5151,2471,2680
20190,125063,7162,60183,4580,117901,5152,2471,2681
20195,125094,7163,60196,4581,117931,5153,2472,2681
20200,125125,7165,60216,4583,117960,5154,2473,2681
20205,125156,7167,60236,4585,117989,5155,2473,2682
20210,125187,7168,60251,4585,118019,5156,2474,2682
20215,125218,7169,60267,4585,118049,5159,2477,2682
20220,125249,7170,60282,4585,118079,5162,2479,2683
20225,125280,7171,60292,4585,118109,5164,2480,2684
20230,125311,7173,60305,4587,118138,5165,2480,2685
20235,125342,7174,60320,4587,118168,5166,2480,2686
20240,125373,7175,60336,4587,118198,5167,2481,2686
20245,125404,7176,60354,4587,118228,5168,2481,2687
20250,125435,7177,60367,4587,118258,5169,2481,2688
20255,125466,7178,60384,4587,118288,5170,2482,2688
20260,125497,7179,60399,4588,118318,5171,2483,2688
20265,125528,7180,60414,4588,118348,5172,2483,2689
20270,125559,7180,60427,4588,118379,5173,2484,2689
20275,125590,7180,60445,4588,118410,5174,2485,2689
20280,125621,7181,60460,4589,118440,5175,2485,2690
20285,125652,7183,60475,4591,118469,5176,2486,2690
20290,125683,7185,60491,4592,118497,5177,2487,2690
20295,125714,7188,60507,4593,118526,5178,2488,2690
20300,125745,7191,60523,4594,118553,5179,2488,2691
20305,125776,7194,60533,4595,118581,5180,2489,2691
20310,125807,7197,60548,4597,118610,5181,2489,2692
20315,125838,7200,60568,4600,118637,5182,2490,2692
20320,125869,7203,60583,4603,118665,5183,2490,2693
20325,125900,7208,60598,4607,118691,5184,2491,2693
20330,125931,7212,60615,4609,118718,5186,2492,2694
20335,125962,7216,60632,4613,118745,5188,2492,2696
20340,125993,7219,60650,4615,118773,5190,2494,2696
20345,126024,7222,60667,4618,118802,5192,2495,2697
20350,126055,7223,60684,4619,118832,5194,2496,2698
20355,126086,7224,60696,4620,118862,5196,2496,2700
20360,126117,7225,60709,4621,118892,5198,2496,2702
20365,126148,7226,60721,4622,118922,5199,2496,2703
20370,126179,7227,60735,4622,118952,5200,2497,2703
20375,126210,7229,60745,4623,118981,5201,2497,2704
20380,126241,7231,60759,4624,119010,5202,2497,2705
20385,126272,7233,60773,4626,119039,5203,2497,2706
20390,126303,7235,60789,4627,119068,5204,2498,2706
20395,126334,7237,60805,4628,119097,5205,2499,2706
20400,126365,7239,60821,4628,119126,5206,2500,2706
20405,126396,7241,60836,4628,119155,5207,2501,2706
20410,126427,7244,60848,4630,119183,5208,2501,2707
20415,126458,7247,60862,4631,119211,5209,2502,2707
20420,126489,7249,60873,4632,119240,5210,2502,2708
20425,126520,7252,60888,4634,119268,5211,2502,2709
20430,126551,7254,60902,4635,119297,5212,2503,2709
20435,126582,7257,60918,4637,119325,5213,2504,2709
20440,126613,7260,60933,4639,119353,5214,2505,2709
20445,126644,7264,60953,4642,119379,5216,2506,2710
20450,126675,7268,60970,4645,119406,5218,2507,2711
20455,126706,7273,60989,4649,119433,5220,2507,2713
20460,126737,7275,60999,4649,119461,5221,2507,2714
20465,126768,7278,61014,4651,119489,5222,2508,2714
20470,126799,7281,61030,4654,119516,5223,2508,2715
20475,126830,7285,61044,4657,119545,5224,2509,2715
20480,126861,7287,61061,4658,119574,5225,2510,2715
20485,126892,7289,61075,4659,119603,5226,2511,2715
20490,126923,7291,61094,4660,119632,5227,2512,2715
20495,126954,7293,61109,4661,119661,5228,2513,2715
20500,126985,7295,61120,4663,119690,5229,2513,2716
20505,127016,7298,61135,4665,119718,5230,2513,2717
20510,127047,7301,61151,4667,119746,5231,2514,2717
20515,127078,7304,61172,4670,119774,5232,2514,2718
20520,127109,7305,61191,4670,119804,5233,2514,2719
20525,127140,7308,61205,4673,119831,5234,2515,2719
20530,127171,7310,61221,4675,119860,5235,2515,2720
20535,127202,7312,61236,4677,119889,5236,2515,2721
20540,127233,7314,61250,4679,119919,5237,2515,2722
20545,127264,7315,61264,4680,119949,5238,2515,2723
20550,127295,7317,61277,4681,119977,5239,2516,2723
20555,127326,7319,61295,4682,120006,5240,2516,2724
20560,127357,7322,61312,4685,120034,5243,2518,2725
20565,127388,7324,61326,4686,120064,5245,2519,2726
20570,127419,7325,61341,4687,120094,5247,2519,2728
20575,127450,7326,61359,4687,120124,5249,2521,2728
20580,127481,7327,61372,4687,120154,5251,2522,2729
20585,127512,7330,61386,4689,120182,5252,2522,2730
20590,127543,7332,61396,4689,120211,5253,2522,2731
20595,127574,7336,61407,4692,120238,5254,2522,2732
20600,127605,7340,61426,4694,120265,5255,2523,2732
20605,127636,7342,61443,4696,120294,5256,2524,2732
20610,127667,7345,61460,4699,120322,5257,2524,2733
20615,127698,7348,61473,4701,120350,5258,2524,2734
20620,127729,7349,61485,4702,120380,5259,2524,2735
20625,127760,7350,61500,4702,120410,5260,2524,2736
20630,127791,7351,61517,4702,120440,5261,2525,2736
20635,127822,7352,61529,4702,120470,5262,2525,2737
20640,127853,7353,61545,4702,120500,5263,2526,2737
20645,127884,7353,61555,4702,120531,5263,2526,2737
20650,127915,7353,61567,4702,120562,5263,2526,2737
20655,127946,7353,61583,4702,120593,5263,2526,2737
20660,127977,7353,61597,4702,120624,5263,2526,2737
20665,128008,7353,61611,4702,120655,5263,2526,2737
20670,128039,7353,61627,4702,120686,5263,2526,2737
20675,128070,7353,61640,4702,120717,5263,2526,2737
20680,128101,7353,61656,4702,120748,5263,2526,2737
20685,128132,7353,61674,4702,120778,5263,2526,2737
20690,128163,7356,61685,4704,120804,5264,2527,2737
20695,128194,7360,61700,4707,120833,5265,2528,2737
20700,128225,7363,61709,4709,120861,5266,2528,2738
20705,128256,7367,61726,4712,120889,5268,2529,2739
20710,128287,7370,61742,4715,120917,5269,2530,2739
20715,128318,7371,61760,4716,120947,5270,2531,2739
20720,128349,7373,61773,4718,120976,5271,2531,2740
20725,128380,7374,61785,4718,121006,5272,2531,2741
20730,128411,7377,61803,4721,121034,5273,2531,2742
20735,128442,7379,61816,4722,121063,5274,2531,2743
20740,128473,7382,61833,4724,121091,5275,2531,2744
20745,128504,7384,61848,4725,121120,5276,2531,2745
20750,128535,7386,61863,4726,121149,5277,2532,2745
20755,128566,7390,61877,4728,121176,5278,2532,2746
20760,128597,7393,61890,4729,121204,5279,2532,2747
20765,128628,7394,61909,4729,121234,5280,2532,2748
20770,128659,7395,61919,4729,121264,5281,2533,2748
20775,128690,7396,61932,4729,121294,5282,2533,2749
20780,128721,7397,61948,4730,121324,5283,2533,2750
20785,128752,7398,61962,4730,121354,5284,2533,2751
20790,128783,7399,61978,4731,121384,5285,2533,2752
20795,128814,7400,61991,4732,121414,5286,2534,2752
20800,128845,7401,62008,4733,121444,5287,2535,2752
20805,128876,7402,62021,4733,121474,5288,2536,2752
20810,128907,7403,62042,4734,121503,5289,2537,2752
20815,128938,7406,62054,4736,121529,5291,2537,2754
20820,128969,7412,62072,4741,121555,5293,2539,2754
20825,129000,7417,62083,4743,121583,5295,2539,2756
20830,129031,7420,62099,4745,121611,5297,2540,2757
20835,129062,7424,62114,4749,121638,5299,2540,2759
20840,129093,7427,62134,4752,121666,5301,2542,2759
20845,129124,7430,62150,4755,121694,5302,2543,2759
20850,129155,7432,62161,4755,121723,5303,2544,2759
20855,129186,7435,62177,4757,121751,5304,2545,2759
20860,129217,7437,62188,4758,121780,5305,2546,2759
20865,129248,7440,62202,4760,121808,5306,2546,2760
20870,129279,7442,62218,4762,121837,5307,2546,2761
20875,129310,7446,62233,4766,121864,5308,2547,2761
20880,129341,7448,62242,4767,121893,5309,2547,2762
20885,129372,7449,62254,4767,121923,5310,2547,2763
20890,129403,7451,62268,4768,121952,5311,2547,2764
20895,129434,7451,62287,4768,121983,5312,2547,2765
20900,129465,7451,62303,4768,122014,5313,2547,2766
20905,129496,7451,62318,4768,122045,5314,2547,2767
20910,129527,7451,62327,4768,122076,5315,2547,2768
20915,129558,7451,62342,4768,122107,5316,2548,2768
20920,129589,7451,62356,4768,122138,5317,2549,2768
20925,129620,7451,62370,4768,122169,5318,2550,2768
20930,129651,7451,62382,4768,122200,5319,2551,2768
20935,129682,7451,62400,4768,122231,5320,2552,2768
20940,129713,7451,62420,4768,122262,5321,2553,2768
20945,129744,7454,62431,4770,122290,5322,2553,2769
20950,129775,7459,62447,4774,122316,5324,2554,2770
20955,129806,7463,62463,4777,122343,5326,2556,2770
20960,129837,7466,62477,4777,122371,5327,2556,2771
20965,129868,7470,62495,4779,122398,5328,2557,2771
20970,129899,7473,62510,4780,122426,5329,2558,2771
20975,129930,7476,62526,4781,122454,5330,2558,2772
20980,129961,7480,62544,4784,122481,5331,2559,2772
20985,129992,7484,62558,4786,122508,5332,2560,2772
20990,130023,7488,62578,4790,122535,5333,2561,2772
20995,130054,7489,62597,4791,122565,5334,2562,2772
21000,130085,7490,62612,4791,122595,5335,2562,2773
21005,130116,7491,62629,4792,122625,5336,2562,2774
21010,130147,7492,62642,4792,122655,5337,2562,2775
21015,130178,7493,62657,4793,122685,5338,2562,2776
21020,130209,7495,62675,4794,122714,5339,2563,2776
21025,130240,7497,62689,4795,122743,5340,2564,2776
21030,130271,7498,62704,4795,122773,5341,2564,2777
21035,130302,7500,62720,4797,122802,5342,2565,2777
21040,130333,7501,62735,4798,122832,5343,2565,2778
21045,130364,7503,62753,4800,122860,5345,2566,2779
21050,130395,7505,62766,4801,122890,5347,2567,2780
21055,130426,7506,62778,4801,122919,5349,2568,2781
21060,130457,7509,62791,4803,122948,5351,2569,2782
21065,130488,7511,62806,4805,122977,5352,2570,2782
21070,130519,7514,62826,4808,123005,5352,2570,2782
21075,130550,7516,62837,4809,123034,5352,2570,2782
21080,130581,7518,62849,4811,123063,5352,2570,2782
21085,130612,7520,62866,4812,123092,5352,2570,2782
21090,130643,7520,62881,4812,123123,5352,2570,2782
21095,130674,7520,62895,4812,123154,5352,2570,2782
21100,130705,7520,62913,4812,123185,5352,2570,2782
21105,130736,7520,62928,4812,123216,5352,2570,2782
21110,130767,7520,62948,4812,123247,5352,2570,2782
21115,130798,7520,62962,4812,123278,5352,2570,2782
21120,130829,7520,62977,4812,123309,5352,2570,2782
21125,130860,7520,62994,4812,123340,5353,2571,2782
21130,130891,7520,63010,4812,123371,5354,2572,2782
21135,130922,7520,63028,4812,123402,5354,2572,2782
21140,130953,7520,63045,4812,123433,5354,2572,2782
21145,130984,7520,63064,4812,123464,5354,2572,2782
21150,131015,7520,63074,4812,123495,5354,2572,2782
21155,131046,7520,63090,4812,123526,5354,2572,2782
21160,131077,7520,63103,4812,123557,5354,2572,2782
21165,131108,7522,63119,4814,123586,5354,2572,2782
21170,131139,7524,63137,4815,123613,5356,2573,2783
21175,131170,7530,63155,4821,123639,5358,2575,2783
21180,131201,7536,63170,4826,123663,5360,2576,2784
21185,131232,7540,63190,4829,123692,5361,2576,2785
21190,131263,7541,63205,4829,123722,5362,2576,2786
21195,131294,7542,63217,4829,123752,5363,2576,2787
21200,131325,7544,63233,4830,123781,5364,2577,2787
21205,131356,7545,63241,4830,123811,5365,2577,2788
21210,131387,7546,63257,4830,123841,5366,2578,2788
21215,131418,7548,63271,4831,123870,5367,2579,2788
21220,131449,7550,63292,4833,123899,5368,2580,2788
21225,131480,7551,63302,4833,123929,5369,2580,2789
21230,131511,7553,63313,4834,123958,5370,2581,2789
21235,131542,7554,63329,4834,123988,5372,2582,2790
21240,131573,7555,63344,4835,124018,5374,2584,2790
21245,131604,7556,63358,4836,124048,5376,2584,2792
21250,131635,7557,63369,4836,124078,5377,2584,2793
21255,131666,7559,63386,4837,124107,5378,2584,2794
21260,131697,7561,63400,4839,124136,5379,2584,2795
21265,131728,7562,63415,4839,124166,5380,2584,2796
21270,131759,7563,63429,4840,124196,5381,2585,2796
21275,131790,7564,63449,4841,124226,5382,2586,2796
21280,131821,7565,63465,4841,124256,5383,2587,2796
21285,131852,7566,63478,4841,124286,5384,2587,2797
21290,131883,7570,63496,4844,124312,5386,2589,2797
21295,131914,7575,63506,4848,124339,5388,2590,2798
21300,131945,7581,63523,4852,124363,5390,2590,2800
21305,131976,7583,63537,4853,124393,5391,2591,2800
21310,132007,7584,63550,4854,124423,5392,2591,2801
21315,132038,7585,63569,4854,124453,5393,2591,2802
21320,132069,7586,63585,4855,124483,5394,2591,2803
21325,132100,7587,63604,4856,124513,5395,2592,2803
21330,132131,7588,63618,4856,124543,5396,2593,2803
21335,132162,7589,63637,4857,124573,5397,2594,2803
21340,132193,7590,63652,4857,124603,5398,2594,2804
21345,132224,7591,63668,4857,124633,5399,2595,2804
21350,132255,7593,63682,4859,124662,5401,2596,2805
21355,132286,7594,63696,4859,124692,5403,2596,2807
21360,132317,7595,63711,4860,124722,5405,2598,2807
21365,132348,7596,63725,4861,124752,5407,2599,2808
21370,132379,7597,63741,4861,124782,5408,2599,2809
21375,132410,7598,63755,4861,124812,5409,2599,2810
21380,132441,7600,63770,4862,124841,5410,2600,2810
21385,132472,7601,63784,4862,124871,5411,2601,2810
21390,132503,7603,63799,4864,124900,5412,2601,2811
21395,132534,7604,63817,4865,124930,5413,2602,2811
21400,132565,7605,63830,4865,124960,5414,2602,2812
21405,132596,7606,63845,4866,124990,5415,2603,2812
21410,132627,7608,63861,4868,125019,5416,2604,2812
21415,132658,7612,63875,4871,125046,5418,2606,2812
21420,132689,7616,63889,4875,125073,5420,2606,2814
21425,132720,7617,63905,4876,125103,5421,2607,2814
21430,132751,7619,63925,4877,125132,5422,2607,2815
21435,132782,7620,63937,4877,125162,5423,2608,2815
21440,132813,7621,63953,4877,125192,5424,2609,2815
21445,132844,7623,63973,4879,125221,5425,2609,2816
21450,132875,7624,63992,4879,125251,5426,2610,2816
21455,132906,7625,64002,4879,125281,5427,2610,2817
21460,132937,7627,64020,4881,125310,5428,2610,2818
21465,132968,7628,64035,4882,125340,5429,2610,2819
21470,132999,7629,64043,4882,125370,5431,2611,2820
21475,133030,7630,64054,4882,125400,5433,2612,2821
21480,133061,7632,64071,4884,125429,5435,2614,2821
21485,133092,7634,64089,4886,125458,5437,2615,2822
21490,133123,7635,64108,4887,125488,5438,2616,2822
21495,133154,7636,64126,4888,125518,5439,2616,2823
21500,133185,7637,64143,4888,125548,5440,2616,2824
21505,133216,7638,64162,4888,125578,5441,2616,2825
21510,133247,7639,64176,4888,125608,5442,2617,2825
21515,133278,7640,64193,4889,125638,5443,2617,2826
21520,133309,7640,64204,4889,125669,5444,2617,2827
21525,133340,7642,64222,4891,125698,5445,2618,2827
21530,133371,7645,64237,4893,125726,5446,2619,2827
21535,133402,7649,64248,4896,125753,5448,2619,2829
21540,133433,7652,64259,4897,125781,5450,2620,2830
21545,133464,7654,64276,4899,125810,5451,2621,2830
21550,133495,7655,64289,4899,125840,5452,2621,2831
21555,133526,7656,64306,4899,125870,5453,2622,2831
21560,133557,7657,64321,4900,125900,5454,2622,2832
21565,133588,7659,64335,4901,125929,5455,2623,2832
21570,133619,7660,64350,4902,125959,5456,2624,2832
21575,133650,7662,64365,4904,125988,5457,2625,2832
21580,133681,7662,64383,4904,126019,5458,2626,2832
21585,133712,7662,64395,4904,126050,5459,2626,2833
21590,133743,7662,64413,4904,126081,5460,2627,2833
21595,133774,7662,64427,4904,126112,5462,2628,2834
21600,133805,7662,64444,4904,126143,5464,2628,2836
21605,133836,7663,64458,4905,126173,5465,2629,2836
21610,133867,7664,64467,4905,126203,5466,2629,2837
21615,133898,7665,64488,4906,126233,5467,2630,2837
21620,133929,7667,64502,4908,126262,5468,2630,2838
21625,133960,7668,64521,4908,126292,5469,2630,2839
21630,133991,7669,64530,4908,126322,5470,2630,2840
21635,134022,7670,64545,4908,126352,5471,2630,2841
21640,134053,7672,64560,4910,126381,5472,2631,2841
21645,134084,7672,64573,4910,126412,5473,2631,2842
21650,134115,7675,64587,4912,126439,5474,2631,2843
21655,134146,7680,64600,4915,126465,5475,2632,2843
21660,134177,7686,64615,4920,126490,5476,2633,2843
21665,134208,7690,64632,4923,126518,5476,2633,2843
21670,134239,7690,64644,4923,126549,5476,2633,2843
21675,134270,7690,64659,4923,126580,5476,2633,2843
21680,134301,7690,64672,4923,126611,5476,2633,2843
21685,134332,7690,64686,4923,126642,5476,2633,2843
21690,134363,7690,64702,4923,126673,5476,2633,2843
21695,134394,7690,64712,4923,126704,5476,2633,2843
21700,134425,7690,64727,4923,126735,5476,2633,2843
21705,134456,7690,64741,4923,126766,5476,2633,2843
21710,134487,7690,64753,4923,126797,5477,2633,2844
21715,134518,7690,64766,4923,126828,5478,2634,2844
21720,134549,7690,64778,4923,126859,5479,2635,2844
21725,134580,7692,64795,4924,126888,5479,2635,2844
21730,134611,7694,64807,4926,126917,5479,2635,2844
21735,134642,7695,64824,4927,126947,5479,2635,2844
21740,134673,7697,64837,4929,126976,5479,2635,2844
21745,134704,7699,64853,4931,127005,5479,2635,2844
21750,134735,7700,64870,4931,127035,5479,2635,2844
21755,134766,7701,64884,4932,127065,5479,2635,2844
21760,134797,7702,64900,4932,127095,5479,2635,2844
21765,134828,7704,64917,4934,127124,5479,2635,2844
21770,134859,7710,64931,4937,127149,5480,2635,2845
21775,134890,7715,64946,4941,127175,5481,2635,2846
21780,134921,7718,64962,4943,127203,5482,2636,2846
21785,134952,7722,64976,4946,127230,5483,2636,2847
21790,134983,7725,64993,4949,127258,5484,2637,2847
21795,135014,7727,65007,4951,127287,5485,2638,2847
21800,135045,7729,65024,4952,127316,5486,2639,2847
21805,135076,7730,65037,4952,127346,5487,2640,2847
21810,135107,7731,65055,4952,127376,5488,2641,2847
21815,135138,7732,65071,4952,127406,5489,2641,2848
21820,135169,7733,65084,4952,127436,5490,2641,2849
21825,135200,7734,65100,4952,127466,5491,2642,2849
21830,135231,7735,65109,4952,127496,5493,2642,2851
21835,135262,7736,65127,4952,127526,5495,2643,2852
21840,135293,7737,65140,4952,127556,5496,2643,2853
21845,135324,7737,65152,4952,127587,5498,2644,2854
21850,135355,7737,65169,4952,127618,5500,2645,2855
21855,135386,7737,65181,4952,127649,5501,2645,2856
21860,135417,7737,65200,4952,127680,5502,2646,2856
21865,135448,7737,65212,4952,127711,5503,2646,2857
21870,135479,7737,65228,4952,127742,5504,2647,2857
21875,135510,7737,65241,4952,127773,5505,2648,2857
21880,135541,7738,65257,4952,127803,5506,2648,2858
21885,135572,7739,65269,4952,127833,5507,2648,2859
21890,135603,7740,65282,4953,127862,5508,2648,2860
21895,135634,7742,65293,4954,127892,5509,2648,2861
21900,135665,7745,65307,4957,127920,5510,2648,2862
21905,135696,7748,65323,4959,127947,5511,2649,2862
21910,135727,7751,65338,4960,127975,5512,2649,2863
21915,135758,7755,65355,4963,128001,5513,2650,2863
21920,135789,7761,65371,4969,128028,5514,2650,2864
21925,135820,7762,65387,4970,128058,5515,2651,2864
21930,135851,7763,65408,4971,128088,5516,2652,2864
21935,135882,7765,65425,4973,128117,5517,2652,2865
21940,135913,7767,65440,4974,128146,5518,2653,2865
21945,135944,7768,65454,4975,128176,5519,2654,2865
21950,135975,7769,65468,4976,128206,5520,2654,2866
21955,136006,7770,65485,4977,128236,5521,2654,2867
21960,136037,7772,65501,4979,128265,5522,2655,2867
21965,136068,7777,65519,4983,128290,5524,2656,2868
21970,136099,7782,65535,4987,128316,5526,2657,2869
21975,136130,7786,65551,4990,128344,5527,2657,2870
21980,136161,7787,65567,4991,128374,5528,2657,2871
21985,136192,7787,65578,4991,128405,5529,2658,2871
21990,136223,7787,65592,4991,128436,5530,2658,2872
21995,136254,7787,65608,4991,128467,5531,2658,2873
22000,136285,7787,65621,4991,128498,5532,2659,2873
22005,136316,7787,65634,4991,128529,5533,2659,2874
22010,136347,7787,65653,4991,128560,5534,2660,2874
22015,136378,7787,65663,4991,128591,5535,2660,2875
22020,136409,7787,65681,4991,128622,5536,2661,2875
22025,136440,7790,65695,4993,128650,5537,2661,2876
22030,136471,7791,65709,4993,128680,5538,2661,2877
22035,136502,7792,65723,4993,128710,5539,2662,2877
22040,136533,7793,65739,4993,128740,5540,2662,2878
22045,136564,7794,65762,4994,128770,5541,2662,2879
22050,136595,7795,65777,4994,128800,5542,2663,2879
22055,136626,7796,65794,4994,128830,5543,2664,2879
22060,136657,7797,65808,4995,128860,5544,2664,2880
22065,136688,7798,65816,4996,128890,5545,2664,2881
22070,136719,7800,65830,4997,128919,5546,2665,2881
22075,136750,7802,65849,4999,128948,5548,2667,2881
22080,136781,7805,65867,5001,128974,5550,2668,2882
22085,136812,7810,65881,5005,129002,5552,2670,2882
22090,136843,7814,65897,5008,129029,5554,2672,2882
22095,136874,7817,65914,5010,129057,5556,2673,2883
22100,136905,7818,65931,5011,129087,5558,2674,2884
22105,136936,7819,65949,5012,129117,5560,2675,2885
22110,136967,7820,65964,5012,129147,5562,2675,2887
22115,136998,7821,65975,5013,129177,5563,2675,2888
22120,137029,7822,65983,5013,129207,5564,2675,2889
22125,137060,7823,65993,5014,129237,5565,2675,2890
22130,137091,7825,66011,5015,129266,5566,2676,2890
22135,137122,7827,66022,5015,129295,5567,2677,2890
22140,137153,7830,66034,5017,129323,5568,2677,2891
22145,137184,7834,66054,5020,129350,5570,2678,2892
22150,137215,7836,66068,5021,129379,5572,2679,2893
22155,137246,7838,66082,5023,129408,5573,2679,2894
22160,137277,7840,66093,5024,129437,5574,2680,2894
22165,137308,7840,66110,5024,129468,5575,2680,2895
22170,137339,7840,66120,5024,129499,5576,2680,2896
22175,137370,7840,66138,5024,129530,5577,2680,2897
22180,137401,7840,66153,5024,129561,5578,2681,2897
22185,137432,7840,66167,5024,129592,5579,2682,2897
22190,137463,7840,66186,5024,129623,5580,2682,2898
22195,137494,7840,66206,5024,129654,5581,2682,2899
22200,137525,7840,66219,5024,129685,5582,2682,2900
22205,137556,7840,66230,5024,129716,5584,2683,2901
22210,137587,7840,66244,5024,129747,5585,2683,2902
22215,137618,7840,66262,5024,129778,5586,2684,2902
22220,137649,7840,66275,5024,129809,5587,2684,2903
22225,137680,7840,66288,5024,129840,5588,2684,2904
22230,137711,7840,66300,5024,129871,5589,2685,2904
22235,137742,7840,66316,5024,129902,5590,2685,2905
22240,137773,7840,66332,5024,129933,5591,2686,2905
22245,137804,7840,66348,5024,129964,5592,2687,2905
22250,137835,7842,66361,5025,129993,5593,2687,2906
22255,137866,7845,66375,5028,130019,5594,2687,2907
22260,137897,7849,66386,5031,130048,5596,2687,2909
22265,137928,7852,66402,5032,130076,5597,2688,2909
22270,137959,7855,66420,5035,130104,5598,2689,2909
22275,137990,7858,66438,5037,130132,5599,2690,2909
22280,138021,7861,66453,5039,130160,5600,2690,2910
22285,138052,7863,66470,5039,130189,5601,2691,2910
22290,138083,7866,66484,5041,130217,5602,2692,2910
22295,138114,7867,66499,5042,130247,5603,2692,2911
22300,138145,7868,66514,5043,130277,5604,2692,2912
22305,138176,7869,66529,5043,130307,5604,2692,2912
22310,138207,7870,66545,5044,130337,5605,2693,2912
22315,138238,7871,66554,5045,130367,5606,2693,2913
22320,138269,7872,66572,5045,130397,5607,2693,2914
22325,138300,7873,66590,5045,130427,5608,2693,2915
22330,138331,7874,66609,5046,130457,5608,2693,2915
22335,138362,7875,66623,5046,130487,5608,2693,2915
22340,138393,7876,66638,5047,130517,5608,2693,2915
22345,138424,7877,66654,5048,130547,5608,2693,2915
22350,138455,7878,66668,5048,130577,5608,2693,2915
22355,138486,7879,66680,5048,130607,5608,2693,2915
22360,138517,7880,66695,5049,130637,5608,2693,2915
22365,138548,7883,66710,5051,130665,5609,2694,2915
22370,138579,7887,66725,5053,130692,5610,2694,2916
22375,138610,7889,66739,5053,130720,5611,2695,2916
22380,138641,7893,66751,5055,130747,5612,2695,2917
22385,138672,7895,66766,5056,130777,5613,2695,2918
22390,138703,7896,66779,5056,130807,5614,2696,2918
22395,138734,7897,66794,5057,130837,5615,2697,2918
22400,138765,7898,66809,5058,130867,5616,2697,2919
22405,138796,7899,66820,5059,130897,5617,2697,2920
22410,138827,7900,66835,5059,130927,5618,2697,2921
22415,138858,7901,66849,5059,130957,5619,2698,2921
22420,138889,7902,66864,5060,130987,5620,2699,2921
22425,138920,7903,66884,5061,131017,5621,2699,2922
22430,138951,7904,66897,5061,131047,5622,2699,2923
22435,138982,7906,66915,5063,131076,5624,2700,2924
22440,139013,7907,66936,5064,131106,5626,2702,2924
22445,139044,7909,66952,5065,131135,5628,2704,2924
22450,139075,7910,66970,5066,131165,5631,2707,2924
22455,139106,7912,66983,5067,131194,5634,2708,2926
22460,139137,7914,66996,5069,131223,5636,2709,2927
22465,139168,7915,67009,5070,131253,5638,2710,2928
22470,139199,7917,67022,5071,131282,5640,2711,2929
22475,139230,7918,67039,5072,131312,5642,2713,2929
22480,139261,7920,67056,5073,131341,5644,2713,2931
22485,139292,7921,67069,5073,131370,5646,2715,2931
22490,139323,7924,67086,5076,131398,5647,2716,2931
22495,139354,7928,67103,5080,131424,5648,2716,2932
22500,139385,7933,67118,5083,131451,5649,2717,2932
22505,139416,7937,67137,5087,131479,5650,2717,2933
22510,139447,7939,67153,5089,131508,5651,2718,2933
22515,139478,7940,67171,5090,131538,5652,2718,2934
22520,139509,7942,67186,5091,131567,5653,2719,2934
22525,139540,7943,67202,5091,131597,5654,2720,2934
22530,139571,7944,67215,5092,131627,5655,2720,2935
22535,139602,7945,67226,5093,131657,5656,2720,2936
22540,139633,7947,67242,5094,131686,5657,2720,2937
22545,139664,7948,67259,5094,131716,5658,2721,2937
22550,139695,7950,67274,5095,131745,5659,2721,2938
22555,139726,7952,67291,5096,131774,5660,2721,2939
22560,139757,7953,67306,5097,131804,5662,2723,2939
22565,139788,7954,67318,5097,131834,5664,2723,2941
22570,139819,7955,67334,5097,131864,5666,2724,2942
22575,139850,7956,67349,5098,131894,5667,2725,2942
22580,139881,7958,67362,5099,131923,5668,2726,2942
22585,139912,7959,67374,5099,131953,5669,2726,2943
22590,139943,7959,67388,5099,131984,5670,2727,2943
22595,139974,7959,67406,5099,132015,5672,2729,2943
22600,140005,7959,67419,5099,132046,5674,2730,2944
22605,140036,7959,67435,5099,132076,5676,2732,2944
22610,140067,7963,67454,5102,132102,5678,2734,2944
22615,140098,7969,67469,5106,132128,5680,2736,2944
22620,140129,7973,67480,5108,132156,5682,2736,2946
22625,140160,7977,67493,5111,132183,5684,2736,2948
22630,140191,7980,67503,5112,132211,5685,2736,2949
22635,140222,7983,67522,5115,132239,5686,2736,2950
22640,140253,7987,67534,5119,132266,5687,2736,2951
22645,140284,7990,67545,5121,132294,5688,2736,2952
22650,140315,7993,67558,5121,132322,5689,2737,2952
22655,140346,7995,67568,5121,132351,5690,2738,2952
22660,140377,7996,67584,5122,132381,5691,2738,2953
22665,140408,7997,67600,5123,132411,5692,2739,2953
22670,140439,7998,67620,5124,132441,5693,2740,2953
22675,140470,7999,67636,5124,132471,5695,2740,2955
22680,140501,8000,67648,5124,132501,5697,2741,2956
22685,140532,8001,67655,5124,132531,5699,2742,2957
22690,140563,8002,67667,5124,132561,5701,2743,2958
22695,140594,8003,67684,5124,132591,5702,2744,2958
22700,140625,8004,67694,5125,132621,5703,2744,2959
22705,140656,8005,67709,5126,132651,5704,2744,2960
22710,140687,8006,67727,5127,132681,5705,2745,2960
22715,140718,8008,67744,5129,132710,5706,2746,2960
22720,140749,8008,67759,5129,132741,5707,2747,2960
22725,140780,8008,67771,5129,132772,5708,2748,2960
22730,140811,8008,67783,5129,132803,5710,2748,2962
22735,140842,8008,67797,5129,132834,5712,2749,2963
22740,140873,8008,67816,5129,132865,5714,2749,2965
22745,140904,8013,67832,5133,132891,5716,2750,2966
22750,140935,8016,67843,5135,132919,5718,2750,2968
22755,140966,8017,67857,5136,132949,5720,2751,2969
22760,140997,8019,67871,5138,132978,5722,2751,2971
22765,141028,8020,67889,5139,133008,5724,2753,2971
22770,141059,8021,67900,5139,133038,5726,2754,2972
22775,141090,8022,67914,5140,133068,5728,2755,2973
22780,141121,8024,67931,5141,133097,5730,2756,2974
22785,141152,8024,67941,5141,133128,5732,2757,2975
22790,141183,8024,67956,5141,133159,5733,2757,2976
22795,141214,8024,67965,5141,133190,5735,2759,2976
22800,141245,8024,67984,5141,133221,5737,2760,2977
22805,141276,8024,68002,5141,133252,5739,2760,2979
22810,141307,8024,68014,5141,133283,5740,2761,2979
22815,141338,8024,68025,5141,133314,5741,2761,2980
22820,141369,8024,68038,5141,133345,5742,2762,2980
22825,141400,8024,68056,5141,133376,5743,2762,2981
22830,141431,8024,68072,5141,133407,5744,2763,2981
22835,141462,8024,68088,5141,133438,5745,2764,2981
22840,141493,8024,68106,5141,133469,5746,2764,2982
22845,141524,8024,68118,5141,133500,5747,2764,2983
22850,141555,8025,68129,5141,133530,5748,2764,2984
22855,141586,8027,68138,5141,133559,5749,2764,2985
22860,141617,8030,68155,5143,133585,5750,2764,2986
22865,141648,8034,68169,5146,133614,5751,2764,2987
22870,141679,8036,68184,5147,133643,5752,2764,2988
22875,141710,8039,68196,5149,133671,5753,2765,2988
22880,141741,8042,68219,5152,133699,5754,2766,2988
22885,141772,8044,68232,5152,133728,5755,2767,2988
22890,141803,8045,68245,5153,133758,5756,2767,2989
22895,141834,8046,68261,5154,133788,5757,2768,2989
22900,141865,8048,68271,5156,133817,5758,2769,2989
22905,141896,8049,68286,5157,133847,5759,2769,2990
22910,141927,8051,68300,5158,133876,5761,2770,2991
22915,141958,8053,68314,5159,133905,5763,2772,2991
22920,141989,8054,68329,5160,133935,5765,2772,2993
22925,142020,8058,68347,5162,133962,5767,2772,2995
22930,142051,8060,68365,5162,133991,5768,2772,2996
22935,142082,8063,68379,5164,134019,5769,2773,2996
22940,142113,8066,68397,5167,134047,5770,2774,2996
22945,142144,8068,68416,5169,134076,5771,2775,2996
22950,142175,8069,68429,5169,134106,5772,2776,2996
22955,142206,8070,68441,5170,134136,5773,2777,2996
22960,142237,8071,68455,5171,134166,5774,2777,2997
22965,142268,8072,68466,5171,134195,5775,2778,2997
22970,142299,8074,68476,5172,134224,5776,2778,2998
22975,142330,8076,68490,5174,134254,5777,2778,2999
22980,142361,8077,68505,5174,134283,5778,2778,3000
22985,142392,8082,68516,5178,134310,5779,2778,3001
22990,142423,8085,68531,5181,134338,5780,2778,3002
22995,142454,8087,68542,5183,134367,5781,2778,3003
23000,142485,8089,68556,5184,134396,5782,2778,3004
23005,142516,8091,68570,5184,134425,5783,2779,3004
23010,142547,8093,68587,5186,134454,5784,2779,3005
23015,142578,8095,68601,5188,134483,5785,2779,3006
23020,142609,8097,68615,5189,134512,5786,2779,3007
23025,142640,8099,68633,5191,134541,5787,2780,3007
23030,142671,8101,68649,5192,134570,5789,2781,3008
23035,142702,8103,68667,5194,134599,5791,2783,3008
23040,142733,8105,68688,5195,134628,5793,2784,3009
23045,142764,8107,68702,5196,134657,5794,2785,3009
23050,142795,8110,68712,5198,134685,5794,2785,3009
23055,142826,8112,68729,5200,134714,5794,2785,3009
23060,142857,8115,68743,5202,134742,5794,2785,3009
23065,142888,8118,68755,5204,134770,5794,2785,3009
23070,142919,8120,68770,5205,134799,5794,2785,3009
23075,142950,8122,68782,5206,134828,5794,2785,3009
23080,142981,8124,68799,5207,134857,5794,2785,3009
23085,143012,8125,68815,5208,134887,5794,2785,3009
23090,143043,8127,68831,5209,134916,5794,2785,3009
23095,143074,8128,68841,5209,134946,5794,2785,3009
23100,143105,8129,68856,5210,134976,5794,2785,3009
23105,143136,8132,68870,5212,135004,5795,2785,3010
23110,143167,8134,68887,5214,135033,5796,2785,3011
23115,143198,8136,68905,5215,135061,5797,2786,3011
23120,143229,8139,68920,5218,135090,5798,2786,3012
23125,143260,8140,68932,5219,135120,5799,2786,3013
23130,143291,8140,68943,5219,135151,5800,2787,3013
23135,143322,8140,68957,5219,135182,5801,2787,3014
23140,143353,8140,68972,5219,135213,5802,2788,3014
23145,143384,8140,68984,5219,135244,5803,2789,3014
23150,143415,8140,68996,5219,135275,5805,2791,3014
23155,143446,8140,69012,5219,135306,5807,2792,3015
23160,143477,8140,69026,5219,135337,5809,2794,3015
23165,143508,8142,69041,5221,135366,5810,2795,3015
23170,143539,8145,69054,5223,135394,5811,2795,3016
23175,143570,8147,69070,5224,135423,5812,2796,3016
23180,143601,8149,69077,5224,135452,5813,2797,3016
23185,143632,8151,69093,5224,135481,5814,2797,3017
23190,143663,8153,69108,5225,135510,5815,2797,3018
23195,143694,8155,69117,5225,135539,5816,2797,3019
23200,143725,8157,69129,5225,135568,5817,2798,3019
23205,143756,8159,69139,5226,135597,5818,2798,3020
23210,143787,8161,69153,5227,135626,5819,2798,3021
23215,143818,8166,69170,5231,135652,5820,2798,3022
23220,143849,8170,69184,5235,135679,5821,2799,3022
23225,143880,8172,69198,5236,135707,5823,2800,3023
23230,143911,8175,69210,5237,135736,5824,2800,3024
23235,143942,8177,69226,5238,135765,5825,2800,3025
23240,143973,8178,69243,5238,135795,5826,2800,3026
23245,144004,8179,69258,5239,135825,5827,2800,3027
23250,144035,8180,69272,5239,135855,5828,2801,3027
23255,144066,8182,69288,5241,135884,5829,2801,3028
23260,144097,8183,69302,5241,135914,5830,2802,3028
23265,144128,8184,69311,5242,135944,5831,2803,3028
23270,144159,8185,69328,5242,135974,5832,2804,3028
23275,144190,8186,69342,5242,136004,5833,2805,3028
23280,144221,8187,69355,5242,136034,5834,2805,3029
23285,144252,8187,69367,5242,136065,5835,2805,3030
23290,144283,8187,69382,5242,136096,5836,2806,3030
23295,144314,8187,69402,5242,136127,5837,2807,3030
23300,144345,8187,69413,5242,136158,5838,2808,3030
23305,144376,8187,69425,5242,136189,5839,2809,3030
23310,144407,8187,69439,5242,136220,5840,2809,3031
23315,144438,8187,69451,5242,136251,5841,2809,3032
23320,144469,8187,69461,5242,136282,5842,2809,3033
23325,144500,8189,69472,5243,136311,5843,2809,3034
23330,144531,8192,69487,5246,136339,5845,2810,3035
23335,144562,8193,69501,5246,136369,5847,2810,3037
23340,144593,8198,69517,5250,136395,5848,2811,3037
23345,144624,8199,69534,5250,136425,5849,2812,3037
23350,144655,8200,69552,5251,136455,5850,2813,3037
23355,144686,8201,69571,5252,136485,5851,2814,3037
23360,144717,8202,69583,5253,136515,5852,2814,3038
23365,144748,8203,69598,5254,136545,5853,2814,3039
23370,144779,8204,69611,5255,136575,5854,2814,3040
23375,144810,8205,69623,5255,136605,5855,2814,3041
23380,144841,8206,69641,5255,136635,5856,2814,3042
23385,144872,8207,69656,5256,136665,5857,2815,3042
23390,144903,8209,69671,5256,136694,5859,2816,3043
23395,144934,8211,69687,5258,136723,5861,2817,3044
23400,144965,8213,69701,5258,136752,5863,2817,3046
23405,144996,8215,69716,5258,136781,5865,2819,3046
23410,145027,8217,69729,5258,136810,5867,2819,3048
23415,145058,8219,69749,5259,136839,5869,2820,3049
23420,145089,8221,69767,5260,136868,5871,2822,3049
23425,145120,8223,69780,5262,136897,5873,2824,3049
23430,145151,8225,69791,5263,136926,5875,2825,3050
23435,145182,8227,69804,5265,136955,5877,2826,3051
23440,145213,8229,69820,5267,136984,5880,2827,3053
23445,145244,8232,69835,5268,137011,5883,2829,3054
23450,145275,8239,69850,5273,137035,5886,2829,3057
23455,145306,8244,69859,5277,137062,5888,2830,3058
23460,145337,8251,69882,5284,137085,5890,2832,3058
23465,145368,8254,69895,5286,137114,5891,2832,3059
23470,145399,8255,69909,5286,137144,5892,2832,3060
23475,145430,8256,69926,5286,137174,5893,2832,3061
23480,145461,8256,69940,5286,137205,5894,2833,3061
23485,145492,8256,69950,5286,137236,5894,2833,3061
23490,145523,8256,69964,5286,137267,5894,2833,3061
23495,145554,8256,69985,5286,137298,5894,2833,3061
23500,145585,8256,70002,5286,137329,5894,2833,3061
23505,145616,8256,70020,5286,137360,5894,2833,3061
23510,145647,8256,70040,5286,137391,5894,2833,3061
23515,145678,8256,70057,5286,137422,5894,2833,3061
23520,145709,8256,70071,5286,137453,5894,2833,3061
23525,145740,8256,70082,5286,137484,5894,2833,3061
23530,145771,8256,70098,5286,137515,5894,2833,3061
23535,145802,8256,70117,5286,137546,5894,2833,3061
23540,145833,8256,70132,5286,137577,5894,2833,3061
23545,145864,8256,70149,5286,137608,5894,2833,3061
23550,145895,8256,70161,5286,137639,5894,2833,3061
23555,145926,8256,70172,5286,137670,5895,2833,3062
23560,145957,8256,70189,5286,137701,5896,2834,3062
23565,145988,8256,70205,5286,137732,5896,2834,3062
23570,146019,8256,70217,5286,137763,5897,2834,3063
23575,146050,8258,70226,5288,137792,5899,2835,3064
23580,146081,8263,70246,5293,137816,5901,2836,3065
23585,146112,8268,70259,5297,137844,5902,2836,3066
23590,146143,8271,70275,5298,137872,5903,2837,3066
23595,146174,8273,70285,5300,137901,5904,2838,3066
23600,146205,8275,70300,5302,137930,5905,2838,3067
23605,146236,8276,70314,5303,137960,5906,2839,3067
23610,146267,8277,70326,5304,137990,5907,2839,3068
23615,146298,8278,70341,5305,138020,5908,2839,3069
23620,146329,8279,70361,5306,138050,5909,2840,3069
23625,146360,8280,70373,5307,138080,5910,2841,3069
23630,146391,8281,70389,5308,138110,5911,2842,3069
23635,146422,8282,70404,5309,138140,5912,2842,3070
23640,146453,8283,70420,5310,138170,5913,2843,3070
23645,146484,8284,70431,5310,138200,5914,2844,3070
23650,146515,8285,70453,5311,138230,5915,2845,3070
23655,146546,8286,70468,5312,138260,5916,2845,3071
23660,146577,8287,70486,5312,138290,5917,2846,3071
23665,146608,8288,70502,5312,138320,5918,2847,3071
23670,146639,8289,70517,5313,138350,5920,2847,3073
23675,146670,8290,70535,5314,138380,5922,2849,3073
23680,146701,8291,70551,5315,138410,5924,2849,3075
23685,146732,8292,70568,5316,138439,5926,2851,3075
23690,146763,8295,70586,5318,138467,5927,2852,3075
23695,146794,8298,70596,5321,138495,5929,2852,3077
23700,146825,8303,70605,5324,138522,5931,2852,3079
23705,146856,8305,70620,5326,138551,5932,2852,3080
23710,146887,8307,70636,5327,138580,5933,2852,3081
23715,146918,8310,70653,5330,138608,5934,2853,3081
23720,146949,8312,70670,5331,138637,5935,2853,3082
23725,146980,8314,70688,5333,138666,5936,2854,3082
23730,147011,8315,70701,5334,138696,5937,2854,3083
23735,147042,8315,70720,5334,138727,5938,2855,3083
23740,147073,8315,70732,5334,138758,5939,2855,3084
23745,147104,8315,70749,5334,138789,5940,2855,3085
23750,147135,8315,70771,5334,138820,5941,2856,3085
23755,147166,8315,70787,5334,138851,5942,2856,3086
23760,147197,8315,70800,5334,138882,5943,2856,3087
23765,147228,8316,70813,5334,138912,5944,2856,3088
23770,147259,8317,70824,5334,138942,5945,2856,3089
23775,147290,8318,70838,5334,138972,5946,2856,3090
23780,147321,8319,70854,5335,139002,5947,2856,3091
23785,147352,8320,70870,5335,139032,5948,2856,3092
23790,147383,8321,70885,5335,139062,5950,2856,3094
23795,147414,8322,70901,5335,139092,5952,2857,3095
23800,147445,8323,70919,5336,139122,5954,2858,3096
23805,147476,8324,70930,5336,139152,5956,2860,3096
23810,147507,8327,70944,5338,139180,5958,2862,3096
23815,147538,8331,70961,5341,139207,5960,2863,3097
23820,147569,8334,70977,5343,139235,5961,2864,3097
23825,147600,8336,70991,5345,139264,5962,2864,3098
23830,147631,8338,71006,5346,139293,5963,2865,3098
23835,147662,8340,71017,5347,139322,5964,2865,3099
23840,147693,8342,71035,5349,139351,5965,2866,3099
23845,147724,8345,71053,5352,139379,5966,2866,3100
23850,147755,8347,71063,5353,139408,5968,2867,3101
23855,147786,8348,71079,5353,139438,5970,2868,3102
23860,147817,8351,71092,5355,139466,5972,2869,3103
23865,147848,8352,71110,5355,139496,5974,2870,3104
23870,147879,8352,71125,5355,139527,5976,2872,3104
23875,147910,8352,71138,5355,139558,5978,2873,3105
23880,147941,8352,71147,5355,139589,5979,2873,3106
23885,147972,8355,71161,5357,139617,5981,2874,3107
23890,148003,8358,71178,5360,139645,5983,2875,3108
23895,148034,8359,71194,5361,139675,5984,2875,3109
23900,148065,8360,71205,5361,139705,5985,2875,3110
23905,148096,8362,71221,5363,139734,5986,2875,3111
23910,148127,8364,71233,5364,139763,5987,2875,3112
23915,148158,8364,71246,5364,139794,5988,2875,3113
23920,148189,8364,71265,5364,139825,5989,2876,3113
23925,148220,8364,71282,5364,139856,5990,2877,3113
23930,148251,8366,71295,5366,139885,5991,2877,3114
23935,148282,8368,71314,5368,139913,5992,2877,3115
23940,148313,8371,71323,5371,139941,5993,2877,3116
23945,148344,8374,71343,5374,139970,5994,2878,3116
23950,148375,8374,71360,5374,140001,5995,2878,3117
23955,148406,8374,71378,5374,140032,5996,2879,3117
23960,148437,8374,71392,5374,140063,5997,2880,3117
23965,148468,8374,71403,5374,140094,5998,2880,3118
23970,148499,8374,71420,5374,140125,5999,2880,3119
23975,148530,8374,71435,5374,140156,6000,2880,3120
23980,148561,8374,71449,5374,140187,6001,2881,3120
23985,148592,8374,71469,5374,140218,6002,2881,3121
23990,148623,8374,71485,5374,140249,6003,2881,3122
23995,148654,8374,71504,5374,140280,6005,2883,3122
24000,148685,8375,71521,5374,140310,6008,2883,3125
24005,148716,8376,71534,5375,140340,6010,2884,3126
24010,148747,8377,71547,5375,140370,6011,2884,3127
24015,148778,8378,71560,5376,140400,6012,2884,3128
24020,148809,8380,71572,5377,140429,6013,2884,3129
24025,148840,8384,71589,5380,140456,6014,2885,3129
24030,148871,8386,71604,5380,140485,6015,2886,3129
24035,148902,8390,71619,5383,140512,6016,2886,3130
24040,148933,8393,71634,5385,140540,6017,2886,3131
24045,148964,8397,71653,5389,140567,6018,2886,3132
24050,148995,8399,71665,5389,140596,6019,2887,3132
24055,149026,8402,71680,5389,140624,6020,2887,3133
24060,149057,8407,71690,5393,140650,6021,2887,3134
24065,149088,8411,71706,5397,140676,6023,2889,3134
24070,149119,8417,71721,5402,140701,6025,2890,3135
24075,149150,8422,71739,5406,140727,6027,2891,3136
24080,149181,8425,71755,5408,140756,6028,2891,3137
24085,149212,8426,71770,5409,140786,6029,2892,3137
24090,149243,8427,71787,5410,140816,6030,2893,3137
24095,149274,8428,71799,5411,140846,6031,2893,3138
24100,149305,8429,71808,5411,140876,6032,2894,3138
24105,149336,8430,71818,5411,140906,6033,2894,3139
24110,149367,8433,71832,5413,140934,6035,2895,3140
24115,149398,8436,71849,5415,140962,6037,2896,3141
24120,149429,8438,71864,5416,140991,6039,2898,3141
24125,149460,8440,71877,5417,141020,6040,2898,3142
24130,149491,8443,71891,5420,141048,6041,2898,3143
24135,149522,8443,71906,5420,141079,6042,2898,3144
24140,149553,8443,71917,5420,141110,6043,2898,3145
24145,149584,8443,71933,5420,141141,6044,2898,3146
24150,149615,8443,71945,5420,141172,6045,2898,3147
24155,149646,8443,71960,5420,141203,6046,2898,3148
24160,149677,8443,71971,5420,141234,6047,2898,3149
24165,149708,8443,71980,5420,141265,6048,2898,3150
24170,149739,8443,71992,5420,141296,6049,2898,3151
24175,149770,8443,72007,5420,141327,6050,2899,3151
24180,149801,8443,72023,5420,141358,6051,2899,3152
24185,149832,8445,72040,5422,141386,6054,2900,3154
24190,149863,8449,72054,5425,141413,6057,2901,3156
24195,149894,8455,72069,5430,141438,6059,2902,3157
24200,149925,8460,72083,5435,141464,6061,2903,3158
24205,149956,8465,72101,5440,141490,6063,2903,3160
24210,149987,8466,72115,5441,141521,6065,2903,3162
24215,150018,8466,72127,5441,141552,6067,2904,3163
24220,150049,8466,72143,5441,141583,6069,2905,3164
24225,150080,8466,72156,5441,141614,6070,2906,3164
24230,150111,8467,72172,5442,141644,6071,2907,3164
24235,150142,8469,72193,5444,141673,6072,2908,3164
24240,150173,8470,72208,5444,141703,6073,2909,3164
24245,150204,8471,72226,5445,141733,6074,2910,3164
24250,150235,8472,72236,5445,141763,6075,2910,3165
24255,150266,8473,72248,5446,141793,6076,2910,3166
24260,150297,8474,72260,5446,141823,6077,2910,3167
24265,150328,8475,72280,5447,141853,6078,2910,3168
24270,150359,8476,72292,5447,141883,6079,2911,3168
24275,150390,8477,72312,5447,141913,6080,2912,3168
24280,150421,8478,72327,5448,141943,6081,2912,3169
24285,150452,8479,72345,5449,141973,6082,2913,3169
24290,150483,8480,72358,5449,142003,6083,2914,3169
24295,150514,8481,72374,5449,142033,6085,2915,3170
24300,150545,8482,72390,5450,142063,6087,2916,3171
24305,150576,8483,72403,5450,142093,6089,2917,3172
24310,150607,8485,72412,5450,142122,6091,2919,3172
24315,150638,8489,72428,5452,142148,6093,2921,3172
24320,150669,8494,72439,5455,142174,6095,2921,3174
24325,150700,8500,72449,5458,142200,6096,2922,3174
24330,150731,8505,72459,5460,142225,6098,2922,3176
24335,150762,8511,72469,5463,142251,6100,2923,3177
24340,150793,8516,72483,5466,142276,6102,2923,3179
24345,150824,8523,72499,5472,142301,6104,2923,3181
24350,150855,8526,72511,5474,142329,6106,2924,3182
24355,150886,8529,72528,5477,142356,6108,2924,3184
24360,150917,8534,72542,5481,142383,6110,2925,3185
24365,150948,8535,72559,5482,142413,6111,2925,3186
24370,150979,8535,72575,5482,142444,6112,2926,3186
24375,151010,8535,72595,5482,142475,6113,2927,3186
24380,151041,8535,72606,5482,142506,6114,2927,3187
24385,151072,8535,72621,5482,142537,6115,2927,3188
24390,151103,8535,72631,5482,142568,6116,2928,3188
24395,151134,8535,72643,5482,142599,6117,2929,3188
24400,151165,8535,72661,5482,142630,6118,2930,3188
24405,151196,8535,72680,5482,142661,6119,2930,3189
24410,151227,8535,72694,5482,142692,6120,2931,3189
24415,151258,8535,72712,5482,142723,6121,2932,3189
24420,151289,8535,72724,5482,142754,6122,2932,3190
24425,151320,8535,72742,5482,142785,6124,2933,3191
24430,151351,8535,72756,5482,142816,6126,2934,3192
24435,151382,8535,72772,5482,142847,6128,2936,3192
24440,151413,8535,72787,5482,142878,6129,2936,3193
24445,151444,8535,72802,5482,142909,6130,2937,3193
24450,151475,8535,72815,5482,142940,6131,2937,3194
24455,151506,8536,72831,5483,142970,6132,2938,3194
24460,151537,8538,72843,5484,142999,6133,2939,3194
24465,151568,8539,72855,5484,143029,6134,2939,3195
24470,151599,8541,72867,5485,143058,6135,2939,3196
24475,151630,8545,72882,5486,143085,6136,2940,3196
24480,151661,8550,72898,5490,143111,6137,2941,3196
24485,151692,8554,72913,5493,143137,6138,2942,3196
24490,151723,8560,72931,5498,143162,6139,2942,3197
24495,151754,8564,72952,5502,143190,6140,2942,3198
24500,151785,8567,72971,5503,143217,6142,2943,3199
24505,151816,8570,72983,5505,143246,6144,2944,3200
24510,151847,8573,73000,5507,143273,6146,2945,3201
24515,151878,8576,73018,5508,143301,6147,2945,3202
24520,151909,8579,73030,5509,143329,6148,2946,3202
24525,151940,8582,73049,5512,143358,6149,2947,3202
24530,151971,8584,73064,5513,143387,6150,2948,3202
24535,152002,8586,73085,5514,143416,6151,2949,3202
24540,152033,8588,73102,5514,143444,6153,2951,3202
24545,152064,8592,73120,5517,143471,6155,2953,3202
24550,152095,8596,73134,5520,143498,6157,2953,3204
24555,152126,8598,73146,5521,143528,6159,2954,3205
24560,152157,8599,73161,5521,143558,6161,2956,3205
24565,152188,8600,73171,5521,143588,6163,2956,3207
24570,152219,8601,73188,5521,143618,6165,2958,3207
24575,152250,8603,73202,5522,143647,6167,2958,3209
24580,152281,8607,73218,5526,143674,6169,2958,3211
24585,152312,8609,73227,5527,143703,6171,2959,3212
24590,152343,8611,73248,5529,143732,6173,2961,3212
24595,152374,8613,73262,5530,143761,6174,2961,3213
24600,152405,8614,73274,5531,143791,6175,2961,3214
24605,152436,8616,73289,5532,143820,6176,2962,3214
24610,152467,8618,73301,5532,143849,6178,2963,3215
24615,152498,8621,73316,5534,143877,6179,2964,3215
24620,152529,8623,73332,5535,143906,6180,2965,3215
24625,152560,8626,73350,5537,143934,6181,2965,3216
24630,152591,8628,73368,5538,143963,6182,2965,3217
24635,152622,8630,73384,5540,143992,6183,2966,3217
24640,152653,8633,73401,5542,144020,6184,2966,3218
24645,152684,8635,73416,5542,144049,6185,2966,3219
24650,152715,8637,73432,5542,144078,6186,2966,3220
24655,152746,8640,73448,5544,144106,6187,2967,3220
24660,152777,8642,73462,5546,144135,6188,2967,3221
24665,152808,8643,73473,5546,144165,6190,2967,3223
24670,152839,8644,73490,5546,144195,6192,2967,3225
24675,152870,8646,73506,5548,144224,6193,2967,3226
24680,152901,8648,73521,5549,144253,6194,2967,3227
24685,152932,8649,73537,5550,144283,6195,2968,3227
24690,152963,8650,73552,5550,144313,6196,2968,3228
24695,152994,8651,73561,5550,144343,6197,2968,3229
24700,153025,8652,73573,5550,144373,6198,2969,3229
24705,153056,8653,73588,5551,144403,6199,2969,3230
24710,153087,8654,73604,5552,144433,6200,2970,3230
24715,153118,8656,73621,5554,144462,6201,2971,3230
24720,153149,8657,73631,5555,144492,6202,2971,3231
24725,153180,8658,73650,5556,144522,6202,2971,3231
24730,153211,8659,73663,5557,144552,6202,2971,3231
24735,153242,8660,73679,5557,144582,6202,2971,3231
24740,153273,8662,73693,5559,144611,6202,2971,3231
24745,153304,8662,73705,5559,144642,6202,2971,3231
24750,153335,8662,73717,5559,144673,6202,2971,3231
24755,153366,8662,73730,5559,144704,6202,2971,3231
24760,153397,8662,73742,5559,144735,6202,2971,3231
24765,153428,8662,73758,5559,144766,6202,2971,3231
24770,153459,8664,73770,5561,144794,6202,2971,3231
24775,153490,8667,73784,5562,144821,6203,2971,3232
24780,153521,8672,73796,5565,144847,6204,2971,3233
24785,153552,8675,73812,5568,144877,6206,2973,3233
24790,153583,8676,73826,5568,144907,6207,2974,3233
24795,153614,8677,73844,5569,144937,6208,2975,3233
24800,153645,8678,73858,5570,144967,6209,2976,3233
24805,153676,8679,73872,5571,144997,6210,2977,3233
24810,153707,8680,73883,5571,145027,6211,2978,3233
24815,153738,8681,73902,5572,145057,6212,2979,3233
24820,153769,8682,73919,5572,145087,6213,2980,3233
24825,153800,8683,73928,5572,145117,6214,2981,3233
24830,153831,8684,73945,5573,145147,6215,2982,3233
24835,153862,8685,73958,5573,145177,6216,2983,3233
24840,153893,8686,73972,5573,145207,6217,2984,3233
24845,153924,8687,73989,5573,145237,6219,2986,3233
24850,153955,8688,73997,5574,145267,6221,2987,3234
24855,153986,8689,74010,5574,145297,6223,2988,3235
24860,154017,8690,74024,5575,145327,6225,2989,3236
24865,154048,8691,74039,5576,145357,6227,2991,3236
24870,154079,8692,74056,5576,145387,6229,2992,3237
24875,154110,8693,74066,5576,145417,6232,2993,3239
24880,154141,8694,74079,5576,145447,6235,2995,3240
24885,154172,8695,74097,5577,145476,6237,2996,3241
24890,154203,8701,74107,5581,145501,6238,2997,3241
24895,154234,8708,74120,5586,145525,6239,2997,3242
24900,154265,8714,74136,5591,145550,6240,2998,3242
24905,154296,8715,74153,5592,145581,6241,2998,3243
24910,154327,8715,74171,5592,145612,6242,2999,3243
24915,154358,8715,74188,5592,145643,6243,3000,3243
24920,154389,8715,74202,5592,145674,6244,3000,3244
24925,154420,8715,74213,5592,145705,6245,3001,3244
24930,154451,8715,74229,5592,145736,6246,3002,3244
24935,154482,8715,74241,5592,145767,6247,3002,3245
24940,154513,8715,74260,5592,145798,6248,3002,3246
24945,154544,8715,74270,5592,145829,6249,3002,3247
24950,154575,8715,74282,5592,145860,6250,3002,3248
24955,154606,8715,74299,5592,145891,6251,3003,3248
24960,154637,8715,74315,5592,145922,6252,3004,3248
24965,154668,8715,74330,5592,145953,6254,3006,3248
24970,154699,8715,74348,5592,145984,6256,3007,3249
24975,154730,8715,74364,5592,146015,6258,3008,3250
24980,154761,8715,74372,5592,146046,6260,3009,3251
24985,154792,8715,74385,5592,146077,6262,3010,3252
24990,154823,8715,74398,5592,146108,6264,3010,3254
24995,154854,8715,74414,5592,146139,6266,3011,3255
25000,154885,8715,74429,5592,146170,6268,3013,3255
25005,154916,8716,74444,5592,146199,6270,3013,3257
25010,154947,8722,74455,5596,146224,6272,3014,3258
25015,154978,8729,74473,5602,146248,6274,3014,3260
25020,155009,8737,74482,5608,146272,6276,3016,3260
25025,155040,8739,74495,5609,146301,6277,3017,3260
25030,155071,8741,74510,5610,146330,6278,3017,3261
25035,155102,8743,74522,5611,146359,6279,3018,3261
25040,155133,8745,74538,5612,146388,6280,3019,3261
25045,155164,8748,74553,5613,146416,6281,3019,3262
25050,155195,8751,74566,5615,146444,6282,3019,3263
25055,155226,8755,74585,5617,146471,6283,3019,3264
25060,155257,8759,74597,5620,146498,6284,3020,3264
25065,155288,8759,74610,5620,146529,6285,3020,3265
25070,155319,8759,74628,5620,146560,6286,3021,3265
25075,155350,8759,74640,5620,146591,6287,3022,3265
25080,155381,8759,74659,5620,146622,6288,3023,3265
25085,155412,8759,74673,5620,146653,6289,3023,3266
25090,155443,8759,74691,5620,146684,6290,3024,3266
25095,155474,8759,74713,5620,146715,6291,3024,3267
25100,155505,8759,74724,5620,146746,6292,3025,3267
25105,155536,8759,74737,5620,146777,6293,3026,3267
25110,155567,8759,74755,5620,146808,6294,3027,3267
25115,155598,8759,74773,5620,146839,6296,3028,3268
25120,155629,8759,74787,5620,146870,6298,3029,3269
25125,155660,8759,74801,5620,146901,6300,3030,3270
25130,155691,8760,74814,5621,146931,6303,3031,3272
25135,155722,8762,74828,5622,146960,6306,3033,3273
25140,155753,8763,74840,5622,146990,6309,3036,3273
25145,155784,8765,74854,5623,147019,6310,3036,3274
25150,155815,8767,74869,5623,147048,6310,3036,3274
25155,155846,8769,74885,5623,147077,6310,3036,3274
25160,155877,8771,74905,5625,147106,6310,3036,3274
25165,155908,8773,74918,5626,147135,6310,3036,3274
25170,155939,8775,74934,5627,147164,6310,3036,3274
25175,155970,8777,74953,5628,147193,6310,3036,3274
25180,156001,8779,74969,5630,147222,6310,3036,3274
25185,156032,8781,74988,5631,147251,6310,3036,3274
25190,156063,8783,75003,5632,147280,6310,3036,3274
25195,156094,8785,75021,5633,147309,6310,3036,3274
25200,156125,8787,75037,5633,147338,6310,3036,3274
25205,156156,8789,75049,5635,147367,6310,3036,3274
25210,156187,8791,75063,5635,147396,6310,3036,3274
25215,156218,8793,75080,5636,147425,6310,3036,3274
25220,156249,8795,75093,5636,147454,6310,3036,3274
25225,156280,8797,75106,5637,147483,6310,3036,3274
25230,156311,8799,75121,5639,147512,6310,3036,3274
25235,156342,8801,75138,5639,147541,6310,3036,3274
25240,156373,8803,75150,5640,147570,6310,3036,3274
25245,156404,8806,75165,5642,147597,6312,3036,3276
25250,156435,8811,75178,5646,147624,6314,3038,3276
25255,156466,8814,75192,5647,147651,6316,3039,3277
25260,156497,8819,75207,5650,147677,6318,3040,3278
25265,156528,8823,75218,5653,147705,6319,3041,3278
25270,156559,8826,75235,5655,147732,6320,3041,3279
25275,156590,8830,75251,5657,147760,6321,3042,3279
25280,156621,8832,75269,5658,147789,6322,3042,3280
25285,156652,8833,75279,5659,147819,6323,3043,3280
25290,156683,8834,75298,5660,147849,6324,3043,3281
25295,156714,8835,75315,5660,147879,6325,3044,3281
25300,156745,8836,75333,5661,147909,6326,3044,3282
25305,156776,8837,75352,5662,147939,6327,3044,3283
25310,156807,8838,75368,5663,147969,6328,3044,3284
25315,156838,8839,75390,5664,147999,6329,3045,3284
25320,156869,8840,75410,5665,148029,6330,3046,3284
25325,156900,8841,75428,5666,148059,6331,3046,3285
25330,156931,8842,75437,5666,148089,6332,3047,3285
25335,156962,8843,75448,5667,148119,6333,3048,3285
25340,156993,8844,75462,5668,148149,6334,3048,3286
25345,157024,8845,75476,5668,148179,6335,3048,3287
25350,157055,8846,75494,5668,148209,6336,3049,3287
25355,157086,8848,75509,5669,148238,6337,3050,3287
25360,157117,8850,75526,5669,148267,6339,3050,3289
25365,157148,8853,75538,5670,148295,6341,3051,3290
25370,157179,8856,75554,5671,148323,6343,3052,3291
25375,157210,8857,75568,5671,148353,6345,3054,3291
25380,157241,8858,75589,5672,148383,6347,3056,3291
25385,157272,8860,75606,5674,148411,6350,3057,3293
25390,157303,8864,75621,5677,148438,6353,3058,3295
25395,157334,8867,75632,5679,148466,6355,3058,3297
25400,157365,8871,75643,5681,148494,6357,3059,3298
25405,157396,8873,75658,5681,148522,6359,3060,3299
25410,157427,8878,75676,5685,148548,6361,3061,3300
25415,157458,8881,75695,5688,148575,6363,3062,3301
25420,157489,8886,75712,5692,148603,6365,3063,3302
25425,157520,8890,75729,5695,148628,6367,3064,3303
25430,157551,8894,75745,5698,148657,6369,3066,3303
25435,157582,8896,75759,5699,148686,6370,3067,3303
25440,157613,8897,75770,5699,148716,6371,3067,3304
25445,157644,8898,75782,5700,148746,6372,3067,3305
25450,157675,8900,75796,5702,148775,6373,3068,3305
25455,157706,8902,75810,5703,148804,6374,3068,3306
25460,157737,8904,75825,5704,148833,6375,3068,3307
25465,157768,8906,75845,5706,148862,6376,3069,3307
25470,157799,8907,75861,5706,148892,6377,3070,3307
25475,157830,8908,75874,5707,148922,6378,3070,3308
25480,157861,8909,75884,5707,148952,6379,3071,3308
25485,157892,8911,75898,5708,148981,6380,3072,3308
25490,157923,8915,75910,5711,149008,6381,3073,3308
25495,157954,8916,75929,5712,149038,6382,3073,3309
25500,157985,8917,75938,5712,149068,6384,3074,3310
25505,158016,8919,75954,5713,149097,6386,3076,3310
25510,158047,8920,75965,5713,149127,6387,3076,3311
25515,158078,8921,75979,5713,149157,6388,3077,3311
25520,158109,8922,75995,5713,149187,6389,3078,3311
25525,158140,8923,76016,5714,149217,6390,3078,3312
25530,158171,8924,76030,5715,149247,6391,3078,3313
25535,158202,8925,76043,5716,149277,6392,3078,3314
25540,158233,8927,76054,5718,149306,6393,3078,3315
25545,158264,8929,76070,5720,149334,6394,3079,3315
25550,158295,8932,76082,5722,149363,6395,3080,3315
25555,158326,8935,76094,5725,149390,6397,3081,3316
25560,158357,8939,76106,5727,149416,6399,3083,3316
25565,158388,8943,76121,5731,149445,6402,3086,3316
25570,158419,8945,76137,5733,149474,6404,3087,3317
25575,158450,8947,76155,5735,149503,6405,3087,3318
25580,158481,8948,76170,5735,149533,6406,3088,3318
25585,158512,8949,76183,5736,149563,6407,3088,3319
25590,158543,8951,76199,5738,149592,6408,3089,3319
25595,158574,8951,76214,5738,149623,6409,3089,3320
25600,158605,8952,76226,5738,149653,6410,3090,3320
25605,158636,8953,76238,5738,149683,6411,3091,3320
25610,158667,8954,76251,5739,149713,6412,3091,3321
25615,158698,8955,76266,5739,149743,6413,3091,3322
25620,158729,8956,76281,5739,149773,6414,3092,3322
25625,158760,8960,76293,5740,149800,6415,3092,3323
25630,158791,8964,76308,5742,149827,6416,3092,3324
25635,158822,8967,76321,5744,149855,6417,3093,3324
25640,158853,8970,76337,5745,149883,6418,3093,3325
25645,158884,8973,76353,5747,149911,6419,3093,3326
25650,158915,8977,76368,5750,149938,6420,3093,3327
25655,158946,8980,76381,5752,149966,6421,3094,3327
25660,158977,8985,76398,5755,149992,6422,3095,3327
25665,159008,8990,76411,5757,150018,6423,3095,3328
25670,159039,8991,76430,5757,150048,6424,3095,3329
25675,159070,8992,76453,5758,150078,6425,3096,3329
25680,159101,8992,76465,5758,150109,6426,3096,3330
25685,159132,8992,76478,5758,150140,6427,3096,3331
25690,159163,8992,76497,5758,150171,6428,3096,3332
25695,159194,8992,76513,5758,150202,6429,3097,3332
25700,159225,8992,76525,5758,150233,6430,3098,3332
25705,159256,8992,76544,5758,150264,6431,3098,3333
25710,159287,8992,76561,5758,150295,6432,3099,3333
25715,159318,8992,76579,5758,150326,6433,3099,3334
25720,159349,8992,76594,5758,150357,6434,3100,3334
25725,159380,8992,76607,5758,150388,6435,3100,3335
25730,159411,8992,76622,5758,150419,6436,3100,3336
25735,159442,8992,76639,5758,150450,6437,3100,3337
25740,159473,8992,76653,5758,150481,6438,3100,3338
25745,159504,8993,76669,5759,150511,6438,3100,3338
25750,159535,8994,76685,5760,150541,6438,3100,3338
25755,159566,8995,76696,5760,150571,6438,3100,3338
25760,159597,8996,76713,5760,150601,6438,3100,3338
25765,159628,8997,76727,5761,150631,6438,3100,3338
25770,159659,8998,76740,5762,150661,6438,3100,3338
25775,159690,9000,76754,5763,150690,6438,3100,3338
25780,159721,9002,76768,5765,150719,6438,3100,3338
25785,159752,9005,76781,5766,150747,6438,3100,3338
25790,159783,9009,76794,5768,150774,6438,3100,3338
25795,159814,9013,76810,5770,150801,6439,3101,3338
25800,159845,9017,76828,5772,150828,6440,3102,3338
25805,159876,9020,76838,5773,150856,6440,3102,3338
25810,159907,9022,76851,5774,150885,6440,3102,3338
25815,159938,9023,76865,5774,150915,6440,3102,3338
25820,159969,9024,76881,5775,150945,6440,3102,3338
25825,160000,9024,76893,5775,150976,6440,3102,3338
25830,160031,9024,76911,5775,151007,6440,3102,3338
25835,160062,9024,76925,5775,151038,6440,3102,3338
25840,160093,9024,76942,5775,151069,6440,3102,3338
25845,160124,9024,76959,5775,151100,6441,3103,3338
25850,160155,9024,76975,5775,151131,6442,3103,3339
25855,160186,9024,76990,5775,151162,6443,3104,3339
25860,160217,9024,77005,5775,151193,6444,3104,3340
25865,160248,9027,77016,5776,151221,6445,3105,3340
25870,160279,9031,77031,5779,151248,6446,3105,3341
25875,160310,9032,77048,5780,151278,6447,3105,3342
25880,160341,9033,77058,5780,151308,6448,3105,3343
25885,160372,9034,77074,5780,151338,6449,3105,3344
25890,160403,9035,77088,5781,151368,6450,3105,3345
25895,160434,9036,77100,5782,151398,6451,3105,3346
25900,160465,9037,77115,5782,151428,6452,3105,3347
25905,160496,9038,77134,5782,151458,6454,3107,3347
25910,160527,9040,77153,5783,151486,6457,3110,3347
25915,160558,9045,77170,5788,151513,6460,3113,3347
25920,160589,9048,77179,5790,151541,6462,3113,3349
25925,160620,9049,77193,5790,151571,6464,3114,3350
25930,160651,9050,77213,5791,151601,6465,3115,3350
25935,160682,9051,77226,5792,151631,6466,3116,3350
25940,160713,9052,77244,5793,151661,6467,3117,3350
25945,160744,9053,77259,5793,151691,6468,3117,3351
25950,160775,9054,77273,5794,151721,6469,3117,3352
25955,160806,9055,77289,5794,151751,6470,3118,3352
25960,160837,9056,77305,5794,151781,6471,3119,3352
25965,160868,9057,77318,5794,151811,6472,3119,3353
25970,160899,9058,77333,5795,151841,6473,3119,3354
25975,160930,9060,77345,5796,151870,6474,3119,3355
25980,160961,9062,77360,5798,151899,6475,3119,3356
25985,160992,9066,77374,5801,151926,6477,3120,3357
25990,161023,9069,77388,5804,151954,6479,3121,3358
25995,161054,9072,77405,5806,151982,6481,3123,3358
26000,161085,9076,77420,5807,152009,6482,3123,3359
26005,161116,9081,77430,5810,152035,6483,3123,3360
26010,161147,9085,77443,5812,152062,6484,3123,3361
26015,161178,9089,77456,5815,152089,6485,3124,3361
26020,161209,9094,77476,5819,152115,6486,3125,3361
26025,161240,9099,77489,5822,152140,6487,3126,3361
26030,161271,9103,77506,5826,152168,6488,3126,3362
26035,161302,9107,77521,5830,152194,6490,3127,3363
26040,161333,9113,77539,5836,152219,6492,3127,3365
26045,161364,9115,77559,5837,152249,6493,3128,3365
26050,161395,9115,77568,5837,152280,6494,3128,3366
26055,161426,9115,77582,5837,152311,6495,3128,3367
26060,161457,9115,77598,5837,152342,6496,3128,3368
26065,161488,9115,77612,5837,152373,6497,3128,3369
26070,161519,9115,77628,5837,152404,6498,3128,3370
26075,161550,9115,77641,5837,152435,6499,3129,3370
26080,161581,9115,77654,5837,152466,6500,3130,3370
26085,161612,9115,77665,5837,152497,6501,3130,3371
26090,161643,9115,77677,5837,152528,6502,3130,3372
26095,161674,9115,77692,5837,152559,6503,3131,3372
26100,161705,9115,77705,5837,152590,6504,3132,3372
26105,161736,9116,77722,5838,152620,6506,3133,3373
26110,161767,9117,77735,5838,152650,6508,3134,3374
26115,161798,9118,77752,5839,152680,6510,3136,3374
26120,161829,9119,77764,5839,152710,6512,3136,3376
26125,161860,9120,77779,5840,152740,6514,3138,3376
26130,161891,9122,77793,5841,152769,6516,3139,3377
26135,161922,9124,77808,5842,152798,6517,3139,3378
26140,161953,9126,77823,5843,152827,6518,3139,3379
26145,161984,9129,77840,5845,152855,6519,3140,3379
26150,162015,9133,77858,5849,152882,6520,3140,3380
26155,162046,9137,77871,5851,152909,6522,3141,3381
26160,162077,9141,77890,5855,152936,6524,3142,3382
26165,162108,9142,77910,5856,152966,6525,3143,3382
26170,162139,9144,77929,5858,152995,6526,3143,3383
26175,162170,9146,77945,5859,153024,6527,3144,3383
26180,162201,9148,77958,5861,153053,6528,3145,3383
26185,162232,9150,77976,5863,153082,6529,3145,3384
26190,162263,9152,77994,5865,153111,6530,3145,3385
26195,162294,9154,78010,5866,153140,6531,3146,3385
26200,162325,9155,78028,5866,153170,6532,3147,3385
26205,162356,9157,78039,5868,153199,6533,3148,3385
26210,162387,9158,78053,5868,153229,6534,3148,3386
26215,162418,9159,78067,5869,153259,6535,3149,3386
26220,162449,9161,78079,5870,153288,6536,3150,3386
26225,162480,9162,78097,5871,153318,6537,3151,3386
26230,162511,9164,78114,5873,153347,6538,3151,3387
26235,162542,9166,78126,5875,153376,6540,3152,3388
26240,162573,9166,78140,5875,153407,6542,3153,3389
26245,162604,9166,78155,5875,153438,6544,3155,3389
26250,162635,9166,78177,5875,153469,6546,3156,3390
26255,162666,9166,78197,5875,153500,6548,3158,3390
26260,162697,9166,78209,5875,153531,6550,3159,3391
26265,162728,9166,78223,5875,153562,6551,3160,3391
26270,162759,9169,78244,5878,153589,6552,3161,3391
26275,162790,9172,78258,5880,153617,6553,3161,3392
26280,162821,9174,78275,5881,153647,6555,3162,3393
26285,162852,9175,78289,5881,153676,6556,3163,3393
26290,162883,9177,78300,5882,153705,6557,3163,3394
26295,162914,9179,78320,5884,153735,6558,3164,3394
26300,162945,9180,78333,5885,153765,6559,3164,3395
26305,162976,9181,78345,5886,153795,6560,3164,3396
26310,163007,9182,78361,5887,153825,6561,3165,3396
26315,163038,9183,78378,5888,153855,6562,3165,3397
26320,163069,9184,78393,5888,153885,6563,3166,3397
26325,163100,9185,78406,5888,153915,6564,3166,3398
26330,163131,9189,78427,5890,153942,6565,3166,3399
26335,163162,9193,78442,5893,153969,6566,3166,3400
26340,163193,9197,78453,5895,153996,6567,3166,3401
26345,163224,9200,78469,5897,154024,6568,3167,3401
26350,163255,9204,78483,5901,154051,6569,3167,3402
26355,163286,9208,78501,5904,154078,6570,3168,3402
26360,163317,9213,78514,5906,154104,6571,3169,3402
26365,163348,9217,78531,5909,154131,6572,3170,3402
26370,163379,9221,78540,5910,154158,6574,3171,3403
26375,163410,9225,78557,5913,154185,6576,3172,3404
26380,163441,9226,78571,5914,154215,6578,3172,3406
26385,163472,9227,78590,5915,154245,6580,3174,3406
26390,163503,9227,78602,5915,154276,6583,3175,3408
26395,163534,9227,78618,5915,154307,6586,3176,3410
26400,163565,9227,78632,5915,154338,6587,3177,3410
26405,163596,9227,78649,5915,154369,6588,3177,3411
26410,163627,9227,78671,5915,154400,6589,3178,3411
26415,163658,9227,78690,5915,154431,6590,3179,3411
26420,163689,9227,78707,5915,154462,6591,3180,3411
26425,163720,9227,78722,5915,154493,6592,3181,3411
26430,163751,9227,78743,5915,154524,6593,3181,3412
26435,163782,9227,78760,5915,154555,6594,3182,3412
26440,163813,9227,78779,5915,154586,6595,3182,3413
26445,163844,9227,78791,5915,154617,6596,3183,3413
26450,163875,9227,78807,5915,154648,6597,3184,3413
26455,163906,9227,78823,5915,154679,6598,3185,3413
26460,163937,9227,78829,5915,154710,6599,3185,3414
26465,163968,9228,78845,5916,154739,6600,3186,3414
26470,163999,9231,78858,5918,154766,6601,3186,3415
26475,164030,9236,78873,5923,154793,6602,3187,3415
26480,164061,9240,78888,5925,154820,6603,3188,3415
26485,164092,9244,78899,5928,154848,6604,3188,3416
26490,164123,9249,78914,5932,154874,6605,3188,3417
26495,164154,9253,78932,5934,154900,6606,3188,3418
26500,164185,9257,78948,5936,154927,6609,3190,3419
26505,164216,9262,78964,5939,154954,6612,3192,3420
26510,164247,9265,78981,5941,154982,6615,3194,3421
26515,164278,9269,78995,5945,155009,6616,3195,3421
26520,164309,9272,79012,5947,155037,6617,3195,3422
26525,164340,9275,79024,5948,155065,6618,3196,3422
26530,164371,9277,79039,5949,155094,6619,3196,3423
26535,164402,9279,79052,5950,155123,6620,3197,3423
26540,164433,9281,79069,5951,155152,6621,3197,3424
26545,164464,9283,79086,5952,155181,6622,3197,3425
26550,164495,9285,79100,5953,155210,6623,3198,3425
26555,164526,9287,79118,5955,155239,6624,3199,3425
26560,164557,9289,79138,5956,155268,6625,3200,3425
26565,164588,9290,79153,5956,155298,6626,3201,3425
26570,164619,9290,79168,5956,155329,6627,3201,3426
26575,164650,9290,79181,5956,155360,6628,3201,3427
26580,164681,9290,79191,5956,155391,6629,3201,3428
26585,164712,9290,79207,5956,155422,6630,3201,3429
26590,164743,9290,79225,5956,155453,6631,3201,3430
26595,164774,9290,79239,5956,155484,6632,3201,3431
26600,164805,9291,79250,5956,155514,6633,3202,3431
26605,164836,9293,79261,5957,155543,6634,3202,3432
26610,164867,9294,79275,5957,155573,6635,3203,3432
26615,164898,9295,79290,5957,155603,6637,3204,3433
26620,164929,9297,79305,5959,155632,6640,3204,3436
26625,164960,9298,79318,5959,155662,6643,3205,3438
26630,164991,9299,79337,5959,155692,6646,3207,3439
26635,165022,9301,79348,5959,155721,6648,3208,3440
26640,165053,9304,79360,5962,155748,6650,3208,3442
26645,165084,9307,79375,5963,155777,6651,3208,3443
26650,165115,9310,79391,5966,155805,6652,3208,3444
26655,165146,9314,79411,5970,155832,6653,3209,3444
26660,165177,9318,79424,5972,155859,6654,3209,3445
26665,165208,9319,79437,5972,155889,6655,3209,3446
26670,165239,9320,79452,5972,155919,6656,3210,3446
26675,165270,9322,79470,5972,155948,6657,3211,3446
26680,165301,9324,79483,5974,155977,6658,3211,3447
26685,165332,9326,79500,5975,156006,6659,3212,3447
26690,165363,9328,79515,5976,156035,6660,3213,3447
26695,165394,9330,79533,5978,156064,6661,3214,3447
26700,165425,9332,79543,5979,156093,6662,3214,3448
26705,165456,9334,79553,5981,156122,6663,3214,3449
26710,165487,9336,79568,5982,156151,6664,3214,3450
26715,165518,9338,79581,5983,156180,6665,3214,3451
26720,165549,9340,79591,5983,156209,6666,3215,3451
26725,165580,9342,79605,5983,156238,6667,3215,3452
26730,165611,9344,79620,5984,156267,6668,3215,3453
26735,165642,9346,79632,5984,156296,6670,3215,3455
26740,165673,9348,79642,5984,156325,6672,3217,3455
26745,165704,9350,79658,5985,156353,6674,3218,3456
26750,165735,9354,79677,5988,156380,6677,3219,3458
26755,165766,9359,79694,5992,156407,6680,3220,3460
26760,165797,9362,79706,5994,156435,6683,3222,3461
26765,165828,9364,79719,5995,156464,6684,3222,3462
26770,165859,9366,79736,5996,156492,6685,3223,3462
26775,165890,9369,79753,5998,156521,6686,3224,3462
26780,165921,9371,79771,5999,156550,6687,3224,3463
26785,165952,9374,79787,6000,156578,6688,3225,3463
26790,165983,9377,79805,6002,156606,6689,3226,3463
26795,166014,9381,79820,6005,156633,6690,3227,3463
26800,166045,9384,79840,6008,156661,6691,3228,3463
26805,166076,9387,79855,6010,156689,6692,3228,3464
26810,166107,9390,79866,6013,156717,6693,3228,3465
26815,166138,9393,79878,6015,156745,6694,3229,3465
26820,166169,9397,79895,6018,156772,6695,3230,3465
26825,166200,9398,79911,6019,156802,6696,3231,3465
26830,166231,9400,79928,6020,156831,6697,3232,3465
26835,166262,9402,79943,6022,156860,6698,3232,3466
26840,166293,9404,79963,6023,156889,6699,3232,3467
26845,166324,9406,79981,6025,156918,6700,3232,3468
26850,166355,9407,79995,6025,156948,6701,3232,3469
26855,166386,9408,80010,6025,156978,6702,3233,3469
26860,166417,9409,80023,6025,157008,6703,3233,3470
26865,166448,9411,80038,6026,157037,6705,3235,3470
26870,166479,9412,80056,6026,157067,6708,3238,3470
26875,166510,9413,80069,6026,157097,6711,3238,3473
26880,166541,9414,80087,6026,157125,6714,3238,3476
26885,166572,9416,80101,6028,157156,6714,3238,3476
26890,166603,9416,80113,6028,157187,6714,3238,3476
26895,166634,9416,80129,6028,157218,6714,3238,3476
26900,166665,9416,80143,6028,157249,6714,3238,3476
26905,166696,9416,80157,6028,157280,6714,3238,3476
26910,166727,9416,80170,6028,157311,6714,3238,3476
26915,166758,9416,80189,6028,157342,6714,3238,3476
26920,166789,9416,80206,6028,157373,6714,3238,3476
26925,166820,9416,80222,6028,157404,6714,3238,3476
26930,166851,9416,80238,6028,157435,6714,3238,3476
26935,166882,9416,80250,6028,157466,6714,3238,3476
26940,166913,9416,80261,6028,157497,6714,3238,3476
26945,166944,9417,80276,6029,157527,6715,3238,3477
26950,166975,9418,80294,6029,157557,6715,3238,3477
26955,167006,9419,80309,6030,157587,6715,3238,3477
26960,167037,9420,80324,6030,157617,6715,3238,3477
26965,167068,9421,80341,6030,157647,6715,3238,3477
26970,167099,9422,80360,6030,157677,6715,3238,3477
26975,167130,9423,80373,6031,157707,6715,3238,3477
26980,167161,9424,80391,6032,157737,6715,3238,3477
26985,167192,9427,80404,6033,157765,6717,3238,3479
26990,167223,9432,80417,6038,157791,6719,3240,3479
26995,167254,9438,80437,6043,157816,6721,3240,3481
27000,167285,9443,80454,6046,157842,6723,3242,3481
27005,167316,9446,80466,6048,157870,6725,3243,3482
27010,167347,9448,80476,6049,157899,6727,3244,3483
27015,167378,9451,80485,6051,157927,6728,3245,3483
27020,167409,9454,80504,6054,157954,6729,3246,3483
27025,167440,9456,80519,6056,157984,6730,3246,3484
27030,167471,9456,80532,6056,158015,6731,3246,3485
27035,167502,9456,80546,6056,158046,6732,3246,3486
27040,167533,9456,80558,6056,158077,6733,3247,3486
27045,167564,9456,80572,6056,158108,6734,3247,3487
27050,167595,9456,80590,6056,158139,6735,3248,3487
27055,167626,9456,80604,6056,158170,6736,3248,3488
27060,167657,9456,80623,6056,158201,6737,3248,3489
27065,167688,9456,80634,6056,158232,6738,3249,3489
27070,167719,9456,80646,6056,158263,6739,3249,3490
27075,167750,9456,80661,6056,158294,6740,3250,3490
27080,167781,9456,80674,6056,158325,6741,3250,3491
27085,167812,9456,80691,6056,158356,6742,3250,3492
27090,167843,9456,80704,6056,158387,6743,3250,3493
27095,167874,9456,80723,6056,158418,6744,3251,3493
27100,167905,9456,80732,6056,158449,6745,3251,3494
27105,167936,9456,80749,6056,158480,6746,3252,3494
27110,167967,9458,80765,6057,158509,6748,3253,3495
27115,167998,9459,80777,6057,158539,6750,3253,3497
27120,168029,9461,80794,6059,158568,6753,3255,3498
27125,168060,9464,80808,6062,158595,6754,3256,3498
27130,168091,9468,80819,6064,158623,6755,3256,3499
27135,168122,9471,80833,6066,158650,6756,3256,3500
27140,168153,9476,80844,6069,158677,6757,3256,3501
27145,168184,9479,80858,6070,158704,6758,3257,3501
27150,168215,9483,80870,6073,158732,6759,3258,3501
27155,168246,9488,80888,6078,158758,6760,3259,3501
27160,168277,9492,80903,6080,158784,6761,3260,3501
27165,168308,9497,80919,6084,158811,6762,3260,3502
27170,168339,9500,80933,6086,158838,6763,3261,3502
27175,168370,9504,80947,6090,158865,6764,3261,3503
27180,168401,9507,80960,6092,158894,6765,3262,3503
27185,168432,9510,80976,6094,158921,6766,3263,3503
27190,168463,9514,80991,6097,158949,6767,3263,3504
27195,168494,9516,81012,6098,158978,6768,3264,3504
27200,168525,9518,81025,6099,159007,6769,3264,3505
27205,168556,9521,81041,6101,159034,6770,3265,3505
27210,168587,9525,81053,6104,159062,6771,3266,3505
27215,168618,9528,81069,6107,159090,6772,3266,3506
27220,168649,9531,81087,6109,159118,6773,3266,3507
27225,168680,9537,81106,6114,159142,6775,3267,3508
27230,168711,9540,81121,6116,159171,6777,3268,3509
27235,168742,9540,81126,6116,159202,6779,3268,3511
27240,168773,9540,81138,6116,159233,6780,3268,3512
27245,168804,9540,81153,6116,159264,6781,3269,3512
27250,168835,9540,81174,6116,159295,6782,3269,3513
27255,168866,9540,81186,6116,159326,6783,3270,3513
27260,168897,9540,81203,6116,159357,6784,3271,3513
27265,168928,9540,81224,6116,159388,6785,3271,3514
27270,168959,9540,81239,6116,159419,6786,3272,3514
27275,168990,9542,81252,6118,159448,6787,3272,3515
27280,169021,9545,81266,6121,159476,6788,3273,3515
27285,169052,9546,81281,6121,159506,6789,3273,3516
27290,169083,9548,81297,6123,159535,6790,3274,3516
27295,169114,9550,81313,6124,159564,6791,3274,3517
27300,169145,9551,81327,6124,159594,6792,3274,3518
27305,169176,9553,81341,6126,159623,6793,3274,3519
27310,169207,9555,81355,6128,159652,6794,3275,3519
27315,169238,9555,81372,6128,159683,6795,3275,3520
27320,169269,9555,81385,6128,159714,6796,3275,3521
27325,169300,9555,81401,6128,159745,6797,3276,3521
27330,169331,9555,81415,6128,159776,6798,3276,3522
27335,169362,9557,81427,6130,159805,6799,3277,3522
27340,169393,9562,81440,6133,159831,6800,3278,3522
27345,169424,9565,81454,6134,159859,6803,3279,3524
27350,169455,9569,81472,6138,159885,6805,3281,3524
27355,169486,9574,81490,6143,159912,6807,3283,3524
27360,169517,9576,81506,6144,159940,6809,3284,3525
27365,169548,9580,81520,6147,159968,6810,3285,3525
27370,169579,9582,81532,6148,159997,6811,3286,3525
27375,169610,9584,81547,6149,160026,6812,3286,3526
27380,169641,9586,81565,6149,160055,6813,3287,3526
27385,169672,9588,81575,6149,160083,6814,3287,3527
27390,169703,9591,81591,6152,160112,6815,3288,3527
27395,169734,9594,81607,6154,160139,6816,3289,3527
27400,169765,9597,81620,6157,160168,6817,3289,3528
27405,169796,9600,81636,6158,160196,6818,3290,3528
27410,169827,9603,81651,6159,160224,6819,3291,3528
27415,169858,9605,81666,6159,160252,6820,3292,3528
27420,169889,9608,81684,6161,160281,6821,3292,3529
27425,169920,9610,81695,6162,160310,6822,3292,3530
27430,169951,9612,81706,6163,160339,6823,3293,3530
27435,169982,9615,81724,6166,160367,6824,3293,3531
27440,170013,9618,81739,6167,160395,6825,3293,3532
27445,170044,9620,81754,6168,160424,6826,3293,3533
27450,170075,9624,81771,6171,160451,6828,3294,3534
27455,170106,9628,81789,6173,160478,6830,3295,3535
27460,170137,9632,81805,6177,160505,6832,3296,3536
27465,170168,9635,81820,6180,160533,6834,3297,3537
27470,170199,9636,81830,6181,160563,6836,3298,3538
27475,170230,9637,81848,6182,160593,6838,3299,3539
27480,170261,9638,81866,6183,160623,6840,3300,3540
27485,170292,9641,81883,6184,160651,6841,3301,3540
27490,170323,9644,81898,6186,160679,6842,3301,3541
27495,170354,9647,81915,6187,160707,6843,3302,3541
27500,170385,9650,81930,6189,160735,6844,3302,3542
27505,170416,9652,81945,6189,160764,6845,3302,3543
27510,170447,9654,81960,6189,160793,6846,3303,3543
27515,170478,9656,81975,6191,160822,6847,3303,3544
27520,170509,9658,81992,6193,160851,6848,3303,3545
27525,170540,9661,82010,6195,160878,6849,3303,3546
27530,170571,9664,82024,6197,160907,6850,3303,3547
27535,170602,9666,82034,6198,160936,6851,3303,3548
27540,170633,9668,82049,6199,160965,6852,3303,3549
27545,170664,9670,82062,6200,160994,6853,3303,3550
27550,170695,9671,82077,6200,161024,6854,3304,3550
27555,170726,9673,82097,6202,161053,6855,3305,3550
27560,170757,9675,82111,6203,161082,6856,3305,3551
27565,170788,9677,82125,6204,161111,6857,3306,3551
27570,170819,9679,82141,6205,161140,6858,3306,3552
27575,170850,9680,82165,6206,161170,6859,3306,3553
27580,170881,9681,82179,6206,161200,6861,3307,3554
27585,170912,9682,82193,6207,161230,6863,3308,3555
27590,170943,9683,82209,6208,161260,6866,3310,3556
27595,170974,9684,82221,6208,161290,6869,3310,3559
27600,171005,9685,82235,6209,161320,6871,3310,3561
27605,171036,9685,82251,6209,161351,6872,3311,3561
27610,171067,9685,82264,6209,161382,6873,3312,3561
27615,171098,9685,82279,6209,161413,6874,3312,3562
27620,171129,9685,82292,6209,161444,6875,3312,3563
27625,171160,9685,82308,6209,161475,6876,3313,3563
27630,171191,9685,82326,6209,161506,6877,3314,3563
27635,171222,9685,82337,6209,161537,6878,3314,3564
27640,171253,9685,82354,6209,161568,6879,3314,3565
27645,171284,9687,82374,6210,161597,6880,3315,3565
27650,171315,9689,82388,6211,161626,6881,3316,3565
27655,171346,9692,82403,6214,161654,6882,3316,3566
27660,171377,9694,82417,6215,161682,6883,3317,3566
27665,171408,9697,82430,6218,161711,6884,3318,3566
27670,171439,9699,82442,6219,161740,6885,3318,3567
27675,171470,9700,82455,6219,161770,6886,3318,3568
27680,171501,9701,82468,6219,161800,6887,3318,3569
27685,171532,9704,82484,6222,161828,6888,3318,3570
27690,171563,9706,82500,6224,161857,6889,3318,3571
27695,171594,9708,82518,6226,161886,6890,3319,3571
27700,171625,9708,82534,6226,161917,6891,3319,3572
27705,171656,9708,82551,6226,161948,6892,3320,3572
27710,171687,9708,82563,6226,161979,6894,3321,3573
27715,171718,9708,82575,6226,162010,6896,3321,3575
27720,171749,9708,82591,6226,162041,6898,3322,3576
27725,171780,9708,82604,6226,162072,6900,3322,3578
27730,171811,9708,82615,6226,162103,6901,3322,3579
27735,171842,9708,82630,6226,162134,6902,3323,3579
27740,171873,9708,82645,6226,162165,6903,3323,3580
27745,171904,9708,82661,6226,162196,6904,3324,3580
27750,171935,9708,82679,6226,162227,6905,3325,3580
27755,171966,9708,82692,6226,162258,6906,3325,3581
27760,171997,9708,82708,6226,162289,6907,3325,3582
27765,172028,9708,82722,6226,162320,6908,3326,3582
27770,172059,9711,82738,6228,162348,6910,3326,3584
27775,172090,9714,82753,6231,162376,6912,3327,3585
27780,172121,9717,82764,6233,162403,6914,3328,3586
27785,172152,9719,82779,6235,162433,6914,3328,3586
27790,172183,9720,82794,6236,162463,6914,3328,3586
27795,172214,9721,82812,6236,162493,6914,3328,3586
27800,172245,9722,82833,6237,162523,6914,3328,3586
27805,172276,9723,82848,6237,162553,6914,3328,3586
27810,172307,9724,82859,6237,162583,6914,3328,3586
27815,172338,9725,82874,6238,162613,6914,3328,3586
27820,172369,9726,82892,6239,162643,6914,3328,3586
27825,172400,9727,82907,6239,162673,6914,3328,3586
27830,172431,9728,82923,6239,162703,6915,3328,3587
27835,172462,9730,82940,6240,162732,6916,3329,3587
27840,172493,9731,82958,6241,162762,6917,3329,3588
27845,172524,9732,82974,6241,162792,6919,3330,3589
27850,172555,9733,82983,6242,162822,6920,3331,3589
27855,172586,9735,82994,6243,162851,6921,3331,3590
27860,172617,9736,83009,6243,162881,6922,3331,3591
27865,172648,9737,83024,6243,162911,6923,3332,3591
27870,172679,9739,83038,6245,162940,6924,3332,3592
27875,172710,9740,83051,6245,162970,6925,3333,3592
27880,172741,9741,83064,6245,163000,6926,3334,3592
27885,172772,9742,83080,6245,163030,6927,3334,3593
27890,172803,9747,83096,6248,163056,6928,3335,3593
27895,172834,9753,83111,6254,163081,6929,3335,3594
27900,172865,9757,83129,6257,163108,6930,3336,3594
27905,172896,9757,83142,6257,163139,6931,3337,3594
27910,172927,9757,83158,6257,163170,6932,3338,3594
27915,172958,9757,83175,6257,163201,6933,3339,3594
27920,172989,9757,83190,6257,163232,6934,3340,3594
27925,173020,9757,83207,6257,163263,6935,3341,3594
27930,173051,9757,83222,6257,163294,6936,3341,3595
27935,173082,9757,83242,6257,163325,6937,3341,3596
27940,173113,9757,83255,6257,163356,6938,3341,3597
27945,173144,9757,83270,6257,163387,6939,3341,3598
27950,173175,9757,83280,6257,163418,6941,3342,3599
27955,173206,9757,83295,6257,163449,6943,3343,3600
27960,173237,9757,83311,6257,163480,6945,3344,3601
27965,173268,9757,83324,6257,163511,6946,3344,3602
27970,173299,9757,83341,6257,163542,6947,3344,3603
27975,173330,9757,83353,6257,163573,6948,3344,3604
27980,173361,9757,83367,6257,163604,6949,3345,3604
27985,173392,9757,83379,6257,163635,6950,3346,3604
27990,173423,9757,83388,6257,163666,6951,3347,3604
27995,173454,9757,83398,6257,163697,6952,3348,3604
28000,173485,9758,83412,6257,163727,6953,3349,3604
28005,173516,9759,83430,6258,163757,6954,3349,3605
28010,173547,9762,83444,6259,163784,6955,3349,3606
28015,173578,9768,83457,6263,163810,6957,3350,3607
28020,173609,9773,83473,6267,163835,6959,3351,3608
28025,173640,9778,83484,6271,163862,6961,3352,3609
28030,173671,9782,83503,6274,163889,6963,3353,3610
28035,173702,9785,83516,6277,163917,6965,3354,3611
28040,173733,9789,83527,6279,163944,6967,3354,3613
28045,173764,9791,83539,6279,163973,6969,3355,3614
28050,173795,9792,83550,6279,164003,6971,3355,3616
28055,173826,9794,83567,6281,164032,6972,3356,3616
28060,173857,9795,83583,6282,164062,6973,3356,3617
28065,173888,9797,83596,6283,164091,6974,3357,3617
28070,173919,9798,83607,6283,164121,6975,3357,3618
28075,173950,9800,83618,6284,164150,6976,3358,3618
28080,173981,9801,83630,6284,164180,6978,3359,3619
28085,174012,9803,83644,6286,164209,6980,3361,3619
28090,174043,9805,83659,6287,164238,6981,3361,3620
28095,174074,9807,83672,6288,164267,6982,3362,3620
28100,174105,9809,83689,6288,164296,6983,3363,3620
28105,174136,9812,83701,6290,164324,6984,3363,3621
28110,174167,9815,83719,6292,164352,6985,3363,3622
28115,174198,9818,83732,6295,164380,6986,3364,3622
28120,174229,9821,83746,6296,164408,6987,3364,3623
28125,174260,9823,83766,6298,164437,6988,3365,3623
28130,174291,9825,83774,6299,164466,6989,3365,3624
28135,174322,9827,83786,6300,164495,6990,3365,3625
28140,174353,9827,83800,6300,164526,6991,3365,3626
28145,174384,9829,83815,6301,164555,6991,3365,3626
28150,174415,9830,83831,6301,164585,6991,3365,3626
28155,174446,9831,83846,6302,164615,6992,3365,3627
28160,174477,9832,83865,6303,164645,6993,3366,3627
28165,174508,9833,83878,6304,164675,6994,3367,3627
28170,174539,9834,83891,6304,164705,6995,3367,3628
28175,174570,9835,83909,6305,164735,6996,3368,3628
28180,174601,9836,83926,6305,164765,6997,3369,3628
28185,174632,9837,83943,6305,164795,6998,3370,3628
28190,174663,9838,83954,6306,164825,6999,3370,3629
28195,174694,9839,83968,6307,164855,7000,3370,3630
28200,174725,9840,83981,6307,164885,7001,3371,3630
28205,174756,9841,83993,6307,164915,7001,3371,3630
28210,174787,9842,84008,6307,164945,7001,3371,3630
28215,174818,9843,84021,6308,164975,7001,3371,3630
28220,174849,9844,84039,6308,165005,7001,3371,3630
28225,174880,9846,84053,6309,165034,7001,3371,3630
28230,174911,9848,84070,6311,165063,7001,3371,3630
28235,174942,9850,84086,6311,165092,7001,3371,3630
28240,174973,9853,84102,6313,165120,7001,3371,3630
28245,175004,9858,84115,6318,165146,7001,3371,3630
28250,175035,9861,84126,6319,165174,7002,3372,3630
28255,175066,9866,84140,6322,165200,7003,3373,3630
28260,175097,9870,84159,6326,165227,7004,3373,3631
28265,175128,9872,84173,6327,165255,7005,3373,3632
28270,175159,9875,84189,6330,165284,7006,3373,3633
28275,175190,9876,84200,6330,165314,7007,3373,3634
28280,175221,9878,84212,6331,165343,7008,3373,3635
28285,175252,9879,84221,6331,165373,7009,3374,3635
28290,175283,9880,84235,6332,165403,7010,3374,3636
28295,175314,9882,84257,6334,165431,7011,3374,3637
28300,175345,9884,84264,6335,165460,7012,3374,3638
28305,175376,9887,84283,6337,165488,7014,3375,3639
28310,175407,9890,84298,6340,165517,7015,3375,3640
28315,175438,9890,84311,6340,165548,7016,3376,3640
28320,175469,9890,84328,6340,165579,7017,3376,3641
28325,175500,9890,84339,6340,165610,7018,3377,3641
28330,175531,9890,84352,6340,165641,7019,3377,3642
28335,175562,9890,84367,6340,165672,7020,3377,3643
28340,175593,9890,84381,6340,165703,7021,3377,3644
28345,175624,9890,84393,6340,165734,7022,3377,3645
28350,175655,9890,84408,6340,165765,7023,3377,3646
28355,175686,9890,84421,6340,165796,7024,3378,3646
28360,175717,9890,84438,6340,165827,7025,3378,3647
28365,175748,9892,84454,6342,165856,7026,3378,3648
28370,175779,9894,84465,6342,165885,7027,3378,3649
28375,175810,9897,84483,6344,165913,7028,3379,3649
28380,175841,9902,84498,6348,165939,7029,3379,3650
28385,175872,9906,84511,6351,165966,7031,3380,3651
28390,175903,9909,84527,6352,165994,7033,3382,3651
28395,175934,9912,84538,6354,166022,7035,3383,3652
28400,175965,9914,84553,6356,166051,7037,3383,3654
28405,175996,9915,84574,6357,166081,7038,3384,3654
28410,176027,9916,84588,6358,166111,7039,3384,3655
28415,176058,9917,84603,6359,166141,7040,3384,3656
28420,176089,9919,84620,6360,166169,7042,3384,3658
28425,176120,9922,84634,6362,166198,7044,3386,3658
28430,176151,9924,84652,6363,166227,7046,3387,3659
28435,176182,9926,84672,6365,166255,7048,3388,3660
28440,176213,9929,84683,6367,166284,7050,3388,3662
28445,176244,9932,84700,6370,166311,7052,3388,3664
28450,176275,9936,84716,6372,166338,7053,3388,3665
28455,176306,9939,84726,6375,166367,7054,3388,3666
28460,176337,9942,84740,6377,166394,7055,3388,3667
28465,176368,9945,84749,6380,166423,7056,3389,3667
28470,176399,9948,84763,6381,166450,7057,3390,3667
28475,176430,9952,84781,6385,166477,7058,3390,3668
28480,176461,9955,84797,6388,166505,7059,3391,3668
28485,176492,9957,84806,6390,166535,7060,3392,3668
28490,176523,9957,84818,6390,166566,7061,3393,3668
28495,176554,9957,84830,6390,166597,7062,3393,3669
28500,176585,9957,84846,6390,166628,7063,3393,3670
28505,176616,9960,84865,6393,166656,7065,3395,3670
28510,176647,9964,84877,6395,166683,7067,3396,3671
28515,176678,9966,84887,6397,166712,7069,3397,3672
28520,176709,9969,84901,6400,166740,7071,3398,3673
28525,176740,9972,84918,6402,166768,7073,3400,3673
28530,176771,9974,84931,6403,166797,7075,3400,3675
28535,176802,9976,84951,6405,166826,7076,3401,3675
28540,176833,9977,84964,6406,166856,7077,3402,3675
28545,176864,9977,84983,6406,166887,7078,3403,3675
28550,176895,9977,85000,6406,166918,7080,3404,3676
28555,176926,9977,85015,6406,166949,7082,3405,3677
28560,176957,9977,85027,6406,166980,7084,3405,3679
28565,176988,9977,85039,6406,167011,7085,3405,3680
28570,177019,9977,85055,6406,167042,7086,3406,3680
28575,177050,9977,85070,6406,167073,7087,3407,3680
28580,177081,9977,85086,6406,167104,7088,3407,3681
28585,177112,9977,85098,6406,167135,7089,3408,3681
28590,177143,9978,85115,6406,167165,7090,3409,3681
28595,177174,9979,85131,6407,167195,7091,3409,3682
28600,177205,9981,85147,6409,167224,7092,3410,3682
28605,177236,9982,85166,6410,167254,7093,3410,3683
28610,177267,9984,85181,6411,167282,7094,3411,3683
28615,177298,9987,85192,6413,167311,7095,3411,3684
28620,177329,9989,85206,6414,167340,7096,3411,3685
28625,177360,9992,85222,6415,167368,7097,3411,3686
28630,177391,9994,85238,6416,167396,7098,3411,3687
28635,177422,9997,85255,6419,167424,7100,3413,3687
28640,177453,10000,85270,6420,167452,7102,3414,3688
28645,177484,10003,85284,6422,167481,7104,3415,3689
28650,177515,10005,85299,6423,167510,7106,3415,3691
28655,177546,10008,85317,6425,167538,7108,3417,3691
28660,177577,10010,85330,6426,167567,7110,3418,3692
28665,177608,10012,85341,6427,167596,7112,3418,3694
28670,177639,10014,85352,6428,167625,7115,3420,3695
28675,177670,10016,85365,6429,167654,7118,3421,3697
28680,177701,10018,85384,6429,167683,7121,3424,3697
28685,177732,10020,85400,6430,167712,7124,3425,3699
28690,177763,10022,85405,6430,167741,7126,3426,3700
28695,177794,10024,85422,6431,167770,7127,3426,3701
28700,177825,10026,85440,6432,167799,7128,3426,3702
28705,177856,10028,85458,6434,167828,7129,3427,3702
28710,177887,10030,85474,6436,167857,7130,3428,3702
28715,177918,10032,85485,6437,167886,7131,3428,3703
28720,177949,10034,85500,6438,167915,7132,3429,3703
28725,177980,10036,85517,6440,167944,7133,3430,3703
28730,178011,10038,85536,6441,167973,7134,3431,3703
28735,178042,10041,85547,6444,168001,7135,3432,3703
28740,178073,10043,85558,6444,168030,7136,3433,3703
28745,178104,10046,85572,6446,168058,7137,3434,3703
28750,178135,10048,85588,6447,168087,7138,3435,3703
28755,178166,10049,85608,6448,168117,7139,3436,3703
28760,178197,10050,85623,6449,168147,7140,3436,3704
28765,178228,10051,85640,6449,168177,7141,3436,3705
28770,178259,10052,85653,6450,168206,7142,3436,3706
28775,178290,10054,85665,6451,168236,7143,3437,3706
28780,178321,10055,85678,6451,168266,7144,3438,3706
28785,178352,10056,85693,6452,168296,7145,3439,3706
28790,178383,10057,85710,6452,168325,7146,3440,3706
28795,178414,10059,85729,6454,168354,7148,3441,3707
28800,178445,10061,85741,6456,168383,7150,3442,3708
28805,178476,10065,85754,6458,168411,7153,3442,3711
28810,178507,10068,85767,6459,168439,7156,3443,3713
28815,178538,10071,85780,6460,168467,7158,3443,3715
28820,178569,10075,85797,6462,168494,7160,3444,3716
28825,178600,10078,85812,6464,168522,7162,3444,3718
28830,178631,10081,85830,6466,168550,7164,3444,3720
28835,178662,10082,85848,6466,168580,7166,3446,3720
28840,178693,10084,85862,6467,168609,7167,3446,3721
28845,178724,10085,85877,6468,168639,7168,3446,3722
28850,178755,10087,85892,6470,168668,7169,3447,3722
28855,178786,10091,85910,6473,168695,7170,3448,3722
28860,178817,10094,85927,6476,168723,7171,3448,3723
28865,178848,10096,85940,6477,168752,7172,3448,3724
28870,178879,10098,85956,6478,168780,7173,3448,3725
28875,178910,10102,85969,6480,168808,7174,3448,3726
28880,178941,10104,85981,6480,168836,7175,3449,3726
28885,178972,10108,85996,6483,168864,7176,3449,3727
28890,179003,10110,86014,6484,168893,7177,3450,3727
28895,179034,10111,86030,6484,168923,7178,3450,3728
28900,179065,10112,86043,6484,168953,7179,3450,3729
28905,179096,10113,86055,6484,168983,7180,3451,3729
28910,179127,10115,86072,6485,169012,7181,3451,3730
28915,179158,10116,86091,6486,169042,7183,3452,3731
28920,179189,10117,86106,6487,169072,7185,3454,3731
28925,179220,10118,86122,6487,169102,7187,3456,3731
28930,179251,10119,86133,6488,169132,7188,3456,3732
28935,179282,10120,86147,6488,169162,7189,3457,3732
28940,179313,10121,86165,6489,169192,7190,3458,3732
28945,179344,10122,86176,6489,169222,7191,3459,3732
28950,179375,10123,86193,6489,169252,7192,3460,3732
28955,179406,10124,86207,6489,169282,7193,3461,3732
28960,179437,10125,86220,6489,169312,7194,3461,3733
28965,179468,10125,86239,6489,169343,7196,3463,3733
28970,179499,10126,86255,6489,169373,7198,3464,3734
28975,179530,10128,86274,6491,169402,7200,3465,3735
28980,179561,10130,86290,6493,169431,7201,3465,3736
28985,179592,10132,86305,6494,169459,7202,3466,3736
28990,179623,10136,86317,6497,169487,7203,3466,3737
28995,179654,10140,86330,6500,169513,7204,3467,3737
29000,179685,10144,86339,6502,169540,7205,3468,3737
29005,179716,10148,86354,6505,169568,7206,3468,3738
29010,179747,10151,86364,6507,169595,7207,3468,3739
29015,179778,10154,86380,6510,169623,7208,3468,3740
29020,179809,10157,86395,6512,169651,7209,3469,3740
29025,179840,10160,86407,6514,169680,7210,3469,3741
29030,179871,10162,86424,6515,169708,7212,3470,3742
29035,179902,10165,86444,6517,169736,7213,3471,3742
29040,179933,10168,86458,6520,169764,7214,3472,3742
29045,179964,10171,86472,6521,169793,7215,3472,3743
29050,179995,10174,86487,6523,169821,7216,3472,3744
29055,180026,10176,86501,6524,169850,7217,3473,3744
29060,180057,10179,86514,6526,169878,7218,3473,3745
29065,180088,10181,86526,6527,169907,7219,3473,3746
29070,180119,10184,86540,6529,169935,7220,3473,3747
29075,180150,10186,86553,6529,169964,7221,3473,3748
29080,180181,10190,86575,6533,169991,7222,3473,3749
29085,180212,10192,86589,6534,170020,7224,3475,3749
29090,180243,10193,86604,6535,170050,7226,3475,3751
29095,180274,10194,86614,6536,170080,7228,3476,3752
29100,180305,10195,86626,6536,170110,7230,3477,3753
29105,180336,10195,86637,6536,170141,7231,3477,3754
29110,180367,10195,86648,6536,170172,7231,3477,3754
29115,180398,10196,86664,6537,170202,7231,3477,3754
29120,180429,10198,86682,6539,170231,7231,3477,3754
29125,180460,10201,86695,6541,170259,7231,3477,3754
29130,180491,10203,86712,6543,170288,7231,3477,3754
29135,180522,10205,86730,6545,170317,7231,3477,3754
29140,180553,10207,86746,6546,170346,7231,3477,3754
29145,180584,10208,86761,6547,170376,7231,3477,3754
29150,180615,10211,86781,6550,170404,7231,3477,3754
29155,180646,10213,86794,6551,170433,7231,3477,3754
29160,180677,10216,86808,6553,170461,7231,3477,3754
29165,180708,10217,86825,6554,170491,7233,3479,3754
29170,180739,10218,86841,6555,170521,7234,3480,3754
29175,180770,10219,86854,6556,170551,7235,3481,3754
29180,180801,10220,86867,6557,170581,7236,3481,3755
29185,180832,10221,86881,6557,170611,7237,3481,3756
29190,180863,10222,86901,6558,170641,7238,3481,3757
29195,180894,10223,86915,6559,170671,7239,3482,3757
29200,180925,10224,86928,6559,170701,7240,3482,3758
29205,180956,10225,86941,6560,170731,7241,3482,3759
29210,180987,10228,86958,6563,170759,7242,3483,3759
29215,181018,10232,86971,6566,170786,7243,3483,3760
29220,181049,10236,86988,6568,170813,7244,3484,3760
29225,181080,10237,87004,6569,170843,7245,3485,3760
29230,181111,10238,87021,6569,170873,7246,3486,3760
29235,181142,10239,87037,6570,170903,7247,3487,3760
29240,181173,10240,87051,6570,170933,7248,3487,3761
29245,181204,10241,87071,6571,170963,7249,3488,3761
29250,181235,10242,87084,6572,170993,7250,3488,3762
29255,181266,10243,87102,6573,171023,7251,3489,3762
29260,181297,10244,87116,6573,171053,7252,3490,3762
29265,181328,10245,87130,6573,171083,7253,3490,3763
29270,181359,10247,87148,6574,171112,7255,3492,3763
29275,181390,10249,87161,6574,171140,7257,3492,3765
29280,181421,10252,87177,6576,171168,7259,3493,3766
29285,181452,10255,87193,6577,171197,7260,3494,3766
29290,181483,10257,87207,6579,171225,7261,3495,3766
29295,181514,10260,87225,6582,171254,7262,3496,3766
29300,181545,10262,87238,6582,171282,7263,3496,3767
29305,181576,10265,87250,6583,171311,7264,3496,3768
29310,181607,10267,87267,6584,171339,7265,3496,3769
29315,181638,10270,87279,6585,171368,7266,3496,3770
29320,181669,10272,87294,6586,171396,7267,3497,3770
29325,181700,10278,87308,6591,171422,7268,3498,3770
29330,181731,10283,87323,6596,171448,7269,3499,3770
29335,181762,10289,87338,6600,171473,7271,3501,3770
29340,181793,10294,87348,6604,171499,7273,3501,3772
29345,181824,10296,87364,6605,171528,7275,3501,3774
29350,181855,10300,87386,6608,171555,7277,3503,3774
29355,181886,10302,87399,6610,171584,7278,3503,3775
29360,181917,10305,87412,6612,171612,7279,3503,3776
29365,181948,10307,87425,6612,171641,7280,3504,3776
29370,181979,10309,87442,6612,171670,7281,3505,3776
29375,182010,10311,87455,6612,171699,7282,3506,3776
29380,182041,10313,87473,6614,171728,7283,3506,3777
29385,182072,10314,87484,6614,171758,7285,3508,3777
29390,182103,10315,87501,6615,171788,7287,3509,3778
29395,182134,10316,87516,6615,171818,7289,3510,3779
29400,182165,10317,87530,6616,171848,7291,3511,3780
29405,182196,10318,87546,6616,171878,7293,3512,3781
29410,182227,10319,87558,6616,171908,7295,3512,3783
29415,182258,10320,87574,6617,171938,7297,3514,3783
29420,182289,10321,87588,6618,171968,7299,3514,3785
29425,182320,10322,87604,6619,171998,7301,3515,3786
29430,182351,10323,87616,6619,172028,7303,3515,3788
29435,182382,10324,87631,6619,172058,7305,3516,3789
29440,182413,10325,87650,6620,172088,7307,3517,3790
29445,182444,10327,87660,6620,172116,7308,3517,3791
29450,182475,10330,87677,6623,172145,7310,3517,3793
29455,182506,10334,87699,6627,172171,7312,3519,3793
29460,182537,10336,87712,6628,172201,7313,3519,3794
29465,182568,10338,87731,6630,172230,7314,3519,3795
29470,182599,10339,87744,6630,172260,7315,3519,3796
29475,182630,10341,87758,6631,172289,7316,3520,3796
29480,182661,10342,87774,6632,172319,7317,3521,3796
29485,182692,10343,87787,6633,172349,7318,3522,3796
29490,182723,10346,87805,6635,172377,7319,3523,3796
29495,182754,10349,87825,6637,172405,7320,3524,3796
29500,182785,10351,87836,6637,172434,7321,3524,3797
29505,182816,10354,87851,6638,172462,7322,3525,3797
29510,182847,10358,87868,6641,172489,7323,3525,3798
29515,182878,10361,87888,6644,172517,7324,3525,3799
29520,182909,10363,87901,6645,172546,7325,3525,3800
29525,182940,10365,87921,6647,172575,7326,3525,3801
29530,182971,10366,87938,6647,172605,7327,3526,3801
29535,183002,10367,87951,6648,172635,7328,3527,3801
29540,183033,10368,87961,6648,172665,7329,3528,3801
29545,183064,10369,87975,6649,172695,7331,3529,3802
29550,183095,10371,87988,6651,172724,7333,3529,3804
29555,183126,10373,88004,6653,172753,7335,3529,3806
29560,183157,10378,88019,6658,172779,7337,3530,3807
29565,183188,10381,88030,6659,172807,7340,3530,3810
29570,183219,10384,88047,6660,172835,7342,3531,3811
29575,183250,10387,88064,6662,172863,7344,3532,3812
29580,183281,10390,88072,6664,172891,7346,3533,3813
29585,183312,10393,88089,6666,172919,7347,3534,3813
29590,183343,10398,88106,6670,172945,7348,3535,3813
29595,183374,10401,88122,6672,172973,7349,3536,3813
29600,183405,10402,88139,6672,173003,7350,3536,3814
29605,183436,10403,88155,6672,173033,7351,3536,3815
29610,183467,10404,88167,6673,173063,7352,3537,3815
29615,183498,10405,88179,6673,173093,7353,3538,3815
29620,183529,10406,88194,6673,173123,7354,3539,3815
29625,183560,10407,88211,6674,173153,7355,3540,3815
29630,183591,10408,88229,6675,173183,7356,3540,3816
29635,183622,10409,88240,6676,173213,7357,3540,3817
29640,183653,10410,88256,6677,173243,7358,3540,3818
29645,183684,10410,88277,6677,173274,7360,3540,3820
29650,183715,10410,88296,6677,173305,7362,3541,3821
29655,183746,10410,88310,6677,173336,7363,3542,3821
29660,183777,10410,88329,6677,173367,7364,3542,3822
29665,183808,10410,88344,6677,173398,7365,3542,3823
29670,183839,10410,88357,6677,173429,7366,3543,3823
29675,183870,10410,88373,6677,173460,7367,3544,3823
29680,183901,10410,88388,6677,173491,7368,3545,3823
29685,183932,10410,88404,6677,173522,7370,3547,3823
29690,183963,10412,88423,6678,173551,7372,3549,3823
29695,183994,10414,88435,6679,173580,7374,3549,3825
29700,184025,10416,88452,6681,173608,7375,3550,3825
29705,184056,10422,88463,6687,173633,7376,3550,3826
29710,184087,10427,88482,6691,173659,7377,3550,3827
29715,184118,10431,88495,6694,173686,7378,3550,3828
29720,184149,10435,88508,6698,173714,7379,3550,3829
29725,184180,10437,88525,6700,173743,7380,3550,3830
29730,184211,10440,88544,6702,173770,7381,3551,3830
29735,184242,10444,88557,6705,173798,7382,3552,3830
29740,184273,10446,88573,6706,173827,7383,3552,3831
29745,184304,10448,88589,6706,173856,7384,3553,3831
29750,184335,10450,88603,6706,173885,7385,3553,3832
29755,184366,10452,88614,6706,173914,7386,3554,3832
29760,184397,10456,88630,6709,173941,7387,3554,3833
29765,184428,10456,88640,6709,173972,7388,3555,3833
29770,184459,10456,88652,6709,174003,7388,3555,3833
29775,184490,10456,88669,6709,174034,7388,3555,3833
29780,184521,10456,88687,6709,174065,7388,3555,3833
29785,184552,10456,88705,6709,174096,7388,3555,3833
29790,184583,10456,88718,6709,174127,7388,3555,3833
29795,184614,10456,88733,6709,174158,7388,3555,3833
29800,184645,10456,88752,6709,174189,7388,3555,3833
29805,184676,10456,88764,6709,174220,7388,3555,3833
29810,184707,10456,88777,6709,174251,7388,3555,3833
29815,184738,10457,88792,6710,174281,7388,3555,3833
29820,184769,10459,88806,6712,174310,7388,3555,3833
29825,184800,10461,88817,6714,174339,7389,3555,3834
29830,184831,10463,88831,6716,174368,7390,3556,3834
29835,184862,10464,88845,6717,174398,7391,3556,3835
29840,184893,10467,88858,6720,174426,7392,3556,3836
29845,184924,10469,88876,6722,174455,7393,3556,3837
29850,184955,10471,88892,6724,174484,7394,3556,3838
29855,184986,10474,88911,6726,174512,7395,3557,3838
29860,185017,10474,88930,6726,174543,7396,3558,3838
29865,185048,10474,88947,6726,174574,7397,3559,3838
29870,185079,10474,88957,6726,174605,7399,3560,3839
29875,185110,10477,88972,6727,174632,7401,3561,3840
29880,185141,10482,88984,6731,174659,7403,3561,3842
29885,185172,10485,88996,6733,174687,7404,3561,3843
29890,185203,10489,89014,6737,174714,7405,3562,3843
29895,185234,10490,89029,6738,174744,7406,3563,3843
29900,185265,10491,89046,6739,174774,7407,3563,3844
29905,185296,10493,89064,6741,174803,7408,3563,3845
29910,185327,10495,89074,6742,174832,7409,3563,3846
29915,185358,10497,89089,6743,174861,7410,3563,3847
29920,185389,10498,89104,6744,174891,7411,3564,3847
29925,185420,10500,89121,6746,174920,7413,3566,3847
29930,185451,10501,89138,6746,174950,7415,3568,3847
29935,185482,10501,89154,6746,174981,7416,3569,3847
29940,185513,10501,89166,6746,175012,7417,3569,3848
29945,185544,10501,89180,6746,175043,7418,3570,3848
29950,185575,10501,89193,6746,175074,7419,3571,3848
29955,185606,10501,89206,6746,175105,7420,3571,3849
29960,185637,10501,89220,6746,175136,7421,3572,3849
29965,185668,10502,89238,6746,175166,7422,3573,3849
29970,185699,10503,89252,6746,175196,7423,3574,3849
29975,185730,10504,89271,6746,175226,7424,3574,3850
29980,185761,10506,89286,6747,175255,7425,3575,3850
29985,185792,10508,89302,6749,175284,7426,3575,3851
29990,185823,10509,89316,6749,175314,7427,3575,3852
29995,185854,10512,89331,6750,175342,7428,3576,3852
30000,185885,10515,89349,6752,175370,7429,3577,3852
30005,185916,10518,89362,6755,175398,7430,3577,3853
30010,185947,10523,89376,6760,175424,7431,3578,3853
30015,185978,10526,89391,6761,175452,7432,3579,3853
30020,186009,10526,89406,6761,175483,7433,3579,3854
30025,186040,10526,89414,6761,175514,7434,3579,3855
30030,186071,10526,89424,6761,175545,7435,3580,3855
30035,186102,10526,89439,6761,175576,7436,3580,3856
30040,186133,10526,89454,6761,175607,7437,3581,3856
30045,186164,10526,89470,6761,175638,7438,3582,3856
30050,186195,10526,89484,6761,175669,7439,3583,3856
30055,186226,10526,89493,6761,175700,7440,3584,3856
30060,186257,10526,89506,6761,175731,7441,3584,3857
30065,186288,10529,89519,6764,175759,7443,3585,3858
30070,186319,10530,89525,6765,175789,7444,3585,3859
30075,186350,10531,89538,6766,175819,7445,3585,3860
30080,186381,10532,89554,6767,175849,7446,3585,3861
30085,186412,10534,89571,6769,175878,7447,3586,3861
30090,186443,10536,89583,6771,175907,7448,3586,3862
30095,186474,10537,89600,6772,175937,7449,3586,3863
30100,186505,10538,89618,6773,175967,7450,3586,3864
30105,186536,10540,89623,6773,175996,7451,3586,3865
30110,186567,10541,89641,6773,176026,7452,3587,3865
30115,186598,10542,89655,6773,176056,7453,3588,3865
30120,186629,10544,89667,6773,176085,7454,3588,3866
30125,186660,10548,89686,6777,176111,7455,3589,3866
30130,186691,10552,89699,6780,176139,7456,3589,3867
30135,186722,10556,89714,6783,176165,7457,3590,3867
30140,186753,10559,89726,6785,176194,7458,3591,3867
30145,186784,10560,89743,6786,176224,7459,3592,3867
30150,186815,10561,89753,6787,176254,7460,3592,3868
30155,186846,10562,89765,6788,176284,7461,3592,3869
30160,186877,10563,89777,6788,176314,7462,3592,3870
30165,186908,10564,89789,6789,176344,7463,3592,3871
30170,186939,10565,89807,6789,176374,7464,3593,3871
30175,186970,10566,89823,6789,176403,7465,3594,3871
30180,187001,10568,89839,6791,176432,7466,3594,3872
30185,187032,10572,89852,6794,176460,7468,3594,3874
30190,187063,10574,89866,6795,176489,7470,3595,3875
30195,187094,10576,89878,6796,176518,7472,3597,3875
30200,187125,10578,89895,6797,176547,7474,3598,3876
30205,187156,10580,89910,6798,176576,7476,3598,3878
30210,187187,10583,89926,6800,176604,7478,3600,3878
30215,187218,10585,89943,6802,176633,7480,3600,3880
30220,187249,10588,89965,6805,176661,7481,3600,3881
30225,187280,10590,89989,6807,176690,7482,3601,3881
30230,187311,10592,90001,6808,176719,7483,3601,3882
30235,187342,10594,90013,6809,176748,7484,3602,3882
30240,187373,10596,90028,6810,176777,7485,3602,3883
30245,187404,10598,90038,6811,176806,7485,3602,3883
30250,187435,10601,90055,6812,176834,7485,3602,3883
30255,187466,10603,90070,6813,176863,7485,3602,3883
30260,187497,10605,90086,6815,176892,7485,3602,3883
30265,187528,10608,90106,6817,176920,7485,3602,3883
30270,187559,10610,90119,6818,176949,7485,3602,3883
30275,187590,10612,90138,6819,176978,7485,3602,3883
30280,187621,10614,90152,6820,177007,7485,3602,3883
30285,187652,10617,90172,6822,177035,7485,3602,3883
30290,187683,10620,90188,6824,177063,7485,3602,3883
30295,187714,10623,90202,6827,177091,7485,3602,3883
30300,187745,10627,90217,6830,177118,7485,3602,3883
30305,187776,10630,90233,6833,177146,7486,3603,3883
30310,187807,10631,90246,6834,177176,7487,3603,3884
30315,187838,10632,90260,6834,177206,7488,3603,3885
30320,187869,10633,90275,6835,177236,7489,3603,3886
30325,187900,10634,90286,6835,177266,7490,3604,3886
30330,187931,10635,90301,6836,177296,7491,3604,3887
30335,187962,10636,90319,6837,177326,7492,3605,3887
30340,187993,10637,90332,6838,177356,7493,3605,3888
30345,188024,10638,90344,6838,177386,7494,3605,3889
30350,188055,10640,90357,6839,177414,7496,3605,3891
30355,188086,10643,90378,6841,177442,7497,3606,3891
30360,188117,10646,90397,6843,177470,7498,3607,3891
30365,188148,10650,90415,6846,177498,7500,3608,3892
30370,188179,10653,90433,6847,177525,7502,3610,3892
30375,188210,10657,90450,6848,177553,7504,3611,3893
30380,188241,10660,90461,6850,177581,7505,3611,3894
30385,188272,10663,90478,6851,177609,7506,3612,3894
30390,188303,10666,90495,6851,177637,7507,3613,3894
30395,188334,10669,90509,6853,177665,7508,3613,3895
30400,188365,10672,90523,6855,177693,7509,3614,3895
30405,188396,10675,90538,6856,177721,7510,3614,3896
30410,188427,10678,90551,6858,177749,7511,3614,3897
30415,188458,10681,90567,6859,177777,7512,3614,3898
30420,188489,10684,90580,6860,177805,7513,3614,3899
30425,188520,10686,90598,6861,177833,7514,3615,3899
30430,188551,10690,90610,6865,177860,7515,3615,3900
30435,188582,10693,90626,6867,177889,7516,3616,3900
30440,188613,10695,90645,6868,177918,7517,3616,3901
30445,188644,10697,90657,6870,177947,7518,3616,3902
30450,188675,10699,90672,6871,177975,7519,3616,3903
30455,188706,10701,90690,6873,178004,7520,3617,3903
30460,188737,10703,90709,6874,178033,7521,3617,3904
30465,188768,10705,90725,6876,178062,7522,3617,3905
30470,188799,10707,90738,6877,178092,7523,3617,3906
30475,188830,10709,90758,6878,178120,7524,3618,3906
30480,188861,10711,90770,6879,178150,7526,3620,3906
30485,188892,10711,90783,6879,178181,7527,3621,3906
30490,188923,10711,90794,6879,178212,7528,3622,3906
30495,188954,10711,90813,6879,178243,7529,3622,3907
30500,188985,10711,90828,6879,178274,7530,3622,3908
30505,189016,10711,90841,6879,178305,7532,3623,3909
30510,189047,10711,90856,6879,178336,7534,3625,3909
30515,189078,10711,90875,6879,178367,7536,3626,3910
30520,189109,10711,90890,6879,178398,7538,3628,3910
30525,189140,10712,90900,6879,178428,7540,3629,3911
30530,189171,10713,90910,6879,178458,7541,3630,3911
30535,189202,10714,90925,6879,178488,7542,3630,3912
30540,189233,10715,90940,6879,178518,7543,3630,3913
30545,189264,10717,90952,6881,178547,7544,3630,3914
30550,189295,10718,90964,6881,178577,7545,3631,3914
30555,189326,10721,90985,6883,178605,7546,3632,3914
30560,189357,10724,91001,6884,178632,7547,3632,3915
30565,189388,10728,91016,6886,178659,7548,3632,3916
30570,189419,10733,91033,6890,178685,7549,3633,3916
30575,189450,10736,91052,6892,178714,7550,3634,3916
30580,189481,10740,91070,6895,178741,7551,3635,3916
30585,189512,10744,91086,6899,178768,7552,3636,3916
30590,189543,10748,91101,6903,178795,7553,3636,3917
30595,189574,10750,91117,6904,178824,7554,3637,3917
30600,189605,10752,91135,6905,178853,7556,3639,3917
30605,189636,10754,91146,6906,178882,7558,3639,3919
30610,189667,10756,91159,6907,178911,7560,3640,3920
30615,189698,10759,91177,6909,178939,7561,3640,3921
30620,189729,10762,91194,6911,178967,7562,3641,3921
30625,189760,10765,91213,6913,178995,7563,3642,3921
30630,189791,10768,91223,6914,179023,7564,3643,3921
30635,189822,10772,91237,6918,179050,7565,3644,3921
30640,189853,10773,91251,6919,179080,7566,3644,3922
30645,189884,10775,91264,6921,179109,7567,3644,3923
30650,189915,10776,91277,6922,179139,7568,3645,3923
30655,189946,10777,91290,6922,179169,7570,3646,3924
30660,189977,10778,91304,6922,179199,7572,3647,3925
30665,190008,10780,91316,6924,179228,7574,3647,3927
30670,190039,10781,91329,6924,179258,7575,3648,3927
30675,190070,10782,91344,6924,179288,7576,3649,3927
30680,190101,10784,91358,6925,179317,7577,3650,3927
30685,190132,10786,91370,6926,179346,7578,3650,3928
30690,190163,10788,91383,6926,179375,7579,3650,3929
30695,190194,10790,91397,6928,179404,7580,3650,3930
30700,190225,10792,91412,6929,179433,7581,3651,3930
30705,190256,10795,91426,6931,179461,7582,3651,3931
30710,190287,10798,91442,6933,179488,7583,3652,3931
30715,190318,10802,91450,6935,179516,7585,3653,3932
30720,190349,10805,91466,6938,179543,7587,3655,3932
30725,190380,10809,91483,6941,179571,7588,3655,3933
30730,190411,10811,91505,6943,179600,7588,3655,3933
30735,190442,10813,91518,6944,179629,7588,3655,3933
30740,190473,10815,91540,6946,179658,7588,3655,3933
30745,190504,10816,91556,6947,179688,7588,3655,3933
30750,190535,10818,91570,6948,179717,7588,3655,3933
30755,190566,10819,91585,6948,179747,7588,3655,3933
30760,190597,10821,91598,6949,179776,7588,3655,3933
30765,190628,10822,91615,6950,179806,7588,3655,3933
30770,190659,10823,91631,6951,179836,7588,3655,3933
30775,190690,10825,91649,6953,179865,7588,3655,3933
30780,190721,10826,91664,6953,179895,7588,3655,3933
30785,190752,10828,91681,6954,179923,7589,3655,3934
30790,190783,10832,91697,6958,179950,7590,3656,3934
30795,190814,10837,91715,6963,179976,7591,3657,3934
30800,190845,10841,91732,6966,180004,7592,3658,3934
30805,190876,10845,91748,6968,180031,7593,3659,3934
30810,190907,10847,91763,6970,180060,7594,3659,3935
30815,190938,10849,91776,6971,180089,7595,3660,3935
30820,190969,10851,91791,6972,180118,7596,3660,3936
30825,191000,10853,91811,6974,180147,7598,3660,3938
30830,191031,10855,91826,6976,180176,7600,3661,3939
30835,191062,10857,91836,6977,180205,7602,3661,3941
30840,191093,10857,91853,6977,180236,7603,3662,3941
30845,191124,10857,91869,6977,180267,7604,3663,3941
30850,191155,10858,91883,6978,180297,7605,3663,3942
30855,191186,10860,91896,6979,180326,7606,3663,3943
30860,191217,10862,91913,6980,180355,7607,3664,3943
30865,191248,10864,91930,6981,180384,7608,3665,3943
30870,191279,10865,91944,6981,180414,7609,3666,3943
30875,191310,10866,91966,6982,180444,7610,3667,3943
30880,191341,10867,91977,6982,180474,7611,3668,3943
30885,191372,10869,91993,6983,180503,7612,3668,3944
30890,191403,10871,92011,6985,180532,7613,3668,3945
30895,191434,10873,92027,6987,180561,7614,3669,3945
30900,191465,10875,92041,6988,180590,7615,3669,3946
30905,191496,10875,92053,6988,180621,7616,3669,3947
30910,191527,10877,92068,6989,180650,7617,3669,3948
30915,191558,10878,92084,6989,180679,7618,3669,3949
30920,191589,10881,92100,6991,180707,7619,3669,3950
30925,191620,10883,92116,6993,180736,7620,3669,3951
30930,191651,10885,92128,6995,180766,7622,3670,3952
30935,191682,10886,92138,6995,180796,7624,3671,3953
30940,191713,10888,92156,6996,180825,7627,3673,3954
30945,191744,10891,92170,6999,180852,7630,3675,3955
30950,191775,10895,92186,7003,180880,7633,3677,3956
30955,191806,10898,92200,7005,180908,7636,3677,3959
30960,191837,10900,92216,7005,180937,7637,3678,3959
30965,191868,10902,92231,7007,180966,7638,3679,3959
30970,191899,10905,92247,7009,180994,7639,3679,3960
30975,191930,10907,92263,7009,181023,7640,3680,3960
30980,191961,10909,92277,7011,181052,7641,3680,3961
30985,191992,10912,92292,7012,181080,7642,3681,3961
30990,192023,10915,92304,7013,181108,7643,3681,3962
30995,192054,10918,92323,7015,181136,7644,3682,3962
31000,192085,10921,92339,7018,181164,7645,3682,3963
31005,192116,10925,92351,7020,181191,7646,3682,3964
31010,192147,10929,92367,7023,181218,7647,3683,3964
31015,192178,10932,92378,7024,181246,7648,3683,3965
31020,192209,10936,92397,7028,181273,7649,3683,3966
31025,192240,10939,92413,7030,181301,7650,3684,3966
31030,192271,10943,92424,7032,181328,7651,3684,3967
31035,192302,10946,92436,7034,181356,7652,3684,3968
31040,192333,10948,92450,7035,181385,7653,3684,3969
31045,192364,10952,92468,7039,181412,7654,3684,3970
31050,192395,10953,92483,7040,181442,7655,3684,3971
31055,192426,10954,92496,7041,181472,7656,3685,3971
31060,192457,10956,92512,7042,181501,7658,3687,3971
31065,192488,10959,92532,7045,181529,7660,3689,3971
31070,192519,10959,92547,7045,181560,7662,3689,3973
31075,192550,10959,92560,7045,181591,7664,3689,3975
31080,192581,10959,92573,7045,181622,7666,3691,3975
31085,192612,10959,92585,7045,181653,7667,3692,3975
31090,192643,10959,92599,7045,181684,7668,3693,3975
31095,192674,10959,92613,7045,181715,7669,3694,3975
31100,192705,10959,92631,7045,181746,7670,3694,3976
31105,192736,10959,92644,7045,181777,7671,3694,3977
31110,192767,10959,92661,7045,181808,7672,3695,3977
31115,192798,10959,92675,7045,181839,7673,3695,3978
31120,192829,10959,92688,7045,181870,7674,3695,3979
31125,192860,10959,92706,7045,181901,7675,3695,3980
31130,192891,10960,92720,7046,181931,7676,3696,3980
31135,192922,10961,92733,7047,181961,7677,3696,3981
31140,192953,10962,92749,7047,181991,7678,3697,3981
31145,192984,10963,92766,7048,182021,7679,3698,3981
31150,193015,10964,92779,7049,182051,7680,3699,3981
31155,193046,10967,92798,7050,182079,7681,3700,3981
31160,193077,10969,92811,7050,182108,7682,3701,3981
31165,193108,10972,92828,7052,182136,7683,3702,3981
31170,193139,10976,92844,7054,182163,7684,3702,3982
31175,193170,10979,92860,7054,182191,7685,3702,3983
31180,193201,10984,92878,7058,182217,7686,3703,3983
31185,193232,10990,92897,7063,182242,7688,3705,3983
31190,193263,10995,92914,7067,182268,7690,3707,3983
31195,193294,11000,92928,7070,182294,7692,3707,3985
31200,193325,11007,92944,7076,182318,7694,3708,3986
31205,193356,11007,92962,7076,182349,7695,3708,3987
31210,193387,11007,92978,7076,182380,7696,3708,3988
31215,193418,11007,92992,7076,182411,7697,3709,3988
31220,193449,11007,93003,7076,182442,7698,3710,3988
31225,193480,11007,93017,7076,182473,7699,3710,3989
31230,193511,11007,93032,7076,182504,7700,3711,3989
31235,193542,11007,93044,7076,182535,7701,3712,3989
31240,193573,11007,93057,7076,182566,7702,3713,3989
31245,193604,11007,93069,7076,182597,7703,3714,3989
31250,193635,11007,93083,7076,182628,7704,3714,3990
31255,193666,11007,93102,7076,182659,7705,3714,3991
31260,193697,11007,93119,7076,182690,7706,3715,3991
31265,193728,11007,93134,7076,182721,7707,3716,3991
31270,193759,11007,93153,7076,182752,7708,3717,3991
31275,193790,11007,93170,7076,182783,7709,3718,3991
31280,193821,11007,93185,7076,182814,7710,3719,3991
31285,193852,11007,93198,7076,182845,7711,3720,3991
31290,193883,11007,93215,7076,182876,7712,3720,3992
31295,193914,11007,93229,7076,182907,7714,3720,3994
31300,193945,11007,93247,7076,182938,7716,3722,3994
31305,193976,11008,93258,7077,182967,7719,3723,3996
31310,194007,11012,93270,7079,182994,7721,3724,3997
31315,194038,11016,93281,7080,183021,7722,3725,3997
31320,194069,11021,93295,7082,183047,7723,3725,3998
31325,194100,11026,93313,7084,183074,7724,3726,3998
31330,194131,11030,93330,7087,183101,7725,3726,3999
31335,194162,11034,93343,7091,183128,7726,3727,3999
31340,194193,11038,93355,7093,183155,7727,3727,4000
31345,194224,11041,93364,7094,183183,7728,3727,4001
31350,194255,11045,93381,7097,183210,7729,3728,4001
31355,194286,11050,93395,7101,183236,7730,3729,4001
31360,194317,11054,93412,7102,183263,7731,3730,4001
31365,194348,11057,93431,7103,183291,7732,3730,4002
31370,194379,11059,93442,7105,183320,7733,3731,4002
31375,194410,11061,93455,7106,183349,7734,3731,4003
31380,194441,11064,93471,7107,183377,7735,3731,4004
31385,194472,11066,93487,7108,183406,7736,3732,4004
31390,194503,11068,93507,7110,183435,7737,3732,4005
31395,194534,11071,93521,7112,183463,7738,3733,4005
31400,194565,11073,93530,7112,183492,7739,3734,4005
31405,194596,11076,93546,7114,183520,7740,3735,4005
31410,194627,11078,93564,7115,183549,7741,3736,4005
31415,194658,11080,93578,7116,183578,7743,3737,4006
31420,194689,11082,93590,7118,183607,7745,3739,4006
31425,194720,11086,93607,7121,183634,7747,3740,4007
31430,194751,11089,93625,7124,183662,7749,3742,4007
31435,194782,11090,93642,7124,183692,7751,3744,4007
31440,194813,11092,93656,7125,183721,7753,3745,4008
31445,194844,11093,93667,7126,183750,7754,3746,4008
31450,194875,11095,93681,7127,183780,7755,3746,4009
31455,194906,11096,93695,7127,183810,7756,3746,4010
31460,194937,11097,93702,7127,183840,7757,3746,4011
31465,194968,11098,93713,7127,183870,7758,3746,4012
31470,194999,11099,93724,7128,183900,7759,3746,4013
31475,195030,11100,93737,7128,183930,7760,3746,4014
31480,195061,11101,93749,7128,183960,7761,3746,4015
31485,195092,11102,93761,7128,183990,7762,3747,4015
31490,195123,11103,93774,7128,184020,7763,3747,4016
31495,195154,11104,93788,7128,184050,7764,3747,4017
31500,195185,11105,93799,7128,184080,7765,3748,4017
31505,195216,11106,93817,7128,184110,7766,3748,4018
31510,195247,11107,93829,7128,184140,7767,3749,4018
31515,195278,11108,93847,7128,184170,7768,3750,4018
31520,195309,11109,93861,7128,184200,7769,3751,4018
31525,195340,11110,93876,7128,184230,7770,3752,4018
31530,195371,11111,93892,7129,184260,7771,3752,4019
31535,195402,11112,93905,7129,184290,7772,3752,4020
31540,195433,11113,93918,7130,184320,7773,3752,4021
31545,195464,11114,93932,7130,184350,7774,3752,4022
31550,195495,11118,93949,7133,184376,7776,3752,4024
31555,195526,11124,93967,7136,184401,7778,3753,4025
31560,195557,11130,93986,7140,184427,7780,3755,4025
31565,195588,11132,93998,7141,184456,7781,3756,4025
31570,195619,11135,94010,7143,184484,7782,3756,4026
31575,195650,11137,94022,7143,184513,7783,3757,4026
31580,195681,11139,94038,7144,184542,7784,3758,4026
31585,195712,11142,94055,7146,184570,7785,3758,4027
31590,195743,11145,94068,7148,184598,7786,3758,4028
31595,195774,11148,94081,7150,184626,7787,3759,4028
31600,195805,11150,94099,7151,184655,7788,3760,4028
31605,195836,11152,94113,7152,184684,7789,3760,4029
31610,195867,11154,94128,7152,184713,7791,3762,4029
31615,195898,11155,94151,7153,184743,7793,3764,4029
31620,195929,11156,94166,7153,184773,7794,3765,4029
31625,195960,11157,94181,7154,184803,7795,3765,4030
31630,195991,11158,94197,7155,184833,7796,3765,4031
31635,196022,11159,94218,7156,184863,7797,3766,4031
31640,196053,11160,94230,7156,184893,7798,3766,4032
31645,196084,11161,94243,7156,184923,7799,3767,4032
31650,196115,11162,94257,7156,184953,7800,3768,4032
31655,196146,11163,94268,7156,184983,7801,3768,4033
31660,196177,11164,94287,7157,185013,7802,3769,4033
31665,196208,11166,94304,7159,185042,7803,3769,4034
31670,196239,11168,94316,7160,185071,7804,3770,4034
31675,196270,11169,94329,7161,185100,7805,3770,4035
31680,196301,11172,94349,7164,185128,7806,3770,4036
31685,196332,11175,94364,7166,185157,7807,3771,4036
31690,196363,11179,94382,7169,185184,7808,3772,4036
31695,196394,11181,94396,7170,185213,7809,3773,4036
31700,196425,11184,94409,7172,185241,7810,3773,4037
31705,196456,11188,94425,7174,185268,7811,3774,4037
31710,196487,11191,94440,7177,185296,7812,3775,4037
31715,196518,11195,94455,7181,185323,7813,3775,4038
31720,196549,11197,94466,7182,185352,7814,3775,4039
31725,196580,11199,94477,7183,185381,7815,3775,4040
31730,196611,11201,94484,7184,185410,7815,3775,4040
31735,196642,11201,94496,7184,185441,7815,3775,4040
31740,196673,11201,94509,7184,185472,7815,3775,4040
31745,196704,11201,94523,7184,185503,7815,3775,4040
31750,196735,11201,94536,7184,185534,7815,3775,4040
31755,196766,11201,94551,7184,185565,7815,3775,4040
31760,196797,11201,94570,7184,185596,7815,3775,4040
31765,196828,11201,94587,7184,185627,7815,3775,4040
31770,196859,11201,94600,7184,185658,7815,3775,4040
31775,196890,11201,94610,7184,185689,7815,3775,4040
31780,196921,11201,94624,7184,185720,7815,3775,4040
31785,196952,11201,94636,7184,185751,7816,3775,4041
31790,196983,11202,94647,7184,185781,7817,3776,4041
31795,197014,11204,94665,7186,185810,7818,3777,4041
31800,197045,11205,94681,7186,185840,7819,3777,4042
31805,197076,11209,94694,7188,185866,7820,3778,4042
31810,197107,11211,94708,7190,185896,7821,3778,4043
31815,197138,11213,94719,7192,185925,7822,3778,4044
31820,197169,11216,94735,7194,185953,7823,3778,4045
31825,197200,11219,94752,7196,185981,7824,3779,4045
31830,197231,11221,94768,7198,186010,7825,3780,4045
31835,197262,11224,94780,7199,186038,7827,3781,4046
31840,197293,11226,94790,7200,186067,7829,3781,4048
31845,197324,11228,94804,7201,186096,7831,3781,4050
31850,197355,11229,94820,7202,186126,7833,3781,4052
31855,197386,11231,94835,7204,186155,7835,3782,4053
31860,197417,11234,94845,7207,186183,7836,3782,4054
31865,197448,11237,94860,7209,186211,7837,3783,4054
31870,197479,11239,94879,7211,186240,7838,3784,4054
31875,197510,11241,94894,7213,186269,7839,3785,4054
31880,197541,11243,94906,7214,186298,7840,3785,4055
31885,197572,11244,94920,7215,186328,7841,3785,4056
31890,197603,11245,94936,7216,186358,7842,3786,4056
31895,197634,11246,94952,7217,186388,7843,3786,4057
31900,197665,11247,94971,7218,186418,7844,3786,4058
31905,197696,11248,94990,7219,186448,7845,3786,4059
31910,197727,11249,95009,7219,186478,7846,3787,4059
31915,197758,11251,95025,7221,186507,7847,3788,4059
31920,197789,11254,95040,7223,186535,7848,3789,4059
31925,197820,11257,95054,7226,186563,7849,3790,4059
31930,197851,11261,95069,7230,186589,7850,3790,4060
31935,197882,11264,95080,7232,186617,7851,3790,4061
31940,197913,11268,95092,7235,186644,7852,3790,4062
31945,197944,11272,95111,7238,186671,7853,3790,4063
31950,197975,11275,95126,7240,186699,7854,3791,4063
31955,198006,11277,95139,7242,186728,7855,3791,4064
31960,198037,11279,95154,7243,186757,7857,3793,4064
31965,198068,11281,95169,7244,186787,7859,3794,4065
31970,198099,11282,95182,7245,186817,7861,3794,4067
31975,198130,11284,95199,7247,186846,7862,3794,4068
31980,198161,11284,95213,7247,186877,7864,3795,4069
31985,198192,11286,95230,7249,186906,7866,3796,4070
31990,198223,11288,95246,7250,186935,7868,3797,4071
31995,198254,11290,95258,7251,186964,7869,3797,4072
32000,198285,11292,95270,7251,186993,7870,3797,4073
32005,198316,11294,95285,7252,187022,7871,3797,4074
32010,198347,11296,95300,7254,187051,7872,3798,4074
32015,198378,11298,95311,7254,187080,7873,3798,4075
32020,198409,11300,95328,7255,187109,7874,3798,4076
32025,198440,11302,95347,7256,187138,7875,3799,4076
32030,198471,11304,95368,7256,187167,7876,3800,4076
32035,198502,11307,95380,7258,187195,7877,3800,4077
32040,198533,11309,95393,7259,187224,7878,3800,4078
32045,198564,11311,95409,7260,187252,7880,3802,4078
32050,198595,11313,95421,7262,187282,7881,3803,4078
32055,198626,11314,95433,7263,187311,7882,3803,4079
32060,198657,11316,95445,7264,187341,7883,3804,4079
32065,198688,11317,95459,7264,187371,7884,3804,4080
32070,198719,11318,95479,7265,187401,7885,3805,4080
32075,198750,11319,95496,7266,187431,7886,3806,4080
32080,198781,11320,95509,7267,187461,7887,3807,4080
32085,198812,11321,95525,7268,187491,7889,3808,4081
32090,198843,11322,95534,7268,187521,7891,3809,4082
32095,198874,11323,95547,7268,187551,7893,3811,4082
32100,198905,11324,95560,7268,187581,7894,3812,4082
32105,198936,11325,95576,7268,187611,7895,3813,4082
32110,198967,11326,95589,7268,187641,7896,3814,4082
32115,198998,11327,95600,7269,187671,7897,3814,4083
32120,199029,11328,95615,7269,187701,7898,3815,4083
32125,199060,11329,95634,7270,187731,7899,3815,4084
32130,199091,11330,95648,7271,187761,7900,3816,4084
32135,199122,11331,95668,7271,187791,7901,3816,4085
32140,199153,11332,95686,7271,187821,7902,3816,4086
32145,199184,11334,95698,7271,187850,7903,3816,4087
32150,199215,11337,95715,7271,187878,7904,3816,4088
32155,199246,11341,95730,7272,187905,7906,3816,4090
32160,199277,11346,95745,7274,187930,7908,3817,4091
32165,199308,11351,95765,7278,187956,7910,3819,4091
32170,199339,11354,95778,7281,187985,7912,3820,4092
32175,199370,11356,95794,7282,188014,7914,3821,4093
32180,199401,11359,95813,7283,188042,7916,3822,4094
32185,199432,11363,95832,7286,188069,7917,3823,4094
32190,199463,11366,95847,7289,188097,7918,3824,4094
32195,199494,11368,95863,7290,188126,7919,3824,4095
32200,199525,11372,95875,7293,188153,7921,3824,4097
32205,199556,11374,95886,7294,188182,7923,3825,4098
32210,199587,11377,95904,7297,188210,7925,3826,4099
32215,199618,11379,95920,7299,188239,7927,3827,4100
32220,199649,11381,95940,7300,188268,7929,3828,4101
32225,199680,11381,95955,7300,188299,7930,3828,4102
32230,199711,11381,95972,7300,188330,7931,3828,4103
32235,199742,11381,95985,7300,188361,7932,3828,4104
32240,199773,11381,96000,7300,188392,7933,3828,4105
32245,199804,11381,96012,7300,188423,7934,3829,4105
32250,199835,11381,96031,7300,188454,7935,3829,4106
32255,199866,11381,96047,7300,188485,7936,3829,4107
32260,199897,11381,96065,7300,188516,7937,3829,4108
32265,199928,11381,96077,7300,188547,7938,3829,4109
32270,199959,11381,96091,7300,188578,7939,3830,4109
32275,199990,11381,96106,7300,188609,7940,3831,4109
32280,200021,11382,96122,7301,188639,7941,3832,4109
32285,200052,11385,96138,7303,188666,7942,3833,4109
32290,200083,11390,96153,7307,188693,7944,3834,4110
32295,200114,11395,96166,7309,188719,7946,3835,4111
32300,200145,11399,96180,7311,188746,7948,3836,4112
32305,200176,11401,96197,7312,188775,7950,3838,4112
32310,200207,11404,96213,7313,188803,7952,3840,4112
32315,200238,11408,96232,7316,188830,7954,3841,4113
32320,200269,11411,96242,7317,188858,7956,3842,4114
32325,200300,11415,96258,7320,188885,7958,3843,4115
32330,200331,11418,96272,7321,188913,7961,3844,4117
32335,200362,11422,96284,7323,188940,7964,3845,4119
32340,200393,11424,96299,7325,188969,7967,3847,4120
32345,200424,11424,96313,7325,189000,7968,3848,4120
32350,200455,11424,96325,7325,189031,7968,3848,4120
32355,200486,11424,96338,7325,189062,7968,3848,4120
32360,200517,11424,96353,7325,189093,7968,3848,4120
32365,200548,11424,96364,7325,189124,7968,3848,4120
32370,200579,11424,96376,7325,189155,7968,3848,4120
32375,200610,11424,96395,7325,189186,7968,3848,4120
32380,200641,11424,96411,7325,189217,7968,3848,4120
32385,200672,11424,96425,7325,189248,7968,3848,4120
32390,200703,11424,96440,7325,189279,7968,3848,4120
32395,200734,11424,96452,7325,189310,7968,3848,4120
32400,200765,11424,96467,7325,189341,7968,3848,4120
32405,200796,11426,96484,7326,189370,7968,3848,4120
32410,200827,11429,96500,7328,189398,7968,3848,4120
32415,200858,11431,96515,7330,189427,7968,3848,4120
32420,200889,11432,96527,7330,189457,7968,3848,4120
32425,200920,11434,96550,7331,189486,7968,3848,4120
32430,200951,11435,96567,7331,189516,7968,3848,4120
32435,200982,11437,96578,7332,189545,7968,3848,4120
32440,201013,11439,96594,7333,189574,7968,3848,4120
32445,201044,11440,96613,7334,189603,7968,3848,4120
32450,201075,11443,96630,7336,189632,7970,3849,4121
32455,201106,11446,96649,7338,189660,7972,3850,4122
32460,201137,11448,96665,7339,189688,7974,3851,4123
32465,201168,11453,96687,7343,189715,7975,3852,4123
32470,201199,11457,96704,7346,189742,7976,3852,4124
32475,201230,11459,96723,7347,189771,7977,3852,4125
32480,201261,11463,96741,7350,189798,7978,3853,4125
32485,201292,11465,96758,7352,189827,7979,3853,4126
32490,201323,11467,96773,7354,189856,7980,3853,4127
32495,201354,11468,96789,7355,189886,7981,3854,4127
32500,201385,11469,96799,7355,189916,7982,3854,4128
32505,201416,11470,96812,7356,189946,7983,3855,4128
32510,201447,11471,96831,7356,189976,7984,3856,4128
32515,201478,11474,96844,7359,190004,7985,3856,4129
32520,201509,11476,96864,7361,190033,7986,3857,4129
32525,201540,11478,96883,7363,190062,7987,3858,4129
32530,201571,11479,96902,7364,190092,7988,3859,4129
32535,201602,11481,96920,7365,190121,7989,3859,4130
32540,201633,11482,96933,7365,190151,7990,3859,4131
32545,201664,11484,96950,7366,190180,7991,3859,4132
32550,201695,11486,96965,7368,190209,7992,3859,4133
32555,201726,11487,96977,7369,190239,7993,3860,4133
32560,201757,11489,96992,7371,190268,7994,3860,4134
32565,201788,11491,97008,7372,190297,7995,3861,4134
32570,201819,11492,97024,7372,190327,7996,3862,4134
32575,201850,11492,97041,7372,190358,7999,3863,4136
32580,201881,11492,97055,7372,190389,8002,3864,4138
32585,201912,11496,97067,7375,190416,8004,3866,4138
32590,201943,11499,97084,7377,190444,8005,3867,4138
32595,201974,11500,97098,7378,190474,8006,3867,4139
32600,202005,11501,97113,7378,190504,8007,3867,4140
32605,202036,11502,97130,7378,190534,8008,3868,4140
32610,202067,11503,97145,7378,190564,8009,3869,4140
32615,202098,11504,97158,7378,190594,8010,3869,4141
32620,202129,11505,97170,7378,190624,8011,3870,4141
32625,202160,11506,97187,7378,190654,8012,3870,4142
32630,202191,11507,97204,7378,190684,8013,3871,4142
32635,202222,11508,97215,7378,190714,8014,3872,4142
32640,202253,11509,97232,7378,190744,8015,3873,4142
32645,202284,11512,97248,7380,190772,8016,3874,4142
32650,202315,11515,97258,7382,190800,8017,3875,4142
32655,202346,11517,97272,7382,190829,8018,3876,4142
32660,202377,11520,97286,7383,190857,8019,3876,4143
32665,202408,11523,97304,7386,190885,8020,3877,4143
32670,202439,11524,97316,7387,190915,8021,3877,4144
32675,202470,11525,97327,7388,190945,8022,3877,4145
32680,202501,11526,97348,7389,190975,8023,3878,4145
32685,202532,11527,97359,7389,191005,8025,3878,4147
32690,202563,11529,97375,7391,191034,8027,3879,4148
32695,202594,11533,97397,7395,191060,8030,3881,4149
32700,202625,11538,97413,7398,191087,8032,3881,4151
32705,202656,11539,97431,7398,191117,8033,3882,4151
32710,202687,11540,97450,7398,191147,8034,3882,4152
32715,202718,11541,97462,7398,191177,8035,3883,4152
32720,202749,11542,97473,7398,191207,8036,3884,4152
32725,202780,11543,97489,7398,191237,8037,3885,4152
32730,202811,11544,97506,7399,191267,8038,3886,4152
32735,202842,11545,97520,7399,191297,8039,3886,4153
32740,202873,11546,97536,7399,191327,8040,3886,4154
32745,202904,11547,97552,7400,191357,8041,3887,4154
32750,202935,11548,97567,7400,191387,8042,3887,4155
32755,202966,11549,97585,7400,191417,8043,3887,4156
32760,202997,11550,97604,7401,191447,8044,3888,4156
32765,203028,11551,97619,7401,191477,8045,3889,4156
32770,203059,11553,97634,7401,191506,8046,3890,4156
32775,203090,11555,97644,7402,191535,8047,3890,4157
32780,203121,11557,97655,7403,191564,8048,3891,4157
32785,203152,11559,97668,7404,191593,8049,3892,4157
32790,203183,11561,97684,7405,191622,8050,3893,4157
32795,203214,11563,97700,7406,191651,8051,3894,4157
32800,203245,11566,97716,7408,191679,8052,3895,4157
32805,203276,11569,97732,7410,191707,8053,3895,4158
32810,203307,11573,97743,7412,191734,8056,3896,4160
32815,203338,11579,97758,7417,191758,8058,3896,4162
32820,203369,11584,97773,7420,191785,8060,3897,4163
32825,203400,11585,97783,7421,191815,8062,3897,4165
32830,203431,11586,97796,7422,191845,8063,3898,4165
32835,203462,11588,97812,7423,191874,8064,3898,4166
32840,203493,11589,97829,7423,191904,8065,3898,4167
32845,203524,11590,97839,7424,191934,8066,3898,4168
32850,203555,11591,97853,7424,191964,8067,3898,4169
32855,203586,11592,97871,7424,191994,8068,3898,4170
32860,203617,11593,97882,7425,192024,8069,3898,4171
32865,203648,11594,97902,7425,192054,8070,3899,4171
32870,203679,11595,97921,7425,192084,8071,3900,4171
32875,203710,11596,97937,7426,192114,8072,3901,4171
32880,203741,11597,97952,7426,192144,8073,3901,4172
32885,203772,11598,97964,7426,192174,8074,3902,4172
32890,203803,11599,97978,7427,192204,8075,3902,4173
32895,203834,11600,97993,7428,192234,8076,3903,4173
32900,203865,11601,98011,7429,192264,8077,3904,4173
32905,203896,11602,98023,7430,192294,8078,3904,4174
32910,203927,11603,98037,7431,192324,8079,3905,4174
32915,203958,11604,98049,7431,192354,8081,3906,4175
32920,203989,11604,98063,7431,192385,8083,3907,4176
32925,204020,11606,98076,7432,192414,8085,3908,4177
32930,204051,11608,98086,7433,192443,8086,3908,4178
32935,204082,11613,98105,7437,192469,8088,3909,4179
32940,204113,11618,98126,7441,192495,8090,3911,4179
32945,204144,11621,98143,7444,192523,8092,3913,4179
32950,204175,11623,98161,7445,192552,8094,3914,4180
32955,204206,11625,98180,7446,192581,8096,3916,4180
32960,204237,11626,98198,7447,192611,8098,3917,4181
32965,204268,11626,98213,7447,192642,8099,3918,4181
32970,204299,11626,98228,7447,192673,8100,3919,4181
32975,204330,11626,98242,7447,192704,8101,3919,4182
32980,204361,11626,98256,7447,192735,8102,3919,4183
32985,204392,11626,98271,7447,192766,8103,3920,4183
32990,204423,11626,98290,7447,192797,8104,3920,4184
32995,204454,11626,98305,7447,192828,8105,3920,4185
33000,204485,11626,98321,7447,192859,8106,3921,4185
33005,204516,11626,98335,7447,192890,8107,3921,4186
33010,204547,11626,98347,7447,192921,8108,3921,4187
33015,204578,11626,98363,7447,192952,8109,3922,4187
33020,204609,11626,98374,7447,192983,8110,3922,4188
33025,204640,11627,98389,7448,193013,8111,3923,4188
33030,204671,11629,98397,7449,193042,8113,3924,4189
33035,204702,11632,98412,7451,193070,8115,3925,4190
33040,204733,11635,98427,7453,193098,8117,3927,4190
33045,204764,11638,98441,7456,193126,8119,3929,4190
33050,204795,11642,98456,7458,193153,8121,3929,4192
33055,204826,11645,98476,7461,193180,8122,3929,4193
33060,204857,11649,98494,7464,193207,8123,3929,4194
33065,204888,11653,98509,7468,193235,8124,3930,4194
33070,204919,11656,98522,7471,193263,8125,3931,4194
33075,204950,11658,98537,7471,193292,8126,3932,4194
33080,204981,11660,98551,7472,193321,8127,3932,4195
33085,205012,11662,98567,7473,193350,8128,3933,4195
33090,205043,11665,98585,7474,193378,8129,3933,4196
33095,205074,11668,98601,7476,193406,8130,3933,4197
33100,205105,11670,98615,7477,193435,8131,3934,4197
33105,205136,11672,98628,7477,193464,8132,3934,4198
33110,205167,11674,98642,7478,193493,8133,3934,4199
33115,205198,11676,98654,7480,193522,8134,3934,4200
33120,205229,11678,98667,7481,193551,8135,3934,4201
33125,205260,11683,98687,7486,193577,8135,3934,4201
33130,205291,11686,98702,7488,193605,8135,3934,4201
33135,205322,11689,98715,7489,193633,8135,3934,4201
33140,205353,11690,98732,7490,193663,8135,3934,4201
33145,205384,11691,98746,7491,193693,8136,3935,4201
33150,205415,11691,98762,7491,193724,8137,3935,4202
33155,205446,11691,98772,7491,193755,8138,3935,4203
33160,205477,11691,98785,7491,193786,8138,3935,4203
33165,205508,11691,98803,7491,193817,8138,3935,4203
33170,205539,11692,98825,7492,193847,8139,3936,4203
33175,205570,11693,98839,7492,193877,8140,3937,4203
33180,205601,11695,98855,7493,193906,8141,3937,4204
33185,205632,11698,98871,7494,193934,8141,3937,4204
33190,205663,11701,98888,7496,193962,8141,3937,4204
33195,205694,11704,98906,7499,193990,8141,3937,4204
33200,205725,11707,98923,7502,194018,8141,3937,4204
33205,205756,11711,98938,7505,194045,8141,3937,4204
33210,205787,11713,98949,7506,194074,8141,3937,4204
33215,205818,11716,98966,7508,194102,8141,3937,4204
33220,205849,11718,98981,7510,194131,8141,3937,4204
33225,205880,11719,98996,7510,194161,8142,3938,4204
33230,205911,11723,99018,7514,194188,8143,3938,4205
33235,205942,11724,99030,7514,194218,8144,3938,4206
33240,205973,11724,99044,7514,194249,8145,3939,4206
33245,206004,11725,99057,7514,194279,8146,3940,4206
33250,206035,11726,99073,7514,194309,8147,3941,4206
33255,206066,11728,99088,7515,194338,8148,3941,4207
33260,206097,11730,99102,7517,194367,8150,3943,4207
33265,206128,11732,99116,7518,194396,8152,3945,4207
33270,206159,11733,99136,7519,194426,8154,3947,4207
33275,206190,11735,99147,7520,194455,8156,3947,4209
33280,206221,11737,99162,7521,194484,8158,3948,4210
33285,206252,11739,99178,7522,194513,8161,3950,4211
33290,206283,11740,99190,7522,194543,8164,3951,4213
33295,206314,11741,99204,7523,194573,8167,3953,4214
33300,206345,11743,99216,7524,194602,8170,3955,4215
33305,206376,11743,99233,7524,194633,8171,3955,4216
33310,206407,11743,99248,7524,194664,8172,3956,4216
33315,206438,11745,99263,7525,194693,8173,3957,4216
33320,206469,11746,99279,7526,194723,8174,3957,4217
33325,206500,11748,99293,7527,194752,8175,3957,4218
33330,206531,11750,99308,7529,194781,8176,3957,4219
33335,206562,11751,99324,7530,194811,8177,3957,4220
33340,206593,11753,99340,7532,194840,8178,3957,4221
33345,206624,11756,99355,7534,194868,8179,3958,4221
33350,206655,11758,99372,7535,194897,8180,3958,4222
33355,206686,11760,99385,7536,194926,8181,3958,4223
33360,206717,11763,99403,7537,194954,8182,3958,4224
33365,206748,11767,99414,7539,194981,8183,3959,4224
33370,206779,11770,99427,7539,195008,8184,3960,4224
33375,206810,11774,99442,7542,195036,8185,3961,4224
33380,206841,11777,99456,7544,195064,8186,3961,4225
33385,206872,11780,99473,7544,195092,8187,3962,4225
33390,206903,11783,99486,7546,195119,8188,3962,4226
33395,206934,11787,99501,7549,195146,8189,3962,4227
33400,206965,11790,99519,7551,195175,8190,3962,4228
33405,206996,11792,99532,7551,195204,8192,3963,4229
33410,207027,11794,99544,7552,195232,8195,3964,4231
33415,207058,11797,99563,7554,195260,8198,3965,4233
33420,207089,11800,99583,7557,195289,8201,3967,4234
33425,207120,11802,99596,7557,195318,8204,3968,4236
33430,207151,11804,99614,7557,195347,8206,3969,4237
33435,207182,11807,99631,7560,195375,8208,3970,4238
33440,207213,11808,99646,7561,195405,8209,3971,4238
33445,207244,11809,99658,7562,195435,8210,3971,4239
33450,207275,11810,99674,7562,195465,8211,3971,4240
33455,207306,11811,99691,7562,195495,8212,3971,4241
33460,207337,11812,99709,7563,195525,8213,3971,4242
33465,207368,11813,99725,7564,195555,8214,3972,4242
33470,207399,11814,99737,7564,195585,8215,3973,4242
33475,207430,11815,99748,7564,195615,8216,3973,4243
33480,207461,11818,99768,7566,195643,8217,3974,4243
33485,207492,11822,99786,7569,195670,8218,3974,4244
33490,207523,11823,99802,7569,195700,8219,3975,4244
33495,207554,11824,99818,7569,195730,8220,3975,4245
33500,207585,11826,99830,7570,195759,8221,3975,4246
33505,207616,11827,99841,7571,195789,8222,3975,4247
33510,207647,11829,99855,7572,195818,8223,3976,4247
33515,207678,11831,99868,7573,195847,8224,3977,4247
33520,207709,11833,99885,7574,195876,8225,3977,4248
33525,207740,11833,99902,7574,195907,8226,3977,4249
33530,207771,11833,99913,7574,195938,8228,3978,4250
33535,207802,11833,99928,7574,195969,8230,3979,4251
33540,207833,11833,99944,7574,196000,8232,3979,4253
33545,207864,11836,99960,7577,196028,8235,3980,4255
33550,207895,11839,99975,7579,196056,8238,3982,4256
33555,207926,11840,99993,7580,196086,8239,3983,4256
33560,207957,11841,100013,7580,196116,8240,3984,4256
33565,207988,11842,100028,7580,196146,8241,3984,4257
33570,208019,11843,100037,7580,196176,8242,3985,4257
33575,208050,11844,100053,7581,196206,8243,3985,4258
33580,208081,11845,100071,7582,196236,8244,3986,4258
33585,208112,11846,100089,7582,196266,8245,3987,4258
33590,208143,11847,100102,7582,196295,8246,3987,4259
33595,208174,11849,100116,7584,196324,8247,3987,4260
33600,208205,11851,100130,7586,196354,8248,3988,4260
33605,208236,11854,100145,7588,196382,8249,3988,4261
33610,208267,11856,100157,7590,196411,8250,3988,4262
33615,208298,11858,100173,7592,196440,8250,3988,4262
33620,208329,11859,100188,7593,196470,8250,3988,4262
33625,208360,11860,100202,7594,196500,8250,3988,4262
33630,208391,11861,100215,7594,196530,8250,3988,4262
33635,208422,11862,100231,7595,196560,8250,3988,4262
33640,208453,11863,100246,7596,196590,8250,3988,4262
33645,208484,11864,100262,7596,196620,8250,3988,4262
33650,208515,11865,100277,7596,196650,8250,3988,4262
33655,208546,11866,100290,7596,196680,8250,3988,4262
33660,208577,11867,100304,7597,196710,8251,3989,4262
33665,208608,11868,100321,7597,196740,8252,3989,4263
33670,208639,11869,100338,7597,196770,8252,3989,4263
33675,208670,11870,100353,7597,196800,8252,3989,4263
33680,208701,11871,100367,7597,196830,8252,3989,4263
33685,208732,11872,100382,7598,196860,8252,3989,4263
33690,208763,11873,100403,7599,196890,8252,3989,4263
33695,208794,11874,100419,7599,196920,8252,3989,4263
33700,208825,11875,100436,7600,196950,8252,3989,4263
33705,208856,11877,100453,7601,196978,8252,3989,4263
33710,208887,11881,100469,7604,197005,8253,3989,4264
33715,208918,11887,100483,7608,197031,8254,3990,4264
33720,208949,11890,100500,7610,197059,8255,3990,4265
33725,208980,11892,100512,7611,197088,8256,3991,4265
33730,209011,11894,100526,7612,197117,8257,3991,4266
33735,209042,11897,100544,7614,197145,8258,3992,4266
33740,209073,11898,100560,7615,197175,8259,3992,4267
33745,209104,11898,100577,7615,197206,8260,3993,4267
33750,209135,11898,100592,7615,197237,8261,3994,4267
33755,209166,11898,100608,7615,197268,8262,3994,4268
33760,209197,11898,100620,7615,197299,8263,3994,4269
33765,209228,11898,100634,7615,197330,8264,3994,4270
33770,209259,11898,100648,7615,197361,8266,3994,4272
33775,209290,11898,100667,7615,197392,8268,3996,4272
33780,209321,11898,100681,7615,197423,8270,3998,4272
33785,209352,11898,100698,7615,197454,8272,3998,4274
33790,209383,11898,100714,7615,197485,8273,3998,4275
33795,209414,11898,100728,7615,197516,8274,3999,4275
33800,209445,11898,100741,7615,197547,8275,4000,4275
33805,209476,11898,100762,7615,197578,8276,4001,4275
33810,209507,11898,100777,7615,197609,8277,4002,4275
33815,209538,11898,100793,7615,197640,8278,4002,4276
33820,209569,11898,100808,7615,197671,8279,4003,4276
33825,209600,11898,100827,7615,197702,8280,4004,4276
33830,209631,11900,100840,7616,197731,8282,4005,4277
33835,209662,11903,100850,7617,197758,8284,4005,4279
33840,209693,11908,100862,7621,197784,8286,4007,4279
33845,209724,11911,100880,7624,197813,8287,4007,4280
33850,209755,11913,100892,7625,197842,8288,4008,4280
33855,209786,11915,100906,7626,197871,8289,4008,4281
33860,209817,11917,100921,7626,197900,8290,4008,4282
33865,209848,11919,100942,7628,197929,8291,4009,4282
33870,209879,11921,100960,7629,197958,8292,4009,4283
33875,209910,11923,100971,7630,197987,8293,4010,4283
33880,209941,11926,100983,7632,198015,8294,4010,4284
33885,209972,11929,101001,7634,198043,8295,4011,4284
33890,210003,11932,101017,7636,198071,8297,4013,4284
33895,210034,11934,101030,7636,198100,8299,4013,4286
33900,210065,11936,101045,7637,198129,8301,4014,4287
33905,210096,11938,101066,7639,198158,8303,4015,4288
33910,210127,11940,101086,7641,198187,8305,4015,4290
33915,210158,11942,101102,7642,198216,8307,4017,4290
33920,210189,11944,101124,7644,198245,8309,4019,4290
33925,210220,11946,101140,7645,198274,8310,4019,4291
33930,210251,11948,101158,7646,198303,8311,4020,4291
33935,210282,11950,101171,7648,198332,8312,4020,4292
33940,210313,11952,101188,7649,198361,8313,4020,4293
33945,210344,11957,101204,7653,198387,8314,4021,4293
33950,210375,11961,101219,7655,198413,8316,4021,4295
33955,210406,11965,101232,7659,198440,8318,4022,4296
33960,210437,11970,101248,7662,198466,8320,4023,4297
33965,210468,11971,101262,7663,198497,8321,4024,4297
33970,210499,11971,101273,7663,198528,8322,4024,4298
33975,210530,11971,101290,7663,198559,8323,4025,4298
33980,210561,11971,101303,7663,198590,8324,4026,4298
33985,210592,11971,101318,7663,198621,8325,4027,4298
33990,210623,11971,101332,7663,198652,8326,4027,4299
33995,210654,11971,101346,7663,198683,8327,4027,4300
34000,210685,11971,101363,7663,198714,8328,4027,4301
34005,210716,11971,101375,7663,198745,8329,4028,4301
34010,210747,11971,101392,7663,198776,8330,4028,4302
34015,210778,11971,101407,7663,198807,8331,4029,4302
34020,210809,11971,101426,7663,198838,8332,4030,4302
34025,210840,11973,101445,7664,198867,8334,4032,4302
34030,210871,11976,101456,7666,198895,8336,4032,4304
34035,210902,11979,101471,7668,198923,8338,4033,4305
34040,210933,11983,101486,7671,198950,8340,4033,4307
34045,210964,11986,101505,7672,198978,8342,4035,4307
34050,210995,11988,101519,7674,199007,8344,4035,4309
34055,211026,11991,101535,7677,199035,8345,4036,4309
34060,211057,11993,101544,7677,199064,8346,4036,4310
34065,211088,11997,101556,7680,199091,8347,4036,4311
34070,211119,12001,101572,7683,199118,8349,4038,4311
34075,211150,12004,101588,7685,199145,8351,4038,4313
34080,211181,12009,101608,7690,199172,8353,4039,4314
34085,211212,12011,101625,7692,199201,8354,4040,4314
34090,211243,12011,101640,7692,199232,8355,4041,4314
34095,211274,12011,101655,7692,199263,8356,4042,4314
34100,211305,12011,101668,7692,199294,8357,4042,4315
34105,211336,12011,101684,7692,199325,8358,4043,4315
34110,211367,12011,101694,7692,199356,8359,4044,4315
34115,211398,12011,101710,7692,199387,8360,4045,4315
34120,211429,12011,101724,7692,199418,8361,4045,4316
34125,211460,12011,101735,7692,199449,8362,4046,4316
34130,211491,12011,101752,7692,199480,8363,4046,4317
34135,211522,12011,101763,7692,199511,8364,4047,4317
34140,211553,12011,101781,7692,199542,8365,4047,4318
34145,211584,12011,101797,7692,199573,8366,4048,4318
34150,211615,12011,101813,7692,199604,8367,4049,4318
34155,211646,12012,101824,7692,199634,8368,4049,4319
34160,211677,12014,101839,7694,199663,8369,4050,4319
34165,211708,12015,101852,7694,199693,8370,4051,4319
34170,211739,12018,101863,7697,199721,8371,4051,4320
34175,211770,12020,101880,7699,199750,8372,4052,4320
34180,211801,12021,101892,7700,199780,8373,4052,4321
34185,211832,12022,101905,7700,199809,8374,4052,4322
34190,211863,12027,101916,7703,199835,8376,4053,4323
34195,211894,12035,101931,7710,199858,8378,4055,4323
34200,211925,12041,101942,7713,199884,8380,4055,4325
34205,211956,12043,101956,7715,199913,8382,4056,4326
34210,211987,12045,101967,7716,199942,8383,4056,4327
34215,212018,12048,101983,7717,199970,8384,4057,4327
34220,212049,12050,101998,7718,199999,8385,4057,4328
34225,212080,12052,102009,7720,200028,8386,4057,4329
34230,212111,12054,102024,7721,200057,8387,4057,4330
34235,212142,12057,102038,7722,200085,8388,4057,4331
34240,212173,12060,102054,7723,200113,8389,4058,4331
34245,212204,12062,102064,7723,200142,8390,4059,4331
34250,212235,12065,102077,7725,200170,8391,4059,4332
34255,212266,12067,102092,7725,200199,8392,4059,4333
34260,212297,12069,102106,7725,200228,8393,4059,4334
34265,212328,12071,102120,7727,200257,8395,4060,4335
34270,212359,12074,102138,7728,200285,8396,4061,4335
34275,212390,12076,102154,7728,200314,8397,4061,4336
34280,212421,12079,102173,7730,200342,8398,4061,4337
34285,212452,12082,102186,7731,200370,8399,4061,4338
34290,212483,12083,102201,7732,200400,8400,4061,4339
34295,212514,12084,102221,7733,200430,8401,4061,4340
34300,212545,12085,102238,7734,200460,8402,4061,4341
34305,212576,12089,102254,7738,200486,8403,4062,4341
34310,212607,12093,102269,7741,200513,8405,4062,4343
34315,212638,12097,102282,7743,200540,8406,4063,4343
34320,212669,12102,102295,7747,200567,8407,4063,4344
34325,212700,12104,102311,7749,200596,8408,4063,4345
34330,212731,12106,102325,7750,200625,8409,4064,4345
34335,212762,12106,102345,7750,200656,8410,4064,4346
34340,212793,12106,102359,7750,200687,8411,4064,4347
34345,212824,12106,102376,7750,200718,8412,4064,4348
34350,212855,12106,102388,7750,200749,8413,4065,4348
34355,212886,12106,102398,7750,200780,8414,4065,4349
34360,212917,12106,102414,7750,200811,8415,4066,4349
34365,212948,12106,102428,7750,200842,8416,4067,4349
34370,212979,12106,102442,7750,200873,8417,4067,4350
34375,213010,12106,102463,7750,200904,8418,4067,4351
34380,213041,12106,102479,7750,200935,8419,4068,4351
34385,213072,12106,102495,7750,200966,8421,4069,4352
34390,213103,12106,102515,7750,200997,8423,4070,4353
34395,213134,12106,102529,7750,201028,8425,4072,4353
34400,213165,12106,102544,7750,201059,8427,4072,4355
34405,213196,12106,102559,7750,201090,8429,4074,4355
34410,213227,12106,102569,7750,201121,8430,4074,4356
34415,213258,12106,102588,7750,201152,8431,4074,4357
34420,213289,12106,102604,7750,201183,8432,4074,4358
34425,213320,12106,102619,7750,201214,8433,4075,4358
34430,213351,12108,102632,7751,201243,8434,4076,4358
34435,213382,12110,102648,7753,201271,8436,4076,4360
34440,213413,12115,102665,7756,201297,8438,4077,4361
34445,213444,12120,102680,7760,201324,8440,4078,4362
34450,213475,12124,102698,7763,201351,8442,4079,4363
34455,213506,12128,102712,7766,201378,8444,4079,4365
34460,213537,12132,102730,7769,201405,8446,4081,4365
34465,213568,12136,102749,7772,201432,8448,4082,4366
34470,213599,12142,102766,7776,201457,8450,4083,4367
34475,213630,12146,102782,7780,201484,8452,4084,4368
34480,213661,12150,102798,7784,201511,8454,4085,4369
34485,213692,12154,102811,7785,201538,8456,4087,4369
34490,213723,12159,102834,7789,201564,8458,4089,4369
34495,213754,12163,102847,7791,201591,8460,4091,4369
34500,213785,12167,102862,7794,201618,8462,4093,4369
34505,213816,12167,102877,7794,201649,8464,4094,4370
34510,213847,12167,102889,7794,201680,8466,4095,4371
34515,213878,12167,102902,7794,201711,8468,4095,4373
34520,213909,12167,102913,7794,201742,8470,4096,4374
34525,213940,12167,102933,7794,201773,8472,4098,4374
34530,213971,12167,102950,7794,201804,8474,4100,4374
34535,214002,12167,102962,7794,201835,8475,4100,4375
34540,214033,12167,102977,7794,201866,8476,4101,4375
34545,214064,12167,102990,7794,201897,8477,4101,4376
34550,214095,12167,103006,7794,201928,8478,4102,4376
34555,214126,12167,103022,7794,201959,8479,4102,4377
34560,214157,12167,103040,7794,201990,8480,4103,4377
34565,214188,12172,103054,7797,202016,8481,4103,4378
34570,214219,12176,103072,7799,202043,8482,4104,4378
34575,214250,12179,103083,7799,202071,8483,4104,4379
34580,214281,12183,103097,7802,202098,8483,4104,4379
34585,214312,12187,103113,7805,202125,8483,4104,4379
34590,214343,12190,103133,7807,202153,8483,4104,4379
34595,214374,12193,103152,7809,202181,8483,4104,4379
34600,214405,12196,103170,7812,202209,8483,4104,4379
34605,214436,12200,103188,7815,202236,8483,4104,4379
34610,214467,12203,103202,7817,202264,8483,4104,4379
34615,214498,12206,103215,7818,202292,8483,4104,4379
34620,214529,12209,103231,7819,202320,8483,4104,4379
34625,214560,12212,103250,7820,202348,8483,4104,4379
34630,214591,12215,103268,7822,202376,8483,4104,4379
34635,214622,12218,103277,7823,202404,8484,4105,4379
34640,214653,12221,103288,7823,202432,8485,4106,4379
34645,214684,12224,103304,7824,202460,8486,4106,4380
34650,214715,12227,103322,7827,202488,8487,4107,4380
34655,214746,12229,103342,7827,202517,8488,4108,4380
34660,214777,12231,103359,7827,202546,8489,4109,4380
34665,214808,12234,103377,7828,202574,8491,4110,4381
34670,214839,12236,103393,7829,202602,8492,4110,4382
34675,214870,12239,103405,7831,202630,8493,4111,4382
34680,214901,12242,103422,7833,202659,8494,4111,4383
34685,214932,12243,103441,7833,202689,8496,4111,4385
34690,214963,12243,103455,7833,202720,8497,4112,4385
34695,214994,12243,103465,7833,202751,8498,4113,4385
34700,215025,12243,103480,7833,202782,8499,4114,4385
34705,215056,12243,103498,7833,202813,8500,4115,4385
34710,215087,12243,103509,7833,202844,8501,4115,4386
34715,215118,12243,103530,7833,202875,8502,4115,4387
34720,215149,12243,103545,7833,202906,8503,4115,4388
34725,215180,12243,103561,7833,202937,8504,4116,4388
34730,215211,12243,103578,7833,202968,8505,4117,4388
34735,215242,12243,103591,7833,202999,8506,4118,4388
34740,215273,12243,103604,7833,203030,8507,4119,4388
34745,215304,12243,103617,7833,203061,8508,4119,4389
34750,215335,12243,103632,7833,203092,8509,4119,4390
34755,215366,12243,103647,7833,203123,8510,4120,4390
34760,215397,12243,103664,7833,203154,8511,4121,4390
34765,215428,12243,103679,7833,203185,8512,4122,4390
34770,215459,12243,103689,7833,203216,8514,4122,4392
34775,215490,12243,103704,7833,203247,8516,4123,4393
34780,215521,12243,103720,7833,203278,8518,4123,4395
34785,215552,12244,103731,7834,203308,8520,4124,4396
34790,215583,12247,103750,7837,203336,8522,4125,4397
34795,215614,12252,103767,7840,203361,8524,4126,4398
34800,215645,12257,103779,7845,203388,8526,4127,4399
34805,215676,12260,103793,7847,203416,8527,4128,4399
34810,215707,12264,103809,7850,203443,8528,4129,4399
34815,215738,12267,103827,7852,203471,8529,4129,4400
34820,215769,12269,103844,7854,203500,8530,4129,4401
34825,215800,12271,103856,7854,203529,8531,4129,4402
34830,215831,12274,103867,7855,203557,8532,4129,4403
34835,215862,12276,103882,7857,203586,8533,4129,4404
34840,215893,12277,103897,7857,203616,8534,4130,4404
34845,215924,12278,103913,7858,203646,8535,4131,4404
34850,215955,12279,103929,7859,203676,8536,4132,4404
34855,215986,12280,103945,7860,203706,8537,4133,4404
34860,216017,12282,103960,7862,203735,8538,4134,4404
34865,216048,12284,103978,7864,203764,8539,4135,4404
34870,216079,12285,103993,7864,203794,8540,4136,4404
34875,216110,12287,104014,7865,203823,8541,4137,4404
34880,216141,12288,104026,7865,203853,8542,4138,4404
34885,216172,12289,104043,7866,203883,8543,4138,4405
34890,216203,12290,104060,7866,203913,8545,4139,4406
34895,216234,12290,104074,7866,203944,8547,4139,4408
34900,216265,12290,104094,7866,203975,8549,4139,4410
34905,216296,12291,104107,7867,204005,8550,4140,4410
34910,216327,12293,104125,7868,204033,8552,4141,4411
34915,216358,12296,104143,7871,204061,8554,4142,4412
34920,216389,12299,104155,7873,204089,8556,4142,4414
34925,216420,12305,104176,7879,204115,8558,4143,4415
34930,216451,12306,104188,7879,204145,8560,4144,4416
34935,216482,12309,104205,7882,204173,8562,4146,4416
34940,216513,12312,104221,7885,204201,8564,4148,4416
34945,216544,12315,104240,7888,204229,8566,4149,4417
34950,216575,12316,104253,7889,204259,8568,4150,4418
34955,216606,12317,104264,7889,204289,8570,4150,4420
34960,216637,12319,104281,7891,204318,8572,4150,4422
34965,216668,12319,104291,7891,204349,8574,4151,4423
34970,216699,12319,104309,7891,204380,8575,4152,4423
34975,216730,12319,104325,7891,204411,8576,4152,4424
34980,216761,12319,104342,7891,204442,8577,4152,4425
34985,216792,12319,104357,7891,204473,8578,4153,4425
34990,216823,12319,104369,7891,204504,8579,4154,4425
34995,216854,12321,104385,7892,204533,8580,4155,4425
35000,216885,12322,104398,7893,204563,8581,4155,4426
35005,216916,12323,104413,7894,204593,8583,4155,4428
35010,216947,12324,104429,7895,204623,8585,4156,4429
35015,216978,12327,104439,7898,204651,8587,4156,4431
35020,217009,12330,104456,7900,204679,8589,4156,4433
35025,217040,12331,104470,7900,204709,8591,4156,4435
35030,217071,12332,104484,7900,204739,8593,4157,4436
35035,217102,12335,104495,7902,204767,8594,4157,4437
35040,217133,12338,104508,7905,204794,8595,4158,4437
35045,217164,12343,104527,7909,204821,8596,4158,4438
35050,217195,12348,104542,7914,204847,8597,4158,4439
35055,217226,12351,104559,7915,204875,8598,4159,4439
35060,217257,12355,104575,7917,204902,8599,4160,4439
35065,217288,12359,104592,7920,204929,8600,4161,4439
35070,217319,12362,104604,7921,204957,8601,4161,4440
35075,217350,12366,104621,7924,204984,8603,4163,4440
35080,217381,12370,104636,7928,205011,8605,4164,4441
35085,217412,12373,104648,7929,205039,8607,4164,4443
35090,217443,12376,104665,7930,205067,8609,4166,4443
35095,217474,12378,104676,7931,205096,8611,4167,4444
35100,217505,12381,104691,7932,205124,8613,4168,4445
35105,217536,12384,104704,7933,205152,8614,4168,4446
35110,217567,12387,104718,7935,205180,8615,4168,4447
35115,217598,12389,104731,7935,205209,8616,4169,4447
35120,217629,12391,104748,7937,205238,8617,4169,4448
35125,217660,12393,104767,7937,205267,8618,4170,4448
35130,217691,12395,104785,7938,205296,8619,4170,4449
35135,217722,12398,104800,7940,205324,8621,4171,4450
35140,217753,12401,104815,7942,205352,8623,4171,4452
35145,217784,12403,104825,7943,205380,8624,4171,4453
35150,217815,12406,104832,7945,205409,8625,4172,4453
35155,217846,12407,104848,7946,205439,8626,4173,4453
35160,217877,12408,104868,7947,205469,8627,4174,4453
35165,217908,12408,104883,7947,205500,8628,4175,4453
35170,217939,12408,104895,7947,205531,8629,4175,4454
35175,217970,12408,104914,7947,205562,8630,4175,4455
35180,218001,12408,104935,7947,205593,8631,4176,4455
35185,218032,12409,104947,7948,205623,8632,4177,4455
35190,218063,12410,104963,7949,205653,8633,4177,4456
35195,218094,12411,104978,7949,205683,8634,4177,4457
35200,218125,12412,104996,7950,205713,8635,4178,4457
35205,218156,12413,105014,7951,205743,8636,4178,4458
35210,218187,12414,105033,7952,205773,8637,4178,4459
35215,218218,12416,105050,7954,205802,8638,4179,4459
35220,218249,12418,105063,7955,205831,8640,4180,4460
35225,218280,12419,105076,7955,205861,8642,4180,4462
35230,218311,12420,105090,7956,205891,8644,4182,4462
35235,218342,12421,105109,7957,205921,8645,4183,4462
35240,218373,12422,105128,7958,205951,8646,4183,4463
35245,218404,12423,105139,7958,205981,8647,4183,4464
35250,218435,12424,105153,7958,206011,8648,4183,4465
35255,218466,12426,105167,7959,206040,8649,4184,4465
35260,218497,12428,105182,7961,206069,8651,4184,4467
35265,218528,12430,105199,7962,206098,8653,4185,4468
35270,218559,12432,105217,7963,206127,8655,4187,4468
35275,218590,12435,105230,7963,206155,8657,4187,4470
35280,218621,12441,105246,7967,206180,8659,4187,4472
35285,218652,12444,105259,7968,206208,8660,4187,4473
35290,218683,12449,105271,7971,206234,8661,4187,4474
35295,218714,12451,105282,7972,206263,8662,4188,4474
35300,218745,12453,105293,7972,206292,8663,4189,4474
35305,218776,12456,105307,7974,206320,8664,4190,4474
35310,218807,12459,105322,7977,206348,8665,4191,4474
35315,218838,12462,105338,7979,206376,8666,4191,4475
35320,218869,12464,105349,7979,206405,8667,4191,4476
35325,218900,12468,105365,7983,206432,8668,4192,4476
35330,218931,12471,105383,7986,206460,8669,4193,4476
35335,218962,12475,105401,7989,206487,8670,4193,4477
35340,218993,12476,105417,7989,206517,8671,4194,4477
35345,219024,12476,105433,7989,206548,8672,4195,4477
35350,219055,12476,105449,7989,206579,8673,4196,4477
35355,219086,12476,105462,7989,206610,8674,4196,4478
35360,219117,12476,105480,7989,206641,8675,4196,4479
35365,219148,12476,105494,7989,206672,8676,4197,4479
35370,219179,12476,105510,7989,206703,8677,4197,4480
35375,219210,12476,105524,7989,206734,8678,4197,4481
35380,219241,12476,105536,7989,206765,8679,4197,4482
35385,219272,12476,105552,7989,206796,8681,4199,4482
35390,219303,12476,105569,7989,206827,8683,4200,4483
35395,219334,12476,105582,7989,206858,8685,4200,4485
35400,219365,12477,105599,7990,206888,8687,4200,4487
35405,219396,12481,105620,7994,206915,8689,4202,4487
35410,219427,12485,105632,7997,206942,8690,4203,4487
35415,219458,12488,105644,8000,206970,8691,4203,4488
35420,219489,12490,105659,8000,206999,8692,4203,4489
35425,219520,12493,105678,8002,207027,8693,4203,4490
35430,219551,12496,105696,8005,207055,8694,4204,4490
35435,219582,12498,105708,8006,207084,8695,4204,4491
35440,219613,12502,105724,8010,207111,8696,4205,4491
35445,219644,12504,105741,8011,207140,8697,4206,4491
35450,219675,12507,105750,8012,207168,8698,4206,4492
35455,219706,12510,105765,8014,207196,8699,4206,4493
35460,219737,12513,105775,8015,207224,8700,4207,4493
35465,219768,12514,105787,8015,207254,8700,4207,4493
35470,219799,12516,105807,8016,207283,8700,4207,4493
35475,219830,12518,105827,8017,207312,8700,4207,4493
35480,219861,12519,105842,8017,207342,8700,4207,4493
35485,219892,12520,105855,8018,207372,8700,4207,4493
35490,219923,12521,105868,8018,207402,8700,4207,4493
35495,219954,12522,105886,8018,207432,8700,4207,4493
35500,219985,12523,105901,8019,207462,8700,4207,4493
35505,220016,12524,105912,8019,207492,8701,4207,4494
35510,220047,12525,105923,8020,207522,8702,4208,4494
35515,220078,12526,105939,8021,207552,8703,4209,4494
35520,220109,12527,105954,8021,207582,8703,4209,4494
35525,220140,12530,105971,8024,207610,8703,4209,4494
35530,220171,12532,105984,8024,207639,8703,4209,4494
35535,220202,12536,106000,8028,207666,8703,4209,4494
35540,220233,12539,106016,8030,207694,8703,4209,4494
35545,220264,12543,106032,8033,207721,8703,4209,4494
35550,220295,12546,106049,8034,207749,8703,4209,4494
35555,220326,12549,106062,8035,207777,8703,4209,4494
35560,220357,12552,106081,8037,207805,8703,4209,4494
35565,220388,12554,106096,8038,207834,8703,4209,4494
35570,220419,12556,106113,8039,207863,8703,4209,4494
35575,220450,12558,106129,8040,207892,8704,4210,4494
35580,220481,12559,106145,8041,207922,8705,4211,4494
35585,220512,12559,106163,8041,207953,8706,4211,4495
35590,220543,12559,106178,8041,207984,8707,4211,4496
35595,220574,12559,106191,8041,208015,8708,4211,4497
35600,220605,12559,106205,8041,208046,8709,4212,4497
35605,220636,12559,106221,8041,208077,8710,4212,4498
35610,220667,12559,106233,8041,208108,8711,4212,4499
35615,220698,12559,106246,8041,208139,8712,4212,4500
35620,220729,12559,106259,8041,208170,8714,4214,4500
35625,220760,12559,106276,8041,208201,8716,4214,4502
35630,220791,12560,106293,8041,208231,8718,4216,4502
35635,220822,12561,106304,8042,208261,8719,4216,4503
35640,220853,12562,106317,8042,208291,8720,4216,4504
35645,220884,12564,106334,8044,208320,8721,4217,4504
35650,220915,12566,106351,8046,208349,8722,4218,4504
35655,220946,12568,106363,8048,208378,8723,4219,4504
35660,220977,12570,106377,8049,208407,8724,4219,4505
35665,221008,12572,106393,8051,208436,8725,4219,4506
35670,221039,12574,106410,8052,208465,8726,4220,4506
35675,221070,12577,106422,8053,208493,8727,4220,4507
35680,221101,12582,106441,8057,208519,8728,4221,4507
35685,221132,12587,106461,8060,208545,8729,4221,4508
35690,221163,12592,106476,8062,208571,8730,4222,4508
35695,221194,12597,106490,8065,208597,8731,4223,4508
35700,221225,12602,106510,8069,208623,8732,4224,4508
35705,221256,12607,106526,8072,208649,8733,4224,4509
35710,221287,12612,106544,8077,208675,8734,4224,4510
35715,221318,12617,106561,8082,208701,8735,4225,4510
35720,221349,12619,106578,8083,208730,8736,4225,4511
35725,221380,12621,106592,8083,208759,8737,4225,4512
35730,221411,12624,106603,8085,208787,8738,4225,4513
35735,221442,12627,106621,8088,208815,8740,4226,4514
35740,221473,12629,106637,8090,208844,8742,4227,4515
35745,221504,12630,106651,8090,208874,8744,4229,4515
35750,221535,12631,106669,8091,208904,8746,4230,4516
35755,221566,12632,106682,8092,208934,8748,4230,4518
35760,221597,12633,106697,8093,208964,8749,4231,4518
35765,221628,12636,106711,8095,208992,8751,4231,4520
35770,221659,12638,106728,8096,209020,8753,4232,4521
35775,221690,12640,106744,8098,209050,8754,4233,4521
35780,221721,12641,106758,8098,209080,8755,4233,4522
35785,221752,12642,106773,8099,209110,8756,4233,4523
35790,221783,12643,106789,8100,209140,8757,4233,4524
35795,221814,12645,106807,8102,209169,8758,4233,4525
35800,221845,12645,106818,8102,209200,8759,4233,4526
35805,221876,12645,106830,8102,209231,8760,4234,4526
35810,221907,12645,106843,8102,209262,8761,4234,4527
35815,221938,12645,106858,8102,209293,8762,4235,4527
35820,221969,12645,106872,8102,209324,8763,4236,4527
35825,222000,12646,106883,8102,209354,8764,4236,4528
35830,222031,12647,106898,8102,209384,8765,4236,4529
35835,222062,12648,106911,8102,209414,8766,4236,4530
35840,222093,12649,106923,8102,209444,8767,4237,4530
35845,222124,12650,106935,8102,209474,8768,4237,4531
35850,222155,12651,106951,8102,209504,8769,4237,4532
35855,222186,12652,106968,8102,209534,8770,4238,4532
35860,222217,12655,106984,8104,209562,8772,4238,4534
35865,222248,12657,107000,8106,209591,8774,4239,4535
35870,222279,12658,107017,8106,209621,8776,4240,4536
35875,222310,12661,107030,8108,209649,8778,4240,4538
35880,222341,12665,107045,8111,209676,8779,4241,4538
35885,222372,12665,107066,8111,209707,8781,4243,4538
35890,222403,12665,107079,8111,209738,8782,4244,4538
35895,222434,12665,107091,8111,209769,8783,4244,4539
35900,222465,12665,107107,8111,209800,8784,4244,4540
35905,222496,12666,107119,8111,209830,8785,4244,4541
35910,222527,12669,107137,8114,209858,8786,4245,4541
35915,222558,12672,107152,8116,209886,8787,4245,4542
35920,222589,12674,107167,8117,209915,8788,4246,4542
35925,222620,12676,107183,8118,209944,8789,4247,4542
35930,222651,12678,107200,8120,209973,8790,4247,4543
35935,222682,12679,107215,8121,210003,8791,4248,4543
35940,222713,12680,107231,8121,210033,8792,4248,4544
35945,222744,12682,107248,8123,210062,8793,4248,4545
35950,222775,12683,107265,8124,210092,8794,4248,4546
35955,222806,12685,107281,8126,210121,8795,4248,4547
35960,222837,12687,107293,8128,210150,8796,4248,4548
35965,222868,12688,107306,8129,210180,8797,4249,4548
35970,222899,12689,107316,8130,210210,8798,4250,4548
35975,222930,12690,107330,8130,210240,8799,4250,4549
35980,222961,12691,107343,8130,210270,8800,4250,4550
35985,222992,12694,107357,8132,210297,8802,4250,4552
35990,223023,12698,107373,8135,210324,8805,4252,4553
35995,223054,12704,107389,8139,210349,8806,4253,4553
36000,223085,12710,107406,8143,210374,8807,4253,4554
36005,223116,12716,107427,8148,210400,8808,4254,4554
36010,223147,12717,107440,8148,210430,8809,4255,4554
36015,223178,12719,107453,8150,210459,8810,4255,4555
36020,223209,12720,107470,8151,210489,8811,4255,4556
36025,223240,12722,107485,8152,210518,8812,4256,4556
36030,223271,12723,107500,8153,210548,8813,4256,4557
36035,223302,12724,107512,8154,210578,8814,4257,4557
36040,223333,12725,107525,8155,210608,8815,4257,4558
36045,223364,12727,107543,8157,210637,8816,4257,4559
36050,223395,12728,107561,8157,210667,8817,4258,4559
36055,223426,12729,107577,8157,210697,8818,4259,4559
36060,223457,12730,107589,8158,210727,8819,4259,4560
36065,223488,12731,107603,8158,210757,8820,4259,4561
36070,223519,12732,107614,8158,210787,8821,4260,4561
36075,223550,12733,107627,8158,210817,8822,4261,4561
36080,223581,12734,107636,8159,210847,8823,4262,4561
36085,223612,12735,107655,8159,210877,8824,4263,4561
36090,223643,12736,107670,8159,210907,8825,4264,4561
36095,223674,12737,107682,8159,210937,8827,4265,4562
36100,223705,12738,107701,8159,210967,8830,4267,4563
36105,223736,12739,107719,8160,210997,8833,4270,4563
36110,223767,12740,107731,8161,211026,8836,4270,4566
36115,223798,12744,107748,8164,211054,8839,4271,4568
36120,223829,12746,107763,8165,211083,8841,4272,4569
36125,223860,12750,107779,8167,211110,8842,4272,4570
36130,223891,12754,107790,8170,211137,8843,4272,4571
36135,223922,12759,107807,8173,211163,8844,4272,4572
36140,223953,12762,107817,8173,211191,8845,4272,4573
36145,223984,12765,107831,8174,211219,8846,4272,4574
36150,224015,12769,107852,8177,211246,8847,4273,4574
36155,224046,12773,107867,8181,211273,8848,4273,4575
36160,224077,12777,107883,8184,211300,8849,4273,4576
36165,224108,12779,107896,8185,211329,8850,4273,4577
36170,224139,12782,107907,8186,211357,8851,4273,4578
36175,224170,12787,107921,8190,211383,8852,4273,4579
36180,224201,12791,107936,8193,211410,8853,4274,4579
36185,224232,12791,107948,8193,211441,8854,4274,4580
36190,224263,12791,107959,8193,211472,8855,4275,4580
36195,224294,12791,107975,8193,211503,8856,4276,4580
36200,224325,12791,107991,8193,211534,8857,4276,4581
36205,224356,12791,108008,8193,211565,8858,4276,4582
36210,224387,12791,108021,8193,211596,8859,4276,4583
36215,224418,12791,108033,8193,211627,8860,4277,4583
36220,224449,12791,108047,8193,211658,8862,4278,4584
36225,224480,12791,108063,8193,211689,8864,4280,4584
36230,224511,12791,108074,8193,211720,8867,4281,4586
36235,224542,12791,108090,8193,211751,8870,4283,4587
36240,224573,12791,108104,8193,211782,8872,4284,4588
36245,224604,12792,108122,8193,211812,8874,4285,4589
36250,224635,12793,108137,8194,211842,8875,4286,4589
36255,224666,12794,108149,8194,211872,8876,4286,4590
36260,224697,12795,108166,8194,211902,8877,4286,4591
36265,224728,12796,108179,8195,211932,8878,4286,4592
36270,224759,12797,108190,8196,211962,8879,4286,4593
36275,224790,12798,108205,8197,211992,8880,4287,4593
36280,224821,12799,108222,8197,212022,8881,4288,4593
36285,224852,12800,108233,8197,212052,8882,4289,4593
36290,224883,12803,108245,8198,212080,8883,4290,4593
36295,224914,12807,108262,8202,212107,8884,4291,4593
36300,224945,12811,108276,8205,212134,8885,4291,4594
36305,224976,12815,108291,8206,212161,8886,4291,4595
36310,225007,12819,108306,8207,212188,8887,4292,4595
36315,225038,12825,108325,8212,212213,8888,4293,4595
36320,225069,12828,108342,8215,212241,8889,4293,4596
36325,225100,12832,108359,8217,212268,8890,4294,4596
36330,225131,12837,108377,8222,212294,8891,4294,4597
36335,225162,12843,108387,8225,212319,8892,4294,4598
36340,225193,12848,108402,8229,212345,8894,4294,4600
36345,225224,12851,108414,8231,212373,8896,4295,4601
36350,225255,12854,108428,8233,212401,8899,4297,4602
36355,225286,12858,108446,8236,212428,8900,4298,4602
36360,225317,12860,108456,8237,212457,8901,4298,4603
36365,225348,12861,108472,8238,212487,8902,4298,4604
36370,225379,12861,108490,8238,212518,8903,4299,4604
36375,225410,12861,108501,8238,212549,8904,4299,4605
36380,225441,12861,108519,8238,212580,8905,4300,4605
36385,225472,12861,108529,8238,212611,8906,4300,4606
36390,225503,12861,108542,8238,212642,8907,4300,4607
36395,225534,12861,108554,8238,212673,8908,4301,4607
36400,225565,12861,108567,8238,212704,8909,4301,4608
36405,225596,12861,108582,8238,212735,8910,4301,4609
36410,225627,12861,108602,8238,212766,8911,4302,4609
36415,225658,12861,108621,8238,212797,8912,4302,4610
36420,225689,12861,108633,8238,212828,8913,4303,4610
36425,225720,12861,108654,8238,212859,8915,4304,4611
36430,225751,12861,108674,8238,212890,8917,4306,4611
36435,225782,12861,108687,8238,212921,8918,4307,4611
36440,225813,12861,108704,8238,212952,8919,4308,4611
36445,225844,12861,108718,8238,212983,8920,4308,4612
36450,225875,12861,108730,8238,213014,8921,4309,4612
36455,225906,12861,108744,8238,213045,8922,4309,4613
36460,225937,12861,108761,8238,213076,8923,4310,4613
36465,225968,12862,108774,8239,213105,8924,4311,4613
36470,225999,12865,108790,8240,213133,8926,4312,4614
36475,226030,12871,108807,8246,213159,8928,4312,4616
36480,226061,12877,108821,8251,213183,8930,4312,4618
36485,226092,12882,108836,8254,213210,8932,4313,4619
36490,226123,12886,108853,8256,213237,8934,4314,4620
36495,226154,12890,108869,8257,213264,8935,4314,4621
36500,226185,12893,108884,8257,213292,8936,4315,4621
36505,226216,12896,108901,8258,213320,8936,4315,4621
36510,226247,12899,108921,8260,213348,8936,4315,4621
36515,226278,12903,108935,8263,213375,8936,4315,4621
36520,226309,12907,108954,8264,213402,8936,4315,4621
36525,226340,12910,108969,8266,213430,8936,4315,4621
36530,226371,12911,108987,8267,213460,8936,4315,4621
36535,226402,12912,109001,8267,213490,8936,4315,4621
36540,226433,12913,109012,8267,213520,8936,4315,4621
36545,226464,12914,109033,8268,213550,8936,4315,4621
36550,226495,12915,109046,8269,213580,8936,4315,4621
36555,226526,12916,109065,8270,213610,8936,4315,4621
36560,226557,12917,109082,8271,213640,8936,4315,4621
36565,226588,12918,109094,8272,213670,8936,4315,4621
36570,226619,12919,109112,8272,213700,8936,4315,4621
36575,226650,12920,109128,8273,213730,8936,4315,4621
36580,226681,12921,109146,8273,213760,8936,4315,4621
36585,226712,12923,109162,8274,213789,8937,4316,4621
36590,226743,12924,109180,8274,213819,8938,4316,4622
36595,226774,12924,109196,8274,213850,8939,4317,4622
36600,226805,12924,109212,8274,213881,8940,4318,4622
36605,226836,12927,109227,8277,213909,8942,4319,4623
36610,226867,12930,109236,8278,213937,8944,4320,4624
36615,226898,12932,109242,8278,213966,8946,4320,4626
36620,226929,12936,109261,8281,213993,8947,4320,4627
36625,226960,12937,109273,8281,214023,8948,4321,4627
36630,226991,12938,109290,8281,214053,8949,4321,4628
36635,227022,12939,109305,8282,214083,8950,4321,4629
36640,227053,12940,109321,8283,214113,8951,4321,4630
36645,227084,12941,109331,8283,214143,8952,4321,4631
36650,227115,12942,109346,8283,214173,8953,4321,4632
36655,227146,12943,109368,8284,214203,8954,4321,4633
36660,227177,12944,109386,8284,214233,8955,4322,4633
36665,227208,12945,109403,8285,214263,8956,4322,4634
36670,227239,12946,109414,8286,214293,8957,4322,4635
36675,227270,12947,109430,8286,214323,8958,4323,4635
36680,227301,12948,109444,8287,214353,8959,4323,4636
36685,227332,12949,109460,8288,214383,8960,4324,4636
36690,227363,12950,109472,8288,214413,8961,4325,4636
36695,227394,12951,109486,8289,214443,8963,4326,4637
36700,227425,12954,109495,8291,214471,8965,4326,4639
36705,227456,12956,109514,8292,214499,8967,4327,4640
36710,227487,12959,109526,8295,214527,8969,4327,4642
36715,227518,12963,109540,8298,214554,8970,4328,4642
36720,227549,12967,109559,8302,214581,8971,4329,4642
36725,227580,12970,109577,8305,214610,8972,4330,4642
36730,227611,12972,109592,8307,214639,8973,4330,4643
36735,227642,12973,109601,8307,214669,8974,4330,4644
36740,227673,12975,109619,8309,214698,8975,4331,4644
36745,227704,12976,109632,8310,214728,8976,4331,4645
36750,227735,12978,109646,8312,214757,8977,4331,4646
36755,227766,12980,109661,8313,214786,8978,4331,4647
36760,227797,12981,109676,8313,214816,8980,4332,4648
36765,227828,12982,109688,8314,214846,8982,4332,4650
36770,227859,12984,109708,8316,214875,8984,4334,4650
36775,227890,12985,109722,8317,214905,8986,4336,4650
36780,227921,12986,109735,8317,214935,8988,4338,4650
36785,227952,12989,109750,8320,214963,8990,4339,4651
36790,227983,12992,109763,8322,214991,8992,4340,4652
36795,228014,12995,109778,8324,215019,8994,4342,4652
36800,228045,12998,109792,8324,215047,8995,4342,4653
36805,228076,13001,109808,8325,215075,8996,4343,4653
36810,228107,13005,109824,8326,215102,8997,4344,4653
36815,228138,13008,109841,8327,215130,8998,4345,4653
36820,228169,13011,109856,8329,215158,8999,4345,4654
36825,228200,13015,109875,8333,215185,9000,4346,4654
36830,228231,13019,109888,8335,215212,9002,4346,4656
36835,228262,13022,109900,8337,215239,9004,4346,4658
36840,228293,13026,109916,8340,215266,9006,4346,4660
36845,228324,13027,109931,8341,215297,9008,4346,4662
36850,228355,13027,109944,8341,215328,9009,4347,4662
36855,228386,13027,109957,8341,215359,9010,4347,4663
36860,228417,13027,109976,8341,215390,9011,4347,4664
36865,228448,13027,109993,8341,215421,9012,4348,4664
36870,228479,13027,110006,8341,215452,9013,4348,4665
36875,228510,13027,110024,8341,215483,9014,4349,4665
36880,228541,13027,110036,8341,215514,9015,4349,4666
36885,228572,13027,110055,8341,215545,9016,4350,4666
36890,228603,13027,110065,8341,215576,9017,4350,4667
36895,228634,13027,110078,8341,215607,9018,4350,4668
36900,228665,13027,110088,8341,215638,9019,4350,4669
36905,228696,13027,110099,8341,215669,9020,4351,4669
36910,228727,13027,110114,8341,215700,9022,4353,4669
36915,228758,13027,110131,8341,215731,9024,4355,4669
36920,228789,13027,110143,8341,215762,9026,4356,4670
36925,228820,13027,110155,8341,215793,9028,4356,4672
36930,228851,13027,110166,8341,215824,9030,4357,4673
36935,228882,13027,110179,8341,215855,9032,4358,4674
36940,228913,13027,110194,8341,215886,9033,4359,4674
36945,228944,13027,110209,8341,215917,9034,4359,4675
36950,228975,13029,110221,8343,215946,9035,4359,4676
36955,229006,13032,110235,8344,215973,9037,4359,4678
36960,229037,13036,110251,8346,216001,9039,4361,4678
36965,229068,13041,110266,8350,216026,9041,4361,4680
36970,229099,13046,110281,8355,216053,9043,4362,4681
36975,229130,13050,110293,8356,216080,9045,4364,4681
36980,229161,13053,110310,8358,216108,9046,4365,4681
36985,229192,13058,110324,8361,216134,9047,4365,4682
36990,229223,13063,110341,8365,216160,9048,4366,4682
36995,229254,13068,110355,8369,216186,9049,4366,4683
37000,229285,13071,110368,8371,216214,9050,4366,4684
37005,229316,13075,110387,8374,216241,9051,4367,4684
37010,229347,13077,110403,8374,216270,9052,4368,4684
37015,229378,13081,110417,8376,216297,9053,4368,4685
37020,229409,13084,110435,8378,216325,9054,4369,4685
37025,229440,13085,110448,8379,216355,9056,4369,4687
37030,229471,13086,110459,8380,216385,9058,4370,4688
37035,229502,13087,110478,8380,216415,9060,4371,4689
37040,229533,13088,110493,8381,216445,9061,4372,4689
37045,229564,13089,110507,8381,216475,9062,4372,4690
37050,229595,13089,110517,8381,216506,9063,4372,4691
37055,229626,13089,110535,8381,216537,9064,4373,4691
37060,229657,13089,110549,8381,216568,9065,4374,4691
37065,229688,13089,110565,8381,216599,9066,4375,4691
37070,229719,13089,110583,8381,216630,9067,4376,4691
37075,229750,13089,110596,8381,216661,9068,4377,4691
37080,229781,13089,110611,8381,216692,9069,4378,4691
37085,229812,13092,110625,8382,216720,9071,4379,4692
37090,229843,13094,110641,8383,216748,9073,4380,4693
37095,229874,13098,110656,8385,216776,9075,4381,4694
37100,229905,13102,110673,8387,216802,9077,4382,4695
37105,229936,13106,110685,8390,216830,9079,4382,4697
37110,229967,13109,110696,8392,216858,9081,4382,4699
37115,229998,13111,110710,8394,216887,9083,4382,4701
37120,230029,13113,110727,8395,216915,9085,4383,4702
37125,230060,13116,110743,8397,216944,9087,4383,4704
37130,230091,13120,110761,8400,216971,9088,4384,4704
37135,230122,13122,110776,8400,217000,9089,4385,4704
37140,230153,13125,110789,8401,217028,9091,4387,4704
37145,230184,13128,110805,8402,217056,9093,4388,4705
37150,230215,13132,110817,8403,217083,9094,4389,4705
37155,230246,13136,110832,8405,217110,9095,4390,4705
37160,230277,13138,110848,8406,217139,9096,4390,4706
37165,230308,13142,110864,8409,217166,9097,4390,4707
37170,230339,13145,110883,8411,217194,9098,4391,4707
37175,230370,13148,110897,8414,217222,9099,4391,4708
37180,230401,13150,110913,8416,217251,9100,4392,4708
37185,230432,13151,110926,8416,217281,9101,4392,4709
37190,230463,13152,110941,8416,217311,9102,4392,4710
37195,230494,13153,110959,8417,217341,9103,4393,4710
37200,230525,13154,110971,8418,217371,9104,4393,4711
37205,230556,13155,110986,8418,217401,9105,4394,4711
37210,230587,13156,111005,8419,217431,9106,4395,4711
37215,230618,13157,111016,8420,217461,9107,4396,4711
37220,230649,13158,111029,8420,217491,9108,4396,4712
37225,230680,13159,111045,8420,217521,9109,4397,4712
37230,230711,13160,111055,8420,217551,9111,4398,4713
37235,230742,13161,111071,8420,217581,9113,4400,4713
37240,230773,13162,111085,8421,217611,9115,4400,4715
37245,230804,13163,111099,8421,217641,9117,4401,4716
37250,230835,13165,111114,8422,217670,9120,4402,4718
37255,230866,13166,111128,8422,217700,9123,4403,4720
37260,230897,13169,111142,8425,217728,9125,4405,4720
37265,230928,13171,111164,8427,217757,9126,4405,4721
37270,230959,13172,111181,8427,217787,9127,4405,4722
37275,230990,13173,111198,8428,217817,9128,4405,4723
37280,231021,13175,111211,8429,217846,9129,4405,4724
37285,231052,13177,111229,8430,217875,9130,4405,4725
37290,231083,13179,111237,8431,217904,9131,4405,4726
37295,231114,13180,111251,8431,217934,9132,4405,4727
37300,231145,13181,111268,8432,217964,9133,4405,4728
37305,231176,13183,111281,8434,217993,9134,4405,4729
37310,231207,13186,111296,8437,218021,9135,4406,4729
37315,231238,13188,111309,8438,218050,9136,4407,4729
37320,231269,13190,111325,8440,218079,9137,4408,4729
37325,231300,13193,111341,8442,218107,9138,4408,4730
37330,231331,13196,111354,8444,218135,9139,4409,4730
37335,231362,13198,111367,8445,218164,9140,4409,4731
37340,231393,13201,111386,8448,218192,9141,4410,4731
37345,231424,13203,111401,8449,218221,9142,4411,4731
37350,231455,13205,111415,8450,218250,9143,4411,4732
37355,231486,13208,111434,8453,218278,9144,4412,4732
37360,231517,13211,111447,8456,218306,9145,4412,4733
37365,231548,13214,111462,8458,218334,9147,4413,4734
37370,231579,13217,111470,8459,218362,9149,4414,4735
37375,231610,13219,111479,8460,218390,9152,4414,4738
37380,231641,13223,111493,8462,218418,9154,4415,4739
37385,231672,13225,111505,8463,218446,9155,4416,4739
37390,231703,13228,111526,8466,218475,9156,4417,4739
37395,231734,13230,111538,8467,218504,9157,4417,4740
37400,231765,13232,111556,8467,218533,9158,4418,4740
37405,231796,13234,111570,8468,218562,9159,4418,4741
37410,231827,13236,111584,8469,218591,9160,4418,4742
37415,231858,13238,111600,8471,218620,9161,4418,4743
37420,231889,13240,111616,8472,218649,9162,4418,4744
37425,231920,13242,111633,8472,218678,9163,4418,4745
37430,231951,13244,111647,8473,218707,9164,4418,4746
37435,231982,13246,111663,8474,218736,9165,4418,4747
37440,232013,13248,111682,8476,218765,9166,4419,4747
37445,232044,13251,111697,8478,218793,9166,4419,4747
37450,232075,13253,111710,8479,218822,9166,4419,4747
37455,232106,13255,111724,8480,218851,9166,4419,4747
37460,232137,13257,111742,8480,218880,9166,4419,4747
37465,232168,13259,111760,8482,218909,9166,4419,4747
37470,232199,13261,111777,8484,218938,9166,4419,4747
37475,232230,13263,111789,8484,218967,9166,4419,4747
37480,232261,13266,111804,8485,218995,9167,4419,4748
37485,232292,13268,111819,8486,219024,9168,4419,4749
37490,232323,13272,111837,8490,219050,9169,4420,4749
37495,232354,13274,111850,8491,219079,9169,4420,4749
37500,232385,13276,111864,8493,219109,9169,4420,4749
37505,232416,13277,111879,8494,219139,9169,4420,4749
37510,232447,13278,111888,8494,219169,9169,4420,4749
37515,232478,13279,111897,8494,219199,9169,4420,4749
37520,232509,13280,111911,8494,219229,9169,4420,4749
37525,232540,13281,111929,8495,219259,9169,4420,4749
37530,232571,13282,111949,8495,219289,9169,4420,4749
37535,232602,13283,111961,8496,219319,9169,4420,4749
37540,232633,13284,111976,8496,219349,9169,4420,4749
37545,232664,13285,111996,8496,219379,9169,4420,4749
37550,232695,13286,112011,8496,219409,9170,4421,4749
37555,232726,13287,112027,8496,219439,9171,4421,4750
37560,232757,13288,112039,8496,219469,9172,4421,4751
37565,232788,13292,112056,8499,219496,9173,4422,4751
37570,232819,13295,112067,8500,219524,9174,4423,4751
37575,232850,13300,112088,8504,219550,9175,4424,4751
37580,232881,13304,112105,8507,219577,9176,4425,4751
37585,232912,13307,112117,8508,219605,9177,4425,4752
37590,232943,13311,112129,8510,219632,9178,4426,4752
37595,232974,13313,112143,8510,219661,9180,4426,4754
37600,233005,13315,112157,8511,219690,9183,4428,4755
37605,233036,13317,112168,8512,219719,9185,4429,4756
37610,233067,13320,112183,8515,219746,9187,4430,4757
37615,233098,13324,112194,8518,219774,9189,4431,4758
37620,233129,13328,112210,8521,219800,9190,4432,4758
37625,233160,13330,112222,8523,219830,9191,4432,4759
37630,233191,13332,112238,8525,219859,9192,4433,4759
37635,233222,13333,112249,8525,219889,9193,4433,4760
37640,233253,13334,112265,8525,219919,9194,4434,4760
37645,233284,13335,112280,8525,219949,9195,4434,4761
37650,233315,13336,112290,8526,219979,9196,4435,4761
37655,233346,13337,112305,8526,220009,9197,4436,4761
37660,233377,13338,112321,8526,220039,9198,4436,4762
37665,233408,13339,112335,8527,220069,9199,4437,4762
37670,233439,13340,112349,8527,220099,9200,4437,4763
37675,233470,13341,112363,8528,220129,9201,4437,4764
37680,233501,13342,112374,8528,220159,9202,4438,4764
37685,233532,13343,112387,8529,220189,9203,4438,4765
37690,233563,13344,112401,8529,220219,9204,4439,4765
37695,233594,13345,112414,8530,220249,9205,4439,4766
37700,233625,13348,112428,8532,220277,9206,4440,4766
37705,233656,13350,112438,8534,220306,9208,4441,4767
37710,233687,13353,112451,8536,220334,9210,4442,4768
37715,233718,13355,112463,8536,220362,9212,4443,4769
37720,233749,13360,112477,8540,220388,9215,4445,4770
37725,233780,13365,112492,8545,220415,9217,4446,4771
37730,233811,13368,112511,8548,220443,9219,4447,4772
37735,233842,13370,112523,8549,220472,9221,4449,4772
37740,233873,13373,112538,8551,220500,9223,4449,4774
37745,233904,13376,112560,8554,220528,9224,4450,4774
37750,233935,13378,112572,8556,220557,9225,4451,4774
37755,233966,13379,112589,8557,220587,9226,4452,4774
37760,233997,13380,112602,8557,220617,9227,4452,4775
37765,234028,13381,112619,8558,220647,9228,4452,4776
37770,234059,13382,112636,8558,220677,9229,4452,4777
37775,234090,13383,112649,8559,220707,9230,4452,4778
37780,234121,13384,112662,8559,220737,9231,4453,4778
37785,234152,13385,112678,8560,220767,9232,4453,4779
37790,234183,13386,112699,8560,220797,9233,4454,4779
37795,234214,13387,112716,8560,220827,9234,4455,4779
37800,234245,13388,112730,8560,220857,9235,4455,4780
37805,234276,13389,112743,8561,220887,9236,4455,4781
37810,234307,13390,112756,8562,220917,9237,4456,4781
37815,234338,13391,112772,8562,220947,9238,4456,4782
37820,234369,13392,112784,8563,220977,9239,4457,4782
37825,234400,13393,112795,8563,221007,9241,4458,4783
37830,234431,13394,112807,8563,221037,9243,4459,4784
37835,234462,13395,112817,8564,221066,9245,4459,4786
37840,234493,13397,112835,8566,221096,9247,4460,4787
37845,234524,13399,112843,8567,221125,9248,4460,4788
37850,234555,13401,112855,8567,221154,9250,4461,4789
37855,234586,13404,112872,8569,221181,9252,4463,4789
37860,234617,13409,112883,8572,221208,9254,4464,4790
37865,234648,13412,112900,8575,221236,9256,4465,4791
37870,234679,13416,112914,8579,221263,9257,4465,4792
37875,234710,13419,112930,8582,221291,9258,4466,4792
37880,234741,13421,112945,8583,221320,9259,4466,4793
37885,234772,13425,112962,8585,221347,9260,4467,4793
37890,234803,13427,112969,8586,221376,9261,4467,4794
37895,234834,13429,112981,8588,221405,9262,4468,4794
37900,234865,13431,112996,8589,221434,9263,4468,4795
37905,234896,13432,113012,8589,221464,9264,4468,4796
37910,234927,13433,113023,8590,221494,9265,4468,4797
37915,234958,13434,113042,8591,221524,9266,4468,4798
37920,234989,13435,113058,8592,221554,9267,4468,4799
37925,235020,13436,113069,8592,221584,9269,4468,4801
37930,235051,13437,113086,8593,221614,9271,4468,4803
37935,235082,13438,113099,8593,221644,9273,4469,4804
37940,235113,13439,113113,8593,221674,9275,4470,4805
37945,235144,13440,113128,8594,221704,9277,4472,4805
37950,235175,13441,113143,8594,221734,9278,4473,4805
37955,235206,13442,113160,8595,221764,9279,4474,4805
37960,235237,13443,113174,8596,221794,9280,4474,4806
37965,235268,13444,113183,8596,221824,9281,4474,4807
37970,235299,13445,113197,8597,221854,9282,4474,4808
37975,235330,13446,113211,8597,221884,9284,4475,4809
37980,235361,13448,113228,8598,221912,9286,4476,4810
37985,235392,13450,113243,8600,221942,9288,4477,4811
37990,235423,13452,113254,8601,221971,9290,4477,4813
37995,235454,13454,113267,8601,222000,9292,4478,4814
38000,235485,13457,113281,8604,222028,9294,4480,4814
38005,235516,13460,113296,8606,222056,9296,4482,4814
38010,235547,13463,113310,8608,222084,9298,4482,4816
38015,235578,13465,113323,8609,222113,9300,4483,4817
38020,235609,13467,113335,8609,222142,9302,4483,4819
38025,235640,13469,113353,8609,222171,9304,4484,4820
38030,235671,13472,113365,8612,222199,9306,4486,4820
38035,235702,13475,113387,8615,222227,9308,4487,4821
38040,235733,13476,113400,8616,222257,9310,4487,4823
38045,235764,13478,113418,8617,222286,9312,4488,4824
38050,235795,13480,113430,8619,222315,9314,4488,4826
38055,235826,13482,113449,8621,222344,9316,4490,4826
38060,235857,13486,113467,8623,222371,9318,4491,4827
38065,235888,13488,113478,8624,222400,9320,4491,4829
38070,235919,13491,113496,8627,222428,9322,4492,4830
38075,235950,13496,113515,8630,222454,9324,4493,4831
38080,235981,13499,113529,8631,222482,9326,4495,4831
38085,236012,13502,113547,8634,222510,9328,4496,4832
38090,236043,13503,113557,8634,222540,9329,4496,4833
38095,236074,13505,113571,8635,222569,9330,4497,4833
38100,236105,13506,113586,8635,222599,9331,4497,4834
38105,236136,13508,113605,8637,222627,9332,4497,4835
38110,236167,13510,113622,8638,222656,9333,4497,4836
38115,236198,13512,113638,8639,222685,9334,4498,4836
38120,236229,13515,113655,8641,222713,9335,4499,4836
38125,236260,13517,113668,8643,222743,9336,4500,4836
38130,236291,13518,113681,8643,222773,9337,4501,4836
38135,236322,13520,113697,8645,222802,9338,4502,4836
38140,236353,13522,113711,8646,222831,9339,4502,4837
38145,236384,13523,113724,8646,222861,9340,4502,4838
38150,236415,13523,113743,8646,222892,9341,4503,4838
38155,236446,13523,113756,8646,222923,9342,4503,4839
38160,236477,13523,113774,8646,222954,9343,4504,4839
38165,236508,13523,113791,8646,222985,9344,4504,4840
38170,236539,13523,113803,8646,223016,9345,4504,4841
38175,236570,13523,113819,8646,223047,9346,4505,4841
38180,236601,13523,113833,8646,223078,9347,4506,4841
38185,236632,13523,113846,8646,223109,9348,4506,4842
38190,236663,13523,113858,8646,223140,9350,4507,4843
38195,236694,13523,113874,8646,223171,9352,4508,4844
38200,236725,13523,113890,8646,223202,9354,4509,4845
38205,236756,13523,113905,8646,223233,9356,4510,4846
38210,236787,13527,113919,8649,223259,9359,4511,4848
38215,236818,13531,113938,8651,223287,9360,4512,4848
38220,236849,13536,113951,8656,223313,9361,4513,4848
38225,236880,13540,113959,8657,223340,9362,4513,4849
38230,236911,13543,113974,8658,223368,9363,4514,4849
38235,236942,13548,113993,8662,223394,9364,4514,4850
38240,236973,13552,114010,8663,223421,9365,4515,4850
38245,237004,13555,114026,8666,223449,9366,4515,4851
38250,237035,13559,114042,8669,223476,9367,4515,4852
38255,237066,13560,114061,8669,223506,9368,4515,4853
38260,237097,13561,114077,8669,223536,9369,4515,4854
38265,237128,13562,114093,8670,223566,9370,4516,4854
38270,237159,13564,114105,8671,223595,9371,4516,4855
38275,237190,13566,114117,8672,223624,9372,4516,4856
38280,237221,13568,114126,8673,223653,9373,4517,4856
38285,237252,13570,114138,8673,223682,9375,4517,4858
38290,237283,13574,114157,8675,223709,9377,4519,4858
38295,237314,13575,114173,8676,223739,9379,4519,4860
38300,237345,13576,114182,8677,223769,9381,4519,4862
38305,237376,13578,114196,8678,223798,9383,4521,4862
38310,237407,13580,114208,8680,223827,9384,4521,4863
38315,237438,13581,114222,8681,223857,9386,4522,4864
38320,237469,13581,114239,8681,223888,9388,4523,4865
38325,237500,13581,114254,8681,223919,9390,4524,4866
38330,237531,13581,114266,8681,223950,9391,4524,4867
38335,237562,13581,114279,8681,223981,9392,4525,4867
38340,237593,13581,114289,8681,224012,9393,4525,4868
38345,237624,13582,114306,8681,224042,9394,4525,4869
38350,237655,13584,114326,8683,224071,9395,4525,4870
38355,237686,13585,114341,8684,224101,9396,4525,4871
38360,237717,13587,114355,8686,224130,9397,4525,4872
38365,237748,13589,114369,8687,224159,9398,4526,4872
38370,237779,13591,114389,8688,224188,9399,4527,4872
38375,237810,13593,114405,8690,224217,9400,4527,4873
38380,237841,13594,114419,8690,224247,9401,4527,4874
38385,237872,13595,114436,8690,224277,9402,4527,4875
38390,237903,13596,114452,8691,224307,9403,4527,4876
38395,237934,13598,114468,8691,224336,9404,4528,4876
38400,237965,13600,114485,8692,224365,9405,4529,4876
38405,237996,13603,114498,8693,224393,9406,4529,4877
38410,238027,13606,114515,8696,224421,9408,4531,4877
38415,238058,13608,114527,8697,224450,9410,4532,4878
38420,238089,13611,114539,8698,224478,9412,4533,4879
38425,238120,13614,114553,8698,224506,9414,4535,4879
38430,238151,13618,114565,8699,224533,9417,4536,4881
38435,238182,13621,114583,8699,224561,9420,4539,4881
38440,238213,13625,114598,8701,224588,9423,4540,4883
38445,238244,13630,114616,8704,224614,9426,4542,4884
38450,238275,13634,114629,8706,224641,9427,4542,4885
38455,238306,13638,114643,8709,224668,9428,4542,4886
38460,238337,13641,114657,8710,224696,9429,4543,4886
38465,238368,13644,114672,8711,224724,9430,4543,4887
38470,238399,13647,114685,8712,224752,9431,4543,4888
38475,238430,13650,114696,8713,224780,9432,4543,4889
38480,238461,13653,114710,8716,224808,9433,4544,4889
38485,238492,13655,114721,8716,224837,9434,4545,4889
38490,238523,13658,114739,8718,224865,9435,4545,4890
38495,238554,13659,114754,8719,224895,9436,4545,4891
38500,238585,13660,114767,8719,224925,9437,4546,4891
38505,238616,13661,114781,8720,224955,9438,4547,4891
38510,238647,13663,114793,8721,224984,9439,4548,4891
38515,238678,13665,114809,8723,225013,9440,4548,4892
38520,238709,13667,114824,8725,225041,9441,4549,4892
38525,238740,13670,114838,8727,225070,9441,4549,4892
38530,238771,13673,114853,8729,225098,9441,4549,4892
38535,238802,13676,114866,8731,225126,9441,4549,4892
38540,238833,13679,114878,8732,225154,9441,4549,4892
38545,238864,13682,114892,8734,225182,9441,4549,4892
38550,238895,13684,114907,8735,225211,9443,4550,4893
38555,238926,13686,114924,8735,225240,9445,4551,4894
38560,238957,13687,114941,8735,225270,9447,4553,4894
38565,238988,13688,114956,8736,225300,9449,4554,4895
38570,239019,13690,114970,8737,225329,9450,4554,4896
38575,239050,13691,114986,8737,225359,9451,4555,4896
38580,239081,13693,115001,8738,225388,9452,4555,4897
38585,239112,13696,115014,8739,225416,9452,4555,4897
38590,239143,13700,115026,8741,225443,9452,4555,4897
38595,239174,13703,115041,8743,225471,9452,4555,4897
38600,239205,13704,115059,8743,225501,9452,4555,4897
38605,239236,13705,115070,8743,225531,9452,4555,4897
38610,239267,13706,115083,8743,225561,9452,4555,4897
38615,239298,13707,115098,8744,225591,9452,4555,4897
38620,239329,13708,115111,8744,225621,9452,4555,4897
38625,239360,13709,115125,8745,225651,9453,4556,4897
38630,239391,13710,115144,8746,225681,9454,4557,4897
38635,239422,13711,115155,8747,225711,9455,4557,4898
38640,239453,13712,115170,8747,225741,9456,4557,4899
38645,239484,13713,115189,8747,225771,9457,4558,4899
38650,239515,13714,115206,8748,225801,9458,4558,4900
38655,239546,13715,115224,8749,225831,9459,4559,4900
38660,239577,13716,115237,8750,225861,9460,4560,4900
38665,239608,13717,115258,8751,225891,9461,4561,4900
38670,239639,13718,115276,8751,225921,9462,4562,4900
38675,239670,13719,115287,8751,225951,9464,4563,4901
38680,239701,13720,115302,8752,225981,9466,4565,4901
38685,239732,13721,115316,8753,226011,9467,4566,4901
38690,239763,13723,115335,8754,226040,9469,4567,4902
38695,239794,13724,115352,8754,226070,9471,4569,4902
38700,239825,13726,115365,8755,226098,9473,4570,4903
38705,239856,13729,115377,8757,226127,9475,4571,4904
38710,239887,13733,115392,8760,226154,9476,4572,4904
38715,239918,13736,115406,8762,226182,9477,4573,4904
38720,239949,13739,115427,8765,226210,9478,4574,4904
38725,239980,13742,115441,8767,226238,9479,4575,4904
38730,240011,13745,115456,8769,226266,9480,4576,4904
38735,240042,13747,115475,8770,226295,9481,4577,4904
38740,240073,13750,115491,8771,226323,9482,4577,4905
38745,240104,13752,115502,8772,226352,9483,4578,4905
38750,240135,13755,115521,8775,226380,9484,4578,4906
38755,240166,13757,115529,8775,226409,9485,4579,4906
38760,240197,13758,115544,8776,226439,9486,4579,4907
38765,240228,13759,115562,8777,226469,9487,4580,4907
38770,240259,13760,115577,8777,226499,9488,4581,4907
38775,240290,13761,115596,8778,226529,9489,4582,4907
38780,240321,13763,115612,8780,226558,9490,4582,4908
38785,240352,13764,115628,8781,226588,9492,4583,4909
38790,240383,13766,115643,8783,226617,9494,4584,4910
38795,240414,13767,115655,8784,226647,9496,4584,4912
38800,240445,13768,115670,8785,226677,9498,4584,4914
38805,240476,13770,115689,8786,226706,9500,4586,4914
38810,240507,13772,115705,8788,226735,9501,4586,4915
38815,240538,13776,115722,8791,226761,9503,4587,4916
38820,240569,13780,115738,8795,226789,9505,4589,4916
38825,240600,13782,115751,8796,226818,9506,4590,4916
38830,240631,13784,115766,8798,226847,9507,4590,4917
38835,240662,13786,115780,8799,226876,9508,4591,4917
38840,240693,13788,115801,8801,226905,9509,4591,4918
38845,240724,13790,115812,8801,226934,9510,4591,4919
38850,240755,13792,115824,8802,226963,9511,4591,4920
38855,240786,13794,115839,8802,226992,9512,4591,4921
38860,240817,13796,115853,8803,227021,9513,4591,4922
38865,240848,13798,115871,8805,227050,9514,4592,4922
38870,240879,13800,115890,8806,227079,9515,4593,4922
38875,240910,13802,115902,8806,227108,9516,4594,4922
38880,240941,13804,115916,8807,227137,9517,4594,4923
38885,240972,13806,115935,8807,227166,9518,4594,4924
38890,241003,13808,115948,8808,227195,9519,4594,4925
38895,241034,13810,115965,8808,227224,9520,4595,4925
38900,241065,13812,115978,8809,227253,9521,4595,4926
38905,241096,13814,115995,8811,227282,9522,4596,4926
38910,241127,13816,116012,8813,227311,9524,4597,4927
38915,241158,13819,116027,8815,227339,9526,4597,4929
38920,241189,13822,116042,8817,227367,9528,4599,4929
38925,241220,13826,116059,8819,227393,9530,4600,4930
38930,241251,13828,116078,8820,227423,9533,4601,4932
38935,241282,13830,116091,8822,227451,9535,4601,4934
38940,241313,13833,116109,8824,227480,9536,4602,4934
38945,241344,13835,116124,8826,227509,9537,4603,4934
38950,241375,13839,116133,8829,227536,9538,4603,4935
38955,241406,13841,116148,8830,227565,9539,4603,4936
38960,241437,13843,116164,8831,227594,9540,4604,4936
38965,241468,13844,116181,8832,227624,9541,4605,4936
38970,241499,13846,116199,8834,227653,9542,4605,4937
38975,241530,13848,116215,8836,227682,9543,4606,4937
38980,241561,13849,116231,8836,227712,9544,4607,4937
38985,241592,13851,116241,8837,227741,9545,4607,4938
38990,241623,13853,116259,8838,227770,9546,4608,4938
38995,241654,13853,116274,8838,227801,9547,4608,4939
39000,241685,13853,116288,8838,227832,9548,4608,4940
39005,241716,13853,116305,8838,227863,9549,4609,4940
39010,241747,13853,116316,8838,227894,9550,4610,4940
39015,241778,13853,116335,8838,227925,9551,4611,4940
39020,241809,13853,116349,8838,227956,9552,4611,4941
39025,241840,13853,116362,8838,227987,9553,4611,4942
39030,241871,13853,116373,8838,228018,9554,4611,4943
39035,241902,13854,116387,8839,228048,9556,4611,4945
39040,241933,13855,116403,8839,228078,9558,4611,4947
39045,241964,13856,116418,8840,228107,9561,4611,4950
39050,241995,13858,116433,8842,228137,9563,4613,4950
39055,242026,13859,116446,8843,228166,9565,4614,4951
39060,242057,13863,116459,8845,228194,9567,4616,4951
39065,242088,13867,116475,8848,228221,9569,4617,4952
39070,242119,13872,116489,8853,228247,9570,4618,4952
39075,242150,13878,116503,8857,228272,9571,4619,4952
39080,242181,13882,116514,8858,228299,9572,4620,4952
39085,242212,13885,116530,8860,228327,9573,4620,4953
39090,242243,13888,116543,8862,228355,9574,4621,4953
39095,242274,13891,116558,8864,228383,9575,4622,4953
39100,242305,13895,116573,8867,228410,9576,4623,4953
39105,242336,13897,116584,8868,228439,9577,4623,4954
39110,242367,13898,116599,8868,228469,9578,4624,4954
39115,242398,13900,116615,8869,228498,9579,4624,4955
39120,242429,13902,116631,8871,228527,9580,4624,4956
39125,242460,13902,116649,8871,228558,9581,4624,4957
39130,242491,13902,116665,8871,228589,9582,4624,4958
39135,242522,13902,116675,8871,228620,9583,4624,4959
39140,242553,13902,116688,8871,228651,9584,4624,4960
39145,242584,13902,116699,8871,228682,9585,4624,4961
39150,242615,13902,116721,8871,228713,9587,4625,4962
39155,242646,13902,116735,8871,228744,9589,4627,4962
39160,242677,13902,116753,8871,228775,9591,4628,4963
39165,242708,13902,116767,8871,228806,9592,4628,4964
39170,242739,13902,116781,8871,228837,9593,4628,4965
39175,242770,13902,116799,8871,228868,9595,4630,4965
39180,242801,13902,116813,8871,228899,9597,4631,4966
39185,242832,13904,116829,8873,228927,9599,4633,4966
39190,242863,13907,116842,8875,228955,9601,4635,4966
39195,242894,13910,116858,8877,228984,9603,4636,4967
39200,242925,13912,116876,8879,229013,9605,4637,4968
39205,242956,13915,116893,8881,229041,9607,4638,4969
39210,242987,13918,116907,8883,229069,9608,4639,4969
39215,243018,13921,116922,8886,229097,9609,4639,4970
39220,243049,13924,116934,8888,229125,9610,4639,4971
39225,243080,13927,116951,8889,229153,9611,4639,4972
39230,243111,13931,116964,8891,229180,9612,4639,4973
39235,243142,13936,116977,8894,229206,9613,4639,4974
39240,243173,13940,116993,8897,229233,9614,4640,4974
39245,243204,13942,117006,8898,229262,9616,4640,4976
39250,243235,13944,117024,8900,229291,9618,4642,4976
39255,243266,13947,117040,8902,229319,9620,4642,4978
39260,243297,13949,117059,8903,229348,9622,4644,4978
39265,243328,13952,117074,8904,229376,9624,4646,4978
39270,243359,13954,117090,8905,229405,9626,4646,4980
39275,243390,13956,117107,8906,229434,9627,4646,4981
39280,243421,13958,117118,8906,229463,9628,4646,4982
39285,243452,13962,117135,8910,229490,9629,4646,4983
39290,243483,13963,117149,8910,229520,9630,4646,4984
39295,243514,13964,117166,8910,229550,9631,4647,4984
39300,243545,13966,117179,8911,229579,9632,4648,4984
39305,243576,13967,117192,8911,229608,9633,4648,4985
39310,243607,13969,117209,8913,229638,9634,4649,4985
39315,243638,13972,117223,8915,229665,9636,4650,4986
39320,243669,13975,117240,8917,229694,9638,4651,4987
39325,243700,13976,117253,8918,229723,9639,4651,4988
39330,243731,13978,117268,8920,229752,9640,4652,4988
39335,243762,13980,117285,8922,229781,9641,4653,4988
39340,243793,13982,117300,8924,229810,9642,4654,4988
39345,243824,13984,117311,8925,229840,9643,4655,4988
39350,243855,13985,117328,8925,229870,9644,4656,4988
39355,243886,13986,117347,8925,229899,9645,4656,4989
39360,243917,13988,117363,8927,229929,9646,4656,4990
39365,243948,13988,117379,8927,229960,9647,4657,4990
39370,243979,13988,117398,8927,229991,9648,4658,4990
39375,244010,13988,117413,8927,230022,9650,4660,4990
39380,244041,13988,117427,8927,230053,9652,4661,4991
39385,244072,13988,117440,8927,230084,9654,4662,4992
39390,244103,13988,117456,8927,230115,9656,4664,4992
39395,244134,13988,117468,8927,230146,9657,4665,4992
39400,244165,13988,117485,8927,230177,9658,4665,4993
39405,244196,13988,117501,8927,230208,9659,4665,4994
39410,244227,13991,117518,8929,230236,9660,4665,4995
39415,244258,13993,117532,8929,230265,9661,4666,4995
39420,244289,13995,117552,8930,230294,9662,4667,4995
39425,244320,13999,117566,8932,230321,9663,4668,4995
39430,244351,14004,117584,8937,230347,9664,4668,4996
39435,244382,14008,117600,8940,230374,9665,4668,4997
39440,244413,14013,117612,8944,230400,9666,4668,4998
39445,244444,14018,117626,8949,230426,9667,4669,4998
39450,244475,14025,117647,8954,230450,9668,4670,4998
39455,244506,14029,117658,8956,230477,9669,4670,4999
39460,244537,14032,117670,8959,230505,9670,4671,4999
39465,244568,14036,117685,8962,230532,9671,4671,5000
39470,244599,14040,117701,8965,230559,9672,4671,5001
39475,244630,14043,117716,8968,230586,9673,4672,5001
39480,244661,14047,117732,8971,230613,9674,4673,5001
39485,244692,14049,117752,8972,230643,9675,4673,5002
39490,244723,14051,117771,8974,230672,9676,4674,5002
39495,244754,14052,117782,8974,230702,9678,4676,5002
39500,244785,14054,117800,8975,230731,9680,4677,5003
39505,244816,14056,117816,8976,230760,9682,4677,5005
39510,244847,14057,117829,8976,230790,9684,4678,5006
39515,244878,14058,117838,8976,230820,9686,4680,5006
39520,244909,14059,117854,8977,230850,9688,4680,5008
39525,244940,14061,117870,8979,230879,9689,4681,5008
39530,244971,14061,117882,8979,230910,9691,4681,5010
39535,245002,14061,117897,8979,230941,9692,4682,5010
39540,245033,14061,117913,8979,230972,9693,4682,5011
39545,245064,14063,117925,8981,231001,9694,4682,5012
39550,245095,14063,117939,8981,231032,9695,4682,5013
39555,245126,14063,117953,8981,231063,9696,4683,5013
39560,245157,14063,117969,8981,231094,9697,4684,5013
39565,245188,14064,117985,8981,231124,9698,4685,5013
39570,245219,14065,117997,8981,231154,9699,4685,5014
39575,245250,14066,118010,8982,231184,9700,4686,5014
39580,245281,14067,118023,8982,231214,9701,4687,5014
39585,245312,14069,118041,8983,231243,9702,4688,5014
39590,245343,14071,118055,8985,231272,9703,4688,5015
39595,245374,14073,118073,8987,231301,9704,4688,5016
39600,245405,14075,118090,8988,231330,9705,4689,5016
39605,245436,14077,118104,8989,231359,9706,4689,5017
39610,245467,14079,118119,8990,231388,9707,4689,5018
39615,245498,14081,118132,8991,231417,9708,4689,5019
39620,245529,14083,118147,8992,231446,9709,4689,5020
39625,245560,14085,118162,8993,231475,9711,4691,5020
39630,245591,14087,118176,8995,231504,9713,4693,5020
39635,245622,14089,118195,8996,231533,9715,4695,5020
39640,245653,14091,118213,8998,231562,9717,4697,5020
39645,245684,14093,118230,8998,231590,9718,4698,5020
39650,245715,14098,118248,9002,231616,9719,4698,5021
39655,245746,14101,118258,9004,231645,9720,4699,5021
39660,245777,14103,118270,9005,231674,9721,4699,5022
39665,245808,14103,118287,9005,231705,9722,4700,5022
39670,245839,14103,118301,9005,231736,9723,4700,5023
39675,245870,14103,118313,9005,231767,9724,4700,5024
39680,245901,14103,118326,9005,231798,9725,4700,5025
39685,245932,14103,118342,9005,231829,9726,4700,5026
39690,245963,14103,118354,9005,231860,9727,4700,5027
39695,245994,14103,118371,9005,231891,9728,4701,5027
39700,246025,14103,118388,9005,231922,9729,4701,5028
39705,246056,14103,118404,9005,231953,9730,4702,5028
39710,246087,14105,118421,9007,231982,9732,4704,5028
39715,246118,14106,118434,9007,232012,9734,4705,5029
39720,246149,14108,118449,9008,232041,9736,4705,5031
39725,246180,14110,118461,9009,232070,9737,4706,5031
39730,246211,14112,118474,9010,232099,9738,4706,5032
39735,246242,14114,118487,9010,232128,9739,4707,5032
39740,246273,14116,118501,9012,232157,9740,4708,5032
39745,246304,14118,118511,9012,232186,9742,4708,5034
39750,246335,14120,118530,9013,232215,9744,4709,5035
39755,246366,14122,118541,9014,232244,9746,4710,5036
39760,246397,14124,118555,9014,232273,9747,4711,5036
39765,246428,14126,118563,9015,232302,9748,4712,5036
39770,246459,14129,118579,9018,232330,9749,4713,5036
39775,246490,14133,118593,9020,232357,9750,4713,5037
39780,246521,14137,118607,9022,232384,9751,4714,5037
39785,246552,14140,118625,9024,232412,9751,4714,5037
39790,246583,14140,118636,9024,232443,9751,4714,5037
39795,246614,14140,118652,9024,232474,9751,4714,5037
39800,246645,14140,118665,9024,232505,9751,4714,5037
39805,246676,14140,118678,9024,232536,9751,4714,5037
39810,246707,14140,118692,9024,232567,9751,4714,5037
39815,246738,14140,118708,9024,232598,9751,4714,5037
39820,246769,14140,118723,9024,232629,9751,4714,5037
39825,246800,14140,118738,9024,232660,9751,4714,5037
39830,246831,14140,118757,9024,232691,9752,4715,5037
39835,246862,14140,118775,9024,232722,9753,4716,5037
39840,246893,14140,118794,9024,232753,9754,4716,5038
39845,246924,14142,118810,9026,232782,9756,4716,5040
39850,246955,14144,118827,9027,232811,9758,4718,5040
39855,246986,14146,118839,9029,232840,9760,4720,5040
39860,247017,14147,118854,9030,232870,9762,4722,5040
39865,247048,14148,118866,9030,232900,9764,4724,5040
39870,247079,14150,118882,9031,232929,9766,4724,5042
39875,247110,14150,118898,9031,232960,9768,4725,5043
39880,247141,14150,118914,9031,232991,9769,4726,5043
39885,247172,14150,118931,9031,233022,9770,4727,5043
39890,247203,14151,118942,9032,233052,9770,4727,5043
39895,247234,14153,118955,9032,233081,9771,4728,5043
39900,247265,14155,118974,9034,233110,9772,4729,5043
39905,247296,14157,118991,9036,233138,9773,4730,5043
39910,247327,14160,119003,9037,233166,9774,4730,5044
39915,247358,14163,119018,9040,233194,9775,4731,5044
39920,247389,14168,119037,9044,233221,9776,4732,5044
39925,247420,14172,119054,9048,233248,9777,4732,5045
39930,247451,14175,119071,9050,233276,9778,4732,5046
39935,247482,14179,119090,9052,233303,9779,4733,5046
39940,247513,14181,119107,9054,233332,9780,4734,5046
39945,247544,14182,119121,9055,233362,9781,4734,5047
39950,247575,14184,119137,9056,233391,9782,4735,5047
39955,247606,14186,119154,9058,233420,9783,4736,5047
39960,247637,14188,119169,9060,233449,9784,4737,5047
39965,247668,14191,119183,9062,233477,9785,4737,5048
39970,247699,14194,119197,9064,233505,9786,4737,5049
39975,247730,14197,119211,9066,233533,9787,4737,5050
39980,247761,14199,119223,9068,233562,9789,4738,5051
39985,247792,14202,119239,9070,233590,9791,4739,5052
39990,247823,14205,119254,9071,233618,9793,4741,5052
39995,247854,14206,119270,9071,233648,9796,4744,5052
40000,247885,14208,119285,9073,233677,9798,4745,5053
40005,247916,14209,119301,9073,233707,9799,4745,5054
40010,247947,14210,119315,9074,233737,9800,4746,5054
40015,247978,14211,119330,9074,233767,9801,4747,5054
40020,248009,14212,119346,9074,233797,9802,4747,5055
40025,248040,14214,119363,9075,233826,9803,4748,5055
40030,248071,14216,119378,9077,233854,9804,4748,5056
40035,248102,14220,119398,9079,233881,9805,4749,5056
40040,248133,14224,119414,9083,233908,9806,4749,5057
40045,248164,14228,119433,9087,233936,9807,4750,5057
40050,248195,14231,119447,9089,233964,9808,4751,5057
40055,248226,14233,119463,9090,233993,9809,4752,5057
40060,248257,14235,119473,9091,234022,9810,4752,5058
40065,248288,14238,119487,9093,234050,9811,4753,5058
40070,248319,14241,119501,9096,234078,9812,4754,5058
40075,248350,14242,119513,9096,234108,9813,4754,5059
40080,248381,14243,119523,9096,234138,9814,4755,5059
40085,248412,14244,119536,9096,234168,9815,4756,5059
40090,248443,14245,119547,9097,234198,9816,4757,5059
40095,248474,14246,119565,9097,234228,9817,4757,5060
40100,248505,14249,119584,9098,234256,9819,4759,5060
40105,248536,14252,119594,9100,234284,9821,4760,5061
40110,248567,14256,119608,9102,234311,9823,4760,5063
40115,248598,14259,119626,9104,234339,9825,4762,5063
40120,248629,14262,119643,9106,234367,9827,4763,5064
40125,248660,14266,119653,9109,234394,9829,4763,5066
40130,248691,14269,119669,9111,234422,9831,4763,5068
40135,248722,14272,119684,9113,234450,9832,4764,5068
40140,248753,14277,119703,9117,234476,9833,4765,5068
40145,248784,14279,119717,9118,234505,9834,4765,5069
40150,248815,14282,119732,9120,234533,9835,4765,5070
40155,248846,14285,119746,9121,234561,9837,4767,5070
40160,248877,14287,119757,9121,234590,9839,4767,5072
40165,248908,14289,119769,9123,234619,9841,4768,5073
40170,248939,14292,119784,9126,234647,9843,4769,5074
40175,248970,14294,119798,9126,234676,9844,4769,5075
40180,249001,14297,119812,9128,234704,9845,4770,5075
40185,249032,14300,119827,9130,234732,9846,4770,5076
40190,249063,14302,119841,9130,234761,9847,4770,5077
40195,249094,14305,119853,9131,234789,9848,4771,5077
40200,249125,14308,119868,9132,234817,9849,4772,5077
40205,249156,14310,119880,9132,234846,9851,4773,5078
40210,249187,14312,119896,9133,234875,9853,4775,5078
40215,249218,14314,119906,9134,234904,9855,4775,5080
40220,249249,14317,119923,9136,234932,9857,4776,5081
40225,249280,14320,119936,9137,234960,9859,4776,5083
40230,249311,14323,119951,9138,234988,9861,4776,5085
40235,249342,14325,119971,9139,235017,9864,4777,5087
40240,249373,14327,119980,9139,235046,9866,4778,5088
40245,249404,14331,119998,9142,235073,9868,4779,5089
40250,249435,14334,120010,9144,235101,9870,4780,5090
40255,249466,14335,120020,9144,235131,9871,4781,5090
40260,249497,14336,120036,9145,235161,9872,4781,5091
40265,249528,14338,120050,9146,235190,9873,4782,5091
40270,249559,14340,120065,9148,235219,9874,4783,5091
40275,249590,14342,120083,9148,235248,9875,4783,5092
40280,249621,14344,120097,9149,235277,9876,4784,5092
40285,249652,14347,120111,9151,235304,9877,4785,5092
40290,249683,14350,120126,9152,235333,9878,4785,5093
40295,249714,14352,120143,9152,235362,9879,4785,5094
40300,249745,14353,120157,9152,235392,9880,4785,5095
40305,249776,14354,120169,9152,235422,9881,4785,5096
40310,249807,14355,120183,9153,235452,9882,4785,5097
40315,249838,14357,120198,9154,235481,9883,4786,5097
40320,249869,14358,120206,9154,235511,9884,4786,5098
40325,249900,14360,120224,9155,235540,9885,4787,5098
40330,249931,14362,120243,9157,235569,9886,4787,5099
40335,249962,14365,120256,9160,235597,9887,4787,5100
40340,249993,14367,120269,9161,235626,9888,4788,5100
40345,250024,14370,120287,9163,235654,9889,4788,5101
40350,250055,14373,120301,9164,235682,9890,4789,5101
40355,250086,14376,120321,9167,235710,9891,4789,5102
40360,250117,14378,120336,9168,235739,9893,4790,5103
40365,250148,14381,120352,9171,235767,9895,4790,5105
40370,250179,14384,120367,9172,235795,9898,4793,5105
40375,250210,14388,120380,9174,235822,9901,4794,5107
40380,250241,14389,120391,9174,235852,9903,4795,5108
40385,250272,14391,120405,9175,235881,9905,4797,5108
40390,250303,14392,120420,9175,235911,9906,4797,5109
40395,250334,14393,120436,9175,235941,9907,4797,5110
40400,250365,14394,120454,9176,235971,9908,4797,5111
40405,250396,14395,120470,9177,236000,9909,4797,5112
40410,250427,14397,120483,9179,236030,9910,4797,5113
40415,250458,14398,120495,9179,236059,9911,4797,5114
40420,250489,14400,120513,9181,236088,9912,4798,5114
40425,250520,14402,120532,9183,236117,9913,4799,5114
40430,250551,14404,120549,9184,236147,9914,4800,5114
40435,250582,14405,120560,9184,236176,9915,4800,5115
40440,250613,14407,120575,9185,236206,9916,4800,5116
40445,250644,14408,120592,9185,236236,9917,4801,5116
40450,250675,14409,120608,9186,236266,9918,4802,5116
40455,250706,14410,120621,9187,236296,9919,4803,5116
40460,250737,14411,120630,9187,236326,9920,4803,5117
40465,250768,14412,120649,9188,236356,9921,4803,5118
40470,250799,14413,120662,9188,236386,9922,4804,5118
40475,250830,14414,120675,9188,236416,9923,4804,5119
40480,250861,14416,120689,9189,236445,9924,4804,5120
40485,250892,14418,120702,9190,236474,9925,4804,5121
40490,250923,14423,120718,9195,236500,9926,4805,5121
40495,250954,14426,120737,9197,236528,9927,4806,5121
40500,250985,14430,120750,9200,236555,9928,4806,5122
40505,251016,14434,120763,9204,236582,9929,4806,5123
40510,251047,14436,120775,9205,236611,9930,4806,5124
40515,251078,14438,120786,9207,236640,9931,4806,5125
40520,251109,14441,120804,9209,236668,9932,4807,5125
40525,251140,14445,120823,9212,236695,9933,4807,5126
40530,251171,14447,120839,9214,236724,9934,4807,5127
40535,251202,14448,120848,9214,236754,9935,4808,5127
40540,251233,14449,120864,9214,236784,9936,4809,5127
40545,251264,14450,120880,9215,236813,9937,4809,5128
40550,251295,14452,120892,9216,236842,9938,4809,5129
40555,251326,14454,120910,9218,236872,9939,4810,5129
40560,251357,14454,120928,9218,236903,9940,4810,5130
40565,251388,14454,120945,9218,236934,9941,4811,5130
40570,251419,14454,120961,9218,236965,9942,4812,5130
40575,251450,14454,120980,9218,236996,9943,4812,5131
40580,251481,14454,120994,9218,237027,9944,4813,5131
40585,251512,14454,121008,9218,237058,9945,4813,5132
40590,251543,14454,121018,9218,237089,9946,4813,5133
40595,251574,14454,121032,9218,237120,9947,4813,5134
40600,251605,14455,121048,9218,237150,9948,4813,5135
40605,251636,14456,121058,9218,237180,9949,4814,5135
40610,251667,14457,121068,9218,237210,9950,4814,5136
40615,251698,14458,121081,9218,237240,9951,4814,5137
40620,251729,14459,121098,9218,237270,9952,4815,5137
40625,251760,14462,121117,9221,237297,9953,4816,5137
40630,251791,14467,121129,9224,237324,9954,4816,5138
40635,251822,14471,121146,9227,237351,9955,4816,5139
40640,251853,14475,121158,9228,237378,9956,4817,5139
40645,251884,14479,121175,9231,237405,9957,4818,5139
40650,251915,14483,121189,9234,237432,9958,4819,5139
40655,251946,14486,121206,9236,237460,9959,4819,5140
40660,251977,14490,121225,9239,237487,9960,4820,5140
40665,252008,14495,121244,9243,237513,9962,4821,5141
40670,252039,14499,121257,9246,237540,9964,4821,5143
40675,252070,14503,121272,9248,237567,9965,4821,5144
40680,252101,14505,121282,9249,237596,9966,4822,5144
40685,252132,14508,121298,9251,237624,9968,4823,5145
40690,252163,14510,121317,9252,237653,9969,4823,5146
40695,252194,14511,121334,9252,237683,9970,4823,5147
40700,252225,14512,121352,9252,237713,9971,4824,5147
40705,252256,14513,121366,9253,237743,9972,4825,5147
40710,252287,14514,121381,9254,237773,9973,4826,5147
40715,252318,14515,121391,9255,237803,9974,4826,5148
40720,252349,14516,121404,9255,237833,9975,4826,5149
40725,252380,14517,121416,9255,237863,9976,4826,5150
40730,252411,14518,121430,9255,237893,9977,4826,5151
40735,252442,14519,121441,9256,237923,9978,4826,5152
40740,252473,14520,121458,9257,237953,9979,4826,5153
40745,252504,14523,121469,9258,237980,9979,4826,5153
40750,252535,14528,121484,9261,238007,9979,4826,5153
40755,252566,14532,121501,9265,238034,9979,4826,5153
40760,252597,14535,121517,9267,238062,9979,4826,5153
40765,252628,14538,121534,9269,238090,9979,4826,5153
40770,252659,14541,121552,9270,238118,9979,4826,5153
40775,252690,14544,121566,9272,238146,9979,4826,5153
40780,252721,14547,121580,9275,238174,9979,4826,5153
40785,252752,14550,121597,9277,238202,9979,4826,5153
40790,252783,14553,121607,9278,238230,9980,4826,5154
40795,252814,14557,121621,9281,238257,9981,4826,5155
40800,252845,14562,121640,9284,238283,9981,4826,5155
40805,252876,14564,121659,9285,238312,9983,4828,5155
40810,252907,14567,121676,9287,238340,9985,4828,5157
40815,252938,14569,121691,9288,238369,9987,4829,5158
40820,252969,14572,121710,9289,238397,9988,4829,5159
40825,253000,14574,121727,9291,238426,9989,4829,5160
40830,253031,14576,121742,9293,238455,9990,4830,5160
40835,253062,14578,121753,9294,238484,9991,4830,5161
40840,253093,14580,121766,9295,238513,9992,4831,5161
40845,253124,14583,121782,9296,238541,9993,4831,5162
40850,253155,14585,121792,9297,238570,9994,4832,5162
40855,253186,14588,121802,9299,238598,9995,4832,5163
40860,253217,14592,121817,9302,238625,9996,4833,5163
40865,253248,14592,121829,9302,238656,9997,4833,5164
40870,253279,14592,121846,9302,238687,9998,4834,5164
40875,253310,14592,121862,9302,238718,9999,4834,5165
40880,253341,14592,121881,9302,238749,10000,4834,5166
40885,253372,14592,121892,9302,238780,10001,4835,5166
40890,253403,14592,121902,9302,238811,10002,4836,5166
40895,253434,14592,121917,9302,238842,10003,4837,5166
40900,253465,14592,121929,9302,238873,10004,4838,5166
40905,253496,14592,121941,9302,238904,10005,4838,5167
40910,253527,14594,121957,9304,238933,10007,4839,5168
40915,253558,14596,121971,9306,238962,10009,4839,5170
40920,253589,14598,121990,9308,238991,10011,4841,5170
40925,253620,14600,122004,9310,239020,10013,4842,5171
40930,253651,14603,122022,9312,239048,10015,4844,5171
40935,253682,14605,122033,9312,239077,10017,4845,5172
40940,253713,14608,122049,9314,239105,10019,4846,5173
40945,253744,14610,122063,9315,239134,10021,4847,5174
40950,253775,14614,122078,9317,239161,10023,4848,5175
40955,253806,14618,122096,9320,239188,10024,4848,5176
40960,253837,14620,122110,9322,239217,10025,4849,5176
40965,253868,14621,122127,9322,239247,10026,4850,5176
40970,253899,14624,122142,9324,239275,10027,4851,5176
40975,253930,14626,122157,9325,239304,10028,4851,5177
40980,253961,14627,122168,9326,239334,10029,4852,5177
40985,253992,14630,122180,9328,239362,10030,4853,5177
40990,254023,14633,122196,9330,239390,10031,4854,5177
40995,254054,14636,122212,9332,239418,10032,4854,5178
41000,254085,14639,122229,9335,239445,10033,4854,5179
41005,254116,14641,122246,9337,239475,10034,4855,5179
41010,254147,14642,122265,9338,239505,10035,4855,5180
41015,254178,14643,122280,9339,239534,10036,4856,5180
41020,254209,14645,122291,9341,239564,10037,4857,5180
41025,254240,14646,122306,9341,239593,10039,4857,5182
41030,254271,14647,122314,9342,239624,10041,4857,5184
41035,254302,14647,122325,9342,239655,10043,4858,5185
41040,254333,14647,122337,9342,239686,10045,4858,5187
41045,254364,14647,122352,9342,239717,10046,4859,5187
41050,254395,14647,122367,9342,239748,10047,4860,5187
41055,254426,14647,122378,9342,239779,10049,4861,5188
41060,254457,14647,122392,9342,239810,10051,4862,5189
41065,254488,14647,122410,9342,239841,10053,4862,5191
41070,254519,14647,122426,9342,239872,10055,4864,5191
41075,254550,14648,122443,9342,239902,10057,4865,5192
41080,254581,14649,122462,9342,239932,10058,4865,5193
41085,254612,14650,122474,9342,239962,10059,4865,5194
41090,254643,14652,122487,9344,239991,10060,4865,5195
41095,254674,14655,122502,9346,240019,10061,4866,5195
41100,254705,14657,122512,9347,240048,10062,4867,5195
41105,254736,14660,122529,9348,240076,10063,4868,5195
41110,254767,14663,122545,9350,240104,10064,4869,5195
41115,254798,14666,122556,9351,240132,10065,4870,5195
41120,254829,14669,122570,9353,240160,10066,4871,5195
41125,254860,14671,122582,9354,240189,10067,4872,5195
41130,254891,14673,122598,9354,240218,10068,4872,5196
41135,254922,14677,122618,9357,240245,10069,4873,5196
41140,254953,14680,122631,9359,240273,10070,4874,5196
41145,254984,14683,122646,9359,240301,10071,4874,5197
41150,255015,14688,122661,9363,240327,10073,4875,5198
41155,255046,14692,122676,9365,240354,10075,4876,5199
41160,255077,14697,122692,9369,240380,10077,4877,5200
41165,255108,14701,122707,9371,240407,10078,4877,5201
41170,255139,14704,122721,9373,240435,10078,4877,5201
41175,255170,14706,122739,9374,240464,10078,4877,5201
41180,255201,14708,122752,9374,240493,10078,4877,5201
41185,255232,14711,122764,9375,240521,10078,4877,5201
41190,255263,14713,122775,9375,240550,10078,4877,5201
41195,255294,14715,122793,9376,240579,10078,4877,5201
41200,255325,14717,122807,9377,240608,10078,4877,5201
41205,255356,14720,122824,9378,240636,10078,4877,5201
41210,255387,14721,122835,9378,240666,10078,4877,5201
41215,255418,14722,122849,9379,240695,10078,4877,5201
41220,255449,14724,122865,9381,240724,10078,4877,5201
41225,255480,14727,122874,9382,240753,10078,4877,5201
41230,255511,14729,122889,9383,240781,10078,4877,5201
41235,255542,14732,122905,9384,240810,10078,4877,5201
41240,255573,14733,122918,9384,240840,10078,4877,5201
41245,255604,14734,122935,9385,240870,10078,4877,5201
41250,255635,14735,122951,9386,240900,10078,4877,5201
41255,255666,14736,122967,9386,240930,10078,4877,5201
41260,255697,14737,122984,9387,240960,10078,4877,5201
41265,255728,14738,122996,9387,240990,10078,4877,5201
41270,255759,14739,123009,9388,241020,10079,4877,5202
41275,255790,14740,123022,9388,241050,10080,4877,5203
41280,255821,14742,123039,9390,241079,10081,4878,5203
41285,255852,14745,123054,9393,241107,10082,4878,5204
41290,255883,14747,123068,9394,241136,10083,4878,5205
41295,255914,14750,123084,9396,241164,10084,4879,5205
41300,255945,14753,123102,9398,241192,10086,4880,5206
41305,255976,14757,123122,9402,241219,10088,4882,5206
41310,256007,14760,123137,9405,241247,10090,4882,5208
41315,256038,14761,123150,9405,241277,10092,4883,5209
41320,256069,14761,123163,9405,241308,10093,4883,5210
41325,256100,14761,123174,9405,241339,10094,4883,5211
41330,256131,14763,123194,9407,241368,10095,4884,5211
41335,256162,14765,123212,9408,241397,10096,4885,5211
41340,256193,14766,123224,9408,241427,10097,4885,5212
41345,256224,14768,123234,9409,241456,10100,4887,5213
41350,256255,14771,123251,9410,241484,10102,4888,5214
41355,256286,14775,123271,9414,241511,10104,4890,5214
41360,256317,14778,123287,9415,241539,10106,4892,5214
41365,256348,14781,123299,9416,241567,10108,4893,5215
41370,256379,14783,123312,9418,241596,10110,4894,5216
41375,256410,14786,123332,9420,241624,10112,4895,5217
41380,256441,14789,123348,9422,241652,10114,4896,5218
41385,256472,14791,123366,9424,241681,10116,4897,5219
41390,256503,14795,123383,9427,241708,10118,4898,5220
41395,256534,14796,123398,9428,241738,10120,4898,5222
41400,256565,14797,123414,9428,241768,10122,4900,5222
41405,256596,14798,123427,9429,241798,10123,4901,5222
41410,256627,14798,123440,9429,241829,10124,4901,5223
41415,256658,14798,123449,9429,241860,10125,4902,5223
41420,256689,14800,123467,9431,241889,10126,4903,5223
41425,256720,14802,123482,9432,241918,10127,4904,5223
41430,256751,14804,123496,9433,241947,10128,4904,5224
41435,256782,14805,123511,9434,241977,10129,4904,5225
41440,256813,14807,123529,9436,242006,10130,4904,5226
41445,256844,14808,123541,9436,242036,10131,4905,5226
41450,256875,14810,123553,9437,242065,10132,4905,5227
41455,256906,14811,123562,9438,242095,10133,4905,5228
41460,256937,14814,123579,9441,242123,10135,4906,5229
41465,256968,14815,123593,9441,242153,10137,4907,5230
41470,256999,14816,123607,9441,242183,10138,4908,5230
41475,257030,14817,123621,9442,242213,10139,4908,5231
41480,257061,14818,123636,9443,242243,10140,4909,5231
41485,257092,14819,123654,9444,242273,10141,4909,5232
41490,257123,14820,123667,9445,242303,10142,4910,5232
41495,257154,14822,123680,9446,242332,10143,4910,5233
41500,257185,14824,123693,9447,242361,10144,4910,5234
41505,257216,14826,123711,9448,242390,10146,4911,5235
41510,257247,14829,123724,9450,242418,10148,4912,5236
41515,257278,14833,123741,9451,242445,10150,4912,5238
41520,257309,14836,123755,9453,242473,10152,4913,5239
41525,257340,14839,123766,9454,242501,10153,4913,5240
41530,257371,14842,123778,9454,242529,10154,4914,5240
41535,257402,14845,123789,9455,242557,10155,4914,5241
41540,257433,14848,123810,9457,242585,10156,4915,5241
41545,257464,14851,123824,9458,242613,10157,4915,5242
41550,257495,14854,123840,9461,242641,10158,4915,5243
41555,257526,14857,123857,9463,242669,10159,4915,5244
41560,257557,14860,123873,9463,242697,10160,4915,5245
41565,257588,14863,123889,9465,242725,10161,4916,5245
41570,257619,14868,123905,9469,242750,10162,4917,5245
41575,257650,14872,123917,9471,242777,10164,4918,5246
41580,257681,14877,123934,9475,242803,10166,4919,5247
41585,257712,14881,123951,9478,242830,10168,4920,5248
41590,257743,14884,123966,9479,242859,10169,4920,5249
41595,257774,14886,123985,9480,242888,10170,4921,5249
41600,257805,14889,123997,9482,242916,10171,4921,5250
41605,257836,14890,124014,9483,242945,10172,4921,5251
41610,257867,14892,124022,9484,242975,10173,4921,5252
41615,257898,14893,124037,9485,243004,10174,4921,5253
41620,257929,14896,124048,9487,243033,10175,4921,5254
41625,257960,14898,124057,9488,243062,10177,4922,5255
41630,257991,14899,124068,9488,243092,10179,4923,5256
41635,258022,14900,124087,9489,243121,10181,4925,5256
41640,258053,14901,124103,9490,243152,10183,4927,5256
41645,258084,14903,124117,9492,243181,10185,4927,5258
41650,258115,14905,124128,9494,243210,10187,4928,5259
41655,258146,14907,124146,9495,243239,10189,4928,5261
41660,258177,14909,124162,9496,243268,10191,4928,5263
41665,258208,14910,124180,9497,243298,10192,4929,5263
41670,258239,14912,124197,9499,243327,10193,4930,5263
41675,258270,14913,124209,9499,243357,10194,4930,5264
41680,258301,14913,124222,9499,243388,10195,4931,5264
41685,258332,14913,124234,9499,243419,10196,4931,5265
41690,258363,14913,124245,9499,243450,10197,4931,5266
41695,258394,14913,124263,9499,243481,10198,4932,5266
41700,258425,14913,124275,9499,243512,10199,4932,5267
41705,258456,14914,124294,9499,243542,10200,4933,5267
41710,258487,14915,124306,9499,243572,10201,4933,5268
41715,258518,14916,124323,9500,243602,10202,4933,5269
41720,258549,14917,124341,9501,243632,10203,4933,5270
41725,258580,14918,124362,9502,243662,10204,4933,5271
41730,258611,14919,124377,9502,243692,10205,4934,5271
41735,258642,14920,124391,9502,243722,10206,4934,5272
41740,258673,14921,124404,9502,243752,10207,4935,5272
41745,258704,14922,124418,9502,243782,10208,4935,5273
41750,258735,14924,124434,9504,243811,10209,4936,5273
41755,258766,14927,124450,9506,243839,10210,4937,5273
41760,258797,14930,124466,9509,243866,10211,4938,5273
41765,258828,14935,124478,9513,243893,10213,4938,5275
41770,258859,14939,124490,9517,243919,10215,4938,5277
41775,258890,14944,124513,9521,243946,10217,4940,5277
41780,258921,14948,124530,9525,243973,10219,4940,5279
41785,258952,14951,124544,9527,244001,10221,4940,5281
41790,258983,14955,124559,9530,244027,10223,4940,5283
41795,259014,14961,124579,9533,244052,10225,4941,5284
41800,259045,14965,124589,9534,244079,10227,4942,5285
41805,259076,14970,124602,9539,244106,10229,4942,5287
41810,259107,14971,124622,9539,244136,10231,4944,5287
41815,259138,14973,124637,9541,244165,10233,4944,5289
41820,259169,14974,124651,9541,244195,10235,4945,5290
41825,259200,14974,124664,9541,244226,10236,4946,5290
41830,259231,14974,124679,9541,244257,10237,4946,5291
41835,259262,14974,124695,9541,244288,10238,4946,5292
41840,259293,14974,124713,9541,244319,10239,4946,5293
41845,259324,14974,124729,9541,244350,10240,4946,5294
41850,259355,14974,124745,9541,244381,10241,4946,5295
41855,259386,14974,124756,9541,244412,10242,4947,5295
41860,259417,14974,124774,9541,244443,10243,4948,5295
41865,259448,14974,124790,9541,244474,10244,4949,5295
41870,259479,14974,124805,9541,244505,10245,4949,5296
41875,259510,14974,124822,9541,244536,10246,4949,5297
41880,259541,14974,124839,9541,244567,10247,4949,5298
41885,259572,14975,124851,9541,244597,10248,4949,5299
41890,259603,14977,124869,9543,244626,10249,4949,5300
41895,259634,14979,124886,9545,244655,10250,4950,5300
41900,259665,14980,124905,9546,244685,10251,4950,5301
41905,259696,14982,124921,9547,244714,10252,4950,5302
41910,259727,14983,124934,9547,244743,10253,4951,5302
41915,259758,14987,124949,9550,244771,10254,4952,5302
41920,259789,14990,124964,9551,244799,10255,4952,5303
41925,259820,14994,124977,9554,244826,10257,4954,5303
41930,259851,14999,124989,9558,244852,10259,4955,5304
41935,259882,15004,125008,9562,244877,10261,4956,5305
41940,259913,15008,125022,9565,244904,10263,4956,5307
41945,259944,15011,125033,9567,244933,10265,4957,5308
41950,259975,15013,125047,9569,244962,10267,4957,5310
41955,260006,15015,125065,9571,244991,10269,4958,5311
41960,260037,15016,125080,9572,245021,10271,4959,5312
41965,260068,15018,125097,9574,245050,10273,4960,5313
41970,260099,15019,125111,9574,245080,10275,4962,5313
41975,260130,15020,125129,9575,245110,10277,4964,5313
41980,260161,15022,125146,9576,245139,10279,4965,5314
41985,260192,15025,125162,9579,245167,10281,4966,5315
41990,260223,15028,125177,9582,245195,10283,4966,5317
41995,260254,15032,125194,9585,245222,10285,4966,5319
42000,260285,15032,125210,9585,245253,10287,4967,5320
42005,260316,15032,125223,9585,245284,10288,4967,5321
42010,260347,15032,125240,9585,245315,10289,4967,5322
42015,260378,15032,125260,9585,245346,10290,4967,5323
42020,260409,15032,125278,9585,245377,10291,4967,5324
42025,260440,15032,125296,9585,245408,10292,4968,5324
42030,260471,15032,125311,9585,245439,10293,4968,5325
42035,260502,15032,125325,9585,245470,10294,4968,5326
42040,260533,15033,125342,9585,245500,10295,4969,5326
42045,260564,15035,125357,9586,245529,10296,4970,5326
42050,260595,15038,125369,9589,245557,10297,4971,5326
42055,260626,15043,125386,9594,245583,10298,4972,5326
42060,260657,15047,125399,9598,245610,10299,4972,5327
42065,260688,15048,125415,9599,245640,10301,4972,5329
42070,260719,15049,125433,9600,245670,10303,4973,5330
42075,260750,15050,125450,9601,245700,10305,4974,5331
42080,260781,15051,125467,9602,245730,10307,4975,5332
42085,260812,15052,125482,9602,245760,10309,4976,5333
42090,260843,15053,125501,9603,245790,10312,4978,5334
42095,260874,15054,125517,9604,245820,10315,4979,5336
42100,260905,15055,125529,9605,245850,10318,4981,5337
42105,260936,15058,125544,9607,245878,10321,4983,5338
42110,260967,15062,125561,9610,245905,10324,4983,5341
42115,260998,15067,125574,9613,245931,10326,4984,5342
42120,261029,15071,125589,9615,245958,10328,4986,5342
42125,261060,15072,125606,9615,245988,10330,4986,5344
42130,261091,15072,125622,9615,246019,10332,4986,5346
42135,261122,15072,125637,9615,246050,10334,4988,5346
42140,261153,15072,125653,9615,246081,10336,4989,5347
42145,261184,15072,125671,9615,246112,10338,4991,5347
42150,261215,15072,125689,9615,246143,10340,4991,5349
42155,261246,15072,125703,9615,246174,10342,4992,5350
42160,261277,15072,125715,9615,246205,10344,4992,5352
42165,261308,15073,125731,9616,246235,10346,4993,5353
42170,261339,15074,125743,9616,246265,10348,4993,5355
42175,261370,15075,125755,9616,246295,10349,4993,5356
42180,261401,15078,125774,9619,246323,10350,4993,5357
42185,261432,15081,125787,9620,246350,10351,4993,5358
42190,261463,15084,125802,9623,246379,10352,4993,5359
42195,261494,15087,125817,9626,246407,10353,4993,5360
42200,261525,15088,125834,9627,246437,10354,4994,5360
42205,261556,15089,125849,9627,246467,10355,4995,5360
42210,261587,15090,125864,9628,246497,10356,4996,5360
42215,261618,15091,125879,9628,246527,10357,4997,5360
42220,261649,15092,125895,9628,246557,10358,4998,5360
42225,261680,15093,125911,9628,246587,10359,4998,5361
42230,261711,15097,125928,9632,246614,10361,4999,5362
42235,261742,15099,125941,9633,246643,10363,5000,5363
42240,261773,15101,125956,9634,246672,10365,5002,5363
42245,261804,15103,125978,9634,246701,10366,5002,5364
42250,261835,15105,125999,9634,246730,10367,5002,5365
42255,261866,15108,126018,9636,246758,10368,5003,5365
42260,261897,15110,126034,9637,246787,10369,5004,5365
42265,261928,15112,126052,9639,246816,10370,5004,5366
42270,261959,15115,126069,9641,246844,10371,5005,5366
42275,261990,15118,126087,9643,246872,10373,5007,5366
42280,262021,15121,126102,9644,246900,10375,5008,5367
42285,262052,15125,126118,9647,246927,10377,5009,5368
42290,262083,15128,126133,9648,246954,10379,5009,5370
42295,262114,15131,126151,9650,246983,10381,5010,5371
42300,262145,15134,126165,9653,247011,10382,5011,5371
42305,262176,15136,126177,9653,247039,10383,5011,5372
42310,262207,15139,126189,9655,247067,10384,5011,5373
42315,262238,15142,126205,9658,247095,10385,5012,5373
42320,262269,15145,126222,9661,247123,10386,5013,5373
42325,262300,15148,126239,9664,247151,10387,5014,5373
42330,262331,15151,126251,9667,247180,10388,5014,5374
42335,262362,15153,126273,9669,247208,10389,5014,5375
42340,262393,15156,126287,9671,247236,10390,5015,5375
42345,262424,15160,126300,9674,247263,10391,5016,5375
42350,262455,15165,126313,9678,247289,10393,5018,5375
42355,262486,15167,126331,9680,247319,10395,5019,5376
42360,262517,15168,126348,9681,247349,10397,5021,5376
42365,262548,15170,126361,9683,247378,10398,5021,5377
42370,262579,15171,126378,9683,247408,10399,5021,5378
42375,262610,15173,126397,9684,247437,10400,5022,5378
42380,262641,15175,126414,9686,247466,10401,5022,5379
42385,262672,15175,126435,9686,247497,10402,5023,5379
42390,262703,15175,126450,9686,247528,10403,5023,5380
42395,262734,15175,126465,9686,247559,10404,5024,5380
42400,262765,15175,126484,9686,247590,10406,5025,5381
42405,262796,15176,126499,9686,247620,10407,5025,5382
42410,262827,15177,126515,9687,247650,10408,5025,5383
42415,262858,15178,126531,9687,247680,10409,5025,5384
42420,262889,15179,126546,9687,247710,10410,5026,5384
42425,262920,15182,126555,9689,247738,10411,5027,5384
42430,262951,15185,126575,9691,247766,10412,5027,5385
42435,262982,15189,126589,9693,247793,10413,5027,5386
42440,263013,15193,126603,9696,247820,10414,5028,5386
42445,263044,15196,126621,9699,247848,10415,5028,5387
42450,263075,15198,126635,9699,247877,10416,5028,5388
42455,263106,15200,126654,9701,247906,10417,5029,5388
42460,263137,15202,126674,9703,247935,10418,5030,5388
42465,263168,15205,126689,9706,247963,10420,5032,5388
42470,263199,15207,126704,9707,247992,10422,5033,5389
42475,263230,15209,126719,9708,248021,10424,5034,5390
42480,263261,15212,126731,9710,248049,10426,5036,5390
42485,263292,15214,126747,9711,248078,10427,5036,5391
42490,263323,15216,126764,9712,248106,10428,5036,5392
42495,263354,15219,126783,9714,248134,10429,5037,5392
42500,263385,15222,126796,9716,248163,10430,5037,5393
42505,263416,15224,126812,9717,248192,10431,5038,5393
42510,263447,15227,126830,9719,248220,10432,5038,5394
42515,263478,15230,126846,9722,248248,10433,5039,5394
42520,263509,15234,126865,9725,248275,10435,5040,5395
42525,263540,15238,126887,9728,248302,10437,5041,5396
42530,263571,15240,126903,9729,248331,10439,5042,5397
42535,263602,15241,126914,9729,248361,10441,5043,5398
42540,263633,15242,126929,9729,248391,10443,5045,5398
42545,263664,15242,126942,9729,248422,10444,5045,5399
42550,263695,15242,126957,9729,248453,10445,5045,5400
42555,263726,15242,126971,9729,248484,10446,5045,5401
42560,263757,15242,126984,9729,248515,10447,5045,5402
42565,263788,15242,126998,9729,248546,10448,5045,5403
42570,263819,15242,127005,9729,248577,10449,5045,5404
42575,263850,15244,127020,9730,248606,10450,5046,5404
42580,263881,15246,127033,9731,248635,10450,5046,5404
42585,263912,15248,127046,9733,248664,10450,5046,5404
42590,263943,15250,127053,9734,248693,10450,5046,5404
42595,263974,15252,127066,9735,248722,10450,5046,5404
42600,264005,15254,127083,9737,248751,10450,5046,5404
42605,264036,15257,127096,9738,248779,10450,5046,5404
42610,264067,15260,127109,9738,248807,10450,5046,5404
42615,264098,15263,127127,9739,248835,10450,5046,5404
42620,264129,15266,127144,9740,248863,10450,5046,5404
42625,264160,15270,127157,9742,248890,10450,5046,5404
42630,264191,15274,127179,9745,248917,10450,5046,5404
42635,264222,15277,127193,9746,248944,10450,5046,5404
42640,264253,15281,127209,9748,248971,10450,5046,5404
42645,264284,15286,127227,9753,248998,10451,5047,5404
42650,264315,15291,127248,9757,249024,10453,5048,5405
42655,264346,15293,127261,9758,249053,10455,5048,5407
42660,264377,15296,127277,9760,249080,10457,5048,5409
42665,264408,15297,127289,9761,249111,10458,5048,5410
42670,264439,15297,127306,9761,249142,10459,5048,5411
42675,264470,15297,127315,9761,249173,10460,5048,5412
42680,264501,15297,127332,9761,249204,10461,5048,5413
42685,264532,15297,127346,9761,249235,10463,5049,5414
42690,264563,15297,127360,9761,249266,10465,5050,5415
42695,264594,15297,127377,9761,249297,10467,5051,5416
42700,264625,15297,127392,9761,249328,10469,5052,5417
42705,264656,15297,127411,9761,249359,10471,5053,5418
42710,264687,15297,127426,9761,249390,10473,5053,5420
42715,264718,15297,127440,9761,249421,10474,5053,5421
42720,264749,15297,127457,9761,249452,10475,5054,5421
42725,264780,15297,127471,9761,249483,10476,5054,5422
42730,264811,15297,127488,9761,249514,10477,5054,5423
42735,264842,15297,127500,9761,249545,10478,5054,5424
42740,264873,15297,127514,9761,249576,10479,5054,5425
42745,264904,15297,127529,9761,249607,10480,5054,5426
42750,264935,15297,127544,9761,249638,10481,5055,5426
42755,264966,15297,127554,9761,249669,10482,5055,5427
42760,264997,15297,127568,9761,249700,10483,5055,5428
42765,265028,15297,127577,9761,249731,10484,5056,5428
42770,265059,15299,127588,9763,249760,10485,5056,5429
42775,265090,15303,127601,9765,249787,10486,5056,5430
42780,265121,15308,127617,9768,249813,10487,5057,5430
42785,265152,15312,127639,9770,249839,10488,5058,5430
42790,265183,15317,127656,9774,249865,10489,5059,5430
42795,265214,15321,127669,9776,249893,10490,5060,5430
42800,265245,15324,127685,9778,249921,10491,5061,5430
42805,265276,15327,127695,9779,249948,10492,5061,5431
42810,265307,15331,127712,9782,249975,10494,5062,5432
42815,265338,15336,127725,9785,250002,10497,5064,5433
42820,265369,15341,127742,9789,250028,10500,5066,5434
42825,265400,15344,127755,9791,250056,10503,5067,5436
42830,265431,15346,127766,9791,250085,10506,5068,5438
42835,265462,15349,127782,9793,250112,10509,5070,5439
42840,265493,15354,127797,9797,250139,10512,5072,5440
42845,265524,15354,127810,9797,250170,10514,5073,5441
42850,265555,15354,127824,9797,250201,10515,5073,5442
42855,265586,15354,127838,9797,250232,10516,5074,5442
42860,265617,15354,127851,9797,250263,10517,5074,5443
42865,265648,15354,127868,9797,250294,10518,5074,5444
42870,265679,15354,127888,9797,250325,10519,5075,5444
42875,265710,15354,127901,9797,250356,10520,5075,5445
42880,265741,15354,127913,9797,250387,10521,5076,5445
42885,265772,15354,127935,9797,250418,10522,5077,5445
42890,265803,15354,127949,9797,250449,10523,5077,5446
42895,265834,15354,127966,9797,250480,10524,5078,5446
42900,265865,15354,127981,9797,250511,10525,5079,5446
42905,265896,15354,128001,9797,250542,10526,5080,5446
42910,265927,15354,128016,9797,250573,10527,5080,5447
42915,265958,15354,128030,9797,250604,10528,5080,5448
42920,265989,15354,128049,9797,250635,10529,5080,5449
42925,266020,15354,128067,9797,250666,10530,5080,5450
42930,266051,15356,128084,9799,250695,10531,5080,5451
42935,266082,15357,128103,9799,250725,10532,5081,5451
42940,266113,15358,128114,9800,250755,10533,5081,5452
42945,266144,15361,128129,9802,250783,10534,5081,5453
42950,266175,15366,128144,9805,250809,10536,5082,5454
42955,266206,15371,128156,9809,250835,10538,5082,5456
42960,266237,15376,128170,9812,250861,10540,5084,5456
42965,266268,15378,128188,9814,250889,10541,5084,5457
42970,266299,15381,128196,9815,250918,10542,5085,5457
42975,266330,15383,128209,9816,250946,10543,5085,5458
42980,266361,15386,128224,9818,250974,10544,5085,5459
42985,266392,15389,128247,9821,251003,10545,5085,5460
42990,266423,15391,128266,9822,251032,10546,5086,5460
42995,266454,15393,128281,9823,251061,10547,5086,5461
43000,266485,15396,128298,9826,251089,10548,5087,5461
43005,266516,15398,128315,9828,251118,10549,5087,5462
43010,266547,15400,128330,9830,251147,10550,5087,5463
43015,266578,15402,128338,9830,251176,10551,5088,5463
43020,266609,15404,128354,9830,251205,10552,5089,5463
43025,266640,15406,128370,9832,251234,10554,5090,5464
43030,266671,15408,128386,9833,251263,10556,5092,5464
43035,266702,15410,128403,9834,251292,10557,5092,5465
43040,266733,15412,128415,9834,251321,10558,5093,5465
43045,266764,15414,128431,9834,251350,10559,5093,5466
43050,266795,15416,128450,9835,251379,10560,5093,5467
43055,266826,15418,128464,9835,251408,10561,5094,5467
43060,266857,15420,128479,9836,251437,10562,5095,5467
43065,266888,15424,128495,9838,251464,10563,5096,5467
43070,266919,15428,128508,9841,251491,10564,5097,5467
43075,266950,15432,128524,9842,251518,10565,5097,5468
43080,266981,15435,128541,9844,251546,10566,5098,5468
43085,267012,15437,128556,9844,251575,10567,5098,5469
43090,267043,15438,128574,9845,251605,10568,5099,5469
43095,267074,15439,128590,9846,251634,10569,5099,5470
43100,267105,15441,128611,9848,251664,10570,5100,5470
43105,267136,15442,128625,9849,251694,10571,5100,5471
43110,267167,15443,128640,9849,251723,10572,5101,5471
43115,267198,15445,128655,9850,251752,10573,5101,5472
43120,267229,15447,128669,9851,251782,10574,5102,5472
43125,267260,15448,128685,9852,251812,10575,5102,5473
43130,267291,15449,128698,9852,251842,10576,5103,5473
43135,267322,15451,128710,9853,251871,10578,5103,5475
43140,267353,15452,128726,9853,251901,10580,5105,5475
43145,267384,15452,128738,9853,251932,10582,5106,5476
43150,267415,15452,128753,9853,251963,10584,5106,5478
43155,267446,15452,128767,9853,251994,10586,5107,5479
43160,267477,15452,128782,9853,252025,10588,5109,5479
43165,267508,15452,128795,9853,252056,10590,5110,5480
43170,267539,15452,128808,9853,252087,10592,5111,5481
43175,267570,15452,128818,9853,252118,10593,5111,5482
43180,267601,15452,128832,9853,252149,10594,5111,5483
43185,267632,15452,128847,9853,252180,10595,5112,5483
43190,267663,15453,128861,9853,252210,10596,5112,5484
43195,267694,15455,128879,9855,252239,10597,5113,5484
43200,267725,15459,128896,9859,252266,10598,5113,5485
43205,267756,15463,128915,9861,252293,10599,5114,5485
43210,267787,15467,128934,9865,252320,10600,5115,5485
43215,267818,15470,128948,9867,252348,10601,5115,5486
43220,267849,15475,128968,9871,252374,10602,5115,5487
43225,267880,15478,128983,9872,252402,10603,5115,5488
43230,267911,15482,128995,9874,252429,10604,5115,5489
43235,267942,15485,129010,9876,252457,10605,5115,5490
43240,267973,15490,129025,9878,252483,10606,5116,5490
43245,268004,15494,129039,9882,252510,10607,5116,5491
43250,268035,15497,129057,9884,252538,10608,5117,5491
43255,268066,15498,129070,9885,252568,10609,5118,5491
43260,268097,15499,129084,9885,252598,10610,5118,5492
43265,268128,15500,129101,9886,252628,10612,5118,5494
43270,268159,15501,129121,9887,252658,10614,5120,5494
43275,268190,15502,129134,9888,252688,10616,5121,5495
43280,268221,15503,129148,9889,252718,10618,5122,5496
43285,268252,15504,129165,9890,252748,10620,5124,5496
43290,268283,15505,129182,9891,252778,10622,5125,5497
43295,268314,15506,129199,9892,252808,10624,5127,5497
43300,268345,15507,129212,9893,252838,10626,5129,5497
43305,268376,15508,129227,9894,252868,10628,5129,5499
43310,268407,15511,129241,9897,252896,10631,5130,5501
43315,268438,15511,129255,9897,252927,10633,5132,5501
43320,268469,15511,129266,9897,252958,10635,5133,5502
43325,268500,15511,129283,9897,252989,10636,5133,5503
43330,268531,15511,129295,9897,253020,10637,5133,5504
43335,268562,15511,129307,9897,253051,10638,5134,5504
43340,268593,15511,129323,9897,253082,10639,5135,5504
43345,268624,15511,129342,9897,253113,10640,5135,5505
43350,268655,15511,129359,9897,253144,10641,5136,5505
43355,268686,15512,129372,9897,253174,10642,5136,5506
43360,268717,15514,129390,9898,253203,10643,5137,5506
43365,268748,15517,129408,9901,253231,10644,5137,5507
43370,268779,15519,129425,9902,253260,10645,5137,5508
43375,268810,15522,129437,9904,253288,10646,5138,5508
43380,268841,15524,129449,9904,253317,10647,5138,5509
43385,268872,15526,129467,9905,253346,10648,5139,5509
43390,268903,15528,129483,9906,253375,10649,5139,5510
43395,268934,15530,129499,9907,253404,10650,5139,5511
43400,268965,15532,129515,9909,253433,10651,5139,5512
43405,268996,15534,129533,9910,253462,10652,5140,5512
43410,269027,15536,129551,9911,253491,10653,5141,5512
43415,269058,15538,129562,9912,253520,10654,5141,5513
43420,269089,15541,129578,9913,253548,10656,5143,5513
43425,269120,15545,129595,9915,253574,10659,5144,5515
43430,269151,15550,129612,9919,253600,10662,5146,5516
43435,269182,15554,129624,9923,253628,10665,5147,5518
43440,269213,15559,129638,9926,253653,10667,5147,5520
43445,269244,15561,129650,9927,253683,10668,5147,5521
43450,269275,15562,129662,9928,253713,10669,5147,5522
43455,269306,15564,129682,9930,253742,10670,5148,5522
43460,269337,15565,129694,9930,253772,10671,5149,5522
43465,269368,15567,129709,9932,253801,10672,5150,5522
43470,269399,15568,129722,9932,253831,10673,5150,5523
43475,269430,15569,129736,9933,253861,10674,5151,5523
43480,269461,15570,129751,9933,253891,10675,5152,5523
43485,269492,15572,129765,9934,253920,10676,5152,5524
43490,269523,15573,129780,9934,253950,10677,5153,5524
43495,269554,15574,129793,9935,253980,10678,5154,5524
43500,269585,15575,129806,9935,254010,10679,5154,5525
43505,269616,15577,129823,9936,254039,10680,5154,5526
43510,269647,15578,129835,9936,254069,10681,5154,5527
43515,269678,15580,129849,9937,254098,10682,5154,5528
43520,269709,15582,129866,9938,254127,10683,5155,5528
43525,269740,15584,129879,9939,254156,10684,5155,5529
43530,269771,15585,129898,9940,254186,10685,5155,5530
43535,269802,15586,129910,9941,254216,10686,5155,5531
43540,269833,15587,129922,9941,254246,10687,5156,5531
43545,269864,15590,129934,9942,254274,10688,5156,5532
43550,269895,15593,129951,9944,254301,10690,5158,5532
43555,269926,15596,129964,9947,254329,10693,5159,5534
43560,269957,15601,129979,9951,254355,10696,5159,5537
43565,269988,15605,129995,9954,254383,10698,5160,5538
43570,270019,15605,130010,9954,254414,10699,5161,5538
43575,270050,15605,130017,9954,254445,10700,5161,5539
43580,270081,15605,130031,9954,254476,10701,5161,5540
43585,270112,15605,130047,9954,254507,10702,5161,5541
43590,270143,15605,130067,9954,254538,10703,5162,5541
43595,270174,15605,130082,9954,254569,10704,5163,5541
43600,270205,15605,130098,9954,254600,10705,5163,5542
43605,270236,15605,130113,9954,254631,10706,5163,5543
43610,270267,15605,130128,9954,254662,10707,5163,5544
43615,270298,15605,130140,9954,254693,10708,5163,5545
43620,270329,15605,130155,9954,254724,10709,5164,5545
43625,270360,15605,130167,9954,254755,10710,5164,5546
43630,270391,15605,130181,9954,254786,10711,5164,5547
43635,270422,15605,130192,9954,254817,10712,5164,5548
43640,270453,15605,130207,9954,254848,10713,5164,5549
43645,270484,15605,130221,9954,254879,10714,5165,5549
43650,270515,15605,130232,9954,254910,10715,5165,5550
43655,270546,15605,130245,9954,254941,10716,5165,5551
43660,270577,15605,130264,9954,254972,10717,5166,5551
43665,270608,15605,130278,9954,255003,10719,5168,5551
43670,270639,15607,130292,9955,255032,10721,5169,5552
43675,270670,15612,130303,9959,255057,10724,5170,5554
43680,270701,15617,130314,9961,255084,10726,5172,5554
43685,270732,15619,130324,9962,255113,10727,5173,5554
43690,270763,15622,130340,9964,255141,10727,5173,5554
43695,270794,15625,130348,9965,255169,10727,5173,5554
43700,270825,15628,130362,9967,255197,10727,5173,5554
43705,270856,15630,130377,9968,255226,10727,5173,5554
43710,270887,15632,130391,9970,255255,10727,5173,5554
43715,270918,15634,130407,9972,255284,10727,5173,5554
43720,270949,15636,130422,9974,255313,10727,5173,5554
43725,270980,15638,130435,9976,255342,10727,5173,5554
43730,271011,15642,130447,9979,255369,10727,5173,5554
43735,271042,15646,130465,9982,255396,10727,5173,5554
43740,271073,15649,130482,9984,255424,10727,5173,5554
43745,271104,15651,130493,9986,255453,10729,5173,5556
43750,271135,15653,130510,9988,255482,10730,5173,5557
43755,271166,15653,130523,9988,255513,10731,5174,5557
43760,271197,15653,130538,9988,255544,10732,5174,5558
43765,271228,15653,130558,9988,255575,10733,5175,5558
43770,271259,15653,130574,9988,255606,10734,5175,5559
43775,271290,15653,130593,9988,255637,10735,5176,5559
43780,271321,15653,130607,9988,255668,10736,5177,5559
43785,271352,15653,130620,9988,255699,10737,5178,5559
43790,271383,15655,130632,9989,255728,10738,5178,5560
43795,271414,15657,130647,9991,255757,10740,5178,5562
43800,271445,15659,130663,9993,255786,10742,5179,5563
43805,271476,15662,130677,9995,255814,10743,5179,5564
43810,271507,15664,130691,9996,255843,10744,5179,5565
43815,271538,15667,130703,9997,255871,10745,5180,5565
43820,271569,15670,130720,9999,255899,10746,5180,5566
43825,271600,15672,130736,10001,255928,10747,5180,5567
43830,271631,15673,130754,10002,255958,10748,5180,5568
43835,271662,15674,130771,10002,255988,10749,5181,5568
43840,271693,15676,130788,10004,256017,10750,5181,5569
43845,271724,15678,130805,10006,256046,10751,5182,5569
43850,271755,15679,130820,10006,256076,10752,5183,5569
43855,271786,15680,130837,10007,256106,10754,5184,5570
43860,271817,15682,130851,10008,256135,10756,5184,5572
43865,271848,15682,130864,10008,256166,10758,5184,5574
43870,271879,15682,130876,10008,256197,10759,5184,5575
43875,271910,15682,130894,10008,256228,10760,5184,5576
43880,271941,15682,130909,10008,256259,10761,5185,5576
43885,271972,15682,130924,10008,256290,10762,5186,5576
43890,272003,15682,130936,10008,256321,10763,5186,5577
43895,272034,15682,130950,10008,256352,10764,5186,5578
43900,272065,15682,130963,10008,256383,10765,5186,5579
43905,272096,15682,130973,10008,256414,10766,5186,5580
43910,272127,15683,130985,10008,256444,10768,5188,5580
43915,272158,15685,130999,10009,256472,10770,5188,5582
43920,272189,15687,131013,10010,256502,10771,5188,5583
43925,272220,15689,131026,10010,256531,10772,5188,5584
43930,272251,15692,131040,10011,256559,10773,5188,5585
43935,272282,15695,131055,10014,256587,10774,5188,5586
43940,272313,15698,131074,10017,256615,10775,5189,5586
43945,272344,15701,131088,10019,256643,10776,5190,5586
43950,272375,15705,131105,10022,256670,10777,5190,5587
43955,272406,15707,131119,10022,256699,10778,5191,5587
43960,272437,15711,131133,10025,256726,10779,5191,5588
43965,272468,15714,131147,10028,256754,10780,5191,5589
43970,272499,15719,131162,10032,256780,10782,5192,5590
43975,272530,15721,131176,10033,256809,10784,5194,5590
43980,272561,15723,131191,10034,256838,10786,5194,5592
43985,272592,15725,131208,10035,256867,10787,5194,5593
43990,272623,15727,131221,10035,256896,10788,5195,5593
43995,272654,15730,131239,10038,256924,10789,5195,5594
44000,272685,15733,131255,10040,256952,10790,5195,5595
44005,272716,15735,131268,10040,256981,10791,5195,5596
44010,272747,15737,131285,10041,257010,10792,5195,5597
44015,272778,15740,131300,10042,257038,10793,5196,5597
44020,272809,15743,131308,10044,257066,10795,5196,5599
44025,272840,15748,131324,10048,257092,10797,5197,5600
44030,272871,15750,131334,10049,257121,10799,5198,5601
44035,272902,15754,131353,10052,257147,10801,5198,5603
44040,272933,15756,131365,10053,257177,10803,5199,5604
44045,272964,15758,131375,10053,257206,10804,5200,5604
44050,272995,15761,131393,10056,257234,10805,5201,5604
44055,273026,15764,131410,10058,257262,10806,5202,5604
44060,273057,15767,131427,10060,257290,10807,5203,5604
44065,273088,15770,131445,10061,257318,10808,5204,5604
44070,273119,15772,131460,10062,257347,10809,5204,5605
44075,273150,15773,131475,10063,257377,10810,5205,5605
44080,273181,15774,131493,10064,257407,10811,5205,5606
44085,273212,15775,131513,10065,257437,10813,5206,5607
44090,273243,15776,131527,10066,257467,10815,5207,5608
44095,273274,15777,131539,10067,257497,10816,5208,5608
44100,273305,15779,131560,10068,257526,10817,5209,5608
44105,273336,15781,131572,10070,257555,10818,5209,5609
44110,273367,15782,131586,10070,257585,10819,5209,5610
44115,273398,15783,131603,10071,257615,10820,5210,5610
44120,273429,15784,131617,10071,257645,10821,5211,5610
44125,273460,15785,131627,10071,257675,10822,5211,5611
44130,273491,15786,131643,10071,257705,10823,5212,5611
44135,273522,15787,131661,10071,257735,10824,5212,5612
44140,273553,15788,131681,10072,257765,10825,5213,5612
44145,273584,15789,131698,10073,257795,10826,5213,5613
44150,273615,15791,131715,10073,257823,10828,5214,5614
44155,273646,15795,131732,10075,257851,10830,5215,5615
44160,273677,15798,131748,10077,257879,10832,5216,5616
44165,273708,15801,131766,10078,257907,10833,5216,5617
44170,273739,15804,131785,10080,257935,10834,5217,5617
44175,273770,15808,131803,10082,257962,10835,5218,5617
44180,273801,15810,131817,10084,257991,10836,5219,5617
44185,273832,15813,131830,10085,258019,10837,5219,5618
44190,273863,15816,131848,10087,258047,10838,5219,5619
44195,273894,15818,131861,10088,258076,10839,5219,5620
44200,273925,15820,131873,10089,258105,10841,5221,5620
44205,273956,15823,131892,10092,258133,10843,5221,5622
44210,273987,15826,131913,10094,258161,10845,5221,5624
44215,274018,15829,131930,10097,258189,10847,5222,5625
44220,274049,15832,131945,10100,258217,10849,5223,5626
44225,274080,15835,131963,10102,258245,10850,5224,5626
44230,274111,15837,131982,10102,258274,10851,5225,5626
44235,274142,15839,131996,10103,258303,10852,5225,5627
44240,274173,15842,132015,10105,258331,10853,5226,5627
44245,274204,15845,132028,10106,258359,10854,5226,5628
44250,274235,15846,132037,10106,258389,10855,5226,5629
44255,274266,15847,132049,10106,258419,10856,5227,5629
44260,274297,15848,132063,10106,258449,10857,5228,5629
44265,274328,15849,132080,10106,258479,10858,5229,5629
44270,274359,15851,132096,10108,258507,10859,5230,5629
44275,274390,15853,132106,10109,258537,10861,5231,5630
44280,274421,15853,132121,10109,258568,10862,5231,5631
44285,274452,15853,132135,10109,258599,10863,5232,5631
44290,274483,15853,132158,10109,258630,10864,5232,5632
44295,274514,15853,132176,10109,258661,10865,5233,5632
44300,274545,15853,132192,10109,258692,10866,5234,5632
44305,274576,15853,132210,10109,258723,10867,5235,5632
44310,274607,15853,132225,10109,258754,10868,5236,5632
44315,274638,15853,132241,10109,258785,10869,5236,5633
44320,274669,15853,132254,10109,258816,10870,5236,5634
44325,274700,15853,132264,10109,258847,10872,5236,5636
44330,274731,15854,132278,10109,258877,10874,5237,5637
44335,274762,15855,132295,10109,258907,10876,5238,5638
44340,274793,15856,132309,10109,258937,10878,5239,5639
44345,274824,15859,132326,10112,258964,10878,5239,5639
44350,274855,15862,132340,10113,258993,10878,5239,5639
44355,274886,15865,132352,10114,259021,10878,5239,5639
44360,274917,15867,132365,10116,259050,10878,5239,5639
44365,274948,15869,132374,10117,259079,10878,5239,5639
44370,274979,15872,132388,10119,259107,10878,5239,5639
44375,275010,15875,132400,10120,259135,10878,5239,5639
44380,275041,15878,132416,10121,259163,10879,5239,5640
44385,275072,15881,132427,10122,259191,10880,5240,5640
44390,275103,15884,132440,10123,259219,10881,5240,5641
44395,275134,15888,132453,10125,259246,10882,5240,5642
44400,275165,15890,132466,10126,259275,10883,5240,5643
44405,275196,15893,132486,10128,259303,10883,5240,5643
44410,275227,15896,132504,10131,259331,10883,5240,5643
44415,275258,15899,132521,10133,259359,10883,5240,5643
44420,275289,15902,132537,10135,259387,10883,5240,5643
44425,275320,15904,132549,10137,259416,10883,5240,5643
44430,275351,15906,132566,10138,259445,10883,5240,5643
44435,275382,15909,132581,10140,259473,10883,5240,5643
44440,275413,15911,132594,10141,259502,10883,5240,5643
44445,275444,15913,132610,10143,259531,10884,5240,5644
44450,275475,15915,132625,10144,259560,10886,5240,5646
44455,275506,15918,132640,10146,259587,10888,5241,5647
44460,275537,15923,132653,10150,259614,10889,5242,5647
44465,275568,15925,132667,10151,259643,10890,5243,5647
44470,275599,15928,132683,10154,259671,10891,5243,5648
44475,275630,15928,132694,10154,259702,10892,5244,5648
44480,275661,15928,132713,10154,259733,10893,5245,5648
44485,275692,15928,132726,10154,259764,10894,5245,5649
44490,275723,15928,132743,10154,259795,10895,5245,5650
44495,275754,15928,132755,10154,259826,10896,5245,5651
44500,275785,15928,132767,10154,259857,10897,5245,5652
44505,275816,15928,132781,10154,259888,10899,5247,5652
44510,275847,15928,132802,10154,259919,10901,5249,5652
44515,275878,15928,132811,10154,259950,10903,5250,5653
44520,275909,15928,132825,10154,259981,10905,5251,5654
44525,275940,15928,132843,10154,260012,10907,5253,5654
44530,275971,15928,132858,10154,260043,10909,5254,5655
44535,276002,15928,132872,10154,260074,10910,5255,5655
44540,276033,15928,132887,10154,260105,10911,5256,5655
44545,276064,15928,132899,10154,260136,10912,5256,5656
44550,276095,15928,132911,10154,260167,10913,5256,5657
44555,276126,15928,132929,10154,260198,10914,5257,5657
44560,276157,15928,132941,10154,260229,10916,5257,5659
44565,276188,15928,132956,10154,260260,10918,5257,5661
44570,276219,15933,132972,10157,260286,10920,5258,5662
44575,276250,15935,132983,10158,260315,10921,5258,5663
44580,276281,15940,133000,10162,260341,10922,5258,5664
44585,276312,15943,133016,10164,260368,10923,5258,5665
44590,276343,15947,133033,10165,260396,10924,5259,5665
44595,276374,15950,133044,10166,260423,10925,5260,5665
44600,276405,15955,133059,10169,260449,10926,5260,5666
44605,276436,15960,133074,10173,260476,10927,5260,5667
44610,276467,15963,133086,10174,260504,10928,5260,5668
44615,276498,15967,133103,10176,260531,10929,5260,5669
44620,276529,15970,133116,10179,260559,10930,5261,5669
44625,276560,15974,133129,10181,260586,10931,5262,5669
44630,276591,15977,133139,10182,260614,10932,5262,5670
44635,276622,15979,133160,10182,260643,10934,5264,5670
44640,276653,15981,133175,10182,260672,10936,5266,5670
44645,276684,15984,133187,10184,260700,10938,5267,5671
44650,276715,15987,133204,10186,260728,10940,5268,5672
44655,276746,15991,133218,10188,260755,10942,5269,5673
44660,276777,15995,133231,10191,260782,10944,5271,5673
44665,276808,15998,133245,10192,260810,10945,5271,5674
44670,276839,16000,133253,10193,260839,10946,5272,5674
44675,276870,16001,133267,10193,260869,10948,5273,5675
44680,276901,16002,133280,10193,260899,10950,5273,5677
44685,276932,16003,133290,10193,260929,10952,5273,5679
44690,276963,16005,133306,10194,260958,10953,5274,5679
44695,276994,16007,133319,10196,260987,10954,5274,5680
44700,277025,16008,133335,10196,261017,10955,5274,5681
44705,277056,16010,133342,10196,261046,10956,5274,5682
44710,277087,16011,133356,10196,261076,10957,5275,5682
44715,277118,16012,133367,10197,261105,10958,5276,5682
44720,277149,16015,133383,10200,261134,10959,5277,5682
44725,277180,16016,133398,10200,261164,10960,5278,5682
44730,277211,16017,133411,10200,261194,10961,5279,5682
44735,277242,16018,133431,10200,261223,10962,5279,5683
44740,277273,16020,133453,10202,261253,10963,5279,5684
44745,277304,16020,133468,10202,261284,10964,5279,5685
44750,277335,16020,133481,10202,261315,10965,5280,5685
44755,277366,16020,133496,10202,261346,10966,5281,5685
44760,277397,16021,133508,10203,261375,10967,5282,5685
44765,277428,16023,133519,10204,261405,10969,5283,5686
44770,277459,16025,133539,10206,261434,10971,5284,5687
44775,277490,16026,133556,10207,261464,10973,5284,5689
44780,277521,16027,133577,10208,261494,10975,5284,5691
44785,277552,16028,133588,10208,261524,10977,5284,5693
44790,277583,16030,133600,10210,261553,10980,5285,5695
44795,277614,16032,133623,10212,261582,10982,5287,5695
44800,277645,16033,133636,10212,261612,10984,5288,5696
44805,277676,16034,133650,10213,261642,10986,5289,5697
44810,277707,16035,133664,10214,261672,10987,5290,5697
44815,277738,16037,133678,10214,261701,10988,5291,5697
44820,277769,16039,133694,10216,261730,10989,5291,5698
44825,277800,16042,133709,10217,261758,10991,5293,5698
44830,277831,16046,133725,10219,261785,10993,5295,5698
44835,277862,16050,133739,10221,261812,10995,5296,5699
44840,277893,16053,133751,10222,261840,10997,5297,5700
44845,277924,16057,133764,10225,261867,10999,5299,5700
44850,277955,16061,133777,10228,261894,11001,5300,5701
44855,277986,16065,133791,10231,261921,11003,5301,5702
44860,278017,16069,133805,10232,261948,11005,5302,5703
44865,278048,16072,133822,10233,261976,11006,5303,5703
44870,278079,16074,133835,10235,262004,11007,5303,5704
44875,278110,16077,133844,10237,262033,11008,5303,5705
44880,278141,16079,133862,10239,262061,11009,5304,5705
44885,278172,16081,133874,10241,262091,11010,5304,5706
44890,278203,16082,133888,10242,262121,11011,5304,5707
44895,278234,16083,133904,10242,262151,11012,5305,5707
44900,278265,16085,133921,10243,262180,11013,5306,5707
44905,278296,16087,133943,10245,262209,11014,5307,5707
44910,278327,16088,133962,10246,262239,11016,5307,5709
44915,278358,16090,133973,10247,262268,11018,5307,5711
44920,278389,16092,133986,10248,262297,11020,5307,5713
44925,278420,16093,133995,10248,262327,11021,5308,5713
44930,278451,16094,134009,10249,262357,11022,5308,5714
44935,278482,16096,134023,10251,262386,11023,5308,5715
44940,278513,16097,134035,10252,262416,11024,5308,5716
44945,278544,16097,134048,10252,262447,11025,5309,5716
44950,278575,16097,134063,10252,262478,11026,5310,5716
44955,278606,16097,134081,10252,262509,11027,5310,5717
44960,278637,16097,134096,10252,262540,11028,5311,5717
44965,278668,16098,134111,10253,262570,11029,5311,5718
44970,278699,16099,134127,10253,262600,11031,5312,5719
44975,278730,16100,134140,10253,262630,11033,5314,5719
44980,278761,16101,134156,10254,262660,11035,5316,5719
44985,278792,16102,134171,10255,262690,11037,5317,5720
44990,278823,16103,134187,10256,262720,11039,5319,5720
44995,278854,16104,134205,10257,262750,11041,5320,5721
45000,278885,16105,134222,10257,262780,11043,5322,5721
45005,278916,16107,134233,10258,262809,11046,5323,5723
45010,278947,16110,134246,10260,262837,11049,5323,5726
45015,278978,16113,134265,10262,262865,11051,5325,5726
45020,279009,16117,134282,10265,262892,11053,5325,5728
45025,279040,16120,134292,10267,262920,11055,5325,5730
45030,279071,16121,134307,10268,262950,11057,5327,5730
45035,279102,16123,134319,10269,262979,11058,5327,5731
45040,279133,16124,134335,10270,263009,11059,5327,5732
45045,279164,16126,134348,10270,263038,11060,5328,5732
45050,279195,16128,134369,10270,263067,11061,5329,5732
45055,279226,16130,134385,10271,263096,11062,5330,5732
45060,279257,16132,134399,10272,263125,11063,5331,5732
45065,279288,16136,134417,10275,263152,11065,5332,5733
45070,279319,16139,134430,10276,263180,11067,5333,5734
45075,279350,16142,134445,10277,263208,11069,5333,5736
45080,279381,16145,134458,10280,263236,11071,5333,5738
45085,279412,16148,134471,10282,263264,11073,5333,5740
45090,279443,16152,134482,10284,263291,11075,5333,5742
45095,279474,16153,134497,10284,263321,11076,5334,5742
45100,279505,16154,134516,10285,263351,11077,5334,5743
45105,279536,16155,134527,10286,263381,11078,5334,5744
45110,279567,16156,134540,10287,263410,11079,5334,5745
45115,279598,16158,134553,10289,263440,11081,5334,5747
45120,279629,16159,134563,10289,263470,11083,5334,5749
45125,279660,16159,134580,10289,263501,11084,5335,5749
45130,279691,16159,134595,10289,263532,11085,5335,5750
45135,279722,16159,134607,10289,263563,11086,5336,5750
45140,279753,16159,134622,10289,263594,11087,5337,5750
45145,279784,16159,134634,10289,263625,11088,5338,5750
45150,279815,16159,134648,10289,263656,11089,5339,5750
45155,279846,16159,134660,10289,263687,11090,5339,5751
45160,279877,16159,134678,10289,263718,11091,5339,5752
45165,279908,16159,134695,10289,263749,11092,5339,5753
45170,279939,16160,134713,10289,263779,11093,5340,5753
45175,279970,16161,134725,10290,263809,11094,5341,5753
45180,280001,16162,134736,10290,263839,11095,5341,5754
45185,280032,16163,134746,10291,263869,11095,5341,5754
45190,280063,16164,134762,10291,263899,11095,5341,5754
45195,280094,16166,134778,10292,263928,11095,5341,5754
45200,280125,16169,134793,10295,263956,11095,5341,5754
45205,280156,16172,134810,10297,263984,11095,5341,5754
45210,280187,16175,134828,10299,264012,11095,5341,5754
45215,280218,16178,134843,10301,264040,11095,5341,5754
45220,280249,16181,134854,10303,264068,11095,5341,5754
45225,280280,16184,134868,10306,264096,11096,5341,5755
45230,280311,16186,134883,10307,264124,11098,5343,5755
45235,280342,16190,134896,10309,264152,11099,5343,5756
45240,280373,16194,134907,10312,264178,11100,5344,5756
45245,280404,16196,134925,10313,264208,11101,5344,5757
45250,280435,16197,134939,10313,264238,11102,5344,5758
45255,280466,16198,134955,10313,264268,11103,5345,5758
45260,280497,16199,134971,10313,264298,11104,5346,5758
45265,280528,16200,134988,10314,264328,11105,5346,5759
45270,280559,16201,135002,10315,264358,11106,5347,5759
45275,280590,16202,135016,10316,264388,11107,5347,5760
45280,280621,16203,135031,10317,264418,11108,5348,5760
45285,280652,16204,135046,10317,264448,11109,5348,5761
45290,280683,16205,135062,10318,264478,11110,5349,5761
45295,280714,16206,135078,10319,264508,11111,5349,5762
45300,280745,16207,135090,10319,264538,11112,5349,5763
45305,280776,16210,135106,10321,264566,11113,5350,5763
45310,280807,16213,135120,10323,264594,11114,5350,5764
45315,280838,16216,135129,10326,264622,11115,5350,5765
45320,280869,16219,135144,10327,264650,11116,5350,5766
45325,280900,16223,135157,10328,264677,11117,5350,5767
45330,280931,16227,135176,10331,264704,11118,5350,5768
45335,280962,16230,135194,10333,264732,11119,5350,5769
45340,280993,16234,135210,10336,264759,11120,5350,5770
45345,281024,16236,135225,10337,264788,11122,5351,5771
45350,281055,16240,135237,10340,264815,11125,5352,5773
45355,281086,16243,135252,10341,264843,11127,5353,5774
45360,281117,16246,135272,10344,264871,11128,5354,5774
45365,281148,16248,135291,10346,264900,11129,5354,5775
45370,281179,16248,135304,10346,264931,11130,5354,5776
45375,281210,16248,135319,10346,264962,11131,5354,5777
45380,281241,16248,135337,10346,264993,11132,5355,5777
45385,281272,16248,135352,10346,265024,11133,5356,5777
45390,281303,16248,135365,10346,265055,11134,5356,5778
45395,281334,16248,135380,10346,265086,11135,5357,5778
45400,281365,16248,135396,10346,265117,11136,5358,5778
45405,281396,16248,135414,10346,265148,11137,5359,5778
45410,281427,16248,135426,10346,265179,11138,5359,5779
45415,281458,16248,135435,10346,265210,11139,5359,5780
45420,281489,16248,135454,10346,265241,11140,5359,5781
45425,281520,16248,135470,10346,265272,11141,5359,5782
45430,281551,16248,135482,10346,265303,11142,5359,5783
45435,281582,16248,135495,10346,265334,11143,5359,5784
45440,281613,16248,135512,10346,265365,11144,5359,5785
45445,281644,16250,135530,10347,265394,11145,5360,5785
45450,281675,16252,135550,10348,265423,11146,5361,5785
45455,281706,16253,135564,10349,265453,11148,5361,5787
45460,281737,16254,135581,10349,265483,11150,5362,5788
45465,281768,16257,135597,10350,265511,11152,5363,5789
45470,281799,16261,135609,10354,265537,11154,5363,5791
45475,281830,16266,135628,10357,265564,11156,5364,5792
45480,281861,16271,135642,10361,265589,11158,5365,5793
45485,281892,16274,135657,10363,265618,11159,5366,5793
45490,281923,16279,135674,10366,265644,11160,5367,5793
45495,281954,16282,135690,10368,265672,11161,5367,5794
45500,281985,16285,135703,10370,265700,11162,5368,5794
45505,282016,16290,135715,10374,265726,11163,5369,5794
45510,282047,16294,135733,10377,265753,11164,5370,5794
45515,282078,16297,135744,10380,265781,11165,5370,5795
45520,282109,16300,135759,10381,265809,11166,5370,5796
45525,282140,16304,135772,10383,265836,11167,5370,5797
45530,282171,16308,135789,10386,265863,11168,5371,5797
45535,282202,16311,135804,10388,265891,11170,5373,5797
45540,282233,16314,135823,10391,265919,11172,5375,5797
45545,282264,16317,135839,10393,265947,11173,5376,5797
45550,282295,16318,135856,10394,265977,11174,5377,5797
45555,282326,16318,135866,10394,266008,11175,5378,5797
45560,282357,16318,135884,10394,266039,11176,5378,5798
45565,282388,16318,135901,10394,266070,11177,5378,5799
45570,282419,16318,135913,10394,266101,11178,5379,5799
45575,282450,16318,135929,10394,266132,11179,5379,5800
45580,282481,16318,135945,10394,266163,11180,5379,5801
45585,282512,16318,135958,10394,266194,11182,5379,5803
45590,282543,16318,135974,10394,266225,11184,5380,5804
45595,282574,16318,135995,10394,266256,11186,5382,5804
45600,282605,16318,136010,10394,266287,11187,5383,5804
45605,282636,16318,136028,10394,266318,11188,5383,5805
45610,282667,16318,136042,10394,266349,11189,5383,5806
45615,282698,16318,136059,10394,266380,11190,5384,5806
45620,282729,16318,136076,10394,266411,11191,5384,5807
45625,282760,16318,136092,10394,266442,11192,5384,5808
45630,282791,16318,136107,10394,266473,11193,5385,5808
45635,282822,16318,136121,10394,266504,11194,5385,5809
45640,282853,16318,136132,10394,266535,11195,5386,5809
45645,282884,16318,136144,10394,266566,11196,5386,5810
45650,282915,16321,136158,10396,266594,11197,5386,5811
45655,282946,16325,136174,10400,266621,11198,5386,5812
45660,282977,16328,136190,10401,266649,11199,5387,5812
45665,283008,16332,136204,10404,266676,11199,5387,5812
45670,283039,16336,136219,10408,266703,11199,5387,5812
45675,283070,16340,136234,10411,266730,11199,5387,5812
45680,283101,16343,136254,10414,266758,11199,5387,5812
45685,283132,16346,136266,10416,266786,11199,5387,5812
45690,283163,16350,136282,10419,266813,11199,5387,5812
45695,283194,16354,136295,10422,266840,11199,5387,5812
45700,283225,16358,136305,10424,266867,11199,5387,5812
45705,283256,16363,136320,10426,266892,11200,5388,5812
45710,283287,16367,136336,10429,266919,11201,5388,5813
45715,283318,16371,136352,10432,266947,11202,5388,5814
45720,283349,16374,136363,10435,266975,11203,5388,5815
45725,283380,16379,136382,10440,267001,11203,5388,5815
45730,283411,16381,136399,10441,267030,11203,5388,5815
45735,283442,16382,136413,10442,267060,11203,5388,5815
45740,283473,16383,136428,10442,267090,11203,5388,5815
45745,283504,16384,136440,10442,267120,11203,5388,5815
45750,283535,16385,136455,10443,267150,11203,5388,5815
45755,283566,16386,136463,10443,267180,11203,5388,5815
45760,283597,16387,136480,10443,267210,11203,5388,5815
45765,283628,16387,136495,10443,267241,11204,5388,5816
45770,283659,16387,136506,10443,267272,11205,5389,5816
45775,283690,16387,136520,10443,267303,11206,5389,5817
45780,283721,16387,136541,10443,267334,11207,5389,5818
45785,283752,16387,136552,10443,267365,11208,5390,5818
45790,283783,16387,136567,10443,267396,11209,5390,5819
45795,283814,16387,136584,10443,267427,11210,5390,5820
45800,283845,16387,136596,10443,267458,11211,5391,5820
45805,283876,16387,136610,10443,267489,11212,5392,5820
45810,283907,16388,136626,10443,267519,11213,5393,5820
45815,283938,16390,136642,10444,267548,11214,5394,5820
45820,283969,16392,136661,10446,267577,11215,5394,5821
45825,284000,16394,136672,10447,267606,11216,5395,5821
45830,284031,16396,136686,10448,267634,11218,5397,5821
45835,284062,16401,136699,10453,267661,11220,5397,5823
45840,284093,16403,136709,10453,267690,11222,5399,5823
45845,284124,16408,136724,10456,267716,11223,5399,5824
45850,284155,16411,136735,10458,267744,11224,5399,5825
45855,284186,16413,136751,10459,267773,11225,5400,5825
45860,284217,16415,136767,10461,267802,11226,5400,5826
45865,284248,16417,136780,10462,267831,11227,5400,5827
45870,284279,16419,136795,10464,267860,11228,5401,5827
45875,284310,16423,136814,10467,267887,11229,5402,5827
45880,284341,16425,136829,10468,267916,11230,5403,5827
45885,284372,16427,136843,10470,267945,11231,5404,5827
45890,284403,16430,136860,10472,267973,11232,5405,5827
45895,284434,16432,136876,10474,268002,11233,5405,5828
45900,284465,16433,136887,10474,268032,11234,5406,5828
45905,284496,16434,136903,10474,268062,11236,5407,5829
45910,284527,16435,136921,10474,268092,11237,5407,5830
45915,284558,16436,136937,10475,268122,11238,5407,5831
45920,284589,16437,136946,10475,268152,11239,5408,5831
45925,284620,16438,136967,10476,268182,11240,5409,5831
45930,284651,16439,136985,10477,268212,11241,5410,5831
45935,284682,16440,137000,10478,268242,11242,5410,5832
45940,284713,16441,137017,10479,268272,11243,5410,5833
45945,284744,16442,137036,10480,268302,11245,5410,5835
45950,284775,16443,137049,10480,268332,11247,5411,5836
45955,284806,16445,137063,10480,268361,11249,5411,5838
45960,284837,16448,137080,10482,268389,11251,5413,5838
45965,284868,16449,137094,10483,268419,11252,5414,5838
45970,284899,16451,137113,10484,268448,11253,5415,5838
45975,284930,16452,137128,10484,268478,11254,5416,5838
45980,284961,16454,137139,10485,268507,11255,5417,5838
45985,284992,16455,137150,10485,268537,11256,5418,5838
45990,285023,16456,137164,10486,268567,11257,5418,5839
45995,285054,16458,137175,10487,268596,11258,5418,5840
46000,285085,16461,137189,10489,268624,11259,5419,5840
46005,285116,16465,137201,10492,268651,11260,5419,5841
46010,285147,16468,137213,10494,268679,11261,5419,5842
46015,285178,16470,137225,10495,268708,11263,5420,5843
46020,285209,16474,137241,10499,268735,11265,5420,5845
46025,285240,16476,137258,10500,268764,11266,5421,5845
46030,285271,16477,137268,10500,268794,11267,5422,5845
46035,285302,16479,137285,10502,268823,11268,5422,5846
46040,285333,16482,137300,10504,268851,11269,5423,5846
46045,285364,16484,137311,10506,268880,11270,5423,5847
46050,285395,16487,137328,10509,268908,11271,5423,5848
46055,285426,16487,137345,10509,268939,11272,5424,5848
46060,285457,16487,137365,10509,268970,11273,5425,5848
46065,285488,16488,137379,10509,269000,11274,5425,5849
46070,285519,16489,137387,10509,269030,11276,5425,5851
46075,285550,16490,137404,10509,269060,11278,5425,5853
46080,285581,16491,137418,10510,269089,11280,5425,5855
46085,285612,16494,137434,10513,269118,11282,5427,5855
46090,285643,16496,137449,10515,269146,11284,5428,5856
46095,285674,16499,137463,10517,269174,11285,5429,5856
46100,285705,16502,137471,10519,269203,11286,5429,5857
46105,285736,16504,137483,10520,269231,11287,5429,5858
46110,285767,16507,137493,10521,269259,11288,5429,5859
46115,285798,16511,137510,10524,269287,11289,5430,5859
46120,285829,16514,137530,10527,269315,11290,5431,5859
46125,285860,16517,137545,10530,269343,11291,5431,5860
46130,285891,16519,137561,10531,269372,11292,5431,5861
46135,285922,16520,137576,10532,269402,11293,5432,5861
46140,285953,16522,137593,10533,269431,11294,5433,5861
46145,285984,16523,137608,10533,269461,11295,5433,5862
46150,286015,16524,137629,10534,269491,11296,5434,5862
46155,286046,16525,137644,10535,269521,11297,5434,5863
46160,286077,16526,137661,10536,269551,11298,5435,5863
46165,286108,16526,137676,10536,269582,11299,5436,5863
46170,286139,16526,137692,10536,269613,11300,5437,5863
46175,286170,16526,137706,10536,269644,11301,5438,5863
46180,286201,16526,137720,10536,269675,11302,5438,5864
46185,286232,16526,137733,10536,269706,11303,5439,5864
46190,286263,16528,137750,10538,269735,11304,5440,5864
46195,286294,16530,137762,10539,269764,11306,5440,5866
46200,286325,16532,137771,10540,269793,11308,5440,5868
46205,286356,16536,137791,10544,269820,11309,5441,5868
46210,286387,16540,137811,10547,269847,11310,5442,5868
46215,286418,16543,137825,10550,269875,11311,5442,5869
46220,286449,16549,137840,10555,269900,11312,5442,5870
46225,286480,16550,137851,10556,269930,11313,5443,5870
46230,286511,16551,137864,10556,269960,11314,5444,5870
46235,286542,16552,137879,10557,269990,11314,5444,5870
46240,286573,16553,137900,10558,270020,11314,5444,5870
46245,286604,16554,137917,10559,270050,11314,5444,5870
46250,286635,16555,137931,10559,270080,11314,5444,5870
46255,286666,16556,137948,10560,270110,11314,5444,5870
46260,286697,16557,137968,10560,270140,11314,5444,5870
46265,286728,16560,137986,10561,270168,11315,5445,5870
46270,286759,16562,138001,10561,270197,11316,5445,5871
46275,286790,16564,138020,10563,270226,11317,5446,5871
46280,286821,16566,138038,10565,270255,11318,5447,5871
46285,286852,16568,138053,10567,270284,11319,5448,5871
46290,286883,16570,138064,10567,270313,11320,5448,5872
46295,286914,16572,138084,10568,270342,11321,5449,5872
46300,286945,16575,138101,10570,270369,11322,5450,5872
46305,286976,16579,138118,10573,270396,11323,5450,5873
46310,287007,16582,138133,10574,270425,11324,5451,5873
46315,287038,16583,138149,10575,270455,11325,5451,5874
46320,287069,16584,138164,10576,270485,11326,5451,5875
46325,287100,16585,138178,10577,270515,11327,5452,5875
46330,287131,16586,138198,10577,270545,11328,5453,5875
46335,287162,16587,138210,10577,270575,11329,5453,5876
46340,287193,16589,138224,10579,270604,11331,5454,5877
46345,287224,16590,138244,10580,270634,11333,5456,5877
46350,287255,16591,138261,10581,270664,11335,5457,5878
46355,287286,16592,138279,10582,270694,11337,5458,5879
46360,287317,16593,138292,10582,270724,11339,5459,5880
46365,287348,16594,138306,10583,270754,11341,5460,5881
46370,287379,16596,138316,10583,270783,11343,5460,5883
46375,287410,16598,138327,10584,270812,11345,5460,5885
46380,287441,16600,138339,10584,270841,11346,5460,5886
46385,287472,16604,138355,10587,270868,11347,5461,5886
46390,287503,16608,138372,10591,270895,11348,5461,5887
46395,287534,16611,138388,10593,270923,11349,5461,5888
46400,287565,16612,138402,10593,270953,11350,5462,5888
46405,287596,16614,138415,10595,270982,11351,5463,5888
46410,287627,16616,138430,10597,271011,11352,5463,5889
46415,287658,16617,138442,10598,271041,11353,5463,5890
46420,287689,16618,138461,10599,271071,11354,5464,5890
46425,287720,16619,138476,10599,271101,11355,5464,5891
46430,287751,16620,138490,10599,271131,11356,5464,5892
46435,287782,16621,138507,10600,271161,11357,5464,5893
46440,287813,16622,138520,10600,271191,11358,5465,5893
46445,287844,16626,138537,10603,271217,11360,5466,5894
46450,287875,16630,138550,10605,271245,11362,5467,5895
46455,287906,16633,138562,10608,271272,11364,5468,5896
46460,287937,16637,138578,10612,271299,11365,5468,5897
46465,287968,16640,138591,10614,271328,11366,5468,5898
46470,287999,16642,138605,10615,271357,11367,5468,5899
46475,288030,16644,138617,10616,271386,11368,5468,5900
46480,288061,16646,138632,10618,271415,11369,5469,5900
46485,288092,16648,138642,10618,271444,11370,5470,5900
46490,288123,16650,138659,10619,271473,11371,5470,5901
46495,288154,16653,138673,10621,271501,11372,5470,5902
46500,288185,16655,138685,10622,271530,11373,5470,5903
46505,288216,16655,138695,10622,271561,11374,5470,5904
46510,288247,16655,138711,10622,271592,11375,5471,5904
46515,288278,16655,138724,10622,271623,11376,5472,5904
46520,288309,16655,138743,10622,271654,11376,5472,5904
46525,288340,16655,138760,10622,271685,11376,5472,5904
46530,288371,16655,138773,10622,271716,11376,5472,5904
46535,288402,16655,138786,10622,271747,11376,5472,5904
46540,288433,16655,138801,10622,271778,11376,5472,5904
46545,288464,16655,138819,10622,271809,11376,5472,5904
46550,288495,16655,138831,10622,271840,11376,5472,5904
46555,288526,16655,138844,10622,271871,11376,5472,5904
46560,288557,16655,138856,10622,271902,11376,5472,5904
46565,288588,16657,138870,10623,271931,11378,5473,5905
46570,288619,16659,138881,10623,271960,11380,5474,5906
46575,288650,16661,138893,10624,271989,11382,5475,5907
46580,288681,16665,138909,10628,272016,11384,5476,5908
46585,288712,16668,138924,10631,272044,11386,5478,5908
46590,288743,16670,138943,10632,272073,11388,5479,5909
46595,288774,16672,138958,10633,272102,11390,5480,5910
46600,288805,16674,138971,10635,272131,11392,5480,5912
46605,288836,16678,138986,10639,272158,11394,5480,5914
46610,288867,16681,138997,10640,272186,11396,5480,5916
46615,288898,16684,139012,10642,272214,11398,5482,5916
46620,288929,16688,139026,10645,272241,11400,5483,5917
46625,288960,16690,139042,10646,272270,11401,5484,5917
46630,288991,16692,139057,10647,272299,11402,5485,5917
46635,289022,16694,139081,10648,272328,11403,5486,5917
46640,289053,16697,139096,10650,272356,11404,5487,5917
46645,289084,16700,139110,10652,272384,11405,5487,5918
46650,289115,16702,139126,10652,272413,11406,5488,5918
46655,289146,16704,139142,10653,272442,11407,5489,5918
46660,289177,16707,139157,10655,272470,11408,5490,5918
46665,289208,16710,139176,10657,272498,11409,5490,5919
46670,289239,16715,139193,10660,272524,11410,5491,5919
46675,289270,16719,139208,10663,272551,11411,5491,5920
46680,289301,16720,139223,10664,272581,11412,5491,5921
46685,289332,16724,139241,10667,272608,11413,5492,5921
46690,289363,16728,139260,10670,272635,11414,5492,5922
46695,289394,16729,139281,10671,272665,11415,5493,5922
46700,289425,16730,139295,10672,272695,11416,5493,5923
46705,289456,16732,139309,10673,272724,11417,5494,5923
46710,289487,16732,139323,10673,272755,11418,5494,5924
46715,289518,16732,139338,10673,272786,11419,5495,5924
46720,289549,16732,139348,10673,272817,11420,5496,5924
46725,289580,16732,139362,10673,272848,11421,5497,5924
46730,289611,16732,139380,10673,272879,11422,5498,5924
46735,289642,16732,139392,10673,272910,11424,5498,5926
46740,289673,16732,139408,10673,272941,11425,5498,5927
46745,289704,16732,139423,10673,272972,11427,5499,5928
46750,289735,16732,139438,10673,273003,11428,5499,5929
46755,289766,16732,139453,10673,273034,11429,5500,5929
46760,289797,16732,139464,10673,273065,11430,5500,5930
46765,289828,16732,139479,10673,273096,11431,5501,5930
46770,289859,16732,139497,10673,273127,11432,5501,5931
46775,289890,16732,139513,10673,273158,11433,5501,5932
46780,289921,16732,139526,10673,273189,11434,5501,5933
46785,289952,16733,139542,10674,273219,11435,5501,5934
46790,289983,16734,139556,10675,273249,11436,5502,5934
46795,290014,16735,139568,10675,273279,11437,5502,5935
46800,290045,16737,139585,10675,273308,11438,5502,5936
46805,290076,16741,139598,10676,273335,11440,5503,5937
46810,290107,16745,139618,10680,273362,11442,5504,5938
46815,290138,16749,139629,10683,273389,11442,5504,5938
46820,290169,16753,139650,10686,273416,11442,5504,5938
46825,290200,16757,139671,10690,273443,11442,5504,5938
46830,290231,16760,139687,10691,273471,11442,5504,5938
46835,290262,16764,139699,10693,273498,11442,5504,5938
46840,290293,16768,139714,10695,273525,11442,5504,5938
46845,290324,16775,139731,10701,273549,11442,5504,5938
46850,290355,16779,139748,10704,273576,11442,5504,5938
46855,290386,16782,139763,10705,273604,11442,5504,5938
46860,290417,16787,139781,10709,273630,11442,5504,5938
46865,290448,16789,139795,10710,273659,11444,5506,5938
46870,290479,16791,139804,10712,273688,11445,5506,5939
46875,290510,16794,139825,10714,273716,11446,5507,5939
46880,290541,16796,139841,10715,273745,11447,5508,5939
46885,290572,16797,139856,10715,273775,11448,5509,5939
46890,290603,16798,139875,10716,273805,11449,5509,5940
46895,290634,16799,139894,10716,273835,11450,5510,5940
46900,290665,16800,139907,10716,273865,11451,5511,5940
46905,290696,16801,139918,10717,273895,11452,5511,5941
46910,290727,16801,139932,10717,273926,11453,5511,5942
46915,290758,16801,139948,10717,273957,11454,5512,5942
46920,290789,16801,139963,10717,273988,11455,5513,5942
46925,290820,16801,139978,10717,274019,11456,5514,5942
46930,290851,16801,139995,10717,274050,11457,5514,5943
46935,290882,16801,140009,10717,274081,11458,5514,5944
46940,290913,16801,140026,10717,274112,11459,5515,5944
46945,290944,16801,140042,10717,274143,11460,5515,5945
46950,290975,16801,140055,10717,274174,11461,5515,5946
46955,291006,16801,140068,10717,274205,11462,5516,5946
46960,291037,16801,140087,10717,274236,11463,5517,5946
46965,291068,16801,140106,10717,274267,11464,5518,5946
46970,291099,16803,140118,10718,274296,11466,5519,5947
46975,291130,16805,140130,10719,274325,11468,5519,5949
46980,291161,16809,140147,10722,274352,11470,5520,5950
46985,291192,16811,140161,10722,274381,11472,5521,5951
46990,291223,16814,140177,10725,274409,11474,5523,5951
46995,291254,16816,140190,10726,274438,11476,5525,5951
47000,291285,16817,140200,10726,274468,11477,5525,5952
47005,291316,16818,140216,10726,274498,11478,5525,5953
47010,291347,16819,140231,10727,274528,11479,5525,5954
47015,291378,16820,140249,10728,274558,11480,5526,5954
47020,291409,16821,140264,10728,274588,11481,5527,5954
47025,291440,16823,140276,10728,274617,11482,5527,5955
47030,291471,16826,140290,10730,274645,11483,5528,5955
47035,291502,16829,140309,10732,274673,11484,5529,5955
47040,291533,16832,140322,10733,274701,11485,5529,5956
47045,291564,16836,140342,10737,274728,11486,5530,5956
47050,291595,16841,140358,10740,274754,11487,5531,5956
47055,291626,16845,140373,10742,274781,11488,5531,5957
47060,291657,16850,140387,10745,274807,11489,5531,5958
47065,291688,16853,140402,10748,274835,11490,5532,5958
47070,291719,16856,140414,10749,274863,11491,5533,5958
47075,291750,16859,140431,10751,274891,11492,5533,5959
47080,291781,16861,140438,10751,274920,11493,5533,5960
47085,291812,16862,140452,10751,274949,11494,5534,5960
47090,291843,16864,140465,10753,274978,11496,5534,5962
47095,291874,16866,140479,10754,275008,11498,5536,5962
47100,291905,16866,140493,10754,275039,11499,5536,5963
47105,291936,16866,140508,10754,275070,11501,5537,5964
47110,291967,16866,140519,10754,275101,11502,5537,5965
47115,291998,16866,140531,10754,275132,11503,5537,5966
47120,292029,16866,140546,10754,275163,11504,5537,5967
47125,292060,16866,140563,10754,275194,11505,5538,5967
47130,292091,16866,140580,10754,275225,11506,5538,5968
47135,292122,16866,140600,10754,275256,11507,5538,5969
47140,292153,16866,140613,10754,275287,11508,5538,5970
47145,292184,16866,140627,10754,275318,11509,5538,5971
47150,292215,16866,140638,10754,275349,11510,5539,5971
47155,292246,16866,140651,10754,275380,11511,5539,5972
47160,292277,16867,140664,10754,275410,11512,5540,5972
47165,292308,16869,140677,10756,275439,11512,5540,5972
47170,292339,16871,140687,10756,275468,11512,5540,5972
47175,292370,16873,140701,10757,275497,11512,5540,5972
47180,292401,16875,140718,10757,275526,11512,5540,5972
47185,292432,16877,140736,10758,275555,11512,5540,5972
47190,292463,16880,140749,10760,275583,11512,5540,5972
47195,292494,16884,140766,10763,275610,11512,5540,5972
47200,292525,16887,140781,10765,275638,11513,5540,5973
47205,292556,16890,140798,10768,275666,11514,5540,5974
47210,292587,16893,140812,10769,275694,11515,5541,5974
47215,292618,16896,140821,10770,275722,11515,5541,5974
47220,292649,16901,140835,10772,275747,11515,5541,5974
47225,292680,16904,140848,10773,275776,11516,5541,5975
47230,292711,16907,140869,10775,275804,11517,5542,5975
47235,292742,16909,140879,10775,275833,11519,5543,5976
47240,292773,16912,140894,10777,275861,11521,5544,5977
47245,292804,16915,140908,10779,275889,11523,5544,5979
47250,292835,16916,140921,10779,275919,11525,5544,5981
47255,292866,16917,140939,10780,275949,11527,5545,5982
47260,292897,16918,140955,10781,275979,11528,5545,5983
47265,292928,16919,140967,10782,276009,11530,5546,5984
47270,292959,16921,140982,10783,276038,11532,5548,5984
47275,292990,16922,140999,10784,276068,11534,5549,5985
47280,293021,16924,141018,10785,276097,11535,5549,5986
47285,293052,16927,141031,10786,276125,11536,5549,5987
47290,293083,16929,141041,10787,276154,11537,5550,5987
47295,293114,16932,141059,10789,276182,11538,5550,5988
47300,293145,16935,141070,10791,276210,11539,5550,5989
47305,293176,16938,141081,10792,276238,11540,5550,5990
47310,293207,16940,141097,10793,276267,11541,5550,5991
47315,293238,16942,141109,10793,276296,11543,5550,5993
47320,293269,16944,141117,10794,276325,11545,5550,5995
47325,293300,16947,141134,10797,276353,11547,5551,5996
47330,293331,16949,141153,10798,276382,11549,5552,5997
47335,293362,16950,141167,10799,276412,11551,5552,5999
47340,293393,16951,141176,10799,276442,11552,5552,6000
47345,293424,16951,141191,10799,276473,11553,5552,6001
47350,293455,16951,141205,10799,276504,11554,5552,6002
47355,293486,16952,141222,10800,276534,11555,5552,6003
47360,293517,16953,141235,10800,276564,11556,5552,6004
47365,293548,16954,141250,10801,276594,11557,5553,6004
47370,293579,16955,141265,10802,276624,11558,5554,6004
47375,293610,16956,141280,10803,276654,11559,5554,6005
47380,293641,16958,141295,10804,276683,11560,5554,6006
47385,293672,16961,141315,10807,276711,11561,5555,6006
47390,293703,16963,141333,10808,276740,11562,5555,6007
47395,293734,16965,141347,10809,276769,11563,5555,6008
47400,293765,16966,141360,10810,276799,11564,5555,6009
47405,293796,16968,141377,10811,276828,11565,5556,6009
47410,293827,16970,141394,10812,276857,11566,5556,6010
47415,293858,16972,141404,10812,276886,11567,5556,6011
47420,293889,16975,141418,10814,276914,11568,5557,6011
47425,293920,16977,141428,10816,276943,11569,5558,6011
47430,293951,16979,141443,10817,276972,11570,5559,6011
47435,293982,16982,141460,10818,277000,11571,5560,6011
47440,294013,16986,141475,10820,277027,11573,5561,6012
47445,294044,16991,141489,10823,277052,11575,5562,6013
47450,294075,16996,141505,10826,277079,11577,5563,6014
47455,294106,16999,141525,10828,277107,11579,5565,6014
47460,294137,17002,141534,10828,277135,11581,5566,6015
47465,294168,17004,141548,10830,277164,11582,5566,6016
47470,294199,17006,141568,10832,277193,11583,5567,6016
47475,294230,17007,141584,10833,277223,11584,5568,6016
47480,294261,17007,141596,10833,277254,11585,5568,6017
47485,294292,17007,141612,10833,277285,11586,5569,6017
47490,294323,17007,141631,10833,277316,11587,5570,6017
47495,294354,17007,141648,10833,277347,11588,5570,6018
47500,294385,17007,141663,10833,277378,11589,5571,6018
47505,294416,17007,141678,10833,277409,11590,5572,6018
47510,294447,17007,141689,10833,277440,11591,5572,6019
47515,294478,17007,141705,10833,277471,11592,5572,6020
47520,294509,17007,141723,10833,277502,11593,5572,6021
47525,294540,17007,141743,10833,277533,11595,5573,6022
47530,294571,17007,141759,10833,277564,11597,5574,6023
47535,294602,17007,141771,10833,277595,11599,5576,6023
47540,294633,17007,141786,10833,277626,11601,5576,6025
47545,294664,17007,141801,10833,277657,11602,5576,6026
47550,294695,17007,141813,10833,277688,11603,5577,6026
47555,294726,17007,141826,10833,277719,11604,5577,6027
47560,294757,17007,141839,10833,277750,11605,5578,6027
47565,294788,17007,141851,10833,277781,11606,5578,6028
47570,294819,17009,141866,10835,277810,11607,5578,6029
47575,294850,17012,141877,10837,277838,11608,5578,6030
47580,294881,17016,141891,10840,277865,11609,5579,6030
47585,294912,17020,141907,10843,277892,11610,5580,6030
47590,294943,17025,141925,10848,277918,11611,5581,6030
47595,294974,17030,141939,10851,277944,11612,5582,6030
47600,295005,17034,141958,10855,277971,11613,5583,6030
47605,295036,17036,141974,10857,278000,11614,5584,6030
47610,295067,17040,141994,10861,278027,11615,5585,6030
47615,295098,17043,142008,10863,278055,11616,5585,6031
47620,295129,17046,142023,10866,278083,11617,5586,6031
47625,295160,17050,142042,10870,278110,11618,5587,6031
47630,295191,17053,142056,10872,278138,11620,5588,6032
47635,295222,17055,142071,10873,278167,11621,5588,6033
47640,295253,17058,142090,10875,278195,11622,5589,6033
47645,295284,17061,142105,10876,278223,11624,5590,6034
47650,295315,17063,142120,10877,278252,11625,5590,6035
47655,295346,17066,142140,10878,278280,11626,5591,6035
47660,295377,17068,142155,10879,278309,11627,5591,6036
47665,295408,17070,142164,10880,278338,11628,5592,6036
47670,295439,17072,142177,10882,278367,11629,5592,6037
47675,295470,17075,142197,10885,278395,11630,5592,6038
47680,295501,17078,142211,10887,278423,11631,5593,6038
47685,295532,17079,142229,10888,278453,11632,5594,6038
47690,295563,17080,142238,10888,278483,11633,5594,6039
47695,295594,17081,142250,10888,278513,11634,5595,6039
47700,295625,17082,142265,10888,278543,11635,5596,6039
47705,295656,17083,142278,10888,278573,11636,5596,6040
47710,295687,17084,142286,10888,278603,11637,5597,6040
47715,295718,17085,142299,10888,278633,11638,5598,6040
47720,295749,17086,142316,10889,278663,11639,5598,6041
47725,295780,17087,142330,10890,278693,11640,5598,6042
47730,295811,17088,142345,10891,278723,11641,5598,6043
47735,295842,17089,142361,10891,278753,11642,5599,6043
47740,295873,17090,142378,10891,278783,11643,5599,6044
47745,295904,17092,142389,10892,278812,11644,5599,6045
47750,295935,17095,142403,10893,278840,11645,5600,6045
47755,295966,17100,142420,10897,278866,11646,5600,6046
47760,295997,17102,142429,10898,278895,11647,5600,6047
47765,296028,17104,142439,10899,278924,11647,5600,6047
47770,296059,17106,142455,10900,278952,11647,5600,6047
47775,296090,17110,142473,10903,278980,11647,5600,6047
47780,296121,17113,142487,10905,279008,11647,5600,6047
47785,296152,17115,142501,10907,279037,11647,5600,6047
47790,296183,17117,142512,10908,279066,11647,5600,6047
47795,296214,17119,142528,10909,279095,11647,5600,6047
47800,296245,17121,142543,10910,279124,11647,5600,6047
47805,296276,17124,142562,10912,279152,11648,5601,6047
47810,296307,17128,142581,10916,279179,11649,5602,6047
47815,296338,17130,142597,10918,279208,11650,5602,6048
47820,296369,17131,142614,10919,279238,11650,5602,6048
47825,296400,17132,142632,10919,279268,11650,5602,6048
47830,296431,17133,142647,10919,279298,11650,5602,6048
47835,296462,17134,142660,10920,279328,11650,5602,6048
47840,296493,17135,142673,10920,279358,11650,5602,6048
47845,296524,17136,142691,10921,279388,11650,5602,6048
47850,296555,17137,142705,10921,279418,11650,5602,6048
47855,296586,17138,142721,10922,279448,11650,5602,6048
47860,296617,17139,142739,10922,279478,11650,5602,6048
47865,296648,17141,142752,10923,279507,11651,5603,6048
47870,296679,17143,142770,10924,279536,11652,5604,6048
47875,296710,17145,142788,10925,279565,11653,5605,6048
47880,296741,17147,142801,10927,279594,11654,5605,6049
47885,296772,17150,142818,10930,279622,11655,5606,6049
47890,296803,17153,142833,10933,279650,11656,5606,6050
47895,296834,17155,142845,10934,279679,11657,5606,6051
47900,296865,17158,142858,10936,279707,11658,5606,6052
47905,296896,17160,142873,10936,279736,11659,5606,6053
47910,296927,17163,142893,10938,279764,11660,5606,6054
47915,296958,17165,142906,10938,279793,11661,5607,6054
47920,296989,17166,142926,10938,279823,11663,5607,6056
47925,297020,17167,142943,10939,279853,11665,5609,6056
47930,297051,17168,142958,10939,279883,11667,5610,6057
47935,297082,17169,142971,10939,279913,11669,5611,6058
47940,297113,17170,142985,10939,279943,11671,5612,6059
47945,297144,17171,142992,10939,279973,11673,5612,6061
47950,297175,17172,143008,10940,280003,11675,5614,6061
47955,297206,17173,143022,10940,280033,11677,5615,6062
47960,297237,17174,143037,10941,280063,11678,5615,6063
47965,297268,17175,143049,10942,280093,11679,5616,6063
47970,297299,17176,143067,10943,280123,11681,5618,6063
47975,297330,17177,143081,10944,280153,11683,5618,6065
47980,297361,17178,143098,10945,280183,11685,5619,6066
47985,297392,17179,143112,10945,280213,11687,5621,6066
47990,297423,17182,143129,10947,280240,11689,5623,6066
47995,297454,17184,143140,10949,280269,11691,5624,6067
48000,297485,17186,143155,10950,280299,11693,5625,6068
48005,297516,17187,143172,10950,280329,11694,5626,6068
48010,297547,17188,143192,10951,280359,11695,5626,6069
48015,297578,17189,143205,10951,280389,11696,5626,6070
48020,297609,17190,143217,10952,280419,11697,5626,6071
48025,297640,17193,143234,10954,280447,11698,5627,6071
48030,297671,17196,143252,10955,280475,11699,5628,6071
48035,297702,17198,143264,10956,280504,11700,5629,6071
48040,297733,17201,143283,10959,280532,11701,5630,6071
48045,297764,17204,143302,10962,280560,11702,5631,6071
48050,297795,17208,143317,10965,280587,11703,5631,6072
48055,297826,17211,143330,10966,280615,11704,5631,6073
48060,297857,17215,143346,10970,280642,11706,5633,6073
48065,297888,17216,143362,10971,280672,11708,5634,6074
48070,297919,17217,143377,10971,280702,11710,5634,6076
48075,297950,17218,143395,10972,280732,11711,5635,6076
48080,297981,17219,143414,10972,280762,11712,5635,6077
48085,298012,17221,143430,10974,280791,11713,5635,6078
48090,298043,17222,143447,10974,280821,11714,5635,6079
48095,298074,17224,143460,10976,280850,11715,5635,6080
48100,298105,17229,143479,10980,280876,11716,5635,6081
48105,298136,17234,143495,10983,280902,11717,5635,6082
48110,298167,17237,143510,10986,280930,11719,5637,6082
48115,298198,17239,143522,10988,280959,11721,5638,6083
48120,298229,17242,143537,10991,280987,11723,5639,6084
48125,298260,17244,143551,10993,281016,11724,5640,6084
48130,298291,17247,143569,10995,281044,11725,5641,6084
48135,298322,17249,143579,10996,281073,11726,5641,6085
48140,298353,17250,143592,10996,281103,11727,5641,6086
48145,298384,17251,143609,10997,281133,11728,5641,6087
48150,298415,17252,143626,10998,281163,11729,5642,6087
48155,298446,17253,143644,10999,281193,11730,5643,6087
48160,298477,17254,143657,10999,281223,11731,5643,6088
48165,298508,17256,143670,11000,281252,11732,5644,6088
48170,298539,17258,143683,11000,281281,11733,5644,6089
48175,298570,17260,143702,11001,281310,11735,5646,6089
48180,298601,17262,143717,11002,281339,11737,5647,6090
48185,298632,17265,143732,11003,281367,11739,5648,6091
48190,298663,17267,143750,11003,281396,11741,5650,6091
48195,298694,17270,143762,11004,281424,11742,5651,6091
48200,298725,17273,143771,11006,281452,11743,5651,6092
48205,298756,17275,143785,11007,281481,11744,5652,6092
48210,298787,17279,143801,11009,281508,11745,5652,6093
48215,298818,17283,143818,11012,281535,11746,5653,6093
48220,298849,17287,143833,11015,281562,11747,5654,6093
48225,298880,17291,143849,11019,281589,11748,5654,6094
48230,298911,17295,143863,11023,281616,11750,5655,6095
48235,298942,17297,143876,11025,281644,11752,5656,6096
48240,298973,17300,143892,11027,281673,11754,5657,6097
48245,299004,17301,143905,11027,281703,11755,5658,6097
48250,299035,17302,143921,11028,281733,11756,5659,6097
48255,299066,17303,143930,11028,281763,11757,5659,6098
48260,299097,17304,143941,11028,281793,11758,5659,6099
48265,299128,17305,143955,11028,281823,11759,5659,6100
48270,299159,17306,143971,11029,281853,11760,5659,6101
48275,299190,17307,143985,11029,281883,11761,5659,6102
48280,299221,17308,143999,11030,281913,11762,5659,6103
48285,299252,17309,144014,11030,281943,11763,5660,6103
48290,299283,17310,144030,11031,281973,11764,5660,6104
48295,299314,17311,144047,11032,282003,11766,5661,6105
48300,299345,17312,144061,11033,282033,11768,5661,6107
48305,299376,17313,144083,11034,282063,11770,5663,6107
48310,299407,17314,144096,11034,282093,11772,5664,6108
48315,299438,17315,144108,11034,282123,11774,5665,6109
48320,299469,17316,144121,11035,282153,11776,5665,6111
48325,299500,17317,144134,11035,282183,11777,5665,6112
48330,299531,17318,144147,11035,282213,11778,5666,6112
48335,299562,17320,144166,11037,282242,11779,5667,6112
48340,299593,17323,144180,11039,282270,11781,5668,6113
48345,299624,17326,144194,11040,282298,11783,5670,6113
48350,299655,17331,144207,11043,282324,11784,5670,6114
48355,299686,17336,144223,11047,282350,11785,5671,6114
48360,299717,17340,144241,11051,282377,11786,5672,6114
48365,299748,17343,144254,11053,282405,11787,5672,6115
48370,299779,17346,144268,11055,282433,11788,5672,6116
48375,299810,17350,144282,11058,282460,11789,5673,6116
48380,299841,17353,144299,11060,282488,11790,5674,6116
48385,299872,17356,144314,11062,282516,11791,5674,6117
48390,299903,17358,144327,11063,282545,11792,5675,6117
48395,299934,17360,144343,11064,282574,11793,5675,6118
48400,299965,17362,144361,11065,282603,11794,5675,6119
48405,299996,17365,144374,11066,282631,11795,5675,6120
48410,300027,17367,144386,11067,282660,11796,5675,6121
48415,300058,17369,144399,11068,282689,11797,5676,6121
48420,300089,17371,144419,11069,282718,11798,5677,6121
48425,300120,17373,144426,11069,282747,11800,5677,6123
48430,300151,17375,144442,11071,282776,11802,5678,6124
48435,300182,17377,144453,11072,282805,11804,5678,6126
48440,300213,17379,144464,11072,282834,11806,5678,6128
48445,300244,17381,144477,11072,282863,11808,5678,6130
48450,300275,17383,144496,11073,282892,11810,5679,6131
48455,300306,17387,144511,11076,282919,11813,5680,6133
48460,300337,17388,144526,11076,282949,11816,5681,6135
48465,300368,17391,144545,11078,282977,11818,5682,6136
48470,300399,17392,144559,11079,283007,11820,5683,6137
48475,300430,17393,144572,11080,283037,11822,5685,6137
48480,300461,17394,144586,11080,283067,11823,5685,6138
48485,300492,17395,144601,11081,283097,11824,5685,6139
48490,300523,17396,144616,11081,283127,11825,5685,6140
48495,300554,17397,144630,11081,283157,11826,5685,6141
48500,300585,17398,144648,11082,283187,11827,5686,6141
48505,300616,17399,144661,11082,283217,11828,5686,6142
48510,300647,17400,144671,11083,283247,11829,5686,6143
48515,300678,17402,144690,11084,283276,11830,5686,6144
48520,300709,17404,144701,11086,283305,11831,5686,6145
48525,300740,17405,144717,11087,283335,11832,5687,6145
48530,300771,17406,144731,11088,283365,11833,5688,6145
48535,300802,17407,144743,11089,283395,11834,5688,6146
48540,300833,17408,144752,11089,283425,11835,5689,6146
48545,300864,17410,144763,11090,283454,11836,5690,6146
48550,300895,17411,144778,11090,283484,11837,5691,6146
48555,300926,17413,144795,11092,283513,11838,5692,6146
48560,300957,17415,144808,11094,283542,11839,5692,6147
48565,300988,17418,144818,11095,283570,11841,5692,6149
48570,301019,17421,144837,11098,283598,11843,5693,6150
48575,301050,17423,144852,11098,283627,11845,5695,6150
48580,301081,17426,144868,11100,283655,11848,5696,6152
48585,301112,17430,144883,11103,283681,11850,5696,6154
48590,301143,17436,144902,11108,283707,11852,5697,6155
48595,301174,17441,144920,11111,283733,11854,5699,6155
48600,301205,17445,144937,11113,283759,11856,5701,6155
48605,301236,17448,144956,11115,283788,11858,5703,6155
48610,301267,17448,144971,11115,283819,11859,5703,6156
48615,301298,17448,144985,11115,283850,11860,5703,6157
48620,301329,17448,144999,11115,283881,11861,5704,6157
48625,301360,17448,145015,11115,283912,11862,5705,6157
48630,301391,17448,145033,11115,283943,11863,5705,6158
48635,301422,17448,145047,11115,283974,11864,5705,6159
48640,301453,17448,145066,11115,284005,11865,5706,6159
48645,301484,17448,145081,11115,284036,11866,5706,6160
48650,301515,17448,145091,11115,284067,11867,5706,6161
48655,301546,17448,145105,11115,284098,11868,5707,6161
48660,301577,17448,145119,11115,284129,11869,5708,6161
48665,301608,17448,145130,11115,284160,11870,5708,6162
48670,301639,17448,145150,11115,284191,11871,5709,6162
48675,301670,17448,145165,11115,284222,11872,5710,6162
48680,301701,17448,145178,11115,284253,11873,5710,6163
48685,301732,17448,145193,11115,284284,11874,5710,6164
48690,301763,17448,145205,11115,284315,11875,5710,6165
48695,301794,17448,145218,11115,284346,11876,5711,6165
48700,301825,17448,145235,11115,284377,11877,5711,6166
48705,301856,17448,145252,11115,284408,11878,5712,6166
48710,301887,17450,145267,11116,284436,11881,5714,6167
48715,301918,17454,145276,11118,284464,11884,5716,6168
48720,301949,17459,145291,11122,284490,11886,5717,6169
48725,301980,17463,145309,11124,284517,11888,5719,6169
48730,302011,17466,145324,11127,284545,11890,5720,6170
48735,302042,17471,145335,11130,284571,11892,5722,6170
48740,302073,17474,145351,11132,284599,11894,5723,6171
48745,302104,17478,145364,11134,284626,11896,5723,6173
48750,302135,17483,145384,11139,284652,11898,5724,6174
48755,302166,17486,145401,11140,284680,11900,5725,6175
48760,302197,17491,145414,11142,284706,11902,5726,6176
48765,302228,17493,145422,11144,284735,11903,5726,6177
48770,302259,17495,145436,11146,284764,11904,5727,6177
48775,302290,17498,145454,11148,284792,11905,5727,6178
48780,302321,17500,145473,11150,284821,11906,5727,6179
48785,302352,17502,145492,11152,284850,11907,5727,6180
48790,302383,17504,145504,11153,284879,11908,5728,6180
48795,302414,17505,145521,11154,284909,11909,5729,6180
48800,302445,17505,145534,11154,284940,11910,5729,6181
48805,302476,17505,145551,11154,284971,11911,5729,6182
48810,302507,17505,145570,11154,285002,11912,5729,6183
48815,302538,17505,145586,11154,285033,11913,5730,6183
48820,302569,17505,145601,11154,285064,11915,5730,6185
48825,302600,17505,145610,11154,285095,11917,5731,6186
48830,302631,17505,145634,11154,285126,11919,5733,6186
48835,302662,17505,145645,11154,285157,11920,5733,6187
48840,302693,17505,145659,11154,285188,11921,5734,6187
48845,302724,17505,145670,11154,285219,11921,5734,6187
48850,302755,17505,145684,11154,285250,11921,5734,6187
48855,302786,17505,145695,11154,285281,11921,5734,6187
48860,302817,17505,145711,11154,285312,11921,5734,6187
48865,302848,17506,145728,11155,285342,11921,5734,6187
48870,302879,17507,145741,11156,285372,11922,5734,6188
48875,302910,17508,145758,11156,285402,11923,5734,6189
48880,302941,17509,145768,11156,285432,11924,5734,6190
48885,302972,17512,145788,11158,285460,11925,5735,6190
48890,303003,17514,145801,11160,285489,11926,5735,6191
48895,303034,17518,145818,11163,285516,11927,5735,6192
48900,303065,17521,145835,11166,285544,11928,5735,6193
48905,303096,17527,145854,11172,285569,11931,5737,6194
48910,303127,17532,145871,11175,285595,11933,5739,6194
48915,303158,17537,145884,11179,285621,11935,5739,6196
48920,303189,17543,145903,11184,285646,11937,5739,6198
48925,303220,17549,145915,11188,285671,11939,5739,6200
48930,303251,17552,145931,11190,285699,11941,5741,6200
48935,303282,17554,145940,11191,285728,11943,5742,6201
48940,303313,17556,145955,11192,285757,11945,5744,6201
48945,303344,17558,145972,11193,285786,11947,5745,6202
48950,303375,17560,145989,11194,285815,11948,5745,6203
48955,303406,17561,146004,11195,285845,11949,5746,6203
48960,303437,17564,146022,11198,285873,11950,5746,6204
48965,303468,17565,146037,11198,285903,11951,5747,6204
48970,303499,17567,146054,11200,285932,11952,5747,6205
48975,303530,17569,146065,11201,285961,11953,5747,6206
48980,303561,17570,146083,11201,285991,11954,5747,6207
48985,303592,17572,146100,11203,286020,11955,5748,6207
48990,303623,17573,146116,11203,286050,11956,5749,6207
48995,303654,17574,146130,11203,286080,11957,5749,6208
49000,303685,17576,146149,11204,286109,11958,5750,6208
49005,303716,17577,146161,11205,286139,11959,5750,6209
49010,303747,17578,146177,11206,286169,11961,5752,6209
49015,303778,17579,146190,11206,286199,11963,5752,6211
49020,303809,17580,146202,11206,286229,11965,5753,6212
49025,303840,17580,146219,11206,286260,11966,5753,6213
49030,303871,17581,146234,11206,286290,11967,5753,6214
49035,303902,17583,146252,11208,286319,11968,5754,6214
49040,303933,17585,146271,11210,286348,11969,5755,6214
49045,303964,17589,146289,11213,286375,11970,5756,6214
49050,303995,17592,146300,11214,286403,11971,5757,6214
49055,304026,17594,146315,11215,286432,11972,5758,6214
49060,304057,17596,146326,11216,286461,11973,5758,6215
49065,304088,17599,146340,11218,286489,11974,5759,6215
49070,304119,17601,146353,11219,286518,11975,5760,6215
49075,304150,17605,146370,11223,286544,11976,5761,6215
49080,304181,17609,146385,11226,286572,11977,5761,6216
49085,304212,17610,146399,11227,286602,11979,5762,6217
49090,304243,17610,146412,11227,286633,11980,5762,6218
49095,304274,17610,146424,11227,286664,11981,5763,6218
49100,304305,17610,146436,11227,286695,11982,5764,6218
49105,304336,17610,146451,11227,286726,11983,5764,6219
49110,304367,17610,146464,11227,286757,11984,5765,6219
49115,304398,17610,146476,11227,286788,11985,5766,6219
49120,304429,17610,146488,11227,286819,11986,5766,6220
49125,304460,17610,146505,11227,286850,11988,5766,6222
49130,304491,17610,146524,11227,286881,11990,5767,6223
49135,304522,17610,146538,11227,286912,11992,5768,6224
49140,304553,17610,146552,11227,286943,11994,5769,6225
49145,304584,17610,146568,11227,286974,11996,5770,6226
49150,304615,17610,146582,11227,287005,11997,5770,6227
49155,304646,17610,146597,11227,287036,11998,5771,6227
49160,304677,17610,146610,11227,287067,11999,5771,6228
49165,304708,17610,146629,11227,287098,12000,5772,6228
49170,304739,17610,146643,11227,287129,12001,5772,6229
49175,304770,17610,146661,11227,287160,12002,5773,6229
49180,304801,17610,146679,11227,287191,12003,5774,6229
49185,304832,17611,146697,11228,287220,12004,5775,6229
49190,304863,17614,146708,11231,287248,12006,5776,6230
49195,304894,17620,146723,11235,287274,12008,5777,6231
49200,304925,17625,146735,11237,287299,12010,5779,6231
49205,304956,17631,146755,11243,287325,12010,5779,6231
49210,304987,17634,146765,11244,287353,12010,5779,6231
49215,305018,17638,146777,11245,287380,12010,5779,6231
49220,305049,17642,146793,11247,287407,12010,5779,6231
49225,305080,17646,146806,11249,287434,12010,5779,6231
49230,305111,17651,146818,11253,287460,12010,5779,6231
49235,305142,17654,146833,11255,287488,12010,5779,6231
49240,305173,17656,146850,11257,287517,12010,5779,6231
49245,305204,17657,146867,11257,287547,12010,5779,6231
49250,305235,17658,146880,11257,287577,12011,5780,6231
49255,305266,17660,146892,11258,287606,12012,5781,6231
49260,305297,17663,146910,11260,287634,12013,5782,6231
49265,305328,17663,146927,11260,287665,12014,5783,6231
49270,305359,17663,146944,11260,287696,12014,5783,6231
49275,305390,17663,146958,11260,287727,12014,5783,6231
49280,305421,17663,146972,11260,287758,12014,5783,6231
49285,305452,17663,146990,11260,287789,12014,5783,6231
49290,305483,17663,147007,11260,287820,12014,5783,6231
49295,305514,17663,147022,11260,287851,12014,5783,6231
49300,305545,17663,147034,11260,287882,12014,5783,6231
49305,305576,17663,147052,11260,287913,12014,5783,6231
49310,305607,17663,147068,11260,287944,12016,5784,6232
49315,305638,17663,147084,11260,287975,12018,5786,6232
49320,305669,17663,147096,11260,288006,12020,5787,6233
49325,305700,17663,147104,11260,288037,12022,5788,6234
49330,305731,17663,147120,11260,288068,12023,5788,6235
49335,305762,17663,147136,11260,288099,12024,5788,6236
49340,305793,17666,147152,11262,288127,12025,5788,6237
49345,305824,17669,147171,11264,288155,12026,5789,6237
49350,305855,17672,147185,11265,288183,12027,5789,6238
49355,305886,17675,147201,11266,288211,12028,5790,6238
49360,305917,17679,147216,11270,288238,12029,5791,6238
49365,305948,17681,147230,11270,288267,12030,5791,6239
49370,305979,17684,147246,11273,288295,12032,5792,6240
49375,306010,17687,147262,11274,288323,12034,5794,6240
49380,306041,17690,147278,11276,288351,12036,5796,6240
49385,306072,17694,147293,11278,288378,12037,5797,6240
49390,306103,17697,147309,11280,288406,12038,5798,6240
49395,306134,17701,147323,11282,288433,12039,5798,6241
49400,306165,17704,147333,11283,288461,12040,5798,6242
49405,306196,17707,147349,11285,288489,12041,5799,6242
49410,306227,17711,147368,11287,288516,12042,5799,6243
49415,306258,17715,147382,11290,288543,12043,5799,6244
49420,306289,17719,147397,11293,288570,12044,5799,6245
49425,306320,17725,147412,11297,288595,12045,5800,6245
49430,306351,17729,147422,11299,288622,12046,5800,6246
49435,306382,17733,147431,11302,288649,12048,5800,6248
49440,306413,17737,147447,11304,288675,12050,5801,6249
49445,306444,17740,147462,11307,288704,12052,5803,6249
49450,306475,17741,147475,11307,288734,12053,5804,6249
49455,306506,17741,147493,11307,288765,12054,5805,6249
49460,306537,17741,147508,11307,288796,12055,5806,6249
49465,306568,17741,147525,11307,288827,12056,5807,6249
49470,306599,17741,147538,11307,288858,12057,5807,6250
49475,306630,17741,147552,11307,288889,12058,5807,6251
49480,306661,17741,147567,11307,288920,12059,5807,6252
49485,306692,17741,147586,11307,288951,12060,5808,6252
49490,306723,17741,147603,11307,288982,12061,5809,6252
49495,306754,17741,147623,11307,289013,12062,5810,6252
49500,306785,17741,147641,11307,289044,12064,5811,6253
49505,306816,17743,147655,11308,289073,12065,5811,6254
49510,306847,17745,147671,11309,289102,12066,5812,6254
49515,306878,17747,147683,11309,289131,12067,5812,6255
49520,306909,17749,147699,11309,289160,12068,5813,6255
49525,306940,17751,147715,11311,289189,12069,5814,6255
49530,306971,17753,147730,11311,289218,12070,5814,6256
49535,307002,17755,147750,11313,289247,12071,5815,6256
49540,307033,17757,147764,11315,289276,12072,5815,6257
49545,307064,17759,147783,11316,289305,12073,5816,6257
49550,307095,17762,147794,11318,289333,12074,5816,6258
49555,307126,17765,147811,11320,289360,12076,5818,6258
49560,307157,17770,147826,11324,289386,12078,5819,6259
49565,307188,17772,147844,11326,289416,12080,5819,6261
49570,307219,17773,147862,11327,289446,12082,5820,6262
49575,307250,17774,147879,11328,289476,12084,5821,6263
49580,307281,17775,147891,11329,289506,12086,5821,6265
49585,307312,17777,147905,11330,289535,12088,5821,6267
49590,307343,17779,147925,11331,289564,12090,5821,6269
49595,307374,17781,147941,11332,289593,12092,5822,6270
49600,307405,17782,147955,11333,289623,12093,5822,6271
49605,307436,17783,147970,11334,289653,12094,5822,6272
49610,307467,17785,147982,11335,289682,12095,5822,6273
49615,307498,17786,147993,11336,289712,12097,5822,6275
49620,307529,17788,148009,11337,289741,12099,5823,6276
49625,307560,17791,148025,11338,289769,12100,5823,6277
49630,307591,17793,148033,11338,289798,12101,5823,6278
49635,307622,17796,148045,11341,289826,12102,5823,6279
49640,307653,17799,148057,11343,289854,12103,5824,6279
49645,307684,17802,148076,11346,289882,12104,5825,6279
49650,307715,17803,148090,11347,289912,12105,5825,6280
49655,307746,17804,148107,11348,289942,12106,5826,6280
49660,307777,17805,148123,11349,289972,12107,5827,6280
49665,307808,17805,148135,11349,290003,12108,5827,6281
49670,307839,17806,148147,11350,290032,12109,5827,6282
49675,307870,17808,148161,11352,290062,12110,5827,6283
49680,307901,17809,148174,11352,290091,12111,5827,6284
49685,307932,17811,148191,11354,290121,12112,5828,6284
49690,307963,17812,148209,11355,290151,12113,5828,6285
49695,307994,17813,148222,11356,290181,12114,5828,6286
49700,308025,17814,148238,11356,290211,12115,5828,6287
49705,308056,17815,148259,11357,290241,12116,5828,6288
49710,308087,17816,148274,11357,290271,12117,5828,6289
49715,308118,17817,148291,11358,290301,12118,5829,6289
49720,308149,17818,148310,11359,290331,12119,5830,6289
49725,308180,17819,148321,11359,290361,12120,5830,6290
49730,308211,17820,148337,11360,290391,12121,5830,6291
49735,308242,17821,148353,11361,290421,12123,5832,6291
49740,308273,17822,148370,11362,290451,12125,5832,6293
49745,308304,17823,148384,11362,290481,12127,5833,6294
49750,308335,17824,148403,11363,290511,12128,5833,6295
49755,308366,17825,148418,11364,290541,12129,5833,6296
49760,308397,17826,148429,11365,290571,12130,5833,6297
49765,308428,17827,148444,11366,290601,12131,5833,6298
49770,308459,17828,148461,11367,290631,12132,5833,6299
49775,308490,17829,148477,11367,290661,12133,5834,6299
49780,308521,17830,148495,11367,290691,12134,5834,6300
49785,308552,17832,148513,11369,290720,12135,5835,6300
49790,308583,17837,148529,11372,290746,12136,5836,6300
49795,308614,17841,148543,11373,290772,12137,5837,6300
49800,308645,17847,148555,11378,290798,12138,5837,6301
49805,308676,17850,148569,11379,290826,12139,5837,6302
49810,308707,17853,148584,11381,290854,12140,5838,6302
49815,308738,17855,148597,11381,290882,12141,5839,6302
49820,308769,17858,148618,11384,290910,12142,5840,6302
49825,308800,17862,148634,11388,290938,12143,5841,6302
49830,308831,17865,148647,11391,290965,12144,5841,6303
49835,308862,17867,148661,11393,290995,12145,5841,6304
49840,308893,17868,148673,11393,291025,12146,5842,6304
49845,308924,17869,148690,11393,291055,12147,5842,6305
49850,308955,17870,148700,11394,291085,12149,5842,6307
49855,308986,17871,148713,11395,291115,12151,5843,6308
49860,309017,17872,148730,11395,291145,12153,5845,6308
49865,309048,17872,148746,11395,291176,12155,5847,6308
49870,309079,17872,148758,11395,291207,12157,5849,6308
49875,309110,17872,148775,11395,291238,12159,5850,6309
49880,309141,17872,148792,11395,291269,12160,5851,6309
49885,309172,17872,148803,11395,291300,12161,5851,6310
49890,309203,17872,148813,11395,291331,12162,5851,6311
49895,309234,17872,148828,11395,291362,12163,5851,6312
49900,309265,17872,148848,11395,291393,12164,5851,6313
49905,309296,17872,148861,11395,291424,12165,5852,6313
49910,309327,17873,148879,11396,291454,12166,5853,6313
49915,309358,17874,148893,11396,291484,12167,5853,6314
49920,309389,17876,148908,11397,291513,12168,5854,6314
49925,309420,17880,148925,11400,291540,12169,5855,6314
49930,309451,17882,148936,11401,291569,12170,5855,6315
49935,309482,17886,148951,11403,291596,12171,5855,6316
49940,309513,17890,148964,11405,291623,12172,5856,6316
49945,309544,17896,148986,11411,291648,12173,5857,6316
49950,309575,17900,149005,11415,291675,12174,5858,6316
49955,309606,17903,149025,11416,291703,12175,5859,6316
49960,309637,17905,149038,11418,291732,12176,5859,6317
49965,309668,17908,149054,11420,291760,12177,5860,6317
49970,309699,17911,149069,11421,291788,12178,5861,6317
49975,309730,17913,149085,11422,291817,12179,5862,6317
49980,309761,17915,149100,11422,291845,12181,5862,6319
49985,309792,17918,149110,11424,291874,12183,5862,6321
49990,309823,17920,149128,11426,291902,12185,5864,6321
49995,309854,17922,149141,11427,291932,12186,5864,6322
50000,309885,17922,149153,11427,291963,12187,5865,6322
50005,309916,17922,149165,11427,291994,12188,5866,6322
50010,309947,17922,149178,11427,292025,12189,5866,6323
50015,309978,17922,149188,11427,292056,12190,5866,6324
50020,310009,17922,149201,11427,292087,12191,5867,6324
50025,310040,17922,149215,11427,292118,12192,5867,6325
50030,310071,17922,149230,11427,292149,12193,5867,6326
50035,310102,17922,149245,11427,292180,12194,5868,6326
50040,310133,17922,149263,11427,292211,12195,5869,6326
50045,310164,17923,149279,11428,292241,12196,5870,6326
50050,310195,17924,149292,11428,292271,12197,5870,6327
50055,310226,17925,149304,11428,292301,12197,5870,6327
50060,310257,17926,149322,11429,292331,12197,5870,6327
50065,310288,17927,149337,11429,292361,12197,5870,6327
50070,310319,17928,149349,11430,292391,12197,5870,6327
50075,310350,17929,149361,11430,292421,12197,5870,6327
50080,310381,17930,149371,11431,292451,12197,5870,6327
50085,310412,17931,149385,11431,292481,12197,5870,6327
50090,310443,17932,149400,11432,292511,12197,5870,6327
50095,310474,17934,149419,11434,292540,12197,5870,6327
50100,310505,17937,149436,11437,292568,12197,5870,6327
50105,310536,17941,149453,11440,292594,12198,5870,6328
50110,310567,17946,149468,11443,292621,12199,5870,6329
50115,310598,17952,149485,11449,292646,12200,5871,6329
50120,310629,17957,149501,11453,292671,12201,5871,6330
50125,310660,17962,149517,11457,292698,12202,5872,6330
50130,310691,17965,149532,11460,292726,12202,5872,6330
50135,310722,17969,149547,11462,292753,12202,5872,6330
50140,310753,17972,149562,11464,292781,12202,5872,6330
50145,310784,17975,149575,11465,292809,12202,5872,6330
50150,310815,17976,149590,11466,292839,12202,5872,6330
50155,310846,17978,149602,11468,292868,12204,5872,6332
50160,310877,17980,149616,11469,292897,12206,5873,6333
50165,310908,17980,149633,11469,292928,12208,5873,6335
50170,310939,17980,149651,11469,292959,12209,5873,6336
50175,310970,17980,149666,11469,292990,12210,5873,6337
50180,311001,17980,149687,11469,293021,12211,5874,6337
50185,311032,17980,149698,11469,293052,12212,5875,6337
50190,311063,17980,149711,11469,293083,12213,5875,6338
50195,311094,17980,149727,11469,293114,12214,5876,6338
50200,311125,17980,149745,11469,293145,12215,5877,6338
50205,311156,17980,149758,11469,293176,12216,5877,6339
50210,311187,17980,149774,11469,293207,12217,5878,6339
50215,311218,17980,149789,11469,293238,12218,5878,6340
50220,311249,17980,149808,11469,293269,12219,5878,6341
50225,311280,17980,149823,11469,293300,12220,5879,6341
50230,311311,17981,149837,11470,293330,12222,5879,6343
50235,311342,17982,149847,11470,293360,12223,5879,6344
50240,311373,17983,149860,11471,293390,12224,5879,6345
50245,311404,17984,149878,11472,293420,12225,5879,6346
50250,311435,17985,149890,11473,293450,12227,5880,6347
50255,311466,17987,149903,11474,293479,12229,5881,6348
50260,311497,17988,149914,11475,293509,12231,5883,6348
50265,311528,17990,149930,11476,293538,12232,5883,6349
50270,311559,17994,149942,11478,293564,12234,5884,6350
50275,311590,17999,149962,11483,293590,12236,5886,6350
50280,311621,18004,149979,11486,293616,12238,5887,6351
50285,311652,18010,149998,11492,293642,12239,5888,6351
50290,311683,18013,150012,11492,293670,12240,5888,6352
50295,311714,18019,150029,11497,293695,12241,5888,6353
50300,311745,18024,150043,11500,293721,12242,5889,6353
50305,311776,18029,150060,11503,293747,12243,5890,6353
50310,311807,18035,150082,11508,293772,12244,5891,6353
50315,311838,18038,150094,11509,293800,12245,5892,6353
50320,311869,18044,150107,11514,293825,12246,5893,6353
50325,311900,18047,150125,11517,293853,12247,5893,6354
50330,311931,18051,150142,11519,293880,12248,5894,6354
50335,311962,18054,150158,11521,293908,12249,5895,6354
50340,311993,18057,150179,11524,293936,12250,5895,6355
50345,312024,18057,150193,11524,293967,12252,5896,6356
50350,312055,18057,150211,11524,293998,12253,5896,6357
50355,312086,18057,150226,11524,294029,12254,5896,6358
50360,312117,18057,150243,11524,294060,12255,5896,6359
50365,312148,18057,150259,11524,294091,12256,5897,6359
50370,312179,18057,150272,11524,294122,12257,5897,6360
50375,312210,18057,150289,11524,294153,12258,5897,6361
50380,312241,18057,150300,11524,294184,12259,5898,6361
50385,312272,18057,150318,11524,294215,12261,5899,6362
50390,312303,18057,150333,11524,294246,12263,5900,6363
50395,312334,18057,150351,11524,294277,12265,5901,6364
50400,312365,18057,150368,11524,294308,12267,5902,6365
50405,312396,18057,150376,11524,294339,12268,5902,6366
50410,312427,18057,150388,11524,294370,12269,5902,6367
50415,312458,18057,150405,11524,294401,12270,5902,6368
50420,312489,18057,150421,11524,294432,12271,5903,6368
50425,312520,18057,150434,11524,294463,12272,5904,6368
50430,312551,18057,150447,11524,294494,12273,5904,6369
50435,312582,18058,150462,11525,294524,12274,5904,6370
50440,312613,18060,150473,11527,294553,12275,5904,6371
50445,312644,18062,150488,11529,294582,12276,5904,6372
50450,312675,18064,150500,11530,294610,12277,5905,6372
50455,312706,18070,150513,11535,294636,12278,5905,6373
50460,312737,18075,150527,11539,294662,12279,5906,6373
50465,312768,18077,150538,11539,294691,12280,5907,6373
50470,312799,18080,150558,11541,294719,12282,5909,6373
50475,312830,18082,150576,11542,294748,12284,5910,6374
50480,312861,18084,150591,11544,294777,12285,5911,6374
50485,312892,18085,150603,11545,294807,12286,5911,6375
50490,312923,18087,150620,11547,294836,12287,5911,6376
50495,312954,18088,150631,11548,294866,12288,5911,6377
50500,312985,18089,150648,11549,294896,12289,5912,6377
50505,313016,18091,150662,11550,294925,12291,5913,6378
50510,313047,18091,150675,11550,294956,12292,5913,6379
50515,313078,18091,150689,11550,294987,12293,5913,6380
50520,313109,18091,150707,11550,295018,12294,5913,6381
50525,313140,18091,150721,11550,295049,12295,5914,6381
50530,313171,18091,150736,11550,295080,12296,5915,6381
50535,313202,18091,150751,11550,295111,12297,5916,6381
50540,313233,18091,150764,11550,295142,12298,5916,6382
50545,313264,18091,150780,11550,295173,12299,5916,6383
50550,313295,18091,150799,11550,295204,12300,5916,6384
50555,313326,18091,150814,11550,295235,12301,5917,6384
50560,313357,18091,150830,11550,295266,12302,5917,6385
50565,313388,18092,150848,11550,295295,12303,5917,6386
50570,313419,18094,150858,11551,295325,12304,5917,6387
50575,313450,18096,150873,11551,295354,12305,5918,6387
50580,313481,18099,150890,11553,295382,12306,5919,6387
50585,313512,18106,150907,11558,295406,12308,5919,6389
50590,313543,18110,150927,11560,295433,12309,5920,6389
50595,313574,18113,150939,11563,295461,12310,5921,6389
50600,313605,18116,150955,11565,295489,12311,5921,6390
50605,313636,18119,150972,11566,295517,12312,5922,6390
50610,313667,18121,150983,11567,295546,12313,5923,6390
50615,313698,18125,151003,11569,295573,12314,5923,6391
50620,313729,18126,151013,11570,295603,12315,5923,6392
50625,313760,18128,151026,11572,295632,12316,5924,6392
50630,313791,18129,151042,11572,295662,12318,5925,6393
50635,313822,18131,151056,11573,295691,12320,5925,6395
50640,313853,18133,151076,11574,295720,12321,5926,6395
50645,313884,18134,151093,11575,295750,12322,5926,6396
50650,313915,18135,151109,11575,295780,12323,5927,6396
50655,313946,18136,151125,11575,295810,12324,5928,6396
50660,313977,18137,151139,11575,295840,12325,5928,6397
50665,314008,18138,151156,11576,295870,12326,5929,6397
50670,314039,18139,151165,11576,295900,12327,5929,6398
50675,314070,18140,151183,11577,295930,12328,5930,6398
50680,314101,18141,151195,11577,295960,12329,5930,6399
50685,314132,18142,151211,11578,295990,12330,5930,6400
50690,314163,18143,151229,11579,296020,12331,5930,6401
50695,314194,18144,151241,11580,296050,12332,5931,6401
50700,314225,18146,151254,11581,296079,12333,5932,6401
50705,314256,18149,151267,11583,296107,12334,5932,6402
50710,314287,18154,151285,11586,296133,12335,5933,6402
50715,314318,18159,151302,11588,296159,12337,5935,6402
50720,314349,18164,151317,11592,296185,12339,5936,6403
50725,314380,18167,151328,11593,296213,12341,5937,6404
50730,314411,18171,151345,11595,296240,12343,5938,6405
50735,314442,18176,151360,11598,296266,12345,5940,6405
50740,314473,18180,151373,11600,296293,12348,5940,6408
50745,314504,18182,151387,11600,296322,12351,5942,6409
50750,314535,18184,151402,11602,296351,12353,5942,6411
50755,314566,18186,151418,11603,296380,12355,5943,6412
50760,314597,18188,151431,11604,296408,12357,5945,6412
50765,314628,18189,151442,11605,296439,12357,5945,6412
50770,314659,18189,151457,11605,296470,12357,5945,6412
50775,314690,18189,151471,11605,296501,12357,5945,6412
50780,314721,18189,151487,11605,296532,12357,5945,6412
50785,314752,18189,151504,11605,296563,12357,5945,6412
50790,314783,18189,151525,11605,296594,12357,5945,6412
50795,314814,18189,151544,11605,296625,12357,5945,6412
50800,314845,18189,151559,11605,296656,12357,5945,6412
50805,314876,18189,151570,11605,296687,12357,5945,6412
50810,314907,18189,151586,11605,296718,12357,5945,6412
50815,314938,18189,151598,11605,296749,12357,5945,6412
50820,314969,18189,151617,11605,296780,12357,5945,6412
50825,315000,18192,151632,11607,296808,12357,5945,6412
50830,315031,18196,151649,11611,296835,12357,5945,6412
50835,315062,18198,151660,11613,296864,12357,5945,6412
50840,315093,18201,151677,11614,296892,12357,5945,6412
50845,315124,18204,151699,11617,296920,12357,5945,6412
50850,315155,18206,151713,11619,296949,12357,5945,6412
50855,315186,18208,151727,11620,296978,12357,5945,6412
50860,315217,18210,151740,11621,297007,12357,5945,6412
50865,315248,18212,151751,11621,297036,12357,5945,6412
50870,315279,18216,151770,11624,297063,12359,5945,6414
50875,315310,18219,151790,11627,297091,12361,5946,6415
50880,315341,18220,151806,11628,297121,12363,5947,6416
50885,315372,18221,151820,11629,297151,12364,5947,6417
50890,315403,18222,151835,11629,297181,12365,5947,6418
50895,315434,18223,151852,11630,297211,12366,5948,6418
50900,315465,18224,151865,11631,297241,12367,5949,6418
50905,315496,18225,151878,11631,297271,12368,5950,6418
50910,315527,18226,151899,11632,297301,12369,5951,6418
50915,315558,18227,151918,11633,297331,12370,5951,6419
50920,315589,18228,151932,11634,297361,12371,5952,6419
50925,315620,18229,151944,11634,297391,12372,5953,6419
50930,315651,18230,151956,11634,297421,12373,5953,6420
50935,315682,18231,151969,11634,297451,12374,5953,6421
50940,315713,18232,151984,11635,297481,12375,5954,6421
50945,315744,18234,151997,11637,297510,12378,5956,6422
50950,315775,18238,152013,11640,297537,12380,5957,6423
50955,315806,18242,152026,11642,297564,12382,5957,6425
50960,315837,18247,152039,11645,297590,12384,5959,6425
50965,315868,18250,152051,11647,297617,12386,5960,6426
50970,315899,18255,152057,11649,297644,12388,5960,6428
50975,315930,18258,152077,11652,297671,12389,5961,6428
50980,315961,18261,152088,11653,297700,12390,5961,6429
50985,315992,18263,152098,11655,297729,12391,5961,6430
50990,316023,18267,152115,11658,297755,12392,5961,6431
50995,316054,18272,152130,11663,297781,12393,5962,6431
51000,316085,18277,152145,11666,297807,12394,5962,6432
51005,316116,18280,152160,11669,297836,12395,5963,6432
51010,316147,18283,152175,11671,297864,12396,5964,6432
51015,316178,18283,152186,11671,297895,12397,5965,6432
51020,316209,18283,152198,11671,297926,12398,5966,6432
51025,316240,18283,152211,11671,297957,12399,5966,6433
51030,316271,18283,152224,11671,297988,12400,5966,6434
51035,316302,18283,152234,11671,298019,12401,5966,6435
51040,316333,18283,152247,11671,298050,12402,5967,6435
51045,316364,18283,152267,11671,298081,12403,5968,6435
51050,316395,18283,152285,11671,298112,12405,5969,6436
51055,316426,18283,152294,11671,298143,12407,5970,6437
51060,316457,18283,152312,11671,298174,12408,5970,6438
51065,316488,18283,152327,11671,298205,12409,5970,6439
51070,316519,18283,152341,11671,298236,12410,5970,6440
51075,316550,18284,152353,11671,298266,12411,5971,6440
51080,316581,18285,152371,11671,298296,12413,5972,6441
51085,316612,18287,152386,11672,298325,12415,5973,6442
51090,316643,18288,152398,11672,298355,12417,5974,6443
51095,316674,18290,152413,11673,298384,12419,5975,6444
51100,316705,18291,152427,11673,298414,12421,5977,6444
51105,316736,18292,152440,11674,298444,12423,5978,6445
51110,316767,18296,152458,11678,298471,12425,5979,6446
51115,316798,18300,152475,11682,298498,12427,5980,6447
51120,316829,18304,152489,11685,298525,12429,5981,6448
51125,316860,18307,152506,11686,298553,12430,5981,6449
51130,316891,18310,152520,11687,298581,12431,5981,6450
51135,316922,18314,152537,11690,298608,12432,5981,6451
51140,316953,18317,152554,11691,298636,12433,5982,6451
51145,316984,18318,152569,11692,298666,12434,5982,6452
51150,317015,18320,152582,11694,298695,12435,5983,6452
51155,317046,18322,152597,11695,298724,12436,5984,6452
51160,317077,18324,152612,11696,298753,12438,5984,6454
51165,317108,18326,152624,11697,298782,12440,5984,6456
51170,317139,18327,152632,11697,298812,12442,5984,6458
51175,317170,18329,152645,11698,298841,12444,5985,6459
51180,317201,18330,152663,11699,298871,12445,5985,6460
51185,317232,18331,152676,11699,298901,12446,5985,6461
51190,317263,18332,152691,11700,298931,12447,5986,6461
51195,317294,18333,152711,11701,298961,12448,5986,6462
51200,317325,18334,152728,11701,298991,12449,5987,6462
51205,317356,18335,152740,11702,299021,12450,5987,6463
51210,317387,18336,152756,11702,299051,12451,5987,6464
51215,317418,18337,152768,11702,299081,12452,5987,6465
51220,317449,18338,152781,11703,299111,12453,5987,6466
51225,317480,18339,152792,11704,299141,12454,5988,6466
51230,317511,18341,152807,11706,299170,12455,5988,6467
51235,317542,18343,152824,11708,299199,12456,5988,6468
51240,317573,18344,152834,11708,299229,12457,5988,6469
51245,317604,18346,152848,11709,299258,12458,5988,6470
51250,317635,18348,152860,11710,299286,12459,5988,6471
51255,317666,18352,152875,11712,299314,12460,5989,6471
51260,317697,18355,152893,11714,299342,12462,5989,6473
51265,317728,18358,152911,11716,299370,12463,5989,6474
51270,317759,18360,152918,11716,299399,12464,5989,6475
51275,317790,18362,152932,11718,299428,12465,5989,6476
51280,317821,18365,152948,11719,299456,12467,5991,6476
51285,317852,18368,152960,11721,299484,12469,5991,6478
51290,317883,18371,152974,11723,299512,12471,5993,6478
51295,317914,18374,152987,11725,299540,12473,5995,6478
51300,317945,18376,153005,11726,299569,12474,5995,6479
51305,317976,18377,153015,11726,299599,12475,5995,6480
51310,318007,18378,153030,11726,299629,12476,5996,6480
51315,318038,18379,153042,11727,299659,12477,5997,6480
51320,318069,18380,153056,11727,299689,12478,5998,6480
51325,318100,18381,153070,11727,299719,12479,5999,6480
51330,318131,18382,153087,11728,299749,12480,5999,6481
51335,318162,18384,153097,11729,299778,12481,5999,6482
51340,318193,18386,153107,11730,299807,12482,6000,6482
51345,318224,18389,153119,11731,299835,12483,6001,6482
51350,318255,18393,153136,11733,299862,12484,6002,6482
51355,318286,18398,153153,11737,299888,12485,6002,6483
51360,318317,18401,153163,11738,299916,12486,6002,6484
51365,318348,18402,153182,11739,299946,12487,6003,6484
51370,318379,18403,153200,11739,299976,12488,6003,6485
51375,318410,18404,153214,11740,300006,12489,6003,6486
51380,318441,18405,153228,11741,300036,12490,6004,6486
51385,318472,18406,153241,11741,300066,12491,6004,6487
51390,318503,18407,153258,11741,300096,12492,6004,6488
51395,318534,18408,153268,11742,300126,12493,6004,6489
51400,318565,18409,153284,11742,300156,12494,6004,6490
51405,318596,18410,153300,11742,300186,12495,6005,6490
51410,318627,18411,153314,11743,300216,12496,6006,6490
51415,318658,18412,153334,11744,300246,12497,6007,6490
51420,318689,18413,153347,11744,300276,12499,6008,6491
51425,318720,18414,153364,11744,300306,12501,6009,6492
51430,318751,18415,153376,11745,300336,12503,6010,6493
51435,318782,18416,153388,11746,300366,12505,6012,6493
51440,318813,18417,153401,11746,300396,12506,6012,6494
51445,318844,18418,153418,11747,300426,12507,6012,6495
51450,318875,18419,153434,11748,300456,12508,6013,6495
51455,318906,18420,153451,11749,300486,12509,6013,6496
51460,318937,18421,153468,11750,300516,12510,6014,6496
51465,318968,18424,153481,11753,300544,12511,6014,6497
51470,318999,18429,153495,11757,300569,12512,6014,6498
51475,319030,18434,153508,11760,300595,12514,6015,6499
51480,319061,18439,153526,11764,300622,12516,6017,6499
51485,319092,18444,153545,11769,300648,12517,6017,6500
51490,319123,18445,153562,11770,300678,12518,6018,6500
51495,319154,18446,153580,11771,300708,12519,6019,6500
51500,319185,18447,153595,11771,300738,12520,6020,6500
51505,319216,18448,153612,11771,300768,12521,6020,6501
51510,319247,18449,153623,11772,300798,12522,6021,6501
51515,319278,18450,153635,11772,300828,12523,6021,6502
51520,319309,18451,153647,11773,300858,12524,6022,6502
51525,319340,18452,153666,11774,300888,12525,6023,6502
51530,319371,18453,153678,11775,300918,12526,6023,6503
51535,319402,18454,153688,11776,300948,12527,6023,6504
51540,319433,18455,153702,11777,300978,12529,6024,6505
51545,319464,18456,153721,11778,301008,12530,6024,6506
51550,319495,18457,153742,11779,301038,12531,6024,6507
51555,319526,18458,153755,11779,301068,12532,6025,6507
51560,319557,18459,153770,11779,301098,12533,6026,6507
51565,319588,18460,153791,11780,301128,12534,6027,6507
51570,319619,18461,153808,11781,301158,12535,6027,6508
51575,319650,18462,153824,11781,301188,12536,6028,6508
51580,319681,18463,153840,11781,301218,12537,6028,6509
51585,319712,18465,153854,11783,301247,12538,6029,6509
51590,319743,18469,153868,11786,301274,12540,6029,6511
51595,319774,18474,153884,11789,301300,12542,6030,6512
51600,319805,18478,153900,11793,301327,12544,6031,6513
51605,319836,18480,153918,11795,301356,12545,6032,6513
51610,319867,18482,153931,11796,301384,12546,6032,6514
51615,319898,18485,153939,11797,301413,12547,6032,6515
51620,319929,18487,153955,11797,301442,12548,6032,6516
51625,319960,18489,153970,11798,301471,12549,6033,6516
51630,319991,18492,153986,11801,301499,12550,6033,6517
51635,320022,18495,154007,11803,301527,12551,6034,6517
51640,320053,18498,154022,11804,301555,12552,6035,6517
51645,320084,18500,154039,11804,301584,12553,6035,6518
51650,320115,18502,154056,11805,301613,12554,6035,6519
51655,320146,18504,154071,11805,301642,12556,6037,6519
51660,320177,18506,154086,11805,301671,12558,6038,6520
51665,320208,18508,154102,11806,301700,12560,6038,6522
51670,320239,18510,154121,11808,301729,12562,6039,6523
51675,320270,18512,154135,11809,301758,12564,6039,6525
51680,320301,18514,154149,11809,301787,12565,6039,6526
51685,320332,18516,154168,11811,301816,12566,6040,6526
51690,320363,18518,154182,11812,301845,12567,6040,6527
51695,320394,18520,154202,11814,301874,12568,6041,6527
51700,320425,18523,154219,11815,301902,12569,6042,6527
51705,320456,18527,154239,11817,301929,12570,6043,6527
51710,320487,18529,154255,11818,301958,12571,6043,6528
51715,320518,18532,154279,11821,301985,12572,6044,6528
51720,320549,18535,154297,11824,302013,12574,6045,6529
51725,320580,18537,154311,11826,302043,12575,6046,6529
51730,320611,18538,154330,11827,302073,12576,6047,6529
51735,320642,18539,154345,11827,302103,12577,6047,6530
51740,320673,18540,154355,11828,302133,12578,6048,6530
51745,320704,18541,154366,11828,302163,12579,6048,6531
51750,320735,18542,154380,11829,302193,12580,6048,6532
51755,320766,18543,154393,11829,302223,12581,6048,6533
51760,320797,18544,154409,11829,302253,12582,6048,6534
51765,320828,18545,154424,11829,302283,12583,6048,6535
51770,320859,18546,154438,11830,302313,12584,6049,6535
51775,320890,18547,154450,11830,302343,12585,6049,6536
51780,320921,18548,154463,11831,302373,12587,6051,6536
51785,320952,18551,154482,11833,302400,12588,6052,6536
51790,320983,18554,154497,11835,302428,12589,6053,6536
51795,321014,18558,154507,11837,302456,12590,6053,6537
51800,321045,18560,154526,11839,302485,12591,6054,6537
51805,321076,18561,154543,11840,302515,12592,6055,6537
51810,321107,18563,154561,11841,302544,12593,6056,6537
51815,321138,18566,154574,11842,302572,12594,6057,6537
51820,321169,18568,154589,11843,302601,12595,6058,6537
51825,321200,18572,154603,11845,302628,12596,6059,6537
51830,321231,18573,154617,11846,302658,12598,6061,6537
51835,321262,18576,154629,11849,302686,12600,6062,6538
51840,321293,18578,154641,11850,302715,12601,6063,6538
51845,321324,18581,154651,11852,302743,12601,6063,6538
51850,321355,18584,154672,11854,302771,12601,6063,6538
51855,321386,18585,154689,11854,302801,12601,6063,6538
51860,321417,18586,154708,11855,302831,12601,6063,6538
51865,321448,18587,154720,11856,302861,12601,6063,6538
51870,321479,18588,154733,11856,302891,12601,6063,6538
51875,321510,18589,154751,11857,302921,12601,6063,6538
51880,321541,18590,154768,11858,302951,12601,6063,6538
51885,321572,18591,154780,11858,302981,12601,6063,6538
51890,321603,18592,154797,11858,303011,12601,6063,6538
51895,321634,18593,154814,11858,303041,12601,6063,6538
51900,321665,18594,154830,11859,303071,12601,6063,6538
51905,321696,18594,154850,11859,303102,12602,6063,6539
51910,321727,18596,154869,11860,303131,12603,6064,6539
51915,321758,18598,154885,11862,303160,12604,6065,6539
51920,321789,18599,154898,11862,303190,12605,6065,6540
51925,321820,18600,154916,11863,303219,12606,6066,6540
51930,321851,18603,154934,11866,303248,12607,6067,6540
51935,321882,18605,154952,11868,303277,12608,6067,6541
51940,321913,18607,154968,11869,303305,12609,6068,6541
51945,321944,18609,154982,11870,303334,12611,6069,6542
51950,321975,18611,154997,11872,303363,12613,6070,6543
51955,322006,18615,155018,11876,303390,12615,6071,6544
51960,322037,18618,155028,11878,303419,12617,6072,6545
51965,322068,18620,155043,11880,303448,12618,6072,6546
51970,322099,18623,155056,11883,303476,12619,6072,6547
51975,322130,18624,155073,11884,303506,12620,6073,6547
51980,322161,18625,155087,11885,303536,12621,6073,6548
51985,322192,18626,155103,11886,303566,12622,6074,6548
51990,322223,18627,155119,11886,303596,12623,6074,6549
51995,322254,18628,155136,11886,303626,12624,6074,6550
52000,322285,18629,155148,11886,303656,12625,6075,6550
52005,322316,18630,155165,11887,303686,12626,6076,6550
52010,322347,18632,155184,11887,303715,12627,6076,6551
52015,322378,18634,155196,11888,303744,12628,6076,6552
52020,322409,18636,155211,11889,303773,12629,6077,6552
52025,322440,18638,155228,11891,303802,12630,6078,6552
52030,322471,18640,155240,11891,303831,12631,6078,6553
52035,322502,18642,155251,11892,303860,12632,6078,6554
52040,322533,18644,155265,11893,303889,12633,6078,6555
52045,322564,18646,155282,11895,303918,12634,6078,6556
52050,322595,18648,155294,11895,303947,12636,6079,6557
52055,322626,18650,155307,11896,303976,12638,6080,6558
52060,322657,18652,155322,11897,304005,12640,6081,6559
52065,322688,18656,155337,11901,304031,12642,6083,6559
52070,322719,18661,155350,11905,304058,12644,6083,6561
52075,322750,18666,155367,11909,304084,12647,6084,6563
52080,322781,18669,155383,11910,304111,12650,6085,6565
52085,322812,18673,155398,11912,304139,12651,6086,6565
52090,322843,18675,155413,11914,304168,12652,6087,6565
52095,322874,18678,155430,11916,304196,12653,6088,6565
52100,322905,18680,155444,11918,304225,12654,6089,6565
52105,322936,18683,155459,11919,304253,12655,6090,6565
52110,322967,18685,155479,11921,304282,12656,6090,6566
52115,322998,18688,155494,11922,304310,12657,6090,6567
52120,323029,18690,155506,11923,304339,12658,6091,6567
52125,323060,18694,155521,11926,304366,12659,6092,6567
52130,323091,18696,155537,11927,304395,12660,6093,6567
52135,323122,18699,155552,11930,304423,12661,6093,6568
52140,323153,18702,155561,11933,304451,12662,6093,6569
52145,323184,18702,155575,11933,304482,12663,6094,6569
52150,323215,18702,155585,11933,304513,12664,6095,6569
52155,323246,18702,155601,11933,304544,12665,6095,6570
52160,323277,18702,155618,11933,304575,12666,6095,6571
52165,323308,18702,155634,11933,304606,12667,6096,6571
52170,323339,18702,155647,11933,304637,12668,6097,6571
52175,323370,18702,155660,11933,304668,12669,6097,6572
52180,323401,18702,155676,11933,304699,12670,6097,6573
52185,323432,18702,155692,11933,304730,12672,6097,6575
52190,323463,18703,155708,11933,304760,12674,6098,6576
52195,323494,18705,155725,11934,304789,12676,6099,6577
52200,323525,18706,155743,11934,304819,12678,6100,6578
52205,323556,18708,155756,11934,304848,12679,6101,6578
52210,323587,18709,155778,11934,304878,12680,6102,6578
52215,323618,18710,155793,11935,304908,12681,6102,6579
52220,323649,18711,155809,11936,304938,12682,6103,6579
52225,323680,18712,155826,11936,304968,12683,6104,6579
52230,323711,18713,155841,11937,304998,12684,6105,6579
52235,323742,18714,155856,11938,305028,12685,6105,6580
52240,323773,18715,155872,11938,305058,12686,6105,6581
52245,323804,18716,155890,11939,305088,12687,6105,6582
52250,323835,18717,155901,11939,305118,12688,6105,6583
52255,323866,18718,155917,11940,305148,12689,6105,6584
52260,323897,18719,155930,11941,305178,12690,6106,6584
52265,323928,18720,155946,11941,305208,12691,6106,6585
52270,323959,18721,155965,11942,305238,12692,6107,6585
52275,323990,18722,155980,11943,305268,12693,6108,6585
52280,324021,18723,155994,11944,305298,12694,6108,6586
52285,324052,18724,156008,11945,305328,12695,6108,6587
52290,324083,18725,156021,11946,305358,12696,6108,6588
52295,324114,18726,156033,11947,305388,12697,6108,6589
52300,324145,18727,156048,11948,305418,12698,6109,6589
52305,324176,18730,156063,11951,305446,12699,6110,6589
52310,324207,18735,156083,11955,305471,12701,6112,6589
52315,324238,18739,156100,11958,305499,12703,6113,6590
52320,324269,18742,156112,11961,305526,12704,6114,6590
52325,324300,18745,156127,11962,305555,12705,6115,6590
52330,324331,18747,156138,11963,305584,12706,6116,6590
52335,324362,18751,156150,11966,305611,12707,6117,6590
52340,324393,18754,156162,11968,305639,12708,6117,6591
52345,324424,18757,156180,11970,305667,12709,6118,6591
52350,324455,18760,156195,11972,305695,12710,6118,6592
52355,324486,18764,156210,11976,305722,12711,6119,6592
52360,324517,18766,156225,11977,305751,12712,6120,6592
52365,324548,18769,156238,11979,305779,12713,6120,6593
52370,324579,18771,156255,11980,305808,12714,6120,6594
52375,324610,18773,156267,11981,305837,12715,6120,6595
52380,324641,18776,156281,11983,305865,12716,6121,6595
52385,324672,18776,156296,11983,305896,12718,6121,6597
52390,324703,18776,156314,11983,305927,12720,6122,6598
52395,324734,18776,156328,11983,305958,12722,6124,6598
52400,324765,18776,156340,11983,305989,12723,6125,6598
52405,324796,18776,156356,11983,306020,12724,6126,6598
52410,324827,18776,156373,11983,306051,12725,6127,6598
52415,324858,18776,156391,11983,306082,12727,6128,6599
52420,324889,18777,156409,11984,306112,12729,6130,6599
52425,324920,18778,156419,11985,306142,12731,6130,6601
52430,324951,18779,156436,11986,306172,12733,6131,6602
52435,324982,18782,156447,11989,306200,12735,6131,6604
52440,325013,18784,156464,11990,306229,12737,6131,6606
52445,325044,18787,156480,11991,306257,12738,6132,6606
52450,325075,18792,156497,11995,306283,12739,6133,6606
52455,325106,18797,156516,11998,306309,12740,6134,6606
52460,325137,18801,156529,12001,306336,12741,6135,6606
52465,325168,18805,156546,12004,306363,12742,6136,6606
52470,325199,18809,156561,12006,306390,12743,6137,6606
52475,325230,18813,156575,12009,306417,12744,6137,6607
52480,325261,18814,156589,12009,306447,12745,6138,6607
52485,325292,18815,156606,12010,306477,12746,6138,6608
52490,325323,18816,156625,12010,306507,12747,6139,6608
52495,325354,18817,156641,12011,306537,12748,6140,6608
52500,325385,18818,156653,12011,306567,12749,6140,6609
52505,325416,18819,156666,12011,306597,12751,6140,6611
52510,325447,18820,156681,12012,306627,12753,6141,6612
52515,325478,18821,156695,12012,306657,12755,6142,6613
52520,325509,18822,156714,12013,306687,12757,6144,6613
52525,325540,18823,156726,12013,306717,12759,6144,6615
52530,325571,18824,156740,12013,306747,12760,6144,6616
52535,325602,18825,156757,12014,306777,12761,6145,6616
52540,325633,18826,156775,12015,306807,12762,6146,6616
52545,325664,18827,156791,12016,306837,12763,6147,6616
52550,325695,18829,156805,12018,306866,12765,6147,6618
52555,325726,18831,156818,12019,306895,12767,6148,6619
52560,325757,18831,156835,12019,306926,12769,6148,6621
52565,325788,18831,156849,12019,306957,12770,6148,6622
52570,325819,18832,156864,12020,306987,12771,6149,6622
52575,325850,18833,156877,12020,307017,12772,6149,6623
52580,325881,18835,156890,12021,307046,12773,6150,6623
52585,325912,18837,156907,12021,307075,12774,6150,6624
52590,325943,18840,156926,12023,307103,12775,6151,6624
52595,325974,18843,156946,12025,307131,12776,6151,6625
52600,326005,18845,156961,12026,307160,12777,6151,6626
52605,326036,18848,156979,12029,307188,12778,6152,6626
52610,326067,18851,156994,12031,307216,12779,6152,6627
52615,326098,18855,157009,12033,307243,12780,6153,6627
52620,326129,18857,157023,12034,307272,12781,6154,6627
52625,326160,18860,157037,12035,307300,12781,6154,6627
52630,326191,18862,157054,12037,307329,12781,6154,6627
52635,326222,18864,157070,12039,307358,12782,6154,6628
52640,326253,18867,157090,12042,307386,12783,6155,6628
52645,326284,18869,157106,12044,307415,12784,6155,6629
52650,326315,18871,157119,12045,307444,12785,6156,6629
52655,326346,18874,157137,12046,307472,12786,6157,6629
52660,326377,18876,157153,12046,307501,12787,6157,6630
52665,326408,18879,157165,12047,307529,12787,6157,6630
52670,326439,18883,157178,12051,307556,12788,6158,6630
52675,326470,18887,157190,12053,307583,12789,6158,6631
52680,326501,18891,157203,12056,307610,12790,6159,6631
52685,326532,18894,157219,12059,307638,12791,6159,6632
52690,326563,18896,157232,12060,307667,12792,6159,6633
52695,326594,18896,157248,12060,307698,12792,6159,6633
52700,326625,18896,157260,12060,307729,12792,6159,6633
52705,326656,18896,157270,12060,307760,12792,6159,6633
52710,326687,18896,157282,12060,307791,12792,6159,6633
52715,326718,18896,157299,12060,307822,12792,6159,6633
52720,326749,18896,157312,12060,307853,12792,6159,6633
52725,326780,18896,157326,12060,307884,12792,6159,6633
52730,326811,18896,157337,12060,307915,12793,6159,6634
52735,326842,18896,157353,12060,307946,12794,6159,6635
52740,326873,18896,157369,12060,307977,12795,6160,6635
52745,326904,18896,157381,12060,308008,12797,6160,6637
52750,326935,18896,157394,12060,308039,12799,6161,6638
52755,326966,18896,157411,12060,308070,12801,6163,6638
52760,326997,18896,157427,12060,308101,12802,6163,6639
52765,327028,18896,157447,12060,308132,12803,6163,6640
52770,327059,18896,157459,12060,308163,12804,6164,6640
52775,327090,18896,157473,12060,308194,12805,6165,6640
52780,327121,18896,157485,12060,308225,12806,6165,6641
52785,327152,18897,157499,12061,308255,12807,6165,6642
52790,327183,18898,157509,12061,308285,12808,6166,6642
52795,327214,18900,157523,12062,308314,12809,6167,6642
52800,327245,18905,157534,12064,308340,12810,6167,6643
52805,327276,18909,157544,12066,308367,12811,6168,6643
52810,327307,18913,157560,12069,308394,12812,6168,6644
52815,327338,18916,157575,12070,308422,12813,6169,6644
52820,327369,18919,157592,12073,308450,12814,6170,6644
52825,327400,18922,157607,12075,308478,12815,6171,6644
52830,327431,18926,157623,12077,308505,12816,6171,6645
52835,327462,18928,157634,12078,308534,12817,6171,6646
52840,327493,18931,157652,12080,308562,12818,6171,6647
52845,327524,18933,157664,12081,308591,12819,6171,6648
52850,327555,18935,157675,12083,308620,12820,6171,6649
52855,327586,18937,157690,12084,308649,12821,6172,6649
52860,327617,18940,157708,12086,308677,12823,6173,6650
52865,327648,18941,157726,12087,308707,12824,6173,6651
52870,327679,18942,157740,12087,308737,12825,6173,6652
52875,327710,18944,157754,12089,308766,12826,6174,6652
52880,327741,18946,157772,12091,308795,12827,6175,6652
52885,327772,18947,157786,12092,308825,12828,6176,6652
52890,327803,18948,157799,12093,308855,12829,6176,6653
52895,327834,18950,157815,12094,308884,12831,6177,6654
52900,327865,18950,157831,12094,308915,12833,6177,6656
52905,327896,18950,157848,12094,308946,12835,6178,6657
52910,327927,18950,157863,12094,308977,12837,6179,6658
52915,327958,18951,157877,12094,309007,12839,6181,6658
52920,327989,18952,157892,12095,309037,12841,6182,6659
52925,328020,18954,157913,12096,309066,12842,6183,6659
52930,328051,18956,157925,12097,309095,12843,6183,6660
52935,328082,18959,157938,12098,309123,12844,6183,6661
52940,328113,18962,157952,12099,309151,12845,6184,6661
52945,328144,18964,157967,12099,309180,12846,6184,6662
52950,328175,18966,157978,12100,309209,12847,6184,6663
52955,328206,18968,157993,12101,309238,12848,6185,6663
52960,328237,18971,158007,12103,309266,12849,6186,6663
52965,328268,18974,158027,12105,309294,12850,6186,6664
52970,328299,18977,158041,12107,309322,12851,6186,6665
52975,328330,18978,158058,12108,309352,12852,6187,6665
52980,328361,18979,158071,12109,309382,12854,6187,6667
52985,328392,18980,158087,12110,309412,12856,6189,6667
52990,328423,18981,158105,12111,309442,12858,6191,6667
52995,328454,18982,158116,12112,309472,12860,6191,6669
53000,328485,18983,158131,12113,309502,12862,6191,6671
53005,328516,18984,158148,12113,309532,12864,6192,6672
53010,328547,18985,158161,12113,309562,12866,6193,6673
53015,328578,18986,158179,12113,309592,12868,6195,6673
53020,328609,18987,158197,12113,309622,12870,6196,6674
53025,328640,18989,158210,12114,309650,12873,6199,6674
53030,328671,18993,158224,12117,309678,12875,6200,6675
53035,328702,18994,158237,12118,309708,12877,6201,6676
53040,328733,18995,158250,12119,309738,12879,6202,6677
53045,328764,18997,158264,12121,309767,12880,6202,6678
53050,328795,19001,158283,12124,309794,12881,6203,6678
53055,328826,19003,158294,12125,309823,12882,6203,6679
53060,328857,19006,158306,12126,309851,12883,6203,6680
53065,328888,19009,158323,12128,309879,12884,6203,6681
53070,328919,19011,158338,12130,309908,12885,6203,6682
53075,328950,19014,158355,12132,309936,12886,6203,6683
53080,328981,19017,158364,12133,309964,12887,6203,6684
53085,329012,19020,158384,12135,309992,12888,6203,6685
53090,329043,19023,158400,12137,310020,12889,6203,6686
53095,329074,19025,158415,12137,310049,12890,6204,6686
53100,329105,19027,158431,12138,310078,12891,6205,6686
53105,329136,19030,158446,12141,310106,12893,6206,6687
53110,329167,19031,158462,12142,310136,12895,6208,6687
53115,329198,19032,158481,12142,310166,12897,6210,6687
53120,329229,19033,158497,12143,310196,12899,6211,6688
53125,329260,19034,158510,12143,310226,12901,6211,6690
53130,329291,19035,158525,12144,310256,12902,6211,6691
53135,329322,19036,158539,12145,310286,12903,6212,6691
53140,329353,19037,158553,12146,310316,12904,6213,6691
53145,329384,19038,158568,12147,310346,12906,6214,6692
53150,329415,19039,158587,12147,310375,12908,6215,6693
53155,329446,19043,158605,12149,310403,12910,6216,6694
53160,329477,19045,158620,12151,310431,12912,6217,6695
53165,329508,19048,158634,12154,310460,12913,6217,6696
53170,329539,19051,158648,12156,310488,12914,6217,6697
53175,329570,19053,158661,12158,310517,12915,6217,6698
53180,329601,19055,158676,12160,310546,12916,6217,6699
53185,329632,19056,158692,12160,310576,12917,6218,6699
53190,329663,19057,158711,12161,310606,12918,6219,6699
53195,329694,19058,158726,12162,310636,12919,6220,6699
53200,329725,19059,158741,12163,310666,12920,6220,6700
53205,329756,19060,158754,12164,310696,12921,6220,6701
53210,329787,19061,158774,12165,310726,12922,6221,6701
53215,329818,19063,158785,12166,310755,12923,6221,6702
53220,329849,19065,158802,12167,310784,12924,6222,6702
53225,329880,19066,158819,12168,310814,12925,6222,6703
53230,329911,19067,158835,12168,310844,12927,6223,6704
53235,329942,19068,158849,12168,310874,12929,6224,6705
53240,329973,19069,158859,12168,310904,12931,6225,6706
53245,330004,19070,158873,12169,310934,12932,6226,6706
53250,330035,19071,158890,12169,310964,12933,6227,6706
53255,330066,19072,158907,12170,310994,12934,6228,6706
53260,330097,19073,158921,12170,311024,12935,6229,6706
53265,330128,19074,158934,12170,311054,12936,6230,6706
53270,330159,19078,158948,12172,311080,12938,6231,6707
53275,330190,19082,158968,12175,311107,12939,6232,6707
53280,330221,19085,158982,12177,311135,12940,6232,6708
53285,330252,19090,158994,12180,311162,12941,6233,6708
53290,330283,19093,159007,12182,311190,12942,6233,6709
53295,330314,19098,159017,12184,311215,12943,6233,6710
53300,330345,19102,159031,12186,311243,12944,6233,6711
53305,330376,19105,159045,12188,311270,12945,6233,6712
53310,330407,19110,159061,12192,311297,12946,6234,6712
53315,330438,19112,159075,12193,311325,12947,6235,6712
53320,330469,19115,159093,12195,311354,12948,6236,6712
53325,330500,19117,159109,12195,311383,12949,6237,6712
53330,330531,19120,159126,12198,311410,12950,6237,6713
53335,330562,19123,159138,12200,311439,12951,6238,6713
53340,330593,19126,159158,12202,311467,12952,6238,6714
53345,330624,19129,159173,12203,311494,12953,6239,6714
53350,330655,19132,159187,12206,311523,12954,6239,6715
53355,330686,19134,159205,12208,311551,12955,6239,6716
53360,330717,19137,159218,12209,311580,12956,6239,6717
53365,330748,19139,159231,12210,311608,12957,6240,6717
53370,330779,19141,159243,12212,311638,12958,6240,6718
53375,330810,19142,159255,12212,311668,12959,6241,6718
53380,330841,19143,159268,12213,311698,12960,6241,6719
53385,330872,19144,159287,12213,311728,12961,6242,6719
53390,330903,19144,159297,12213,311759,12962,6242,6720
53395,330934,19144,159310,12213,311790,12964,6243,6721
53400,330965,19144,159325,12213,311821,12966,6243,6723
53405,330996,19145,159339,12214,311851,12967,6243,6724
53410,331027,19145,159351,12214,311882,12968,6243,6725
53415,331058,19145,159367,12214,311913,12969,6243,6726
53420,331089,19147,159383,12216,311942,12970,6243,6727
53425,331120,19148,159400,12217,311972,12971,6243,6728
53430,331151,19149,159415,12218,312002,12972,6243,6729
53435,331182,19151,159434,12220,312031,12973,6243,6730
53440,331213,19152,159447,12221,312061,12974,6243,6731
53445,331244,19153,159464,12221,312091,12975,6244,6731
53450,331275,19155,159478,12222,312120,12976,6244,6732
53455,331306,19157,159492,12223,312149,12977,6244,6733
53460,331337,19159,159508,12225,312178,12978,6244,6734
53465,331368,19162,159523,12227,312206,12978,6244,6734
53470,331399,19165,159537,12229,312234,12978,6244,6734
53475,331430,19167,159551,12231,312263,12978,6244,6734
53480,331461,19169,159560,12231,312292,12978,6244,6734
53485,331492,19171,159573,12231,312321,12978,6244,6734
53490,331523,19173,159588,12232,312350,12978,6244,6734
53495,331554,19175,159607,12234,312379,12978,6244,6734
53500,331585,19177,159619,12234,312408,12978,6244,6734
53505,331616,19179,159631,12235,312437,12978,6244,6734
53510,331647,19183,159643,12238,312464,12980,6245,6735
53515,331678,19186,159661,12239,312491,12982,6246,6736
53520,331709,19190,159674,12242,312519,12984,6247,6737
53525,331740,19191,159689,12242,312549,12984,6247,6737
53530,331771,19192,159705,12243,312579,12984,6247,6737
53535,331802,19193,159722,12243,312609,12984,6247,6737
53540,331833,19194,159741,12243,312639,12984,6247,6737
53545,331864,19195,159758,12243,312669,12984,6247,6737
53550,331895,19196,159774,12243,312699,12984,6247,6737
53555,331926,19197,159790,12244,312729,12984,6247,6737
53560,331957,19198,159802,12245,312759,12984,6247,6737
53565,331988,19199,159820,12245,312789,12984,6247,6737
53570,332019,19201,159839,12247,312818,12985,6248,6737
53575,332050,19201,159858,12247,312849,12986,6249,6737
53580,332081,19201,159874,12247,312880,12987,6249,6738
53585,332112,19201,159888,12247,312911,12988,6249,6739
53590,332143,19201,159902,12247,312942,12989,6249,6740
53595,332174,19201,159918,12247,312973,12990,6249,6741
53600,332205,19201,159930,12247,313004,12991,6249,6742
53605,332236,19201,159941,12247,313035,12992,6250,6742
53610,332267,19201,159953,12247,313066,12993,6250,6743
53615,332298,19201,159967,12247,313097,12994,6251,6743
53620,332329,19203,159980,12248,313126,12995,6252,6743
53625,332360,19204,159996,12248,313156,12996,6253,6743
53630,332391,19207,160012,12251,313183,12998,6254,6744
53635,332422,19211,160026,12254,313210,13001,6255,6746
53640,332453,19214,160041,12256,313239,13003,6255,6748
53645,332484,19220,160060,12261,313264,13005,6256,6749
53650,332515,19224,160072,12264,313291,13007,6257,6750
53655,332546,19225,160089,12264,313321,13008,6258,6750
53660,332577,19226,160106,12265,313351,13009,6258,6751
53665,332608,19227,160123,12265,313381,13010,6259,6751
53670,332639,19228,160136,12265,313411,13011,6259,6752
53675,332670,19230,160148,12266,313440,13012,6260,6752
53680,332701,19231,160162,12267,313470,13013,6260,6753
53685,332732,19231,160178,12267,313501,13014,6261,6753
53690,332763,19233,160195,12268,313530,13015,6261,6754
53695,332794,19235,160213,12270,313559,13016,6262,6754
53700,332825,19237,160229,12271,313588,13017,6262,6755
53705,332856,19239,160243,12272,313617,13018,6262,6756
53710,332887,19241,160261,12274,313646,13019,6262,6757
53715,332918,19243,160274,12275,313675,13020,6263,6757
53720,332949,19244,160288,12275,313705,13021,6264,6757
53725,332980,19246,160299,12276,313734,13022,6265,6757
53730,333011,19248,160312,12278,313763,13023,6266,6757
53735,333042,19249,160327,12279,313793,13024,6266,6758
53740,333073,19250,160341,12279,313823,13026,6268,6758
53745,333104,19251,160358,12279,313853,13028,6269,6759
53750,333135,19253,160369,12281,313882,13030,6270,6760
53755,333166,19253,160386,12281,313912,13031,6270,6761
53760,333197,19256,160402,12283,313941,13033,6270,6763
53765,333228,19260,160415,12286,313968,13035,6272,6763
53770,333259,19262,160426,12287,313997,13037,6273,6764
53775,333290,19264,160447,12289,314026,13039,6274,6765
53780,333321,19266,160458,12289,314055,13041,6274,6767
53785,333352,19268,160473,12289,314084,13043,6275,6768
53790,333383,19271,160486,12291,314112,13045,6276,6769
53795,333414,19275,160503,12294,314139,13047,6277,6770
53800,333445,19278,160512,12296,314167,13049,6277,6772
53805,333476,19282,160527,12298,314194,13051,6278,6773
53810,333507,19286,160543,12302,314221,13053,6280,6773
53815,333538,19289,160558,12304,314249,13054,6280,6774
53820,333569,19291,160576,12305,314278,13055,6280,6775
53825,333600,19293,160590,12305,314307,13057,6281,6776
53830,333631,19296,160604,12307,314335,13059,6282,6777
53835,333662,19299,160622,12308,314363,13061,6283,6778
53840,333693,19300,160643,12309,314393,13062,6283,6779
53845,333724,19301,160654,12309,314423,13063,6284,6779
53850,333755,19303,160667,12310,314452,13064,6284,6780
53855,333786,19304,160685,12311,314482,13066,6286,6780
53860,333817,19305,160699,12311,314512,13068,6286,6782
53865,333848,19306,160709,12311,314542,13070,6287,6783
53870,333879,19307,160725,12311,314572,13072,6288,6784
53875,333910,19309,160739,12312,314601,13074,6290,6784
53880,333941,19310,160752,12312,314631,13075,6290,6785
53885,333972,19313,160768,12315,314659,13076,6291,6785
53890,334003,19316,160785,12317,314687,13077,6292,6785
53895,334034,19319,160803,12319,314715,13078,6292,6786
53900,334065,19320,160818,12319,314745,13079,6292,6787
53905,334096,19321,160830,12320,314775,13080,6292,6788
53910,334127,19322,160841,12320,314805,13081,6293,6788
53915,334158,19323,160857,12320,314835,13082,6293,6789
53920,334189,19324,160877,12320,314865,13083,6293,6790
53925,334220,19326,160893,12321,314894,13084,6293,6791
53930,334251,19327,160906,12321,314924,13085,6293,6792
53935,334282,19328,160920,12321,314954,13086,6294,6792
53940,334313,19329,160934,12322,314984,13087,6294,6793
53945,334344,19331,160945,12324,315013,13088,6294,6794
53950,334375,19331,160960,12324,315044,13089,6294,6795
53955,334406,19331,160969,12324,315075,13090,6294,6796
53960,334437,19331,160986,12324,315106,13091,6294,6797
53965,334468,19331,161003,12324,315137,13092,6294,6798
53970,334499,19331,161017,12324,315168,13093,6295,6798
53975,334530,19331,161032,12324,315199,13094,6295,6799
53980,334561,19331,161049,12324,315230,13096,6295,6801
53985,334592,19331,161067,12324,315261,13098,6297,6801
53990,334623,19332,161080,12324,315291,13100,6299,6801
53995,334654,19334,161095,12325,315320,13102,6300,6802
54000,334685,19335,161110,12326,315350,13104,6300,6804
54005,334716,19338,161125,12328,315378,13105,6300,6805
54010,334747,19341,161141,12329,315405,13106,6300,6806
54015,334778,19345,161154,12331,315432,13107,6301,6806
54020,334809,19349,161166,12334,315459,13108,6301,6807
54025,334840,19353,161179,12337,315486,13109,6301,6808
54030,334871,19358,161191,12340,315512,13110,6301,6809
54035,334902,19362,161202,12342,315540,13111,6301,6810
54040,334933,19366,161222,12345,315566,13112,6302,6810
54045,334964,19371,161239,12348,315593,13113,6303,6810
54050,334995,19373,161249,12348,315622,13114,6303,6811
54055,335026,19376,161266,12351,315650,13115,6304,6811
54060,335057,19378,161284,12352,315679,13116,6305,6811
54065,335088,19381,161297,12354,315707,13118,6306,6812
54070,335119,19383,161310,12354,315736,13120,6308,6812
54075,335150,19385,161326,12355,315765,13121,6308,6813
54080,335181,19388,161346,12356,315793,13122,6309,6813
54085,335212,19391,161367,12359,315821,13123,6310,6813
54090,335243,19394,161385,12360,315849,13124,6311,6813
54095,335274,19396,161398,12360,315878,13125,6311,6814
54100,335305,19399,161415,12362,315906,13126,6311,6815
54105,335336,19401,161429,12362,315935,13127,6311,6816
54110,335367,19404,161445,12363,315963,13128,6312,6816
54115,335398,19407,161459,12365,315991,13129,6313,6816
54120,335429,19408,161473,12366,316021,13130,6313,6817
54125,335460,19410,161484,12367,316050,13132,6313,6819
54130,335491,19411,161500,12368,316079,13133,6313,6820
54135,335522,19414,161513,12370,316107,13134,6313,6821
54140,335553,19415,161526,12371,316138,13135,6314,6821
54145,335584,19415,161538,12371,316169,13136,6314,6822
54150,335615,19416,161550,12372,316199,13137,6314,6823
54155,335646,19417,161564,12372,316229,13138,6315,6823
54160,335677,19418,161581,12373,316258,13139,6316,6823
54165,335708,19420,161595,12375,316288,13140,6317,6823
54170,335739,19421,161611,12375,316318,13141,6317,6824
54175,335770,19422,161630,12376,316348,13142,6317,6825
54180,335801,19423,161648,12376,316377,13143,6318,6825
54185,335832,19427,161661,12380,316405,13144,6319,6825
54190,335863,19431,161679,12384,316432,13144,6319,6825
54195,335894,19434,161697,12386,316460,13144,6319,6825
54200,335925,19438,161710,12390,316487,13144,6319,6825
54205,335956,19440,161724,12391,316516,13144,6319,6825
54210,335987,19441,161740,12391,316546,13144,6319,6825
54215,336018,19442,161756,12392,316576,13144,6319,6825
54220,336049,19443,161769,12392,316606,13144,6319,6825
54225,336080,19444,161786,12393,316636,13144,6319,6825
54230,336111,19445,161802,12394,316666,13144,6319,6825
54235,336142,19446,161820,12394,316696,13144,6319,6825
54240,336173,19447,161836,12394,316726,13144,6319,6825
54245,336204,19449,161850,12394,316755,13144,6319,6825
54250,336235,19453,161867,12397,316782,13144,6319,6825
54255,336266,19456,161879,12398,316810,13144,6319,6825
54260,336297,19459,161893,12399,316838,13144,6319,6825
54265,336328,19462,161912,12402,316866,13144,6319,6825
54270,336359,19465,161923,12404,316894,13144,6319,6825
54275,336390,19467,161938,12406,316923,13144,6319,6825
54280,336421,19469,161951,12408,316952,13144,6319,6825
54285,336452,19472,161961,12410,316980,13144,6319,6825
54290,336483,19475,161977,12412,317008,13145,6320,6825
54295,336514,19478,161990,12415,317036,13146,6320,6826
54300,336545,19481,162000,12416,317063,13148,6320,6828
54305,336576,19483,162019,12418,317093,13150,6320,6830
54310,336607,19485,162036,12419,317122,13152,6322,6830
54315,336638,19489,162055,12422,317149,13153,6322,6831
54320,336669,19491,162077,12423,317178,13154,6322,6832
54325,336700,19493,162092,12424,317207,13155,6322,6833
54330,336731,19495,162106,12426,317236,13156,6322,6834
54335,336762,19496,162120,12427,317266,13157,6323,6834
54340,336793,19497,162130,12428,317296,13158,6323,6835
54345,336824,19499,162146,12429,317325,13159,6324,6835
54350,336855,19500,162154,12429,317355,13160,6324,6836
54355,336886,19501,162167,12430,317385,13161,6324,6837
54360,336917,19502,162177,12431,317415,13162,6324,6838
54365,336948,19504,162197,12433,317444,13163,6325,6838
54370,336979,19506,162210,12435,317473,13164,6325,6839
54375,337010,19507,162223,12435,317503,13165,6325,6840
54380,337041,19507,162238,12435,317534,13166,6325,6841
54385,337072,19507,162254,12435,317565,13167,6325,6842
54390,337103,19507,162272,12435,317596,13168,6325,6843
54395,337134,19507,162286,12435,317627,13169,6325,6844
54400,337165,19507,162301,12435,317658,13170,6326,6844
54405,337196,19507,162316,12435,317689,13171,6327,6844
54410,337227,19507,162330,12435,317720,13172,6328,6844
54415,337258,19508,162346,12436,317750,13173,6329,6844
54420,337289,19510,162361,12437,317779,13174,6329,6845
54425,337320,19514,162376,12439,317805,13176,6330,6846
54430,337351,19519,162391,12442,317832,13178,6331,6847
54435,337382,19523,162403,12444,317858,13180,6332,6848
54440,337413,19529,162420,12449,317883,13182,6334,6848
54445,337444,19533,162431,12451,317911,13184,6334,6850
54450,337475,19537,162444,12453,317937,13186,6335,6851
54455,337506,19542,162457,12456,317964,13188,6337,6851
54460,337537,19545,162476,12458,317992,13190,6338,6852
54465,337568,19549,162494,12462,318018,13192,6338,6854
54470,337599,19554,162508,12465,318045,13194,6339,6855
54475,337630,19558,162524,12469,318071,13196,6339,6857
54480,337661,19561,162537,12471,318099,13198,6341,6857
54485,337692,19563,162554,12472,318129,13199,6342,6857
54490,337723,19564,162567,12472,318159,13200,6342,6858
54495,337754,19565,162583,12472,318189,13201,6342,6859
54500,337785,19566,162591,12472,318219,13202,6342,6860
54505,337816,19567,162607,12473,318249,13203,6342,6861
54510,337847,19568,162620,12474,318279,13204,6342,6862
54515,337878,19569,162634,12474,318309,13205,6343,6862
54520,337909,19570,162647,12475,318339,13206,6343,6863
54525,337940,19571,162661,12475,318369,13207,6343,6864
54530,337971,19573,162674,12476,318398,13208,6344,6864
54535,338002,19575,162688,12477,318427,13209,6344,6865
54540,338033,19575,162704,12477,318458,13210,6345,6865
54545,338064,19575,162721,12477,318489,13211,6346,6865
54550,338095,19575,162733,12477,318520,13212,6346,6866
54555,338126,19575,162749,12477,318551,13213,6347,6866
54560,338157,19575,162765,12477,318582,13214,6348,6866
54565,338188,19575,162780,12477,318613,13215,6349,6866
54570,338219,19575,162793,12477,318644,13216,6349,6867
54575,338250,19575,162805,12477,318675,13217,6349,6868
54580,338281,19575,162821,12477,318706,13218,6350,6868
54585,338312,19576,162842,12478,318736,13219,6350,6869
54590,338343,19578,162856,12479,318765,13220,6350,6870
54595,338374,19580,162870,12480,318794,13221,6351,6870
54600,338405,19582,162885,12481,318823,13222,6352,6870
54605,338436,19585,162896,12483,318851,13223,6352,6871
54610,338467,19588,162914,12486,318878,13224,6352,6872
54615,338498,19591,162925,12488,318907,13225,6352,6873
54620,338529,19595,162939,12491,318934,13226,6352,6874
54625,338560,19597,162955,12493,318962,13227,6353,6874
54630,338591,19599,162970,12495,318991,13228,6353,6875
54635,338622,19601,162986,12496,319020,13229,6354,6875
54640,338653,19603,163004,12498,319050,13230,6355,6875
54645,338684,19604,163021,12498,319079,13231,6356,6875
54650,338715,19607,163039,12500,319108,13233,6357,6876
54655,338746,19610,163059,12502,319136,13235,6358,6877
54660,338777,19613,163076,12505,319164,13236,6358,6878
54665,338808,19615,163092,12507,319193,13237,6359,6878
54670,338839,19618,163106,12509,319221,13238,6360,6878
54675,338870,19619,163122,12509,319251,13239,6361,6878
54680,338901,19620,163139,12509,319281,13240,6361,6879
54685,338932,19621,163150,12509,319311,13241,6361,6880
54690,338963,19623,163167,12511,319340,13242,6362,6880
54695,338994,19625,163181,12513,319369,13243,6362,6881
54700,339025,19626,163200,12513,319399,13244,6362,6882
54705,339056,19628,163221,12515,319428,13245,6362,6883
54710,339087,19629,163234,12516,319458,13246,6363,6883
54715,339118,19629,163248,12516,319489,13247,6363,6884
54720,339149,19629,163266,12516,319520,13248,6364,6884
54725,339180,19629,163284,12516,319551,13249,6364,6885
54730,339211,19630,163299,12517,319581,13250,6365,6885
54735,339242,19631,163314,12517,319611,13251,6365,6886
54740,339273,19632,163328,12517,319641,13252,6365,6887
54745,339304,19633,163348,12518,319671,13253,6365,6888
54750,339335,19634,163361,12519,319701,13254,6366,6888
54755,339366,19635,163378,12520,319731,13255,6367,6888
54760,339397,19636,163393,12521,319761,13256,6368,6888
54765,339428,19637,163405,12522,319791,13257,6368,6889
54770,339459,19641,163420,12525,319817,13258,6368,6890
54775,339490,19645,163432,12528,319844,13259,6368,6891
54780,339521,19648,163446,12531,319873,13260,6368,6892
54785,339552,19650,163458,12531,319902,13261,6368,6893
54790,339583,19652,163473,12532,319931,13263,6369,6894
54795,339614,19655,163492,12535,319959,13265,6370,6895
54800,339645,19658,163511,12537,319987,13267,6372,6895
54805,339676,19660,163524,12538,320016,13268,6373,6895
54810,339707,19662,163538,12538,320045,13269,6374,6895
54815,339738,19664,163555,12539,320074,13270,6375,6895
54820,339769,19666,163567,12539,320103,13271,6375,6896
54825,339800,19669,163579,12542,320131,13272,6376,6896
54830,339831,19672,163596,12544,320159,13273,6377,6896
54835,339862,19674,163611,12545,320188,13274,6378,6896
54840,339893,19676,163626,12545,320217,13275,6379,6896
54845,339924,19679,163641,12546,320245,13276,6380,6896
54850,339955,19683,163653,12547,320272,13277,6381,6896
54855,339986,19686,163669,12549,320300,13278,6382,6896
54860,340017,19689,163685,12550,320328,13279,6383,6896
54865,340048,19692,163699,12551,320356,13280,6384,6896
54870,340079,19695,163710,12553,320384,13281,6384,6897
54875,340110,19698,163726,12555,320412,13282,6384,6898
54880,340141,19701,163737,12558,320440,13283,6384,6899
54885,340172,19704,163750,12558,320468,13285,6385,6900
54890,340203,19707,163765,12560,320496,13287,6385,6902
54895,340234,19710,163778,12560,320523,13290,6386,6904
54900,340265,19715,163796,12562,320550,13292,6388,6904
54905,340296,19716,163811,12563,320580,13293,6389,6904
54910,340327,19717,163825,12564,320610,13294,6389,6905
54915,340358,19719,163840,12565,320639,13295,6390,6905
54920,340389,19720,163853,12566,320669,13296,6391,6905
54925,340420,19722,163866,12567,320698,13297,6391,6906
54930,340451,19724,163882,12568,320727,13298,6391,6907
54935,340482,19725,163896,12569,320757,13299,6392,6907
54940,340513,19727,163919,12570,320786,13300,6393,6907
54945,340544,19729,163934,12571,320815,13301,6393,6908
54950,340575,19730,163946,12572,320845,13302,6394,6908
54955,340606,19731,163961,12572,320875,13303,6394,6909
54960,340637,19732,163976,12573,320905,13304,6394,6910
54965,340668,19732,163990,12573,320936,13305,6394,6911
54970,340699,19732,164002,12573,320967,13306,6394,6912
54975,340730,19732,164016,12573,320998,13307,6394,6913
54980,340761,19732,164030,12573,321029,13308,6394,6914
54985,340792,19732,164045,12573,321060,13309,6395,6914
54990,340823,19732,164059,12573,321091,13310,6396,6914
54995,340854,19732,164068,12573,321122,13311,6397,6914
55000,340885,19732,164084,12573,321153,13312,6398,6914
55005,340916,19734,164101,12575,321182,13314,6398,6916
55010,340947,19737,164117,12578,321210,13317,6401,6916
55015,340978,19739,164129,12578,321239,13320,6402,6918
55020,341009,19743,164147,12582,321265,13323,6404,6919
55025,341040,19747,164156,12584,321293,13324,6404,6920
55030,341071,19751,164173,12586,321320,13325,6405,6920
55035,341102,19756,164189,12589,321346,13326,6405,6921
55040,341133,19758,164209,12590,321375,13327,6406,6921
55045,341164,19761,164225,12592,321403,13328,6407,6921
55050,341195,19763,164240,12593,321432,13329,6408,6921
55055,341226,19766,164253,12594,321460,13330,6408,6922
55060,341257,19770,164274,12597,321487,13331,6409,6922
55065,341288,19772,164286,12597,321516,13332,6410,6922
55070,341319,19774,164302,12599,321545,13333,6411,6922
55075,341350,19776,164316,12600,321574,13334,6412,6922
55080,341381,19778,164329,12600,321603,13335,6413,6922
55085,341412,19778,164342,12600,321634,13335,6413,6922
55090,341443,19778,164358,12600,321665,13335,6413,6922
55095,341474,19778,164373,12600,321696,13335,6413,6922
55100,341505,19778,164384,12600,321727,13335,6413,6922
55105,341536,19778,164400,12600,321758,13335,6413,6922
55110,341567,19778,164411,12600,321789,13335,6413,6922
55115,341598,19778,164428,12600,321820,13335,6413,6922
55120,341629,19778,164443,12600,321851,13335,6413,6922
55125,341660,19778,164460,12600,321882,13336,6413,6923
55130,341691,19778,164477,12600,321913,13337,6413,6924
55135,341722,19778,164495,12600,321944,13339,6415,6924
55140,341753,19780,164511,12602,321973,13341,6415,6926
55145,341784,19783,164525,12604,322001,13342,6415,6927
55150,341815,19786,164540,12605,322029,13343,6415,6928
55155,341846,19789,164551,12605,322057,13344,6415,6929
55160,341877,19792,164570,12607,322085,13345,6416,6929
55165,341908,19795,164585,12607,322113,13346,6417,6929
55170,341939,19798,164604,12609,322141,13347,6417,6930
55175,341970,19801,164621,12611,322169,13348,6417,6931
55180,342001,19804,164639,12613,322197,13349,6417,6932
55185,342032,19807,164657,12614,322225,13350,6418,6932
55190,342063,19810,164671,12616,322253,13351,6419,6932
55195,342094,19813,164685,12617,322281,13352,6420,6932
55200,342125,19816,164700,12617,322309,13353,6421,6932
55205,342156,19819,164712,12617,322337,13354,6422,6932
55210,342187,19821,164730,12617,322366,13355,6423,6932
55215,342218,19824,164742,12619,322394,13356,6423,6933
55220,342249,19826,164757,12621,322423,13357,6423,6934
55225,342280,19828,164772,12623,322452,13358,6424,6934
55230,342311,19830,164785,12623,322481,13359,6424,6935
55235,342342,19832,164801,12624,322510,13360,6425,6935
55240,342373,19835,164817,12626,322538,13361,6425,6936
55245,342404,19836,164832,12627,322568,13363,6426,6937
55250,342435,19837,164844,12628,322598,13365,6426,6939
55255,342466,19839,164862,12630,322627,13367,6427,6940
55260,342497,19839,164874,12630,322658,13369,6427,6942
55265,342528,19839,164884,12630,322689,13370,6427,6943
55270,342559,19839,164904,12630,322720,13371,6427,6944
55275,342590,19839,164920,12630,322751,13372,6427,6945
55280,342621,19839,164933,12630,322782,13373,6427,6946
55285,342652,19839,164952,12630,322813,13374,6427,6947
55290,342683,19839,164968,12630,322844,13375,6427,6948
55295,342714,19839,164977,12630,322875,13376,6427,6949
55300,342745,19839,164995,12630,322906,13377,6428,6949
55305,342776,19839,165016,12630,322937,13378,6429,6949
55310,342807,19840,165032,12631,322967,13379,6429,6950
55315,342838,19842,165051,12633,322996,13380,6429,6951
55320,342869,19843,165065,12633,323026,13381,6430,6951
55325,342900,19845,165075,12635,323055,13382,6430,6952
55330,342931,19846,165085,12635,323085,13383,6431,6952
55335,342962,19847,165101,12635,323115,13384,6432,6952
55340,342993,19849,165117,12636,323144,13385,6432,6953
55345,343024,19850,165128,12636,323174,13386,6432,6954
55350,343055,19852,165143,12638,323203,13387,6433,6954
55355,343086,19855,165159,12640,323231,13388,6434,6954
55360,343117,19858,165177,12643,323259,13390,6435,6955
55365,343148,19862,165190,12644,323285,13393,6436,6957
55370,343179,19867,165201,12646,323311,13396,6437,6959
55375,343210,19874,165217,12650,323336,13398,6438,6960
55380,343241,19878,165233,12652,323363,13399,6439,6960
55385,343272,19881,165249,12655,323391,13399,6439,6960
55390,343303,19885,165269,12658,323418,13399,6439,6960
55395,343334,19889,165279,12660,323445,13399,6439,6960
55400,343365,19893,165295,12663,323472,13399,6439,6960
55405,343396,19896,165312,12665,323500,13399,6439,6960
55410,343427,19898,165326,12666,323529,13399,6439,6960
55415,343458,19901,165340,12668,323557,13399,6439,6960
55420,343489,19903,165356,12669,323586,13399,6439,6960
55425,343520,19906,165370,12672,323614,13399,6439,6960
55430,343551,19907,165384,12672,323644,13399,6439,6960
55435,343582,19908,165397,12672,323674,13399,6439,6960
55440,343613,19909,165410,12672,323704,13399,6439,6960
55445,343644,19910,165423,12673,323734,13399,6439,6960
55450,343675,19911,165440,12674,323764,13399,6439,6960
55455,343706,19912,165452,12675,323794,13399,6439,6960
55460,343737,19913,165466,12675,323824,13399,6439,6960
55465,343768,19914,165483,12676,323854,13399,6439,6960
55470,343799,19915,165499,12676,323884,13399,6439,6960
55475,343830,19916,165513,12676,323914,13400,6440,6960
55480,343861,19917,165536,12677,323944,13402,6441,6961
55485,343892,19919,165551,12678,323972,13404,6441,6963
55490,343923,19923,165567,12681,324000,13407,6442,6965
55495,343954,19925,165576,12681,324029,13409,6443,6966
55500,343985,19927,165589,12682,324058,13411,6444,6967
55505,344016,19930,165606,12685,324086,13412,6444,6968
55510,344047,19933,165621,12687,324114,13413,6445,6968
55515,344078,19935,165629,12687,324143,13414,6445,6969
55520,344109,19938,165645,12689,324171,13415,6446,6969
55525,344140,19940,165658,12689,324200,13416,6446,6970
55530,344171,19943,165676,12691,324228,13417,6446,6971
55535,344202,19946,165692,12694,324256,13418,6447,6971
55540,344233,19949,165712,12696,324284,13419,6448,6971
55545,344264,19952,165724,12698,324312,13420,6448,6972
55550,344295,19955,165739,12699,324340,13421,6448,6973
55555,344326,19957,165754,12701,324369,13422,6448,6974
55560,344357,19959,165766,12701,324398,13423,6448,6975
55565,344388,19961,165784,12702,324427,13424,6448,6976
55570,344419,19963,165797,12703,324456,13425,6448,6977
55575,344450,19965,165809,12704,324485,13426,6448,6978
55580,344481,19967,165824,12704,324514,13427,6448,6979
55585,344512,19969,165835,12705,324543,13428,6449,6979
55590,344543,19971,165850,12705,324572,13429,6450,6979
55595,344574,19973,165861,12706,324601,13431,6450,6981
55600,344605,19975,165880,12707,324630,13433,6451,6982
55605,344636,19978,165889,12709,324658,13435,6451,6984
55610,344667,19981,165903,12711,324686,13437,6451,6986
55615,344698,19984,165920,12714,324714,13439,6453,6986
55620,344729,19985,165932,12714,324744,13440,6453,6987
55625,344760,19986,165949,12714,324774,13442,6454,6988
55630,344791,19988,165968,12716,324803,13444,6456,6988
55635,344822,19989,165981,12717,324833,13446,6457,6989
55640,344853,19990,165994,12718,324863,13448,6457,6991
55645,344884,19991,166009,12719,324893,13450,6458,6992
55650,344915,19992,166021,12719,324923,13452,6458,6994
55655,344946,19993,166036,12720,324953,13454,6460,6994
55660,344977,19995,166050,12721,324982,13456,6462,6994
55665,345008,19996,166062,12722,325012,13458,6462,6996
55670,345039,19998,166081,12724,325041,13460,6462,6998
55675,345070,19999,166093,12724,325071,13462,6463,6999
55680,345101,20001,166114,12725,325100,13464,6465,6999
55685,345132,20005,166130,12728,325127,13465,6465,7000
55690,345163,20008,166152,12731,325155,13466,6466,7000
55695,345194,20009,166169,12731,325185,13467,6466,7001
55700,345225,20010,166183,12732,325215,13468,6467,7001
55705,345256,20011,166197,12732,325245,13469,6468,7001
55710,345287,20012,166212,12732,325275,13470,6468,7002
55715,345318,20013,166228,12732,325305,13471,6469,7002
55720,345349,20014,166240,12732,325335,13472,6469,7003
55725,345380,20015,166253,12732,325365,13473,6469,7004
55730,345411,20018,166270,12734,325393,13474,6470,7004
55735,345442,20021,166278,12735,325421,13476,6470,7006
55740,345473,20025,166286,12739,325448,13477,6471,7006
55745,345504,20027,166299,12740,325477,13479,6473,7006
55750,345535,20031,166314,12743,325504,13480,6473,7007
55755,345566,20034,166329,12745,325532,13481,6473,7008
55760,345597,20036,166341,12746,325561,13482,6473,7009
55765,345628,20037,166357,12746,325591,13483,6473,7010
55770,345659,20038,166374,12746,325621,13484,6474,7010
55775,345690,20039,166396,12747,325651,13485,6475,7010
55780,345721,20040,166410,12748,325681,13486,6475,7011
55785,345752,20041,166423,12749,325711,13487,6476,7011
55790,345783,20042,166440,12749,325741,13488,6476,7012
55795,345814,20043,166455,12750,325771,13489,6477,7012
55800,345845,20044,166474,12750,325801,13490,6477,7013
55805,345876,20045,166482,12751,325831,13491,6477,7014
55810,345907,20046,166498,12751,325861,13492,6477,7015
55815,345938,20047,166512,12752,325891,13493,6477,7016
55820,345969,20048,166522,12752,325921,13494,6477,7017
55825,346000,20049,166537,12753,325951,13495,6478,7017
55830,346031,20050,166550,12754,325981,13496,6478,7018
55835,346062,20051,166564,12754,326011,13497,6479,7018
55840,346093,20052,166575,12754,326041,13499,6479,7020
55845,346124,20053,166594,12754,326071,13501,6480,7021
55850,346155,20054,166613,12755,326101,13502,6481,7021
55855,346186,20055,166624,12755,326131,13504,6481,7023
55860,346217,20056,166636,12755,326161,13506,6483,7023
55865,346248,20057,166649,12756,326190,13508,6484,7024
55870,346279,20060,166667,12758,326219,13510,6486,7024
55875,346310,20063,166684,12759,326247,13512,6487,7025
55880,346341,20065,166699,12761,326276,13514,6488,7026
55885,346372,20068,166714,12763,326304,13515,6489,7026
55890,346403,20071,166729,12764,326332,13516,6490,7026
55895,346434,20074,166747,12767,326360,13517,6490,7027
55900,346465,20078,166766,12770,326387,13518,6491,7027
55905,346496,20080,166779,12771,326416,13519,6492,7027
55910,346527,20082,166793,12771,326445,13520,6493,7027
55915,346558,20084,166804,12772,326474,13521,6493,7028
55920,346589,20088,166822,12776,326501,13522,6494,7028
55925,346620,20090,166841,12778,326530,13523,6494,7029
55930,346651,20092,166855,12780,326559,13524,6494,7030
55935,346682,20094,166871,12781,326588,13525,6494,7031
55940,346713,20097,166889,12784,326616,13526,6494,7032
55945,346744,20098,166906,12785,326646,13527,6494,7033
55950,346775,20102,166923,12787,326673,13529,6496,7033
55955,346806,20106,166934,12791,326700,13531,6496,7035
55960,346837,20108,166951,12792,326729,13533,6497,7036
55965,346868,20110,166965,12794,326758,13534,6498,7036
55970,346899,20113,166982,12796,326786,13535,6498,7037
55975,346930,20114,166999,12797,326816,13536,6499,7037
55980,346961,20115,167011,12798,326846,13537,6499,7038
55985,346992,20117,167019,12800,326875,13539,6500,7039
55990,347023,20118,167034,12801,326904,13541,6502,7039
55995,347054,20120,167051,12803,326934,13542,6502,7040
56000,347085,20121,167068,12803,326963,13543,6502,7041
56005,347116,20123,167081,12805,326993,13544,6503,7041
56010,347147,20124,167098,12806,327022,13545,6504,7041
56015,347178,20126,167115,12807,327051,13546,6504,7042
56020,347209,20128,167128,12809,327081,13547,6504,7043
56025,347240,20129,167142,12809,327111,13548,6504,7044
56030,347271,20130,167151,12809,327141,13549,6504,7045
56035,347302,20131,167164,12810,327171,13550,6504,7046
56040,347333,20132,167178,12810,327201,13551,6505,7046
56045,347364,20133,167190,12810,327231,13552,6505,7047
56050,347395,20134,167206,12810,327261,13553,6506,7047
56055,347426,20135,167225,12810,327291,13554,6507,7047
56060,347457,20138,167246,12812,327319,13555,6508,7047
56065,347488,20141,167259,12813,327347,13557,6508,7049
56070,347519,20144,167270,12815,327375,13559,6509,7050
56075,347550,20147,167281,12816,327403,13560,6509,7051
56080,347581,20151,167297,12818,327430,13561,6510,7051
56085,347612,20156,167314,12820,327456,13562,6511,7051
56090,347643,20159,167332,12822,327484,13563,6512,7051
56095,347674,20163,167344,12823,327511,13564,6513,7051
56100,347705,20166,167355,12824,327539,13565,6514,7051
56105,347736,20167,167364,12824,327569,13566,6514,7052
56110,347767,20168,167380,12824,327599,13567,6515,7052
56115,347798,20170,167397,12826,327627,13568,6516,7052
56120,347829,20173,167409,12829,327655,13569,6516,7053
56125,347860,20176,167423,12831,327683,13570,6516,7054
56130,347891,20178,167441,12833,327712,13571,6516,7055
56135,347922,20181,167460,12836,327740,13572,6517,7055
56140,347953,20183,167477,12838,327770,13573,6518,7055
56145,347984,20184,167490,12839,327800,13574,6518,7056
56150,348015,20185,167507,12840,327830,13575,6518,7057
56155,348046,20185,167520,12840,327861,13576,6518,7058
56160,348077,20185,167535,12840,327892,13577,6519,7058
56165,348108,20186,167549,12840,327922,13577,6519,7058
56170,348139,20187,167562,12840,327952,13577,6519,7058
56175,348170,20189,167573,12841,327981,13578,6519,7059
56180,348201,20189,167591,12841,328012,13579,6520,7059
56185,348232,20189,167604,12841,328043,13580,6521,7059
56190,348263,20189,167621,12841,328074,13580,6521,7059
56195,348294,20189,167633,12841,328105,13580,6521,7059
56200,348325,20189,167649,12841,328136,13580,6521,7059
56205,348356,20190,167665,12842,328166,13580,6521,7059
56210,348387,20192,167679,12842,328195,13580,6521,7059
56215,348418,20194,167697,12844,328224,13580,6521,7059
56220,348449,20196,167706,12845,328253,13580,6521,7059
56225,348480,20198,167724,12847,328282,13580,6521,7059
56230,348511,20200,167741,12848,328311,13580,6521,7059
56235,348542,20203,167753,12850,328339,13580,6521,7059
56240,348573,20205,167774,12852,328368,13580,6521,7059
56245,348604,20207,167790,12853,328397,13580,6521,7059
56250,348635,20210,167807,12856,328425,13580,6521,7059
56255,348666,20212,167821,12856,328454,13580,6521,7059
56260,348697,20214,167833,12857,328483,13580,6521,7059
56265,348728,20216,167846,12858,328512,13580,6521,7059
56270,348759,20218,167859,12859,328541,13581,6522,7059
56275,348790,20222,167872,12861,328568,13583,6522,7061
56280,348821,20225,167888,12864,328596,13585,6523,7062
56285,348852,20228,167904,12866,328624,13587,6523,7064
56290,348883,20231,167918,12868,328652,13590,6525,7065
56295,348914,20234,167934,12870,328680,13593,6526,7067
56300,348945,20236,167944,12871,328709,13595,6526,7069
56305,348976,20239,167961,12873,328737,13597,6526,7071
56310,349007,20242,167977,12875,328765,13599,6527,7072
56315,349038,20245,167995,12877,328793,13601,6529,7072
56320,349069,20247,168009,12878,328822,13602,6530,7072
56325,349100,20248,168023,12878,328852,13603,6530,7073
56330,349131,20250,168042,12879,328881,13604,6530,7074
56335,349162,20251,168055,12880,328911,13605,6531,7074
56340,349193,20252,168070,12880,328941,13606,6532,7074
56345,349224,20254,168087,12881,328970,13607,6533,7074
56350,349255,20256,168107,12882,328999,13608,6533,7075
56355,349286,20257,168119,12883,329029,13609,6534,7075
56360,349317,20258,168135,12884,329059,13610,6535,7075
56365,349348,20259,168152,12885,329089,13611,6535,7076
56370,349379,20260,168171,12886,329119,13612,6535,7077
56375,349410,20261,168184,12887,329149,13613,6535,7078
56380,349441,20262,168195,12887,329179,13614,6536,7078
56385,349472,20263,168213,12888,329209,13615,6536,7079
56390,349503,20266,168227,12889,329237,13616,6536,7080
56395,349534,20269,168239,12891,329265,13617,6537,7080
56400,349565,20272,168251,12892,329293,13618,6537,7081
56405,349596,20275,168268,12895,329321,13619,6537,7082
56410,349627,20277,168284,12896,329350,13620,6537,7083
56415,349658,20277,168296,12896,329381,13621,6538,7083
56420,349689,20277,168311,12896,329412,13622,6539,7083
56425,349720,20277,168325,12896,329443,13623,6540,7083
56430,349751,20277,168341,12896,329474,13624,6541,7083
56435,349782,20277,168356,12896,329505,13626,6542,7084
56440,349813,20277,168373,12896,329536,13628,6543,7085
56445,349844,20277,168384,12896,329567,13630,6544,7086
56450,349875,20277,168399,12896,329598,13632,6545,7087
56455,349906,20277,168408,12896,329629,13634,6546,7088
56460,349937,20277,168419,12896,329660,13636,6546,7090
56465,349968,20278,168433,12897,329690,13638,6547,7091
56470,349999,20279,168449,12897,329720,13640,6549,7091
56475,350030,20281,168466,12899,329749,13642,6551,7091
56480,350061,20282,168484,12899,329779,13644,6552,7092
56485,350092,20284,168502,12900,329808,13646,6554,7092
56490,350123,20287,168518,12902,329836,13648,6555,7093
56495,350154,20288,168529,12903,329866,13650,6557,7093
56500,350185,20290,168546,12905,329895,13652,6558,7094
56505,350216,20290,168559,12905,329926,13653,6559,7094
56510,350247,20291,168572,12905,329956,13654,6559,7095
56515,350278,20293,168584,12906,329985,13655,6559,7096
56520,350309,20296,168596,12908,330013,13656,6559,7097
56525,350340,20300,168616,12912,330040,13657,6560,7097
56530,350371,20302,168629,12913,330069,13658,6561,7097
56535,350402,20305,168645,12915,330097,13659,6562,7097
56540,350433,20308,168662,12917,330125,13660,6563,7097
56545,350464,20310,168679,12918,330154,13661,6564,7097
56550,350495,20313,168690,12920,330182,13662,6565,7097
56555,350526,20317,168704,12922,330209,13664,6565,7099
56560,350557,20320,168714,12923,330237,13666,6565,7101
56565,350588,20322,168730,12923,330266,13668,6567,7101
56570,350619,20324,168748,12924,330295,13670,6568,7102
56575,350650,20326,168760,12925,330324,13672,6570,7102
56580,350681,20327,168775,12925,330354,13674,6571,7103
56585,350712,20330,168791,12927,330382,13676,6571,7105
56590,350743,20332,168807,12928,330411,13677,6571,7106
56595,350774,20333,168823,12929,330441,13678,6572,7106
56600,350805,20334,168840,12929,330471,13679,6573,7106
56605,350836,20336,168852,12930,330500,13680,6573,7107
56610,350867,20338,168866,12930,330529,13681,6573,7108
56615,350898,20340,168877,12932,330558,13683,6574,7109
56620,350929,20343,168891,12934,330586,13685,6576,7109
56625,350960,20346,168905,12936,330614,13687,6576,7111
56630,350991,20348,168919,12938,330643,13688,6577,7111
56635,351022,20350,168938,12940,330672,13689,6577,7112
56640,351053,20353,168952,12942,330700,13690,6578,7112
56645,351084,20354,168966,12943,330730,13691,6578,7113
56650,351115,20356,168981,12944,330759,13692,6578,7114
56655,351146,20358,168997,12946,330788,13693,6578,7115
56660,351177,20360,169011,12947,330817,13694,6579,7115
56665,351208,20362,169023,12948,330846,13695,6579,7116
56670,351239,20363,169037,12948,330876,13696,6580,7116
56675,351270,20363,169054,12948,330907,13697,6581,7116
56680,351301,20363,169075,12948,330938,13698,6582,7116
56685,351332,20363,169090,12948,330969,13699,6583,7116
56690,351363,20364,169102,12948,330999,13700,6583,7117
56695,351394,20365,169118,12949,331029,13701,6584,7117
56700,351425,20366,169138,12950,331059,13702,6585,7117
56705,351456,20371,169152,12953,331085,13704,6586,7118
56710,351487,20376,169171,12957,331111,13706,6587,7119
56715,351518,20380,169185,12960,331138,13708,6587,7121
56720,351549,20381,169199,12961,331168,13710,6587,7123
56725,351580,20383,169213,12962,331197,13712,6588,7124
56730,351611,20384,169230,12963,331227,13714,6588,7126
56735,351642,20385,169242,12963,331257,13716,6589,7127
56740,351673,20386,169254,12963,331287,13717,6589,7128
56745,351704,20387,169265,12963,331317,13718,6589,7129
56750,351735,20388,169277,12963,331346,13719,6589,7130
56755,351766,20390,169291,12964,331376,13720,6590,7130
56760,351797,20391,169303,12965,331405,13721,6591,7130
56765,351828,20393,169320,12967,331434,13722,6592,7130
56770,351859,20395,169333,12969,331464,13723,6593,7130
56775,351890,20396,169346,12969,331494,13724,6593,7131
56780,351921,20398,169365,12970,331522,13725,6594,7131
56785,351952,20403,169382,12974,331548,13726,6594,7132
56790,351983,20408,169403,12979,331575,13727,6595,7132
56795,352014,20410,169417,12980,331604,13728,6596,7132
56800,352045,20413,169434,12983,331632,13729,6596,7133
56805,352076,20415,169449,12984,331661,13730,6597,7133
56810,352107,20418,169466,12986,331689,13731,6597,7134
56815,352138,20420,169482,12987,331718,13732,6597,7135
56820,352169,20422,169502,12989,331747,13733,6597,7136
56825,352200,20423,169516,12989,331777,13734,6598,7136
56830,352231,20424,169535,12990,331807,13735,6598,7137
56835,352262,20425,169549,12990,331837,13736,6598,7138
56840,352293,20426,169565,12990,331867,13737,6598,7139
56845,352324,20427,169582,12991,331897,13738,6599,7139
56850,352355,20429,169599,12993,331926,13740,6600,7140
56855,352386,20430,169613,12994,331956,13742,6602,7140
56860,352417,20431,169626,12995,331986,13744,6603,7141
56865,352448,20433,169641,12996,332015,13745,6603,7142
56870,352479,20434,169652,12996,332045,13746,6603,7143
56875,352510,20436,169665,12998,332074,13747,6603,7144
56880,352541,20437,169677,12998,332104,13748,6604,7144
56885,352572,20441,169695,13000,332131,13748,6604,7144
56890,352603,20445,169711,13002,332158,13748,6604,7144
56895,352634,20447,169723,13002,332187,13748,6604,7144
56900,352665,20450,169741,13005,332215,13748,6604,7144
56905,352696,20453,169758,13007,332243,13748,6604,7144
56910,352727,20456,169776,13009,332271,13748,6604,7144
56915,352758,20460,169795,13013,332298,13748,6604,7144
56920,352789,20463,169811,13015,332325,13748,6604,7144
56925,352820,20465,169825,13016,332354,13748,6604,7144
56930,352851,20468,169844,13019,332383,13748,6604,7144
56935,352882,20470,169865,13021,332412,13748,6604,7144
56940,352913,20472,169877,13022,332441,13748,6604,7144
56945,352944,20475,169894,13024,332469,13749,6605,7144
56950,352975,20477,169908,13026,332498,13750,6605,7145
56955,353006,20479,169926,13028,332527,13751,6606,7145
56960,353037,20481,169943,13030,332556,13752,6607,7145
56965,353068,20483,169960,13031,332585,13753,6608,7145
56970,353099,20484,169975,13031,332615,13754,6609,7145
56975,353130,20486,169990,13033,332644,13755,6609,7146
56980,353161,20487,170003,13034,332674,13756,6609,7147
56985,353192,20488,170015,13034,332704,13757,6610,7147
56990,353223,20489,170029,13035,332734,13758,6610,7148
56995,353254,20491,170044,13036,332763,13759,6610,7149
57000,353285,20492,170055,13036,332793,13760,6610,7150
57005,353316,20495,170073,13039,332821,13762,6612,7150
57010,353347,20497,170083,13041,332850,13764,6612,7152
57015,353378,20498,170098,13042,332880,13766,6614,7152
57020,353409,20500,170113,13043,332909,13767,6614,7153
57025,353440,20502,170126,13044,332938,13768,6614,7154
57030,353471,20503,170140,13044,332968,13769,6614,7155
57035,353502,20504,170157,13044,332998,13770,6614,7156
57040,353533,20505,170175,13044,333028,13771,6615,7156
57045,353564,20508,170194,13047,333056,13772,6616,7156
57050,353595,20511,170206,13048,333084,13773,6616,7157
57055,353626,20513,170221,13049,333113,13774,6616,7158
57060,353657,20515,170238,13051,333142,13775,6616,7159
57065,353688,20518,170254,13053,333170,13777,6618,7159
57070,353719,20521,170264,13055,333198,13779,6618,7161
57075,353750,20523,170277,13057,333227,13781,6618,7163
57080,353781,20526,170288,13058,333255,13782,6618,7164
57085,353812,20528,170303,13060,333284,13783,6618,7165
57090,353843,20531,170318,13062,333312,13784,6619,7165
57095,353874,20533,170331,13064,333341,13785,6619,7166
57100,353905,20535,170348,13065,333369,13786,6619,7167
57105,353936,20537,170359,13066,333398,13788,6619,7169
57110,353967,20539,170370,13068,333428,13790,6619,7171
57115,353998,20540,170392,13068,333458,13792,6621,7171
57120,354029,20541,170405,13068,333488,13793,6621,7172
57125,354060,20543,170422,13069,333517,13794,6622,7172
57130,354091,20544,170435,13069,333547,13795,6623,7172
57135,354122,20545,170446,13069,333577,13796,6623,7173
57140,354153,20546,170465,13069,333607,13797,6623,7174
57145,354184,20547,170477,13070,333637,13798,6623,7175
57150,354215,20548,170493,13071,333667,13799,6623,7176
57155,354246,20550,170509,13072,333696,13800,6624,7176
57160,354277,20551,170522,13072,333726,13801,6624,7177
57165,354308,20553,170536,13074,333755,13802,6624,7178
57170,354339,20555,170548,13075,333784,13803,6625,7178
57175,354370,20557,170568,13076,333813,13804,6626,7178
57180,354401,20558,170582,13076,333843,13806,6627,7179
57185,354432,20559,170595,13076,333873,13807,6627,7180
57190,354463,20560,170605,13076,333903,13808,6627,7181
57195,354494,20561,170619,13076,333933,13809,6628,7181
57200,354525,20562,170632,13077,333963,13810,6628,7182
57205,354556,20563,170641,13078,333993,13811,6628,7183
57210,354587,20564,170661,13079,334023,13812,6629,7183
57215,354618,20566,170680,13081,334052,13813,6630,7183
57220,354649,20568,170695,13082,334081,13814,6631,7183
57225,354680,20569,170709,13083,334111,13815,6631,7184
57230,354711,20572,170725,13084,334139,13816,6631,7185
57235,354742,20575,170740,13086,334167,13817,6631,7186
57240,354773,20579,170756,13089,334194,13818,6631,7187
57245,354804,20581,170772,13090,334222,13820,6632,7188
57250,354835,20585,170786,13092,334249,13822,6632,7190
57255,354866,20589,170799,13095,334276,13824,6632,7192
57260,354897,20593,170815,13098,334303,13826,6632,7194
57265,354928,20597,170833,13102,334331,13828,6633,7195
57270,354959,20599,170852,13104,334360,13830,6635,7195
57275,354990,20601,170868,13105,334388,13832,6635,7197
57280,355021,20604,170885,13107,334416,13834,6636,7198
57285,355052,20608,170902,13111,334444,13837,6637,7200
57290,355083,20611,170914,13113,334472,13839,6638,7201
57295,355114,20612,170931,13114,334502,13841,6639,7202
57300,355145,20613,170943,13115,334532,13843,6640,7203
57305,355176,20615,170956,13116,334561,13844,6641,7203
57310,355207,20617,170972,13116,334590,13845,6641,7204
57315,355238,20619,170987,13116,334619,13846,6642,7204
57320,355269,20621,171000,13117,334648,13847,6643,7204
57325,355300,20623,171017,13118,334677,13848,6643,7205
57330,355331,20625,171033,13118,334706,13849,6644,7205
57335,355362,20627,171050,13120,334735,13850,6644,7206
57340,355393,20629,171066,13121,334764,13851,6645,7206
57345,355424,20632,171081,13123,334792,13852,6645,7207
57350,355455,20634,171099,13125,334821,13853,6646,7207
57355,355486,20636,171112,13126,334850,13854,6646,7208
57360,355517,20638,171128,13126,334879,13855,6646,7209
57365,355548,20641,171142,13128,334907,13857,6647,7210
57370,355579,20643,171157,13128,334935,13858,6648,7210
57375,355610,20646,171174,13130,334964,13859,6648,7211
57380,355641,20648,171188,13131,334993,13860,6649,7211
57385,355672,20650,171198,13131,335022,13861,6649,7212
57390,355703,20652,171212,13133,335051,13862,6649,7213
57395,355734,20655,171224,13134,335079,13864,6649,7215
57400,355765,20658,171239,13136,335107,13866,6650,7216
57405,355796,20663,171251,13140,335133,13868,6650,7218
57410,355827,20669,171270,13144,335158,13870,6652,7218
57415,355858,20672,171288,13147,335186,13871,6653,7218
57420,355889,20674,171306,13149,335215,13872,6653,7219
57425,355920,20675,171321,13150,335245,13872,6653,7219
57430,355951,20676,171337,13151,335275,13872,6653,7219
57435,355982,20677,171353,13152,335305,13872,6653,7219
57440,356013,20679,171367,13153,335334,13872,6653,7219
57445,356044,20681,171384,13155,335363,13872,6653,7219
57450,356075,20682,171399,13155,335393,13872,6653,7219
57455,356106,20683,171415,13156,335423,13872,6653,7219
57460,356137,20685,171427,13158,335452,13872,6653,7219
57465,356168,20686,171441,13159,335482,13872,6653,7219
57470,356199,20688,171456,13161,335511,13872,6653,7219
57475,356230,20690,171469,13163,335540,13872,6653,7219
57480,356261,20692,171483,13165,335569,13873,6653,7220
57485,356292,20693,171495,13166,335598,13875,6655,7220
57490,356323,20696,171506,13168,335627,13877,6656,7221
57495,356354,20697,171518,13169,335657,13879,6657,7222
57500,356385,20699,171530,13170,335685,13881,6658,7223
57505,356416,20702,171547,13172,335714,13883,6659,7224
57510,356447,20703,171557,13172,335744,13885,6660,7225
57515,356478,20705,171575,13173,335773,13887,6661,7226
57520,356509,20706,171595,13173,335803,13889,6663,7226
57525,356540,20707,171612,13174,335833,13891,6663,7228
57530,356571,20708,171623,13174,335863,13892,6663,7229
57535,356602,20710,171640,13176,335892,13893,6664,7229
57540,356633,20711,171651,13176,335922,13894,6665,7229
57545,356664,20712,171663,13176,335952,13895,6666,7229
57550,356695,20713,171672,13176,335982,13896,6666,7230
57555,356726,20714,171688,13177,336012,13897,6666,7231
57560,356757,20715,171698,13177,336042,13898,6666,7232
57565,356788,20716,171714,13178,336072,13899,6667,7232
57570,356819,20717,171727,13178,336102,13900,6667,7233
57575,356850,20718,171743,13179,336132,13901,6668,7233
57580,356881,20719,171762,13179,336162,13902,6669,7233
57585,356912,20720,171781,13179,336192,13903,6670,7233
57590,356943,20723,171798,13182,336220,13904,6671,7233
57595,356974,20726,171812,13184,336248,13905,6671,7234
57600,357005,20728,171824,13184,336277,13906,6672,7234
57605,357036,20733,171840,13186,336302,13907,6673,7234
57610,357067,20738,171852,13189,336329,13908,6673,7235
57615,357098,20742,171868,13192,336355,13910,6674,7236
57620,357129,20747,171879,13195,336382,13912,6675,7237
57625,357160,20750,171893,13197,336410,13914,6675,7239
57630,357191,20753,171911,13198,336438,13917,6678,7239
57635,357222,20755,171926,13199,336467,13920,6680,7240
57640,357253,20757,171939,13200,336496,13923,6680,7243
57645,357284,20759,171951,13201,336525,13925,6681,7244
57650,357315,20762,171966,13203,336553,13927,6682,7245
57655,357346,20765,171980,13205,336580,13929,6683,7246
57660,357377,20770,171998,13209,336607,13931,6683,7248
57665,357408,20773,172010,13210,336635,13933,6683,7250
57670,357439,20776,172025,13213,336663,13935,6683,7252
57675,357470,20779,172038,13216,336691,13936,6683,7253
57680,357501,20780,172050,13216,336721,13937,6684,7253
57685,357532,20780,172059,13216,336752,13938,6685,7253
57690,357563,20780,172074,13216,336783,13939,6686,7253
57695,357594,20780,172089,13216,336814,13940,6686,7254
57700,357625,20780,172102,13216,336845,13941,6687,7254
57705,357656,20780,172119,13216,336876,13942,6688,7254
57710,357687,20780,172137,13216,336907,13943,6688,7255
57715,357718,20780,172146,13216,336938,13944,6688,7256
57720,357749,20780,172164,13216,336969,13945,6689,7256
57725,357780,20782,172181,13217,336998,13946,6690,7256
57730,357811,20785,172192,13219,337026,13947,6691,7256
57735,357842,20788,172205,13221,337054,13948,6692,7256
57740,357873,20791,172225,13223,337082,13949,6692,7257
57745,357904,20794,172241,13224,337110,13950,6692,7258
57750,357935,20796,172257,13225,337139,13951,6692,7259
57755,357966,20797,172269,13226,337169,13952,6693,7259
57760,357997,20799,172286,13228,337198,13953,6693,7260
57765,358028,20801,172303,13230,337227,13954,6694,7260
57770,358059,20803,172313,13231,337256,13956,6694,7262
57775,358090,20805,172324,13233,337284,13958,6696,7262
57780,358121,20808,172340,13236,337312,13961,6699,7262
57785,358152,20812,172353,13239,337340,13963,6700,7263
57790,358183,20817,172370,13243,337366,13965,6701,7264
57795,358214,20820,172380,13245,337394,13967,6701,7266
57800,358245,20823,172395,13248,337421,13969,6702,7267
57805,358276,20828,172407,13251,337448,13971,6704,7267
57810,358307,20832,172426,13252,337475,13973,6706,7267
57815,358338,20837,172437,13256,337500,13975,6706,7269
57820,358369,20841,172454,13259,337527,13977,6707,7270
57825,358400,20846,172473,13264,337554,13978,6707,7271
57830,358431,20848,172487,13266,337583,13979,6708,7271
57835,358462,20849,172495,13266,337613,13980,6708,7272
57840,358493,20851,172509,13267,337642,13981,6708,7273
57845,358524,20851,172517,13267,337673,13982,6709,7273
57850,358555,20851,172539,13267,337704,13983,6710,7273
57855,358586,20851,172553,13267,337735,13984,6711,7273
57860,358617,20851,172572,13267,337766,13985,6711,7274
57865,358648,20851,172589,13267,337797,13986,6712,7274
57870,358679,20851,172605,13267,337828,13987,6713,7274
57875,358710,20851,172615,13267,337859,13988,6714,7274
57880,358741,20851,172629,13267,337890,13989,6714,7275
57885,358772,20851,172641,13267,337921,13990,6714,7276
57890,358803,20851,172654,13267,337952,13991,6715,7276
57895,358834,20851,172672,13267,337983,13992,6716,7276
57900,358865,20851,172682,13267,338014,13993,6716,7277
57905,358896,20854,172701,13269,338042,13994,6717,7277
57910,358927,20855,172714,13269,338072,13995,6717,7278
57915,358958,20857,172728,13270,338101,13996,6717,7279
57920,358989,20858,172741,13271,338131,13997,6718,7279
57925,359020,20859,172756,13272,338161,13998,6718,7280
57930,359051,20860,172765,13273,338191,13999,6719,7280
57935,359082,20861,172781,13274,338221,14000,6719,7281
57940,359113,20862,172794,13274,338251,14001,6719,7282
57945,359144,20863,172809,13274,338281,14002,6719,7283
57950,359175,20866,172825,13275,338309,14005,6720,7285
57955,359206,20871,172845,13280,338334,14008,6722,7286
57960,359237,20876,172855,13284,338361,14011,6724,7287
57965,359268,20877,172871,13285,338391,14011,6724,7287
57970,359299,20879,172886,13287,338420,14011,6724,7287
57975,359330,20880,172900,13287,338450,14011,6724,7287
57980,359361,20881,172915,13287,338480,14011,6724,7287
57985,359392,20883,172928,13288,338509,14011,6724,7287
57990,359423,20884,172940,13288,338539,14011,6724,7287
57995,359454,20886,172959,13289,338568,14011,6724,7287
58000,359485,20887,172966,13289,338598,14011,6724,7287
58005,359516,20889,172980,13291,338627,14011,6724,7287
58010,359547,20889,173000,13291,338658,14011,6724,7287
58015,359578,20889,173015,13291,338689,14011,6724,7287
58020,359609,20889,173034,13291,338720,14011,6724,7287
58025,359640,20889,173048,13291,338751,14011,6724,7287
58030,359671,20889,173060,13291,338782,14011,6724,7287
58035,359702,20889,173081,13291,338813,14011,6724,7287
58040,359733,20889,173099,13291,338844,14011,6724,7287
58045,359764,20889,173112,13291,338875,14011,6724,7287
58050,359795,20889,173132,13291,338906,14011,6724,7287
58055,359826,20889,173142,13291,338937,14011,6724,7287
58060,359857,20889,173156,13291,338968,14011,6724,7287
58065,359888,20889,173167,13291,338999,14014,6725,7289
58070,359919,20891,173177,13291,339028,14017,6726,7291
58075,359950,20893,173196,13293,339056,14020,6728,7292
58080,359981,20896,173208,13294,339085,14023,6729,7294
58085,360012,20899,173222,13295,339113,14024,6729,7295
58090,360043,20902,173236,13297,339141,14025,6730,7295
58095,360074,20905,173251,13299,339169,14026,6731,7295
58100,360105,20908,173269,13301,339197,14027,6732,7295
58105,360136,20911,173283,13303,339225,14028,6733,7295
58110,360167,20914,173300,13306,339253,14029,6734,7295
58115,360198,20917,173311,13306,339281,14030,6735,7295
58120,360229,20920,173331,13308,339309,14031,6736,7295
58125,360260,20923,173343,13310,339337,14032,6736,7296
58130,360291,20926,173353,13311,339365,14033,6737,7296
58135,360322,20930,173373,13314,339392,14034,6738,7296
58140,360353,20933,173387,13315,339420,14035,6738,7297
58145,360384,20938,173405,13318,339446,14036,6739,7297
58150,360415,20941,173420,13320,339474,14037,6740,7297
58155,360446,20944,173433,13321,339502,14038,6740,7298
58160,360477,20948,173446,13322,339529,14039,6741,7298
58165,360508,20951,173464,13324,339557,14040,6742,7298
58170,360539,20954,173482,13325,339585,14041,6743,7298
58175,360570,20956,173497,13327,339614,14042,6744,7298
58180,360601,20959,173511,13330,339642,14043,6745,7298
58185,360632,20962,173526,13332,339669,14045,6747,7298
58190,360663,20968,173540,13337,339694,14047,6747,7300
58195,360694,20973,173560,13342,339721,14049,6748,7301
58200,360725,20975,173575,13344,339750,14050,6748,7302
58205,360756,20975,173590,13344,339781,14051,6749,7302
58210,360787,20975,173605,13344,339812,14052,6749,7303
58215,360818,20975,173621,13344,339843,14053,6750,7303
58220,360849,20975,173635,13344,339874,14054,6751,7303
58225,360880,20975,173647,13344,339905,14055,6751,7304
58230,360911,20975,173660,13344,339936,14056,6752,7304
58235,360942,20975,173677,13344,339967,14057,6753,7304
58240,360973,20975,173693,13344,339998,14058,6753,7305
58245,361004,20975,173703,13344,340029,14059,6753,7306
58250,361035,20975,173725,13344,340060,14060,6753,7307
58255,361066,20975,173741,13344,340091,14061,6753,7308
58260,361097,20975,173754,13344,340122,14062,6753,7309
58265,361128,20977,173768,13346,340151,14063,6753,7310
58270,361159,20978,173783,13346,340181,14064,6753,7311
58275,361190,20979,173796,13347,340211,14065,6754,7311
58280,361221,20981,173811,13348,340240,14066,6755,7311
58285,361252,20982,173824,13349,340270,14067,6756,7311
58290,361283,20983,173836,13349,340300,14069,6757,7312
58295,361314,20984,173856,13349,340330,14071,6759,7312
58300,361345,20986,173870,13350,340359,14073,6761,7312
58305,361376,20989,173885,13352,340387,14074,6762,7312
58310,361407,20993,173897,13354,340414,14075,6762,7313
58315,361438,21000,173910,13359,340438,14076,6762,7314
58320,361469,21005,173922,13362,340464,14077,6763,7314
58325,361500,21006,173937,13362,340494,14078,6763,7315
58330,361531,21008,173951,13363,340523,14079,6763,7316
58335,361562,21010,173968,13364,340552,14080,6763,7317
58340,361593,21011,173991,13364,340582,14081,6763,7318
58345,361624,21013,174004,13365,340611,14082,6764,7318
58350,361655,21014,174016,13365,340641,14083,6764,7319
58355,361686,21016,174028,13367,340670,14084,6764,7320
58360,361717,21018,174042,13368,340699,14085,6764,7321
58365,361748,21020,174055,13369,340728,14086,6764,7322
58370,361779,21020,174066,13369,340759,14087,6765,7322
58375,361810,21020,174082,13369,340790,14088,6766,7322
58380,361841,21020,174098,13369,340821,14089,6767,7322
58385,361872,21020,174115,13369,340852,14091,6769,7322
58390,361903,21020,174132,13369,340883,14093,6770,7323
58395,361934,21020,174151,13369,340914,14095,6770,7325
58400,361965,21020,174170,13369,340945,14097,6771,7326
58405,361996,21020,174185,13369,340976,14099,6773,7326
58410,362027,21020,174194,13369,341007,14101,6773,7328
58415,362058,21020,174214,13369,341038,14103,6775,7328
58420,362089,21020,174228,13369,341069,14104,6776,7328
58425,362120,21021,174244,13370,341099,14105,6777,7328
58430,362151,21023,174258,13372,341128,14106,6777,7329
58435,362182,21025,174271,13373,341157,14108,6778,7330
58440,362213,21028,174289,13376,341185,14110,6778,7332
58445,362244,21032,174302,13378,341212,14111,6778,7333
58450,362275,21034,174319,13379,341241,14112,6778,7334
58455,362306,21036,174334,13380,341269,14113,6779,7334
58460,362337,21040,174346,13383,341297,14114,6779,7335
58465,362368,21043,174356,13385,341325,14115,6779,7336
58470,362399,21047,174368,13388,341352,14116,6780,7336
58475,362430,21050,174382,13389,341379,14117,6781,7336
58480,362461,21053,174397,13391,341408,14118,6782,7336
58485,362492,21054,174407,13391,341437,14119,6783,7336
58490,362523,21056,174419,13393,341466,14120,6783,7337
58495,362554,21058,174436,13395,341496,14121,6784,7337
58500,362585,21059,174450,13395,341525,14122,6785,7337
58505,362616,21060,174463,13396,341556,14123,6785,7338
58510,362647,21060,174476,13396,341587,14124,6786,7338
58515,362678,21060,174489,13396,341618,14125,6787,7338
58520,362709,21060,174502,13396,341649,14126,6788,7338
58525,362740,21060,174516,13396,341680,14128,6788,7340
58530,362771,21060,174534,13396,341711,14130,6790,7340
58535,362802,21060,174549,13396,341742,14132,6791,7341
58540,362833,21060,174568,13396,341773,14133,6792,7341
58545,362864,21060,174589,13396,341804,14134,6793,7341
58550,362895,21061,174605,13397,341834,14136,6793,7343
58555,362926,21062,174624,13397,341864,14138,6795,7343
58560,362957,21063,174642,13398,341894,14140,6796,7344
58565,362988,21066,174657,13400,341922,14142,6798,7344
58570,363019,21069,174671,13402,341950,14144,6799,7345
58575,363050,21072,174683,13404,341978,14145,6799,7346
58580,363081,21076,174698,13407,342005,14146,6799,7347
58585,363112,21080,174712,13409,342032,14147,6800,7347
58590,363143,21085,174729,13412,342058,14148,6801,7347
58595,363174,21089,174740,13414,342085,14149,6801,7348
58600,363205,21093,174751,13417,342112,14150,6802,7348
58605,363236,21099,174767,13421,342137,14151,6803,7348
58610,363267,21103,174780,13423,342164,14152,6803,7349
58615,363298,21105,174793,13424,342193,14153,6803,7350
58620,363329,21107,174810,13426,342222,14154,6804,7350
58625,363360,21108,174826,13426,342252,14155,6805,7350
58630,363391,21109,174837,13427,342282,14156,6805,7351
58635,363422,21110,174850,13427,342312,14157,6805,7352
58640,363453,21111,174867,13427,342342,14158,6806,7352
58645,363484,21112,174886,13427,342372,14159,6807,7352
58650,363515,21113,174903,13427,342402,14160,6808,7352
58655,363546,21114,174922,13428,342432,14162,6809,7353
58660,363577,21115,174936,13429,342462,14164,6809,7355
58665,363608,21116,174951,13430,342492,14166,6810,7356
58670,363639,21117,174964,13430,342522,14168,6811,7357
58675,363670,21118,174983,13430,342552,14169,6811,7358
58680,363701,21119,174999,13431,342582,14171,6812,7359
58685,363732,21122,175014,13433,342610,14173,6813,7360
58690,363763,21126,175031,13435,342637,14175,6813,7362
58695,363794,21129,175045,13436,342665,14177,6814,7363
58700,363825,21132,175059,13439,342693,14178,6815,7363
58705,363856,21134,175073,13440,342722,14179,6815,7364
58710,363887,21136,175087,13442,342751,14180,6815,7365
58715,363918,21138,175101,13442,342780,14181,6815,7366
58720,363949,21140,175114,13442,342809,14182,6815,7367
58725,363980,21142,175122,13442,342838,14183,6816,7367
58730,364011,21145,175137,13444,342866,14184,6817,7367
58735,364042,21149,175157,13448,342893,14185,6818,7367
58740,364073,21152,175169,13449,342921,14186,6818,7368
58745,364104,21155,175178,13451,342949,14187,6819,7368
58750,364135,21159,175196,13455,342976,14188,6820,7368
58755,364166,21165,175208,13460,343001,14189,6820,7369
58760,364197,21170,175229,13465,343027,14190,6821,7369
58765,364228,21175,175243,13467,343053,14191,6821,7370
58770,364259,21178,175256,13469,343081,14192,6821,7371
58775,364290,21180,175270,13470,343110,14194,6822,7372
58780,364321,21182,175286,13472,343139,14196,6822,7374
58785,364352,21185,175301,13474,343167,14198,6823,7375
58790,364383,21188,175319,13476,343195,14200,6824,7376
58795,364414,21191,175334,13478,343223,14202,6824,7378
58800,364445,21192,175343,13479,343253,14204,6824,7380
58805,364476,21193,175357,13480,343283,14206,6825,7381
58810,364507,21195,175370,13482,343312,14208,6826,7382
58815,364538,21197,175385,13484,343341,14210,6827,7383
58820,364569,21199,175402,13486,343370,14212,6827,7385
58825,364600,21199,175420,13486,343401,14213,6828,7385
58830,364631,21199,175440,13486,343432,14214,6829,7385
58835,364662,21199,175458,13486,343463,14215,6830,7385
58840,364693,21199,175471,13486,343494,14216,6831,7385
58845,364724,21199,175487,13486,343525,14217,6831,7386
58850,364755,21199,175506,13486,343556,14218,6832,7386
58855,364786,21199,175521,13486,343587,14219,6833,7386
58860,364817,21199,175531,13486,343618,14220,6833,7387
58865,364848,21201,175545,13487,343647,14222,6835,7387
58870,364879,21203,175560,13487,343676,14223,6836,7387
58875,364910,21205,175576,13489,343705,14224,6837,7387
58880,364941,21207,175588,13490,343734,14225,6837,7388
58885,364972,21209,175605,13491,343763,14226,6837,7389
58890,365003,21211,175621,13492,343792,14227,6837,7390
58895,365034,21213,175633,13493,343821,14228,6837,7391
58900,365065,21215,175646,13494,343850,14229,6838,7391
58905,365096,21218,175666,13495,343878,14230,6838,7392
58910,365127,21222,175682,13497,343905,14231,6838,7393
58915,365158,21225,175693,13498,343932,14232,6838,7394
58920,365189,21229,175705,13500,343959,14233,6838,7395
58925,365220,21233,175721,13503,343987,14234,6838,7396
58930,365251,21236,175739,13506,344015,14236,6839,7397
58935,365282,21239,175752,13509,344043,14238,6840,7398
58940,365313,21241,175765,13510,344072,14240,6840,7400
58945,365344,21241,175783,13510,344103,14242,6840,7402
58950,365375,21241,175797,13510,344134,14244,6841,7403
58955,365406,21241,175810,13510,344165,14246,6843,7403
58960,365437,21241,175824,13510,344196,14248,6844,7404
58965,365468,21241,175838,13510,344227,14250,6845,7405
58970,365499,21241,175859,13510,344258,14251,6846,7405
58975,365530,21241,175878,13510,344289,14252,6847,7405
58980,365561,21241,175897,13510,344320,14253,6848,7405
58985,365592,21243,175909,13510,344349,14253,6848,7405
58990,365623,21245,175922,13512,344378,14253,6848,7405
58995,365654,21247,175941,13514,344407,14253,6848,7405
59000,365685,21249,175960,13516,344436,14253,6848,7405
59005,365716,21251,175979,13517,344465,14253,6848,7405
59010,365747,21253,175995,13518,344494,14253,6848,7405
59015,365778,21255,176010,13519,344523,14253,6848,7405
59020,365809,21257,176027,13520,344552,14253,6848,7405
59025,365840,21259,176042,13520,344581,14253,6848,7405
59030,365871,21261,176055,13521,344610,14253,6848,7405
59035,365902,21263,176072,13522,344639,14253,6848,7405
59040,365933,21265,176089,13522,344668,14253,6848,7405
59045,365964,21267,176104,13524,344697,14253,6848,7405
59050,365995,21271,176120,13527,344724,14253,6848,7405
59055,366026,21274,176128,13527,344752,14253,6848,7405
59060,366057,21276,176139,13528,344781,14253,6848,7405
59065,366088,21279,176149,13529,344809,14253,6848,7405
59070,366119,21281,176162,13529,344838,14253,6848,7405
59075,366150,21285,176177,13533,344865,14253,6848,7405
59080,366181,21287,176189,13533,344894,14253,6848,7405
59085,366212,21291,176204,13536,344921,14253,6848,7405
59090,366243,21293,176218,13538,344950,14254,6848,7406
59095,366274,21298,176233,13543,344976,14256,6849,7407
59100,366305,21300,176245,13544,345004,14258,6850,7408
59105,366336,21303,176262,13547,345033,14260,6851,7409
59110,366367,21303,176275,13547,345064,14261,6852,7409
59115,366398,21303,176292,13547,345095,14262,6853,7409
59120,366429,21303,176307,13547,345126,14263,6854,7409
59125,366460,21303,176322,13547,345157,14264,6854,7410
59130,366491,21303,176336,13547,345188,14265,6855,7410
59135,366522,21303,176350,13547,345219,14266,6855,7411
59140,366553,21303,176364,13547,345250,14267,6855,7412
59145,366584,21303,176379,13547,345281,14268,6855,7413
59150,366615,21303,176397,13547,345312,14269,6856,7413
59155,366646,21303,176410,13547,345343,14271,6857,7414
59160,366677,21303,176430,13547,345374,14273,6857,7416
59165,366708,21303,176443,13547,345405,14275,6858,7417
59170,366739,21303,176457,13547,345436,14276,6859,7417
59175,366770,21303,176468,13547,345467,14277,6859,7418
59180,366801,21303,176486,13547,345498,14278,6860,7418
59185,366832,21303,176500,13547,345529,14279,6860,7419
59190,366863,21303,176513,13547,345560,14280,6860,7420
59195,366894,21303,176533,13547,345591,14281,6860,7421
59200,366925,21303,176550,13547,345622,14282,6860,7422
59205,366956,21304,176568,13547,345652,14283,6860,7423
59210,366987,21305,176583,13547,345682,14284,6861,7423
59215,367018,21308,176591,13547,345710,14285,6861,7424
59220,367049,21314,176608,13550,345735,14286,6861,7425
59225,367080,21317,176620,13552,345763,14287,6861,7426
59230,367111,21321,176630,13555,345790,14288,6862,7426
59235,367142,21324,176644,13557,345818,14289,6862,7427
59240,367173,21328,176657,13561,345845,14291,6862,7429
59245,367204,21331,176669,13563,345873,14293,6863,7430
59250,367235,21334,176682,13564,345900,14295,6864,7431
59255,367266,21340,176698,13569,345926,14297,6864,7433
59260,367297,21344,176713,13571,345953,14299,6864,7435
59265,367328,21347,176728,13572,345980,14301,6864,7437
59270,367359,21352,176745,13576,346006,14304,6866,7438
59275,367390,21355,176755,13578,346035,14306,6868,7438
59280,367421,21357,176768,13578,346064,14308,6869,7439
59285,367452,21362,176787,13580,346090,14310,6870,7440
59290,367483,21364,176801,13580,346119,14312,6870,7442
59295,367514,21368,176821,13582,346146,14313,6871,7442
59300,367545,21372,176838,13586,346173,14314,6871,7443
59305,367576,21375,176852,13587,346201,14315,6871,7444
59310,367607,21376,176867,13588,346231,14316,6871,7445
59315,367638,21377,176883,13588,346261,14317,6871,7446
59320,367669,21378,176900,13588,346291,14318,6871,7447
59325,367700,21380,176914,13589,346320,14319,6872,7447
59330,367731,21380,176928,13589,346351,14320,6872,7448
59335,367762,21380,176943,13589,346382,14321,6873,7448
59340,367793,21380,176958,13589,346413,14322,6873,7449
59345,367824,21380,176975,13589,346444,14323,6874,7449
59350,367855,21380,176990,13589,346475,14324,6875,7449
59355,367886,21380,177008,13589,346506,14325,6876,7449
59360,367917,21380,177019,13589,346537,14326,6876,7450
59365,367948,21380,177034,13589,346568,14327,6876,7451
59370,367979,21380,177047,13589,346599,14328,6877,7451
59375,368010,21380,177066,13589,346630,14329,6877,7452
59380,368041,21380,177083,13589,346661,14330,6877,7453
59385,368072,21380,177093,13589,346692,14332,6877,7455
59390,368103,21380,177110,13589,346723,14334,6878,7456
59395,368134,21382,177131,13591,346752,14337,6881,7456
59400,368165,21383,177150,13592,346782,14339,6883,7456
59405,368196,21387,177168,13595,346809,14341,6884,7457
59410,368227,21391,177183,13598,346836,14343,6884,7459
59415,368258,21397,177202,13604,346861,14345,6885,7460
59420,368289,21400,177221,13606,346889,14347,6886,7461
59425,368320,21402,177229,13606,346918,14348,6886,7462
59430,368351,21405,177244,13609,346946,14349,6886,7463
59435,368382,21408,177263,13610,346974,14350,6887,7463
59440,368413,21411,177276,13613,347002,14351,6888,7463
59445,368444,21414,177297,13615,347030,14352,6889,7463
59450,368475,21416,177309,13616,347059,14353,6889,7464
59455,368506,21418,177326,13618,347088,14354,6889,7465
59460,368537,21420,177344,13619,347117,14355,6889,7466
59465,368568,21422,177359,13621,347146,14356,6890,7466
59470,368599,21424,177372,13621,347175,14357,6890,7467
59475,368630,21426,177384,13621,347204,14358,6890,7468
59480,368661,21428,177396,13623,347233,14359,6891,7468
59485,368692,21430,177415,13625,347262,14360,6892,7468
59490,368723,21432,177430,13626,347291,14361,6892,7469
59495,368754,21434,177444,13627,347320,14362,6893,7469
59500,368785,21436,177457,13628,347349,14364,6894,7470
59505,368816,21438,177469,13629,347378,14366,6894,7472
59510,368847,21440,177484,13631,347407,14368,6895,7473
59515,368878,21441,177497,13631,347437,14370,6896,7474
59520,368909,21442,177514,13632,347467,14371,6896,7475
59525,368940,21446,177527,13635,347494,14373,6898,7475
59530,368971,21448,177541,13635,347523,14375,6898,7477
59535,369002,21451,177554,13636,347551,14377,6899,7478
59540,369033,21453,177568,13637,347580,14378,6900,7478
59545,369064,21456,177585,13639,347608,14379,6900,7479
59550,369095,21458,177603,13641,347637,14380,6901,7479
59555,369126,21462,177618,13644,347664,14381,6901,7480
59560,369157,21466,177636,13648,347691,14382,6901,7481
59565,369188,21467,177646,13649,347721,14383,6902,7481
59570,369219,21470,177660,13652,347749,14384,6903,7481
59575,369250,21471,177674,13653,347779,14385,6904,7481
59580,369281,21473,177694,13654,347808,14386,6904,7482
59585,369312,21475,177708,13656,347837,14388,6904,7484
59590,369343,21477,177721,13657,347866,14390,6906,7484
59595,369374,21480,177738,13659,347894,14392,6907,7485
59600,369405,21480,177755,13659,347925,14394,6909,7485
59605,369436,21480,177775,13659,347956,14396,6910,7486
59610,369467,21480,177789,13659,347987,14398,6911,7487
59615,369498,21480,177805,13659,348018,14400,6912,7488
59620,369529,21481,177816,13660,348048,14403,6914,7489
59625,369560,21482,177827,13660,348078,14406,6915,7491
59630,369591,21483,177844,13661,348108,14409,6916,7493
59635,369622,21484,177859,13662,348138,14411,6917,7494
59640,369653,21485,177872,13663,348168,14413,6918,7495
59645,369684,21489,177887,13665,348195,14414,6918,7496
59650,369715,21492,177902,13667,348223,14415,6918,7497
59655,369746,21494,177913,13669,348252,14416,6919,7497
59660,369777,21495,177930,13670,348282,14417,6919,7498
59665,369808,21496,177944,13670,348312,14418,6920,7498
59670,369839,21497,177957,13671,348342,14419,6920,7499
59675,369870,21498,177973,13671,348372,14420,6921,7499
59680,369901,21499,177986,13671,348402,14421,6922,7499
59685,369932,21501,178003,13672,348431,14422,6923,7499
59690,369963,21506,178022,13677,348457,14423,6924,7499
59695,369994,21508,178035,13677,348486,14424,6924,7500
59700,370025,21512,178052,13679,348513,14425,6925,7500
59705,370056,21515,178067,13681,348541,14427,6926,7501
59710,370087,21518,178081,13683,348569,14429,6927,7502
59715,370118,21519,178095,13684,348599,14430,6928,7502
59720,370149,21520,178108,13685,348629,14431,6928,7503
59725,370180,21521,178124,13685,348659,14432,6928,7504
59730,370211,21522,178138,13685,348689,14433,6929,7504
59735,370242,21523,178155,13686,348719,14434,6929,7505
59740,370273,21524,178175,13687,348749,14435,6930,7505
59745,370304,21525,178196,13688,348779,14437,6931,7506
59750,370335,21526,178214,13689,348809,14439,6933,7506
59755,370366,21527,178229,13690,348838,14441,6934,7507
59760,370397,21531,178244,13694,348866,14443,6935,7508
59765,370428,21534,178258,13696,348894,14444,6935,7509
59770,370459,21537,178270,13698,348922,14445,6936,7509
59775,370490,21540,178285,13700,348950,14446,6936,7510
59780,370521,21543,178303,13701,348978,14447,6936,7511
59785,370552,21545,178317,13701,349007,14448,6936,7512
59790,370583,21549,178333,13704,349034,14449,6936,7513
59795,370614,21551,178352,13706,349063,14450,6937,7513
59800,370645,21552,178369,13706,349093,14451,6937,7514
59805,370676,21553,178380,13706,349123,14452,6938,7514
59810,370707,21554,178393,13707,349153,14453,6939,7514
59815,370738,21556,178408,13709,349182,14454,6939,7515
59820,370769,21558,178423,13710,349211,14455,6940,7515
59825,370800,21560,178433,13711,349240,14456,6940,7516
59830,370831,21561,178449,13711,349270,14457,6941,7516
59835,370862,21562,178458,13711,349300,14458,6941,7517
59840,370893,21563,178471,13712,349330,14459,6942,7517
59845,370924,21564,178490,13713,349360,14460,6942,7518
59850,370955,21564,178501,13713,349391,14461,6942,7519
59855,370986,21564,178514,13713,349422,14462,6943,7519
59860,371017,21564,178529,13713,349453,14463,6944,7519
59865,371048,21564,178545,13713,349484,14464,6945,7519
59870,371079,21566,178556,13715,349513,14466,6946,7520
59875,371110,21568,178570,13717,349542,14468,6946,7522
59880,371141,21569,178588,13717,349572,14469,6947,7522
59885,371172,21571,178607,13719,349601,14470,6948,7522
59890,371203,21572,178623,13720,349631,14471,6949,7522
59895,371234,21574,178637,13722,349660,14472,6950,7522
59900,371265,21575,178653,13723,349690,14472,6950,7522
59905,371296,21576,178663,13723,349720,14472,6950,7522
59910,371327,21577,178680,13724,349750,14472,6950,7522
59915,371358,21578,178697,13725,349780,14472,6950,7522
59920,371389,21579,178710,13726,349810,14472,6950,7522
59925,371420,21580,178724,13726,349840,14472,6950,7522
59930,371451,21582,178739,13727,349869,14473,6950,7523
59935,371482,21584,178755,13729,349898,14474,6951,7523
59940,371513,21586,178771,13731,349927,14475,6952,7523
59945,371544,21589,178791,13734,349955,14476,6953,7523
59950,371575,21592,178807,13735,349983,14477,6953,7524
59955,371606,21594,178821,13737,350012,14478,6954,7524
59960,371637,21597,178835,13739,350040,14479,6955,7524
59965,371668,21599,178848,13740,350069,14480,6955,7525
59970,371699,21602,178862,13742,350097,14481,6955,7526
59975,371730,21605,178880,13744,350125,14482,6956,7526
59980,371761,21608,178893,13746,350153,14483,6956,7527
59985,371792,21611,178909,13748,350181,14484,6957,7527
59990,371823,21616,178924,13750,350207,14485,6957,7528
59995,371854,21619,178938,13751,350234,14486,6958,7528
60000,371885,21624,178950,13754,350261,14487,6958,7529
60005,371916,21626,178964,13756,350290,14489,6959,7530
60010,371947,21627,178977,13756,350320,14490,6959,7531
60015,371978,21629,178993,13758,350349,14491,6959,7532
60020,372009,21631,179012,13760,350378,14492,6960,7532
60025,372040,21632,179028,13760,350408,14493,6960,7533
60030,372071,21633,179041,13760,350438,14494,6960,7534
60035,372102,21635,179054,13762,350467,14495,6960,7535
60040,372133,21636,179067,13763,350497,14496,6960,7536
60045,372164,21637,179084,13764,350527,14497,6961,7536
60050,372195,21638,179096,13764,350557,14499,6962,7537
60055,372226,21639,179112,13764,350587,14500,6963,7537
60060,372257,21640,179126,13764,350617,14501,6963,7538
60065,372288,21640,179143,13764,350648,14502,6963,7539
60070,372319,21640,179162,13764,350679,14503,6964,7539
60075,372350,21640,179177,13764,350710,14504,6965,7539
60080,372381,21640,179196,13764,350741,14505,6966,7539
60085,372412,21640,179213,13764,350772,14506,6967,7539
60090,372443,21640,179225,13764,350803,14507,6968,7539
60095,372474,21640,179240,13764,350834,14508,6968,7540
60100,372505,21640,179256,13764,350865,14509,6968,7541
60105,372536,21640,179273,13764,350896,14510,6968,7542
60110,372567,21641,179288,13765,350925,14511,6969,7542
60115,372598,21644,179305,13767,350954,14512,6969,7543
60120,372629,21646,179318,13769,350982,14513,6970,7543
60125,372660,21653,179334,13775,351007,14515,6971,7544
60130,372691,21658,179346,13777,351033,14517,6972,7545
60135,372722,21660,179364,13779,351062,14519,6973,7546
60140,372753,21662,179380,13780,351091,14521,6974,7547
60145,372784,21664,179393,13782,351120,14523,6976,7547
60150,372815,21665,179413,13783,351150,14525,6977,7548
60155,372846,21667,179432,13785,351179,14527,6977,7550
60160,372877,21669,179442,13786,351208,14529,6977,7552
60165,372908,21670,179453,13787,351238,14530,6978,7552
60170,372939,21671,179469,13787,351268,14531,6979,7552
60175,372970,21672,179483,13788,351298,14533,6979,7554
60180,373001,21673,179498,13788,351328,14535,6980,7555
60185,373032,21674,179515,13789,351358,14537,6981,7556
60190,373063,21675,179530,13790,351388,14539,6982,7557
60195,373094,21676,179543,13791,351418,14541,6983,7558
60200,373125,21677,179563,13791,351448,14542,6984,7558
60205,373156,21678,179581,13792,351478,14543,6985,7558
60210,373187,21679,179598,13792,351508,14544,6986,7558
60215,373218,21680,179611,13792,351538,14545,6987,7558
60220,373249,21681,179625,13793,351568,14546,6987,7559
60225,373280,21682,179637,13793,351598,14547,6987,7560
60230,373311,21684,179652,13795,351627,14548,6987,7561
60235,373342,21686,179667,13797,351655,14549,6987,7562
60240,373373,21691,179684,13802,351682,14550,6988,7562
60245,373404,21694,179694,13805,351710,14551,6988,7563
60250,373435,21698,179713,13807,351737,14552,6989,7563
60255,373466,21701,179728,13808,351765,14553,6989,7564
60260,373497,21704,179745,13810,351793,14554,6990,7564
60265,373528,21706,179764,13812,351822,14555,6990,7565
60270,373559,21708,179777,13814,351851,14556,6990,7566
60275,373590,21709,179794,13815,351881,14557,6990,7567
60280,373621,21710,179809,13815,351911,14558,6991,7567
60285,373652,21713,179828,13818,351939,14559,6992,7567
60290,373683,21715,179844,13820,351968,14560,6993,7567
60295,373714,21715,179858,13820,351999,14561,6994,7567
60300,373745,21715,179874,13820,352030,14563,6995,7568
60305,373776,21715,179887,13820,352061,14565,6997,7568
60310,373807,21715,179901,13820,352092,14567,6998,7569
60315,373838,21715,179922,13820,352123,14569,6999,7570
60320,373869,21715,179934,13820,352154,14571,6999,7572
60325,373900,21715,179951,13820,352185,14573,7000,7573
60330,373931,21715,179964,13820,352216,14574,7000,7574
60335,373962,21715,179980,13820,352247,14575,7000,7575
60340,373993,21715,179992,13820,352278,14576,7001,7575
60345,374024,21715,180010,13820,352309,14577,7002,7575
60350,374055,21715,180023,13820,352340,14578,7003,7575
60355,374086,21717,180039,13822,352369,14579,7003,7576
60360,374117,21718,180053,13822,352399,14581,7004,7577
60365,374148,21719,180068,13823,352429,14583,7006,7577
60370,374179,21723,180083,13825,352456,14585,7007,7578
60375,374210,21726,180101,13828,352484,14587,7008,7579
60380,374241,21729,180117,13830,352512,14589,7008,7581
60385,374272,21731,180125,13830,352541,14591,7008,7583
60390,374303,21735,180143,13833,352568,14593,7010,7583
60395,374334,21739,180161,13837,352595,14595,7010,7585
60400,374365,21742,180173,13838,352623,14597,7010,7587
60405,374396,21746,180190,13841,352650,14599,7011,7588
60410,374427,21751,180204,13846,352676,14601,7012,7589
60415,374458,21755,180216,13848,352703,14603,7013,7590
60420,374489,21759,180232,13851,352730,14605,7014,7591
60425,374520,21762,180245,13853,352758,14606,7014,7592
60430,374551,21765,180261,13854,352786,14607,7014,7593
60435,374582,21768,180274,13855,352814,14608,7015,7593
60440,374613,21772,180294,13858,352841,14609,7015,7594
60445,374644,21776,180312,13862,352868,14610,7015,7595
60450,374675,21777,180323,13863,352898,14610,7015,7595
60455,374706,21778,180343,13864,352928,14610,7015,7595
60460,374737,21779,180356,13864,352958,14610,7015,7595
60465,374768,21781,180372,13865,352987,14610,7015,7595
60470,374799,21783,180386,13867,353016,14610,7015,7595
60475,374830,21784,180392,13868,353046,14610,7015,7595
60480,374861,21786,180411,13870,353075,14610,7015,7595
60485,374892,21787,180423,13870,353105,14610,7015,7595
60490,374923,21788,180437,13870,353135,14610,7015,7595
60495,374954,21789,180450,13871,353165,14610,7015,7595
60500,374985,21790,180468,13871,353195,14610,7015,7595
60505,375016,21791,180485,13872,353225,14610,7015,7595
60510,375047,21792,180499,13873,353255,14610,7015,7595
60515,375078,21793,180518,13874,353285,14610,7015,7595
60520,375109,21794,180534,13875,353315,14610,7015,7595
60525,375140,21795,180551,13876,353345,14611,7015,7596
60530,375171,21796,180566,13877,353375,14613,7015,7598
60535,375202,21798,180578,13878,353404,14615,7015,7600
60540,375233,21800,180590,13879,353433,14617,7015,7602
60545,375264,21803,180608,13882,353461,14619,7015,7604
60550,375295,21804,180626,13882,353491,14622,7016,7606
60555,375326,21808,180636,13885,353518,14625,7017,7608
60560,375357,21811,180652,13888,353546,14628,7018,7610
60565,375388,21815,180670,13891,353573,14630,7019,7611
60570,375419,21816,180681,13891,353603,14632,7019,7613
60575,375450,21817,180692,13891,353633,14633,7020,7613
60580,375481,21818,180703,13891,353663,14634,7020,7614
60585,375512,21819,180721,13892,353693,14635,7020,7615
60590,375543,21822,180734,13894,353720,14636,7020,7616
60595,375574,21826,180748,13897,353747,14637,7020,7617
60600,375605,21828,180760,13899,353777,14638,7020,7618
60605,375636,21829,180772,13899,353807,14639,7020,7619
60610,375667,21830,180784,13900,353837,14640,7021,7619
60615,375698,21831,180792,13901,353867,14641,7022,7619
60620,375729,21832,180809,13901,353897,14642,7022,7620
60625,375760,21833,180822,13902,353927,14643,7022,7621
60630,375791,21834,180836,13903,353957,14644,7022,7622
60635,375822,21835,180851,13904,353986,14645,7022,7623
60640,375853,21837,180863,13905,354016,14646,7022,7624
60645,375884,21838,180879,13905,354046,14647,7023,7624
60650,375915,21839,180891,13906,354076,14648,7024,7624
60655,375946,21841,180908,13908,354105,14649,7025,7624
60660,375977,21844,180921,13910,354133,14650,7026,7624
60665,376008,21846,180934,13911,354162,14651,7026,7625
60670,376039,21847,180950,13912,354192,14653,7028,7625
60675,376070,21848,180961,13912,354222,14656,7029,7627
60680,376101,21850,180970,13913,354251,14659,7029,7630
60685,376132,21853,180988,13916,354279,14661,7030,7631
60690,376163,21855,181005,13917,354308,14663,7032,7631
60695,376194,21856,181015,13917,354338,14665,7032,7633
60700,376225,21858,181033,13919,354367,14667,7033,7634
60705,376256,21860,181051,13920,354396,14669,7035,7634
60710,376287,21862,181069,13921,354425,14670,7035,7635
60715,376318,21864,181081,13921,354454,14671,7036,7635
60720,376349,21866,181096,13921,354483,14672,7036,7636
60725,376380,21867,181114,13921,354513,14673,7036,7637
60730,376411,21868,181126,13921,354543,14674,7037,7637
60735,376442,21869,181141,13921,354573,14675,7038,7637
60740,376473,21870,181152,13921,354603,14676,7038,7638
60745,376504,21871,181172,13921,354633,14677,7038,7639
60750,376535,21872,181187,13922,354663,14678,7039,7639
60755,376566,21873,181204,13923,354693,14679,7039,7640
60760,376597,21874,181219,13923,354723,14680,7039,7641
60765,376628,21875,181234,13924,354753,14681,7039,7642
60770,376659,21878,181249,13925,354781,14682,7040,7642
60775,376690,21881,181263,13927,354808,14683,7041,7642
60780,376721,21885,181278,13930,354836,14684,7041,7643
60785,376752,21888,181292,13933,354864,14686,7042,7644
60790,376783,21890,181306,13934,354893,14688,7043,7645
60795,376814,21893,181321,13936,354921,14690,7044,7646
60800,376845,21896,181339,13937,354949,14692,7045,7647
60805,376876,21899,181355,13940,354977,14694,7045,7649
60810,376907,21900,181372,13940,355007,14697,7046,7651
60815,376938,21902,181385,13942,355036,14700,7047,7653
60820,376969,21902,181400,13942,355067,14703,7050,7653
60825,377000,21902,181411,13942,355098,14706,7050,7656
60830,377031,21904,181425,13943,355127,14708,7051,7657
60835,377062,21906,181436,13944,355156,14710,7051,7659
60840,377093,21907,181453,13944,355186,14712,7051,7661
60845,377124,21910,181468,13946,355214,14713,7051,7662
60850,377155,21912,181482,13947,355243,14714,7052,7662
60855,377186,21913,181496,13948,355273,14715,7053,7662
60860,377217,21914,181513,13948,355303,14716,7053,7663
60865,377248,21915,181530,13949,355333,14717,7053,7664
60870,377279,21916,181546,13949,355363,14718,7053,7665
60875,377310,21917,181558,13949,355393,14719,7053,7666
60880,377341,21918,181568,13949,355423,14720,7054,7666
60885,377372,21919,181583,13949,355453,14721,7054,7667
60890,377403,21921,181599,13951,355482,14722,7055,7667
60895,377434,21922,181608,13951,355512,14723,7055,7668
60900,377465,21924,181627,13953,355541,14724,7055,7669
60905,377496,21925,181643,13953,355571,14725,7056,7669
60910,377527,21926,181660,13954,355601,14726,7057,7669
60915,377558,21928,181679,13956,355630,14727,7058,7669
60920,377589,21929,181695,13956,355660,14728,7058,7670
60925,377620,21930,181708,13956,355690,14729,7058,7671
60930,377651,21931,181720,13957,355720,14730,7058,7672
60935,377682,21932,181736,13958,355750,14731,7059,7672
60940,377713,21934,181752,13959,355779,14732,7060,7672
60945,377744,21934,181770,13959,355810,14733,7061,7672
60950,377775,21937,181784,13960,355837,14735,7062,7673
60955,377806,21941,181798,13963,355864,14737,7064,7673
60960,377837,21946,181814,13966,355891,14738,7065,7673
60965,377868,21949,181832,13968,355919,14740,7066,7674
60970,377899,21953,181847,13971,355946,14742,7066,7676
60975,377930,21955,181860,13972,355975,14744,7066,7678
60980,377961,21957,181869,13973,356004,14746,7067,7679
60985,377992,21960,181882,13974,356032,14748,7067,7681
60990,378023,21964,181899,13977,356059,14750,7069,7681
60995,378054,21966,181913,13978,356088,14752,7069,7683
61000,378085,21968,181925,13978,356117,14754,7070,7684
61005,378116,21972,181935,13981,356144,14756,7071,7685
61010,378147,21976,181952,13984,356171,14758,7073,7685
61015,378178,21980,181966,13986,356198,14759,7074,7685
61020,378209,21981,181985,13986,356228,14760,7075,7685
61025,378240,21982,182002,13986,356258,14761,7075,7686
61030,378271,21983,182018,13986,356288,14762,7076,7686
61035,378302,21984,182035,13986,356318,14763,7076,7687
61040,378333,21985,182049,13987,356348,14764,7076,7688
61045,378364,21986,182061,13987,356378,14765,7076,7689
61050,378395,21988,182077,13987,356407,14766,7076,7690
61055,378426,21990,182091,13989,356436,14767,7076,7691
61060,378457,21992,182104,13989,356465,14769,7078,7691
61065,378488,21996,182121,13992,356492,14771,7079,7692
61070,378519,21999,182138,13995,356520,14772,7080,7692
61075,378550,22001,182155,13997,356549,14773,7081,7692
61080,378581,22003,182172,13998,356578,14774,7082,7692
61085,378612,22006,182188,14000,356606,14775,7082,7693
61090,378643,22008,182202,14001,356635,14776,7082,7694
61095,378674,22011,182221,14003,356663,14777,7083,7694
61100,378705,22014,182240,14005,356691,14778,7083,7695
61105,378736,22016,182257,14006,356720,14779,7084,7695
61110,378767,22019,182268,14008,356748,14780,7084,7696
61115,378798,22020,182283,14009,356778,14781,7084,7697
61120,378829,22022,182296,14011,356807,14782,7085,7697
61125,378860,22025,182313,14013,356835,14783,7085,7698
61130,378891,22027,182330,14014,356864,14784,7086,7698
61135,378922,22028,182344,14015,356894,14785,7086,7699
61140,378953,22028,182360,14015,356925,14786,7087,7699
61145,378984,22028,182368,14015,356956,14788,7087,7701
61150,379015,22028,182382,14015,356987,14790,7087,7703
61155,379046,22028,182398,14015,357018,14792,7088,7704
61160,379077,22028,182414,14015,357049,14793,7089,7704
61165,379108,22028,182431,14015,357080,14794,7090,7704
61170,379139,22028,182443,14015,357111,14795,7090,7705
61175,379170,22028,182458,14015,357142,14796,7090,7706
61180,379201,22028,182473,14015,357173,14797,7091,7706
61185,379232,22028,182486,14015,357204,14798,7092,7706
61190,379263,22029,182496,14015,357234,14799,7093,7706
61195,379294,22030,182513,14016,357264,14800,7093,7707
61200,379325,22031,182523,14016,357293,14801,7093,7708
61205,379356,22036,182534,14019,357320,14803,7093,7710
61210,379387,22039,182549,14021,357348,14804,7094,7710
61215,379418,22042,182562,14021,357376,14805,7095,7710
61220,379449,22045,182582,14023,357404,14806,7095,7711
61225,379480,22048,182598,14026,357432,14807,7096,7711
61230,379511,22051,182613,14026,357460,14808,7097,7711
61235,379542,22054,182623,14027,357488,14809,7097,7712
61240,379573,22057,182636,14028,357516,14810,7098,7712
61245,379604,22060,182653,14030,357544,14811,7099,7712
61250,379635,22064,182665,14032,357571,14812,7100,7712
61255,379666,22067,182679,14034,357599,14813,7100,7713
61260,379697,22071,182699,14037,357626,14815,7100,7715
61265,379728,22073,182714,14038,357655,14817,7101,7716
61270,379759,22075,182727,14038,357684,14819,7101,7718
61275,379790,22077,182740,14039,357713,14820,7101,7719
61280,379821,22079,182752,14039,357742,14821,7102,7719
61285,379852,22082,182768,14040,357770,14822,7102,7720
61290,379883,22085,182785,14042,357798,14823,7103,7720
61295,379914,22088,182804,14044,357826,14824,7104,7720
61300,379945,22091,182820,14045,357854,14825,7104,7721
61305,379976,22093,182832,14046,357883,14827,7105,7722
61310,380007,22094,182851,14047,357913,14829,7106,7723
61315,380038,22095,182860,14047,357943,14831,7106,7725
61320,380069,22096,182875,14047,357972,14832,7107,7725
61325,380100,22098,182897,14049,358002,14833,7108,7725
61330,380131,22098,182917,14049,358033,14834,7109,7725
61335,380162,22098,182930,14049,358064,14835,7109,7726
61340,380193,22098,182943,14049,358095,14836,7110,7726
61345,380224,22098,182959,14049,358126,14837,7111,7726
61350,380255,22098,182980,14049,358157,14838,7112,7726
61355,380286,22098,182995,14049,358188,14839,7112,7727
61360,380317,22098,183008,14049,358219,14840,7112,7728
61365,380348,22098,183026,14049,358250,14841,7113,7728
61370,380379,22098,183044,14049,358281,14842,7114,7728
61375,380410,22098,183059,14049,358312,14844,7114,7730
61380,380441,22098,183076,14049,358343,14846,7115,7731
61385,380472,22098,183090,14049,358374,14848,7115,7733
61390,380503,22098,183105,14049,358405,14849,7116,7733
61395,380534,22098,183124,14049,358436,14850,7117,7733
61400,380565,22098,183139,14049,358467,14851,7117,7734
61405,380596,22098,183154,14049,358498,14852,7118,7734
61410,380627,22099,183169,14049,358528,14853,7119,7734
61415,380658,22100,183183,14049,358558,14854,7120,7734
61420,380689,22101,183196,14049,358588,14855,7120,7735
61425,380720,22103,183205,14050,358617,14857,7121,7736
61430,380751,22106,183215,14051,358645,14859,7122,7737
61435,380782,22111,183229,14053,358671,14861,7123,7738
61440,380813,22117,183244,14057,358695,14863,7125,7738
61445,380844,22122,183256,14060,358722,14863,7125,7738
61450,380875,22124,183274,14062,358751,14863,7125,7738
61455,380906,22125,183290,14063,358781,14863,7125,7738
61460,380937,22127,183307,14064,358810,14863,7125,7738
61465,380968,22128,183317,14065,358840,14863,7125,7738
61470,380999,22130,183332,14066,358869,14863,7125,7738
61475,381030,22131,183348,14066,358899,14863,7125,7738
61480,381061,22133,183365,14068,358928,14863,7125,7738
61485,381092,22135,183379,14069,358957,14863,7125,7738
61490,381123,22135,183393,14069,358988,14864,7125,7739
61495,381154,22135,183406,14069,359019,14865,7125,7740
61500,381185,22135,183419,14069,359050,14866,7125,7741
61505,381216,22135,183432,14069,359081,14867,7126,7741
61510,381247,22135,183448,14069,359112,14868,7127,7741
61515,381278,22135,183463,14069,359143,14868,7127,7741
61520,381309,22135,183482,14069,359174,14868,7127,7741
61525,381340,22135,183499,14069,359205,14868,7127,7741
61530,381371,22135,183518,14069,359236,14868,7127,7741
61535,381402,22135,183537,14069,359267,14868,7127,7741
61540,381433,22135,183559,14069,359298,14868,7127,7741
61545,381464,22135,183576,14069,359329,14870,7129,7741
61550,381495,22138,183592,14071,359357,14872,7131,7741
61555,381526,22141,183607,14073,359385,14874,7132,7742
61560,381557,22144,183625,14075,359413,14876,7134,7742
61565,381588,22148,183641,14077,359440,14877,7135,7742
61570,381619,22150,183664,14079,359469,14878,7136,7742
61575,381650,22153,183678,14082,359497,14879,7137,7742
61580,381681,22156,183699,14084,359525,14880,7138,7742
61585,381712,22157,183710,14084,359555,14881,7139,7742
61590,381743,22158,183730,14084,359585,14882,7139,7743
61595,381774,22159,183748,14084,359615,14883,7140,7743
61600,381805,22160,183766,14084,359645,14884,7140,7744
61605,381836,22161,183779,14084,359675,14885,7140,7745
61610,381867,22162,183792,14084,359705,14886,7140,7746
61615,381898,22163,183808,14085,359735,14888,7140,7748
61620,381929,22164,183821,14085,359765,14890,7141,7749
61625,381960,22165,183838,14085,359795,14892,7141,7751
61630,381991,22166,183854,14086,359825,14893,7141,7752
61635,382022,22167,183873,14087,359855,14894,7141,7753
61640,382053,22168,183893,14088,359885,14895,7142,7753
61645,382084,22169,183907,14089,359915,14896,7142,7754
61650,382115,22170,183918,14090,359945,14897,7142,7755
61655,382146,22171,183934,14090,359975,14898,7143,7755
61660,382177,22172,183947,14091,360005,14899,7144,7755
61665,382208,22174,183965,14093,360034,14900,7145,7755
61670,382239,22177,183977,14096,360062,14902,7146,7756
61675,382270,22181,183993,14099,360089,14904,7147,7757
61680,382301,22183,184005,14101,360118,14906,7148,7758
61685,382332,22185,184017,14103,360147,14907,7149,7758
61690,382363,22187,184035,14104,360176,14908,7149,7759
61695,382394,22188,184048,14104,360206,14909,7150,7759
61700,382425,22189,184061,14104,360236,14910,7151,7759
61705,382456,22192,184078,14107,360264,14911,7152,7759
61710,382487,22194,184098,14108,360293,14912,7153,7759
61715,382518,22196,184113,14109,360322,14913,7154,7759
61720,382549,22197,184130,14110,360352,14914,7155,7759
61725,382580,22197,184144,14110,360383,14915,7156,7759
61730,382611,22197,184162,14110,360414,14917,7157,7760
61735,382642,22197,184175,14110,360445,14919,7157,7762
61740,382673,22197,184191,14110,360476,14921,7159,7762
61745,382704,22197,184207,14110,360507,14923,7160,7763
61750,382735,22197,184221,14110,360538,14925,7160,7765
61755,382766,22197,184240,14110,360569,14927,7161,7766
61760,382797,22197,184258,14110,360600,14928,7161,7767
61765,382828,22197,184275,14110,360631,14929,7161,7768
61770,382859,22197,184290,14110,360662,14930,7161,7769
61775,382890,22197,184304,14110,360693,14931,7161,7770
61780,382921,22199,184322,14112,360722,14932,7162,7770
61785,382952,22202,184340,14115,360750,14934,7163,7771
61790,382983,22207,184359,14120,360776,14935,7163,7772
61795,383014,22210,184371,14122,360804,14936,7163,7773
61800,383045,22212,184386,14124,360833,14937,7164,7773
61805,383076,22217,184401,14128,360859,14938,7165,7773
61810,383107,22221,184418,14129,360886,14939,7166,7773
61815,383138,22226,184435,14132,360912,14940,7167,7773
61820,383169,22230,184453,14135,360939,14941,7168,7773
61825,383200,22232,184465,14136,360968,14942,7168,7774
61830,383231,22234,184481,14137,360997,14943,7169,7774
61835,383262,22236,184493,14138,361026,14944,7169,7775
61840,383293,22237,184508,14138,361056,14945,7170,7775
61845,383324,22239,184524,14139,361085,14946,7171,7775
61850,383355,22242,184544,14142,361113,14947,7171,7776
61855,383386,22243,184554,14143,361143,14948,7172,7776
61860,383417,22245,184568,14144,361172,14950,7172,7778
61865,383448,22245,184588,14144,361203,14952,7174,7778
61870,383479,22245,184600,14144,361234,14954,7174,7780
61875,383510,22245,184616,14144,361265,14956,7174,7782
61880,383541,22245,184633,14144,361296,14958,7176,7782
61885,383572,22245,184648,14144,361327,14960,7176,7784
61890,383603,22245,184662,14144,361358,14961,7176,7785
61895,383634,22245,184680,14144,361389,14963,7176,7787
61900,383665,22245,184700,14144,361420,14965,7177,7788
61905,383696,22245,184716,14144,361451,14967,7178,7789
61910,383727,22245,184729,14144,361482,14969,7179,7790
61915,383758,22245,184745,14144,361513,14971,7179,7792
61920,383789,22245,184762,14144,361544,14973,7181,7792
61925,383820,22249,184776,14146,361571,14974,7182,7792
61930,383851,22252,184788,14148,361599,14975,7182,7793
61935,383882,22255,184802,14150,361627,14976,7183,7793
61940,383913,22259,184813,14151,361654,14977,7184,7793
61945,383944,22263,184828,14154,361681,14978,7184,7794
61950,383975,22266,184842,14155,361709,14979,7184,7795
61955,384006,22269,184857,14157,361737,14980,7184,7796
61960,384037,22272,184869,14157,361765,14981,7185,7796
61965,384068,22275,184882,14158,361793,14982,7186,7796
61970,384099,22278,184897,14160,361821,14983,7187,7796
61975,384130,22282,184913,14161,361848,14984,7188,7796
61980,384161,22286,184930,14165,361875,14985,7189,7796
61985,384192,22288,184942,14166,361904,14987,7190,7797
61990,384223,22290,184956,14166,361933,14988,7191,7797
61995,384254,22293,184975,14168,361961,14989,7192,7797
62000,384285,22295,184989,14170,361990,14990,7192,7798
62005,384316,22298,185006,14171,362018,14991,7192,7799
62010,384347,22300,185018,14172,362047,14992,7193,7799
62015,384378,22302,185037,14174,362076,14993,7194,7799
62020,384409,22304,185054,14175,362105,14994,7194,7800
62025,384440,22308,185071,14178,362132,14996,7195,7801
62030,384471,22313,185086,14182,362158,14998,7195,7803
62035,384502,22317,185100,14185,362185,15000,7196,7804
62040,384533,22321,185113,14188,362212,15002,7197,7805
62045,384564,22321,185125,14188,362243,15004,7198,7806
62050,384595,22321,185139,14188,362274,15005,7199,7806
62055,384626,22321,185155,14188,362305,15006,7200,7806
62060,384657,22321,185171,14188,362336,15007,7200,7807
62065,384688,22321,185182,14188,362367,15008,7200,7808
62070,384719,22321,185198,14188,362398,15009,7200,7809
62075,384750,22321,185213,14188,362429,15010,7201,7809
62080,384781,22321,185227,14188,362460,15011,7202,7809
62085,384812,22321,185240,14188,362491,15012,7203,7809
62090,384843,22321,185253,14188,362522,15013,7204,7809
62095,384874,22321,185268,14188,362553,15014,7204,7810
62100,384905,22321,185282,14188,362584,15015,7204,7811
62105,384936,22321,185297,14188,362615,15017,7205,7812
62110,384967,22321,185310,14188,362646,15019,7207,7812
62115,384998,22321,185324,14188,362677,15021,7207,7814
62120,385029,22321,185342,14188,362708,15023,7207,7816
62125,385060,22321,185356,14188,362739,15024,7207,7817
62130,385091,22321,185373,14188,362770,15025,7208,7817
62135,385122,22321,185389,14188,362801,15026,7209,7817
62140,385153,22321,185407,14188,362832,15027,7210,7817
62145,385184,22323,185423,14189,362861,15028,7211,7817
62150,385215,22326,185437,14191,362889,15029,7211,7818
62155,385246,22331,185457,14195,362914,15031,7212,7819
62160,385277,22337,185470,14200,362939,15033,7213,7820
62165,385308,22342,185487,14204,362966,15034,7213,7821
62170,385339,22344,185505,14205,362995,15035,7214,7821
62175,385370,22346,185519,14207,363024,15036,7214,7822
62180,385401,22347,185537,14207,363054,15037,7215,7822
62185,385432,22348,185548,14207,363084,15038,7215,7823
62190,385463,22350,185564,14208,363113,15039,7216,7823
62195,385494,22351,185577,14208,363143,15040,7217,7823
62200,385525,22352,185595,14209,363173,15041,7218,7823
62205,385556,22353,185611,14210,363203,15042,7219,7823
62210,385587,22354,185621,14211,363233,15043,7220,7823
62215,385618,22355,185633,14211,363263,15044,7221,7823
62220,385649,22356,185645,14211,363293,15045,7221,7824
62225,385680,22357,185659,14211,363323,15047,7221,7826
62230,385711,22358,185672,14211,363353,15049,7222,7827
62235,385742,22359,185686,14211,363383,15051,7223,7828
62240,385773,22360,185701,14211,363413,15053,7224,7829
62245,385804,22361,185717,14211,363443,15055,7226,7829
62250,385835,22362,185734,14212,363473,15057,7227,7830
62255,385866,22363,185753,14212,363503,15059,7228,7831
62260,385897,22365,185769,14213,363532,15061,7229,7832
62265,385928,22365,185785,14213,363563,15062,7229,7833
62270,385959,22367,185800,14215,363592,15063,7230,7833
62275,385990,22370,185813,14216,363620,15064,7231,7833
62280,386021,22373,185830,14218,363647,15065,7232,7833
62285,386052,22378,185842,14222,363674,15067,7232,7835
62290,386083,22380,185854,14223,363703,15069,7233,7836
62295,386114,22383,185870,14224,363731,15071,7234,7837
62300,386145,22387,185886,14227,363758,15073,7234,7839
62305,386176,22389,185901,14227,363787,15075,7235,7840
62310,386207,22392,185915,14229,363815,15077,7236,7841
62315,386238,22395,185929,14231,363843,15078,7237,7841
62320,386269,22396,185943,14232,363873,15079,7238,7841
62325,386300,22397,185954,14233,363903,15080,7239,7841
62330,386331,22398,185970,14233,363933,15081,7240,7841
62335,386362,22399,185983,14233,363963,15082,7240,7842
62340,386393,22400,185991,14233,363993,15083,7240,7843
62345,386424,22401,186005,14234,364023,15084,7241,7843
62350,386455,22402,186020,14235,364053,15085,7241,7844
62355,386486,22403,186030,14236,364083,15086,7242,7844
62360,386517,22404,186050,14237,364113,15087,7243,7844
62365,386548,22405,186066,14238,364143,15089,7245,7844
62370,386579,22406,186081,14239,364173,15091,7247,7844
62375,386610,22407,186098,14239,364203,15093,7249,7844
62380,386641,22408,186114,14239,364233,15095,7251,7844
62385,386672,22409,186135,14239,364263,15096,7252,7844
62390,386703,22412,186149,14240,364291,15097,7253,7844
62395,386734,22414,186159,14242,364320,15098,7254,7844
62400,386765,22415,186169,14242,364350,15099,7254,7845
62405,386796,22416,186185,14242,364380,15100,7255,7845
62410,386827,22418,186203,14243,364409,15101,7256,7845
62415,386858,22420,186216,14245,364438,15102,7256,7846
62420,386889,22422,186228,14245,364467,15103,7256,7847
62425,386920,22425,186242,14247,364495,15104,7257,7847
62430,386951,22427,186255,14247,364524,15105,7257,7848
62435,386982,22430,186271,14248,364552,15106,7258,7848
62440,387013,22433,186286,14250,364580,15107,7259,7848
62445,387044,22437,186302,14254,364607,15108,7260,7848
62450,387075,22439,186324,14255,364636,15109,7261,7848
62455,387106,22443,186342,14257,364663,15110,7262,7848
62460,387137,22446,186352,14258,364691,15111,7262,7849
62465,387168,22448,186369,14260,364720,15112,7263,7849
62470,387199,22449,186382,14260,364750,15113,7263,7850
62475,387230,22451,186393,14262,364779,15114,7263,7851
62480,387261,22453,186409,14263,364808,15115,7263,7852
62485,387292,22455,186424,14264,364837,15117,7263,7854
62490,387323,22457,186438,14266,364866,15119,7264,7855
62495,387354,22458,186449,14267,364896,15121,7265,7856
62500,387385,22460,186467,14268,364925,15123,7266,7857
62505,387416,22461,186477,14268,364955,15124,7266,7858
62510,387447,22463,186491,14268,364984,15125,7267,7858
62515,387478,22466,186508,14270,365012,15126,7268,7858
62520,387509,22468,186521,14270,365041,15127,7269,7858
62525,387540,22469,186539,14271,365071,15128,7270,7858
62530,387571,22470,186552,14271,365101,15129,7271,7858
62535,387602,22471,186564,14272,365131,15130,7271,7859
62540,387633,22472,186574,14272,365161,15131,7271,7860
62545,387664,22473,186585,14273,365191,15132,7272,7860
62550,387695,22474,186601,14274,365221,15134,7273,7861
62555,387726,22476,186622,14275,365250,15136,7275,7861
62560,387757,22477,186634,14276,365280,15138,7276,7862
62565,387788,22480,186650,14279,365308,15140,7276,7864
62570,387819,22482,186667,14280,365337,15142,7277,7865
62575,387850,22485,186682,14283,365365,15144,7277,7867
62580,387881,22488,186698,14285,365393,15145,7277,7868
62585,387912,22492,186711,14288,365420,15146,7277,7869
62590,387943,22496,186726,14291,365447,15147,7277,7870
62595,387974,22500,186740,14293,365474,15148,7277,7871
62600,388005,22504,186754,14295,365501,15149,7278,7871
62605,388036,22507,186763,14296,365529,15151,7278,7873
62610,388067,22511,186776,14299,365556,15153,7279,7874
62615,388098,22514,186791,14300,365584,15155,7280,7875
62620,388129,22517,186802,14301,365612,15157,7281,7876
62625,388160,22519,186818,14302,365640,15159,7282,7877
62630,388191,22525,186833,14307,365666,15161,7284,7877
62635,388222,22529,186850,14310,365693,15163,7285,7878
62640,388253,22532,186864,14312,365721,15165,7286,7879
62645,388284,22534,186879,14313,365750,15166,7286,7880
62650,388315,22535,186897,14314,365780,15167,7287,7880
62655,388346,22536,186908,14315,365810,15168,7287,7881
62660,388377,22537,186925,14316,365840,15169,7288,7881
62665,388408,22538,186937,14317,365870,15170,7288,7882
62670,388439,22539,186948,14317,365900,15171,7288,7883
62675,388470,22540,186963,14317,365930,15172,7288,7884
62680,388501,22541,186979,14317,365960,15173,7289,7884
62685,388532,22542,186995,14317,365990,15174,7289,7885
62690,388563,22543,187008,14317,366020,15175,7289,7886
62695,388594,22544,187025,14317,366050,15176,7290,7886
62700,388625,22545,187036,14317,366080,15177,7290,7887
62705,388656,22547,187050,14318,366109,15177,7290,7887
62710,388687,22548,187066,14319,366139,15177,7290,7887
62715,388718,22549,187080,14319,366169,15177,7290,7887
62720,388749,22551,187093,14319,366198,15177,7290,7887
62725,388780,22553,187104,14321,366227,15177,7290,7887
62730,388811,22555,187122,14322,366256,15177,7290,7887
62735,388842,22557,187138,14322,366285,15177,7290,7887
62740,388873,22559,187160,14324,366314,15177,7290,7887
62745,388904,22562,187174,14327,366342,15177,7290,7887
62750,388935,22564,187187,14328,366371,15177,7290,7887
62755,388966,22569,187199,14331,366397,15178,7291,7887
62760,388997,22571,187207,14332,366425,15180,7292,7888
62765,389028,22575,187219,14336,366453,15181,7293,7888
62770,389059,22575,187236,14336,366484,15182,7294,7888
62775,389090,22575,187255,14336,366515,15183,7295,7888
62780,389121,22575,187270,14336,366546,15184,7296,7888
62785,389152,22575,187288,14336,366577,15185,7296,7889
62790,389183,22575,187306,14336,366608,15186,7297,7889
62795,389214,22575,187323,14336,366639,15187,7297,7890
62800,389245,22575,187340,14336,366670,15188,7297,7891
62805,389276,22575,187359,14336,366701,15189,7298,7891
62810,389307,22575,187373,14336,366732,15190,7298,7892
62815,389338,22578,187387,14338,366760,15192,7298,7894
62820,389369,22580,187401,14339,366789,15194,7298,7896
62825,389400,22582,187416,14340,366818,15195,7298,7897
62830,389431,22583,187430,14340,366848,15196,7299,7897
62835,389462,22584,187447,14340,366878,15197,7300,7897
62840,389493,22585,187463,14340,366908,15198,7300,7898
62845,389524,22587,187481,14341,366937,15199,7301,7898
62850,389555,22589,187493,14342,366966,15200,7301,7899
62855,389586,22590,187504,14342,366996,15201,7302,7899
62860,389617,22592,187518,14343,367025,15202,7303,7899
62865,389648,22594,187537,14345,367053,15203,7303,7900
62870,389679,22598,187551,14349,367081,15205,7304,7901
62875,389710,22602,187569,14350,367108,15207,7305,7902
62880,389741,22606,187587,14354,367135,15208,7305,7903
62885,389772,22610,187599,14356,367162,15209,7305,7904
62890,389803,22613,187609,14358,367190,15210,7305,7905
62895,389834,22616,187622,14359,367218,15211,7305,7906
62900,389865,22619,187638,14362,367246,15212,7306,7906
62905,389896,22622,187651,14364,367274,15213,7306,7907
62910,389927,22625,187665,14366,367302,15214,7306,7908
62915,389958,22627,187682,14367,367331,15215,7307,7908
62920,389989,22630,187693,14370,367359,15216,7307,7909
62925,390020,22634,187707,14373,367386,15217,7307,7910
62930,390051,22637,187723,14376,367414,15218,7307,7911
62935,390082,22640,187736,14378,367442,15219,7307,7912
62940,390113,22644,187753,14381,367469,15220,7307,7913
62945,390144,22645,187767,14381,367499,15221,7307,7914
62950,390175,22646,187783,14381,367529,15222,7308,7914
62955,390206,22647,187798,14381,367559,15223,7308,7915
62960,390237,22648,187819,14381,367589,15224,7309,7915
62965,390268,22649,187836,14382,367619,15225,7310,7915
62970,390299,22650,187851,14382,367649,15226,7310,7916
62975,390330,22651,187862,14383,367679,15227,7310,7917
62980,390361,22652,187880,14384,367709,15229,7311,7918
62985,390392,22653,187897,14384,367739,15231,7312,7919
62990,390423,22654,187906,14384,367769,15232,7312,7920
62995,390454,22655,187917,14385,367799,15233,7312,7921
63000,390485,22656,187930,14385,367829,15234,7312,7922
63005,390516,22659,187941,14386,367857,15236,7313,7923
63010,390547,22663,187959,14390,367884,15238,7314,7924
63015,390578,22668,187981,14394,367910,15240,7314,7926
63020,390609,22670,187997,14396,367939,15242,7315,7927
63025,390640,22671,188017,14397,367969,15243,7316,7927
63030,390671,22672,188033,14398,367999,15244,7317,7927
63035,390702,22673,188054,14399,368029,15245,7318,7927
63040,390733,22674,188072,14400,368059,15246,7319,7927
63045,390764,22675,188082,14400,368089,15247,7320,7927
63050,390795,22677,188100,14401,368118,15248,7320,7928
63055,390826,22679,188114,14402,368147,15249,7321,7928
63060,390857,22679,188132,14402,368178,15250,7321,7929
63065,390888,22679,188143,14402,368209,15251,7322,7929
63070,390919,22679,188163,14402,368240,15252,7323,7929
63075,390950,22679,188177,14402,368271,15253,7323,7930
63080,390981,22679,188198,14402,368302,15254,7323,7931
63085,391012,22679,188212,14402,368333,15255,7323,7932
63090,391043,22679,188232,14402,368364,15256,7324,7932
63095,391074,22679,188244,14402,368395,15257,7324,7933
63100,391105,22679,188256,14402,368426,15258,7325,7933
63105,391136,22679,188272,14402,368457,15259,7325,7934
63110,391167,22680,188287,14403,368487,15261,7326,7935
63115,391198,22681,188301,14403,368517,15263,7326,7937
63120,391229,22682,188316,14403,368547,15264,7327,7937
63125,391260,22684,188332,14404,368576,15265,7328,7937
63130,391291,22686,188345,14406,368605,15266,7329,7937
63135,391322,22689,188364,14407,368633,15267,7330,7937
63140,391353,22691,188376,14407,368662,15268,7331,7937
63145,391384,22694,188394,14410,368690,15269,7332,7937
63150,391415,22697,188407,14411,368718,15270,7332,7938
63155,391446,22699,188422,14412,368747,15271,7333,7938
63160,391477,22701,188440,14414,368776,15272,7333,7939
63165,391508,22704,188456,14416,368804,15273,7334,7939
63170,391539,22710,188471,14421,368829,15275,7335,7940
63175,391570,22715,188492,14425,368854,15277,7337,7940
63180,391601,22723,188511,14430,368877,15278,7337,7941
63185,391632,22726,188524,14432,368906,15279,7338,7941
63190,391663,22726,188540,14432,368937,15280,7338,7942
63195,391694,22726,188556,14432,368968,15280,7338,7942
63200,391725,22726,188564,14432,368999,15280,7338,7942
63205,391756,22726,188582,14432,369030,15280,7338,7942
63210,391787,22726,188594,14432,369061,15280,7338,7942
63215,391818,22726,188611,14432,369092,15280,7338,7942
63220,391849,22726,188621,14432,369123,15280,7338,7942
63225,391880,22726,188638,14432,369154,15280,7338,7942
63230,391911,22726,188655,14432,369185,15280,7338,7942
63235,391942,22726,188669,14432,369216,15280,7338,7942
63240,391973,22726,188683,14432,369247,15280,7338,7942
63245,392004,22726,188702,14432,369278,15280,7338,7942
63250,392035,22726,188715,14432,369309,15280,7338,7942
63255,392066,22726,188727,14432,369340,15280,7338,7942
63260,392097,22726,188747,14432,369371,15280,7338,7942
63265,392128,22726,188764,14432,369402,15280,7338,7942
63270,392159,22726,188782,14432,369433,15280,7338,7942
63275,392190,22726,188801,14432,369464,15280,7338,7942
63280,392221,22726,188814,14432,369495,15281,7338,7943
63285,392252,22728,188833,14434,369524,15283,7339,7944
63290,392283,22731,188846,14435,369552,15285,7340,7945
63295,392314,22736,188863,14438,369577,15288,7340,7948
63300,392345,22743,188880,14442,369602,15291,7340,7951
63305,392376,22746,188901,14444,369630,15293,7342,7951
63310,392407,22749,188917,14446,369658,15294,7342,7952
63315,392438,22750,188926,14446,369688,15295,7342,7953
63320,392469,22751,188935,14446,369718,15296,7342,7954
63325,392500,22752,188951,14446,369748,15297,7343,7954
63330,392531,22753,188964,14446,369778,15298,7343,7955
63335,392562,22754,188976,14447,369808,15299,7344,7955
63340,392593,22755,188994,14447,369838,15300,7344,7956
63345,392624,22756,189009,14447,369868,15301,7344,7957
63350,392655,22757,189028,14448,369898,15302,7345,7957
63355,392686,22758,189043,14448,369928,15303,7345,7958
63360,392717,22759,189059,14449,369958,15304,7345,7959
63365,392748,22760,189072,14449,369988,15305,7345,7960
63370,392779,22761,189092,14450,370018,15306,7346,7960
63375,392810,22762,189106,14451,370048,15307,7347,7960
63380,392841,22763,189122,14451,370078,15308,7347,7961
63385,392872,22764,189136,14451,370108,15309,7347,7962
63390,392903,22765,189153,14451,370138,15310,7348,7962
63395,392934,22766,189166,14451,370168,15311,7348,7963
63400,392965,22767,189185,14452,370198,15312,7349,7963
63405,392996,22768,189204,14453,370228,15314,7351,7963
63410,393027,22771,189218,14454,370256,15316,7352,7964
63415,393058,22776,189239,14459,370281,15319,7353,7966
63420,393089,22783,189260,14464,370305,15321,7354,7967
63425,393120,22787,189274,14468,370332,15322,7354,7968
63430,393151,22790,189289,14471,370360,15323,7354,7969
63435,393182,22793,189301,14472,370389,15324,7355,7969
63440,393213,22796,189318,14474,370417,15325,7355,7970
63445,393244,22798,189333,14474,370446,15326,7355,7971
63450,393275,22800,189346,14475,370475,15327,7355,7972
63455,393306,22803,189357,14476,370503,15328,7355,7973
63460,393337,22805,189370,14476,370532,15329,7356,7973
63465,393368,22807,189387,14477,370561,15330,7357,7973
63470,393399,22810,189403,14479,370589,15331,7357,7974
63475,393430,22813,189414,14481,370617,15332,7357,7975
63480,393461,22815,189423,14482,370646,15333,7357,7976
63485,393492,22818,189438,14483,370674,15334,7357,7977
63490,393523,22820,189455,14484,370703,15335,7358,7977
63495,393554,22823,189471,14486,370731,15336,7358,7978
63500,393585,22826,189489,14489,370759,15337,7359,7978
63505,393616,22829,189508,14491,370787,15338,7359,7979
63510,393647,22832,189526,14493,370815,15339,7360,7979
63515,393678,22834,189540,14494,370844,15340,7360,7980
63520,393709,22836,189558,14495,370873,15342,7362,7980
63525,393740,22839,189571,14497,370901,15345,7363,7982
63530,393771,22842,189585,14500,370929,15348,7364,7984
63535,393802,22846,189606,14504,370955,15350,7365,7985
63540,393833,22850,189622,14507,370983,15352,7366,7986
63545,393864,22852,189636,14508,371012,15353,7366,7987
63550,393895,22854,189651,14509,371040,15354,7366,7988
63555,393926,22856,189667,14511,371070,15355,7367,7988
63560,393957,22858,189681,14512,371098,15356,7368,7988
63565,393988,22860,189694,14513,371128,15357,7368,7989
63570,394019,22861,189704,14513,371158,15358,7368,7990
63575,394050,22863,189715,14514,371186,15359,7368,7991
63580,394081,22866,189727,14517,371215,15360,7368,7992
63585,394112,22866,189739,14517,371246,15361,7368,7993
63590,394143,22866,189755,14517,371277,15362,7369,7993
63595,394174,22866,189771,14517,371308,15363,7369,7994
63600,394205,22866,189789,14517,371339,15364,7370,7994
63605,394236,22866,189803,14517,371370,15365,7370,7995
63610,394267,22866,189820,14517,371401,15366,7370,7996
63615,394298,22866,189835,14517,371432,15367,7370,7997
63620,394329,22866,189845,14517,371463,15368,7370,7998
63625,394360,22866,189858,14517,371494,15369,7370,7999
63630,394391,22866,189873,14517,371525,15370,7371,7999
63635,394422,22867,189885,14517,371555,15372,7372,8000
63640,394453,22868,189901,14518,371585,15374,7373,8001
63645,394484,22871,189921,14520,371613,15377,7375,8002
63650,394515,22873,189936,14520,371642,15379,7377,8002
63655,394546,22875,189953,14522,371671,15381,7378,8003
63660,394577,22877,189970,14522,371700,15383,7379,8004
63665,394608,22879,189983,14522,371729,15385,7379,8006
63670,394639,22881,189999,14524,371758,15387,7380,8007
63675,394670,22883,190014,14524,371787,15389,7380,8009
63680,394701,22885,190029,14525,371816,15391,7381,8010
63685,394732,22887,190046,14526,371845,15393,7382,8011
63690,394763,22890,190062,14529,371873,15395,7383,8012
63695,394794,22893,190079,14530,371901,15397,7385,8012
63700,394825,22896,190094,14532,371929,15399,7386,8013
63705,394856,22899,190110,14533,371957,15401,7386,8015
63710,394887,22902,190121,14535,371985,15403,7387,8016
63715,394918,22905,190136,14536,372013,15405,7389,8016
63720,394949,22908,190146,14537,372041,15407,7389,8018
63725,394980,22911,190161,14538,372069,15409,7390,8019
63730,395011,22915,190175,14540,372096,15411,7392,8019
63735,395042,22918,190194,14542,372124,15413,7393,8020
63740,395073,22922,190208,14543,372150,15415,7394,8021
63745,395104,22928,190227,14548,372175,15417,7395,8022
63750,395135,22935,190244,14554,372199,15420,7397,8023
63755,395166,22940,190259,14557,372225,15423,7400,8023
63760,395197,22947,190276,14562,372249,15426,7400,8026
63765,395228,22952,190289,14566,372276,15429,7402,8027
63770,395259,22957,190305,14570,372302,15430,7403,8027
63775,395290,22962,190319,14573,372327,15431,7403,8028
63780,395321,22967,190335,14578,372354,15432,7403,8029
63785,395352,22970,190347,14579,372382,15433,7403,8030
63790,395383,22973,190366,14582,372410,15434,7404,8030
63795,395414,22976,190380,14584,372438,15435,7405,8030
63800,395445,22979,190394,14585,372466,15436,7406,8030
63805,395476,22980,190408,14585,372496,15437,7407,8030
63810,395507,22981,190422,14585,372526,15438,7407,8031
63815,395538,22982,190435,14585,372556,15439,7407,8032
63820,395569,22983,190447,14585,372586,15440,7408,8032
63825,395600,22984,190464,14586,372616,15441,7408,8033
63830,395631,22985,190481,14587,372646,15442,7408,8034
63835,395662,22986,190500,14587,372676,15443,7409,8034
63840,395693,22987,190513,14587,372706,15444,7410,8034
63845,395724,22987,190527,14587,372737,15446,7412,8034
63850,395755,22987,190542,14587,372768,15448,7412,8036
63855,395786,22987,190558,14587,372799,15449,7412,8037
63860,395817,22987,190574,14587,372830,15450,7412,8038
63865,395848,22987,190591,14587,372861,15451,7413,8038
63870,395879,22987,190604,14587,372892,15453,7414,8039
63875,395910,22987,190620,14587,372923,15455,7416,8039
63880,395941,22987,190632,14587,372954,15457,7417,8040
63885,395972,22989,190651,14589,372983,15459,7419,8040
63890,396003,22991,190663,14590,373011,15461,7419,8042
63895,396034,22993,190680,14592,373040,15463,7420,8043
63900,396065,22997,190698,14596,373068,15465,7420,8045
63905,396096,23000,190711,14598,373096,15467,7422,8045
63910,396127,23004,190726,14600,373123,15469,7423,8046
63915,396158,23006,190742,14602,373152,15471,7424,8047
63920,396189,23007,190751,14603,373182,15473,7424,8049
63925,396220,23008,190765,14603,373212,15474,7425,8049
63930,396251,23009,190779,14604,373242,15475,7425,8050
63935,396282,23010,190797,14604,373272,15476,7426,8050
63940,396313,23011,190811,14604,373302,15477,7426,8051
63945,396344,23012,190829,14605,373332,15478,7426,8052
63950,396375,23013,190845,14605,373362,15479,7427,8052
63955,396406,23016,190862,14607,373390,15480,7427,8053
63960,396437,23018,190873,14608,373419,15481,7428,8053
63965,396468,23020,190887,14609,373448,15482,7428,8054
63970,396499,23022,190905,14609,373477,15483,7428,8055
63975,396530,23024,190921,14610,373506,15484,7429,8055
63980,396561,23026,190935,14611,373535,15485,7430,8055
63985,396592,23028,190949,14612,373564,15486,7430,8056
63990,396623,23030,190965,14613,373593,15487,7430,8057
63995,396654,23032,190978,14614,373622,15488,7430,8058
64000,396685,23034,190990,14615,373651,15489,7430,8059
64005,396716,23036,191004,14616,373680,15490,7430,8060
64010,396747,23038,191020,14616,373709,15491,7430,8061
64015,396778,23041,191037,14617,373737,15492,7430,8062
64020,396809,23044,191053,14619,373765,15493,7431,8062
64025,396840,23047,191072,14620,373793,15494,7432,8062
64030,396871,23051,191092,14624,373820,15495,7432,8063
64035,396902,23055,191104,14627,373847,15496,7433,8063
64040,396933,23056,191119,14627,373877,15497,7433,8064
64045,396964,23057,191135,14627,373907,15498,7434,8064
64050,396995,23058,191155,14628,373937,15499,7434,8065
64055,397026,23059,191168,14628,373967,15500,7435,8065
64060,397057,23060,191187,14629,373997,15501,7436,8065
64065,397088,23061,191203,14629,374027,15502,7437,8065
64070,397119,23062,191221,14629,374057,15504,7438,8066
64075,397150,23063,191233,14629,374087,15506,7438,8068
64080,397181,23066,191254,14632,374115,15508,7440,8068
64085,397212,23068,191268,14633,374144,15510,7442,8068
64090,397243,23070,191280,14635,374173,15512,7442,8070
64095,397274,23072,191295,14637,374202,15514,7442,8072
64100,397305,23073,191315,14637,374232,15516,7443,8073
64105,397336,23075,191328,14638,374261,15518,7445,8073
64110,397367,23077,191346,14639,374290,15519,7446,8073
64115,397398,23077,191362,14639,374321,15520,7447,8073
64120,397429,23077,191376,14639,374352,15521,7447,8074
64125,397460,23077,191388,14639,374383,15522,7447,8075
64130,397491,23077,191403,14639,374414,15523,7448,8075
64135,397522,23077,191416,14639,374445,15524,7448,8076
64140,397553,23078,191429,14639,374475,15526,7448,8078
64145,397584,23080,191447,14640,374504,15527,7449,8078
64150,397615,23081,191466,14641,374534,15528,7450,8078
64155,397646,23083,191483,14643,374563,15529,7450,8079
64160,397677,23085,191498,14645,374592,15530,7451,8079
64165,397708,23087,191514,14646,374621,15531,7451,8080
64170,397739,23088,191528,14647,374651,15532,7452,8080
64175,397770,23090,191543,14649,374680,15533,7453,8080
64180,397801,23091,191555,14649,374710,15534,7454,8080
64185,397832,23093,191568,14651,374739,15535,7454,8081
64190,397863,23095,191580,14652,374768,15536,7454,8082
64195,397894,23098,191591,14653,374796,15537,7454,8083
64200,397925,23101,191612,14656,374824,15538,7454,8084
64205,397956,23103,191627,14656,374852,15538,7454,8084
64210,397987,23108,191647,14660,374879,15538,7454,8084
64215,398018,23110,191657,14660,374908,15538,7454,8084
64220,398049,23113,191675,14662,374936,15538,7454,8084
64225,398080,23118,191684,14665,374962,15538,7454,8084
64230,398111,23120,191701,14666,374991,15538,7454,8084
64235,398142,23122,191715,14668,375020,15538,7454,8084
64240,398173,23123,191728,14668,375050,15539,7454,8085
64245,398204,23125,191746,14670,375079,15540,7455,8085
64250,398235,23127,191760,14672,375108,15541,7456,8085
64255,398266,23129,191773,14673,375137,15542,7456,8086
64260,398297,23130,191788,14673,375167,15542,7456,8086
64265,398328,23130,191801,14673,375198,15543,7456,8087
64270,398359,23130,191817,14673,375229,15544,7457,8087
64275,398390,23130,191832,14673,375260,15545,7457,8088
64280,398421,23130,191851,14673,375291,15546,7458,8088
64285,398452,23130,191868,14673,375322,15547,7458,8089
64290,398483,23130,191879,14673,375353,15548,7458,8090
64295,398514,23130,191897,14673,375384,15549,7459,8090
64300,398545,23130,191911,14673,375415,15550,7460,8090
64305,398576,23130,191925,14673,375446,15551,7460,8091
64310,398607,23131,191943,14674,375476,15552,7461,8091
64315,398638,23132,191959,14674,375506,15553,7461,8092
64320,398669,23133,191977,14675,375536,15554,7462,8092
64325,398700,23135,191996,14676,375564,15555,7463,8092
64330,398731,23139,192008,14678,375592,15556,7463,8093
64335,398762,23142,192025,14679,375620,15557,7464,8093
64340,398793,23145,192040,14680,375648,15558,7464,8094
64345,398824,23147,192053,14680,375676,15559,7464,8095
64350,398855,23151,192065,14683,375704,15560,7464,8096
64355,398886,23155,192083,14686,375731,15561,7464,8097
64360,398917,23157,192097,14687,375759,15562,7465,8097
64365,398948,23161,192112,14690,375786,15563,7465,8098
64370,398979,23166,192123,14694,375813,15564,7465,8099
64375,399010,23171,192134,14696,375839,15565,7466,8099
64380,399041,23174,192146,14697,375866,15566,7466,8100
64385,399072,23177,192161,14700,375895,15567,7467,8100
64390,399103,23179,192175,14702,375924,15568,7467,8101
64395,399134,23181,192190,14703,375953,15569,7468,8101
64400,399165,23183,192206,14704,375982,15570,7469,8101
64405,399196,23184,192217,14704,376012,15571,7469,8102
64410,399227,23185,192229,14704,376042,15572,7469,8103
64415,399258,23186,192243,14704,376072,15573,7469,8104
64420,399289,23187,192255,14704,376102,15574,7469,8105
64425,399320,23188,192271,14705,376132,15575,7469,8106
64430,399351,23189,192282,14705,376162,15576,7470,8106
64435,399382,23190,192297,14706,376192,15577,7471,8106
64440,399413,23191,192310,14707,376222,15578,7471,8107
64445,399444,23192,192326,14708,376252,15579,7472,8107
64450,399475,23193,192335,14709,376282,15580,7472,8108
64455,399506,23194,192349,14709,376312,15581,7473,8108
64460,399537,23195,192361,14709,376342,15582,7473,8109
64465,399568,23196,192374,14709,376372,15583,7474,8109
64470,399599,23197,192392,14710,376402,15584,7475,8109
64475,399630,23198,192406,14711,376432,15585,7476,8109
64480,399661,23199,192422,14712,376462,15586,7477,8109
64485,399692,23201,192434,14714,376491,15587,7477,8110
64490,399723,23204,192452,14715,376518,15588,7477,8111
64495,399754,23209,192468,14719,376544,15589,7477,8112
64500,399785,23214,192483,14723,376570,15590,7478,8112
64505,399816,23217,192496,14726,376599,15590,7478,8112
64510,399847,23220,192510,14727,376627,15590,7478,8112
64515,399878,23223,192524,14729,376654,15590,7478,8112
64520,399909,23226,192541,14731,376682,15590,7478,8112
64525,399940,23230,192553,14734,376710,15590,7478,8112
64530,399971,23233,192569,14736,376738,15590,7478,8112
64535,400002,23235,192580,14736,376767,15591,7479,8112
64540,400033,23238,192601,14738,376795,15592,7480,8112
64545,400064,23241,192615,14739,376823,15592,7480,8112
64550,400095,23243,192627,14739,376852,15592,7480,8112
64555,400126,23246,192644,14742,376880,15592,7480,8112
64560,400157,23248,192652,14743,376909,15592,7480,8112
64565,400188,23249,192664,14743,376939,15593,7480,8113
64570,400219,23250,192682,14743,376969,15594,7480,8114
64575,400250,23251,192699,14744,376999,15595,7480,8115
64580,400281,23252,192715,14744,377029,15596,7480,8116
64585,400312,23253,192726,14744,377059,15597,7480,8117
64590,400343,23254,192744,14745,377089,15598,7480,8118
64595,400374,23255,192762,14746,377119,15599,7480,8119
64600,400405,23256,192771,14747,377149,15600,7480,8120
64605,400436,23257,192784,14747,377179,15601,7480,8121
64610,400467,23259,192797,14748,377208,15602,7480,8122
64615,400498,23260,192810,14748,377238,15603,7480,8123
64620,400529,23262,192824,14749,377267,15604,7480,8124
64625,400560,23263,192834,14749,377297,15605,7480,8125
64630,400591,23265,192853,14751,377326,15606,7481,8125
64635,400622,23267,192865,14753,377355,15607,7481,8126
64640,400653,23269,192881,14754,377384,15608,7482,8126
64645,400684,23271,192897,14756,377413,15610,7483,8127
64650,400715,23272,192910,14756,377443,15612,7484,8128
64655,400746,23273,192926,14756,377473,15614,7485,8129
64660,400777,23274,192942,14757,377503,15616,7486,8130
64665,400808,23275,192956,14757,377533,15618,7486,8132
64670,400839,23277,192971,14759,377562,15620,7487,8133
64675,400870,23279,192985,14759,377591,15622,7489,8133
64680,400901,23281,192999,14761,377620,15623,7489,8134
64685,400932,23284,193016,14763,377648,15625,7491,8134
64690,400963,23288,193027,14765,377675,15627,7491,8136
64695,400994,23293,193044,14769,377701,15628,7491,8137
64700,401025,23298,193057,14771,377727,15629,7491,8138
64705,401056,23301,193068,14773,377755,15630,7492,8138
64710,401087,23305,193080,14774,377782,15631,7492,8139
64715,401118,23309,193091,14776,377809,15632,7492,8140
64720,401149,23314,193111,14781,377835,15633,7493,8140
64725,401180,23318,193125,14784,377862,15634,7493,8141
64730,401211,23321,193134,14786,377890,15635,7493,8142
64735,401242,23323,193154,14786,377919,15636,7494,8142
64740,401273,23325,193169,14787,377948,15637,7495,8142
64745,401304,23327,193185,14788,377977,15638,7496,8142
64750,401335,23327,193202,14788,378008,15639,7497,8142
64755,401366,23327,193213,14788,378039,15640,7497,8143
64760,401397,23327,193225,14788,378070,15641,7497,8144
64765,401428,23327,193240,14788,378101,15642,7497,8145
64770,401459,23327,193255,14788,378132,15643,7497,8146
64775,401490,23327,193270,14788,378163,15644,7497,8147
64780,401521,23327,193282,14788,378194,15646,7498,8148
64785,401552,23327,193296,14788,378225,15648,7498,8150
64790,401583,23327,193314,14788,378256,15650,7499,8151
64795,401614,23327,193323,14788,378287,15653,7501,8152
64800,401645,23327,193343,14788,378318,15655,7502,8153
64805,401676,23329,193357,14789,378346,15657,7502,8155
64810,401707,23331,193371,14791,378376,15659,7503,8156
64815,401738,23333,193386,14792,378405,15661,7504,8157
64820,401769,23335,193393,14793,378434,15663,7504,8159
64825,401800,23336,193408,14794,378464,15664,7505,8159
64830,401831,23337,193421,14794,378494,15665,7505,8160
64835,401862,23338,193432,14794,378524,15666,7505,8161
64840,401893,23340,193445,14795,378553,15667,7506,8161
64845,401924,23342,193464,14796,378582,15668,7507,8161
64850,401955,23345,193477,14798,378610,15669,7507,8162
64855,401986,23349,193493,14800,378637,15670,7508,8162
64860,402017,23354,193511,14804,378663,15671,7509,8162
64865,402048,23357,193524,14805,378691,15672,7509,8163
64870,402079,23362,193541,14810,378717,15672,7509,8163
64875,402110,23365,193551,14811,378745,15672,7509,8163
64880,402141,23369,193564,14813,378772,15672,7509,8163
64885,402172,23374,193580,14818,378798,15672,7509,8163
64890,402203,23376,193593,14819,378827,15672,7509,8163
64895,402234,23378,193609,14820,378856,15672,7509,8163
64900,402265,23380,193629,14821,378885,15672,7509,8163
64905,402296,23382,193645,14823,378914,15672,7509,8163
64910,402327,23384,193662,14824,378943,15672,7509,8163
64915,402358,23387,193674,14827,378971,15672,7509,8163
64920,402389,23390,193693,14830,378999,15672,7509,8163
64925,402420,23390,193709,14830,379030,15672,7509,8163
64930,402451,23390,193724,14830,379061,15672,7509,8163
64935,402482,23390,193736,14830,379092,15672,7509,8163
64940,402513,23390,193747,14830,379123,15672,7509,8163
64945,402544,23390,193762,14830,379154,15672,7509,8163
64950,402575,23390,193779,14830,379185,15672,7509,8163
64955,402606,23390,193793,14830,379216,15672,7509,8163
64960,402637,23390,193808,14830,379247,15672,7509,8163
64965,402668,23390,193826,14830,379278,15672,7509,8163
64970,402699,23390,193837,14830,379309,15672,7509,8163
64975,402730,23390,193851,14830,379340,15674,7509,8165
64980,402761,23390,193866,14830,379371,15676,7510,8166
64985,402792,23390,193881,14830,379402,15678,7510,8168
64990,402823,23390,193899,14830,379433,15679,7510,8169
64995,402854,23390,193918,14830,379464,15680,7511,8169
65000,402885,23390,193931,14830,379495,15681,7512,8169
65005,402916,23390,193941,14830,379526,15682,7512,8170
65010,402947,23390,193956,14830,379557,15683,7512,8171
65015,402978,23390,193969,14830,379588,15684,7512,8172
65020,403009,23390,193986,14830,379619,15685,7513,8172
65025,403040,23390,193999,14830,379650,15686,7513,8173
65030,403071,23392,194016,14832,379678,15688,7513,8175
65035,403102,23398,194032,14836,379703,15690,7514,8176
65040,403133,23405,194046,14841,379728,15692,7514,8178
65045,403164,23409,194060,14844,379755,15693,7514,8179
65050,403195,23411,194075,14846,379784,15694,7515,8179
65055,403226,23413,194088,14848,379813,15695,7515,8180
65060,403257,23416,194102,14850,379841,15696,7515,8181
65065,403288,23419,194114,14851,379869,15697,7515,8182
65070,403319,23421,194126,14852,379898,15698,7515,8183
65075,403350,23423,194142,14853,379927,15699,7515,8184
65080,403381,23425,194157,14855,379956,15700,7516,8184
65085,403412,23428,194173,14857,379984,15701,7517,8184
65090,403443,23429,194187,14857,380014,15703,7517,8186
65095,403474,23430,194194,14857,380044,15705,7517,8188
65100,403505,23432,194213,14858,380073,15707,7518,8189
65105,403536,23432,194227,14858,380104,15708,7519,8189
65110,403567,23432,194245,14858,380135,15709,7520,8189
65115,403598,23432,194260,14858,380166,15710,7520,8190
65120,403629,23432,194276,14858,380197,15711,7521,8190
65125,403660,23432,194292,14858,380228,15712,7521,8191
65130,403691,23432,194305,14858,380259,15713,7521,8192
65135,403722,23432,194323,14858,380290,15714,7522,8192
65140,403753,23432,194342,14858,380321,15715,7522,8193
65145,403784,23432,194356,14858,380352,15716,7523,8193
65150,403815,23433,194372,14858,380381,15718,7525,8193
65155,403846,23435,194388,14860,380411,15720,7526,8194
65160,403877,23436,194406,14860,380440,15722,7527,8195
65165,403908,23440,194421,14864,380468,15723,7528,8195
65170,403939,23443,194429,14865,380496,15724,7528,8196
65175,403970,23445,194444,14866,380525,15725,7529,8196
65180,404001,23446,194457,14866,380555,15726,7529,8197
65185,404032,23447,194472,14867,380585,15727,7529,8198
65190,404063,23448,194489,14867,380615,15728,7529,8199
65195,404094,23449,194508,14868,380645,15729,7530,8199
65200,404125,23450,194520,14869,380675,15730,7530,8200
65205,404156,23451,194531,14869,380705,15731,7530,8201
65210,404187,23452,194543,14870,380735,15733,7531,8202
65215,404218,23453,194560,14870,380765,15735,7533,8202
65220,404249,23455,194576,14872,380794,15737,7534,8203
65225,404280,23457,194593,14873,380823,15738,7535,8203
65230,404311,23459,194611,14875,380852,15739,7535,8204
65235,404342,23460,194621,14876,380882,15740,7536,8204
65240,404373,23462,194639,14877,380911,15741,7536,8205
65245,404404,23463,194650,14877,380941,15742,7537,8205
65250,404435,23464,194662,14877,380971,15743,7537,8206
65255,404466,23465,194672,14877,381001,15744,7537,8207
65260,404497,23467,194690,14878,381030,15745,7537,8208
65265,404528,23467,194711,14878,381061,15746,7538,8208
65270,404559,23468,194729,14878,381091,15747,7539,8208
65275,404590,23469,194743,14878,381120,15749,7540,8209
65280,404621,23472,194763,14881,381149,15751,7541,8210
65285,404652,23473,194775,14881,381179,15753,7541,8212
65290,404683,23474,194792,14881,381209,15754,7542,8212
65295,404714,23475,194808,14882,381239,15755,7543,8212
65300,404745,23476,194824,14882,381269,15756,7544,8212
65305,404776,23477,194838,14882,381299,15757,7545,8212
65310,404807,23478,194854,14883,381329,15758,7546,8212
65315,404838,23479,194866,14884,381359,15759,7546,8213
65320,404869,23480,194881,14884,381389,15760,7546,8214
65325,404900,23481,194896,14885,381419,15761,7546,8215
65330,404931,23482,194912,14886,381449,15763,7547,8216
65335,404962,23483,194930,14887,381479,15765,7548,8217
65340,404993,23484,194944,14888,381509,15767,7549,8218
65345,405024,23486,194964,14889,381538,15768,7550,8218
65350,405055,23488,194982,14890,381567,15769,7551,8218
65355,405086,23490,194996,14891,381596,15770,7552,8218
65360,405117,23492,195013,14892,381625,15771,7553,8218
65365,405148,23494,195030,14893,381654,15772,7554,8218
65370,405179,23496,195042,14894,381683,15773,7554,8219
65375,405210,23498,195054,14896,381712,15774,7555,8219
65380,405241,23500,195065,14897,381741,15775,7555,8220
65385,405272,23502,195080,14898,381769,15776,7556,8220
65390,405303,23507,195091,14901,381796,15777,7557,8220
65395,405334,23511,195105,14902,381822,15778,7557,8221
65400,405365,23515,195118,14905,381850,15780,7557,8223
65405,405396,23519,195132,14907,381877,15782,7557,8225
65410,405427,23522,195145,14910,381905,15784,7558,8226
65415,405458,23524,195162,14912,381934,15786,7559,8227
65420,405489,23528,195174,14915,381961,15788,7559,8229
65425,405520,23530,195191,14916,381990,15790,7560,8230
65430,405551,23533,195205,14919,382018,15792,7560,8232
65435,405582,23535,195223,14920,382047,15794,7560,8234
65440,405613,23538,195242,14923,382075,15796,7562,8234
65445,405644,23540,195256,14924,382104,15798,7564,8234
65450,405675,23543,195273,14926,382132,15801,7566,8235
65455,405706,23545,195286,14927,382161,15803,7566,8237
65460,405737,23548,195304,14930,382189,15805,7568,8237
65465,405768,23549,195321,14930,382219,15806,7568,8238
65470,405799,23550,195335,14931,382249,15807,7568,8239
65475,405830,23551,195353,14932,382279,15808,7568,8240
65480,405861,23552,195368,14933,382309,15809,7569,8240
65485,405892,23553,195380,14933,382339,15810,7569,8241
65490,405923,23554,195394,14934,382369,15811,7569,8242
65495,405954,23555,195409,14934,382399,15812,7570,8242
65500,405985,23556,195422,14934,382429,15813,7571,8242
65505,406016,23558,195439,14935,382457,15814,7572,8242
65510,406047,23561,195452,14938,382485,15815,7572,8243
65515,406078,23564,195467,14939,382514,15816,7573,8243
65520,406109,23566,195483,14940,382543,15817,7573,8244
65525,406140,23571,195498,14943,382569,15818,7573,8245
65530,406171,23575,195516,14946,382596,15818,7573,8245
65535,406202,23578,195533,14948,382624,15818,7573,8245
65540,406233,23580,195543,14950,382653,15818,7573,8245
65545,406264,23582,195556,14951,382682,15818,7573,8245
65550,406295,23586,195574,14954,382709,15818,7573,8245
65555,406326,23588,195588,14955,382738,15818,7573,8245
65560,406357,23592,195603,14959,382765,15818,7573,8245
65565,406388,23595,195615,14961,382793,15819,7574,8245
65570,406419,23599,195629,14963,382820,15820,7574,8246
65575,406450,23600,195641,14964,382850,15821,7575,8246
65580,406481,23601,195656,14965,382880,15822,7575,8247
65585,406512,23604,195673,14967,382908,15823,7576,8247
65590,406543,23608,195690,14970,382935,15823,7576,8247
65595,406574,23610,195709,14972,382964,15823,7576,8247
65600,406605,23613,195724,14974,382992,15823,7576,8247
65605,406636,23614,195740,14975,383022,15823,7576,8247
65610,406667,23615,195757,14975,383052,15823,7576,8247
65615,406698,23616,195767,14976,383082,15823,7576,8247
65620,406729,23617,195784,14977,383111,15823,7576,8247
65625,406760,23619,195794,14978,383141,15823,7576,8247
65630,406791,23620,195816,14979,383171,15823,7576,8247
65635,406822,23621,195834,14980,383200,15823,7576,8247
65640,406853,23623,195851,14982,383230,15823,7576,8247
65645,406884,23625,195862,14984,383259,15823,7576,8247
65650,406915,23627,195873,14986,383288,15823,7576,8247
65655,406946,23630,195887,14989,383315,15823,7576,8247
65660,406977,23633,195905,14990,383343,15823,7576,8247
65665,407008,23636,195919,14992,383372,15823,7576,8247
65670,407039,23639,195932,14994,383399,15823,7576,8247
65675,407070,23641,195945,14995,383429,15823,7576,8247
65680,407101,23642,195958,14996,383459,15823,7576,8247
65685,407132,23642,195976,14996,383490,15823,7576,8247
65690,407163,23643,195991,14997,383520,15823,7576,8247
65695,407194,23644,196007,14997,383550,15824,7577,8247
65700,407225,23648,196022,15001,383577,15825,7577,8248
65705,407256,23650,196040,15003,383606,15825,7577,8248
65710,407287,23651,196056,15004,383636,15825,7577,8248
65715,407318,23652,196069,15004,383666,15825,7577,8248
65720,407349,23653,196086,15005,383696,15825,7577,8248
65725,407380,23654,196099,15006,383726,15825,7577,8248
65730,407411,23656,196113,15008,383755,15825,7577,8248
65735,407442,23657,196133,15009,383785,15825,7577,8248
65740,407473,23659,196145,15011,383814,15825,7577,8248
65745,407504,23660,196157,15011,383844,15825,7577,8248
65750,407535,23661,196173,15011,383874,15825,7577,8248
65755,407566,23662,196189,15012,383904,15825,7577,8248
65760,407597,23664,196205,15014,383933,15825,7577,8248
65765,407628,23666,196214,15016,383962,15825,7577,8248
65770,407659,23667,196225,15016,383992,15825,7577,8248
65775,407690,23670,196241,15018,384020,15825,7577,8248
65780,407721,23673,196253,15019,384048,15825,7577,8248
65785,407752,23676,196268,15021,384076,15825,7577,8248
65790,407783,23679,196283,15023,384104,15825,7577,8248
65795,407814,23683,196297,15026,384131,15825,7577,8248
65800,407845,23686,196314,15029,384159,15825,7577,8248
65805,407876,23692,196334,15034,384183,15825,7577,8248
65810,407907,23696,196350,15036,384210,15825,7577,8248
65815,407938,23701,196366,15040,384236,15826,7578,8248
65820,407969,23704,196376,15042,384265,15827,7578,8249
65825,408000,23705,196389,15042,384294,15828,7578,8250
65830,408031,23707,196400,15044,384323,15829,7578,8251
65835,408062,23709,196420,15046,384352,15829,7578,8251
65840,408093,23711,196436,15048,384381,15829,7578,8251
65845,408124,23713,196452,15050,384410,15829,7578,8251
65850,408155,23715,196469,15051,384439,15829,7578,8251
65855,408186,23717,196483,15052,384469,15829,7578,8251
65860,408217,23718,196500,15053,384498,15829,7578,8251
65865,408248,23720,196514,15054,384527,15829,7578,8251
65870,408279,23722,196526,15056,384557,15829,7578,8251
65875,408310,23723,196540,15056,384586,15829,7578,8251
65880,408341,23725,196555,15057,384616,15829,7578,8251
65885,408372,23725,196571,15057,384647,15829,7578,8251
65890,408403,23725,196584,15057,384678,15829,7578,8251
65895,408434,23725,196592,15057,384709,15829,7578,8251
65900,408465,23725,196608,15057,384740,15829,7578,8251
65905,408496,23725,196626,15057,384771,15829,7578,8251
65910,408527,23725,196642,15057,384802,15829,7578,8251
65915,408558,23726,196659,15057,384832,15829,7578,8251
65920,408589,23727,196672,15057,384862,15829,7578,8251
65925,408620,23728,196691,15057,384892,15829,7578,8251
65930,408651,23731,196707,15059,384920,15830,7579,8251
65935,408682,23734,196721,15060,384948,15832,7581,8251
65940,408713,23737,196734,15061,384976,15834,7583,8251
65945,408744,23740,196750,15063,385004,15834,7583,8251
65950,408775,23744,196766,15067,385031,15834,7583,8251
65955,408806,23747,196779,15069,385059,15834,7583,8251
65960,408837,23750,196791,15071,385087,15834,7583,8251
65965,408868,23753,196807,15074,385115,15834,7583,8251
65970,408899,23756,196825,15075,385143,15834,7583,8251
65975,408930,23760,196835,15077,385170,15834,7583,8251
65980,408961,23764,196858,15080,385197,15834,7583,8251
65985,408992,23768,196872,15083,385224,15834,7583,8251
65990,409023,23772,196894,15087,385251,15834,7583,8251
65995,409054,23774,196910,15088,385280,15834,7583,8251
66000,409085,23776,196924,15089,385309,15834,7583,8251
66005,409116,23778,196940,15090,385338,15834,7583,8251
66010,409147,23781,196957,15092,385366,15834,7583,8251
66015,409178,23784,196975,15094,385394,15834,7583,8251
66020,409209,23787,196994,15095,385422,15834,7583,8251
66025,409240,23789,197005,15095,385451,15834,7583,8251
66030,409271,23791,197018,15096,385480,15834,7583,8251
66035,409302,23793,197033,15096,385509,15834,7583,8251
66040,409333,23795,197044,15097,385538,15834,7583,8251
66045,409364,23800,197064,15101,385564,15835,7583,8252
66050,409395,23800,197082,15101,385595,15837,7584,8253
66055,409426,23800,197095,15101,385626,15838,7585,8253
66060,409457,23800,197111,15101,385657,15838,7585,8253
66065,409488,23800,197123,15101,385688,15838,7585,8253
66070,409519,23800,197138,15101,385719,15838,7585,8253
66075,409550,23800,197158,15101,385750,15838,7585,8253
66080,409581,23800,197172,15101,385781,15838,7585,8253
66085,409612,23800,197184,15101,385812,15838,7585,8253
66090,409643,23800,197199,15101,385843,15838,7585,8253
66095,409674,23801,197214,15101,385873,15838,7585,8253
66100,409705,23802,197229,15101,385903,15838,7585,8253
66105,409736,23803,197239,15101,385933,15838,7585,8253
66110,409767,23804,197256,15101,385963,15838,7585,8253
66115,409798,23805,197266,15101,385993,15838,7585,8253
66120,409829,23806,197286,15101,386023,15838,7585,8253
66125,409860,23807,197297,15102,386052,15838,7585,8253
66130,409891,23810,197311,15104,386081,15838,7585,8253
66135,409922,23811,197327,15104,386111,15838,7585,8253
66140,409953,23812,197346,15104,386141,15838,7585,8253
66145,409984,23814,197364,15105,386170,15838,7585,8253
66150,410015,23816,197379,15106,386199,15838,7585,8253
66155,410046,23819,197394,15108,386227,15838,7585,8253
66160,410077,23823,197412,15110,386254,15838,7585,8253
66165,410108,23827,197427,15112,386281,15839,7586,8253
66170,410139,23831,197445,15115,386308,15841,7587,8254
66175,410170,23835,197460,15118,386335,15843,7588,8255
66180,410201,23840,197476,15121,386361,15845,7590,8255
66185,410232,23843,197485,15121,386389,15845,7590,8255
66190,410263,23846,197496,15122,386417,15845,7590,8255
66195,410294,23849,197511,15123,386445,15845,7590,8255
66200,410325,23854,197526,15126,386471,15845,7590,8255
66205,410356,23858,197543,15130,386498,15845,7590,8255
66210,410387,23862,197554,15132,386525,15845,7590,8255
66215,410418,23865,197567,15133,386553,15845,7590,8255
66220,410449,23869,197582,15137,386580,15845,7590,8255
66225,410480,23874,197597,15141,386606,15845,7590,8255
66230,410511,23877,197608,15142,386634,15845,7590,8255
66235,410542,23881,197620,15146,386661,15845,7590,8255
66240,410573,23886,197634,15149,386687,15845,7590,8255
66245,410604,23888,197645,15150,386716,15846,7590,8256
66250,410635,23890,197659,15152,386745,15847,7591,8256
66255,410666,23891,197671,15153,386775,15847,7591,8256
66260,410697,23891,197681,15153,386806,15847,7591,8256
66265,410728,23891,197693,15153,386837,15847,7591,8256
66270,410759,23891,197706,15153,386868,15847,7591,8256
66275,410790,23891,197716,15153,386899,15847,7591,8256
66280,410821,23891,197729,15153,386930,15847,7591,8256
66285,410852,23891,197742,15153,386961,15847,7591,8256
66290,410883,23891,197756,15153,386992,15847,7591,8256
66295,410914,23891,197774,15153,387023,15847,7591,8256
66300,410945,23891,197789,15153,387054,15847,7591,8256
66305,410976,23894,197810,15156,387082,15848,7592,8256
66310,411007,23897,197824,15158,387110,15849,7593,8256
66315,411038,23898,197835,15158,387140,15850,7593,8257
66320,411069,23899,197847,15158,387170,15851,7594,8257
66325,411100,23901,197864,15160,387199,15851,7594,8257
66330,411131,23901,197875,15160,387230,15851,7594,8257
66335,411162,23901,197890,15160,387261,15851,7594,8257
66340,411193,23901,197906,15160,387292,15851,7594,8257
66345,411224,23903,197922,15161,387321,15851,7594,8257
66350,411255,23906,197938,15164,387349,15851,7594,8257
66355,411286,23910,197952,15167,387376,15851,7594,8257
66360,411317,23913,197963,15169,387404,15852,7595,8257
66365,411348,23914,197977,15170,387434,15853,7596,8257
66370,411379,23915,197991,15171,387464,15854,7596,8258
66375,411410,23916,198005,15171,387494,15854,7596,8258
66380,411441,23918,198020,15172,387523,15854,7596,8258
66385,411472,23919,198033,15173,387553,15854,7596,8258
66390,411503,23921,198051,15175,387582,15854,7596,8258
66395,411534,23923,198064,15177,387611,15854,7596,8258
66400,411565,23924,198078,15178,387641,15854,7596,8258
66405,411596,23925,198094,15179,387671,15854,7596,8258
66410,411627,23926,198111,15179,387701,15854,7596,8258
66415,411658,23928,198125,15181,387730,15854,7596,8258
66420,411689,23931,198145,15183,387758,15854,7596,8258
66425,411720,23931,198155,15183,387789,15854,7596,8258
66430,411751,23931,198169,15183,387820,15855,7596,8259
66435,411782,23933,198186,15185,387849,15856,7596,8260
66440,411813,23934,198200,15186,387879,15857,7596,8261
66445,411844,23935,198211,15186,387909,15858,7596,8262
66450,411875,23937,198231,15188,387937,15859,7596,8263
66455,411906,23939,198247,15190,387967,15859,7596,8263
66460,411937,23940,198265,15191,387996,15859,7596,8263
66465,411968,23943,198278,15193,388025,15860,7596,8264
66470,411999,23946,198290,15195,388052,15861,7596,8265
66475,412030,23951,198311,15199,388078,15863,7596,8267
66480,412061,23955,198329,15201,388105,15865,7597,8268
66485,412092,23958,198343,15204,388134,15865,7597,8268
66490,412123,23962,198357,15207,388161,15865,7597,8268
66495,412154,23965,198373,15210,388189,15865,7597,8268
66500,412185,23968,198385,15211,388217,15865,7597,8268
66505,412216,23971,198406,15213,388245,15865,7597,8268
66510,412247,23974,198421,15215,388273,15865,7597,8268
66515,412278,23976,198430,15215,388302,15865,7597,8268
66520,412309,23979,198446,15218,388330,15865,7597,8268
66525,412340,23983,198461,15221,388357,15865,7597,8268
66530,412371,23986,198481,15224,388385,15865,7597,8268
66535,412402,23987,198498,15225,388415,15865,7597,8268
66540,412433,23989,198513,15227,388444,15865,7597,8268
66545,412464,23989,198526,15227,388475,15865,7597,8268
66550,412495,23989,198543,15227,388506,15865,7597,8268
66555,412526,23989,198561,15227,388537,15865,7597,8268
66560,412557,23989,198576,15227,388568,15865,7597,8268
66565,412588,23989,198591,15227,388599,15865,7597,8268
66570,412619,23989,198606,15227,388630,15865,7597,8268
66575,412650,23989,198621,15227,388661,15865,7597,8268
66580,412681,23989,198640,15227,388692,15865,7597,8268
66585,412712,23989,198654,15227,388723,15865,7597,8268
66590,412743,23990,198665,15228,388752,15867,7598,8269
66595,412774,23992,198681,15230,388782,15869,7598,8271
66600,412805,23995,198695,15232,388809,15870,7599,8271
66605,412836,23998,198706,15233,388838,15871,7599,8272
66610,412867,24001,198718,15235,388866,15871,7599,8272
66615,412898,24004,198735,15238,388894,15871,7599,8272
66620,412929,24007,198746,15240,388922,15871,7599,8272
66625,412960,24009,198758,15240,388951,15871,7599,8272
66630,412991,24012,198775,15241,388979,15871,7599,8272
66635,413022,24014,198785,15242,389008,15871,7599,8272
66640,413053,24016,198800,15243,389037,15871,7599,8272
66645,413084,24018,198810,15244,389066,15871,7599,8272
66650,413115,24020,198825,15245,389095,15871,7599,8272
66655,413146,24023,198843,15247,389123,15871,7599,8272
66660,413177,24026,198856,15250,389151,15871,7599,8272
66665,413208,24029,198872,15251,389179,15871,7599,8272
66670,413239,24032,198882,15253,389207,15871,7599,8272
66675,413270,24034,198901,15254,389236,15871,7599,8272
66680,413301,24037,198916,15257,389264,15871,7599,8272
66685,413332,24040,198925,15258,389292,15871,7599,8272
66690,413363,24042,198941,15259,389321,15871,7599,8272
66695,413394,24044,198956,15260,389350,15871,7599,8272
66700,413425,24046,198966,15261,389379,15872,7600,8272
66705,413456,24048,198981,15263,389408,15874,7601,8273
66710,413487,24053,198999,15266,389434,15876,7602,8274
66715,413518,24057,199016,15270,389461,15877,7602,8275
66720,413549,24061,199031,15273,389487,15877,7602,8275
66725,413580,24063,199043,15274,389517,15877,7602,8275
66730,413611,24064,199057,15275,389547,15877,7602,8275
66735,413642,24065,199068,15275,389577,15877,7602,8275
66740,413673,24066,199081,15276,389607,15877,7602,8275
66745,413704,24067,199095,15276,389637,15877,7602,8275
66750,413735,24068,199109,15277,389667,15877,7602,8275
66755,413766,24069,199127,15277,389697,15877,7602,8275
66760,413797,24070,199140,15278,389727,15877,7602,8275
66765,413828,24071,199157,15278,389757,15877,7602,8275
66770,413859,24072,199176,15279,389787,15877,7602,8275
66775,413890,24073,199192,15279,389817,15877,7602,8275
66780,413921,24074,199207,15279,389847,15877,7602,8275
66785,413952,24077,199222,15280,389874,15877,7602,8275
66790,413983,24080,199232,15282,389902,15877,7602,8275
66795,414014,24083,199250,15283,389930,15877,7602,8275
66800,414045,24086,199264,15285,389959,15877,7602,8275
66805,414076,24087,199281,15286,389989,15877,7602,8275
66810,414107,24088,199294,15286,390019,15877,7602,8275
66815,414138,24089,199309,15286,390049,15878,7603,8275
66820,414169,24090,199323,15287,390079,15880,7603,8277
66825,414200,24092,199340,15288,390108,15882,7603,8279
66830,414231,24093,199353,15289,390138,15883,7603,8280
66835,414262,24097,199372,15293,390165,15883,7603,8280
66840,414293,24099,199389,15295,390194,15883,7603,8280
66845,414324,24100,199402,15295,390224,15883,7603,8280
66850,414355,24101,199418,15295,390254,15883,7603,8280
66855,414386,24103,199434,15296,390283,15883,7603,8280
66860,414417,24105,199449,15297,390312,15883,7603,8280
66865,414448,24106,199460,15298,390342,15883,7603,8280
66870,414479,24107,199472,15299,390372,15883,7603,8280
66875,414510,24109,199488,15300,390401,15883,7603,8280
66880,414541,24110,199501,15300,390431,15883,7603,8280
66885,414572,24112,199520,15302,390460,15883,7603,8280
66890,414603,24113,199537,15302,390490,15883,7603,8280
66895,414634,24115,199556,15303,390519,15883,7603,8280
66900,414665,24117,199574,15304,390548,15883,7603,8280
66905,414696,24118,199589,15305,390578,15883,7603,8280
66910,414727,24120,199612,15307,390607,15883,7603,8280
66915,414758,24122,199626,15308,390636,15883,7603,8280
66920,414789,24124,199643,15310,390665,15883,7603,8280
66925,414820,24126,199665,15311,390693,15883,7603,8280
66930,414851,24129,199675,15313,390722,15884,7604,8280
66935,414882,24131,199692,15314,390750,15886,7606,8280
66940,414913,24133,199705,15316,390780,15888,7607,8281
66945,414944,24137,199722,15318,390807,15889,7607,8282
66950,414975,24141,199742,15321,390834,15890,7607,8283
66955,415006,24144,199758,15323,390862,15890,7607,8283
66960,415037,24147,199776,15325,390889,15890,7607,8283
66965,415068,24150,199796,15328,390918,15890,7607,8283
66970,415099,24152,199813,15330,390947,15890,7607,8283
66975,415130,24154,199828,15332,390976,15890,7607,8283
66980,415161,24156,199844,15334,391005,15890,7607,8283
66985,415192,24157,199861,15335,391035,15890,7607,8283
66990,415223,24158,199875,15336,391065,15890,7607,8283
66995,415254,24158,199886,15336,391096,15890,7607,8283
67000,415285,24158,199907,15336,391127,15890,7607,8283
67005,415316,24158,199921,15336,391158,15890,7607,8283
67010,415347,24158,199935,15336,391189,15890,7607,8283
67015,415378,24158,199953,15336,391220,15890,7607,8283
67020,415409,24158,199967,15336,391251,15890,7607,8283
67025,415440,24158,199981,15336,391282,15890,7607,8283
67030,415471,24158,199989,15336,391313,15890,7607,8283
67035,415502,24158,200001,15336,391344,15890,7607,8283
67040,415533,24158,200013,15336,391375,15890,7607,8283
67045,415564,24158,200025,15336,391406,15890,7607,8283
67050,415595,24158,200040,15336,391437,15890,7607,8283
67055,415626,24158,200054,15336,391468,15891,7607,8284
67060,415657,24158,200067,15336,391499,15892,7607,8285
67065,415688,24158,200083,15336,391530,15893,7607,8286
67070,415719,24160,200100,15338,391559,15895,7608,8287
67075,415750,24163,200113,15341,391587,15897,7610,8287
67080,415781,24165,200129,15342,391616,15897,7610,8287
67085,415812,24170,200148,15345,391642,15897,7610,8287
67090,415843,24173,200161,15347,391669,15897,7610,8287
67095,415874,24178,200175,15350,391696,15897,7610,8287
67100,415905,24183,200190,15354,391722,15897,7610,8287
67105,415936,24186,200209,15354,391749,15897,7610,8287
67110,415967,24189,200222,15355,391778,15897,7610,8287
67115,415998,24192,200236,15356,391806,15897,7610,8287
67120,416029,24195,200255,15359,391833,15897,7610,8287
67125,416060,24198,200265,15361,391861,15897,7610,8287
67130,416091,24202,200279,15365,391888,15897,7610,8287
67135,416122,24205,200294,15367,391917,15897,7610,8287
67140,416153,24207,200305,15369,391945,15897,7610,8287
67145,416184,24210,200317,15371,391974,15897,7610,8287
67150,416215,24211,200327,15372,392004,15897,7610,8287
67155,416246,24212,200338,15373,392034,15897,7610,8287
67160,416277,24213,200350,15373,392064,15897,7610,8287
67165,416308,24214,200363,15373,392094,15897,7610,8287
67170,416339,24215,200383,15374,392124,15897,7610,8287
67175,416370,24216,200396,15374,392154,15897,7610,8287
67180,416401,24217,200406,15375,392184,15899,7612,8287
67185,416432,24218,200420,15375,392214,15901,7613,8288
67190,416463,24221,200438,15377,392242,15902,7614,8288
67195,416494,24222,200458,15377,392272,15903,7615,8288
67200,416525,24224,200471,15379,392301,15904,7615,8289
67205,416556,24224,200488,15379,392332,15904,7615,8289
67210,416587,24224,200498,15379,392363,15904,7615,8289
67215,416618,24226,200515,15380,392392,15904,7615,8289
67220,416649,24227,200529,15380,392421,15904,7615,8289
67225,416680,24229,200542,15381,392451,15904,7615,8289
67230,416711,24230,200556,15381,392480,15904,7615,8289
67235,416742,24233,200571,15384,392508,15904,7615,8289
67240,416773,24236,200590,15386,392537,15904,7615,8289
67245,416804,24238,200600,15387,392566,15904,7615,8289
67250,416835,24240,200616,15389,392594,15904,7615,8289
67255,416866,24242,200631,15391,392623,15904,7615,8289
67260,416897,24245,200649,15394,392652,15904,7615,8289
67265,416928,24247,200667,15396,392681,15904,7615,8289
67270,416959,24248,200683,15397,392711,15904,7615,8289
67275,416990,24250,200697,15398,392740,15904,7615,8289
67280,417021,24252,200711,15399,392769,15904,7615,8289
67285,417052,24254,200723,15400,392798,15904,7615,8289
67290,417083,24256,200737,15401,392827,15905,7615,8290
67295,417114,24257,200751,15401,392857,15906,7615,8291
67300,417145,24258,200763,15401,392887,15907,7615,8292
67305,417176,24259,200772,15401,392917,15907,7615,8292
67310,417207,24261,200785,15402,392946,15907,7615,8292
67315,417238,24264,200802,15405,392974,15907,7615,8292
67320,417269,24267,200821,15407,393002,15907,7615,8292
67325,417300,24268,200835,15408,393032,15907,7615,8292
67330,417331,24268,200854,15408,393063,15907,7615,8292
67335,417362,24268,200867,15408,393094,15907,7615,8292
67340,417393,24268,200884,15408,393125,15907,7615,8292
67345,417424,24268,200897,15408,393156,15907,7615,8292
67350,417455,24268,200914,15408,393187,15907,7615,8292
67355,417486,24268,200928,15408,393218,15907,7615,8292
67360,417517,24268,200940,15408,393249,15907,7615,8292
67365,417548,24268,200955,15408,393280,15907,7615,8292
67370,417579,24270,200972,15409,393308,15907,7615,8292
67375,417610,24273,200982,15411,393337,15907,7615,8292
67380,417641,24274,200994,15412,393366,15908,7615,8293
67385,417672,24277,201009,15415,393395,15910,7616,8294
67390,417703,24278,201018,15415,393425,15912,7616,8296
67395,417734,24279,201032,15416,393455,15913,7616,8297
67400,417765,24280,201047,15416,393485,15914,7617,8297
67405,417796,24281,201066,15417,393515,15915,7618,8297
67410,417827,24282,201083,15417,393545,15916,7619,8297
67415,417858,24283,201097,15417,393575,15916,7619,8297
67420,417889,24285,201109,15419,393604,15916,7619,8297
67425,417920,24287,201126,15421,393633,15916,7619,8297
67430,417951,24290,201140,15424,393661,15916,7619,8297
67435,417982,24293,201158,15425,393689,15916,7619,8297
67440,418013,24294,201172,15425,393719,15916,7619,8297
67445,418044,24297,201183,15426,393747,15916,7619,8297
67450,418075,24301,201205,15430,393774,15916,7619,8297
67455,418106,24303,201213,15431,393803,15916,7619,8297
67460,418137,24305,201228,15432,393832,15916,7619,8297
67465,418168,24308,201241,15433,393860,15916,7619,8297
67470,418199,24309,201255,15434,393890,15916,7619,8297
67475,418230,24311,201268,15435,393919,15916,7619,8297
67480,418261,24313,201284,15437,393948,15916,7619,8297
67485,418292,24316,201296,15440,393976,15916,7619,8297
67490,418323,24319,201313,15442,394004,15916,7619,8297
67495,418354,24320,201331,15443,394034,15916,7619,8297
67500,418385,24320,201347,15443,394065,15916,7619,8297
67505,418416,24320,201363,15443,394096,15916,7619,8297
67510,418447,24320,201381,15443,394127,15916,7619,8297
67515,418478,24320,201396,15443,394158,15917,7619,8298
67520,418509,24320,201411,15443,394189,15918,7620,8298
67525,418540,24320,201422,15443,394220,15919,7620,8299
67530,418571,24320,201433,15443,394251,15920,7620,8300
67535,418602,24320,201450,15443,394282,15921,7621,8300
67540,418633,24320,201461,15443,394313,15922,7621,8301
67545,418664,24320,201481,15443,394344,15923,7621,8302
67550,418695,24322,201496,15445,394373,15923,7621,8302
67555,418726,24324,201512,15447,394402,15924,7622,8302
67560,418757,24326,201531,15449,394431,15925,7623,8302
67565,418788,24330,201549,15453,394457,15925,7623,8302
67570,418819,24333,201563,15454,394486,15925,7623,8302
67575,418850,24336,201577,15456,394514,15925,7623,8302
67580,418881,24338,201594,15456,394542,15925,7623,8302
67585,418912,24341,201610,15458,394570,15925,7623,8302
67590,418943,24345,201625,15462,394598,15925,7623,8302
67595,418974,24348,201639,15464,394626,15925,7623,8302
67600,419005,24353,201653,15466,394652,15925,7623,8302
67605,419036,24356,201665,15467,394680,15925,7623,8302
67610,419067,24360,201681,15470,394707,15925,7623,8302
67615,419098,24362,201695,15472,394736,15925,7623,8302
67620,419129,24364,201709,15474,394765,15925,7623,8302
67625,419160,24368,201722,15477,394792,15925,7623,8302
67630,419191,24372,201734,15479,394819,15925,7623,8302
67635,419222,24375,201753,15480,394847,15925,7623,8302
67640,419253,24379,201768,15484,394874,15925,7623,8302
67645,419284,24381,201783,15486,394903,15925,7623,8302
67650,419315,24384,201798,15488,394931,15926,7624,8302
67655,419346,24387,201819,15491,394959,15927,7625,8302
67660,419377,24388,201832,15491,394989,15928,7625,8303
67665,419408,24389,201845,15491,395019,15930,7625,8305
67670,419439,24390,201862,15491,395049,15932,7626,8306
67675,419470,24391,201880,15492,395079,15933,7627,8306
67680,419501,24392,201893,15493,395109,15934,7628,8306
67685,419532,24393,201906,15494,395138,15934,7628,8306
67690,419563,24395,201919,15496,395167,15934,7628,8306
67695,419594,24397,201929,15497,395196,15934,7628,8306
67700,419625,24399,201946,15499,395226,15934,7628,8306
67705,419656,24400,201957,15499,395256,15934,7628,8306
67710,419687,24402,201972,15500,395285,15934,7628,8306
67715,419718,24404,201983,15501,395314,15934,7628,8306
67720,419749,24406,201996,15502,395343,15934,7628,8306
67725,419780,24408,202013,15504,395372,15934,7628,8306
67730,419811,24410,202028,15506,395401,15934,7628,8306
67735,419842,24411,202040,15506,395431,15934,7628,8306
67740,419873,24412,202052,15507,395461,15934,7628,8306
67745,419904,24413,202065,15508,395491,15934,7628,8306
67750,419935,24414,202080,15508,395521,15934,7628,8306
67755,419966,24415,202096,15508,395551,15934,7628,8306
67760,419997,24416,202110,15509,395581,15934,7628,8306
67765,420028,24417,202122,15509,395611,15934,7628,8306
67770,420059,24418,202134,15510,395641,15934,7628,8306
67775,420090,24420,202147,15511,395670,15935,7629,8306
67780,420121,24423,202165,15513,395698,15936,7629,8307
67785,420152,24426,202180,15515,395726,15937,7630,8307
67790,420183,24429,202198,15518,395754,15939,7632,8307
67795,420214,24432,202215,15520,395782,15941,7633,8308
67800,420245,24436,202227,15522,395809,15943,7635,8308
67805,420276,24440,202246,15524,395836,15944,7636,8308
67810,420307,24444,202260,15526,395862,15945,7637,8308
67815,420338,24448,202277,15528,395890,15946,7638,8308
67820,420369,24451,202289,15530,395918,15946,7638,8308
67825,420400,24451,202305,15530,395949,15946,7638,8308
67830,420431,24451,202317,15530,395980,15946,7638,8308
67835,420462,24451,202328,15530,396011,15946,7638,8308
67840,420493,24451,202341,15530,396042,15946,7638,8308
67845,420524,24451,202356,15530,396073,15946,7638,8308
67850,420555,24451,202369,15530,396104,15946,7638,8308
67855,420586,24451,202383,15530,396135,15946,7638,8308
67860,420617,24451,202402,15530,396166,15946,7638,8308
67865,420648,24451,202417,15530,396197,15947,7639,8308
67870,420679,24451,202432,15530,396228,15948,7639,8309
67875,420710,24451,202444,15530,396259,15949,7640,8309
67880,420741,24451,202457,15530,396290,15950,7641,8309
67885,420772,24451,202470,15530,396321,15950,7641,8309
67890,420803,24451,202485,15530,396352,15950,7641,8309
67895,420834,24451,202498,15530,396383,15950,7641,8309
67900,420865,24451,202519,15530,396414,15950,7641,8309
67905,420896,24451,202537,15530,396445,15950,7641,8309
67910,420927,24453,202554,15532,396474,15950,7641,8309
67915,420958,24455,202568,15533,396503,15950,7641,8309
67920,420989,24456,202583,15533,396533,15950,7641,8309
67925,421020,24459,202597,15536,396561,15951,7642,8309
67930,421051,24461,202616,15537,396590,15951,7642,8309
67935,421082,24463,202627,15538,396619,15951,7642,8309
67940,421113,24465,202638,15539,396648,15951,7642,8309
67945,421144,24468,202653,15540,396676,15951,7642,8309
67950,421175,24471,202671,15542,396704,15951,7642,8309
67955,421206,24474,202684,15543,396732,15951,7642,8309
67960,421237,24477,202700,15545,396760,15951,7642,8309
67965,421268,24479,202716,15546,396789,15951,7642,8309
67970,421299,24481,202729,15547,396818,15951,7642,8309
67975,421330,24484,202743,15550,396846,15951,7642,8309
67980,421361,24485,202755,15550,396876,15951,7642,8309
67985,421392,24486,202768,15550,396906,15951,7642,8309
67990,421423,24487,202782,15551,396936,15951,7642,8309
67995,421454,24489,202796,15552,396965,15951,7642,8309
68000,421485,24490,202811,15552,396995,15951,7642,8309
68005,421516,24491,202822,15552,397025,15951,7642,8309
68010,421547,24492,202833,15552,397055,15951,7642,8309
68015,421578,24494,202851,15553,397084,15951,7642,8309
68020,421609,24496,202866,15554,397113,15951,7642,8309
68025,421640,24499,202878,15557,397141,15953,7642,8311
68030,421671,24501,202891,15559,397169,15955,7642,8313
68035,421702,24505,202904,15562,397197,15956,7642,8314
68040,421733,24507,202920,15563,397226,15957,7642,8315
68045,421764,24509,202936,15564,397255,15957,7642,8315
68050,421795,24512,202957,15567,397283,15957,7642,8315
68055,421826,24514,202976,15568,397312,15957,7642,8315
68060,421857,24517,202987,15570,397340,15957,7642,8315
68065,421888,24519,202999,15571,397369,15957,7642,8315
68070,421919,24522,203013,15574,397397,15957,7642,8315
68075,421950,24524,203021,15575,397426,15957,7642,8315
68080,421981,24526,203031,15576,397455,15957,7642,8315
68085,422012,24529,203044,15577,397483,15957,7642,8315
68090,422043,24531,203059,15577,397512,15957,7642,8315
68095,422074,24535,203074,15580,397539,15957,7642,8315
68100,422105,24536,203092,15580,397569,15957,7642,8315
68105,422136,24537,203109,15581,397599,15957,7642,8315
68110,422167,24538,203123,15582,397629,15957,7642,8315
68115,422198,24539,203139,15583,397659,15957,7642,8315
68120,422229,24540,203153,15583,397689,15957,7642,8315
68125,422260,24541,203168,15584,397719,15957,7642,8315
68130,422291,24542,203186,15585,397749,15957,7642,8315
68135,422322,24543,203203,15585,397779,15958,7642,8316
68140,422353,24544,203220,15585,397809,15959,7643,8316
68145,422384,24545,203237,15586,397839,15961,7644,8317
68150,422415,24548,203253,15587,397867,15962,7644,8318
68155,422446,24549,203266,15587,397897,15963,7645,8318
68160,422477,24550,203280,15587,397927,15964,7645,8319
68165,422508,24552,203297,15589,397956,15964,7645,8319
68170,422539,24554,203313,15590,397985,15964,7645,8319
68175,422570,24555,203331,15590,398015,15964,7645,8319
68180,422601,24556,203344,15590,398045,15964,7645,8319
68185,422632,24558,203356,15591,398074,15964,7645,8319
68190,422663,24560,203372,15593,398103,15964,7645,8319
68195,422694,24561,203384,15593,398133,15964,7645,8319
68200,422725,24563,203399,15595,398162,15964,7645,8319
68205,422756,24565,203409,15596,398191,15964,7645,8319
68210,422787,24567,203426,15597,398220,15964,7645,8319
68215,422818,24571,203442,15600,398247,15964,7645,8319
68220,422849,24573,203461,15602,398276,15964,7645,8319
68225,422880,24577,203479,15605,398303,15964,7645,8319
68230,422911,24580,203493,15607,398331,15964,7645,8319
68235,422942,24582,203507,15608,398360,15964,7645,8319
68240,422973,24584,203524,15609,398389,15964,7645,8319
68245,423004,24586,203544,15611,398418,15964,7645,8319
68250,423035,24588,203557,15613,398447,15965,7646,8319
68255,423066,24589,203571,15613,398477,15966,7647,8319
68260,423097,24591,203580,15613,398506,15967,7648,8319
68265,423128,24593,203597,15614,398535,15969,7650,8319
68270,423159,24595,203611,15614,398563,15970,7650,8320
68275,423190,24598,203625,15616,398591,15971,7650,8321
68280,423221,24600,203643,15618,398620,15971,7650,8321
68285,423252,24602,203657,15620,398649,15971,7650,8321
68290,423283,24604,203669,15622,398679,15971,7650,8321
68295,423314,24605,203685,15623,398709,15971,7650,8321
68300,423345,24606,203699,15624,398739,15971,7650,8321
68305,423376,24607,203708,15624,398769,15971,7650,8321
68310,423407,24608,203726,15625,398799,15971,7650,8321
68315,423438,24609,203741,15626,398829,15971,7650,8321
68320,423469,24610,203755,15626,398859,15971,7650,8321
68325,423500,24611,203767,15627,398889,15971,7650,8321
68330,423531,24612,203777,15627,398919,15971,7650,8321
68335,423562,24615,203793,15629,398947,15971,7650,8321
68340,423593,24617,203807,15631,398976,15971,7650,8321
68345,423624,24619,203822,15632,399005,15972,7650,8322
68350,423655,24621,203838,15632,399034,15973,7651,8322
68355,423686,24623,203847,15633,399063,15973,7651,8322
68360,423717,24625,203864,15634,399092,15973,7651,8322
68365,423748,24627,203880,15634,399121,15973,7651,8322
68370,423779,24629,203899,15636,399150,15973,7651,8322
68375,423810,24631,203911,15637,399179,15973,7651,8322
68380,423841,24634,203925,15639,399207,15973,7651,8322
68385,423872,24637,203939,15640,399235,15973,7651,8322
68390,423903,24640,203949,15640,399263,15973,7651,8322
68395,423934,24644,203968,15644,399289,15974,7651,8323
68400,423965,24649,203984,15648,399316,15975,7652,8323
68405,423996,24651,204000,15650,399345,15975,7652,8323
68410,424027,24655,204018,15653,399372,15975,7652,8323
68415,424058,24657,204034,15654,399401,15975,7652,8323
68420,424089,24661,204047,15658,399428,15975,7652,8323
68425,424120,24664,204065,15659,399456,15975,7652,8323
68430,424151,24667,204081,15661,399484,15975,7652,8323
68435,424182,24670,204099,15662,399512,15975,7652,8323
68440,424213,24671,204114,15662,399542,15975,7652,8323
68445,424244,24672,204130,15663,399572,15975,7652,8323
68450,424275,24674,204149,15665,399601,15975,7652,8323
68455,424306,24675,204165,15665,399631,15975,7652,8323
68460,424337,24675,204180,15665,399662,15975,7652,8323
68465,424368,24675,204191,15665,399693,15976,7653,8323
68470,424399,24675,204207,15665,399724,15977,7654,8323
68475,424430,24675,204220,15665,399755,15978,7655,8323
68480,424461,24675,204238,15665,399786,15979,7656,8323
68485,424492,24675,204251,15665,399817,15979,7656,8323
68490,424523,24675,204268,15665,399848,15979,7656,8323
68495,424554,24675,204281,15665,399879,15979,7656,8323
68500,424585,24675,204297,15665,399910,15979,7656,8323
68505,424616,24675,204309,15665,399941,15980,7656,8324
68510,424647,24676,204321,15666,399971,15981,7656,8325
68515,424678,24677,204338,15667,400001,15982,7656,8326
68520,424709,24678,204347,15667,400031,15983,7656,8327
68525,424740,24682,204364,15670,400058,15983,7656,8327
68530,424771,24686,204379,15673,400085,15983,7656,8327
68535,424802,24690,204393,15675,400112,15983,7656,8327
68540,424833,24694,204408,15678,400139,15983,7656,8327
68545,424864,24698,204426,15680,400166,15983,7656,8327
68550,424895,24702,204441,15684,400193,15983,7656,8327
68555,424926,24705,204458,15686,400221,15983,7656,8327
68560,424957,24708,204475,15689,400249,15983,7656,8327
68565,424988,24710,204489,15690,400278,15983,7656,8327
68570,425019,24712,204504,15692,400307,15983,7656,8327
68575,425050,24715,204521,15694,400335,15983,7656,8327
68580,425081,24717,204535,15696,400364,15983,7656,8327
68585,425112,24720,204542,15697,400392,15984,7656,8328
68590,425143,24723,204553,15698,400420,15985,7656,8329
68595,425174,24725,204569,15700,400449,15986,7657,8329
68600,425205,24728,204585,15703,400477,15987,7658,8329
68605,425236,24730,204601,15705,400506,15988,7658,8330
68610,425267,24733,204616,15707,400534,15989,7658,8331
68615,425298,24735,204627,15708,400563,15989,7658,8331
68620,425329,24738,204644,15711,400591,15989,7658,8331
68625,425360,24741,204662,15712,400619,15989,7658,8331
68630,425391,24742,204674,15713,400649,15990,7658,8332
68635,425422,24743,204693,15714,400678,15991,7658,8333
68640,425453,24746,204708,15717,400707,15992,7659,8333
68645,425484,24746,204721,15717,400738,15992,7659,8333
68650,425515,24746,204738,15717,400769,15992,7659,8333
68655,425546,24747,204755,15718,400799,15992,7659,8333
68660,425577,24748,204766,15719,400829,15992,7659,8333
68665,425608,24749,204786,15720,400859,15992,7659,8333
68670,425639,24750,204799,15720,400889,15992,7659,8333
68675,425670,24751,204812,15720,400919,15992,7659,8333
68680,425701,24752,204832,15720,400949,15992,7659,8333
68685,425732,24753,204846,15720,400979,15992,7659,8333
68690,425763,24754,204856,15720,401009,15992,7659,8333
68695,425794,24755,204869,15721,401039,15992,7659,8333
68700,425825,24756,204883,15722,401069,15992,7659,8333
68705,425856,24757,204900,15722,401099,15992,7659,8333
68710,425887,24758,204915,15722,401129,15992,7659,8333
68715,425918,24759,204933,15722,401159,15993,7660,8333
68720,425949,24760,204949,15723,401189,15994,7660,8334
68725,425980,24761,204961,15724,401219,15995,7660,8335
68730,426011,24762,204974,15724,401249,15996,7661,8335
68735,426042,24764,204993,15726,401278,15997,7662,8335
68740,426073,24767,205004,15728,401306,15998,7662,8336
68745,426104,24769,205015,15730,401335,16000,7664,8336
68750,426135,24774,205041,15734,401360,16001,7665,8336
68755,426166,24779,205058,15738,401386,16002,7666,8336
68760,426197,24783,205070,15739,401414,16003,7666,8337
68765,426228,24789,205088,15744,401439,16003,7666,8337
68770,426259,24792,205099,15745,401467,16003,7666,8337
68775,426290,24794,205110,15746,401496,16003,7666,8337
68780,426321,24798,205127,15749,401523,16003,7666,8337
68785,426352,24801,205141,15750,401551,16003,7666,8337
68790,426383,24804,205157,15752,401579,16003,7666,8337
68795,426414,24807,205172,15755,401607,16003,7666,8337
68800,426445,24809,205185,15756,401636,16003,7666,8337
68805,426476,24811,205200,15758,401665,16003,7666,8337
68810,426507,24813,205215,15759,401694,16003,7666,8337
68815,426538,24816,205229,15760,401722,16003,7666,8337
68820,426569,24818,205245,15761,401751,16003,7666,8337
68825,426600,24818,205257,15761,401782,16004,7667,8337
68830,426631,24818,205271,15761,401813,16004,7667,8337
68835,426662,24818,205285,15761,401844,16004,7667,8337
68840,426693,24818,205299,15761,401875,16004,7667,8337
68845,426724,24818,205315,15761,401906,16004,7667,8337
68850,426755,24818,205326,15761,401937,16004,7667,8337
68855,426786,24818,205339,15761,401968,16004,7667,8337
68860,426817,24818,205354,15761,401999,16004,7667,8337
68865,426848,24818,205371,15761,402030,16004,7667,8337
68870,426879,24818,205385,15761,402061,16005,7667,8338
68875,426910,24819,205402,15762,402091,16006,7667,8339
68880,426941,24820,205417,15763,402121,16007,7667,8340
68885,426972,24822,205429,15763,402150,16008,7668,8340
68890,427003,24825,205444,15764,402178,16009,7668,8341
68895,427034,24828,205455,15765,402206,16010,7668,8342
68900,427065,24830,205470,15766,402235,16010,7668,8342
68905,427096,24833,205482,15769,402263,16010,7668,8342
68910,427127,24836,205498,15771,402291,16010,7668,8342
68915,427158,24839,205511,15772,402319,16010,7668,8342
68920,427189,24841,205523,15773,402348,16010,7668,8342
68925,427220,24844,205534,15775,402376,16010,7668,8342
68930,427251,24849,205549,15778,402401,16011,7669,8342
68935,427282,24854,205566,15782,402428,16012,7670,8342
68940,427313,24858,205579,15784,402454,16013,7670,8343
68945,427344,24860,205594,15786,402484,16014,7671,8343
68950,427375,24860,205607,15786,402515,16014,7671,8343
68955,427406,24860,205622,15786,402546,16014,7671,8343
68960,427437,24860,205639,15786,402577,16014,7671,8343
68965,427468,24860,205653,15786,402608,16014,7671,8343
68970,427499,24860,205665,15786,402639,16014,7671,8343
68975,427530,24860,205676,15786,402670,16014,7671,8343
68980,427561,24860,205691,15786,402701,16014,7671,8343
68985,427592,24860,205708,15786,402732,16014,7671,8343
68990,427623,24860,205723,15786,402763,16014,7671,8343
68995,427654,24860,205735,15786,402794,16014,7671,8343
69000,427685,24860,205749,15786,402825,16014,7671,8343
69005,427716,24860,205762,15786,402856,16014,7671,8343
69010,427747,24860,205774,15786,402887,16014,7671,8343
69015,427778,24860,205795,15786,402918,16014,7671,8343
69020,427809,24860,205808,15786,402949,16014,7671,8343
69025,427840,24860,205824,15786,402980,16014,7671,8343
69030,427871,24860,205838,15786,403011,16014,7671,8343
69035,427902,24860,205848,15786,403042,16014,7671,8343
69040,427933,24860,205862,15786,403073,16014,7671,8343
69045,427964,24861,205872,15786,403103,16014,7671,8343
69050,427995,24866,205888,15789,403129,16016,7672,8344
69055,428026,24870,205903,15792,403156,16017,7672,8345
69060,428057,24874,205918,15794,403182,16018,7673,8345
69065,428088,24879,205934,15797,403209,16018,7673,8345
69070,428119,24883,205953,15801,403236,16018,7673,8345
69075,428150,24887,205968,15803,403263,16018,7673,8345
69080,428181,24891,205987,15806,403290,16018,7673,8345
69085,428212,24895,205998,15809,403317,16018,7673,8345
69090,428243,24899,206010,15813,403344,16018,7673,8345
69095,428274,24903,206024,15816,403371,16018,7673,8345
69100,428305,24905,206044,15817,403400,16018,7673,8345
69105,428336,24908,206061,15819,403428,16018,7673,8345
69110,428367,24910,206076,15820,403457,16018,7673,8345
69115,428398,24912,206091,15821,403486,16018,7673,8345
69120,428429,24915,206106,15824,403514,16018,7673,8345
69125,428460,24918,206122,15825,403542,16018,7673,8345
69130,428491,24921,206140,15828,403570,16018,7673,8345
69135,428522,24923,206154,15828,403599,16018,7673,8345
69140,428553,24925,206169,15829,403628,16018,7673,8345
69145,428584,24928,206184,15832,403656,16018,7673,8345
69150,428615,24931,206203,15834,403684,16018,7673,8345
69155,428646,24933,206220,15836,403713,16019,7673,8346
69160,428677,24936,206233,15839,403741,16020,7674,8346
69165,428708,24940,206252,15843,403768,16022,7676,8346
69170,428739,24941,206267,15843,403798,16023,7677,8346
69175,428770,24943,206286,15845,403827,16024,7678,8346
69180,428801,24946,206301,15847,403855,16025,7678,8347
69185,428832,24947,206313,15847,403885,16025,7678,8347
69190,428863,24948,206326,15847,403915,16025,7678,8347
69195,428894,24950,206345,15848,403943,16025,7678,8347
69200,428925,24952,206365,15850,403972,16025,7678,8347
69205,428956,24954,206376,15851,404002,16025,7678,8347
69210,428987,24955,206389,15852,404032,16025,7678,8347
69215,429018,24956,206404,15852,404062,16025,7678,8347
69220,429049,24957,206415,15852,404092,16025,7678,8347
69225,429080,24959,206431,15853,404121,16025,7678,8347
69230,429111,24960,206441,15854,404151,16025,7678,8347
69235,429142,24962,206456,15855,404180,16025,7678,8347
69240,429173,24964,206471,15857,404209,16025,7678,8347
69245,429204,24966,206479,15858,404238,16025,7678,8347
69250,429235,24967,206494,15858,404268,16025,7678,8347
69255,429266,24968,206507,15859,404298,16025,7678,8347
69260,429297,24969,206524,15860,404328,16025,7678,8347
69265,429328,24969,206540,15860,404359,16025,7678,8347
69270,429359,24969,206550,15860,404390,16026,7679,8347
69275,429390,24970,206560,15861,404420,16027,7680,8347
69280,429421,24971,206573,15862,404450,16028,7681,8347
69285,429452,24972,206585,15862,404480,16029,7681,8348
69290,429483,24974,206593,15863,404509,16030,7681,8349
69295,429514,24976,206608,15863,404538,16031,7682,8349
69300,429545,24979,206624,15865,404566,16032,7682,8350
69305,429576,24983,206637,15868,404593,16032,7682,8350
69310,429607,24987,206650,15869,404619,16032,7682,8350
69315,429638,24990,206659,15871,404648,16032,7682,8350
69320,429669,24993,206671,15873,404676,16032,7682,8350
69325,429700,24997,206683,15877,404703,16032,7682,8350
69330,429731,24999,206698,15879,404732,16032,7682,8350
69335,429762,25001,206718,15880,404761,16032,7682,8350
69340,429793,25003,206732,15881,404790,16032,7682,8350
69345,429824,25005,206744,15882,404819,16032,7682,8350
69350,429855,25008,206759,15884,404847,16032,7682,8350
69355,429886,25009,206773,15884,404877,16032,7682,8350
69360,429917,25010,206787,15885,404907,16032,7682,8350
69365,429948,25011,206807,15885,404937,16032,7682,8350
69370,429979,25011,206817,15885,404968,16032,7682,8350
69375,430010,25011,206834,15885,404999,16032,7682,8350
69380,430041,25011,206850,15885,405030,16032,7682,8350
69385,430072,25011,206865,15885,405061,16033,7682,8351
69390,430103,25011,206882,15885,405092,16034,7683,8351
69395,430134,25011,206897,15885,405123,16035,7684,8351
69400,430165,25011,206913,15885,405154,16035,7684,8351
69405,430196,25011,206928,15885,405185,16036,7684,8352
69410,430227,25011,206935,15885,405216,16037,7684,8353
69415,430258,25012,206949,15885,405245,16038,7685,8353
69420,430289,25014,206962,15886,405274,16039,7686,8353
69425,430320,25016,206980,15888,405304,16039,7686,8353
69430,430351,25018,206993,15890,405333,16039,7686,8353
69435,430382,25021,207009,15892,405361,16039,7686,8353
69440,430413,25023,207024,15894,405390,16039,7686,8353
69445,430444,25026,207043,15896,405418,16039,7686,8353
69450,430475,25028,207056,15897,405447,16039,7686,8353
69455,430506,25030,207071,15898,405475,16039,7686,8353
69460,430537,25034,207084,15900,405502,16039,7686,8353
69465,430568,25037,207099,15902,405530,16039,7686,8353
69470,430599,25040,207112,15904,405559,16039,7686,8353
69475,430630,25042,207130,15905,405587,16039,7686,8353
69480,430661,25046,207142,15907,405614,16039,7686,8353
69485,430692,25050,207157,15910,405642,16039,7686,8353
69490,430723,25053,207176,15913,405670,16039,7686,8353
69495,430754,25056,207193,15914,405698,16039,7686,8353
69500,430785,25058,207208,15914,405727,16040,7687,8353
69505,430816,25060,207224,15915,405756,16040,7687,8353
69510,430847,25062,207244,15916,405785,16040,7687,8353
69515,430878,25065,207260,15917,405813,16040,7687,8353
69520,430909,25069,207276,15919,405840,16040,7687,8353
69525,430940,25072,207292,15921,405868,16041,7688,8353
69530,430971,25075,207309,15923,405896,16042,7688,8354
69535,431002,25077,207319,15924,405925,16043,7688,8355
69540,431033,25080,207335,15926,405953,16044,7689,8355
69545,431064,25081,207353,15927,405983,16044,7689,8355
69550,431095,25082,207370,15927,406013,16044,7689,8355
69555,431126,25083,207383,15927,406043,16044,7689,8355
69560,431157,25084,207399,15927,406073,16044,7689,8355
69565,431188,25085,207417,15927,406103,16044,7689,8355
69570,431219,25086,207430,15927,406133,16044,7689,8355
69575,431250,25088,207446,15928,406162,16044,7689,8355
69580,431281,25090,207460,15929,406191,16044,7689,8355
69585,431312,25092,207477,15930,406220,16044,7689,8355
69590,431343,25095,207494,15932,406248,16044,7689,8355
69595,431374,25098,207511,15934,406276,16044,7689,8355
69600,431405,25101,207528,15936,406304,16044,7689,8355
69605,431436,25104,207546,15938,406332,16044,7689,8355
69610,431467,25107,207556,15939,406360,16044,7689,8355
69615,431498,25111,207573,15943,406387,16044,7689,8355
69620,431529,25115,207584,15945,406414,16044,7689,8355
69625,431560,25118,207601,15948,406442,16044,7689,8355
69630,431591,25121,207620,15950,406470,16045,7690,8355
69635,431622,25124,207636,15952,406498,16046,7690,8356
69640,431653,25128,207653,15955,406525,16047,7691,8356
69645,431684,25131,207666,15957,406553,16048,7692,8356
69650,431715,25135,207683,15960,406580,16048,7692,8356
69655,431746,25137,207701,15962,406609,16049,7693,8356
69660,431777,25138,207717,15963,406639,16050,7693,8357
69665,431808,25138,207736,15963,406670,16051,7694,8357
69670,431839,25138,207752,15963,406701,16051,7694,8357
69675,431870,25138,207765,15963,406732,16051,7694,8357
69680,431901,25138,207778,15963,406763,16051,7694,8357
69685,431932,25138,207797,15963,406794,16051,7694,8357
69690,431963,25138,207811,15963,406825,16051,7694,8357
69695,431994,25138,207829,15963,406856,16051,7694,8357
69700,432025,25138,207849,15963,406887,16051,7694,8357
69705,432056,25139,207860,15964,406917,16051,7694,8357
69710,432087,25141,207878,15965,406946,16051,7694,8357
69715,432118,25143,207891,15967,406975,16051,7694,8357
69720,432149,25145,207904,15969,407004,16051,7694,8357
69725,432180,25148,207913,15970,407032,16051,7694,8357
69730,432211,25150,207924,15971,407061,16051,7694,8357
69735,432242,25153,207939,15973,407089,16051,7694,8357
69740,432273,25156,207956,15975,407117,16051,7694,8357
69745,432304,25159,207976,15977,407145,16051,7694,8357
69750,432335,25161,207985,15977,407174,16052,7694,8358
69755,432366,25163,208002,15978,407203,16053,7694,8359
69760,432397,25166,208008,15978,407231,16054,7695,8359
69765,432428,25169,208023,15979,407259,16055,7695,8360
69770,432459,25174,208031,15981,407285,16057,7695,8362
69775,432490,25179,208044,15984,407311,16059,7695,8364
69780,432521,25185,208060,15988,407336,16060,7695,8365
69785,432552,25186,208073,15989,407366,16060,7695,8365
69790,432583,25187,208084,15989,407396,16060,7695,8365
69795,432614,25188,208101,15989,407426,16060,7695,8365
69800,432645,25189,208116,15990,407456,16060,7695,8365
69805,432676,25190,208132,15991,407486,16060,7695,8365
69810,432707,25191,208141,15992,407516,16060,7695,8365
69815,432738,25192,208160,15992,407546,16060,7695,8365
69820,432769,25193,208177,15993,407576,16060,7695,8365
69825,432800,25194,208189,15994,407606,16060,7695,8365
69830,432831,25195,208204,15994,407636,16060,7695,8365
69835,432862,25196,208221,15995,407666,16060,7695,8365
69840,432893,25197,208236,15995,407696,16060,7695,8365
69845,432924,25198,208251,15995,407726,16060,7695,8365
69850,432955,25199,208263,15995,407756,16060,7695,8365
69855,432986,25200,208279,15996,407786,16060,7695,8365
69860,433017,25201,208293,15996,407816,16060,7695,8365
69865,433048,25202,208307,15997,407846,16060,7695,8365
69870,433079,25203,208319,15997,407876,16060,7695,8365
69875,433110,25204,208337,15998,407906,16060,7695,8365
69880,433141,25205,208351,15998,407936,16061,7695,8366
69885,433172,25207,208366,16000,407965,16063,7696,8367
69890,433203,25210,208379,16002,407993,16065,7696,8369
69895,433234,25214,208393,16005,408020,16066,7696,8370
69900,433265,25220,208406,16010,408044,16067,7697,8370
69905,433296,25224,208421,16013,408072,16067,7697,8370
69910,433327,25225,208432,16013,408102,16067,7697,8370
69915,433358,25227,208454,16014,408131,16067,7697,8370
69920,433389,25229,208465,16015,408160,16067,7697,8370
69925,433420,25230,208479,16015,408190,16067,7697,8370
69930,433451,25231,208493,16016,408220,16067,7697,8370
69935,433482,25233,208510,16017,408249,16067,7697,8370
69940,433513,25234,208526,16018,408279,16067,7697,8370
69945,433544,25235,208535,16019,408309,16067,7697,8370
69950,433575,25237,208555,16021,408338,16067,7697,8370
69955,433606,25238,208569,16021,408368,16067,7697,8370
69960,433637,25240,208584,16023,408397,16067,7697,8370
69965,433668,25240,208602,16023,408428,16068,7697,8371
69970,433699,25240,208619,16023,408459,16068,7697,8371
69975,433730,25240,208634,16023,408490,16068,7697,8371
69980,433761,25240,208647,16023,408521,16068,7697,8371
69985,433792,25240,208666,16023,408552,16068,7697,8371
69990,433823,25240,208684,16023,408583,16068,7697,8371
69995,433854,25240,208697,16023,408614,16068,7697,8371
70000,433885,25240,208710,16023,408645,16068,7697,8371
70005,433916,25240,208722,16023,408676,16068,7697,8371
70010,433947,25240,208738,16023,408707,16069,7697,8372
70015,433978,25241,208752,16023,408737,16070,7698,8372
70020,434009,25243,208769,16025,408766,16071,7699,8372
70025,434040,25246,208784,16028,408794,16071,7699,8372
70030,434071,25249,208801,16029,408822,16071,7699,8372
70035,434102,25251,208816,16030,408851,16071,7699,8372
70040,434133,25254,208828,16031,408879,16071,7699,8372
70045,434164,25257,208843,16033,408907,16071,7699,8372
70050,434195,25260,208859,16034,408935,16071,7699,8372
70055,434226,25262,208875,16034,408964,16071,7699,8372
70060,434257,25264,208889,16036,408993,16071,7699,8372
70065,434288,25268,208902,16039,409020,16071,7699,8372
70070,434319,25271,208916,16041,409048,16071,7699,8372
70075,434350,25274,208932,16044,409076,16071,7699,8372
70080,434381,25276,208953,16046,409105,16071,7699,8372
70085,434412,25278,208970,16048,409134,16072,7700,8372
70090,434443,25279,208980,16048,409164,16073,7701,8372
70095,434474,25280,208993,16048,409194,16073,7701,8372
70100,434505,25283,209009,16050,409222,16073,7701,8372
70105,434536,25285,209023,16051,409251,16073,7701,8372
70110,434567,25287,209035,16052,409280,16073,7701,8372
70115,434598,25288,209050,16052,409310,16073,7701,8372
70120,434629,25290,209068,16054,409338,16073,7701,8372
70125,434660,25292,209080,16055,409368,16074,7701,8373
70130,434691,25292,209094,16055,409399,16075,7701,8374
70135,434722,25292,209109,16055,409430,16076,7701,8375
70140,434753,25292,209118,16055,409461,16077,7702,8375
70145,434784,25293,209134,16055,409491,16078,7702,8376
70150,434815,25295,209146,16056,409520,16079,7702,8377
70155,434846,25297,209163,16058,409549,16080,7702,8378
70160,434877,25298,209174,16058,409579,16080,7702,8378
70165,434908,25299,209186,16058,409609,16080,7702,8378
70170,434939,25300,209203,16059,409639,16080,7702,8378
70175,434970,25302,209220,16059,409668,16080,7702,8378
70180,435001,25304,209236,16060,409697,16080,7702,8378
70185,435032,25306,209257,16062,409726,16080,7702,8378
70190,435063,25308,209267,16062,409755,16080,7702,8378
70195,435094,25310,209282,16064,409784,16081,7703,8378
70200,435125,25312,209294,16064,409813,16082,7704,8378
70205,435156,25316,209304,16066,409840,16083,7704,8379
70210,435187,25319,209317,16067,409868,16083,7704,8379
70215,435218,25323,209329,16068,409895,16083,7704,8379
70220,435249,25326,209341,16068,409923,16083,7704,8379
70225,435280,25330,209357,16070,409950,16083,7704,8379
70230,435311,25334,209373,16073,409977,16083,7704,8379
70235,435342,25338,209391,16076,410004,16083,7704,8379
70240,435373,25341,209404,16078,410032,16083,7704,8379
70245,435404,25345,209416,16080,410059,16083,7704,8379
70250,435435,25347,209429,16081,410088,16083,7704,8379
70255,435466,25349,209441,16083,410117,16083,7704,8379
70260,435497,25350,209462,16084,410147,16083,7704,8379
70265,435528,25352,209478,16086,410176,16083,7704,8379
70270,435559,25353,209495,16086,410206,16083,7704,8379
70275,435590,25355,209513,16087,410235,16083,7704,8379
70280,435621,25357,209529,16089,410264,16083,7704,8379
70285,435652,25358,209541,16090,410294,16083,7704,8379
70290,435683,25360,209556,16092,410323,16083,7704,8379
70295,435714,25361,209573,16092,410353,16083,7704,8379
70300,435745,25362,209587,16092,410383,16083,7704,8379
70305,435776,25363,209599,16093,410413,16083,7704,8379
70310,435807,25365,209619,16095,410442,16084,7705,8379
70315,435838,25367,209637,16096,410471,16085,7705,8380
70320,435869,25369,209654,16097,410500,16086,7705,8381
70325,435900,25371,209669,16098,410529,16087,7706,8381
70330,435931,25372,209684,16099,410559,16087,7706,8381
70335,435962,25373,209698,16099,410589,16087,7706,8381
70340,435993,25374,209717,16100,410619,16087,7706,8381
70345,436024,25375,209734,16100,410649,16087,7706,8381
70350,436055,25377,209753,16100,410678,16087,7706,8381
70355,436086,25379,209768,16101,410707,16087,7706,8381
70360,436117,25381,209780,16102,410736,16087,7706,8381
70365,436148,25384,209798,16104,410764,16087,7706,8381
70370,436179,25386,209810,16105,410793,16087,7706,8381
70375,436210,25389,209824,16106,410821,16087,7706,8381
70380,436241,25392,209841,16109,410849,16087,7706,8381
70385,436272,25395,209854,16111,410877,16087,7706,8381
70390,436303,25398,209872,16114,410905,16087,7706,8381
70395,436334,25400,209883,16115,410934,16087,7706,8381
70400,436365,25403,209901,16118,410962,16087,7706,8381
70405,436396,25406,209919,16121,410990,16087,7706,8381
70410,436427,25408,209932,16123,411019,16087,7706,8381
70415,436458,25411,209945,16126,411047,16087,7706,8381
70420,436489,25415,209961,16128,411074,16087,7706,8381
70425,436520,25418,209978,16131,411102,16087,7706,8381
70430,436551,25422,209997,16134,411129,16088,7706,8382
70435,436582,25426,210017,16136,411156,16089,7707,8382
70440,436613,25431,210033,16139,411182,16090,7708,8382
70445,436644,25434,210046,16141,411210,16091,7708,8383
70450,436675,25436,210059,16142,411238,16091,7708,8383
70455,436706,25439,210076,16145,411267,16091,7708,8383
70460,436737,25441,210094,16146,411296,16091,7708,8383
70465,436768,25442,210109,16147,411326,16091,7708,8383
70470,436799,25443,210126,16148,411356,16091,7708,8383
70475,436830,25444,210142,16149,411386,16091,7708,8383
70480,436861,25445,210155,16150,411416,16091,7708,8383
70485,436892,25446,210168,16150,411446,16091,7708,8383
70490,436923,25447,210187,16150,411476,16091,7708,8383
70495,436954,25448,210201,16151,411506,16091,7708,8383
70500,436985,25449,210217,16151,411536,16091,7708,8383
70505,437016,25450,210230,16151,411566,16092,7709,8383
70510,437047,25451,210247,16152,411596,16092,7709,8383
70515,437078,25452,210262,16152,411626,16092,7709,8383
70520,437109,25453,210279,16153,411656,16092,7709,8383
70525,437140,25454,210293,16154,411686,16092,7709,8383
70530,437171,25455,210306,16155,411716,16092,7709,8383
70535,437202,25456,210321,16156,411746,16092,7709,8383
70540,437233,25457,210336,16156,411776,16092,7709,8383
70545,437264,25459,210351,16158,411805,16092,7709,8383
70550,437295,25462,210367,16159,411833,16092,7709,8383
70555,437326,25465,210388,16161,411861,16092,7709,8383
70560,437357,25467,210402,16162,411890,16092,7709,8383
70565,437388,25470,210416,16165,411918,16093,7709,8384
70570,437419,25473,210433,16168,411945,16094,7710,8384
70575,437450,25476,210453,16171,411973,16094,7710,8384
70580,437481,25480,210470,16174,412001,16094,7710,8384
70585,437512,25483,210487,16177,412029,16094,7710,8384
70590,437543,25486,210503,16179,412057,16094,7710,8384
70595,437574,25488,210521,16180,412086,16094,7710,8384
70600,437605,25491,210537,16181,412114,16094,7710,8384
70605,437636,25493,210550,16181,412143,16094,7710,8384
70610,437667,25496,210568,16182,412171,16095,7711,8384
70615,437698,25498,210580,16184,412200,16096,7711,8385
70620,437729,25500,210596,16185,412229,16097,7711,8386
70625,437760,25502,210614,16187,412258,16097,7711,8386
70630,437791,25504,210631,16188,412287,16097,7711,8386
70635,437822,25506,210648,16189,412316,16097,7711,8386
70640,437853,25508,210661,16190,412345,16097,7711,8386
70645,437884,25510,210677,16191,412374,16097,7711,8386
70650,437915,25512,210694,16191,412403,16097,7711,8386
70655,437946,25514,210713,16191,412432,16097,7711,8386
70660,437977,25516,210727,16191,412461,16097,7711,8386
70665,438008,25518,210743,16191,412490,16097,7711,8386
70670,438039,25522,210757,16193,412517,16097,7711,8386
70675,438070,25526,210772,16196,412544,16097,7711,8386
70680,438101,25529,210786,16197,412572,16098,7711,8387
70685,438132,25531,210799,16199,412601,16099,7712,8387
70690,438163,25532,210815,16200,412631,16099,7712,8387
70695,438194,25534,210829,16202,412660,16099,7712,8387
70700,438225,25535,210839,16202,412690,16099,7712,8387
70705,438256,25536,210854,16203,412720,16099,7712,8387
70710,438287,25537,210868,16204,412750,16099,7712,8387
70715,438318,25538,210886,16205,412780,16099,7712,8387
70720,438349,25539,210902,16206,412810,16099,7712,8387
70725,438380,25540,210918,16206,412840,16100,7712,8388
70730,438411,25541,210931,16206,412870,16101,7712,8389
70735,438442,25542,210946,16207,412900,16102,7713,8389
70740,438473,25543,210962,16207,412930,16102,7713,8389
70745,438504,25544,210975,16208,412960,16102,7713,8389
70750,438535,25545,210991,16209,412990,16102,7713,8389
70755,438566,25546,211009,16210,413020,16102,7713,8389
70760,438597,25547,211028,16211,413050,16102,7713,8389
70765,438628,25548,211042,16211,413080,16102,7713,8389
70770,438659,25549,211055,16211,413110,16102,7713,8389
70775,438690,25550,211070,16211,413140,16102,7713,8389
70780,438721,25551,211082,16211,413170,16102,7713,8389
70785,438752,25554,211096,16213,413198,16102,7713,8389
70790,438783,25558,211112,16215,413225,16102,7713,8389
70795,438814,25563,211130,16220,413251,16103,7713,8390
70800,438845,25566,211144,16221,413279,16104,7713,8391
70805,438876,25567,211161,16222,413309,16104,7713,8391
70810,438907,25568,211175,16222,413339,16104,7713,8391
70815,438938,25569,211195,16223,413369,16104,7713,8391
70820,438969,25570,211210,16223,413399,16104,7713,8391
70825,439000,25571,211225,16223,413429,16104,7713,8391
70830,439031,25572,211244,16224,413459,16104,7713,8391
70835,439062,25573,211259,16225,413489,16104,7713,8391
70840,439093,25574,211277,16226,413519,16105,7714,8391
70845,439124,25575,211295,16227,413549,16106,7715,8391
70850,439155,25576,211305,16227,413579,16107,7715,8392
70855,439186,25577,211318,16228,413609,16107,7715,8392
70860,439217,25578,211338,16229,413639,16107,7715,8392
70865,439248,25579,211348,16229,413669,16107,7715,8392
70870,439279,25580,211365,16230,413699,16107,7715,8392
70875,439310,25581,211380,16230,413729,16107,7715,8392
70880,439341,25582,211397,16231,413759,16107,7715,8392
70885,439372,25583,211412,16232,413789,16107,7715,8392
70890,439403,25584,211429,16233,413819,16107,7715,8392
70895,439434,25585,211445,16233,413849,16107,7715,8392
70900,439465,25586,211466,16234,413879,16107,7715,8392
70905,439496,25587,211483,16234,413909,16107,7715,8392
70910,439527,25590,211489,16235,413937,16108,7715,8393
70915,439558,25595,211506,16239,413963,16109,7715,8394
70920,439589,25599,211515,16241,413990,16110,7716,8394
70925,439620,25601,211529,16242,414019,16110,7716,8394
70930,439651,25603,211544,16244,414048,16110,7716,8394
70935,439682,25605,211559,16246,414077,16110,7716,8394
70940,439713,25607,211573,16248,414106,16110,7716,8394
70945,439744,25608,211590,16249,414136,16110,7716,8394
70950,439775,25609,211604,16249,414166,16110,7716,8394
70955,439806,25610,211621,16250,414196,16110,7716,8394
70960,439837,25611,211633,16251,414226,16110,7716,8394
70965,439868,25612,211649,16252,414256,16111,7717,8394
70970,439899,25613,211666,16253,414286,16112,7717,8395
70975,439930,25614,211682,16254,414316,16113,7718,8395
70980,439961,25615,211698,16254,414346,16114,7719,8395
70985,439992,25616,211711,16254,414376,16115,7720,8395
70990,440023,25617,211728,16254,414406,16115,7720,8395
70995,440054,25618,211735,16254,414436,16115,7720,8395
71000,440085,25619,211752,16255,414466,16115,7720,8395
71005,440116,25620,211768,16255,414496,16115,7720,8395
71010,440147,25621,211782,16256,414526,16115,7720,8395
71015,440178,25622,211799,16257,414556,16115,7720,8395
71020,440209,25624,211819,16258,414585,16115,7720,8395
71025,440240,25627,211829,16259,414613,16115,7720,8395
71030,440271,25630,211846,16261,414640,16116,7721,8395
71035,440302,25634,211856,16264,414667,16117,7721,8396
71040,440333,25638,211870,16267,414694,16118,7722,8396
71045,440364,25641,211887,16268,414723,16119,7723,8396
71050,440395,25643,211900,16268,414752,16120,7723,8397
71055,440426,25645,211917,16269,414781,16121,7723,8398
71060,440457,25648,211935,16271,414809,16122,7723,8399
71065,440488,25650,211948,16271,414838,16123,7724,8399
71070,440519,25653,211965,16273,414866,16124,7725,8399
71075,440550,25656,211986,16276,414894,16125,7726,8399
71080,440581,25658,211999,16278,414923,16126,7727,8399
71085,440612,25660,212013,16279,414952,16127,7727,8400
71090,440643,25662,212032,16281,414981,16129,7729,8400
71095,440674,25664,212046,16281,415010,16131,7730,8401
71100,440705,25666,212052,16281,415039,16133,7731,8402
71105,440736,25669,212070,16283,415067,16134,7731,8403
71110,440767,25671,212084,16284,415096,16134,7731,8403
71115,440798,25673,212096,16285,415125,16134,7731,8403
71120,440829,25675,212111,16286,415154,16134,7731,8403
71125,440860,25677,212128,16287,415183,16134,7731,8403
71130,440891,25679,212145,16289,415212,16134,7731,8403
71135,440922,25680,212162,16289,415242,16134,7731,8403
71140,440953,25681,212180,16289,415272,16134,7731,8403
71145,440984,25682,212193,16289,415302,16134,7731,8403
71150,441015,25683,212209,16289,415332,16134,7731,8403
71155,441046,25684,212226,16290,415362,16134,7731,8403
71160,441077,25685,212238,16291,415392,16134,7731,8403
71165,441108,25686,212259,16291,415422,16134,7731,8403
71170,441139,25687,212274,16291,415452,16134,7731,8403
71175,441170,25688,212289,16292,415482,16134,7731,8403
71180,441201,25689,212303,16292,415512,16134,7731,8403
71185,441232,25690,212316,16292,415542,16134,7731,8403
71190,441263,25691,212333,16292,415572,16134,7731,8403
71195,441294,25692,212346,16292,415602,16134,7731,8403
71200,441325,25693,212358,16292,415632,16134,7731,8403
71205,441356,25694,212375,16292,415662,16134,7731,8403
71210,441387,25696,212391,16292,415691,16136,7731,8405
71215,441418,25698,212406,16293,415720,16138,7732,8406
71220,441449,25701,212422,16296,415748,16140,7733,8407
71225,441480,25704,212439,16298,415776,16141,7734,8407
71230,441511,25706,212453,16299,415804,16142,7735,8407
71235,441542,25710,212469,16302,415831,16143,7735,8408
71240,441573,25714,212487,16305,415859,16144,7735,8409
71245,441604,25716,212502,16306,415888,16144,7735,8409
71250,441635,25717,212518,16307,415918,16144,7735,8409
71255,441666,25718,212532,16307,415948,16144,7735,8409
71260,441697,25719,212549,16308,415978,16144,7735,8409
71265,441728,25720,212563,16308,416008,16144,7735,8409
71270,441759,25721,212575,16308,416038,16144,7735,8409
71275,441790,25722,212585,16308,416068,16144,7735,8409
71280,441821,25723,212600,16308,416098,16144,7735,8409
71285,441852,25724,212615,16308,416128,16144,7735,8409
71290,441883,25725,212630,16308,416158,16144,7735,8409
71295,441914,25726,212643,16308,416188,16144,7735,8409
71300,441945,25727,212659,16309,416218,16144,7735,8409
71305,441976,25728,212673,16309,416248,16144,7735,8409
71310,442007,25730,212686,16310,416277,16144,7735,8409
71315,442038,25731,212702,16311,416307,16144,7735,8409
71320,442069,25732,212715,16311,416337,16144,7735,8409
71325,442100,25733,212734,16312,416367,16144,7735,8409
71330,442131,25736,212751,16314,416395,16145,7735,8410
71335,442162,25739,212767,16315,416423,16146,7735,8411
71340,442193,25742,212777,16317,416451,16147,7735,8412
71345,442224,25744,212791,16317,416480,16149,7737,8412
71350,442255,25747,212804,16318,416508,16150,7737,8413
71355,442286,25749,212817,16319,416537,16151,7737,8414
71360,442317,25751,212831,16321,416566,16152,7737,8415
71365,442348,25753,212846,16321,416595,16153,7737,8416
71370,442379,25755,212862,16322,416624,16154,7737,8417
71375,442410,25757,212878,16322,416652,16155,7738,8417
71380,442441,25760,212893,16325,416680,16156,7739,8417
71385,442472,25763,212907,16327,416709,16157,7739,8418
71390,442503,25765,212924,16329,416738,16158,7739,8419
71395,442534,25767,212939,16331,416767,16159,7740,8419
71400,442565,25769,212951,16331,416796,16159,7740,8419
71405,442596,25774,212968,16333,416822,16159,7740,8419
71410,442627,25777,212980,16334,416850,16159,7740,8419
71415,442658,25779,212991,16335,416879,16159,7740,8419
71420,442689,25781,213003,16337,416908,16159,7740,8419
71425,442720,25783,213021,16338,416937,16159,7740,8419
71430,442751,25785,213030,16338,416966,16159,7740,8419
71435,442782,25787,213045,16340,416995,16159,7740,8419
71440,442813,25789,213064,16342,417024,16159,7740,8419
71445,442844,25791,213077,16344,417053,16159,7740,8419
71450,442875,25793,213095,16344,417082,16160,7740,8420
71455,442906,25795,213107,16345,417111,16161,7740,8421
71460,442937,25798,213122,16346,417139,16161,7740,8421
71465,442968,25801,213138,16349,417167,16161,7740,8421
71470,442999,25803,213151,16350,417196,16161,7740,8421
71475,443030,25806,213168,16353,417224,16161,7740,8421
71480,443061,25809,213180,16354,417252,16161,7740,8421
71485,443092,25811,213198,16354,417280,16161,7740,8421
71490,443123,25814,213213,16357,417309,16161,7740,8421
71495,443154,25816,213224,16357,417337,16161,7740,8421
71500,443185,25819,213238,16359,417366,16161,7740,8421
71505,443216,25821,213253,16361,417395,16161,7740,8421
71510,443247,25824,213268,16363,417422,16162,7740,8422
71515,443278,25826,213278,16365,417452,16162,7740,8422
71520,443309,25826,213290,16365,417483,16162,7740,8422
71525,443340,25828,213307,16367,417512,16162,7740,8422
71530,443371,25829,213321,16367,417542,16162,7740,8422
71535,443402,25831,213338,16369,417571,16162,7740,8422
71540,443433,25833,213358,16370,417600,16162,7740,8422
71545,443464,25834,213373,16371,417630,16162,7740,8422
71550,443495,25836,213395,16373,417659,16162,7740,8422
71555,443526,25837,213405,16373,417689,16162,7740,8422
71560,443557,25839,213418,16374,417718,16162,7740,8422
71565,443588,25840,213433,16375,417748,16162,7740,8422
71570,443619,25840,213443,16375,417779,16163,7741,8422
71575,443650,25840,213455,16375,417810,16163,7741,8422
71580,443681,25840,213471,16375,417841,16163,7741,8422
71585,443712,25840,213485,16375,417872,16163,7741,8422
71590,443743,25840,213501,16375,417903,16163,7741,8422
71595,443774,25840,213513,16375,417934,16163,7741,8422
71600,443805,25840,213527,16375,417965,16163,7741,8422
71605,443836,25840,213539,16375,417996,16163,7741,8422
71610,443867,25840,213552,16375,418027,16163,7741,8422
71615,443898,25840,213568,16375,418058,16163,7741,8422
71620,443929,25841,213587,16376,418088,16163,7741,8422
71625,443960,25842,213602,16376,418117,16164,7741,8423
71630,443991,25846,213615,16378,418145,16165,7741,8424
71635,444022,25848,213624,16379,418174,16166,7742,8424
71640,444053,25851,213636,16380,418201,16167,7743,8424
71645,444084,25855,213653,16383,418229,16167,7743,8424
71650,444115,25858,213668,16385,418257,16167,7743,8424
71655,444146,25861,213684,16386,418285,16167,7743,8424
71660,444177,25864,213697,16386,418313,16167,7743,8424
71665,444208,25867,213713,16387,418341,16167,7743,8424
71670,444239,25870,213726,16388,418369,16167,7743,8424
71675,444270,25873,213739,16390,418397,16168,7744,8424
71680,444301,25877,213753,16392,418424,16169,7745,8424
71685,444332,25881,213765,16394,418451,16170,7745,8425
71690,444363,25885,213779,16396,418478,16171,7746,8425
71695,444394,25888,213788,16397,418506,16172,7747,8425
71700,444425,25891,213808,16398,418534,16173,7748,8425
71705,444456,25894,213822,16399,418562,16173,7748,8425
71710,444487,25897,213835,16400,418590,16173,7748,8425
71715,444518,25900,213851,16402,418618,16173,7748,8425
71720,444549,25903,213862,16402,418646,16173,7748,8425
71725,444580,25906,213876,16402,418674,16173,7748,8425
71730,444611,25909,213888,16403,418702,16173,7748,8425
71735,444642,25912,213907,16404,418730,16173,7748,8425
71740,444673,25915,213922,16406,418758,16173,7748,8425
71745,444704,25919,213933,16407,418785,16173,7748,8425
71750,444735,25923,213945,16408,418812,16174,7748,8426
71755,444766,25928,213964,16412,418837,16175,7749,8426
71760,444797,25932,213982,16415,418864,16176,7750,8426
71765,444828,25934,213995,16417,418894,16177,7751,8426
71770,444859,25934,214006,16417,418925,16178,7751,8427
71775,444890,25934,214019,16417,418956,16178,7751,8427
71780,444921,25934,214034,16417,418987,16178,7751,8427
71785,444952,25934,214050,16417,419018,16178,7751,8427
71790,444983,25934,214065,16417,419049,16178,7751,8427
71795,445014,25934,214081,16417,419080,16178,7751,8427
71800,445045,25934,214095,16417,419111,16178,7751,8427
71805,445076,25934,214111,16417,419142,16179,7751,8428
71810,445107,25934,214124,16417,419173,16180,7751,8429
71815,445138,25934,214141,16417,419204,16181,7752,8429
71820,445169,25934,214158,16417,419235,16182,7752,8430
71825,445200,25934,214169,16417,419266,16183,7752,8431
71830,445231,25934,214186,16417,419297,16184,7752,8432
71835,445262,25934,214201,16417,419328,16185,7752,8433
71840,445293,25934,214215,16417,419359,16185,7752,8433
71845,445324,25934,214228,16417,419390,16185,7752,8433
71850,445355,25934,214245,16417,419421,16185,7752,8433
71855,445386,25934,214260,16417,419452,16185,7752,8433
71860,445417,25934,214274,16417,419483,16185,7752,8433
71865,445448,25934,214288,16417,419514,16185,7752,8433
71870,445479,25936,214304,16418,419543,16185,7752,8433
71875,445510,25940,214321,16421,419569,16185,7752,8433
71880,445541,25945,214334,16426,419595,16186,7753,8433
71885,445572,25951,214348,16430,419621,16188,7754,8434
71890,445603,25954,214360,16431,419649,16189,7754,8435
71895,445634,25957,214374,16433,419677,16189,7754,8435
71900,445665,25959,214388,16433,419706,16189,7754,8435
71905,445696,25961,214402,16433,419735,16189,7754,8435
71910,445727,25963,214422,16434,419764,16189,7754,8435
71915,445758,25965,214437,16435,419793,16189,7754,8435
71920,445789,25967,214453,16436,419822,16189,7754,8435
71925,445820,25969,214470,16436,419851,16189,7754,8435
71930,445851,25971,214480,16437,419880,16189,7754,8435
71935,445882,25973,214494,16437,419909,16189,7754,8435
71940,445913,25975,214512,16438,419938,16189,7754,8435
71945,445944,25977,214529,16439,419967,16189,7754,8435
71950,445975,25980,214543,16440,419995,16189,7754,8435
71955,446006,25982,214556,16442,420024,16189,7754,8435
71960,446037,25984,214571,16443,420053,16189,7754,8435
71965,446068,25986,214587,16445,420082,16189,7754,8435
71970,446099,25988,214607,16445,420111,16189,7754,8435
71975,446130,25990,214621,16447,420140,16189,7754,8435
71980,446161,25992,214633,16448,420169,16189,7754,8435
71985,446192,25994,214651,16450,420198,16189,7754,8435
71990,446223,25997,214667,16452,420225,16189,7754,8435
71995,446254,26002,214675,16455,420252,16190,7754,8436
72000,446285,26005,214691,16457,420280,16191,7754,8437
72005,446316,26006,214700,16458,420310,16193,7755,8438
72010,446347,26007,214717,16459,420339,16194,7755,8439
72015,446378,26009,214730,16461,420369,16195,7755,8440
72020,446409,26011,214750,16462,420397,16196,7755,8441
72025,446440,26013,214766,16463,420427,16197,7756,8441
72030,446471,26015,214785,16465,420455,16198,7757,8441
72035,446502,26018,214805,16468,420483,16199,7758,8441
72040,446533,26021,214822,16471,420512,16200,7759,8441
72045,446564,26021,214839,16471,420543,16200,7759,8441
72050,446595,26021,214853,16471,420574,16200,7759,8441
72055,446626,26021,214863,16471,420605,16200,7759,8441
72060,446657,26021,214879,16471,420636,16200,7759,8441
72065,446688,26021,214897,16471,420667,16200,7759,8441
72070,446719,26021,214910,16471,420698,16200,7759,8441
72075,446750,26021,214929,16471,420729,16200,7759,8441
72080,446781,26021,214942,16471,420760,16200,7759,8441
72085,446812,26021,214958,16471,420791,16200,7759,8441
72090,446843,26021,214975,16471,420822,16200,7759,8441
72095,446874,26021,214984,16471,420853,16200,7759,8441
72100,446905,26021,215004,16471,420884,16200,7759,8441
72105,446936,26022,215017,16471,420914,16200,7759,8441
72110,446967,26024,215030,16472,420943,16201,7759,8442
72115,446998,26026,215047,16473,420972,16203,7759,8444
72120,447029,26028,215062,16474,421001,16203,7759,8444
72125,447060,26032,215075,16476,421028,16203,7759,8444
72130,447091,26035,215088,16477,421056,16203,7759,8444
72135,447122,26038,215103,16480,421084,16203,7759,8444
72140,447153,26041,215121,16482,421112,16203,7759,8444
72145,447184,26044,215135,16483,421140,16203,7759,8444
72150,447215,26048,215146,16485,421167,16203,7759,8444
72155,447246,26053,215163,16489,421193,16203,7759,8444
72160,447277,26058,215179,16493,421219,16203,7759,8444
72165,447308,26062,215197,16497,421246,16203,7759,8444
72170,447339,26065,215211,16500,421274,16203,7759,8444
72175,447370,26070,215229,16503,421300,16203,7759,8444
72180,447401,26073,215241,16504,421328,16203,7759,8444
72185,447432,26076,215264,16505,421356,16203,7759,8444
72190,447463,26078,215275,16506,421385,16203,7759,8444
72195,447494,26081,215287,16507,421413,16203,7759,8444
72200,447525,26083,215301,16508,421442,16203,7759,8444
72205,447556,26085,215316,16509,421471,16203,7759,8444
72210,447587,26086,215334,16509,421501,16203,7759,8444
72215,447618,26087,215349,16509,421531,16203,7759,8444
72220,447649,26088,215362,16509,421561,16204,7760,8444
72225,447680,26090,215374,16510,421590,16205,7761,8444
72230,447711,26091,215388,16511,421620,16206,7762,8444
72235,447742,26093,215402,16512,421649,16207,7762,8445
72240,447773,26095,215417,16514,421678,16208,7762,8446
72245,447804,26096,215432,16515,421708,16208,7762,8446
72250,447835,26096,215448,16515,421739,16208,7762,8446
72255,447866,26096,215466,16515,421770,16208,7762,8446
72260,447897,26096,215482,16515,421801,16208,7762,8446
72265,447928,26096,215495,16515,421832,16208,7762,8446
72270,447959,26096,215511,16515,421863,16208,7762,8446
72275,447990,26096,215522,16515,421894,16208,7762,8446
72280,448021,26096,215535,16515,421925,16208,7762,8446
72285,448052,26096,215547,16515,421956,16208,7762,8446
72290,448083,26096,215561,16515,421987,16208,7762,8446
72295,448114,26098,215575,16516,422016,16209,7762,8447
72300,448145,26099,215586,16516,422046,16210,7762,8448
72305,448176,26102,215605,16519,422074,16210,7762,8448
72310,448207,26105,215620,16520,422102,16210,7762,8448
72315,448238,26108,215633,16522,422130,16210,7762,8448
72320,448269,26111,215649,16524,422158,16210,7762,8448
72325,448300,26114,215665,16525,422186,16210,7762,8448
72330,448331,26117,215683,16526,422214,16210,7762,8448
72335,448362,26120,215699,16528,422242,16210,7762,8448
72340,448393,26123,215717,16530,422270,16210,7762,8448
72345,448424,26126,215737,16533,422298,16211,7762,8449
72350,448455,26129,215755,16535,422326,16212,7762,8450
72355,448486,26132,215769,16536,422354,16213,7763,8450
72360,448517,26136,215787,16538,422381,16214,7764,8450
72365,448548,26138,215805,16539,422410,16214,7764,8450
72370,448579,26140,215820,16539,422439,16214,7764,8450
72375,448610,26143,215835,16540,422467,16214,7764,8450
72380,448641,26146,215845,16542,422495,16214,7764,8450
72385,448672,26148,215859,16544,422524,16214,7764,8450
72390,448703,26150,215877,16545,422553,16214,7764,8450
72395,448734,26151,215887,16546,422583,16214,7764,8450
72400,448765,26152,215899,16546,422613,16214,7764,8450
72405,448796,26154,215913,16547,422642,16214,7764,8450
72410,448827,26156,215927,16549,422671,16214,7764,8450
72415,448858,26157,215941,16550,422701,16214,7764,8450
72420,448889,26159,215957,16551,422730,16214,7764,8450
72425,448920,26161,215972,16553,422759,16214,7764,8450
72430,448951,26162,215986,16553,422789,16214,7764,8450
72435,448982,26164,216002,16555,422818,16214,7764,8450
72440,449013,26165,216019,16555,422848,16214,7764,8450
72445,449044,26167,216037,16557,422877,16214,7764,8450
72450,449075,26168,216055,16557,422907,16214,7764,8450
72455,449106,26168,216069,16557,422938,16214,7764,8450
72460,449137,26168,216082,16557,422969,16214,7764,8450
72465,449168,26168,216097,16557,423000,16215,7764,8451
72470,449199,26168,216110,16557,423031,16216,7764,8452
72475,449230,26168,216129,16557,423062,16217,7764,8453
72480,449261,26168,216146,16557,423093,16218,7765,8453
72485,449292,26168,216160,16557,423124,16218,7765,8453
72490,449323,26168,216180,16557,423155,16218,7765,8453
72495,449354,26168,216197,16557,423186,16218,7765,8453
72500,449385,26168,216212,16557,423217,16218,7765,8453
72505,449416,26168,216230,16557,423248,16218,7765,8453
72510,449447,26168,216244,16557,423279,16218,7765,8453
72515,449478,26168,216260,16557,423310,16218,7765,8453
72520,449509,26168,216275,16557,423341,16218,7765,8453
72525,449540,26169,216286,16558,423371,16218,7765,8453
72530,449571,26170,216298,16559,423401,16218,7765,8453
72535,449602,26173,216312,16560,423429,16218,7765,8453
72540,449633,26176,216326,16563,423457,16218,7765,8453
72545,449664,26180,216348,16566,423484,16219,7766,8453
72550,449695,26184,216362,16568,423511,16220,7766,8454
72555,449726,26189,216377,16570,423537,16220,7766,8454
72560,449757,26194,216394,16572,423562,16220,7766,8454
72565,449788,26200,216412,16578,423588,16220,7766,8454
72570,449819,26204,216428,16581,423615,16220,7766,8454
72575,449850,26208,216437,16583,423641,16220,7766,8454
72580,449881,26214,216453,16587,423667,16220,7766,8454
72585,449912,26218,216467,16589,423693,16220,7766,8454
72590,449943,26222,216480,16591,423721,16220,7766,8454
72595,449974,26225,216500,16593,423749,16220,7766,8454
72600,450005,26227,216518,16594,423778,16220,7766,8454
72605,450036,26228,216531,16594,423808,16221,7767,8454
72610,450067,26229,216544,16594,423838,16221,7767,8454
72615,450098,26230,216558,16595,423868,16221,7767,8454
72620,450129,26231,216574,16596,423898,16221,7767,8454
72625,450160,26232,216585,16596,423928,16221,7767,8454
72630,450191,26233,216604,16596,423958,16221,7767,8454
72635,450222,26234,216617,16597,423988,16221,7767,8454
72640,450253,26235,216627,16597,424018,16221,7767,8454
72645,450284,26236,216645,16597,424048,16221,7767,8454
72650,450315,26238,216661,16598,424077,16221,7767,8454
72655,450346,26240,216677,16599,424106,16221,7767,8454
72660,450377,26241,216688,16599,424136,16221,7767,8454
72665,450408,26243,216705,16600,424165,16221,7767,8454
72670,450439,26245,216718,16600,424194,16221,7767,8454
72675,450470,26247,216734,16601,424223,16221,7767,8454
72680,450501,26249,216750,16601,424252,16221,7767,8454
72685,450532,26251,216766,16603,424281,16221,7767,8454
72690,450563,26253,216775,16603,424310,16221,7767,8454
72695,450594,26255,216795,16605,424339,16221,7767,8454
72700,450625,26257,216812,16606,424368,16221,7767,8454
72705,450656,26259,216833,16607,424397,16221,7767,8454
72710,450687,26263,216848,16611,424424,16222,7767,8455
72715,450718,26268,216866,16615,424450,16223,7768,8455
72720,450749,26272,216883,16619,424477,16224,7768,8456
72725,450780,26273,216894,16619,424507,16224,7768,8456
72730,450811,26275,216910,16620,424536,16224,7768,8456
72735,450842,26276,216924,16621,424566,16224,7768,8456
72740,450873,26277,216944,16622,424596,16224,7768,8456
72745,450904,26278,216952,16622,424626,16224,7768,8456
72750,450935,26280,216966,16623,424655,16224,7768,8456
72755,450966,26281,216977,16623,424685,16224,7768,8456
72760,450997,26282,216993,16623,424715,16224,7768,8456
72765,451028,26283,217004,16624,424745,16224,7768,8456
72770,451059,26284,217016,16625,424775,16224,7768,8456
72775,451090,26285,217032,16626,424804,16224,7768,8456
72780,451121,26286,217043,16627,424835,16224,7768,8456
72785,451152,26286,217058,16627,424866,16224,7768,8456
72790,451183,26286,217073,16627,424897,16224,7768,8456
72795,451214,26286,217087,16627,424928,16224,7768,8456
72800,451245,26286,217105,16627,424959,16224,7768,8456
72805,451276,26286,217121,16627,424990,16224,7768,8456
72810,451307,26286,217138,16627,425021,16224,7768,8456
72815,451338,26286,217150,16627,425052,16224,7768,8456
72820,451369,26286,217163,16627,425083,16224,7768,8456
72825,451400,26286,217179,16627,425114,16225,7769,8456
72830,451431,26287,217200,16627,425144,16226,7770,8456
72835,451462,26289,217215,16628,425173,16227,7770,8457
72840,451493,26291,217227,16629,425202,16228,7770,8458
72845,451524,26294,217246,16632,425230,16228,7770,8458
72850,451555,26296,217256,16633,425259,16228,7770,8458
72855,451586,26298,217268,16633,425288,16228,7770,8458
72860,451617,26300,217283,16635,425317,16228,7770,8458
72865,451648,26303,217293,16636,425345,16228,7770,8458
72870,451679,26305,217309,16637,425374,16228,7770,8458
72875,451710,26308,217330,16638,425402,16228,7770,8458
72880,451741,26310,217342,16639,425431,16228,7770,8458
72885,451772,26313,217357,16642,425459,16228,7770,8458
72890,451803,26317,217367,16645,425486,16228,7770,8458
72895,451834,26320,217380,16646,425514,16228,7770,8458
72900,451865,26323,217390,16646,425541,16229,7771,8458
72905,451896,26327,217401,16648,425568,16229,7771,8458
72910,451927,26331,217416,16652,425596,16229,7771,8458
72915,451958,26335,217432,16655,425623,16229,7771,8458
72920,451989,26339,217446,16657,425650,16229,7771,8458
72925,452020,26342,217460,16657,425677,16229,7771,8458
72930,452051,26347,217477,16660,425703,16229,7771,8458
72935,452082,26352,217491,16663,425729,16229,7771,8458
72940,452113,26357,217503,16666,425756,16229,7771,8458
72945,452144,26360,217522,16667,425784,16231,7773,8458
72950,452175,26363,217534,16668,425812,16233,7773,8460
72955,452206,26367,217547,16671,425839,16235,7775,8460
72960,452237,26370,217563,16672,425867,16237,7775,8462
72965,452268,26371,217586,16673,425897,16238,7776,8462
72970,452299,26372,217601,16673,425927,16238,7776,8462
72975,452330,26373,217617,16673,425957,16238,7776,8462
72980,452361,26374,217634,16673,425987,16238,7776,8462
72985,452392,26375,217647,16674,426017,16238,7776,8462
72990,452423,26376,217659,16674,426047,16238,7776,8462
72995,452454,26377,217671,16675,426077,16238,7776,8462
73000,452485,26378,217679,16675,426107,16238,7776,8462
73005,452516,26379,217692,16675,426137,16238,7776,8462
73010,452547,26380,217709,16675,426167,16238,7776,8462
73015,452578,26381,217720,16676,426197,16238,7776,8462
73020,452609,26383,217735,16677,426226,16238,7776,8462
73025,452640,26383,217750,16677,426257,16238,7776,8462
73030,452671,26383,217763,16677,426288,16238,7776,8462
73035,452702,26383,217775,16677,426319,16238,7776,8462
73040,452733,26383,217789,16677,426350,16238,7776,8462
73045,452764,26383,217799,16677,426381,16238,7776,8462
73050,452795,26383,217817,16677,426412,16238,7776,8462
73055,452826,26383,217833,16677,426443,16238,7776,8462
73060,452857,26383,217847,16677,426474,16238,7776,8462
73065,452888,26384,217861,16677,426504,16238,7776,8462
73070,452919,26385,217875,16678,426534,16239,7777,8462
73075,452950,26388,217889,16680,426562,16239,7777,8462
73080,452981,26390,217902,16682,426590,16239,7777,8462
73085,453012,26395,217918,16686,426616,16239,7777,8462
73090,453043,26399,217933,16689,426643,16239,7777,8462
73095,453074,26403,217946,16693,426671,16239,7777,8462
73100,453105,26406,217965,16695,426698,16239,7777,8462
73105,453136,26410,217981,16697,426726,16239,7777,8462
73110,453167,26413,217994,16699,426753,16239,7777,8462
73115,453198,26417,218010,16701,426780,16239,7777,8462
73120,453229,26421,218028,16705,426807,16239,7777,8462
73125,453260,26426,218045,16710,426833,16239,7777,8462
73130,453291,26429,218056,16712,426861,16239,7777,8462
73135,453322,26432,218068,16715,426889,16239,7777,8462
73140,453353,26435,218084,16717,426918,16239,7777,8462
73145,453384,26438,218097,16719,426946,16240,7778,8462
73150,453415,26441,218113,16722,426974,16241,7778,8463
73155,453446,26443,218123,16723,427003,16242,7778,8464
73160,453477,26446,218139,16725,427031,16243,7779,8464
73165,453508,26448,218155,16725,427060,16244,7780,8464
73170,453539,26451,218173,16727,427088,16245,7781,8464
73175,453570,26452,218184,16728,427118,16245,7781,8464
73180,453601,26453,218199,16728,427148,16245,7781,8464
73185,453632,26454,218218,16729,427178,16246,7782,8464
73190,453663,26455,218231,16729,427208,16247,7782,8465
73195,453694,26456,218249,16730,427238,16248,7783,8465
73200,453725,26457,218267,16731,427268,16249,7784,8465
73205,453756,26462,218282,16736,427294,16249,7784,8465
73210,453787,26464,218297,16737,427323,16249,7784,8465
73215,453818,26466,218309,16738,427352,16249,7784,8465
73220,453849,26468,218324,16738,427381,16249,7784,8465
73225,453880,26470,218341,16740,427410,16249,7784,8465
73230,453911,26472,218352,16742,427439,16249,7784,8465
73235,453942,26474,218368,16743,427468,16249,7784,8465
73240,453973,26476,218380,16743,427497,16249,7784,8465
73245,454004,26478,218393,16744,427526,16249,7784,8465
73250,454035,26481,218408,16746,427554,16249,7784,8465
73255,454066,26482,218418,16747,427584,16249,7784,8465
73260,454097,26483,218436,16748,427614,16249,7784,8465
73265,454128,26488,218450,16751,427639,16249,7784,8465
73270,454159,26492,218463,16755,427667,16249,7784,8465
73275,454190,26495,218480,16757,427695,16250,7784,8466
73280,454221,26497,218496,16758,427724,16251,7784,8467
73285,454252,26498,218513,16758,427754,16251,7784,8467
73290,454283,26499,218533,16759,427784,16251,7784,8467
73295,454314,26500,218548,16759,427814,16251,7784,8467
73300,454345,26501,218567,16759,427844,16251,7784,8467
73305,454376,26502,218578,16760,427874,16252,7784,8468
73310,454407,26504,218593,16762,427903,16253,7784,8469
73315,454438,26505,218605,16762,427933,16254,7784,8470
73320,454469,26507,218621,16764,427962,16254,7784,8470
73325,454500,26508,218634,16765,427992,16254,7784,8470
73330,454531,26509,218646,16766,428022,16254,7784,8470
73335,454562,26510,218661,16767,428052,16254,7784,8470
73340,454593,26511,218678,16768,428082,16254,7784,8470
73345,454624,26512,218695,16769,428112,16254,7784,8470
73350,454655,26513,218712,16769,428142,16254,7784,8470
73355,454686,26514,218723,16769,428172,16254,7784,8470
73360,454717,26515,218736,16769,428202,16254,7784,8470
73365,454748,26516,218754,16769,428232,16254,7784,8470
73370,454779,26517,218769,16769,428262,16254,7784,8470
73375,454810,26518,218788,16770,428292,16254,7784,8470
73380,454841,26520,218802,16772,428321,16254,7784,8470
73385,454872,26521,218819,16773,428351,16255,7784,8471
73390,454903,26524,218831,16775,428379,16256,7785,8471
73395,454934,26527,218844,16777,428406,16257,7785,8472
73400,454965,26530,218857,16779,428435,16257,7785,8472
73405,454996,26531,218870,16779,428465,16257,7785,8472
73410,455027,26533,218885,16780,428494,16257,7785,8472
73415,455058,26535,218901,16781,428523,16257,7785,8472
73420,455089,26536,218917,16782,428553,16257,7785,8472
73425,455120,26538,218933,16784,428582,16258,7786,8472
73430,455151,26540,218941,16785,428611,16259,7786,8473
73435,455182,26541,218954,16785,428641,16260,7786,8474
73440,455213,26542,218970,16785,428671,16261,7786,8475
73445,455244,26543,218988,16785,428701,16262,7787,8475
73450,455275,26545,219003,16787,428730,16262,7787,8475
73455,455306,26546,219017,16787,428760,16262,7787,8475
73460,455337,26548,219032,16788,428789,16262,7787,8475
73465,455368,26549,219044,16788,428819,16262,7787,8475
73470,455399,26551,219064,16790,428848,16262,7787,8475
73475,455430,26552,219077,16790,428878,16262,7787,8475
73480,455461,26553,219095,16790,428908,16262,7787,8475
73485,455492,26554,219111,16790,428938,16262,7787,8475
73490,455523,26556,219128,16792,428967,16262,7787,8475
73495,455554,26559,219148,16795,428995,16262,7787,8475
73500,455585,26563,219162,16798,429022,16263,7787,8476
73505,455616,26567,219173,16800,429049,16264,7787,8477
73510,455647,26570,219187,16802,429076,16265,7787,8478
73515,455678,26573,219204,16804,429104,16266,7788,8478
73520,455709,26576,219219,16806,429132,16267,7789,8478
73525,455740,26579,219237,16807,429161,16267,7789,8478
73530,455771,26581,219250,16808,429190,16267,7789,8478
73535,455802,26583,219263,16809,429219,16267,7789,8478
73540,455833,26585,219279,16810,429248,16267,7789,8478
73545,455864,26587,219293,16811,429277,16267,7789,8478
73550,455895,26589,219308,16812,429306,16268,7789,8479
73555,455926,26591,219318,16813,429335,16269,7789,8480
73560,455957,26593,219332,16814,429364,16270,7789,8481
73565,455988,26596,219347,16816,429392,16271,7790,8481
73570,456019,26598,219364,16816,429421,16271,7790,8481
73575,456050,26601,219381,16818,429449,16271,7790,8481
73580,456081,26603,219396,16819,429478,16271,7790,8481
73585,456112,26606,219412,16820,429506,16271,7790,8481
73590,456143,26608,219425,16821,429535,16271,7790,8481
73595,456174,26610,219437,16822,429564,16271,7790,8481
73600,456205,26612,219452,16824,429593,16271,7790,8481
73605,456236,26614,219469,16826,429622,16271,7790,8481
73610,456267,26617,219487,16828,429650,16271,7790,8481
73615,456298,26621,219501,16830,429677,16271,7790,8481
73620,456329,26624,219514,16831,429705,16271,7790,8481
73625,456360,26626,219531,16833,429734,16273,7790,8483
73630,456391,26627,219544,16833,429764,16274,7791,8483
73635,456422,26628,219562,16834,429794,16275,7792,8483
73640,456453,26629,219578,16834,429823,16275,7792,8483
73645,456484,26631,219591,16836,429853,16275,7792,8483
73650,456515,26632,219603,16836,429883,16275,7792,8483
73655,456546,26633,219616,16837,429913,16275,7792,8483
73660,456577,26634,219632,16838,429942,16275,7792,8483
73665,456608,26636,219643,16840,429972,16275,7792,8483
73670,456639,26637,219657,16840,430002,16275,7792,8483
73675,456670,26638,219670,16841,430032,16275,7792,8483
73680,456701,26639,219683,16841,430062,16275,7792,8483
73685,456732,26640,219696,16842,430092,16275,7792,8483
73690,456763,26641,219712,16843,430122,16275,7792,8483
73695,456794,26642,219727,16843,430152,16275,7792,8483
73700,456825,26643,219741,16844,430182,16275,7792,8483
73705,456856,26644,219758,16844,430212,16275,7792,8483
73710,456887,26645,219774,16845,430242,16275,7792,8483
73715,456918,26646,219794,16846,430272,16275,7792,8483
73720,456949,26647,219813,16847,430302,16275,7792,8483
73725,456980,26648,219827,16847,430332,16275,7792,8483
73730,457011,26650,219841,16849,430361,16276,7792,8484
73735,457042,26655,219856,16852,430387,16277,7793,8484
73740,457073,26657,219869,16853,430416,16279,7794,8485
73745,457104,26660,219883,16856,430444,16279,7794,8485
73750,457135,26663,219897,16858,430472,16279,7794,8485
73755,457166,26665,219909,16858,430501,16279,7794,8485
73760,457197,26668,219924,16860,430529,16279,7794,8485
73765,457228,26670,219942,16861,430558,16279,7794,8485
73770,457259,26672,219957,16863,430587,16279,7794,8485
73775,457290,26674,219975,16863,430616,16279,7794,8485
73780,457321,26676,219991,16863,430645,16279,7794,8485
73785,457352,26678,220005,16864,430674,16279,7794,8485
73790,457383,26680,220019,16865,430703,16279,7794,8485
73795,457414,26682,220033,16866,430732,16279,7794,8485
73800,457445,26684,220046,16866,430761,16279,7794,8485
73805,457476,26687,220065,16868,430789,16279,7794,8485
73810,457507,26690,220077,16870,430817,16279,7794,8485
73815,457538,26692,220092,16870,430846,16279,7794,8485
73820,457569,26694,220105,16872,430875,16279,7794,8485
73825,457600,26697,220123,16875,430903,16279,7794,8485
73830,457631,26699,220138,16876,430932,16279,7794,8485
73835,457662,26702,220154,16877,430960,16279,7794,8485
73840,457693,26705,220167,16879,430988,16279,7794,8485
73845,457724,26708,220182,16882,431016,16280,7795,8485
73850,457755,26710,220200,16883,431045,16282,7796,8486
73855,457786,26712,220217,16884,431074,16284,7797,8487
73860,457817,26714,220227,16884,431103,16285,7797,8488
73865,457848,26716,220244,16885,431131,16286,7797,8489
73870,457879,26718,220255,16886,431161,16287,7797,8490
73875,457910,26719,220270,16886,431191,16288,7798,8490
73880,457941,26720,220283,16887,431221,16289,7798,8491
73885,457972,26722,220302,16889,431250,16290,7799,8491
73890,458003,26724,220316,16890,431279,16291,7799,8492
73895,458034,26726,220331,16891,431308,16292,7800,8492
73900,458065,26727,220346,16892,431338,16293,7801,8492
73905,458096,26729,220361,16893,431367,16294,7802,8492
73910,458127,26731,220374,16895,431396,16295,7802,8493
73915,458158,26732,220386,16895,431426,16295,7802,8493
73920,458189,26733,220401,16896,431456,16295,7802,8493
73925,458220,26734,220419,16896,431486,16295,7802,8493
73930,458251,26735,220434,16897,431516,16295,7802,8493
73935,458282,26736,220453,16897,431546,16295,7802,8493
73940,458313,26737,220469,16897,431576,16295,7802,8493
73945,458344,26738,220489,16898,431606,16295,7802,8493
73950,458375,26739,220503,16899,431636,16295,7802,8493
73955,458406,26740,220520,16900,431666,16295,7802,8493
73960,458437,26741,220533,16901,431696,16296,7802,8494
73965,458468,26743,220548,16903,431725,16297,7802,8495
73970,458499,26745,220566,16903,431753,16299,7803,8496
73975,458530,26749,220581,16907,431781,16300,7804,8496
73980,458561,26751,220600,16908,431809,16300,7804,8496
73985,458592,26755,220616,16911,431837,16300,7804,8496
73990,458623,26758,220629,16914,431865,16300,7804,8496
73995,458654,26760,220639,16914,431894,16300,7804,8496
74000,458685,26762,220653,16915,431923,16300,7804,8496
74005,458716,26764,220664,16915,431952,16300,7804,8496
74010,458747,26766,220679,16917,431981,16300,7804,8496
74015,458778,26768,220696,16918,432010,16300,7804,8496
74020,458809,26771,220708,16919,432038,16300,7804,8496
74025,458840,26773,220723,16920,432067,16300,7804,8496
74030,458871,26776,220738,16921,432095,16300,7804,8496
74035,458902,26779,220756,16924,432123,16300,7804,8496
74040,458933,26782,220773,16927,432151,16300,7804,8496
74045,458964,26785,220792,16929,432179,16300,7804,8496
74050,458995,26787,220808,16930,432207,16300,7804,8496
74055,459026,26790,220818,16932,432236,16300,7804,8496
74060,459057,26792,220833,16934,432265,16300,7804,8496
74065,459088,26794,220854,16935,432294,16300,7804,8496
74070,459119,26796,220867,16936,432323,16300,7804,8496
74075,459150,26798,220880,16938,432352,16301,7804,8497
74080,459181,26800,220892,16939,432381,16303,7804,8499
74085,459212,26802,220908,16941,432410,16305,7806,8499
74090,459243,26805,220923,16942,432438,16307,7807,8500
74095,459274,26809,220935,16944,432465,16309,7807,8502
74100,459305,26813,220948,16946,432492,16311,7809,8502
74105,459336,26814,220968,16947,432522,16312,7809,8503
74110,459367,26815,220982,16947,432552,16313,7810,8503
74115,459398,26816,220999,16948,432582,16314,7810,8504
74120,459429,26818,221015,16950,432611,16314,7810,8504
74125,459460,26820,221030,16951,432640,16314,7810,8504
74130,459491,26822,221050,16952,432669,16314,7810,8504
74135,459522,26823,221061,16953,432699,16314,7810,8504
74140,459553,26825,221076,16955,432728,16314,7810,8504
74145,459584,26827,221088,16956,432757,16314,7810,8504
74150,459615,26829,221104,16958,432786,16314,7810,8504
74155,459646,26831,221114,16959,432815,16314,7810,8504
74160,459677,26833,221127,16961,432844,16314,7810,8504
74165,459708,26835,221139,16963,432872,16314,7810,8504
74170,459739,26838,221155,16964,432901,16314,7810,8504
74175,459770,26841,221170,16966,432929,16314,7810,8504
74180,459801,26843,221187,16967,432958,16314,7810,8504
74185,459832,26844,221202,16968,432988,16314,7810,8504
74190,459863,26845,221216,16968,433018,16314,7810,8504
74195,459894,26846,221228,16969,433048,16314,7810,8504
74200,459925,26847,221245,16969,433078,16314,7810,8504
74205,459956,26848,221261,16970,433108,16315,7811,8504
74210,459987,26849,221282,16971,433138,16316,7812,8504
74215,460018,26851,221298,16973,433167,16317,7813,8504
74220,460049,26852,221315,16974,433197,16319,7814,8505
74225,460080,26855,221331,16977,433225,16320,7814,8506
74230,460111,26857,221346,16978,433254,16321,7815,8506
74235,460142,26859,221363,16980,433283,16322,7815,8507
74240,460173,26861,221384,16982,433312,16323,7816,8507
74245,460204,26864,221395,16983,433340,16324,7816,8508
74250,460235,26866,221407,16985,433369,16325,7817,8508
74255,460266,26868,221423,16987,433398,16326,7818,8508
74260,460297,26870,221443,16988,433427,16327,7819,8508
74265,460328,26871,221456,16989,433457,16328,7820,8508
74270,460359,26872,221468,16989,433487,16329,7820,8509
74275,460390,26873,221484,16989,433517,16330,7821,8509
74280,460421,26874,221498,16990,433547,16331,7822,8509
74285,460452,26876,221512,16991,433576,16331,7822,8509
74290,460483,26876,221522,16991,433607,16331,7822,8509
74295,460514,26876,221539,16991,433638,16331,7822,8509
74300,460545,26876,221552,16991,433669,16331,7822,8509
74305,460576,26876,221569,16991,433700,16331,7822,8509
74310,460607,26876,221583,16991,433731,16331,7822,8509
74315,460638,26876,221596,16991,433762,16331,7822,8509
74320,460669,26876,221607,16991,433793,16331,7822,8509
74325,460700,26876,221618,16991,433824,16331,7822,8509
74330,460731,26878,221628,16992,433853,16331,7822,8509
74335,460762,26879,221641,16992,433883,16331,7822,8509
74340,460793,26881,221660,16993,433912,16331,7822,8509
74345,460824,26884,221673,16994,433940,16331,7822,8509
74350,460855,26888,221687,16997,433966,16331,7822,8509
74355,460886,26892,221696,16998,433994,16331,7822,8509
74360,460917,26896,221711,16999,434020,16331,7822,8509
74365,460948,26900,221723,17001,434048,16331,7822,8509
74370,460979,26903,221737,17002,434075,16331,7822,8509
74375,461010,26907,221755,17004,434103,16331,7822,8509
74380,461041,26910,221768,17006,434131,16331,7822,8509
74385,461072,26913,221782,17007,434158,16331,7822,8509
74390,461103,26918,221801,17012,434184,16331,7822,8509
74395,461134,26923,221821,17017,434210,16331,7822,8509
74400,461165,26927,221833,17020,434238,16331,7822,8509
74405,461196,26929,221846,17021,434267,16331,7822,8509
74410,461227,26930,221860,17022,434297,16331,7822,8509
74415,461258,26931,221872,17023,434327,16331,7822,8509
74420,461289,26932,221887,17023,434357,16331,7822,8509
74425,461320,26933,221903,17023,434387,16331,7822,8509
74430,461351,26934,221913,17023,434417,16331,7822,8509
74435,461382,26935,221928,17023,434447,16331,7822,8509
74440,461413,26936,221943,17023,434477,16331,7822,8509
74445,461444,26937,221951,17023,434507,16331,7822,8509
74450,461475,26940,221966,17025,434535,16331,7822,8509
74455,461506,26942,221976,17026,434564,16331,7822,8509
74460,461537,26944,221990,17027,434593,16331,7822,8509
74465,461568,26946,222001,17027,434622,16331,7822,8509
74470,461599,26948,222013,17029,434651,16331,7822,8509
74475,461630,26951,222028,17032,434679,16331,7822,8509
74480,461661,26953,222039,17032,434708,16331,7822,8509
74485,461692,26955,222057,17033,434737,16331,7822,8509
74490,461723,26958,222070,17034,434765,16331,7822,8509
74495,461754,26961,222084,17036,434793,16331,7822,8509
74500,461785,26963,222099,17037,434822,16331,7822,8509
74505,461816,26965,222116,17039,434851,16331,7822,8509
74510,461847,26967,222136,17039,434880,16331,7822,8509
74515,461878,26969,222147,17040,434909,16331,7822,8509
74520,461909,26971,222164,17041,434938,16331,7822,8509
74525,461940,26974,222177,17043,434966,16332,7822,8510
74530,461971,26976,222187,17043,434995,16333,7822,8511
74535,462002,26979,222202,17046,435023,16334,7823,8511
74540,462033,26981,222213,17046,435052,16335,7824,8511
74545,462064,26984,222227,17049,435080,16335,7824,8511
74550,462095,26986,222241,17049,435109,16335,7824,8511
74555,462126,26987,222256,17050,435139,16335,7824,8511
74560,462157,26988,222270,17050,435169,16335,7824,8511
74565,462188,26989,222284,17050,435199,16335,7824,8511
74570,462219,26991,222297,17052,435228,16335,7824,8511
74575,462250,26992,222314,17053,435258,16335,7824,8511
74580,462281,26993,222326,17054,435288,16335,7824,8511
74585,462312,26996,222339,17055,435316,16336,7824,8512
74590,462343,26999,222355,17057,435344,16336,7824,8512
74595,462374,27000,222372,17057,435373,16336,7824,8512
74600,462405,27002,222391,17058,435402,16336,7824,8512
74605,462436,27004,222404,17059,435432,16336,7824,8512
74610,462467,27005,222419,17060,435462,16336,7824,8512
74615,462498,27006,222434,17061,435492,16336,7824,8512
74620,462529,27007,222448,17061,435522,16336,7824,8512
74625,462560,27008,222462,17061,435552,16336,7824,8512
74630,462591,27009,222479,17061,435582,16336,7824,8512
74635,462622,27010,222494,17062,435612,16336,7824,8512
74640,462653,27011,222510,17062,435642,16336,7824,8512
74645,462684,27013,222524,17063,435671,16336,7824,8512
74650,462715,27015,222538,17064,435700,16336,7824,8512
74655,462746,27017,222556,17066,435729,16336,7824,8512
74660,462777,27019,222570,17066,435758,16336,7824,8512
74665,462808,27021,222584,17068,435787,16336,7824,8512
74670,462839,27023,222598,17069,435816,16336,7824,8512
74675,462870,27025,222614,17069,435845,16336,7824,8512
74680,462901,27027,222626,17070,435874,16336,7824,8512
74685,462932,27029,222637,17071,435903,16336,7824,8512
74690,462963,27032,222650,17073,435931,16337,7824,8513
74695,462994,27033,222663,17074,435961,16338,7824,8514
74700,463025,27037,222679,17078,435988,16339,7825,8514
74705,463056,27039,222694,17080,436017,16340,7825,8515
74710,463087,27040,222705,17080,436047,16340,7825,8515
74715,463118,27041,222721,17081,436077,16340,7825,8515
74720,463149,27042,222735,17082,436106,16340,7825,8515
74725,463180,27044,222752,17084,436136,16340,7825,8515
74730,463211,27045,222766,17084,436165,16340,7825,8515
74735,463242,27047,222779,17086,436195,16340,7825,8515
74740,463273,27048,222797,17086,436224,16340,7825,8515
74745,463304,27049,222812,17087,436255,16340,7825,8515
74750,463335,27049,222827,17087,436286,16340,7825,8515
74755,463366,27049,222844,17087,436317,16340,7825,8515
74760,463397,27049,222858,17087,436348,16340,7825,8515
74765,463428,27049,222873,17087,436379,16340,7825,8515
74770,463459,27049,222887,17087,436410,16340,7825,8515
74775,463490,27049,222904,17087,436441,16340,7825,8515
74780,463521,27049,222918,17087,436472,16340,7825,8515
74785,463552,27049,222930,17087,436503,16340,7825,8515
74790,463583,27049,222944,17087,436534,16340,7825,8515
74795,463614,27049,222960,17087,436565,16340,7825,8515
74800,463645,27049,222972,17087,436596,16340,7825,8515
74805,463676,27050,222984,17087,436626,16340,7825,8515
74810,463707,27052,222997,17089,436655,16340,7825,8515
74815,463738,27055,223013,17091,436683,16341,7826,8515
74820,463769,27057,223024,17092,436712,16342,7826,8516
74825,463800,27061,223043,17096,436739,16343,7827,8516
74830,463831,27065,223057,17098,436765,16344,7828,8516
74835,463862,27069,223073,17100,436792,16345,7829,8516
74840,463893,27074,223089,17104,436818,16346,7829,8517
74845,463924,27080,223106,17109,436844,16346,7829,8517
74850,463955,27084,223120,17110,436871,16346,7829,8517
74855,463986,27088,223133,17112,436898,16346,7829,8517
74860,464017,27093,223152,17116,436924,16346,7829,8517
74865,464048,27096,223166,17118,436952,16346,7829,8517
74870,464079,27098,223180,17119,436981,16346,7829,8517
74875,464110,27100,223191,17120,437010,16346,7829,8517
74880,464141,27102,223204,17121,437039,16346,7829,8517
74885,464172,27103,223223,17121,437069,16346,7829,8517
74890,464203,27104,223234,17121,437099,16346,7829,8517
74895,464234,27105,223248,17121,437129,16346,7829,8517
74900,464265,27106,223264,17122,437159,16346,7829,8517
74905,464296,27107,223279,17122,437189,16346,7829,8517
74910,464327,27108,223293,17123,437219,16346,7829,8517
74915,464358,27109,223305,17124,437249,16346,7829,8517
74920,464389,27110,223320,17124,437279,16346,7829,8517
74925,464420,27112,223333,17125,437308,16346,7829,8517
74930,464451,27114,223347,17127,437337,16346,7829,8517
74935,464482,27117,223365,17129,437365,16346,7829,8517
74940,464513,27119,223385,17131,437394,16346,7829,8517
74945,464544,27122,223399,17133,437422,16346,7829,8517
74950,464575,27124,223411,17135,437451,16347,7830,8517
74955,464606,27127,223422,17137,437479,16348,7830,8518
74960,464637,27129,223435,17138,437508,16349,7831,8518
74965,464668,27132,223450,17139,437536,16350,7832,8518
74970,464699,27134,223459,17141,437565,16351,7833,8518
74975,464730,27136,223473,17142,437594,16352,7834,8518
74980,464761,27138,223484,17142,437623,16353,7834,8519
74985,464792,27142,223502,17144,437650,16354,7835,8519
74990,464823,27146,223515,17147,437676,16355,7836,8519
74995,464854,27149,223532,17149,437704,16355,7836,8519
75000,464885,27151,223549,17151,437734,16355,7836,8519
75005,464916,27153,223567,17151,437763,16355,7836,8519
75010,464947,27155,223583,17153,437792,16355,7836,8519
75015,464978,27157,223597,17153,437821,16355,7836,8519
75020,465009,27159,223618,17153,437850,16355,7836,8519
75025,465040,27161,223628,17154,437879,16355,7836,8519
75030,465071,27163,223640,17155,437908,16355,7836,8519
75035,465102,27165,223655,17157,437937,16355,7836,8519
75040,465133,27167,223668,17157,437966,16355,7836,8519
75045,465164,27169,223679,17158,437995,16355,7836,8519
75050,465195,27172,223693,17160,438023,16355,7836,8519
75055,465226,27176,223709,17163,438050,16355,7836,8519
75060,465257,27179,223723,17165,438078,16355,7836,8519
75065,465288,27179,223741,17165,438109,16355,7836,8519
75070,465319,27179,223759,17165,438140,16355,7836,8519
75075,465350,27179,223770,17165,438171,16355,7836,8519
75080,465381,27179,223784,17165,438202,16355,7836,8519
75085,465412,27179,223802,17165,438233,16355,7836,8519
75090,465443,27179,223813,17165,438264,16355,7836,8519
75095,465474,27179,223831,17165,438295,16355,7836,8519
75100,465505,27179,223846,17165,438326,16355,7836,8519
75105,465536,27180,223863,17165,438356,16355,7836,8519
75110,465567,27181,223874,17165,438386,16356,7836,8520
75115,465598,27182,223889,17166,438416,16357,7837,8520
75120,465629,27184,223905,17167,438445,16358,7837,8521
75125,465660,27188,223921,17168,438472,16359,7838,8521
75130,465691,27193,223940,17172,438498,16360,7839,8521
75135,465722,27197,223955,17175,438525,16361,7840,8521
75140,465753,27201,223967,17178,438552,16361,7840,8521
75145,465784,27206,223983,17181,438578,16361,7840,8521
75150,465815,27208,224002,17183,438607,16361,7840,8521
75155,465846,27209,224021,17184,438637,16361,7840,8521
75160,465877,27210,224043,17185,438667,16361,7840,8521
75165,465908,27211,224057,17186,438697,16361,7840,8521
75170,465939,27212,224075,17186,438727,16361,7840,8521
75175,465970,27214,224083,17188,438756,16361,7840,8521
75180,466001,27215,224095,17189,438786,16361,7840,8521
75185,466032,27216,224114,17189,438816,16361,7840,8521
75190,466063,27216,224130,17189,438847,16361,7840,8521
75195,466094,27216,224145,17189,438878,16361,7840,8521
75200,466125,27216,224160,17189,438909,16361,7840,8521
75205,466156,27216,224174,17189,438940,16361,7840,8521
75210,466187,27216,224191,17189,438971,16361,7840,8521
75215,466218,27216,224211,17189,439002,16361,7840,8521
75220,466249,27216,224233,17189,439033,16361,7840,8521
75225,466280,27216,224246,17189,439064,16361,7840,8521
75230,466311,27216,224261,17189,439095,16361,7840,8521
75235,466342,27216,224274,17189,439126,16361,7840,8521
75240,466373,27216,224290,17189,439157,16361,7840,8521
75245,466404,27216,224307,17189,439188,16361,7840,8521
75250,466435,27216,224319,17189,439219,16361,7840,8521
75255,466466,27216,224336,17189,439250,16361,7840,8521
75260,466497,27218,224350,17191,439279,16361,7840,8521
75265,466528,27219,224366,17191,439309,16361,7840,8521
75270,466559,27221,224375,17192,439338,16361,7840,8521
75275,466590,27222,224389,17192,439368,16361,7840,8521
75280,466621,27224,224402,17193,439397,16361,7840,8521
75285,466652,27226,224417,17195,439426,16361,7840,8521
75290,466683,27229,224429,17196,439454,16361,7840,8521
75295,466714,27234,224446,17200,439480,16361,7840,8521
75300,466745,27238,224458,17202,439507,16361,7840,8521
75305,466776,27243,224473,17207,439532,16361,7840,8521
75310,466807,27247,224491,17210,439560,16361,7840,8521
75315,466838,27250,224504,17212,439588,16361,7840,8521
75320,466869,27253,224519,17215,439616,16361,7840,8521
75325,466900,27256,224531,17215,439644,16361,7840,8521
75330,466931,27260,224544,17217,439671,16361,7840,8521
75335,466962,27263,224561,17218,439699,16361,7840,8521
75340,466993,27265,224576,17220,439728,16361,7840,8521
75345,467024,27267,224596,17222,439757,16361,7840,8521
75350,467055,27269,224611,17223,439786,16361,7840,8521
75355,467086,27271,224625,17224,439815,16361,7840,8521
75360,467117,27273,224643,17225,439844,16361,7840,8521
75365,467148,27276,224655,17226,439872,16362,7841,8521
75370,467179,27281,224670,17229,439898,16363,7842,8521
75375,467210,27283,224686,17230,439927,16363,7842,8521
75380,467241,27285,224700,17231,439956,16363,7842,8521
75385,467272,27287,224716,17231,439985,16363,7842,8521
75390,467303,27289,224732,17232,440014,16363,7842,8521
75395,467334,27291,224750,17233,440043,16363,7842,8521
75400,467365,27293,224764,17234,440072,16363,7842,8521
75405,467396,27295,224774,17235,440101,16364,7843,8521
75410,467427,27298,224792,17237,440129,16365,7844,8521
75415,467458,27302,224809,17241,440156,16366,7844,8522
75420,467489,27305,224825,17244,440184,16367,7844,8523
75425,467520,27307,224841,17246,440213,16367,7844,8523
75430,467551,27309,224851,17247,440242,16367,7844,8523
75435,467582,27309,224866,17247,440273,16367,7844,8523
75440,467613,27309,224879,17247,440304,16367,7844,8523
75445,467644,27309,224900,17247,440335,16367,7844,8523
75450,467675,27309,224915,17247,440366,16367,7844,8523
75455,467706,27309,224928,17247,440397,16367,7844,8523
75460,467737,27309,224946,17247,440428,16367,7844,8523
75465,467768,27309,224962,17247,440459,16367,7844,8523
75470,467799,27309,224975,17247,440490,16367,7844,8523
75475,467830,27309,224991,17247,440521,16367,7844,8523
75480,467861,27309,225009,17247,440552,16367,7844,8523
75485,467892,27311,225022,17248,440581,16368,7844,8524
75490,467923,27312,225033,17249,440611,16369,7844,8525
75495,467954,27313,225053,17249,440641,16370,7845,8525
75500,467985,27315,225069,17251,440670,16370,7845,8525
75505,468016,27316,225077,17252,440700,16370,7845,8525
75510,468047,27318,225096,17254,440729,16370,7845,8525
75515,468078,27320,225108,17256,440758,16370,7845,8525
75520,468109,27322,225121,17257,440787,16370,7845,8525
75525,468140,27323,225133,17257,440817,16370,7845,8525
75530,468171,27325,225148,17258,440846,16370,7845,8525
75535,468202,27328,225165,17261,440874,16370,7845,8525
75540,468233,27333,225180,17264,440900,16370,7845,8525
75545,468264,27335,225197,17266,440929,16370,7845,8525
75550,468295,27337,225207,17266,440958,16370,7845,8525
75555,468326,27339,225217,17268,440987,16370,7845,8525
75560,468357,27341,225233,17270,441016,16370,7845,8525
75565,468388,27343,225247,17270,441045,16370,7845,8525
75570,468419,27345,225260,17270,441074,16370,7845,8525
75575,468450,27348,225272,17271,441102,16370,7845,8525
75580,468481,27351,225285,17273,441130,16370,7845,8525
75585,468512,27353,225301,17274,441159,16370,7845,8525
75590,468543,27356,225316,17276,441187,16370,7845,8525
75595,468574,27359,225335,17278,441215,16370,7845,8525
75600,468605,27362,225352,17280,441243,16370,7845,8525
75605,468636,27365,225369,17281,441271,16371,7845,8526
75610,468667,27367,225381,17282,441300,16372,7845,8527
75615,468698,27369,225399,17282,441329,16373,7846,8527
75620,468729,27371,225414,17282,441358,16374,7847,8527
75625,468760,27374,225431,17284,441386,16375,7847,8528
75630,468791,27377,225447,17286,441414,16375,7847,8528
75635,468822,27379,225461,17287,441443,16375,7847,8528
75640,468853,27381,225477,17287,441472,16375,7847,8528
75645,468884,27384,225492,17289,441500,16375,7847,8528
75650,468915,27387,225505,17291,441528,16375,7847,8528
75655,468946,27389,225518,17292,441557,16375,7847,8528
75660,468977,27393,225533,17295,441584,16375,7847,8528
75665,469008,27395,225547,17296,441613,16375,7847,8528
75670,469039,27397,225560,17297,441641,16375,7847,8528
75675,469070,27399,225570,17299,441671,16375,7847,8528
75680,469101,27400,225592,17300,441701,16375,7847,8528
75685,469132,27401,225604,17301,441731,16375,7847,8528
75690,469163,27402,225621,17302,441761,16375,7847,8528
75695,469194,27403,225638,17303,441790,16375,7847,8528
75700,469225,27405,225656,17305,441819,16375,7847,8528
75705,469256,27407,225670,17307,441849,16375,7847,8528
75710,469287,27408,225684,17308,441879,16375,7847,8528
75715,469318,27408,225696,17308,441910,16375,7847,8528
75720,469349,27408,225711,17308,441941,16375,7847,8528
75725,469380,27408,225728,17308,441972,16375,7847,8528
75730,469411,27408,225749,17308,442003,16375,7847,8528
75735,469442,27408,225768,17308,442034,16376,7848,8528
75740,469473,27408,225778,17308,442065,16377,7849,8528
75745,469504,27408,225790,17308,442096,16378,7850,8528
75750,469535,27408,225805,17308,442127,16379,7850,8529
75755,469566,27408,225818,17308,442158,16380,7850,8530
75760,469597,27408,225831,17308,442189,16381,7850,8531
75765,469628,27408,225841,17308,442220,16382,7850,8532
75770,469659,27409,225858,17309,442250,16383,7851,8532
75775,469690,27411,225874,17311,442279,16384,7852,8532
75780,469721,27414,225889,17313,442307,16385,7853,8532
75785,469752,27417,225898,17314,442335,16385,7853,8532
75790,469783,27421,225915,17316,442362,16385,7853,8532
75795,469814,27424,225931,17317,442390,16385,7853,8532
75800,469845,27428,225943,17319,442417,16385,7853,8532
75805,469876,27431,225952,17321,442445,16385,7853,8532
75810,469907,27434,225973,17322,442473,16385,7853,8532
75815,469938,27437,225988,17324,442501,16385,7853,8532
75820,469969,27441,226000,17326,442528,16385,7853,8532
75825,470000,27444,226012,17326,442556,16385,7853,8532
75830,470031,27448,226033,17328,442582,16385,7853,8532
75835,470062,27452,226045,17332,442609,16385,7853,8532
75840,470093,27456,226063,17334,442636,16385,7853,8532
75845,470124,27459,226080,17336,442664,16385,7853,8532
75850,470155,27462,226099,17338,442692,16385,7853,8532
75855,470186,27465,226118,17341,442720,16385,7853,8532
75860,470217,27468,226130,17342,442749,16385,7853,8532
75865,470248,27470,226143,17343,442777,16385,7853,8532
75870,470279,27473,226157,17344,442805,16385,7853,8532
75875,470310,27476,226171,17346,442834,16385,7853,8532
75880,470341,27478,226186,17346,442863,16385,7853,8532
75885,470372,27480,226202,17346,442891,16386,7854,8532
75890,470403,27484,226215,17349,442919,16387,7855,8532
75895,470434,27485,226229,17350,442949,16388,7855,8533
75900,470465,27486,226243,17350,442979,16389,7856,8533
75905,470496,27489,226258,17351,443007,16390,7857,8533
75910,470527,27491,226270,17353,443036,16390,7857,8533
75915,470558,27493,226287,17354,443065,16390,7857,8533
75920,470589,27495,226304,17356,443094,16390,7857,8533
75925,470620,27496,226322,17356,443124,16390,7857,8533
75930,470651,27497,226335,17356,443154,16390,7857,8533
75935,470682,27498,226349,17357,443184,16390,7857,8533
75940,470713,27499,226362,17358,443214,16390,7857,8533
75945,470744,27500,226378,17358,443244,16390,7857,8533
75950,470775,27501,226394,17358,443274,16390,7857,8533
75955,470806,27502,226407,17358,443304,16390,7857,8533
75960,470837,27503,226420,17359,443334,16390,7857,8533
75965,470868,27504,226432,17359,443364,16390,7857,8533
75970,470899,27505,226448,17359,443394,16390,7857,8533
75975,470930,27506,226462,17359,443424,16390,7857,8533
75980,470961,27507,226468,17359,443454,16390,7857,8533
75985,470992,27508,226486,17359,443484,16390,7857,8533
75990,471023,27509,226503,17360,443514,16390,7857,8533
75995,471054,27510,226515,17361,443544,16390,7857,8533
76000,471085,27512,226529,17362,443573,16390,7857,8533
76005,471116,27514,226548,17363,443602,16390,7857,8533
76010,471147,27516,226564,17364,443631,16390,7857,8533
76015,471178,27518,226581,17364,443660,16391,7858,8533
76020,471209,27521,226595,17367,443688,16392,7858,8534
76025,471240,27524,226612,17369,443715,16393,7858,8535
76030,471271,27527,226629,17372,443744,16393,7858,8535
76035,471302,27529,226643,17373,443773,16393,7858,8535
76040,471333,27531,226659,17375,443802,16393,7858,8535
76045,471364,27533,226674,17376,443831,16393,7858,8535
76050,471395,27535,226691,17378,443860,16393,7858,8535
76055,471426,27537,226710,17379,443889,16393,7858,8535
76060,471457,27539,226728,17380,443918,16393,7858,8535
76065,471488,27541,226742,17380,443947,16393,7858,8535
76070,471519,27543,226754,17381,443976,16393,7858,8535
76075,471550,27545,226769,17383,444005,16393,7858,8535
76080,471581,27547,226787,17384,444034,16393,7858,8535
76085,471612,27549,226797,17384,444063,16393,7858,8535
76090,471643,27551,226814,17385,444092,16393,7858,8535
76095,471674,27553,226828,17385,444121,16393,7858,8535
76100,471705,27555,226846,17387,444150,16393,7858,8535
76105,471736,27557,226861,17387,444179,16393,7858,8535
76110,471767,27559,226870,17388,444208,16393,7858,8535
76115,471798,27561,226891,17389,444237,16393,7858,8535
76120,471829,27563,226915,17391,444266,16393,7858,8535
76125,471860,27565,226928,17391,444295,16393,7858,8535
76130,471891,27567,226942,17393,444324,16393,7858,8535
76135,471922,27571,226953,17396,444351,16394,7858,8536
76140,471953,27575,226966,17399,444378,16395,7859,8536
76145,471984,27577,226978,17400,444407,16395,7859,8536
76150,472015,27578,226992,17400,444437,16395,7859,8536
76155,472046,27579,227007,17401,444467,16395,7859,8536
76160,472077,27580,227023,17402,444497,16395,7859,8536
76165,472108,27581,227039,17403,444527,16395,7859,8536
76170,472139,27582,227055,17404,444557,16395,7859,8536
76175,472170,27583,227069,17404,444587,16395,7859,8536
76180,472201,27584,227082,17404,444617,16395,7859,8536
76185,472232,27585,227094,17405,444647,16395,7859,8536
76190,472263,27586,227104,17405,444677,16395,7859,8536
76195,472294,27587,227113,17405,444707,16395,7859,8536
76200,472325,27588,227127,17405,444737,16395,7859,8536
76205,472356,27589,227143,17405,444767,16395,7859,8536
76210,472387,27590,227161,17406,444797,16395,7859,8536
76215,472418,27591,227176,17407,444827,16395,7859,8536
76220,472449,27592,227191,17408,444857,16395,7859,8536
76225,472480,27593,227207,17408,444887,16395,7859,8536
76230,472511,27594,227224,17409,444917,16395,7859,8536
76235,472542,27595,227241,17409,444947,16395,7859,8536
76240,472573,27596,227255,17409,444977,16395,7859,8536
76245,472604,27597,227269,17409,445007,16395,7859,8536
76250,472635,27598,227286,17410,445037,16395,7859,8536
76255,472666,27600,227300,17411,445066,16396,7860,8536
76260,472697,27603,227318,17413,445094,16397,7861,8536
76265,472728,27607,227338,17416,445121,16398,7862,8536
76270,472759,27611,227351,17419,445148,16399,7863,8536
76275,472790,27615,227362,17421,445175,16400,7863,8537
76280,472821,27619,227384,17424,445202,16400,7863,8537
76285,472852,27623,227399,17426,445229,16400,7863,8537
76290,472883,27627,227414,17427,445256,16400,7863,8537
76295,472914,27630,227437,17429,445284,16400,7863,8537
76300,472945,27631,227452,17429,445314,16400,7863,8537
76305,472976,27632,227467,17429,445344,16400,7863,8537
76310,473007,27633,227486,17430,445374,16400,7863,8537
76315,473038,27634,227499,17431,445404,16400,7863,8537
76320,473069,27635,227510,17432,445434,16400,7863,8537
76325,473100,27637,227521,17433,445463,16400,7863,8537
76330,473131,27639,227534,17433,445492,16400,7863,8537
76335,473162,27641,227547,17434,445521,16400,7863,8537
76340,473193,27643,227562,17435,445550,16400,7863,8537
76345,473224,27645,227577,17436,445579,16400,7863,8537
76350,473255,27647,227588,17436,445608,16400,7863,8537
76355,473286,27649,227603,17437,445637,16400,7863,8537
76360,473317,27651,227619,17438,445666,16400,7863,8537
76365,473348,27653,227633,17440,445695,16400,7863,8537
76370,473379,27656,227647,17442,445722,16400,7863,8537
76375,473410,27659,227661,17443,445751,16400,7863,8537
76380,473441,27662,227677,17446,445779,16401,7864,8537
76385,473472,27662,227695,17446,445810,16401,7864,8537
76390,473503,27662,227711,17446,445841,16401,7864,8537
76395,473534,27662,227731,17446,445872,16401,7864,8537
76400,473565,27663,227747,17447,445902,16402,7865,8537
76405,473596,27664,227765,17447,445932,16402,7865,8537
76410,473627,27665,227783,17448,445962,16402,7865,8537
76415,473658,27666,227796,17448,445992,16402,7865,8537
76420,473689,27667,227811,17449,446022,16402,7865,8537
76425,473720,27668,227827,17449,446052,16402,7865,8537
76430,473751,27669,227843,17449,446082,16402,7865,8537
76435,473782,27671,227862,17450,446111,16402,7865,8537
76440,473813,27672,227878,17451,446141,16402,7865,8537
76445,473844,27675,227895,17452,446169,16402,7865,8537
76450,473875,27678,227912,17453,446197,16402,7865,8537
76455,473906,27681,227931,17454,446225,16402,7865,8537
76460,473937,27684,227947,17455,446253,16402,7865,8537
76465,473968,27687,227962,17458,446281,16402,7865,8537
76470,473999,27690,227978,17459,446309,16402,7865,8537
76475,474030,27693,227992,17460,446337,16402,7865,8537
76480,474061,27696,228007,17463,446365,16402,7865,8537
76485,474092,27699,228020,17464,446393,16402,7865,8537
76490,474123,27702,228027,17464,446421,16402,7865,8537
76495,474154,27706,228037,17467,446448,16402,7865,8537
76500,474185,27709,228049,17470,446475,16402,7865,8537
76505,474216,27710,228064,17471,446506,16403,7865,8538
76510,474247,27710,228081,17471,446537,16403,7865,8538
76515,474278,27710,228099,17471,446568,16403,7865,8538
76520,474309,27710,228112,17471,446599,16403,7865,8538
76525,474340,27710,228124,17471,446630,16403,7865,8538
76530,474371,27710,228141,17471,446661,16403,7865,8538
76535,474402,27710,228153,17471,446692,16403,7865,8538
76540,474433,27710,228167,17471,446723,16403,7865,8538
76545,474464,27710,228177,17471,446754,16403,7865,8538
76550,474495,27710,228197,17471,446785,16403,7865,8538
76555,474526,27710,228214,17471,446816,16403,7865,8538
76560,474557,27710,228227,17471,446847,16403,7865,8538
76565,474588,27710,228238,17471,446878,16403,7865,8538
76570,474619,27710,228252,17471,446909,16403,7865,8538
76575,474650,27710,228264,17471,446940,16403,7865,8538
76580,474681,27710,228278,17471,446971,16403,7865,8538
76585,474712,27710,228294,17471,447002,16403,7865,8538
76590,474743,27710,228308,17471,447033,16403,7865,8538
76595,474774,27710,228322,17471,447064,16403,7865,8538
76600,474805,27710,228332,17471,447095,16403,7865,8538
76605,474836,27711,228345,17471,447125,16403,7865,8538
76610,474867,27714,228358,17473,447153,16404,7865,8539
76615,474898,27719,228371,17475,447179,16405,7865,8540
76620,474929,27723,228383,17479,447205,16406,7865,8541
76625,474960,27726,228395,17482,447234,16406,7865,8541
76630,474991,27729,228404,17483,447262,16406,7865,8541
76635,475022,27732,228419,17486,447290,16406,7865,8541
76640,475053,27734,228432,17487,447319,16406,7865,8541
76645,475084,27737,228447,17489,447347,16406,7865,8541
76650,475115,27739,228458,17489,447376,16406,7865,8541
76655,475146,27742,228470,17492,447404,16406,7865,8541
76660,475177,27744,228483,17493,447433,16406,7865,8541
76665,475208,27747,228501,17494,447461,16406,7865,8541
76670,475239,27750,228515,17497,447489,16406,7865,8541
76675,475270,27753,228530,17499,447517,16406,7865,8541
76680,475301,27756,228542,17501,447545,16406,7865,8541
76685,475332,27758,228555,17502,447573,16406,7865,8541
76690,475363,27762,228565,17504,447601,16406,7865,8541
76695,475394,27764,228583,17506,447630,16406,7865,8541
76700,475425,27766,228601,17507,447659,16406,7865,8541
76705,475456,27768,228613,17508,447688,16406,7865,8541
76710,475487,27770,228628,17509,447717,16406,7865,8541
76715,475518,27772,228645,17511,447746,16406,7865,8541
76720,475549,27774,228657,17511,447775,16406,7865,8541
76725,475580,27776,228667,17512,447804,16407,7865,8542
76730,475611,27778,228677,17513,447833,16408,7865,8543
76735,475642,27780,228692,17513,447862,16409,7866,8543
76740,475673,27783,228709,17515,447890,16410,7866,8544
76745,475704,27786,228725,17515,447918,16411,7866,8545
76750,475735,27789,228739,17518,447946,16412,7866,8546
76755,475766,27792,228755,17521,447974,16412,7866,8546
76760,475797,27795,228775,17522,448002,16412,7866,8546
76765,475828,27799,228790,17525,448029,16412,7866,8546
76770,475859,27802,228804,17526,448057,16412,7866,8546
76775,475890,27805,228816,17527,448085,16412,7866,8546
76780,475921,27809,228833,17528,448112,16412,7866,8546
76785,475952,27812,228851,17529,448140,16412,7866,8546
76790,475983,27815,228864,17530,448167,16412,7866,8546
76795,476014,27818,228878,17532,448196,16412,7866,8546
76800,476045,27821,228892,17534,448224,16412,7866,8546
76805,476076,27823,228909,17536,448253,16412,7866,8546
76810,476107,27824,228927,17537,448283,16412,7866,8546
76815,476138,27824,228942,17537,448314,16412,7866,8546
76820,476169,27824,228957,17537,448345,16412,7866,8546
76825,476200,27824,228972,17537,448376,16412,7866,8546
76830,476231,27824,228989,17537,448407,16412,7866,8546
76835,476262,27824,229004,17537,448438,16412,7866,8546
76840,476293,27824,229022,17537,448469,16412,7866,8546
76845,476324,27824,229042,17537,448500,16412,7866,8546
76850,476355,27824,229056,17537,448531,16412,7866,8546
76855,476386,27824,229075,17537,448562,16412,7866,8546
76860,476417,27824,229091,17537,448593,16413,7866,8547
76865,476448,27825,229106,17538,448622,16414,7866,8548
76870,476479,27828,229127,17541,448651,16415,7867,8548
76875,476510,27829,229143,17542,448680,16416,7867,8549
76880,476541,27831,229156,17544,448710,16417,7867,8550
76885,476572,27832,229171,17545,448739,16418,7868,8550
76890,476603,27835,229187,17548,448767,16419,7869,8550
76895,476634,27837,229203,17550,448797,16420,7870,8550
76900,476665,27837,229214,17550,448828,16421,7870,8551
76905,476696,27838,229231,17550,448857,16422,7871,8551
76910,476727,27840,229241,17552,448887,16423,7871,8552
76915,476758,27842,229254,17552,448916,16424,7871,8553
76920,476789,27844,229266,17552,448945,16424,7871,8553
76925,476820,27847,229282,17554,448973,16424,7871,8553
76930,476851,27849,229297,17554,449002,16424,7871,8553
76935,476882,27851,229308,17555,449031,16424,7871,8553
76940,476913,27855,229325,17558,449058,16424,7871,8553
76945,476944,27857,229338,17560,449087,16424,7871,8553
76950,476975,27861,229351,17563,449114,16424,7871,8553
76955,477006,27864,229366,17566,449142,16424,7871,8553
76960,477037,27866,229380,17567,449171,16424,7871,8553
76965,477068,27868,229391,17568,449200,16424,7871,8553
76970,477099,27871,229408,17571,449228,16424,7871,8553
76975,477130,27874,229424,17574,449256,16424,7871,8553
76980,477161,27876,229440,17574,449285,16424,7871,8553
76985,477192,27878,229453,17574,449314,16424,7871,8553
76990,477223,27880,229471,17576,449343,16424,7871,8553
76995,477254,27882,229487,17577,449372,16424,7871,8553
77000,477285,27885,229504,17580,449400,16424,7871,8553
77005,477316,27888,229519,17582,449428,16424,7871,8553
77010,477347,27891,229537,17585,449456,16424,7871,8553
77015,477378,27894,229554,17588,449484,16424,7871,8553
77020,477409,27897,229567,17590,449512,16424,7871,8553
77025,477440,27900,229583,17591,449540,16424,7871,8553
77030,477471,27903,229597,17594,449568,16425,7871,8554
77035,477502,27906,229609,17597,449595,16426,7872,8554
77040,477533,27910,229627,17600,449623,16427,7873,8554
77045,477564,27913,229641,17602,449651,16428,7874,8554
77050,477595,27914,229653,17603,449681,16428,7874,8554
77055,477626,27915,229664,17603,449711,16428,7874,8554
77060,477657,27916,229680,17604,449740,16428,7874,8554
77065,477688,27918,229693,17606,449770,16428,7874,8554
77070,477719,27919,229710,17607,449800,16428,7874,8554
77075,477750,27920,229727,17608,449830,16428,7874,8554
77080,477781,27921,229741,17608,449860,16428,7874,8554
77085,477812,27922,229750,17609,449890,16428,7874,8554
77090,477843,27923,229769,17609,449920,16428,7874,8554
77095,477874,27924,229783,17609,449950,16428,7874,8554
77100,477905,27925,229795,17609,449980,16428,7874,8554
77105,477936,27926,229809,17609,450010,16428,7874,8554
77110,477967,27927,229827,17610,450040,16428,7874,8554
77115,477998,27928,229844,17611,450070,16428,7874,8554
77120,478029,27929,229859,17612,450100,16428,7874,8554
77125,478060,27930,229872,17612,450130,16428,7874,8554
77130,478091,27931,229888,17612,450160,16428,7874,8554
77135,478122,27932,229900,17612,450190,16428,7874,8554
77140,478153,27933,229917,17612,450220,16428,7874,8554
77145,478184,27935,229934,17614,450249,16428,7874,8554
77150,478215,27942,229951,17618,450273,16428,7874,8554
77155,478246,27946,229964,17620,450300,16428,7874,8554
77160,478277,27949,229979,17622,450328,16429,7875,8554
77165,478308,27951,229988,17622,450357,16429,7875,8554
77170,478339,27953,230005,17623,450385,16429,7875,8554
77175,478370,27956,230019,17625,450413,16429,7875,8554
77180,478401,27959,230039,17628,450441,16429,7875,8554
77185,478432,27962,230051,17629,450470,16429,7875,8554
77190,478463,27964,230067,17629,450499,16429,7875,8554
77195,478494,27966,230080,17630,450528,16429,7875,8554
77200,478525,27968,230094,17632,450557,16429,7875,8554
77205,478556,27970,230106,17633,450586,16429,7875,8554
77210,478587,27972,230119,17634,450614,16429,7875,8554
77215,478618,27975,230131,17636,450643,16429,7875,8554
77220,478649,27977,230143,17637,450672,16429,7875,8554
77225,478680,27980,230155,17638,450700,16429,7875,8554
77230,478711,27983,230173,17639,450728,16429,7875,8554
77235,478742,27986,230189,17640,450755,16429,7875,8554
77240,478773,27990,230204,17642,450783,16429,7875,8554
77245,478804,27992,230218,17643,450812,16429,7875,8554
77250,478835,27994,230235,17645,450841,16429,7875,8554
77255,478866,27995,230249,17645,450871,16429,7875,8554
77260,478897,27997,230262,17646,450900,16429,7875,8554
77265,478928,27999,230272,17648,450929,16429,7875,8554
77270,478959,28001,230285,17649,450958,16429,7875,8554
77275,478990,28002,230301,17649,450988,16429,7875,8554
77280,479021,28002,230314,17649,451019,16429,7875,8554
77285,479052,28002,230323,17649,451050,16429,7875,8554
77290,479083,28002,230341,17649,451081,16429,7875,8554
77295,479114,28002,230353,17649,451112,16429,7875,8554
77300,479145,28002,230361,17649,451143,16429,7875,8554
77305,479176,28002,230372,17649,451174,16429,7875,8554
77310,479207,28002,230385,17649,451205,16429,7875,8554
77315,479238,28002,230405,17649,451236,16429,7875,8554
77320,479269,28002,230423,17649,451267,16429,7875,8554
77325,479300,28003,230441,17649,451297,16429,7875,8554
77330,479331,28004,230457,17650,451327,16429,7875,8554
77335,479362,28005,230474,17650,451357,16429,7875,8554
77340,479393,28006,230485,17650,451387,16429,7875,8554
77345,479424,28009,230501,17652,451414,16429,7875,8554
77350,479455,28013,230518,17655,451442,16429,7875,8554
77355,479486,28017,230535,17658,451469,16429,7875,8554
77360,479517,28021,230549,17661,451496,16429,7875,8554
77365,479548,28025,230566,17665,451523,16429,7875,8554
77370,479579,28028,230583,17666,451551,16429,7875,8554
77375,479610,28032,230599,17669,451578,16429,7875,8554
77380,479641,28036,230617,17672,451605,16429,7875,8554
77385,479672,28041,230635,17676,451631,16429,7875,8554
77390,479703,28043,230646,17677,451660,16429,7875,8554
77395,479734,28045,230662,17678,451689,16429,7875,8554
77400,479765,28048,230672,17680,451717,16429,7875,8554
77405,479796,28050,230691,17682,451746,16429,7875,8554
77410,479827,28051,230707,17682,451776,16429,7875,8554
77415,479858,28052,230720,17683,451806,16429,7875,8554
77420,479889,28053,230737,17683,451836,16429,7875,8554
77425,479920,28054,230755,17684,451866,16429,7875,8554
77430,479951,28055,230770,17685,451896,16429,7875,8554
77435,479982,28056,230785,17685,451926,16429,7875,8554
77440,480013,28057,230801,17685,451956,16429,7875,8554
77445,480044,28058,230817,17685,451986,16429,7875,8554
77450,480075,28059,230831,17685,452016,16429,7875,8554
77455,480106,28060,230850,17685,452046,16429,7875,8554
77460,480137,28061,230864,17685,452076,16429,7875,8554
77465,480168,28062,230876,17685,452106,16430,7875,8555
77470,480199,28063,230886,17686,452136,16431,7876,8555
77475,480230,28064,230901,17686,452166,16432,7876,8556
77480,480261,28065,230919,17687,452196,16432,7876,8556
77485,480292,28066,230939,17688,452226,16432,7876,8556
77490,480323,28067,230952,17688,452256,16432,7876,8556
77495,480354,28068,230965,17689,452286,16432,7876,8556
77500,480385,28069,230980,17689,452316,16432,7876,8556
77505,480416,28070,230997,17690,452346,16432,7876,8556
77510,480447,28072,231016,17691,452374,16432,7876,8556
77515,480478,28076,231034,17693,452401,16432,7876,8556
77520,480509,28080,231047,17695,452429,16432,7876,8556
77525,480540,28084,231067,17698,452456,16432,7876,8556
77530,480571,28088,231082,17702,452483,16432,7876,8556
77535,480602,28092,231093,17703,452510,16432,7876,8556
77540,480633,28094,231111,17704,452539,16432,7876,8556
77545,480664,28096,231127,17705,452568,16432,7876,8556
77550,480695,28098,231140,17705,452597,16432,7876,8556
77555,480726,28100,231156,17707,452626,16432,7876,8556
77560,480757,28102,231173,17708,452655,16432,7876,8556
77565,480788,28104,231186,17708,452684,16432,7876,8556
77570,480819,28106,231198,17709,452713,16432,7876,8556
77575,480850,28109,231214,17711,452741,16432,7876,8556
77580,480881,28111,231234,17712,452770,16432,7876,8556
77585,480912,28112,231248,17712,452800,16433,7877,8556
77590,480943,28113,231265,17712,452830,16433,7877,8556
77595,480974,28114,231284,17713,452860,16433,7877,8556
77600,481005,28115,231297,17713,452890,16433,7877,8556
77605,481036,28116,231311,17713,452920,16433,7877,8556
77610,481067,28117,231324,17714,452950,16433,7877,8556
77615,481098,28118,231338,17715,452980,16433,7877,8556
77620,481129,28119,231355,17715,453010,16433,7877,8556
77625,481160,28121,231367,17717,453039,16433,7877,8556
77630,481191,28121,231380,17717,453070,16433,7877,8556
77635,481222,28121,231397,17717,453100,16433,7877,8556
77640,481253,28123,231408,17718,453130,16433,7877,8556
77645,481284,28126,231426,17719,453158,16433,7877,8556
77650,481315,28129,231439,17721,453186,16433,7877,8556
77655,481346,28131,231453,17723,453215,16433,7877,8556
77660,481377,28134,231467,17725,453243,16433,7877,8556
77665,481408,28137,231483,17727,453271,16433,7877,8556
77670,481439,28139,231499,17729,453300,16433,7877,8556
77675,481470,28141,231510,17730,453329,16433,7877,8556
77680,481501,28143,231523,17731,453358,16433,7877,8556
77685,481532,28146,231541,17733,453386,16433,7877,8556
77690,481563,28150,231562,17736,453413,16433,7877,8556
77695,481594,28153,231575,17737,453441,16433,7877,8556
77700,481625,28155,231589,17738,453470,16433,7877,8556
77705,481656,28158,231601,17740,453498,16433,7877,8556
77710,481687,28160,231616,17741,453527,16433,7877,8556
77715,481718,28161,231629,17742,453557,16433,7877,8556
77720,481749,28162,231642,17743,453587,16433,7877,8556
77725,481780,28163,231659,17743,453617,16433,7877,8556
77730,481811,28164,231674,17744,453647,16433,7877,8556
77735,481842,28165,231687,17745,453677,16433,7877,8556
77740,481873,28166,231701,17746,453707,16433,7877,8556
77745,481904,28167,231716,17746,453737,16433,7877,8556
77750,481935,28168,231734,17747,453767,16433,7877,8556
77755,481966,28170,231745,17749,453796,16433,7877,8556
77760,481997,28172,231761,17750,453825,16433,7877,8556
77765,482028,28176,231772,17753,453852,16433,7877,8556
77770,482059,28177,231787,17753,453882,16433,7877,8556
77775,482090,28179,231801,17755,453911,16433,7877,8556
77780,482121,28180,231816,17756,453941,16433,7877,8556
77785,482152,28180,231832,17756,453972,16433,7877,8556
77790,482183,28180,231846,17756,454003,16433,7877,8556
77795,482214,28180,231861,17756,454034,16433,7877,8556
77800,482245,28180,231877,17756,454065,16433,7877,8556
77805,482276,28182,231890,17758,454094,16433,7877,8556
77810,482307,28183,231904,17759,454124,16433,7877,8556
77815,482338,28185,231920,17761,454153,16433,7877,8556
77820,482369,28187,231932,17763,454182,16433,7877,8556
77825,482400,28188,231950,17763,454212,16433,7877,8556
77830,482431,28189,231964,17764,454242,16433,7877,8556
77835,482462,28191,231984,17765,454271,16433,7877,8556
77840,482493,28192,231993,17765,454301,16433,7877,8556
77845,482524,28193,232006,17766,454331,16433,7877,8556
77850,482555,28194,232023,17767,454361,16433,7877,8556
77855,482586,28196,232039,17769,454390,16433,7877,8556
77860,482617,28197,232051,17769,454420,16433,7877,8556
77865,482648,28198,232065,17769,454450,16433,7877,8556
77870,482679,28199,232083,17769,454480,16434,7877,8557
77875,482710,28200,232098,17769,454510,16435,7878,8557
77880,482741,28203,232113,17771,454538,16436,7879,8557
77885,482772,28206,232129,17773,454566,16436,7879,8557
77890,482803,28208,232141,17775,454595,16436,7879,8557
77895,482834,28211,232156,17777,454623,16436,7879,8557
77900,482865,28214,232169,17780,454651,16436,7879,8557
77905,482896,28216,232184,17782,454680,16436,7879,8557
77910,482927,28218,232196,17782,454709,16436,7879,8557
77915,482958,28220,232211,17783,454738,16436,7879,8557
77920,482989,28223,232228,17785,454766,16436,7879,8557
77925,483020,28226,232247,17787,454794,16436,7879,8557
77930,483051,28228,232263,17788,454823,16436,7879,8557
77935,483082,28230,232278,17788,454852,16436,7879,8557
77940,483113,28232,232297,17790,454881,16436,7879,8557
77945,483144,28235,232315,17792,454909,16436,7879,8557
77950,483175,28238,232329,17794,454937,16436,7879,8557
77955,483206,28240,232342,17795,454966,16436,7879,8557
77960,483237,28242,232357,17796,454995,16436,7879,8557
77965,483268,28244,232373,17797,455024,16436,7879,8557
77970,483299,28246,232389,17798,455053,16436,7879,8557
77975,483330,28248,232404,17799,455082,16436,7879,8557
77980,483361,28250,232422,17799,455111,16436,7879,8557
77985,483392,28253,232435,17802,455139,16437,7879,8558
77990,483423,28256,232450,17802,455167,16437,7879,8558
77995,483454,28260,232468,17806,455194,16437,7879,8558
78000,483485,28264,232485,17809,455221,16437,7879,8558
78005,483516,28265,232499,17810,455251,16437,7879,8558
78010,483547,28266,232516,17810,455281,16437,7879,8558
78015,483578,28267,232532,17810,455311,16437,7879,8558
78020,483609,28268,232550,17811,455341,16437,7879,8558
78025,483640,28269,232565,17812,455371,16437,7879,8558
78030,483671,28270,232575,17812,455401,16437,7879,8558
78035,483702,28271,232590,17812,455431,16437,7879,8558
78040,483733,28272,232606,17812,455461,16437,7879,8558
78045,483764,28273,232620,17813,455491,16437,7879,8558
78050,483795,28274,232636,17814,455521,16437,7879,8558
78055,483826,28276,232652,17816,455550,16437,7879,8558
78060,483857,28277,232668,17816,455580,16437,7879,8558
78065,483888,28280,232679,17817,455608,16437,7879,8558
78070,483919,28285,232694,17820,455634,16437,7879,8558
78075,483950,28290,232711,17823,455660,16437,7879,8558
78080,483981,28293,232727,17824,455688,16437,7879,8558
78085,484012,28295,232746,17826,455717,16437,7879,8558
78090,484043,28297,232763,17827,455746,16437,7879,8558
78095,484074,28299,232777,17827,455775,16437,7879,8558
78100,484105,28301,232795,17829,455804,16437,7879,8558
78105,484136,28303,232810,17829,455833,16437,7879,8558
78110,484167,28305,232827,17829,455862,16437,7879,8558
78115,484198,28307,232843,17830,455891,16437,7879,8558
78120,484229,28309,232858,17830,455920,16437,7879,8558
78125,484260,28313,232874,17832,455947,16437,7879,8558
78130,484291,28316,232887,17833,455975,16437,7879,8558
78135,484322,28319,232904,17834,456003,16437,7879,8558
78140,484353,28322,232915,17835,456031,16437,7879,8558
78145,484384,28325,232927,17836,456059,16437,7879,8558
78150,484415,28328,232941,17837,456087,16437,7879,8558
78155,484446,28331,232958,17839,456115,16437,7879,8558
78160,484477,28334,232970,17840,456143,16437,7879,8558
78165,484508,28337,232982,17841,456171,16437,7879,8558
78170,484539,28340,232994,17843,456198,16437,7879,8558
78175,484570,28344,233008,17845,456226,16437,7879,8558
78180,484601,28347,233026,17848,456253,16437,7879,8558
78185,484632,28349,233041,17849,456283,16437,7879,8558
78190,484663,28350,233048,17850,456313,16437,7879,8558
78195,484694,28351,233060,17851,456343,16437,7879,8558
78200,484725,28352,233074,17852,456373,16437,7879,8558
78205,484756,28353,233095,17852,456403,16437,7879,8558
78210,484787,28354,233109,17853,456433,16437,7879,8558
78215,484818,28355,233125,17853,456463,16437,7879,8558
78220,484849,28356,233140,17853,456493,16437,7879,8558
78225,484880,28357,233158,17853,456523,16437,7879,8558
78230,484911,28358,233174,17853,456553,16437,7879,8558
78235,484942,28360,233191,17854,456582,16437,7879,8558
78240,484973,28361,233203,17855,456612,16437,7879,8558
78245,485004,28363,233217,17856,456641,16437,7879,8558
78250,485035,28365,233233,17857,456670,16437,7879,8558
78255,485066,28366,233243,17858,456700,16437,7879,8558
78260,485097,28367,233257,17858,456730,16437,7879,8558
78265,485128,28368,233277,17858,456760,16437,7879,8558
78270,485159,28369,233292,17858,456790,16437,7879,8558
78275,485190,28370,233306,17858,456820,16437,7879,8558
78280,485221,28371,233321,17858,456850,16437,7879,8558
78285,485252,28372,233331,17859,456880,16437,7879,8558
78290,485283,28374,233346,17859,456909,16438,7880,8558
78295,485314,28377,233365,17861,456937,16439,7881,8558
78300,485345,28379,233380,17862,456966,16440,7881,8559
78305,485376,28382,233391,17865,456994,16441,7882,8559
78310,485407,28384,233408,17866,457023,16442,7883,8559
78315,485438,28387,233423,17867,457051,16443,7883,8560
78320,485469,28390,233438,17870,457079,16444,7884,8560
78325,485500,28393,233450,17872,457107,16445,7885,8560
78330,485531,28395,233469,17874,457136,16446,7886,8560
78335,485562,28397,233482,17875,457165,16447,7886,8561
78340,485593,28398,233501,17876,457195,16448,7887,8561
78345,485624,28399,233517,17877,457225,16449,7887,8562
78350,485655,28401,233535,17878,457254,16450,7887,8563
78355,485686,28403,233553,17879,457283,16451,7888,8563
78360,485717,28405,233569,17880,457312,16452,7888,8564
78365,485748,28408,233589,17881,457339,16452,7888,8564
78370,485779,28411,233606,17884,457368,16452,7888,8564
78375,485810,28413,233623,17886,457397,16452,7888,8564
78380,485841,28415,233639,17888,457426,16452,7888,8564
78385,485872,28417,233652,17890,457455,16452,7888,8564
78390,485903,28419,233669,17892,457484,16452,7888,8564
78395,485934,28421,233684,17892,457513,16452,7888,8564
78400,485965,28423,233699,17893,457542,16452,7888,8564
78405,485996,28425,233714,17894,457571,16452,7888,8564
78410,486027,28427,233730,17895,457600,16452,7888,8564
78415,486058,28429,233745,17896,457629,16452,7888,8564
78420,486089,28431,233759,17896,457658,16452,7888,8564
78425,486120,28435,233775,17898,457685,16452,7888,8564
78430,486151,28438,233788,17900,457713,16452,7888,8564
78435,486182,28441,233803,17901,457741,16452,7888,8564
78440,486213,28443,233822,17902,457770,16452,7888,8564
78445,486244,28445,233841,17904,457799,16452,7888,8564
78450,486275,28447,233857,17906,457828,16452,7888,8564
78455,486306,28449,233875,17907,457857,16452,7888,8564
78460,486337,28451,233892,17907,457886,16452,7888,8564
78465,486368,28453,233908,17908,457915,16452,7888,8564
78470,486399,28456,233923,17910,457943,16453,7889,8564
78475,486430,28459,233934,17912,457971,16454,7890,8564
78480,486461,28462,233949,17914,457998,16455,7890,8565
78485,486492,28464,233969,17916,458028,16456,7890,8566
78490,486523,28465,233981,17916,458058,16457,7891,8566
78495,486554,28466,233994,17917,458088,16458,7892,8566
78500,486585,28468,234012,17919,458117,16459,7892,8567
78505,486616,28470,234030,17921,458146,16460,7892,8568
78510,486647,28470,234045,17921,458177,16461,7893,8568
78515,486678,28470,234060,17921,458208,16461,7893,8568
78520,486709,28470,234073,17921,458239,16461,7893,8568
78525,486740,28470,234092,17921,458270,16461,7893,8568
78530,486771,28470,234107,17921,458301,16461,7893,8568
78535,486802,28470,234122,17921,458332,16461,7893,8568
78540,486833,28470,234142,17921,458363,16461,7893,8568
78545,486864,28470,234155,17921,458394,16461,7893,8568
78550,486895,28470,234170,17921,458425,16461,7893,8568
78555,486926,28470,234183,17921,458456,16461,7893,8568
78560,486957,28470,234197,17921,458487,16461,7893,8568
78565,486988,28470,234215,17921,458518,16461,7893,8568
78570,487019,28470,234226,17921,458549,16461,7893,8568
78575,487050,28470,234240,17921,458580,16461,7893,8568
78580,487081,28470,234254,17921,458611,16461,7893,8568
78585,487112,28471,234269,17922,458641,16461,7893,8568
78590,487143,28473,234280,17923,458670,16461,7893,8568
78595,487174,28476,234292,17924,458698,16461,7893,8568
78600,487205,28479,234305,17926,458726,16461,7893,8568
78605,487236,28483,234324,17928,458752,16461,7893,8568
78610,487267,28487,234337,17931,458780,16461,7893,8568
78615,487298,28491,234353,17934,458807,16462,7893,8569
78620,487329,28495,234364,17936,458834,16463,7894,8569
78625,487360,28498,234381,17939,458861,16464,7895,8569
78630,487391,28503,234400,17941,458888,16465,7896,8569
78635,487422,28506,234414,17942,458916,16466,7896,8570
78640,487453,28510,234429,17944,458942,16467,7897,8570
78645,487484,28514,234440,17946,458970,16468,7898,8570
78650,487515,28517,234453,17948,458998,16469,7898,8571
78655,487546,28520,234473,17949,459026,16470,7899,8571
78660,487577,28524,234491,17953,459053,16471,7899,8572
78665,487608,28526,234510,17955,459082,16471,7899,8572
78670,487639,28528,234531,17957,459111,16471,7899,8572
78675,487670,28531,234550,17959,459139,16471,7899,8572
78680,487701,28533,234561,17959,459168,16471,7899,8572
78685,487732,28535,234575,17961,459197,16471,7899,8572
78690,487763,28538,234593,17964,459225,16471,7899,8572
78695,487794,28540,234604,17964,459254,16471,7899,8572
78700,487825,28543,234622,17966,459282,16471,7899,8572
78705,487856,28545,234634,17966,459311,16471,7899,8572
78710,487887,28547,234648,17966,459340,16471,7899,8572
78715,487918,28549,234658,17967,459369,16471,7899,8572
78720,487949,28552,234679,17969,459397,16471,7899,8572
78725,487980,28554,234690,17970,459426,16471,7899,8572
78730,488011,28557,234704,17971,459454,16471,7899,8572
78735,488042,28559,234719,17972,459483,16471,7899,8572
78740,488073,28561,234735,17973,459512,16471,7899,8572
78745,488104,28563,234755,17975,459541,16471,7899,8572
78750,488135,28565,234772,17976,459570,16471,7899,8572
78755,488166,28567,234782,17976,459599,16471,7899,8572
78760,488197,28569,234802,17978,459628,16471,7899,8572
78765,488228,28571,234818,17978,459657,16471,7899,8572
78770,488259,28574,234833,17979,459684,16471,7899,8572
78775,488290,28578,234849,17981,459711,16471,7899,8572
78780,488321,28583,234864,17984,459738,16471,7899,8572
78785,488352,28585,234881,17985,459767,16471,7899,8572
78790,488383,28586,234895,17986,459796,16472,7900,8572
78795,488414,28588,234905,17987,459826,16473,7900,8573
78800,488445,28590,234924,17989,459855,16474,7900,8574
78805,488476,28592,234941,17991,459883,16475,7901,8574
78810,488507,28594,234956,17992,459912,16476,7902,8574
78815,488538,28597,234969,17994,459941,16477,7903,8574
78820,488569,28597,234984,17994,459972,16477,7903,8574
78825,488600,28597,235002,17994,460003,16477,7903,8574
78830,488631,28597,235013,17994,460034,16477,7903,8574
78835,488662,28597,235027,17994,460065,16477,7903,8574
78840,488693,28597,235041,17994,460096,16477,7903,8574
78845,488724,28597,235056,17994,460127,16477,7903,8574
78850,488755,28597,235067,17994,460158,16477,7903,8574
78855,488786,28597,235082,17994,460189,16477,7903,8574
78860,488817,28597,235096,17994,460220,16477,7903,8574
78865,488848,28597,235113,17994,460251,16477,7903,8574
78870,488879,28597,235127,17994,460282,16477,7903,8574
78875,488910,28597,235144,17994,460313,16477,7903,8574
78880,488941,28597,235155,17994,460344,16477,7903,8574
78885,488972,28598,235167,17994,460374,16477,7903,8574
78890,489003,28599,235185,17994,460404,16477,7903,8574
78895,489034,28601,235202,17996,460433,16477,7903,8574
78900,489065,28603,235221,17997,460462,16477,7903,8574
78905,489096,28605,235238,17998,460491,16477,7903,8574
78910,489127,28607,235253,18000,460520,16477,7903,8574
78915,489158,28609,235265,18001,460549,16477,7903,8574
78920,489189,28612,235282,18003,460576,16477,7903,8574
78925,489220,28617,235294,18006,460603,16477,7903,8574
78930,489251,28620,235306,18007,460631,16478,7903,8575
78935,489282,28624,235321,18009,460658,16479,7903,8576
78940,489313,28628,235331,18011,460684,16480,7903,8577
78945,489344,28633,235345,18014,460710,16481,7903,8578
78950,489375,28638,235361,18019,460736,16482,7904,8578
78955,489406,28643,235373,18022,460762,16483,7904,8579
78960,489437,28648,235388,18024,460788,16484,7905,8579
78965,489468,28652,235406,18027,460816,16484,7905,8579
78970,489499,28653,235422,18027,460846,16484,7905,8579
78975,489530,28654,235436,18027,460876,16484,7905,8579
78980,489561,28655,235454,18028,460906,16484,7905,8579
78985,489592,28656,235465,18029,460936,16484,7905,8579
78990,489623,28657,235479,18030,460966,16484,7905,8579
78995,489654,28658,235493,18030,460996,16484,7905,8579
79000,489685,28659,235508,18030,461026,16484,7905,8579
79005,489716,28660,235518,18031,461056,16484,7905,8579
79010,489747,28661,235531,18031,461086,16484,7905,8579
79015,489778,28662,235548,18031,461116,16484,7905,8579
79020,489809,28663,235564,18031,461146,16484,7905,8579
79025,489840,28664,235575,18032,461176,16484,7905,8579
79030,489871,28665,235594,18033,461206,16484,7905,8579
79035,489902,28666,235607,18034,461236,16484,7905,8579
79040,489933,28667,235622,18034,461266,16484,7905,8579
79045,489964,28668,235638,18035,461296,16484,7905,8579
79050,489995,28669,235651,18035,461326,16484,7905,8579
79055,490026,28670,235662,18035,461356,16484,7905,8579
79060,490057,28671,235679,18036,461386,16484,7905,8579
79065,490088,28672,235695,18037,461416,16484,7905,8579
79070,490119,28673,235711,18037,461445,16484,7905,8579
79075,490150,28678,235723,18040,461471,16484,7905,8579
79080,490181,28683,235741,18044,461497,16484,7905,8579
79085,490212,28686,235754,18046,461526,16484,7905,8579
79090,490243,28689,235767,18047,461554,16484,7905,8579
79095,490274,28692,235779,18050,461582,16484,7905,8579
79100,490305,28695,235798,18052,461610,16484,7905,8579
79105,490336,28698,235810,18054,461638,16484,7905,8579
79110,490367,28700,235823,18056,461667,16484,7905,8579
79115,490398,28703,235840,18058,461695,16484,7905,8579
79120,490429,28706,235850,18059,461723,16484,7905,8579
79125,490460,28709,235866,18061,461751,16484,7905,8579
79130,490491,28712,235889,18063,461779,16484,7905,8579
79135,490522,28713,235901,18064,461809,16484,7905,8579
79140,490553,28714,235916,18064,461839,16484,7905,8579
79145,490584,28717,235928,18066,461867,16484,7905,8579
79150,490615,28718,235950,18067,461897,16484,7905,8579
79155,490646,28719,235964,18068,461927,16484,7905,8579
79160,490677,28720,235977,18069,461957,16484,7905,8579
79165,490708,28721,235994,18070,461987,16484,7905,8579
79170,490739,28722,236010,18071,462017,16484,7905,8579
79175,490770,28723,236023,18072,462047,16484,7905,8579
79180,490801,28724,236036,18072,462077,16484,7905,8579
79185,490832,28725,236053,18072,462106,16484,7905,8579
79190,490863,28727,236074,18074,462135,16484,7905,8579
79195,490894,28730,236090,18077,462164,16484,7905,8579
79200,490925,28732,236106,18078,462193,16484,7905,8579
79205,490956,28735,236123,18081,462221,16484,7905,8579
79210,490987,28739,236137,18082,462248,16484,7905,8579
79215,491018,28742,236149,18082,462276,16484,7905,8579
79220,491049,28746,236164,18085,462303,16484,7905,8579
79225,491080,28749,236181,18087,462331,16484,7905,8579
79230,491111,28753,236195,18089,462358,16484,7905,8579
79235,491142,28756,236208,18090,462386,16484,7905,8579
79240,491173,28760,236229,18093,462413,16484,7905,8579
79245,491204,28763,236240,18096,462441,16484,7905,8579
79250,491235,28766,236258,18096,462469,16484,7905,8579
79255,491266,28770,236278,18099,462496,16484,7905,8579
79260,491297,28773,236292,18101,462524,16484,7905,8579
79265,491328,28774,236306,18101,462554,16484,7905,8579
79270,491359,28775,236318,18101,462584,16484,7905,8579
79275,491390,28776,236338,18102,462614,16484,7905,8579
79280,491421,28777,236356,18103,462644,16484,7905,8579
79285,491452,28778,236375,18104,462674,16484,7905,8579
79290,491483,28779,236391,18105,462704,16484,7905,8579
79295,491514,28780,236405,18105,462734,16484,7905,8579
79300,491545,28781,236422,18106,462764,16484,7905,8579
79305,491576,28782,236437,18107,462794,16484,7905,8579
79310,491607,28783,236451,18108,462824,16484,7905,8579
79315,491638,28784,236466,18109,462854,16484,7905,8579
79320,491669,28785,236479,18110,462884,16484,7905,8579
79325,491700,28786,236494,18111,462913,16484,7905,8579
79330,491731,28788,236510,18113,462942,16484,7905,8579
79335,491762,28790,236529,18115,462971,16484,7905,8579
79340,491793,28792,236548,18117,463001,16484,7905,8579
79345,491824,28793,236555,18117,463031,16484,7905,8579
79350,491855,28794,236571,18117,463061,16484,7905,8579
79355,491886,28795,236583,18118,463091,16484,7905,8579
79360,491917,28796,236604,18119,463121,16484,7905,8579
79365,491948,28798,236620,18119,463150,16484,7905,8579
79370,491979,28801,236635,18121,463178,16484,7905,8579
79375,492010,28805,236653,18122,463205,16484,7905,8579
79380,492041,28810,236677,18127,463231,16484,7905,8579
79385,492072,28813,236694,18129,463259,16484,7905,8579
79390,492103,28815,236711,18131,463288,16484,7905,8579
79395,492134,28817,236725,18132,463317,16484,7905,8579
79400,492165,28820,236742,18135,463345,16484,7905,8579
79405,492196,28822,236755,18135,463374,16484,7905,8579
79410,492227,28824,236769,18136,463403,16484,7905,8579
79415,492258,28826,236786,18138,463432,16484,7905,8579
79420,492289,28828,236802,18139,463461,16484,7905,8579
79425,492320,28830,236817,18140,463490,16484,7905,8579
79430,492351,28832,236830,18140,463519,16484,7905,8579
79435,492382,28834,236845,18141,463548,16484,7905,8579
79440,492413,28836,236863,18142,463577,16484,7905,8579
79445,492444,28838,236880,18142,463606,16484,7905,8579
79450,492475,28840,236891,18142,463635,16484,7905,8579
79455,492506,28843,236904,18143,463663,16484,7905,8579
79460,492537,28844,236918,18143,463693,16484,7905,8579
79465,492568,28845,236933,18144,463723,16484,7905,8579
79470,492599,28846,236945,18144,463753,16484,7905,8579
79475,492630,28847,236959,18144,463783,16484,7905,8579
79480,492661,28848,236974,18144,463813,16484,7905,8579
79485,492692,28849,236990,18144,463843,16484,7905,8579
79490,492723,28851,237002,18146,463872,16484,7905,8579
79495,492754,28853,237020,18148,463900,16484,7905,8579
79500,492785,28856,237033,18151,463929,16484,7905,8579
79505,492816,28859,237048,18153,463957,16484,7905,8579
79510,492847,28864,237064,18156,463983,16484,7905,8579
79515,492878,28867,237077,18158,464011,16484,7905,8579
79520,492909,28870,237087,18159,464039,16484,7905,8579
79525,492940,28873,237101,18161,464067,16484,7905,8579
79530,492971,28876,237119,18163,464094,16484,7905,8579
79535,493002,28880,237136,18165,464121,16484,7905,8579
79540,493033,28884,237156,18168,464148,16484,7905,8579
79545,493064,28887,237162,18170,464177,16484,7905,8579
79550,493095,28889,237179,18171,464205,16484,7905,8579
79555,493126,28892,237192,18173,464234,16484,7905,8579
79560,493157,28894,237208,18174,464262,16484,7905,8579
79565,493188,28897,237218,18176,464291,16484,7905,8579
79570,493219,28899,237234,18177,464320,16484,7905,8579
79575,493250,28901,237251,18177,464349,16484,7905,8579
79580,493281,28903,237267,18178,464378,16484,7905,8579
79585,493312,28905,237285,18179,464407,16484,7905,8579
79590,493343,28907,237301,18181,464436,16484,7905,8579
79595,493374,28909,237314,18182,464465,16484,7905,8579
79600,493405,28911,237328,18183,464494,16484,7905,8579
79605,493436,28913,237344,18185,464523,16484,7905,8579
79610,493467,28915,237360,18187,464552,16484,7905,8579
79615,493498,28917,237373,18188,464581,16484,7905,8579
79620,493529,28920,237390,18190,464609,16484,7905,8579
79625,493560,28922,237402,18190,464638,16484,7905,8579
79630,493591,28924,237416,18191,464667,16484,7905,8579
79635,493622,28926,237423,18192,464696,16484,7905,8579
79640,493653,28928,237434,18194,464725,16484,7905,8579
79645,493684,28930,237450,18194,464754,16484,7905,8579
79650,493715,28932,237463,18195,464783,16484,7905,8579
79655,493746,28934,237480,18196,464812,16484,7905,8579
79660,493777,28936,237492,18196,464841,16484,7905,8579
79665,493808,28938,237508,18196,464869,16484,7905,8579
79670,493839,28941,237526,18198,464897,16484,7905,8579
79675,493870,28944,237544,18200,464925,16484,7905,8579
79680,493901,28947,237554,18201,464953,16484,7905,8579
79685,493932,28950,237570,18204,464982,16484,7905,8579
79690,493963,28952,237585,18205,465011,16484,7905,8579
79695,493994,28954,237597,18205,465040,16484,7905,8579
79700,494025,28956,237612,18207,465069,16484,7905,8579
79705,494056,28958,237629,18207,465098,16484,7905,8579
79710,494087,28960,237646,18208,465127,16484,7905,8579
79715,494118,28962,237660,18209,465156,16484,7905,8579
79720,494149,28964,237678,18210,465185,16484,7905,8579
79725,494180,28966,237692,18212,465214,16484,7905,8579
79730,494211,28968,237703,18212,465243,16484,7905,8579
79735,494242,28970,237717,18212,465272,16484,7905,8579
79740,494273,28973,237736,18215,465300,16484,7905,8579
79745,494304,28975,237750,18216,465328,16484,7905,8579
79750,494335,28978,237760,18217,465357,16484,7905,8579
79755,494366,28979,237776,18217,465387,16484,7905,8579
79760,494397,28980,237790,18218,465416,16484,7905,8579
79765,494428,28982,237805,18219,465446,16484,7905,8579
79770,494459,28983,237819,18220,465476,16484,7905,8579
79775,494490,28984,237837,18221,465506,16484,7905,8579
79780,494521,28985,237849,18222,465536,16484,7905,8579
79785,494552,28986,237864,18223,465566,16484,7905,8579
79790,494583,28987,237878,18223,465596,16484,7905,8579
79795,494614,28988,237890,18223,465626,16484,7905,8579
79800,494645,28989,237909,18223,465656,16484,7905,8579
79805,494676,28990,237930,18223,465686,16484,7905,8579
79810,494707,28991,237942,18223,465716,16484,7905,8579
79815,494738,28992,237955,18224,465746,16484,7905,8579
79820,494769,28993,237970,18224,465776,16484,7905,8579
79825,494800,28994,237985,18224,465806,16484,7905,8579
79830,494831,28995,238000,18224,465836,16484,7905,8579
79835,494862,28996,238014,18225,465866,16484,7905,8579
79840,494893,28997,238031,18225,465896,16484,7905,8579
79845,494924,28999,238047,18227,465925,16484,7905,8579
79850,494955,29001,238063,18227,465954,16484,7905,8579
79855,494986,29004,238076,18229,465982,16484,7905,8579
79860,495017,29008,238090,18232,466009,16484,7905,8579
79865,495048,29010,238103,18233,466038,16484,7905,8579
79870,495079,29012,238116,18234,466067,16484,7905,8579
79875,495110,29015,238130,18236,466095,16484,7905,8579
79880,495141,29017,238145,18237,466124,16484,7905,8579
79885,495172,29019,238161,18238,466153,16484,7905,8579
79890,495203,29021,238175,18240,466182,16484,7905,8579
79895,495234,29023,238188,18240,466211,16484,7905,8579
79900,495265,29026,238206,18242,466239,16484,7905,8579
79905,495296,29029,238221,18243,466267,16484,7905,8579
79910,495327,29031,238237,18244,466296,16484,7905,8579
79915,495358,29033,238251,18244,466325,16484,7905,8579
79920,495389,29035,238269,18245,466354,16484,7905,8579
79925,495420,29039,238287,18248,466380,16484,7905,8579
79930,495451,29043,238303,18250,466408,16484,7905,8579
79935,495482,29047,238322,18252,466434,16484,7905,8579
79940,495513,29052,238336,18256,466461,16484,7905,8579
79945,495544,29055,238351,18257,466489,16484,7905,8579
79950,495575,29058,238366,18257,466517,16484,7905,8579
79955,495606,29061,238378,18259,466545,16484,7905,8579
79960,495637,29064,238392,18260,466573,16484,7905,8579
79965,495668,29067,238406,18261,466601,16484,7905,8579
79970,495699,29070,238418,18263,466629,16484,7905,8579
79975,495730,29073,238436,18265,466657,16484,7905,8579
79980,495761,29076,238451,18267,466685,16484,7905,8579
79985,495792,29079,238466,18269,466713,16484,7905,8579
79990,495823,29082,238476,18269,466741,16484,7905,8579
79995,495854,29085,238493,18271,466769,16484,7905,8579
80000,495885,29088,238510,18273,466797,16484,7905,8579
80005,495916,29091,238524,18274,466825,16484,7905,8579
80010,495947,29095,238539,18278,466852,16484,7905,8579
80015,495978,29097,238553,18279,466881,16484,7905,8579
80020,496009,29099,238568,18280,466910,16484,7905,8579
80025,496040,29101,238585,18281,466939,16484,7905,8579
80030,496071,29103,238603,18281,466968,16484,7905,8579
80035,496102,29105,238618,18281,466997,16484,7905,8579
80040,496133,29107,238633,18282,467026,16484,7905,8579
80045,496164,29110,238647,18283,467054,16484,7905,8579
80050,496195,29112,238663,18283,467083,16484,7905,8579
80055,496226,29114,238680,18285,467112,16484,7905,8579
80060,496257,29116,238692,18287,467141,16484,7905,8579
80065,496288,29118,238704,18288,467170,16484,7905,8579
80070,496319,29121,238716,18289,467198,16484,7905,8579
80075,496350,29124,238730,18291,467226,16484,7905,8579
80080,496381,29125,238739,18292,467256,16484,7905,8579
80085,496412,29126,238750,18292,467286,16484,7905,8579
80090,496443,29127,238766,18292,467316,16484,7905,8579
80095,496474,29128,238781,18292,467346,16484,7905,8579
80100,496505,29129,238790,18292,467376,16484,7905,8579
80105,496536,29130,238811,18293,467406,16484,7905,8579
80110,496567,29131,238826,18293,467436,16484,7905,8579
80115,496598,29132,238840,18294,467466,16484,7905,8579
80120,496629,29133,238857,18294,467496,16484,7905,8579
80125,496660,29134,238873,18295,467526,16484,7905,8579
80130,496691,29135,238890,18295,467556,16484,7905,8579
80135,496722,29136,238906,18296,467586,16484,7905,8579
80140,496753,29137,238920,18296,467616,16484,7905,8579
80145,496784,29139,238930,18298,467645,16484,7905,8579
80150,496815,29140,238946,18299,467675,16484,7905,8579
80155,496846,29141,238951,18299,467705,16484,7905,8579
80160,496877,29142,238969,18300,467735,16484,7905,8579
80165,496908,29143,238988,18301,467765,16484,7905,8579
80170,496939,29144,239004,18301,467795,16484,7905,8579
80175,496970,29145,239021,18302,467825,16484,7905,8579
80180,497001,29146,239039,18303,467855,16484,7905,8579
80185,497032,29147,239055,18303,467885,16484,7905,8579
80190,497063,29148,239072,18304,467915,16484,7905,8579
80195,497094,29149,239093,18304,467944,16484,7905,8579
80200,497125,29151,239107,18305,467974,16484,7905,8579
80205,497156,29152,239118,18305,468004,16484,7905,8579
80210,497187,29155,239130,18306,468031,16484,7905,8579
80215,497218,29159,239144,18308,468058,16484,7905,8579
80220,497249,29162,239160,18309,468086,16484,7905,8579
80225,497280,29167,239172,18313,468112,16484,7905,8579
80230,497311,29171,239186,18316,468140,16484,7905,8579
80235,497342,29173,239199,18317,468169,16484,7905,8579
80240,497373,29175,239209,18317,468198,16484,7905,8579
80245,497404,29177,239225,18318,468227,16484,7905,8579
80250,497435,29179,239243,18320,468256,16484,7905,8579
80255,497466,29181,239257,18321,468285,16484,7905,8579
80260,497497,29183,239269,18322,468314,16484,7905,8579
80265,497528,29186,239286,18323,468342,16484,7905,8579
80270,497559,29188,239295,18323,468371,16484,7905,8579
80275,497590,29190,239311,18324,468400,16484,7905,8579
80280,497621,29192,239328,18326,468429,16484,7905,8579
80285,497652,29194,239346,18326,468458,16484,7905,8579
80290,497683,29196,239359,18326,468487,16484,7905,8579
80295,497714,29198,239374,18328,468516,16484,7905,8579
80300,497745,29200,239390,18329,468545,16484,7905,8579
80305,497776,29202,239406,18330,468574,16484,7905,8579
80310,497807,29204,239424,18331,468603,16484,7905,8579
80315,497838,29206,239434,18332,468632,16484,7905,8579
80320,497869,29208,239449,18332,468661,16484,7905,8579
80325,497900,29210,239467,18333,468690,16484,7905,8579
80330,497931,29212,239482,18334,468719,16484,7905,8579
80335,497962,29215,239502,18336,468747,16484,7905,8579
80340,497993,29219,239517,18338,468774,16484,7905,8579
80345,498024,29222,239528,18339,468802,16484,7905,8579
80350,498055,29225,239544,18340,468830,16484,7905,8579
80355,498086,29228,239557,18342,468857,16484,7905,8579
80360,498117,29233,239572,18344,468883,16484,7905,8579
80365,498148,29238,239593,18346,468909,16484,7905,8579
80370,498179,29243,239611,18349,468935,16484,7905,8579
80375,498210,29247,239627,18352,468963,16484,7905,8579
80380,498241,29250,239646,18355,468991,16484,7905,8579
80385,498272,29252,239656,18355,469020,16484,7905,8579
80390,498303,29253,239669,18355,469049,16484,7905,8579
80395,498334,29255,239683,18356,469079,16484,7905,8579
80400,498365,29256,239696,18356,469109,16484,7905,8579
80405,498396,29257,239713,18357,469139,16484,7905,8579
80410,498427,29258,239730,18358,469169,16484,7905,8579
80415,498458,29259,239744,18358,469199,16484,7905,8579
80420,498489,29260,239756,18358,469229,16484,7905,8579
80425,498520,29261,239766,18358,469259,16484,7905,8579
80430,498551,29262,239781,18359,469289,16484,7905,8579
80435,498582,29263,239798,18360,469319,16484,7905,8579
80440,498613,29264,239810,18360,469349,16484,7905,8579
80445,498644,29265,239824,18361,469379,16484,7905,8579
80450,498675,29266,239835,18362,469409,16484,7905,8579
80455,498706,29267,239852,18363,469439,16484,7905,8579
80460,498737,29268,239869,18363,469469,16484,7905,8579
80465,498768,29269,239884,18363,469499,16484,7905,8579
80470,498799,29270,239896,18364,469529,16484,7905,8579
80475,498830,29271,239912,18364,469559,16484,7905,8579
80480,498861,29274,239929,18365,469587,16484,7905,8579
80485,498892,29277,239946,18367,469615,16484,7905,8579
80490,498923,29279,239958,18368,469644,16484,7905,8579
80495,498954,29282,239971,18368,469672,16484,7905,8579
80500,498985,29286,239985,18369,469699,16484,7905,8579
80505,499016,29290,240004,18372,469726,16484,7905,8579
80510,499047,29295,240018,18375,469752,16484,7905,8579
80515,499078,29299,240036,18379,469779,16484,7905,8579
80520,499109,29302,240051,18381,469807,16484,7905,8579
80525,499140,29305,240062,18381,469834,16484,7905,8579
80530,499171,29310,240075,18384,469860,16484,7905,8579
80535,499202,29315,240093,18388,469887,16484,7905,8579
80540,499233,29319,240109,18390,469913,16484,7905,8579
80545,499264,29324,240123,18393,469939,16484,7905,8579
80550,499295,29327,240139,18395,469967,16484,7905,8579
80555,499326,29330,240154,18397,469996,16484,7905,8579
80560,499357,29332,240171,18399,470025,16484,7905,8579
80565,499388,29334,240189,18400,470054,16484,7905,8579
80570,499419,29336,240203,18402,470083,16484,7905,8579
80575,499450,29338,240217,18403,470112,16484,7905,8579
80580,499481,29340,240229,18404,470141,16484,7905,8579
80585,499512,29342,240247,18404,470170,16484,7905,8579
80590,499543,29344,240265,18406,470199,16484,7905,8579
80595,499574,29346,240280,18408,470228,16484,7905,8579
80600,499605,29348,240295,18409,470257,16484,7905,8579
80605,499636,29350,240312,18411,470286,16484,7905,8579
80610,499667,29352,240328,18411,470315,16484,7905,8579
80615,499698,29354,240347,18412,470344,16484,7905,8579
80620,499729,29356,240359,18412,470373,16484,7905,8579
80625,499760,29358,240377,18413,470402,16484,7905,8579
80630,499791,29361,240394,18415,470430,16484,7905,8579
80635,499822,29363,240412,18417,470459,16484,7905,8579
80640,499853,29364,240428,18417,470489,16484,7905,8579
80645,499884,29364,240447,18417,470520,16484,7905,8579
80650,499915,29364,240460,18417,470551,16484,7905,8579
80655,499946,29364,240479,18417,470582,16484,7905,8579
80660,499977,29364,240492,18417,470613,16484,7905,8579
80665,500008,29364,240503,18417,470644,16484,7905,8579
80670,500039,29364,240522,18417,470675,16484,7905,8579
80675,500070,29364,240535,18417,470706,16484,7905,8579
80680,500101,29364,240551,18417,470737,16484,7905,8579
80685,500132,29364,240565,18417,470768,16484,7905,8579
80690,500163,29365,240582,18417,470798,16484,7905,8579
80695,500194,29366,240599,18418,470828,16484,7905,8579
80700,500225,29367,240615,18418,470858,16484,7905,8579
80705,500256,29371,240625,18420,470885,16484,7905,8579
80710,500287,29374,240643,18422,470913,16484,7905,8579
80715,500318,29377,240655,18423,470941,16484,7905,8579
80720,500349,29380,240672,18425,470969,16484,7905,8579
80725,500380,29383,240689,18426,470997,16484,7905,8579
80730,500411,29386,240706,18426,471025,16484,7905,8579
80735,500442,29389,240720,18428,471053,16484,7905,8579
80740,500473,29392,240734,18429,471081,16484,7905,8579
80745,500504,29395,240750,18429,471109,16484,7905,8579
80750,500535,29398,240761,18431,471137,16484,7905,8579
80755,500566,29401,240775,18432,471165,16484,7905,8579
80760,500597,29404,240789,18433,471193,16484,7905,8579
80765,500628,29407,240809,18434,471221,16484,7905,8579
80770,500659,29410,240820,18434,471249,16484,7905,8579
80775,500690,29413,240836,18436,471277,16484,7905,8579
80780,500721,29416,240851,18438,471305,16484,7905,8579
80785,500752,29419,240864,18440,471333,16484,7905,8579
80790,500783,29422,240879,18441,471361,16484,7905,8579
80795,500814,29425,240892,18443,471389,16484,7905,8579
80800,500845,29429,240911,18447,471416,16484,7905,8579
80805,500876,29432,240920,18447,471444,16484,7905,8579
80810,500907,29435,240937,18448,471471,16484,7905,8579
80815,500938,29441,240953,18452,471497,16484,7905,8579
80820,500969,29444,240971,18454,471525,16484,7905,8579
80825,501000,29445,240986,18455,471555,16484,7905,8579
80830,501031,29446,240997,18456,471585,16484,7905,8579
80835,501062,29447,241014,18456,471614,16484,7905,8579
80840,501093,29449,241026,18458,471644,16484,7905,8579
80845,501124,29450,241043,18458,471673,16484,7905,8579
80850,501155,29452,241058,18459,471703,16484,7905,8579
80855,501186,29453,241069,18459,471733,16484,7905,8579
80860,501217,29454,241083,18459,471763,16484,7905,8579
80865,501248,29455,241097,18460,471793,16484,7905,8579
80870,501279,29456,241112,18461,471823,16484,7905,8579
80875,501310,29457,241131,18462,471853,16484,7905,8579
80880,501341,29458,241142,18463,471883,16484,7905,8579
80885,501372,29459,241161,18464,471913,16484,7905,8579
80890,501403,29460,241177,18465,471943,16484,7905,8579
80895,501434,29461,241190,18465,471973,16484,7905,8579
80900,501465,29462,241207,18465,472003,16484,7905,8579
80905,501496,29463,241222,18465,472033,16484,7905,8579
80910,501527,29464,241240,18465,472063,16484,7905,8579
80915,501558,29465,241251,18466,472093,16484,7905,8579
80920,501589,29466,241267,18467,472123,16484,7905,8579
80925,501620,29468,241280,18468,472152,16484,7905,8579
80930,501651,29470,241296,18468,472181,16484,7905,8579
80935,501682,29474,241310,18470,472208,16484,7905,8579
80940,501713,29477,241324,18472,472236,16484,7905,8579
80945,501744,29480,241343,18475,472264,16484,7905,8579
80950,501775,29482,241360,18477,472293,16484,7905,8579
80955,501806,29484,241377,18479,472321,16484,7905,8579
80960,501837,29487,241387,18481,472350,16484,7905,8579
80965,501868,29489,241405,18482,472379,16484,7905,8579
80970,501899,29491,241422,18484,472408,16484,7905,8579
80975,501930,29493,241437,18485,472436,16484,7905,8579
80980,501961,29496,241451,18487,472464,16484,7905,8579
80985,501992,29499,241465,18489,472492,16484,7905,8579
80990,502023,29502,241483,18492,472521,16484,7905,8579
80995,502054,29504,241498,18494,472549,16484,7905,8579
81000,502085,29507,241515,18495,472578,16484,7905,8579
81005,502116,29511,241530,18496,472604,16484,7905,8579
81010,502147,29515,241544,18498,472631,16484,7905,8579
81015,502178,29518,241563,18501,472660,16484,7905,8579
81020,502209,29520,241580,18502,472688,16484,7905,8579
81025,502240,29523,241591,18504,472717,16484,7905,8579
81030,502271,29525,241609,18505,472745,16484,7905,8579
81035,502302,29528,241627,18508,472774,16484,7905,8579
81040,502333,29530,241650,18510,472802,16484,7905,8579
81045,502364,29534,241669,18513,472830,16484,7905,8579
81050,502395,29536,241686,18513,472858,16484,7905,8579
81055,502426,29540,241705,18515,472885,16484,7905,8579
81060,502457,29544,241718,18518,472913,16484,7905,8579
81065,502488,29547,241734,18520,472941,16484,7905,8579
81070,502519,29550,241753,18522,472969,16484,7905,8579
81075,502550,29553,241769,18524,472997,16484,7905,8579
81080,502581,29556,241781,18524,473025,16484,7905,8579
81085,502612,29559,241795,18525,473053,16484,7905,8579
81090,502643,29562,241811,18527,473081,16484,7905,8579
81095,502674,29565,241827,18528,473109,16484,7905,8579
81100,502705,29568,241844,18529,473137,16484,7905,8579
81105,502736,29571,241859,18530,473165,16484,7905,8579
81110,502767,29574,241875,18530,473193,16484,7905,8579
81115,502798,29577,241895,18532,473221,16484,7905,8579
81120,502829,29580,241909,18534,473249,16484,7905,8579
81125,502860,29581,241925,18535,473279,16484,7905,8579
81130,502891,29582,241940,18535,473309,16484,7905,8579
81135,502922,29584,241956,18536,473338,16484,7905,8579
81140,502953,29584,241969,18536,473369,16484,7905,8579
81145,502984,29584,241986,18536,473400,16484,7905,8579
81150,503015,29584,242001,18536,473431,16484,7905,8579
81155,503046,29584,242010,18536,473462,16484,7905,8579
81160,503077,29584,242027,18536,473493,16484,7905,8579
81165,503108,29584,242045,18536,473524,16484,7905,8579
81170,503139,29584,242060,18536,473555,16484,7905,8579
81175,503170,29584,242077,18536,473586,16484,7905,8579
81180,503201,29584,242092,18536,473617,16484,7905,8579
81185,503232,29585,242103,18537,473647,16484,7905,8579
81190,503263,29586,242118,18537,473677,16484,7905,8579
81195,503294,29587,242134,18538,473707,16484,7905,8579
81200,503325,29588,242149,18538,473737,16484,7905,8579
81205,503356,29589,242164,18538,473767,16484,7905,8579
81210,503387,29590,242177,18539,473797,16484,7905,8579
81215,503418,29591,242194,18539,473827,16484,7905,8579
81220,503449,29592,242206,18540,473857,16484,7905,8579
81225,503480,29593,242226,18541,473887,16484,7905,8579
81230,503511,29595,242243,18541,473916,16484,7905,8579
81235,503542,29597,242261,18542,473945,16484,7905,8579
81240,503573,29599,242279,18542,473974,16484,7905,8579
81245,503604,29602,242292,18543,474002,16484,7905,8579
81250,503635,29605,242308,18544,474030,16484,7905,8579
81255,503666,29608,242320,18544,474058,16484,7905,8579
81260,503697,29611,242337,18546,474086,16484,7905,8579
81265,503728,29614,242350,18546,474114,16484,7905,8579
81270,503759,29617,242360,18546,474142,16484,7905,8579
81275,503790,29620,242382,18549,474170,16484,7905,8579
81280,503821,29625,242395,18551,474196,16484,7905,8579
81285,503852,29628,242405,18553,474224,16484,7905,8579
81290,503883,29632,242417,18556,474251,16484,7905,8579
81295,503914,29636,242434,18558,474278,16484,7905,8579
81300,503945,29640,242452,18560,474305,16484,7905,8579
81305,503976,29643,242466,18562,474332,16484,7905,8579
81310,504007,29647,242482,18565,474359,16484,7905,8579
81315,504038,29651,242498,18568,474387,16484,7905,8579
81320,504069,29654,242513,18570,474414,16484,7905,8579
81325,504100,29658,242533,18572,474441,16484,7905,8579
81330,504131,29662,242548,18574,474469,16484,7905,8579
81335,504162,29665,242564,18576,474497,16484,7905,8579
81340,504193,29668,242585,18578,474524,16484,7905,8579
81345,504224,29672,242602,18581,474551,16484,7905,8579
81350,504255,29674,242617,18582,474581,16484,7905,8579
81355,504286,29675,242635,18583,474611,16484,7905,8579
81360,504317,29676,242652,18583,474641,16484,7905,8579
81365,504348,29677,242671,18584,474671,16484,7905,8579
81370,504379,29678,242680,18585,474701,16484,7905,8579
81375,504410,29679,242692,18586,474731,16484,7905,8579
81380,504441,29680,242710,18586,474761,16484,7905,8579
81385,504472,29681,242718,18586,474791,16484,7905,8579
81390,504503,29682,242733,18587,474821,16484,7905,8579
81395,504534,29683,242747,18588,474851,16484,7905,8579
81400,504565,29685,242763,18590,474880,16484,7905,8579
81405,504596,29686,242776,18590,474910,16484,7905,8579
81410,504627,29688,242789,18591,474939,16484,7905,8579
81415,504658,29689,242800,18592,474969,16484,7905,8579
81420,504689,29691,242816,18594,474998,16484,7905,8579
81425,504720,29693,242833,18595,475027,16484,7905,8579
81430,504751,29695,242848,18596,475056,16484,7905,8579
81435,504782,29698,242867,18598,475084,16484,7905,8579
81440,504813,29700,242884,18600,475113,16484,7905,8579
81445,504844,29703,242901,18602,475141,16484,7905,8579
81450,504875,29705,242915,18602,475170,16484,7905,8579
81455,504906,29707,242929,18603,475199,16484,7905,8579
81460,504937,29709,242939,18603,475228,16484,7905,8579
81465,504968,29712,242952,18605,475255,16484,7905,8579
81470,504999,29716,242964,18607,475283,16484,7905,8579
81475,505030,29718,242975,18608,475311,16484,7905,8579
81480,505061,29722,242991,18611,475338,16484,7905,8579
81485,505092,29725,243006,18613,475367,16484,7905,8579
81490,505123,29726,243018,18613,475397,16484,7905,8579
81495,505154,29727,243032,18614,475427,16484,7905,8579
81500,505185,29728,243051,18615,475457,16484,7905,8579
81505,505216,29729,243066,18615,475487,16484,7905,8579
81510,505247,29730,243082,18616,475517,16484,7905,8579
81515,505278,29732,243095,18618,475546,16484,7905,8579
81520,505309,29733,243110,18619,475576,16484,7905,8579
81525,505340,29734,243127,18620,475606,16484,7905,8579
81530,505371,29736,243139,18622,475635,16484,7905,8579
81535,505402,29738,243148,18624,475664,16484,7905,8579
81540,505433,29740,243159,18626,475693,16484,7905,8579
81545,505464,29741,243172,18627,475723,16484,7905,8579
81550,505495,29742,243189,18628,475753,16484,7905,8579
81555,505526,29743,243207,18628,475783,16484,7905,8579
81560,505557,29744,243221,18628,475813,16484,7905,8579
81565,505588,29745,243239,18629,475843,16484,7905,8579
81570,505619,29746,243259,18630,475873,16484,7905,8579
81575,505650,29747,243272,18630,475903,16484,7905,8579
81580,505681,29748,243286,18630,475933,16484,7905,8579
81585,505712,29749,243302,18630,475963,16484,7905,8579
81590,505743,29751,243319,18630,475992,16484,7905,8579
81595,505774,29754,243340,18631,476020,16484,7905,8579
81600,505805,29756,243358,18632,476049,16484,7905,8579
81605,505836,29759,243377,18634,476077,16484,7905,8579
81610,505867,29762,243391,18636,476105,16484,7905,8579
81615,505898,29765,243406,18637,476133,16484,7905,8579
81620,505929,29768,243417,18637,476161,16484,7905,8579
81625,505960,29771,243436,18640,476189,16484,7905,8579
81630,505991,29774,243453,18642,476217,16484,7905,8579
81635,506022,29777,243464,18642,476245,16484,7905,8579
81640,506053,29780,243473,18643,476273,16484,7905,8579
81645,506084,29783,243486,18645,476301,16484,7905,8579
81650,506115,29786,243502,18648,476329,16484,7905,8579
81655,506146,29790,243516,18650,476355,16484,7905,8579
81660,506177,29794,243527,18652,476383,16484,7905,8579
81665,506208,29796,243542,18654,476411,16484,7905,8579
81670,506239,29798,243558,18656,476440,16484,7905,8579
81675,506270,29800,243574,18658,476470,16484,7905,8579
81680,506301,29801,243592,18658,476500,16484,7905,8579
81685,506332,29802,243604,18658,476530,16484,7905,8579
81690,506363,29803,243618,18659,476559,16484,7905,8579
81695,506394,29805,243632,18661,476589,16484,7905,8579
81700,506425,29806,243648,18661,476618,16484,7905,8579
81705,506456,29808,243661,18662,476648,16484,7905,8579
81710,506487,29809,243674,18663,476678,16484,7905,8579
81715,506518,29810,243687,18664,476707,16484,7905,8579
81720,506549,29812,243704,18665,476736,16484,7905,8579
81725,506580,29814,243718,18667,476765,16484,7905,8579
81730,506611,29816,243732,18668,476794,16484,7905,8579
81735,506642,29818,243747,18669,476824,16484,7905,8579
81740,506673,29818,243761,18669,476855,16484,7905,8579
81745,506704,29818,243775,18669,476886,16484,7905,8579
81750,506735,29818,243794,18669,476917,16484,7905,8579
81755,506766,29818,243809,18669,476948,16484,7905,8579
81760,506797,29818,243828,18669,476979,16484,7905,8579
81765,506828,29819,243842,18669,477009,16484,7905,8579
81770,506859,29822,243856,18671,477037,16484,7905,8579
81775,506890,29824,243869,18673,477066,16484,7905,8579
81780,506921,29827,243885,18676,477094,16484,7905,8579
81785,506952,29832,243902,18680,477120,16484,7905,8579
81790,506983,29836,243916,18683,477147,16484,7905,8579
81795,507014,29839,243929,18684,477175,16484,7905,8579
81800,507045,29842,243947,18686,477203,16484,7905,8579
81805,507076,29845,243964,18688,477231,16484,7905,8579
81810,507107,29848,243979,18690,477259,16484,7905,8579
81815,507138,29851,243999,18692,477287,16484,7905,8579
81820,507169,29854,244014,18694,477315,16484,7905,8579
81825,507200,29857,244026,18694,477343,16484,7905,8579
81830,507231,29860,244037,18695,477371,16484,7905,8579
81835,507262,29863,244047,18697,477399,16484,7905,8579
81840,507293,29866,244061,18698,477427,16484,7905,8579
81845,507324,29869,244071,18698,477455,16484,7905,8579
81850,507355,29872,244086,18699,477483,16484,7905,8579
81855,507386,29875,244098,18700,477511,16484,7905,8579
81860,507417,29878,244114,18701,477539,16484,7905,8579
81865,507448,29881,244128,18701,477567,16484,7905,8579
81870,507479,29884,244145,18702,477595,16484,7905,8579
81875,507510,29887,244160,18705,477622,16484,7905,8579
81880,507541,29891,244168,18708,477650,16484,7905,8579
81885,507572,29894,244188,18709,477678,16484,7905,8579
81890,507603,29897,244199,18711,477706,16484,7905,8579
81895,507634,29902,244213,18715,477732,16484,7905,8579
81900,507665,29905,244228,18717,477759,16484,7905,8579
81905,507696,29909,244245,18721,477787,16484,7905,8579
81910,507727,29910,244261,18721,477817,16484,7905,8579
81915,507758,29911,244278,18721,477847,16484,7905,8579
81920,507789,29912,244292,18722,477877,16484,7905,8579
81925,507820,29913,244306,18723,477907,16484,7905,8579
81930,507851,29914,244321,18724,477937,16484,7905,8579
81935,507882,29915,244334,18724,477967,16484,7905,8579
81940,507913,29916,244348,18725,477997,16484,7905,8579
81945,507944,29917,244362,18726,478027,16484,7905,8579
81950,507975,29918,244380,18727,478057,16484,7905,8579
81955,508006,29919,244394,18727,478087,16484,7905,8579
81960,508037,29920,244406,18727,478117,16484,7905,8579
81965,508068,29922,244415,18727,478146,16484,7905,8579
81970,508099,29924,244435,18729,478175,16484,7905,8579
81975,508130,29926,244450,18730,478204,16484,7905,8579
81980,508161,29928,244469,18731,478233,16484,7905,8579
81985,508192,29930,244482,18732,478262,16484,7905,8579
81990,508223,29932,244496,18733,478291,16484,7905,8579
81995,508254,29934,244512,18734,478320,16484,7905,8579
82000,508285,29936,244526,18735,478349,16484,7905,8579
82005,508316,29938,244541,18736,478378,16484,7905,8579
82010,508347,29941,244556,18737,478406,16484,7905,8579
82015,508378,29944,244573,18737,478434,16484,7905,8579
82020,508409,29948,244594,18739,478461,16484,7905,8579
82025,508440,29951,244604,18741,478489,16484,7905,8579
82030,508471,29953,244620,18742,478518,16484,7905,8579
82035,508502,29955,244636,18743,478547,16484,7905,8579
82040,508533,29957,244656,18745,478576,16484,7905,8579
82045,508564,29959,244666,18745,478604,16484,7905,8579
82050,508595,29962,244681,18747,478632,16484,7905,8579
82055,508626,29965,244701,18750,478660,16484,7905,8579
82060,508657,29967,244716,18752,478689,16484,7905,8579
82065,508688,29969,244728,18753,478719,16484,7905,8579
82070,508719,29970,244735,18753,478749,16484,7905,8579
82075,508750,29971,244752,18753,478778,16484,7905,8579
82080,508781,29973,244769,18755,478808,16484,7905,8579
82085,508812,29974,244786,18755,478838,16484,7905,8579
82090,508843,29975,244801,18756,478868,16484,7905,8579
82095,508874,29977,244818,18758,478897,16484,7905,8579
82100,508905,29978,244833,18759,478927,16484,7905,8579
82105,508936,29980,244849,18760,478955,16484,7905,8579
82110,508967,29983,244860,18762,478984,16484,7905,8579
82115,508998,29985,244876,18764,479013,16484,7905,8579
82120,509029,29987,244889,18765,479042,16484,7905,8579
82125,509060,29987,244904,18765,479073,16484,7905,8579
82130,509091,29988,244920,18766,479103,16484,7905,8579
82135,509122,29989,244939,18766,479133,16484,7905,8579
82140,509153,29990,244960,18767,479163,16484,7905,8579
82145,509184,29992,244973,18768,479192,16484,7905,8579
82150,509215,29994,244991,18769,479221,16484,7905,8579
82155,509246,29996,245004,18769,479250,16484,7905,8579
82160,509277,29998,245016,18769,479279,16484,7905,8579
82165,509308,30000,245032,18770,479308,16484,7905,8579
82170,509339,30002,245045,18770,479337,16484,7905,8579
82175,509370,30004,245061,18771,479366,16484,7905,8579
82180,509401,30006,245074,18773,479395,16484,7905,8579
82185,509432,30008,245093,18774,479424,16484,7905,8579
82190,509463,30010,245107,18774,479453,16484,7905,8579
82195,509494,30012,245120,18774,479482,16484,7905,8579
82200,509525,30014,245134,18774,479511,16484,7905,8579
82205,509556,30017,245147,18777,479539,16484,7905,8579
82210,509587,30019,245158,18777,479567,16484,7905,8579
82215,509618,30023,245171,18781,479595,16484,7905,8579
82220,509649,30025,245189,18782,479624,16484,7905,8579
82225,509680,30027,245208,18783,479653,16484,7905,8579
82230,509711,30031,245223,18784,479680,16484,7905,8579
82235,509742,30035,245234,18786,479707,16484,7905,8579
82240,509773,30038,245250,18786,479735,16484,7905,8579
82245,509804,30041,245261,18789,479763,16484,7905,8579
82250,509835,30044,245271,18790,479791,16484,7905,8579
82255,509866,30048,245285,18791,479818,16484,7905,8579
82260,509897,30051,245303,18793,479846,16484,7905,8579
82265,509928,30053,245322,18794,479875,16484,7905,8579
82270,509959,30055,245337,18794,479904,16484,7905,8579
82275,509990,30057,245352,18794,479933,16484,7905,8579
82280,510021,30059,245369,18795,479962,16484,7905,8579
82285,510052,30061,245383,18796,479991,16484,7905,8579
82290,510083,30063,245398,18796,480020,16484,7905,8579
82295,510114,30065,245413,18797,480049,16484,7905,8579
82300,510145,30067,245429,18798,480078,16484,7905,8579
82305,510176,30069,245439,18799,480107,16484,7905,8579
82310,510207,30071,245453,18799,480136,16484,7905,8579
82315,510238,30073,245469,18800,480165,16484,7905,8579
82320,510269,30075,245485,18801,480193,16484,7905,8579
82325,510300,30079,245501,18804,480220,16484,7905,8579
82330,510331,30082,245519,18805,480248,16484,7905,8579
82335,510362,30085,245536,18806,480276,16484,7905,8579
82340,510393,30088,245550,18809,480305,16484,7905,8579
82345,510424,30090,245569,18810,480333,16484,7905,8579
82350,510455,30093,245587,18812,480361,16484,7905,8579
82355,510486,30096,245602,18814,480389,16484,7905,8579
82360,510517,30099,245620,18816,480417,16484,7905,8579
82365,510548,30102,245632,18818,480446,16484,7905,8579
82370,510579,30104,245648,18819,480475,16484,7905,8579
82375,510610,30106,245664,18820,480503,16484,7905,8579
82380,510641,30111,245685,18823,480529,16484,7905,8579
82385,510672,30113,245698,18825,480559,16484,7905,8579
82390,510703,30114,245714,18825,480589,16484,7905,8579
82395,510734,30115,245729,18826,480619,16484,7905,8579
82400,510765,30116,245742,18826,480649,16484,7905,8579
82405,510796,30117,245758,18827,480679,16484,7905,8579
82410,510827,30118,245773,18827,480709,16484,7905,8579
82415,510858,30119,245790,18827,480739,16484,7905,8579
82420,510889,30120,245803,18827,480769,16484,7905,8579
82425,510920,30121,245815,18828,480799,16484,7905,8579
82430,510951,30122,245827,18829,480829,16484,7905,8579
82435,510982,30123,245837,18829,480859,16484,7905,8579
82440,511013,30124,245856,18830,480889,16484,7905,8579
82445,511044,30126,245871,18831,480918,16484,7905,8579
82450,511075,30128,245893,18833,480947,16484,7905,8579
82455,511106,30130,245903,18833,480976,16484,7905,8579
82460,511137,30132,245916,18835,481005,16484,7905,8579
82465,511168,30134,245930,18835,481034,16484,7905,8579
82470,511199,30136,245945,18835,481063,16484,7905,8579
82475,511230,30138,245957,18835,481092,16484,7905,8579
82480,511261,30140,245971,18836,481121,16484,7905,8579
82485,511292,30142,245985,18836,481150,16484,7905,8579
82490,511323,30145,245993,18836,481178,16484,7905,8579
82495,511354,30150,246009,18840,481203,16484,7905,8579
82500,511385,30156,246027,18844,481229,16484,7905,8579
82505,511416,30158,246040,18845,481257,16484,7905,8579
82510,511447,30161,246054,18847,481286,16484,7905,8579
82515,511478,30163,246070,18849,481315,16484,7905,8579
82520,511509,30164,246083,18850,481344,16484,7905,8579
82525,511540,30166,246099,18851,481374,16484,7905,8579
82530,511571,30167,246108,18851,481404,16484,7905,8579
82535,511602,30168,246125,18852,481434,16484,7905,8579
82540,511633,30169,246138,18852,481464,16484,7905,8579
82545,511664,30170,246155,18853,481494,16484,7905,8579
82550,511695,30171,246169,18853,481524,16484,7905,8579
82555,511726,30172,246187,18854,481554,16484,7905,8579
82560,511757,30173,246208,18855,481584,16484,7905,8579
82565,511788,30174,246225,18855,481614,16484,7905,8579
82570,511819,30175,246236,18855,481644,16484,7905,8579
82575,511850,30176,246252,18855,481674,16484,7905,8579
82580,511881,30177,246265,18856,481704,16484,7905,8579
82585,511912,30178,246279,18856,481734,16484,7905,8579
82590,511943,30179,246288,18856,481764,16484,7905,8579
82595,511974,30180,246301,18857,481794,16484,7905,8579
82600,512005,30181,246317,18858,481824,16484,7905,8579
82605,512036,30183,246331,18860,481853,16484,7905,8579
82610,512067,30186,246345,18860,481881,16484,7905,8579
82615,512098,30189,246359,18862,481909,16484,7905,8579
82620,512129,30192,246367,18864,481937,16484,7905,8579
82625,512160,30195,246380,18865,481965,16484,7905,8579
82630,512191,30200,246392,18868,481990,16484,7905,8579
82635,512222,30205,246407,18871,482017,16484,7905,8579
82640,512253,30208,246422,18873,482044,16484,7905,8579
82645,512284,30211,246437,18875,482072,16484,7905,8579
82650,512315,30214,246448,18876,482100,16484,7905,8579
82655,512346,30217,246461,18878,482129,16484,7905,8579
82660,512377,30219,246475,18880,482158,16484,7905,8579
82665,512408,30221,246487,18880,482187,16484,7905,8579
82670,512439,30223,246499,18882,482216,16484,7905,8579
82675,512470,30225,246518,18883,482244,16484,7905,8579
82680,512501,30228,246535,18885,482272,16484,7905,8579
82685,512532,30231,246549,18887,482300,16484,7905,8579
82690,512563,30234,246563,18888,482329,16484,7905,8579
82695,512594,30236,246578,18889,482358,16484,7905,8579
82700,512625,30238,246592,18889,482387,16484,7905,8579
82705,512656,30240,246612,18890,482416,16484,7905,8579
82710,512687,30242,246624,18891,482445,16484,7905,8579
82715,512718,30244,246640,18892,482474,16484,7905,8579
82720,512749,30246,246656,18894,482503,16484,7905,8579
82725,512780,30248,246665,18894,482532,16484,7905,8579
82730,512811,30250,246678,18895,482561,16484,7905,8579
82735,512842,30252,246690,18897,482590,16484,7905,8579
82740,512873,30255,246704,18898,482618,16484,7905,8579
82745,512904,30256,246716,18898,482648,16484,7905,8579
82750,512935,30258,246732,18900,482677,16484,7905,8579
82755,512966,30259,246750,18900,482707,16484,7905,8579
82760,512997,30260,246766,18901,482737,16484,7905,8579
82765,513028,30261,246777,18901,482767,16484,7905,8579
82770,513059,30262,246793,18901,482797,16484,7905,8579
82775,513090,30263,246813,18902,482827,16484,7905,8579
82780,513121,30264,246830,18903,482857,16484,7905,8579
82785,513152,30265,246843,18903,482887,16484,7905,8579
82790,513183,30266,246861,18903,482917,16484,7905,8579
82795,513214,30267,246881,18904,482947,16484,7905,8579
82800,513245,30268,246893,18904,482977,16484,7905,8579
82805,513276,30272,246907,18907,483003,16484,7905,8579
82810,513307,30277,246925,18911,483029,16484,7905,8579
82815,513338,30281,246937,18913,483057,16484,7905,8579
82820,513369,30284,246953,18914,483085,16484,7905,8579
82825,513400,30287,246967,18916,483113,16484,7905,8579
82830,513431,30290,246979,18917,483141,16484,7905,8579
82835,513462,30293,246993,18918,483169,16484,7905,8579
82840,513493,30296,247005,18920,483196,16484,7905,8579
82845,513524,30300,247020,18923,483224,16484,7905,8579
82850,513555,30303,247036,18924,483251,16484,7905,8579
82855,513586,30307,247053,18928,483278,16484,7905,8579
82860,513617,30311,247069,18930,483305,16484,7905,8579
82865,513648,30314,247086,18932,483334,16484,7905,8579
82870,513679,30316,247101,18934,483363,16484,7905,8579
82875,513710,30318,247114,18935,483392,16484,7905,8579
82880,513741,30320,247125,18936,483421,16484,7905,8579
82885,513772,30322,247139,18938,483450,16484,7905,8579
82890,513803,30324,247156,18939,483479,16484,7905,8579
82895,513834,30326,247172,18940,483508,16484,7905,8579
82900,513865,30328,247187,18940,483537,16484,7905,8579
82905,513896,30331,247202,18942,483565,16484,7905,8579
82910,513927,30332,247216,18942,483595,16484,7905,8579
82915,513958,30333,247229,18943,483625,16484,7905,8579
82920,513989,30334,247244,18944,483655,16484,7905,8579
82925,514020,30335,247258,18945,483685,16484,7905,8579
82930,514051,30336,247276,18945,483715,16484,7905,8579
82935,514082,30337,247294,18945,483745,16484,7905,8579
82940,514113,30338,247311,18946,483775,16484,7905,8579
82945,514144,30339,247330,18947,483805,16484,7905,8579
82950,514175,30340,247343,18947,483835,16484,7905,8579
82955,514206,30341,247355,18947,483865,16484,7905,8579
82960,514237,30342,247371,18947,483895,16484,7905,8579
82965,514268,30343,247388,18948,483925,16484,7905,8579
82970,514299,30345,247405,18948,483954,16484,7905,8579
82975,514330,30347,247420,18950,483982,16484,7905,8579
82980,514361,30350,247432,18952,484010,16484,7905,8579
82985,514392,30353,247443,18955,484038,16484,7905,8579
82990,514423,30356,247459,18957,484066,16484,7905,8579
82995,514454,30359,247479,18960,484095,16484,7905,8579
83000,514485,30361,247498,18961,484123,16484,7905,8579
83005,514516,30364,247512,18962,484151,16484,7905,8579
83010,514547,30367,247527,18963,484180,16484,7905,8579
83015,514578,30369,247545,18964,484208,16484,7905,8579
83020,514609,30372,247560,18966,484236,16484,7905,8579
83025,514640,30376,247571,18968,484264,16484,7905,8579
83030,514671,30378,247587,18970,484293,16484,7905,8579
83035,514702,30380,247602,18972,484321,16484,7905,8579
83040,514733,30383,247618,18975,484350,16484,7905,8579
83045,514764,30384,247636,18976,484380,16484,7905,8579
83050,514795,30385,247652,18976,484410,16484,7905,8579
83055,514826,30386,247664,18976,484440,16484,7905,8579
83060,514857,30387,247675,18976,484470,16484,7905,8579
83065,514888,30388,247692,18977,484500,16484,7905,8579
83070,514919,30389,247711,18978,484530,16484,7905,8579
83075,514950,30390,247723,18979,484560,16484,7905,8579
83080,514981,30391,247738,18980,484590,16484,7905,8579
83085,515012,30393,247756,18981,484619,16484,7905,8579
83090,515043,30396,247771,18983,484647,16484,7905,8579
83095,515074,30398,247788,18985,484676,16484,7905,8579
83100,515105,30401,247802,18987,484704,16484,7905,8579
83105,515136,30403,247814,18988,484733,16484,7905,8579
83110,515167,30405,247832,18989,484762,16484,7905,8579
83115,515198,30407,247846,18990,484791,16484,7905,8579
83120,515229,30409,247862,18991,484820,16484,7905,8579
83125,515260,30411,247880,18993,484849,16484,7905,8579
83130,515291,30413,247899,18994,484878,16484,7905,8579
83135,515322,30415,247913,18994,484907,16484,7905,8579
83140,515353,30417,247929,18995,484936,16484,7905,8579
83145,515384,30419,247949,18996,484964,16484,7905,8579
83150,515415,30422,247967,18998,484992,16484,7905,8579
83155,515446,30425,247984,19000,485020,16484,7905,8579
83160,515477,30428,248001,19002,485049,16484,7905,8579
83165,515508,30431,248018,19004,485076,16484,7905,8579
83170,515539,30435,248027,19007,485103,16484,7905,8579
83175,515570,30440,248042,19010,485129,16484,7905,8579
83180,515601,30444,248058,19013,485156,16484,7905,8579
83185,515632,30449,248078,19017,485182,16484,7905,8579
83190,515663,30454,248094,19021,485209,16484,7905,8579
83195,515694,30458,248107,19023,485236,16484,7905,8579
83200,515725,30461,248120,19025,485264,16484,7905,8579
83205,515756,30465,248135,19028,485291,16484,7905,8579
83210,515787,30467,248149,19030,485319,16484,7905,8579
83215,515818,30470,248165,19032,485347,16484,7905,8579
83220,515849,30472,248175,19033,485377,16484,7905,8579
83225,515880,30473,248191,19033,485407,16484,7905,8579
83230,515911,30474,248202,19033,485437,16484,7905,8579
83235,515942,30476,248217,19035,485466,16484,7905,8579
83240,515973,30477,248232,19036,485496,16484,7905,8579
83245,516004,30477,248254,19036,485527,16484,7905,8579
83250,516035,30477,248265,19036,485558,16484,7905,8579
83255,516066,30477,248281,19036,485589,16484,7905,8579
83260,516097,30477,248292,19036,485620,16484,7905,8579
83265,516128,30477,248303,19036,485651,16484,7905,8579
83270,516159,30477,248314,19036,485682,16484,7905,8579
83275,516190,30477,248331,19036,485713,16484,7905,8579
83280,516221,30477,248346,19036,485744,16484,7905,8579
83285,516252,30477,248361,19036,485775,16484,7905,8579
83290,516283,30477,248375,19036,485806,16484,7905,8579
83295,516314,30477,248389,19036,485837,16484,7905,8579
83300,516345,30477,248402,19036,485868,16484,7905,8579
83305,516376,30477,248420,19036,485899,16484,7905,8579
83310,516407,30477,248435,19036,485930,16484,7905,8579
83315,516438,30477,248452,19036,485961,16484,7905,8579
83320,516469,30477,248470,19036,485992,16484,7905,8579
83325,516500,30478,248484,19036,486022,16484,7905,8579
83330,516531,30480,248499,19036,486051,16484,7905,8579
83335,516562,30482,248521,19037,486079,16484,7905,8579
83340,516593,30485,248537,19038,486108,16484,7905,8579
83345,516624,30489,248550,19041,486134,16484,7905,8579
83350,516655,30494,248565,19045,486160,16484,7905,8579
83355,516686,30499,248581,19049,486187,16484,7905,8579
83360,516717,30503,248598,19051,486213,16484,7905,8579
83365,516748,30507,248609,19055,486241,16484,7905,8579
83370,516779,30511,248628,19058,486267,16484,7905,8579
83375,516810,30515,248641,19059,486295,16484,7905,8579
83380,516841,30518,248654,19060,486323,16484,7905,8579
83385,516872,30522,248671,19061,486350,16484,7905,8579
83390,516903,30526,248684,19063,486377,16484,7905,8579
83395,516934,30529,248704,19064,486405,16484,7905,8579
83400,516965,30533,248720,19067,486432,16484,7905,8579
83405,516996,30536,248737,19068,486460,16484,7905,8579
83410,517027,30539,248750,19070,486488,16484,7905,8579
83415,517058,30542,248764,19070,486516,16484,7905,8579
83420,517089,30545,248779,19072,486544,16484,7905,8579
83425,517120,30548,248793,19073,486572,16484,7905,8579
83430,517151,30551,248811,19074,486600,16484,7905,8579
83435,517182,30554,248824,19075,486628,16484,7905,8579
83440,517213,30557,248843,19076,486656,16484,7905,8579
83445,517244,30560,248861,19077,486684,16484,7905,8579
83450,517275,30563,248880,19077,486712,16484,7905,8579
83455,517306,30566,248894,19079,486740,16484,7905,8579
83460,517337,30570,248909,19082,486767,16484,7905,8579
83465,517368,30574,248921,19084,486794,16484,7905,8579
83470,517399,30578,248937,19085,486821,16484,7905,8579
83475,517430,30581,248951,19085,486849,16484,7905,8579
83480,517461,30584,248965,19087,486877,16484,7905,8579
83485,517492,30587,248983,19089,486905,16484,7905,8579
83490,517523,30590,248995,19090,486933,16484,7905,8579
83495,517554,30593,249009,19091,486960,16484,7905,8579
83500,517585,30597,249023,19093,486987,16484,7905,8579
83505,517616,30600,249035,19096,487015,16484,7905,8579
83510,517647,30603,249052,19099,487043,16484,7905,8579
83515,517678,30607,249068,19103,487070,16484,7905,8579
83520,517709,30611,249082,19105,487098,16484,7905,8579
83525,517740,30613,249099,19105,487126,16484,7905,8579
83530,517771,30615,249114,19107,487156,16484,7905,8579
83535,517802,30615,249124,19107,487187,16484,7905,8579
83540,517833,30615,249139,19107,487218,16484,7905,8579
83545,517864,30615,249152,19107,487249,16484,7905,8579
83550,517895,30615,249168,19107,487280,16484,7905,8579
83555,517926,30615,249185,19107,487311,16484,7905,8579
83560,517957,30615,249196,19107,487342,16484,7905,8579
83565,517988,30615,249214,19107,487373,16484,7905,8579
83570,518019,30615,249231,19107,487404,16484,7905,8579
83575,518050,30615,249246,19107,487435,16484,7905,8579
83580,518081,30615,249262,19107,487466,16484,7905,8579
83585,518112,30615,249278,19107,487497,16484,7905,8579
83590,518143,30615,249291,19107,487528,16484,7905,8579
83595,518174,30615,249305,19107,487559,16484,7905,8579
83600,518205,30615,249316,19107,487590,16484,7905,8579
83605,518236,30615,249329,19107,487621,16484,7905,8579
83610,518267,30615,249343,19107,487652,16484,7905,8579
83615,518298,30615,249360,19107,487683,16484,7905,8579
83620,518329,30615,249373,19107,487714,16484,7905,8579
83625,518360,30615,249383,19107,487745,16484,7905,8579
83630,518391,30615,249395,19107,487776,16484,7905,8579
83635,518422,30617,249409,19108,487805,16484,7905,8579
83640,518453,30621,249423,19110,487831,16484,7905,8579
83645,518484,30625,249436,19112,487858,16484,7905,8579
83650,518515,30630,249455,19116,487884,16484,7905,8579
83655,518546,30635,249473,19119,487911,16484,7905,8579
83660,518577,30638,249486,19120,487939,16484,7905,8579
83665,518608,30641,249505,19122,487967,16484,7905,8579
83670,518639,30644,249520,19125,487995,16484,7905,8579
83675,518670,30647,249537,19126,488023,16484,7905,8579
83680,518701,30650,249554,19129,488051,16484,7905,8579
83685,518732,30652,249570,19131,488080,16484,7905,8579
83690,518763,30654,249584,19131,488109,16484,7905,8579
83695,518794,30656,249597,19132,488138,16484,7905,8579
83700,518825,30658,249609,19132,488167,16484,7905,8579
83705,518856,30660,249619,19133,488196,16484,7905,8579
83710,518887,30662,249632,19133,488225,16484,7905,8579
83715,518918,30664,249651,19133,488254,16484,7905,8579
83720,518949,30666,249669,19134,488283,16484,7905,8579
83725,518980,30668,249683,19135,488312,16484,7905,8579
83730,519011,30670,249695,19136,488341,16484,7905,8579
83735,519042,30672,249715,19138,488370,16484,7905,8579
83740,519073,30674,249733,19140,488399,16484,7905,8579
83745,519104,30676,249754,19142,488428,16484,7905,8579
83750,519135,30678,249769,19144,488457,16484,7905,8579
83755,519166,30681,249782,19146,488485,16484,7905,8579
83760,519197,30682,249798,19146,488515,16484,7905,8579
83765,519228,30683,249810,19146,488545,16484,7905,8579
83770,519259,30684,249826,19146,488574,16484,7905,8579
83775,519290,30686,249840,19148,488603,16484,7905,8579
83780,519321,30688,249850,19149,488632,16484,7905,8579
83785,519352,30690,249866,19151,488661,16484,7905,8579
83790,519383,30692,249881,19152,488691,16484,7905,8579
83795,519414,30693,249896,19153,488720,16484,7905,8579
83800,519445,30694,249911,19154,488751,16484,7905,8579
83805,519476,30694,249924,19154,488782,16484,7905,8579
83810,519507,30694,249940,19154,488813,16484,7905,8579
83815,519538,30694,249955,19154,488844,16484,7905,8579
83820,519569,30694,249971,19154,488875,16484,7905,8579
83825,519600,30694,249986,19154,488906,16484,7905,8579
83830,519631,30694,249999,19154,488937,16484,7905,8579
83835,519662,30694,250014,19154,488968,16484,7905,8579
83840,519693,30694,250027,19154,488999,16484,7905,8579
83845,519724,30694,250040,19154,489030,16484,7905,8579
83850,519755,30694,250054,19154,489061,16484,7905,8579
83855,519786,30694,250069,19154,489092,16484,7905,8579
83860,519817,30694,250084,19154,489123,16484,7905,8579
83865,519848,30694,250101,19154,489154,16484,7905,8579
83870,519879,30694,250120,19154,489185,16484,7905,8579
83875,519910,30694,250137,19154,489216,16484,7905,8579
83880,519941,30694,250150,19154,489247,16484,7905,8579
83885,519972,30694,250167,19154,489278,16484,7905,8579
83890,520003,30694,250181,19154,489309,16484,7905,8579
83895,520034,30694,250198,19154,489340,16484,7905,8579
83900,520065,30694,250209,19154,489371,16484,7905,8579
83905,520096,30695,250227,19155,489401,16484,7905,8579
83910,520127,30696,250241,19156,489431,16484,7905,8579
83915,520158,30697,250256,19157,489461,16484,7905,8579
83920,520189,30698,250267,19158,489491,16484,7905,8579
83925,520220,30699,250284,19159,489521,16484,7905,8579
83930,520251,30700,250297,19160,489551,16484,7905,8579
83935,520282,30701,250307,19160,489581,16484,7905,8579
83940,520313,30702,250325,19160,489611,16484,7905,8579
83945,520344,30703,250336,19160,489640,16484,7905,8579
83950,520375,30705,250353,19162,489670,16484,7905,8579
83955,520406,30706,250365,19163,489700,16484,7905,8579
83960,520437,30707,250379,19163,489730,16484,7905,8579
83965,520468,30708,250398,19164,489759,16484,7905,8579
83970,520499,30710,250412,19165,489788,16484,7905,8579
83975,520530,30712,250424,19166,489818,16484,7905,8579
83980,520561,30713,250440,19166,489847,16484,7905,8579
83985,520592,30715,250458,19168,489877,16484,7905,8579
83990,520623,30716,250472,19169,489906,16484,7905,8579
83995,520654,30718,250487,19170,489935,16484,7905,8579
84000,520685,30720,250503,19172,489965,16484,7905,8579
84005,520716,30721,250518,19172,489994,16484,7905,8579
84010,520747,30723,250536,19174,490023,16484,7905,8579
84015,520778,30725,250547,19175,490053,16484,7905,8579
84020,520809,30726,250560,19176,490082,16484,7905,8579
84025,520840,30728,250573,19177,490112,16484,7905,8579
84030,520871,30728,250586,19177,490143,16484,7905,8579
84035,520902,30728,250599,19177,490174,16484,7905,8579
84040,520933,30728,250613,19177,490205,16484,7905,8579
84045,520964,30728,250625,19177,490236,16484,7905,8579
84050,520995,30728,250643,19177,490267,16484,7905,8579
84055,521026,30728,250658,19177,490298,16484,7905,8579
84060,521057,30728,250677,19177,490329,16484,7905,8579
84065,521088,30728,250693,19177,490360,16484,7905,8579
84070,521119,30728,250706,19177,490391,16484,7905,8579
84075,521150,30728,250720,19177,490422,16484,7905,8579
84080,521181,30728,250736,19177,490453,16484,7905,8579
84085,521212,30728,250750,19177,490484,16484,7905,8579
84090,521243,30728,250764,19177,490515,16484,7905,8579
84095,521274,30728,250784,19177,490546,16484,7905,8579
84100,521305,30728,250799,19177,490577,16484,7905,8579
84105,521336,30728,250815,19177,490608,16484,7905,8579
84110,521367,30728,250833,19177,490639,16484,7905,8579
84115,521398,30728,250851,19177,490670,16484,7905,8579
84120,521429,30728,250865,19177,490701,16484,7905,8579
84125,521460,30728,250882,19177,490732,16484,7905,8579
84130,521491,30729,250897,19177,490762,16484,7905,8579
84135,521522,30730,250914,19178,490792,16484,7905,8579
84140,521553,30731,250926,19179,490822,16484,7905,8579
84145,521584,30732,250944,19180,490852,16484,7905,8579
84150,521615,30733,250955,19180,490882,16484,7905,8579
84155,521646,30734,250970,19180,490912,16484,7905,8579
84160,521677,30735,250981,19180,490941,16484,7905,8579
84165,521708,30737,250997,19182,490971,16484,7905,8579
84170,521739,30738,251010,19183,491001,16484,7905,8579
84175,521770,30739,251025,19183,491030,16484,7905,8579
84180,521801,30741,251035,19184,491059,16484,7905,8579
84185,521832,30743,251052,19186,491089,16484,7905,8579
84190,521863,30744,251066,19187,491119,16484,7905,8579
84195,521894,30745,251081,19187,491149,16484,7905,8579
84200,521925,30746,251097,19188,491179,16484,7905,8579
84205,521956,30747,251112,19188,491209,16484,7905,8579
84210,521987,30748,251129,19189,491239,16484,7905,8579
84215,522018,30749,251145,19189,491268,16484,7905,8579
84220,522049,30751,251161,19191,491297,16484,7905,8579
84225,522080,30753,251180,19193,491326,16484,7905,8579
84230,522111,30755,251193,19195,491356,16484,7905,8579
84235,522142,30756,251210,19196,491385,16484,7905,8579
84240,522173,30758,251221,19198,491414,16484,7905,8579
84245,522204,30760,251233,19200,491444,16484,7905,8579
84250,522235,30761,251249,19200,491473,16484,7905,8579
84255,522266,30762,251266,19201,491504,16484,7905,8579
84260,522297,30762,251280,19201,491535,16484,7905,8579
84265,522328,30762,251297,19201,491566,16484,7905,8579
84270,522359,30762,251309,19201,491597,16484,7905,8579
84275,522390,30762,251326,19201,491628,16484,7905,8579
84280,522421,30762,251340,19201,491659,16484,7905,8579
84285,522452,30762,251351,19201,491690,16484,7905,8579
84290,522483,30762,251371,19201,491721,16484,7905,8579
84295,522514,30762,251384,19201,491752,16484,7905,8579
84300,522545,30762,251396,19201,491783,16484,7905,8579
84305,522576,30762,251415,19201,491814,16484,7905,8579
84310,522607,30762,251429,19201,491845,16484,7905,8579
84315,522638,30762,251443,19201,491876,16484,7905,8579
84320,522669,30762,251457,19201,491907,16484,7905,8579
84325,522700,30762,251476,19201,491938,16484,7905,8579
84330,522731,30762,251490,19201,491969,16484,7905,8579
84335,522762,30762,251513,19201,492000,16484,7905,8579
84340,522793,30762,251531,19201,492031,16484,7905,8579
84345,522824,30762,251548,19201,492062,16484,7905,8579
84350,522855,30762,251563,19201,492093,16484,7905,8579
84355,522886,30763,251581,19202,492123,16484,7905,8579
84360,522917,30764,251597,19203,492153,16484,7905,8579
84365,522948,30765,251612,19203,492183,16484,7905,8579
84370,522979,30766,251627,19203,492213,16484,7905,8579
84375,523010,30767,251644,19204,492242,16484,7905,8579
84380,523041,30769,251662,19206,492271,16484,7905,8579
84385,523072,30771,251679,19207,492300,16484,7905,8579
84390,523103,30773,251695,19209,492330,16484,7905,8579
84395,523134,30774,251714,19210,492360,16484,7905,8579
84400,523165,30775,251727,19211,492390,16484,7905,8579
84405,523196,30776,251740,19212,492420,16484,7905,8579
84410,523227,30777,251748,19213,492450,16484,7905,8579
84415,523258,30778,251760,19214,492479,16484,7905,8579
84420,523289,30780,251774,19215,492509,16484,7905,8579
84425,523320,30781,251794,19215,492538,16484,7905,8579
84430,523351,30783,251809,19216,492568,16484,7905,8579
84435,523382,30784,251819,19217,492597,16484,7905,8579
84440,523413,30786,251831,19218,492626,16484,7905,8579
84445,523444,30788,251839,19219,492656,16484,7905,8579
84450,523475,30789,251851,19219,492685,16484,7905,8579
84455,523506,30791,251866,19220,492714,16484,7905,8579
84460,523537,30793,251880,19221,492744,16484,7905,8579
84465,523568,30793,251896,19221,492775,16484,7905,8579
84470,523599,30793,251914,19221,492806,16484,7905,8579
84475,523630,30793,251929,19221,492837,16484,7905,8579
84480,523661,30793,251944,19221,492868,16484,7905,8579
84485,523692,30793,251958,19221,492899,16484,7905,8579
84490,523723,30793,251972,19221,492930,16484,7905,8579
84495,523754,30793,251985,19221,492961,16484,7905,8579
84500,523785,30793,251999,19221,492992,16484,7905,8579
84505,523816,30793,252013,19221,493023,16484,7905,8579
84510,523847,30793,252028,19221,493054,16484,7905,8579
84515,523878,30793,252043,19221,493085,16484,7905,8579
84520,523909,30793,252060,19221,493116,16484,7905,8579
84525,523940,30793,252077,19221,493147,16484,7905,8579
84530,523971,30793,252088,19221,493178,16484,7905,8579
84535,524002,30793,252101,19221,493209,16484,7905,8579
84540,524033,30793,252114,19221,493240,16484,7905,8579
84545,524064,30793,252129,19221,493271,16484,7905,8579
84550,524095,30793,252146,19221,493302,16484,7905,8579
84555,524126,30793,252165,19221,493333,16484,7905,8579
84560,524157,30793,252181,19221,493364,16484,7905,8579
84565,524188,30793,252196,19221,493395,16484,7905,8579
84570,524219,30794,252208,19222,493425,16484,7905,8579
84575,524250,30795,252219,19222,493455,16484,7905,8579
84580,524281,30796,252233,19223,493485,16484,7905,8579
84585,524312,30797,252250,19224,493514,16484,7905,8579
84590,524343,30799,252265,19225,493544,16484,7905,8579
84595,524374,30800,252274,19225,493574,16484,7905,8579
84600,524405,30801,252290,19225,493604,16484,7905,8579
84605,524436,30802,252303,19225,493633,16484,7905,8579
84610,524467,30804,252316,19226,493663,16484,7905,8579
84615,524498,30805,252335,19227,493693,16484,7905,8579
84620,524529,30806,252350,19227,493722,16484,7905,8579
84625,524560,30808,252362,19228,493751,16484,7905,8579
84630,524591,30810,252381,19230,493781,16484,7905,8579
84635,524622,30811,252392,19231,493810,16484,7905,8579
84640,524653,30813,252406,19232,493840,16484,7905,8579
84645,524684,30814,252425,19232,493869,16484,7905,8579
84650,524715,30816,252439,19233,493899,16484,7905,8579
84655,524746,30817,252451,19233,493928,16484,7905,8579
84660,524777,30819,252462,19235,493957,16484,7905,8579
84665,524808,30821,252475,19237,493987,16484,7905,8579
84670,524839,30822,252490,19237,494017,16484,7905,8579
84675,524870,30823,252501,19238,494046,16484,7905,8579
84680,524901,30825,252516,19240,494076,16484,7905,8579
84685,524932,30825,252532,19240,494107,16484,7905,8579
84690,524963,30825,252545,19240,494138,16484,7905,8579
84695,524994,30825,252561,19240,494169,16484,7905,8579
84700,525025,30825,252579,19240,494200,16484,7905,8579
84705,525056,30825,252590,19240,494231,16484,7905,8579
84710,525087,30825,252607,19240,494262,16484,7905,8579
84715,525118,30825,252623,19240,494293,16484,7905,8579
84720,525149,30825,252639,19240,494324,16484,7905,8579
84725,525180,30825,252649,19240,494355,16484,7905,8579
84730,525211,30825,252671,19240,494386,16484,7905,8579
84735,525242,30825,252686,19240,494417,16484,7905,8579
84740,525273,30825,252701,19240,494448,16484,7905,8579
84745,525304,30825,252716,19240,494479,16484,7905,8579
84750,525335,30825,252726,19240,494510,16484,7905,8579
84755,525366,30825,252743,19240,494541,16484,7905,8579
84760,525397,30825,252759,19240,494572,16484,7905,8579
84765,525428,30825,252774,19240,494603,16484,7905,8579
84770,525459,30825,252785,19240,494634,16484,7905,8579
84775,525490,30825,252800,19240,494665,16484,7905,8579
84780,525521,30825,252816,19240,494696,16484,7905,8579
84785,525552,30825,252830,19240,494727,16484,7905,8579
84790,525583,30826,252849,19240,494757,16484,7905,8579
84795,525614,30827,252866,19240,494787,16484,7905,8579
84800,525645,30828,252875,19241,494817,16484,7905,8579
84805,525676,30829,252887,19242,494847,16484,7905,8579
84810,525707,30830,252900,19243,494877,16484,7905,8579
84815,525738,30831,252913,19244,494907,16484,7905,8579
84820,525769,30832,252931,19244,494937,16484,7905,8579
84825,525800,30833,252950,19245,494967,16484,7905,8579
84830,525831,30834,252967,19246,494997,16484,7905,8579
84835,525862,30835,252977,19247,495027,16484,7905,8579
84840,525893,30836,252996,19247,495057,16484,7905,8579
84845,525924,30837,253009,19248,495087,16484,7905,8579
84850,525955,30838,253025,19248,495117,16484,7905,8579
84855,525986,30839,253041,19249,495147,16484,7905,8579
84860,526017,30840,253058,19250,495177,16484,7905,8579
84865,526048,30841,253076,19251,495207,16484,7905,8579
84870,526079,30842,253093,19252,495237,16484,7905,8579
84875,526110,30843,253108,19252,495267,16484,7905,8579
84880,526141,30844,253119,19253,495297,16484,7905,8579
84885,526172,30845,253131,19254,495327,16484,7905,8579
84890,526203,30846,253147,19254,495357,16484,7905,8579
84895,526234,30847,253158,19254,495387,16484,7905,8579
84900,526265,30848,253174,19255,495417,16484,7905,8579
84905,526296,30849,253192,19256,495447,16484,7905,8579
84910,526327,30850,253206,19256,495477,16484,7905,8579
84915,526358,30851,253222,19257,495507,16484,7905,8579
84920,526389,30852,253243,19258,495537,16484,7905,8579
84925,526420,30853,253257,19259,495567,16484,7905,8579
84930,526451,30854,253274,19260,495597,16484,7905,8579
84935,526482,30855,253289,19260,495627,16484,7905,8579
84940,526513,30856,253305,19260,495657,16484,7905,8579
84945,526544,30857,253322,19260,495687,16484,7905,8579
84950,526575,30858,253336,19260,495717,16484,7905,8579
84955,526606,30859,253347,19260,495747,16484,7905,8579
84960,526637,30860,253360,19261,495777,16484,7905,8579
84965,526668,30861,253379,19261,495807,16484,7905,8579
84970,526699,30862,253389,19261,495837,16484,7905,8579
84975,526730,30863,253408,19262,495867,16484,7905,8579
84980,526761,30864,253425,19263,495897,16484,7905,8579
84985,526792,30865,253444,19263,495927,16484,7905,8579
84990,526823,30866,253455,19263,495957,16484,7905,8579
84995,526854,30867,253468,19263,495987,16484,7905,8579
85000,526885,30868,253479,19263,496017,16484,7905,8579
85005,526916,30869,253494,19263,496047,16484,7905,8579
85010,526947,30870,253507,19264,496077,16484,7905,8579
85015,526978,30871,253520,19265,496107,16484,7905,8579
85020,527009,30872,253534,19266,496137,16484,7905,8579
85025,527040,30873,253547,19266,496167,16484,7905,8579
85030,527071,30874,253561,19267,496197,16484,7905,8579
85035,527102,30875,253577,19268,496227,16484,7905,8579
85040,527133,30876,253592,19268,496257,16484,7905,8579
85045,527164,30877,253608,19268,496287,16484,7905,8579
85050,527195,30878,253630,19269,496317,16484,7905,8579
85055,527226,30879,253648,19270,496347,16484,7905,8579
85060,527257,30880,253667,19270,496377,16484,7905,8579
85065,527288,30881,253682,19271,496407,16484,7905,8579
85070,527319,30882,253695,19272,496437,16484,7905,8579
85075,527350,30883,253709,19273,496467,16484,7905,8579
85080,527381,30884,253726,19274,496497,16484,7905,8579
85085,527412,30885,253737,19274,496527,16484,7905,8579
85090,527443,30886,253748,19275,496557,16484,7905,8579
85095,527474,30887,253759,19275,496587,16484,7905,8579
85100,527505,30888,253772,19275,496617,16484,7905,8579
85105,527536,30889,253787,19275,496647,16484,7905,8579
85110,527567,30890,253806,19276,496677,16484,7905,8579
85115,527598,30891,253823,19276,496707,16484,7905,8579
85120,527629,30892,253842,19277,496737,16484,7905,8579
85125,527660,30893,253855,19277,496767,16484,7905,8579
85130,527691,30894,253872,19277,496797,16484,7905,8579
85135,527722,30895,253887,19278,496827,16484,7905,8579
85140,527753,30896,253905,19278,496857,16484,7905,8579
85145,527784,30897,253922,19279,496887,16484,7905,8579
85150,527815,30898,253939,19280,496917,16484,7905,8579
85155,527846,30899,253956,19281,496947,16484,7905,8579
85160,527877,30900,253971,19282,496977,16484,7905,8579
85165,527908,30901,253985,19282,497007,16484,7905,8579
85170,527939,30902,254006,19283,497037,16484,7905,8579
85175,527970,30903,254024,19284,497067,16484,7905,8579
85180,528001,30904,254037,19284,497097,16484,7905,8579
85185,528032,30905,254048,19284,497127,16484,7905,8579
85190,528063,30906,254067,19285,497157,16484,7905,8579
85195,528094,30907,254083,19286,497187,16484,7905,8579
85200,528125,30908,254095,19287,497217,16484,7905,8579
85205,528156,30909,254106,19287,497247,16484,7905,8579
85210,528187,30910,254126,19287,497277,16484,7905,8579
85215,528218,30911,254143,19287,497307,16484,7905,8579
85220,528249,30912,254156,19287,497337,16484,7905,8579
85225,528280,30913,254170,19288,497367,16484,7905,8579
85230,528311,30914,254189,19289,497397,16484,7905,8579
85235,528342,30915,254201,19289,497427,16484,7905,8579
85240,528373,30916,254209,19289,497457,16484,7905,8579
85245,528404,30917,254223,19290,497487,16484,7905,8579
85250,528435,30918,254242,19291,497517,16484,7905,8579
85255,528466,30919,254258,19291,497547,16484,7905,8579
85260,528497,30920,254268,19291,497577,16484,7905,8579
85265,528528,30921,254288,19291,497607,16484,7905,8579
85270,528559,30922,254302,19292,497637,16484,7905,8579
85275,528590,30923,254317,19293,497667,16484,7905,8579
85280,528621,30924,254334,19294,497697,16484,7905,8579
85285,528652,30925,254350,19294,497727,16484,7905,8579
85290,528683,30926,254362,19294,497757,16484,7905,8579
85295,528714,30927,254379,19294,497787,16484,7905,8579
85300,528745,30928,254390,19295,497817,16484,7905,8579
85305,528776,30929,254408,19296,497847,16484,7905,8579
85310,528807,30930,254424,19297,497877,16484,7905,8579
85315,528838,30931,254439,19298,497907,16484,7905,8579
85320,528869,30932,254451,19299,497937,16484,7905,8579
85325,528900,30932,254469,19299,497968,16484,7905,8579
85330,528931,30932,254487,19299,497999,16484,7905,8579
85335,528962,30932,254499,19299,498030,16484,7905,8579
85340,528993,30932,254511,19299,498061,16484,7905,8579
85345,529024,30932,254524,19299,498092,16484,7905,8579
85350,529055,30932,254536,19299,498123,16484,7905,8579
85355,529086,30932,254550,19299,498154,16484,7905,8579
85360,529117,30932,254560,19299,498185,16484,7905,8579
85365,529148,30932,254574,19299,498216,16484,7905,8579
85370,529179,30932,254589,19299,498247,16484,7905,8579
85375,529210,30932,254604,19299,498278,16484,7905,8579
85380,529241,30932,254619,19299,498309,16484,7905,8579
85385,529272,30932,254633,19299,498340,16484,7905,8579
85390,529303,30932,254651,19299,498371,16484,7905,8579
85395,529334,30932,254666,19299,498402,16484,7905,8579
85400,529365,30932,254679,19299,498433,16484,7905,8579
85405,529396,30932,254692,19299,498464,16484,7905,8579
85410,529427,30932,254710,19299,498495,16484,7905,8579
85415,529458,30932,254724,19299,498526,16484,7905,8579
85420,529489,30932,254741,19299,498557,16484,7905,8579
85425,529520,30932,254752,19299,498588,16484,7905,8579
85430,529551,30933,254764,19299,498618,16484,7905,8579
85435,529582,30934,254778,19299,498648,16484,7905,8579
85440,529613,30935,254796,19300,498678,16484,7905,8579
85445,529644,30936,254816,19300,498708,16484,7905,8579
85450,529675,30937,254830,19301,498738,16484,7905,8579
85455,529706,30938,254848,19302,498768,16484,7905,8579
85460,529737,30939,254863,19303,498798,16484,7905,8579
85465,529768,30940,254883,19304,498828,16484,7905,8579
85470,529799,30941,254896,19304,498858,16484,7905,8579
85475,529830,30942,254908,19305,498888,16484,7905,8579
85480,529861,30943,254923,19306,498918,16484,7905,8579
85485,529892,30944,254938,19306,498948,16484,7905,8579
85490,529923,30945,254953,19307,498978,16484,7905,8579
85495,529954,30946,254968,19307,499008,16484,7905,8579
85500,529985,30947,254980,19307,499038,16484,7905,8579
85505,530016,30948,254992,19308,499068,16484,7905,8579
85510,530047,30949,255007,19309,499098,16484,7905,8579
85515,530078,30950,255025,19310,499128,16484,7905,8579
85520,530109,30951,255039,19310,499158,16484,7905,8579
85525,530140,30952,255052,19310,499188,16484,7905,8579
85530,530171,30953,255069,19310,499218,16484,7905,8579
85535,530202,30954,255087,19311,499248,16484,7905,8579
85540,530233,30955,255098,19311,499278,16484,7905,8579
85545,530264,30956,255110,19312,499308,16484,7905,8579
85550,530295,30957,255122,19312,499338,16484,7905,8579
85555,530326,30958,255134,19312,499368,16484,7905,8579
85560,530357,30959,255154,19313,499398,16484,7905,8579
85565,530388,30960,255171,19313,499428,16484,7905,8579
85570,530419,30961,255186,19314,499458,16484,7905,8579
85575,530450,30962,255202,19315,499488,16484,7905,8579
85580,530481,30963,255215,19315,499518,16484,7905,8579
85585,530512,30964,255226,19315,499548,16484,7905,8579
85590,530543,30965,255243,19316,499578,16484,7905,8579
85595,530574,30966,255252,19316,499608,16484,7905,8579
85600,530605,30967,255265,19316,499638,16484,7905,8579
85605,530636,30968,255282,19317,499668,16484,7905,8579
85610,530667,30969,255292,19317,499698,16484,7905,8579
85615,530698,30970,255305,19317,499728,16484,7905,8579
85620,530729,30971,255319,19317,499758,16484,7905,8579
85625,530760,30972,255334,19317,499788,16484,7905,8579
85630,530791,30973,255353,19317,499818,16484,7905,8579
85635,530822,30974,255368,19318,499848,16484,7905,8579
85640,530853,30975,255382,19318,499878,16484,7905,8579
85645,530884,30976,255396,19318,499908,16484,7905,8579
85650,530915,30977,255408,19319,499938,16484,7905,8579
85655,530946,30978,255427,19320,499968,16484,7905,8579
85660,530977,30979,255438,19320,499998,16484,7905,8579
85665,531008,30980,255451,19321,500028,16484,7905,8579
85670,531039,30981,255464,19322,500058,16484,7905,8579
85675,531070,30982,255477,19322,500088,16484,7905,8579
85680,531101,30983,255494,19323,500118,16484,7905,8579
85685,531132,30984,255509,19324,500148,16484,7905,8579
85690,531163,30985,255525,19324,500178,16484,7905,8579
85695,531194,30986,255545,19325,500208,16484,7905,8579
85700,531225,30987,255567,19326,500238,16484,7905,8579
85705,531256,30988,255583,19327,500268,16484,7905,8579
85710,531287,30989,255602,19327,500298,16484,7905,8579
85715,531318,30990,255615,19327,500328,16484,7905,8579
85720,531349,30991,255633,19328,500358,16484,7905,8579
85725,531380,30992,255649,19329,500388,16484,7905,8579
85730,531411,30993,255665,19329,500418,16484,7905,8579
85735,531442,30994,255680,19329,500448,16484,7905,8579
85740,531473,30995,255693,19329,500478,16484,7905,8579
85745,531504,30996,255710,19330,500508,16484,7905,8579
85750,531535,30997,255723,19330,500538,16484,7905,8579
85755,531566,30998,255736,19330,500568,16484,7905,8579
85760,531597,30999,255748,19331,500598,16484,7905,8579
85765,531628,31000,255765,19332,500628,16484,7905,8579
85770,531659,31001,255780,19333,500658,16484,7905,8579
85775,531690,31002,255798,19334,500688,16484,7905,8579
85780,531721,31003,255814,19335,500718,16484,7905,8579
85785,531752,31004,255827,19336,500748,16484,7905,8579
85790,531783,31005,255840,19337,500778,16484,7905,8579
85795,531814,31006,255855,19337,500808,16484,7905,8579
85800,531845,31007,255864,19338,500838,16484,7905,8579
85805,531876,31008,255879,19338,500868,16484,7905,8579
85810,531907,31009,255890,19338,500898,16484,7905,8579
85815,531938,31010,255904,19338,500928,16484,7905,8579
85820,531969,31011,255920,19339,500958,16484,7905,8579
85825,532000,31012,255938,19340,500988,16484,7905,8579
85830,532031,31013,255956,19340,501018,16484,7905,8579
85835,532062,31014,255971,19341,501048,16484,7905,8579
85840,532093,31015,255984,19342,501078,16484,7905,8579
85845,532124,31016,255995,19342,501108,16484,7905,8579
85849,532152,31017,256007,19343,501135,16484,7905,8579
