Time,  Packets Generated,  Packets Reached,High Priority Packets Generated, High Priority Packets reached, Packet Dropped, Packet Dropped due to Faulty Node, High Prio Packet Dropped due to Faulty Node, Low Prio Packet Dropped due to Faulty Node 
5,1,1,1,1,0,0,0,0
10,6,3,5,2,3,3,3,0
15,8,3,6,2,4,4,4,0
20,16,7,10,3,8,8,6,2
25,20,10,11,5,10,10,6,4
30,30,16,16,7,14,14,9,5
35,36,16,19,7,18,18,11,7
40,47,22,23,10,24,24,13,11
45,51,25,27,12,26,26,15,11
50,61,31,30,14,30,30,16,14
55,67,31,32,14,34,34,18,16
60,78,37,36,16,40,40,20,20
65,82,40,37,16,40,40,20,20
70,92,48,43,21,42,42,20,22
75,98,51,44,23,45,45,21,24
80,109,58,50,26,47,47,22,25
85,113,64,54,30,47,47,22,25
90,123,72,59,35,49,49,24,25
95,129,75,63,36,52,52,26,26
100,140,82,68,39,54,54,27,27
105,144,88,70,42,54,54,27,27
110,154,96,75,47,56,56,28,28
115,160,99,79,48,59,59,31,28
120,171,106,85,51,61,61,31,30
125,175,112,88,55,61,61,31,30
130,185,120,94,61,63,63,33,30
135,191,123,95,61,65,65,33,32
140,202,131,101,64,67,67,34,33
145,206,137,104,68,67,67,34,33
150,216,144,107,72,70,69,34,35
155,222,147,110,73,72,71,35,36
160,233,153,113,75,77,73,36,37
165,237,158,115,78,77,73,36,37
170,247,164,120,81,81,75,38,37
175,253,167,123,82,84,77,39,38
180,264,173,131,87,87,79,40,39
185,268,178,132,91,88,79,40,39
190,278,185,137,96,91,81,40,41
195,284,188,138,97,93,83,40,43
200,295,194,144,101,97,85,42,43
205,299,197,145,102,101,85,42,43
210,309,203,151,106,104,87,44,43
215,315,206,156,108,106,89,45,44
220,326,212,161,113,110,91,46,45
225,330,217,163,116,111,91,46,45
230,340,223,170,121,115,93,48,45
235,346,226,172,122,119,95,49,46
240,357,230,177,124,124,97,51,46
245,361,233,178,126,126,97,51,46
250,371,239,183,129,130,99,52,47
255,377,242,186,132,134,101,54,47
260,388,247,193,135,137,103,55,48
265,392,252,194,139,139,103,55,48
270,402,255,200,142,145,105,57,48
275,408,258,200,142,149,107,57,50
280,419,262,205,144,154,109,58,51
285,423,264,206,144,158,109,58,51
290,433,267,210,147,164,111,58,53
295,439,270,212,147,167,113,59,54
300,450,274,218,149,173,115,60,55
305,454,276,221,150,177,115,60,55
310,464,279,223,151,184,117,61,56
315,470,279,225,151,190,119,62,57
320,481,281,227,152,198,121,62,59
325,485,282,228,153,202,121,62,59
330,495,285,231,154,209,123,64,59
335,501,286,234,155,213,125,64,61
340,512,289,241,157,221,127,66,61
345,516,290,242,157,225,127,66,61
350,526,293,245,158,231,129,66,63
355,532,295,247,160,236,131,66,65
360,543,299,252,162,242,133,66,67
365,547,300,253,163,246,133,66,67
370,557,305,255,164,250,135,66,69
375,563,306,257,165,256,137,67,70
380,574,311,261,168,259,139,67,72
385,578,315,264,171,261,139,67,72
390,588,322,270,176,265,141,69,72
395,594,324,274,178,267,143,70,73
400,605,331,281,185,271,145,71,74
405,609,334,283,187,274,145,71,74
410,619,339,286,189,278,147,72,75
415,625,341,290,191,282,149,73,76
420,636,346,296,195,286,151,74,77
425,640,350,297,199,290,151,74,77
430,650,355,302,202,293,153,74,79
435,656,357,306,204,297,155,75,80
440,667,360,312,207,305,157,76,81
445,671,361,315,208,309,157,76,81
450,681,364,322,210,315,159,76,83
455,687,366,325,212,319,161,77,84
460,698,369,333,215,326,163,77,86
465,702,370,335,216,331,163,77,86
470,712,372,340,217,338,165,78,87
475,718,375,344,220,343,167,80,87
480,729,376,350,221,351,169,80,89
485,733,377,353,222,356,169,80,89
490,743,378,357,223,365,171,81,90
495,749,379,360,224,370,173,82,91
500,760,381,365,226,378,175,82,93
505,764,381,368,226,382,175,82,93
510,774,383,374,228,390,177,83,94
515,780,384,375,229,396,179,83,96
520,791,385,380,230,405,181,84,97
525,795,386,381,231,409,181,84,97
530,805,387,384,231,416,183,84,99
535,811,389,385,233,422,185,85,100
540,822,391,389,234,429,187,86,101
545,826,392,390,235,434,187,86,101
550,836,395,392,236,441,189,87,102
555,842,395,396,236,445,191,89,102
560,853,400,401,240,452,193,90,103
565,857,400,402,240,457,193,90,103
570,867,403,407,242,464,195,91,104
575,873,404,410,243,467,197,91,106
580,884,409,417,248,472,199,92,107
585,888,413,418,252,475,199,92,107
590,898,417,422,255,480,201,92,109
595,904,419,425,257,484,203,93,110
600,915,423,431,260,490,205,95,110
605,919,426,433,263,492,205,95,110
610,929,430,437,267,499,207,95,112
615,935,430,440,267,504,209,96,113
620,946,433,446,270,512,211,97,114
625,950,435,448,272,514,211,97,114
630,960,440,454,277,519,213,97,116
635,966,440,458,277,525,215,99,116
640,977,442,461,278,534,217,99,118
645,981,443,462,279,537,217,99,118
650,991,447,467,283,544,219,101,118
655,997,447,471,283,549,221,103,118
660,1008,449,478,284,557,223,104,119
665,1012,449,479,284,562,223,104,119
670,1022,449,483,284,573,225,105,120
675,1028,449,486,284,579,227,106,121
680,1039,451,492,285,588,229,107,122
685,1043,451,494,285,591,229,107,122
690,1053,452,497,286,601,231,108,123
695,1059,452,501,286,606,233,109,124
700,1070,453,509,287,616,235,111,124
705,1074,453,511,287,620,235,111,124
710,1084,456,515,289,627,237,111,126
715,1090,457,515,290,633,239,111,128
720,1101,458,520,291,642,241,112,129
725,1105,460,523,293,645,241,112,129
730,1115,461,527,293,653,243,113,130
735,1121,463,533,295,657,245,115,130
740,1132,466,539,297,666,247,117,130
745,1136,467,543,298,668,247,117,130
750,1146,470,548,300,676,249,118,131
755,1152,470,551,300,681,251,119,132
760,1163,471,556,300,691,253,121,132
765,1167,472,560,301,694,253,121,132
770,1177,475,565,303,702,255,121,134
775,1183,475,567,303,708,257,122,135
780,1194,477,571,305,716,259,123,136
785,1198,479,573,307,718,259,123,136
790,1208,483,579,310,724,261,125,136
795,1214,483,581,310,729,263,125,138
800,1225,487,585,314,737,265,125,140
805,1229,490,587,317,739,265,125,140
810,1239,494,593,321,744,267,126,141
815,1245,494,594,321,750,269,126,143
820,1256,496,598,322,759,271,127,144
825,1260,498,600,324,761,271,127,144
830,1270,503,607,328,766,273,129,144
835,1276,503,609,328,772,275,129,146
840,1287,506,615,331,780,277,129,148
845,1291,507,616,332,783,277,129,148
850,1301,512,619,335,788,279,129,150
855,1307,514,622,337,791,281,129,152
860,1318,518,627,341,797,283,129,154
865,1322,520,628,343,801,283,129,154
870,1332,524,631,346,807,285,129,156
875,1338,526,634,348,811,287,130,157
880,1349,529,639,350,817,289,131,158
885,1353,530,640,351,823,289,131,158
890,1363,533,648,354,828,291,132,159
895,1369,535,650,356,834,293,133,160
900,1380,538,656,359,840,295,134,161
905,1384,540,659,361,843,295,134,161
910,1394,543,662,363,850,297,134,163
915,1400,544,665,364,856,299,136,163
920,1411,548,671,368,862,301,137,164
925,1415,550,673,370,865,301,137,164
930,1425,551,678,370,872,303,138,165
935,1431,554,682,373,877,305,139,166
940,1442,556,687,374,884,307,139,168
945,1446,557,689,375,889,307,139,168
950,1456,558,693,376,897,309,140,169
955,1462,560,697,378,901,311,141,170
960,1473,562,701,379,910,313,142,171
965,1477,563,701,380,914,313,142,171
970,1487,565,706,381,921,315,143,172
975,1493,567,710,383,925,317,144,173
980,1504,570,717,386,931,319,144,175
985,1508,572,720,388,936,319,144,175
990,1518,573,726,389,945,321,146,175
995,1524,573,727,389,951,323,146,177
1000,1535,574,732,389,961,325,147,178
1005,1539,575,735,390,964,325,147,178
1010,1549,575,740,390,973,327,147,180
1015,1555,575,743,390,979,329,149,180
1020,1566,577,747,391,988,331,150,181
1025,1570,578,750,392,992,331,150,181
1030,1580,578,752,392,1002,333,151,182
1035,1586,578,754,392,1007,335,151,184
1040,1597,581,760,395,1014,337,152,185
1045,1601,583,763,397,1017,337,152,185
1050,1611,584,766,397,1027,339,153,186
1055,1617,584,769,397,1031,341,153,188
1060,1628,587,774,400,1040,343,154,189
1065,1632,589,777,402,1043,343,154,189
1070,1642,590,781,402,1052,345,155,190
1075,1648,590,785,402,1057,347,157,190
1080,1659,594,792,405,1063,349,159,190
1085,1663,596,794,407,1066,349,159,190
1090,1673,598,799,408,1075,351,160,191
1095,1679,598,803,408,1080,353,162,191
1100,1690,603,809,412,1086,355,162,193
1105,1694,603,809,412,1091,355,162,193
1110,1704,606,813,414,1098,357,162,195
1115,1710,606,816,414,1104,359,162,197
1120,1721,609,822,417,1111,361,162,199
1125,1725,609,824,417,1116,361,162,199
1130,1735,612,829,419,1123,363,164,199
1135,1741,612,832,419,1128,365,165,200
1140,1752,615,838,421,1135,367,167,200
1145,1756,617,839,423,1138,367,167,200
1150,1766,622,843,426,1144,369,168,201
1155,1772,622,844,426,1150,371,168,203
1160,1783,624,846,427,1158,373,168,205
1165,1787,625,847,428,1161,373,168,205
1170,1797,632,853,433,1165,375,169,206
1175,1803,632,856,433,1171,377,170,207
1180,1814,633,860,434,1181,379,171,208
1185,1818,634,864,435,1183,379,171,208
1190,1828,637,870,437,1190,381,172,209
1195,1834,638,874,438,1195,383,174,209
1200,1845,640,876,439,1205,385,174,211
1205,1849,640,879,439,1208,385,174,211
1210,1859,641,886,440,1216,387,176,211
1215,1865,643,888,442,1220,389,176,213
1220,1876,647,895,446,1227,391,177,214
1225,1880,648,895,447,1232,391,177,214
1230,1890,651,900,449,1238,393,179,214
1235,1896,652,902,450,1243,395,179,216
1240,1907,655,911,453,1250,397,181,216
1245,1911,657,914,455,1253,397,181,216
1250,1921,659,920,457,1260,399,182,217
1255,1927,662,925,460,1264,401,184,217
1260,1938,664,929,462,1272,403,184,219
1265,1942,666,932,464,1276,403,184,219
1270,1952,667,937,465,1284,405,185,220
1275,1958,669,940,467,1288,407,185,222
1280,1969,672,946,469,1294,409,186,223
1285,1973,674,947,471,1299,409,186,223
1290,1983,677,951,473,1306,411,187,224
1295,1989,678,953,474,1311,413,187,226
1300,2000,679,956,474,1319,415,187,228
1305,2004,680,958,475,1324,415,187,228
1310,2014,682,960,475,1331,417,187,230
1315,2020,683,963,476,1337,419,189,230
1320,2031,687,972,480,1342,421,191,230
1325,2035,687,972,480,1348,421,191,230
1330,2045,691,980,483,1353,423,193,230
1335,2051,693,983,485,1357,425,194,231
1340,2062,698,989,489,1361,427,194,233
1345,2066,700,991,491,1365,427,194,233
1350,2076,704,994,494,1372,429,194,235
1355,2082,704,998,494,1376,431,195,236
1360,2093,709,1006,499,1381,433,197,236
1365,2097,712,1009,502,1384,433,197,236
1370,2107,716,1014,505,1390,435,198,237
1375,2113,717,1016,506,1395,437,199,238
1380,2124,721,1022,509,1402,439,201,238
1385,2128,724,1024,512,1404,439,201,238
1390,2138,726,1027,512,1411,441,202,239
1395,2144,727,1030,513,1415,443,203,240
1400,2155,733,1034,518,1422,445,203,242
1405,2159,734,1037,519,1424,445,203,242
1410,2169,738,1043,523,1430,447,204,243
1415,2175,738,1047,523,1436,449,205,244
1420,2186,739,1051,524,1447,451,205,246
1425,2190,739,1052,524,1451,451,205,246
1430,2200,743,1060,528,1457,453,206,247
1435,2206,743,1064,528,1462,455,207,248
1440,2217,746,1069,531,1471,457,208,249
1445,2221,748,1072,533,1473,457,208,249
1450,2231,751,1077,535,1480,459,209,250
1455,2237,751,1077,535,1486,461,209,252
1460,2248,755,1086,538,1492,463,211,252
1465,2252,757,1090,540,1495,463,211,252
1470,2262,757,1093,540,1505,465,211,254
1475,2268,757,1096,540,1511,467,212,255
1480,2279,759,1100,541,1520,469,214,255
1485,2283,760,1103,542,1522,469,214,255
1490,2293,761,1107,543,1532,471,215,256
1495,2299,761,1110,543,1537,473,217,256
1500,2310,763,1114,544,1546,475,218,257
1505,2314,763,1115,544,1551,475,218,257
1510,2324,765,1118,545,1559,477,220,257
1515,2330,765,1121,545,1565,479,221,258
1520,2341,767,1128,547,1571,481,222,259
1525,2345,769,1131,549,1576,481,222,259
1530,2355,770,1134,550,1585,483,223,260
1535,2361,770,1137,550,1589,485,223,262
1540,2372,774,1143,554,1596,487,224,263
1545,2376,776,1146,556,1599,487,224,263
1550,2386,778,1153,558,1606,489,224,265
1555,2392,780,1154,560,1612,491,224,267
1560,2403,783,1161,563,1618,493,224,269
1565,2407,784,1163,564,1622,493,224,269
1570,2417,789,1169,568,1626,495,225,270
1575,2423,792,1173,571,1629,497,225,272
1580,2434,796,1179,575,1636,499,226,273
1585,2438,798,1180,577,1640,499,226,273
1590,2448,801,1181,578,1647,501,226,275
1595,2454,802,1184,579,1651,503,226,277
1600,2465,804,1188,581,1660,505,227,278
1605,2469,805,1190,582,1664,505,227,278
1610,2479,807,1192,583,1671,507,227,280
1615,2485,809,1195,585,1675,509,228,281
1620,2496,811,1200,587,1682,511,228,283
1625,2500,812,1203,588,1688,511,228,283
1630,2510,814,1210,589,1695,513,230,283
1635,2516,814,1213,589,1701,515,230,285
1640,2527,815,1216,590,1711,517,230,287
1645,2531,815,1218,590,1715,517,230,287
1650,2541,817,1221,591,1724,519,230,289
1655,2547,817,1224,591,1729,521,231,290
1660,2558,817,1230,591,1740,523,232,291
1665,2562,817,1233,591,1744,523,232,291
1670,2572,819,1239,592,1753,525,234,291
1675,2578,819,1242,592,1757,527,234,293
1680,2589,823,1248,596,1766,529,236,293
1685,2593,823,1249,596,1769,529,236,293
1690,2603,827,1253,598,1776,531,237,294
1695,2609,827,1256,598,1780,533,237,296
1700,2620,832,1263,602,1786,535,239,296
1705,2624,835,1264,605,1789,535,239,296
1710,2634,840,1271,610,1794,537,241,296
1715,2640,840,1273,610,1799,539,242,297
1720,2651,844,1280,613,1806,541,243,298
1725,2655,845,1282,614,1810,541,243,298
1730,2665,846,1284,615,1818,543,243,300
1735,2671,848,1286,617,1822,545,243,302
1740,2682,850,1290,619,1832,547,244,303
1745,2686,851,1293,620,1835,547,244,303
1750,2696,853,1297,622,1843,549,245,304
1755,2702,854,1299,623,1847,551,245,306
1760,2713,857,1303,626,1856,553,245,308
1765,2717,857,1304,626,1860,553,245,308
1770,2727,860,1310,628,1866,555,246,309
1775,2733,862,1313,630,1870,557,246,311
1780,2744,865,1319,632,1876,559,246,313
1785,2748,867,1322,634,1881,559,246,313
1790,2758,869,1325,636,1888,561,246,315
1795,2764,871,1328,638,1893,563,247,316
1800,2775,873,1334,639,1901,565,249,316
1805,2779,874,1337,640,1904,565,249,316
1810,2789,876,1343,642,1912,567,249,318
1815,2795,878,1347,644,1916,569,250,319
1820,2806,881,1352,647,1924,571,251,320
1825,2810,882,1353,648,1928,571,251,320
1830,2820,886,1358,651,1932,573,251,322
1835,2826,888,1361,653,1936,575,252,323
1840,2837,890,1367,655,1945,577,254,323
1845,2841,892,1369,657,1949,577,254,323
1850,2851,894,1376,659,1957,579,256,323
1855,2857,894,1378,659,1962,581,257,324
1860,2868,896,1382,660,1971,583,258,325
1865,2872,896,1384,660,1976,583,258,325
1870,2882,899,1391,662,1983,585,260,325
1875,2888,899,1393,662,1988,587,260,327
1880,2899,901,1399,663,1996,589,262,327
1885,2903,902,1401,664,2001,589,262,327
1890,2913,903,1404,664,2010,591,263,328
1895,2919,903,1407,664,2015,593,264,329
1900,2930,905,1413,666,2023,595,264,331
1905,2934,907,1415,668,2027,595,264,331
1910,2944,908,1416,668,2035,597,264,333
1915,2950,908,1420,668,2040,599,265,334
1920,2961,910,1424,670,2049,601,266,335
1925,2965,914,1427,674,2051,601,266,335
1930,2975,917,1434,677,2058,603,267,336
1935,2981,917,1437,677,2063,605,267,338
1940,2992,921,1443,680,2070,607,269,338
1945,2996,923,1445,682,2073,607,269,338
1950,3006,928,1450,685,2078,609,270,339
1955,3012,928,1454,685,2084,611,271,340
1960,3023,930,1458,686,2092,613,272,341
1965,3027,931,1458,687,2096,613,272,341
1970,3037,935,1461,689,2102,615,273,342
1975,3043,935,1462,689,2107,617,273,344
1980,3054,938,1466,692,2116,619,274,345
1985,3058,939,1468,693,2118,619,274,345
1990,3068,944,1472,696,2124,621,275,346
1995,3074,944,1475,696,2130,623,276,347
2000,3085,947,1478,698,2138,625,276,349
2005,3089,949,1481,700,2140,625,276,349
2010,3099,953,1487,703,2146,627,278,349
2015,3105,953,1490,703,2152,629,279,350
2020,3116,956,1497,705,2160,631,281,350
2025,3120,958,1499,707,2162,631,281,350
2030,3130,961,1502,708,2168,633,282,351
2035,3136,963,1505,710,2173,635,284,351
2040,3147,966,1510,712,2179,637,285,352
2045,3151,967,1510,713,2184,637,285,352
2050,3161,968,1513,713,2192,639,286,353
2055,3167,970,1517,715,2196,641,287,354
2060,3178,971,1518,715,2207,643,288,355
2065,3182,972,1521,716,2210,643,288,355
2070,3192,974,1527,718,2217,645,289,356
2075,3198,975,1530,719,2221,647,290,357
2080,3209,977,1532,720,2230,649,290,359
2085,3213,978,1535,721,2235,649,290,359
2090,3223,980,1541,722,2242,651,292,359
2095,3229,982,1545,724,2246,653,293,360
2100,3240,986,1551,728,2253,655,294,361
2105,3244,986,1554,728,2257,655,294,361
2110,3254,987,1560,729,2266,657,296,361
2115,3260,989,1564,731,2270,659,298,361
2120,3271,990,1570,732,2279,661,299,362
2125,3275,990,1573,732,2284,661,299,362
2130,3285,991,1577,732,2293,663,300,363
2135,3291,993,1579,734,2298,665,300,365
2140,3302,994,1584,735,2306,667,300,367
2145,3306,995,1588,736,2310,667,300,367
2150,3316,996,1594,736,2319,669,301,368
2155,3322,998,1599,738,2322,671,302,369
2160,3333,1002,1605,742,2329,673,303,370
2165,3337,1003,1607,743,2334,673,303,370
2170,3347,1005,1613,743,2340,675,304,371
2175,3353,1007,1615,745,2345,677,304,373
2180,3364,1010,1623,748,2352,679,306,373
2185,3368,1012,1625,750,2355,679,306,373
2190,3378,1014,1634,752,2362,681,307,374
2195,3384,1017,1640,755,2365,683,309,374
2200,3395,1019,1646,757,2375,685,310,375
2205,3399,1020,1649,758,2378,685,310,375
2210,3409,1023,1654,761,2386,687,311,376
2215,3415,1023,1658,761,2390,689,312,377
2220,3426,1026,1663,763,2397,691,312,379
2225,3430,1031,1666,768,2398,691,312,379
2230,3440,1035,1669,771,2405,693,313,380
2235,3446,1035,1671,771,2410,695,313,382
2240,3457,1038,1676,774,2417,697,314,383
2245,3461,1041,1677,777,2420,697,314,383
2250,3471,1043,1679,778,2428,699,315,384
2255,3477,1043,1683,778,2433,701,317,384
2260,3488,1044,1689,778,2443,703,318,385
2265,3492,1044,1689,778,2448,703,318,385
2270,3502,1044,1693,778,2458,705,319,386
2275,3508,1044,1695,778,2464,707,321,386
2280,3519,1045,1701,778,2473,709,323,386
2285,3523,1046,1703,779,2477,709,323,386
2290,3533,1047,1705,780,2486,711,324,387
2295,3539,1047,1708,780,2491,713,324,389
2300,3550,1048,1713,780,2502,715,324,391
2305,3554,1049,1714,781,2505,715,324,391
2310,3564,1050,1716,782,2513,717,324,393
2315,3570,1052,1718,784,2518,719,325,394
2320,3581,1053,1723,785,2527,721,325,396
2325,3585,1054,1726,786,2531,721,325,396
2330,3595,1056,1728,787,2539,723,326,397
2335,3601,1056,1731,787,2544,725,327,398
2340,3612,1058,1737,789,2554,727,329,398
2345,3616,1058,1738,789,2558,727,329,398
2350,3626,1060,1743,790,2564,729,331,398
2355,3632,1062,1745,792,2570,731,332,399
2360,3643,1065,1751,795,2577,733,334,399
2365,3647,1067,1753,797,2579,733,334,399
2370,3657,1071,1758,800,2584,735,335,400
2375,3663,1073,1761,802,2589,737,337,400
2380,3674,1077,1767,806,2597,739,339,400
2385,3678,1079,1771,808,2598,739,339,400
2390,3688,1084,1775,813,2604,741,339,402
2395,3694,1085,1776,814,2609,743,339,404
2400,3705,1089,1781,818,2615,745,339,406
2405,3709,1091,1782,820,2618,745,339,406
2410,3719,1095,1788,824,2623,747,340,407
2415,3725,1097,1792,826,2626,749,341,408
2420,3736,1103,1797,831,2632,751,342,409
2425,3740,1105,1799,833,2634,751,342,409
2430,3750,1108,1801,835,2641,753,342,411
2435,3756,1110,1805,837,2644,755,343,412
2440,3767,1114,1809,840,2651,757,344,413
2445,3771,1117,1811,843,2653,757,344,413
2450,3781,1120,1816,846,2661,759,346,413
2455,3787,1120,1817,846,2667,761,347,414
2460,3798,1123,1823,849,2674,763,347,416
2465,3802,1123,1825,849,2678,763,347,416
2470,3812,1126,1832,851,2685,765,348,417
2475,3818,1128,1835,853,2690,767,349,418
2480,3829,1130,1842,854,2696,769,350,419
2485,3833,1131,1844,855,2701,769,350,419
2490,3843,1133,1851,857,2708,771,351,420
2495,3849,1136,1855,860,2712,773,351,422
2500,3860,1139,1862,863,2719,775,353,422
2505,3864,1139,1864,863,2725,775,353,422
2510,3874,1141,1870,865,2733,777,354,423
2515,3880,1141,1874,865,2739,779,356,423
2520,3891,1142,1880,866,2749,781,357,424
2525,3895,1143,1883,867,2752,781,357,424
2530,3905,1143,1885,867,2762,783,357,426
2535,3911,1143,1889,867,2768,785,358,427
2540,3922,1144,1894,867,2776,787,360,427
2545,3926,1144,1894,867,2782,787,360,427
2550,3936,1145,1896,868,2791,789,360,429
2555,3942,1145,1899,868,2797,791,362,429
2560,3953,1147,1906,869,2803,793,364,429
2565,3957,1149,1909,871,2807,793,364,429
2570,3967,1154,1914,876,2813,795,364,431
2575,3973,1154,1916,876,2819,797,365,432
2580,3984,1157,1921,878,2826,799,366,433
2585,3988,1159,1924,880,2827,799,366,433
2590,3998,1162,1928,883,2836,801,366,435
2595,4004,1162,1933,883,2840,803,367,436
2600,4015,1166,1938,887,2848,805,368,437
2605,4019,1168,1941,889,2849,805,368,437
2610,4029,1175,1948,895,2852,807,369,438
2615,4035,1178,1950,898,2856,809,369,440
2620,4046,1184,1956,904,2862,811,370,441
2625,4050,1185,1959,905,2865,811,370,441
2630,4060,1186,1962,906,2874,813,371,442
2635,4066,1186,1964,906,2879,815,372,443
2640,4077,1189,1971,909,2886,817,373,444
2645,4081,1191,1974,911,2889,817,373,444
2650,4091,1192,1976,911,2899,819,373,446
2655,4097,1193,1979,912,2904,821,373,448
2660,4108,1195,1982,913,2913,823,373,450
2665,4112,1196,1985,914,2915,823,373,450
2670,4122,1198,1991,915,2922,825,374,451
2675,4128,1200,1994,917,2927,827,375,452
2680,4139,1203,2001,920,2934,829,376,453
2685,4143,1204,2003,921,2939,829,376,453
2690,4153,1205,2006,922,2948,831,377,454
2695,4159,1205,2008,922,2954,833,378,455
2700,4170,1207,2012,924,2962,835,379,456
2705,4174,1208,2015,925,2966,835,379,456
2710,4184,1211,2020,928,2973,837,380,457
2715,4190,1212,2024,929,2978,839,381,458
2720,4201,1215,2031,932,2983,841,382,459
2725,4205,1216,2033,933,2988,841,382,459
2730,4215,1219,2037,936,2996,843,382,461
2735,4221,1219,2038,936,3002,845,383,462
2740,4232,1222,2043,939,3009,847,384,463
2745,4236,1223,2046,940,3013,847,384,463
2750,4246,1225,2051,941,3019,849,384,465
2755,4252,1227,2055,943,3024,851,386,465
2760,4263,1230,2059,946,3032,853,387,466
2765,4267,1230,2061,946,3036,853,387,466
2770,4277,1233,2067,948,3043,855,389,466
2775,4283,1235,2069,950,3047,857,389,468
2780,4294,1237,2073,952,3057,859,390,469
2785,4298,1238,2074,953,3060,859,390,469
2790,4308,1240,2083,954,3067,861,392,469
2795,4314,1240,2086,954,3073,863,393,470
2800,4325,1241,2092,955,3083,865,395,470
2805,4329,1242,2096,956,3086,865,395,470
2810,4339,1245,2100,958,3094,867,396,471
2815,4345,1245,2104,958,3099,869,398,471
2820,4356,1245,2110,958,3109,871,399,472
2825,4360,1247,2111,960,3113,871,399,472
2830,4370,1249,2116,961,3120,873,399,474
2835,4376,1249,2120,961,3126,875,401,474
2840,4387,1251,2125,963,3136,877,403,474
2845,4391,1252,2127,964,3138,877,403,474
2850,4401,1255,2130,965,3146,879,405,474
2855,4407,1255,2136,965,3149,881,407,474
2860,4418,1260,2142,969,3156,883,408,475
2865,4422,1263,2143,972,3159,883,408,475
2870,4432,1266,2145,974,3166,885,408,477
2875,4438,1266,2147,974,3171,887,409,478
2880,4449,1269,2154,977,3178,889,410,479
2885,4453,1271,2157,979,3182,889,410,479
2890,4463,1274,2163,981,3187,891,411,480
2895,4469,1277,2166,984,3192,893,412,481
2900,4480,1279,2170,985,3201,895,413,482
2905,4484,1279,2170,985,3205,895,413,482
2910,4494,1281,2178,987,3212,897,415,482
2915,4500,1283,2181,989,3217,899,416,483
2920,4511,1285,2188,990,3225,901,418,483
2925,4515,1287,2189,992,3228,901,418,483
2930,4525,1289,2195,994,3235,903,420,483
2935,4531,1290,2198,995,3240,905,421,484
2940,4542,1293,2203,997,3249,907,422,485
2945,4546,1294,2204,998,3252,907,422,485
2950,4556,1297,2212,1000,3259,909,424,485
2955,4562,1297,2216,1000,3265,911,426,485
2960,4573,1299,2222,1001,3274,913,428,485
2965,4577,1299,2223,1001,3278,913,428,485
2970,4587,1302,2227,1003,3285,915,428,487
2975,4593,1302,2230,1003,3291,917,430,487
2980,4604,1304,2235,1004,3300,919,431,488
2985,4608,1304,2236,1004,3304,919,431,488
2990,4618,1307,2240,1007,3311,921,431,490
2995,4624,1307,2243,1007,3316,923,433,490
3000,4635,1311,2249,1010,3321,925,434,491
3005,4639,1314,2250,1013,3324,925,434,491
3010,4649,1320,2256,1019,3329,927,435,492
3015,4655,1320,2259,1019,3334,929,436,493
3020,4666,1324,2263,1023,3342,931,437,494
3025,4670,1324,2264,1023,3345,931,437,494
3030,4680,1328,2269,1025,3352,933,439,494
3035,4686,1328,2271,1025,3358,935,439,496
3040,4697,1332,2278,1029,3363,937,439,498
3045,4701,1335,2280,1032,3365,937,439,498
3050,4711,1339,2284,1035,3371,939,440,499
3055,4717,1340,2287,1036,3375,941,441,500
3060,4728,1346,2295,1042,3380,943,443,500
3065,4732,1348,2297,1044,3383,943,443,500
3070,4742,1350,2302,1046,3390,945,444,501
3075,4748,1352,2305,1048,3395,947,445,502
3080,4759,1355,2309,1050,3404,949,446,503
3085,4763,1355,2310,1050,3408,949,446,503
3090,4773,1357,2315,1052,3414,951,446,505
3095,4779,1360,2319,1055,3417,953,446,507
3100,4790,1363,2325,1058,3425,955,447,508
3105,4794,1365,2327,1060,3428,955,447,508
3110,4804,1366,2329,1060,3437,957,447,510
3115,4810,1367,2333,1061,3441,959,448,511
3120,4821,1370,2339,1064,3450,961,448,513
3125,4825,1370,2340,1064,3454,961,448,513
3130,4835,1372,2346,1066,3462,963,450,513
3135,4841,1372,2349,1066,3468,965,451,514
3140,4852,1374,2355,1068,3478,967,453,514
3145,4856,1374,2356,1068,3482,967,453,514
3150,4866,1374,2360,1068,3492,969,455,514
3155,4872,1374,2362,1068,3497,971,456,515
3160,4883,1375,2364,1068,3507,973,456,517
3165,4887,1376,2368,1069,3510,973,456,517
3170,4897,1378,2373,1070,3518,975,458,517
3175,4903,1378,2377,1070,3523,977,459,518
3180,4914,1380,2382,1071,3533,979,461,518
3185,4918,1380,2385,1071,3537,979,461,518
3190,4928,1383,2390,1074,3545,981,461,520
3195,4934,1383,2394,1074,3551,983,462,521
3200,4945,1386,2402,1077,3557,985,463,522
3205,4949,1387,2402,1078,3562,985,463,522
3210,4959,1388,2404,1078,3571,987,464,523
3215,4965,1388,2407,1078,3576,989,465,524
3220,4976,1392,2412,1082,3583,991,466,525
3225,4980,1392,2413,1082,3587,991,466,525
3230,4990,1396,2418,1086,3594,993,468,525
3235,4996,1396,2423,1086,3598,995,470,525
3240,5007,1403,2429,1092,3602,997,470,527
3245,5011,1407,2432,1096,3603,997,470,527
3250,5021,1413,2440,1102,3608,999,471,528
3255,5027,1413,2442,1102,3613,1001,471,530
3260,5038,1417,2448,1105,3620,1003,473,530
3265,5042,1418,2450,1106,3623,1003,473,530
3270,5052,1421,2453,1107,3631,1005,474,531
3275,5058,1421,2458,1107,3635,1007,476,531
3280,5069,1424,2463,1110,3644,1009,477,532
3285,5073,1424,2466,1110,3648,1009,477,532
3290,5083,1425,2469,1110,3658,1011,477,534
3295,5089,1425,2473,1110,3663,1013,479,534
3300,5100,1425,2476,1110,3673,1015,479,536
3305,5104,1426,2479,1111,3677,1015,479,536
3310,5114,1427,2483,1111,3686,1017,479,538
3315,5120,1429,2487,1113,3690,1019,481,538
3320,5131,1431,2492,1115,3698,1021,482,539
3325,5135,1431,2495,1115,3704,1021,482,539
3330,5145,1432,2501,1115,3711,1023,483,540
3335,5151,1435,2505,1118,3715,1025,484,541
3340,5162,1436,2509,1119,3725,1027,485,542
3345,5166,1437,2513,1120,3729,1027,485,542
3350,5176,1438,2520,1121,3736,1029,486,543
3355,5182,1441,2523,1124,3741,1031,487,544
3360,5193,1441,2528,1124,3750,1033,488,545
3365,5197,1441,2531,1124,3756,1033,488,545
3370,5207,1443,2535,1126,3764,1035,489,546
3375,5213,1443,2539,1126,3769,1037,490,547
3380,5224,1445,2543,1127,3778,1039,491,548
3385,5228,1445,2544,1127,3783,1039,491,548
3390,5238,1448,2549,1130,3790,1041,491,550
3395,5244,1448,2550,1130,3796,1043,491,552
3400,5255,1451,2558,1133,3801,1045,491,554
3405,5259,1453,2559,1135,3806,1045,491,554
3410,5269,1457,2566,1139,3812,1047,492,555
3415,5275,1457,2569,1139,3818,1049,493,556
3420,5286,1459,2573,1141,3827,1051,493,558
3425,5290,1460,2576,1142,3829,1051,493,558
3430,5300,1465,2582,1147,3834,1053,493,560
3435,5306,1465,2584,1147,3840,1055,494,561
3440,5317,1468,2589,1149,3849,1057,496,561
3445,5321,1469,2591,1150,3852,1057,496,561
3450,5331,1473,2598,1153,3857,1059,497,562
3455,5337,1473,2602,1153,3863,1061,498,563
3460,5348,1477,2606,1156,3870,1063,499,564
3465,5352,1478,2608,1157,3873,1063,499,564
3470,5362,1482,2612,1159,3879,1065,501,564
3475,5368,1484,2613,1161,3884,1067,501,566
3480,5379,1486,2616,1163,3893,1069,502,567
3485,5383,1488,2619,1165,3895,1069,502,567
3490,5393,1491,2622,1166,3900,1071,502,569
3495,5399,1493,2625,1168,3905,1073,503,570
3500,5410,1497,2629,1171,3913,1075,503,572
3505,5414,1497,2629,1171,3917,1075,503,572
3510,5424,1501,2637,1175,3922,1077,505,572
3515,5430,1503,2640,1177,3927,1079,506,573
3520,5441,1505,2644,1178,3934,1081,506,575
3525,5445,1509,2647,1182,3935,1081,506,575
3530,5455,1514,2651,1185,3940,1083,507,576
3535,5461,1516,2654,1187,3944,1085,508,577
3540,5472,1520,2657,1190,3952,1087,509,578
3545,5476,1520,2658,1190,3955,1087,509,578
3550,5486,1522,2664,1192,3963,1089,511,578
3555,5492,1524,2667,1194,3967,1091,511,580
3560,5503,1527,2672,1196,3974,1093,511,582
3565,5507,1529,2673,1198,3978,1093,511,582
3570,5517,1530,2676,1198,3987,1095,512,583
3575,5523,1530,2679,1198,3992,1097,513,584
3580,5534,1531,2683,1199,4003,1099,514,585
3585,5538,1532,2686,1200,4006,1099,514,585
3590,5548,1534,2691,1201,4013,1101,515,586
3595,5554,1535,2692,1202,4019,1103,516,587
3600,5565,1537,2697,1204,4028,1105,516,589
3605,5569,1538,2700,1205,4030,1105,516,589
3610,5579,1541,2707,1207,4036,1107,518,589
3615,5585,1544,2709,1210,4041,1109,519,590
3620,5596,1545,2711,1210,4050,1111,519,592
3625,5600,1547,2714,1212,4053,1111,519,592
3630,5610,1549,2717,1213,4061,1113,520,593
3635,5616,1550,2721,1214,4065,1115,521,594
3640,5627,1554,2729,1218,4071,1117,523,594
3645,5631,1557,2731,1221,4073,1117,523,594
3650,5641,1562,2734,1225,4079,1119,523,596
3655,5647,1562,2735,1225,4085,1121,523,598
3660,5658,1564,2741,1227,4091,1123,523,600
3665,5662,1566,2743,1229,4095,1123,523,600
3670,5672,1569,2748,1231,4103,1125,525,600
3675,5678,1569,2751,1231,4108,1127,526,601
3680,5689,1572,2756,1233,4115,1129,528,601
3685,5693,1573,2756,1234,4120,1129,528,601
3690,5703,1576,2760,1236,4127,1131,529,602
3695,5709,1576,2762,1236,4132,1133,529,604
3700,5720,1581,2768,1240,4137,1135,530,605
3705,5724,1581,2768,1240,4143,1135,530,605
3710,5734,1585,2774,1243,4149,1137,531,606
3715,5740,1585,2776,1243,4154,1139,532,607
3720,5751,1589,2781,1247,4161,1141,533,608
3725,5755,1589,2782,1247,4166,1141,533,608
3730,5765,1592,2787,1248,4173,1143,533,610
3735,5771,1592,2791,1248,4178,1145,534,611
3740,5782,1595,2796,1251,4186,1147,535,612
3745,5786,1596,2799,1252,4190,1147,535,612
3750,5796,1598,2803,1252,4196,1149,536,613
3755,5802,1601,2807,1255,4199,1151,536,615
3760,5813,1603,2812,1257,4209,1153,537,616
3765,5817,1604,2814,1258,4213,1153,537,616
3770,5827,1608,2821,1261,4217,1155,538,617
3775,5833,1610,2823,1263,4222,1157,539,618
3780,5844,1613,2829,1266,4229,1159,540,619
3785,5848,1615,2831,1268,4232,1159,540,619
3790,5858,1620,2836,1272,4238,1161,541,620
3795,5864,1620,2839,1272,4243,1163,543,620
3800,5875,1624,2850,1276,4248,1165,545,620
3805,5879,1625,2852,1277,4253,1165,545,620
3810,5889,1625,2857,1277,4264,1167,546,621
3815,5895,1625,2859,1277,4270,1169,547,622
3820,5906,1625,2864,1277,4279,1171,547,624
3825,5910,1625,2868,1277,4284,1171,547,624
3830,5920,1625,2870,1277,4295,1173,548,625
3835,5926,1625,2873,1277,4300,1175,548,627
3840,5937,1625,2879,1277,4310,1177,549,628
3845,5941,1625,2880,1277,4315,1177,549,628
3850,5951,1626,2885,1278,4325,1179,549,630
3855,5957,1626,2888,1278,4330,1181,550,631
3860,5968,1628,2897,1279,4338,1183,552,631
3865,5972,1628,2898,1279,4343,1183,552,631
3870,5982,1629,2903,1280,4352,1185,552,633
3875,5988,1629,2908,1280,4359,1187,554,633
3880,5999,1631,2916,1282,4367,1189,556,633
3885,6003,1631,2917,1282,4372,1189,556,633
3890,6013,1631,2921,1282,4381,1191,557,634
3895,6019,1631,2924,1282,4388,1193,559,634
3900,6030,1632,2928,1283,4397,1195,560,635
3905,6034,1633,2930,1284,4401,1195,560,635
3910,6044,1635,2934,1286,4409,1197,561,636
3915,6050,1635,2936,1286,4414,1199,562,637
3920,6061,1639,2944,1290,4421,1201,564,637
3925,6065,1640,2944,1291,4425,1201,564,637
3930,6075,1644,2950,1293,4430,1203,564,639
3935,6081,1644,2953,1293,4436,1205,566,639
3940,6092,1646,2955,1294,4446,1207,566,641
3945,6096,1647,2957,1295,4448,1207,566,641
3950,6106,1650,2960,1296,4455,1209,566,643
3955,6112,1650,2964,1296,4460,1211,567,644
3960,6123,1652,2968,1297,4471,1213,569,644
3965,6127,1653,2970,1298,4473,1213,569,644
3970,6137,1658,2978,1302,4477,1215,571,644
3975,6143,1661,2983,1305,4480,1217,572,645
3980,6154,1666,2988,1310,4487,1219,572,647
3985,6158,1667,2990,1311,4490,1219,572,647
3990,6168,1672,2996,1315,4495,1221,573,648
3995,6174,1673,2999,1316,4499,1223,574,649
4000,6185,1679,3004,1321,4504,1225,574,651
4005,6189,1681,3004,1323,4508,1225,574,651
4010,6199,1686,3013,1328,4513,1227,576,651
4015,6205,1686,3015,1328,4518,1229,577,652
4020,6216,1690,3021,1331,4523,1231,577,654
4025,6220,1694,3024,1335,4524,1231,577,654
4030,6230,1697,3029,1338,4533,1233,578,655
4035,6236,1697,3029,1338,4539,1235,578,657
4040,6247,1700,3037,1340,4545,1237,578,659
4045,6251,1700,3038,1340,4551,1237,578,659
4050,6261,1702,3040,1341,4559,1239,579,660
4055,6267,1702,3046,1341,4564,1241,581,660
4060,6278,1703,3051,1341,4575,1243,583,660
4065,6282,1704,3053,1342,4578,1243,583,660
4070,6292,1706,3055,1344,4586,1245,583,662
4075,6298,1706,3058,1344,4592,1247,585,662
4080,6309,1709,3066,1347,4598,1249,586,663
4085,6313,1710,3069,1348,4602,1249,586,663
4090,6323,1713,3075,1350,4610,1251,587,664
4095,6329,1713,3080,1350,4615,1253,588,665
4100,6340,1714,3083,1350,4624,1255,588,667
4105,6344,1715,3085,1351,4629,1255,588,667
4110,6354,1718,3091,1354,4634,1257,588,669
4115,6360,1721,3097,1357,4638,1259,590,669
4120,6371,1724,3102,1359,4646,1261,591,670
4125,6375,1724,3104,1359,4650,1261,591,670
4130,6385,1725,3108,1360,4660,1263,593,670
4135,6391,1726,3111,1361,4664,1265,593,672
4140,6402,1731,3117,1366,4670,1267,594,673
4145,6406,1732,3119,1367,4674,1267,594,673
4150,6416,1734,3123,1368,4682,1269,595,674
4155,6422,1734,3126,1368,4687,1271,596,675
4160,6433,1738,3130,1372,4695,1273,597,676
4165,6437,1739,3132,1373,4698,1273,597,676
4170,6447,1742,3137,1375,4704,1275,599,676
4175,6453,1743,3138,1376,4710,1277,599,678
4180,6464,1744,3141,1377,4718,1279,599,680
4185,6468,1745,3143,1378,4722,1279,599,680
4190,6478,1748,3149,1381,4728,1281,599,682
4195,6484,1751,3151,1384,4733,1283,599,684
4200,6495,1753,3155,1385,4741,1285,600,685
4205,6499,1755,3159,1387,4743,1285,600,685
4210,6509,1759,3166,1389,4748,1287,602,685
4215,6515,1761,3169,1391,4752,1289,603,686
4220,6526,1767,3175,1396,4756,1291,603,688
4225,6530,1769,3176,1398,4760,1291,603,688
4230,6540,1772,3179,1400,4767,1293,604,689
4235,6546,1773,3181,1401,4773,1295,605,690
4240,6557,1775,3187,1403,4780,1297,607,690
4245,6561,1777,3189,1405,4783,1297,607,690
4250,6571,1780,3191,1407,4791,1299,607,692
4255,6577,1781,3196,1408,4795,1301,609,692
4260,6588,1786,3202,1412,4799,1303,609,694
4265,6592,1788,3203,1414,4803,1303,609,694
4270,6602,1792,3208,1416,4809,1305,611,694
4275,6608,1793,3209,1417,4815,1307,611,696
4280,6619,1796,3216,1420,4821,1309,613,696
4285,6623,1799,3219,1423,4823,1309,613,696
4290,6633,1803,3220,1425,4830,1311,613,698
4295,6639,1803,3224,1425,4835,1313,615,698
4300,6650,1806,3228,1428,4843,1315,616,699
4305,6654,1808,3230,1430,4846,1315,616,699
4310,6664,1811,3234,1432,4852,1317,617,700
4315,6670,1812,3236,1433,4857,1319,618,701
4320,6681,1815,3239,1435,4865,1321,619,702
4325,6685,1818,3241,1438,4867,1321,619,702
4330,6695,1823,3249,1443,4872,1323,620,703
4335,6701,1823,3252,1443,4877,1325,621,704
4340,6712,1825,3256,1445,4886,1327,621,706
4345,6716,1826,3258,1446,4889,1327,621,706
4350,6726,1826,3261,1446,4899,1329,621,708
4355,6732,1826,3264,1446,4905,1331,622,709
4360,6743,1826,3270,1446,4915,1333,623,710
4365,6747,1826,3271,1446,4921,1333,623,710
4370,6757,1826,3279,1446,4930,1335,624,711
4375,6763,1826,3281,1446,4937,1337,624,713
4380,6774,1826,3285,1446,4947,1339,624,715
4385,6778,1826,3287,1446,4952,1339,624,715
4390,6788,1826,3295,1446,4961,1341,625,716
4395,6794,1826,3299,1446,4967,1343,627,716
4400,6805,1826,3305,1446,4979,1345,629,716
4405,6809,1826,3306,1446,4982,1345,629,716
4410,6819,1826,3312,1446,4992,1347,630,717
4415,6825,1826,3314,1446,4999,1349,630,719
4420,6836,1826,3322,1446,5008,1351,631,720
4425,6840,1826,3324,1446,5013,1351,631,720
4430,6850,1827,3328,1447,5022,1353,632,721
4435,6856,1827,3331,1447,5028,1355,634,721
4440,6867,1829,3338,1449,5037,1357,635,722
4445,6871,1830,3340,1450,5041,1357,635,722
4450,6881,1831,3343,1450,5050,1359,635,724
4455,6887,1831,3345,1450,5055,1361,635,726
4460,6898,1833,3350,1452,5064,1363,636,727
4465,6902,1834,3352,1453,5068,1363,636,727
4470,6912,1837,3356,1455,5075,1365,637,728
4475,6918,1837,3357,1455,5081,1367,638,729
4480,6929,1838,3363,1456,5090,1369,639,730
4485,6933,1840,3367,1458,5093,1369,639,730
4490,6943,1843,3372,1461,5100,1371,639,732
4495,6949,1843,3373,1461,5106,1373,639,734
4500,6960,1846,3378,1463,5114,1375,640,735
4505,6964,1846,3380,1463,5118,1375,640,735
4510,6974,1850,3384,1466,5124,1377,641,736
4515,6980,1850,3388,1466,5129,1379,642,737
4520,6991,1852,3393,1468,5139,1381,644,737
4525,6995,1852,3396,1468,5143,1381,644,737
4530,7005,1856,3401,1471,5149,1383,645,738
4535,7011,1856,3402,1471,5155,1385,646,739
4540,7022,1858,3409,1473,5163,1387,648,739
4545,7026,1859,3411,1474,5166,1387,648,739
4550,7036,1864,3415,1478,5172,1389,649,740
4555,7042,1864,3419,1478,5176,1391,651,740
4560,7053,1868,3422,1481,5183,1393,651,742
4565,7057,1872,3424,1485,5185,1393,651,742
4570,7067,1876,3427,1488,5191,1395,651,744
4575,7073,1876,3429,1488,5196,1397,652,745
4580,7084,1879,3432,1491,5205,1399,653,746
4585,7088,1879,3434,1491,5207,1399,653,746
4590,7098,1886,3439,1496,5211,1401,654,747
4595,7104,1888,3444,1498,5214,1403,656,747
4600,7115,1892,3449,1501,5221,1405,658,747
4605,7119,1894,3451,1503,5223,1405,658,747
4610,7129,1900,3456,1508,5227,1407,658,749
4615,7135,1902,3459,1510,5231,1409,659,750
4620,7146,1907,3464,1515,5238,1411,660,751
4625,7150,1909,3466,1517,5240,1411,660,751
4630,7160,1913,3472,1521,5246,1413,662,751
4635,7166,1915,3477,1523,5248,1415,663,752
4640,7177,1919,3480,1526,5256,1417,664,753
4645,7181,1921,3482,1528,5260,1417,664,753
4650,7191,1923,3488,1530,5268,1419,666,753
4655,7197,1924,3494,1531,5271,1421,668,753
4660,7208,1927,3499,1534,5280,1423,668,755
4665,7212,1928,3500,1535,5284,1423,668,755
4670,7222,1929,3503,1535,5292,1425,668,757
4675,7228,1930,3506,1536,5298,1427,669,758
4680,7239,1932,3511,1538,5306,1429,670,759
4685,7243,1933,3514,1539,5309,1429,670,759
4690,7253,1936,3519,1541,5317,1431,672,759
4695,7259,1937,3522,1542,5322,1433,673,760
4700,7270,1938,3527,1542,5329,1435,674,761
4705,7274,1940,3529,1544,5333,1435,674,761
4710,7284,1942,3536,1545,5340,1437,675,762
4715,7290,1945,3541,1548,5344,1439,677,762
4720,7301,1948,3546,1551,5351,1441,677,764
4725,7305,1949,3546,1552,5356,1441,677,764
4730,7315,1951,3552,1553,5364,1443,679,764
4735,7321,1952,3557,1554,5368,1445,680,765
4740,7332,1954,3561,1556,5378,1447,682,765
4745,7336,1955,3564,1557,5381,1447,682,765
4750,7346,1957,3570,1559,5387,1449,682,767
4755,7352,1960,3576,1562,5390,1451,684,767
4760,7363,1965,3584,1566,5395,1453,685,768
4765,7367,1967,3587,1568,5400,1453,685,768
4770,7377,1969,3593,1570,5408,1455,687,768
4775,7383,1969,3599,1570,5412,1457,689,768
4780,7394,1972,3605,1573,5421,1459,691,768
4785,7398,1974,3607,1575,5424,1459,691,768
4790,7408,1977,3612,1577,5431,1461,692,769
4795,7414,1977,3613,1577,5436,1463,692,771
4800,7425,1982,3621,1582,5442,1465,694,771
4805,7429,1984,3623,1584,5445,1465,694,771
4810,7439,1987,3631,1586,5451,1467,696,771
4815,7445,1987,3634,1586,5457,1469,697,772
4820,7456,1991,3640,1590,5463,1471,698,773
4825,7460,1992,3643,1591,5467,1471,698,773
4830,7470,1997,3648,1595,5472,1473,699,774
4835,7476,1997,3653,1595,5477,1475,700,775
4840,7487,1999,3660,1597,5487,1477,702,775
4845,7491,1999,3662,1597,5491,1477,702,775
4850,7501,2002,3665,1599,5499,1479,703,776
4855,7507,2002,3667,1599,5505,1481,704,777
4860,7518,2003,3672,1600,5513,1483,705,778
4865,7522,2005,3675,1602,5515,1483,705,778
4870,7532,2009,3677,1604,5523,1485,705,780
4875,7538,2009,3679,1604,5528,1487,706,781
4880,7549,2010,3681,1605,5538,1489,706,783
4885,7553,2011,3681,1606,5542,1489,706,783
4890,7563,2013,3684,1607,5550,1491,707,784
4895,7569,2013,3688,1607,5555,1493,709,784
4900,7580,2015,3692,1609,5564,1495,709,786
4905,7584,2017,3694,1611,5567,1495,709,786
4910,7594,2018,3697,1612,5576,1497,709,788
4915,7600,2018,3702,1612,5581,1499,711,788
4920,7611,2018,3708,1612,5592,1501,712,789
4925,7615,2018,3710,1612,5597,1501,712,789
4930,7625,2019,3715,1612,5606,1503,712,791
4935,7631,2019,3716,1612,5612,1505,713,792
4940,7642,2022,3723,1614,5619,1507,715,792
4945,7646,2023,3725,1615,5623,1507,715,792
4950,7656,2025,3728,1617,5631,1509,715,794
4955,7662,2025,3731,1617,5636,1511,716,795
4960,7673,2026,3736,1618,5646,1513,717,796
4965,7677,2027,3740,1619,5649,1513,717,796
4970,7687,2029,3746,1621,5657,1515,719,796
4975,7693,2031,3750,1623,5661,1517,721,796
4980,7704,2035,3760,1627,5667,1519,723,796
4985,7708,2036,3763,1628,5671,1519,723,796
4990,7718,2038,3770,1630,5679,1521,725,796
4995,7724,2040,3772,1632,5684,1523,725,798
5000,7735,2042,3778,1633,5693,1525,727,798
5005,7739,2042,3779,1633,5697,1525,727,798
5010,7749,2044,3784,1634,5704,1527,728,799
5015,7755,2045,3786,1635,5710,1529,729,800
5020,7766,2048,3793,1638,5717,1531,730,801
5025,7770,2049,3793,1639,5721,1531,730,801
5030,7780,2052,3798,1642,5728,1533,731,802
5035,7786,2052,3798,1642,5734,1535,731,804
5040,7797,2054,3802,1643,5743,1537,732,805
5045,7801,2054,3803,1643,5747,1537,732,805
5050,7811,2057,3807,1644,5753,1539,733,806
5055,7817,2059,3810,1646,5758,1541,734,807
5060,7828,2063,3818,1650,5764,1543,736,807
5065,7832,2065,3821,1652,5767,1543,736,807
5070,7842,2068,3824,1653,5773,1545,737,808
5075,7848,2069,3829,1654,5777,1547,739,808
5080,7859,2074,3837,1659,5784,1549,740,809
5085,7863,2077,3840,1662,5786,1549,740,809
5090,7873,2079,3842,1662,5793,1551,740,811
5095,7879,2080,3844,1663,5798,1553,741,812
5100,7890,2083,3849,1665,5805,1555,743,812
5105,7894,2087,3852,1669,5806,1555,743,812
5110,7904,2092,3857,1673,5810,1557,743,814
5115,7910,2095,3862,1676,5813,1559,745,814
5120,7921,2098,3866,1679,5822,1561,746,815
5125,7925,2099,3868,1680,5824,1561,746,815
5130,7935,2103,3872,1684,5832,1563,746,817
5135,7941,2103,3877,1684,5835,1565,747,818
5140,7952,2108,3881,1688,5843,1567,747,820
5145,7956,2110,3883,1690,5845,1567,747,820
5150,7966,2113,3886,1692,5853,1569,748,821
5155,7972,2113,3889,1692,5857,1571,749,822
5160,7983,2116,3895,1694,5866,1573,750,823
5165,7987,2116,3895,1694,5871,1573,750,823
5170,7997,2118,3900,1696,5879,1575,752,823
5175,8003,2118,3902,1696,5885,1577,754,823
5180,8014,2119,3904,1696,5894,1579,754,825
5185,8018,2119,3906,1696,5899,1579,754,825
5190,8028,2120,3911,1697,5907,1581,754,827
5195,8034,2120,3913,1697,5913,1583,755,828
5200,8045,2121,3917,1697,5923,1585,755,830
5205,8049,2122,3919,1698,5927,1585,755,830
5210,8059,2123,3922,1699,5935,1587,755,832
5215,8065,2123,3924,1699,5942,1589,756,833
5220,8076,2124,3931,1699,5949,1591,757,834
5225,8080,2125,3932,1700,5955,1591,757,834
5230,8090,2127,3935,1701,5963,1593,758,835
5235,8096,2127,3937,1701,5968,1595,758,837
5240,8107,2130,3945,1703,5975,1597,760,837
5245,8111,2131,3947,1704,5979,1597,760,837
5250,8121,2134,3953,1706,5987,1599,762,837
5255,8127,2134,3957,1706,5992,1601,764,837
5260,8138,2138,3963,1709,5997,1603,765,838
5265,8142,2141,3964,1712,6000,1603,765,838
5270,8152,2145,3970,1716,6006,1605,766,839
5275,8158,2147,3975,1718,6010,1607,768,839
5280,8169,2151,3981,1721,6016,1609,770,839
5285,8173,2153,3983,1723,6019,1609,770,839
5290,8183,2156,3988,1726,6027,1611,771,840
5295,8189,2156,3989,1726,6032,1613,771,842
5300,8200,2159,3994,1729,6039,1615,772,843
5305,8204,2160,3997,1730,6043,1615,772,843
5310,8214,2164,4003,1732,6050,1617,774,843
5315,8220,2164,4005,1732,6055,1619,774,845
5320,8231,2168,4009,1735,6061,1621,774,847
5325,8235,2171,4011,1738,6063,1621,774,847
5330,8245,2173,4014,1739,6071,1623,774,849
5335,8251,2174,4015,1740,6077,1625,775,850
5340,8262,2176,4022,1742,6083,1627,776,851
5345,8266,2178,4023,1744,6088,1627,776,851
5350,8276,2181,4028,1746,6094,1629,777,852
5355,8282,2182,4031,1747,6099,1631,779,852
5360,8293,2185,4035,1749,6107,1633,779,854
5365,8297,2186,4037,1750,6111,1633,779,854
5370,8307,2190,4044,1754,6117,1635,781,854
5375,8313,2190,4048,1754,6123,1637,783,854
5380,8324,2192,4052,1756,6132,1639,784,855
5385,8328,2192,4053,1756,6136,1639,784,855
5390,8338,2194,4056,1756,6144,1641,784,857
5395,8344,2194,4060,1756,6150,1643,785,858
5400,8355,2195,4065,1757,6159,1645,786,859
5405,8359,2196,4067,1758,6162,1645,786,859
5410,8369,2199,4070,1761,6170,1647,786,861
5415,8375,2199,4073,1761,6176,1649,788,861
5420,8386,2201,4079,1763,6184,1651,789,862
5425,8390,2203,4082,1765,6186,1651,789,862
5430,8400,2206,4087,1766,6194,1653,790,863
5435,8406,2206,4089,1766,6199,1655,790,865
5440,8417,2208,4094,1768,6207,1657,790,867
5445,8421,2210,4098,1770,6210,1657,790,867
5450,8431,2213,4104,1772,6218,1659,792,867
5455,8437,2213,4107,1772,6223,1661,793,868
5460,8448,2215,4112,1774,6230,1663,793,870
5465,8452,2219,4114,1778,6233,1663,793,870
5470,8462,2221,4119,1780,6241,1665,794,871
5475,8468,2221,4119,1780,6247,1667,794,873
5480,8479,2224,4124,1782,6254,1669,795,874
5485,8483,2226,4127,1784,6257,1669,795,874
5490,8493,2229,4134,1786,6262,1671,796,875
5495,8499,2231,4138,1788,6267,1673,797,876
5500,8510,2235,4143,1791,6274,1675,797,878
5505,8514,2237,4146,1793,6277,1675,797,878
5510,8524,2240,4150,1795,6282,1677,797,880
5515,8530,2243,4153,1798,6286,1679,798,881
5520,8541,2245,4159,1799,6296,1681,800,881
5525,8545,2246,4160,1800,6299,1681,800,881
5530,8555,2248,4165,1802,6306,1683,801,882
5535,8561,2248,4169,1802,6313,1685,803,882
5540,8572,2249,4175,1803,6323,1687,805,882
5545,8576,2250,4177,1804,6326,1687,805,882
5550,8586,2252,4182,1805,6333,1689,806,883
5555,8592,2252,4186,1805,6339,1691,807,884
5560,8603,2253,4194,1806,6350,1693,809,884
5565,8607,2253,4196,1806,6354,1693,809,884
5570,8617,2255,4201,1808,6362,1695,810,885
5575,8623,2255,4203,1808,6368,1697,811,886
5580,8634,2257,4212,1810,6375,1699,812,887
5585,8638,2258,4214,1811,6379,1699,812,887
5590,8648,2263,4218,1814,6384,1701,813,888
5595,8654,2263,4220,1814,6391,1703,814,889
5600,8665,2267,4226,1818,6397,1705,815,890
5605,8669,2269,4228,1820,6399,1705,815,890
5610,8679,2275,4235,1825,6403,1707,817,890
5615,8685,2275,4236,1825,6409,1709,817,892
5620,8696,2280,4242,1829,6415,1711,818,893
5625,8700,2280,4245,1829,6419,1711,818,893
5630,8710,2283,4249,1831,6426,1713,818,895
5635,8716,2284,4250,1832,6432,1715,819,896
5640,8727,2286,4252,1833,6441,1717,820,897
5645,8731,2287,4253,1834,6444,1717,820,897
5650,8741,2291,4258,1836,6449,1719,821,898
5655,8747,2293,4259,1838,6454,1721,821,900
5660,8758,2296,4266,1841,6460,1723,823,900
5665,8762,2296,4267,1841,6466,1723,823,900
5670,8772,2298,4272,1842,6473,1725,825,900
5675,8778,2300,4277,1844,6476,1727,826,901
5680,8789,2305,4282,1849,6483,1729,827,902
5685,8793,2307,4284,1851,6485,1729,827,902
5690,8803,2311,4288,1854,6492,1731,827,904
5695,8809,2311,4291,1854,6497,1733,828,905
5700,8820,2316,4298,1859,6502,1735,829,906
5705,8824,2317,4300,1860,6506,1735,829,906
5710,8834,2319,4305,1861,6513,1737,829,908
5715,8840,2321,4305,1863,6519,1739,829,910
5720,8851,2322,4311,1864,6526,1741,830,911
5725,8855,2326,4312,1868,6529,1741,830,911
5730,8865,2329,4314,1870,6536,1743,830,913
5735,8871,2329,4316,1870,6540,1745,830,915
5740,8882,2333,4322,1874,6547,1747,831,916
5745,8886,2335,4324,1876,6549,1747,831,916
5750,8896,2339,4327,1879,6557,1749,831,918
5755,8902,2339,4330,1879,6563,1751,832,919
5760,8913,2339,4335,1879,6574,1753,834,919
5765,8917,2339,4339,1879,6577,1753,834,919
5770,8927,2340,4345,1880,6587,1755,836,919
5775,8933,2340,4350,1880,6592,1757,838,919
5780,8944,2340,4353,1880,6604,1759,839,920
5785,8948,2340,4354,1880,6607,1759,839,920
5790,8958,2341,4359,1880,6617,1761,839,922
5795,8964,2341,4361,1880,6623,1763,840,923
5800,8975,2342,4365,1881,6631,1765,840,925
5805,8979,2342,4365,1881,6637,1765,840,925
5810,8989,2344,4369,1883,6645,1767,840,927
5815,8995,2344,4370,1883,6650,1769,840,929
5820,9006,2346,4377,1885,6660,1771,841,930
5825,9010,2346,4378,1885,6664,1771,841,930
5830,9020,2348,4383,1887,6672,1773,843,930
5835,9026,2348,4387,1887,6678,1775,845,930
5840,9037,2349,4391,1888,6687,1777,846,931
5845,9041,2350,4395,1889,6690,1777,846,931
5850,9051,2351,4401,1890,6699,1779,848,931
5855,9057,2353,4405,1892,6704,1781,849,932
5860,9068,2355,4410,1893,6711,1783,850,933
5865,9072,2357,4413,1895,6714,1783,850,933
5870,9082,2360,4420,1898,6720,1785,851,934
5875,9088,2363,4426,1901,6723,1787,853,934
5880,9099,2367,4430,1905,6730,1789,853,936
5885,9103,2369,4432,1907,6734,1789,853,936
5890,9113,2372,4439,1910,6740,1791,854,937
5895,9119,2373,4442,1911,6745,1793,855,938
5900,9130,2377,4450,1915,6750,1795,856,939
5905,9134,2380,4453,1918,6754,1795,856,939
5910,9144,2382,4456,1918,6760,1797,857,940
5915,9150,2384,4457,1920,6766,1799,857,942
5920,9161,2386,4463,1921,6773,1801,857,944
5925,9165,2388,4464,1923,6777,1801,857,944
5930,9175,2390,4469,1924,6784,1803,859,944
5935,9181,2390,4473,1924,6789,1805,860,945
5940,9192,2394,4477,1927,6797,1807,861,946
5945,9196,2395,4480,1928,6800,1807,861,946
5950,9206,2398,4483,1930,6807,1809,861,948
5955,9212,2398,4487,1930,6813,1811,862,949
5960,9223,2402,4491,1934,6820,1813,862,951
5965,9227,2405,4495,1937,6821,1813,862,951
5970,9237,2408,4500,1939,6828,1815,864,951
5975,9243,2408,4504,1939,6834,1817,866,951
5980,9254,2411,4511,1942,6840,1819,867,952
5985,9258,2414,4513,1945,6844,1819,867,952
5990,9268,2417,4517,1947,6850,1821,868,953
5995,9274,2417,4519,1947,6856,1823,869,954
6000,9285,2421,4525,1951,6862,1825,869,956
6005,9289,2422,4525,1952,6867,1825,869,956
6010,9299,2422,4528,1952,6876,1827,869,958
6015,9305,2422,4531,1952,6883,1829,871,958
6020,9316,2424,4537,1954,6891,1831,872,959
6025,9320,2424,4538,1954,6895,1831,872,959
6030,9330,2426,4542,1955,6904,1833,873,960
6035,9336,2426,4545,1955,6909,1835,874,961
6040,9347,2428,4550,1956,6918,1837,874,963
6045,9351,2428,4551,1956,6923,1837,874,963
6050,9361,2430,4556,1957,6930,1839,875,964
6055,9367,2430,4558,1957,6936,1841,876,965
6060,9378,2432,4562,1959,6946,1843,877,966
6065,9382,2433,4565,1960,6948,1843,877,966
6070,9392,2436,4570,1963,6956,1845,878,967
6075,9398,2436,4574,1963,6961,1847,878,969
6080,9409,2438,4578,1964,6971,1849,879,970
6085,9413,2439,4580,1965,6974,1849,879,970
6090,9423,2441,4584,1967,6981,1851,880,971
6095,9429,2441,4588,1967,6987,1853,882,971
6100,9440,2443,4595,1968,6997,1855,884,971
6105,9444,2444,4598,1969,6999,1855,884,971
6110,9454,2448,4604,1971,7006,1857,885,972
6115,9460,2448,4608,1971,7010,1859,886,973
6120,9471,2453,4615,1976,7017,1861,887,974
6125,9475,2454,4617,1977,7021,1861,887,974
6130,9485,2456,4622,1978,7029,1863,888,975
6135,9491,2456,4628,1978,7034,1865,890,975
6140,9502,2459,4634,1981,7042,1867,892,975
6145,9506,2461,4635,1983,7045,1867,892,975
6150,9516,2463,4640,1983,7053,1869,893,976
6155,9522,2463,4645,1983,7058,1871,895,976
6160,9533,2466,4652,1986,7066,1873,897,976
6165,9537,2468,4653,1988,7069,1873,897,976
6170,9547,2471,4657,1990,7076,1875,898,977
6175,9553,2471,4659,1990,7082,1877,899,978
6180,9564,2473,4666,1992,7089,1879,901,978
6185,9568,2475,4667,1994,7093,1879,901,978
6190,9578,2478,4672,1997,7100,1881,901,980
6195,9584,2478,4675,1997,7106,1883,901,982
6200,9595,2479,4684,1998,7115,1885,902,983
6205,9599,2479,4686,1998,7119,1885,902,983
6210,9609,2482,4693,2001,7127,1887,903,984
6215,9615,2482,4697,2001,7133,1889,905,984
6220,9626,2484,4702,2002,7142,1891,906,985
6225,9630,2484,4704,2002,7146,1891,906,985
6230,9640,2487,4710,2004,7153,1893,908,985
6235,9646,2487,4713,2004,7158,1895,909,986
6240,9657,2489,4721,2006,7165,1897,911,986
6245,9661,2491,4723,2008,7170,1897,911,986
6250,9671,2493,4730,2010,7177,1899,913,986
6255,9677,2494,4731,2011,7183,1901,913,988
6260,9688,2496,4736,2013,7191,1903,913,990
6265,9692,2497,4738,2014,7194,1903,913,990
6270,9702,2498,4743,2015,7203,1905,914,991
6275,9708,2499,4744,2016,7209,1907,915,992
6280,9719,2501,4751,2018,7218,1909,917,992
6285,9723,2501,4753,2018,7221,1909,917,992
6290,9733,2503,4758,2020,7228,1911,917,994
6295,9739,2506,4761,2023,7232,1913,918,995
6300,9750,2510,4769,2027,7237,1915,920,995
6305,9754,2514,4771,2031,7239,1915,920,995
6310,9764,2517,4776,2033,7245,1917,922,995
6315,9770,2519,4779,2035,7249,1919,923,996
6320,9781,2524,4783,2039,7256,1921,924,997
6325,9785,2525,4784,2040,7259,1921,924,997
6330,9795,2529,4790,2043,7264,1923,926,997
6335,9801,2531,4793,2045,7268,1925,927,998
6340,9812,2535,4795,2048,7276,1927,927,1000
6345,9816,2537,4796,2050,7279,1927,927,1000
6350,9826,2540,4799,2051,7284,1929,927,1002
6355,9832,2542,4803,2053,7287,1931,928,1003
6360,9843,2548,4809,2059,7293,1933,929,1004
6365,9847,2549,4810,2060,7298,1933,929,1004
6370,9857,2551,4815,2061,7304,1935,930,1005
6375,9863,2554,4818,2064,7309,1937,932,1005
6380,9874,2557,4825,2067,7315,1939,932,1007
6385,9878,2557,4827,2067,7321,1939,932,1007
6390,9888,2560,4834,2070,7327,1941,933,1008
6395,9894,2561,4837,2071,7332,1943,934,1009
6400,9905,2564,4843,2073,7339,1945,935,1010
6405,9909,2565,4845,2074,7344,1945,935,1010
6410,9919,2567,4851,2075,7350,1947,936,1011
6415,9925,2569,4853,2077,7356,1949,937,1012
6420,9936,2571,4859,2079,7364,1951,938,1013
6425,9940,2571,4861,2079,7369,1951,938,1013
6430,9950,2572,4865,2080,7377,1953,939,1014
6435,9956,2574,4867,2082,7382,1955,939,1016
6440,9967,2576,4871,2083,7390,1957,941,1016
6445,9971,2577,4872,2084,7394,1957,941,1016
6450,9981,2578,4875,2085,7403,1959,941,1018
6455,9987,2578,4877,2085,7409,1961,942,1019
6460,9998,2580,4879,2087,7418,1963,942,1021
6465,10002,2580,4880,2087,7422,1963,942,1021
6470,10012,2582,4885,2089,7429,1965,943,1022
6475,10018,2584,4889,2091,7433,1967,944,1023
6480,10029,2588,4896,2094,7438,1969,945,1024
6485,10033,2590,4898,2096,7443,1969,945,1024
6490,10043,2593,4901,2098,7450,1971,946,1025
6495,10049,2593,4903,2098,7454,1973,946,1027
6500,10060,2598,4909,2103,7460,1975,947,1028
6505,10064,2600,4912,2105,7463,1975,947,1028
6510,10074,2603,4916,2107,7470,1977,948,1029
6515,10080,2604,4919,2108,7474,1979,949,1030
6520,10091,2610,4926,2114,7479,1981,950,1031
6525,10095,2612,4926,2116,7483,1981,950,1031
6530,10105,2615,4929,2118,7490,1983,950,1033
6535,10111,2615,4931,2118,7495,1985,950,1035
6540,10122,2618,4940,2121,7502,1987,952,1035
6545,10126,2620,4943,2123,7505,1987,952,1035
6550,10136,2623,4950,2125,7513,1989,954,1035
6555,10142,2623,4952,2125,7519,1991,955,1036
6560,10153,2626,4957,2127,7526,1993,957,1036
6565,10157,2628,4960,2129,7528,1993,957,1036
6570,10167,2630,4964,2130,7537,1995,957,1038
6575,10173,2630,4968,2130,7543,1997,958,1039
6580,10184,2632,4971,2132,7552,1999,958,1041
6585,10188,2633,4973,2133,7554,1999,958,1041
6590,10198,2635,4978,2135,7563,2001,960,1041
6595,10204,2635,4980,2135,7568,2003,961,1042
6600,10215,2637,4985,2137,7576,2005,963,1042
6605,10219,2639,4987,2139,7580,2005,963,1042
6610,10229,2640,4991,2140,7589,2007,964,1043
6615,10235,2640,4993,2140,7595,2009,965,1044
6620,10246,2642,5001,2142,7602,2011,966,1045
6625,10250,2643,5004,2143,7607,2011,966,1045
6630,10260,2645,5007,2144,7615,2013,966,1047
6635,10266,2645,5007,2144,7621,2015,966,1049
6640,10277,2646,5013,2145,7629,2017,967,1050
6645,10281,2646,5014,2145,7635,2017,967,1050
6650,10291,2648,5019,2147,7643,2019,968,1051
6655,10297,2648,5021,2147,7648,2021,969,1052
6660,10308,2652,5026,2150,7655,2023,969,1054
6665,10312,2653,5028,2151,7659,2023,969,1054
6670,10322,2656,5037,2154,7665,2025,971,1054
6675,10328,2657,5040,2155,7670,2027,973,1054
6680,10339,2660,5045,2158,7679,2029,974,1055
6685,10343,2661,5048,2159,7682,2029,974,1055
6690,10353,2664,5053,2161,7689,2031,975,1056
6695,10359,2664,5055,2161,7695,2033,976,1057
6700,10370,2666,5060,2163,7703,2035,976,1059
6705,10374,2668,5063,2165,7705,2035,976,1059
6710,10384,2673,5072,2170,7709,2037,978,1059
6715,10390,2676,5077,2173,7713,2039,980,1059
6720,10401,2680,5085,2177,7719,2041,982,1059
6725,10405,2682,5086,2179,7723,2041,982,1059
6730,10415,2685,5091,2180,7729,2043,984,1059
6735,10421,2687,5095,2182,7734,2045,986,1059
6740,10432,2691,5102,2186,7740,2047,987,1060
6745,10436,2693,5104,2188,7742,2047,987,1060
6750,10446,2696,5106,2190,7749,2049,987,1062
6755,10452,2697,5107,2191,7755,2051,988,1063
6760,10463,2700,5113,2194,7760,2053,988,1065
6765,10467,2704,5114,2198,7763,2053,988,1065
6770,10477,2708,5119,2202,7768,2055,988,1067
6775,10483,2709,5121,2203,7774,2057,990,1067
6780,10494,2712,5126,2205,7780,2059,991,1068
6785,10498,2715,5127,2208,7783,2059,991,1068
6790,10508,2718,5133,2211,7789,2061,992,1069
6795,10514,2719,5136,2212,7794,2063,994,1069
6800,10525,2720,5140,2213,7805,2065,996,1069
6805,10529,2721,5143,2214,7807,2065,996,1069
6810,10539,2724,5149,2216,7815,2067,998,1069
6815,10545,2724,5154,2216,7819,2069,1000,1069
6820,10556,2727,5161,2219,7827,2071,1002,1069
6825,10560,2728,5164,2220,7832,2071,1002,1069
6830,10570,2728,5168,2220,7842,2073,1004,1069
6835,10576,2728,5171,2220,7846,2075,1004,1071
6840,10587,2728,5176,2220,7858,2077,1004,1073
6845,10591,2728,5176,2220,7863,2077,1004,1073
6850,10601,2728,5178,2220,7872,2079,1004,1075
6855,10607,2728,5182,2220,7878,2081,1006,1075
6860,10618,2728,5188,2220,7889,2083,1007,1076
6865,10622,2728,5191,2220,7894,2083,1007,1076
6870,10632,2728,5199,2220,7903,2085,1008,1077
6875,10638,2728,5202,2220,7909,2087,1009,1078
6880,10649,2728,5204,2220,7921,2089,1010,1079
6885,10653,2728,5205,2220,7925,2089,1010,1079
6890,10663,2730,5209,2222,7932,2091,1010,1081
6895,10669,2730,5213,2222,7939,2093,1011,1082
6900,10680,2731,5218,2222,7948,2095,1012,1083
6905,10684,2731,5219,2222,7953,2095,1012,1083
6910,10694,2733,5224,2223,7961,2097,1013,1084
6915,10700,2733,5227,2223,7967,2099,1014,1085
6920,10711,2734,5234,2224,7976,2101,1015,1086
6925,10715,2734,5235,2224,7980,2101,1015,1086
6930,10725,2736,5240,2226,7989,2103,1016,1087
6935,10731,2736,5245,2226,7995,2105,1018,1087
6940,10742,2738,5250,2227,8002,2107,1019,1088
6945,10746,2739,5252,2228,8007,2107,1019,1088
6950,10756,2742,5255,2230,8014,2109,1019,1090
6955,10762,2742,5259,2230,8020,2111,1020,1091
6960,10773,2745,5264,2232,8027,2113,1020,1093
6965,10777,2745,5265,2232,8032,2113,1020,1093
6970,10787,2749,5272,2236,8038,2115,1021,1094
6975,10793,2749,5275,2236,8044,2117,1023,1094
6980,10804,2753,5282,2240,8049,2119,1024,1095
6985,10808,2756,5285,2243,8050,2119,1024,1095
6990,10818,2762,5291,2248,8056,2121,1025,1096
6995,10824,2762,5294,2248,8061,2123,1026,1097
7000,10835,2766,5300,2251,8068,2125,1028,1097
7005,10839,2768,5302,2253,8070,2125,1028,1097
7010,10849,2771,5303,2255,8078,2127,1028,1099
7015,10855,2772,5304,2256,8083,2129,1028,1101
7020,10866,2775,5311,2258,8087,2131,1029,1102
7025,10870,2780,5313,2263,8089,2131,1029,1102
7030,10880,2785,5317,2266,8094,2133,1030,1103
7035,10886,2787,5321,2268,8098,2135,1032,1103
7040,10897,2790,5328,2271,8106,2137,1034,1103
7045,10901,2792,5332,2273,8108,2137,1034,1103
7050,10911,2794,5336,2274,8117,2139,1035,1104
7055,10917,2794,5339,2274,8121,2141,1036,1105
7060,10928,2797,5346,2277,8130,2143,1037,1106
7065,10932,2798,5348,2278,8133,2143,1037,1106
7070,10942,2801,5354,2281,8140,2145,1038,1107
7075,10948,2802,5358,2282,8144,2147,1039,1108
7080,10959,2806,5367,2286,8150,2149,1040,1109
7085,10963,2808,5368,2288,8155,2149,1040,1109
7090,10973,2811,5373,2291,8161,2151,1040,1111
7095,10979,2813,5376,2293,8165,2153,1041,1112
7100,10990,2815,5381,2295,8174,2155,1042,1113
7105,10994,2817,5385,2297,8176,2155,1042,1113
7110,11004,2819,5392,2299,8183,2157,1044,1113
7115,11010,2822,5395,2302,8188,2159,1045,1114
7120,11021,2824,5401,2304,8195,2161,1046,1115
7125,11025,2824,5402,2304,8201,2161,1046,1115
7130,11035,2826,5409,2305,8208,2163,1048,1115
7135,11041,2827,5410,2306,8214,2165,1049,1116
7140,11052,2829,5415,2307,8221,2167,1050,1117
7145,11056,2831,5417,2309,8224,2167,1050,1117
7150,11066,2833,5422,2309,8231,2169,1052,1117
7155,11072,2835,5425,2311,8235,2171,1052,1119
7160,11083,2840,5429,2315,8242,2173,1053,1120
7165,11087,2841,5432,2316,8245,2173,1053,1120
7170,11097,2843,5436,2317,8252,2175,1053,1122
7175,11103,2846,5439,2320,8257,2177,1055,1122
7180,11114,2847,5444,2321,8266,2179,1057,1122
7185,11118,2849,5446,2323,8269,2179,1057,1122
7190,11128,2852,5452,2326,8275,2181,1058,1123
7195,11134,2852,5455,2326,8281,2183,1060,1123
7200,11145,2854,5461,2328,8289,2185,1062,1123
7205,11149,2856,5463,2330,8292,2185,1062,1123
7210,11159,2857,5467,2331,8302,2187,1063,1124
7215,11165,2857,5471,2331,8307,2189,1065,1124
7220,11176,2862,5474,2335,8314,2191,1065,1126
7225,11180,2863,5475,2336,8317,2191,1065,1126
7230,11190,2866,5480,2339,8324,2193,1065,1128
7235,11196,2866,5484,2339,8327,2195,1066,1129
7240,11207,2871,5489,2344,8335,2197,1067,1130
7245,11211,2874,5492,2347,8336,2197,1067,1130
7250,11221,2879,5499,2351,8341,2199,1068,1131
7255,11227,2879,5502,2351,8346,2201,1068,1133
7260,11238,2882,5509,2354,8354,2203,1070,1133
7265,11242,2884,5511,2356,8357,2203,1070,1133
7270,11252,2885,5517,2357,8367,2205,1071,1134
7275,11258,2885,5522,2357,8373,2207,1073,1134
7280,11269,2885,5529,2357,8382,2209,1074,1135
7285,11273,2885,5530,2357,8388,2209,1074,1135
7290,11283,2886,5535,2358,8397,2211,1074,1137
7295,11289,2886,5538,2358,8403,2213,1076,1137
7300,11300,2886,5542,2358,8413,2215,1076,1139
7305,11304,2886,5544,2358,8418,2215,1076,1139
7310,11314,2887,5549,2359,8427,2217,1076,1141
7315,11320,2887,5553,2359,8433,2219,1078,1141
7320,11331,2887,5557,2359,8443,2221,1078,1143
7325,11335,2887,5560,2359,8448,2221,1078,1143
7330,11345,2888,5563,2359,8457,2223,1079,1144
7335,11351,2888,5564,2359,8463,2225,1079,1146
7340,11362,2888,5567,2359,8474,2227,1079,1148
7345,11366,2888,5569,2359,8478,2227,1079,1148
7350,11376,2889,5573,2359,8487,2229,1079,1150
7355,11382,2889,5576,2359,8493,2231,1080,1151
7360,11393,2889,5581,2359,8503,2233,1081,1152
7365,11397,2889,5583,2359,8508,2233,1081,1152
7370,11407,2891,5586,2360,8515,2235,1081,1154
7375,11413,2892,5589,2361,8520,2237,1083,1154
7380,11424,2897,5593,2366,8527,2239,1083,1156
7385,11428,2897,5595,2366,8529,2239,1083,1156
7390,11438,2902,5599,2371,8535,2241,1083,1158
7395,11444,2904,5604,2373,8537,2243,1084,1159
7400,11455,2910,5607,2378,8544,2245,1084,1161
7405,11459,2911,5609,2379,8546,2245,1084,1161
7410,11469,2918,5616,2385,8549,2247,1085,1162
7415,11475,2921,5618,2388,8553,2249,1085,1164
7420,11486,2926,5623,2393,8559,2251,1085,1166
7425,11490,2929,5626,2396,8560,2251,1085,1166
7430,11500,2933,5630,2400,8567,2253,1086,1167
7435,11506,2934,5633,2401,8571,2255,1087,1168
7440,11517,2939,5636,2405,8578,2257,1087,1170
7445,11521,2939,5637,2405,8582,2257,1087,1170
7450,11531,2941,5641,2406,8590,2259,1089,1170
7455,11537,2941,5643,2406,8594,2261,1089,1172
7460,11548,2945,5644,2409,8603,2263,1089,1174
7465,11552,2946,5646,2410,8605,2263,1089,1174
7470,11562,2950,5651,2412,8611,2265,1090,1175
7475,11568,2951,5653,2413,8617,2267,1091,1176
7480,11579,2952,5656,2413,8625,2269,1092,1177
7485,11583,2953,5656,2414,8630,2269,1092,1177
7490,11593,2955,5660,2414,8636,2271,1093,1178
7495,11599,2958,5663,2417,8640,2273,1094,1179
7500,11610,2963,5668,2421,8646,2275,1094,1181
7505,11614,2964,5671,2422,8649,2275,1094,1181
7510,11624,2967,5675,2423,8657,2277,1096,1181
7515,11630,2967,5677,2423,8662,2279,1097,1182
7520,11641,2970,5683,2426,8669,2281,1098,1183
7525,11645,2972,5685,2428,8672,2281,1098,1183
7530,11655,2977,5690,2432,8678,2283,1099,1184
7535,11661,2977,5691,2432,8684,2285,1100,1185
7540,11672,2981,5697,2435,8689,2287,1101,1186
7545,11676,2983,5699,2437,8692,2287,1101,1186
7550,11686,2986,5704,2440,8699,2289,1101,1188
7555,11692,2987,5705,2441,8704,2291,1101,1190
7560,11703,2989,5707,2442,8713,2293,1102,1191
7565,11707,2990,5710,2443,8717,2293,1102,1191
7570,11717,2992,5718,2444,8723,2295,1104,1191
7575,11723,2994,5720,2446,8728,2297,1105,1192
7580,11734,2997,5725,2448,8736,2299,1105,1194
7585,11738,2999,5728,2450,8739,2299,1105,1194
7590,11748,3001,5734,2452,8747,2301,1107,1194
7595,11754,3002,5738,2453,8751,2303,1109,1194
7600,11765,3006,5744,2457,8759,2305,1110,1195
7605,11769,3006,5745,2457,8763,2305,1110,1195
7610,11779,3009,5749,2459,8770,2307,1111,1196
7615,11785,3009,5752,2459,8776,2309,1112,1197
7620,11796,3011,5756,2461,8785,2311,1112,1199
7625,11800,3012,5758,2462,8788,2311,1112,1199
7630,11810,3013,5759,2462,8797,2313,1112,1201
7635,11816,3014,5762,2463,8801,2315,1113,1202
7640,11827,3017,5768,2465,8810,2317,1114,1203
7645,11831,3018,5772,2466,8812,2317,1114,1203
7650,11841,3022,5776,2469,8818,2319,1114,1205
7655,11847,3023,5778,2470,8823,2321,1115,1206
7660,11858,3026,5783,2473,8831,2323,1117,1206
7665,11862,3029,5787,2476,8831,2323,1117,1206
7670,11872,3037,5793,2482,8834,2325,1118,1207
7675,11878,3038,5796,2483,8837,2327,1118,1209
7680,11889,3044,5803,2489,8841,2329,1118,1211
7685,11893,3047,5806,2492,8845,2329,1118,1211
7690,11903,3049,5813,2494,8852,2331,1119,1212
7695,11909,3050,5814,2495,8859,2333,1119,1214
7700,11920,3051,5823,2496,8866,2335,1121,1214
7705,11924,3052,5825,2497,8872,2335,1121,1214
7710,11934,3053,5830,2498,8880,2337,1121,1216
7715,11940,3053,5832,2498,8887,2339,1122,1217
7720,11951,3053,5837,2498,8897,2341,1124,1217
7725,11955,3053,5839,2498,8901,2341,1124,1217
7730,11965,3054,5845,2499,8910,2343,1124,1219
7735,11971,3054,5846,2499,8917,2345,1125,1220
7740,11982,3055,5851,2500,8925,2347,1125,1222
7745,11986,3055,5853,2500,8931,2347,1125,1222
7750,11996,3056,5857,2501,8940,2349,1125,1224
7755,12002,3056,5860,2501,8945,2351,1125,1226
7760,12013,3058,5866,2503,8954,2353,1126,1227
7765,12017,3059,5868,2504,8958,2353,1126,1227
7770,12027,3060,5874,2505,8966,2355,1127,1228
7775,12033,3060,5877,2505,8973,2357,1129,1228
7780,12044,3060,5883,2505,8982,2359,1129,1230
7785,12048,3060,5885,2505,8988,2359,1129,1230
7790,12058,3062,5889,2506,8995,2361,1130,1231
7795,12064,3062,5894,2506,9000,2363,1132,1231
7800,12075,3065,5899,2508,9007,2365,1132,1233
7805,12079,3067,5901,2510,9012,2365,1132,1233
7810,12089,3069,5907,2512,9020,2367,1134,1233
7815,12095,3069,5913,2512,9025,2369,1136,1233
7820,12106,3070,5917,2513,9034,2371,1136,1235
7825,12110,3071,5918,2514,9039,2371,1136,1235
7830,12120,3073,5923,2516,9047,2373,1137,1236
7835,12126,3073,5928,2516,9053,2375,1139,1236
7840,12137,3074,5936,2517,9061,2377,1141,1236
7845,12141,3074,5937,2517,9067,2377,1141,1236
7850,12151,3076,5940,2519,9075,2379,1141,1238
7855,12157,3076,5944,2519,9081,2381,1142,1239
7860,12168,3078,5949,2520,9089,2383,1144,1239
7865,12172,3079,5952,2521,9093,2383,1144,1239
7870,12182,3081,5955,2522,9101,2385,1145,1240
7875,12188,3081,5958,2522,9107,2387,1147,1240
7880,12199,3083,5960,2524,9116,2389,1147,1242
7885,12203,3083,5962,2524,9120,2389,1147,1242
7890,12213,3085,5966,2525,9128,2391,1148,1243
7895,12219,3085,5971,2525,9134,2393,1150,1243
7900,12230,3087,5978,2527,9142,2395,1152,1243
7905,12234,3087,5978,2527,9147,2395,1152,1243
7910,12244,3090,5986,2530,9152,2397,1152,1245
7915,12250,3092,5987,2532,9158,2399,1153,1246
7920,12261,3095,5992,2534,9165,2401,1155,1246
7925,12265,3096,5992,2535,9169,2401,1155,1246
7930,12275,3098,5994,2536,9177,2403,1156,1247
7935,12281,3098,5996,2536,9182,2405,1157,1248
7940,12292,3101,6001,2538,9189,2407,1159,1248
7945,12296,3104,6003,2541,9191,2407,1159,1248
7950,12306,3107,6005,2543,9199,2409,1160,1249
7955,12312,3107,6005,2543,9205,2411,1160,1251
7960,12323,3109,6010,2545,9213,2413,1162,1251
7965,12327,3112,6013,2548,9214,2413,1162,1251
7970,12337,3116,6017,2552,9220,2415,1162,1253
7975,12343,3117,6020,2553,9224,2417,1163,1254
7980,12354,3123,6024,2558,9230,2419,1163,1256
7985,12358,3124,6024,2559,9234,2419,1163,1256
7990,12368,3128,6028,2562,9239,2421,1163,1258
7995,12374,3130,6031,2564,9242,2423,1163,1260
8000,12385,3133,6032,2566,9251,2425,1163,1262
8005,12389,3134,6032,2567,9255,2425,1163,1262
8010,12399,3138,6036,2569,9260,2427,1164,1263
8015,12405,3139,6037,2570,9265,2429,1164,1265
8020,12416,3143,6042,2574,9272,2431,1165,1266
8025,12420,3146,6044,2577,9274,2431,1165,1266
8030,12430,3150,6048,2580,9279,2433,1165,1268
8035,12436,3152,6049,2582,9284,2435,1165,1270
8040,12447,3155,6054,2585,9291,2437,1166,1271
8045,12451,3156,6056,2586,9293,2437,1166,1271
8050,12461,3162,6064,2591,9298,2439,1168,1271
8055,12467,3163,6065,2592,9304,2441,1169,1272
8060,12478,3164,6066,2592,9314,2443,1170,1273
8065,12482,3165,6068,2593,9317,2443,1170,1273
8070,12492,3167,6075,2595,9325,2445,1172,1273
8075,12498,3167,6078,2595,9329,2447,1173,1274
8080,12509,3171,6083,2598,9337,2449,1174,1275
8085,12513,3171,6084,2598,9342,2449,1174,1275
8090,12523,3173,6087,2600,9349,2451,1174,1277
8095,12529,3174,6090,2601,9354,2453,1175,1278
8100,12540,3178,6096,2605,9361,2455,1176,1279
8105,12544,3178,6098,2605,9365,2455,1176,1279
8110,12554,3181,6102,2607,9373,2457,1176,1281
8115,12560,3181,6103,2607,9378,2459,1176,1283
8120,12571,3184,6109,2610,9385,2461,1176,1285
8125,12575,3185,6111,2611,9389,2461,1176,1285
8130,12585,3188,6117,2613,9395,2463,1177,1286
8135,12591,3190,6119,2615,9401,2465,1178,1287
8140,12602,3191,6125,2615,9410,2467,1178,1289
8145,12606,3193,6127,2617,9413,2467,1178,1289
8150,12616,3196,6133,2620,9419,2469,1179,1290
8155,12622,3197,6136,2621,9424,2471,1180,1291
8160,12633,3202,6143,2625,9430,2473,1181,1292
8165,12637,3204,6145,2627,9433,2473,1181,1292
8170,12647,3207,6149,2629,9439,2475,1182,1293
8175,12653,3209,6152,2631,9443,2477,1182,1295
8180,12664,3212,6155,2633,9451,2479,1182,1297
8185,12668,3215,6158,2636,9452,2479,1182,1297
8190,12678,3220,6163,2639,9457,2481,1184,1297
8195,12684,3222,6166,2641,9462,2483,1185,1298
8200,12695,3224,6171,2643,9470,2485,1186,1299
8205,12699,3227,6175,2646,9471,2485,1186,1299
8210,12709,3230,6176,2648,9479,2487,1186,1301
8215,12715,3231,6179,2649,9484,2489,1187,1302
8220,12726,3233,6181,2650,9493,2491,1187,1304
8225,12730,3234,6184,2651,9496,2491,1187,1304
8230,12740,3235,6188,2651,9505,2493,1188,1305
8235,12746,3235,6189,2651,9511,2495,1189,1306
8240,12757,3235,6190,2651,9522,2497,1189,1308
8245,12761,3236,6192,2652,9524,2497,1189,1308
8250,12771,3239,6198,2655,9532,2499,1190,1309
8255,12777,3239,6200,2655,9537,2501,1191,1310
8260,12788,3242,6206,2658,9544,2503,1192,1311
8265,12792,3243,6208,2659,9548,2503,1192,1311
8270,12802,3244,6213,2660,9558,2505,1194,1311
8275,12808,3244,6216,2660,9563,2507,1195,1312
8280,12819,3245,6220,2661,9573,2509,1195,1314
8285,12823,3246,6223,2662,9576,2509,1195,1314
8290,12833,3247,6230,2662,9585,2511,1196,1315
8295,12839,3247,6231,2662,9592,2513,1196,1317
8300,12850,3248,6239,2663,9600,2515,1198,1317
8305,12854,3249,6241,2664,9605,2515,1198,1317
8310,12864,3250,6246,2664,9613,2517,1200,1317
8315,12870,3250,6250,2664,9618,2519,1201,1318
8320,12881,3252,6256,2666,9628,2521,1202,1319
8325,12885,3252,6259,2666,9632,2521,1202,1319
8330,12895,3255,6262,2667,9640,2523,1203,1320
8335,12901,3255,6266,2667,9646,2525,1205,1320
8340,12912,3256,6271,2667,9653,2527,1206,1321
8345,12916,3258,6272,2669,9658,2527,1206,1321
8350,12926,3261,6275,2670,9665,2529,1207,1322
8355,12932,3261,6277,2670,9670,2531,1207,1324
8360,12943,3264,6283,2673,9678,2533,1208,1325
8365,12947,3265,6286,2674,9681,2533,1208,1325
8370,12957,3270,6291,2678,9687,2535,1209,1326
8375,12963,3270,6293,2678,9692,2537,1210,1327
8380,12974,3273,6301,2681,9699,2539,1212,1327
8385,12978,3276,6303,2684,9702,2539,1212,1327
8390,12988,3279,6310,2686,9709,2541,1214,1327
8395,12994,3280,6314,2687,9713,2543,1216,1327
8400,13005,3282,6321,2689,9721,2545,1217,1328
8405,13009,3284,6324,2691,9724,2545,1217,1328
8410,13019,3286,6328,2692,9732,2547,1217,1330
8415,13025,3288,6331,2694,9737,2549,1218,1331
8420,13036,3291,6339,2697,9742,2551,1219,1332
8425,13040,3293,6342,2699,9746,2551,1219,1332
8430,13050,3295,6347,2700,9753,2553,1221,1332
8435,13056,3297,6351,2702,9759,2555,1223,1332
8440,13067,3299,6358,2704,9767,2557,1224,1333
8445,13071,3299,6359,2704,9771,2557,1224,1333
8450,13081,3300,6363,2704,9781,2559,1226,1333
8455,13087,3300,6366,2704,9787,2561,1227,1334
8460,13098,3301,6368,2704,9797,2563,1227,1336
8465,13102,3301,6368,2704,9801,2563,1227,1336
8470,13112,3303,6373,2705,9809,2565,1229,1336
8475,13118,3303,6376,2705,9814,2567,1229,1338
8480,13129,3306,6382,2707,9823,2569,1231,1338
8485,13133,3307,6385,2708,9825,2569,1231,1338
8490,13143,3309,6387,2709,9834,2571,1232,1339
8495,13149,3309,6389,2709,9840,2573,1232,1341
8500,13160,3312,6394,2711,9847,2575,1232,1343
8505,13164,3313,6396,2712,9850,2575,1232,1343
8510,13174,3317,6401,2715,9857,2577,1232,1345
8515,13180,3317,6404,2715,9863,2579,1233,1346
8520,13191,3320,6410,2718,9870,2581,1234,1347
8525,13195,3322,6413,2720,9873,2581,1234,1347
8530,13205,3325,6416,2721,9880,2583,1235,1348
8535,13211,3325,6419,2721,9886,2585,1236,1349
8540,13222,3327,6423,2723,9893,2587,1236,1351
8545,13226,3329,6425,2725,9897,2587,1236,1351
8550,13236,3333,6432,2728,9901,2589,1237,1352
8555,13242,3335,6433,2730,9906,2591,1237,1354
8560,13253,3338,6440,2732,9912,2593,1239,1354
8565,13257,3340,6442,2734,9917,2593,1239,1354
8570,13267,3343,6445,2735,9923,2595,1239,1356
8575,13273,3344,6445,2736,9929,2597,1239,1358
8580,13284,3345,6449,2737,9936,2599,1239,1360
8585,13288,3347,6452,2739,9941,2599,1239,1360
8590,13298,3349,6456,2740,9948,2601,1241,1360
8595,13304,3351,6461,2742,9952,2603,1243,1360
8600,13315,3355,6465,2746,9959,2605,1243,1362
8605,13319,3356,6466,2747,9963,2605,1243,1362
8610,13329,3359,6474,2750,9968,2607,1245,1362
8615,13335,3362,6478,2753,9971,2609,1246,1363
8620,13346,3368,6486,2759,9976,2611,1248,1363
8625,13350,3371,6488,2762,9978,2611,1248,1363
8630,13360,3375,6491,2765,9985,2613,1249,1364
8635,13366,3376,6495,2766,9988,2615,1250,1365
8640,13377,3382,6501,2771,9993,2617,1251,1366
8645,13381,3384,6503,2773,9995,2617,1251,1366
8650,13391,3388,6506,2776,10002,2619,1251,1368
8655,13397,3388,6511,2776,10006,2621,1252,1369
8660,13408,3391,6517,2779,10014,2623,1252,1371
8665,13412,3395,6520,2783,10015,2623,1252,1371
8670,13422,3400,6528,2788,10021,2625,1253,1372
8675,13428,3400,6530,2788,10028,2627,1254,1373
8680,13439,3400,6536,2788,10038,2629,1256,1373
8685,13443,3400,6538,2788,10043,2629,1256,1373
8690,13453,3400,6541,2788,10053,2631,1257,1374
8695,13459,3400,6543,2788,10057,2633,1257,1376
8700,13470,3400,6550,2788,10069,2635,1258,1377
8705,13474,3400,6554,2788,10074,2635,1258,1377
8710,13484,3400,6556,2788,10084,2637,1259,1378
8715,13490,3400,6558,2788,10089,2639,1259,1380
8720,13501,3400,6563,2788,10101,2641,1261,1380
8725,13505,3400,6566,2788,10105,2641,1261,1380
8730,13515,3400,6571,2788,10115,2643,1263,1380
8735,13521,3400,6575,2788,10120,2645,1265,1380
8740,13532,3400,6582,2788,10132,2647,1267,1380
8745,13536,3400,6586,2788,10136,2647,1267,1380
8750,13546,3401,6590,2788,10145,2649,1268,1381
8755,13552,3401,6592,2788,10151,2651,1269,1382
8760,13563,3402,6598,2788,10161,2653,1271,1382
8765,13567,3402,6600,2788,10165,2653,1271,1382
8770,13577,3403,6606,2788,10173,2655,1272,1383
8775,13583,3403,6611,2788,10179,2657,1274,1383
8780,13594,3405,6616,2790,10189,2659,1275,1384
8785,13598,3405,6619,2790,10193,2659,1275,1384
8790,13608,3407,6623,2792,10201,2661,1275,1386
8795,13614,3407,6624,2792,10207,2663,1275,1388
8800,13625,3409,6628,2793,10216,2665,1276,1389
8805,13629,3410,6632,2794,10219,2665,1276,1389
8810,13639,3412,6634,2794,10227,2667,1277,1390
8815,13645,3412,6637,2794,10231,2669,1278,1391
8820,13656,3417,6642,2799,10238,2671,1279,1392
8825,13660,3419,6644,2801,10240,2671,1279,1392
8830,13670,3423,6649,2805,10246,2673,1280,1393
8835,13676,3424,6652,2806,10250,2675,1281,1394
8840,13687,3429,6658,2810,10254,2677,1281,1396
8845,13691,3434,6660,2815,10256,2677,1281,1396
8850,13701,3438,6664,2818,10262,2679,1282,1397
8855,13707,3440,6667,2820,10266,2681,1283,1398
8860,13718,3443,6669,2822,10275,2683,1284,1399
8865,13722,3444,6671,2823,10277,2683,1284,1399
8870,13732,3447,6673,2825,10285,2685,1285,1400
8875,13738,3448,6677,2826,10288,2687,1286,1401
8880,13749,3452,6683,2829,10293,2689,1287,1402
8885,13753,3454,6684,2831,10298,2689,1287,1402
8890,13763,3456,6686,2832,10306,2691,1287,1404
8895,13769,3457,6688,2833,10311,2693,1288,1405
8900,13780,3459,6693,2834,10318,2695,1288,1407
8905,13784,3461,6695,2836,10323,2695,1288,1407
8910,13794,3463,6701,2838,10331,2697,1290,1407
8915,13800,3464,6704,2839,10335,2699,1290,1409
8920,13811,3467,6710,2842,10343,2701,1291,1410
8925,13815,3468,6713,2843,10347,2701,1291,1410
8930,13825,3470,6719,2844,10353,2703,1292,1411
8935,13831,3473,6721,2847,10358,2705,1293,1412
8940,13842,3475,6727,2848,10365,2707,1294,1413
8945,13846,3476,6728,2849,10370,2707,1294,1413
8950,13856,3477,6731,2849,10379,2709,1296,1413
8955,13862,3477,6732,2849,10385,2711,1297,1414
8960,13873,3480,6736,2852,10393,2713,1298,1415
8965,13877,3480,6737,2852,10397,2713,1298,1415
8970,13887,3482,6741,2853,10405,2715,1300,1415
8975,13893,3482,6743,2853,10411,2717,1300,1417
8980,13904,3484,6746,2854,10419,2719,1300,1419
8985,13908,3485,6747,2855,10423,2719,1300,1419
8990,13918,3488,6753,2857,10430,2721,1302,1419
8995,13924,3488,6754,2857,10436,2723,1303,1420
9000,13935,3490,6758,2858,10444,2725,1304,1421
9005,13939,3491,6760,2859,10447,2725,1304,1421
9010,13949,3495,6766,2862,10454,2727,1305,1422
9015,13955,3495,6769,2862,10460,2729,1306,1423
9020,13966,3497,6772,2863,10467,2731,1306,1425
9025,13970,3499,6773,2865,10471,2731,1306,1425
9030,13980,3501,6777,2865,10479,2733,1308,1425
9035,13986,3501,6781,2865,10483,2735,1309,1426
9040,13997,3506,6787,2870,10490,2737,1310,1427
9045,14001,3507,6788,2871,10493,2737,1310,1427
9050,14011,3512,6791,2874,10498,2739,1310,1429
9055,14017,3514,6794,2876,10501,2741,1310,1431
9060,14028,3519,6799,2881,10508,2743,1311,1432
9065,14032,3520,6800,2882,10511,2743,1311,1432
9070,14042,3525,6802,2885,10517,2745,1311,1434
9075,14048,3526,6804,2886,10521,2747,1311,1436
9080,14059,3530,6810,2890,10527,2749,1312,1437
9085,14063,3533,6812,2893,10529,2749,1312,1437
9090,14073,3539,6820,2899,10533,2751,1314,1437
9095,14079,3540,6821,2900,10538,2753,1314,1439
9100,14090,3544,6829,2904,10543,2755,1315,1440
9105,14094,3546,6832,2906,10548,2755,1315,1440
9110,14104,3547,6836,2907,10556,2757,1316,1441
9115,14110,3548,6838,2908,10562,2759,1318,1441
9120,14121,3549,6843,2908,10569,2761,1320,1441
9125,14125,3550,6843,2909,10575,2761,1320,1441
9130,14135,3552,6848,2910,10581,2763,1320,1443
9135,14141,3555,6853,2913,10585,2765,1322,1443
9140,14152,3557,6856,2914,10594,2767,1323,1444
9145,14156,3557,6856,2914,10599,2767,1323,1444
9150,14166,3560,6862,2917,10605,2769,1323,1446
9155,14172,3561,6864,2918,10610,2771,1324,1447
9160,14183,3563,6868,2919,10619,2773,1325,1448
9165,14187,3564,6868,2920,10623,2773,1325,1448
9170,14197,3566,6873,2922,10631,2775,1326,1449
9175,14203,3566,6874,2922,10637,2777,1326,1451
9180,14214,3568,6878,2923,10645,2779,1326,1453
9185,14218,3570,6880,2925,10648,2779,1326,1453
9190,14228,3571,6886,2926,10657,2781,1328,1453
9195,14234,3571,6887,2926,10663,2783,1328,1455
9200,14245,3575,6895,2929,10668,2785,1329,1456
9205,14249,3578,6898,2932,10671,2785,1329,1456
9210,14259,3581,6902,2934,10678,2787,1330,1457
9215,14265,3581,6908,2934,10682,2789,1332,1457
9220,14276,3584,6914,2937,10690,2791,1333,1458
9225,14280,3587,6917,2940,10693,2791,1333,1458
9230,14290,3590,6924,2943,10699,2793,1335,1458
9235,14296,3590,6926,2943,10704,2795,1335,1460
9240,14307,3595,6930,2947,10711,2797,1336,1461
9245,14311,3597,6931,2949,10714,2797,1336,1461
9250,14321,3600,6937,2952,10720,2799,1336,1463
9255,14327,3600,6941,2952,10726,2801,1337,1464
9260,14338,3604,6947,2956,10733,2803,1338,1465
9265,14342,3605,6948,2957,10737,2803,1338,1465
9270,14352,3606,6953,2958,10746,2805,1340,1465
9275,14358,3606,6955,2958,10750,2807,1340,1467
9280,14369,3609,6956,2960,10760,2809,1340,1469
9285,14373,3610,6958,2961,10763,2809,1340,1469
9290,14383,3613,6964,2963,10769,2811,1341,1470
9295,14389,3613,6967,2963,10776,2813,1343,1470
9300,14400,3614,6972,2963,10784,2815,1345,1470
9305,14404,3615,6975,2964,10788,2815,1345,1470
9310,14414,3617,6977,2964,10796,2817,1345,1472
9315,14420,3617,6978,2964,10803,2819,1346,1473
9320,14431,3620,6985,2967,10809,2821,1347,1474
9325,14435,3620,6986,2967,10815,2821,1347,1474
9330,14445,3623,6992,2970,10822,2823,1349,1474
9335,14451,3623,6995,2970,10828,2825,1351,1474
9340,14462,3625,7001,2972,10836,2827,1351,1476
9345,14466,3627,7004,2974,10839,2827,1351,1476
9350,14476,3631,7010,2976,10844,2829,1351,1478
9355,14482,3631,7012,2976,10850,2831,1352,1479
9360,14493,3635,7015,2979,10858,2833,1353,1480
9365,14497,3636,7016,2980,10861,2833,1353,1480
9370,14507,3639,7021,2983,10868,2835,1354,1481
9375,14513,3639,7023,2983,10873,2837,1354,1483
9380,14524,3642,7028,2986,10881,2839,1356,1483
9385,14528,3644,7030,2988,10884,2839,1356,1483
9390,14538,3647,7034,2990,10891,2841,1357,1484
9395,14544,3647,7037,2990,10895,2843,1358,1485
9400,14555,3653,7044,2996,10900,2845,1359,1486
9405,14559,3657,7047,3000,10902,2845,1359,1486
9410,14569,3660,7051,3001,10908,2847,1360,1487
9415,14575,3661,7055,3002,10912,2849,1361,1488
9420,14586,3665,7062,3006,10921,2851,1363,1488
9425,14590,3665,7066,3006,10924,2851,1363,1488
9430,14600,3666,7071,3007,10934,2853,1364,1489
9435,14606,3666,7076,3007,10939,2855,1366,1489
9440,14617,3666,7079,3007,10951,2857,1367,1490
9445,14621,3666,7080,3007,10954,2857,1367,1490
9450,14631,3667,7083,3007,10964,2859,1367,1492
9455,14637,3667,7085,3007,10970,2861,1368,1493
9460,14648,3667,7090,3007,10980,2863,1369,1494
9465,14652,3667,7091,3007,10985,2863,1369,1494
9470,14662,3668,7097,3008,10994,2865,1370,1495
9475,14668,3668,7099,3008,11000,2867,1370,1497
9480,14679,3669,7103,3009,11009,2869,1371,1498
9485,14683,3669,7105,3009,11014,2869,1371,1498
9490,14693,3670,7109,3009,11023,2871,1372,1499
9495,14699,3670,7111,3009,11029,2873,1373,1500
9500,14710,3671,7119,3010,11037,2875,1375,1500
9505,14714,3671,7120,3010,11043,2875,1375,1500
9510,14724,3672,7124,3011,11052,2877,1376,1501
9515,14730,3672,7127,3011,11058,2879,1376,1503
9520,14741,3674,7134,3013,11065,2881,1377,1504
9525,14745,3674,7135,3013,11070,2881,1377,1504
9530,14755,3679,7140,3017,11075,2883,1378,1505
9535,14761,3681,7144,3019,11078,2885,1379,1506
9540,14772,3685,7150,3023,11084,2887,1380,1507
9545,14776,3690,7154,3028,11084,2887,1380,1507
9550,14786,3694,7161,3031,11090,2889,1381,1508
9555,14792,3696,7163,3033,11096,2891,1382,1509
9560,14803,3699,7170,3036,11102,2893,1383,1510
9565,14807,3700,7172,3037,11107,2893,1383,1510
9570,14817,3703,7177,3039,11113,2895,1385,1510
9575,14823,3704,7180,3040,11117,2897,1385,1512
9580,14834,3708,7185,3044,11123,2899,1385,1514
9585,14838,3710,7186,3046,11128,2899,1385,1514
9590,14848,3713,7188,3048,11135,2901,1385,1516
9595,14854,3714,7192,3049,11138,2903,1386,1517
9600,14865,3719,7198,3053,11144,2905,1387,1518
9605,14869,3721,7200,3055,11148,2905,1387,1518
9610,14879,3723,7201,3055,11156,2907,1387,1520
9615,14885,3724,7202,3056,11161,2909,1387,1522
9620,14896,3727,7209,3059,11168,2911,1389,1522
9625,14900,3728,7211,3060,11172,2911,1389,1522
9630,14910,3732,7216,3063,11177,2913,1390,1523
9635,14916,3733,7218,3064,11183,2915,1391,1524
9640,14927,3735,7220,3065,11192,2917,1391,1526
9645,14931,3736,7223,3066,11194,2917,1391,1526
9650,14941,3739,7228,3069,11202,2919,1391,1528
9655,14947,3739,7232,3069,11206,2921,1393,1528
9660,14958,3743,7237,3073,11213,2923,1394,1529
9665,14962,3746,7239,3076,11215,2923,1394,1529
9670,14972,3750,7243,3078,11220,2925,1394,1531
9675,14978,3753,7247,3081,11224,2927,1396,1531
9680,14989,3756,7253,3084,11232,2929,1398,1531
9685,14993,3756,7254,3084,11237,2929,1398,1531
9690,15003,3758,7256,3085,11245,2931,1399,1532
9695,15009,3758,7258,3085,11251,2933,1400,1533
9700,15020,3760,7263,3087,11260,2935,1401,1534
9705,15024,3761,7266,3088,11262,2935,1401,1534
9710,15034,3763,7271,3089,11269,2937,1402,1535
9715,15040,3765,7274,3091,11274,2939,1403,1536
9720,15051,3767,7280,3092,11282,2941,1405,1536
9725,15055,3769,7284,3094,11286,2941,1405,1536
9730,15065,3772,7288,3097,11292,2943,1405,1538
9735,15071,3773,7292,3098,11297,2945,1407,1538
9740,15082,3777,7298,3102,11304,2947,1407,1540
9745,15086,3777,7299,3102,11309,2947,1407,1540
9750,15096,3779,7303,3103,11317,2949,1408,1541
9755,15102,3780,7306,3104,11321,2951,1409,1542
9760,15113,3784,7313,3107,11327,2953,1410,1543
9765,15117,3786,7315,3109,11331,2953,1410,1543
9770,15127,3787,7321,3110,11339,2955,1412,1543
9775,15133,3787,7324,3110,11346,2957,1413,1544
9780,15144,3790,7331,3112,11352,2959,1415,1544
9785,15148,3791,7333,3113,11356,2959,1415,1544
9790,15158,3794,7339,3116,11364,2961,1416,1545
9795,15164,3794,7343,3116,11369,2963,1418,1545
9800,15175,3798,7349,3120,11375,2965,1418,1547
9805,15179,3799,7349,3121,11380,2965,1418,1547
9810,15189,3801,7353,3123,11388,2967,1419,1548
9815,15195,3801,7355,3123,11394,2969,1421,1548
9820,15206,3802,7356,3124,11404,2971,1421,1550
9825,15210,3803,7359,3125,11405,2971,1421,1550
9830,15220,3810,7366,3132,11410,2973,1422,1551
9835,15226,3810,7369,3132,11415,2975,1424,1551
9840,15237,3813,7373,3135,11423,2977,1424,1553
9845,15241,3814,7373,3136,11427,2977,1424,1553
9850,15251,3816,7380,3138,11434,2979,1426,1553
9855,15257,3816,7383,3138,11440,2981,1428,1553
9860,15268,3818,7386,3140,11449,2983,1429,1554
9865,15272,3820,7387,3142,11452,2983,1429,1554
9870,15282,3824,7391,3145,11458,2985,1430,1555
9875,15288,3824,7392,3145,11463,2987,1430,1557
9880,15299,3827,7395,3147,11471,2989,1431,1558
9885,15303,3829,7397,3149,11473,2989,1431,1558
9890,15313,3833,7404,3152,11478,2991,1433,1558
9895,15319,3835,7407,3154,11483,2993,1434,1559
9900,15330,3839,7413,3157,11490,2995,1435,1560
9905,15334,3840,7415,3158,11494,2995,1435,1560
9910,15344,3842,7420,3160,11501,2997,1436,1561
9915,15350,3844,7424,3162,11505,2999,1437,1562
9920,15361,3847,7431,3165,11512,3001,1439,1562
9925,15365,3849,7435,3167,11515,3001,1439,1562
9930,15375,3850,7439,3168,11525,3003,1440,1563
9935,15381,3850,7442,3168,11531,3005,1441,1564
9940,15392,3852,7448,3170,11539,3007,1442,1565
9945,15396,3852,7448,3170,11544,3007,1442,1565
9950,15406,3854,7454,3172,11550,3009,1442,1567
9955,15412,3857,7457,3175,11555,3011,1443,1568
9960,15423,3858,7459,3175,11564,3013,1444,1569
9965,15427,3859,7461,3176,11568,3013,1444,1569
9970,15437,3860,7464,3176,11576,3015,1444,1571
9975,15443,3862,7469,3178,11580,3017,1445,1572
9980,15454,3865,7473,3180,11589,3019,1445,1574
9985,15458,3865,7474,3180,11593,3019,1445,1574
9990,15468,3867,7478,3181,11601,3021,1446,1575
9995,15474,3867,7481,3181,11606,3023,1447,1576
10000,15485,3870,7488,3183,11614,3025,1448,1577
10005,15489,3872,7490,3185,11617,3025,1448,1577
10010,15499,3874,7495,3186,11625,3027,1450,1577
10015,15505,3874,7498,3186,11630,3029,1451,1578
10020,15516,3878,7504,3189,11638,3031,1453,1578
10025,15520,3879,7507,3190,11640,3031,1453,1578
10030,15530,3883,7511,3193,11647,3033,1454,1579
10035,15536,3883,7514,3193,11651,3035,1455,1580
10040,15547,3885,7520,3195,11661,3037,1456,1581
10045,15551,3887,7523,3197,11663,3037,1456,1581
10050,15561,3891,7527,3200,11670,3039,1457,1582
10055,15567,3891,7530,3200,11675,3041,1459,1582
10060,15578,3893,7537,3202,11684,3043,1459,1584
10065,15582,3895,7539,3204,11687,3043,1459,1584
10070,15592,3899,7544,3206,11693,3045,1461,1584
10075,15598,3899,7547,3206,11698,3047,1462,1585
10080,15609,3901,7554,3208,11707,3049,1464,1585
10085,15613,3902,7557,3209,11710,3049,1464,1585
10090,15623,3903,7563,3210,11719,3051,1466,1585
10095,15629,3905,7568,3212,11722,3053,1467,1586
10100,15640,3907,7576,3214,11731,3055,1469,1586
10105,15644,3908,7578,3215,11735,3055,1469,1586
10110,15654,3909,7583,3216,11744,3057,1469,1588
10115,15660,3911,7586,3218,11749,3059,1470,1589
10120,15671,3912,7594,3219,11758,3061,1472,1589
10125,15675,3912,7598,3219,11762,3061,1472,1589
10130,15685,3914,7603,3221,11770,3063,1473,1590
10135,15691,3916,7607,3223,11774,3065,1475,1590
10140,15702,3919,7610,3225,11783,3067,1475,1592
10145,15706,3919,7611,3225,11787,3067,1475,1592
10150,15716,3921,7616,3227,11794,3069,1476,1593
10155,15722,3922,7620,3228,11799,3071,1478,1593
10160,15733,3926,7626,3232,11807,3073,1479,1594
10165,15737,3927,7628,3233,11809,3073,1479,1594
10170,15747,3929,7633,3234,11817,3075,1480,1595
10175,15753,3931,7638,3236,11822,3077,1482,1595
10180,15764,3932,7643,3237,11829,3079,1483,1596
10185,15768,3933,7644,3238,11834,3079,1483,1596
10190,15778,3937,7649,3240,11839,3081,1483,1598
10195,15784,3940,7653,3243,11842,3083,1484,1599
10200,15795,3944,7658,3247,11849,3085,1485,1600
10205,15799,3946,7659,3249,11853,3085,1485,1600
10210,15809,3948,7661,3250,11861,3087,1486,1601
10215,15815,3948,7664,3250,11866,3089,1487,1602
10220,15826,3952,7673,3254,11872,3091,1489,1602
10225,15830,3953,7675,3255,11877,3091,1489,1602
10230,15840,3957,7680,3259,11883,3093,1489,1604
10235,15846,3957,7683,3259,11888,3095,1489,1606
10240,15857,3961,7689,3263,11895,3097,1489,1608
10245,15861,3962,7692,3264,11899,3097,1489,1608
10250,15871,3966,7699,3267,11905,3099,1490,1609
10255,15877,3966,7702,3267,11909,3101,1490,1611
10260,15888,3971,7705,3271,11917,3103,1491,1612
10265,15892,3971,7706,3271,11920,3103,1491,1612
10270,15902,3975,7710,3274,11927,3105,1491,1614
10275,15908,3975,7714,3274,11932,3107,1492,1615
10280,15919,3978,7718,3276,11939,3109,1493,1616
10285,15923,3978,7719,3276,11944,3109,1493,1616
10290,15933,3981,7722,3278,11952,3111,1494,1617
10295,15939,3981,7725,3278,11958,3113,1494,1619
10300,15950,3983,7730,3279,11965,3115,1495,1620
10305,15954,3984,7731,3280,11970,3115,1495,1620
10310,15964,3986,7736,3282,11977,3117,1496,1621
10315,15970,3988,7739,3284,11981,3119,1497,1622
10320,15981,3993,7747,3289,11985,3121,1498,1623
10325,15985,3996,7750,3292,11989,3121,1498,1623
10330,15995,3999,7758,3295,11995,3123,1500,1623
10335,16001,4000,7759,3296,12000,3125,1500,1625
10340,16012,4005,7767,3301,12005,3127,1502,1625
10345,16016,4007,7769,3303,12009,3127,1502,1625
10350,16026,4011,7776,3305,12013,3129,1504,1625
10355,16032,4013,7779,3307,12018,3131,1505,1626
10360,16043,4016,7783,3310,12025,3133,1505,1628
10365,16047,4019,7786,3313,12028,3133,1505,1628
10370,16057,4021,7793,3315,12035,3135,1507,1628
10375,16063,4021,7795,3315,12042,3137,1508,1629
10380,16074,4023,7800,3317,12049,3139,1508,1631
10385,16078,4026,7801,3320,12052,3139,1508,1631
10390,16088,4030,7808,3323,12057,3141,1508,1633
10395,16094,4030,7812,3323,12062,3143,1509,1634
10400,16105,4030,7818,3323,12074,3145,1510,1635
10405,16109,4030,7821,3323,12078,3145,1510,1635
10410,16119,4030,7825,3323,12089,3147,1511,1636
10415,16125,4030,7829,3323,12094,3149,1513,1636
10420,16136,4030,7839,3323,12105,3151,1515,1636
10425,16140,4030,7841,3323,12110,3151,1515,1636
10430,16150,4030,7847,3323,12120,3153,1516,1637
10435,16156,4030,7852,3323,12124,3155,1518,1637
10440,16167,4030,7857,3323,12136,3157,1520,1637
10445,16171,4030,7857,3323,12141,3157,1520,1637
10450,16181,4030,7861,3323,12151,3159,1521,1638
10455,16187,4030,7863,3323,12157,3161,1521,1640
10460,16198,4030,7866,3323,12168,3163,1522,1641
10465,16202,4030,7868,3323,12172,3163,1522,1641
10470,16212,4031,7873,3323,12181,3165,1522,1643
10475,16218,4031,7879,3323,12186,3167,1524,1643
10480,16229,4031,7884,3323,12198,3169,1526,1643
10485,16233,4031,7886,3323,12202,3169,1526,1643
10490,16243,4032,7890,3324,12211,3171,1526,1645
10495,16249,4032,7893,3324,12216,3173,1527,1646
10500,16260,4034,7899,3325,12225,3175,1528,1647
10505,16264,4036,7901,3327,12227,3175,1528,1647
10510,16274,4039,7904,3329,12235,3177,1529,1648
10515,16280,4039,7907,3329,12240,3179,1530,1649
10520,16291,4042,7912,3331,12249,3181,1531,1650
10525,16295,4044,7915,3333,12250,3181,1531,1650
10530,16305,4049,7920,3337,12255,3183,1531,1652
10535,16311,4049,7923,3337,12261,3185,1533,1652
10540,16322,4053,7930,3341,12269,3187,1535,1652
10545,16326,4054,7931,3342,12272,3187,1535,1652
10550,16336,4059,7937,3345,12276,3189,1537,1652
10555,16342,4060,7941,3346,12280,3191,1539,1652
10560,16353,4064,7944,3349,12288,3193,1540,1653
10565,16357,4065,7946,3350,12290,3193,1540,1653
10570,16367,4070,7951,3354,12295,3195,1541,1654
10575,16373,4072,7954,3356,12299,3197,1542,1655
10580,16384,4079,7959,3362,12304,3199,1542,1657
10585,16388,4080,7962,3363,12307,3199,1542,1657
10590,16398,4081,7967,3364,12316,3201,1543,1658
10595,16404,4083,7971,3366,12321,3203,1545,1658
10600,16415,4085,7977,3367,12328,3205,1547,1658
10605,16419,4086,7978,3368,12333,3205,1547,1658
10610,16429,4089,7985,3371,12339,3207,1549,1658
10615,16435,4090,7986,3372,12345,3209,1550,1659
10620,16446,4092,7990,3373,12352,3211,1551,1660
10625,16450,4094,7994,3375,12355,3211,1551,1660
10630,16460,4096,7998,3377,12364,3213,1552,1661
10635,16466,4097,8001,3378,12368,3215,1553,1662
10640,16477,4101,8007,3381,12374,3217,1554,1663
10645,16481,4102,8010,3382,12378,3217,1554,1663
10650,16491,4104,8013,3383,12387,3219,1554,1665
10655,16497,4104,8015,3383,12393,3221,1554,1667
10660,16508,4105,8019,3383,12402,3223,1555,1668
10665,16512,4105,8020,3383,12407,3223,1555,1668
10670,16522,4107,8027,3385,12415,3225,1557,1668
10675,16528,4107,8028,3385,12421,3227,1557,1670
10680,16539,4109,8032,3386,12429,3229,1558,1671
10685,16543,4109,8033,3386,12433,3229,1558,1671
10690,16553,4112,8040,3388,12441,3231,1560,1671
10695,16559,4112,8044,3388,12446,3233,1561,1672
10700,16570,4116,8048,3391,12452,3235,1561,1674
10705,16574,4120,8052,3395,12452,3235,1561,1674
10710,16584,4125,8054,3398,12459,3237,1561,1676
10715,16590,4125,8058,3398,12464,3239,1562,1677
10720,16601,4127,8060,3399,12473,3241,1563,1678
10725,16605,4129,8063,3401,12474,3241,1563,1678
10730,16615,4135,8068,3405,12480,3243,1564,1679
10735,16621,4135,8070,3405,12486,3245,1565,1680
10740,16632,4139,8075,3408,12493,3247,1566,1681
10745,16636,4140,8076,3409,12496,3247,1566,1681
10750,16646,4144,8082,3413,12500,3249,1566,1683
10755,16652,4146,8084,3415,12504,3251,1566,1685
10760,16663,4152,8090,3420,12510,3253,1568,1685
10765,16667,4154,8091,3422,12513,3253,1568,1685
10770,16677,4157,8096,3424,12519,3255,1570,1685
10775,16683,4158,8100,3425,12522,3257,1571,1686
10780,16694,4164,8105,3430,12529,3259,1572,1687
10785,16698,4165,8105,3431,12533,3259,1572,1687
10790,16708,4166,8108,3431,12542,3261,1573,1688
10795,16714,4167,8111,3432,12546,3263,1574,1689
10800,16725,4169,8114,3433,12556,3265,1575,1690
10805,16729,4169,8114,3433,12560,3265,1575,1690
10810,16739,4171,8118,3434,12567,3267,1575,1692
10815,16745,4173,8120,3436,12571,3269,1575,1694
10820,16756,4175,8125,3437,12580,3271,1576,1695
10825,16760,4177,8129,3439,12582,3271,1576,1695
10830,16770,4178,8131,3439,12591,3273,1576,1697
10835,16776,4180,8134,3441,12596,3275,1577,1698
10840,16787,4183,8139,3443,12604,3277,1578,1699
10845,16791,4183,8140,3443,12608,3277,1578,1699
10850,16801,4185,8145,3445,12615,3279,1578,1701
10855,16807,4186,8148,3446,12620,3281,1579,1702
10860,16818,4189,8154,3448,12628,3283,1581,1702
10865,16822,4189,8157,3448,12632,3283,1581,1702
10870,16832,4191,8162,3449,12640,3285,1582,1703
10875,16838,4192,8165,3450,12645,3287,1583,1704
10880,16849,4194,8169,3452,12655,3289,1585,1704
10885,16853,4195,8172,3453,12658,3289,1585,1704
10890,16863,4198,8175,3454,12664,3291,1585,1706
10895,16869,4199,8178,3455,12670,3293,1587,1706
10900,16880,4202,8183,3457,12676,3295,1588,1707
10905,16884,4203,8185,3458,12681,3295,1588,1707
10910,16894,4207,8191,3461,12687,3297,1590,1707
10915,16900,4208,8193,3462,12691,3299,1590,1709
10920,16911,4213,8200,3466,12696,3301,1591,1710
10925,16915,4213,8203,3466,12702,3301,1591,1710
10930,16925,4214,8208,3467,12710,3303,1592,1711
10935,16931,4214,8211,3467,12715,3305,1593,1712
10940,16942,4217,8215,3469,12724,3307,1594,1713
10945,16946,4217,8216,3469,12729,3307,1594,1713
10950,16956,4219,8221,3470,12737,3309,1594,1715
10955,16962,4219,8225,3470,12741,3311,1595,1716
10960,16973,4223,8229,3473,12749,3313,1596,1717
10965,16977,4224,8231,3474,12752,3313,1596,1717
10970,16987,4227,8236,3477,12760,3315,1596,1719
10975,16993,4227,8239,3477,12765,3317,1598,1719
10980,17004,4230,8244,3480,12772,3319,1599,1720
10985,17008,4233,8246,3483,12774,3319,1599,1720
10990,17018,4238,8251,3488,12780,3321,1600,1721
10995,17024,4238,8253,3488,12785,3323,1600,1723
11000,17035,4241,8258,3490,12792,3325,1601,1724
11005,17039,4243,8260,3492,12794,3325,1601,1724
11010,17049,4247,8266,3496,12802,3327,1603,1724
11015,17055,4247,8269,3496,12808,3329,1604,1725
11020,17066,4248,8276,3497,12816,3331,1605,1726
11025,17070,4248,8278,3497,12822,3331,1605,1726
11030,17080,4249,8284,3498,12830,3333,1606,1727
11035,17086,4249,8287,3498,12836,3335,1607,1728
11040,17097,4251,8293,3500,12846,3337,1607,1730
11045,17101,4252,8296,3501,12849,3337,1607,1730
11050,17111,4254,8302,3503,12856,3339,1608,1731
11055,17117,4254,8305,3503,12863,3341,1609,1732
11060,17128,4256,8310,3505,12872,3343,1609,1734
11065,17132,4256,8311,3505,12876,3343,1609,1734
11070,17142,4258,8315,3506,12883,3345,1609,1736
11075,17148,4260,8318,3508,12887,3347,1609,1738
11080,17159,4263,8322,3511,12896,3349,1610,1739
11085,17163,4264,8326,3512,12899,3349,1610,1739
11090,17173,4266,8333,3513,12905,3351,1612,1739
11095,17179,4269,8338,3516,12909,3353,1614,1739
11100,17190,4271,8343,3517,12918,3355,1615,1740
11105,17194,4273,8347,3519,12921,3355,1615,1740
11110,17204,4274,8350,3520,12930,3357,1615,1742
11115,17210,4274,8353,3520,12936,3359,1617,1742
11120,17221,4275,8356,3521,12946,3361,1618,1743
11125,17225,4275,8357,3521,12950,3361,1618,1743
11130,17235,4277,8362,3523,12958,3363,1619,1744
11135,17241,4277,8364,3523,12963,3365,1620,1745
11140,17252,4279,8369,3525,12972,3367,1621,1746
11145,17256,4279,8371,3525,12976,3367,1621,1746
11150,17266,4282,8372,3527,12984,3369,1621,1748
11155,17272,4282,8376,3527,12989,3371,1623,1748
11160,17283,4285,8380,3530,12997,3373,1623,1750
11165,17287,4286,8381,3531,13001,3373,1623,1750
11170,17297,4289,8386,3533,13008,3375,1624,1751
11175,17303,4289,8389,3533,13013,3377,1624,1753
11180,17314,4291,8394,3535,13021,3379,1625,1754
11185,17318,4294,8398,3538,13022,3379,1625,1754
11190,17328,4299,8404,3542,13029,3381,1627,1754
11195,17334,4299,8407,3542,13034,3383,1628,1755
11200,17345,4302,8411,3545,13043,3385,1628,1757
11205,17349,4303,8413,3546,13045,3385,1628,1757
11210,17359,4308,8417,3550,13050,3387,1628,1759
11215,17365,4309,8418,3551,13056,3389,1629,1760
11220,17376,4312,8421,3553,13064,3391,1630,1761
11225,17380,4312,8422,3553,13067,3391,1630,1761
11230,17390,4313,8425,3553,13076,3393,1631,1762
11235,17396,4315,8426,3555,13081,3395,1631,1764
11240,17407,4318,8432,3558,13088,3397,1632,1765
11245,17411,4319,8434,3559,13091,3397,1632,1765
11250,17421,4321,8441,3561,13099,3399,1634,1765
11255,17427,4322,8442,3562,13104,3401,1634,1767
11260,17438,4325,8448,3565,13110,3403,1634,1769
11265,17442,4327,8450,3567,13115,3403,1634,1769
11270,17452,4329,8455,3568,13122,3405,1635,1770
11275,17458,4330,8457,3569,13128,3407,1635,1772
11280,17469,4332,8461,3570,13136,3409,1636,1773
11285,17473,4332,8462,3570,13141,3409,1636,1773
11290,17483,4334,8469,3572,13147,3411,1637,1774
11295,17489,4337,8473,3575,13152,3413,1639,1774
11300,17500,4339,8476,3576,13160,3415,1639,1776
11305,17504,4341,8479,3578,13163,3415,1639,1776
11310,17514,4344,8485,3581,13169,3417,1639,1778
11315,17520,4345,8487,3582,13174,3419,1640,1779
11320,17531,4347,8490,3583,13183,3421,1640,1781
11325,17535,4349,8494,3585,13185,3421,1640,1781
11330,17545,4351,8499,3585,13193,3423,1642,1781
11335,17551,4352,8502,3586,13199,3425,1644,1781
11340,17562,4353,8506,3587,13207,3427,1645,1782
11345,17566,4355,8509,3589,13211,3427,1645,1782
11350,17576,4358,8515,3592,13216,3429,1645,1784
11355,17582,4360,8519,3594,13220,3431,1646,1785
11360,17593,4364,8523,3598,13229,3433,1647,1786
11365,17597,4365,8525,3599,13231,3433,1647,1786
11370,17607,4366,8532,3600,13240,3435,1649,1786
11375,17613,4366,8536,3600,13246,3437,1651,1786
11380,17624,4367,8539,3600,13255,3439,1651,1788
11385,17628,4369,8540,3602,13258,3439,1651,1788
11390,17638,4372,8545,3604,13265,3441,1652,1789
11395,17644,4372,8548,3604,13271,3443,1654,1789
11400,17655,4376,8556,3607,13277,3445,1656,1789
11405,17659,4379,8558,3610,13279,3445,1656,1789
11410,17669,4382,8562,3613,13287,3447,1657,1790
11415,17675,4382,8565,3613,13293,3449,1658,1791
11420,17686,4385,8571,3616,13299,3451,1659,1792
11425,17690,4387,8571,3618,13303,3451,1659,1792
11430,17700,4389,8574,3619,13311,3453,1660,1793
11435,17706,4389,8578,3619,13315,3455,1661,1794
11440,17717,4393,8583,3622,13322,3457,1662,1795
11445,17721,4395,8585,3624,13324,3457,1662,1795
11450,17731,4401,8590,3630,13330,3459,1662,1797
11455,17737,4401,8593,3630,13335,3461,1663,1798
11460,17748,4402,8597,3630,13345,3463,1664,1799
11465,17752,4402,8598,3630,13349,3463,1664,1799
11470,17762,4404,8603,3632,13358,3465,1665,1800
11475,17768,4404,8606,3632,13363,3467,1665,1802
11480,17779,4405,8611,3632,13372,3469,1666,1803
11485,17783,4405,8612,3632,13378,3469,1666,1803
11490,17793,4407,8617,3633,13386,3471,1668,1803
11495,17799,4407,8618,3633,13392,3473,1668,1805
11500,17810,4409,8624,3635,13400,3475,1670,1805
11505,17814,4409,8627,3635,13405,3475,1670,1805
11510,17824,4410,8631,3635,13412,3477,1671,1806
11515,17830,4412,8633,3637,13418,3479,1672,1807
11520,17841,4415,8638,3639,13424,3481,1673,1808
11525,17845,4417,8642,3641,13428,3481,1673,1808
11530,17855,4418,8646,3641,13435,3483,1673,1810
11535,17861,4421,8650,3644,13439,3485,1674,1811
11540,17872,4424,8655,3646,13447,3487,1675,1812
11545,17876,4424,8657,3646,13452,3487,1675,1812
11550,17886,4427,8663,3648,13457,3489,1675,1814
11555,17892,4429,8667,3650,13463,3491,1677,1814
11560,17903,4432,8674,3652,13467,3493,1678,1815
11565,17907,4434,8674,3654,13473,3493,1678,1815
11570,17917,4437,8678,3656,13480,3495,1678,1817
11575,17923,4437,8681,3656,13485,3497,1679,1818
11580,17934,4442,8688,3660,13489,3499,1680,1819
11585,17938,4445,8691,3663,13492,3499,1680,1819
11590,17948,4449,8695,3666,13498,3501,1681,1820
11595,17954,4450,8698,3667,13503,3503,1683,1820
11600,17965,4453,8705,3670,13510,3505,1684,1821
11605,17969,4456,8708,3673,13512,3505,1684,1821
11610,17979,4460,8713,3676,13517,3507,1684,1823
11615,17985,4463,8716,3679,13522,3509,1685,1824
11620,17996,4468,8723,3683,13526,3511,1685,1826
11625,18000,4471,8725,3686,13529,3511,1685,1826
11630,18010,4475,8730,3690,13535,3513,1686,1827
11635,18016,4475,8735,3690,13539,3515,1688,1827
11640,18027,4481,8743,3695,13544,3517,1690,1827
11645,18031,4484,8745,3698,13547,3517,1690,1827
11650,18041,4485,8750,3699,13555,3519,1691,1828
11655,18047,4485,8754,3699,13560,3521,1691,1830
11660,18058,4488,8759,3702,13570,3523,1692,1831
11665,18062,4489,8762,3703,13573,3523,1692,1831
11670,18072,4490,8769,3704,13582,3525,1693,1832
11675,18078,4490,8772,3704,13588,3527,1695,1832
11680,18089,4491,8774,3704,13598,3529,1695,1834
11685,18093,4491,8774,3704,13602,3529,1695,1834
11690,18103,4492,8777,3705,13611,3531,1697,1834
11695,18109,4492,8782,3705,13617,3533,1699,1834
11700,18120,4494,8786,3706,13625,3535,1699,1836
11705,18124,4495,8789,3707,13628,3535,1699,1836
11710,18134,4496,8793,3708,13638,3537,1699,1838
11715,18140,4496,8797,3708,13644,3539,1700,1839
11720,18151,4497,8802,3708,13652,3541,1701,1840
11725,18155,4498,8806,3709,13656,3541,1701,1840
11730,18165,4500,8809,3711,13665,3543,1702,1841
11735,18171,4500,8809,3711,13671,3545,1702,1843
11740,18182,4502,8815,3713,13679,3547,1703,1844
11745,18186,4503,8817,3714,13682,3547,1703,1844
11750,18196,4506,8823,3716,13690,3549,1705,1844
11755,18202,4506,8828,3716,13696,3551,1707,1844
11760,18213,4508,8832,3718,13704,3553,1707,1846
11765,18217,4508,8834,3718,13708,3553,1707,1846
11770,18227,4510,8840,3718,13715,3555,1708,1847
11775,18233,4513,8845,3721,13718,3557,1710,1847
11780,18244,4516,8850,3724,13726,3559,1712,1847
11785,18248,4519,8853,3727,13728,3559,1712,1847
11790,18258,4524,8858,3730,13732,3561,1712,1849
11795,18264,4526,8860,3732,13737,3563,1713,1850
11800,18275,4528,8867,3734,13743,3565,1715,1850
11805,18279,4532,8869,3738,13746,3565,1715,1850
11810,18289,4535,8872,3739,13754,3567,1717,1850
11815,18295,4535,8873,3739,13760,3569,1718,1851
11820,18306,4536,8878,3740,13768,3571,1719,1852
11825,18310,4538,8878,3742,13772,3571,1719,1852
11830,18320,4540,8884,3744,13780,3573,1721,1852
11835,18326,4540,8888,3744,13783,3575,1722,1853
11840,18337,4544,8893,3748,13791,3577,1723,1854
11845,18341,4547,8896,3751,13793,3577,1723,1854
11850,18351,4548,8900,3752,13803,3579,1724,1855
11855,18357,4548,8904,3752,13807,3581,1725,1856
11860,18368,4550,8910,3754,13816,3583,1726,1857
11865,18372,4551,8913,3755,13820,3583,1726,1857
11870,18382,4553,8918,3757,13829,3585,1727,1858
11875,18388,4553,8923,3757,13833,3587,1729,1858
11880,18399,4557,8930,3760,13841,3589,1731,1858
11885,18403,4558,8932,3761,13844,3589,1731,1858
11890,18413,4560,8938,3762,13852,3591,1732,1859
11895,18419,4561,8943,3763,13857,3593,1734,1859
11900,18430,4564,8950,3766,13865,3595,1736,1859
11905,18434,4566,8951,3768,13868,3595,1736,1859
11910,18444,4568,8956,3770,13876,3597,1737,1860
11915,18450,4569,8960,3771,13880,3599,1737,1862
11920,18461,4571,8967,3773,13889,3601,1738,1863
11925,18465,4573,8968,3775,13892,3601,1738,1863
11930,18475,4575,8971,3776,13900,3603,1738,1865
11935,18481,4576,8974,3777,13904,3605,1739,1866
11940,18492,4580,8978,3780,13912,3607,1740,1867
11945,18496,4581,8980,3781,13915,3607,1740,1867
11950,18506,4583,8985,3782,13921,3609,1741,1868
11955,18512,4585,8989,3784,13926,3611,1743,1868
11960,18523,4588,8993,3786,13934,3613,1744,1869
11965,18527,4589,8994,3787,13938,3613,1744,1869
11970,18537,4591,8999,3789,13946,3615,1745,1870
11975,18543,4591,9001,3789,13952,3617,1746,1871
11980,18554,4592,9005,3789,13962,3619,1747,1872
11985,18558,4593,9007,3790,13965,3619,1747,1872
11990,18568,4596,9014,3793,13971,3621,1748,1873
11995,18574,4596,9019,3793,13976,3623,1750,1873
12000,18585,4600,9025,3797,13983,3625,1751,1874
12005,18589,4603,9027,3800,13985,3625,1751,1874
12010,18599,4607,9032,3804,13992,3627,1752,1875
12015,18605,4607,9034,3804,13998,3629,1753,1876
12020,18616,4609,9038,3806,14006,3631,1753,1878
12025,18620,4611,9041,3808,14007,3631,1753,1878
12030,18630,4615,9044,3811,14015,3633,1754,1879
12035,18636,4615,9046,3811,14021,3635,1756,1879
12040,18647,4618,9053,3813,14026,3637,1757,1880
12045,18651,4622,9056,3817,14027,3637,1757,1880
12050,18661,4627,9060,3822,14034,3639,1758,1881
12055,18667,4627,9064,3822,14037,3641,1759,1882
12060,18678,4631,9072,3826,14045,3643,1761,1882
12065,18682,4631,9072,3826,14051,3643,1761,1882
12070,18692,4634,9076,3828,14058,3645,1761,1884
12075,18698,4634,9078,3828,14064,3647,1761,1886
12080,18709,4635,9082,3828,14073,3649,1762,1887
12085,18713,4635,9083,3828,14077,3649,1762,1887
12090,18723,4637,9088,3829,14085,3651,1763,1888
12095,18729,4637,9093,3829,14091,3653,1764,1889
12100,18740,4639,9101,3831,14100,3655,1765,1890
12105,18744,4640,9104,3832,14104,3655,1765,1890
12110,18754,4642,9109,3833,14111,3657,1767,1890
12115,18760,4644,9113,3835,14115,3659,1767,1892
12120,18771,4647,9115,3837,14124,3661,1768,1893
12125,18775,4647,9117,3837,14128,3661,1768,1893
12130,18785,4648,9119,3837,14136,3663,1768,1895
12135,18791,4649,9123,3838,14142,3665,1770,1895
12140,18802,4650,9132,3839,14149,3667,1772,1895
12145,18806,4651,9133,3840,14155,3667,1772,1895
12150,18816,4652,9137,3841,14164,3669,1773,1896
12155,18822,4652,9139,3841,14169,3671,1773,1898
12160,18833,4653,9142,3842,14180,3673,1774,1899
12165,18837,4653,9144,3842,14184,3673,1774,1899
12170,18847,4655,9152,3843,14190,3675,1776,1899
12175,18853,4658,9156,3846,14194,3677,1778,1899
12180,18864,4661,9162,3849,14201,3679,1780,1899
12185,18868,4663,9164,3851,14205,3679,1780,1899
12190,18878,4665,9172,3852,14213,3681,1782,1899
12195,18884,4665,9176,3852,14218,3683,1783,1900
12200,18895,4668,9179,3855,14227,3685,1784,1901
12205,18899,4669,9181,3856,14230,3685,1784,1901
12210,18909,4671,9189,3858,14238,3687,1786,1901
12215,18915,4671,9191,3858,14243,3689,1786,1903
12220,18926,4673,9195,3860,14252,3691,1787,1904
12225,18930,4673,9197,3860,14256,3691,1787,1904
12230,18940,4678,9201,3863,14262,3693,1789,1904
12235,18946,4678,9206,3863,14266,3695,1790,1905
12240,18957,4683,9209,3867,14273,3697,1790,1907
12245,18961,4685,9210,3869,14276,3697,1790,1907
12250,18971,4690,9217,3873,14281,3699,1791,1908
12255,18977,4690,9220,3873,14286,3701,1791,1910
12260,18988,4695,9226,3878,14292,3703,1792,1911
12265,18992,4696,9228,3879,14294,3703,1792,1911
12270,19002,4701,9230,3882,14301,3705,1792,1913
12275,19008,4701,9231,3882,14307,3707,1792,1915
12280,19019,4703,9236,3884,14315,3709,1793,1916
12285,19023,4704,9238,3885,14319,3709,1793,1916
12290,19033,4705,9243,3886,14326,3711,1794,1917
12295,19039,4707,9246,3888,14331,3713,1796,1917
12300,19050,4709,9252,3890,14340,3715,1798,1917
12305,19054,4710,9254,3891,14344,3715,1798,1917
12310,19064,4712,9256,3892,14351,3717,1798,1919
12315,19070,4713,9259,3893,14356,3719,1799,1920
12320,19081,4716,9266,3895,14363,3721,1801,1920
12325,19085,4717,9267,3896,14367,3721,1801,1920
12330,19095,4720,9276,3899,14373,3723,1803,1920
12335,19101,4723,9279,3902,14377,3725,1804,1921
12340,19112,4726,9283,3904,14384,3727,1805,1922
12345,19116,4727,9284,3905,14388,3727,1805,1922
12350,19126,4730,9292,3908,14395,3729,1806,1923
12355,19132,4732,9295,3910,14399,3731,1807,1924
12360,19143,4734,9302,3912,14408,3733,1809,1924
12365,19147,4734,9303,3912,14413,3733,1809,1924
12370,19157,4735,9306,3913,14421,3735,1810,1925
12375,19163,4735,9309,3913,14426,3737,1810,1927
12380,19174,4737,9312,3914,14436,3739,1811,1928
12385,19178,4738,9314,3915,14440,3739,1811,1928
12390,19188,4740,9321,3917,14447,3741,1812,1929
12395,19194,4740,9326,3917,14452,3743,1813,1930
12400,19205,4743,9333,3919,14460,3745,1814,1931
12405,19209,4744,9334,3920,14465,3745,1814,1931
12410,19219,4745,9339,3921,14473,3747,1814,1933
12415,19225,4745,9342,3921,14479,3749,1815,1934
12420,19236,4748,9346,3923,14487,3751,1816,1935
12425,19240,4748,9346,3923,14492,3751,1816,1935
12430,19250,4749,9350,3923,14501,3753,1817,1936
12435,19256,4749,9353,3923,14506,3755,1818,1937
12440,19267,4753,9358,3926,14514,3757,1819,1938
12445,19271,4753,9360,3926,14518,3757,1819,1938
12450,19281,4755,9365,3928,14526,3759,1820,1939
12455,19287,4755,9368,3928,14531,3761,1821,1940
12460,19298,4757,9371,3929,14540,3763,1821,1942
12465,19302,4760,9373,3932,14542,3763,1821,1942
12470,19312,4763,9377,3933,14548,3765,1822,1943
12475,19318,4763,9380,3933,14553,3767,1822,1945
12480,19329,4767,9385,3936,14561,3769,1823,1946
12485,19333,4769,9388,3938,14563,3769,1823,1946
12490,19343,4773,9394,3942,14569,3771,1825,1946
12495,19349,4773,9397,3942,14575,3773,1825,1948
12500,19360,4777,9402,3945,14583,3775,1825,1950
12505,19364,4777,9403,3945,14587,3775,1825,1950
12510,19374,4782,9409,3949,14592,3777,1825,1952
12515,19380,4782,9412,3949,14596,3779,1825,1954
12520,19391,4785,9417,3952,14605,3781,1825,1956
12525,19395,4786,9418,3953,14608,3781,1825,1956
12530,19405,4792,9423,3958,14613,3783,1826,1957
12535,19411,4792,9426,3958,14617,3785,1827,1958
12540,19422,4798,9433,3963,14622,3787,1829,1958
12545,19426,4801,9434,3966,14625,3787,1829,1958
12550,19436,4804,9439,3968,14632,3789,1830,1959
12555,19442,4804,9443,3968,14637,3791,1831,1960
12560,19453,4807,9449,3970,14645,3793,1832,1961
12565,19457,4807,9452,3970,14649,3793,1832,1961
12570,19467,4809,9456,3971,14658,3795,1832,1963
12575,19473,4809,9460,3971,14663,3797,1833,1964
12580,19484,4811,9464,3972,14671,3799,1834,1965
12585,19488,4812,9467,3973,14675,3799,1834,1965
12590,19498,4813,9472,3974,14685,3801,1835,1966
12595,19504,4813,9473,3974,14691,3803,1835,1968
12600,19515,4816,9478,3976,14699,3805,1835,1970
12605,19519,4817,9481,3977,14701,3805,1835,1970
12610,19529,4819,9487,3978,14710,3807,1836,1971
12615,19535,4819,9490,3978,14716,3809,1838,1971
12620,19546,4821,9496,3979,14724,3811,1839,1972
12625,19550,4822,9499,3980,14728,3811,1839,1972
12630,19560,4823,9502,3981,14737,3813,1840,1973
12635,19566,4823,9505,3981,14743,3815,1841,1974
12640,19577,4825,9510,3982,14751,3817,1842,1975
12645,19581,4826,9513,3983,14754,3817,1842,1975
12650,19591,4828,9517,3984,14762,3819,1843,1976
12655,19597,4829,9520,3985,14767,3821,1844,1977
12660,19608,4834,9525,3990,14773,3823,1844,1979
12665,19612,4834,9526,3990,14778,3823,1844,1979
12670,19622,4836,9529,3990,14786,3825,1846,1979
12675,19628,4837,9533,3991,14790,3827,1848,1979
12680,19639,4839,9540,3993,14797,3829,1849,1980
12685,19643,4841,9541,3995,14802,3829,1849,1980
12690,19653,4843,9544,3996,14810,3831,1849,1982
12695,19659,4844,9548,3997,14814,3833,1850,1983
12700,19670,4846,9554,3999,14821,3835,1850,1985
12705,19674,4848,9556,4001,14826,3835,1850,1985
12710,19684,4850,9559,4001,14833,3837,1851,1986
12715,19690,4851,9563,4002,14838,3839,1853,1986
12720,19701,4854,9570,4005,14845,3841,1854,1987
12725,19705,4854,9571,4005,14850,3841,1854,1987
12730,19715,4857,9577,4007,14856,3843,1856,1987
12735,19721,4860,9578,4010,14861,3845,1856,1989
12740,19732,4861,9585,4011,14867,3847,1857,1990
12745,19736,4863,9587,4013,14872,3847,1857,1990
12750,19746,4866,9595,4016,14879,3849,1858,1991
12755,19752,4868,9599,4018,14883,3851,1860,1991
12760,19763,4870,9604,4020,14891,3853,1861,1992
12765,19767,4872,9605,4022,14894,3853,1861,1992
12770,19777,4877,9610,4027,14899,3855,1861,1994
12775,19783,4878,9613,4028,14904,3857,1863,1994
12780,19794,4881,9617,4030,14911,3859,1864,1995
12785,19798,4884,9620,4033,14912,3859,1864,1995
12790,19808,4890,9627,4038,14916,3861,1865,1996
12795,19814,4893,9630,4041,14920,3863,1866,1997
12800,19825,4897,9634,4044,14928,3865,1867,1998
12805,19829,4897,9636,4044,14932,3865,1867,1998
12810,19839,4899,9641,4046,14939,3867,1868,1999
12815,19845,4901,9645,4048,14943,3869,1869,2000
12820,19856,4904,9651,4051,14951,3871,1870,2001
12825,19860,4905,9653,4052,14955,3871,1870,2001
12830,19870,4908,9659,4055,14962,3873,1871,2002
12835,19876,4909,9662,4056,14967,3875,1873,2002
12840,19887,4910,9666,4057,14977,3877,1874,2003
12845,19891,4911,9669,4058,14980,3877,1874,2003
12850,19901,4913,9674,4060,14987,3879,1876,2003
12855,19907,4915,9676,4062,14992,3881,1876,2005
12860,19918,4917,9680,4063,15001,3883,1877,2006
12865,19922,4918,9682,4064,15004,3883,1877,2006
12870,19932,4918,9686,4064,15014,3885,1879,2006
12875,19938,4918,9689,4064,15019,3887,1881,2006
12880,19949,4919,9693,4065,15030,3889,1882,2007
12885,19953,4920,9696,4066,15033,3889,1882,2007
12890,19963,4920,9698,4066,15042,3891,1882,2009
12895,19969,4920,9701,4066,15047,3893,1883,2010
12900,19980,4923,9707,4069,15055,3895,1885,2010
12905,19984,4925,9709,4071,15057,3895,1885,2010
12910,19994,4928,9711,4073,15065,3897,1885,2012
12915,20000,4928,9714,4073,15071,3899,1887,2012
12920,20011,4931,9720,4076,15078,3901,1888,2013
12925,20015,4934,9722,4079,15080,3901,1888,2013
12930,20025,4939,9728,4084,15086,3903,1889,2014
12935,20031,4939,9730,4084,15091,3905,1890,2015
12940,20042,4941,9735,4085,15100,3907,1891,2016
12945,20046,4942,9737,4086,15102,3907,1891,2016
12950,20056,4946,9743,4090,15109,3909,1892,2017
12955,20062,4946,9748,4090,15113,3911,1893,2018
12960,20073,4950,9754,4094,15121,3913,1895,2018
12965,20077,4951,9756,4095,15126,3913,1895,2018
12970,20087,4953,9762,4097,15134,3915,1895,2020
12975,20093,4953,9765,4097,15140,3917,1895,2022
12980,20104,4955,9772,4098,15148,3919,1896,2023
12985,20108,4956,9773,4099,15152,3919,1896,2023
12990,20118,4957,9774,4099,15161,3921,1896,2025
12995,20124,4957,9777,4099,15167,3923,1898,2025
13000,20135,4959,9781,4100,15175,3925,1899,2026
13005,20139,4960,9784,4101,15178,3925,1899,2026
13010,20149,4962,9787,4102,15187,3927,1901,2026
13015,20155,4962,9790,4102,15193,3929,1902,2027
13020,20166,4963,9794,4102,15202,3931,1903,2028
13025,20170,4963,9794,4102,15207,3931,1903,2028
13030,20180,4965,9799,4104,15215,3933,1904,2029
13035,20186,4965,9802,4104,15221,3935,1906,2029
13040,20197,4967,9808,4105,15229,3937,1907,2030
13045,20201,4968,9810,4106,15233,3937,1907,2030
13050,20211,4970,9814,4108,15241,3939,1908,2031
13055,20217,4970,9818,4108,15247,3941,1910,2031
13060,20228,4973,9822,4111,15255,3943,1910,2033
13065,20232,4973,9824,4111,15258,3943,1910,2033
13070,20242,4979,9829,4115,15263,3945,1912,2033
13075,20248,4979,9831,4115,15268,3947,1913,2034
13080,20259,4983,9836,4118,15275,3949,1915,2034
13085,20263,4984,9836,4119,15279,3949,1915,2034
13090,20273,4988,9841,4122,15285,3951,1917,2034
13095,20279,4988,9844,4122,15290,3953,1919,2034
13100,20290,4990,9846,4124,15300,3955,1920,2035
13105,20294,4990,9846,4124,15304,3955,1920,2035
13110,20304,4993,9851,4126,15310,3957,1922,2035
13115,20310,4995,9855,4128,15314,3959,1924,2035
13120,20321,4999,9858,4131,15321,3961,1924,2037
13125,20325,5001,9861,4133,15322,3961,1924,2037
13130,20335,5008,9867,4140,15327,3963,1925,2038
13135,20341,5009,9869,4141,15332,3965,1926,2039
13140,20352,5010,9873,4142,15340,3967,1927,2040
13145,20356,5013,9874,4145,15343,3967,1927,2040
13150,20366,5017,9879,4148,15348,3969,1928,2041
13155,20372,5019,9883,4150,15352,3971,1930,2041
13160,20383,5024,9890,4154,15357,3973,1932,2041
13165,20387,5028,9892,4158,15359,3973,1932,2041
13170,20397,5033,9899,4162,15363,3975,1934,2041
13175,20403,5035,9900,4164,15368,3977,1934,2043
13180,20414,5038,9906,4166,15374,3979,1936,2043
13185,20418,5041,9907,4169,15377,3979,1936,2043
13190,20428,5044,9912,4171,15383,3981,1937,2044
13195,20434,5046,9915,4173,15386,3983,1937,2046
13200,20445,5049,9920,4176,15394,3985,1938,2047
13205,20449,5050,9922,4177,15399,3985,1938,2047
13210,20459,5051,9924,4177,15408,3987,1939,2048
13215,20465,5052,9929,4178,15411,3989,1940,2049
13220,20476,5054,9934,4180,15421,3991,1940,2051
13225,20480,5054,9936,4180,15426,3991,1940,2051
13230,20490,5055,9941,4181,15434,3993,1940,2053
13235,20496,5057,9946,4183,15437,3995,1942,2053
13240,20507,5059,9951,4185,15446,3997,1944,2053
13245,20511,5060,9952,4186,15451,3997,1944,2053
13250,20521,5061,9958,4186,15459,3999,1945,2054
13255,20527,5063,9962,4188,15464,4001,1947,2054
13260,20538,5063,9964,4188,15474,4003,1947,2056
13265,20542,5063,9966,4188,15479,4003,1947,2056
13270,20552,5064,9972,4189,15487,4005,1948,2057
13275,20558,5064,9973,4189,15494,4007,1948,2059
13280,20569,5064,9978,4189,15505,4009,1950,2059
13285,20573,5064,9980,4189,15508,4009,1950,2059
13290,20583,5066,9984,4190,15517,4011,1952,2059
13295,20589,5066,9985,4190,15523,4013,1953,2060
13300,20600,5068,9992,4192,15531,4015,1954,2061
13305,20604,5069,9995,4193,15534,4015,1954,2061
13310,20614,5073,10005,4197,15540,4017,1956,2061
13315,20620,5073,10009,4197,15546,4019,1957,2062
13320,20631,5075,10016,4199,15555,4021,1958,2063
13325,20635,5075,10018,4199,15560,4021,1958,2063
13330,20645,5077,10021,4200,15568,4023,1959,2064
13335,20651,5077,10023,4200,15574,4025,1960,2065
13340,20662,5079,10029,4202,15581,4027,1961,2066
13345,20666,5080,10031,4203,15586,4027,1961,2066
13350,20676,5084,10036,4205,15592,4029,1962,2067
13355,20682,5084,10039,4205,15597,4031,1963,2068
13360,20693,5085,10043,4205,15607,4033,1963,2070
13365,20697,5086,10044,4206,15611,4033,1963,2070
13370,20707,5089,10049,4208,15617,4035,1965,2070
13375,20713,5090,10050,4209,15622,4037,1965,2072
13380,20724,5093,10054,4212,15630,4039,1966,2073
13385,20728,5093,10055,4212,15634,4039,1966,2073
13390,20738,5098,10062,4217,15639,4041,1967,2074
13395,20744,5100,10067,4219,15643,4043,1969,2074
13400,20755,5103,10070,4222,15651,4045,1969,2076
13405,20759,5105,10072,4224,15653,4045,1969,2076
13410,20769,5109,10078,4227,15658,4047,1970,2077
13415,20775,5112,10079,4230,15663,4049,1970,2079
13420,20786,5114,10083,4231,15670,4051,1971,2080
13425,20790,5117,10085,4234,15672,4051,1971,2080
13430,20800,5124,10091,4240,15675,4053,1971,2082
13435,20806,5125,10094,4241,15679,4055,1972,2083
13440,20817,5130,10101,4246,15685,4057,1974,2083
13445,20821,5132,10103,4248,15687,4057,1974,2083
13450,20831,5137,10108,4252,15694,4059,1976,2083
13455,20837,5137,10112,4252,15699,4061,1977,2084
13460,20848,5140,10119,4255,15705,4063,1978,2085
13465,20852,5144,10121,4259,15707,4063,1978,2085
13470,20862,5148,10126,4262,15714,4065,1979,2086
13475,20868,5148,10129,4262,15720,4067,1981,2086
13480,20879,5149,10133,4263,15729,4069,1981,2088
13485,20883,5150,10134,4264,15733,4069,1981,2088
13490,20893,5152,10138,4265,15741,4071,1982,2089
13495,20899,5152,10141,4265,15747,4073,1983,2090
13500,20910,5154,10149,4267,15755,4075,1985,2090
13505,20914,5155,10152,4268,15759,4075,1985,2090
13510,20924,5157,10155,4270,15767,4077,1986,2091
13515,20930,5157,10157,4270,15773,4079,1987,2092
13520,20941,5159,10163,4272,15782,4081,1987,2094
13525,20945,5159,10163,4272,15786,4081,1987,2094
13530,20955,5161,10168,4274,15794,4083,1987,2096
13535,20961,5161,10169,4274,15800,4085,1987,2098
13540,20972,5163,10175,4275,15809,4087,1989,2098
13545,20976,5163,10177,4275,15813,4087,1989,2098
13550,20986,5165,10181,4276,15820,4089,1990,2099
13555,20992,5166,10184,4277,15825,4091,1991,2100
13560,21003,5168,10189,4279,15834,4093,1992,2101
13565,21007,5170,10192,4281,15837,4093,1992,2101
13570,21017,5171,10193,4281,15846,4095,1992,2103
13575,21023,5172,10196,4282,15850,4097,1992,2105
13580,21034,5176,10200,4285,15858,4099,1993,2106
13585,21038,5177,10201,4286,15861,4099,1993,2106
13590,21048,5179,10207,4288,15868,4101,1994,2107
13595,21054,5181,10211,4290,15872,4103,1995,2108
13600,21065,5184,10216,4293,15881,4105,1996,2109
13605,21069,5184,10216,4293,15885,4105,1996,2109
13610,21079,5187,10221,4295,15890,4107,1997,2110
13615,21085,5190,10225,4298,15892,4109,1997,2112
13620,21096,5196,10230,4304,15900,4111,1999,2112
13625,21100,5196,10231,4304,15903,4111,1999,2112
13630,21110,5201,10235,4307,15908,4113,2000,2113
13635,21116,5203,10239,4309,15912,4115,2002,2113
13640,21127,5207,10244,4312,15919,4117,2004,2113
13645,21131,5210,10247,4315,15920,4117,2004,2113
13650,21141,5215,10252,4319,15925,4119,2005,2114
13655,21147,5216,10253,4320,15930,4121,2005,2116
13660,21158,5220,10259,4324,15936,4123,2006,2117
13665,21162,5223,10260,4327,15939,4123,2006,2117
13670,21172,5226,10263,4328,15946,4125,2008,2117
13675,21178,5227,10266,4329,15949,4127,2008,2119
13680,21189,5230,10272,4332,15956,4129,2009,2120
13685,21193,5231,10272,4333,15962,4129,2009,2120
13690,21203,5232,10276,4333,15970,4131,2010,2121
13695,21209,5234,10279,4335,15975,4133,2011,2122
13700,21220,5234,10286,4335,15985,4135,2012,2123
13705,21224,5234,10289,4335,15989,4135,2012,2123
13710,21234,5234,10296,4335,15999,4137,2012,2125
13715,21240,5234,10299,4335,16006,4139,2014,2125
13720,21251,5234,10306,4335,16016,4141,2015,2126
13725,21255,5234,10308,4335,16021,4141,2015,2126
13730,21265,5234,10314,4335,16030,4143,2016,2127
13735,21271,5234,10316,4335,16036,4145,2016,2129
13740,21282,5234,10317,4335,16048,4147,2017,2130
13745,21286,5234,10320,4335,16051,4147,2017,2130
13750,21296,5234,10327,4335,16061,4149,2018,2131
13755,21302,5234,10327,4335,16068,4151,2018,2133
13760,21313,5234,10333,4335,16079,4153,2020,2133
13765,21317,5234,10333,4335,16083,4153,2020,2133
13770,21327,5234,10335,4335,16093,4155,2020,2135
13775,21333,5234,10339,4335,16098,4157,2021,2136
13780,21344,5236,10346,4336,16107,4159,2022,2137
13785,21348,5236,10348,4336,16112,4159,2022,2137
13790,21358,5238,10351,4338,16120,4161,2022,2139
13795,21364,5238,10355,4338,16126,4163,2024,2139
13800,21375,5240,10360,4339,16134,4165,2025,2140
13805,21379,5240,10362,4339,16139,4165,2025,2140
13810,21389,5244,10367,4342,16145,4167,2027,2140
13815,21395,5244,10371,4342,16150,4169,2029,2140
13820,21406,5247,10377,4344,16157,4171,2029,2142
13825,21410,5248,10378,4345,16162,4171,2029,2142
13830,21420,5250,10382,4346,16169,4173,2029,2144
13835,21426,5250,10383,4346,16176,4175,2029,2146
13840,21437,5254,10391,4349,16180,4177,2030,2147
13845,21441,5255,10391,4350,16186,4177,2030,2147
13850,21451,5258,10398,4353,16192,4179,2030,2149
13855,21457,5258,10401,4353,16199,4181,2032,2149
13860,21468,5262,10409,4356,16204,4183,2033,2150
13865,21472,5265,10412,4359,16205,4183,2033,2150
13870,21482,5273,10419,4367,16209,4185,2034,2151
13875,21488,5273,10421,4367,16215,4187,2036,2151
13880,21499,5276,10424,4369,16223,4189,2036,2153
13885,21503,5277,10427,4370,16224,4189,2036,2153
13890,21513,5282,10429,4373,16231,4191,2037,2154
13895,21519,5282,10431,4373,16236,4193,2037,2156
13900,21530,5286,10438,4377,16243,4195,2039,2156
13905,21534,5288,10440,4379,16245,4195,2039,2156
13910,21544,5290,10443,4380,16254,4197,2040,2157
13915,21550,5290,10447,4380,16259,4199,2041,2158
13920,21561,5293,10452,4382,16268,4201,2042,2159
13925,21565,5293,10454,4382,16271,4201,2042,2159
13930,21575,5296,10462,4385,16279,4203,2044,2159
13935,21581,5296,10465,4385,16284,4205,2045,2160
13940,21592,5299,10472,4388,16291,4207,2045,2162
13945,21596,5299,10473,4388,16296,4207,2045,2162
13950,21606,5301,10479,4390,16305,4209,2047,2162
13955,21612,5301,10484,4390,16311,4211,2049,2162
13960,21623,5304,10490,4393,16318,4213,2049,2164
13965,21627,5304,10491,4393,16322,4213,2049,2164
13970,21637,5305,10494,4393,16332,4215,2050,2165
13975,21643,5306,10499,4394,16336,4217,2052,2165
13980,21654,5309,10506,4397,16344,4219,2053,2166
13985,21658,5311,10508,4399,16347,4219,2053,2166
13990,21668,5314,10514,4402,16354,4221,2054,2167
13995,21674,5314,10516,4402,16360,4223,2056,2167
14000,21685,5315,10521,4402,16370,4225,2057,2168
14005,21689,5316,10524,4403,16373,4225,2057,2168
14010,21699,5318,10528,4405,16381,4227,2058,2169
14015,21705,5319,10533,4406,16385,4229,2060,2169
14020,21716,5322,10537,4409,16394,4231,2061,2170
14025,21720,5323,10540,4410,16397,4231,2061,2170
14030,21730,5326,10543,4412,16404,4233,2062,2171
14035,21736,5326,10545,4412,16409,4235,2062,2173
14040,21747,5329,10550,4414,16417,4237,2063,2174
14045,21751,5330,10550,4415,16421,4237,2063,2174
14050,21761,5334,10556,4419,16427,4239,2065,2174
14055,21767,5334,10559,4419,16432,4241,2067,2174
14060,21778,5339,10565,4424,16438,4243,2068,2175
14065,21782,5341,10566,4426,16441,4243,2068,2175
14070,21792,5344,10570,4428,16447,4245,2069,2176
14075,21798,5345,10572,4429,16452,4247,2070,2177
14080,21809,5348,10575,4431,16460,4249,2071,2178
14085,21813,5349,10575,4432,16464,4249,2071,2178
14090,21823,5355,10581,4437,16467,4251,2071,2180
14095,21829,5357,10585,4439,16470,4253,2072,2181
14100,21840,5363,10593,4445,16474,4255,2073,2182
14105,21844,5368,10597,4450,16474,4255,2073,2182
14110,21854,5374,10603,4456,16478,4257,2073,2184
14115,21860,5376,10606,4458,16481,4259,2073,2186
14120,21871,5383,10612,4464,16486,4261,2074,2187
14125,21875,5384,10612,4465,16491,4261,2074,2187
14130,21885,5387,10619,4467,16496,4263,2076,2187
14135,21891,5390,10623,4470,16499,4265,2076,2189
14140,21902,5394,10629,4474,16506,4267,2076,2191
14145,21906,5394,10629,4474,16512,4267,2076,2191
14150,21916,5396,10635,4476,16519,4269,2078,2191
14155,21922,5397,10639,4477,16523,4271,2080,2191
14160,21933,5400,10645,4480,16531,4273,2081,2192
14165,21937,5400,10648,4480,16537,4273,2081,2192
14170,21947,5401,10653,4480,16546,4275,2083,2192
14175,21953,5402,10657,4481,16551,4277,2084,2193
14180,21964,5402,10661,4481,16562,4279,2086,2193
14185,21968,5402,10663,4481,16566,4279,2086,2193
14190,21978,5403,10667,4482,16574,4281,2086,2195
14195,21984,5404,10671,4483,16579,4283,2088,2195
14200,21995,5405,10675,4484,16588,4285,2088,2197
14205,21999,5406,10676,4485,16592,4285,2088,2197
14210,22009,5407,10681,4486,16601,4287,2090,2197
14215,22015,5409,10685,4488,16605,4289,2090,2199
14220,22026,5411,10689,4490,16614,4291,2092,2199
14225,22030,5411,10691,4490,16619,4291,2092,2199
14230,22040,5413,10695,4490,16626,4293,2092,2201
14235,22046,5414,10697,4491,16631,4295,2092,2203
14240,22057,5417,10703,4494,16638,4297,2093,2204
14245,22061,5418,10705,4495,16643,4297,2093,2204
14250,22071,5419,10709,4495,16651,4299,2094,2205
14255,22077,5419,10710,4495,16658,4301,2094,2207
14260,22088,5419,10715,4495,16667,4303,2095,2208
14265,22092,5419,10718,4495,16673,4303,2095,2208
14270,22102,5421,10721,4497,16681,4305,2096,2209
14275,22108,5421,10724,4497,16687,4307,2098,2209
14280,22119,5424,10731,4499,16693,4309,2099,2210
14285,22123,5426,10733,4501,16697,4309,2099,2210
14290,22133,5427,10736,4501,16706,4311,2100,2211
14295,22139,5427,10738,4501,16711,4313,2101,2212
14300,22150,5430,10741,4503,16719,4315,2102,2213
14305,22154,5431,10742,4504,16723,4315,2102,2213
14310,22164,5433,10747,4505,16730,4317,2103,2214
14315,22170,5433,10749,4505,16737,4319,2103,2216
14320,22181,5436,10754,4507,16743,4321,2104,2217
14325,22185,5438,10756,4509,16746,4321,2104,2217
14330,22195,5442,10759,4512,16753,4323,2104,2219
14335,22201,5442,10761,4512,16757,4325,2104,2221
14340,22212,5446,10768,4515,16764,4327,2105,2222
14345,22216,5448,10768,4517,16768,4327,2105,2222
14350,22226,5452,10772,4520,16774,4329,2106,2223
14355,22232,5453,10776,4521,16777,4331,2107,2224
14360,22243,5457,10779,4524,16785,4333,2108,2225
14365,22247,5460,10781,4527,16787,4333,2108,2225
14370,22257,5465,10785,4531,16792,4335,2108,2227
14375,22263,5465,10787,4531,16796,4337,2108,2229
14380,22274,5469,10793,4535,16802,4339,2109,2230
14385,22278,5473,10796,4539,16803,4339,2109,2230
14390,22288,5478,10801,4544,16809,4341,2110,2231
14395,22294,5479,10801,4545,16815,4343,2110,2233
14400,22305,5481,10805,4547,16824,4345,2110,2235
14405,22309,5482,10807,4548,16827,4345,2110,2235
14410,22319,5483,10812,4548,16834,4347,2112,2235
14415,22325,5486,10816,4551,16839,4349,2114,2235
14420,22336,5487,10821,4551,16849,4351,2116,2235
14425,22340,5487,10822,4551,16852,4351,2116,2235
14430,22350,5488,10826,4551,16862,4353,2117,2236
14435,22356,5488,10828,4551,16868,4355,2118,2237
14440,22367,5489,10832,4552,16877,4357,2119,2238
14445,22371,5489,10834,4552,16882,4357,2119,2238
14450,22381,5492,10841,4555,16888,4359,2120,2239
14455,22387,5492,10844,4555,16893,4361,2120,2241
14460,22398,5494,10852,4557,16903,4363,2122,2241
14465,22402,5495,10854,4558,16907,4363,2122,2241
14470,22412,5496,10859,4558,16916,4365,2124,2241
14475,22418,5496,10861,4558,16922,4367,2125,2242
14480,22429,5498,10867,4560,16931,4369,2125,2244
14485,22433,5498,10868,4560,16935,4369,2125,2244
14490,22443,5500,10873,4561,16943,4371,2126,2245
14495,22449,5500,10877,4561,16949,4373,2128,2245
14500,22460,5502,10882,4562,16957,4375,2129,2246
14505,22464,5503,10883,4563,16961,4375,2129,2246
14510,22474,5506,10888,4565,16968,4377,2129,2248
14515,22480,5506,10890,4565,16974,4379,2130,2249
14520,22491,5507,10894,4565,16981,4381,2131,2250
14525,22495,5508,10895,4566,16987,4381,2131,2250
14530,22505,5511,10899,4567,16994,4383,2131,2252
14535,22511,5511,10903,4567,17000,4385,2132,2253
14540,22522,5514,10908,4569,17007,4387,2134,2253
14545,22526,5515,10908,4570,17011,4387,2134,2253
14550,22536,5517,10912,4571,17019,4389,2135,2254
14555,22542,5517,10917,4571,17024,4391,2137,2254
14560,22553,5520,10923,4574,17032,4393,2139,2254
14565,22557,5520,10924,4574,17036,4393,2139,2254
14570,22567,5524,10930,4577,17042,4395,2140,2255
14575,22573,5526,10934,4579,17044,4397,2140,2257
14580,22584,5531,10940,4584,17050,4399,2141,2258
14585,22588,5536,10944,4589,17050,4399,2141,2258
14590,22598,5542,10947,4594,17056,4401,2141,2260
14595,22604,5543,10950,4595,17060,4403,2142,2261
14600,22615,5546,10953,4597,17067,4405,2142,2263
14605,22619,5550,10955,4601,17069,4405,2142,2263
14610,22629,5555,10962,4604,17072,4407,2144,2263
14615,22635,5557,10966,4606,17075,4409,2145,2264
14620,22646,5563,10972,4611,17083,4411,2147,2264
14625,22650,5564,10974,4612,17086,4411,2147,2264
14630,22660,5566,10976,4613,17094,4413,2147,2266
14635,22666,5567,10981,4614,17097,4415,2148,2267
14640,22677,5570,10987,4617,17106,4417,2149,2268
14645,22681,5570,10988,4617,17111,4417,2149,2268
14650,22691,5572,10993,4618,17118,4419,2150,2269
14655,22697,5573,10995,4619,17124,4421,2150,2271
14660,22708,5574,11001,4620,17132,4423,2150,2273
14665,22712,5574,11003,4620,17138,4423,2150,2273
14670,22722,5577,11007,4622,17144,4425,2150,2275
14675,22728,5578,11009,4623,17149,4427,2151,2276
14680,22739,5581,11015,4625,17155,4429,2152,2277
14685,22743,5583,11017,4627,17160,4429,2152,2277
14690,22753,5585,11022,4629,17166,4431,2153,2278
14695,22759,5588,11026,4632,17171,4433,2154,2279
14700,22770,5590,11032,4633,17178,4435,2156,2279
14705,22774,5591,11033,4634,17183,4435,2156,2279
14710,22784,5593,11037,4636,17191,4437,2156,2281
14715,22790,5594,11040,4637,17195,4439,2157,2282
14720,22801,5597,11046,4640,17203,4441,2158,2283
14725,22805,5599,11048,4642,17206,4441,2158,2283
14730,22815,5601,11053,4642,17213,4443,2160,2283
14735,22821,5603,11056,4644,17217,4445,2160,2285
14740,22832,5605,11062,4646,17226,4447,2161,2286
14745,22836,5607,11065,4648,17228,4447,2161,2286
14750,22846,5610,11067,4650,17236,4449,2162,2287
14755,22852,5611,11071,4651,17239,4451,2163,2288
14760,22863,5615,11078,4655,17247,4453,2165,2288
14765,22867,5617,11080,4657,17250,4453,2165,2288
14770,22877,5619,11086,4659,17258,4455,2167,2288
14775,22883,5619,11091,4659,17262,4457,2169,2288
14780,22894,5621,11096,4661,17272,4459,2170,2289
14785,22898,5622,11098,4662,17275,4459,2170,2289
14790,22908,5625,11104,4665,17282,4461,2172,2289
14795,22914,5625,11106,4665,17289,4463,2173,2290
14800,22925,5626,11112,4666,17298,4465,2174,2291
14805,22929,5627,11114,4667,17301,4465,2174,2291
14810,22939,5631,11120,4671,17307,4467,2175,2292
14815,22945,5631,11124,4671,17312,4469,2177,2292
14820,22956,5634,11131,4674,17321,4471,2179,2292
14825,22960,5636,11133,4676,17324,4471,2179,2292
14830,22970,5637,11135,4677,17332,4473,2179,2294
14835,22976,5637,11138,4677,17339,4475,2180,2295
14840,22987,5638,11145,4678,17348,4477,2182,2295
14845,22991,5639,11147,4679,17352,4477,2182,2295
14850,23001,5641,11151,4680,17360,4479,2183,2296
14855,23007,5641,11153,4680,17365,4481,2184,2297
14860,23018,5642,11161,4681,17374,4483,2185,2298
14865,23022,5643,11164,4682,17378,4483,2185,2298
14870,23032,5645,11168,4683,17386,4485,2185,2300
14875,23038,5646,11171,4684,17391,4487,2186,2301
14880,23049,5648,11175,4686,17399,4489,2186,2303
14885,23053,5650,11177,4688,17403,4489,2186,2303
14890,23063,5653,11182,4690,17410,4491,2187,2304
14895,23069,5653,11184,4690,17416,4493,2187,2306
14900,23080,5655,11190,4692,17424,4495,2188,2307
14905,23084,5655,11190,4692,17429,4495,2188,2307
14910,23094,5657,11196,4693,17437,4497,2190,2307
14915,23100,5657,11199,4693,17443,4499,2191,2308
14920,23111,5660,11207,4695,17449,4501,2192,2309
14925,23115,5660,11208,4695,17455,4501,2192,2309
14930,23125,5662,11213,4696,17463,4503,2193,2310
14935,23131,5662,11214,4696,17469,4505,2193,2312
14940,23142,5665,11219,4699,17476,4507,2194,2313
14945,23146,5666,11221,4700,17479,4507,2194,2313
14950,23156,5668,11226,4701,17488,4509,2196,2313
14955,23162,5668,11230,4701,17494,4511,2197,2314
14960,23173,5670,11234,4703,17502,4513,2197,2316
14965,23177,5671,11235,4704,17506,4513,2197,2316
14970,23187,5674,11238,4706,17513,4515,2198,2317
14975,23193,5674,11240,4706,17519,4517,2199,2318
14980,23204,5675,11243,4707,17528,4519,2200,2319
14985,23208,5676,11245,4708,17531,4519,2200,2319
14990,23218,5683,11252,4715,17534,4521,2200,2321
14995,23224,5685,11256,4717,17537,4523,2201,2322
15000,23235,5689,11259,4721,17545,4525,2201,2324
15005,23239,5690,11259,4722,17549,4525,2201,2324
15010,23249,5693,11261,4723,17556,4527,2202,2325
15015,23255,5694,11265,4724,17560,4529,2204,2325
15020,23266,5699,11273,4728,17564,4531,2206,2325
15025,23270,5703,11276,4732,17565,4531,2206,2325
15030,23280,5709,11282,4738,17570,4533,2207,2326
15035,23286,5711,11286,4740,17573,4535,2208,2327
15040,23297,5715,11291,4744,17580,4537,2209,2328
15045,23301,5719,11294,4748,17581,4537,2209,2328
15050,23311,5723,11296,4750,17588,4539,2210,2329
15055,23317,5723,11297,4750,17593,4541,2210,2331
15060,23328,5727,11304,4754,17598,4543,2211,2332
15065,23332,5730,11307,4757,17601,4543,2211,2332
15070,23342,5733,11312,4759,17608,4545,2211,2334
15075,23348,5735,11315,4761,17612,4547,2212,2335
15080,23359,5737,11319,4762,17621,4549,2214,2335
15085,23363,5738,11321,4763,17624,4549,2214,2335
15090,23373,5739,11324,4763,17633,4551,2215,2336
15095,23379,5740,11325,4764,17639,4553,2215,2338
15100,23390,5743,11331,4766,17644,4555,2216,2339
15105,23394,5744,11332,4767,17650,4555,2216,2339
15110,23404,5746,11335,4769,17658,4557,2216,2341
15115,23410,5747,11338,4770,17663,4559,2218,2341
15120,23421,5748,11345,4770,17670,4561,2219,2342
15125,23425,5749,11346,4771,17676,4561,2219,2342
15130,23435,5751,11353,4773,17682,4563,2220,2343
15135,23441,5753,11357,4775,17687,4565,2221,2344
15140,23452,5755,11363,4776,17696,4567,2222,2345
15145,23456,5755,11364,4776,17701,4567,2222,2345
15150,23466,5755,11367,4776,17710,4569,2224,2345
15155,23472,5755,11370,4776,17716,4571,2225,2346
15160,23483,5757,11376,4778,17725,4573,2227,2346
15165,23487,5757,11378,4778,17729,4573,2227,2346
15170,23497,5760,11384,4780,17736,4575,2228,2347
15175,23503,5760,11386,4780,17743,4577,2229,2348
15180,23514,5762,11392,4782,17749,4579,2229,2350
15185,23518,5766,11395,4786,17751,4579,2229,2350
15190,23528,5770,11400,4789,17758,4581,2230,2351
15195,23534,5770,11403,4789,17763,4583,2231,2352
15200,23545,5772,11409,4791,17771,4585,2233,2352
15205,23549,5775,11411,4794,17774,4585,2233,2352
15210,23559,5778,11418,4796,17780,4587,2235,2352
15215,23565,5778,11421,4796,17785,4589,2235,2354
15220,23576,5781,11424,4798,17794,4591,2236,2355
15225,23580,5782,11425,4799,17798,4591,2236,2355
15230,23590,5784,11430,4800,17806,4593,2238,2355
15235,23596,5784,11435,4800,17811,4595,2240,2355
15240,23607,5787,11439,4803,17820,4597,2241,2356
15245,23611,5787,11441,4803,17823,4597,2241,2356
15250,23621,5791,11446,4805,17830,4599,2242,2357
15255,23627,5791,11448,4805,17836,4601,2243,2358
15260,23638,5793,11454,4806,17843,4603,2244,2359
15265,23642,5795,11457,4808,17846,4603,2244,2359
15270,23652,5799,11462,4811,17853,4605,2245,2360
15275,23658,5799,11463,4811,17859,4607,2246,2361
15280,23669,5802,11468,4813,17866,4609,2248,2361
15285,23673,5805,11470,4816,17868,4609,2248,2361
15290,23683,5809,11473,4818,17874,4611,2249,2362
15295,23689,5809,11475,4818,17880,4613,2251,2362
15300,23700,5812,11481,4821,17887,4615,2252,2363
15305,23704,5813,11482,4822,17890,4615,2252,2363
15310,23714,5816,11488,4824,17898,4617,2253,2364
15315,23720,5816,11491,4824,17903,4619,2254,2365
15320,23731,5818,11495,4826,17912,4621,2254,2367
15325,23735,5819,11495,4827,17916,4621,2254,2367
15330,23745,5822,11500,4829,17923,4623,2255,2368
15335,23751,5823,11502,4830,17927,4625,2255,2370
15340,23762,5824,11506,4831,17936,4627,2255,2372
15345,23766,5824,11507,4831,17942,4627,2255,2372
15350,23776,5825,11508,4831,17951,4629,2255,2374
15355,23782,5826,11510,4832,17956,4631,2255,2376
15360,23793,5826,11514,4832,17966,4633,2256,2377
15365,23797,5826,11517,4832,17970,4633,2256,2377
15370,23807,5827,11521,4832,17979,4635,2256,2379
15375,23813,5828,11526,4833,17983,4637,2258,2379
15380,23824,5830,11534,4835,17992,4639,2260,2379
15385,23828,5830,11535,4835,17998,4639,2260,2379
15390,23838,5831,11543,4836,18005,4641,2262,2379
15395,23844,5833,11545,4838,18010,4643,2263,2380
15400,23855,5834,11551,4839,18020,4645,2264,2381
15405,23859,5834,11553,4839,18024,4645,2264,2381
15410,23869,5837,11559,4842,18032,4647,2265,2382
15415,23875,5838,11564,4843,18035,4649,2266,2383
15420,23886,5842,11571,4846,18043,4651,2268,2383
15425,23890,5843,11571,4847,18047,4651,2268,2383
15430,23900,5844,11575,4847,18054,4653,2268,2385
15435,23906,5847,11580,4850,18058,4655,2270,2385
15440,23917,5852,11586,4855,18065,4657,2271,2386
15445,23921,5853,11589,4856,18067,4657,2271,2386
15450,23931,5856,11594,4858,18074,4659,2272,2387
15455,23937,5858,11598,4860,18077,4661,2273,2388
15460,23948,5862,11604,4864,18084,4663,2275,2388
15465,23952,5864,11605,4866,18088,4663,2275,2388
15470,23962,5867,11609,4867,18094,4665,2277,2388
15475,23968,5868,11611,4868,18099,4667,2278,2389
15480,23979,5871,11615,4871,18107,4669,2279,2390
15485,23983,5871,11618,4871,18111,4669,2279,2390
15490,23993,5875,11626,4874,18117,4671,2281,2390
15495,23999,5877,11630,4876,18120,4673,2282,2391
15500,24010,5880,11634,4879,18129,4675,2283,2392
15505,24014,5881,11635,4880,18133,4675,2283,2392
15510,24024,5884,11641,4882,18140,4677,2285,2392
15515,24030,5885,11645,4883,18143,4679,2286,2393
15520,24041,5891,11653,4888,18149,4681,2287,2394
15525,24045,5893,11656,4890,18152,4681,2287,2394
15530,24055,5896,11659,4891,18158,4683,2288,2395
15535,24061,5897,11660,4892,18164,4685,2289,2396
15540,24072,5900,11664,4894,18172,4687,2290,2397
15545,24076,5901,11665,4895,18175,4687,2290,2397
15550,24086,5906,11670,4898,18179,4689,2291,2398
15555,24092,5907,11671,4899,18184,4691,2291,2400
15560,24103,5912,11677,4904,18191,4693,2292,2401
15565,24107,5913,11679,4905,18194,4693,2292,2401
15570,24117,5915,11684,4906,18201,4695,2293,2402
15575,24123,5915,11685,4906,18208,4697,2293,2404
15580,24134,5917,11690,4907,18217,4699,2295,2404
15585,24138,5917,11691,4907,18221,4699,2295,2404
15590,24148,5918,11695,4908,18229,4701,2296,2405
15595,24154,5918,11697,4908,18235,4703,2297,2406
15600,24165,5919,11700,4908,18244,4705,2297,2408
15605,24169,5921,11700,4910,18248,4705,2297,2408
15610,24179,5925,11707,4914,18253,4707,2298,2409
15615,24185,5925,11707,4914,18260,4709,2298,2411
15620,24196,5928,11715,4917,18266,4711,2300,2411
15625,24200,5931,11716,4920,18269,4711,2300,2411
15630,24210,5933,11720,4921,18276,4713,2300,2413
15635,24216,5933,11723,4921,18281,4715,2301,2414
15640,24227,5936,11728,4924,18289,4717,2302,2415
15645,24231,5939,11729,4927,18292,4717,2302,2415
15650,24241,5941,11732,4928,18300,4719,2303,2416
15655,24247,5941,11735,4928,18305,4721,2304,2417
15660,24258,5943,11741,4930,18313,4723,2305,2418
15665,24262,5944,11742,4931,18318,4723,2305,2418
15670,24272,5947,11748,4933,18325,4725,2307,2418
15675,24278,5947,11750,4933,18331,4727,2307,2420
15680,24289,5948,11754,4934,18341,4729,2308,2421
15685,24293,5948,11755,4934,18344,4729,2308,2421
15690,24303,5950,11763,4936,18352,4731,2310,2421
15695,24309,5950,11767,4936,18358,4733,2311,2422
15700,24320,5952,11771,4937,18367,4735,2312,2423
15705,24324,5953,11774,4938,18370,4735,2312,2423
15710,24334,5955,11781,4940,18377,4737,2314,2423
15715,24340,5957,11783,4942,18383,4739,2315,2424
15720,24351,5959,11788,4944,18390,4741,2315,2426
15725,24355,5959,11788,4944,18396,4741,2315,2426
15730,24365,5960,11794,4945,18405,4743,2316,2427
15735,24371,5960,11798,4945,18411,4745,2318,2427
15740,24382,5962,11806,4947,18418,4747,2319,2428
15745,24386,5963,11808,4948,18423,4747,2319,2428
15750,24396,5965,11814,4950,18431,4749,2321,2428
15755,24402,5965,11817,4950,18437,4751,2323,2428
15760,24413,5966,11819,4951,18447,4753,2324,2429
15765,24417,5967,11822,4952,18449,4753,2324,2429
15770,24427,5968,11824,4952,18459,4755,2325,2430
15775,24433,5968,11826,4952,18465,4757,2325,2432
15780,24444,5969,11831,4953,18474,4759,2327,2432
15785,24448,5969,11833,4953,18478,4759,2327,2432
15790,24458,5972,11836,4954,18486,4761,2328,2433
15795,24464,5972,11839,4954,18491,4763,2330,2433
15800,24475,5975,11846,4957,18498,4765,2331,2434
15805,24479,5976,11846,4958,18503,4765,2331,2434
15810,24489,5979,11850,4960,18510,4767,2332,2435
15815,24495,5979,11855,4960,18515,4769,2334,2435
15820,24506,5983,11863,4963,18520,4771,2335,2436
15825,24510,5984,11864,4964,18526,4771,2335,2436
15830,24520,5987,11869,4966,18532,4773,2337,2436
15835,24526,5989,11873,4968,18535,4775,2337,2438
15840,24537,5994,11878,4972,18540,4777,2337,2440
15845,24541,5997,11880,4975,18544,4777,2337,2440
15850,24551,6001,11886,4978,18550,4779,2339,2440
15855,24557,6002,11889,4979,18553,4781,2339,2442
15860,24568,6007,11892,4984,18561,4783,2339,2444
15865,24572,6008,11895,4985,18562,4783,2339,2444
15870,24582,6015,11899,4991,18567,4785,2339,2446
15875,24588,6016,11901,4992,18572,4787,2340,2447
15880,24599,6018,11905,4994,18579,4789,2340,2449
15885,24603,6021,11907,4997,18581,4789,2340,2449
15890,24613,6026,11911,5001,18587,4791,2341,2450
15895,24619,6026,11914,5001,18591,4793,2342,2451
15900,24630,6031,11918,5005,18598,4795,2343,2452
15905,24634,6032,11918,5006,18602,4795,2343,2452
15910,24644,6036,11922,5008,18606,4797,2343,2454
15915,24650,6039,11927,5011,18608,4799,2344,2455
15920,24661,6044,11931,5015,18616,4801,2345,2456
15925,24665,6045,11931,5016,18620,4801,2345,2456
15930,24675,6047,11935,5017,18627,4803,2346,2457
15935,24681,6048,11937,5018,18632,4805,2346,2459
15940,24692,6051,11941,5020,18641,4807,2348,2459
15945,24696,6052,11944,5021,18643,4807,2348,2459
15950,24706,6055,11951,5023,18650,4809,2349,2460
15955,24712,6056,11954,5024,18656,4811,2351,2460
15960,24723,6056,11961,5024,18667,4813,2353,2460
15965,24727,6056,11963,5024,18670,4813,2353,2460
15970,24737,6057,11968,5025,18680,4815,2354,2461
15975,24743,6058,11970,5026,18685,4817,2355,2462
15980,24754,6059,11977,5027,18693,4819,2357,2462
15985,24758,6060,11979,5028,18698,4819,2357,2462
15990,24768,6061,11982,5028,18706,4821,2358,2463
15995,24774,6062,11984,5029,18711,4823,2358,2465
16000,24785,6064,11991,5031,18719,4825,2360,2465
16005,24789,6065,11995,5032,18723,4825,2360,2465
16010,24799,6066,11999,5032,18733,4827,2360,2467
16015,24805,6066,12002,5032,18739,4829,2362,2467
16020,24816,6067,12009,5033,18748,4831,2363,2468
16025,24820,6067,12012,5033,18752,4831,2363,2468
16030,24830,6069,12017,5034,18759,4833,2363,2470
16035,24836,6071,12021,5036,18763,4835,2364,2471
16040,24847,6074,12026,5039,18770,4837,2365,2472
16045,24851,6076,12030,5041,18775,4837,2365,2472
16050,24861,6078,12033,5042,18782,4839,2366,2473
16055,24867,6079,12037,5043,18786,4841,2367,2474
16060,24878,6084,12041,5048,18793,4843,2367,2476
16065,24882,6085,12041,5049,18797,4843,2367,2476
16070,24892,6088,12046,5051,18803,4845,2369,2476
16075,24898,6089,12046,5052,18809,4847,2369,2478
16080,24909,6093,12054,5056,18812,4849,2369,2480
16085,24913,6095,12056,5058,18817,4849,2369,2480
16090,24923,6097,12059,5060,18826,4851,2370,2481
16095,24929,6097,12061,5060,18832,4853,2371,2482
16100,24940,6099,12066,5062,18840,4855,2373,2482
16105,24944,6100,12067,5063,18843,4855,2373,2482
16110,24954,6103,12073,5066,18850,4857,2374,2483
16115,24960,6103,12076,5066,18856,4859,2375,2484
16120,24971,6106,12081,5069,18864,4861,2376,2485
16125,24975,6108,12082,5071,18867,4861,2376,2485
16130,24985,6110,12084,5072,18875,4863,2377,2486
16135,24991,6110,12087,5072,18880,4865,2379,2486
16140,25002,6113,12089,5074,18888,4867,2379,2488
16145,25006,6115,12090,5076,18891,4867,2379,2488
16150,25016,6116,12091,5076,18900,4869,2380,2489
16155,25022,6116,12093,5076,18906,4871,2381,2490
16160,25033,6117,12098,5077,18914,4873,2382,2491
16165,25037,6120,12100,5080,18916,4873,2382,2491
16170,25047,6125,12106,5084,18921,4875,2383,2492
16175,25053,6125,12108,5084,18927,4877,2384,2493
16180,25064,6127,12113,5086,18935,4879,2384,2495
16185,25068,6130,12114,5089,18938,4879,2384,2495
16190,25078,6134,12119,5092,18943,4881,2385,2496
16195,25084,6136,12123,5094,18946,4883,2386,2497
16200,25095,6141,12128,5098,18953,4885,2388,2497
16205,25099,6142,12130,5099,18956,4885,2388,2497
16210,25109,6144,12135,5101,18964,4887,2389,2498
16215,25115,6144,12138,5101,18970,4889,2391,2498
16220,25126,6146,12146,5103,18979,4891,2392,2499
16225,25130,6146,12147,5103,18984,4891,2392,2499
16230,25140,6147,12151,5103,18992,4893,2393,2500
16235,25146,6147,12154,5103,18997,4895,2393,2502
16240,25157,6149,12159,5104,19008,4897,2395,2502
16245,25161,6150,12162,5105,19010,4897,2395,2502
16250,25171,6152,12168,5107,19019,4899,2397,2502
16255,25177,6152,12172,5107,19024,4901,2398,2503
16260,25188,6154,12176,5109,19032,4903,2398,2505
16265,25192,6154,12177,5109,19038,4903,2398,2505
16270,25202,6156,12181,5111,19046,4905,2399,2506
16275,25208,6156,12184,5111,19052,4907,2401,2506
16280,25219,6157,12189,5112,19062,4909,2402,2507
16285,25223,6158,12192,5113,19064,4909,2402,2507
16290,25233,6159,12197,5114,19074,4911,2402,2509
16295,25239,6159,12198,5114,19079,4913,2402,2511
16300,25250,6160,12205,5115,19088,4915,2403,2512
16305,25254,6160,12206,5115,19094,4915,2403,2512
16310,25264,6162,12211,5117,19101,4917,2405,2512
16315,25270,6164,12213,5119,19105,4919,2405,2514
16320,25281,6168,12219,5122,19111,4921,2406,2515
16325,25285,6169,12219,5123,19116,4921,2406,2515
16330,25295,6171,12222,5123,19124,4923,2407,2516
16335,25301,6171,12223,5123,19130,4925,2408,2517
16340,25312,6173,12227,5125,19139,4927,2409,2518
16345,25316,6174,12231,5126,19141,4927,2409,2518
16350,25326,6177,12234,5128,19149,4929,2409,2520
16355,25332,6177,12236,5128,19154,4931,2410,2521
16360,25343,6182,12243,5132,19158,4933,2411,2522
16365,25347,6185,12243,5135,19162,4933,2411,2522
16370,25357,6190,12249,5140,19167,4935,2411,2524
16375,25363,6190,12251,5140,19173,4937,2412,2525
16380,25374,6193,12256,5142,19179,4939,2413,2526
16385,25378,6195,12256,5144,19183,4939,2413,2526
16390,25388,6198,12261,5146,19190,4941,2415,2526
16395,25394,6198,12263,5146,19195,4943,2416,2527
16400,25405,6201,12268,5148,19202,4945,2418,2527
16405,25409,6204,12271,5151,19203,4945,2418,2527
16410,25419,6209,12274,5154,19210,4947,2419,2528
16415,25425,6209,12275,5154,19216,4949,2419,2530
16420,25436,6213,12280,5157,19222,4951,2420,2531
16425,25440,6214,12281,5158,19226,4951,2420,2531
16430,25450,6217,12284,5160,19232,4953,2420,2533
16435,25456,6219,12287,5162,19236,4955,2421,2534
16440,25467,6222,12290,5164,19244,4957,2422,2535
16445,25471,6225,12293,5167,19245,4957,2422,2535
16450,25481,6228,12300,5169,19252,4959,2424,2535
16455,25487,6229,12300,5170,19258,4961,2424,2537
16460,25498,6231,12305,5172,19266,4963,2425,2538
16465,25502,6232,12306,5173,19270,4963,2425,2538
16470,25512,6234,12312,5174,19276,4965,2426,2539
16475,25518,6236,12314,5176,19282,4967,2427,2540
16480,25529,6238,12319,5177,19289,4969,2428,2541
16485,25533,6240,12322,5179,19293,4969,2428,2541
16490,25543,6242,12326,5180,19300,4971,2429,2542
16495,25549,6244,12328,5182,19305,4973,2430,2543
16500,25560,6246,12333,5183,19314,4975,2431,2544
16505,25564,6246,12334,5183,19318,4975,2431,2544
16510,25574,6249,12338,5186,19325,4977,2431,2546
16515,25580,6249,12339,5186,19331,4979,2432,2547
16520,25591,6251,12347,5188,19339,4981,2433,2548
16525,25595,6253,12349,5190,19342,4981,2433,2548
16530,25605,6254,12353,5190,19350,4983,2434,2549
16535,25611,6256,12357,5192,19354,4985,2436,2549
16540,25622,6259,12362,5195,19362,4987,2437,2550
16545,25626,6260,12364,5196,19366,4987,2437,2550
16550,25636,6262,12371,5198,19373,4989,2438,2551
16555,25642,6263,12375,5199,19378,4991,2440,2551
16560,25653,6267,12381,5202,19384,4993,2442,2551
16565,25657,6270,12384,5205,19386,4993,2442,2551
16570,25667,6275,12389,5208,19391,4995,2444,2551
16575,25673,6276,12392,5209,19396,4997,2446,2551
16580,25684,6280,12400,5213,19403,4999,2448,2551
16585,25688,6282,12403,5215,19405,4999,2448,2551
16590,25698,6287,12407,5218,19410,5001,2449,2552
16595,25704,6288,12411,5219,19415,5003,2451,2552
16600,25715,6293,12418,5224,19421,5005,2452,2553
16605,25719,6294,12419,5225,19424,5005,2452,2553
16610,25729,6299,12424,5228,19428,5007,2453,2554
16615,25735,6301,12427,5230,19432,5009,2454,2555
16620,25746,6304,12428,5232,19441,5011,2454,2557
16625,25750,6305,12429,5233,19444,5011,2454,2557
16630,25760,6308,12433,5235,19452,5013,2456,2557
16635,25766,6308,12436,5235,19458,5015,2458,2557
16640,25777,6309,12441,5236,19467,5017,2458,2559
16645,25781,6311,12444,5238,19468,5017,2458,2559
16650,25791,6315,12451,5241,19475,5019,2459,2560
16655,25797,6315,12454,5241,19480,5021,2459,2562
16660,25808,6316,12462,5242,19491,5023,2461,2562
16665,25812,6316,12465,5242,19495,5023,2461,2562
16670,25822,6316,12468,5242,19505,5025,2462,2563
16675,25828,6316,12470,5242,19511,5027,2462,2565
16680,25839,6316,12477,5242,19521,5029,2462,2567
16685,25843,6316,12478,5242,19526,5029,2462,2567
16690,25853,6316,12483,5242,19537,5031,2463,2568
16695,25859,6316,12486,5242,19543,5033,2464,2569
16700,25870,6316,12490,5242,19553,5035,2464,2571
16705,25874,6316,12492,5242,19557,5035,2464,2571
16710,25884,6316,12494,5242,19568,5037,2464,2573
16715,25890,6316,12497,5242,19574,5039,2465,2574
16720,25901,6316,12502,5242,19584,5041,2467,2574
16725,25905,6316,12504,5242,19588,5041,2467,2574
16730,25915,6319,12508,5244,19596,5043,2467,2576
16735,25921,6319,12512,5244,19602,5045,2468,2577
16740,25932,6322,12518,5246,19608,5047,2469,2578
16745,25936,6322,12519,5246,19614,5047,2469,2578
16750,25946,6323,12523,5246,19623,5049,2471,2578
16755,25952,6323,12526,5246,19629,5051,2473,2578
16760,25963,6325,12532,5248,19635,5053,2473,2580
16765,25967,6329,12534,5252,19637,5053,2473,2580
16770,25977,6332,12538,5255,19645,5055,2475,2580
16775,25983,6332,12542,5255,19650,5057,2477,2580
16780,25994,6336,12546,5258,19656,5059,2477,2582
16785,25998,6340,12550,5262,19656,5059,2477,2582
16790,26008,6345,12553,5266,19663,5061,2478,2583
16795,26014,6346,12558,5267,19666,5063,2480,2583
16800,26025,6352,12564,5272,19672,5065,2482,2583
16805,26029,6353,12565,5273,19676,5065,2482,2583
16810,26039,6355,12571,5274,19683,5067,2484,2583
16815,26045,6356,12575,5275,19688,5069,2486,2583
16820,26056,6360,12582,5279,19696,5071,2488,2583
16825,26060,6360,12583,5279,19699,5071,2488,2583
16830,26070,6361,12587,5279,19707,5073,2489,2584
16835,26076,6364,12590,5282,19712,5075,2491,2584
16840,26087,6366,12594,5283,19720,5077,2491,2586
16845,26091,6368,12597,5285,19722,5077,2491,2586
16850,26101,6371,12601,5287,19730,5079,2491,2588
16855,26107,6371,12604,5287,19735,5081,2492,2589
16860,26118,6373,12608,5289,19743,5083,2492,2591
16865,26122,6374,12609,5290,19748,5083,2492,2591
16870,26132,6377,12613,5292,19755,5085,2494,2591
16875,26138,6377,12614,5292,19761,5087,2494,2593
16880,26149,6379,12619,5293,19769,5089,2495,2594
16885,26153,6380,12621,5294,19772,5089,2495,2594
16890,26163,6382,12625,5296,19781,5091,2496,2595
16895,26169,6382,12627,5296,19786,5093,2496,2597
16900,26180,6385,12633,5298,19793,5095,2498,2597
16905,26184,6385,12635,5298,19799,5095,2498,2597
16910,26194,6389,12641,5300,19803,5097,2499,2598
16915,26200,6391,12646,5302,19807,5099,2501,2598
16920,26211,6396,12652,5307,19815,5101,2502,2599
16925,26215,6397,12656,5308,19818,5101,2502,2599
16930,26225,6400,12661,5310,19823,5103,2502,2601
16935,26231,6402,12664,5312,19828,5105,2503,2602
16940,26242,6406,12671,5315,19834,5107,2505,2602
16945,26246,6408,12673,5317,19838,5107,2505,2602
16950,26256,6411,12677,5320,19845,5109,2505,2604
16955,26262,6411,12680,5320,19849,5111,2506,2605
16960,26273,6416,12687,5325,19855,5113,2507,2606
16965,26277,6419,12688,5328,19858,5113,2507,2606
16970,26287,6423,12693,5330,19863,5115,2508,2607
16975,26293,6424,12696,5331,19868,5117,2509,2608
16980,26304,6430,12703,5337,19874,5119,2510,2609
16985,26308,6430,12704,5337,19877,5119,2510,2609
16990,26318,6434,12709,5340,19884,5121,2510,2611
16995,26324,6434,12711,5340,19890,5123,2512,2611
17000,26335,6436,12718,5342,19899,5125,2514,2611
17005,26339,6437,12720,5343,19901,5125,2514,2611
17010,26349,6443,12725,5347,19905,5127,2515,2612
17015,26355,6443,12729,5347,19911,5129,2517,2612
17020,26366,6445,12733,5348,19920,5131,2518,2613
17025,26370,6447,12735,5350,19922,5131,2518,2613
17030,26380,6451,12739,5353,19928,5133,2518,2615
17035,26386,6451,12741,5353,19935,5135,2519,2616
17040,26397,6453,12746,5355,19942,5137,2520,2617
17045,26401,6457,12749,5359,19943,5137,2520,2617
17050,26411,6462,12755,5363,19949,5139,2522,2617
17055,26417,6462,12758,5363,19954,5141,2523,2618
17060,26428,6463,12765,5363,19965,5143,2525,2618
17065,26432,6464,12768,5364,19967,5143,2525,2618
17070,26442,6465,12771,5364,19977,5145,2526,2619
17075,26448,6465,12774,5364,19982,5147,2527,2620
17080,26459,6467,12781,5365,19990,5149,2528,2621
17085,26463,6467,12781,5365,19996,5149,2528,2621
17090,26473,6470,12785,5368,20003,5151,2528,2623
17095,26479,6471,12789,5369,20007,5153,2529,2624
17100,26490,6473,12795,5371,20014,5155,2530,2625
17105,26494,6474,12798,5372,20019,5155,2530,2625
17110,26504,6475,12802,5372,20028,5157,2530,2627
17115,26510,6477,12806,5374,20033,5159,2532,2627
17120,26521,6478,12809,5375,20043,5161,2532,2629
17125,26525,6478,12811,5375,20047,5161,2532,2629
17130,26535,6479,12819,5376,20055,5163,2533,2630
17135,26541,6481,12820,5378,20060,5165,2533,2632
17140,26552,6482,12828,5379,20069,5167,2535,2632
17145,26556,6482,12829,5379,20073,5167,2535,2632
17150,26566,6483,12832,5379,20082,5169,2535,2634
17155,26572,6484,12835,5380,20088,5171,2537,2634
17160,26583,6484,12839,5380,20097,5173,2537,2636
17165,26587,6485,12841,5381,20102,5173,2537,2636
17170,26597,6487,12847,5382,20108,5175,2538,2637
17175,26603,6490,12849,5385,20112,5177,2538,2639
17180,26614,6491,12854,5386,20122,5179,2539,2640
17185,26618,6492,12857,5387,20125,5179,2539,2640
17190,26628,6493,12863,5387,20135,5181,2539,2642
17195,26634,6493,12864,5387,20141,5183,2540,2643
17200,26645,6493,12870,5387,20150,5185,2541,2644
17205,26649,6494,12872,5388,20154,5185,2541,2644
17210,26659,6497,12876,5390,20162,5187,2542,2645
17215,26665,6497,12879,5390,20167,5189,2543,2646
17220,26676,6502,12885,5394,20172,5191,2543,2648
17225,26680,6505,12888,5397,20173,5191,2543,2648
17230,26690,6508,12892,5400,20182,5193,2545,2648
17235,26696,6508,12894,5400,20188,5195,2546,2649
17240,26707,6512,12900,5404,20194,5197,2546,2651
17245,26711,6513,12901,5405,20197,5197,2546,2651
17250,26721,6516,12907,5408,20205,5199,2547,2652
17255,26727,6516,12909,5408,20209,5201,2547,2654
17260,26738,6522,12915,5414,20216,5203,2549,2654
17265,26742,6523,12918,5415,20217,5203,2549,2654
17270,26752,6528,12923,5419,20224,5205,2549,2656
17275,26758,6528,12925,5419,20230,5207,2549,2658
17280,26769,6530,12934,5421,20237,5209,2550,2659
17285,26773,6531,12937,5422,20242,5209,2550,2659
17290,26783,6533,12942,5423,20248,5211,2552,2659
17295,26789,6535,12944,5425,20254,5213,2553,2660
17300,26800,6538,12952,5427,20260,5215,2555,2660
17305,26804,6540,12954,5429,20264,5215,2555,2660
17310,26814,6541,12960,5430,20271,5217,2556,2661
17315,26820,6543,12960,5432,20277,5219,2556,2663
17320,26831,6546,12967,5435,20284,5221,2558,2663
17325,26835,6548,12970,5437,20287,5221,2558,2663
17330,26845,6551,12979,5440,20292,5223,2560,2663
17335,26851,6554,12984,5443,20296,5225,2562,2663
17340,26862,6557,12991,5446,20304,5227,2564,2663
17345,26866,6557,12993,5446,20309,5227,2564,2663
17350,26876,6559,12997,5448,20317,5229,2564,2665
17355,26882,6559,12999,5448,20322,5231,2564,2667
17360,26893,6562,13002,5450,20331,5233,2565,2668
17365,26897,6562,13003,5450,20335,5233,2565,2668
17370,26907,6564,13009,5451,20342,5235,2567,2668
17375,26913,6565,13012,5452,20346,5237,2568,2669
17380,26924,6570,13017,5456,20354,5239,2569,2670
17385,26928,6571,13018,5457,20357,5239,2569,2670
17390,26938,6576,13024,5461,20362,5241,2570,2671
17395,26944,6576,13026,5461,20367,5243,2571,2672
17400,26955,6581,13034,5465,20372,5245,2572,2673
17405,26959,6584,13036,5468,20374,5245,2572,2673
17410,26969,6589,13041,5472,20379,5247,2572,2675
17415,26975,6591,13043,5474,20383,5249,2572,2677
17420,26986,6594,13049,5477,20392,5251,2572,2679
17425,26990,6595,13051,5478,20395,5251,2572,2679
17430,27000,6596,13056,5478,20403,5253,2574,2679
17435,27006,6596,13060,5478,20409,5255,2576,2679
17440,27017,6600,13065,5481,20417,5257,2576,2681
17445,27021,6601,13068,5482,20419,5257,2576,2681
17450,27031,6602,13071,5483,20428,5259,2576,2683
17455,27037,6602,13076,5483,20434,5261,2578,2683
17460,27048,6604,13084,5485,20442,5263,2580,2683
17465,27052,6606,13085,5487,20446,5263,2580,2683
17470,27062,6608,13093,5489,20454,5265,2582,2683
17475,27068,6608,13096,5489,20460,5267,2583,2684
17480,27079,6609,13103,5490,20469,5269,2584,2685
17485,27083,6609,13104,5490,20474,5269,2584,2685
17490,27093,6610,13108,5490,20483,5271,2586,2685
17495,27099,6610,13113,5490,20488,5273,2588,2685
17500,27110,6612,13120,5492,20496,5275,2590,2685
17505,27114,6613,13123,5493,20501,5275,2590,2685
17510,27124,6614,13128,5494,20510,5277,2591,2686
17515,27130,6614,13131,5494,20515,5279,2592,2687
17520,27141,6615,13138,5495,20524,5281,2594,2687
17525,27145,6617,13139,5497,20527,5281,2594,2687
17530,27155,6620,13144,5499,20535,5283,2595,2688
17535,27161,6620,13146,5499,20540,5285,2596,2689
17540,27172,6623,13154,5502,20547,5287,2596,2691
17545,27176,6625,13157,5504,20551,5287,2596,2691
17550,27186,6626,13158,5504,20560,5289,2597,2692
17555,27192,6626,13160,5504,20566,5291,2598,2693
17560,27203,6626,13163,5504,20577,5293,2599,2694
17565,27207,6626,13167,5504,20580,5293,2599,2694
17570,27217,6627,13172,5504,20588,5295,2599,2696
17575,27223,6629,13173,5506,20593,5297,2599,2698
17580,27234,6633,13182,5510,20598,5299,2601,2698
17585,27238,6634,13184,5511,20603,5299,2601,2698
17590,27248,6636,13189,5512,20611,5301,2602,2699
17595,27254,6638,13192,5514,20614,5303,2602,2701
17600,27265,6641,13199,5517,20622,5305,2603,2702
17605,27269,6643,13201,5519,20626,5305,2603,2702
17610,27279,6645,13207,5520,20632,5307,2604,2703
17615,27285,6648,13212,5523,20635,5309,2606,2703
17620,27296,6650,13215,5525,20645,5311,2606,2705
17625,27300,6652,13218,5527,20647,5311,2606,2705
17630,27310,6654,13223,5529,20655,5313,2607,2706
17635,27316,6655,13225,5530,20661,5315,2608,2707
17640,27327,6657,13229,5532,20670,5317,2608,2709
17645,27331,6658,13231,5533,20672,5317,2608,2709
17650,27341,6660,13235,5535,20680,5319,2608,2711
17655,27347,6661,13237,5536,20685,5321,2609,2712
17660,27358,6665,13242,5539,20691,5323,2609,2714
17665,27362,6666,13244,5540,20696,5323,2609,2714
17670,27372,6669,13249,5542,20703,5325,2610,2715
17675,27378,6670,13254,5543,20706,5327,2611,2716
17680,27389,6674,13258,5547,20714,5329,2611,2718
17685,27393,6675,13259,5548,20718,5329,2611,2718
17690,27403,6678,13264,5551,20725,5331,2612,2719
17695,27409,6678,13267,5551,20729,5333,2613,2720
17700,27420,6681,13269,5554,20739,5335,2613,2722
17705,27424,6682,13270,5555,20742,5335,2613,2722
17710,27434,6684,13275,5556,20749,5337,2614,2723
17715,27440,6685,13279,5557,20753,5339,2615,2724
17720,27451,6688,13283,5559,20762,5341,2616,2725
17725,27455,6689,13284,5560,20766,5341,2616,2725
17730,27465,6691,13286,5561,20774,5343,2616,2727
17735,27471,6691,13290,5561,20779,5345,2618,2727
17740,27482,6695,13294,5564,20786,5347,2619,2728
17745,27486,6696,13295,5565,20790,5347,2619,2728
17750,27496,6698,13301,5567,20797,5349,2621,2728
17755,27502,6698,13304,5567,20803,5351,2622,2729
17760,27513,6699,13310,5567,20812,5353,2624,2729
17765,27517,6702,13313,5570,20813,5353,2624,2729
17770,27527,6706,13316,5574,20821,5355,2625,2730
17775,27533,6706,13318,5574,20826,5357,2626,2731
17780,27544,6709,13322,5576,20834,5359,2627,2732
17785,27548,6711,13324,5578,20836,5359,2627,2732
17790,27558,6715,13329,5581,20843,5361,2628,2733
17795,27564,6715,13332,5581,20848,5363,2628,2735
17800,27575,6717,13334,5583,20857,5365,2628,2737
17805,27579,6718,13335,5584,20860,5365,2628,2737
17810,27589,6722,13340,5587,20867,5367,2630,2737
17815,27595,6722,13342,5587,20872,5369,2631,2738
17820,27606,6725,13347,5590,20881,5371,2632,2739
17825,27610,6725,13347,5590,20885,5371,2632,2739
17830,27620,6727,13351,5592,20893,5373,2633,2740
17835,27626,6727,13353,5592,20899,5375,2635,2740
17840,27637,6729,13355,5594,20908,5377,2635,2742
17845,27641,6730,13356,5595,20911,5377,2635,2742
17850,27651,6733,13362,5598,20918,5379,2636,2743
17855,27657,6733,13365,5598,20923,5381,2637,2744
17860,27668,6736,13370,5600,20931,5383,2638,2745
17865,27672,6737,13374,5601,20934,5383,2638,2745
17870,27682,6739,13378,5603,20942,5385,2639,2746
17875,27688,6741,13384,5605,20945,5387,2641,2746
17880,27699,6743,13387,5606,20955,5389,2643,2746
17885,27703,6743,13388,5606,20960,5389,2643,2746
17890,27713,6745,13392,5607,20967,5391,2644,2747
17895,27719,6747,13394,5609,20972,5393,2645,2748
17900,27730,6749,13396,5610,20981,5395,2645,2750
17905,27734,6750,13399,5611,20983,5395,2645,2750
17910,27744,6751,13402,5612,20993,5397,2646,2751
17915,27750,6751,13406,5612,20998,5399,2647,2752
17920,27761,6753,13408,5613,21006,5401,2647,2754
17925,27765,6754,13411,5614,21010,5401,2647,2754
17930,27775,6757,13420,5616,21016,5403,2649,2754
17935,27781,6760,13425,5619,21020,5405,2651,2754
17940,27792,6763,13427,5621,21029,5407,2651,2756
17945,27796,6763,13430,5621,21033,5407,2651,2756
17950,27806,6764,13431,5621,21041,5409,2651,2758
17955,27812,6765,13434,5622,21045,5411,2652,2759
17960,27823,6771,13439,5627,21050,5413,2652,2761
17965,27827,6772,13440,5628,21055,5413,2652,2761
17970,27837,6775,13447,5630,21060,5415,2654,2761
17975,27843,6778,13449,5633,21065,5417,2655,2762
17980,27854,6780,13454,5635,21072,5419,2655,2764
17985,27858,6782,13456,5637,21076,5419,2655,2764
17990,27868,6785,13460,5639,21082,5421,2655,2766
17995,27874,6786,13462,5640,21087,5423,2656,2767
18000,27885,6791,13469,5644,21091,5425,2657,2768
18005,27889,6793,13471,5646,21095,5425,2657,2768
18010,27899,6798,13479,5650,21099,5427,2658,2769
18015,27905,6800,13481,5652,21104,5429,2659,2770
18020,27916,6806,13488,5657,21108,5431,2660,2771
18025,27920,6808,13490,5659,21112,5431,2660,2771
18030,27930,6810,13494,5660,21120,5433,2661,2772
18035,27936,6810,13498,5660,21125,5435,2662,2773
18040,27947,6813,13503,5663,21133,5437,2663,2774
18045,27951,6815,13505,5665,21135,5437,2663,2774
18050,27961,6820,13510,5670,21141,5439,2663,2776
18055,27967,6820,13513,5670,21146,5441,2665,2776
18060,27978,6822,13520,5672,21153,5443,2666,2777
18065,27982,6826,13521,5676,21156,5443,2666,2777
18070,27992,6826,13525,5676,21165,5445,2667,2778
18075,27998,6826,13526,5676,21171,5447,2667,2780
18080,28009,6828,13531,5677,21181,5449,2668,2781
18085,28013,6829,13532,5678,21184,5449,2668,2781
18090,28023,6830,13538,5679,21192,5451,2670,2781
18095,28029,6830,13540,5679,21198,5453,2671,2782
18100,28040,6832,13545,5681,21207,5455,2671,2784
18105,28044,6833,13549,5682,21210,5455,2671,2784
18110,28054,6835,13555,5684,21219,5457,2671,2786
18115,28060,6835,13557,5684,21225,5459,2672,2787
18120,28071,6836,13561,5685,21235,5461,2673,2788
18125,28075,6836,13562,5685,21239,5461,2673,2788
18130,28085,6837,13565,5686,21248,5463,2674,2789
18135,28091,6837,13568,5686,21254,5465,2675,2790
18140,28102,6838,13574,5687,21264,5467,2677,2790
18145,28106,6839,13576,5688,21267,5467,2677,2790
18150,28116,6840,13578,5688,21276,5469,2678,2791
18155,28122,6840,13579,5688,21282,5471,2679,2792
18160,28133,6841,13584,5689,21292,5473,2681,2792
18165,28137,6842,13586,5690,21295,5473,2681,2792
18170,28147,6845,13591,5693,21302,5475,2682,2793
18175,28153,6845,13594,5693,21306,5477,2683,2794
18180,28164,6849,13599,5696,21313,5479,2684,2795
18185,28168,6851,13600,5698,21316,5479,2684,2795
18190,28178,6857,13604,5703,21321,5481,2684,2797
18195,28184,6857,13606,5703,21326,5483,2684,2799
18200,28195,6861,13617,5707,21331,5485,2686,2799
18205,28199,6865,13619,5711,21334,5485,2686,2799
18210,28209,6868,13624,5712,21341,5487,2687,2800
18215,28215,6868,13625,5712,21347,5489,2687,2802
18220,28226,6868,13628,5712,21357,5491,2688,2803
18225,28230,6870,13630,5714,21359,5491,2688,2803
18230,28240,6875,13636,5719,21365,5493,2688,2805
18235,28246,6875,13641,5719,21369,5495,2690,2805
18240,28257,6876,13645,5720,21380,5497,2690,2807
18245,28261,6876,13645,5720,21385,5497,2690,2807
18250,28271,6877,13649,5720,21393,5499,2690,2809
18255,28277,6879,13653,5722,21398,5501,2691,2810
18260,28288,6879,13660,5722,21407,5503,2693,2810
18265,28292,6880,13661,5723,21412,5503,2693,2810
18270,28302,6881,13668,5724,21420,5505,2695,2810
18275,28308,6883,13671,5726,21425,5507,2696,2811
18280,28319,6884,13674,5727,21435,5509,2697,2812
18285,28323,6884,13676,5727,21439,5509,2697,2812
18290,28333,6885,13679,5728,21447,5511,2697,2814
18295,28339,6886,13679,5729,21453,5513,2697,2816
18300,28350,6888,13683,5730,21461,5515,2698,2817
18305,28354,6888,13684,5730,21466,5515,2698,2817
18310,28364,6889,13688,5730,21474,5517,2699,2818
18315,28370,6891,13690,5732,21478,5519,2699,2820
18320,28381,6895,13696,5735,21485,5521,2700,2821
18325,28385,6895,13697,5735,21490,5521,2700,2821
18330,28395,6896,13700,5735,21499,5523,2701,2822
18335,28401,6897,13703,5736,21502,5525,2701,2824
18340,28412,6902,13708,5740,21508,5527,2702,2825
18345,28416,6903,13710,5741,21513,5527,2702,2825
18350,28426,6905,13714,5743,21519,5529,2702,2827
18355,28432,6908,13717,5746,21523,5531,2703,2828
18360,28443,6912,13723,5749,21528,5533,2704,2829
18365,28447,6916,13725,5753,21530,5533,2704,2829
18370,28457,6920,13731,5757,21535,5535,2705,2830
18375,28463,6923,13734,5760,21539,5537,2706,2831
18380,28474,6927,13740,5763,21544,5539,2707,2832
18385,28478,6930,13742,5766,21546,5539,2707,2832
18390,28488,6935,13745,5770,21553,5541,2708,2833
18395,28494,6936,13748,5771,21557,5543,2709,2834
18400,28505,6941,13754,5776,21564,5545,2710,2835
18405,28509,6942,13756,5777,21566,5545,2710,2835
18410,28519,6948,13763,5783,21571,5547,2711,2836
18415,28525,6948,13766,5783,21576,5549,2713,2836
18420,28536,6952,13773,5787,21584,5551,2714,2837
18425,28540,6953,13776,5788,21587,5551,2714,2837
18430,28550,6955,13779,5789,21594,5553,2714,2839
18435,28556,6956,13783,5790,21599,5555,2715,2840
18440,28567,6958,13787,5791,21609,5557,2715,2842
18445,28571,6958,13788,5791,21613,5557,2715,2842
18450,28581,6958,13791,5791,21623,5559,2716,2843
18455,28587,6958,13793,5791,21628,5561,2717,2844
18460,28598,6959,13798,5792,21639,5563,2718,2845
18465,28602,6959,13801,5792,21643,5563,2718,2845
18470,28612,6960,13807,5793,21651,5565,2720,2845
18475,28618,6960,13811,5793,21657,5567,2722,2845
18480,28629,6961,13816,5794,21668,5569,2722,2847
18485,28633,6961,13817,5794,21672,5569,2722,2847
18490,28643,6962,13820,5795,21681,5571,2722,2849
18495,28649,6962,13823,5795,21686,5573,2722,2851
18500,28660,6963,13825,5795,21696,5575,2722,2853
18505,28664,6964,13827,5796,21700,5575,2722,2853
18510,28674,6965,13831,5797,21709,5577,2723,2854
18515,28680,6965,13835,5797,21712,5579,2723,2856
18520,28691,6969,13840,5801,21721,5581,2725,2856
18525,28695,6971,13842,5803,21723,5581,2725,2856
18530,28705,6974,13847,5806,21731,5583,2727,2856
18535,28711,6975,13851,5807,21735,5585,2728,2857
18540,28722,6979,13857,5811,21741,5587,2729,2858
18545,28726,6980,13861,5812,21745,5587,2729,2858
18550,28736,6982,13867,5814,21753,5589,2729,2860
18555,28742,6982,13870,5814,21760,5591,2730,2861
18560,28753,6983,13874,5814,21770,5593,2732,2861
18565,28757,6984,13877,5815,21773,5593,2732,2861
18570,28767,6987,13882,5816,21779,5595,2733,2862
18575,28773,6987,13885,5816,21785,5597,2734,2863
18580,28784,6989,13890,5817,21794,5599,2735,2864
18585,28788,6990,13893,5818,21797,5599,2735,2864
18590,28798,6993,13899,5821,21805,5601,2737,2864
18595,28804,6993,13902,5821,21811,5603,2739,2864
18600,28815,6995,13906,5822,21818,5605,2740,2865
18605,28819,6997,13907,5824,21822,5605,2740,2865
18610,28829,7001,13913,5827,21827,5607,2741,2866
18615,28835,7001,13915,5827,21834,5609,2742,2867
18620,28846,7002,13918,5827,21842,5611,2743,2868
18625,28850,7002,13920,5827,21848,5611,2743,2868
18630,28860,7004,13923,5829,21856,5613,2744,2869
18635,28866,7004,13928,5829,21860,5615,2746,2869
18640,28877,7008,13935,5832,21867,5617,2747,2870
18645,28881,7010,13935,5834,21871,5617,2747,2870
18650,28891,7014,13939,5836,21876,5619,2748,2871
18655,28897,7015,13940,5837,21881,5621,2748,2873
18660,28908,7018,13945,5839,21886,5623,2748,2875
18665,28912,7022,13947,5843,21889,5623,2748,2875
18670,28922,7025,13951,5845,21897,5625,2749,2876
18675,28928,7025,13954,5845,21903,5627,2750,2877
18680,28939,7029,13960,5848,21909,5629,2751,2878
18685,28943,7029,13961,5848,21913,5629,2751,2878
18690,28953,7033,13968,5852,21920,5631,2752,2879
18695,28959,7033,13971,5852,21925,5633,2753,2880
18700,28970,7037,13976,5856,21933,5635,2755,2880
18705,28974,7038,13977,5857,21936,5635,2755,2880
18710,28984,7041,13979,5858,21943,5637,2756,2881
18715,28990,7041,13983,5858,21948,5639,2757,2882
18720,29001,7044,13986,5861,21957,5641,2758,2883
18725,29005,7044,13987,5861,21961,5641,2758,2883
18730,29015,7047,13990,5862,21968,5643,2759,2884
18735,29021,7047,13992,5862,21973,5645,2759,2886
18740,29032,7050,13995,5864,21981,5647,2760,2887
18745,29036,7050,13995,5864,21986,5647,2760,2887
18750,29046,7052,13998,5864,21994,5649,2762,2887
18755,29052,7052,14003,5864,21999,5651,2763,2888
18760,29063,7057,14010,5869,22005,5653,2765,2888
18765,29067,7059,14012,5871,22008,5653,2765,2888
18770,29077,7063,14017,5874,22012,5655,2765,2890
18775,29083,7066,14019,5877,22016,5657,2765,2892
18780,29094,7070,14024,5881,22022,5659,2765,2894
18785,29098,7072,14024,5883,22026,5659,2765,2894
18790,29108,7075,14030,5885,22031,5661,2767,2894
18795,29114,7077,14035,5887,22034,5663,2769,2894
18800,29125,7082,14041,5892,22041,5665,2769,2896
18805,29129,7084,14044,5894,22044,5665,2769,2896
18810,29139,7086,14048,5895,22053,5667,2770,2897
18815,29145,7086,14051,5895,22058,5669,2771,2898
18820,29156,7089,14054,5897,22067,5671,2772,2899
18825,29160,7090,14057,5898,22070,5671,2772,2899
18830,29170,7091,14062,5898,22078,5673,2773,2900
18835,29176,7093,14067,5900,22082,5675,2775,2900
18840,29187,7095,14072,5901,22090,5677,2776,2901
18845,29191,7096,14073,5902,22094,5677,2776,2901
18850,29201,7099,14080,5905,22100,5679,2776,2903
18855,29207,7101,14081,5907,22106,5681,2776,2905
18860,29218,7104,14091,5910,22112,5683,2778,2905
18865,29222,7106,14093,5912,22115,5683,2778,2905
18870,29232,7107,14100,5912,22123,5685,2780,2905
18875,29238,7110,14103,5915,22128,5687,2781,2906
18880,29249,7113,14108,5917,22136,5689,2782,2907
18885,29253,7114,14111,5918,22139,5689,2782,2907
18890,29263,7116,14115,5919,22146,5691,2783,2908
18895,29269,7117,14118,5920,22151,5693,2785,2908
18900,29280,7121,14125,5924,22159,5695,2787,2908
18905,29284,7121,14128,5924,22162,5695,2787,2908
18910,29294,7125,14131,5927,22169,5697,2787,2910
18915,29300,7125,14135,5927,22174,5699,2789,2910
18920,29311,7128,14139,5930,22181,5701,2789,2912
18925,29315,7130,14140,5932,22185,5701,2789,2912
18930,29325,7133,14145,5934,22191,5703,2789,2914
18935,29331,7135,14148,5936,22195,5705,2790,2915
18940,29342,7138,14152,5938,22201,5707,2790,2917
18945,29346,7140,14154,5940,22205,5707,2790,2917
18950,29356,7143,14157,5942,22212,5709,2790,2919
18955,29362,7144,14159,5943,22218,5711,2791,2920
18960,29373,7147,14167,5946,22223,5713,2793,2920
18965,29377,7149,14167,5948,22228,5713,2793,2920
18970,29387,7151,14171,5949,22235,5715,2794,2921
18975,29393,7152,14174,5950,22239,5717,2795,2922
18980,29404,7154,14179,5952,22248,5719,2796,2923
18985,29408,7156,14180,5954,22251,5719,2796,2923
18990,29418,7159,14184,5956,22258,5721,2796,2925
18995,29424,7159,14187,5956,22264,5723,2797,2926
19000,29435,7161,14194,5958,22271,5725,2798,2927
19005,29439,7163,14197,5960,22275,5725,2798,2927
19010,29449,7165,14202,5962,22283,5727,2798,2929
19015,29455,7165,14206,5962,22289,5729,2799,2930
19020,29466,7167,14213,5964,22298,5731,2800,2931
19025,29470,7167,14214,5964,22302,5731,2800,2931
19030,29480,7169,14219,5965,22311,5733,2802,2931
19035,29486,7169,14222,5965,22316,5735,2803,2932
19040,29497,7170,14227,5966,22326,5737,2804,2933
19045,29501,7171,14229,5967,22329,5737,2804,2933
19050,29511,7173,14236,5969,22338,5739,2806,2933
19055,29517,7173,14238,5969,22344,5741,2806,2935
19060,29528,7175,14248,5971,22351,5743,2808,2935
19065,29532,7176,14251,5972,22356,5743,2808,2935
19070,29542,7178,14257,5973,22364,5745,2810,2935
19075,29548,7178,14257,5973,22370,5747,2810,2937
19080,29559,7180,14265,5975,22377,5749,2812,2937
19085,29563,7180,14266,5975,22382,5749,2812,2937
19090,29573,7184,14270,5978,22389,5751,2812,2939
19095,29579,7184,14273,5978,22395,5753,2813,2940
19100,29590,7186,14277,5980,22404,5755,2814,2941
19105,29594,7186,14279,5980,22407,5755,2814,2941
19110,29604,7191,14284,5984,22413,5757,2815,2942
19115,29610,7191,14288,5984,22419,5759,2816,2943
19120,29621,7193,14292,5985,22428,5761,2817,2944
19125,29625,7194,14293,5986,22431,5761,2817,2944
19130,29635,7197,14299,5988,22438,5763,2819,2944
19135,29641,7197,14303,5988,22443,5765,2821,2944
19140,29652,7201,14309,5991,22451,5767,2822,2945
19145,29656,7202,14313,5992,22454,5767,2822,2945
19150,29666,7204,14320,5994,22461,5769,2824,2945
19155,29672,7205,14324,5995,22466,5771,2826,2945
19160,29683,7208,14330,5997,22475,5773,2828,2945
19165,29687,7208,14330,5997,22479,5773,2828,2945
19170,29697,7210,14336,5999,22485,5775,2828,2947
19175,29703,7213,14339,6002,22489,5777,2829,2948
19180,29714,7216,14343,6004,22497,5779,2829,2950
19185,29718,7218,14345,6006,22500,5779,2829,2950
19190,29728,7219,14350,6007,22508,5781,2831,2950
19195,29734,7220,14352,6008,22512,5783,2831,2952
19200,29745,7224,14359,6012,22520,5785,2832,2953
19205,29749,7224,14359,6012,22525,5785,2832,2953
19210,29759,7227,14367,6015,22530,5787,2834,2953
19215,29765,7229,14370,6017,22534,5789,2835,2954
19220,29776,7234,14376,6021,22539,5791,2836,2955
19225,29780,7239,14380,6026,22539,5791,2836,2955
19230,29790,7244,14386,6031,22545,5793,2838,2955
19235,29796,7245,14389,6032,22549,5795,2839,2956
19240,29807,7251,14396,6038,22554,5797,2840,2957
19245,29811,7253,14396,6040,22558,5797,2840,2957
19250,29821,7257,14401,6043,22563,5799,2841,2958
19255,29827,7259,14404,6045,22566,5801,2841,2960
19260,29838,7264,14411,6050,22571,5803,2842,2961
19265,29842,7266,14415,6052,22575,5803,2842,2961
19270,29852,7267,14419,6052,22585,5805,2844,2961
19275,29858,7267,14421,6052,22591,5807,2845,2962
19280,29869,7270,14426,6054,22597,5809,2845,2964
19285,29873,7272,14428,6056,22601,5809,2845,2964
19290,29883,7273,14430,6056,22610,5811,2846,2965
19295,29889,7273,14434,6056,22614,5813,2846,2967
19300,29900,7276,14440,6058,22623,5815,2847,2968
19305,29904,7276,14441,6058,22628,5815,2847,2968
19310,29914,7278,14447,6060,22636,5817,2848,2969
19315,29920,7278,14451,6060,22641,5819,2849,2970
19320,29931,7282,14456,6063,22648,5821,2850,2971
19325,29935,7284,14457,6065,22651,5821,2850,2971
19330,29945,7286,14461,6066,22659,5823,2851,2972
19335,29951,7286,14464,6066,22663,5825,2852,2973
19340,29962,7289,14472,6069,22671,5827,2853,2974
19345,29966,7290,14474,6070,22676,5827,2853,2974
19350,29976,7291,14478,6070,22684,5829,2853,2976
19355,29982,7291,14482,6070,22690,5831,2855,2976
19360,29993,7294,14487,6073,22699,5833,2855,2978
19365,29997,7296,14490,6075,22700,5833,2855,2978
19370,30007,7302,14496,6079,22704,5835,2857,2978
19375,30013,7302,14500,6079,22710,5837,2858,2979
19380,30024,7302,14506,6079,22721,5839,2860,2979
19385,30028,7302,14508,6079,22726,5839,2860,2979
19390,30038,7303,14515,6079,22735,5841,2862,2979
19395,30044,7303,14516,6079,22741,5843,2863,2980
19400,30055,7303,14518,6079,22752,5845,2863,2982
19405,30059,7303,14521,6079,22755,5845,2863,2982
19410,30069,7304,14527,6079,22765,5847,2864,2983
19415,30075,7304,14529,6079,22771,5849,2865,2984
19420,30086,7304,14533,6079,22780,5851,2865,2986
19425,30090,7304,14534,6079,22785,5851,2865,2986
19430,30100,7305,14541,6080,22795,5853,2865,2988
19435,30106,7305,14545,6080,22800,5855,2867,2988
19440,30117,7306,14552,6081,22809,5857,2868,2989
19445,30121,7306,14552,6081,22815,5857,2868,2989
19450,30131,7307,14555,6081,22824,5859,2869,2990
19455,30137,7307,14558,6081,22830,5861,2871,2990
19460,30148,7307,14563,6081,22839,5863,2872,2991
19465,30152,7307,14565,6081,22844,5863,2872,2991
19470,30162,7308,14567,6081,22854,5865,2872,2993
19475,30168,7308,14569,6081,22859,5867,2872,2995
19480,30179,7311,14574,6083,22868,5869,2874,2995
19485,30183,7312,14577,6084,22871,5869,2874,2995
19490,30193,7315,14582,6086,22877,5871,2874,2997
19495,30199,7317,14586,6088,22880,5873,2875,2998
19500,30210,7321,14591,6091,22888,5875,2877,2998
19505,30214,7322,14592,6092,22892,5875,2877,2998
19510,30224,7325,14595,6093,22898,5877,2878,2999
19515,30230,7326,14597,6094,22903,5879,2878,3001
19520,30241,7330,14604,6098,22909,5881,2880,3001
19525,30245,7331,14605,6099,22914,5881,2880,3001
19530,30255,7334,14611,6101,22919,5883,2880,3003
19535,30261,7337,14614,6104,22923,5885,2881,3004
19540,30272,7340,14617,6107,22931,5887,2881,3006
19545,30276,7341,14620,6108,22935,5887,2881,3006
19550,30286,7343,14624,6109,22942,5889,2882,3007
19555,30292,7344,14627,6110,22947,5891,2883,3008
19560,30303,7348,14631,6114,22954,5893,2883,3010
19565,30307,7348,14632,6114,22959,5893,2883,3010
19570,30317,7352,14637,6117,22965,5895,2883,3012
19575,30323,7353,14640,6118,22969,5897,2884,3013
19580,30334,7358,14647,6123,22973,5899,2884,3015
19585,30338,7362,14650,6127,22974,5899,2884,3015
19590,30348,7367,14652,6130,22980,5901,2884,3017
19595,30354,7368,14655,6131,22984,5903,2885,3018
19600,30365,7373,14662,6136,22990,5905,2887,3018
19605,30369,7375,14662,6138,22994,5905,2887,3018
19610,30379,7378,14667,6141,23000,5907,2888,3019
19615,30385,7380,14670,6143,23003,5909,2888,3021
19620,30396,7385,14676,6147,23009,5911,2890,3021
19625,30400,7386,14677,6148,23014,5911,2890,3021
19630,30410,7389,14683,6149,23019,5913,2892,3021
19635,30416,7391,14686,6151,23023,5915,2893,3022
19640,30427,7395,14693,6155,23029,5917,2895,3022
19645,30431,7398,14695,6158,23032,5917,2895,3022
19650,30441,7402,14700,6161,23039,5919,2897,3022
19655,30447,7402,14702,6161,23043,5921,2897,3024
19660,30458,7407,14707,6165,23049,5923,2898,3025
19665,30462,7407,14707,6165,23055,5923,2898,3025
19670,30472,7409,14711,6166,23061,5925,2898,3027
19675,30478,7412,14714,6169,23064,5927,2898,3029
19680,30489,7417,14720,6174,23070,5929,2898,3031
19685,30493,7419,14722,6176,23074,5929,2898,3031
19690,30503,7421,14727,6178,23082,5931,2900,3031
19695,30509,7421,14730,6178,23088,5933,2901,3032
19700,30520,7422,14733,6178,23098,5935,2901,3034
19705,30524,7423,14736,6179,23101,5935,2901,3034
19710,30534,7424,14742,6180,23110,5937,2902,3035
19715,30540,7424,14744,6180,23116,5939,2904,3035
19720,30551,7425,14748,6180,23126,5941,2904,3037
19725,30555,7425,14750,6180,23130,5941,2904,3037
19730,30565,7425,14755,6180,23140,5943,2905,3038
19735,30571,7425,14760,6180,23145,5945,2906,3039
19740,30582,7427,14768,6182,23155,5947,2907,3040
19745,30586,7428,14772,6183,23158,5947,2907,3040
19750,30596,7430,14779,6185,23165,5949,2907,3042
19755,30602,7430,14783,6185,23172,5951,2908,3043
19760,30613,7432,14789,6187,23181,5953,2908,3045
19765,30617,7432,14791,6187,23185,5953,2908,3045
19770,30627,7433,14796,6188,23193,5955,2909,3046
19775,30633,7433,14799,6188,23199,5957,2909,3048
19780,30644,7435,14805,6190,23209,5959,2910,3049
19785,30648,7435,14807,6190,23211,5959,2910,3049
19790,30658,7442,14812,6195,23216,5961,2911,3050
19795,30664,7442,14816,6195,23220,5963,2912,3051
19800,30675,7446,14823,6199,23227,5965,2913,3052
19805,30679,7449,14826,6202,23228,5965,2913,3052
19810,30689,7454,14831,6205,23235,5967,2915,3052
19815,30695,7454,14835,6205,23241,5969,2916,3053
19820,30706,7455,14840,6205,23250,5971,2918,3053
19825,30710,7455,14842,6205,23255,5971,2918,3053
19830,30720,7458,14843,6206,23262,5973,2918,3055
19835,30726,7458,14845,6206,23268,5975,2919,3056
19840,30737,7459,14850,6207,23276,5977,2920,3057
19845,30741,7460,14851,6208,23280,5977,2920,3057
19850,30751,7463,14853,6210,23288,5979,2920,3059
19855,30757,7463,14856,6210,23294,5981,2921,3060
19860,30768,7467,14866,6214,23298,5983,2923,3060
19865,30772,7469,14868,6216,23303,5983,2923,3060
19870,30782,7471,14871,6217,23311,5985,2924,3061
19875,30788,7471,14876,6217,23316,5987,2926,3061
19880,30799,7476,14882,6221,23323,5989,2927,3062
19885,30803,7476,14884,6221,23327,5989,2927,3062
19890,30813,7480,14889,6224,23333,5991,2928,3063
19895,30819,7481,14893,6225,23337,5993,2929,3064
19900,30830,7485,14898,6228,23343,5995,2929,3066
19905,30834,7486,14899,6229,23347,5995,2929,3066
19910,30844,7489,14904,6231,23354,5997,2930,3067
19915,30850,7491,14907,6233,23359,5999,2932,3067
19920,30861,7494,14911,6235,23366,6001,2933,3068
19925,30865,7496,14914,6237,23368,6001,2933,3068
19930,30875,7499,14918,6239,23376,6003,2935,3068
19935,30881,7499,14920,6239,23380,6005,2935,3070
19940,30892,7503,14924,6243,23389,6007,2936,3071
19945,30896,7503,14927,6243,23392,6007,2936,3071
19950,30906,7504,14932,6244,23402,6009,2937,3072
19955,30912,7504,14934,6244,23407,6011,2938,3073
19960,30923,7506,14942,6246,23415,6013,2940,3073
19965,30927,7507,14943,6247,23419,6013,2940,3073
19970,30937,7508,14950,6247,23427,6015,2941,3074
19975,30943,7510,14953,6249,23432,6017,2942,3075
19980,30954,7510,14956,6249,23443,6019,2942,3077
19985,30958,7511,14959,6250,23446,6019,2942,3077
19990,30968,7512,14962,6250,23456,6021,2943,3078
19995,30974,7513,14966,6251,23460,6023,2944,3079
20000,30985,7515,14971,6253,23470,6025,2946,3079
20005,30989,7515,14975,6253,23474,6025,2946,3079
20010,30999,7516,14982,6253,23481,6027,2947,3080
20015,31005,7518,14985,6255,23487,6029,2949,3080
20020,31016,7519,14993,6256,23495,6031,2949,3082
20025,31020,7520,14996,6257,23500,6031,2949,3082
20030,31030,7523,15000,6259,23506,6033,2949,3084
20035,31036,7524,15002,6260,23512,6035,2950,3085
20040,31047,7526,15007,6262,23520,6037,2951,3086
20045,31051,7527,15008,6263,23524,6037,2951,3086
20050,31061,7529,15013,6265,23531,6039,2952,3087
20055,31067,7531,15017,6267,23534,6041,2953,3088
20060,31078,7535,15020,6271,23542,6043,2953,3090
20065,31082,7537,15023,6273,23545,6043,2953,3090
20070,31092,7540,15027,6275,23552,6045,2954,3091
20075,31098,7540,15029,6275,23558,6047,2955,3092
20080,31109,7543,15034,6277,23565,6049,2957,3092
20085,31113,7544,15037,6278,23569,6049,2957,3092
20090,31123,7546,15040,6278,23576,6051,2958,3093
20095,31129,7547,15044,6279,23581,6053,2960,3093
20100,31140,7550,15048,6282,23589,6055,2961,3094
20105,31144,7552,15049,6284,23592,6055,2961,3094
20110,31154,7557,15054,6288,23597,6057,2962,3095
20115,31160,7557,15058,6288,23601,6059,2964,3095
20120,31171,7560,15060,6290,23610,6061,2965,3096
20125,31175,7561,15060,6291,23614,6061,2965,3096
20130,31185,7565,15064,6293,23620,6063,2967,3096
20135,31191,7565,15065,6293,23625,6065,2967,3098
20140,31202,7570,15071,6298,23630,6067,2967,3100
20145,31206,7572,15072,6300,23633,6067,2967,3100
20150,31216,7576,15073,6302,23640,6069,2967,3102
20155,31222,7576,15074,6302,23646,6071,2968,3103
20160,31233,7578,15079,6303,23653,6073,2970,3103
20165,31237,7580,15080,6305,23656,6073,2970,3103
20170,31247,7587,15087,6311,23659,6075,2971,3104
20175,31253,7588,15091,6312,23664,6077,2973,3104
20180,31264,7591,15098,6315,23672,6079,2975,3104
20185,31268,7593,15100,6317,23674,6079,2975,3104
20190,31278,7596,15106,6320,23680,6081,2976,3105
20195,31284,7598,15109,6322,23685,6083,2977,3106
20200,31295,7601,15117,6325,23693,6085,2979,3106
20205,31299,7603,15118,6327,23696,6085,2979,3106
20210,31309,7605,15123,6329,23703,6087,2981,3106
20215,31315,7606,15125,6330,23709,6089,2982,3107
20220,31326,7608,15131,6332,23718,6091,2983,3108
20225,31330,7609,15132,6333,23721,6091,2983,3108
20230,31340,7610,15138,6334,23729,6093,2985,3108
20235,31346,7610,15139,6334,23736,6095,2986,3109
20240,31357,7612,15145,6335,23745,6097,2987,3110
20245,31361,7613,15148,6336,23748,6097,2987,3110
20250,31371,7614,15152,6337,23756,6099,2987,3112
20255,31377,7614,15155,6337,23763,6101,2987,3114
20260,31388,7615,15157,6337,23773,6103,2988,3115
20265,31392,7615,15159,6337,23777,6103,2988,3115
20270,31402,7617,15166,6339,23785,6105,2989,3116
20275,31408,7617,15170,6339,23790,6107,2990,3117
20280,31419,7618,15173,6339,23800,6109,2991,3118
20285,31423,7618,15173,6339,23805,6109,2991,3118
20290,31433,7619,15177,6340,23813,6111,2992,3119
20295,31439,7619,15180,6340,23819,6113,2993,3120
20300,31450,7623,15186,6344,23826,6115,2994,3121
20305,31454,7624,15187,6345,23829,6115,2994,3121
20310,31464,7627,15193,6347,23836,6117,2996,3121
20315,31470,7627,15199,6347,23840,6119,2998,3121
20320,31481,7632,15206,6352,23848,6121,2999,3122
20325,31485,7633,15206,6353,23852,6121,2999,3122
20330,31495,7636,15210,6354,23858,6123,3000,3123
20335,31501,7636,15214,6354,23862,6125,3000,3125
20340,31512,7639,15218,6357,23871,6127,3000,3127
20345,31516,7643,15220,6361,23873,6127,3000,3127
20350,31526,7648,15225,6365,23878,6129,3000,3129
20355,31532,7648,15227,6365,23883,6131,3001,3130
20360,31543,7651,15232,6368,23891,6133,3002,3131
20365,31547,7652,15233,6369,23894,6133,3002,3131
20370,31557,7657,15238,6373,23900,6135,3004,3131
20375,31563,7657,15240,6373,23905,6137,3004,3133
20380,31574,7661,15244,6376,23912,6139,3004,3135
20385,31578,7662,15245,6377,23916,6139,3004,3135
20390,31588,7664,15250,6379,23924,6141,3004,3137
20395,31594,7664,15253,6379,23930,6143,3004,3139
20400,31605,7667,15262,6382,23937,6145,3005,3140
20405,31609,7667,15265,6382,23941,6145,3005,3140
20410,31619,7670,15269,6385,23949,6147,3006,3141
20415,31625,7670,15271,6385,23955,6149,3006,3143
20420,31636,7672,15274,6386,23964,6151,3006,3145
20425,31640,7672,15275,6386,23967,6151,3006,3145
20430,31650,7675,15279,6389,23975,6153,3006,3147
20435,31656,7675,15281,6389,23981,6155,3006,3149
20440,31667,7678,15287,6391,23988,6157,3006,3151
20445,31671,7679,15289,6392,23992,6157,3006,3151
20450,31681,7682,15295,6395,23999,6159,3008,3151
20455,31687,7682,15296,6395,24005,6161,3009,3152
20460,31698,7683,15300,6395,24015,6163,3011,3152
20465,31702,7683,15302,6395,24018,6163,3011,3152
20470,31712,7684,15308,6396,24026,6165,3012,3153
20475,31718,7687,15312,6399,24030,6167,3013,3154
20480,31729,7689,15320,6401,24039,6169,3014,3155
20485,31733,7690,15323,6402,24042,6169,3014,3155
20490,31743,7694,15328,6405,24048,6171,3014,3157
20495,31749,7695,15332,6406,24052,6173,3016,3157
20500,31760,7698,15336,6409,24061,6175,3016,3159
20505,31764,7700,15337,6411,24064,6175,3016,3159
20510,31774,7704,15344,6414,24068,6177,3017,3160
20515,31780,7707,15348,6417,24072,6179,3019,3160
20520,31791,7710,15351,6420,24081,6181,3019,3162
20525,31795,7710,15352,6420,24085,6181,3019,3162
20530,31805,7713,15355,6421,24091,6183,3020,3163
20535,31811,7714,15358,6422,24095,6185,3021,3164
20540,31822,7717,15363,6425,24102,6187,3022,3165
20545,31826,7721,15365,6429,24104,6187,3022,3165
20550,31836,7726,15371,6434,24109,6189,3022,3167
20555,31842,7728,15374,6436,24114,6191,3023,3168
20560,31853,7729,15380,6437,24121,6193,3024,3169
20565,31857,7730,15380,6438,24127,6193,3024,3169
20570,31867,7731,15382,6438,24135,6195,3024,3171
20575,31873,7733,15387,6440,24138,6197,3025,3172
20580,31884,7737,15391,6443,24147,6199,3025,3174
20585,31888,7737,15393,6443,24150,6199,3025,3174
20590,31898,7739,15399,6444,24157,6201,3026,3175
20595,31904,7741,15402,6446,24162,6203,3027,3176
20600,31915,7744,15409,6449,24170,6205,3029,3176
20605,31919,7744,15411,6449,24174,6205,3029,3176
20610,31929,7746,15416,6451,24182,6207,3030,3177
20615,31935,7748,15418,6453,24186,6209,3030,3179
20620,31946,7749,15424,6453,24196,6211,3031,3180
20625,31950,7750,15428,6454,24200,6211,3031,3180
20630,31960,7750,15433,6454,24209,6213,3033,3180
20635,31966,7750,15434,6454,24216,6215,3033,3182
20640,31977,7751,15442,6454,24224,6217,3035,3182
20645,31981,7752,15444,6455,24229,6217,3035,3182
20650,31991,7754,15448,6457,24236,6219,3036,3183
20655,31997,7754,15452,6457,24242,6221,3037,3184
20660,32008,7756,15457,6458,24251,6223,3039,3184
20665,32012,7756,15458,6458,24256,6223,3039,3184
20670,32022,7758,15461,6459,24264,6225,3040,3185
20675,32028,7758,15465,6459,24269,6227,3041,3186
20680,32039,7762,15471,6462,24274,6229,3041,3188
20685,32043,7764,15472,6464,24279,6229,3041,3188
20690,32053,7765,15477,6465,24288,6231,3042,3189
20695,32059,7765,15481,6465,24294,6233,3044,3189
20700,32070,7768,15489,6467,24299,6235,3046,3189
20705,32074,7770,15491,6469,24303,6235,3046,3189
20710,32084,7772,15495,6471,24312,6237,3047,3190
20715,32090,7772,15500,6471,24316,6239,3049,3190
20720,32101,7775,15504,6473,24324,6241,3050,3191
20725,32105,7777,15506,6475,24326,6241,3050,3191
20730,32115,7785,15511,6481,24330,6243,3050,3193
20735,32121,7785,15512,6481,24335,6245,3050,3195
20740,32132,7788,15515,6483,24343,6247,3051,3196
20745,32136,7791,15517,6486,24345,6247,3051,3196
20750,32146,7795,15524,6490,24351,6249,3052,3197
20755,32152,7795,15529,6490,24356,6251,3054,3197
20760,32163,7798,15533,6492,24362,6253,3054,3199
20765,32167,7799,15533,6493,24368,6253,3054,3199
20770,32177,7800,15538,6493,24376,6255,3056,3199
20775,32183,7802,15541,6495,24381,6257,3057,3200
20780,32194,7804,15545,6496,24390,6259,3058,3201
20785,32198,7804,15547,6496,24394,6259,3058,3201
20790,32208,7806,15552,6497,24401,6261,3060,3201
20795,32214,7808,15555,6499,24405,6263,3061,3202
20800,32225,7811,15561,6502,24413,6265,3062,3203
20805,32229,7812,15561,6503,24417,6265,3062,3203
20810,32239,7814,15566,6504,24424,6267,3062,3205
20815,32245,7816,15570,6506,24428,6269,3063,3206
20820,32256,7820,15576,6509,24435,6271,3064,3207
20825,32260,7821,15579,6510,24439,6271,3064,3207
20830,32270,7824,15586,6512,24444,6273,3065,3208
20835,32276,7826,15588,6514,24450,6275,3065,3210
20840,32287,7829,15596,6517,24458,6277,3066,3211
20845,32291,7829,15597,6517,24462,6277,3066,3211
20850,32301,7830,15602,6518,24470,6279,3068,3211
20855,32307,7832,15604,6520,24475,6281,3069,3212
20860,32318,7834,15609,6522,24484,6283,3070,3213
20865,32322,7834,15609,6522,24488,6283,3070,3213
20870,32332,7839,15613,6525,24493,6285,3071,3214
20875,32338,7839,15615,6525,24498,6287,3072,3215
20880,32349,7843,15620,6529,24505,6289,3073,3216
20885,32353,7845,15623,6531,24506,6289,3073,3216
20890,32363,7850,15626,6534,24512,6291,3074,3217
20895,32369,7851,15628,6535,24517,6293,3074,3219
20900,32380,7855,15633,6539,24523,6295,3074,3221
20905,32384,7856,15634,6540,24528,6295,3074,3221
20910,32394,7860,15641,6543,24533,6297,3075,3222
20915,32400,7861,15644,6544,24537,6299,3076,3223
20920,32411,7865,15652,6548,24543,6301,3078,3223
20925,32415,7866,15654,6549,24548,6301,3078,3223
20930,32425,7870,15661,6553,24554,6303,3080,3223
20935,32431,7871,15664,6554,24559,6305,3081,3224
20940,32442,7875,15668,6557,24566,6307,3081,3226
20945,32446,7876,15671,6558,24569,6307,3081,3226
20950,32456,7880,15677,6561,24574,6309,3081,3228
20955,32462,7882,15680,6563,24578,6311,3081,3230
20960,32473,7886,15687,6566,24583,6313,3082,3231
20965,32477,7888,15690,6568,24588,6313,3082,3231
20970,32487,7891,15694,6570,24595,6315,3082,3233
20975,32493,7893,15698,6572,24599,6317,3083,3234
20980,32504,7895,15705,6574,24608,6319,3084,3235
20985,32508,7896,15708,6575,24611,6319,3084,3235
20990,32518,7899,15715,6578,24618,6321,3085,3236
20995,32524,7899,15718,6578,24623,6323,3086,3237
21000,32535,7904,15727,6583,24630,6325,3088,3237
21005,32539,7906,15728,6585,24633,6325,3088,3237
21010,32549,7910,15735,6588,24639,6327,3090,3237
21015,32555,7910,15740,6588,24644,6329,3091,3238
21020,32566,7912,15744,6589,24654,6331,3092,3239
21025,32570,7912,15745,6589,24658,6331,3092,3239
21030,32580,7912,15746,6589,24668,6333,3092,3241
21035,32586,7912,15747,6589,24673,6335,3092,3243
21040,32597,7914,15751,6590,24683,6337,3093,3244
21045,32601,7915,15753,6591,24686,6337,3093,3244
21050,32611,7916,15756,6592,24695,6339,3094,3245
21055,32617,7916,15760,6592,24700,6341,3095,3246
21060,32628,7918,15764,6593,24709,6343,3095,3248
21065,32632,7918,15766,6593,24714,6343,3095,3248
21070,32642,7918,15771,6593,24724,6345,3096,3249
21075,32648,7918,15773,6593,24730,6347,3097,3250
21080,32659,7918,15777,6593,24740,6349,3098,3251
21085,32663,7918,15779,6593,24745,6349,3098,3251
21090,32673,7919,15783,6594,24754,6351,3098,3253
21095,32679,7919,15786,6594,24760,6353,3100,3253
21100,32690,7919,15791,6594,24770,6355,3102,3253
21105,32694,7919,15792,6594,24775,6355,3102,3253
21110,32704,7920,15795,6594,24783,6357,3103,3254
21115,32710,7921,15796,6595,24789,6359,3104,3255
21120,32721,7922,15802,6596,24796,6361,3105,3256
21125,32725,7924,15805,6598,24800,6361,3105,3256
21130,32735,7927,15811,6600,24807,6363,3107,3256
21135,32741,7928,15812,6601,24813,6365,3108,3257
21140,32752,7930,15816,6603,24820,6367,3108,3259
21145,32756,7931,15817,6604,24824,6367,3108,3259
21150,32766,7934,15824,6606,24831,6369,3110,3259
21155,32772,7936,15827,6608,24835,6371,3111,3260
21160,32783,7939,15832,6611,24843,6373,3112,3261
21165,32787,7940,15835,6612,24846,6373,3112,3261
21170,32797,7945,15839,6615,24851,6375,3113,3262
21175,32803,7946,15844,6616,24854,6377,3115,3262
21180,32814,7951,15850,6621,24861,6379,3117,3262
21185,32818,7955,15852,6625,24863,6379,3117,3262
21190,32828,7959,15857,6628,24868,6381,3118,3263
21195,32834,7961,15862,6630,24871,6383,3120,3263
21200,32845,7966,15867,6635,24879,6385,3122,3263
21205,32849,7966,15869,6635,24881,6385,3122,3263
21210,32859,7970,15872,6638,24889,6387,3123,3264
21215,32865,7970,15876,6638,24894,6389,3125,3264
21220,32876,7974,15882,6641,24899,6391,3126,3265
21225,32880,7975,15884,6642,24904,6391,3126,3265
21230,32890,7977,15889,6644,24911,6393,3126,3267
21235,32896,7980,15892,6647,24916,6395,3128,3267
21240,32907,7981,15896,6647,24924,6397,3129,3268
21245,32911,7982,15897,6648,24929,6397,3129,3268
21250,32921,7984,15901,6649,24936,6399,3130,3269
21255,32927,7985,15902,6650,24941,6401,3130,3271
21260,32938,7989,15909,6653,24947,6403,3132,3271
21265,32942,7990,15910,6654,24951,6403,3132,3271
21270,32952,7993,15918,6657,24957,6405,3134,3271
21275,32958,7995,15921,6659,24961,6407,3135,3272
21280,32969,7997,15925,6661,24972,6409,3136,3273
21285,32973,7998,15929,6662,24975,6409,3136,3273
21290,32983,8000,15938,6664,24982,6411,3138,3273
21295,32989,8000,15939,6664,24989,6413,3138,3275
21300,33000,8002,15945,6666,24998,6415,3138,3277
21305,33004,8003,15947,6667,25001,6415,3138,3277
21310,33014,8005,15949,6669,25009,6417,3138,3279
21315,33020,8005,15950,6669,25015,6419,3139,3280
21320,33031,8007,15955,6671,25024,6421,3140,3281
21325,33035,8008,15958,6672,25026,6421,3140,3281
21330,33045,8011,15962,6674,25033,6423,3141,3282
21335,33051,8011,15965,6674,25039,6425,3142,3283
21340,33062,8016,15973,6679,25046,6427,3143,3284
21345,33066,8017,15974,6680,25049,6427,3143,3284
21350,33076,8019,15980,6682,25057,6429,3144,3285
21355,33082,8019,15982,6682,25061,6431,3144,3287
21360,33093,8021,15987,6684,25071,6433,3145,3288
21365,33097,8023,15990,6686,25074,6433,3145,3288
21370,33107,8025,15994,6688,25082,6435,3146,3289
21375,33113,8025,15999,6688,25087,6437,3148,3289
21380,33124,8026,16003,6688,25097,6439,3150,3289
21385,33128,8026,16005,6688,25101,6439,3150,3289
21390,33138,8027,16009,6688,25111,6441,3152,3289
21395,33144,8027,16015,6688,25116,6443,3154,3289
21400,33155,8028,16017,6688,25127,6445,3155,3290
21405,33159,8028,16019,6688,25130,6445,3155,3290
21410,33169,8030,16024,6690,25139,6447,3155,3292
21415,33175,8030,16025,6690,25145,6449,3156,3293
21420,33186,8032,16028,6692,25154,6451,3156,3295
21425,33190,8032,16030,6692,25158,6451,3156,3295
21430,33200,8035,16037,6695,25165,6453,3157,3296
21435,33206,8035,16041,6695,25171,6455,3159,3296
21440,33217,8036,16045,6695,25180,6457,3161,3296
21445,33221,8037,16047,6696,25184,6457,3161,3296
21450,33231,8039,16051,6698,25192,6459,3161,3298
21455,33237,8039,16056,6698,25197,6461,3163,3298
21460,33248,8042,16061,6700,25205,6463,3164,3299
21465,33252,8042,16062,6700,25210,6463,3164,3299
21470,33262,8045,16064,6701,25216,6465,3164,3301
21475,33268,8047,16066,6703,25221,6467,3165,3302
21480,33279,8051,16073,6706,25225,6469,3166,3303
21485,33283,8055,16076,6710,25226,6469,3166,3303
21490,33293,8062,16080,6716,25231,6471,3166,3305
21495,33299,8063,16085,6717,25233,6473,3167,3306
21500,33310,8068,16090,6721,25240,6475,3168,3307
21505,33314,8069,16092,6722,25244,6475,3168,3307
21510,33324,8073,16097,6725,25251,6477,3170,3307
21515,33330,8074,16100,6726,25255,6479,3170,3309
21520,33341,8077,16103,6728,25264,6481,3171,3310
21525,33345,8078,16106,6729,25266,6481,3171,3310
21530,33355,8081,16113,6732,25273,6483,3172,3311
21535,33361,8082,16115,6733,25278,6485,3173,3312
21540,33372,8086,16119,6736,25285,6487,3173,3314
21545,33376,8086,16121,6736,25289,6487,3173,3314
21550,33386,8090,16127,6738,25295,6489,3175,3314
21555,33392,8091,16131,6739,25300,6491,3177,3314
21560,33403,8095,16136,6742,25305,6493,3177,3316
21565,33407,8098,16140,6745,25308,6493,3177,3316
21570,33417,8102,16146,6748,25314,6495,3178,3317
21575,33423,8104,16149,6750,25319,6497,3179,3318
21580,33434,8107,16155,6752,25325,6499,3180,3319
21585,33438,8107,16156,6752,25331,6499,3180,3319
21590,33448,8109,16162,6753,25338,6501,3182,3319
21595,33454,8110,16166,6754,25343,6503,3184,3319
21600,33465,8114,16175,6758,25347,6505,3186,3319
21605,33469,8118,16179,6762,25350,6505,3186,3319
21610,33479,8122,16186,6766,25355,6507,3187,3320
21615,33485,8125,16189,6769,25359,6509,3187,3322
21620,33496,8130,16195,6774,25365,6511,3188,3323
21625,33500,8130,16196,6774,25370,6511,3188,3323
21630,33510,8133,16201,6775,25375,6513,3189,3324
21635,33516,8136,16204,6778,25380,6515,3190,3325
21640,33527,8140,16212,6782,25385,6517,3192,3325
21645,33531,8142,16215,6784,25388,6517,3192,3325
21650,33541,8145,16220,6787,25395,6519,3193,3326
21655,33547,8146,16222,6788,25400,6521,3194,3327
21660,33558,8148,16224,6790,25410,6523,3195,3328
21665,33562,8148,16225,6790,25414,6523,3195,3328
21670,33572,8150,16232,6792,25420,6525,3196,3329
21675,33578,8152,16235,6794,25426,6527,3198,3329
21680,33589,8154,16240,6795,25435,6529,3199,3330
21685,33593,8154,16241,6795,25439,6529,3199,3330
21690,33603,8156,16250,6797,25446,6531,3201,3330
21695,33609,8156,16252,6797,25453,6533,3201,3332
21700,33620,8157,16257,6798,25463,6535,3201,3334
21705,33624,8157,16259,6798,25467,6535,3201,3334
21710,33634,8158,16263,6799,25475,6537,3201,3336
21715,33640,8158,16266,6799,25481,6539,3202,3337
21720,33651,8160,16271,6800,25491,6541,3203,3338
21725,33655,8161,16274,6801,25494,6541,3203,3338
21730,33665,8161,16279,6801,25503,6543,3205,3338
21735,33671,8161,16281,6801,25510,6545,3206,3339
21740,33682,8161,16287,6801,25521,6547,3207,3340
21745,33686,8161,16290,6801,25525,6547,3207,3340
21750,33696,8161,16296,6801,25534,6549,3209,3340
21755,33702,8161,16299,6801,25541,6551,3210,3341
21760,33713,8161,16304,6801,25551,6553,3212,3341
21765,33717,8162,16306,6802,25555,6553,3212,3341
21770,33727,8163,16308,6803,25564,6555,3212,3343
21775,33733,8163,16312,6803,25569,6557,3214,3343
21780,33744,8163,16319,6803,25578,6559,3215,3344
21785,33748,8166,16321,6806,25581,6559,3215,3344
21790,33758,8171,16325,6810,25586,6561,3215,3346
21795,33764,8171,16327,6810,25592,6563,3216,3347
21800,33775,8172,16335,6811,25600,6565,3217,3348
21805,33779,8175,16336,6814,25603,6565,3217,3348
21810,33789,8179,16339,6816,25609,6567,3217,3350
21815,33795,8179,16341,6816,25614,6569,3217,3352
21820,33806,8182,16348,6819,25622,6571,3219,3352
21825,33810,8184,16350,6821,25625,6571,3219,3352
21830,33820,8189,16357,6825,25629,6573,3221,3352
21835,33826,8191,16358,6827,25635,6575,3222,3353
21840,33837,8194,16364,6829,25641,6577,3224,3353
21845,33841,8197,16367,6832,25643,6577,3224,3353
21850,33851,8198,16373,6833,25653,6579,3225,3354
21855,33857,8198,16376,6833,25659,6581,3226,3355
21860,33868,8201,16383,6835,25666,6583,3227,3356
21865,33872,8201,16385,6835,25670,6583,3227,3356
21870,33882,8204,16388,6837,25678,6585,3227,3358
21875,33888,8204,16391,6837,25684,6587,3229,3358
21880,33899,8206,16396,6838,25693,6589,3231,3358
21885,33903,8207,16397,6839,25696,6589,3231,3358
21890,33913,8209,16402,6841,25704,6591,3233,3358
21895,33919,8209,16406,6841,25710,6593,3234,3359
21900,33930,8212,16411,6843,25718,6595,3235,3360
21905,33934,8213,16413,6844,25721,6595,3235,3360
21910,33944,8214,16419,6845,25730,6597,3237,3360
21915,33950,8214,16421,6845,25736,6599,3237,3362
21920,33961,8216,16429,6847,25743,6601,3239,3362
21925,33965,8216,16431,6847,25748,6601,3239,3362
21930,33975,8218,16434,6848,25757,6603,3240,3363
21935,33981,8218,16436,6848,25763,6605,3241,3364
21940,33992,8220,16442,6850,25770,6607,3242,3365
21945,33996,8220,16444,6850,25776,6607,3242,3365
21950,34006,8223,16449,6852,25783,6609,3244,3365
21955,34012,8223,16453,6852,25787,6611,3245,3366
21960,34023,8227,16457,6856,25795,6613,3245,3368
21965,34027,8227,16458,6856,25799,6613,3245,3368
21970,34037,8229,16461,6856,25807,6615,3246,3369
21975,34043,8231,16464,6858,25812,6617,3247,3370
21980,34054,8232,16468,6858,25820,6619,3249,3370
21985,34058,8236,16470,6862,25822,6619,3249,3370
21990,34068,8239,16476,6864,25827,6621,3251,3370
21995,34074,8242,16479,6867,25832,6623,3253,3370
22000,34085,8244,16482,6868,25840,6625,3254,3371
22005,34089,8246,16484,6870,25842,6625,3254,3371
22010,34099,8250,16489,6873,25847,6627,3255,3372
22015,34105,8253,16494,6876,25850,6629,3257,3372
22020,34116,8259,16499,6881,25855,6631,3257,3374
22025,34120,8262,16501,6884,25857,6631,3257,3374
22030,34130,8267,16505,6888,25862,6633,3257,3376
22035,34136,8269,16510,6890,25865,6635,3259,3376
22040,34147,8275,16518,6896,25870,6637,3261,3376
22045,34151,8278,16521,6899,25871,6637,3261,3376
22050,34161,8284,16526,6904,25877,6639,3262,3377
22055,34167,8284,16529,6904,25882,6641,3263,3378
22060,34178,8287,16535,6906,25890,6643,3264,3379
22065,34182,8288,16538,6907,25893,6643,3264,3379
22070,34192,8289,16543,6907,25902,6645,3266,3379
22075,34198,8291,16546,6909,25907,6647,3267,3380
22080,34209,8293,16551,6911,25915,6649,3267,3382
22085,34213,8293,16552,6911,25919,6649,3267,3382
22090,34223,8296,16560,6914,25926,6651,3268,3383
22095,34229,8298,16563,6916,25930,6653,3268,3385
22100,34240,8299,16570,6917,25938,6655,3270,3385
22105,34244,8301,16572,6919,25943,6655,3270,3385
22110,34254,8302,16577,6919,25950,6657,3272,3385
22115,34260,8304,16580,6921,25955,6659,3273,3386
22120,34271,8307,16588,6924,25963,6661,3275,3386
22125,34275,8308,16589,6925,25967,6661,3275,3386
22130,34285,8310,16594,6926,25974,6663,3276,3387
22135,34291,8311,16595,6927,25980,6665,3277,3388
22140,34302,8313,16601,6929,25988,6667,3278,3389
22145,34306,8315,16605,6931,25991,6667,3278,3389
22150,34316,8317,16606,6932,25999,6669,3278,3391
22155,34322,8317,16608,6932,26004,6671,3279,3392
22160,34333,8321,16613,6935,26011,6673,3281,3392
22165,34337,8322,16614,6936,26015,6673,3281,3392
22170,34347,8326,16623,6939,26019,6675,3283,3392
22175,34353,8328,16625,6941,26024,6677,3283,3394
22180,34364,8331,16629,6944,26032,6679,3284,3395
22185,34368,8332,16631,6945,26036,6679,3284,3395
22190,34378,8333,16635,6945,26045,6681,3285,3396
22195,34384,8333,16639,6945,26050,6683,3286,3397
22200,34395,8334,16645,6946,26060,6685,3287,3398
22205,34399,8335,16648,6947,26063,6685,3287,3398
22210,34409,8337,16650,6948,26071,6687,3287,3400
22215,34415,8337,16654,6948,26076,6689,3288,3401
22220,34426,8340,16660,6951,26085,6691,3289,3402
22225,34430,8342,16663,6953,26087,6691,3289,3402
22230,34440,8346,16670,6956,26093,6693,3290,3403
22235,34446,8346,16671,6956,26100,6695,3291,3404
22240,34457,8347,16677,6957,26109,6697,3293,3404
22245,34461,8349,16680,6959,26110,6697,3293,3404
22250,34471,8353,16684,6963,26117,6699,3293,3406
22255,34477,8353,16688,6963,26122,6701,3294,3407
22260,34488,8356,16695,6966,26131,6703,3295,3408
22265,34492,8356,16697,6966,26136,6703,3295,3408
22270,34502,8356,16701,6966,26146,6705,3297,3408
22275,34508,8356,16704,6966,26152,6707,3297,3410
22280,34519,8356,16710,6966,26161,6709,3298,3411
22285,34523,8356,16712,6966,26166,6709,3298,3411
22290,34533,8359,16716,6969,26174,6711,3298,3413
22295,34539,8359,16720,6969,26180,6713,3300,3413
22300,34550,8361,16726,6971,26187,6715,3301,3414
22305,34554,8361,16727,6971,26193,6715,3301,3414
22310,34564,8362,16731,6971,26202,6717,3302,3415
22315,34570,8362,16733,6971,26208,6719,3303,3416
22320,34581,8364,16738,6972,26216,6721,3305,3416
22325,34585,8365,16740,6973,26219,6721,3305,3416
22330,34595,8366,16745,6974,26229,6723,3306,3417
22335,34601,8366,16746,6974,26235,6725,3306,3419
22340,34612,8368,16750,6975,26243,6727,3307,3420
22345,34616,8368,16752,6975,26247,6727,3307,3420
22350,34626,8369,16758,6976,26257,6729,3308,3421
22355,34632,8369,16760,6976,26263,6731,3308,3423
22360,34643,8372,16765,6978,26270,6733,3309,3424
22365,34647,8373,16768,6979,26273,6733,3309,3424
22370,34657,8377,16775,6983,26279,6735,3311,3424
22375,34663,8379,16778,6985,26283,6737,3312,3425
22380,34674,8382,16784,6987,26290,6739,3314,3425
22385,34678,8383,16785,6988,26294,6739,3314,3425
22390,34688,8386,16789,6989,26301,6741,3316,3425
22395,34694,8387,16792,6990,26306,6743,3317,3426
22400,34705,8389,16797,6991,26312,6745,3318,3427
22405,34709,8391,16799,6993,26318,6745,3318,3427
22410,34719,8393,16803,6994,26325,6747,3320,3427
22415,34725,8395,16805,6996,26329,6749,3320,3429
22420,34736,8399,16811,6999,26335,6751,3321,3430
22425,34740,8400,16812,7000,26340,6751,3321,3430
22430,34750,8403,16816,7002,26346,6753,3322,3431
22435,34756,8405,16819,7004,26351,6755,3323,3432
22440,34767,8406,16823,7004,26359,6757,3325,3432
22445,34771,8408,16824,7006,26363,6757,3325,3432
22450,34781,8411,16830,7008,26370,6759,3327,3432
22455,34787,8412,16831,7009,26375,6761,3327,3434
22460,34798,8416,16836,7013,26381,6763,3327,3436
22465,34802,8418,16839,7015,26383,6763,3327,3436
22470,34812,8421,16843,7017,26390,6765,3328,3437
22475,34818,8423,16848,7019,26394,6767,3330,3437
22480,34829,8427,16853,7023,26402,6769,3331,3438
22485,34833,8429,16857,7025,26403,6769,3331,3438
22490,34843,8434,16863,7029,26408,6771,3332,3439
22495,34849,8435,16866,7030,26414,6773,3334,3439
22500,34860,8439,16872,7033,26421,6775,3335,3440
22505,34864,8440,16875,7034,26423,6775,3335,3440
22510,34874,8444,16878,7037,26430,6777,3335,3442
22515,34880,8444,16879,7037,26436,6779,3335,3444
22520,34891,8446,16882,7038,26444,6781,3336,3445
22525,34895,8447,16883,7039,26447,6781,3336,3445
22530,34905,8452,16888,7043,26452,6783,3337,3446
22535,34911,8454,16892,7045,26456,6785,3339,3446
22540,34922,8457,16896,7048,26464,6787,3339,3448
22545,34926,8459,16897,7050,26467,6787,3339,3448
22550,34936,8462,16904,7052,26472,6789,3340,3449
22555,34942,8465,16907,7055,26475,6791,3340,3451
22560,34953,8467,16911,7057,26485,6793,3341,3452
22565,34957,8468,16914,7058,26488,6793,3341,3452
22570,34967,8469,16918,7059,26497,6795,3342,3453
22575,34973,8470,16920,7060,26502,6797,3343,3454
22580,34984,8472,16923,7061,26510,6799,3343,3456
22585,34988,8473,16925,7062,26515,6799,3343,3456
22590,34998,8476,16931,7065,26522,6801,3344,3457
22595,35004,8477,16934,7066,26525,6803,3344,3459
22600,35015,8480,16939,7068,26533,6805,3344,3461
22605,35019,8480,16940,7068,26538,6805,3344,3461
22610,35029,8482,16946,7069,26545,6807,3345,3462
22615,35035,8484,16949,7071,26549,6809,3345,3464
22620,35046,8487,16953,7074,26559,6811,3346,3465
22625,35050,8487,16954,7074,26563,6811,3346,3465
22630,35060,8489,16958,7076,26571,6813,3347,3466
22635,35066,8489,16961,7076,26577,6815,3348,3467
22640,35077,8492,16972,7079,26582,6817,3350,3467
22645,35081,8493,16975,7080,26587,6817,3350,3467
22650,35091,8494,16978,7080,26597,6819,3351,3468
22655,35097,8495,16982,7081,26601,6821,3352,3469
22660,35108,8498,16987,7084,26610,6823,3354,3469
22665,35112,8498,16988,7084,26613,6823,3354,3469
22670,35122,8500,16991,7085,26622,6825,3354,3471
22675,35128,8500,16994,7085,26626,6827,3355,3472
22680,35139,8504,16998,7088,26634,6829,3357,3472
22685,35143,8505,17002,7089,26637,6829,3357,3472
22690,35153,8507,17006,7091,26646,6831,3357,3474
22695,35159,8507,17010,7091,26650,6833,3357,3476
22700,35170,8511,17017,7095,26657,6835,3357,3478
22705,35174,8513,17020,7097,26660,6835,3357,3478
22710,35184,8515,17024,7099,26669,6837,3358,3479
22715,35190,8515,17027,7099,26674,6839,3360,3479
22720,35201,8518,17035,7101,26680,6841,3361,3480
22725,35205,8520,17037,7103,26684,6841,3361,3480
22730,35215,8524,17040,7106,26691,6843,3361,3482
22735,35221,8524,17041,7106,26697,6845,3362,3483
22740,35232,8525,17047,7107,26706,6847,3364,3483
22745,35236,8527,17049,7109,26708,6847,3364,3483
22750,35246,8531,17054,7113,26714,6849,3365,3484
22755,35252,8531,17059,7113,26718,6851,3367,3484
22760,35263,8535,17062,7117,26727,6853,3367,3486
22765,35267,8537,17065,7119,26729,6853,3367,3486
22770,35277,8540,17069,7121,26737,6855,3368,3487
22775,35283,8540,17070,7121,26743,6857,3368,3489
22780,35294,8543,17076,7123,26749,6859,3368,3491
22785,35298,8543,17077,7123,26755,6859,3368,3491
22790,35308,8545,17081,7123,26762,6861,3369,3492
22795,35314,8545,17085,7123,26767,6863,3370,3493
22800,35325,8549,17091,7126,26775,6865,3370,3495
22805,35329,8550,17091,7127,26779,6865,3370,3495
22810,35339,8553,17096,7130,26786,6867,3370,3497
22815,35345,8553,17098,7130,26792,6869,3372,3497
22820,35356,8554,17099,7130,26801,6871,3372,3499
22825,35360,8556,17100,7132,26804,6871,3372,3499
22830,35370,8560,17109,7135,26809,6873,3374,3499
22835,35376,8560,17112,7135,26815,6875,3376,3499
22840,35387,8563,17117,7138,26824,6877,3378,3499
22845,35391,8564,17119,7139,26827,6877,3378,3499
22850,35401,8565,17125,7140,26835,6879,3379,3500
22855,35407,8567,17129,7142,26839,6881,3381,3500
22860,35418,8570,17134,7145,26848,6883,3383,3500
22865,35422,8571,17137,7146,26851,6883,3383,3500
22870,35432,8572,17141,7147,26860,6885,3385,3500
22875,35438,8573,17144,7148,26864,6887,3385,3502
22880,35449,8576,17148,7150,26872,6889,3385,3504
22885,35453,8577,17148,7151,26876,6889,3385,3504
22890,35463,8580,17153,7153,26883,6891,3386,3505
22895,35469,8581,17156,7154,26888,6893,3387,3506
22900,35480,8584,17164,7157,26894,6895,3388,3507
22905,35484,8586,17166,7159,26897,6895,3388,3507
22910,35494,8588,17169,7160,26905,6897,3388,3509
22915,35500,8590,17174,7162,26908,6899,3389,3510
22920,35511,8594,17182,7166,26914,6901,3390,3511
22925,35515,8595,17184,7167,26919,6901,3390,3511
22930,35525,8597,17187,7168,26928,6903,3391,3512
22935,35531,8597,17190,7168,26933,6905,3391,3514
22940,35542,8599,17195,7170,26943,6907,3393,3514
22945,35546,8599,17197,7170,26945,6907,3393,3514
22950,35556,8605,17202,7175,26951,6909,3395,3514
22955,35562,8605,17205,7175,26955,6911,3395,3516
22960,35573,8609,17211,7179,26961,6913,3396,3517
22965,35577,8612,17211,7182,26965,6913,3396,3517
22970,35587,8616,17217,7185,26971,6915,3397,3518
22975,35593,8616,17221,7185,26975,6917,3397,3520
22980,35604,8622,17227,7190,26981,6919,3398,3521
22985,35608,8623,17229,7191,26985,6919,3398,3521
22990,35618,8626,17235,7194,26992,6921,3399,3522
22995,35624,8626,17238,7194,26997,6923,3400,3523
23000,35635,8628,17240,7195,27007,6925,3401,3524
23005,35639,8628,17243,7195,27010,6925,3401,3524
23010,35649,8631,17247,7196,27018,6927,3402,3525
23015,35655,8631,17249,7196,27024,6929,3402,3527
23020,35666,8634,17256,7198,27030,6931,3404,3527
23025,35670,8634,17257,7198,27036,6931,3404,3527
23030,35680,8637,17262,7200,27043,6933,3406,3527
23035,35686,8637,17263,7200,27049,6935,3406,3529
23040,35697,8639,17270,7202,27054,6937,3407,3530
23045,35701,8641,17270,7204,27060,6937,3407,3530
23050,35711,8644,17274,7205,27066,6939,3407,3532
23055,35717,8646,17277,7207,27071,6941,3408,3533
23060,35728,8647,17282,7208,27078,6943,3408,3535
23065,35732,8650,17284,7211,27081,6943,3408,3535
23070,35742,8653,17290,7213,27087,6945,3408,3537
23075,35748,8655,17295,7215,27091,6947,3410,3537
23080,35759,8658,17301,7218,27099,6949,3412,3537
23085,35763,8659,17302,7219,27104,6949,3412,3537
23090,35773,8662,17305,7221,27110,6951,3412,3539
23095,35779,8664,17310,7223,27112,6953,3413,3540
23100,35790,8670,17317,7229,27118,6955,3415,3540
23105,35794,8673,17320,7232,27119,6955,3415,3540
23110,35804,8678,17326,7236,27125,6957,3417,3540
23115,35810,8679,17326,7237,27131,6959,3417,3542
23120,35821,8681,17330,7238,27138,6961,3417,3544
23125,35825,8682,17331,7239,27143,6961,3417,3544
23130,35835,8684,17338,7241,27149,6963,3418,3545
23135,35841,8686,17341,7243,27154,6965,3419,3546
23140,35852,8688,17346,7244,27163,6967,3420,3547
23145,35856,8688,17347,7244,27168,6967,3420,3547
23150,35866,8689,17353,7245,27177,6969,3422,3547
23155,35872,8689,17358,7245,27182,6971,3424,3547
23160,35883,8691,17363,7246,27192,6973,3425,3548
23165,35887,8691,17366,7246,27196,6973,3425,3548
23170,35897,8693,17372,7248,27203,6975,3425,3550
23175,35903,8693,17376,7248,27209,6977,3426,3551
23180,35914,8695,17380,7249,27218,6979,3426,3553
23185,35918,8696,17381,7250,27222,6979,3426,3553
23190,35928,8696,17384,7250,27232,6981,3427,3554
23195,35934,8696,17388,7250,27237,6983,3428,3555
23200,35945,8697,17395,7250,27247,6985,3430,3555
23205,35949,8697,17396,7250,27252,6985,3430,3555
23210,35959,8698,17403,7251,27260,6987,3431,3556
23215,35965,8698,17407,7251,27266,6989,3433,3556
23220,35976,8702,17413,7255,27273,6991,3433,3558
23225,35980,8705,17416,7258,27274,6991,3433,3558
23230,35990,8709,17421,7261,27281,6993,3434,3559
23235,35996,8709,17424,7261,27286,6995,3435,3560
23240,36007,8712,17430,7264,27295,6997,3436,3561
23245,36011,8713,17433,7265,27296,6997,3436,3561
23250,36021,8718,17436,7269,27303,6999,3437,3562
23255,36027,8718,17439,7269,27308,7001,3437,3564
23260,36038,8719,17444,7270,27317,7003,3438,3565
23265,36042,8721,17446,7272,27320,7003,3438,3565
23270,36052,8725,17451,7275,27327,7005,3438,3567
23275,36058,8725,17455,7275,27332,7007,3439,3568
23280,36069,8725,17460,7275,27343,7009,3440,3569
23285,36073,8725,17464,7275,27347,7009,3440,3569
23290,36083,8726,17469,7276,27357,7011,3440,3571
23295,36089,8726,17473,7276,27362,7013,3442,3571
23300,36100,8727,17479,7277,27372,7015,3443,3572
23305,36104,8727,17480,7277,27377,7015,3443,3572
23310,36114,8728,17488,7278,27386,7017,3445,3572
23315,36120,8728,17491,7278,27392,7019,3445,3574
23320,36131,8729,17496,7279,27402,7021,3446,3575
23325,36135,8729,17499,7279,27405,7021,3446,3575
23330,36145,8732,17505,7281,27412,7023,3448,3575
23335,36151,8733,17508,7282,27417,7025,3449,3576
23340,36162,8737,17514,7286,27424,7027,3449,3578
23345,36166,8739,17515,7288,27427,7027,3449,3578
23350,36176,8741,17517,7289,27434,7029,3449,3580
23355,36182,8742,17517,7290,27440,7031,3449,3582
23360,36193,8744,17523,7292,27447,7033,3449,3584
23365,36197,8746,17526,7294,27451,7033,3449,3584
23370,36207,8748,17530,7295,27457,7035,3450,3585
23375,36213,8751,17534,7298,27462,7037,3452,3585
23380,36224,8754,17541,7301,27467,7039,3453,3586
23385,36228,8755,17543,7302,27472,7039,3453,3586
23390,36238,8758,17548,7303,27479,7041,3454,3587
23395,36244,8760,17552,7305,27483,7043,3456,3587
23400,36255,8764,17557,7308,27490,7045,3458,3587
23405,36259,8765,17558,7309,27494,7045,3458,3587
23410,36269,8769,17566,7313,27499,7047,3460,3587
23415,36275,8770,17569,7314,27504,7049,3461,3588
23420,36286,8776,17577,7320,27510,7051,3462,3589
23425,36290,8777,17580,7321,27512,7051,3462,3589
23430,36300,8781,17583,7323,27518,7053,3463,3590
23435,36306,8783,17588,7325,27521,7055,3464,3591
23440,36317,8786,17590,7328,27530,7057,3464,3593
23445,36321,8788,17592,7330,27532,7057,3464,3593
23450,36331,8794,17597,7334,27535,7059,3464,3595
23455,36337,8797,17600,7337,27539,7061,3465,3596
23460,36348,8799,17602,7338,27549,7063,3466,3597
23465,36352,8801,17605,7340,27551,7063,3466,3597
23470,36362,8804,17609,7341,27556,7065,3467,3598
23475,36368,8806,17612,7343,27560,7067,3467,3600
23480,36379,8810,17618,7347,27569,7069,3469,3600
23485,36383,8812,17621,7349,27571,7069,3469,3600
23490,36393,8815,17628,7351,27576,7071,3471,3600
23495,36399,8817,17629,7353,27581,7073,3471,3602
23500,36410,8821,17634,7356,27589,7075,3472,3603
23505,36414,8822,17636,7357,27592,7075,3472,3603
23510,36424,8825,17642,7360,27598,7077,3474,3603
23515,36430,8825,17646,7360,27603,7079,3475,3604
23520,36441,8829,17650,7363,27611,7081,3476,3605
23525,36445,8830,17651,7364,27614,7081,3476,3605
23530,36455,8832,17653,7366,27623,7083,3476,3607
23535,36461,8832,17654,7366,27628,7085,3476,3609
23540,36472,8833,17660,7367,27638,7087,3477,3610
23545,36476,8833,17662,7367,27643,7087,3477,3610
23550,36486,8834,17666,7368,27652,7089,3478,3611
23555,36492,8834,17669,7368,27657,7091,3479,3612
23560,36503,8836,17674,7370,27667,7093,3480,3613
23565,36507,8837,17677,7371,27669,7093,3480,3613
23570,36517,8838,17682,7372,27678,7095,3480,3615
23575,36523,8838,17686,7372,27684,7097,3482,3615
23580,36534,8839,17691,7372,27693,7099,3484,3615
23585,36538,8839,17693,7372,27699,7099,3484,3615
23590,36548,8839,17696,7372,27709,7101,3484,3617
23595,36554,8839,17699,7372,27715,7103,3485,3618
23600,36565,8839,17704,7372,27725,7105,3486,3619
23605,36569,8839,17704,7372,27730,7105,3486,3619
23610,36579,8840,17709,7373,27739,7107,3486,3621
23615,36585,8840,17711,7373,27744,7109,3487,3622
23620,36596,8840,17717,7373,27754,7111,3487,3624
23625,36600,8840,17720,7373,27759,7111,3487,3624
23630,36610,8841,17724,7374,27769,7113,3488,3625
23635,36616,8841,17727,7374,27774,7115,3490,3625
23640,36627,8843,17730,7376,27782,7117,3490,3627
23645,36631,8845,17731,7378,27786,7117,3490,3627
23650,36641,8847,17733,7379,27794,7119,3490,3629
23655,36647,8847,17737,7379,27799,7121,3492,3629
23660,36658,8850,17743,7382,27807,7123,3492,3631
23665,36662,8852,17745,7384,27809,7123,3492,3631
23670,36672,8856,17748,7387,27816,7125,3492,3633
23675,36678,8856,17751,7387,27822,7127,3494,3633
23680,36689,8858,17758,7389,27828,7129,3495,3634
23685,36693,8861,17759,7392,27831,7129,3495,3634
23690,36703,8868,17765,7398,27834,7131,3495,3636
23695,36709,8870,17768,7400,27839,7133,3496,3637
23700,36720,8872,17771,7401,27847,7135,3496,3639
23705,36724,8872,17772,7401,27851,7135,3496,3639
23710,36734,8874,17777,7403,27859,7137,3496,3641
23715,36740,8876,17779,7405,27864,7139,3497,3642
23720,36751,8879,17786,7408,27870,7141,3498,3643
23725,36755,8879,17788,7408,27876,7141,3498,3643
23730,36765,8881,17792,7409,27883,7143,3498,3645
23735,36771,8882,17795,7410,27888,7145,3499,3646
23740,36782,8885,17799,7412,27897,7147,3500,3647
23745,36786,8886,17803,7413,27900,7147,3500,3647
23750,36796,8887,17810,7414,27908,7149,3502,3647
23755,36802,8889,17814,7416,27912,7151,3502,3649
23760,36813,8892,17817,7418,27921,7153,3503,3650
23765,36817,8893,17820,7419,27924,7153,3503,3650
23770,36827,8894,17824,7420,27932,7155,3504,3651
23775,36833,8895,17826,7421,27937,7157,3504,3653
23780,36844,8898,17829,7423,27946,7159,3505,3654
23785,36848,8898,17831,7423,27950,7159,3505,3654
23790,36858,8900,17837,7425,27956,7161,3505,3656
23795,36864,8903,17839,7428,27961,7163,3506,3657
23800,36875,8906,17844,7430,27968,7165,3508,3657
23805,36879,8906,17845,7430,27973,7165,3508,3657
23810,36889,8910,17849,7433,27979,7167,3508,3659
23815,36895,8910,17853,7433,27983,7169,3509,3660
23820,36906,8916,17859,7438,27988,7171,3510,3661
23825,36910,8918,17860,7440,27991,7171,3510,3661
23830,36920,8922,17866,7444,27996,7173,3511,3662
23835,36926,8924,17869,7446,27999,7175,3511,3664
23840,36937,8928,17871,7449,28007,7177,3511,3666
23845,36941,8930,17871,7451,28011,7177,3511,3666
23850,36951,8935,17876,7456,28016,7179,3511,3668
23855,36957,8935,17879,7456,28021,7181,3513,3668
23860,36968,8940,17885,7461,28028,7183,3515,3668
23865,36972,8941,17887,7462,28030,7183,3515,3668
23870,36982,8944,17890,7465,28038,7185,3516,3669
23875,36988,8944,17892,7465,28043,7187,3517,3670
23880,36999,8948,17897,7469,28050,7189,3518,3671
23885,37003,8950,17898,7471,28053,7189,3518,3671
23890,37013,8954,17905,7474,28057,7191,3519,3672
23895,37019,8957,17907,7477,28061,7193,3519,3674
23900,37030,8959,17914,7479,28070,7195,3521,3674
23905,37034,8960,17918,7480,28073,7195,3521,3674
23910,37044,8961,17920,7480,28083,7197,3522,3675
23915,37050,8961,17923,7480,28087,7199,3522,3677
23920,37061,8964,17930,7482,28095,7201,3524,3677
23925,37065,8966,17933,7484,28099,7201,3524,3677
23930,37075,8968,17940,7486,28106,7203,3526,3677
23935,37081,8969,17942,7487,28111,7205,3527,3678
23940,37092,8972,17947,7489,28119,7207,3529,3678
23945,37096,8972,17949,7489,28124,7207,3529,3678
23950,37106,8974,17954,7491,28130,7209,3529,3680
23955,37112,8976,17955,7493,28136,7211,3530,3681
23960,37123,8978,17962,7495,28144,7213,3531,3682
23965,37127,8979,17962,7496,28148,7213,3531,3682
23970,37137,8981,17966,7498,28155,7215,3531,3684
23975,37143,8983,17969,7500,28160,7217,3532,3685
23980,37154,8984,17976,7500,28170,7219,3534,3685
23985,37158,8984,17977,7500,28174,7219,3534,3685
23990,37168,8986,17980,7502,28182,7221,3534,3687
23995,37174,8986,17982,7502,28187,7223,3535,3688
24000,37185,8987,17986,7503,28197,7225,3537,3688
24005,37189,8989,17988,7505,28200,7225,3537,3688
24010,37199,8990,17991,7506,28209,7227,3537,3690
24015,37205,8990,17993,7506,28214,7229,3538,3691
24020,37216,8991,17996,7506,28224,7231,3538,3693
24025,37220,8992,17996,7507,28228,7231,3538,3693
24030,37230,8994,18001,7509,28236,7233,3540,3693
24035,37236,8994,18005,7509,28241,7235,3542,3693
24040,37247,8997,18011,7512,28249,7237,3542,3695
24045,37251,8998,18012,7513,28252,7237,3542,3695
24050,37261,9001,18016,7515,28260,7239,3544,3695
24055,37267,9001,18020,7515,28264,7241,3545,3696
24060,37278,9006,18025,7519,28271,7243,3546,3697
24065,37282,9008,18028,7521,28272,7243,3546,3697
24070,37292,9013,18033,7526,28279,7245,3547,3698
24075,37298,9013,18037,7526,28284,7247,3549,3698
24080,37309,9017,18045,7530,28289,7249,3551,3698
24085,37313,9020,18047,7533,28291,7249,3551,3698
24090,37323,9027,18053,7539,28295,7251,3552,3699
24095,37329,9028,18055,7540,28300,7253,3553,3700
24100,37340,9032,18061,7543,28306,7255,3555,3700
24105,37344,9035,18065,7546,28308,7255,3555,3700
24110,37354,9037,18071,7548,28316,7257,3557,3700
24115,37360,9038,18074,7549,28321,7259,3558,3701
24120,37371,9040,18081,7551,28330,7261,3560,3701
24125,37375,9041,18084,7552,28333,7261,3560,3701
24130,37385,9042,18091,7553,28342,7263,3561,3702
24135,37391,9042,18091,7553,28349,7265,3561,3704
24140,37402,9042,18099,7553,28358,7267,3563,3704
24145,37406,9042,18101,7553,28363,7267,3563,3704
24150,37416,9043,18106,7553,28372,7269,3563,3706
24155,37422,9043,18107,7553,28378,7271,3563,3708
24160,37433,9043,18114,7553,28389,7273,3564,3709
24165,37437,9043,18116,7553,28394,7273,3564,3709
24170,37447,9044,18120,7553,28403,7275,3565,3710
24175,37453,9044,18124,7553,28408,7277,3566,3711
24180,37464,9044,18129,7553,28419,7279,3567,3712
24185,37468,9044,18129,7553,28424,7279,3567,3712
24190,37478,9045,18133,7553,28432,7281,3568,3713
24195,37484,9045,18135,7553,28438,7283,3568,3715
24200,37495,9045,18137,7553,28450,7285,3569,3716
24205,37499,9045,18138,7553,28454,7285,3569,3716
24210,37509,9047,18140,7555,28462,7287,3569,3718
24215,37515,9047,18142,7555,28468,7289,3569,3720
24220,37526,9048,18147,7556,28477,7291,3570,3721
24225,37530,9048,18148,7556,28481,7291,3570,3721
24230,37540,9051,18154,7557,28487,7293,3572,3721
24235,37546,9054,18158,7560,28490,7295,3573,3722
24240,37557,9059,18165,7565,28497,7297,3575,3722
24245,37561,9062,18169,7568,28497,7297,3575,3722
24250,37571,9066,18172,7571,28505,7299,3576,3723
24255,37577,9066,18175,7571,28509,7301,3577,3724
24260,37588,9073,18182,7578,28514,7303,3578,3725
24265,37592,9076,18186,7581,28514,7303,3578,3725
24270,37602,9082,18190,7585,28520,7305,3579,3726
24275,37608,9082,18193,7585,28525,7307,3580,3727
24280,37619,9085,18197,7588,28533,7309,3580,3729
24285,37623,9088,18199,7591,28535,7309,3580,3729
24290,37633,9091,18203,7592,28542,7311,3581,3730
24295,37639,9091,18206,7592,28548,7313,3583,3730
24300,37650,9092,18209,7593,28557,7315,3584,3731
24305,37654,9092,18212,7593,28561,7315,3584,3731
24310,37664,9094,18219,7595,28570,7317,3585,3732
24315,37670,9094,18220,7595,28576,7319,3586,3733
24320,37681,9096,18227,7597,28585,7321,3587,3734
24325,37685,9096,18228,7597,28589,7321,3587,3734
24330,37695,9098,18233,7598,28597,7323,3587,3736
24335,37701,9098,18236,7598,28603,7325,3588,3737
24340,37712,9099,18239,7598,28612,7327,3590,3737
24345,37716,9100,18240,7599,28616,7327,3590,3737
24350,37726,9103,18247,7602,28621,7329,3591,3738
24355,37732,9105,18250,7604,28627,7331,3592,3739
24360,37743,9108,18257,7606,28635,7333,3594,3739
24365,37747,9109,18258,7607,28638,7333,3594,3739
24370,37757,9112,18264,7609,28644,7335,3595,3740
24375,37763,9113,18265,7610,28650,7337,3596,3741
24380,37774,9114,18272,7611,28659,7339,3598,3741
24385,37778,9115,18276,7612,28663,7339,3598,3741
24390,37788,9116,18280,7612,28671,7341,3599,3742
24395,37794,9118,18284,7614,28675,7343,3600,3743
24400,37805,9121,18288,7616,28681,7345,3600,3745
24405,37809,9124,18290,7619,28685,7345,3600,3745
24410,37819,9127,18293,7620,28691,7347,3600,3747
24415,37825,9128,18296,7621,28695,7349,3601,3748
24420,37836,9133,18304,7626,28700,7351,3603,3748
24425,37840,9137,18305,7630,28703,7351,3603,3748
24430,37850,9140,18310,7633,28708,7353,3603,3750
24435,37856,9142,18313,7635,28712,7355,3603,3752
24440,37867,9146,18316,7638,28720,7357,3603,3754
24445,37871,9148,18318,7640,28722,7357,3603,3754
24450,37881,9153,18324,7645,28727,7359,3604,3755
24455,37887,9154,18327,7646,28732,7361,3605,3756
24460,37898,9157,18331,7648,28739,7363,3605,3758
24465,37902,9160,18333,7651,28741,7363,3605,3758
24470,37912,9165,18338,7654,28745,7365,3605,3760
24475,37918,9168,18342,7657,28749,7367,3607,3760
24480,37929,9172,18348,7660,28756,7369,3609,3760
24485,37933,9173,18349,7661,28760,7369,3609,3760
24490,37943,9177,18354,7664,28766,7371,3610,3761
24495,37949,9177,18356,7664,28772,7373,3611,3762
24500,37960,9180,18361,7666,28779,7375,3612,3763
24505,37964,9182,18363,7668,28782,7375,3612,3763
24510,37974,9185,18368,7670,28789,7377,3613,3764
24515,37980,9185,18371,7670,28794,7379,3614,3765
24520,37991,9187,18378,7671,28802,7381,3616,3765
24525,37995,9189,18378,7673,28806,7381,3616,3765
24530,38005,9192,18384,7675,28812,7383,3618,3765
24535,38011,9193,18386,7676,28818,7385,3619,3766
24540,38022,9196,18392,7679,28825,7387,3620,3767
24545,38026,9196,18396,7679,28829,7387,3620,3767
24550,38036,9198,18403,7681,28836,7389,3621,3768
24555,38042,9201,18407,7684,28839,7391,3622,3769
24560,38053,9204,18411,7687,28848,7393,3622,3771
24565,38057,9204,18415,7687,28852,7393,3622,3771
24570,38067,9206,18419,7687,28860,7395,3623,3772
24575,38073,9207,18420,7688,28865,7397,3623,3774
24580,38084,9210,18429,7691,28872,7399,3625,3774
24585,38088,9211,18432,7692,28877,7399,3625,3774
24590,38098,9214,18436,7693,28882,7401,3625,3776
24595,38104,9216,18438,7695,28886,7403,3625,3778
24600,38115,9220,18446,7699,28892,7405,3626,3779
24605,38119,9222,18447,7701,28897,7405,3626,3779
24610,38129,9222,18453,7701,28907,7407,3627,3780
24615,38135,9222,18455,7701,28912,7409,3627,3782
24620,38146,9222,18460,7701,28922,7411,3627,3784
24625,38150,9222,18462,7701,28928,7411,3627,3784
24630,38160,9222,18466,7701,28938,7413,3629,3784
24635,38166,9222,18472,7701,28943,7415,3631,3784
24640,38177,9222,18477,7701,28954,7417,3632,3785
24645,38181,9222,18477,7701,28959,7417,3632,3785
24650,38191,9223,18482,7702,28968,7419,3633,3786
24655,38197,9223,18484,7702,28974,7421,3634,3787
24660,38208,9224,18489,7702,28984,7423,3636,3787
24665,38212,9224,18490,7702,28988,7423,3636,3787
24670,38222,9225,18494,7703,28997,7425,3636,3789
24675,38228,9225,18497,7703,29003,7427,3637,3790
24680,38239,9227,18503,7705,29011,7429,3639,3790
24685,38243,9228,18506,7706,29014,7429,3639,3790
24690,38253,9228,18510,7706,29025,7431,3639,3792
24695,38259,9228,18514,7706,29031,7433,3641,3792
24700,38270,9229,18518,7707,29041,7435,3643,3792
24705,38274,9229,18520,7707,29044,7435,3643,3792
24710,38284,9233,18526,7710,29050,7437,3643,3794
24715,38290,9235,18528,7712,29055,7439,3644,3795
24720,38301,9237,18533,7713,29060,7441,3644,3797
24725,38305,9239,18533,7715,29066,7441,3644,3797
24730,38315,9243,18539,7717,29071,7443,3645,3798
24735,38321,9244,18542,7718,29075,7445,3645,3800
24740,38332,9249,18547,7723,29081,7447,3645,3802
24745,38336,9250,18548,7724,29086,7447,3645,3802
24750,38346,9253,18554,7726,29092,7449,3646,3803
24755,38352,9255,18557,7728,29096,7451,3647,3804
24760,38363,9259,18561,7731,29104,7453,3649,3804
24765,38367,9260,18563,7732,29107,7453,3649,3804
24770,38377,9262,18568,7733,29115,7455,3651,3804
24775,38383,9263,18572,7734,29119,7457,3653,3804
24780,38394,9266,18577,7736,29126,7459,3655,3804
24785,38398,9268,18578,7738,29129,7459,3655,3804
24790,38408,9272,18583,7742,29135,7461,3656,3805
24795,38414,9274,18585,7744,29140,7463,3657,3806
24800,38425,9277,18591,7747,29145,7465,3657,3808
24805,38429,9281,18592,7751,29148,7465,3657,3808
24810,38439,9285,18597,7754,29153,7467,3658,3809
24815,38445,9287,18601,7756,29156,7469,3659,3810
24820,38456,9294,18608,7763,29161,7471,3660,3811
24825,38460,9295,18608,7764,29165,7471,3660,3811
24830,38470,9298,18611,7765,29170,7473,3660,3813
24835,38476,9300,18612,7767,29176,7475,3661,3814
24840,38487,9302,18614,7768,29184,7477,3661,3816
24845,38491,9303,18614,7769,29188,7477,3661,3816
24850,38501,9308,18621,7773,29192,7479,3663,3816
24855,38507,9310,18623,7775,29196,7481,3663,3818
24860,38518,9315,18629,7779,29201,7483,3663,3820
24865,38522,9319,18631,7783,29203,7483,3663,3820
24870,38532,9322,18636,7786,29209,7485,3664,3821
24875,38538,9322,18638,7786,29215,7487,3665,3822
24880,38549,9324,18642,7788,29225,7489,3666,3823
24885,38553,9324,18645,7788,29228,7489,3666,3823
24890,38563,9325,18650,7789,29237,7491,3667,3824
24895,38569,9325,18653,7789,29244,7493,3668,3825
24900,38580,9326,18658,7790,29254,7495,3669,3826
24905,38584,9326,18659,7790,29258,7495,3669,3826
24910,38594,9328,18664,7792,29266,7497,3669,3828
24915,38600,9328,18668,7792,29271,7499,3671,3828
24920,38611,9329,18671,7793,29281,7501,3671,3830
24925,38615,9330,18673,7794,29285,7501,3671,3830
24930,38625,9332,18680,7796,29293,7503,3673,3830
24935,38631,9332,18682,7796,29299,7505,3673,3832
24940,38642,9334,18687,7797,29307,7507,3674,3833
24945,38646,9334,18687,7797,29312,7507,3674,3833
24950,38656,9336,18693,7799,29319,7509,3675,3834
24955,38662,9336,18697,7799,29325,7511,3677,3834
24960,38673,9338,18700,7800,29334,7513,3677,3836
24965,38677,9338,18703,7800,29339,7513,3677,3836
24970,38687,9339,18705,7800,29348,7515,3678,3837
24975,38693,9339,18707,7800,29352,7517,3678,3839
24980,38704,9341,18711,7802,29363,7519,3679,3840
24985,38708,9342,18712,7803,29366,7519,3679,3840
24990,38718,9344,18717,7804,29374,7521,3680,3841
24995,38724,9344,18722,7804,29379,7523,3682,3841
25000,38735,9345,18730,7805,29388,7525,3683,3842
25005,38739,9346,18732,7806,29392,7525,3683,3842
25010,38749,9349,18738,7808,29399,7527,3684,3843
25015,38755,9351,18741,7810,29403,7529,3684,3845
25020,38766,9355,18749,7814,29410,7531,3686,3845
25025,38770,9357,18751,7816,29412,7531,3686,3845
25030,38780,9360,18756,7817,29419,7533,3688,3845
25035,38786,9361,18758,7818,29423,7535,3688,3847
25040,38797,9363,18760,7820,29433,7537,3688,3849
25045,38801,9364,18762,7821,29437,7537,3688,3849
25050,38811,9366,18766,7822,29445,7539,3689,3850
25055,38817,9367,18770,7823,29449,7541,3690,3851
25060,38828,9369,18774,7825,29457,7543,3691,3852
25065,38832,9371,18777,7827,29460,7543,3691,3852
25070,38842,9376,18783,7831,29465,7545,3693,3852
25075,38848,9377,18786,7832,29468,7547,3693,3854
25080,38859,9383,18794,7838,29473,7549,3695,3854
25085,38863,9387,18796,7842,29475,7549,3695,3854
25090,38873,9392,18804,7846,29481,7551,3696,3855
25095,38879,9392,18807,7846,29487,7553,3697,3856
25100,38890,9394,18813,7848,29496,7555,3698,3857
25105,38894,9394,18816,7848,29499,7555,3698,3857
25110,38904,9397,18822,7850,29507,7557,3699,3858
25115,38910,9397,18822,7850,29513,7559,3699,3860
25120,38921,9398,18827,7850,29522,7561,3700,3861
25125,38925,9399,18828,7851,29526,7561,3700,3861
25130,38935,9402,18834,7853,29533,7563,3702,3861
25135,38941,9402,18837,7853,29539,7565,3703,3862
25140,38952,9405,18845,7855,29545,7567,3704,3863
25145,38956,9405,18846,7855,29551,7567,3704,3863
25150,38966,9408,18851,7857,29558,7569,3704,3865
25155,38972,9408,18855,7857,29564,7571,3706,3865
25160,38983,9409,18859,7858,29574,7573,3706,3867
25165,38987,9410,18861,7859,29577,7573,3706,3867
25170,38997,9413,18868,7862,29584,7575,3708,3867
25175,39003,9413,18870,7862,29590,7577,3708,3869
25180,39014,9414,18872,7863,29600,7579,3708,3871
25185,39018,9415,18875,7864,29603,7579,3708,3871
25190,39028,9418,18881,7866,29608,7581,3709,3872
25195,39034,9420,18886,7868,29612,7583,3711,3872
25200,39045,9426,18895,7874,29617,7585,3713,3872
25205,39049,9429,18896,7877,29620,7585,3713,3872
25210,39059,9432,18900,7879,29626,7587,3714,3873
25215,39065,9434,18902,7881,29631,7589,3715,3874
25220,39076,9436,18908,7883,29639,7591,3716,3875
25225,39080,9438,18911,7885,29641,7591,3716,3875
25230,39090,9442,18915,7887,29647,7593,3718,3875
25235,39096,9444,18919,7889,29651,7595,3719,3876
25240,39107,9446,18923,7891,29660,7597,3720,3877
25245,39111,9447,18924,7892,29663,7597,3720,3877
25250,39121,9453,18929,7896,29667,7599,3721,3878
25255,39127,9454,18931,7897,29672,7601,3722,3879
25260,39138,9458,18938,7901,29677,7603,3723,3880
25265,39142,9461,18940,7904,29680,7603,3723,3880
25270,39152,9465,18942,7906,29687,7605,3723,3882
25275,39158,9466,18947,7907,29690,7607,3725,3882
25280,39169,9470,18953,7911,29697,7609,3727,3882
25285,39173,9472,18955,7913,29700,7609,3727,3882
25290,39183,9475,18961,7914,29706,7611,3729,3882
25295,39189,9477,18964,7916,29711,7613,3730,3883
25300,39200,9477,18971,7916,29720,7615,3731,3884
25305,39204,9478,18973,7917,29726,7615,3731,3884
25310,39214,9479,18979,7918,29733,7617,3731,3886
25315,39220,9481,18983,7920,29738,7619,3733,3886
25320,39231,9483,18988,7922,29746,7621,3733,3888
25325,39235,9483,18990,7922,29751,7621,3733,3888
25330,39245,9483,18994,7922,29761,7623,3733,3890
25335,39251,9483,18996,7922,29768,7625,3734,3891
25340,39262,9483,19000,7922,29778,7627,3736,3891
25345,39266,9483,19000,7922,29783,7627,3736,3891
25350,39276,9483,19007,7922,29792,7629,3738,3891
25355,39282,9483,19009,7922,29798,7631,3739,3892
25360,39293,9483,19015,7922,29809,7633,3740,3893
25365,39297,9483,19018,7922,29814,7633,3740,3893
25370,39307,9483,19023,7922,29823,7635,3740,3895
25375,39313,9483,19026,7922,29829,7637,3741,3896
25380,39324,9485,19033,7924,29838,7639,3742,3897
25385,39328,9486,19036,7925,29842,7639,3742,3897
25390,39338,9487,19042,7926,29851,7641,3743,3898
25395,39344,9487,19046,7926,29857,7643,3744,3899
25400,39355,9489,19054,7928,29865,7645,3745,3900
25405,39359,9491,19058,7930,29868,7645,3745,3900
25410,39369,9494,19063,7933,29875,7647,3745,3902
25415,39375,9494,19066,7933,29880,7649,3746,3903
25420,39386,9498,19070,7936,29888,7651,3747,3904
25425,39390,9499,19072,7937,29890,7651,3747,3904
25430,39400,9504,19075,7940,29896,7653,3747,3906
25435,39406,9504,19079,7940,29901,7655,3748,3907
25440,39417,9508,19083,7943,29909,7657,3749,3908
25445,39421,9509,19085,7944,29911,7657,3749,3908
25450,39431,9513,19090,7946,29918,7659,3750,3909
25455,39437,9513,19092,7946,29924,7661,3751,3910
25460,39448,9517,19096,7950,29931,7663,3751,3912
25465,39452,9519,19098,7952,29933,7663,3751,3912
25470,39462,9522,19102,7954,29940,7665,3751,3914
25475,39468,9522,19108,7954,29945,7667,3753,3914
25480,39479,9526,19113,7958,29953,7669,3754,3915
25485,39483,9526,19114,7958,29956,7669,3754,3915
25490,39493,9531,19120,7962,29961,7671,3755,3916
25495,39499,9533,19125,7964,29964,7673,3757,3916
25500,39510,9539,19133,7970,29968,7675,3758,3917
25505,39514,9542,19134,7973,29971,7675,3758,3917
25510,39524,9547,19139,7977,29977,7677,3759,3918
25515,39530,9548,19144,7978,29980,7679,3760,3919
25520,39541,9552,19150,7982,29988,7681,3761,3920
25525,39545,9552,19152,7982,29992,7681,3761,3920
25530,39555,9553,19158,7983,30001,7683,3762,3921
25535,39561,9555,19162,7985,30006,7685,3764,3921
25540,39572,9557,19165,7987,30015,7687,3765,3922
25545,39576,9558,19167,7988,30017,7687,3765,3922
25550,39586,9559,19170,7989,30027,7689,3766,3923
25555,39592,9560,19172,7990,30032,7691,3767,3924
25560,39603,9561,19177,7991,30041,7693,3769,3924
25565,39607,9562,19179,7992,30045,7693,3769,3924
25570,39617,9565,19186,7995,30050,7695,3770,3925
25575,39623,9568,19191,7998,30054,7697,3772,3925
25580,39634,9570,19194,8000,30062,7699,3772,3927
25585,39638,9571,19196,8001,30067,7699,3772,3927
25590,39648,9574,19203,8003,30073,7701,3773,3928
25595,39654,9575,19206,8004,30078,7703,3774,3929
25600,39665,9578,19213,8006,30084,7705,3774,3931
25605,39669,9580,19215,8008,30088,7705,3774,3931
25610,39679,9582,19217,8009,30097,7707,3774,3933
25615,39685,9582,19221,8009,30101,7709,3775,3934
25620,39696,9587,19227,8013,30108,7711,3777,3934
25625,39700,9587,19229,8013,30112,7711,3777,3934
25630,39710,9589,19235,8015,30119,7713,3779,3934
25635,39716,9591,19237,8017,30124,7715,3780,3935
25640,39727,9594,19243,8020,30131,7717,3781,3936
25645,39731,9595,19246,8021,30136,7717,3781,3936
25650,39741,9597,19252,8022,30143,7719,3783,3936
25655,39747,9598,19255,8023,30148,7721,3784,3937
25660,39758,9599,19259,8024,30156,7723,3785,3938
25665,39762,9601,19260,8026,30161,7723,3785,3938
25670,39772,9603,19263,8027,30169,7725,3785,3940
25675,39778,9603,19265,8027,30175,7727,3786,3941
25680,39789,9603,19267,8027,30186,7729,3786,3943
25685,39793,9604,19268,8028,30189,7729,3786,3943
25690,39803,9606,19275,8029,30195,7731,3787,3944
25695,39809,9609,19277,8032,30199,7733,3787,3946
25700,39820,9611,19286,8034,30205,7735,3789,3946
25705,39824,9613,19287,8036,30211,7735,3789,3946
25710,39834,9615,19295,8037,30217,7737,3790,3947
25715,39840,9617,19297,8039,30223,7739,3791,3948
25720,39851,9617,19300,8039,30234,7741,3791,3950
25725,39855,9617,19302,8039,30237,7741,3791,3950
25730,39865,9621,19307,8042,30244,7743,3791,3952
25735,39871,9621,19307,8042,30250,7745,3791,3954
25740,39882,9623,19311,8044,30258,7747,3791,3956
25745,39886,9625,19314,8046,30260,7747,3791,3956
25750,39896,9628,19320,8048,30267,7749,3792,3957
25755,39902,9628,19325,8048,30273,7751,3794,3957
25760,39913,9630,19327,8049,30283,7753,3795,3958
25765,39917,9631,19329,8050,30285,7753,3795,3958
25770,39927,9634,19332,8052,30293,7755,3795,3960
25775,39933,9634,19335,8052,30297,7757,3796,3961
25780,39944,9638,19338,8055,30306,7759,3796,3963
25785,39948,9640,19340,8057,30308,7759,3796,3963
25790,39958,9642,19343,8058,30316,7761,3797,3964
25795,39964,9642,19346,8058,30322,7763,3797,3966
25800,39975,9644,19350,8059,30330,7765,3798,3967
25805,39979,9646,19352,8061,30333,7765,3798,3967
25810,39989,9647,19354,8062,30342,7767,3799,3968
25815,39995,9647,19357,8062,30346,7769,3800,3969
25820,40006,9652,19361,8066,30352,7771,3800,3971
25825,40010,9655,19363,8069,30354,7771,3800,3971
25830,40020,9660,19368,8072,30360,7773,3801,3972
25835,40026,9660,19369,8072,30366,7775,3801,3974
25840,40037,9661,19375,8073,30374,7777,3802,3975
25845,40041,9662,19378,8074,30379,7777,3802,3975
25850,40051,9664,19385,8076,30387,7779,3804,3975
25855,40057,9664,19391,8076,30392,7781,3806,3975
25860,40068,9666,19399,8078,30400,7783,3806,3977
25865,40072,9666,19402,8078,30405,7783,3806,3977
25870,40082,9667,19406,8079,30415,7785,3806,3979
25875,40088,9667,19407,8079,30420,7787,3806,3981
25880,40099,9668,19409,8079,30429,7789,3806,3983
25885,40103,9668,19411,8079,30434,7789,3806,3983
25890,40113,9670,19415,8080,30442,7791,3807,3984
25895,40119,9671,19418,8081,30447,7793,3808,3985
25900,40130,9674,19425,8083,30453,7795,3810,3985
25905,40134,9676,19428,8085,30458,7795,3810,3985
25910,40144,9678,19433,8086,30465,7797,3811,3986
25915,40150,9680,19435,8088,30470,7799,3811,3988
25920,40161,9682,19441,8090,30477,7801,3812,3989
25925,40165,9683,19442,8091,30482,7801,3812,3989
25930,40175,9685,19446,8092,30488,7803,3812,3991
25935,40181,9687,19449,8094,30492,7805,3812,3993
25940,40192,9692,19456,8099,30497,7807,3813,3994
25945,40196,9694,19456,8101,30502,7807,3813,3994
25950,40206,9697,19459,8104,30509,7809,3813,3996
25955,40212,9697,19462,8104,30513,7811,3814,3997
25960,40223,9701,19464,8107,30521,7813,3814,3999
25965,40227,9702,19467,8108,30525,7813,3814,3999
25970,40237,9705,19470,8109,30532,7815,3815,4000
25975,40243,9706,19474,8110,30536,7817,3816,4001
25980,40254,9709,19481,8113,30543,7819,3818,4001
25985,40258,9710,19482,8114,30548,7819,3818,4001
25990,40268,9714,19487,8116,30553,7821,3820,4001
25995,40274,9715,19490,8117,30556,7823,3820,4003
26000,40285,9720,19494,8121,30564,7825,3822,4003
26005,40289,9722,19496,8123,30566,7825,3822,4003
26010,40299,9726,19499,8126,30572,7827,3822,4005
26015,40305,9728,19504,8128,30575,7829,3824,4005
26020,40316,9733,19511,8133,30581,7831,3826,4005
26025,40320,9736,19512,8136,30584,7831,3826,4005
26030,40330,9739,19517,8138,30589,7833,3827,4006
26035,40336,9741,19519,8140,30593,7835,3827,4008
26040,40347,9746,19524,8144,30600,7837,3829,4008
26045,40351,9749,19528,8147,30600,7837,3829,4008
26050,40361,9754,19535,8152,30605,7839,3831,4008
26055,40367,9756,19537,8154,30609,7841,3831,4010
26060,40378,9758,19538,8155,30620,7843,3831,4012
26065,40382,9758,19538,8155,30624,7843,3831,4012
26070,40392,9761,19544,8158,30631,7845,3832,4013
26075,40398,9761,19547,8158,30637,7847,3834,4013
26080,40409,9765,19553,8161,30643,7849,3834,4015
26085,40413,9766,19554,8162,30646,7849,3834,4015
26090,40423,9769,19557,8164,30654,7851,3835,4016
26095,40429,9769,19560,8164,30659,7853,3837,4016
26100,40440,9772,19563,8166,30668,7855,3837,4018
26105,40444,9773,19564,8167,30671,7855,3837,4018
26110,40454,9773,19570,8167,30681,7857,3838,4019
26115,40460,9773,19573,8167,30686,7859,3839,4020
26120,40471,9775,19582,8169,30694,7861,3841,4020
26125,40475,9776,19583,8170,30699,7861,3841,4020
26130,40485,9776,19587,8170,30709,7863,3842,4021
26135,40491,9776,19592,8170,30715,7865,3844,4021
26140,40502,9776,19598,8170,30725,7867,3845,4022
26145,40506,9776,19598,8170,30730,7867,3845,4022
26150,40516,9776,19603,8170,30740,7869,3846,4023
26155,40522,9776,19605,8170,30746,7871,3847,4024
26160,40533,9776,19609,8170,30756,7873,3847,4026
26165,40537,9776,19610,8170,30761,7873,3847,4026
26170,40547,9777,19611,8170,30770,7875,3847,4028
26175,40553,9777,19615,8170,30775,7877,3849,4028
26180,40564,9778,19619,8171,30784,7879,3849,4030
26185,40568,9779,19621,8172,30789,7879,3849,4030
26190,40578,9780,19628,8173,30796,7881,3850,4031
26195,40584,9783,19631,8176,30800,7883,3851,4032
26200,40595,9784,19635,8177,30809,7885,3852,4033
26205,40599,9787,19637,8180,30811,7885,3852,4033
26210,40609,9791,19642,8183,30817,7887,3852,4035
26215,40615,9793,19644,8185,30821,7889,3852,4037
26220,40626,9797,19650,8189,30828,7891,3853,4038
26225,40630,9798,19653,8190,30832,7891,3853,4038
26230,40640,9800,19655,8190,30839,7893,3853,4040
26235,40646,9801,19657,8191,30845,7895,3854,4041
26240,40657,9804,19664,8194,30850,7897,3855,4042
26245,40661,9806,19664,8196,30855,7897,3855,4042
26250,40671,9808,19667,8196,30862,7899,3857,4042
26255,40677,9810,19669,8198,30867,7901,3857,4044
26260,40688,9812,19672,8199,30875,7903,3858,4045
26265,40692,9812,19675,8199,30879,7903,3858,4045
26270,40702,9815,19679,8200,30885,7905,3859,4046
26275,40708,9817,19681,8202,30891,7907,3860,4047
26280,40719,9818,19683,8202,30900,7909,3861,4048
26285,40723,9819,19686,8203,30904,7909,3861,4048
26290,40733,9822,19691,8204,30910,7911,3863,4048
26295,40739,9823,19693,8205,30915,7913,3863,4050
26300,40750,9828,19699,8210,30920,7915,3863,4052
26305,40754,9829,19700,8211,30925,7915,3863,4052
26310,40764,9831,19705,8213,30932,7917,3863,4054
26315,40770,9832,19708,8214,30936,7919,3863,4056
26320,40781,9837,19714,8219,30943,7921,3864,4057
26325,40785,9839,19716,8221,30945,7921,3864,4057
26330,40795,9844,19725,8225,30949,7923,3866,4057
26335,40801,9846,19727,8227,30955,7925,3867,4058
26340,40812,9848,19730,8228,30963,7927,3867,4060
26345,40816,9849,19732,8229,30966,7927,3867,4060
26350,40826,9852,19736,8231,30973,7929,3868,4061
26355,40832,9852,19737,8231,30980,7931,3869,4062
26360,40843,9854,19742,8233,30987,7933,3870,4063
26365,40847,9857,19746,8236,30989,7933,3870,4063
26370,40857,9861,19752,8239,30995,7935,3871,4064
26375,40863,9861,19757,8239,31000,7937,3873,4064
26380,40874,9863,19761,8240,31009,7939,3875,4064
26385,40878,9866,19763,8243,31011,7939,3875,4064
26390,40888,9870,19768,8247,31017,7941,3876,4065
26395,40894,9870,19772,8247,31022,7943,3877,4066
26400,40905,9873,19776,8249,31031,7945,3878,4067
26405,40909,9873,19778,8249,31036,7945,3878,4067
26410,40919,9874,19784,8250,31045,7947,3879,4068
26415,40925,9874,19788,8250,31049,7949,3880,4069
26420,40936,9875,19792,8250,31060,7951,3880,4071
26425,40940,9876,19796,8251,31063,7951,3880,4071
26430,40950,9877,19802,8252,31072,7953,3881,4072
26435,40956,9877,19804,8252,31078,7955,3881,4074
26440,40967,9879,19807,8253,31087,7957,3881,4076
26445,40971,9879,19808,8253,31092,7957,3881,4076
26450,40981,9881,19812,8254,31100,7959,3882,4077
26455,40987,9881,19815,8254,31105,7961,3883,4078
26460,40998,9885,19822,8258,31110,7963,3883,4080
26465,41002,9886,19824,8259,31116,7963,3883,4080
26470,41012,9888,19829,8260,31124,7965,3884,4081
26475,41018,9888,19831,8260,31130,7967,3885,4082
26480,41029,9891,19839,8262,31138,7969,3886,4083
26485,41033,9892,19842,8263,31141,7969,3886,4083
26490,41043,9894,19849,8265,31149,7971,3887,4084
26495,41049,9894,19852,8265,31155,7973,3888,4085
26500,41060,9896,19859,8267,31164,7975,3889,4086
26505,41064,9897,19863,8268,31167,7975,3889,4086
26510,41074,9900,19867,8270,31174,7977,3890,4087
26515,41080,9900,19870,8270,31179,7979,3891,4088
26520,41091,9904,19877,8274,31186,7981,3892,4089
26525,41095,9906,19880,8276,31189,7981,3892,4089
26530,41105,9908,19883,8277,31197,7983,3892,4091
26535,41111,9908,19886,8277,31203,7985,3893,4092
26540,41122,9912,19894,8281,31210,7987,3894,4093
26545,41126,9913,19897,8282,31213,7987,3894,4093
26550,41136,9917,19902,8285,31219,7989,3895,4094
26555,41142,9917,19905,8285,31225,7991,3895,4096
26560,41153,9921,19911,8289,31231,7993,3896,4097
26565,41157,9922,19912,8290,31235,7993,3896,4097
26570,41167,9927,19918,8294,31238,7995,3896,4099
26575,41173,9930,19923,8297,31240,7997,3897,4100
26580,41184,9937,19932,8304,31244,7999,3899,4100
26585,41188,9941,19935,8308,31245,7999,3899,4100
26590,41198,9948,19943,8315,31248,8001,3900,4101
26595,41204,9951,19944,8318,31253,8003,3900,4103
26600,41215,9953,19948,8320,31261,8005,3901,4104
26605,41219,9956,19951,8323,31262,8005,3901,4104
26610,41229,9960,19956,8326,31268,8007,3902,4105
26615,41235,9962,19960,8328,31272,8009,3904,4105
26620,41246,9964,19963,8330,31281,8011,3904,4107
26625,41250,9965,19964,8331,31285,8011,3904,4107
26630,41260,9966,19970,8332,31292,8013,3905,4108
26635,41266,9968,19973,8334,31298,8015,3907,4108
26640,41277,9970,19979,8335,31305,8017,3908,4109
26645,41281,9971,19980,8336,31310,8017,3908,4109
26650,41291,9974,19987,8339,31315,8019,3909,4110
26655,41297,9977,19989,8342,31320,8021,3910,4111
26660,41308,9977,19993,8342,31329,8023,3911,4112
26665,41312,9978,19995,8343,31333,8023,3911,4112
26670,41322,9979,19998,8343,31343,8025,3911,4114
26675,41328,9980,20000,8344,31348,8027,3911,4116
26680,41339,9981,20009,8345,31356,8029,3912,4117
26685,41343,9981,20011,8345,31361,8029,3912,4117
26690,41353,9982,20015,8345,31371,8031,3914,4117
26695,41359,9983,20018,8346,31376,8033,3916,4117
26700,41370,9984,20024,8347,31384,8035,3916,4119
26705,41374,9984,20026,8347,31390,8035,3916,4119
26710,41384,9984,20032,8347,31399,8037,3917,4120
26715,41390,9984,20033,8347,31406,8039,3917,4122
26720,41401,9985,20036,8348,31416,8041,3918,4123
26725,41405,9985,20037,8348,31420,8041,3918,4123
26730,41415,9986,20040,8349,31429,8043,3919,4124
26735,41421,9986,20045,8349,31433,8045,3920,4125
26740,41432,9987,20048,8350,31445,8047,3921,4126
26745,41436,9987,20050,8350,31449,8047,3921,4126
26750,41446,9988,20052,8350,31458,8049,3921,4128
26755,41452,9988,20056,8350,31463,8051,3923,4128
26760,41463,9990,20058,8351,31473,8053,3924,4129
26765,41467,9990,20058,8351,31477,8053,3924,4129
26770,41477,9993,20061,8353,31484,8055,3924,4131
26775,41483,9993,20064,8353,31489,8057,3925,4132
26780,41494,9996,20067,8356,31497,8059,3925,4134
26785,41498,9999,20070,8359,31499,8059,3925,4134
26790,41508,10002,20076,8361,31505,8061,3927,4134
26795,41514,10002,20078,8361,31512,8063,3927,4136
26800,41525,10005,20084,8363,31517,8065,3927,4138
26805,41529,10008,20086,8366,31520,8065,3927,4138
26810,41539,10014,20091,8370,31524,8067,3928,4139
26815,41545,10015,20094,8371,31528,8069,3929,4140
26820,41556,10018,20099,8374,31535,8071,3930,4141
26825,41560,10022,20102,8378,31536,8071,3930,4141
26830,41570,10028,20107,8384,31542,8073,3931,4142
26835,41576,10028,20109,8384,31547,8075,3932,4143
26840,41587,10032,20116,8388,31552,8077,3933,4144
26845,41591,10037,20120,8393,31553,8077,3933,4144
26850,41601,10039,20127,8395,31561,8079,3935,4144
26855,41607,10041,20131,8397,31565,8081,3936,4145
26860,41618,10044,20137,8400,31573,8083,3937,4146
26865,41622,10045,20139,8401,31577,8083,3937,4146
26870,41632,10046,20144,8402,31586,8085,3938,4147
26875,41638,10046,20146,8402,31591,8087,3938,4149
26880,41649,10047,20151,8403,31602,8089,3938,4151
26885,41653,10048,20153,8404,31605,8089,3938,4151
26890,41663,10051,20158,8407,31611,8091,3939,4152
26895,41669,10051,20160,8407,31617,8093,3939,4154
26900,41680,10052,20167,8407,31628,8095,3940,4155
26905,41684,10052,20169,8407,31632,8095,3940,4155
26910,41694,10054,20173,8408,31640,8097,3941,4156
26915,41700,10054,20176,8408,31645,8099,3942,4157
26920,41711,10056,20184,8410,31655,8101,3943,4158
26925,41715,10057,20186,8411,31658,8101,3943,4158
26930,41725,10059,20191,8412,31665,8103,3945,4158
26935,41731,10059,20195,8412,31672,8105,3947,4158
26940,41742,10061,20202,8414,31681,8107,3949,4158
26945,41746,10062,20204,8415,31684,8107,3949,4158
26950,41756,10064,20209,8417,31692,8109,3950,4159
26955,41762,10064,20213,8417,31696,8111,3951,4160
26960,41773,10067,20218,8419,31704,8113,3952,4161
26965,41777,10069,20219,8421,31707,8113,3952,4161
26970,41787,10073,20223,8425,31713,8115,3952,4163
26975,41793,10074,20226,8426,31718,8117,3954,4163
26980,41804,10076,20228,8427,31726,8119,3954,4165
26985,41808,10077,20232,8428,31730,8119,3954,4165
26990,41818,10079,20236,8429,31737,8121,3954,4167
26995,41824,10081,20238,8431,31741,8123,3954,4169
27000,41835,10085,20243,8434,31748,8125,3955,4170
27005,41839,10087,20246,8436,31751,8125,3955,4170
27010,41849,10089,20250,8436,31760,8127,3957,4170
27015,41855,10089,20253,8436,31766,8129,3959,4170
27020,41866,10092,20259,8439,31773,8131,3961,4170
27025,41870,10092,20261,8439,31777,8131,3961,4170
27030,41880,10094,20265,8440,31786,8133,3962,4171
27035,41886,10094,20267,8440,31791,8135,3963,4172
27040,41897,10098,20274,8444,31797,8137,3964,4173
27045,41901,10099,20275,8445,31802,8137,3964,4173
27050,41911,10102,20280,8447,31809,8139,3964,4175
27055,41917,10102,20283,8447,31814,8141,3965,4176
27060,41928,10106,20289,8451,31820,8143,3965,4178
27065,41932,10107,20290,8452,31825,8143,3965,4178
27070,41942,10110,20295,8453,31832,8145,3967,4178
27075,41948,10110,20297,8453,31837,8147,3968,4179
27080,41959,10114,20301,8457,31844,8149,3968,4181
27085,41963,10115,20302,8458,31847,8149,3968,4181
27090,41973,10118,20306,8460,31855,8151,3970,4181
27095,41979,10118,20309,8460,31860,8153,3971,4182
27100,41990,10122,20316,8464,31865,8155,3971,4184
27105,41994,10126,20317,8468,31868,8155,3971,4184
27110,42004,10131,20323,8472,31872,8157,3972,4185
27115,42010,10132,20327,8473,31876,8159,3974,4185
27120,42021,10136,20330,8476,31884,8161,3975,4186
27125,42025,10138,20332,8478,31887,8161,3975,4186
27130,42035,10139,20336,8479,31896,8163,3976,4187
27135,42041,10139,20338,8479,31901,8165,3976,4189
27140,42052,10141,20343,8481,31909,8167,3976,4191
27145,42056,10142,20344,8482,31914,8167,3976,4191
27150,42066,10143,20351,8483,31922,8169,3978,4191
27155,42072,10144,20354,8484,31927,8171,3980,4191
27160,42083,10145,20358,8485,31938,8173,3981,4192
27165,42087,10145,20359,8485,31942,8173,3981,4192
27170,42097,10146,20364,8486,31951,8175,3982,4193
27175,42103,10146,20366,8486,31956,8177,3982,4195
27180,42114,10147,20372,8487,31965,8179,3982,4197
27185,42118,10147,20374,8487,31971,8179,3982,4197
27190,42128,10148,20377,8487,31980,8181,3983,4198
27195,42134,10149,20381,8488,31984,8183,3984,4199
27200,42145,10151,20387,8490,31993,8185,3986,4199
27205,42149,10151,20388,8490,31998,8185,3986,4199
27210,42159,10152,20393,8490,32005,8187,3987,4200
27215,42165,10154,20396,8492,32010,8189,3988,4201
27220,42176,10156,20402,8494,32018,8191,3989,4202
27225,42180,10156,20406,8494,32022,8191,3989,4202
27230,42190,10163,20413,8501,32026,8193,3990,4203
27235,42196,10165,20415,8503,32031,8195,3991,4204
27240,42207,10167,20420,8505,32038,8197,3992,4205
27245,42211,10171,20424,8509,32038,8197,3992,4205
27250,42221,10178,20430,8515,32043,8199,3994,4205
27255,42227,10178,20432,8515,32049,8201,3996,4205
27260,42238,10182,20440,8519,32053,8203,3997,4206
27265,42242,10186,20443,8523,32055,8203,3997,4206
27270,42252,10190,20447,8525,32061,8205,3999,4206
27275,42258,10191,20450,8526,32066,8207,4000,4207
27280,42269,10194,20452,8528,32075,8209,4000,4209
27285,42273,10196,20455,8530,32076,8209,4000,4209
27290,42283,10200,20461,8533,32083,8211,4002,4209
27295,42289,10200,20464,8533,32089,8213,4003,4210
27300,42300,10203,20470,8536,32097,8215,4004,4211
27305,42304,10203,20471,8536,32101,8215,4004,4211
27310,42314,10204,20475,8536,32108,8217,4005,4212
27315,42320,10206,20478,8538,32113,8219,4006,4213
27320,42331,10210,20484,8541,32120,8221,4006,4215
27325,42335,10212,20486,8543,32123,8221,4006,4215
27330,42345,10214,20493,8544,32129,8223,4007,4216
27335,42351,10217,20494,8547,32134,8225,4007,4218
27340,42362,10218,20499,8548,32143,8227,4008,4219
27345,42366,10219,20501,8549,32147,8227,4008,4219
27350,42376,10221,20505,8551,32155,8229,4009,4220
27355,42382,10221,20508,8551,32160,8231,4010,4221
27360,42393,10224,20512,8553,32169,8233,4010,4223
27365,42397,10224,20513,8553,32172,8233,4010,4223
27370,42407,10225,20519,8554,32180,8235,4011,4224
27375,42413,10228,20522,8557,32185,8237,4012,4225
27380,42424,10229,20527,8557,32193,8239,4012,4227
27385,42428,10230,20527,8558,32198,8239,4012,4227
27390,42438,10232,20531,8559,32205,8241,4012,4229
27395,42444,10233,20534,8560,32208,8243,4012,4231
27400,42455,10241,20543,8567,32211,8245,4014,4231
27405,42459,10244,20544,8570,32214,8245,4014,4231
27410,42469,10248,20550,8573,32220,8247,4016,4231
27415,42475,10248,20552,8573,32226,8249,4017,4232
27420,42486,10249,20556,8574,32236,8251,4018,4233
27425,42490,10249,20557,8574,32241,8251,4018,4233
27430,42500,10251,20562,8575,32248,8253,4019,4234
27435,42506,10251,20565,8575,32255,8255,4021,4234
27440,42517,10252,20570,8576,32264,8257,4023,4234
27445,42521,10254,20572,8578,32267,8257,4023,4234
27450,42531,10256,20579,8580,32275,8259,4025,4234
27455,42537,10256,20583,8580,32280,8261,4026,4235
27460,42548,10258,20589,8582,32288,8263,4027,4236
27465,42552,10259,20591,8583,32292,8263,4027,4236
27470,42562,10261,20594,8585,32301,8265,4028,4237
27475,42568,10261,20598,8585,32306,8267,4029,4238
27480,42579,10265,20605,8588,32311,8269,4030,4239
27485,42583,10267,20608,8590,32315,8269,4030,4239
27490,42593,10268,20614,8591,32325,8271,4031,4240
27495,42599,10268,20618,8591,32330,8273,4032,4241
27500,42610,10271,20620,8594,32339,8275,4032,4243
27505,42614,10271,20621,8594,32342,8275,4032,4243
27510,42624,10273,20623,8594,32351,8277,4034,4243
27515,42630,10273,20625,8594,32356,8279,4035,4244
27520,42641,10276,20632,8596,32362,8281,4037,4244
27525,42645,10281,20635,8601,32363,8281,4037,4244
27530,42655,10285,20639,8604,32370,8283,4038,4245
27535,42661,10285,20643,8604,32373,8285,4039,4246
27540,42672,10290,20649,8609,32380,8287,4041,4246
27545,42676,10291,20651,8610,32385,8287,4041,4246
27550,42686,10293,20653,8611,32393,8289,4042,4247
27555,42692,10293,20656,8611,32397,8291,4043,4248
27560,42703,10296,20659,8613,32406,8293,4044,4249
27565,42707,10296,20662,8613,32410,8293,4044,4249
27570,42717,10298,20668,8614,32417,8295,4046,4249
27575,42723,10300,20669,8616,32422,8297,4046,4251
27580,42734,10303,20676,8618,32429,8299,4047,4252
27585,42738,10305,20679,8620,32432,8299,4047,4252
27590,42748,10308,20685,8622,32439,8301,4048,4253
27595,42754,10309,20687,8623,32445,8303,4050,4253
27600,42765,10310,20691,8623,32454,8305,4052,4253
27605,42769,10311,20693,8624,32458,8305,4052,4253
27610,42779,10313,20698,8626,32465,8307,4054,4253
27615,42785,10314,20700,8627,32471,8309,4055,4254
27620,42796,10316,20707,8629,32478,8311,4057,4254
27625,42800,10316,20708,8629,32484,8311,4057,4254
27630,42810,10318,20712,8630,32492,8313,4058,4255
27635,42816,10319,20717,8631,32496,8315,4060,4255
27640,42827,10321,20723,8633,32504,8317,4061,4256
27645,42831,10322,20725,8634,32508,8317,4061,4256
27650,42841,10326,20729,8636,32515,8319,4062,4257
27655,42847,10326,20733,8636,32520,8321,4064,4257
27660,42858,10331,20741,8641,32525,8323,4065,4258
27665,42862,10333,20742,8643,32529,8323,4065,4258
27670,42872,10336,20750,8646,32534,8325,4067,4258
27675,42878,10338,20752,8648,32539,8327,4068,4259
27680,42889,10342,20757,8652,32545,8329,4068,4261
27685,42893,10343,20757,8653,32550,8329,4068,4261
27690,42903,10346,20760,8654,32556,8331,4069,4262
27695,42909,10347,20762,8655,32562,8333,4071,4262
27700,42920,10349,20767,8656,32568,8335,4072,4263
27705,42924,10351,20768,8658,32573,8335,4072,4263
27710,42934,10355,20774,8661,32578,8337,4073,4264
27715,42940,10356,20776,8662,32584,8339,4074,4265
27720,42951,10359,20782,8665,32591,8341,4075,4266
27725,42955,10360,20784,8666,32595,8341,4075,4266
27730,42965,10364,20790,8669,32601,8343,4076,4267
27735,42971,10364,20792,8669,32606,8345,4077,4268
27740,42982,10365,20794,8670,32616,8347,4077,4270
27745,42986,10366,20794,8671,32620,8347,4077,4270
27750,42996,10369,20797,8673,32627,8349,4078,4271
27755,43002,10370,20800,8674,32631,8351,4079,4272
27760,43013,10371,20805,8675,32640,8353,4081,4272
27765,43017,10373,20807,8677,32643,8353,4081,4272
27770,43027,10377,20814,8680,32648,8355,4082,4273
27775,43033,10379,20817,8682,32652,8357,4083,4274
27780,43044,10382,20823,8685,32659,8359,4084,4275
27785,43048,10386,20824,8689,32662,8359,4084,4275
27790,43058,10388,20827,8689,32670,8361,4086,4275
27795,43064,10388,20829,8689,32675,8363,4086,4277
27800,43075,10389,20833,8690,32684,8365,4086,4279
27805,43079,10392,20836,8693,32685,8365,4086,4279
27810,43089,10396,20841,8697,32692,8367,4087,4280
27815,43095,10396,20845,8697,32698,8369,4089,4280
27820,43106,10397,20848,8698,32707,8371,4090,4281
27825,43110,10399,20851,8700,32711,8371,4090,4281
27830,43120,10400,20853,8700,32720,8373,4091,4282
27835,43126,10400,20854,8700,32725,8375,4091,4284
27840,43137,10401,20858,8700,32735,8377,4091,4286
27845,43141,10401,20860,8700,32740,8377,4091,4286
27850,43151,10403,20864,8701,32747,8379,4092,4287
27855,43157,10403,20867,8701,32754,8381,4092,4289
27860,43168,10404,20869,8702,32764,8383,4093,4290
27865,43172,10405,20872,8703,32767,8383,4093,4290
27870,43182,10407,20879,8705,32774,8385,4094,4291
27875,43188,10407,20881,8705,32781,8387,4094,4293
27880,43199,10408,20887,8706,32789,8389,4095,4294
27885,43203,10408,20889,8706,32795,8389,4095,4294
27890,43213,10410,20894,8707,32801,8391,4096,4295
27895,43219,10413,20898,8710,32805,8393,4097,4296
27900,43230,10415,20900,8712,32815,8395,4097,4298
27905,43234,10415,20901,8712,32819,8395,4097,4298
27910,43244,10416,20903,8712,32828,8397,4099,4298
27915,43250,10416,20905,8712,32834,8399,4100,4299
27920,43261,10418,20911,8713,32840,8401,4101,4300
27925,43265,10420,20913,8715,32845,8401,4101,4300
27930,43275,10422,20919,8717,32852,8403,4102,4301
27935,43281,10424,20924,8719,32855,8405,4103,4302
27940,43292,10429,20928,8723,32862,8407,4104,4303
27945,43296,10430,20930,8724,32865,8407,4104,4303
27950,43306,10436,20938,8729,32868,8409,4106,4303
27955,43312,10439,20939,8732,32873,8411,4106,4305
27960,43323,10443,20945,8735,32879,8413,4108,4305
27965,43327,10445,20946,8737,32882,8413,4108,4305
27970,43337,10449,20951,8741,32887,8415,4108,4307
27975,43343,10450,20955,8742,32891,8417,4110,4307
27980,43354,10454,20960,8745,32898,8419,4112,4307
27985,43358,10456,20961,8747,32901,8419,4112,4307
27990,43368,10459,20964,8748,32909,8421,4113,4308
27995,43374,10460,20966,8749,32914,8423,4113,4310
28000,43385,10462,20972,8750,32921,8425,4115,4310
28005,43389,10463,20972,8751,32926,8425,4115,4310
28010,43399,10465,20975,8752,32933,8427,4115,4312
28015,43405,10466,20976,8753,32938,8429,4115,4314
28020,43416,10470,20982,8756,32944,8431,4117,4314
28025,43420,10472,20983,8758,32948,8431,4117,4314
28030,43430,10475,20989,8760,32953,8433,4118,4315
28035,43436,10477,20995,8762,32957,8435,4120,4315
28040,43447,10479,21000,8763,32966,8437,4122,4315
28045,43451,10480,21002,8764,32970,8437,4122,4315
28050,43461,10482,21007,8765,32979,8439,4123,4316
28055,43467,10482,21009,8765,32985,8441,4124,4317
28060,43478,10484,21014,8767,32994,8443,4125,4318
28065,43482,10484,21015,8767,32998,8443,4125,4318
28070,43492,10485,21018,8768,33007,8445,4125,4320
28075,43498,10485,21020,8768,33013,8447,4126,4321
28080,43509,10487,21028,8770,33020,8449,4128,4321
28085,43513,10488,21030,8771,33025,8449,4128,4321
28090,43523,10492,21037,8774,33031,8451,4129,4322
28095,43529,10492,21041,8774,33036,8453,4131,4322
28100,43540,10495,21045,8776,33044,8455,4132,4323
28105,43544,10496,21047,8777,33047,8455,4132,4323
28110,43554,10499,21051,8780,33055,8457,4133,4324
28115,43560,10499,21055,8780,33060,8459,4133,4326
28120,43571,10504,21062,8784,33067,8461,4134,4327
28125,43575,10505,21065,8785,33070,8461,4134,4327
28130,43585,10505,21070,8785,33080,8463,4135,4328
28135,43591,10505,21071,8785,33086,8465,4136,4329
28140,43602,10506,21074,8786,33096,8467,4136,4331
28145,43606,10507,21077,8787,33099,8467,4136,4331
28150,43616,10509,21082,8788,33105,8469,4136,4333
28155,43622,10512,21086,8791,33110,8471,4138,4333
28160,43633,10515,21094,8793,33117,8473,4139,4334
28165,43637,10517,21096,8795,33120,8473,4139,4334
28170,43647,10519,21102,8797,33127,8475,4140,4335
28175,43653,10521,21106,8799,33131,8477,4141,4336
28180,43664,10525,21113,8803,33139,8479,4142,4337
28185,43668,10525,21115,8803,33143,8479,4142,4337
28190,43678,10526,21119,8804,33150,8481,4142,4339
28195,43684,10528,21121,8806,33155,8483,4142,4341
28200,43695,10530,21129,8808,33163,8485,4144,4341
28205,43699,10531,21130,8809,33168,8485,4144,4341
28210,43709,10534,21135,8811,33174,8487,4144,4343
28215,43715,10535,21136,8812,33179,8489,4144,4345
28220,43726,10536,21140,8812,33187,8491,4144,4347
28225,43730,10540,21141,8816,33190,8491,4144,4347
28230,43740,10545,21145,8820,33195,8493,4144,4349
28235,43746,10545,21149,8820,33200,8495,4146,4349
28240,43757,10548,21154,8822,33208,8497,4147,4350
28245,43761,10550,21157,8824,33209,8497,4147,4350
28250,43771,10556,21161,8829,33215,8499,4148,4351
28255,43777,10556,21165,8829,33219,8501,4150,4351
28260,43788,10560,21169,8832,33226,8503,4151,4352
28265,43792,10562,21172,8834,33229,8503,4151,4352
28270,43802,10565,21178,8836,33237,8505,4152,4353
28275,43808,10565,21181,8836,33242,8507,4153,4354
28280,43819,10567,21188,8838,33250,8509,4154,4355
28285,43823,10568,21191,8839,33254,8509,4154,4355
28290,43833,10571,21195,8840,33261,8511,4154,4357
28295,43839,10571,21197,8840,33268,8513,4156,4357
28300,43850,10574,21203,8842,33275,8515,4158,4357
28305,43854,10575,21205,8843,33279,8515,4158,4357
28310,43864,10578,21208,8844,33286,8517,4159,4358
28315,43870,10578,21209,8844,33292,8519,4159,4360
28320,43881,10581,21216,8846,33298,8521,4160,4361
28325,43885,10582,21217,8847,33303,8521,4160,4361
28330,43895,10584,21223,8848,33310,8523,4162,4361
28335,43901,10586,21225,8850,33314,8525,4162,4363
28340,43912,10587,21227,8851,33324,8527,4163,4364
28345,43916,10588,21228,8852,33328,8527,4163,4364
28350,43926,10590,21231,8852,33335,8529,4163,4366
28355,43932,10591,21232,8853,33340,8531,4163,4368
28360,43943,10593,21235,8855,33349,8533,4163,4370
28365,43947,10595,21236,8857,33352,8533,4163,4370
28370,43957,10597,21241,8859,33360,8535,4165,4370
28375,43963,10597,21244,8859,33365,8537,4166,4371
28380,43974,10598,21249,8860,33373,8539,4167,4372
28385,43978,10600,21250,8862,33378,8539,4167,4372
28390,43988,10602,21257,8863,33384,8541,4168,4373
28395,43994,10604,21260,8865,33388,8543,4169,4374
28400,44005,10607,21266,8868,33396,8545,4170,4375
28405,44009,10609,21267,8870,33399,8545,4170,4375
28410,44019,10613,21271,8872,33404,8547,4170,4377
28415,44025,10616,21274,8875,33408,8549,4171,4378
28420,44036,10617,21280,8876,33418,8551,4172,4379
28425,44040,10618,21282,8877,33421,8551,4172,4379
28430,44050,10621,21287,8879,33429,8553,4173,4380
28435,44056,10621,21290,8879,33435,8555,4175,4380
28440,44067,10623,21294,8880,33443,8557,4176,4381
28445,44071,10623,21297,8880,33448,8557,4176,4381
28450,44081,10625,21301,8881,33456,8559,4177,4382
28455,44087,10625,21303,8881,33462,8561,4179,4382
28460,44098,10627,21307,8883,33471,8563,4179,4384
28465,44102,10628,21311,8884,33474,8563,4179,4384
28470,44112,10630,21316,8886,33482,8565,4180,4385
28475,44118,10630,21320,8886,33488,8567,4181,4386
28480,44129,10633,21325,8888,33496,8569,4182,4387
28485,44133,10633,21327,8888,33500,8569,4182,4387
28490,44143,10636,21333,8890,33507,8571,4183,4388
28495,44149,10636,21337,8890,33513,8573,4185,4388
28500,44160,10638,21343,8891,33522,8575,4186,4389
28505,44164,10639,21347,8892,33525,8575,4186,4389
28510,44174,10640,21353,8892,33534,8577,4188,4389
28515,44180,10640,21355,8892,33540,8579,4190,4389
28520,44191,10643,21362,8895,33547,8581,4191,4390
28525,44195,10645,21364,8897,33549,8581,4191,4390
28530,44205,10650,21370,8902,33555,8583,4192,4391
28535,44211,10651,21374,8903,33559,8585,4193,4392
28540,44222,10654,21379,8906,33566,8587,4194,4393
28545,44226,10657,21381,8909,33569,8587,4194,4393
28550,44236,10661,21383,8911,33575,8589,4194,4395
28555,44242,10662,21386,8912,33579,8591,4195,4396
28560,44253,10665,21390,8914,33587,8593,4197,4396
28565,44257,10668,21394,8917,33587,8593,4197,4396
28570,44267,10673,21400,8921,33592,8595,4199,4396
28575,44273,10675,21402,8923,33597,8597,4200,4397
28580,44284,10681,21409,8928,33600,8599,4200,4399
28585,44288,10686,21413,8933,33600,8599,4200,4399
28590,44298,10690,21414,8935,33608,8601,4200,4401
28595,44304,10690,21418,8935,33613,8603,4202,4401
28600,44315,10694,21421,8938,33621,8605,4202,4403
28605,44319,10694,21424,8938,33624,8605,4202,4403
28610,44329,10695,21429,8939,33633,8607,4203,4404
28615,44335,10695,21431,8939,33640,8609,4204,4405
28620,44346,10697,21436,8940,33647,8611,4205,4406
28625,44350,10697,21439,8940,33652,8611,4205,4406
28630,44360,10698,21444,8941,33662,8613,4207,4406
28635,44366,10698,21448,8941,33667,8615,4207,4408
28640,44377,10699,21455,8942,33676,8617,4208,4409
28645,44381,10700,21458,8943,33680,8617,4208,4409
28650,44391,10701,21465,8944,33689,8619,4210,4409
28655,44397,10701,21470,8944,33695,8621,4212,4409
28660,44408,10702,21477,8945,33705,8623,4213,4410
28665,44412,10702,21478,8945,33710,8623,4213,4410
28670,44422,10704,21484,8947,33717,8625,4214,4411
28675,44428,10704,21486,8947,33724,8627,4216,4411
28680,44439,10706,21490,8949,33732,8629,4216,4413
28685,44443,10707,21493,8950,33736,8629,4216,4413
28690,44453,10709,21500,8952,33743,8631,4217,4414
28695,44459,10709,21503,8952,33750,8633,4218,4415
28700,44470,10710,21508,8953,33758,8635,4219,4416
28705,44474,10713,21510,8956,33760,8635,4219,4416
28710,44484,10719,21514,8961,33765,8637,4219,4418
28715,44490,10719,21517,8961,33770,8639,4221,4418
28720,44501,10722,21521,8964,33777,8641,4221,4420
28725,44505,10726,21524,8968,33778,8641,4221,4420
28730,44515,10730,21529,8971,33784,8643,4223,4420
28735,44521,10732,21533,8973,33787,8645,4224,4421
28740,44532,10737,21540,8978,33793,8647,4226,4421
28745,44536,10739,21541,8980,33796,8647,4226,4421
28750,44546,10742,21545,8983,33803,8649,4227,4422
28755,44552,10742,21548,8983,33809,8651,4228,4423
28760,44563,10744,21552,8984,33819,8653,4229,4424
28765,44567,10745,21553,8985,33822,8653,4229,4424
28770,44577,10749,21557,8987,33828,8655,4230,4425
28775,44583,10749,21560,8987,33834,8657,4232,4425
28780,44594,10750,21565,8987,33844,8659,4233,4426
28785,44598,10751,21568,8988,33847,8659,4233,4426
28790,44608,10753,21575,8989,33854,8661,4235,4426
28795,44614,10753,21577,8989,33861,8663,4236,4427
28800,44625,10754,21577,8989,33871,8665,4236,4429
28805,44629,10755,21580,8990,33874,8665,4236,4429
28810,44639,10756,21587,8990,33883,8667,4237,4430
28815,44645,10756,21590,8990,33889,8669,4238,4431
28820,44656,10756,21593,8990,33900,8671,4239,4432
28825,44660,10756,21595,8990,33904,8671,4239,4432
28830,44670,10757,21599,8990,33913,8673,4240,4433
28835,44676,10757,21602,8990,33918,8675,4241,4434
28840,44687,10757,21605,8990,33930,8677,4241,4436
28845,44691,10757,21608,8990,33934,8677,4241,4436
28850,44701,10758,21612,8991,33942,8679,4242,4437
28855,44707,10760,21615,8993,33946,8681,4243,4438
28860,44718,10762,21620,8995,33955,8683,4244,4439
28865,44722,10762,21621,8995,33960,8683,4244,4439
28870,44732,10763,21626,8995,33968,8685,4245,4440
28875,44738,10765,21629,8997,33971,8687,4245,4442
28880,44749,10767,21632,8999,33981,8689,4247,4442
28885,44753,10769,21634,9001,33983,8689,4247,4442
28890,44763,10772,21635,9002,33990,8691,4247,4444
28895,44769,10773,21640,9003,33993,8693,4249,4444
28900,44780,10777,21644,9007,34001,8695,4249,4446
28905,44784,10780,21646,9010,34003,8695,4249,4446
28910,44794,10785,21649,9014,34009,8697,4249,4448
28915,44800,10785,21650,9014,34014,8699,4249,4450
28920,44811,10789,21656,9017,34019,8701,4250,4451
28925,44815,10793,21657,9021,34022,8701,4250,4451
28930,44825,10796,21661,9023,34028,8703,4250,4453
28935,44831,10798,21664,9025,34033,8705,4251,4454
28940,44842,10800,21669,9026,34041,8707,4253,4454
28945,44846,10801,21671,9027,34045,8707,4253,4454
28950,44856,10803,21673,9028,34053,8709,4253,4456
28955,44862,10803,21674,9028,34059,8711,4254,4457
28960,44873,10806,21680,9030,34065,8713,4256,4457
28965,44877,10809,21682,9033,34068,8713,4256,4457
28970,44887,10812,21689,9036,34074,8715,4257,4458
28975,44893,10813,21692,9037,34080,8717,4259,4458
28980,44904,10814,21696,9037,34088,8719,4260,4459
28985,44908,10816,21697,9039,34092,8719,4260,4459
28990,44918,10819,21701,9041,34099,8721,4260,4461
28995,44924,10819,21706,9041,34104,8723,4262,4461
29000,44935,10823,21711,9044,34111,8725,4263,4462
29005,44939,10824,21715,9045,34114,8725,4263,4462
29010,44949,10828,21721,9048,34121,8727,4264,4463
29015,44955,10828,21726,9048,34127,8729,4266,4463
29020,44966,10832,21730,9051,34134,8731,4267,4464
29025,44970,10832,21733,9051,34138,8731,4267,4464
29030,44980,10834,21740,9053,34146,8733,4268,4465
29035,44986,10834,21742,9053,34151,8735,4268,4467
29040,44997,10840,21750,9058,34155,8737,4269,4468
29045,45001,10842,21751,9060,34159,8737,4269,4468
29050,45011,10846,21759,9064,34165,8739,4270,4469
29055,45017,10846,21763,9064,34170,8741,4271,4470
29060,45028,10850,21766,9067,34178,8743,4272,4471
29065,45032,10851,21767,9068,34181,8743,4272,4471
29070,45042,10855,21771,9070,34187,8745,4273,4472
29075,45048,10855,21774,9070,34192,8747,4274,4473
29080,45059,10858,21777,9072,34200,8749,4274,4475
29085,45063,10859,21778,9073,34204,8749,4274,4475
29090,45073,10861,21781,9073,34210,8751,4275,4476
29095,45079,10864,21783,9076,34215,8753,4276,4477
29100,45090,10868,21789,9080,34221,8755,4277,4478
29105,45094,10870,21791,9082,34224,8755,4277,4478
29110,45104,10871,21796,9083,34231,8757,4278,4479
29115,45110,10874,21799,9086,34234,8759,4278,4481
29120,45121,10877,21804,9089,34243,8761,4279,4482
29125,45125,10879,21806,9091,34245,8761,4279,4482
29130,45135,10882,21811,9093,34252,8763,4280,4483
29135,45141,10883,21812,9094,34258,8765,4281,4484
29140,45152,10885,21817,9095,34266,8767,4282,4485
29145,45156,10885,21817,9095,34271,8767,4282,4485
29150,45166,10887,21822,9097,34279,8769,4283,4486
29155,45172,10887,21825,9097,34284,8771,4284,4487
29160,45183,10890,21832,9100,34292,8773,4286,4487
29165,45187,10890,21835,9100,34296,8773,4286,4487
29170,45197,10891,21837,9101,34306,8775,4287,4488
29175,45203,10892,21839,9102,34311,8777,4288,4489
29180,45214,10893,21846,9103,34319,8779,4290,4489
29185,45218,10894,21849,9104,34323,8779,4290,4489
29190,45228,10895,21854,9104,34333,8781,4292,4489
29195,45234,10895,21857,9104,34338,8783,4294,4489
29200,45245,10897,21864,9106,34346,8785,4295,4490
29205,45249,10898,21865,9107,34351,8785,4295,4490
29210,45259,10899,21868,9107,34360,8787,4296,4491
29215,45265,10900,21870,9108,34365,8789,4297,4492
29220,45276,10902,21877,9110,34370,8791,4297,4494
29225,45280,10907,21880,9115,34372,8791,4297,4494
29230,45290,10911,21883,9117,34379,8793,4298,4495
29235,45296,10911,21884,9117,34385,8795,4299,4496
29240,45307,10913,21889,9119,34392,8797,4300,4497
29245,45311,10915,21890,9121,34395,8797,4300,4497
29250,45321,10918,21893,9122,34402,8799,4301,4498
29255,45327,10919,21896,9123,34406,8801,4302,4499
29260,45338,10921,21903,9125,34414,8803,4303,4500
29265,45342,10922,21905,9126,34420,8803,4303,4500
29270,45352,10925,21914,9129,34426,8805,4305,4500
29275,45358,10925,21918,9129,34431,8807,4306,4501
29280,45369,10927,21921,9131,34442,8809,4307,4502
29285,45373,10928,21923,9132,34445,8809,4307,4502
29290,45383,10931,21929,9135,34452,8811,4308,4503
29295,45389,10931,21931,9135,34458,8813,4310,4503
29300,45400,10933,21937,9137,34465,8815,4311,4504
29305,45404,10935,21939,9139,34469,8815,4311,4504
29310,45414,10937,21946,9141,34476,8817,4312,4505
29315,45420,10937,21948,9141,34481,8819,4312,4507
29320,45431,10939,21955,9143,34490,8821,4313,4508
29325,45435,10940,21958,9144,34494,8821,4313,4508
29330,45445,10942,21961,9146,34503,8823,4313,4510
29335,45451,10942,21963,9146,34508,8825,4313,4512
29340,45462,10946,21967,9149,34515,8827,4313,4514
29345,45466,10947,21969,9150,34518,8827,4313,4514
29350,45476,10948,21972,9150,34528,8829,4314,4515
29355,45482,10948,21974,9150,34534,8831,4315,4516
29360,45493,10951,21980,9152,34542,8833,4316,4517
29365,45497,10952,21982,9153,34544,8833,4316,4517
29370,45507,10956,21988,9157,34551,8835,4318,4517
29375,45513,10956,21990,9157,34556,8837,4318,4519
29380,45524,10959,21996,9159,34564,8839,4319,4520
29385,45528,10961,21997,9161,34567,8839,4319,4520
29390,45538,10965,22001,9163,34572,8841,4320,4521
29395,45544,10967,22006,9165,34576,8843,4322,4521
29400,45555,10970,22011,9168,34584,8845,4323,4522
29405,45559,10972,22014,9170,34587,8845,4323,4522
29410,45569,10974,22019,9172,34594,8847,4324,4523
29415,45575,10976,22023,9174,34598,8849,4325,4524
29420,45586,10979,22030,9176,34607,8851,4327,4524
29425,45590,10979,22032,9176,34611,8851,4327,4524
29430,45600,10982,22038,9179,34617,8853,4329,4524
29435,45606,10984,22042,9181,34621,8855,4331,4524
29440,45617,10986,22048,9183,34630,8857,4332,4525
29445,45621,10988,22051,9185,34633,8857,4332,4525
29450,45631,10991,22056,9187,34640,8859,4332,4527
29455,45637,10991,22060,9187,34644,8861,4334,4527
29460,45648,10993,22065,9188,34654,8863,4335,4528
29465,45652,10994,22065,9189,34658,8863,4335,4528
29470,45662,10997,22069,9191,34664,8865,4335,4530
29475,45668,10999,22073,9193,34668,8867,4337,4530
29480,45679,11001,22076,9194,34676,8869,4337,4532
29485,45683,11001,22077,9194,34682,8869,4337,4532
29490,45693,11002,22081,9194,34691,8871,4338,4533
29495,45699,11002,22084,9194,34697,8873,4339,4534
29500,45710,11004,22088,9195,34705,8875,4340,4535
29505,45714,11005,22092,9196,34707,8875,4340,4535
29510,45724,11012,22096,9201,34712,8877,4340,4537
29515,45730,11012,22100,9201,34716,8879,4342,4537
29520,45741,11016,22103,9204,34724,8881,4342,4539
29525,45745,11018,22106,9206,34725,8881,4342,4539
29530,45755,11023,22108,9209,34732,8883,4343,4540
29535,45761,11023,22110,9209,34738,8885,4344,4541
29540,45772,11027,22117,9212,34742,8887,4345,4542
29545,45776,11032,22121,9217,34742,8887,4345,4542
29550,45786,11035,22126,9219,34751,8889,4346,4543
29555,45792,11035,22130,9219,34756,8891,4347,4544
29560,45803,11039,22135,9223,34762,8893,4347,4546
29565,45807,11041,22138,9225,34765,8893,4347,4546
29570,45817,11043,22142,9226,34774,8895,4348,4547
29575,45823,11043,22146,9226,34780,8897,4350,4547
29580,45834,11044,22149,9226,34790,8899,4350,4549
29585,45838,11044,22153,9226,34793,8899,4350,4549
29590,45848,11045,22159,9226,34801,8901,4351,4550
29595,45854,11048,22162,9229,34806,8903,4351,4552
29600,45865,11049,22169,9230,34814,8905,4352,4553
29605,45869,11049,22171,9230,34820,8905,4352,4553
29610,45879,11050,22178,9230,34828,8907,4354,4553
29615,45885,11052,22181,9232,34832,8909,4355,4554
29620,45896,11054,22188,9234,34839,8911,4356,4555
29625,45900,11055,22190,9235,34844,8911,4356,4555
29630,45910,11056,22197,9236,34852,8913,4358,4555
29635,45916,11058,22199,9238,34857,8915,4359,4556
29640,45927,11059,22206,9239,34866,8917,4360,4557
29645,45931,11060,22208,9240,34871,8917,4360,4557
29650,45941,11061,22212,9240,34879,8919,4360,4559
29655,45947,11063,22217,9242,34884,8921,4362,4559
29660,45958,11063,22225,9242,34893,8923,4363,4560
29665,45962,11063,22225,9242,34899,8923,4363,4560
29670,45972,11065,22229,9243,34906,8925,4363,4562
29675,45978,11066,22232,9244,34911,8927,4364,4563
29680,45989,11069,22236,9247,34919,8929,4365,4564
29685,45993,11071,22239,9249,34921,8929,4365,4564
29690,46003,11076,22245,9253,34926,8931,4366,4565
29695,46009,11077,22246,9254,34932,8933,4366,4567
29700,46020,11080,22251,9257,34938,8935,4366,4569
29705,46024,11082,22254,9259,34941,8935,4366,4569
29710,46034,11086,22260,9262,34947,8937,4368,4569
29715,46040,11087,22261,9263,34952,8939,4368,4571
29720,46051,11090,22266,9265,34959,8941,4368,4573
29725,46055,11092,22267,9267,34963,8941,4368,4573
29730,46065,11094,22271,9268,34970,8943,4368,4575
29735,46071,11094,22274,9268,34975,8945,4368,4577
29740,46082,11096,22276,9269,34985,8947,4369,4578
29745,46086,11097,22278,9270,34987,8947,4369,4578
29750,46096,11101,22283,9274,34994,8949,4370,4579
29755,46102,11101,22286,9274,34999,8951,4370,4581
29760,46113,11104,22294,9277,35006,8953,4372,4581
29765,46117,11107,22297,9280,35009,8953,4372,4581
29770,46127,11108,22299,9281,35019,8955,4373,4582
29775,46133,11108,22304,9281,35024,8957,4374,4583
29780,46144,11110,22308,9282,35034,8959,4376,4583
29785,46148,11111,22310,9283,35037,8959,4376,4583
29790,46158,11112,22315,9284,35046,8961,4377,4584
29795,46164,11112,22318,9284,35051,8963,4378,4585
29800,46175,11113,22321,9284,35062,8965,4379,4586
29805,46179,11113,22324,9284,35066,8965,4379,4586
29810,46189,11114,22330,9285,35074,8967,4380,4587
29815,46195,11114,22335,9285,35080,8969,4382,4587
29820,46206,11116,22343,9286,35090,8971,4383,4588
29825,46210,11116,22344,9286,35094,8971,4383,4588
29830,46220,11119,22349,9288,35101,8973,4385,4588
29835,46226,11120,22350,9289,35106,8975,4385,4590
29840,46237,11123,22357,9292,35113,8977,4386,4591
29845,46241,11125,22361,9294,35116,8977,4386,4591
29850,46251,11127,22366,9296,35123,8979,4386,4593
29855,46257,11129,22369,9298,35128,8981,4387,4594
29860,46268,11130,22374,9298,35137,8983,4388,4595
29865,46272,11132,22376,9300,35139,8983,4388,4595
29870,46282,11136,22381,9303,35144,8985,4389,4596
29875,46288,11139,22384,9306,35148,8987,4390,4597
29880,46299,11144,22391,9311,35153,8989,4391,4598
29885,46303,11146,22393,9313,35155,8989,4391,4598
29890,46313,11153,22398,9319,35160,8991,4392,4599
29895,46319,11153,22401,9319,35166,8993,4394,4599
29900,46330,11157,22408,9322,35171,8995,4395,4600
29905,46334,11160,22410,9325,35173,8995,4395,4600
29910,46344,11166,22417,9330,35178,8997,4397,4600
29915,46350,11166,22418,9330,35184,8999,4398,4601
29920,46361,11168,22424,9332,35191,9001,4399,4602
29925,46365,11169,22426,9333,35196,9001,4399,4602
29930,46375,11172,22430,9334,35203,9003,4401,4602
29935,46381,11172,22433,9334,35209,9005,4402,4603
29940,46392,11174,22437,9336,35218,9007,4402,4605
29945,46396,11174,22440,9336,35221,9007,4402,4605
29950,46406,11177,22444,9337,35229,9009,4404,4605
29955,46412,11177,22446,9337,35235,9011,4406,4605
29960,46423,11180,22451,9339,35242,9013,4407,4606
29965,46427,11180,22453,9339,35246,9013,4407,4606
29970,46437,11183,22460,9342,35254,9015,4408,4607
29975,46443,11183,22463,9342,35259,9017,4409,4608
29980,46454,11188,22472,9347,35264,9019,4410,4609
29985,46458,11189,22472,9348,35269,9019,4410,4609
29990,46468,11192,22476,9350,35276,9021,4410,4611
29995,46474,11193,22478,9351,35281,9023,4410,4613
30000,46485,11195,22480,9353,35290,9025,4410,4615
30005,46489,11195,22483,9353,35293,9025,4410,4615
30010,46499,11199,22489,9357,35300,9027,4412,4615
30015,46505,11199,22490,9357,35305,9029,4412,4617
30020,46516,11203,22496,9361,35311,9031,4413,4618
30025,46520,11206,22498,9364,35313,9031,4413,4618
30030,46530,11212,22503,9369,35318,9033,4414,4619
30035,46536,11212,22505,9369,35323,9035,4415,4620
30040,46547,11215,22509,9372,35332,9037,4417,4620
30045,46551,11215,22510,9372,35335,9037,4417,4620
30050,46561,11217,22517,9374,35342,9039,4418,4621
30055,46567,11219,22519,9376,35347,9041,4418,4623
30060,46578,11220,22524,9377,35356,9043,4419,4624
30065,46582,11221,22526,9378,35360,9043,4419,4624
30070,46592,11222,22533,9378,35368,9045,4421,4624
30075,46598,11224,22536,9380,35373,9047,4422,4625
30080,46609,11224,22540,9380,35385,9049,4422,4627
30085,46613,11224,22543,9380,35388,9049,4422,4627
30090,46623,11225,22545,9380,35397,9051,4422,4629
30095,46629,11227,22549,9382,35401,9053,4423,4630
30100,46640,11228,22553,9383,35411,9055,4424,4631
30105,46644,11228,22555,9383,35415,9055,4424,4631
30110,46654,11229,22561,9383,35424,9057,4426,4631
30115,46660,11230,22563,9384,35429,9059,4426,4633
30120,46671,11230,22571,9384,35440,9061,4428,4633
30125,46675,11231,22572,9385,35443,9061,4428,4633
30130,46685,11232,22577,9386,35452,9063,4430,4633
30135,46691,11233,22580,9387,35457,9065,4430,4635
30140,46702,11236,22587,9390,35465,9067,4431,4636
30145,46706,11237,22588,9391,35469,9067,4431,4636
30150,46716,11239,22595,9393,35476,9069,4433,4636
30155,46722,11241,22597,9395,35480,9071,4433,4638
30160,46733,11245,22602,9398,35487,9073,4434,4639
30165,46737,11247,22605,9400,35490,9073,4434,4639
30170,46747,11249,22610,9401,35496,9075,4435,4640
30175,46753,11252,22612,9404,35500,9077,4435,4642
30180,46764,11255,22617,9406,35509,9079,4436,4643
30185,46768,11256,22619,9407,35511,9079,4436,4643
30190,46778,11259,22628,9410,35519,9081,4438,4643
30195,46784,11259,22630,9410,35524,9083,4439,4644
30200,46795,11261,22636,9411,35532,9085,4439,4646
30205,46799,11262,22637,9412,35537,9085,4439,4646
30210,46809,11264,22640,9413,35545,9087,4439,4648
30215,46815,11264,22641,9413,35551,9089,4440,4649
30220,46826,11265,22644,9413,35558,9091,4440,4651
30225,46830,11266,22646,9414,35563,9091,4440,4651
30230,46840,11271,22651,9418,35568,9093,4440,4653
30235,46846,11271,22652,9418,35575,9095,4440,4655
30240,46857,11274,22659,9421,35581,9097,4441,4656
30245,46861,11276,22662,9423,35584,9097,4441,4656
30250,46871,11280,22666,9427,35590,9099,4441,4658
30255,46877,11280,22668,9427,35596,9101,4441,4660
30260,46888,11283,22673,9429,35604,9103,4442,4661
30265,46892,11284,22675,9430,35607,9103,4442,4661
30270,46902,11288,22680,9434,35613,9105,4442,4663
30275,46908,11288,22684,9434,35618,9107,4443,4664
30280,46919,11291,22688,9437,35628,9109,4443,4666
30285,46923,11292,22691,9438,35630,9109,4443,4666
30290,46933,11296,22697,9440,35636,9111,4444,4667
30295,46939,11296,22702,9440,35642,9113,4446,4667
30300,46950,11298,22706,9442,35651,9115,4446,4669
30305,46954,11301,22710,9445,35652,9115,4446,4669
30310,46964,11304,22715,9447,35660,9117,4447,4670
30315,46970,11304,22720,9447,35665,9119,4449,4670
30320,46981,11308,22725,9450,35673,9121,4450,4671
30325,46985,11310,22728,9452,35674,9121,4450,4671
30330,46995,11314,22732,9454,35681,9123,4452,4671
30335,47001,11314,22736,9454,35686,9125,4453,4672
30340,47012,11318,22742,9458,35694,9127,4453,4674
30345,47016,11318,22742,9458,35698,9127,4453,4674
30350,47026,11319,22747,9459,35707,9129,4453,4676
30355,47032,11319,22748,9459,35712,9131,4453,4678
30360,47043,11320,22751,9460,35722,9133,4453,4680
30365,47047,11320,22752,9460,35726,9133,4453,4680
30370,47057,11321,22758,9461,35736,9135,4454,4681
30375,47063,11321,22762,9461,35741,9137,4455,4682
30380,47074,11323,22767,9462,35750,9139,4456,4683
30385,47078,11324,22769,9463,35753,9139,4456,4683
30390,47088,11326,22773,9464,35762,9141,4457,4684
30395,47094,11326,22777,9464,35768,9143,4459,4684
30400,47105,11328,22781,9465,35777,9145,4461,4684
30405,47109,11329,22784,9466,35780,9145,4461,4684
30410,47119,11331,22790,9468,35787,9147,4462,4685
30415,47125,11332,22792,9469,35792,9149,4462,4687
30420,47136,11336,22797,9472,35799,9151,4462,4689
30425,47140,11336,22797,9472,35804,9151,4462,4689
30430,47150,11339,22802,9474,35809,9153,4462,4691
30435,47156,11341,22805,9476,35813,9155,4463,4692
30440,47167,11344,22807,9478,35823,9157,4464,4693
30445,47171,11344,22809,9478,35826,9157,4464,4693
30450,47181,11346,22812,9479,35835,9159,4464,4695
30455,47187,11346,22814,9479,35841,9161,4465,4696
30460,47198,11348,22820,9481,35848,9163,4466,4697
30465,47202,11348,22821,9481,35854,9163,4466,4697
30470,47212,11350,22828,9482,35861,9165,4467,4698
30475,47218,11352,22834,9484,35864,9167,4469,4698
30480,47229,11355,22839,9487,35873,9169,4471,4698
30485,47233,11356,22841,9488,35877,9169,4471,4698
30490,47243,11358,22849,9490,35883,9171,4472,4699
30495,47249,11361,22850,9493,35888,9173,4472,4701
30500,47260,11362,22855,9494,35896,9175,4473,4702
30505,47264,11363,22855,9495,35901,9175,4473,4702
30510,47274,11365,22859,9496,35908,9177,4474,4703
30515,47280,11366,22860,9497,35913,9179,4474,4705
30520,47291,11369,22866,9500,35919,9181,4475,4706
30525,47295,11371,22867,9502,35924,9181,4475,4706
30530,47305,11373,22872,9503,35932,9183,4477,4706
30535,47311,11373,22874,9503,35936,9185,4477,4708
30540,47322,11377,22879,9507,35943,9187,4478,4709
30545,47326,11380,22881,9510,35945,9187,4478,4709
30550,47336,11383,22886,9512,35951,9189,4480,4709
30555,47342,11385,22889,9514,35956,9191,4482,4709
30560,47353,11389,22894,9517,35962,9193,4483,4710
30565,47357,11392,22896,9520,35964,9193,4483,4710
30570,47367,11398,22901,9525,35969,9195,4484,4711
30575,47373,11398,22902,9525,35974,9197,4484,4713
30580,47384,11401,22907,9528,35981,9199,4485,4714
30585,47388,11404,22909,9531,35983,9199,4485,4714
30590,47398,11410,22915,9536,35987,9201,4486,4715
30595,47404,11411,22916,9537,35992,9203,4486,4717
30600,47415,11414,22920,9539,36000,9205,4488,4717
30605,47419,11415,22921,9540,36004,9205,4488,4717
30610,47429,11418,22925,9542,36010,9207,4488,4719
30615,47435,11419,22925,9543,36016,9209,4488,4721
30620,47446,11421,22929,9544,36025,9211,4490,4721
30625,47450,11421,22930,9544,36028,9211,4490,4721
30630,47460,11423,22934,9545,36036,9213,4491,4722
30635,47466,11424,22938,9546,36041,9215,4493,4722
30640,47477,11426,22942,9548,36050,9217,4494,4723
30645,47481,11426,22944,9548,36054,9217,4494,4723
30650,47491,11428,22949,9550,36061,9219,4494,4725
30655,47497,11430,22954,9552,36065,9221,4496,4725
30660,47508,11433,22959,9555,36075,9223,4498,4725
30665,47512,11433,22960,9555,36079,9223,4498,4725
30670,47522,11434,22961,9555,36088,9225,4499,4726
30675,47528,11434,22962,9555,36094,9227,4500,4727
30680,47539,11435,22965,9556,36104,9229,4500,4729
30685,47543,11436,22968,9557,36107,9229,4500,4729
30690,47553,11438,22970,9558,36115,9231,4501,4730
30695,47559,11438,22973,9558,36120,9233,4503,4730
30700,47570,11440,22976,9560,36129,9235,4503,4732
30705,47574,11441,22978,9561,36133,9235,4503,4732
30710,47584,11444,22985,9564,36139,9237,4505,4732
30715,47590,11445,22987,9565,36144,9239,4506,4733
30720,47601,11449,22994,9569,36150,9241,4508,4733
30725,47605,11452,22997,9572,36152,9241,4508,4733
30730,47615,11456,23003,9575,36158,9243,4509,4734
30735,47621,11458,23005,9577,36163,9245,4510,4735
30740,47632,11462,23011,9580,36169,9247,4512,4735
30745,47636,11465,23014,9583,36170,9247,4512,4735
30750,47646,11470,23019,9587,36176,9249,4513,4736
30755,47652,11471,23021,9588,36180,9251,4513,4738
30760,47663,11474,23026,9591,36187,9253,4514,4739
30765,47667,11476,23028,9593,36190,9253,4514,4739
30770,47677,11482,23034,9598,36193,9255,4514,4741
30775,47683,11484,23038,9600,36198,9257,4516,4741
30780,47694,11487,23044,9603,36206,9259,4518,4741
30785,47698,11487,23046,9603,36210,9259,4518,4741
30790,47708,11489,23052,9605,36218,9261,4519,4742
30795,47714,11489,23057,9605,36223,9263,4520,4743
30800,47725,11492,23062,9607,36231,9265,4520,4745
30805,47729,11494,23066,9609,36234,9265,4520,4745
30810,47739,11494,23071,9609,36245,9267,4521,4746
30815,47745,11494,23075,9609,36250,9269,4522,4747
30820,47756,11495,23081,9610,36259,9271,4522,4749
30825,47760,11495,23083,9610,36265,9271,4522,4749
30830,47770,11495,23088,9610,36275,9273,4523,4750
30835,47776,11495,23091,9610,36281,9275,4524,4751
30840,47787,11496,23096,9611,36290,9277,4525,4752
30845,47791,11497,23098,9612,36293,9277,4525,4752
30850,47801,11499,23104,9614,36302,9279,4526,4753
30855,47807,11499,23107,9614,36308,9281,4528,4753
30860,47818,11500,23112,9615,36318,9283,4529,4754
30865,47822,11500,23114,9615,36322,9283,4529,4754
30870,47832,11502,23121,9617,36330,9285,4531,4754
30875,47838,11502,23124,9617,36336,9287,4533,4754
30880,47849,11504,23130,9619,36345,9289,4534,4755
30885,47853,11505,23131,9620,36348,9289,4534,4755
30890,47863,11507,23136,9621,36356,9291,4535,4756
30895,47869,11507,23139,9621,36362,9293,4537,4756
30900,47880,11508,23143,9621,36372,9295,4538,4757
30905,47884,11508,23143,9621,36376,9295,4538,4757
30910,47894,11511,23146,9623,36383,9297,4538,4759
30915,47900,11511,23148,9623,36388,9299,4538,4761
30920,47911,11514,23149,9625,36397,9301,4538,4763
30925,47915,11514,23151,9625,36400,9301,4538,4763
30930,47925,11520,23156,9629,36405,9303,4540,4763
30935,47931,11521,23158,9630,36410,9305,4541,4764
30940,47942,11525,23166,9634,36417,9307,4543,4764
30945,47946,11525,23168,9634,36420,9307,4543,4764
30950,47956,11530,23174,9638,36425,9309,4545,4764
30955,47962,11531,23177,9639,36428,9311,4545,4766
30960,47973,11537,23180,9644,36436,9313,4546,4767
30965,47977,11538,23182,9645,36438,9313,4546,4767
30970,47987,11542,23188,9649,36443,9315,4547,4768
30975,47993,11545,23191,9652,36447,9317,4548,4769
30980,48004,11547,23195,9654,36455,9319,4549,4770
30985,48008,11550,23197,9657,36457,9319,4549,4770
30990,48018,11555,23202,9661,36462,9321,4550,4771
30995,48024,11557,23206,9663,36466,9323,4552,4771
31000,48035,11560,23209,9665,36473,9325,4552,4773
31005,48039,11564,23213,9669,36473,9325,4552,4773
31010,48049,11569,23219,9674,36479,9327,4554,4773
31015,48055,11571,23221,9676,36483,9329,4554,4775
31020,48066,11575,23226,9680,36490,9331,4555,4776
31025,48070,11577,23229,9682,36491,9331,4555,4776
31030,48080,11581,23234,9685,36498,9333,4556,4777
31035,48086,11582,23235,9686,36504,9335,4557,4778
31040,48097,11582,23241,9686,36513,9337,4558,4779
31045,48101,11583,23243,9687,36518,9337,4558,4779
31050,48111,11584,23248,9688,36526,9339,4559,4780
31055,48117,11586,23251,9690,36530,9341,4560,4781
31060,48128,11588,23256,9692,36540,9343,4561,4782
31065,48132,11588,23259,9692,36544,9343,4561,4782
31070,48142,11589,23265,9692,36552,9345,4562,4783
31075,48148,11591,23270,9694,36556,9347,4564,4783
31080,48159,11592,23277,9695,36564,9349,4564,4785
31085,48163,11593,23278,9696,36569,9349,4564,4785
31090,48173,11594,23286,9696,36577,9351,4565,4786
31095,48179,11596,23288,9698,36583,9353,4566,4787
31100,48190,11596,23291,9698,36594,9355,4567,4788
31105,48194,11596,23294,9698,36597,9355,4567,4788
31110,48204,11596,23296,9698,36608,9357,4567,4790
31115,48210,11596,23297,9698,36614,9359,4568,4791
31120,48221,11596,23302,9698,36625,9361,4568,4793
31125,48225,11596,23303,9698,36628,9361,4568,4793
31130,48235,11597,23307,9699,36637,9363,4569,4794
31135,48241,11597,23312,9699,36643,9365,4570,4795
31140,48252,11598,23317,9700,36652,9367,4570,4797
31145,48256,11599,23319,9701,36656,9367,4570,4797
31150,48266,11601,23323,9702,36665,9369,4571,4798
31155,48272,11601,23329,9702,36669,9371,4573,4798
31160,48283,11605,23333,9705,36677,9373,4573,4800
31165,48287,11606,23336,9706,36681,9373,4573,4800
31170,48297,11609,23339,9708,36688,9375,4573,4802
31175,48303,11609,23342,9708,36693,9377,4575,4802
31180,48314,11612,23348,9710,36700,9379,4576,4803
31185,48318,11614,23350,9712,36703,9379,4576,4803
31190,48328,11617,23354,9714,36711,9381,4577,4804
31195,48334,11617,23357,9714,36716,9383,4579,4804
31200,48345,11621,23364,9717,36722,9385,4581,4804
31205,48349,11623,23366,9719,36726,9385,4581,4804
31210,48359,11626,23372,9722,36733,9387,4582,4805
31215,48365,11626,23373,9722,36739,9389,4583,4806
31220,48376,11627,23376,9723,36749,9391,4584,4807
31225,48380,11628,23377,9724,36752,9391,4584,4807
31230,48390,11631,23382,9726,36758,9393,4585,4808
31235,48396,11631,23384,9726,36764,9395,4585,4810
31240,48407,11633,23389,9728,36773,9397,4587,4810
31245,48411,11633,23389,9728,36778,9397,4587,4810
31250,48421,11636,23396,9730,36783,9399,4589,4810
31255,48427,11638,23399,9732,36787,9401,4590,4811
31260,48438,11643,23404,9736,36794,9403,4592,4811
31265,48442,11645,23405,9738,36797,9403,4592,4811
31270,48452,11651,23411,9743,36800,9405,4592,4813
31275,48458,11653,23415,9745,36803,9407,4593,4814
31280,48469,11659,23420,9750,36808,9409,4593,4816
31285,48473,11662,23422,9753,36810,9409,4593,4816
31290,48483,11665,23427,9756,36817,9411,4594,4817
31295,48489,11667,23430,9758,36821,9413,4595,4818
31300,48500,11669,23436,9760,36828,9415,4596,4819
31305,48504,11671,23438,9762,36832,9415,4596,4819
31310,48514,11673,23442,9763,36840,9417,4596,4821
31315,48520,11675,23445,9765,36844,9419,4597,4822
31320,48531,11677,23451,9767,36852,9421,4598,4823
31325,48535,11678,23454,9768,36856,9421,4598,4823
31330,48545,11680,23459,9770,36865,9423,4600,4823
31335,48551,11680,23461,9770,36871,9425,4601,4824
31340,48562,11683,23467,9773,36879,9427,4602,4825
31345,48566,11684,23470,9774,36882,9427,4602,4825
31350,48576,11686,23472,9775,36890,9429,4602,4827
31355,48582,11686,23473,9775,36896,9431,4603,4828
31360,48593,11688,23477,9776,36905,9433,4604,4829
31365,48597,11688,23479,9776,36909,9433,4604,4829
31370,48607,11689,23482,9776,36918,9435,4605,4830
31375,48613,11689,23486,9776,36924,9437,4606,4831
31380,48624,11692,23493,9779,36932,9439,4606,4833
31385,48628,11692,23495,9779,36936,9439,4606,4833
31390,48638,11694,23501,9780,36944,9441,4607,4834
31395,48644,11694,23504,9780,36949,9443,4607,4836
31400,48655,11697,23509,9783,36958,9445,4609,4836
31405,48659,11697,23512,9783,36962,9445,4609,4836
31410,48669,11699,23515,9784,36970,9447,4610,4837
31415,48675,11699,23519,9784,36976,9449,4611,4838
31420,48686,11702,23527,9787,36983,9451,4613,4838
31425,48690,11703,23528,9788,36987,9451,4613,4838
31430,48700,11705,23533,9790,36993,9453,4614,4839
31435,48706,11708,23536,9793,36997,9455,4615,4840
31440,48717,11713,23541,9797,37003,9457,4616,4841
31445,48721,11715,23542,9799,37006,9457,4616,4841
31450,48731,11721,23549,9805,37009,9459,4616,4843
31455,48737,11722,23553,9806,37013,9461,4618,4843
31460,48748,11728,23560,9812,37018,9463,4619,4844
31465,48752,11731,23562,9815,37020,9463,4619,4844
31470,48762,11736,23566,9819,37025,9465,4619,4846
31475,48768,11738,23569,9821,37028,9467,4619,4848
31480,48779,11741,23574,9824,37036,9469,4619,4850
31485,48783,11743,23577,9826,37038,9469,4619,4850
31490,48793,11748,23579,9829,37045,9471,4619,4852
31495,48799,11748,23580,9829,37051,9473,4620,4853
31500,48810,11748,23584,9829,37061,9475,4620,4855
31505,48814,11749,23587,9830,37064,9475,4620,4855
31510,48824,11750,23593,9831,37072,9477,4621,4856
31515,48830,11752,23597,9833,37077,9479,4622,4857
31520,48841,11753,23602,9834,37087,9481,4623,4858
31525,48845,11753,23604,9834,37092,9481,4623,4858
31530,48855,11754,23607,9834,37100,9483,4625,4858
31535,48861,11755,23608,9835,37106,9485,4625,4860
31540,48872,11755,23610,9835,37116,9487,4626,4861
31545,48876,11755,23611,9835,37121,9487,4626,4861
31550,48886,11756,23617,9836,37130,9489,4627,4862
31555,48892,11756,23619,9836,37136,9491,4627,4864
31560,48903,11756,23623,9836,37146,9493,4627,4866
31565,48907,11756,23623,9836,37151,9493,4627,4866
31570,48917,11757,23627,9836,37159,9495,4629,4866
31575,48923,11758,23629,9837,37165,9497,4630,4867
31580,48934,11761,23638,9840,37170,9499,4631,4868
31585,48938,11762,23641,9841,37175,9499,4631,4868
31590,48948,11763,23642,9841,37185,9501,4631,4870
31595,48954,11764,23646,9842,37189,9503,4632,4871
31600,48965,11768,23651,9846,37196,9505,4633,4872
31605,48969,11770,23653,9848,37199,9505,4633,4872
31610,48979,11773,23656,9849,37206,9507,4634,4873
31615,48985,11773,23657,9849,37211,9509,4634,4875
31620,48996,11775,23661,9850,37218,9511,4635,4876
31625,49000,11779,23662,9854,37221,9511,4635,4876
31630,49010,11783,23671,9857,37225,9513,4637,4876
31635,49016,11785,23676,9859,37230,9515,4639,4876
31640,49027,11788,23681,9862,37238,9517,4640,4877
31645,49031,11790,23683,9864,37240,9517,4640,4877
31650,49041,11792,23687,9866,37249,9519,4642,4877
31655,49047,11792,23692,9866,37253,9521,4643,4878
31660,49058,11796,23700,9870,37259,9523,4644,4879
31665,49062,11798,23702,9872,37263,9523,4644,4879
31670,49072,11800,23706,9874,37271,9525,4645,4880
31675,49078,11800,23708,9874,37276,9527,4645,4882
31680,49089,11803,23715,9877,37284,9529,4647,4882
31685,49093,11805,23717,9879,37288,9529,4647,4882
31690,49103,11806,23724,9880,37297,9531,4649,4882
31695,49109,11806,23727,9880,37303,9533,4650,4883
31700,49120,11810,23733,9883,37310,9535,4651,4884
31705,49124,11811,23734,9884,37313,9535,4651,4884
31710,49134,11811,23739,9884,37323,9537,4653,4884
31715,49140,11811,23743,9884,37328,9539,4655,4884
31720,49151,11813,23748,9885,37336,9541,4656,4885
31725,49155,11814,23750,9886,37340,9541,4656,4885
31730,49165,11816,23759,9888,37348,9543,4658,4885
31735,49171,11816,23762,9888,37355,9545,4660,4885
31740,49182,11817,23764,9888,37365,9547,4660,4887
31745,49186,11818,23767,9889,37367,9547,4660,4887
31750,49196,11819,23770,9889,37377,9549,4660,4889
31755,49202,11819,23771,9889,37383,9551,4660,4891
31760,49213,11820,23776,9890,37392,9553,4660,4893
31765,49217,11820,23778,9890,37396,9553,4660,4893
31770,49227,11823,23785,9892,37403,9555,4661,4894
31775,49233,11823,23789,9892,37408,9557,4662,4895
31780,49244,11825,23796,9894,37418,9559,4662,4897
31785,49248,11825,23797,9894,37422,9559,4662,4897
31790,49258,11826,23801,9895,37431,9561,4663,4898
31795,49264,11826,23805,9895,37438,9563,4665,4898
31800,49275,11828,23811,9897,37446,9565,4667,4898
31805,49279,11828,23813,9897,37450,9565,4667,4898
31810,49289,11831,23816,9899,37458,9567,4669,4898
31815,49295,11831,23820,9899,37462,9569,4670,4899
31820,49306,11834,23823,9901,37471,9571,4671,4900
31825,49310,11836,23825,9903,37473,9571,4671,4900
31830,49320,11839,23829,9905,37480,9573,4673,4900
31835,49326,11839,23833,9905,37486,9575,4675,4900
31840,49337,11841,23835,9906,37495,9577,4676,4901
31845,49341,11841,23837,9906,37500,9577,4676,4901
31850,49351,11843,23841,9907,37508,9579,4678,4901
31855,49357,11844,23845,9908,37512,9581,4679,4902
31860,49368,11848,23850,9911,37518,9583,4679,4904
31865,49372,11848,23853,9911,37523,9583,4679,4904
31870,49382,11851,23860,9914,37529,9585,4679,4906
31875,49388,11854,23863,9917,37532,9587,4679,4908
31880,49399,11857,23869,9920,37540,9589,4681,4908
31885,49403,11857,23870,9920,37545,9589,4681,4908
31890,49413,11861,23876,9922,37551,9591,4683,4908
31895,49419,11863,23881,9924,37554,9593,4684,4909
31900,49430,11868,23884,9928,37562,9595,4684,4911
31905,49434,11868,23886,9928,37566,9595,4684,4911
31910,49444,11871,23892,9931,37571,9597,4685,4912
31915,49450,11873,23894,9933,37576,9599,4686,4913
31920,49461,11877,23899,9936,37583,9601,4687,4914
31925,49465,11879,23901,9938,37586,9601,4687,4914
31930,49475,11881,23904,9939,37592,9603,4687,4916
31935,49481,11884,23908,9942,37595,9605,4687,4918
31940,49492,11888,23912,9945,37604,9607,4688,4919
31945,49496,11889,23913,9946,37607,9607,4688,4919
31950,49506,11893,23919,9949,37613,9609,4689,4920
31955,49512,11893,23922,9949,37619,9611,4691,4920
31960,49523,11896,23928,9952,37627,9613,4692,4921
31965,49527,11897,23930,9953,37629,9613,4692,4921
31970,49537,11900,23931,9954,37637,9615,4693,4922
31975,49543,11900,23937,9954,37642,9617,4695,4922
31980,49554,11904,23942,9957,37649,9619,4696,4923
31985,49558,11906,23944,9959,37651,9619,4696,4923
31990,49568,11910,23947,9961,37658,9621,4698,4923
31995,49574,11910,23949,9961,37664,9623,4699,4924
32000,49585,11911,23954,9962,37673,9625,4700,4925
32005,49589,11911,23956,9962,37677,9625,4700,4925
32010,49599,11914,23964,9964,37685,9627,4702,4925
32015,49605,11914,23967,9964,37690,9629,4703,4926
32020,49616,11915,23971,9965,37700,9631,4704,4927
32025,49620,11915,23973,9965,37704,9631,4704,4927
32030,49630,11917,23978,9966,37713,9633,4704,4929
32035,49636,11917,23982,9966,37719,9635,4706,4929
32040,49647,11919,23985,9967,37727,9637,4707,4930
32045,49651,11920,23988,9968,37730,9637,4707,4930
32050,49661,11922,23993,9970,37738,9639,4708,4931
32055,49667,11924,23997,9972,37741,9641,4709,4932
32060,49678,11928,24004,9976,37748,9643,4709,4934
32065,49682,11930,24006,9978,37752,9643,4709,4934
32070,49692,11932,24011,9980,37759,9645,4709,4936
32075,49698,11933,24014,9981,37764,9647,4711,4936
32080,49709,11936,24022,9984,37770,9649,4713,4936
32085,49713,11938,24023,9986,37775,9649,4713,4936
32090,49723,11939,24027,9986,37782,9651,4714,4937
32095,49729,11941,24030,9988,37787,9653,4715,4938
32100,49740,11945,24035,9991,37793,9655,4716,4939
32105,49744,11947,24036,9993,37797,9655,4716,4939
32110,49754,11950,24040,9995,37804,9657,4718,4939
32115,49760,11950,24042,9995,37808,9659,4718,4941
32120,49771,11955,24045,9999,37815,9661,4718,4943
32125,49775,11957,24048,10001,37818,9661,4718,4943
32130,49785,11960,24053,10003,37825,9663,4719,4944
32135,49791,11961,24057,10004,37830,9665,4721,4944
32140,49802,11963,24063,10006,37837,9667,4722,4945
32145,49806,11965,24065,10008,37841,9667,4722,4945
32150,49816,11967,24068,10008,37848,9669,4723,4946
32155,49822,11968,24071,10009,37853,9671,4724,4947
32160,49833,11972,24076,10013,37859,9673,4724,4949
32165,49837,11974,24079,10015,37863,9673,4724,4949
32170,49847,11976,24083,10016,37870,9675,4725,4950
32175,49853,11976,24086,10016,37875,9677,4725,4952
32180,49864,11978,24087,10017,37885,9679,4725,4954
32185,49868,11978,24088,10017,37890,9679,4725,4954
32190,49878,11981,24092,10019,37897,9681,4725,4956
32195,49884,11981,24096,10019,37901,9683,4725,4958
32200,49895,11984,24102,10021,37908,9685,4725,4960
32205,49899,11988,24103,10025,37911,9685,4725,4960
32210,49909,11991,24107,10026,37918,9687,4727,4960
32215,49915,11991,24109,10026,37923,9689,4728,4961
32220,49926,11996,24117,10031,37928,9691,4728,4963
32225,49930,11998,24118,10033,37931,9691,4728,4963
32230,49940,12004,24124,10038,37936,9693,4729,4964
32235,49946,12004,24127,10038,37941,9695,4730,4965
32240,49957,12007,24134,10041,37948,9697,4732,4965
32245,49961,12010,24138,10044,37950,9697,4732,4965
32250,49971,12012,24142,10045,37958,9699,4733,4966
32255,49977,12012,24145,10045,37963,9701,4733,4968
32260,49988,12013,24150,10045,37975,9703,4734,4969
32265,49992,12013,24151,10045,37979,9703,4734,4969
32270,50002,12014,24153,10045,37987,9705,4735,4970
32275,50008,12016,24159,10047,37990,9707,4737,4970
32280,50019,12018,24163,10048,37998,9709,4738,4971
32285,50023,12019,24164,10049,38004,9709,4738,4971
32290,50033,12021,24168,10050,38012,9711,4739,4972
32295,50039,12021,24169,10050,38018,9713,4740,4973
32300,50050,12023,24173,10051,38027,9715,4741,4974
32305,50054,12023,24174,10051,38031,9715,4741,4974
32310,50064,12026,24179,10053,38038,9717,4743,4974
32315,50070,12026,24181,10053,38044,9719,4744,4975
32320,50081,12028,24185,10054,38053,9721,4744,4977
32325,50085,12028,24187,10054,38057,9721,4744,4977
32330,50095,12030,24190,10055,38065,9723,4744,4979
32335,50101,12030,24192,10055,38071,9725,4745,4980
32340,50112,12031,24196,10056,38081,9727,4745,4982
32345,50116,12031,24197,10056,38085,9727,4745,4982
32350,50126,12033,24202,10058,38093,9729,4747,4982
32355,50132,12033,24206,10058,38098,9731,4749,4982
32360,50143,12037,24213,10062,38104,9733,4751,4982
32365,50147,12038,24215,10063,38109,9733,4751,4982
32370,50157,12041,24219,10065,38116,9735,4751,4984
32375,50163,12041,24223,10065,38122,9737,4753,4984
32380,50174,12043,24227,10067,38129,9739,4753,4986
32385,50178,12044,24228,10068,38133,9739,4753,4986
32390,50188,12048,24231,10070,38139,9741,4754,4987
32395,50194,12049,24234,10071,38143,9743,4755,4988
32400,50205,12053,24239,10075,38150,9745,4756,4989
32405,50209,12056,24241,10078,38152,9745,4756,4989
32410,50219,12059,24243,10080,38160,9747,4757,4990
32415,50225,12060,24248,10081,38163,9749,4759,4990
32420,50236,12064,24254,10085,38168,9751,4759,4992
32425,50240,12069,24257,10090,38169,9751,4759,4992
32430,50250,12075,24264,10096,38173,9753,4760,4993
32435,50256,12078,24268,10099,38176,9755,4761,4994
32440,50267,12082,24274,10103,38182,9757,4762,4995
32445,50271,12086,24276,10107,38185,9757,4762,4995
32450,50281,12089,24282,10108,38191,9759,4764,4995
32455,50287,12091,24285,10110,38195,9761,4765,4996
32460,50298,12095,24289,10113,38202,9763,4765,4998
32465,50302,12097,24290,10115,38205,9763,4765,4998
32470,50312,12100,24297,10118,38212,9765,4766,4999
32475,50318,12100,24300,10118,38216,9767,4767,5000
32480,50329,12103,24304,10121,38226,9769,4768,5001
32485,50333,12104,24307,10122,38228,9769,4768,5001
32490,50343,12106,24312,10124,38237,9771,4769,5002
32495,50349,12106,24313,10124,38243,9773,4769,5004
32500,50360,12109,24320,10127,38249,9775,4770,5005
32505,50364,12110,24323,10128,38253,9775,4770,5005
32510,50374,12111,24328,10129,38262,9777,4771,5006
32515,50380,12111,24331,10129,38269,9779,4772,5007
32520,50391,12112,24336,10130,38277,9781,4772,5009
32525,50395,12113,24339,10131,38282,9781,4772,5009
32530,50405,12113,24342,10131,38292,9783,4773,5010
32535,50411,12113,24346,10131,38297,9785,4774,5011
32540,50422,12115,24352,10133,38307,9787,4775,5012
32545,50426,12115,24354,10133,38311,9787,4775,5012
32550,50436,12116,24360,10134,38319,9789,4777,5012
32555,50442,12116,24363,10134,38325,9791,4778,5013
32560,50453,12117,24369,10134,38336,9793,4779,5014
32565,50457,12117,24371,10134,38340,9793,4779,5014
32570,50467,12118,24376,10134,38347,9795,4781,5014
32575,50473,12120,24380,10136,38352,9797,4783,5014
32580,50484,12123,24384,10138,38360,9799,4784,5015
32585,50488,12125,24386,10140,38363,9799,4784,5015
32590,50498,12127,24390,10142,38371,9801,4785,5016
32595,50504,12127,24394,10142,38376,9803,4786,5017
32600,50515,12128,24397,10143,38387,9805,4786,5019
32605,50519,12128,24397,10143,38391,9805,4786,5019
32610,50529,12130,24402,10145,38399,9807,4786,5021
32615,50535,12130,24403,10145,38404,9809,4786,5023
32620,50546,12134,24408,10148,38412,9811,4787,5024
32625,50550,12135,24410,10149,38415,9811,4787,5024
32630,50560,12139,24413,10151,38421,9813,4787,5026
32635,50566,12139,24416,10151,38426,9815,4788,5027
32640,50577,12141,24419,10153,38435,9817,4788,5029
32645,50581,12143,24421,10155,38437,9817,4788,5029
32650,50591,12149,24425,10159,38442,9819,4789,5030
32655,50597,12149,24429,10159,38447,9821,4791,5030
32660,50608,12153,24436,10162,38453,9823,4793,5030
32665,50612,12157,24440,10166,38453,9823,4793,5030
32670,50622,12163,24445,10172,38459,9825,4794,5031
32675,50628,12163,24447,10172,38465,9827,4795,5032
32680,50639,12164,24450,10172,38475,9829,4797,5032
32685,50643,12164,24452,10172,38478,9829,4797,5032
32690,50653,12167,24457,10175,38486,9831,4797,5034
32695,50659,12167,24459,10175,38491,9833,4797,5036
32700,50670,12171,24466,10179,38498,9835,4799,5036
32705,50674,12171,24468,10179,38502,9835,4799,5036
32710,50684,12174,24474,10181,38509,9837,4801,5036
32715,50690,12175,24477,10182,38514,9839,4803,5036
32720,50701,12177,24481,10183,38522,9841,4804,5037
32725,50705,12180,24483,10186,38525,9841,4804,5037
32730,50715,12184,24489,10189,38531,9843,4806,5037
32735,50721,12185,24494,10190,38534,9845,4807,5038
32740,50732,12190,24501,10194,38540,9847,4809,5038
32745,50736,12191,24503,10195,38544,9847,4809,5038
32750,50746,12194,24509,10196,38550,9849,4811,5038
32755,50752,12196,24511,10198,38555,9851,4812,5039
32760,50763,12198,24514,10200,38564,9853,4813,5040
32765,50767,12198,24515,10200,38568,9853,4813,5040
32770,50777,12202,24519,10202,38573,9855,4813,5042
32775,50783,12204,24521,10204,38577,9857,4813,5044
32780,50794,12208,24526,10208,38584,9859,4814,5045
32785,50798,12211,24528,10211,38586,9859,4814,5045
32790,50808,12215,24535,10215,38591,9861,4816,5045
32795,50814,12218,24540,10218,38594,9863,4818,5045
32800,50825,12224,24546,10223,38599,9865,4819,5046
32805,50829,12226,24549,10225,38602,9865,4819,5046
32810,50839,12228,24553,10226,38611,9867,4821,5046
32815,50845,12229,24557,10227,38615,9869,4822,5047
32820,50856,12230,24562,10227,38625,9871,4824,5047
32825,50860,12232,24565,10229,38627,9871,4824,5047
32830,50870,12233,24569,10230,38637,9873,4826,5047
32835,50876,12233,24573,10230,38641,9875,4828,5047
32840,50887,12236,24579,10233,38651,9877,4829,5048
32845,50891,12237,24581,10234,38654,9877,4829,5048
32850,50901,12240,24585,10236,38660,9879,4829,5050
32855,50907,12241,24587,10237,38664,9881,4829,5052
32860,50918,12243,24590,10238,38674,9883,4830,5053
32865,50922,12243,24590,10238,38679,9883,4830,5053
32870,50932,12246,24597,10241,38685,9885,4831,5054
32875,50938,12247,24598,10242,38690,9887,4831,5056
32880,50949,12250,24602,10244,38699,9889,4832,5057
32885,50953,12250,24604,10244,38703,9889,4832,5057
32890,50963,12251,24608,10245,38711,9891,4833,5058
32895,50969,12253,24613,10247,38715,9893,4834,5059
32900,50980,12254,24618,10248,38726,9895,4835,5060
32905,50984,12254,24621,10248,38729,9895,4835,5060
32910,50994,12256,24625,10248,38737,9897,4835,5062
32915,51000,12258,24630,10250,38740,9899,4836,5063
32920,51011,12260,24633,10252,38750,9901,4837,5064
32925,51015,12260,24634,10252,38754,9901,4837,5064
32930,51025,12262,24640,10253,38762,9903,4839,5064
32935,51031,12262,24641,10253,38769,9905,4840,5065
32940,51042,12262,24646,10253,38778,9907,4842,5065
32945,51046,12263,24649,10254,38782,9907,4842,5065
32950,51056,12265,24655,10256,38790,9909,4843,5066
32955,51062,12265,24658,10256,38797,9911,4844,5067
32960,51073,12266,24664,10257,38806,9913,4845,5068
32965,51077,12266,24666,10257,38811,9913,4845,5068
32970,51087,12268,24673,10258,38818,9915,4846,5069
32975,51093,12268,24675,10258,38824,9917,4846,5071
32980,51104,12269,24680,10259,38832,9919,4846,5073
32985,51108,12270,24682,10260,38838,9919,4846,5073
32990,51118,12274,24687,10263,38844,9921,4846,5075
32995,51124,12274,24689,10263,38849,9923,4846,5077
33000,51135,12276,24692,10264,38857,9925,4846,5079
33005,51139,12277,24692,10265,38862,9925,4846,5079
33010,51149,12279,24699,10267,38869,9927,4847,5080
33015,51155,12279,24702,10267,38876,9929,4848,5081
33020,51166,12281,24709,10268,38882,9931,4849,5082
33025,51170,12284,24713,10271,38885,9931,4849,5082
33030,51180,12288,24717,10274,38892,9933,4850,5083
33035,51186,12288,24719,10274,38898,9935,4851,5084
33040,51197,12292,24725,10278,38904,9937,4852,5085
33045,51201,12293,24726,10279,38907,9937,4852,5085
33050,51211,12298,24733,10284,38913,9939,4853,5086
33055,51217,12298,24736,10284,38918,9941,4854,5087
33060,51228,12301,24740,10287,38926,9943,4855,5088
33065,51232,12302,24741,10288,38930,9943,4855,5088
33070,51242,12306,24746,10291,38936,9945,4856,5089
33075,51248,12306,24749,10291,38942,9947,4857,5090
33080,51259,12307,24752,10291,38951,9949,4858,5091
33085,51263,12310,24756,10294,38951,9949,4858,5091
33090,51273,12316,24760,10299,38957,9951,4859,5092
33095,51279,12316,24765,10299,38961,9953,4861,5092
33100,51290,12322,24770,10304,38967,9955,4862,5093
33105,51294,12323,24771,10305,38970,9955,4862,5093
33110,51304,12327,24778,10309,38977,9957,4864,5093
33115,51310,12327,24781,10309,38982,9959,4866,5093
33120,51321,12330,24787,10312,38987,9961,4866,5095
33125,51325,12333,24790,10315,38992,9961,4866,5095
33130,51335,12335,24794,10316,38998,9963,4867,5096
33135,51341,12338,24798,10319,39001,9965,4868,5097
33140,51352,12340,24800,10321,39011,9967,4868,5099
33145,51356,12341,24803,10322,39015,9967,4868,5099
33150,51366,12343,24809,10324,39022,9969,4869,5100
33155,51372,12345,24810,10326,39027,9971,4869,5102
33160,51383,12346,24815,10326,39035,9973,4871,5102
33165,51387,12347,24816,10327,39040,9973,4871,5102
33170,51397,12350,24821,10330,39047,9975,4872,5103
33175,51403,12350,24822,10330,39053,9977,4873,5104
33180,51414,12352,24827,10332,39061,9979,4874,5105
33185,51418,12354,24829,10334,39063,9979,4874,5105
33190,51428,12357,24837,10336,39069,9981,4875,5106
33195,51434,12360,24841,10339,39073,9983,4877,5106
33200,51445,12362,24847,10340,39081,9985,4879,5106
33205,51449,12363,24848,10341,39086,9985,4879,5106
33210,51459,12364,24852,10342,39094,9987,4879,5108
33215,51465,12365,24854,10343,39099,9989,4880,5109
33220,51476,12368,24858,10346,39106,9991,4880,5111
33225,51480,12370,24860,10348,39109,9991,4880,5111
33230,51490,12373,24866,10351,39116,9993,4881,5112
33235,51496,12374,24867,10352,39122,9995,4882,5113
33240,51507,12378,24872,10355,39128,9997,4882,5115
33245,51511,12378,24873,10355,39132,9997,4882,5115
33250,51521,12381,24876,10357,39139,9999,4882,5117
33255,51527,12382,24877,10358,39145,10001,4883,5118
33260,51538,12385,24883,10361,39152,10003,4883,5120
33265,51542,12386,24886,10362,39156,10003,4883,5120
33270,51552,12388,24888,10362,39164,10005,4884,5121
33275,51558,12389,24892,10363,39169,10007,4886,5121
33280,51569,12391,24898,10365,39177,10009,4887,5122
33285,51573,12392,24900,10366,39181,10009,4887,5122
33290,51583,12396,24903,10368,39187,10011,4887,5124
33295,51589,12396,24907,10368,39191,10013,4888,5125
33300,51600,12401,24914,10373,39198,10015,4889,5126
33305,51604,12403,24916,10375,39200,10015,4889,5126
33310,51614,12405,24919,10376,39209,10017,4889,5128
33315,51620,12405,24921,10376,39214,10019,4890,5129
33320,51631,12407,24925,10378,39223,10021,4890,5131
33325,51635,12408,24926,10379,39227,10021,4890,5131
33330,51645,12410,24931,10380,39234,10023,4891,5132
33335,51651,12410,24934,10380,39240,10025,4892,5133
33340,51662,12412,24940,10382,39249,10027,4892,5135
33345,51666,12413,24941,10383,39253,10027,4892,5135
33350,51676,12415,24945,10384,39261,10029,4894,5135
33355,51682,12415,24948,10384,39265,10031,4895,5136
33360,51693,12418,24953,10387,39275,10033,4896,5137
33365,51697,12418,24956,10387,39277,10033,4896,5137
33370,51707,12421,24959,10389,39286,10035,4896,5139
33375,51713,12421,24961,10389,39291,10037,4897,5140
33380,51724,12423,24966,10391,39300,10039,4898,5141
33385,51728,12425,24969,10393,39301,10039,4898,5141
33390,51738,12429,24974,10396,39309,10041,4900,5141
33395,51744,12429,24977,10396,39313,10043,4901,5142
33400,51755,12429,24982,10396,39326,10045,4902,5143
33405,51759,12429,24984,10396,39330,10045,4902,5143
33410,51769,12432,24992,10399,39336,10047,4903,5144
33415,51775,12433,24995,10400,39342,10049,4905,5144
33420,51786,12435,25000,10401,39348,10051,4905,5146
33425,51790,12436,25002,10402,39353,10051,4905,5146
33430,51800,12437,25008,10403,39363,10053,4906,5147
33435,51806,12437,25009,10403,39369,10055,4906,5149
33440,51817,12438,25014,10404,39377,10057,4906,5151
33445,51821,12438,25016,10404,39382,10057,4906,5151
33450,51831,12440,25023,10405,39391,10059,4908,5151
33455,51837,12440,25028,10405,39397,10061,4910,5151
33460,51848,12443,25036,10407,39404,10063,4912,5151
33465,51852,12443,25038,10407,39409,10063,4912,5151
33470,51862,12444,25043,10408,39418,10065,4913,5152
33475,51868,12444,25045,10408,39424,10067,4913,5154
33480,51879,12446,25048,10409,39432,10069,4914,5155
33485,51883,12447,25050,10410,39436,10069,4914,5155
33490,51893,12449,25053,10411,39444,10071,4915,5156
33495,51899,12449,25057,10411,39450,10073,4917,5156
33500,51910,12451,25061,10412,39457,10075,4917,5158
33505,51914,12452,25064,10413,39462,10075,4917,5158
33510,51924,12454,25068,10415,39470,10077,4917,5160
33515,51930,12454,25072,10415,39475,10079,4918,5161
33520,51941,12457,25075,10417,39482,10081,4918,5163
33525,51945,12458,25077,10418,39487,10081,4918,5163
33530,51955,12460,25083,10419,39493,10083,4920,5163
33535,51961,12462,25085,10421,39499,10085,4921,5164
33540,51972,12465,25092,10424,39504,10087,4922,5165
33545,51976,12468,25094,10427,39508,10087,4922,5165
33550,51986,12470,25099,10427,39515,10089,4924,5165
33555,51992,12471,25101,10428,39520,10091,4924,5167
33560,52003,12474,25105,10431,39529,10093,4926,5167
33565,52007,12474,25106,10431,39532,10093,4926,5167
33570,52017,12478,25112,10434,39538,10095,4928,5167
33575,52023,12480,25116,10436,39541,10097,4928,5169
33580,52034,12486,25120,10441,39547,10099,4928,5171
33585,52038,12488,25122,10443,39549,10099,4928,5171
33590,52048,12493,25129,10448,39554,10101,4929,5172
33595,52054,12495,25133,10450,39558,10103,4931,5172
33600,52065,12497,25138,10452,39567,10105,4932,5173
33605,52069,12499,25140,10454,39569,10105,4932,5173
33610,52079,12504,25148,10459,39574,10107,4934,5173
33615,52085,12505,25151,10460,39580,10109,4936,5173
33620,52096,12507,25154,10461,39589,10111,4938,5173
33625,52100,12507,25155,10461,39592,10111,4938,5173
33630,52110,12512,25158,10464,39598,10113,4939,5174
33635,52116,12512,25159,10464,39604,10115,4939,5176
33640,52127,12514,25162,10465,39613,10117,4939,5178
33645,52131,12514,25163,10465,39616,10117,4939,5178
33650,52141,12518,25167,10468,39622,10119,4940,5179
33655,52147,12519,25170,10469,39627,10121,4942,5179
33660,52158,12524,25176,10473,39631,10123,4942,5181
33665,52162,12527,25177,10476,39634,10123,4942,5181
33670,52172,12532,25182,10481,39639,10125,4942,5183
33675,52178,12533,25185,10482,39643,10127,4943,5184
33680,52189,12538,25190,10487,39650,10129,4944,5185
33685,52193,12540,25192,10489,39652,10129,4944,5185
33690,52203,12542,25196,10490,39660,10131,4945,5186
33695,52209,12544,25198,10492,39665,10133,4946,5187
33700,52220,12547,25204,10495,39671,10135,4947,5188
33705,52224,12549,25208,10497,39674,10135,4947,5188
33710,52234,12551,25216,10499,39681,10137,4949,5188
33715,52240,12554,25218,10502,39686,10139,4950,5189
33720,52251,12555,25221,10503,39696,10141,4951,5190
33725,52255,12556,25224,10504,39698,10141,4951,5190
33730,52265,12559,25231,10506,39705,10143,4953,5190
33735,52271,12559,25232,10506,39712,10145,4954,5191
33740,52282,12561,25241,10508,39719,10147,4956,5191
33745,52286,12562,25243,10509,39723,10147,4956,5191
33750,52296,12565,25250,10511,39730,10149,4958,5191
33755,52302,12565,25255,10511,39736,10151,4959,5192
33760,52313,12566,25261,10512,39746,10153,4960,5193
33765,52317,12566,25262,10512,39751,10153,4960,5193
33770,52327,12569,25266,10515,39758,10155,4960,5195
33775,52333,12569,25269,10515,39763,10157,4961,5196
33780,52344,12571,25272,10516,39772,10159,4962,5197
33785,52348,12572,25274,10517,39776,10159,4962,5197
33790,52358,12575,25280,10519,39782,10161,4963,5198
33795,52364,12575,25281,10519,39789,10163,4963,5200
33800,52375,12578,25286,10521,39797,10165,4964,5201
33805,52379,12579,25288,10522,39800,10165,4964,5201
33810,52389,12582,25293,10524,39806,10167,4965,5202
33815,52395,12582,25296,10524,39812,10169,4966,5203
33820,52406,12584,25301,10525,39820,10171,4967,5204
33825,52410,12584,25303,10525,39825,10171,4967,5204
33830,52420,12587,25307,10526,39833,10173,4967,5206
33835,52426,12587,25309,10526,39839,10175,4968,5207
33840,52437,12589,25314,10528,39847,10177,4970,5207
33845,52441,12590,25314,10529,39851,10177,4970,5207
33850,52451,12594,25318,10531,39857,10179,4971,5208
33855,52457,12594,25321,10531,39862,10181,4971,5210
33860,52468,12598,25327,10535,39868,10183,4972,5211
33865,52472,12601,25328,10538,39871,10183,4972,5211
33870,52482,12606,25334,10543,39876,10185,4973,5212
33875,52488,12606,25336,10543,39881,10187,4973,5214
33880,52499,12612,25343,10549,39885,10189,4973,5216
33885,52503,12614,25344,10551,39889,10189,4973,5216
33890,52513,12616,25347,10552,39897,10191,4973,5218
33895,52519,12616,25350,10552,39902,10193,4974,5219
33900,52530,12618,25357,10554,39909,10195,4975,5220
33905,52534,12621,25358,10557,39913,10195,4975,5220
33910,52544,12623,25359,10557,39921,10197,4976,5221
33915,52550,12623,25361,10557,39926,10199,4977,5222
33920,52561,12625,25366,10559,39934,10201,4979,5222
33925,52565,12627,25367,10561,39937,10201,4979,5222
33930,52575,12631,25373,10563,39942,10203,4980,5223
33935,52581,12633,25373,10565,39948,10205,4980,5225
33940,52592,12634,25379,10566,39956,10207,4981,5226
33945,52596,12636,25381,10568,39959,10207,4981,5226
33950,52606,12640,25387,10571,39965,10209,4982,5227
33955,52612,12641,25390,10572,39969,10211,4983,5228
33960,52623,12643,25395,10574,39979,10213,4984,5229
33965,52627,12643,25397,10574,39984,10213,4984,5229
33970,52637,12644,25403,10574,39992,10215,4986,5229
33975,52643,12645,25403,10575,39998,10217,4986,5231
33980,52654,12645,25406,10575,40007,10219,4986,5233
33985,52658,12646,25406,10576,40012,10219,4986,5233
33990,52668,12649,25412,10578,40018,10221,4987,5234
33995,52674,12650,25415,10579,40023,10223,4988,5235
34000,52685,12654,25420,10583,40031,10225,4988,5237
34005,52689,12655,25421,10584,40034,10225,4988,5237
34010,52699,12657,25426,10586,40041,10227,4988,5239
34015,52705,12658,25427,10587,40047,10229,4989,5240
34020,52716,12661,25431,10589,40054,10231,4990,5241
34025,52720,12661,25431,10589,40059,10231,4990,5241
34030,52730,12663,25435,10590,40066,10233,4990,5243
34035,52736,12664,25437,10591,40071,10235,4991,5244
34040,52747,12668,25444,10594,40077,10237,4992,5245
34045,52751,12669,25446,10595,40081,10237,4992,5245
34050,52761,12671,25453,10597,40089,10239,4993,5246
34055,52767,12671,25456,10597,40095,10241,4994,5247
34060,52778,12674,25461,10599,40103,10243,4995,5248
34065,52782,12674,25463,10599,40107,10243,4995,5248
34070,52792,12676,25467,10600,40115,10245,4996,5249
34075,52798,12676,25472,10600,40120,10247,4998,5249
34080,52809,12679,25477,10603,40129,10249,4999,5250
34085,52813,12681,25480,10605,40130,10249,4999,5250
34090,52823,12685,25483,10608,40138,10251,5000,5251
34095,52829,12685,25485,10608,40142,10253,5000,5253
34100,52840,12689,25492,10612,40150,10255,5002,5253
34105,52844,12692,25495,10615,40151,10255,5002,5253
34110,52854,12695,25499,10618,40159,10257,5004,5253
34115,52860,12695,25502,10618,40164,10259,5006,5253
34120,52871,12699,25507,10622,40170,10261,5006,5255
34125,52875,12702,25509,10625,40172,10261,5006,5255
34130,52885,12707,25515,10629,40177,10263,5007,5256
34135,52891,12707,25519,10629,40181,10265,5008,5257
34140,52902,12711,25525,10633,40190,10267,5009,5258
34145,52906,12712,25529,10634,40194,10267,5009,5258
34150,52916,12713,25531,10634,40202,10269,5010,5259
34155,52922,12715,25535,10636,40206,10271,5011,5260
34160,52933,12717,25538,10637,40215,10273,5012,5261
34165,52937,12719,25539,10639,40218,10273,5012,5261
34170,52947,12721,25545,10640,40224,10275,5013,5262
34175,52953,12724,25548,10643,40228,10277,5013,5264
34180,52964,12728,25553,10646,40234,10279,5013,5266
34185,52968,12729,25553,10647,40239,10279,5013,5266
34190,52978,12731,25557,10649,40247,10281,5014,5267
34195,52984,12731,25560,10649,40253,10283,5015,5268
34200,52995,12733,25566,10651,40261,10285,5016,5269
34205,52999,12734,25568,10652,40265,10285,5016,5269
34210,53009,12735,25575,10652,40274,10287,5017,5270
34215,53015,12735,25576,10652,40280,10289,5017,5272
34220,53026,12736,25583,10653,40290,10291,5017,5274
34225,53030,12736,25586,10653,40294,10291,5017,5274
34230,53040,12737,25593,10653,40303,10293,5019,5274
34235,53046,12737,25597,10653,40309,10295,5021,5274
34240,53057,12738,25603,10654,40319,10297,5021,5276
34245,53061,12738,25605,10654,40322,10297,5021,5276
34250,53071,12741,25609,10656,40330,10299,5022,5277
34255,53077,12741,25611,10656,40336,10301,5023,5278
34260,53088,12742,25616,10657,40345,10303,5024,5279
34265,53092,12744,25619,10659,40348,10303,5024,5279
34270,53102,12747,25623,10660,40355,10305,5026,5279
34275,53108,12747,25628,10660,40360,10307,5028,5279
34280,53119,12748,25632,10661,40371,10309,5030,5279
34285,53123,12749,25634,10662,40374,10309,5030,5279
34290,53133,12752,25638,10665,40380,10311,5030,5281
34295,53139,12753,25640,10666,40385,10313,5030,5283
34300,53150,12754,25644,10667,40395,10315,5031,5284
34305,53154,12755,25644,10668,40399,10315,5031,5284
34310,53164,12758,25650,10670,40405,10317,5033,5284
34315,53170,12760,25652,10672,40410,10319,5034,5285
34320,53181,12763,25657,10675,40416,10321,5034,5287
34325,53185,12766,25658,10678,40419,10321,5034,5287
34330,53195,12769,25660,10679,40425,10323,5034,5289
34335,53201,12771,25665,10681,40428,10325,5036,5289
34340,53212,12774,25671,10684,40435,10327,5038,5289
34345,53216,12779,25675,10689,40435,10327,5038,5289
34350,53226,12786,25681,10695,40438,10329,5038,5291
34355,53232,12788,25684,10697,40443,10331,5040,5291
34360,53243,12793,25690,10702,40449,10333,5040,5293
34365,53247,12794,25692,10703,40451,10333,5040,5293
34370,53257,12799,25698,10707,40457,10335,5041,5294
34375,53263,12799,25700,10707,40463,10337,5041,5296
34380,53274,12801,25706,10708,40471,10339,5043,5296
34385,53278,12801,25708,10708,40476,10339,5043,5296
34390,53288,12803,25711,10710,40485,10341,5044,5297
34395,53294,12803,25713,10710,40490,10343,5045,5298
34400,53305,12804,25718,10710,40500,10345,5046,5299
34405,53309,12805,25722,10711,40503,10345,5046,5299
34410,53319,12806,25726,10711,40513,10347,5048,5299
34415,53325,12806,25730,10711,40518,10349,5050,5299
34420,53336,12808,25737,10713,40527,10351,5052,5299
34425,53340,12809,25739,10714,40531,10351,5052,5299
34430,53350,12812,25746,10716,40538,10353,5054,5299
34435,53356,12812,25748,10716,40544,10355,5055,5300
34440,53367,12814,25753,10717,40552,10357,5057,5300
34445,53371,12814,25756,10717,40556,10357,5057,5300
34450,53381,12816,25759,10718,40564,10359,5057,5302
34455,53387,12816,25761,10718,40571,10361,5058,5303
34460,53398,12818,25763,10719,40580,10363,5058,5305
34465,53402,12819,25766,10720,40582,10363,5058,5305
34470,53412,12822,25770,10723,40590,10365,5059,5306
34475,53418,12823,25772,10724,40595,10367,5060,5307
34480,53429,12824,25774,10724,40604,10369,5060,5309
34485,53433,12824,25774,10724,40609,10369,5060,5309
34490,53443,12828,25781,10728,40614,10371,5061,5310
34495,53449,12830,25785,10730,40618,10373,5062,5311
34500,53460,12832,25790,10731,40625,10375,5063,5312
34505,53464,12833,25791,10732,40631,10375,5063,5312
34510,53474,12836,25796,10734,40638,10377,5065,5312
34515,53480,12837,25800,10735,40641,10379,5066,5313
34520,53491,12843,25808,10740,40644,10381,5067,5314
34525,53495,12849,25810,10746,40646,10381,5067,5314
34530,53505,12854,25816,10751,40651,10383,5068,5315
34535,53511,12854,25820,10751,40654,10385,5069,5316
34540,53522,12858,25825,10755,40662,10387,5071,5316
34545,53526,12862,25827,10759,40664,10387,5071,5316
34550,53536,12864,25831,10760,40671,10389,5073,5316
34555,53542,12865,25833,10761,40676,10391,5074,5317
34560,53553,12869,25840,10765,40682,10393,5076,5317
34565,53557,12871,25842,10767,40685,10393,5076,5317
34570,53567,12874,25849,10770,40692,10395,5077,5318
34575,53573,12875,25852,10771,40697,10397,5078,5319
34580,53584,12877,25857,10773,40707,10399,5079,5320
34585,53588,12878,25858,10774,40710,10399,5079,5320
34590,53598,12880,25860,10775,40718,10401,5079,5322
34595,53604,12880,25861,10775,40724,10403,5080,5323
34600,53615,12882,25868,10777,40732,10405,5081,5324
34605,53619,12883,25869,10778,40736,10405,5081,5324
34610,53629,12885,25871,10779,40744,10407,5082,5325
34615,53635,12885,25872,10779,40749,10409,5082,5327
34620,53646,12889,25882,10783,40756,10411,5084,5327
34625,53650,12890,25886,10784,40760,10411,5084,5327
34630,53660,12891,25890,10784,40769,10413,5084,5329
34635,53666,12891,25893,10784,40774,10415,5084,5331
34640,53677,12893,25899,10786,40784,10417,5085,5332
34645,53681,12893,25901,10786,40788,10417,5085,5332
34650,53691,12894,25907,10787,40795,10419,5086,5333
34655,53697,12896,25912,10789,40800,10421,5088,5333
34660,53708,12897,25916,10790,40810,10423,5088,5335
34665,53712,12898,25918,10791,40814,10423,5088,5335
34670,53722,12900,25925,10793,40820,10425,5088,5337
34675,53728,12903,25929,10796,40824,10427,5089,5338
34680,53739,12906,25936,10798,40832,10429,5090,5339
34685,53743,12906,25939,10798,40836,10429,5090,5339
34690,53753,12907,25945,10799,40846,10431,5090,5341
34695,53759,12907,25948,10799,40851,10433,5091,5342
34700,53770,12909,25953,10801,40861,10435,5092,5343
34705,53774,12910,25956,10802,40863,10435,5092,5343
34710,53784,12912,25963,10804,40872,10437,5093,5344
34715,53790,12912,25964,10804,40878,10439,5094,5345
34720,53801,12914,25969,10805,40886,10441,5094,5347
34725,53805,12915,25972,10806,40890,10441,5094,5347
34730,53815,12916,25978,10807,40899,10443,5095,5348
34735,53821,12916,25980,10807,40904,10445,5095,5350
34740,53832,12920,25984,10810,40912,10447,5095,5352
34745,53836,12920,25984,10810,40916,10447,5095,5352
34750,53846,12922,25990,10811,40924,10449,5097,5352
34755,53852,12922,25991,10811,40930,10451,5097,5354
34760,53863,12924,25999,10812,40936,10453,5098,5355
34765,53867,12925,26001,10813,40941,10453,5098,5355
34770,53877,12928,26005,10816,40949,10455,5098,5357
34775,53883,12928,26008,10816,40955,10457,5099,5358
34780,53894,12931,26014,10819,40963,10459,5100,5359
34785,53898,12931,26015,10819,40967,10459,5100,5359
34790,53908,12934,26018,10820,40973,10461,5100,5361
34795,53914,12936,26020,10822,40978,10463,5101,5362
34800,53925,12938,26025,10823,40985,10465,5103,5362
34805,53929,12939,26025,10824,40990,10465,5103,5362
34810,53939,12942,26030,10826,40997,10467,5105,5362
34815,53945,12943,26032,10827,41001,10469,5105,5364
34820,53956,12947,26037,10830,41007,10471,5106,5365
34825,53960,12950,26040,10833,41008,10471,5106,5365
34830,53970,12955,26042,10837,41015,10473,5106,5367
34835,53976,12955,26042,10837,41021,10475,5106,5369
34840,53987,12958,26047,10840,41029,10477,5108,5369
34845,53991,12959,26049,10841,41031,10477,5108,5369
34850,54001,12966,26054,10846,41034,10479,5108,5371
34855,54007,12967,26056,10847,41040,10481,5110,5371
34860,54018,12970,26062,10849,41046,10483,5112,5371
34865,54022,12973,26064,10852,41048,10483,5112,5371
34870,54032,12975,26066,10853,41057,10485,5112,5373
34875,54038,12976,26069,10854,41062,10487,5113,5374
34880,54049,12978,26074,10855,41070,10489,5113,5376
34885,54053,12979,26077,10856,41073,10489,5113,5376
34890,54063,12980,26083,10857,41081,10491,5115,5376
34895,54069,12982,26085,10859,41085,10493,5115,5378
34900,54080,12986,26092,10863,41091,10495,5116,5379
34905,54084,12987,26094,10864,41097,10495,5116,5379
34910,54094,12989,26100,10866,41104,10497,5117,5380
34915,54100,12990,26103,10867,41109,10499,5118,5381
34920,54111,12993,26107,10869,41117,10501,5119,5382
34925,54115,12994,26110,10870,41120,10501,5119,5382
34930,54125,12997,26117,10873,41127,10503,5121,5382
34935,54131,12998,26117,10874,41133,10505,5121,5384
34940,54142,13000,26122,10876,41139,10507,5121,5386
34945,54146,13001,26124,10877,41144,10507,5121,5386
34950,54156,13003,26129,10878,41151,10509,5122,5387
34955,54162,13005,26133,10880,41156,10511,5123,5388
34960,54173,13008,26139,10883,41164,10513,5124,5389
34965,54177,13009,26141,10884,41167,10513,5124,5389
34970,54187,13009,26143,10884,41178,10515,5125,5390
34975,54193,13009,26146,10884,41182,10517,5125,5392
34980,54204,13012,26152,10887,41192,10519,5127,5392
34985,54208,13013,26154,10888,41195,10519,5127,5392
34990,54218,13015,26160,10890,41202,10521,5128,5393
34995,54224,13015,26164,10890,41208,10523,5130,5393
35000,54235,13018,26167,10892,41216,10525,5130,5395
35005,54239,13018,26168,10892,41221,10525,5130,5395
35010,54249,13020,26173,10894,41228,10527,5130,5397
35015,54255,13020,26175,10894,41234,10529,5131,5398
35020,54266,13023,26181,10897,41241,10531,5131,5400
35025,54270,13025,26182,10899,41244,10531,5131,5400
35030,54280,13030,26187,10903,41249,10533,5131,5402
35035,54286,13030,26191,10903,41254,10535,5133,5402
35040,54297,13032,26193,10904,41264,10537,5133,5404
35045,54301,13035,26196,10907,41265,10537,5133,5404
35050,54311,13039,26199,10910,41272,10539,5133,5406
35055,54317,13039,26202,10910,41278,10541,5135,5406
35060,54328,13042,26207,10912,41284,10543,5135,5408
35065,54332,13042,26208,10912,41290,10543,5135,5408
35070,54342,13046,26214,10914,41296,10545,5137,5408
35075,54348,13046,26217,10914,41301,10547,5137,5410
35080,54359,13049,26223,10917,41309,10549,5139,5410
35085,54363,13049,26224,10917,41314,10549,5139,5410
35090,54373,13051,26226,10918,41322,10551,5139,5412
35095,54379,13051,26230,10918,41328,10553,5141,5412
35100,54390,13053,26234,10919,41336,10555,5143,5412
35105,54394,13054,26234,10920,41340,10555,5143,5412
35110,54404,13057,26240,10923,41347,10557,5144,5413
35115,54410,13057,26243,10923,41353,10559,5146,5413
35120,54421,13058,26246,10923,41361,10561,5147,5414
35125,54425,13060,26247,10925,41365,10561,5147,5414
35130,54435,13062,26250,10926,41373,10563,5148,5415
35135,54441,13062,26253,10926,41378,10565,5148,5417
35140,54452,13067,26260,10931,41384,10567,5150,5417
35145,54456,13070,26263,10934,41386,10567,5150,5417
35150,54466,13073,26269,10936,41391,10569,5151,5418
35155,54472,13075,26271,10938,41396,10571,5152,5419
35160,54483,13079,26280,10942,41400,10573,5154,5419
35165,54487,13083,26281,10946,41404,10573,5154,5419
35170,54497,13084,26283,10946,41412,10575,5155,5420
35175,54503,13085,26286,10947,41417,10577,5156,5421
35180,54514,13087,26291,10948,41425,10579,5157,5422
35185,54518,13087,26294,10948,41430,10579,5157,5422
35190,54528,13090,26300,10951,41437,10581,5157,5424
35195,54534,13092,26303,10953,41441,10583,5158,5425
35200,54545,13094,26305,10954,41451,10585,5159,5426
35205,54549,13094,26306,10954,41455,10585,5159,5426
35210,54559,13096,26309,10955,41463,10587,5160,5427
35215,54565,13097,26313,10956,41468,10589,5161,5428
35220,54576,13098,26316,10957,41478,10591,5162,5429
35225,54580,13099,26317,10958,41481,10591,5162,5429
35230,54590,13102,26324,10961,41487,10593,5163,5430
35235,54596,13103,26327,10962,41493,10595,5165,5430
35240,54607,13106,26332,10964,41501,10597,5165,5432
35245,54611,13106,26333,10964,41505,10597,5165,5432
35250,54621,13107,26336,10965,41513,10599,5165,5434
35255,54627,13109,26339,10967,41518,10601,5166,5435
35260,54638,13111,26343,10969,41527,10603,5166,5437
35265,54642,13112,26346,10970,41530,10603,5166,5437
35270,54652,13113,26349,10970,41538,10605,5167,5438
35275,54658,13115,26353,10972,41542,10607,5168,5439
35280,54669,13118,26359,10975,41549,10609,5168,5441
35285,54673,13121,26361,10978,41552,10609,5168,5441
35290,54683,13124,26366,10979,41558,10611,5170,5441
35295,54689,13126,26372,10981,41560,10613,5172,5441
35300,54700,13131,26375,10985,41569,10615,5174,5441
35305,54704,13133,26377,10987,41571,10615,5174,5441
35310,54714,13138,26382,10991,41575,10617,5174,5443
35315,54720,13139,26383,10992,41580,10619,5174,5445
35320,54731,13143,26388,10996,41587,10621,5175,5446
35325,54735,13145,26391,10998,41588,10621,5175,5446
35330,54745,13150,26395,11002,41594,10623,5176,5447
35335,54751,13151,26397,11003,41598,10625,5176,5449
35340,54762,13155,26403,11007,41606,10627,5178,5449
35345,54766,13156,26405,11008,41608,10627,5178,5449
35350,54776,13159,26408,11010,41617,10629,5179,5450
35355,54782,13159,26410,11010,41622,10631,5180,5451
35360,54793,13161,26415,11012,41632,10633,5181,5452
35365,54797,13161,26415,11012,41636,10633,5181,5452
35370,54807,13162,26418,11012,41644,10635,5182,5453
35375,54813,13162,26420,11012,41650,10637,5183,5454
35380,54824,13163,26427,11013,41659,10639,5184,5455
35385,54828,13166,26429,11016,41661,10639,5184,5455
35390,54838,13169,26434,11018,41668,10641,5184,5457
35395,54844,13169,26436,11018,41674,10643,5184,5459
35400,54855,13169,26442,11018,41685,10645,5185,5460
35405,54859,13169,26445,11018,41689,10645,5185,5460
35410,54869,13169,26450,11018,41700,10647,5187,5460
35415,54875,13169,26454,11018,41705,10649,5188,5461
35420,54886,13169,26460,11018,41717,10651,5188,5463
35425,54890,13169,26463,11018,41721,10651,5188,5463
35430,54900,13169,26468,11018,41731,10653,5189,5464
35435,54906,13169,26472,11018,41736,10655,5190,5465
35440,54917,13170,26478,11018,41747,10657,5192,5465
35445,54921,13170,26479,11018,41751,10657,5192,5465
35450,54931,13172,26481,11019,41759,10659,5193,5466
35455,54937,13172,26483,11019,41765,10661,5194,5467
35460,54948,13173,26486,11019,41775,10663,5195,5468
35465,54952,13174,26490,11020,41777,10663,5195,5468
35470,54962,13177,26497,11023,41785,10665,5197,5468
35475,54968,13177,26503,11023,41790,10667,5199,5468
35480,54979,13179,26510,11024,41799,10669,5200,5469
35485,54983,13179,26510,11024,41804,10669,5200,5469
35490,54993,13181,26515,11026,41812,10671,5201,5470
35495,54999,13181,26520,11026,41817,10673,5203,5470
35500,55010,13185,26525,11029,41824,10675,5203,5472
35505,55014,13187,26528,11031,41825,10675,5203,5472
35510,55024,13191,26533,11035,41833,10677,5204,5473
35515,55030,13191,26535,11035,41839,10679,5204,5475
35520,55041,13195,26542,11039,41845,10681,5205,5476
35525,55045,13197,26545,11041,41847,10681,5205,5476
35530,55055,13199,26548,11041,41855,10683,5206,5477
35535,55061,13201,26553,11043,41858,10685,5208,5477
35540,55072,13205,26560,11047,41863,10687,5209,5478
35545,55076,13207,26561,11049,41868,10687,5209,5478
35550,55086,13211,26567,11051,41873,10689,5210,5479
35555,55092,13214,26570,11054,41878,10691,5211,5480
35560,55103,13216,26576,11055,41885,10693,5213,5480
35565,55107,13217,26578,11056,41890,10693,5213,5480
35570,55117,13220,26583,11057,41896,10695,5215,5480
35575,55123,13221,26584,11058,41902,10697,5216,5481
35580,55134,13224,26588,11060,41909,10699,5216,5483
35585,55138,13225,26589,11061,41912,10699,5216,5483
35590,55148,13228,26596,11064,41918,10701,5216,5485
35595,55154,13231,26599,11067,41922,10703,5216,5487
35600,55165,13234,26602,11070,41931,10705,5217,5488
35605,55169,13235,26603,11071,41934,10705,5217,5488
35610,55179,13238,26607,11073,41940,10707,5217,5490
35615,55185,13239,26608,11074,41945,10709,5217,5492
35620,55196,13244,26616,11078,41949,10711,5219,5492
35625,55200,13248,26618,11082,41951,10711,5219,5492
35630,55210,13252,26620,11085,41958,10713,5219,5494
35635,55216,13252,26623,11085,41962,10715,5220,5495
35640,55227,13258,26628,11090,41968,10717,5221,5496
35645,55231,13260,26629,11092,41971,10717,5221,5496
35650,55241,13263,26632,11094,41978,10719,5222,5497
35655,55247,13264,26634,11095,41982,10721,5222,5499
35660,55258,13268,26638,11098,41990,10723,5223,5500
35665,55262,13268,26638,11098,41994,10723,5223,5500
35670,55272,13270,26645,11100,42000,10725,5224,5501
35675,55278,13273,26647,11103,42005,10727,5224,5503
35680,55289,13275,26657,11105,42011,10729,5226,5503
35685,55293,13277,26660,11107,42015,10729,5226,5503
35690,55303,13279,26664,11108,42024,10731,5226,5505
35695,55309,13279,26668,11108,42028,10733,5227,5506
35700,55320,13281,26672,11110,42039,10735,5229,5506
35705,55324,13282,26675,11111,42041,10735,5229,5506
35710,55334,13284,26678,11112,42050,10737,5230,5507
35715,55340,13285,26682,11113,42053,10739,5230,5509
35720,55351,13288,26687,11115,42061,10741,5230,5511
35725,55355,13290,26688,11117,42065,10741,5230,5511
35730,55365,13291,26690,11118,42074,10743,5230,5513
35735,55371,13291,26692,11118,42080,10745,5231,5514
35740,55382,13293,26698,11119,42089,10747,5232,5515
35745,55386,13293,26699,11119,42093,10747,5232,5515
35750,55396,13294,26703,11120,42101,10749,5232,5517
35755,55402,13294,26707,11120,42108,10751,5233,5518
35760,55413,13295,26710,11120,42118,10753,5234,5519
35765,55417,13296,26713,11121,42120,10753,5234,5519
35770,55427,13299,26719,11124,42128,10755,5235,5520
35775,55433,13299,26724,11124,42132,10757,5237,5520
35780,55444,13303,26731,11127,42139,10759,5239,5520
35785,55448,13303,26732,11127,42145,10759,5239,5520
35790,55458,13305,26737,11129,42152,10761,5240,5521
35795,55464,13305,26740,11129,42157,10763,5241,5522
35800,55475,13309,26745,11133,42165,10765,5241,5524
35805,55479,13310,26747,11134,42169,10765,5241,5524
35810,55489,13312,26753,11135,42177,10767,5243,5524
35815,55495,13312,26755,11135,42183,10769,5244,5525
35820,55506,13314,26763,11137,42190,10771,5245,5526
35825,55510,13316,26765,11139,42194,10771,5245,5526
35830,55520,13318,26767,11139,42202,10773,5245,5528
35835,55526,13318,26769,11139,42206,10775,5245,5530
35840,55537,13322,26774,11143,42214,10777,5245,5532
35845,55541,13324,26778,11145,42215,10777,5245,5532
35850,55551,13329,26781,11148,42222,10779,5245,5534
35855,55557,13329,26784,11148,42227,10781,5245,5536
35860,55568,13333,26788,11152,42235,10783,5245,5538
35865,55572,13334,26790,11153,42238,10783,5245,5538
35870,55582,13337,26794,11154,42245,10785,5246,5539
35875,55588,13337,26796,11154,42251,10787,5247,5540
35880,55599,13338,26801,11155,42259,10789,5247,5542
35885,55603,13341,26804,11158,42261,10789,5247,5542
35890,55613,13344,26810,11160,42269,10791,5248,5543
35895,55619,13344,26814,11160,42274,10793,5249,5544
35900,55630,13345,26818,11161,42285,10795,5249,5546
35905,55634,13345,26820,11161,42289,10795,5249,5546
35910,55644,13346,26824,11162,42298,10797,5250,5547
35915,55650,13346,26826,11162,42304,10799,5250,5549
35920,55661,13346,26831,11162,42314,10801,5250,5551
35925,55665,13346,26833,11162,42319,10801,5250,5551
35930,55675,13348,26837,11164,42326,10803,5250,5553
35935,55681,13349,26837,11165,42332,10805,5250,5555
35940,55692,13351,26842,11167,42340,10807,5251,5556
35945,55696,13352,26844,11168,42344,10807,5251,5556
35950,55706,13353,26847,11168,42352,10809,5253,5556
35955,55712,13354,26849,11169,42358,10811,5253,5558
35960,55723,13356,26854,11170,42365,10813,5254,5559
35965,55727,13357,26855,11171,42370,10813,5254,5559
35970,55737,13358,26858,11171,42377,10815,5255,5560
35975,55743,13361,26862,11174,42381,10817,5256,5561
35980,55754,13364,26866,11176,42389,10819,5257,5562
35985,55758,13366,26869,11178,42392,10819,5257,5562
35990,55768,13368,26874,11179,42400,10821,5259,5562
35995,55774,13369,26879,11180,42404,10823,5261,5562
36000,55785,13373,26884,11184,42410,10825,5261,5564
36005,55789,13374,26886,11185,42415,10825,5261,5564
36010,55799,13378,26891,11188,42421,10827,5262,5565
36015,55805,13378,26894,11188,42426,10829,5263,5566
36020,55816,13381,26899,11190,42434,10831,5265,5566
36025,55820,13382,26901,11191,42438,10831,5265,5566
36030,55830,13386,26907,11193,42443,10833,5267,5566
36035,55836,13388,26910,11195,42447,10835,5267,5568
36040,55847,13391,26914,11198,42454,10837,5267,5570
36045,55851,13392,26915,11199,42459,10837,5267,5570
36050,55861,13395,26920,11201,42464,10839,5267,5572
36055,55867,13397,26922,11203,42469,10841,5268,5573
36060,55878,13401,26928,11206,42475,10843,5270,5573
36065,55882,13403,26931,11208,42478,10843,5270,5573
36070,55892,13407,26935,11212,42484,10845,5270,5575
36075,55898,13408,26939,11213,42488,10847,5272,5575
36080,55909,13415,26947,11220,42492,10849,5273,5576
36085,55913,13416,26947,11221,42497,10849,5273,5576
36090,55923,13418,26950,11222,42505,10851,5273,5578
36095,55929,13418,26951,11222,42511,10853,5274,5579
36100,55940,13420,26956,11223,42518,10855,5276,5579
36105,55944,13421,26957,11224,42523,10855,5276,5579
36110,55954,13423,26963,11226,42530,10857,5277,5580
36115,55960,13423,26966,11226,42536,10859,5278,5581
36120,55971,13426,26970,11228,42544,10861,5279,5582
36125,55975,13428,26971,11230,42547,10861,5279,5582
36130,55985,13431,26975,11232,42553,10863,5279,5584
36135,55991,13431,26979,11232,42558,10865,5280,5585
36140,56002,13436,26983,11236,42565,10867,5281,5586
36145,56006,13438,26985,11238,42567,10867,5281,5586
36150,56016,13440,26987,11239,42576,10869,5282,5587
36155,56022,13440,26990,11239,42581,10871,5284,5587
36160,56033,13442,26994,11241,42589,10873,5284,5589
36165,56037,13444,26996,11243,42591,10873,5284,5589
36170,56047,13447,26998,11245,42599,10875,5284,5591
36175,56053,13447,27000,11245,42605,10877,5284,5593
36180,56064,13450,27003,11248,42614,10879,5285,5594
36185,56068,13450,27005,11248,42617,10879,5285,5594
36190,56078,13452,27009,11249,42626,10881,5286,5595
36195,56084,13452,27014,11249,42631,10883,5287,5596
36200,56095,13454,27018,11250,42639,10885,5288,5597
36205,56099,13455,27020,11251,42643,10885,5288,5597
36210,56109,13458,27026,11253,42651,10887,5289,5598
36215,56115,13458,27029,11253,42656,10889,5290,5599
36220,56126,13460,27034,11254,42665,10891,5291,5600
36225,56130,13461,27036,11255,42668,10891,5291,5600
36230,56140,13462,27037,11255,42678,10893,5291,5602
36235,56146,13462,27038,11255,42684,10895,5292,5603
36240,56157,13464,27042,11256,42693,10897,5293,5604
36245,56161,13465,27045,11257,42696,10897,5293,5604
36250,56171,13468,27050,11259,42703,10899,5294,5605
36255,56177,13468,27053,11259,42709,10901,5295,5606
36260,56188,13469,27059,11260,42717,10903,5296,5607
36265,56192,13470,27062,11261,42722,10903,5296,5607
36270,56202,13472,27068,11263,42730,10905,5296,5609
36275,56208,13472,27072,11263,42736,10907,5298,5609
36280,56219,13474,27076,11264,42745,10909,5299,5610
36285,56223,13474,27078,11264,42748,10909,5299,5610
36290,56233,13477,27082,11265,42756,10911,5301,5610
36295,56239,13478,27086,11266,42760,10913,5302,5611
36300,56250,13482,27091,11269,42766,10915,5303,5612
36305,56254,13485,27095,11272,42768,10915,5303,5612
36310,56264,13489,27101,11275,42774,10917,5304,5613
36315,56270,13491,27104,11277,42778,10919,5305,5614
36320,56281,13494,27110,11279,42784,10921,5306,5615
36325,56285,13496,27111,11281,42789,10921,5306,5615
36330,56295,13499,27114,11282,42795,10923,5307,5616
36335,56301,13501,27116,11284,42800,10925,5308,5617
36340,56312,13503,27119,11285,42807,10927,5308,5619
36345,56316,13505,27122,11287,42810,10927,5308,5619
36350,56326,13507,27127,11288,42818,10929,5310,5619
36355,56332,13508,27129,11289,42823,10931,5311,5620
36360,56343,13511,27136,11292,42828,10933,5312,5621
36365,56347,13513,27137,11294,42833,10933,5312,5621
36370,56357,13516,27143,11296,42840,10935,5313,5622
36375,56363,13517,27145,11297,42846,10937,5314,5623
36380,56374,13517,27150,11297,42854,10939,5315,5624
36385,56378,13518,27151,11298,42859,10939,5315,5624
36390,56388,13521,27156,11300,42867,10941,5317,5624
36395,56394,13522,27160,11301,42871,10943,5319,5624
36400,56405,13524,27165,11303,42880,10945,5321,5624
36405,56409,13525,27167,11304,42884,10945,5321,5624
36410,56419,13527,27172,11304,42891,10947,5323,5624
36415,56425,13529,27176,11306,42894,10949,5323,5626
36420,56436,13534,27183,11311,42900,10951,5324,5627
36425,56440,13536,27186,11313,42903,10951,5324,5627
36430,56450,13539,27193,11315,42910,10953,5325,5628
36435,56456,13539,27195,11315,42917,10955,5325,5630
36440,56467,13541,27204,11317,42924,10957,5327,5630
36445,56471,13542,27205,11318,42929,10957,5327,5630
36450,56481,13546,27210,11321,42934,10959,5328,5631
36455,56487,13546,27211,11321,42941,10961,5328,5633
36460,56498,13547,27215,11322,42949,10963,5328,5635
36465,56502,13548,27218,11323,42952,10963,5328,5635
36470,56512,13554,27224,11327,42957,10965,5330,5635
36475,56518,13554,27227,11327,42962,10967,5330,5637
36480,56529,13558,27235,11331,42969,10969,5332,5637
36485,56533,13558,27236,11331,42975,10969,5332,5637
36490,56543,13561,27241,11334,42982,10971,5332,5639
36495,56549,13561,27244,11334,42988,10973,5334,5639
36500,56560,13563,27248,11335,42997,10975,5336,5639
36505,56564,13563,27250,11335,43001,10975,5336,5639
36510,56574,13565,27255,11337,43009,10977,5338,5639
36515,56580,13565,27258,11337,43015,10979,5339,5640
36520,56591,13567,27265,11339,43024,10981,5341,5640
36525,56595,13568,27267,11340,43027,10981,5341,5640
36530,56605,13570,27273,11342,43033,10983,5341,5642
36535,56611,13572,27277,11344,43038,10985,5343,5642
36540,56622,13575,27282,11346,43047,10987,5344,5643
36545,56626,13575,27283,11346,43051,10987,5344,5643
36550,56636,13577,27289,11347,43058,10989,5345,5644
36555,56642,13579,27293,11349,43063,10991,5347,5644
36560,56653,13580,27295,11349,43072,10993,5347,5646
36565,56657,13581,27297,11350,43076,10993,5347,5646
36570,56667,13583,27303,11352,43082,10995,5348,5647
36575,56673,13586,27309,11355,43086,10997,5350,5647
36580,56684,13590,27317,11359,43093,10999,5352,5647
36585,56688,13591,27318,11360,43097,10999,5352,5647
36590,56698,13596,27325,11365,43100,11001,5352,5649
36595,56704,13598,27326,11367,43105,11003,5352,5651
36600,56715,13602,27331,11371,43112,11005,5353,5652
36605,56719,13603,27332,11372,43115,11005,5353,5652
36610,56729,13607,27336,11375,43121,11007,5354,5653
36615,56735,13608,27337,11376,43127,11009,5355,5654
36620,56746,13612,27344,11379,43131,11011,5356,5655
36625,56750,13617,27346,11384,43133,11011,5356,5655
36630,56760,13622,27350,11388,43138,11013,5356,5657
36635,56766,13623,27353,11389,43143,11015,5358,5657
36640,56777,13627,27359,11392,43148,11017,5359,5658
36645,56781,13630,27361,11395,43150,11017,5359,5658
36650,56791,13635,27368,11400,43154,11019,5360,5659
36655,56797,13637,27369,11402,43160,11021,5361,5660
36660,56808,13640,27375,11405,43166,11023,5362,5661
36665,56812,13642,27376,11407,43170,11023,5362,5661
36670,56822,13644,27382,11409,43178,11025,5364,5661
36675,56828,13644,27382,11409,43184,11027,5364,5663
36680,56839,13645,27389,11410,43192,11029,5365,5664
36685,56843,13645,27391,11410,43198,11029,5365,5664
36690,56853,13646,27395,11411,43207,11031,5366,5665
36695,56859,13646,27398,11411,43213,11033,5367,5666
36700,56870,13648,27405,11413,43221,11035,5368,5667
36705,56874,13649,27407,11414,43225,11035,5368,5667
36710,56884,13650,27411,11415,43234,11037,5369,5668
36715,56890,13650,27413,11415,43240,11039,5370,5669
36720,56901,13651,27417,11415,43249,11041,5372,5669
36725,56905,13651,27418,11415,43254,11041,5372,5669
36730,56915,13651,27425,11415,43264,11043,5373,5670
36735,56921,13651,27426,11415,43270,11045,5373,5672
36740,56932,13652,27431,11415,43279,11047,5373,5674
36745,56936,13652,27431,11415,43284,11047,5373,5674
36750,56946,13652,27434,11415,43294,11049,5375,5674
36755,56952,13652,27437,11415,43300,11051,5377,5674
36760,56963,13653,27442,11416,43310,11053,5378,5675
36765,56967,13653,27444,11416,43313,11053,5378,5675
36770,56977,13656,27450,11418,43320,11055,5380,5675
36775,56983,13657,27451,11419,43325,11057,5380,5677
36780,56994,13661,27453,11422,43333,11059,5380,5679
36785,56998,13662,27455,11423,43336,11059,5380,5679
36790,57008,13665,27458,11424,43343,11061,5381,5680
36795,57014,13666,27461,11425,43347,11063,5382,5681
36800,57025,13669,27465,11428,43354,11065,5382,5683
36805,57029,13672,27466,11431,43357,11065,5382,5683
36810,57039,13676,27470,11434,43362,11067,5382,5685
36815,57045,13677,27472,11435,43368,11069,5384,5685
36820,57056,13682,27480,11440,43372,11071,5385,5686
36825,57060,13686,27482,11444,43374,11071,5385,5686
36830,57070,13690,27486,11446,43379,11073,5386,5687
36835,57076,13691,27488,11447,43384,11075,5387,5688
36840,57087,13694,27492,11450,43392,11077,5388,5689
36845,57091,13697,27494,11453,43394,11077,5388,5689
36850,57101,13701,27500,11456,43399,11079,5390,5689
36855,57107,13702,27503,11457,43403,11081,5391,5690
36860,57118,13708,27508,11462,43408,11083,5391,5692
36865,57122,13711,27510,11465,43410,11083,5391,5692
36870,57132,13718,27517,11471,43412,11085,5391,5694
36875,57138,13720,27518,11473,43417,11087,5391,5696
36880,57149,13724,27523,11476,43423,11089,5392,5697
36885,57153,13724,27523,11476,43429,11089,5392,5697
36890,57163,13725,27530,11477,43436,11091,5393,5698
36895,57169,13728,27531,11480,43441,11093,5393,5700
36900,57180,13729,27533,11480,43450,11095,5393,5702
36905,57184,13729,27534,11480,43454,11095,5393,5702
36910,57194,13731,27539,11482,43463,11097,5395,5702
36915,57200,13731,27541,11482,43469,11099,5396,5703
36920,57211,13733,27546,11483,43477,11101,5398,5703
36925,57215,13734,27548,11484,43480,11101,5398,5703
36930,57225,13735,27552,11484,43490,11103,5399,5704
36935,57231,13735,27555,11484,43495,11105,5401,5704
36940,57242,13737,27564,11486,43503,11107,5403,5704
36945,57246,13737,27566,11486,43508,11107,5403,5704
36950,57256,13739,27571,11488,43517,11109,5403,5706
36955,57262,13739,27573,11488,43523,11111,5403,5708
36960,57273,13740,27577,11489,43531,11113,5404,5709
36965,57277,13741,27580,11490,43535,11113,5404,5709
36970,57287,13742,27585,11491,43545,11115,5405,5710
36975,57293,13742,27589,11491,43551,11117,5406,5711
36980,57304,13742,27596,11491,43561,11119,5408,5711
36985,57308,13742,27597,11491,43566,11119,5408,5711
36990,57318,13744,27601,11491,43574,11121,5408,5713
36995,57324,13744,27603,11491,43580,11123,5408,5715
37000,57335,13744,27606,11491,43590,11125,5409,5716
37005,57339,13744,27609,11491,43595,11125,5409,5716
37010,57349,13746,27613,11491,43601,11127,5410,5717
37015,57355,13748,27616,11493,43605,11129,5411,5718
37020,57366,13751,27621,11496,43613,11131,5411,5720
37025,57370,13752,27624,11497,43618,11131,5411,5720
37030,57380,13754,27628,11497,43625,11133,5411,5722
37035,57386,13756,27632,11499,43629,11135,5412,5723
37040,57397,13760,27637,11503,43637,11137,5412,5725
37045,57401,13761,27639,11504,43639,11137,5412,5725
37050,57411,13764,27644,11505,43646,11139,5413,5726
37055,57417,13766,27648,11507,43649,11141,5413,5728
37060,57428,13768,27652,11509,43659,11143,5414,5729
37065,57432,13769,27653,11510,43662,11143,5414,5729
37070,57442,13773,27657,11512,43668,11145,5415,5730
37075,57448,13774,27658,11513,43674,11147,5415,5732
37080,57459,13778,27666,11517,43680,11149,5417,5732
37085,57463,13781,27669,11520,43682,11149,5417,5732
37090,57473,13784,27676,11523,43689,11151,5418,5733
37095,57479,13784,27680,11523,43694,11153,5420,5733
37100,57490,13787,27685,11525,43703,11155,5420,5735
37105,57494,13787,27685,11525,43707,11155,5420,5735
37110,57504,13789,27690,11527,43715,11157,5421,5736
37115,57510,13789,27693,11527,43720,11159,5422,5737
37120,57521,13791,27694,11528,43730,11161,5422,5739
37125,57525,13792,27695,11529,43733,11161,5422,5739
37130,57535,13795,27699,11531,43740,11163,5423,5740
37135,57541,13795,27701,11531,43745,11165,5424,5741
37140,57552,13797,27705,11533,43753,11167,5424,5743
37145,57556,13799,27707,11535,43755,11167,5424,5743
37150,57566,13804,27712,11539,43762,11169,5424,5745
37155,57572,13804,27715,11539,43766,11171,5424,5747
37160,57583,13810,27721,11545,43772,11173,5424,5749
37165,57587,13813,27724,11548,43773,11173,5424,5749
37170,57597,13814,27728,11549,43783,11175,5425,5750
37175,57603,13814,27730,11549,43789,11177,5426,5751
37180,57614,13815,27737,11549,43797,11179,5427,5752
37185,57618,13815,27737,11549,43803,11179,5427,5752
37190,57628,13816,27740,11549,43812,11181,5429,5752
37195,57634,13816,27743,11549,43818,11183,5430,5753
37200,57645,13817,27744,11549,43828,11185,5431,5754
37205,57649,13817,27744,11549,43832,11185,5431,5754
37210,57659,13819,27748,11550,43840,11187,5432,5755
37215,57665,13819,27752,11550,43846,11189,5434,5755
37220,57676,13821,27758,11552,43853,11191,5434,5757
37225,57680,13821,27759,11552,43859,11191,5434,5757
37230,57690,13824,27766,11554,43866,11193,5435,5758
37235,57696,13824,27771,11554,43871,11195,5436,5759
37240,57707,13825,27775,11554,43880,11197,5436,5761
37245,57711,13826,27777,11555,43884,11197,5436,5761
37250,57721,13828,27782,11556,43892,11199,5437,5762
37255,57727,13830,27785,11558,43896,11201,5438,5763
37260,57738,13833,27791,11561,43903,11203,5439,5764
37265,57742,13834,27793,11562,43907,11203,5439,5764
37270,57752,13836,27795,11563,43916,11205,5439,5766
37275,57758,13837,27800,11564,43920,11207,5441,5766
37280,57769,13839,27803,11565,43928,11209,5441,5768
37285,57773,13841,27804,11567,43932,11209,5441,5768
37290,57783,13843,27809,11568,43938,11211,5442,5769
37295,57789,13845,27812,11570,43942,11213,5443,5770
37300,57800,13849,27818,11574,43948,11215,5443,5772
37305,57804,13850,27819,11575,43954,11215,5443,5772
37310,57814,13852,27826,11577,43960,11217,5445,5772
37315,57820,13855,27829,11580,43964,11219,5445,5774
37320,57831,13858,27834,11582,43970,11221,5445,5776
37325,57835,13861,27835,11585,43974,11221,5445,5776
37330,57845,13864,27839,11586,43981,11223,5446,5777
37335,57851,13864,27842,11586,43985,11225,5447,5778
37340,57862,13867,27846,11588,43995,11227,5449,5778
37345,57866,13867,27848,11588,43998,11227,5449,5778
37350,57876,13871,27855,11591,44004,11229,5450,5779
37355,57882,13871,27858,11591,44009,11231,5451,5780
37360,57893,13874,27864,11594,44018,11233,5452,5781
37365,57897,13875,27866,11595,44021,11233,5452,5781
37370,57907,13879,27869,11598,44028,11235,5453,5782
37375,57913,13879,27873,11598,44032,11237,5454,5783
37380,57924,13883,27877,11601,44041,11239,5455,5784
37385,57928,13883,27878,11601,44044,11239,5455,5784
37390,57938,13888,27884,11606,44050,11241,5457,5784
37395,57944,13888,27887,11606,44055,11243,5459,5784
37400,57955,13891,27891,11608,44062,11245,5459,5786
37405,57959,13893,27891,11610,44066,11245,5459,5786
37410,57969,13897,27897,11613,44071,11247,5460,5787
37415,57975,13897,27899,11613,44078,11249,5461,5788
37420,57986,13898,27904,11613,44085,11251,5462,5789
37425,57990,13900,27907,11615,44089,11251,5462,5789
37430,58000,13904,27912,11618,44094,11253,5463,5790
37435,58006,13906,27915,11620,44099,11255,5465,5790
37440,58017,13910,27923,11624,44105,11257,5466,5791
37445,58021,13914,27927,11628,44107,11257,5466,5791
37450,58031,13917,27933,11631,44114,11259,5467,5792
37455,58037,13918,27937,11632,44118,11261,5469,5792
37460,58048,13922,27941,11635,44126,11263,5469,5794
37465,58052,13923,27945,11636,44129,11263,5469,5794
37470,58062,13925,27949,11638,44135,11265,5469,5796
37475,58068,13927,27954,11640,44140,11267,5471,5796
37480,58079,13931,27960,11643,44148,11269,5472,5797
37485,58083,13931,27961,11643,44152,11269,5472,5797
37490,58093,13932,27966,11643,44160,11271,5474,5797
37495,58099,13933,27968,11644,44166,11273,5474,5799
37500,58110,13934,27971,11644,44175,11275,5474,5801
37505,58114,13936,27974,11646,44178,11275,5474,5801
37510,58124,13937,27978,11646,44186,11277,5475,5802
37515,58130,13938,27981,11647,44192,11279,5477,5802
37520,58141,13939,27985,11648,44201,11281,5478,5803
37525,58145,13940,27985,11649,44205,11281,5478,5803
37530,58155,13942,27990,11650,44212,11283,5480,5803
37535,58161,13943,27992,11651,44217,11285,5481,5804
37540,58172,13945,27997,11653,44227,11287,5482,5805
37545,58176,13945,27999,11653,44230,11287,5482,5805
37550,58186,13951,28004,11657,44234,11289,5483,5806
37555,58192,13952,28008,11658,44238,11291,5485,5806
37560,58203,13957,28015,11663,44243,11293,5486,5807
37565,58207,13962,28017,11668,44245,11293,5486,5807
37570,58217,13966,28023,11671,44251,11295,5487,5808
37575,58223,13966,28027,11671,44256,11297,5489,5808
37580,58234,13970,28032,11674,44262,11299,5490,5809
37585,58238,13973,28033,11677,44265,11299,5490,5809
37590,58248,13976,28037,11679,44272,11301,5491,5810
37595,58254,13976,28043,11679,44276,11303,5493,5810
37600,58265,13980,28049,11683,44283,11305,5494,5811
37605,58269,13982,28050,11685,44286,11305,5494,5811
37610,58279,13986,28057,11689,44293,11307,5495,5812
37615,58285,13986,28061,11689,44298,11309,5496,5813
37620,58296,13990,28069,11693,44305,11311,5497,5814
37625,58300,13990,28070,11693,44310,11311,5497,5814
37630,58310,13991,28075,11693,44319,11313,5498,5815
37635,58316,13991,28079,11693,44325,11315,5499,5816
37640,58327,13992,28082,11693,44335,11317,5499,5818
37645,58331,13993,28086,11694,44337,11317,5499,5818
37650,58341,13996,28090,11696,44345,11319,5499,5820
37655,58347,13996,28095,11696,44351,11321,5501,5820
37660,58358,13999,28104,11699,44357,11323,5501,5822
37665,58362,13999,28106,11699,44362,11323,5501,5822
37670,58372,14002,28111,11701,44370,11325,5503,5822
37675,58378,14003,28114,11702,44375,11327,5504,5823
37680,58389,14005,28119,11704,44383,11329,5505,5824
37685,58393,14005,28120,11704,44387,11329,5505,5824
37690,58403,14006,28124,11704,44396,11331,5506,5825
37695,58409,14007,28126,11705,44402,11333,5507,5826
37700,58420,14008,28132,11706,44410,11335,5508,5827
37705,58424,14009,28133,11707,44414,11335,5508,5827
37710,58434,14010,28141,11708,44422,11337,5509,5828
37715,58440,14012,28143,11710,44427,11339,5509,5830
37720,58451,14015,28149,11713,44435,11341,5510,5831
37725,58455,14017,28151,11715,44437,11341,5510,5831
37730,58465,14021,28155,11718,44444,11343,5512,5831
37735,58471,14021,28157,11718,44449,11345,5513,5832
37740,58482,14023,28161,11720,44457,11347,5514,5833
37745,58486,14026,28164,11723,44459,11347,5514,5833
37750,58496,14031,28173,11728,44463,11349,5516,5833
37755,58502,14032,28176,11729,44468,11351,5516,5835
37760,58513,14035,28181,11732,44477,11353,5517,5836
37765,58517,14037,28184,11734,44479,11353,5517,5836
37770,58527,14038,28188,11735,44489,11355,5519,5836
37775,58533,14038,28190,11735,44494,11357,5520,5837
37780,58544,14038,28196,11735,44506,11359,5521,5838
37785,58548,14038,28198,11735,44509,11359,5521,5838
37790,58558,14039,28205,11736,44518,11361,5522,5839
37795,58564,14039,28209,11736,44524,11363,5524,5839
37800,58575,14041,28214,11737,44533,11365,5524,5841
37805,58579,14042,28215,11738,44537,11365,5524,5841
37810,58589,14043,28218,11739,44546,11367,5524,5843
37815,58595,14043,28220,11739,44552,11369,5525,5844
37820,58606,14045,28225,11740,44559,11371,5525,5846
37825,58610,14046,28226,11741,44564,11371,5525,5846
37830,58620,14047,28232,11742,44572,11373,5526,5847
37835,58626,14047,28234,11742,44578,11375,5527,5848
37840,58637,14049,28239,11743,44587,11377,5528,5849
37845,58641,14049,28239,11743,44592,11377,5528,5849
37850,58651,14050,28246,11744,44601,11379,5529,5850
37855,58657,14051,28249,11745,44605,11381,5530,5851
37860,58668,14054,28252,11747,44614,11383,5530,5853
37865,58672,14055,28253,11748,44617,11383,5530,5853
37870,58682,14056,28256,11749,44626,11385,5531,5854
37875,58688,14056,28258,11749,44631,11387,5532,5855
37880,58699,14060,28265,11753,44637,11389,5533,5856
37885,58703,14063,28266,11756,44640,11389,5533,5856
37890,58713,14068,28272,11760,44645,11391,5535,5856
37895,58719,14068,28276,11760,44650,11393,5536,5857
37900,58730,14071,28281,11762,44658,11395,5538,5857
37905,58734,14072,28284,11763,44662,11395,5538,5857
37910,58744,14075,28287,11765,44669,11397,5539,5858
37915,58750,14075,28288,11765,44675,11399,5540,5859
37920,58761,14076,28291,11766,44685,11401,5541,5860
37925,58765,14076,28293,11766,44689,11401,5541,5860
37930,58775,14079,28295,11767,44696,11403,5542,5861
37935,58781,14079,28299,11767,44701,11405,5543,5862
37940,58792,14082,28305,11769,44708,11407,5544,5863
37945,58796,14084,28308,11771,44712,11407,5544,5863
37950,58806,14086,28313,11772,44720,11409,5546,5863
37955,58812,14086,28316,11772,44725,11411,5547,5864
37960,58823,14088,28320,11774,44734,11413,5547,5866
37965,58827,14090,28321,11776,44737,11413,5547,5866
37970,58837,14093,28325,11778,44743,11415,5547,5868
37975,58843,14095,28329,11780,44746,11417,5548,5869
37980,58854,14100,28334,11785,44753,11419,5549,5870
37985,58858,14101,28335,11786,44757,11419,5549,5870
37990,58868,14105,28341,11788,44762,11421,5550,5871
37995,58874,14107,28344,11790,44767,11423,5552,5871
38000,58885,14110,28350,11793,44773,11425,5553,5872
38005,58889,14114,28354,11797,44773,11425,5553,5872
38010,58899,14118,28359,11801,44780,11427,5555,5872
38015,58905,14119,28362,11802,44784,11429,5556,5873
38020,58916,14125,28369,11807,44788,11431,5557,5874
38025,58920,14129,28370,11811,44791,11431,5557,5874
38030,58930,14133,28374,11814,44797,11433,5558,5875
38035,58936,14133,28377,11814,44802,11435,5560,5875
38040,58947,14137,28384,11818,44806,11437,5560,5877
38045,58951,14139,28385,11820,44811,11437,5560,5877
38050,58961,14141,28387,11821,44819,11439,5560,5879
38055,58967,14143,28390,11823,44823,11441,5561,5880
38060,58978,14145,28396,11824,44831,11443,5562,5881
38065,58982,14146,28398,11825,44836,11443,5562,5881
38070,58992,14147,28402,11825,44845,11445,5564,5881
38075,58998,14147,28407,11825,44850,11447,5565,5882
38080,59009,14149,28411,11827,44860,11449,5565,5884
38085,59013,14149,28413,11827,44863,11449,5565,5884
38090,59023,14151,28420,11829,44872,11451,5567,5884
38095,59029,14151,28421,11829,44878,11453,5568,5885
38100,59040,14152,28426,11830,44886,11455,5569,5886
38105,59044,14153,28429,11831,44891,11455,5569,5886
38110,59054,14154,28431,11832,44900,11457,5569,5888
38115,59060,14154,28433,11832,44906,11459,5569,5890
38120,59071,14154,28438,11832,44917,11461,5570,5891
38125,59075,14154,28440,11832,44921,11461,5570,5891
38130,59085,14155,28444,11832,44930,11463,5571,5892
38135,59091,14155,28450,11832,44936,11465,5573,5892
38140,59102,14156,28457,11833,44946,11467,5574,5893
38145,59106,14156,28458,11833,44950,11467,5574,5893
38150,59116,14159,28462,11834,44957,11469,5574,5895
38155,59122,14159,28464,11834,44962,11471,5575,5896
38160,59133,14161,28473,11836,44970,11473,5577,5896
38165,59137,14164,28474,11839,44973,11473,5577,5896
38170,59147,14167,28477,11840,44979,11475,5578,5897
38175,59153,14168,28481,11841,44983,11477,5580,5897
38180,59164,14171,28484,11844,44993,11479,5580,5899
38185,59168,14171,28485,11844,44997,11479,5580,5899
38190,59178,14173,28490,11845,45004,11481,5582,5899
38195,59184,14174,28491,11846,45010,11483,5582,5901
38200,59195,14177,28497,11849,45017,11485,5583,5902
38205,59199,14179,28501,11851,45018,11485,5583,5902
38210,59209,14184,28503,11854,45025,11487,5584,5903
38215,59215,14184,28505,11854,45030,11489,5585,5904
38220,59226,14186,28509,11856,45038,11491,5586,5905
38225,59230,14189,28512,11859,45041,11491,5586,5905
38230,59240,14191,28516,11859,45048,11493,5588,5905
38235,59246,14192,28516,11860,45054,11495,5588,5907
38240,59257,14196,28524,11864,45059,11497,5590,5907
38245,59261,14196,28525,11864,45065,11497,5590,5907
38250,59271,14200,28530,11866,45070,11499,5590,5909
38255,59277,14201,28531,11867,45075,11501,5590,5911
38260,59288,14204,28534,11869,45084,11503,5592,5911
38265,59292,14204,28537,11869,45087,11503,5592,5911
38270,59302,14208,28542,11872,45093,11505,5592,5913
38275,59308,14210,28547,11874,45096,11507,5594,5913
38280,59319,14213,28551,11877,45104,11509,5594,5915
38285,59323,14215,28553,11879,45108,11509,5594,5915
38290,59333,14218,28560,11882,45114,11511,5596,5915
38295,59339,14219,28563,11883,45119,11513,5597,5916
38300,59350,14222,28568,11886,45125,11515,5597,5918
38305,59354,14224,28570,11888,45130,11515,5597,5918
38310,59364,14227,28573,11890,45136,11517,5597,5920
38315,59370,14228,28576,11891,45141,11519,5598,5921
38320,59381,14232,28580,11894,45148,11521,5599,5922
38325,59385,14233,28580,11895,45152,11521,5599,5922
38330,59395,14237,28585,11898,45157,11523,5600,5923
38335,59401,14238,28587,11899,45161,11525,5600,5925
38340,59412,14244,28593,11905,45167,11527,5601,5926
38345,59416,14246,28594,11907,45170,11527,5601,5926
38350,59426,14250,28599,11910,45175,11529,5602,5927
38355,59432,14252,28603,11912,45179,11531,5603,5928
38360,59443,14254,28608,11913,45187,11533,5604,5929
38365,59447,14256,28612,11915,45190,11533,5604,5929
38370,59457,14257,28614,11915,45200,11535,5604,5931
38375,59463,14257,28616,11915,45206,11537,5605,5932
38380,59474,14258,28622,11916,45215,11539,5606,5933
38385,59478,14259,28626,11917,45218,11539,5606,5933
38390,59488,14261,28631,11918,45227,11541,5607,5934
38395,59494,14261,28634,11918,45232,11543,5607,5936
38400,59505,14263,28638,11919,45242,11545,5608,5937
38405,59509,14263,28641,11919,45245,11545,5608,5937
38410,59519,14266,28648,11921,45252,11547,5610,5937
38415,59525,14266,28649,11921,45259,11549,5611,5938
38420,59536,14268,28656,11922,45268,11551,5613,5938
38425,59540,14269,28658,11923,45271,11551,5613,5938
38430,59550,14271,28662,11925,45279,11553,5614,5939
38435,59556,14271,28666,11925,45284,11555,5614,5941
38440,59567,14272,28674,11926,45293,11557,5616,5941
38445,59571,14273,28678,11927,45297,11557,5616,5941
38450,59581,14274,28682,11928,45307,11559,5616,5943
38455,59587,14274,28686,11928,45312,11561,5617,5944
38460,59598,14276,28691,11930,45322,11563,5618,5945
38465,59602,14277,28694,11931,45325,11563,5618,5945
38470,59612,14281,28699,11933,45329,11565,5619,5946
38475,59618,14284,28703,11936,45332,11567,5619,5948
38480,59629,14290,28710,11942,45339,11569,5620,5949
38485,59633,14291,28714,11943,45341,11569,5620,5949
38490,59643,14294,28718,11944,45349,11571,5620,5951
38495,59649,14294,28721,11944,45355,11573,5621,5952
38500,59660,14296,28726,11945,45363,11575,5623,5952
38505,59664,14297,28729,11946,45366,11575,5623,5952
38510,59674,14299,28735,11948,45375,11577,5624,5953
38515,59680,14299,28737,11948,45380,11579,5625,5954
38520,59691,14304,28743,11953,45386,11581,5626,5955
38525,59695,14305,28743,11954,45390,11581,5626,5955
38530,59705,14309,28749,11958,45396,11583,5627,5956
38535,59711,14309,28751,11958,45402,11585,5628,5957
38540,59722,14311,28760,11960,45408,11587,5629,5958
38545,59726,14315,28763,11964,45410,11587,5629,5958
38550,59736,14318,28767,11965,45418,11589,5630,5959
38555,59742,14318,28771,11965,45423,11591,5632,5959
38560,59753,14319,28773,11966,45433,11593,5632,5961
38565,59757,14321,28776,11968,45435,11593,5632,5961
38570,59767,14324,28780,11970,45443,11595,5633,5962
38575,59773,14324,28785,11970,45448,11597,5634,5963
38580,59784,14325,28788,11971,45458,11599,5635,5964
38585,59788,14327,28790,11973,45461,11599,5635,5964
38590,59798,14329,28797,11975,45468,11601,5636,5965
38595,59804,14331,28800,11977,45472,11603,5636,5967
38600,59815,14333,28803,11979,45482,11605,5637,5968
38605,59819,14334,28806,11980,45485,11605,5637,5968
38610,59829,14336,28810,11980,45492,11607,5638,5969
38615,59835,14338,28812,11982,45496,11609,5638,5971
38620,59846,14342,28820,11986,45502,11611,5639,5972
38625,59850,14342,28821,11986,45508,11611,5639,5972
38630,59860,14344,28825,11987,45515,11613,5640,5973
38635,59866,14345,28827,11988,45521,11615,5641,5974
38640,59877,14346,28832,11989,45530,11617,5642,5975
38645,59881,14347,28834,11990,45534,11617,5642,5975
38650,59891,14348,28834,11990,45543,11619,5642,5977
38655,59897,14348,28836,11990,45549,11621,5644,5977
38660,59908,14350,28841,11991,45557,11623,5645,5978
38665,59912,14350,28842,11991,45561,11623,5645,5978
38670,59922,14353,28846,11993,45569,11625,5646,5979
38675,59928,14354,28852,11994,45572,11627,5648,5979
38680,59939,14356,28855,11996,45582,11629,5648,5981
38685,59943,14356,28857,11996,45586,11629,5648,5981
38690,59953,14357,28859,11996,45596,11631,5649,5982
38695,59959,14357,28861,11996,45600,11633,5649,5984
38700,59970,14361,28866,12000,45609,11635,5650,5985
38705,59974,14362,28868,12001,45611,11635,5650,5985
38710,59984,14365,28876,12003,45617,11637,5652,5985
38715,59990,14367,28879,12005,45622,11639,5653,5986
38720,60001,14368,28882,12005,45632,11641,5655,5986
38725,60005,14370,28884,12007,45634,11641,5655,5986
38730,60015,14374,28889,12011,45640,11643,5656,5987
38735,60021,14376,28893,12013,45644,11645,5658,5987
38740,60032,14379,28897,12015,45652,11647,5660,5987
38745,60036,14382,28901,12018,45652,11647,5660,5987
38750,60046,14387,28907,12023,45658,11649,5662,5987
38755,60052,14389,28910,12025,45662,11651,5663,5988
38760,60063,14392,28917,12028,45668,11653,5664,5989
38765,60067,14394,28919,12030,45673,11653,5664,5989
38770,60077,14396,28923,12032,45681,11655,5665,5990
38775,60083,14397,28924,12033,45686,11657,5665,5992
38780,60094,14399,28930,12035,45693,11659,5666,5993
38785,60098,14401,28932,12037,45697,11659,5666,5993
38790,60108,14405,28942,12041,45701,11661,5668,5993
38795,60114,14407,28942,12043,45707,11663,5668,5995
38800,60125,14409,28946,12044,45716,11665,5669,5996
38805,60129,14409,28946,12044,45720,11665,5669,5996
38810,60139,14412,28953,12047,45726,11667,5671,5996
38815,60145,14412,28955,12047,45732,11669,5671,5998
38820,60156,14414,28962,12048,45742,11671,5673,5998
38825,60160,14415,28965,12049,45745,11671,5673,5998
38830,60170,14417,28969,12050,45753,11673,5673,6000
38835,60176,14417,28969,12050,45759,11675,5673,6002
38840,60187,14419,28973,12051,45768,11677,5674,6003
38845,60191,14420,28976,12052,45771,11677,5674,6003
38850,60201,14422,28982,12054,45778,11679,5675,6004
38855,60207,14422,28984,12054,45784,11681,5676,6005
38860,60218,14424,28990,12056,45793,11683,5677,6006
38865,60222,14426,28992,12058,45795,11683,5677,6006
38870,60232,14430,28998,12062,45802,11685,5679,6006
38875,60238,14430,29002,12062,45806,11687,5681,6006
38880,60249,14433,29008,12065,45813,11689,5682,6007
38885,60253,14437,29009,12069,45816,11689,5682,6007
38890,60263,14438,29011,12070,45825,11691,5683,6008
38895,60269,14438,29012,12070,45831,11693,5683,6010
38900,60280,14440,29017,12072,45838,11695,5684,6011
38905,60284,14443,29019,12075,45840,11695,5684,6011
38910,60294,14447,29024,12077,45845,11697,5686,6011
38915,60300,14450,29028,12080,45848,11699,5687,6012
38920,60311,14455,29033,12085,45855,11701,5688,6013
38925,60315,14457,29036,12087,45856,11701,5688,6013
38930,60325,14460,29042,12089,45864,11703,5690,6013
38935,60331,14461,29044,12090,45870,11705,5691,6014
38940,60342,14463,29051,12092,45878,11707,5693,6014
38945,60346,14464,29053,12093,45881,11707,5693,6014
38950,60356,14466,29059,12095,45889,11709,5693,6016
38955,60362,14466,29062,12095,45895,11711,5695,6016
38960,60373,14467,29069,12096,45904,11713,5697,6016
38965,60377,14467,29069,12096,45910,11713,5697,6016
38970,60387,14469,29073,12097,45917,11715,5698,6017
38975,60393,14469,29076,12097,45923,11717,5699,6018
38980,60404,14470,29082,12097,45933,11719,5701,6018
38985,60408,14471,29085,12098,45936,11719,5701,6018
38990,60418,14473,29088,12099,45945,11721,5702,6019
38995,60424,14473,29092,12099,45951,11723,5704,6019
39000,60435,14474,29097,12099,45961,11725,5705,6020
39005,60439,14475,29101,12100,45963,11725,5705,6020
39010,60449,14477,29105,12101,45972,11727,5706,6021
39015,60455,14477,29110,12101,45978,11729,5708,6021
39020,60466,14478,29113,12101,45988,11731,5709,6022
39025,60470,14479,29115,12102,45991,11731,5709,6022
39030,60480,14480,29120,12102,46000,11733,5710,6023
39035,60486,14480,29122,12102,46005,11735,5710,6025
39040,60497,14482,29127,12103,46013,11737,5710,6027
39045,60501,14482,29129,12103,46018,11737,5710,6027
39050,60511,14485,29135,12105,46026,11739,5712,6027
39055,60517,14485,29140,12105,46031,11741,5713,6028
39060,60528,14489,29147,12108,46038,11743,5715,6028
39065,60532,14489,29149,12108,46043,11743,5715,6028
39070,60542,14491,29153,12110,46051,11745,5717,6028
39075,60548,14491,29156,12110,46056,11747,5717,6030
39080,60559,14494,29162,12113,46063,11749,5718,6031
39085,60563,14495,29164,12114,46068,11749,5718,6031
39090,60573,14498,29169,12116,46074,11751,5719,6032
39095,60579,14499,29171,12117,46080,11753,5721,6032
39100,60590,14500,29174,12118,46089,11755,5722,6033
39105,60594,14502,29175,12120,46092,11755,5722,6033
39110,60604,14506,29179,12123,46097,11757,5722,6035
39115,60610,14508,29182,12125,46101,11759,5723,6036
39120,60621,14512,29186,12128,46107,11761,5723,6038
39125,60625,14516,29189,12132,46108,11761,5723,6038
39130,60635,14521,29193,12135,46113,11763,5724,6039
39135,60641,14523,29197,12137,46118,11765,5726,6039
39140,60652,14526,29202,12139,46124,11767,5727,6040
39145,60656,14528,29206,12141,46127,11767,5727,6040
39150,60666,14533,29212,12145,46132,11769,5728,6041
39155,60672,14534,29215,12146,46138,11771,5730,6041
39160,60683,14537,29221,12149,46143,11773,5730,6043
39165,60687,14540,29223,12152,46146,11773,5730,6043
39170,60697,14545,29230,12156,46150,11775,5731,6044
39175,60703,14547,29233,12158,46155,11777,5732,6045
39180,60714,14551,29237,12161,46161,11779,5732,6047
39185,60718,14552,29239,12162,46165,11779,5732,6047
39190,60728,14555,29247,12165,46171,11781,5734,6047
39195,60734,14558,29251,12168,46175,11783,5736,6047
39200,60745,14560,29255,12170,46185,11785,5737,6048
39205,60749,14560,29257,12170,46188,11785,5737,6048
39210,60759,14563,29262,12173,46195,11787,5737,6050
39215,60765,14565,29267,12175,46199,11789,5739,6050
39220,60776,14569,29274,12179,46205,11791,5740,6051
39225,60780,14571,29277,12181,46208,11791,5740,6051
39230,60790,14574,29282,12182,46215,11793,5740,6053
39235,60796,14576,29283,12184,46220,11795,5740,6055
39240,60807,14578,29290,12186,46227,11797,5741,6056
39245,60811,14579,29293,12187,46231,11797,5741,6056
39250,60821,14580,29300,12188,46241,11799,5743,6056
39255,60827,14580,29303,12188,46247,11801,5745,6056
39260,60838,14581,29306,12189,46257,11803,5745,6058
39265,60842,14581,29307,12189,46261,11803,5745,6058
39270,60852,14582,29313,12189,46269,11805,5746,6059
39275,60858,14584,29317,12191,46274,11807,5747,6060
39280,60869,14584,29320,12191,46285,11809,5747,6062
39285,60873,14584,29323,12191,46289,11809,5747,6062
39290,60883,14586,29326,12193,46297,11811,5748,6063
39295,60889,14587,29328,12194,46302,11813,5749,6064
39300,60900,14588,29336,12195,46312,11815,5751,6064
39305,60904,14589,29337,12196,46315,11815,5751,6064
39310,60914,14591,29341,12197,46322,11817,5752,6065
39315,60920,14593,29343,12199,46327,11819,5752,6067
39320,60931,14595,29348,12201,46336,11821,5753,6068
39325,60935,14595,29348,12201,46340,11821,5753,6068
39330,60945,14596,29351,12202,46348,11823,5754,6069
39335,60951,14596,29354,12202,46354,11825,5754,6071
39340,60962,14598,29360,12204,46364,11827,5755,6072
39345,60966,14599,29364,12205,46367,11827,5755,6072
39350,60976,14602,29369,12208,46374,11829,5756,6073
39355,60982,14602,29371,12208,46379,11831,5757,6074
39360,60993,14605,29377,12210,46386,11833,5758,6075
39365,60997,14608,29380,12213,46387,11833,5758,6075
39370,61007,14612,29383,12217,46395,11835,5758,6077
39375,61013,14612,29386,12217,46400,11837,5759,6078
39380,61024,14615,29391,12219,46407,11839,5759,6080
39385,61028,14617,29392,12221,46410,11839,5759,6080
39390,61038,14619,29396,12223,46419,11841,5760,6081
39395,61044,14619,29399,12223,46425,11843,5761,6082
39400,61055,14621,29403,12224,46433,11845,5761,6084
39405,61059,14622,29403,12225,46437,11845,5761,6084
39410,61069,14625,29408,12227,46444,11847,5761,6086
39415,61075,14625,29412,12227,46449,11849,5763,6086
39420,61086,14626,29415,12227,46458,11851,5764,6087
39425,61090,14627,29418,12228,46462,11851,5764,6087
39430,61100,14631,29424,12230,46468,11853,5765,6088
39435,61106,14631,29424,12230,46475,11855,5765,6090
39440,61117,14633,29431,12232,46482,11857,5767,6090
39445,61121,14633,29432,12232,46488,11857,5767,6090
39450,61131,14635,29436,12232,46495,11859,5768,6091
39455,61137,14637,29437,12234,46500,11861,5768,6093
39460,61148,14639,29441,12235,46507,11863,5769,6094
39465,61152,14642,29445,12238,46509,11863,5769,6094
39470,61162,14645,29449,12239,46516,11865,5770,6095
39475,61168,14646,29451,12240,46521,11867,5771,6096
39480,61179,14650,29457,12243,46526,11869,5772,6097
39485,61183,14651,29459,12244,46530,11869,5772,6097
39490,61193,14656,29463,12247,46536,11871,5774,6097
39495,61199,14657,29464,12248,46541,11873,5774,6099
39500,61210,14661,29470,12252,46546,11875,5774,6101
39505,61214,14664,29470,12255,46550,11875,5774,6101
39510,61224,14669,29476,12259,46553,11877,5774,6103
39515,61230,14671,29478,12261,46558,11879,5775,6104
39520,61241,14675,29482,12264,46565,11881,5776,6105
39525,61245,14677,29484,12266,46567,11881,5776,6105
39530,61255,14681,29487,12269,46574,11883,5777,6106
39535,61261,14682,29492,12270,46577,11885,5779,6106
39540,61272,14686,29496,12273,46586,11887,5780,6107
39545,61276,14686,29496,12273,46590,11887,5780,6107
39550,61286,14689,29503,12276,46597,11889,5782,6107
39555,61292,14689,29507,12276,46603,11891,5783,6108
39560,61303,14690,29513,12277,46612,11893,5784,6109
39565,61307,14691,29515,12278,46616,11893,5784,6109
39570,61317,14693,29521,12279,46624,11895,5785,6110
39575,61323,14693,29525,12279,46629,11897,5786,6111
39580,61334,14695,29531,12280,46638,11899,5787,6112
39585,61338,14696,29533,12281,46642,11899,5787,6112
39590,61348,14698,29541,12283,46650,11901,5789,6112
39595,61354,14698,29542,12283,46656,11903,5790,6113
39600,61365,14699,29546,12284,46665,11905,5791,6114
39605,61369,14699,29547,12284,46670,11905,5791,6114
39610,61379,14700,29550,12284,46679,11907,5792,6115
39615,61385,14700,29553,12284,46685,11909,5794,6115
39620,61396,14703,29561,12286,46692,11911,5796,6115
39625,61400,14703,29564,12286,46696,11911,5796,6115
39630,61410,14706,29569,12288,46704,11913,5798,6115
39635,61416,14706,29570,12288,46710,11915,5799,6116
39640,61427,14708,29577,12290,46717,11917,5800,6117
39645,61431,14709,29577,12291,46722,11917,5800,6117
39650,61441,14711,29581,12292,46729,11919,5801,6118
39655,61447,14712,29584,12293,46734,11921,5803,6118
39660,61458,14716,29590,12296,46739,11923,5803,6120
39665,61462,14719,29592,12299,46742,11923,5803,6120
39670,61472,14723,29598,12303,46748,11925,5803,6122
39675,61478,14724,29601,12304,46752,11927,5804,6123
39680,61489,14727,29603,12306,46762,11929,5805,6124
39685,61493,14727,29604,12306,46766,11929,5805,6124
39690,61503,14730,29610,12307,46772,11931,5807,6124
39695,61509,14732,29616,12309,46775,11933,5809,6124
39700,61520,14738,29621,12314,46781,11935,5810,6125
39705,61524,14739,29623,12315,46784,11935,5810,6125
39710,61534,14743,29628,12319,46790,11937,5810,6127
39715,61540,14744,29632,12320,46794,11939,5812,6127
39720,61551,14747,29636,12322,46801,11941,5813,6128
39725,61555,14752,29639,12327,46803,11941,5813,6128
39730,61565,14755,29645,12330,46808,11943,5813,6130
39735,61571,14758,29648,12333,46812,11945,5814,6131
39740,61582,14762,29654,12337,46818,11947,5815,6132
39745,61586,14763,29655,12338,46822,11947,5815,6132
39750,61596,14767,29662,12342,46828,11949,5817,6132
39755,61602,14768,29663,12343,46834,11951,5818,6133
39760,61613,14772,29669,12347,46839,11953,5818,6135
39765,61617,14772,29670,12347,46844,11953,5818,6135
39770,61627,14775,29674,12350,46852,11955,5819,6136
39775,61633,14775,29678,12350,46856,11957,5820,6137
39780,61644,14781,29684,12356,46861,11959,5820,6139
39785,61648,14783,29685,12358,46865,11959,5820,6139
39790,61658,14786,29692,12361,46871,11961,5821,6140
39795,61664,14787,29694,12362,46876,11963,5822,6141
39800,61675,14789,29697,12363,46886,11965,5824,6141
39805,61679,14790,29699,12364,46889,11965,5824,6141
39810,61689,14791,29705,12365,46898,11967,5825,6142
39815,61695,14791,29707,12365,46904,11969,5825,6144
39820,61706,14791,29713,12365,46915,11971,5826,6145
39825,61710,14791,29713,12365,46919,11971,5826,6145
39830,61720,14791,29717,12365,46929,11973,5826,6147
39835,61726,14791,29722,12365,46934,11975,5827,6148
39840,61737,14791,29726,12365,46946,11977,5828,6149
39845,61741,14791,29729,12365,46950,11977,5828,6149
39850,61751,14791,29732,12365,46960,11979,5829,6150
39855,61757,14791,29736,12365,46966,11981,5830,6151
39860,61768,14791,29742,12365,46977,11983,5831,6152
39865,61772,14791,29743,12365,46981,11983,5831,6152
39870,61782,14791,29747,12365,46991,11985,5832,6153
39875,61788,14791,29751,12365,46996,11987,5833,6154
39880,61799,14791,29758,12365,47008,11989,5834,6155
39885,61803,14791,29759,12365,47012,11989,5834,6155
39890,61813,14792,29763,12366,47021,11991,5836,6155
39895,61819,14792,29767,12366,47025,11993,5838,6155
39900,61830,14795,29769,12369,47035,11995,5838,6157
39905,61834,14795,29769,12369,47039,11995,5838,6157
39910,61844,14798,29775,12372,47046,11997,5840,6157
39915,61850,14798,29777,12372,47051,11999,5841,6158
39920,61861,14802,29783,12376,47057,12001,5842,6159
39925,61865,14804,29783,12378,47061,12001,5842,6159
39930,61875,14809,29789,12383,47066,12003,5843,6160
39935,61881,14809,29791,12383,47070,12005,5843,6162
39940,61892,14813,29795,12386,47077,12007,5844,6163
39945,61896,14816,29797,12389,47079,12007,5844,6163
39950,61906,14821,29803,12393,47084,12009,5846,6163
39955,61912,14822,29803,12394,47090,12011,5846,6165
39960,61923,14825,29809,12397,47097,12013,5848,6165
39965,61927,14826,29810,12398,47101,12013,5848,6165
39970,61937,14828,29816,12400,47108,12015,5849,6166
39975,61943,14830,29820,12402,47112,12017,5850,6167
39980,61954,14832,29826,12403,47120,12019,5852,6167
39985,61958,14833,29828,12404,47125,12019,5852,6167
39990,61968,14836,29836,12406,47131,12021,5854,6167
39995,61974,14838,29840,12408,47135,12023,5856,6167
40000,61985,14840,29844,12410,47144,12025,5857,6168
40005,61989,14841,29846,12411,47147,12025,5857,6168
40010,61999,14842,29848,12411,47157,12027,5857,6170
40015,62005,14843,29852,12412,47162,12029,5858,6171
40020,62016,14844,29859,12413,47169,12031,5859,6172
40025,62020,14846,29861,12415,47174,12031,5859,6172
40030,62030,14847,29863,12415,47182,12033,5860,6173
40035,62036,14849,29866,12417,47187,12035,5862,6173
40040,62047,14852,29872,12419,47192,12037,5863,6174
40045,62051,14853,29873,12420,47198,12037,5863,6174
40050,62061,14855,29880,12421,47205,12039,5864,6175
40055,62067,14855,29884,12421,47211,12041,5864,6177
40060,62078,14857,29890,12423,47221,12043,5864,6179
40065,62082,14857,29892,12423,47224,12043,5864,6179
40070,62092,14860,29898,12426,47232,12045,5866,6179
40075,62098,14860,29902,12426,47237,12047,5867,6180
40080,62109,14864,29908,12429,47244,12049,5869,6180
40085,62113,14865,29910,12430,47247,12049,5869,6180
40090,62123,14869,29915,12432,47254,12051,5870,6181
40095,62129,14869,29918,12432,47259,12053,5870,6183
40100,62140,14871,29926,12434,47267,12055,5872,6183
40105,62144,14873,29928,12436,47270,12055,5872,6183
40110,62154,14876,29932,12438,47278,12057,5873,6184
40115,62160,14876,29933,12438,47284,12059,5874,6185
40120,62171,14877,29938,12439,47292,12061,5874,6187
40125,62175,14880,29939,12442,47295,12061,5874,6187
40130,62185,14884,29943,12445,47300,12063,5874,6189
40135,62191,14884,29946,12445,47305,12065,5875,6190
40140,62202,14888,29951,12449,47313,12067,5876,6191
40145,62206,14890,29953,12451,47315,12067,5876,6191
40150,62216,14896,29959,12455,47318,12069,5877,6192
40155,62222,14898,29963,12457,47322,12071,5879,6192
40160,62233,14902,29965,12460,47330,12073,5879,6194
40165,62237,14905,29968,12463,47331,12073,5879,6194
40170,62247,14909,29971,12466,47337,12075,5879,6196
40175,62253,14911,29973,12468,47341,12077,5879,6198
40180,62264,14914,29979,12470,47347,12079,5881,6198
40185,62268,14917,29979,12473,47351,12079,5881,6198
40190,62278,14919,29982,12474,47359,12081,5882,6199
40195,62284,14919,29987,12474,47363,12083,5884,6199
40200,62295,14924,29990,12478,47371,12085,5885,6200
40205,62299,14924,29991,12478,47375,12085,5885,6200
40210,62309,14926,29998,12479,47381,12087,5887,6200
40215,62315,14928,30001,12481,47386,12089,5888,6201
40220,62326,14931,30005,12484,47394,12091,5888,6203
40225,62330,14931,30006,12484,47399,12091,5888,6203
40230,62340,14933,30012,12486,47407,12093,5890,6203
40235,62346,14933,30013,12486,47413,12095,5890,6205
40240,62357,14936,30019,12488,47420,12097,5891,6206
40245,62361,14937,30021,12489,47424,12097,5891,6206
40250,62371,14938,30026,12490,47433,12099,5892,6207
40255,62377,14938,30028,12490,47439,12101,5892,6209
40260,62388,14939,30033,12490,47448,12103,5894,6209
40265,62392,14939,30033,12490,47453,12103,5894,6209
40270,62402,14942,30040,12493,47460,12105,5896,6209
40275,62408,14942,30042,12493,47466,12107,5897,6210
40280,62419,14945,30047,12495,47474,12109,5897,6212
40285,62423,14945,30047,12495,47478,12109,5897,6212
40290,62433,14946,30052,12496,47487,12111,5898,6213
40295,62439,14946,30055,12496,47493,12113,5898,6215
40300,62450,14949,30061,12498,47501,12115,5899,6216
40305,62454,14950,30062,12499,47504,12115,5899,6216
40310,62464,14954,30066,12502,47510,12117,5899,6218
40315,62470,14954,30067,12502,47516,12119,5899,6220
40320,62481,14957,30073,12505,47523,12121,5899,6222
40325,62485,14959,30074,12507,47526,12121,5899,6222
40330,62495,14964,30083,12511,47529,12123,5901,6222
40335,62501,14966,30085,12513,47534,12125,5901,6224
40340,62512,14970,30090,12516,47540,12127,5901,6226
40345,62516,14972,30091,12518,47543,12127,5901,6226
40350,62526,14976,30095,12521,47549,12129,5902,6227
40355,62532,14978,30100,12523,47553,12131,5904,6227
40360,62543,14983,30106,12527,47558,12133,5905,6228
40365,62547,14986,30108,12530,47561,12133,5905,6228
40370,62557,14990,30115,12534,47566,12135,5907,6228
40375,62563,14991,30119,12535,47570,12137,5909,6228
40380,62574,14995,30123,12539,47577,12139,5909,6230
40385,62578,14998,30125,12542,47580,12139,5909,6230
40390,62588,15002,30130,12545,47585,12141,5910,6231
40395,62594,15004,30131,12547,47590,12143,5910,6233
40400,62605,15004,30136,12547,47600,12145,5911,6234
40405,62609,15004,30138,12547,47604,12145,5911,6234
40410,62619,15005,30141,12547,47614,12147,5911,6236
40415,62625,15005,30143,12547,47619,12149,5912,6237
40420,62636,15006,30147,12548,47630,12151,5914,6237
40425,62640,15006,30150,12548,47633,12151,5914,6237
40430,62650,15007,30154,12549,47643,12153,5914,6239
40435,62656,15007,30156,12549,47649,12155,5915,6240
40440,62667,15008,30161,12550,47659,12157,5915,6242
40445,62671,15008,30163,12550,47662,12157,5915,6242
40450,62681,15009,30166,12550,47672,12159,5916,6243
40455,62687,15009,30170,12550,47676,12161,5917,6244
40460,62698,15010,30177,12551,47686,12163,5918,6245
40465,62702,15011,30179,12552,47691,12163,5918,6245
40470,62712,15012,30187,12553,47698,12165,5918,6247
40475,62718,15015,30190,12556,47702,12167,5919,6248
40480,62729,15016,30195,12557,47710,12169,5920,6249
40485,62733,15017,30197,12558,47715,12169,5920,6249
40490,62743,15019,30201,12559,47723,12171,5921,6250
40495,62749,15021,30205,12561,47727,12173,5922,6251
40500,62760,15025,30211,12565,47735,12175,5924,6251
40505,62764,15025,30212,12565,47739,12175,5924,6251
40510,62774,15028,30216,12567,47745,12177,5924,6253
40515,62780,15028,30217,12567,47752,12179,5925,6254
40520,62791,15030,30222,12569,47761,12181,5926,6255
40525,62795,15031,30225,12570,47763,12181,5926,6255
40530,62805,15034,30229,12572,47771,12183,5927,6256
40535,62811,15034,30231,12572,47777,12185,5928,6257
40540,62822,15035,30236,12572,47786,12187,5930,6257
40545,62826,15036,30237,12573,47790,12187,5930,6257
40550,62836,15038,30242,12575,47798,12189,5930,6259
40555,62842,15038,30243,12575,47803,12191,5930,6261
40560,62853,15040,30249,12577,47812,12193,5931,6262
40565,62857,15042,30253,12579,47814,12193,5931,6262
40570,62867,15044,30257,12580,47823,12195,5932,6263
40575,62873,15044,30260,12580,47827,12197,5933,6264
40580,62884,15048,30264,12583,47835,12199,5934,6265
40585,62888,15049,30264,12584,47839,12199,5934,6265
40590,62898,15052,30267,12586,47846,12201,5934,6267
40595,62904,15052,30270,12586,47850,12203,5935,6268
40600,62915,15057,30274,12590,47857,12205,5935,6270
40605,62919,15059,30276,12592,47859,12205,5935,6270
40610,62929,15063,30279,12594,47866,12207,5936,6271
40615,62935,15063,30283,12594,47869,12209,5937,6272
40620,62946,15066,30285,12597,47880,12211,5937,6274
40625,62950,15067,30287,12598,47882,12211,5937,6274
40630,62960,15071,30292,12600,47889,12213,5939,6274
40635,62966,15071,30294,12600,47893,12215,5939,6276
40640,62977,15074,30300,12603,47901,12217,5940,6277
40645,62981,15077,30303,12606,47902,12217,5940,6277
40650,62991,15083,30309,12612,47908,12219,5940,6279
40655,62997,15083,30313,12612,47913,12221,5941,6280
40660,63008,15086,30317,12615,47922,12223,5942,6281
40665,63012,15086,30319,12615,47925,12223,5942,6281
40670,63022,15088,30322,12616,47934,12225,5942,6283
40675,63028,15088,30325,12616,47940,12227,5942,6285
40680,63039,15090,30331,12617,47948,12229,5943,6286
40685,63043,15090,30333,12617,47953,12229,5943,6286
40690,63053,15091,30336,12618,47962,12231,5943,6288
40695,63059,15091,30340,12618,47967,12233,5944,6289
40700,63070,15093,30347,12620,47975,12235,5945,6290
40705,63074,15094,30349,12621,47980,12235,5945,6290
40710,63084,15095,30353,12621,47989,12237,5946,6291
40715,63090,15095,30354,12621,47995,12239,5947,6292
40720,63101,15098,30362,12624,48001,12241,5948,6293
40725,63105,15098,30364,12624,48006,12241,5948,6293
40730,63115,15100,30370,12626,48013,12243,5948,6295
40735,63121,15102,30372,12628,48019,12245,5949,6296
40740,63132,15104,30378,12630,48028,12247,5951,6296
40745,63136,15104,30379,12630,48032,12247,5951,6296
40750,63146,15107,30383,12632,48039,12249,5952,6297
40755,63152,15108,30387,12633,48043,12251,5953,6298
40760,63163,15111,30397,12636,48049,12253,5955,6298
40765,63167,15113,30400,12638,48053,12253,5955,6298
40770,63177,15115,30405,12640,48061,12255,5956,6299
40775,63183,15116,30407,12641,48065,12257,5956,6301
40780,63194,15120,30413,12645,48072,12259,5958,6301
40785,63198,15122,30415,12647,48075,12259,5958,6301
40790,63208,15124,30418,12648,48083,12261,5958,6303
40795,63214,15125,30418,12649,48089,12263,5958,6305
40800,63225,15128,30421,12651,48096,12265,5958,6307
40805,63229,15129,30423,12652,48099,12265,5958,6307
40810,63239,15132,30428,12655,48107,12267,5960,6307
40815,63245,15133,30429,12656,48112,12269,5960,6309
40820,63256,15137,30437,12660,48117,12271,5962,6309
40825,63260,15139,30438,12662,48120,12271,5962,6309
40830,63270,15144,30442,12666,48126,12273,5963,6310
40835,63276,15145,30444,12667,48130,12275,5963,6312
40840,63287,15149,30447,12670,48138,12277,5964,6313
40845,63291,15149,30449,12670,48140,12277,5964,6313
40850,63301,15154,30454,12674,48146,12279,5966,6313
40855,63307,15155,30456,12675,48151,12281,5967,6314
40860,63318,15159,30461,12678,48157,12283,5968,6315
40865,63322,15163,30464,12682,48158,12283,5968,6315
40870,63332,15168,30469,12686,48163,12285,5969,6316
40875,63338,15170,30472,12688,48167,12287,5970,6317
40880,63349,15173,30477,12690,48174,12289,5972,6317
40885,63353,15176,30479,12693,48176,12289,5972,6317
40890,63363,15181,30482,12697,48182,12291,5972,6319
40895,63369,15181,30484,12697,48186,12293,5972,6321
40900,63380,15184,30490,12699,48194,12295,5973,6322
40905,63384,15185,30492,12700,48198,12295,5973,6322
40910,63394,15187,30497,12702,48205,12297,5973,6324
40915,63400,15190,30501,12705,48209,12299,5974,6325
40920,63411,15194,30507,12708,48215,12301,5975,6326
40925,63415,15195,30509,12709,48220,12301,5975,6326
40930,63425,15196,30514,12710,48227,12303,5976,6327
40935,63431,15199,30517,12713,48232,12305,5977,6328
40940,63442,15201,30521,12714,48240,12307,5977,6330
40945,63446,15202,30524,12715,48244,12307,5977,6330
40950,63456,15204,30530,12717,48251,12309,5978,6331
40955,63462,15204,30534,12717,48258,12311,5980,6331
40960,63473,15206,30537,12718,48267,12313,5981,6332
40965,63477,15206,30538,12718,48271,12313,5981,6332
40970,63487,15208,30543,12720,48279,12315,5981,6334
40975,63493,15208,30547,12720,48285,12317,5982,6335
40980,63504,15208,30554,12720,48295,12319,5983,6336
40985,63508,15208,30556,12720,48300,12319,5983,6336
40990,63518,15208,30564,12720,48309,12321,5985,6336
40995,63524,15208,30566,12720,48315,12323,5986,6337
41000,63535,15208,30567,12720,48327,12325,5987,6338
41005,63539,15209,30570,12721,48329,12325,5987,6338
41010,63549,15211,30573,12722,48337,12327,5987,6340
41015,63555,15211,30577,12722,48344,12329,5989,6340
41020,63566,15213,30583,12724,48352,12331,5990,6341
41025,63570,15215,30585,12726,48355,12331,5990,6341
41030,63580,15216,30590,12726,48364,12333,5992,6341
41035,63586,15216,30593,12726,48368,12335,5993,6342
41040,63597,15218,30597,12728,48377,12337,5993,6344
41045,63601,15220,30599,12730,48380,12337,5993,6344
41050,63611,15225,30607,12734,48386,12339,5994,6345
41055,63617,15225,30610,12734,48391,12341,5995,6346
41060,63628,15226,30613,12735,48400,12343,5996,6347
41065,63632,15228,30615,12737,48403,12343,5996,6347
41070,63642,15231,30619,12738,48411,12345,5997,6348
41075,63648,15231,30620,12738,48417,12347,5998,6349
41080,63659,15234,30623,12740,48425,12349,5998,6351
41085,63663,15234,30624,12740,48428,12349,5998,6351
41090,63673,15237,30630,12742,48436,12351,6000,6351
41095,63679,15237,30634,12742,48441,12353,6001,6352
41100,63690,15240,30639,12745,48450,12355,6002,6353
41105,63694,15241,30640,12746,48453,12355,6002,6353
41110,63704,15245,30645,12749,48459,12357,6003,6354
41115,63710,15245,30647,12749,48465,12359,6004,6355
41120,63721,15247,30651,12750,48472,12361,6005,6356
41125,63725,15248,30652,12751,48477,12361,6005,6356
41130,63735,15252,30661,12755,48483,12363,6007,6356
41135,63741,15252,30662,12755,48489,12365,6008,6357
41140,63752,15254,30667,12757,48497,12367,6009,6358
41145,63756,15255,30670,12758,48500,12367,6009,6358
41150,63766,15259,30677,12762,48506,12369,6010,6359
41155,63772,15260,30680,12763,48510,12371,6010,6361
41160,63783,15264,30686,12767,48518,12373,6012,6361
41165,63787,15265,30688,12768,48521,12373,6012,6361
41170,63797,15268,30693,12770,48528,12375,6012,6363
41175,63803,15269,30694,12771,48533,12377,6012,6365
41180,63814,15273,30699,12774,48539,12379,6013,6366
41185,63818,15276,30702,12777,48540,12379,6013,6366
41190,63828,15279,30707,12779,48548,12381,6014,6367
41195,63834,15281,30712,12781,48552,12383,6016,6367
41200,63845,15284,30718,12784,48558,12385,6016,6369
41205,63849,15286,30721,12786,48563,12385,6016,6369
41210,63859,15287,30724,12786,48571,12387,6017,6370
41215,63865,15288,30725,12787,48577,12389,6017,6372
41220,63876,15290,30732,12788,48585,12391,6017,6374
41225,63880,15291,30735,12789,48589,12391,6017,6374
41230,63890,15293,30738,12790,48596,12393,6017,6376
41235,63896,15294,30741,12791,48602,12395,6019,6376
41240,63907,15296,30747,12792,48611,12397,6020,6377
41245,63911,15297,30749,12793,48614,12397,6020,6377
41250,63921,15298,30754,12793,48621,12399,6021,6378
41255,63927,15300,30756,12795,48626,12401,6022,6379
41260,63938,15303,30763,12797,48635,12403,6024,6379
41265,63942,15304,30765,12798,48638,12403,6024,6379
41270,63952,15306,30771,12800,48644,12405,6025,6380
41275,63958,15308,30773,12802,48650,12407,6026,6381
41280,63969,15309,30780,12803,48659,12409,6028,6381
41285,63973,15311,30782,12805,48662,12409,6028,6381
41290,63983,15314,30787,12807,48669,12411,6028,6383
41295,63989,15314,30789,12807,48674,12413,6029,6384
41300,64000,15317,30792,12809,48683,12415,6030,6385
41305,64004,15319,30796,12811,48683,12415,6030,6385
41310,64014,15326,30802,12817,48686,12417,6030,6387
41315,64020,15328,30804,12819,48691,12419,6031,6388
41320,64031,15333,30812,12824,48696,12421,6033,6388
41325,64035,15337,30815,12828,48697,12421,6033,6388
41330,64045,15342,30820,12832,48702,12423,6034,6389
41335,64051,15343,30821,12833,48707,12425,6034,6391
41340,64062,15347,30825,12836,48713,12427,6034,6393
41345,64066,15350,30827,12839,48715,12427,6034,6393
41350,64076,15352,30834,12841,48722,12429,6034,6395
41355,64082,15354,30837,12843,48727,12431,6036,6395
41360,64093,15356,30844,12845,48735,12433,6038,6395
41365,64097,15357,30846,12846,48740,12433,6038,6395
41370,64107,15359,30851,12848,48748,12435,6038,6397
41375,64113,15359,30853,12848,48754,12437,6038,6399
41380,64124,15359,30859,12848,48763,12439,6039,6400
41385,64128,15360,30862,12849,48767,12439,6039,6400
41390,64138,15362,30869,12850,48776,12441,6041,6400
41395,64144,15362,30871,12850,48782,12443,6042,6401
41400,64155,15364,30879,12852,48789,12445,6043,6402
41405,64159,15365,30880,12853,48794,12445,6043,6402
41410,64169,15367,30884,12855,48802,12447,6044,6403
41415,64175,15367,30887,12855,48808,12449,6045,6404
41420,64186,15368,30894,12856,48816,12451,6047,6404
41425,64190,15369,30897,12857,48820,12451,6047,6404
41430,64200,15371,30901,12857,48829,12453,6049,6404
41435,64206,15371,30904,12857,48834,12455,6050,6405
41440,64217,15372,30909,12858,48844,12457,6052,6405
41445,64221,15373,30911,12859,48847,12457,6052,6405
41450,64231,15377,30915,12862,48854,12459,6053,6406
41455,64237,15377,30916,12862,48859,12461,6053,6408
41460,64248,15382,30922,12867,48865,12463,6054,6409
41465,64252,15383,30924,12868,48869,12463,6054,6409
41470,64262,15384,30928,12869,48877,12465,6055,6410
41475,64268,15385,30929,12870,48882,12467,6055,6412
41480,64279,15389,30934,12873,48889,12469,6056,6413
41485,64283,15389,30935,12873,48894,12469,6056,6413
41490,64293,15390,30940,12873,48901,12471,6057,6414
41495,64299,15393,30944,12876,48904,12473,6057,6416
41500,64310,15397,30951,12880,48912,12475,6057,6418
41505,64314,15397,30953,12880,48916,12475,6057,6418
41510,64324,15399,30958,12881,48925,12477,6059,6418
41515,64330,15399,30961,12881,48930,12479,6059,6420
41520,64341,15401,30964,12882,48938,12481,6060,6421
41525,64345,15403,30967,12884,48942,12481,6060,6421
41530,64355,15405,30973,12885,48948,12483,6061,6422
41535,64361,15407,30975,12887,48953,12485,6062,6423
41540,64372,15409,30981,12888,48960,12487,6062,6425
41545,64376,15410,30983,12889,48966,12487,6062,6425
41550,64386,15412,30988,12890,48973,12489,6064,6425
41555,64392,15413,30990,12891,48979,12491,6065,6426
41560,64403,15415,30995,12893,48988,12493,6066,6427
41565,64407,15416,30998,12894,48991,12493,6066,6427
41570,64417,15419,31003,12896,48997,12495,6067,6428
41575,64423,15420,31006,12897,49002,12497,6068,6429
41580,64434,15424,31013,12901,49008,12499,6069,6430
41585,64438,15427,31014,12904,49011,12499,6069,6430
41590,64448,15429,31019,12906,49018,12501,6069,6432
41595,64454,15429,31023,12906,49023,12503,6070,6433
41600,64465,15433,31029,12910,49032,12505,6072,6433
41605,64469,15435,31032,12912,49033,12505,6072,6433
41610,64479,15438,31037,12914,49041,12507,6074,6433
41615,64485,15438,31040,12914,49045,12509,6074,6435
41620,64496,15441,31045,12916,49054,12511,6075,6436
41625,64500,15443,31047,12918,49056,12511,6075,6436
41630,64510,15447,31053,12921,49062,12513,6076,6437
41635,64516,15447,31056,12921,49068,12515,6076,6439
41640,64527,15449,31060,12922,49078,12517,6077,6440
41645,64531,15451,31064,12924,49079,12517,6077,6440
41650,64541,15456,31071,12929,49084,12519,6077,6442
41655,64547,15456,31074,12929,49090,12521,6078,6443
41660,64558,15459,31078,12931,49098,12523,6080,6443
41665,64562,15461,31081,12933,49099,12523,6080,6443
41670,64572,15465,31086,12937,49106,12525,6082,6443
41675,64578,15465,31090,12937,49111,12527,6083,6444
41680,64589,15469,31097,12941,49119,12529,6084,6445
41685,64593,15469,31098,12941,49124,12529,6084,6445
41690,64603,15470,31100,12941,49133,12531,6085,6446
41695,64609,15470,31102,12941,49138,12533,6086,6447
41700,64620,15471,31106,12941,49149,12535,6086,6449
41705,64624,15471,31108,12941,49152,12535,6086,6449
41710,64634,15473,31114,12943,49161,12537,6088,6449
41715,64640,15473,31116,12943,49167,12539,6089,6450
41720,64651,15476,31123,12945,49174,12541,6091,6450
41725,64655,15476,31125,12945,49178,12541,6091,6450
41730,64665,15478,31130,12947,49187,12543,6092,6451
41735,64671,15478,31132,12947,49193,12545,6093,6452
41740,64682,15480,31138,12949,49201,12547,6094,6453
41745,64686,15481,31141,12950,49204,12547,6094,6453
41750,64696,15484,31149,12952,49212,12549,6096,6453
41755,64702,15484,31150,12952,49218,12551,6097,6454
41760,64713,15487,31159,12955,49225,12553,6099,6454
41765,64717,15487,31160,12955,49229,12553,6099,6454
41770,64727,15490,31166,12958,49237,12555,6100,6455
41775,64733,15490,31171,12958,49243,12557,6102,6455
41780,64744,15492,31179,12960,49251,12559,6104,6455
41785,64748,15492,31181,12960,49255,12559,6104,6455
41790,64758,15495,31185,12962,49263,12561,6104,6457
41795,64764,15495,31188,12962,49269,12563,6105,6458
41800,64775,15497,31194,12964,49277,12565,6107,6458
41805,64779,15497,31195,12964,49281,12565,6107,6458
41810,64789,15501,31198,12967,49288,12567,6108,6459
41815,64795,15502,31200,12968,49293,12569,6109,6460
41820,64806,15504,31204,12969,49299,12571,6109,6462
41825,64810,15509,31207,12974,49300,12571,6109,6462
41830,64820,15512,31213,12977,49306,12573,6109,6464
41835,64826,15515,31218,12980,49309,12575,6111,6464
41840,64837,15520,31222,12985,49317,12577,6111,6466
41845,64841,15520,31224,12985,49320,12577,6111,6466
41850,64851,15525,31231,12990,49325,12579,6113,6466
41855,64857,15526,31233,12991,49330,12581,6114,6467
41860,64868,15530,31239,12995,49335,12583,6114,6469
41865,64872,15533,31240,12998,49338,12583,6114,6469
41870,64882,15536,31245,13001,49345,12585,6115,6470
41875,64888,15538,31247,13003,49349,12587,6115,6472
41880,64899,15541,31254,13006,49357,12589,6117,6472
41885,64903,15542,31257,13007,49361,12589,6117,6472
41890,64913,15543,31264,13008,49369,12591,6119,6472
41895,64919,15545,31268,13010,49373,12593,6120,6473
41900,64930,15547,31274,13012,49381,12595,6121,6474
41905,64934,15548,31275,13013,49386,12595,6121,6474
41910,64944,15549,31279,13013,49395,12597,6123,6474
41915,64950,15550,31282,13014,49400,12599,6124,6475
41920,64961,15551,31286,13015,49409,12601,6124,6477
41925,64965,15551,31287,13015,49414,12601,6124,6477
41930,64975,15554,31291,13017,49421,12603,6125,6478
41935,64981,15555,31295,13018,49425,12605,6126,6479
41940,64992,15557,31300,13020,49434,12607,6127,6480
41945,64996,15557,31302,13020,49439,12607,6127,6480
41950,65006,15559,31308,13022,49445,12609,6128,6481
41955,65012,15562,31311,13025,49450,12611,6129,6482
41960,65023,15564,31316,13027,49458,12613,6131,6482
41965,65027,15564,31318,13027,49463,12613,6131,6482
41970,65037,15565,31322,13028,49470,12615,6132,6483
41975,65043,15567,31325,13030,49476,12617,6133,6484
41980,65054,15568,31330,13031,49485,12619,6135,6484
41985,65058,15569,31331,13032,49489,12619,6135,6484
41990,65068,15572,31335,13034,49495,12621,6136,6485
41995,65074,15573,31337,13035,49499,12623,6136,6487
42000,65085,15576,31339,13038,49508,12625,6136,6489
42005,65089,15578,31340,13040,49511,12625,6136,6489
42010,65099,15582,31345,13043,49516,12627,6137,6490
42015,65105,15583,31348,13044,49521,12629,6139,6490
42020,65116,15586,31350,13047,49530,12631,6139,6492
42025,65120,15588,31354,13049,49530,12631,6139,6492
42030,65130,15594,31360,13055,49535,12633,6140,6493
42035,65136,15595,31362,13056,49540,12635,6141,6494
42040,65147,15599,31368,13059,49545,12637,6142,6495
42045,65151,15602,31369,13062,49548,12637,6142,6495
42050,65161,15606,31375,13065,49554,12639,6143,6496
42055,65167,15606,31378,13065,49560,12641,6144,6497
42060,65178,15609,31382,13067,49568,12643,6145,6498
42065,65182,15609,31383,13067,49573,12643,6145,6498
42070,65192,15611,31388,13069,49580,12645,6145,6500
42075,65198,15611,31391,13069,49586,12647,6146,6501
42080,65209,15613,31396,13070,49595,12649,6146,6503
42085,65213,15614,31399,13071,49598,12649,6146,6503
42090,65223,15615,31403,13072,49608,12651,6147,6504
42095,65229,15615,31407,13072,49613,12653,6149,6504
42100,65240,15616,31412,13073,49624,12655,6150,6505
42105,65244,15617,31415,13074,49627,12655,6150,6505
42110,65254,15619,31422,13076,49635,12657,6152,6505
42115,65260,15619,31422,13076,49641,12659,6152,6507
42120,65271,15620,31426,13076,49651,12661,6153,6508
42125,65275,15620,31427,13076,49655,12661,6153,6508
42130,65285,15622,31434,13078,49662,12663,6154,6509
42135,65291,15622,31440,13078,49668,12665,6156,6509
42140,65302,15624,31445,13079,49678,12667,6156,6511
42145,65306,15625,31448,13080,49681,12667,6156,6511
42150,65316,15627,31453,13081,49689,12669,6157,6512
42155,65322,15627,31457,13081,49695,12671,6159,6512
42160,65333,15628,31462,13081,49705,12673,6161,6512
42165,65337,15628,31462,13081,49709,12673,6161,6512
42170,65347,15631,31466,13082,49716,12675,6163,6512
42175,65353,15631,31468,13082,49722,12677,6165,6512
42180,65364,15633,31472,13084,49731,12679,6165,6514
42185,65368,15634,31474,13085,49734,12679,6165,6514
42190,65378,15637,31479,13087,49741,12681,6167,6514
42195,65384,15637,31483,13087,49746,12683,6168,6515
42200,65395,15642,31490,13092,49751,12685,6169,6516
42205,65399,15644,31491,13094,49754,12685,6169,6516
42210,65409,15650,31498,13099,49759,12687,6171,6516
42215,65415,15650,31503,13099,49763,12689,6172,6517
42220,65426,15655,31509,13103,49768,12691,6172,6519
42225,65430,15659,31511,13107,49770,12691,6172,6519
42230,65440,15665,31518,13112,49775,12693,6173,6520
42235,65446,15665,31522,13112,49780,12695,6175,6520
42240,65457,15667,31526,13113,49788,12697,6176,6521
42245,65461,15668,31526,13114,49793,12697,6176,6521
42250,65471,15671,31533,13117,49799,12699,6178,6521
42255,65477,15672,31536,13118,49804,12701,6179,6522
42260,65488,15674,31540,13120,49812,12703,6180,6523
42265,65492,15676,31542,13122,49815,12703,6180,6523
42270,65502,15677,31545,13122,49823,12705,6180,6525
42275,65508,15680,31548,13125,49827,12707,6180,6527
42280,65519,15681,31552,13125,49836,12709,6181,6528
42285,65523,15683,31555,13127,49839,12709,6181,6528
42290,65533,15684,31560,13127,49847,12711,6182,6529
42295,65539,15686,31562,13129,49852,12713,6183,6530
42300,65550,15689,31567,13131,49860,12715,6185,6530
42305,65554,15690,31570,13132,49864,12715,6185,6530
42310,65564,15692,31575,13133,49870,12717,6186,6531
42315,65570,15695,31579,13136,49875,12719,6187,6532
42320,65581,15697,31583,13138,49883,12721,6188,6533
42325,65585,15698,31585,13139,49886,12721,6188,6533
42330,65595,15701,31591,13141,49893,12723,6190,6533
42335,65601,15702,31595,13142,49898,12725,6191,6534
42340,65612,15705,31603,13145,49905,12727,6193,6534
42345,65616,15706,31604,13146,49910,12727,6193,6534
42350,65626,15709,31608,13147,49915,12729,6193,6536
42355,65632,15711,31611,13149,49919,12731,6194,6537
42360,65643,15717,31618,13154,49925,12733,6196,6537
42365,65647,15717,31620,13154,49930,12733,6196,6537
42370,65657,15719,31625,13156,49938,12735,6197,6538
42375,65663,15719,31627,13156,49942,12737,6197,6540
42380,65674,15720,31633,13157,49953,12739,6198,6541
42385,65678,15720,31635,13157,49958,12739,6198,6541
42390,65688,15722,31641,13158,49966,12741,6199,6542
42395,65694,15722,31645,13158,49970,12743,6200,6543
42400,65705,15725,31650,13161,49979,12745,6200,6545
42405,65709,15727,31653,13163,49982,12745,6200,6545
42410,65719,15729,31659,13165,49990,12747,6202,6545
42415,65725,15729,31661,13165,49996,12749,6204,6545
42420,65736,15730,31663,13166,50006,12751,6204,6547
42425,65740,15731,31665,13167,50009,12751,6204,6547
42430,65750,15733,31667,13168,50017,12753,6204,6549
42435,65756,15733,31671,13168,50023,12755,6206,6549
42440,65767,15734,31676,13169,50033,12757,6207,6550
42445,65771,15735,31679,13170,50034,12757,6207,6550
42450,65781,15740,31683,13174,50041,12759,6208,6551
42455,65787,15740,31687,13174,50045,12761,6210,6551
42460,65798,15743,31692,13177,50053,12763,6211,6552
42465,65802,15746,31695,13180,50054,12763,6211,6552
42470,65812,15752,31702,13185,50060,12765,6212,6553
42475,65818,15752,31705,13185,50065,12767,6212,6555
42480,65829,15755,31708,13187,50074,12769,6212,6557
42485,65833,15756,31710,13188,50077,12769,6212,6557
42490,65843,15759,31716,13190,50084,12771,6213,6558
42495,65849,15759,31717,13190,50090,12773,6213,6560
42500,65860,15761,31723,13191,50097,12775,6215,6560
42505,65864,15762,31727,13192,50101,12775,6215,6560
42510,65874,15765,31733,13195,50109,12777,6216,6561
42515,65880,15765,31738,13195,50115,12779,6218,6561
42520,65891,15767,31744,13196,50122,12781,6219,6562
42525,65895,15768,31746,13197,50127,12781,6219,6562
42530,65905,15770,31752,13198,50133,12783,6220,6563
42535,65911,15772,31752,13200,50139,12785,6220,6565
42540,65922,15775,31756,13202,50146,12787,6221,6566
42545,65926,15776,31757,13203,50149,12787,6221,6566
42550,65936,15777,31757,13203,50159,12789,6221,6568
42555,65942,15777,31758,13203,50165,12791,6221,6570
42560,65953,15780,31767,13205,50170,12793,6223,6570
42565,65957,15782,31770,13207,50175,12793,6223,6570
42570,65967,15783,31773,13207,50183,12795,6223,6572
42575,65973,15785,31779,13209,50187,12797,6225,6572
42580,65984,15789,31785,13213,50193,12799,6226,6573
42585,65988,15790,31787,13214,50197,12799,6226,6573
42590,65998,15794,31792,13216,50203,12801,6227,6574
42595,66004,15795,31793,13217,50208,12803,6227,6576
42600,66015,15798,31799,13219,50216,12805,6228,6577
42605,66019,15799,31800,13220,50220,12805,6228,6577
42610,66029,15802,31805,13223,50226,12807,6229,6578
42615,66035,15803,31808,13224,50231,12809,6230,6579
42620,66046,15806,31813,13227,50239,12811,6230,6581
42625,66050,15807,31816,13228,50243,12811,6230,6581
42630,66060,15810,31821,13231,50250,12813,6231,6582
42635,66066,15810,31824,13231,50255,12815,6233,6582
42640,66077,15813,31827,13233,50264,12817,6234,6583
42645,66081,15814,31828,13234,50267,12817,6234,6583
42650,66091,15817,31833,13236,50273,12819,6235,6584
42655,66097,15819,31837,13238,50277,12821,6236,6585
42660,66108,15822,31844,13241,50286,12823,6238,6585
42665,66112,15823,31847,13242,50289,12823,6238,6585
42670,66122,15827,31850,13244,50295,12825,6239,6586
42675,66128,15828,31852,13245,50300,12827,6239,6588
42680,66139,15832,31859,13249,50305,12829,6240,6589
42685,66143,15834,31860,13251,50308,12829,6240,6589
42690,66153,15839,31866,13255,50313,12831,6241,6590
42695,66159,15841,31869,13257,50317,12833,6242,6591
42700,66170,15843,31871,13259,50327,12835,6243,6592
42705,66174,15844,31873,13260,50329,12835,6243,6592
42710,66184,15847,31876,13262,50336,12837,6244,6593
42715,66190,15848,31878,13263,50340,12839,6244,6595
42720,66201,15852,31882,13267,50348,12841,6245,6596
42725,66205,15854,31883,13269,50351,12841,6245,6596
42730,66215,15858,31887,13272,50356,12843,6245,6598
42735,66221,15859,31890,13273,50361,12845,6247,6598
42740,66232,15863,31895,13276,50368,12847,6249,6598
42745,66236,15865,31897,13278,50370,12847,6249,6598
42750,66246,15870,31903,13283,50375,12849,6250,6599
42755,66252,15871,31905,13284,50380,12851,6251,6600
42760,66263,15875,31912,13288,50386,12853,6253,6600
42765,66267,15878,31913,13291,50389,12853,6253,6600
42770,66277,15883,31920,13295,50392,12855,6254,6601
42775,66283,15884,31924,13296,50396,12857,6254,6603
42780,66294,15887,31929,13298,50406,12859,6255,6604
42785,66298,15887,31932,13298,50410,12859,6255,6604
42790,66308,15887,31937,13298,50420,12861,6256,6605
42795,66314,15887,31941,13298,50425,12863,6257,6606
42800,66325,15887,31946,13298,50437,12865,6257,6608
42805,66329,15887,31948,13298,50441,12865,6257,6608
42810,66339,15887,31951,13298,50452,12867,6258,6609
42815,66345,15887,31953,13298,50458,12869,6259,6610
42820,66356,15887,31956,13298,50469,12871,6260,6611
42825,66360,15887,31957,13298,50473,12871,6260,6611
42830,66370,15887,31963,13298,50482,12873,6262,6611
42835,66376,15887,31966,13298,50488,12875,6263,6612
42840,66387,15887,31970,13298,50499,12877,6264,6613
42845,66391,15887,31972,13298,50504,12877,6264,6613
42850,66401,15887,31977,13298,50513,12879,6266,6613
42855,66407,15887,31978,13298,50519,12881,6266,6615
42860,66418,15887,31983,13298,50531,12883,6267,6616
42865,66422,15887,31985,13298,50534,12883,6267,6616
42870,66432,15887,31989,13298,50544,12885,6267,6618
42875,66438,15887,31992,13298,50550,12887,6268,6619
42880,66449,15887,31999,13298,50559,12889,6268,6621
42885,66453,15888,32000,13299,50565,12889,6268,6621
42890,66463,15890,32004,13299,50573,12891,6270,6621
42895,66469,15890,32007,13299,50579,12893,6271,6622
42900,66480,15893,32014,13302,50585,12895,6272,6623
42905,66484,15895,32017,13304,50587,12895,6272,6623
42910,66494,15900,32021,13308,50594,12897,6273,6624
42915,66500,15900,32021,13308,50600,12899,6273,6626
42920,66511,15904,32029,13312,50605,12901,6274,6627
42925,66515,15908,32032,13316,50606,12901,6274,6627
42930,66525,15913,32036,13320,50612,12903,6274,6629
42935,66531,15913,32038,13320,50617,12905,6274,6631
42940,66542,15917,32042,13323,50624,12907,6275,6632
42945,66546,15918,32042,13324,50628,12907,6275,6632
42950,66556,15923,32046,13328,50633,12909,6275,6634
42955,66562,15923,32048,13328,50638,12911,6276,6635
42960,66573,15928,32053,13332,50644,12913,6277,6636
42965,66577,15929,32056,13333,50647,12913,6277,6636
42970,66587,15932,32061,13336,50654,12915,6278,6637
42975,66593,15933,32064,13337,50660,12917,6280,6637
42980,66604,15935,32069,13338,50668,12919,6280,6639
42985,66608,15937,32071,13340,50671,12919,6280,6639
42990,66618,15940,32076,13343,50677,12921,6280,6641
42995,66624,15942,32079,13345,50681,12923,6280,6643
43000,66635,15945,32084,13348,50690,12925,6282,6643
43005,66639,15946,32087,13349,50692,12925,6282,6643
43010,66649,15947,32091,13350,50702,12927,6282,6645
43015,66655,15948,32095,13351,50706,12929,6283,6646
43020,66666,15950,32100,13352,50715,12931,6283,6648
43025,66670,15952,32101,13354,50718,12931,6283,6648
43030,66680,15954,32106,13355,50725,12933,6285,6648
43035,66686,15956,32111,13357,50730,12935,6287,6648
43040,66697,15958,32119,13359,50737,12937,6288,6649
43045,66701,15959,32120,13360,50742,12937,6288,6649
43050,66711,15961,32127,13361,50748,12939,6289,6650
43055,66717,15963,32129,13363,50754,12941,6291,6650
43060,66728,15966,32135,13365,50761,12943,6292,6651
43065,66732,15966,32135,13365,50766,12943,6292,6651
43070,66742,15968,32140,13366,50773,12945,6294,6651
43075,66748,15969,32144,13367,50778,12947,6296,6651
43080,66759,15971,32146,13369,50788,12949,6296,6653
43085,66763,15972,32148,13370,50791,12949,6296,6653
43090,66773,15975,32153,13372,50798,12951,6297,6654
43095,66779,15975,32157,13372,50803,12953,6299,6654
43100,66790,15978,32161,13374,50812,12955,6300,6655
43105,66794,15978,32163,13374,50816,12955,6300,6655
43110,66804,15981,32170,13377,50823,12957,6302,6655
43115,66810,15981,32173,13377,50828,12959,6303,6656
43120,66821,15984,32178,13379,50835,12961,6305,6656
43125,66825,15986,32179,13381,50839,12961,6305,6656
43130,66835,15988,32184,13383,50847,12963,6307,6656
43135,66841,15988,32189,13383,50852,12965,6309,6656
43140,66852,15993,32195,13387,50857,12967,6310,6657
43145,66856,15996,32197,13390,50859,12967,6310,6657
43150,66866,16003,32203,13396,50863,12969,6310,6659
43155,66872,16003,32206,13396,50868,12971,6311,6660
43160,66883,16005,32210,13398,50876,12973,6312,6661
43165,66887,16008,32212,13401,50878,12973,6312,6661
43170,66897,16012,32217,13405,50885,12975,6313,6662
43175,66903,16012,32221,13405,50889,12977,6314,6663
43180,66914,16015,32222,13407,50899,12979,6315,6664
43185,66918,16016,32224,13408,50901,12979,6315,6664
43190,66928,16021,32230,13413,50906,12981,6316,6665
43195,66934,16023,32232,13415,50910,12983,6316,6667
43200,66945,16029,32240,13421,50914,12985,6316,6669
43205,66949,16029,32241,13421,50919,12985,6316,6669
43210,66959,16030,32243,13421,50929,12987,6316,6671
43215,66965,16030,32246,13421,50934,12989,6317,6672
43220,66976,16033,32255,13423,50940,12991,6319,6672
43225,66980,16035,32257,13425,50945,12991,6319,6672
43230,66990,16037,32261,13426,50953,12993,6320,6673
43235,66996,16037,32263,13426,50958,12995,6320,6675
43240,67007,16040,32272,13429,50965,12997,6322,6675
43245,67011,16041,32273,13430,50969,12997,6322,6675
43250,67021,16044,32277,13432,50976,12999,6323,6676
43255,67027,16046,32280,13434,50980,13001,6323,6678
43260,67038,16050,32288,13437,50985,13003,6324,6679
43265,67042,16051,32290,13438,50990,13003,6324,6679
43270,67052,16052,32296,13438,51000,13005,6326,6679
43275,67058,16052,32300,13438,51005,13007,6328,6679
43280,67069,16054,32305,13440,51015,13009,6330,6679
43285,67073,16054,32308,13440,51018,13009,6330,6679
43290,67083,16055,32312,13440,51028,13011,6330,6681
43295,67089,16056,32315,13441,51033,13013,6330,6683
43300,67100,16056,32322,13441,51042,13015,6331,6684
43305,67104,16057,32323,13442,51047,13015,6331,6684
43310,67114,16059,32328,13443,51054,13017,6332,6685
43315,67120,16060,32329,13444,51060,13019,6333,6686
43320,67131,16060,32332,13444,51070,13021,6333,6688
43325,67135,16061,32333,13445,51074,13021,6333,6688
43330,67145,16063,32342,13447,51081,13023,6335,6688
43335,67151,16065,32345,13449,51086,13025,6337,6688
43340,67162,16066,32351,13450,51095,13027,6338,6689
43345,67166,16068,32354,13452,51098,13027,6338,6689
43350,67176,16070,32361,13453,51105,13029,6340,6689
43355,67182,16072,32364,13455,51109,13031,6341,6690
43360,67193,16075,32370,13458,51118,13033,6343,6690
43365,67197,16075,32372,13458,51121,13033,6343,6690
43370,67207,16079,32377,13460,51127,13035,6345,6690
43375,67213,16080,32378,13461,51133,13037,6346,6691
43380,67224,16081,32383,13462,51143,13039,6348,6691
43385,67228,16082,32384,13463,51146,13039,6348,6691
43390,67238,16085,32389,13465,51152,13041,6349,6692
43395,67244,16087,32391,13467,51157,13043,6349,6694
43400,67255,16089,32394,13469,51166,13045,6349,6696
43405,67259,16091,32398,13471,51167,13045,6349,6696
43410,67269,16095,32405,13475,51174,13047,6349,6698
43415,67275,16095,32406,13475,51179,13049,6349,6700
43420,67286,16097,32408,13476,51189,13051,6349,6702
43425,67290,16098,32410,13477,51191,13051,6349,6702
43430,67300,16103,32418,13482,51196,13053,6350,6703
43435,67306,16103,32422,13482,51202,13055,6352,6703
43440,67317,16105,32427,13484,51210,13057,6353,6704
43445,67321,16108,32429,13487,51212,13057,6353,6704
43450,67331,16112,32434,13490,51218,13059,6354,6705
43455,67337,16112,32437,13490,51224,13061,6355,6706
43460,67348,16116,32444,13494,51231,13063,6356,6707
43465,67352,16118,32447,13496,51232,13063,6356,6707
43470,67362,16123,32449,13500,51239,13065,6356,6709
43475,67368,16123,32453,13500,51243,13067,6358,6709
43480,67379,16126,32457,13502,51252,13069,6360,6709
43485,67383,16127,32457,13503,51256,13069,6360,6709
43490,67393,16129,32463,13505,51264,13071,6362,6709
43495,67399,16129,32466,13505,51270,13073,6363,6710
43500,67410,16131,32471,13506,51278,13075,6364,6711
43505,67414,16131,32472,13506,51282,13075,6364,6711
43510,67424,16133,32477,13508,51291,13077,6364,6713
43515,67430,16133,32479,13508,51296,13079,6364,6715
43520,67441,16135,32486,13509,51305,13081,6365,6716
43525,67445,16135,32487,13509,51310,13081,6365,6716
43530,67455,16137,32492,13511,51318,13083,6366,6717
43535,67461,16137,32495,13511,51323,13085,6368,6717
43540,67472,16138,32500,13511,51332,13087,6369,6718
43545,67476,16138,32502,13511,51338,13087,6369,6718
43550,67486,16140,32507,13513,51346,13089,6370,6719
43555,67492,16140,32511,13513,51351,13091,6372,6719
43560,67503,16142,32514,13514,51360,13093,6373,6720
43565,67507,16144,32515,13516,51363,13093,6373,6720
43570,67517,16146,32520,13518,51370,13095,6374,6721
43575,67523,16148,32523,13520,51374,13097,6375,6722
43580,67534,16150,32528,13522,51383,13099,6377,6722
43585,67538,16151,32530,13523,51386,13099,6377,6722
43590,67548,16153,32534,13524,51394,13101,6378,6723
43595,67554,16154,32537,13525,51400,13103,6379,6724
43600,67565,16157,32544,13527,51405,13105,6380,6725
43605,67569,16160,32546,13530,51409,13105,6380,6725
43610,67579,16163,32552,13532,51416,13107,6382,6725
43615,67585,16164,32556,13533,51420,13109,6384,6725
43620,67596,16169,32564,13538,51425,13111,6386,6725
43625,67600,16171,32565,13540,51429,13111,6386,6725
43630,67610,16174,32572,13543,51435,13113,6388,6725
43635,67616,16176,32576,13545,51438,13115,6389,6726
43640,67627,16182,32582,13551,51443,13117,6389,6728
43645,67631,16185,32586,13554,51445,13117,6389,6728
43650,67641,16190,32589,13557,51451,13119,6390,6729
43655,67647,16191,32593,13558,51455,13121,6392,6729
43660,67658,16194,32596,13560,51464,13123,6394,6729
43665,67662,16194,32597,13560,51467,13123,6394,6729
43670,67672,16197,32601,13562,51473,13125,6395,6730
43675,67678,16200,32605,13565,51476,13127,6396,6731
43680,67689,16206,32610,13571,51483,13129,6397,6732
43685,67693,16207,32612,13572,51485,13129,6397,6732
43690,67703,16210,32612,13573,51493,13131,6397,6734
43695,67709,16210,32615,13573,51497,13133,6398,6735
43700,67720,16214,32618,13577,51505,13135,6398,6737
43705,67724,16216,32620,13579,51507,13135,6398,6737
43710,67734,16221,32627,13584,51512,13137,6400,6737
43715,67740,16223,32632,13586,51515,13139,6401,6738
43720,67751,16225,32636,13588,51524,13141,6401,6740
43725,67755,16226,32638,13589,51528,13141,6401,6740
43730,67765,16227,32642,13590,51538,13143,6402,6741
43735,67771,16227,32645,13590,51542,13145,6403,6742
43740,67782,16229,32649,13591,51551,13147,6403,6744
43745,67786,16231,32651,13593,51555,13147,6403,6744
43750,67796,16232,32656,13594,51564,13149,6403,6746
43755,67802,16232,32659,13594,51570,13151,6405,6746
43760,67813,16234,32664,13595,51578,13153,6406,6747
43765,67817,16234,32665,13595,51583,13153,6406,6747
43770,67827,16236,32668,13596,51591,13155,6406,6749
43775,67833,16236,32672,13596,51597,13157,6408,6749
43780,67844,16237,32675,13596,51607,13159,6410,6749
43785,67848,16237,32678,13596,51610,13159,6410,6749
43790,67858,16238,32681,13596,51620,13161,6411,6750
43795,67864,16238,32684,13596,51626,13163,6411,6752
43800,67875,16239,32687,13597,51635,13165,6411,6754
43805,67879,16239,32690,13597,51640,13165,6411,6754
43810,67889,16242,32696,13599,51647,13167,6412,6755
43815,67895,16242,32698,13599,51653,13169,6413,6756
43820,67906,16246,32707,13603,51659,13171,6415,6756
43825,67910,16247,32709,13604,51663,13171,6415,6756
43830,67920,16251,32715,13607,51669,13173,6416,6757
43835,67926,16251,32718,13607,51674,13175,6417,6758
43840,67937,16254,32725,13610,51680,13177,6419,6758
43845,67941,16255,32726,13611,51686,13177,6419,6758
43850,67951,16257,32727,13611,51693,13179,6419,6760
43855,67957,16259,32730,13613,51697,13181,6419,6762
43860,67968,16261,32735,13614,51704,13183,6420,6763
43865,67972,16262,32736,13615,51710,13183,6420,6763
43870,67982,16265,32742,13617,51715,13185,6420,6765
43875,67988,16267,32745,13619,51720,13187,6422,6765
43880,67999,16272,32752,13623,51724,13189,6423,6766
43885,68003,16275,32754,13626,51727,13189,6423,6766
43890,68013,16279,32759,13629,51733,13191,6425,6766
43895,68019,16281,32764,13631,51737,13193,6427,6766
43900,68030,16285,32768,13635,51744,13195,6427,6768
43905,68034,16288,32770,13638,51746,13195,6427,6768
43910,68044,16293,32775,13642,51750,13197,6427,6770
43915,68050,16295,32777,13644,51755,13199,6428,6771
43920,68061,16298,32782,13646,51761,13201,6429,6772
43925,68065,16301,32784,13649,51764,13201,6429,6772
43930,68075,16304,32790,13651,51770,13203,6430,6773
43935,68081,16305,32792,13652,51774,13205,6430,6775
43940,68092,16307,32795,13654,51783,13207,6430,6777
43945,68096,16310,32797,13657,51785,13207,6430,6777
43950,68106,16311,32799,13657,51794,13209,6431,6778
43955,68112,16312,32802,13658,51799,13211,6432,6779
43960,68123,16314,32808,13660,51808,13213,6433,6780
43965,68127,16315,32811,13661,51811,13213,6433,6780
43970,68137,16315,32815,13661,51822,13215,6434,6781
43975,68143,16315,32817,13661,51827,13217,6434,6783
43980,68154,16315,32820,13661,51838,13219,6434,6785
43985,68158,16315,32822,13661,51843,13219,6434,6785
43990,68168,16315,32827,13661,51852,13221,6436,6785
43995,68174,16315,32832,13661,51859,13223,6438,6785
44000,68185,16315,32841,13661,51870,13225,6440,6785
44005,68189,16315,32842,13661,51874,13225,6440,6785
44010,68199,16315,32845,13661,51884,13227,6440,6787
44015,68205,16315,32846,13661,51890,13229,6441,6788
44020,68216,16315,32850,13661,51901,13231,6442,6789
44025,68220,16315,32852,13661,51905,13231,6442,6789
44030,68230,16316,32859,13662,51914,13233,6444,6789
44035,68236,16316,32860,13662,51919,13235,6444,6791
44040,68247,16318,32865,13664,51929,13237,6445,6792
44045,68251,16318,32868,13664,51933,13237,6445,6792
44050,68261,16319,32875,13665,51941,13239,6446,6793
44055,68267,16319,32877,13665,51947,13241,6447,6794
44060,68278,16322,32883,13668,51955,13243,6449,6794
44065,68282,16324,32884,13670,51958,13243,6449,6794
44070,68292,16327,32887,13671,51965,13245,6449,6796
44075,68298,16327,32888,13671,51971,13247,6449,6798
44080,68309,16330,32894,13673,51979,13249,6451,6798
44085,68313,16331,32896,13674,51981,13249,6451,6798
44090,68323,16336,32901,13678,51986,13251,6452,6799
44095,68329,16337,32903,13679,51990,13253,6452,6801
44100,68340,16343,32907,13684,51996,13255,6452,6803
44105,68344,16345,32909,13686,51998,13255,6452,6803
44110,68354,16350,32914,13691,52004,13257,6453,6804
44115,68360,16350,32916,13691,52009,13259,6454,6805
44120,68371,16353,32918,13693,52017,13261,6454,6807
44125,68375,16355,32920,13695,52019,13261,6454,6807
44130,68385,16360,32925,13699,52024,13263,6455,6808
44135,68391,16361,32927,13700,52029,13265,6456,6809
44140,68402,16366,32933,13705,52034,13267,6456,6811
44145,68406,16369,32936,13708,52036,13267,6456,6811
44150,68416,16371,32940,13709,52045,13269,6458,6811
44155,68422,16371,32941,13709,52051,13271,6459,6812
44160,68433,16373,32947,13711,52058,13273,6461,6812
44165,68437,16375,32951,13713,52061,13273,6461,6812
44170,68447,16377,32957,13715,52068,13275,6461,6814
44175,68453,16379,32961,13717,52073,13277,6462,6815
44180,68464,16381,32966,13719,52082,13279,6464,6815
44185,68468,16382,32968,13720,52085,13279,6464,6815
44190,68478,16385,32975,13722,52091,13281,6465,6816
44195,68484,16387,32978,13724,52097,13283,6467,6816
44200,68495,16389,32983,13726,52105,13285,6467,6818
44205,68499,16390,32984,13727,52109,13285,6467,6818
44210,68509,16392,32990,13729,52116,13287,6468,6819
44215,68515,16394,32994,13731,52121,13289,6470,6819
44220,68526,16395,32999,13731,52129,13291,6471,6820
44225,68530,16397,33001,13733,52133,13291,6471,6820
44230,68540,16399,33003,13734,52141,13293,6472,6821
44235,68546,16399,33006,13734,52147,13295,6473,6822
44240,68557,16402,33011,13736,52154,13297,6473,6824
44245,68561,16402,33012,13736,52159,13297,6473,6824
44250,68571,16405,33018,13737,52166,13299,6475,6824
44255,68577,16405,33019,13737,52172,13301,6476,6825
44260,68588,16407,33024,13739,52180,13303,6478,6825
44265,68592,16408,33024,13740,52184,13303,6478,6825
44270,68602,16411,33027,13741,52191,13305,6479,6826
44275,68608,16411,33031,13741,52195,13307,6479,6828
44280,68619,16415,33037,13745,52203,13309,6481,6828
44285,68623,16416,33039,13746,52205,13309,6481,6828
44290,68633,16422,33043,13751,52211,13311,6481,6830
44295,68639,16422,33047,13751,52217,13313,6483,6830
44300,68650,16424,33052,13752,52224,13315,6484,6831
44305,68654,16428,33055,13756,52225,13315,6484,6831
44310,68664,16433,33058,13759,52231,13317,6485,6832
44315,68670,16433,33063,13759,52236,13319,6487,6832
44320,68681,16437,33066,13762,52244,13321,6487,6834
44325,68685,16438,33068,13763,52246,13321,6487,6834
44330,68695,16442,33073,13767,52252,13323,6488,6835
44335,68701,16444,33077,13769,52256,13325,6490,6835
44340,68712,16449,33084,13773,52261,13327,6492,6835
44345,68716,16452,33088,13776,52263,13327,6492,6835
44350,68726,16454,33092,13778,52271,13329,6493,6836
44355,68732,16456,33097,13780,52275,13331,6495,6836
44360,68743,16457,33100,13781,52285,13333,6495,6838
44365,68747,16459,33103,13783,52287,13333,6495,6838
44370,68757,16462,33109,13786,52295,13335,6496,6839
44375,68763,16463,33112,13787,52299,13337,6496,6841
44380,68774,16464,33117,13788,52308,13339,6496,6843
44385,68778,16465,33119,13789,52312,13339,6496,6843
44390,68788,16466,33121,13789,52322,13341,6497,6844
44395,68794,16467,33123,13790,52327,13343,6497,6846
44400,68805,16468,33129,13791,52335,13345,6499,6846
44405,68809,16469,33131,13792,52340,13345,6499,6846
44410,68819,16470,33136,13792,52348,13347,6501,6846
44415,68825,16471,33138,13793,52354,13349,6503,6846
44420,68836,16472,33144,13794,52362,13351,6504,6847
44425,68840,16473,33146,13795,52367,13351,6504,6847
44430,68850,16474,33150,13795,52376,13353,6504,6849
44435,68856,16474,33152,13795,52381,13355,6505,6850
44440,68867,16475,33157,13796,52391,13357,6505,6852
44445,68871,16475,33159,13796,52395,13357,6505,6852
44450,68881,16476,33162,13797,52404,13359,6505,6854
44455,68887,16477,33165,13798,52408,13361,6506,6855
44460,68898,16480,33170,13801,52417,13363,6507,6856
44465,68902,16481,33172,13802,52421,13363,6507,6856
44470,68912,16483,33178,13804,52428,13365,6508,6857
44475,68918,16484,33180,13805,52434,13367,6510,6857
44480,68929,16486,33185,13807,52441,13369,6511,6858
44485,68933,16489,33187,13810,52443,13369,6511,6858
44490,68943,16493,33191,13812,52448,13371,6512,6859
44495,68949,16495,33193,13814,52452,13373,6512,6861
44500,68960,16499,33198,13818,52461,13375,6513,6862
44505,68964,16499,33199,13818,52464,13375,6513,6862
44510,68974,16502,33201,13821,52472,13377,6513,6864
44515,68980,16502,33202,13821,52477,13379,6513,6866
44520,68991,16505,33210,13823,52483,13381,6515,6866
44525,68995,16509,33212,13827,52485,13381,6515,6866
44530,69005,16514,33216,13831,52490,13383,6515,6868
44535,69011,16514,33217,13831,52497,13385,6516,6869
44540,69022,16515,33221,13831,52506,13387,6516,6871
44545,69026,16516,33223,13832,52510,13387,6516,6871
44550,69036,16516,33224,13832,52519,13389,6516,6873
44555,69042,16516,33227,13832,52525,13391,6517,6874
44560,69053,16518,33232,13833,52535,13393,6518,6875
44565,69057,16518,33235,13833,52539,13393,6518,6875
44570,69067,16519,33238,13834,52548,13395,6519,6876
44575,69073,16519,33240,13834,52554,13397,6519,6878
44580,69084,16520,33243,13835,52564,13399,6520,6879
44585,69088,16520,33245,13835,52568,13399,6520,6879
44590,69098,16520,33249,13835,52578,13401,6520,6881
44595,69104,16520,33251,13835,52584,13403,6520,6883
44600,69115,16521,33256,13836,52593,13405,6521,6884
44605,69119,16521,33258,13836,52598,13405,6521,6884
44610,69129,16522,33261,13837,52607,13407,6523,6884
44615,69135,16522,33264,13837,52612,13409,6523,6886
44620,69146,16524,33273,13839,52620,13411,6524,6887
44625,69150,16525,33276,13840,52625,13411,6524,6887
44630,69160,16527,33282,13841,52632,13413,6524,6889
44635,69166,16527,33286,13841,52637,13415,6525,6890
44640,69177,16529,33290,13842,52646,13417,6526,6891
44645,69181,16531,33290,13844,52650,13417,6526,6891
44650,69191,16535,33294,13847,52656,13419,6527,6892
44655,69197,16535,33297,13847,52661,13421,6528,6893
44660,69208,16540,33302,13851,52668,13423,6529,6894
44665,69212,16541,33304,13852,52671,13423,6529,6894
44670,69222,16546,33309,13856,52676,13425,6530,6895
44675,69228,16546,33314,13856,52682,13427,6532,6895
44680,69239,16550,33321,13860,52688,13429,6532,6897
44685,69243,16552,33324,13862,52690,13429,6532,6897
44690,69253,16556,33327,13865,52697,13431,6532,6899
44695,69259,16556,33329,13865,52703,13433,6532,6901
44700,69270,16558,33335,13866,52712,13435,6534,6901
44705,69274,16559,33336,13867,52715,13435,6534,6901
44710,69284,16563,33339,13869,52721,13437,6534,6903
44715,69290,16563,33340,13869,52726,13439,6534,6905
44720,69301,16567,33346,13872,52733,13441,6535,6906
44725,69305,16568,33346,13873,52737,13441,6535,6906
44730,69315,16572,33351,13875,52743,13443,6537,6906
44735,69321,16572,33353,13875,52748,13445,6537,6908
44740,69332,16576,33359,13879,52755,13447,6538,6909
44745,69336,16578,33362,13881,52757,13447,6538,6909
44750,69346,16580,33368,13883,52765,13449,6539,6910
44755,69352,16581,33371,13884,52770,13451,6540,6911
44760,69363,16583,33376,13885,52779,13453,6541,6912
44765,69367,16584,33379,13886,52783,13453,6541,6912
44770,69377,16586,33383,13888,52791,13455,6542,6913
44775,69383,16586,33384,13888,52797,13457,6542,6915
44780,69394,16587,33388,13888,52806,13459,6543,6916
44785,69398,16588,33391,13889,52809,13459,6543,6916
44790,69408,16590,33396,13891,52818,13461,6544,6917
44795,69414,16591,33399,13892,52823,13463,6545,6918
44800,69425,16592,33401,13893,52833,13465,6545,6920
44805,69429,16593,33402,13894,52836,13465,6545,6920
44810,69439,16595,33407,13895,52843,13467,6545,6922
44815,69445,16597,33411,13897,52847,13469,6546,6923
44820,69456,16601,33417,13900,52854,13471,6546,6925
44825,69460,16601,33417,13900,52859,13471,6546,6925
44830,69470,16603,33421,13902,52865,13473,6546,6927
44835,69476,16606,33423,13905,52870,13475,6547,6928
44840,69487,16608,33428,13906,52876,13477,6548,6929
44845,69491,16609,33430,13907,52881,13477,6548,6929
44850,69501,16613,33436,13909,52888,13479,6550,6929
44855,69507,16613,33441,13909,52892,13481,6552,6929
44860,69518,16617,33448,13913,52899,13483,6554,6929
44865,69522,16618,33450,13914,52902,13483,6554,6929
44870,69532,16623,33454,13919,52908,13485,6554,6931
44875,69538,16624,33456,13920,52913,13487,6555,6932
44880,69549,16626,33458,13921,52921,13489,6555,6934
44885,69553,16629,33459,13924,52924,13489,6555,6934
44890,69563,16634,33467,13929,52928,13491,6557,6934
44895,69569,16636,33470,13931,52931,13493,6557,6936
44900,69580,16639,33475,13934,52939,13495,6559,6936
44905,69584,16642,33476,13937,52942,13495,6559,6936
44910,69594,16647,33481,13941,52946,13497,6559,6938
44915,69600,16649,33483,13943,52950,13499,6559,6940
44920,69611,16651,33484,13944,52960,13501,6560,6941
44925,69615,16652,33486,13945,52962,13501,6560,6941
44930,69625,16656,33490,13947,52967,13503,6561,6942
44935,69631,16659,33493,13950,52970,13505,6561,6944
44940,69642,16663,33498,13954,52977,13507,6562,6945
44945,69646,16665,33502,13956,52980,13507,6562,6945
44950,69656,16666,33505,13956,52989,13509,6563,6946
44955,69662,16667,33508,13957,52993,13511,6564,6947
44960,69673,16670,33513,13960,53001,13513,6565,6948
44965,69677,16671,33516,13961,53005,13513,6565,6948
44970,69687,16672,33521,13961,53013,13515,6566,6949
44975,69693,16675,33524,13964,53018,13517,6567,6950
44980,69704,16677,33528,13965,53025,13519,6567,6952
44985,69708,16679,33531,13967,53028,13519,6567,6952
44990,69718,16682,33536,13969,53036,13521,6567,6954
44995,69724,16682,33538,13969,53042,13523,6569,6954
45000,69735,16684,33545,13970,53049,13525,6570,6955
45005,69739,16685,33546,13971,53054,13525,6570,6955
45010,69749,16687,33550,13973,53061,13527,6571,6956
45015,69755,16689,33553,13975,53066,13529,6573,6956
45020,69766,16691,33559,13977,53074,13531,6574,6957
45025,69770,16691,33559,13977,53079,13531,6574,6957
45030,69780,16693,33566,13979,53086,13533,6576,6957
45035,69786,16695,33570,13981,53090,13535,6577,6958
45040,69797,16697,33574,13983,53098,13537,6578,6959
45045,69801,16698,33576,13984,53103,13537,6578,6959
45050,69811,16701,33581,13985,53108,13539,6579,6960
45055,69817,16703,33584,13987,53113,13541,6580,6961
45060,69828,16706,33589,13990,53120,13543,6581,6962
45065,69832,16706,33590,13990,53126,13543,6581,6962
45070,69842,16708,33592,13991,53134,13545,6581,6964
45075,69848,16708,33596,13991,53140,13547,6583,6964
45080,69859,16711,33603,13994,53147,13549,6584,6965
45085,69863,16711,33604,13994,53152,13549,6584,6965
45090,69873,16714,33607,13996,53158,13551,6584,6967
45095,69879,16714,33612,13996,53164,13553,6586,6967
45100,69890,16715,33614,13996,53174,13555,6586,6969
45105,69894,16716,33617,13997,53177,13555,6586,6969
45110,69904,16721,33625,14002,53182,13557,6588,6969
45115,69910,16721,33629,14002,53187,13559,6589,6970
45120,69921,16725,33634,14006,53195,13561,6589,6972
45125,69925,16727,33636,14008,53198,13561,6589,6972
45130,69935,16730,33640,14010,53205,13563,6590,6973
45135,69941,16730,33644,14010,53210,13565,6591,6974
45140,69952,16731,33651,14011,53220,13567,6593,6974
45145,69956,16732,33653,14012,53224,13567,6593,6974
45150,69966,16734,33656,14013,53232,13569,6594,6975
45155,69972,16734,33661,14013,53237,13571,6595,6976
45160,69983,16737,33667,14016,53245,13573,6595,6978
45165,69987,16739,33671,14018,53247,13573,6595,6978
45170,69997,16742,33677,14019,53255,13575,6596,6979
45175,70003,16742,33681,14019,53260,13577,6597,6980
45180,70014,16745,33686,14022,53269,13579,6599,6980
45185,70018,16745,33687,14022,53273,13579,6599,6980
45190,70028,16747,33690,14023,53281,13581,6601,6980
45195,70034,16747,33693,14023,53287,13583,6602,6981
45200,70045,16748,33698,14024,53296,13585,6603,6982
45205,70049,16750,33702,14026,53298,13585,6603,6982
45210,70059,16754,33707,14029,53305,13587,6603,6984
45215,70065,16754,33711,14029,53310,13589,6604,6985
45220,70076,16756,33717,14031,53319,13591,6605,6986
45225,70080,16758,33718,14033,53322,13591,6605,6986
45230,70090,16759,33722,14034,53331,13593,6606,6987
45235,70096,16759,33725,14034,53336,13595,6607,6988
45240,70107,16762,33733,14036,53344,13597,6608,6989
45245,70111,16763,33735,14037,53348,13597,6608,6989
45250,70121,16765,33738,14039,53356,13599,6609,6990
45255,70127,16765,33739,14039,53361,13601,6609,6992
45260,70138,16769,33746,14042,53367,13603,6609,6994
45265,70142,16770,33748,14043,53371,13603,6609,6994
45270,70152,16772,33753,14045,53380,13605,6609,6996
45275,70158,16772,33756,14045,53384,13607,6609,6998
45280,70169,16774,33763,14046,53392,13609,6611,6998
45285,70173,16775,33765,14047,53397,13609,6611,6998
45290,70183,16776,33770,14047,53405,13611,6613,6998
45295,70189,16779,33771,14050,53410,13613,6613,7000
45300,70200,16780,33775,14051,53420,13615,6615,7000
45305,70204,16780,33777,14051,53423,13615,6615,7000
45310,70214,16781,33781,14052,53432,13617,6615,7002
45315,70220,16782,33783,14053,53438,13619,6615,7004
45320,70231,16785,33790,14055,53444,13621,6617,7004
45325,70235,16785,33791,14055,53450,13621,6617,7004
45330,70245,16787,33797,14057,53456,13623,6618,7005
45335,70251,16789,33799,14059,53461,13625,6619,7006
45340,70262,16794,33805,14064,53466,13627,6619,7008
45345,70266,16794,33805,14064,53472,13627,6619,7008
45350,70276,16796,33807,14064,53479,13629,6619,7010
45355,70282,16798,33810,14066,53484,13631,6620,7011
45360,70293,16800,33814,14067,53492,13633,6622,7011
45365,70297,16801,33815,14068,53496,13633,6622,7011
45370,70307,16803,33819,14069,53503,13635,6624,7011
45375,70313,16804,33821,14070,53509,13637,6626,7011
45380,70324,16807,33827,14072,53516,13639,6628,7011
45385,70328,16808,33829,14073,53520,13639,6628,7011
45390,70338,16811,33834,14075,53525,13641,6629,7012
45395,70344,16813,33835,14077,53530,13643,6629,7014
45400,70355,16815,33839,14078,53538,13645,6630,7015
45405,70359,16817,33841,14080,53542,13645,6630,7015
45410,70369,16819,33846,14082,53549,13647,6630,7017
45415,70375,16821,33851,14084,53552,13649,6632,7017
45420,70386,16825,33856,14088,53558,13651,6632,7019
45425,70390,16828,33858,14091,53560,13651,6632,7019
45430,70400,16833,33862,14096,53566,13653,6632,7021
45435,70406,16833,33865,14096,53573,13655,6634,7021
45440,70417,16836,33869,14098,53580,13657,6634,7023
45445,70421,16838,33872,14100,53581,13657,6634,7023
45450,70431,16842,33875,14103,53589,13659,6635,7024
45455,70437,16842,33877,14103,53594,13661,6635,7026
45460,70448,16846,33884,14107,53600,13663,6636,7027
45465,70452,16850,33887,14111,53601,13663,6636,7027
45470,70462,16853,33891,14114,53609,13665,6637,7028
45475,70468,16853,33892,14114,53614,13667,6637,7030
45480,70479,16855,33899,14115,53623,13669,6639,7030
45485,70483,16855,33899,14115,53628,13669,6639,7030
45490,70493,16857,33906,14117,53635,13671,6640,7031
45495,70499,16857,33909,14117,53640,13673,6641,7032
45500,70510,16858,33912,14117,53651,13675,6642,7033
45505,70514,16859,33914,14118,53654,13675,6642,7033
45510,70524,16859,33918,14118,53665,13677,6643,7034
45515,70530,16859,33921,14118,53670,13679,6644,7035
45520,70541,16861,33929,14119,53678,13681,6646,7035
45525,70545,16862,33931,14120,53683,13681,6646,7035
45530,70555,16864,33936,14122,53690,13683,6647,7036
45535,70561,16866,33940,14124,53694,13685,6648,7037
45540,70572,16869,33945,14127,53701,13687,6648,7039
45545,70576,16871,33946,14129,53705,13687,6648,7039
45550,70586,16873,33951,14130,53712,13689,6649,7040
45555,70592,16873,33954,14130,53718,13691,6650,7041
45560,70603,16874,33961,14131,53728,13693,6652,7041
45565,70607,16874,33962,14131,53733,13693,6652,7041
45570,70617,16877,33968,14134,53740,13695,6653,7042
45575,70623,16877,33971,14134,53746,13697,6654,7043
45580,70634,16879,33975,14136,53754,13699,6655,7044
45585,70638,16880,33975,14137,53758,13699,6655,7044
45590,70648,16883,33980,14139,53765,13701,6657,7044
45595,70654,16883,33981,14139,53771,13703,6658,7045
45600,70665,16884,33986,14139,53779,13705,6659,7046
45605,70669,16886,33987,14141,53783,13705,6659,7046
45610,70679,16889,33991,14143,53790,13707,6659,7048
45615,70685,16889,33993,14143,53796,13709,6661,7048
45620,70696,16891,33998,14145,53803,13711,6661,7050
45625,70700,16893,34000,14147,53807,13711,6661,7050
45630,70710,16897,34006,14149,53813,13713,6663,7050
45635,70716,16897,34008,14149,53818,13715,6663,7052
45640,70727,16900,34011,14151,53826,13717,6664,7053
45645,70731,16902,34014,14153,53827,13717,6664,7053
45650,70741,16907,34017,14157,53834,13719,6665,7054
45655,70747,16907,34019,14157,53839,13721,6666,7055
45660,70758,16911,34023,14160,53847,13723,6668,7055
45665,70762,16912,34026,14161,53848,13723,6668,7055
45670,70772,16917,34031,14165,53854,13725,6670,7055
45675,70778,16919,34035,14167,53857,13727,6671,7056
45680,70789,16924,34041,14171,53862,13729,6672,7057
45685,70793,16927,34043,14174,53864,13729,6672,7057
45690,70803,16932,34044,14177,53871,13731,6672,7059
45695,70809,16932,34048,14177,53876,13733,6674,7059
45700,70820,16934,34054,14179,53884,13735,6674,7061
45705,70824,16935,34057,14180,53888,13735,6674,7061
45710,70834,16936,34063,14181,53896,13737,6675,7062
45715,70840,16938,34066,14183,53901,13739,6676,7063
45720,70851,16941,34073,14186,53907,13741,6677,7064
45725,70855,16943,34076,14188,53912,13741,6677,7064
45730,70865,16946,34082,14191,53918,13743,6678,7065
45735,70871,16947,34085,14192,53923,13745,6679,7066
45740,70882,16950,34090,14195,53932,13747,6681,7066
45745,70886,16951,34094,14196,53935,13747,6681,7066
45750,70896,16952,34098,14196,53942,13749,6682,7067
45755,70902,16954,34101,14198,53948,13751,6684,7067
45760,70913,16956,34104,14200,53957,13753,6684,7069
45765,70917,16957,34106,14201,53960,13753,6684,7069
45770,70927,16958,34110,14202,53968,13755,6684,7071
45775,70933,16959,34114,14203,53973,13757,6686,7071
45780,70944,16963,34122,14206,53980,13759,6687,7072
45785,70948,16964,34123,14207,53984,13759,6687,7072
45790,70958,16965,34128,14208,53991,13761,6688,7073
45795,70964,16967,34129,14210,53997,13763,6689,7074
45800,70975,16971,34136,14214,54004,13765,6690,7075
45805,70979,16973,34139,14216,54006,13765,6690,7075
45810,70989,16976,34144,14217,54011,13767,6690,7077
45815,70995,16979,34147,14220,54015,13769,6691,7078
45820,71006,16983,34153,14224,54023,13771,6692,7079
45825,71010,16984,34154,14225,54026,13771,6692,7079
45830,71020,16987,34157,14226,54032,13773,6693,7080
45835,71026,16989,34160,14228,54036,13775,6694,7081
45840,71037,16993,34164,14231,54044,13777,6696,7081
45845,71041,16994,34167,14232,54045,13777,6696,7081
45850,71051,17000,34173,14237,54050,13779,6697,7082
45855,71057,17000,34176,14237,54056,13781,6698,7083
45860,71068,17002,34180,14239,54066,13783,6698,7085
45865,71072,17003,34182,14240,54068,13783,6698,7085
45870,71082,17008,34187,14244,54074,13785,6699,7086
45875,71088,17008,34188,14244,54079,13787,6699,7088
45880,71099,17012,34192,14247,54086,13789,6700,7089
45885,71103,17013,34194,14248,54088,13789,6700,7089
45890,71113,17016,34198,14249,54097,13791,6701,7090
45895,71119,17016,34201,14249,54103,13793,6702,7091
45900,71130,17017,34206,14250,54112,13795,6703,7092
45905,71134,17018,34209,14251,54116,13795,6703,7092
45910,71144,17021,34217,14254,54123,13797,6704,7093
45915,71150,17021,34221,14254,54128,13799,6705,7094
45920,71161,17024,34228,14256,54136,13801,6707,7094
45925,71165,17026,34231,14258,54139,13801,6707,7094
45930,71175,17030,34236,14261,54145,13803,6708,7095
45935,71181,17030,34238,14261,54151,13805,6709,7096
45940,71192,17031,34242,14261,54160,13807,6710,7097
45945,71196,17032,34244,14262,54163,13807,6710,7097
45950,71206,17036,34250,14264,54170,13809,6712,7097
45955,71212,17036,34255,14264,54175,13811,6714,7097
45960,71223,17039,34261,14267,54182,13813,6715,7098
45965,71227,17040,34262,14268,54187,13813,6715,7098
45970,71237,17042,34265,14268,54195,13815,6716,7099
45975,71243,17043,34266,14269,54200,13817,6716,7101
45980,71254,17044,34273,14270,54206,13819,6718,7101
45985,71258,17046,34277,14272,54211,13819,6718,7101
45990,71268,17048,34283,14273,54219,13821,6719,7102
45995,71274,17049,34286,14274,54223,13823,6720,7103
46000,71285,17053,34293,14278,54229,13825,6721,7104
46005,71289,17056,34296,14281,54232,13825,6721,7104
46010,71299,17057,34300,14281,54240,13827,6723,7104
46015,71305,17060,34302,14284,54245,13829,6724,7105
46020,71316,17061,34308,14285,54254,13831,6726,7105
46025,71320,17061,34308,14285,54259,13831,6726,7105
46030,71330,17062,34313,14285,54267,13833,6727,7106
46035,71336,17064,34317,14287,54271,13835,6729,7106
46040,71347,17065,34321,14288,54281,13837,6729,7108
46045,71351,17065,34324,14288,54285,13837,6729,7108
46050,71361,17066,34331,14289,54293,13839,6730,7109
46055,71367,17068,34334,14291,54298,13841,6732,7109
46060,71378,17068,34339,14291,54310,13843,6734,7109
46065,71382,17068,34341,14291,54313,13843,6734,7109
46070,71392,17068,34344,14291,54324,13845,6734,7111
46075,71398,17068,34348,14291,54328,13847,6734,7113
46080,71409,17069,34351,14291,54340,13849,6735,7114
46085,71413,17070,34352,14292,54343,13849,6735,7114
46090,71423,17070,34354,14292,54353,13851,6736,7115
46095,71429,17070,34355,14292,54358,13853,6736,7117
46100,71440,17071,34361,14293,54368,13855,6737,7118
46105,71444,17072,34363,14294,54371,13855,6737,7118
46110,71454,17074,34367,14296,54380,13857,6737,7120
46115,71460,17074,34371,14296,54385,13859,6739,7120
46120,71471,17077,34376,14298,54394,13861,6741,7120
46125,71475,17077,34377,14298,54397,13861,6741,7120
46130,71485,17081,34382,14301,54403,13863,6742,7121
46135,71491,17081,34385,14301,54408,13865,6742,7123
46140,71502,17084,34391,14304,54416,13867,6743,7124
46145,71506,17085,34393,14305,54420,13867,6743,7124
46150,71516,17087,34398,14306,54428,13869,6744,7125
46155,71522,17087,34402,14306,54434,13871,6746,7125
46160,71533,17088,34409,14306,54443,13873,6748,7125
46165,71537,17089,34411,14307,54447,13873,6748,7125
46170,71547,17091,34413,14307,54456,13875,6749,7126
46175,71553,17091,34414,14307,54462,13877,6750,7127
46180,71564,17094,34424,14310,54467,13879,6751,7128
46185,71568,17096,34426,14312,54472,13879,6751,7128
46190,71578,17098,34430,14313,54479,13881,6751,7130
46195,71584,17098,34431,14313,54486,13883,6752,7131
46200,71595,17101,34435,14315,54493,13885,6752,7133
46205,71599,17101,34437,14315,54498,13885,6752,7133
46210,71609,17104,34445,14318,54504,13887,6754,7133
46215,71615,17104,34450,14318,54510,13889,6756,7133
46220,71626,17108,34456,14322,54515,13891,6756,7135
46225,71630,17109,34457,14323,54521,13891,6756,7135
46230,71640,17111,34460,14324,54528,13893,6757,7136
46235,71646,17111,34461,14324,54535,13895,6758,7137
46240,71657,17113,34467,14326,54543,13897,6759,7138
46245,71661,17115,34470,14328,54545,13897,6759,7138
46250,71671,17118,34473,14329,54552,13899,6760,7139
46255,71677,17118,34475,14329,54558,13901,6760,7141
46260,71688,17123,34481,14334,54563,13903,6760,7143
46265,71692,17125,34483,14336,54566,13903,6760,7143
46270,71702,17129,34486,14339,54573,13905,6760,7145
46275,71708,17129,34489,14339,54579,13907,6761,7146
46280,71719,17132,34494,14341,54585,13909,6762,7147
46285,71723,17134,34497,14343,54588,13909,6762,7147
46290,71733,17139,34500,14346,54594,13911,6763,7148
46295,71739,17139,34501,14346,54600,13913,6764,7149
46300,71750,17142,34506,14349,54608,13915,6766,7149
46305,71754,17143,34507,14350,54611,13915,6766,7149
46310,71764,17146,34510,14351,54618,13917,6767,7150
46315,71770,17146,34513,14351,54623,13919,6769,7150
46320,71781,17150,34519,14355,54629,13921,6769,7152
46325,71785,17153,34522,14358,54632,13921,6769,7152
46330,71795,17156,34527,14360,54639,13923,6769,7154
46335,71801,17156,34529,14360,54644,13925,6770,7155
46340,71812,17158,34532,14361,54653,13927,6771,7156
46345,71816,17158,34534,14361,54657,13927,6771,7156
46350,71826,17160,34540,14363,54666,13929,6772,7157
46355,71832,17160,34542,14363,54672,13931,6773,7158
46360,71843,17162,34549,14364,54679,13933,6775,7158
46365,71847,17162,34550,14364,54685,13933,6775,7158
46370,71857,17163,34554,14365,54693,13935,6776,7159
46375,71863,17164,34556,14366,54698,13937,6776,7161
46380,71874,17167,34562,14369,54706,13939,6777,7162
46385,71878,17168,34565,14370,54709,13939,6777,7162
46390,71888,17169,34569,14370,54718,13941,6778,7163
46395,71894,17170,34573,14371,54723,13943,6780,7163
46400,71905,17174,34579,14374,54728,13945,6780,7165
46405,71909,17175,34580,14375,54734,13945,6780,7165
46410,71919,17177,34585,14377,54741,13947,6781,7166
46415,71925,17178,34587,14378,54746,13949,6782,7167
46420,71936,17182,34594,14382,54754,13951,6782,7169
46425,71940,17182,34595,14382,54758,13951,6782,7169
46430,71950,17183,34599,14383,54766,13953,6784,7169
46435,71956,17185,34602,14385,54771,13955,6785,7170
46440,71967,17188,34608,14387,54777,13957,6785,7172
46445,71971,17190,34611,14389,54781,13957,6785,7172
46450,71981,17193,34618,14392,54786,13959,6786,7173
46455,71987,17196,34621,14395,54790,13961,6787,7174
46460,71998,17198,34623,14396,54799,13963,6787,7176
46465,72002,17199,34624,14397,54803,13963,6787,7176
46470,72012,17203,34628,14401,54809,13965,6787,7178
46475,72018,17203,34630,14401,54815,13967,6789,7178
46480,72029,17205,34634,14403,54823,13969,6789,7180
46485,72033,17206,34635,14404,54827,13969,6789,7180
46490,72043,17209,34641,14406,54833,13971,6791,7180
46495,72049,17210,34643,14407,54839,13973,6793,7180
46500,72060,17213,34647,14409,54847,13975,6794,7181
46505,72064,17214,34649,14410,54849,13975,6794,7181
46510,72074,17218,34652,14413,54855,13977,6794,7183
46515,72080,17219,34655,14414,54858,13979,6794,7185
46520,72091,17226,34663,14421,54862,13981,6795,7186
46525,72095,17229,34664,14424,54865,13981,6795,7186
46530,72105,17234,34670,14428,54869,13983,6796,7187
46535,72111,17236,34671,14430,54875,13985,6797,7188
46540,72122,17238,34677,14431,54880,13987,6798,7189
46545,72126,17243,34680,14436,54881,13987,6798,7189
46550,72136,17249,34684,14440,54886,13989,6799,7190
46555,72142,17250,34685,14441,54891,13991,6799,7192
46560,72153,17253,34689,14444,54898,13993,6799,7194
46565,72157,17257,34693,14448,54899,13993,6799,7194
46570,72167,17259,34698,14449,54906,13995,6800,7195
46575,72173,17261,34700,14451,54911,13997,6800,7197
46580,72184,17264,34707,14454,54919,13999,6802,7197
46585,72188,17264,34708,14454,54924,13999,6802,7197
46590,72198,17267,34714,14457,54931,14001,6804,7197
46595,72204,17267,34717,14457,54936,14003,6805,7198
46600,72215,17271,34722,14460,54944,14005,6806,7199
46605,72219,17272,34723,14461,54947,14005,6806,7199
46610,72229,17275,34728,14464,54954,14007,6807,7200
46615,72235,17276,34730,14465,54959,14009,6807,7202
46620,72246,17278,34736,14467,54968,14011,6809,7202
46625,72250,17278,34738,14467,54971,14011,6809,7202
46630,72260,17281,34744,14469,54978,14013,6811,7202
46635,72266,17283,34747,14471,54982,14015,6812,7203
46640,72277,17285,34752,14473,54991,14017,6812,7205
46645,72281,17286,34755,14474,54995,14017,6812,7205
46650,72291,17286,34758,14474,55005,14019,6812,7207
46655,72297,17286,34763,14474,55010,14021,6814,7207
46660,72308,17287,34770,14474,55020,14023,6815,7208
46665,72312,17288,34774,14475,55023,14023,6815,7208
46670,72322,17289,34782,14476,55032,14025,6817,7208
46675,72328,17289,34783,14476,55038,14027,6817,7210
46680,72339,17290,34788,14477,55048,14029,6818,7211
46685,72343,17291,34788,14478,55052,14029,6818,7211
46690,72353,17294,34793,14481,55059,14031,6819,7212
46695,72359,17294,34794,14481,55065,14033,6820,7213
46700,72370,17296,34799,14483,55072,14035,6820,7215
46705,72374,17300,34803,14487,55072,14035,6820,7215
46710,72384,17306,34810,14493,55078,14037,6822,7215
46715,72390,17306,34813,14493,55083,14039,6823,7216
46720,72401,17308,34818,14495,55092,14041,6824,7217
46725,72405,17309,34820,14496,55094,14041,6824,7217
46730,72415,17315,34825,14501,55100,14043,6825,7218
46735,72421,17315,34828,14501,55105,14045,6826,7219
46740,72432,17319,34834,14505,55112,14047,6826,7221
46745,72436,17320,34835,14506,55115,14047,6826,7221
46750,72446,17322,34840,14508,55124,14049,6827,7222
46755,72452,17322,34842,14508,55130,14051,6828,7223
46760,72463,17322,34849,14508,55140,14053,6830,7223
46765,72467,17322,34851,14508,55145,14053,6830,7223
46770,72477,17323,34858,14508,55154,14055,6832,7223
46775,72483,17323,34862,14508,55160,14057,6834,7223
46780,72494,17323,34867,14508,55169,14059,6834,7225
46785,72498,17323,34869,14508,55175,14059,6834,7225
46790,72508,17324,34874,14508,55184,14061,6836,7225
46795,72514,17324,34878,14508,55189,14063,6837,7226
46800,72525,17325,34886,14509,55197,14065,6839,7226
46805,72529,17326,34888,14510,55203,14065,6839,7226
46810,72539,17327,34894,14511,55211,14067,6841,7226
46815,72545,17329,34896,14513,55216,14069,6841,7228
46820,72556,17329,34902,14513,55226,14071,6842,7229
46825,72560,17329,34904,14513,55231,14071,6842,7229
46830,72570,17330,34907,14513,55239,14073,6843,7230
46835,72576,17332,34911,14515,55244,14075,6845,7230
46840,72587,17332,34914,14515,55253,14077,6845,7232
46845,72591,17333,34915,14516,55258,14077,6845,7232
46850,72601,17334,34919,14516,55266,14079,6847,7232
46855,72607,17336,34923,14518,55270,14081,6848,7233
46860,72618,17339,34927,14521,55278,14083,6848,7235
46865,72622,17340,34928,14522,55282,14083,6848,7235
46870,72632,17344,34931,14524,55287,14085,6848,7237
46875,72638,17346,34935,14526,55290,14087,6848,7239
46880,72649,17353,34942,14533,55295,14089,6849,7240
46885,72653,17356,34944,14536,55297,14089,6849,7240
46890,72663,17360,34949,14538,55302,14091,6850,7241
46895,72669,17362,34953,14540,55306,14093,6851,7242
46900,72680,17366,34955,14543,55314,14095,6851,7244
46905,72684,17368,34958,14545,55315,14095,6851,7244
46910,72694,17374,34965,14551,55320,14097,6853,7244
46915,72700,17375,34969,14552,55324,14099,6855,7244
46920,72711,17380,34976,14556,55329,14101,6857,7244
46925,72715,17383,34978,14559,55331,14101,6857,7244
46930,72725,17390,34985,14565,55334,14103,6858,7245
46935,72731,17392,34988,14567,55337,14105,6858,7247
46940,72742,17396,34996,14571,55343,14107,6859,7248
46945,72746,17398,34999,14573,55347,14107,6859,7248
46950,72756,17400,35004,14575,55355,14109,6859,7250
46955,72762,17400,35006,14575,55361,14111,6859,7252
46960,72773,17402,35012,14577,55370,14113,6860,7253
46965,72777,17402,35015,14577,55374,14113,6860,7253
46970,72787,17404,35024,14579,55382,14115,6862,7253
46975,72793,17404,35027,14579,55388,14117,6864,7253
46980,72804,17405,35034,14579,55397,14119,6865,7254
46985,72808,17406,35037,14580,55402,14119,6865,7254
46990,72818,17407,35040,14581,55411,14121,6866,7255
46995,72824,17407,35042,14581,55417,14123,6866,7257
47000,72835,17409,35048,14583,55426,14125,6867,7258
47005,72839,17410,35051,14584,55429,14125,6867,7258
47010,72849,17411,35056,14585,55437,14127,6869,7258
47015,72855,17411,35058,14585,55443,14129,6870,7259
47020,72866,17412,35063,14586,55454,14131,6870,7261
47025,72870,17412,35065,14586,55458,14131,6870,7261
47030,72880,17414,35070,14588,55466,14133,6870,7263
47035,72886,17414,35071,14588,55472,14135,6870,7265
47040,72897,17416,35077,14589,55481,14137,6871,7266
47045,72901,17416,35079,14589,55485,14137,6871,7266
47050,72911,17418,35084,14589,55493,14139,6873,7266
47055,72917,17418,35088,14589,55498,14141,6874,7267
47060,72928,17422,35096,14593,55505,14143,6875,7268
47065,72932,17424,35098,14595,55507,14143,6875,7268
47070,72942,17427,35101,14597,55515,14145,6876,7269
47075,72948,17427,35103,14597,55521,14147,6877,7270
47080,72959,17427,35107,14597,55530,14149,6877,7272
47085,72963,17430,35109,14600,55532,14149,6877,7272
47090,72973,17433,35111,14602,55540,14151,6878,7273
47095,72979,17433,35116,14602,55543,14153,6880,7273
47100,72990,17438,35122,14607,55549,14155,6881,7274
47105,72994,17441,35123,14610,55553,14155,6881,7274
47110,73004,17445,35129,14613,55558,14157,6882,7275
47115,73010,17446,35129,14614,55564,14159,6882,7277
47120,73021,17446,35135,14614,55572,14161,6884,7277
47125,73025,17448,35136,14616,55577,14161,6884,7277
47130,73035,17450,35140,14616,55583,14163,6885,7278
47135,73041,17453,35144,14619,55587,14165,6886,7279
47140,73052,17454,35152,14620,55594,14167,6888,7279
47145,73056,17456,35155,14622,55599,14167,6888,7279
47150,73066,17460,35159,14625,55606,14169,6889,7280
47155,73072,17460,35162,14625,55611,14171,6890,7281
47160,73083,17463,35165,14628,55619,14173,6890,7283
47165,73087,17463,35165,14628,55624,14173,6890,7283
47170,73097,17467,35172,14631,55628,14175,6891,7284
47175,73103,17469,35174,14633,55634,14177,6892,7285
47180,73114,17471,35179,14634,55640,14179,6892,7287
47185,73118,17472,35180,14635,55646,14179,6892,7287
47190,73128,17476,35186,14638,55652,14181,6894,7287
47195,73134,17476,35189,14638,55657,14183,6895,7288
47200,73145,17479,35194,14641,55665,14185,6895,7290
47205,73149,17479,35196,14641,55669,14185,6895,7290
47210,73159,17482,35200,14644,55677,14187,6895,7292
47215,73165,17482,35204,14644,55682,14189,6896,7293
47220,73176,17487,35211,14649,55688,14191,6898,7293
47225,73180,17489,35213,14651,55690,14191,6898,7293
47230,73190,17494,35216,14654,55696,14193,6898,7295
47235,73196,17494,35219,14654,55702,14195,6899,7296
47240,73207,17496,35226,14656,55708,14197,6900,7297
47245,73211,17497,35227,14657,55714,14197,6900,7297
47250,73221,17499,35231,14658,55722,14199,6901,7298
47255,73227,17499,35234,14658,55727,14201,6902,7299
47260,73238,17500,35239,14659,55737,14203,6904,7299
47265,73242,17500,35241,14659,55741,14203,6904,7299
47270,73252,17503,35247,14662,55749,14205,6905,7300
47275,73258,17503,35248,14662,55754,14207,6905,7302
47280,73269,17506,35254,14664,55761,14209,6906,7303
47285,73273,17508,35256,14666,55765,14209,6906,7303
47290,73283,17510,35262,14667,55772,14211,6907,7304
47295,73289,17512,35265,14669,55777,14213,6907,7306
47300,73300,17514,35268,14670,55785,14215,6907,7308
47305,73304,17515,35270,14671,55789,14215,6907,7308
47310,73314,17518,35276,14674,55795,14217,6908,7309
47315,73320,17520,35279,14676,55799,14219,6909,7310
47320,73331,17523,35283,14678,55807,14221,6909,7312
47325,73335,17523,35286,14678,55812,14221,6909,7312
47330,73345,17524,35292,14679,55819,14223,6910,7313
47335,73351,17526,35294,14681,55824,14225,6911,7314
47340,73362,17529,35301,14684,55830,14227,6912,7315
47345,73366,17531,35303,14686,55835,14227,6912,7315
47350,73376,17533,35307,14687,55842,14229,6913,7316
47355,73382,17534,35308,14688,55848,14231,6914,7317
47360,73393,17539,35316,14693,55853,14233,6916,7317
47365,73397,17541,35318,14695,55856,14233,6916,7317
47370,73407,17544,35321,14697,55863,14235,6916,7319
47375,73413,17544,35324,14697,55868,14237,6918,7319
47380,73424,17546,35328,14698,55876,14239,6919,7320
47385,73428,17548,35329,14700,55879,14239,6919,7320
47390,73438,17551,35333,14701,55885,14241,6921,7320
47395,73444,17554,35338,14704,55889,14243,6923,7320
47400,73455,17557,35343,14707,55898,14245,6924,7321
47405,73459,17557,35345,14707,55901,14245,6924,7321
47410,73469,17561,35350,14710,55908,14247,6925,7322
47415,73475,17561,35354,14710,55912,14249,6926,7323
47420,73486,17564,35359,14712,55921,14251,6927,7324
47425,73490,17567,35362,14715,55922,14251,6927,7324
47430,73500,17570,35367,14718,55930,14253,6928,7325
47435,73506,17570,35371,14718,55935,14255,6930,7325
47440,73517,17573,35376,14721,55943,14257,6931,7326
47445,73521,17575,35378,14723,55945,14257,6931,7326
47450,73531,17579,35382,14727,55952,14259,6932,7327
47455,73537,17579,35386,14727,55956,14261,6933,7328
47460,73548,17584,35396,14732,55961,14263,6935,7328
47465,73552,17587,35399,14735,55965,14263,6935,7328
47470,73562,17589,35404,14737,55973,14265,6936,7329
47475,73568,17589,35405,14737,55979,14267,6936,7331
47480,73579,17591,35412,14739,55986,14269,6937,7332
47485,73583,17592,35414,14740,55991,14269,6937,7332
47490,73593,17594,35419,14742,55998,14271,6937,7334
47495,73599,17594,35422,14742,56004,14273,6938,7335
47500,73610,17594,35428,14742,56014,14275,6939,7336
47505,73614,17594,35430,14742,56020,14275,6939,7336
47510,73624,17595,35436,14742,56029,14277,6941,7336
47515,73630,17595,35438,14742,56035,14279,6942,7337
47520,73641,17595,35446,14742,56045,14281,6944,7337
47525,73645,17595,35449,14742,56049,14281,6944,7337
47530,73655,17596,35452,14742,56059,14283,6946,7337
47535,73661,17596,35457,14742,56064,14285,6948,7337
47540,73672,17596,35463,14742,56074,14287,6949,7338
47545,73676,17596,35465,14742,56080,14287,6949,7338
47550,73686,17597,35471,14742,56088,14289,6950,7339
47555,73692,17597,35471,14742,56095,14291,6950,7341
47560,73703,17597,35475,14742,56106,14293,6951,7342
47565,73707,17597,35476,14742,56110,14293,6951,7342
47570,73717,17598,35480,14743,56118,14295,6952,7343
47575,73723,17599,35482,14744,56124,14297,6953,7344
47580,73734,17599,35487,14744,56134,14299,6954,7345
47585,73738,17600,35490,14745,56137,14299,6954,7345
47590,73748,17602,35493,14746,56145,14301,6954,7347
47595,73754,17604,35498,14748,56148,14303,6955,7348
47600,73765,17608,35501,14751,56155,14305,6955,7350
47605,73769,17608,35502,14751,56160,14305,6955,7350
47610,73779,17612,35505,14754,56167,14307,6956,7351
47615,73785,17612,35508,14754,56172,14309,6956,7353
47620,73796,17617,35514,14759,56178,14311,6957,7354
47625,73800,17619,35517,14761,56179,14311,6957,7354
47630,73810,17625,35523,14767,56185,14313,6957,7356
47635,73816,17625,35526,14767,56190,14315,6958,7357
47640,73827,17628,35531,14770,56197,14317,6959,7358
47645,73831,17632,35535,14774,56197,14317,6959,7358
47650,73841,17639,35539,14779,56202,14319,6960,7359
47655,73847,17639,35542,14779,56207,14321,6960,7361
47660,73858,17641,35546,14781,56217,14323,6961,7362
47665,73862,17641,35546,14781,56221,14323,6961,7362
47670,73872,17642,35548,14781,56230,14325,6961,7364
47675,73878,17642,35553,14781,56235,14327,6962,7365
47680,73889,17644,35561,14783,56243,14329,6963,7366
47685,73893,17645,35563,14784,56247,14329,6963,7366
47690,73903,17647,35566,14785,56256,14331,6964,7367
47695,73909,17647,35570,14785,56262,14333,6965,7368
47700,73920,17649,35575,14787,56270,14335,6966,7369
47705,73924,17649,35577,14787,56275,14335,6966,7369
47710,73934,17651,35583,14789,56282,14337,6968,7369
47715,73940,17652,35585,14790,56288,14339,6969,7370
47720,73951,17655,35589,14792,56295,14341,6970,7371
47725,73955,17656,35590,14793,56299,14341,6970,7371
47730,73965,17657,35594,14793,56307,14343,6971,7372
47735,73971,17659,35596,14795,56312,14345,6972,7373
47740,73982,17661,35601,14796,56320,14347,6973,7374
47745,73986,17663,35604,14798,56323,14347,6973,7374
47750,73996,17666,35610,14801,56328,14349,6973,7376
47755,74002,17669,35614,14804,56333,14351,6974,7377
47760,74013,17671,35617,14805,56340,14353,6974,7379
47765,74017,17673,35619,14807,56344,14353,6974,7379
47770,74027,17677,35625,14810,56349,14355,6975,7380
47775,74033,17679,35629,14812,56352,14357,6976,7381
47780,74044,17683,35636,14816,56359,14359,6978,7381
47785,74048,17686,35638,14819,56362,14359,6978,7381
47790,74058,17688,35641,14820,56368,14361,6978,7383
47795,74064,17690,35644,14822,56372,14363,6979,7384
47800,74075,17696,35651,14828,56377,14365,6980,7385
47805,74079,17699,35653,14831,56380,14365,6980,7385
47810,74089,17705,35660,14836,56383,14367,6981,7386
47815,74095,17706,35660,14837,56389,14369,6981,7388
47820,74106,17710,35665,14841,56396,14371,6982,7389
47825,74110,17711,35666,14842,56399,14371,6982,7389
47830,74120,17713,35671,14844,56406,14373,6984,7389
47835,74126,17714,35674,14845,56409,14375,6984,7391
47840,74137,17718,35677,14849,56418,14377,6985,7392
47845,74141,17720,35678,14851,56421,14377,6985,7392
47850,74151,17723,35683,14854,56426,14379,6985,7394
47855,74157,17726,35686,14857,56429,14381,6985,7396
47860,74168,17730,35693,14860,56434,14383,6987,7396
47865,74172,17735,35695,14865,56436,14383,6987,7396
47870,74182,17739,35700,14869,56442,14385,6987,7398
47875,74188,17740,35704,14870,56446,14387,6988,7399
47880,74199,17743,35709,14872,56454,14389,6988,7401
47885,74203,17744,35710,14873,56459,14389,6988,7401
47890,74213,17746,35712,14874,56467,14391,6989,7402
47895,74219,17746,35716,14874,56471,14393,6991,7402
47900,74230,17749,35719,14876,56480,14395,6992,7403
47905,74234,17750,35721,14877,56483,14395,6992,7403
47910,74244,17752,35726,14878,56490,14397,6993,7404
47915,74250,17754,35726,14880,56496,14399,6993,7406
47920,74261,17756,35732,14882,56505,14401,6993,7408
47925,74265,17756,35733,14882,56508,14401,6993,7408
47930,74275,17757,35738,14883,56518,14403,6994,7409
47935,74281,17757,35740,14883,56523,14405,6994,7411
47940,74292,17759,35746,14884,56532,14407,6995,7412
47945,74296,17760,35748,14885,56535,14407,6995,7412
47950,74306,17760,35749,14885,56546,14409,6995,7414
47955,74312,17760,35750,14885,56552,14411,6995,7416
47960,74323,17762,35756,14886,56561,14413,6995,7418
47965,74327,17763,35757,14887,56564,14413,6995,7418
47970,74337,17765,35761,14889,56572,14415,6996,7419
47975,74343,17765,35764,14889,56577,14417,6997,7420
47980,74354,17768,35771,14892,56584,14419,6998,7421
47985,74358,17770,35774,14894,56586,14419,6998,7421
47990,74368,17774,35780,14897,56594,14421,6999,7422
47995,74374,17774,35784,14897,56598,14423,6999,7424
48000,74385,17777,35791,14900,56606,14425,7001,7424
48005,74389,17777,35793,14900,56611,14425,7001,7424
48010,74399,17778,35796,14901,56621,14427,7002,7425
48015,74405,17778,35800,14901,56627,14429,7003,7426
48020,74416,17779,35805,14902,56636,14431,7003,7428
48025,74420,17780,35807,14903,56640,14431,7003,7428
48030,74430,17782,35812,14904,56648,14433,7004,7429
48035,74436,17782,35816,14904,56654,14435,7006,7429
48040,74447,17783,35822,14905,56662,14437,7007,7430
48045,74451,17784,35825,14906,56667,14437,7007,7430
48050,74461,17786,35833,14908,56673,14439,7009,7430
48055,74467,17788,35835,14910,56679,14441,7010,7431
48060,74478,17789,35840,14911,56687,14443,7011,7432
48065,74482,17790,35844,14912,56692,14443,7011,7432
48070,74492,17792,35851,14913,56698,14445,7011,7434
48075,74498,17794,35852,14915,56704,14447,7012,7435
48080,74509,17796,35857,14917,56712,14449,7013,7436
48085,74513,17798,35859,14919,56715,14449,7013,7436
48090,74523,17802,35867,14923,56720,14451,7015,7436
48095,74529,17803,35869,14924,56725,14453,7015,7438
48100,74540,17805,35874,14926,56734,14455,7016,7439
48105,74544,17808,35877,14929,56736,14455,7016,7439
48110,74554,17811,35880,14930,56742,14457,7016,7441
48115,74560,17813,35882,14932,56747,14459,7017,7442
48120,74571,17816,35886,14935,56755,14461,7017,7444
48125,74575,17817,35888,14936,56757,14461,7017,7444
48130,74585,17821,35893,14940,56764,14463,7018,7445
48135,74591,17821,35896,14940,56770,14465,7020,7445
48140,74602,17822,35900,14940,56779,14467,7021,7446
48145,74606,17823,35900,14941,56783,14467,7021,7446
48150,74616,17826,35906,14942,56789,14469,7023,7446
48155,74622,17827,35908,14943,56794,14471,7024,7447
48160,74633,17832,35913,14947,56800,14473,7024,7449
48165,74637,17834,35916,14949,56802,14473,7024,7449
48170,74647,17837,35919,14950,56808,14475,7025,7450
48175,74653,17839,35922,14952,56813,14477,7027,7450
48180,74664,17844,35929,14956,56818,14479,7029,7450
48185,74668,17847,35932,14959,56819,14479,7029,7450
48190,74678,17851,35937,14963,56825,14481,7030,7451
48195,74684,17854,35941,14966,56829,14483,7031,7452
48200,74695,17857,35945,14968,56836,14485,7032,7453
48205,74699,17858,35949,14969,56840,14485,7032,7453
48210,74709,17860,35954,14970,56848,14487,7033,7454
48215,74715,17861,35958,14971,56852,14489,7034,7455
48220,74726,17865,35964,14975,56860,14491,7036,7455
48225,74730,17865,35965,14975,56865,14491,7036,7455
48230,74740,17867,35971,14976,56871,14493,7038,7455
48235,74746,17869,35973,14978,56875,14495,7038,7457
48240,74757,17871,35977,14979,56886,14497,7039,7458
48245,74761,17872,35979,14980,56889,14497,7039,7458
48250,74771,17872,35984,14980,56899,14499,7040,7459
48255,74777,17872,35987,14980,56905,14501,7042,7459
48260,74788,17873,35991,14981,56915,14503,7042,7461
48265,74792,17873,35993,14981,56918,14503,7042,7461
48270,74802,17874,35999,14982,56927,14505,7044,7461
48275,74808,17874,36002,14982,56934,14507,7045,7462
48280,74819,17875,36008,14983,56943,14509,7046,7463
48285,74823,17875,36010,14983,56948,14509,7046,7463
48290,74833,17876,36015,14984,56956,14511,7047,7464
48295,74839,17876,36018,14984,56963,14513,7048,7465
48300,74850,17878,36021,14986,56972,14515,7048,7467
48305,74854,17878,36022,14986,56976,14515,7048,7467
48310,74864,17880,36028,14988,56983,14517,7049,7468
48315,74870,17880,36031,14988,56989,14519,7051,7468
48320,74881,17883,36037,14991,56997,14521,7052,7469
48325,74885,17883,36040,14991,57001,14521,7052,7469
48330,74895,17884,36042,14991,57011,14523,7053,7470
48335,74901,17884,36043,14991,57017,14525,7053,7472
48340,74912,17886,36047,14992,57024,14527,7054,7473
48345,74916,17888,36050,14994,57026,14527,7054,7473
48350,74926,17895,36057,15000,57030,14529,7055,7474
48355,74932,17895,36061,15000,57036,14531,7057,7474
48360,74943,17898,36065,15002,57045,14533,7059,7474
48365,74947,17900,36068,15004,57046,14533,7059,7474
48370,74957,17907,36074,15009,57049,14535,7060,7475
48375,74963,17907,36077,15009,57054,14537,7060,7477
48380,74974,17910,36083,15011,57061,14539,7062,7477
48385,74978,17913,36085,15014,57063,14539,7062,7477
48390,74988,17918,36090,15017,57069,14541,7063,7478
48395,74994,17918,36091,15017,57075,14543,7063,7480
48400,75005,17919,36096,15017,57085,14545,7065,7480
48405,75009,17920,36098,15018,57089,14545,7065,7480
48410,75019,17922,36104,15020,57097,14547,7065,7482
48415,75025,17922,36107,15020,57103,14549,7067,7482
48420,75036,17924,36112,15021,57112,14551,7068,7483
48425,75040,17925,36114,15022,57115,14551,7068,7483
48430,75050,17926,36119,15023,57124,14553,7069,7484
48435,75056,17926,36123,15023,57130,14555,7070,7485
48440,75067,17929,36130,15026,57136,14557,7071,7486
48445,75071,17929,36130,15026,57142,14557,7071,7486
48450,75081,17931,36134,15027,57150,14559,7073,7486
48455,75087,17931,36137,15027,57156,14561,7074,7487
48460,75098,17932,36144,15027,57164,14563,7075,7488
48465,75102,17933,36146,15028,57169,14563,7075,7488
48470,75112,17935,36151,15029,57177,14565,7076,7489
48475,75118,17935,36153,15029,57183,14567,7076,7491
48480,75129,17936,36157,15029,57192,14569,7077,7492
48485,75133,17936,36158,15029,57197,14569,7077,7492
48490,75143,17938,36163,15030,57205,14571,7077,7494
48495,75149,17938,36167,15030,57211,14573,7079,7494
48500,75160,17940,36173,15032,57218,14575,7080,7495
48505,75164,17942,36175,15034,57222,14575,7080,7495
48510,75174,17945,36177,15036,57229,14577,7080,7497
48515,75180,17946,36180,15037,57233,14579,7081,7498
48520,75191,17952,36187,15043,57238,14581,7082,7499
48525,75195,17954,36189,15045,57240,14581,7082,7499
48530,75205,17960,36194,15050,57245,14583,7083,7500
48535,75211,17961,36197,15051,57249,14585,7084,7501
48540,75222,17966,36203,15056,57255,14587,7085,7502
48545,75226,17968,36205,15058,57258,14587,7085,7502
48550,75236,17970,36208,15058,57265,14589,7086,7503
48555,75242,17972,36212,15060,57269,14591,7087,7504
48560,75253,17975,36217,15063,57277,14593,7088,7505
48565,75257,17976,36218,15064,57280,14593,7088,7505
48570,75267,17981,36222,15068,57285,14595,7088,7507
48575,75273,17983,36227,15070,57289,14597,7090,7507
48580,75284,17988,36236,15074,57294,14599,7092,7507
48585,75288,17992,36240,15078,57295,14599,7092,7507
48590,75298,17997,36246,15083,57300,14601,7092,7509
48595,75304,17999,36249,15085,57304,14603,7093,7510
48600,75315,18003,36252,15088,57312,14605,7094,7511
48605,75319,18003,36255,15088,57316,14605,7094,7511
48610,75329,18004,36261,15089,57325,14607,7095,7512
48615,75335,18004,36266,15089,57330,14609,7097,7512
48620,75346,18006,36271,15091,57340,14611,7098,7513
48625,75350,18006,36274,15091,57344,14611,7098,7513
48630,75360,18007,36279,15092,57352,14613,7099,7514
48635,75366,18009,36283,15094,57357,14615,7100,7515
48640,75377,18010,36290,15095,57366,14617,7101,7516
48645,75381,18011,36291,15096,57370,14617,7101,7516
48650,75391,18012,36297,15096,57378,14619,7103,7516
48655,75397,18013,36299,15097,57383,14621,7104,7517
48660,75408,18015,36304,15099,57392,14623,7105,7518
48665,75412,18016,36306,15100,57395,14623,7105,7518
48670,75422,18017,36310,15100,57405,14625,7106,7519
48675,75428,18017,36312,15100,57411,14627,7107,7520
48680,75439,18017,36318,15100,57420,14629,7108,7521
48685,75443,18018,36321,15101,57424,14629,7108,7521
48690,75453,18019,36325,15101,57432,14631,7109,7522
48695,75459,18022,36327,15104,57437,14633,7110,7523
48700,75470,18023,36332,15105,57445,14635,7111,7524
48705,75474,18023,36334,15105,57450,14635,7111,7524
48710,75484,18025,36337,15106,57459,14637,7111,7526
48715,75490,18026,36338,15107,57464,14639,7111,7528
48720,75501,18029,36347,15110,57468,14641,7113,7528
48725,75505,18031,36347,15112,57474,14641,7113,7528
48730,75515,18033,36351,15113,57482,14643,7113,7530
48735,75521,18033,36353,15113,57487,14645,7113,7532
48740,75532,18036,36357,15115,57494,14647,7113,7534
48745,75536,18036,36358,15115,57500,14647,7113,7534
48750,75546,18039,36365,15118,57506,14649,7114,7535
48755,75552,18039,36368,15118,57512,14651,7115,7536
48760,75563,18042,36373,15120,57521,14653,7115,7538
48765,75567,18043,36377,15121,57523,14653,7115,7538
48770,75577,18046,36383,15124,57531,14655,7116,7539
48775,75583,18046,36386,15124,57534,14657,7116,7541
48780,75594,18050,36390,15128,57543,14659,7116,7543
48785,75598,18052,36393,15130,57544,14659,7116,7543
48790,75608,18057,36398,15134,57551,14661,7118,7543
48795,75614,18057,36399,15134,57556,14663,7118,7545
48800,75625,18059,36406,15135,57563,14665,7120,7545
48805,75629,18063,36407,15139,57566,14665,7120,7545
48810,75639,18065,36412,15141,57573,14667,7122,7545
48815,75645,18065,36415,15141,57579,14669,7123,7546
48820,75656,18067,36420,15143,57587,14671,7124,7547
48825,75660,18069,36421,15145,57590,14671,7124,7547
48830,75670,18073,36424,15148,57597,14673,7125,7548
48835,75676,18074,36428,15149,57600,14675,7126,7549
48840,75687,18080,36434,15154,57606,14677,7127,7550
48845,75691,18082,36436,15156,57609,14677,7127,7550
48850,75701,18084,36440,15157,57617,14679,7128,7551
48855,75707,18084,36440,15157,57623,14681,7128,7553
48860,75718,18086,36443,15158,57632,14683,7128,7555
48865,75722,18087,36447,15159,57634,14683,7128,7555
48870,75732,18089,36452,15160,57642,14685,7129,7556
48875,75738,18089,36456,15160,57648,14687,7130,7557
48880,75749,18090,36461,15161,57659,14689,7131,7558
48885,75753,18091,36464,15162,57661,14689,7131,7558
48890,75763,18094,36468,15164,57668,14691,7131,7560
48895,75769,18094,36470,15164,57674,14693,7131,7562
48900,75780,18095,36477,15165,57684,14695,7133,7562
48905,75784,18096,36480,15166,57687,14695,7133,7562
48910,75794,18099,36486,15168,57695,14697,7135,7562
48915,75800,18099,36489,15168,57701,14699,7137,7562
48920,75811,18101,36496,15169,57709,14701,7139,7562
48925,75815,18101,36498,15169,57713,14701,7139,7562
48930,75825,18104,36503,15171,57721,14703,7140,7563
48935,75831,18104,36506,15171,57727,14705,7142,7563
48940,75842,18105,36508,15172,57737,14707,7142,7565
48945,75846,18105,36509,15172,57741,14707,7142,7565
48950,75856,18109,36514,15175,57746,14709,7142,7567
48955,75862,18110,36516,15176,57751,14711,7143,7568
48960,75873,18114,36523,15180,57757,14713,7144,7569
48965,75877,18114,36524,15180,57763,14713,7144,7569
48970,75887,18118,36527,15182,57769,14715,7145,7570
48975,75893,18118,36529,15182,57775,14717,7146,7571
48980,75904,18120,36533,15183,57783,14719,7147,7572
48985,75908,18120,36535,15183,57787,14719,7147,7572
48990,75918,18122,36539,15184,57796,14721,7148,7573
48995,75924,18122,36541,15184,57801,14723,7149,7574
49000,75935,18126,36544,15188,57809,14725,7149,7576
49005,75939,18127,36547,15189,57811,14725,7149,7576
49010,75949,18131,36552,15192,57818,14727,7149,7578
49015,75955,18131,36555,15192,57823,14729,7150,7579
49020,75966,18134,36558,15194,57832,14731,7151,7580
49025,75970,18134,36560,15194,57834,14731,7151,7580
49030,75980,18139,36565,15198,57841,14733,7153,7580
49035,75986,18139,36568,15198,57846,14735,7154,7581
49040,75997,18144,36575,15203,57852,14737,7155,7582
49045,76001,18147,36578,15206,57853,14737,7155,7582
49050,76011,18150,36583,15208,57861,14739,7156,7583
49055,76017,18150,36584,15208,57867,14741,7156,7585
49060,76028,18151,36588,15209,57877,14743,7157,7586
49065,76032,18152,36589,15210,57880,14743,7157,7586
49070,76042,18155,36591,15211,57886,14745,7157,7588
49075,76048,18157,36592,15213,57891,14747,7157,7590
49080,76059,18158,36596,15214,57900,14749,7159,7590
49085,76063,18160,36597,15216,57903,14749,7159,7590
49090,76073,18163,36601,15217,57910,14751,7161,7590
49095,76079,18163,36604,15217,57913,14753,7161,7592
49100,76090,18167,36608,15221,57922,14755,7162,7593
49105,76094,18167,36610,15221,57926,14755,7162,7593
49110,76104,18170,36615,15223,57932,14757,7162,7595
49115,76110,18173,36619,15226,57936,14759,7163,7596
49120,76121,18174,36625,15227,57944,14761,7165,7596
49125,76125,18176,36628,15229,57948,14761,7165,7596
49130,76135,18179,36630,15230,57956,14763,7166,7597
49135,76141,18179,36633,15230,57961,14765,7167,7598
49140,76152,18181,36640,15232,57968,14767,7168,7599
49145,76156,18183,36642,15234,57973,14767,7168,7599
49150,76166,18184,36647,15235,57980,14769,7168,7601
49155,76172,18186,36649,15237,57985,14771,7168,7603
49160,76183,18189,36656,15240,57994,14773,7169,7604
49165,76187,18189,36658,15240,57998,14773,7169,7604
49170,76197,18190,36663,15241,58005,14775,7169,7606
49175,76203,18193,36665,15244,58009,14777,7169,7608
49180,76214,18196,36670,15247,58017,14779,7170,7609
49185,76218,18197,36670,15248,58021,14779,7170,7609
49190,76228,18198,36675,15249,58029,14781,7171,7610
49195,76234,18200,36680,15251,58033,14783,7172,7611
49200,76245,18203,36687,15253,58041,14785,7174,7611
49205,76249,18204,36689,15254,58045,14785,7174,7611
49210,76259,18206,36694,15256,58052,14787,7175,7612
49215,76265,18208,36698,15258,58056,14789,7176,7613
49220,76276,18210,36703,15260,58065,14791,7177,7614
49225,76280,18211,36705,15261,58069,14791,7177,7614
49230,76290,18212,36709,15262,58077,14793,7179,7614
49235,76296,18213,36710,15263,58083,14795,7179,7616
49240,76307,18215,36714,15265,58092,14797,7179,7618
49245,76311,18216,36715,15266,58095,14797,7179,7618
49250,76321,18218,36717,15267,58103,14799,7180,7619
49255,76327,18218,36721,15267,58107,14801,7182,7619
49260,76338,18223,36726,15271,58113,14803,7183,7620
49265,76342,18226,36728,15274,58115,14803,7183,7620
49270,76352,18232,36735,15279,58119,14805,7185,7620
49275,76358,18233,36737,15280,58124,14807,7186,7621
49280,76369,18237,36744,15283,58129,14809,7188,7621
49285,76373,18242,36747,15288,58130,14809,7188,7621
49290,76383,18247,36752,15293,58136,14811,7189,7622
49295,76389,18247,36755,15293,58139,14813,7189,7624
49300,76400,18253,36759,15299,58146,14815,7189,7626
49305,76404,18255,36761,15301,58148,14815,7189,7626
49310,76414,18258,36764,15304,58156,14817,7190,7627
49315,76420,18258,36764,15304,58162,14819,7190,7629
49320,76431,18260,36768,15305,58170,14821,7191,7630
49325,76435,18261,36769,15306,58173,14821,7191,7630
49330,76445,18264,36776,15308,58179,14823,7192,7631
49335,76451,18267,36778,15311,58183,14825,7192,7633
49340,76462,18268,36781,15311,58194,14827,7193,7634
49345,76466,18268,36783,15311,58197,14827,7193,7634
49350,76476,18269,36788,15312,58207,14829,7194,7635
49355,76482,18269,36792,15312,58212,14831,7195,7636
49360,76493,18270,36799,15312,58221,14833,7196,7637
49365,76497,18270,36800,15312,58227,14833,7196,7637
49370,76507,18272,36806,15314,58235,14835,7198,7637
49375,76513,18272,36809,15314,58241,14837,7199,7638
49380,76524,18274,36816,15316,58250,14839,7200,7639
49385,76528,18275,36819,15317,58252,14839,7200,7639
49390,76538,18276,36824,15318,58262,14841,7200,7641
49395,76544,18276,36827,15318,58268,14843,7200,7643
49400,76555,18278,36833,15319,58276,14845,7201,7644
49405,76559,18279,36834,15320,58280,14845,7201,7644
49410,76569,18280,36838,15321,58289,14847,7202,7645
49415,76575,18280,36842,15321,58294,14849,7202,7647
49420,76586,18283,36848,15323,58301,14851,7203,7648
49425,76590,18284,36851,15324,58305,14851,7203,7648
49430,76600,18287,36854,15326,58313,14853,7203,7650
49435,76606,18287,36856,15326,58318,14855,7204,7651
49440,76617,18289,36857,15327,58327,14857,7204,7653
49445,76621,18290,36859,15328,58330,14857,7204,7653
49450,76631,18292,36861,15329,58339,14859,7204,7655
49455,76637,18292,36863,15329,58345,14861,7205,7656
49460,76648,18294,36870,15330,58352,14863,7207,7656
49465,76652,18295,36871,15331,58357,14863,7207,7656
49470,76662,18299,36878,15335,58361,14865,7208,7657
49475,76668,18302,36881,15338,58365,14867,7209,7658
49480,76679,18306,36884,15341,58373,14869,7210,7659
49485,76683,18308,36888,15343,58373,14869,7210,7659
49490,76693,18316,36894,15349,58376,14871,7211,7660
49495,76699,18317,36896,15350,58380,14873,7211,7662
49500,76710,18322,36900,15354,58386,14875,7211,7664
49505,76714,18326,36902,15358,58388,14875,7211,7664
49510,76724,18330,36906,15360,58392,14877,7211,7666
49515,76730,18332,36910,15362,58395,14879,7212,7667
49520,76741,18338,36916,15367,58399,14881,7212,7669
49525,76745,18341,36919,15370,58403,14881,7212,7669
49530,76755,18344,36924,15373,58410,14883,7213,7670
49535,76761,18346,36927,15375,58414,14885,7214,7671
49540,76772,18348,36931,15377,58423,14887,7214,7673
49545,76776,18348,36934,15377,58427,14887,7214,7673
49550,76786,18351,36938,15380,58435,14889,7215,7674
49555,76792,18352,36943,15381,58439,14891,7217,7674
49560,76803,18355,36951,15384,58447,14893,7218,7675
49565,76807,18356,36953,15385,58451,14893,7218,7675
49570,76817,18357,36959,15385,58459,14895,7219,7676
49575,76823,18359,36963,15387,58463,14897,7220,7677
49580,76834,18360,36967,15388,58472,14899,7221,7678
49585,76838,18360,36970,15388,58478,14899,7221,7678
49590,76848,18361,36975,15388,58486,14901,7222,7679
49595,76854,18363,36980,15390,58490,14903,7223,7680
49600,76865,18364,36986,15391,58499,14905,7224,7681
49605,76869,18364,36986,15391,58505,14905,7224,7681
49610,76879,18364,36993,15391,58515,14907,7225,7682
49615,76885,18364,36996,15391,58520,14909,7226,7683
49620,76896,18364,37001,15391,58532,14911,7227,7684
49625,76900,18364,37003,15391,58536,14911,7227,7684
49630,76910,18364,37009,15391,58546,14913,7229,7684
49635,76916,18364,37011,15391,58552,14915,7230,7685
49640,76927,18364,37012,15391,58563,14917,7231,7686
49645,76931,18365,37015,15392,58565,14917,7231,7686
49650,76941,18367,37020,15393,58574,14919,7232,7687
49655,76947,18367,37024,15393,58579,14921,7234,7687
49660,76958,18370,37029,15396,58586,14923,7234,7689
49665,76962,18371,37031,15397,58589,14923,7234,7689
49670,76972,18375,37035,15401,58596,14925,7235,7690
49675,76978,18375,37037,15401,58602,14927,7236,7691
49680,76989,18377,37043,15402,58610,14929,7238,7691
49685,76993,18379,37047,15404,58613,14929,7238,7691
49690,77003,18380,37050,15404,58623,14931,7239,7692
49695,77009,18380,37052,15404,58629,14933,7241,7692
49700,77020,18382,37058,15406,58636,14935,7241,7694
49705,77024,18383,37060,15407,58641,14935,7241,7694
49710,77034,18386,37066,15409,58647,14937,7242,7695
49715,77040,18386,37068,15409,58654,14939,7243,7696
49720,77051,18388,37073,15411,58662,14941,7244,7697
49725,77055,18389,37073,15412,58666,14941,7244,7697
49730,77065,18391,37076,15413,58673,14943,7244,7699
49735,77071,18393,37077,15415,58678,14945,7244,7701
49740,77082,18394,37083,15416,58686,14947,7246,7701
49745,77086,18396,37084,15418,58690,14947,7246,7701
49750,77096,18398,37090,15420,58696,14949,7247,7702
49755,77102,18400,37094,15422,58700,14951,7248,7703
49760,77113,18404,37099,15425,58706,14953,7249,7704
49765,77117,18406,37101,15427,58711,14953,7249,7704
49770,77127,18409,37106,15428,58717,14955,7250,7705
49775,77133,18410,37108,15429,58722,14957,7251,7706
49780,77144,18414,37113,15432,58729,14959,7252,7707
49785,77148,18414,37115,15432,58733,14959,7252,7707
49790,77158,18419,37120,15435,58738,14961,7254,7707
49795,77164,18420,37122,15436,58743,14963,7255,7708
49800,77175,18425,37128,15441,58748,14965,7255,7710
49805,77179,18429,37132,15445,58749,14965,7255,7710
49810,77189,18432,37135,15447,58756,14967,7256,7711
49815,77195,18433,37137,15448,58761,14969,7257,7712
49820,77206,18436,37141,15451,58770,14971,7258,7713
49825,77210,18437,37143,15452,58773,14971,7258,7713
49830,77220,18440,37145,15453,58779,14973,7258,7715
49835,77226,18441,37146,15454,58785,14975,7259,7716
49840,77237,18443,37151,15456,58793,14977,7260,7717
49845,77241,18444,37152,15457,58796,14977,7260,7717
49850,77251,18449,37157,15461,58801,14979,7260,7719
49855,77257,18450,37158,15462,58807,14981,7261,7720
49860,77268,18452,37161,15464,58816,14983,7261,7722
49865,77272,18452,37162,15464,58820,14983,7261,7722
49870,77282,18453,37166,15464,58829,14985,7262,7723
49875,77288,18453,37169,15464,58835,14987,7263,7724
49880,77299,18455,37173,15466,58844,14989,7263,7726
49885,77303,18455,37173,15466,58848,14989,7263,7726
49890,77313,18458,37179,15468,58855,14991,7264,7727
49895,77319,18458,37182,15468,58861,14993,7264,7729
49900,77330,18461,37190,15471,58869,14995,7265,7730
49905,77334,18461,37191,15471,58873,14995,7265,7730
49910,77344,18464,37196,15473,58880,14997,7266,7731
49915,77350,18464,37198,15473,58886,14999,7267,7732
49920,77361,18466,37203,15474,58894,15001,7269,7732
49925,77365,18467,37206,15475,58897,15001,7269,7732
49930,77375,18468,37209,15475,58907,15003,7270,7733
49935,77381,18468,37213,15475,58913,15005,7272,7733
49940,77392,18470,37215,15476,58922,15007,7272,7735
49945,77396,18470,37218,15476,58925,15007,7272,7735
49950,77406,18473,37223,15478,58933,15009,7272,7737
49955,77412,18473,37228,15478,58938,15011,7274,7737
49960,77423,18478,37234,15482,58944,15013,7275,7738
49965,77427,18480,37236,15484,58946,15013,7275,7738
49970,77437,18486,37241,15489,58950,15015,7275,7740
49975,77443,18488,37243,15491,58955,15017,7276,7741
49980,77454,18492,37248,15494,58960,15019,7276,7743
49985,77458,18495,37250,15497,58962,15019,7276,7743
49990,77468,18499,37257,15500,58969,15021,7278,7743
49995,77474,18499,37258,15500,58975,15023,7279,7744
50000,77485,18501,37263,15501,58981,15025,7280,7745
50005,77489,18503,37264,15503,58986,15025,7280,7745
50010,77499,18505,37265,15504,58994,15027,7280,7747
50015,77505,18506,37269,15505,58998,15029,7282,7747
50020,77516,18507,37271,15506,59009,15031,7282,7749
50025,77520,18507,37273,15506,59013,15031,7282,7749
50030,77530,18509,37279,15508,59020,15033,7283,7750
50035,77536,18511,37285,15510,59023,15035,7285,7750
50040,77547,18515,37294,15514,59028,15037,7286,7751
50045,77551,18517,37296,15516,59034,15037,7286,7751
50050,77561,18519,37300,15517,59041,15039,7286,7753
50055,77567,18521,37303,15519,59045,15041,7287,7754
50060,77578,18523,37309,15521,59053,15043,7288,7755
50065,77582,18524,37311,15522,59058,15043,7288,7755
50070,77592,18526,37316,15523,59065,15045,7288,7757
50075,77598,18527,37318,15524,59071,15047,7289,7758
50080,77609,18528,37327,15525,59077,15049,7291,7758
50085,77613,18530,37331,15527,59082,15049,7291,7758
50090,77623,18535,37339,15531,59086,15051,7293,7758
50095,77629,18537,37341,15533,59090,15053,7293,7760
50100,77640,18542,37350,15538,59095,15055,7294,7761
50105,77644,18545,37354,15541,59098,15055,7294,7761
50110,77654,18546,37359,15542,59107,15057,7295,7762
50115,77660,18547,37362,15543,59112,15059,7297,7762
50120,77671,18550,37367,15545,59120,15061,7299,7762
50125,77675,18551,37367,15546,59124,15061,7299,7762
50130,77685,18552,37371,15546,59132,15063,7300,7763
50135,77691,18554,37375,15548,59136,15065,7301,7764
50140,77702,18556,37381,15550,59144,15067,7302,7765
50145,77706,18558,37382,15552,59148,15067,7302,7765
50150,77716,18559,37388,15553,59156,15069,7303,7766
50155,77722,18559,37392,15553,59163,15071,7305,7766
50160,77733,18561,37395,15554,59172,15073,7306,7767
50165,77737,18562,37399,15555,59175,15073,7306,7767
50170,77747,18563,37404,15556,59184,15075,7307,7768
50175,77753,18563,37410,15556,59189,15077,7309,7768
50180,77764,18564,37414,15557,59200,15079,7310,7769
50185,77768,18565,37417,15558,59203,15079,7310,7769
50190,77778,18567,37423,15560,59210,15081,7310,7771
50195,77784,18567,37427,15560,59216,15083,7312,7771
50200,77795,18569,37436,15561,59225,15085,7314,7771
50205,77799,18569,37439,15561,59229,15085,7314,7771
50210,77809,18572,37443,15563,59236,15087,7315,7772
50215,77815,18572,37445,15563,59243,15089,7316,7773
50220,77826,18575,37449,15565,59250,15091,7317,7774
50225,77830,18576,37450,15566,59253,15091,7317,7774
50230,77840,18581,37457,15570,59259,15093,7318,7775
50235,77846,18581,37461,15570,59263,15095,7320,7775
50240,77857,18585,37463,15573,59272,15097,7320,7777
50245,77861,18585,37463,15573,59276,15097,7320,7777
50250,77871,18589,37468,15576,59282,15099,7321,7778
50255,77877,18589,37471,15576,59288,15101,7322,7779
50260,77888,18591,37475,15577,59295,15103,7323,7780
50265,77892,18593,37476,15579,59298,15103,7323,7780
50270,77902,18597,37477,15581,59305,15105,7323,7782
50275,77908,18597,37480,15581,59309,15107,7324,7783
50280,77919,18601,37485,15584,59316,15109,7325,7784
50285,77923,18602,37487,15585,59320,15109,7325,7784
50290,77933,18603,37488,15586,59330,15111,7325,7786
50295,77939,18603,37489,15586,59336,15113,7326,7787
50300,77950,18604,37492,15587,59346,15115,7326,7789
50305,77954,18605,37493,15588,59349,15115,7326,7789
50310,77964,18608,37500,15591,59356,15117,7327,7790
50315,77970,18608,37502,15591,59362,15119,7327,7792
50320,77981,18611,37506,15594,59370,15121,7328,7793
50325,77985,18611,37506,15594,59374,15121,7328,7793
50330,77995,18613,37511,15595,59381,15123,7329,7794
50335,78001,18615,37514,15597,59385,15125,7329,7796
50340,78012,18619,37519,15601,59392,15127,7329,7798
50345,78016,18620,37521,15602,59396,15127,7329,7798
50350,78026,18622,37526,15604,59403,15129,7330,7799
50355,78032,18624,37528,15606,59407,15131,7330,7801
50360,78043,18627,37533,15608,59415,15133,7331,7802
50365,78047,18629,37535,15610,59418,15133,7331,7802
50370,78057,18632,37539,15613,59424,15135,7331,7804
50375,78063,18633,37541,15614,59429,15137,7332,7805
50380,78074,18636,37546,15616,59437,15139,7333,7806
50385,78078,18636,37547,15616,59441,15139,7333,7806
50390,78088,18640,37549,15619,59448,15141,7333,7808
50395,78094,18641,37554,15620,59450,15143,7334,7809
50400,78105,18647,37559,15626,59457,15145,7335,7810
50405,78109,18648,37560,15627,59460,15145,7335,7810
50410,78119,18654,37567,15633,59464,15147,7336,7811
50415,78125,18655,37568,15634,59470,15149,7337,7812
50420,78136,18657,37571,15635,59477,15151,7337,7814
50425,78140,18661,37575,15639,59477,15151,7337,7814
50430,78150,18666,37579,15642,59482,15153,7338,7815
50435,78156,18669,37583,15645,59485,15155,7339,7816
50440,78167,18673,37587,15648,59492,15157,7340,7817
50445,78171,18676,37589,15651,59494,15157,7340,7817
50450,78181,18681,37596,15656,59499,15159,7342,7817
50455,78187,18683,37601,15658,59502,15161,7344,7817
50460,78198,18688,37606,15663,59508,15163,7344,7819
50465,78202,18689,37608,15664,59512,15163,7344,7819
50470,78212,18691,37611,15665,59520,15165,7344,7821
50475,78218,18693,37614,15667,59524,15167,7345,7822
50480,78229,18695,37620,15668,59532,15169,7346,7823
50485,78233,18697,37623,15670,59536,15169,7346,7823
50490,78243,18699,37629,15672,59544,15171,7348,7823
50495,78249,18700,37634,15673,59548,15173,7350,7823
50500,78260,18703,37640,15675,59556,15175,7352,7823
50505,78264,18703,37642,15675,59560,15175,7352,7823
50510,78274,18704,37646,15676,59569,15177,7352,7825
50515,78280,18704,37647,15676,59575,15179,7352,7827
50520,78291,18705,37649,15676,59584,15181,7352,7829
50525,78295,18705,37651,15676,59590,15181,7352,7829
50530,78305,18706,37656,15677,59599,15183,7354,7829
50535,78311,18706,37659,15677,59604,15185,7355,7830
50540,78322,18707,37668,15678,59615,15187,7357,7830
50545,78326,18708,37672,15679,59618,15187,7357,7830
50550,78336,18710,37679,15681,59625,15189,7359,7830
50555,78342,18710,37682,15681,59631,15191,7360,7831
50560,78353,18712,37689,15682,59641,15193,7362,7831
50565,78357,18713,37692,15683,59644,15193,7362,7831
50570,78367,18715,37698,15684,59652,15195,7364,7831
50575,78373,18715,37702,15684,59656,15197,7366,7831
50580,78384,18717,37707,15686,59667,15199,7366,7833
50585,78388,18717,37709,15686,59671,15199,7366,7833
50590,78398,18718,37715,15687,59680,15201,7367,7834
50595,78404,18718,37716,15687,59686,15203,7367,7836
50600,78415,18719,37719,15688,59696,15205,7368,7837
50605,78419,18719,37719,15688,59700,15205,7368,7837
50610,78429,18721,37724,15689,59708,15207,7370,7837
50615,78435,18721,37727,15689,59714,15209,7371,7838
50620,78446,18722,37731,15690,59723,15211,7372,7839
50625,78450,18723,37732,15691,59727,15211,7372,7839
50630,78460,18725,37737,15691,59735,15213,7374,7839
50635,78466,18725,37739,15691,59741,15215,7375,7840
50640,78477,18726,37743,15692,59751,15217,7377,7840
50645,78481,18727,37746,15693,59753,15217,7377,7840
50650,78491,18732,37749,15697,59759,15219,7377,7842
50655,78497,18732,37753,15697,59764,15221,7378,7843
50660,78508,18735,37759,15700,59771,15223,7379,7844
50665,78512,18737,37761,15702,59773,15223,7379,7844
50670,78522,18741,37765,15705,59781,15225,7380,7845
50675,78528,18741,37767,15705,59786,15227,7381,7846
50680,78539,18746,37770,15709,59793,15229,7381,7848
50685,78543,18747,37772,15710,59795,15229,7381,7848
50690,78553,18753,37776,15715,59800,15231,7381,7850
50695,78559,18753,37778,15715,59806,15233,7383,7850
50700,78570,18756,37783,15717,59812,15235,7384,7851
50705,78574,18758,37784,15719,59815,15235,7384,7851
50710,78584,18760,37789,15721,59823,15237,7385,7852
50715,78590,18761,37791,15722,59828,15239,7386,7853
50720,78601,18762,37795,15723,59838,15241,7387,7854
50725,78605,18763,37797,15724,59841,15241,7387,7854
50730,78615,18766,37803,15726,59849,15243,7389,7854
50735,78621,18767,37806,15727,59854,15245,7391,7854
50740,78632,18768,37811,15727,59863,15247,7393,7854
50745,78636,18770,37814,15729,59866,15247,7393,7854
50750,78646,18773,37819,15732,59872,15249,7393,7856
50755,78652,18774,37821,15733,59877,15251,7394,7857
50760,78663,18777,37826,15736,59885,15253,7394,7859
50765,78667,18777,37828,15736,59889,15253,7394,7859
50770,78677,18779,37834,15738,59896,15255,7394,7861
50775,78683,18781,37837,15740,59901,15257,7396,7861
50780,78694,18784,37840,15743,59910,15259,7397,7862
50785,78698,18785,37842,15744,59913,15259,7397,7862
50790,78708,18787,37845,15745,59920,15261,7398,7863
50795,78714,18788,37847,15746,59925,15263,7398,7865
50800,78725,18789,37851,15746,59934,15265,7399,7866
50805,78729,18790,37853,15747,59938,15265,7399,7866
50810,78739,18794,37857,15750,59945,15267,7399,7868
50815,78745,18794,37860,15750,59950,15269,7401,7868
50820,78756,18799,37867,15754,59954,15271,7402,7869
50825,78760,18801,37870,15756,59958,15271,7402,7869
50830,78770,18803,37876,15757,59966,15273,7404,7869
50835,78776,18804,37878,15758,59971,15275,7404,7871
50840,78787,18807,37885,15761,59977,15277,7405,7872
50845,78791,18810,37888,15764,59980,15277,7405,7872
50850,78801,18813,37893,15765,59987,15279,7406,7873
50855,78807,18814,37896,15766,59992,15281,7408,7873
50860,78818,18818,37902,15769,59997,15283,7408,7875
50865,78822,18820,37905,15771,60002,15283,7408,7875
50870,78832,18822,37908,15771,60009,15285,7410,7875
50875,78838,18823,37910,15772,60015,15287,7411,7876
50880,78849,18826,37915,15775,60021,15289,7411,7878
50885,78853,18827,37916,15776,60026,15289,7411,7878
50890,78863,18829,37920,15778,60034,15291,7412,7879
50895,78869,18830,37921,15779,60039,15293,7412,7881
50900,78880,18833,37926,15781,60047,15295,7414,7881
50905,78884,18834,37928,15782,60050,15295,7414,7881
50910,78894,18836,37934,15783,60057,15297,7416,7881
50915,78900,18838,37938,15785,60060,15299,7417,7882
50920,78911,18842,37943,15788,60067,15301,7418,7883
50925,78915,18844,37945,15790,60070,15301,7418,7883
50930,78925,18848,37948,15792,60076,15303,7418,7885
50935,78931,18849,37949,15793,60081,15305,7418,7887
50940,78942,18852,37953,15795,60087,15307,7418,7889
50945,78946,18854,37955,15797,60091,15307,7418,7889
50950,78956,18859,37960,15801,60097,15309,7419,7890
50955,78962,18860,37965,15802,60101,15311,7421,7890
50960,78973,18864,37971,15805,60106,15313,7422,7891
50965,78977,18868,37974,15809,60107,15313,7422,7891
50970,78987,18876,37979,15816,60111,15315,7422,7893
50975,78993,18877,37983,15817,60114,15317,7423,7894
50980,79004,18881,37990,15820,60120,15319,7425,7894
50985,79008,18883,37993,15822,60124,15319,7425,7894
50990,79018,18885,37999,15823,60131,15321,7427,7894
50995,79024,18886,38001,15824,60137,15323,7428,7895
51000,79035,18887,38006,15824,60146,15325,7429,7896
51005,79039,18887,38008,15824,60152,15325,7429,7896
51010,79049,18887,38011,15824,60162,15327,7430,7897
51015,79055,18887,38016,15824,60167,15329,7432,7897
51020,79066,18889,38020,15825,60177,15331,7432,7899
51025,79070,18890,38022,15826,60180,15331,7432,7899
51030,79080,18892,38027,15828,60188,15333,7433,7900
51035,79086,18892,38032,15828,60193,15335,7435,7900
51040,79097,18894,38036,15829,60203,15337,7435,7902
51045,79101,18894,38036,15829,60207,15337,7435,7902
51050,79111,18896,38044,15831,60214,15339,7435,7904
51055,79117,18896,38047,15831,60220,15341,7436,7905
51060,79128,18897,38051,15831,60231,15343,7436,7907
51065,79132,18898,38055,15832,60234,15343,7436,7907
51070,79142,18898,38059,15832,60244,15345,7438,7907
51075,79148,18898,38062,15832,60249,15347,7439,7908
51080,79159,18898,38065,15832,60261,15349,7440,7909
51085,79163,18898,38067,15832,60265,15349,7440,7909
51090,79173,18899,38073,15833,60274,15351,7442,7909
51095,79179,18900,38077,15834,60277,15353,7442,7911
51100,79190,18904,38082,15838,60285,15355,7442,7913
51105,79194,18905,38086,15839,60288,15355,7442,7913
51110,79204,18907,38091,15840,60296,15357,7442,7915
51115,79210,18908,38094,15841,60300,15359,7442,7917
51120,79221,18911,38097,15844,60308,15361,7442,7919
51125,79225,18912,38099,15845,60313,15361,7442,7919
51130,79235,18914,38105,15845,60320,15363,7444,7919
51135,79241,18914,38108,15845,60326,15365,7445,7920
51140,79252,18915,38110,15846,60336,15367,7445,7922
51145,79256,18915,38113,15846,60340,15367,7445,7922
51150,79266,18917,38119,15847,60348,15369,7446,7923
51155,79272,18917,38122,15847,60354,15371,7446,7925
51160,79283,18918,38126,15848,60365,15373,7448,7925
51165,79287,18918,38129,15848,60368,15373,7448,7925
51170,79297,18920,38134,15848,60377,15375,7449,7926
51175,79303,18920,38134,15848,60383,15377,7449,7928
51180,79314,18921,38141,15848,60390,15379,7451,7928
51185,79318,18924,38142,15851,60393,15379,7451,7928
51190,79328,18928,38145,15853,60400,15381,7453,7928
51195,79334,18928,38148,15853,60404,15383,7454,7929
51200,79345,18931,38152,15856,60413,15385,7456,7929
51205,79349,18934,38154,15859,60415,15385,7456,7929
51210,79359,18939,38161,15864,60420,15387,7458,7929
51215,79365,18939,38163,15864,60425,15389,7458,7931
51220,79376,18944,38169,15868,60431,15391,7459,7932
51225,79380,18947,38173,15871,60431,15391,7459,7932
51230,79390,18953,38179,15877,60437,15393,7461,7932
51235,79396,18953,38183,15877,60443,15395,7463,7932
51240,79407,18954,38186,15877,60453,15397,7464,7933
51245,79411,18955,38188,15878,60455,15397,7464,7933
51250,79421,18957,38192,15880,60464,15399,7464,7935
51255,79427,18957,38197,15880,60469,15401,7466,7935
51260,79438,18959,38202,15881,60478,15403,7468,7935
51265,79442,18960,38205,15882,60482,15403,7468,7935
51270,79452,18962,38210,15883,60489,15405,7470,7935
51275,79458,18963,38212,15884,60495,15407,7472,7935
51280,79469,18964,38216,15884,60505,15409,7473,7936
51285,79473,18964,38219,15884,60508,15409,7473,7936
51290,79483,18965,38223,15885,60517,15411,7474,7937
51295,79489,18967,38226,15887,60522,15413,7475,7938
51300,79500,18968,38231,15888,60530,15415,7477,7938
51305,79504,18969,38232,15889,60535,15415,7477,7938
51310,79514,18971,38237,15891,60542,15417,7478,7939
51315,79520,18973,38239,15893,60547,15419,7478,7941
51320,79531,18975,38242,15895,60556,15421,7478,7943
51325,79535,18975,38243,15895,60560,15421,7478,7943
51330,79545,18977,38248,15896,60567,15423,7479,7944
51335,79551,18979,38252,15898,60571,15425,7480,7945
51340,79562,18983,38259,15901,60577,15427,7482,7945
51345,79566,18985,38259,15903,60581,15427,7482,7945
51350,79576,18988,38262,15905,60587,15429,7482,7947
51355,79582,18989,38266,15906,60592,15431,7484,7947
51360,79593,18991,38270,15908,60601,15433,7485,7948
51365,79597,18992,38271,15909,60605,15433,7485,7948
51370,79607,18994,38276,15910,60612,15435,7487,7948
51375,79613,18995,38276,15911,60618,15437,7487,7950
51380,79624,18997,38283,15913,60623,15439,7488,7951
51385,79628,18999,38284,15915,60628,15439,7488,7951
51390,79638,19003,38288,15918,60634,15441,7489,7952
51395,79644,19005,38290,15920,60639,15443,7490,7953
51400,79655,19009,38298,15923,60642,15445,7491,7954
51405,79659,19012,38300,15926,60646,15445,7491,7954
51410,79669,19017,38305,15930,60650,15447,7491,7956
51415,79675,19019,38308,15932,60655,15449,7493,7956
51420,79686,19024,38312,15937,60662,15451,7493,7958
51425,79690,19025,38314,15938,60664,15451,7493,7958
51430,79700,19031,38318,15942,60669,15453,7494,7959
51435,79706,19031,38319,15942,60674,15455,7494,7961
51440,79717,19036,38326,15947,60679,15457,7495,7962
51445,79721,19039,38327,15950,60682,15457,7495,7962
51450,79731,19044,38333,15954,60687,15459,7497,7962
51455,79737,19045,38336,15955,60691,15461,7498,7963
51460,79748,19050,38341,15959,60696,15463,7498,7965
51465,79752,19054,38344,15963,60697,15463,7498,7965
51470,79762,19058,38352,15966,60702,15465,7500,7965
51475,79768,19060,38356,15968,60707,15467,7502,7965
51480,79779,19064,38362,15971,60713,15469,7503,7966
51485,79783,19065,38365,15972,60718,15469,7503,7966
51490,79793,19067,38372,15973,60724,15471,7504,7967
51495,79799,19069,38375,15975,60730,15473,7505,7968
51500,79810,19071,38382,15976,60739,15475,7506,7969
51505,79814,19071,38383,15976,60743,15475,7506,7969
51510,79824,19073,38387,15978,60751,15477,7507,7970
51515,79830,19073,38389,15978,60757,15479,7508,7971
51520,79841,19074,38392,15979,60767,15481,7508,7973
51525,79845,19074,38394,15979,60771,15481,7508,7973
51530,79855,19075,38398,15980,60780,15483,7508,7975
51535,79861,19075,38400,15980,60785,15485,7508,7977
51540,79872,19077,38405,15981,60795,15487,7509,7978
51545,79876,19077,38407,15981,60799,15487,7509,7978
51550,79886,19078,38412,15982,60808,15489,7510,7979
51555,79892,19078,38416,15982,60814,15491,7511,7980
51560,79903,19079,38419,15982,60824,15493,7511,7982
51565,79907,19080,38421,15983,60827,15493,7511,7982
51570,79917,19082,38425,15985,60834,15495,7511,7984
51575,79923,19082,38428,15985,60841,15497,7512,7985
51580,79934,19084,38434,15987,60850,15499,7513,7986
51585,79938,19085,38437,15988,60851,15499,7513,7986
51590,79948,19089,38441,15991,60859,15501,7514,7987
51595,79954,19089,38443,15991,60865,15503,7516,7987
51600,79965,19091,38447,15993,60872,15505,7516,7989
51605,79969,19094,38449,15996,60874,15505,7516,7989
51610,79979,19098,38452,15999,60880,15507,7516,7991
51615,79985,19098,38455,15999,60887,15509,7517,7992
51620,79996,19100,38460,16001,60896,15511,7517,7994
51625,80000,19100,38462,16001,60900,15511,7517,7994
51630,80010,19102,38467,16001,60907,15513,7519,7994
51635,80016,19102,38470,16001,60914,15515,7520,7995
51640,80027,19104,38476,16003,60920,15517,7520,7997
51645,80031,19105,38477,16004,60925,15517,7520,7997
51650,80041,19108,38481,16007,60932,15519,7520,7999
51655,80047,19109,38482,16008,60938,15521,7521,8000
51660,80058,19111,38487,16010,60947,15523,7523,8000
51665,80062,19112,38488,16011,60950,15523,7523,8000
51670,80072,19114,38492,16011,60958,15525,7524,8001
51675,80078,19115,38496,16012,60961,15527,7525,8002
51680,80089,19118,38502,16015,60969,15529,7525,8004
51685,80093,19120,38502,16017,60973,15529,7525,8004
51690,80103,19122,38510,16018,60980,15531,7527,8004
51695,80109,19123,38512,16019,60985,15533,7528,8005
51700,80120,19124,38516,16020,60993,15535,7528,8007
51705,80124,19125,38516,16021,60999,15535,7528,8007
51710,80134,19127,38521,16022,61007,15537,7529,8008
51715,80140,19127,38525,16022,61011,15539,7531,8008
51720,80151,19131,38529,16026,61019,15541,7532,8009
51725,80155,19132,38531,16027,61022,15541,7532,8009
51730,80165,19136,38536,16031,61029,15543,7532,8011
51735,80171,19137,38540,16032,61032,15545,7533,8012
51740,80182,19139,38545,16034,61040,15547,7535,8012
51745,80186,19142,38548,16037,61042,15547,7535,8012
51750,80196,19146,38552,16040,61049,15549,7535,8014
51755,80202,19148,38555,16042,61053,15551,7536,8015
51760,80213,19150,38561,16044,61060,15553,7536,8017
51765,80217,19151,38565,16045,61065,15553,7536,8017
51770,80227,19152,38568,16046,61074,15555,7537,8018
51775,80233,19153,38572,16047,61078,15557,7539,8018
51780,80244,19157,38579,16050,61085,15559,7540,8019
51785,80248,19159,38580,16052,61089,15559,7540,8019
51790,80258,19160,38584,16053,61098,15561,7541,8020
51795,80264,19160,38589,16053,61104,15563,7543,8020
51800,80275,19161,38596,16054,61113,15565,7545,8020
51805,80279,19162,38598,16055,61117,15565,7545,8020
51810,80289,19164,38602,16057,61125,15567,7545,8022
51815,80295,19164,38603,16057,61131,15569,7545,8024
51820,80306,19166,38610,16059,61138,15571,7546,8025
51825,80310,19167,38612,16060,61143,15571,7546,8025
51830,80320,19169,38619,16062,61151,15573,7547,8026
51835,80326,19169,38621,16062,61157,15575,7548,8027
51840,80337,19171,38627,16064,61165,15577,7550,8027
51845,80341,19172,38628,16065,61169,15577,7550,8027
51850,80351,19173,38631,16065,61178,15579,7551,8028
51855,80357,19173,38635,16065,61184,15581,7553,8028
51860,80368,19174,38641,16066,61193,15583,7554,8029
51865,80372,19175,38644,16067,61197,15583,7554,8029
51870,80382,19177,38648,16068,61205,15585,7554,8031
51875,80388,19177,38652,16068,61211,15587,7556,8031
51880,80399,19179,38658,16069,61217,15589,7556,8033
51885,80403,19180,38660,16070,61222,15589,7556,8033
51890,80413,19184,38667,16074,61227,15591,7557,8034
51895,80419,19187,38669,16077,61232,15593,7557,8036
51900,80430,19189,38671,16078,61240,15595,7557,8038
51905,80434,19191,38674,16080,61242,15595,7557,8038
51910,80444,19195,38679,16082,61247,15597,7558,8039
51915,80450,19198,38682,16085,61251,15599,7559,8040
51920,80461,19203,38688,16089,61257,15601,7560,8041
51925,80465,19205,38690,16091,61260,15601,7560,8041
51930,80475,19208,38695,16094,61267,15603,7560,8043
51935,80481,19208,38698,16094,61272,15605,7562,8043
51940,80492,19210,38701,16095,61280,15607,7563,8044
51945,80496,19213,38703,16098,61283,15607,7563,8044
51950,80506,19218,38712,16103,61286,15609,7564,8045
51955,80512,19220,38714,16105,61291,15611,7565,8046
51960,80523,19222,38717,16106,61299,15613,7565,8048
51965,80527,19224,38718,16108,61303,15613,7565,8048
51970,80537,19226,38724,16110,61309,15615,7567,8048
51975,80543,19228,38726,16112,61313,15617,7567,8050
51980,80554,19232,38730,16115,61321,15619,7568,8051
51985,80558,19234,38732,16117,61323,15619,7568,8051
51990,80568,19239,38737,16120,61329,15621,7570,8051
51995,80574,19239,38741,16120,61333,15623,7572,8051
52000,80585,19243,38743,16124,61342,15625,7572,8053
52005,80589,19245,38745,16126,61344,15625,7572,8053
52010,80599,19249,38750,16128,61349,15627,7574,8053
52015,80605,19250,38754,16129,61352,15629,7575,8054
52020,80616,19255,38758,16134,61360,15631,7576,8055
52025,80620,19257,38759,16136,61363,15631,7576,8055
52030,80630,19260,38761,16137,61370,15633,7577,8056
52035,80636,19261,38764,16138,61375,15635,7579,8056
52040,80647,19265,38770,16142,61381,15637,7580,8057
52045,80651,19267,38772,16144,61383,15637,7580,8057
52050,80661,19272,38778,16149,61388,15639,7581,8058
52055,80667,19274,38781,16151,61393,15641,7583,8058
52060,80678,19276,38787,16153,61401,15643,7584,8059
52065,80682,19277,38790,16154,61404,15643,7584,8059
52070,80692,19279,38795,16156,61412,15645,7585,8060
52075,80698,19281,38799,16158,61416,15647,7586,8061
52080,80709,19283,38805,16160,61425,15649,7588,8061
52085,80713,19284,38806,16161,61429,15649,7588,8061
52090,80723,19284,38810,16161,61438,15651,7590,8061
52095,80729,19284,38813,16161,61443,15653,7590,8063
52100,80740,19286,38819,16162,61454,15655,7592,8063
52105,80744,19286,38821,16162,61457,15655,7592,8063
52110,80754,19287,38828,16163,61466,15657,7593,8064
52115,80760,19287,38831,16163,61473,15659,7595,8064
52120,80771,19289,38835,16164,61482,15661,7596,8065
52125,80775,19290,38837,16165,61485,15661,7596,8065
52130,80785,19290,38842,16165,61494,15663,7598,8065
52135,80791,19290,38847,16165,61501,15665,7600,8065
52140,80802,19292,38854,16167,61509,15667,7601,8066
52145,80806,19292,38855,16167,61514,15667,7601,8066
52150,80816,19292,38858,16167,61524,15669,7601,8068
52155,80822,19292,38861,16167,61529,15671,7602,8069
52160,80833,19296,38867,16170,61536,15673,7603,8070
52165,80837,19298,38870,16172,61537,15673,7603,8070
52170,80847,19302,38877,16176,61545,15675,7605,8070
52175,80853,19302,38880,16176,61551,15677,7606,8071
52180,80864,19305,38885,16179,61558,15679,7607,8072
52185,80868,19307,38887,16181,61560,15679,7607,8072
52190,80878,19312,38890,16184,61566,15681,7607,8074
52195,80884,19312,38892,16184,61571,15683,7607,8076
52200,80895,19317,38899,16188,61577,15685,7609,8076
52205,80899,19318,38900,16189,61581,15685,7609,8076
52210,80909,19320,38906,16191,61589,15687,7610,8077
52215,80915,19320,38912,16191,61594,15689,7612,8077
52220,80926,19323,38917,16194,61601,15691,7612,8079
52225,80930,19324,38919,16195,61605,15691,7612,8079
52230,80940,19326,38925,16195,61614,15693,7613,8080
52235,80946,19326,38927,16195,61618,15695,7613,8082
52240,80957,19329,38934,16198,61625,15697,7614,8083
52245,80961,19330,38936,16199,61631,15697,7614,8083
52250,80971,19332,38943,16201,61638,15699,7616,8083
52255,80977,19334,38945,16203,61643,15701,7617,8084
52260,80988,19334,38949,16203,61652,15703,7618,8085
52265,80992,19335,38950,16204,61656,15703,7618,8085
52270,81002,19337,38954,16206,61664,15705,7619,8086
52275,81008,19338,38958,16207,61669,15707,7621,8086
52280,81019,19340,38963,16209,61677,15709,7621,8088
52285,81023,19341,38965,16210,61682,15709,7621,8088
52290,81033,19343,38970,16211,61690,15711,7622,8089
52295,81039,19344,38973,16212,61695,15713,7623,8090
52300,81050,19344,38978,16212,61704,15715,7625,8090
52305,81054,19345,38981,16213,61709,15715,7625,8090
52310,81064,19350,38986,16216,61713,15717,7625,8092
52315,81070,19351,38990,16217,61717,15719,7627,8092
52320,81081,19355,38993,16220,61725,15721,7628,8093
52325,81085,19357,38994,16222,61728,15721,7628,8093
52330,81095,19360,38997,16223,61734,15723,7629,8094
52335,81101,19362,39001,16225,61738,15725,7631,8094
52340,81112,19364,39001,16226,61748,15727,7631,8096
52345,81116,19366,39004,16228,61749,15727,7631,8096
52350,81126,19370,39011,16231,61754,15729,7632,8097
52355,81132,19372,39013,16233,61760,15731,7633,8098
52360,81143,19375,39020,16235,61766,15733,7634,8099
52365,81147,19376,39021,16236,61771,15733,7634,8099
52370,81157,19378,39027,16238,61779,15735,7636,8099
52375,81163,19378,39028,16238,61784,15737,7636,8101
52380,81174,19380,39033,16240,61793,15739,7638,8101
52385,81178,19381,39035,16241,61797,15739,7638,8101
52390,81188,19384,39039,16244,61804,15741,7639,8102
52395,81194,19385,39044,16245,61807,15743,7641,8102
52400,81205,19389,39049,16248,61816,15745,7643,8102
52405,81209,19389,39050,16248,61820,15745,7643,8102
52410,81219,19391,39056,16249,61827,15747,7645,8102
52415,81225,19393,39062,16251,61830,15749,7647,8102
52420,81236,19396,39067,16253,61839,15751,7648,8103
52425,81240,19397,39070,16254,61842,15751,7648,8103
52430,81250,19399,39072,16255,61851,15753,7648,8105
52435,81256,19400,39077,16256,61855,15755,7650,8105
52440,81267,19402,39080,16257,61864,15757,7651,8106
52445,81271,19402,39082,16257,61868,15757,7651,8106
52450,81281,19404,39088,16258,61876,15759,7653,8106
52455,81287,19406,39091,16260,61880,15761,7654,8107
52460,81298,19409,39094,16262,61887,15763,7654,8109
52465,81302,19410,39094,16263,61892,15763,7654,8109
52470,81312,19412,39097,16264,61899,15765,7654,8111
52475,81318,19412,39099,16264,61905,15767,7654,8113
52480,81329,19414,39104,16266,61914,15769,7655,8114
52485,81333,19414,39105,16266,61919,15769,7655,8114
52490,81343,19416,39111,16268,61927,15771,7657,8114
52495,81349,19416,39113,16268,61933,15773,7657,8116
52500,81360,19418,39121,16270,61940,15775,7658,8117
52505,81364,19420,39124,16272,61944,15775,7658,8117
52510,81374,19423,39127,16274,61950,15777,7658,8119
52515,81380,19423,39129,16274,61957,15779,7659,8120
52520,81391,19424,39137,16275,61964,15781,7661,8120
52525,81395,19425,39138,16276,61970,15781,7661,8120
52530,81405,19428,39144,16279,61977,15783,7662,8121
52535,81411,19428,39147,16279,61982,15785,7663,8122
52540,81422,19431,39154,16281,61989,15787,7664,8123
52545,81426,19433,39156,16283,61993,15787,7664,8123
52550,81436,19435,39161,16284,62000,15789,7665,8124
52555,81442,19435,39163,16284,62007,15791,7666,8125
52560,81453,19436,39167,16284,62016,15793,7667,8126
52565,81457,19436,39168,16284,62020,15793,7667,8126
52570,81467,19441,39175,16288,62025,15795,7668,8127
52575,81473,19441,39179,16288,62030,15797,7669,8128
52580,81484,19443,39182,16289,62040,15799,7671,8128
52585,81488,19444,39184,16290,62044,15799,7671,8128
52590,81498,19447,39187,16291,62050,15801,7671,8130
52595,81504,19447,39189,16291,62057,15803,7672,8131
52600,81515,19450,39194,16293,62063,15805,7673,8132
52605,81519,19451,39195,16294,62067,15805,7673,8132
52610,81529,19456,39200,16298,62072,15807,7674,8133
52615,81535,19457,39202,16299,62076,15809,7674,8135
52620,81546,19463,39210,16305,62080,15811,7675,8136
52625,81550,19467,39213,16309,62082,15811,7675,8136
52630,81560,19472,39218,16313,62087,15813,7675,8138
52635,81566,19474,39223,16315,62090,15815,7677,8138
52640,81577,19478,39229,16319,62098,15817,7679,8138
52645,81581,19479,39230,16320,62102,15817,7679,8138
52650,81591,19482,39238,16322,62107,15819,7681,8138
52655,81597,19485,39241,16325,62111,15821,7682,8139
52660,81608,19487,39247,16327,62118,15823,7684,8139
52665,81612,19490,39249,16330,62121,15823,7684,8139
52670,81622,19491,39254,16331,62129,15825,7685,8140
52675,81628,19493,39255,16333,62135,15827,7685,8142
52680,81639,19493,39261,16333,62144,15829,7686,8143
52685,81643,19493,39265,16333,62149,15829,7686,8143
52690,81653,19494,39268,16334,62159,15831,7687,8144
52695,81659,19494,39272,16334,62164,15833,7688,8145
52700,81670,19494,39275,16334,62175,15835,7688,8147
52705,81674,19494,39279,16334,62179,15835,7688,8147
52710,81684,19495,39285,16335,62189,15837,7689,8148
52715,81690,19495,39285,16335,62195,15839,7689,8150
52720,81701,19495,39292,16335,62205,15841,7690,8151
52725,81705,19495,39294,16335,62209,15841,7690,8151
52730,81715,19497,39300,16336,62218,15843,7691,8152
52735,81721,19497,39304,16336,62224,15845,7692,8153
52740,81732,19500,39312,16339,62232,15847,7693,8154
52745,81736,19501,39316,16340,62235,15847,7693,8154
52750,81746,19504,39322,16342,62242,15849,7694,8155
52755,81752,19504,39325,16342,62248,15851,7695,8156
52760,81763,19506,39332,16344,62257,15853,7696,8157
52765,81767,19506,39333,16344,62261,15853,7696,8157
52770,81777,19508,39336,16345,62269,15855,7696,8159
52775,81783,19508,39340,16345,62274,15857,7698,8159
52780,81794,19511,39342,16347,62283,15859,7698,8161
52785,81798,19512,39344,16348,62286,15859,7698,8161
52790,81808,19516,39350,16350,62291,15861,7700,8161
52795,81814,19518,39351,16352,62296,15863,7700,8163
52800,81825,19521,39358,16354,62303,15865,7701,8164
52805,81829,19522,39359,16355,62307,15865,7701,8164
52810,81839,19525,39364,16357,62313,15867,7702,8165
52815,81845,19526,39367,16358,62318,15869,7703,8166
52820,81856,19531,39374,16363,62324,15871,7703,8168
52825,81860,19532,39376,16364,62327,15871,7703,8168
52830,81870,19537,39382,16368,62331,15873,7704,8169
52835,81876,19540,39384,16371,62335,15875,7704,8171
52840,81887,19544,39387,16374,62343,15877,7705,8172
52845,81891,19544,39387,16374,62347,15877,7705,8172
52850,81901,19550,39394,16379,62349,15879,7705,8174
52855,81907,19552,39396,16381,62355,15881,7707,8174
52860,81918,19556,39402,16384,62360,15883,7708,8175
52865,81922,19560,39405,16388,62361,15883,7708,8175
52870,81932,19566,39411,16393,62365,15885,7709,8176
52875,81938,19568,39413,16395,62370,15887,7710,8177
52880,81949,19571,39420,16397,62375,15889,7712,8177
52885,81953,19576,39423,16402,62376,15889,7712,8177
52890,81963,19581,39430,16406,62381,15891,7714,8177
52895,81969,19582,39432,16407,62385,15893,7714,8179
52900,81980,19584,39435,16408,62395,15895,7716,8179
52905,81984,19584,39436,16408,62399,15895,7716,8179
52910,81994,19586,39443,16409,62406,15897,7718,8179
52915,82000,19588,39444,16411,62412,15899,7719,8180
52920,82011,19590,39449,16412,62419,15901,7720,8181
52925,82015,19591,39451,16413,62424,15901,7720,8181
52930,82025,19593,39456,16415,62431,15903,7720,8183
52935,82031,19595,39460,16417,62435,15905,7720,8185
52940,82042,19598,39465,16420,62443,15907,7721,8186
52945,82046,19598,39467,16420,62447,15907,7721,8186
52950,82056,19600,39473,16422,62455,15909,7723,8186
52955,82062,19602,39478,16424,62459,15911,7725,8186
52960,82073,19603,39483,16424,62469,15913,7725,8188
52965,82077,19604,39486,16425,62472,15913,7725,8188
52970,82087,19606,39492,16427,62480,15915,7727,8188
52975,82093,19606,39498,16427,62486,15917,7729,8188
52980,82104,19607,39499,16427,62496,15919,7729,8190
52985,82108,19607,39503,16427,62500,15919,7729,8190
52990,82118,19607,39508,16427,62511,15921,7731,8190
52995,82124,19607,39513,16427,62517,15923,7733,8190
53000,82135,19607,39518,16427,62525,15925,7734,8191
53005,82139,19608,39519,16428,62531,15925,7734,8191
53010,82149,19609,39522,16428,62540,15927,7736,8191
53015,82155,19609,39528,16428,62544,15929,7738,8191
53020,82166,19611,39535,16430,62553,15931,7739,8192
53025,82170,19611,39536,16430,62559,15931,7739,8192
53030,82180,19612,39541,16430,62568,15933,7740,8193
53035,82186,19612,39543,16430,62574,15935,7741,8194
53040,82197,19613,39547,16431,62582,15937,7742,8195
53045,82201,19614,39550,16432,62586,15937,7742,8195
53050,82211,19616,39554,16433,62594,15939,7743,8196
53055,82217,19616,39557,16433,62600,15941,7745,8196
53060,82228,19618,39561,16435,62609,15943,7745,8198
53065,82232,19619,39563,16436,62612,15943,7745,8198
53070,82242,19622,39569,16438,62619,15945,7747,8198
53075,82248,19623,39570,16439,62625,15947,7748,8199
53080,82259,19624,39578,16440,62632,15949,7750,8199
53085,82263,19626,39580,16442,62637,15949,7750,8199
53090,82273,19628,39584,16444,62644,15951,7750,8201
53095,82279,19630,39587,16446,62648,15953,7751,8202
53100,82290,19636,39595,16451,62652,15955,7753,8202
53105,82294,19639,39597,16454,62654,15955,7753,8202
53110,82304,19645,39604,16460,62659,15957,7754,8203
53115,82310,19645,39609,16460,62663,15959,7755,8204
53120,82321,19650,39615,16464,62668,15961,7755,8206
53125,82325,19654,39618,16468,62670,15961,7755,8206
53130,82335,19655,39621,16468,62680,15963,7756,8207
53135,82341,19655,39625,16468,62685,15965,7757,8208
53140,82352,19656,39629,16469,62696,15967,7758,8209
53145,82356,19657,39631,16470,62698,15967,7758,8209
53150,82366,19659,39636,16472,62707,15969,7759,8210
53155,82372,19659,39639,16472,62713,15971,7760,8211
53160,82383,19662,39645,16474,62720,15973,7761,8212
53165,82387,19662,39646,16474,62725,15973,7761,8212
53170,82397,19665,39652,16477,62732,15975,7762,8213
53175,82403,19665,39653,16477,62738,15977,7763,8214
53180,82414,19667,39660,16479,62747,15979,7764,8215
53185,82418,19667,39661,16479,62751,15979,7764,8215
53190,82428,19669,39664,16481,62759,15981,7765,8216
53195,82434,19669,39665,16481,62765,15983,7766,8217
53200,82445,19671,39672,16482,62774,15985,7767,8218
53205,82449,19672,39675,16483,62777,15985,7767,8218
53210,82459,19674,39681,16485,62785,15987,7769,8218
53215,82465,19675,39686,16486,62789,15989,7771,8218
53220,82476,19677,39691,16487,62798,15991,7771,8220
53225,82480,19678,39693,16488,62802,15991,7771,8220
53230,82490,19681,39699,16491,62808,15993,7771,8222
53235,82496,19682,39700,16492,62814,15995,7772,8223
53240,82507,19685,39705,16494,62822,15997,7773,8224
53245,82511,19685,39707,16494,62826,15997,7773,8224
53250,82521,19688,39713,16496,62832,15999,7775,8224
53255,82527,19689,39715,16497,62837,16001,7776,8225
53260,82538,19693,39719,16500,62845,16003,7777,8226
53265,82542,19693,39719,16500,62849,16003,7777,8226
53270,82552,19697,39726,16504,62854,16005,7777,8228
53275,82558,19699,39729,16506,62857,16007,7777,8230
53280,82569,19705,39736,16512,62862,16009,7777,8232
53285,82573,19706,39738,16513,62866,16009,7777,8232
53290,82583,19709,39743,16516,62873,16011,7778,8233
53295,82589,19710,39747,16517,62877,16013,7779,8234
53300,82600,19714,39750,16521,62885,16015,7779,8236
53305,82604,19715,39753,16522,62888,16015,7779,8236
53310,82614,19717,39755,16522,62895,16017,7779,8238
53315,82620,19719,39759,16524,62899,16019,7780,8239
53320,82631,19724,39763,16528,62906,16021,7781,8240
53325,82635,19725,39765,16529,62909,16021,7781,8240
53330,82645,19728,39770,16531,62917,16023,7783,8240
53335,82651,19728,39773,16531,62921,16025,7784,8241
53340,82662,19733,39778,16536,62927,16027,7784,8243
53345,82666,19737,39782,16540,62927,16027,7784,8243
53350,82676,19743,39788,16546,62932,16029,7785,8244
53355,82682,19744,39790,16547,62937,16031,7786,8245
53360,82693,19749,39797,16551,62941,16033,7787,8246
53365,82697,19752,39797,16554,62945,16033,7787,8246
53370,82707,19754,39802,16555,62952,16035,7789,8246
53375,82713,19756,39805,16557,62955,16037,7789,8248
53380,82724,19758,39810,16558,62964,16039,7791,8248
53385,82728,19759,39812,16559,62968,16039,7791,8248
53390,82738,19762,39818,16562,62975,16041,7791,8250
53395,82744,19763,39820,16563,62979,16043,7791,8252
53400,82755,19766,39822,16565,62989,16045,7792,8253
53405,82759,19767,39825,16566,62991,16045,7792,8253
53410,82769,19768,39830,16567,63000,16047,7793,8254
53415,82775,19768,39833,16567,63007,16049,7795,8254
53420,82786,19770,39840,16568,63014,16051,7797,8254
53425,82790,19771,39843,16569,63018,16051,7797,8254
53430,82800,19772,39845,16570,63028,16053,7797,8256
53435,82806,19772,39849,16570,63033,16055,7799,8256
53440,82817,19773,39854,16570,63043,16057,7799,8258
53445,82821,19774,39858,16571,63046,16057,7799,8258
53450,82831,19776,39864,16573,63055,16059,7799,8260
53455,82837,19776,39867,16573,63060,16061,7800,8261
53460,82848,19777,39871,16574,63071,16063,7801,8262
53465,82852,19778,39873,16575,63074,16063,7801,8262
53470,82862,19778,39878,16575,63084,16065,7801,8264
53475,82868,19778,39883,16575,63088,16067,7803,8264
53480,82879,19779,39888,16576,63098,16069,7804,8265
53485,82883,19779,39891,16576,63104,16069,7804,8265
53490,82893,19780,39897,16577,63112,16071,7804,8267
53495,82899,19780,39900,16577,63118,16073,7805,8268
53500,82910,19780,39905,16577,63129,16075,7806,8269
53505,82914,19780,39905,16577,63134,16075,7806,8269
53510,82924,19782,39912,16578,63142,16077,7806,8271
53515,82930,19782,39914,16578,63148,16079,7807,8272
53520,82941,19783,39918,16579,63155,16081,7807,8274
53525,82945,19785,39921,16581,63159,16081,7807,8274
53530,82955,19788,39927,16583,63167,16083,7808,8275
53535,82961,19788,39931,16583,63172,16085,7809,8276
53540,82972,19790,39936,16585,63181,16087,7810,8277
53545,82976,19791,39937,16586,63185,16087,7810,8277
53550,82986,19793,39944,16587,63193,16089,7811,8278
53555,82992,19793,39945,16587,63199,16091,7811,8280
53560,83003,19795,39949,16589,63207,16093,7811,8282
53565,83007,19796,39953,16590,63209,16093,7811,8282
53570,83017,19800,39956,16593,63217,16095,7811,8284
53575,83023,19800,39958,16593,63223,16097,7812,8285
53580,83034,19803,39965,16595,63229,16099,7814,8285
53585,83038,19807,39968,16599,63230,16099,7814,8285
53590,83048,19810,39970,16600,63238,16101,7815,8286
53595,83054,19810,39974,16600,63243,16103,7817,8286
53600,83065,19816,39982,16605,63248,16105,7818,8287
53605,83069,19818,39984,16607,63251,16105,7818,8287
53610,83079,19821,39988,16610,63258,16107,7818,8289
53615,83085,19822,39992,16611,63262,16109,7819,8290
53620,83096,19827,39998,16615,63267,16111,7819,8292
53625,83100,19829,40000,16617,63270,16111,7819,8292
53630,83110,19834,40007,16622,63274,16113,7820,8293
53635,83116,19836,40010,16624,63279,16115,7821,8294
53640,83127,19839,40015,16626,63287,16117,7822,8295
53645,83131,19840,40016,16627,63291,16117,7822,8295
53650,83141,19842,40018,16628,63299,16119,7823,8296
53655,83147,19842,40019,16628,63305,16121,7823,8298
53660,83158,19843,40022,16628,63315,16123,7825,8298
53665,83162,19844,40024,16629,63318,16123,7825,8298
53670,83172,19845,40028,16630,63326,16125,7826,8299
53675,83178,19847,40032,16632,63330,16127,7827,8300
53680,83189,19850,40038,16635,63339,16129,7828,8301
53685,83193,19851,40041,16636,63342,16129,7828,8301
53690,83203,19853,40047,16638,63348,16131,7828,8303
53695,83209,19855,40050,16640,63352,16133,7829,8304
53700,83220,19858,40055,16642,63362,16135,7830,8305
53705,83224,19859,40058,16643,63364,16135,7830,8305
53710,83234,19860,40063,16644,63374,16137,7832,8305
53715,83240,19860,40065,16644,63378,16139,7832,8307
53720,83251,19862,40072,16646,63389,16141,7833,8308
53725,83255,19862,40073,16646,63392,16141,7833,8308
53730,83265,19864,40079,16648,63401,16143,7834,8309
53735,83271,19864,40082,16648,63407,16145,7836,8309
53740,83282,19867,40087,16651,63414,16147,7836,8311
53745,83286,19868,40088,16652,63417,16147,7836,8311
53750,83296,19873,40092,16655,63423,16149,7836,8313
53755,83302,19873,40097,16655,63427,16151,7837,8314
53760,83313,19876,40104,16658,63434,16153,7837,8316
53765,83317,19878,40107,16660,63439,16153,7837,8316
53770,83327,19880,40109,16661,63447,16155,7837,8318
53775,83333,19880,40112,16661,63452,16157,7839,8318
53780,83344,19884,40117,16664,63459,16159,7840,8319
53785,83348,19885,40119,16665,63463,16159,7840,8319
53790,83358,19888,40125,16668,63470,16161,7842,8319
53795,83364,19888,40129,16668,63475,16163,7844,8319
53800,83375,19889,40131,16669,63486,16165,7845,8320
53805,83379,19890,40134,16670,63488,16165,7845,8320
53810,83389,19893,40139,16672,63494,16167,7846,8321
53815,83395,19896,40142,16675,63499,16169,7847,8322
53820,83406,19899,40148,16678,63506,16171,7848,8323
53825,83410,19901,40151,16680,63508,16171,7848,8323
53830,83420,19903,40154,16681,63517,16173,7850,8323
53835,83426,19903,40157,16681,63522,16175,7852,8323
53840,83437,19905,40162,16683,63529,16177,7853,8324
53845,83441,19906,40165,16684,63534,16177,7853,8324
53850,83451,19908,40168,16685,63543,16179,7854,8325
53855,83457,19908,40171,16685,63547,16181,7855,8326
53860,83468,19912,40174,16689,63555,16183,7855,8328
53865,83472,19914,40176,16691,63557,16183,7855,8328
53870,83482,19919,40181,16695,63563,16185,7857,8328
53875,83488,19919,40184,16695,63568,16187,7859,8328
53880,83499,19923,40187,16698,63576,16189,7860,8329
53885,83503,19924,40188,16699,63579,16189,7860,8329
53890,83513,19927,40193,16701,63585,16191,7862,8329
53895,83519,19928,40196,16702,63589,16193,7863,8330
53900,83530,19933,40203,16706,63593,16195,7864,8331
53905,83534,19938,40204,16711,63596,16195,7864,8331
53910,83544,19943,40211,16715,63599,16197,7865,8332
53915,83550,19946,40213,16718,63603,16199,7865,8334
53920,83561,19950,40220,16722,63609,16201,7865,8336
53925,83565,19952,40223,16724,63612,16201,7865,8336
53930,83575,19953,40227,16725,63620,16203,7865,8338
53935,83581,19955,40228,16727,63625,16205,7865,8340
53940,83592,19958,40232,16730,63634,16207,7866,8341
53945,83596,19959,40234,16731,63637,16207,7866,8341
53950,83606,19961,40240,16732,63645,16209,7868,8341
53955,83612,19961,40243,16732,63651,16211,7870,8341
53960,83623,19964,40249,16735,63659,16213,7871,8342
53965,83627,19964,40252,16735,63662,16213,7871,8342
53970,83637,19966,40258,16736,63671,16215,7872,8343
53975,83643,19966,40260,16736,63677,16217,7874,8343
53980,83654,19968,40264,16738,63686,16219,7874,8345
53985,83658,19968,40266,16738,63689,16219,7874,8345
53990,83668,19970,40271,16740,63698,16221,7876,8345
53995,83674,19970,40275,16740,63703,16223,7878,8345
54000,83685,19973,40282,16742,63710,16225,7879,8346
54005,83689,19974,40283,16743,63715,16225,7879,8346
54010,83699,19975,40288,16744,63724,16227,7880,8347
54015,83705,19975,40292,16744,63730,16229,7882,8347
54020,83716,19977,40298,16745,63737,16231,7882,8349
54025,83720,19977,40301,16745,63742,16231,7882,8349
54030,83730,19981,40305,16747,63749,16233,7883,8350
54035,83736,19981,40309,16747,63754,16235,7884,8351
54040,83747,19983,40311,16748,63764,16237,7884,8353
54045,83751,19984,40314,16749,63766,16237,7884,8353
54050,83761,19987,40317,16750,63773,16239,7884,8355
54055,83767,19988,40319,16751,63778,16241,7884,8357
54060,83778,19990,40321,16752,63787,16243,7884,8359
54065,83782,19990,40325,16752,63791,16243,7884,8359
54070,83792,19992,40327,16752,63799,16245,7884,8361
54075,83798,19993,40329,16753,63805,16247,7885,8362
54080,83809,19994,40333,16754,63813,16249,7886,8363
54085,83813,19996,40334,16756,63817,16249,7886,8363
54090,83823,19998,40341,16758,63823,16251,7888,8363
54095,83829,20000,40343,16760,63828,16253,7888,8365
54100,83840,20002,40347,16762,63838,16255,7889,8366
54105,83844,20003,40349,16763,63841,16255,7889,8366
54110,83854,20005,40353,16764,63847,16257,7890,8367
54115,83860,20007,40354,16766,63853,16259,7891,8368
54120,83871,20008,40359,16767,63861,16261,7892,8369
54125,83875,20010,40362,16769,63864,16261,7892,8369
54130,83885,20013,40368,16771,63871,16263,7894,8369
54135,83891,20015,40373,16773,63874,16265,7895,8370
54140,83902,20017,40376,16775,63883,16267,7895,8372
54145,83906,20018,40377,16776,63888,16267,7895,8372
54150,83916,20020,40383,16777,63894,16269,7896,8373
54155,83922,20022,40386,16779,63899,16271,7897,8374
54160,83933,20023,40389,16780,63909,16273,7898,8375
54165,83937,20024,40391,16781,63912,16273,7898,8375
54170,83947,20026,40395,16782,63920,16275,7899,8376
54175,83953,20026,40400,16782,63926,16277,7901,8376
54180,83964,20031,40408,16787,63931,16279,7902,8377
54185,83968,20034,40410,16790,63933,16279,7902,8377
54190,83978,20037,40413,16793,63941,16281,7903,8378
54195,83984,20037,40416,16793,63947,16283,7905,8378
54200,83995,20040,40424,16796,63953,16285,7906,8379
54205,83999,20043,40426,16799,63955,16285,7906,8379
54210,84009,20046,40430,16801,63962,16287,7907,8380
54215,84015,20046,40433,16801,63966,16289,7907,8382
54220,84026,20050,40440,16805,63974,16291,7909,8382
54225,84030,20052,40441,16807,63977,16291,7909,8382
54230,84040,20058,40448,16812,63982,16293,7910,8383
54235,84046,20058,40449,16812,63988,16295,7910,8385
54240,84057,20059,40453,16812,63997,16297,7911,8386
54245,84061,20059,40453,16812,64002,16297,7911,8386
54250,84071,20061,40460,16814,64010,16299,7911,8388
54255,84077,20061,40463,16814,64016,16301,7912,8389
54260,84088,20062,40470,16815,64026,16303,7913,8390
54265,84092,20062,40473,16815,64030,16303,7913,8390
54270,84102,20064,40477,16817,64038,16305,7914,8391
54275,84108,20064,40478,16817,64044,16307,7915,8392
54280,84119,20066,40482,16818,64053,16309,7916,8393
54285,84123,20066,40484,16818,64057,16309,7916,8393
54290,84133,20067,40490,16819,64066,16311,7917,8394
54295,84139,20067,40493,16819,64072,16313,7918,8395
54300,84150,20068,40495,16819,64082,16315,7919,8396
54305,84154,20069,40498,16820,64085,16315,7919,8396
54310,84164,20072,40504,16822,64092,16317,7921,8396
54315,84170,20072,40509,16822,64098,16319,7923,8396
54320,84181,20074,40516,16823,64107,16321,7925,8396
54325,84185,20074,40518,16823,64111,16321,7925,8396
54330,84195,20076,40525,16824,64119,16323,7927,8396
54335,84201,20076,40527,16824,64124,16325,7927,8398
54340,84212,20080,40533,16827,64131,16327,7928,8399
54345,84216,20083,40537,16830,64132,16327,7928,8399
54350,84226,20086,40540,16833,64140,16329,7929,8400
54355,84232,20086,40542,16833,64144,16331,7929,8402
54360,84243,20089,40545,16835,64153,16333,7931,8402
54365,84247,20090,40547,16836,64155,16333,7931,8402
54370,84257,20097,40554,16842,64158,16335,7932,8403
54375,84263,20100,40558,16845,64161,16337,7933,8404
54380,84274,20105,40563,16849,64167,16339,7934,8405
54385,84278,20107,40564,16851,64170,16339,7934,8405
54390,84288,20112,40571,16854,64174,16341,7936,8405
54395,84294,20115,40575,16857,64177,16343,7936,8407
54400,84305,20120,40581,16862,64183,16345,7937,8408
54405,84309,20121,40583,16863,64188,16345,7937,8408
54410,84319,20124,40587,16866,64195,16347,7937,8410
54415,84325,20125,40591,16867,64199,16349,7938,8411
54420,84336,20127,40594,16869,64208,16351,7939,8412
54425,84340,20129,40596,16871,64210,16351,7939,8412
54430,84350,20133,40601,16874,64217,16353,7939,8414
54435,84356,20134,40604,16875,64220,16355,7939,8416
54440,84367,20138,40608,16878,64226,16357,7939,8418
54445,84371,20140,40609,16880,64230,16357,7939,8418
54450,84381,20142,40614,16881,64237,16359,7940,8419
54455,84387,20144,40616,16883,64243,16361,7941,8420
54460,84398,20146,40621,16884,64250,16363,7942,8421
54465,84402,20147,40621,16885,64255,16363,7942,8421
54470,84412,20150,40627,16888,64261,16365,7944,8421
54475,84418,20152,40631,16890,64265,16367,7945,8422
54480,84429,20157,40638,16895,64270,16369,7946,8423
54485,84433,20157,40640,16895,64275,16369,7946,8423
54490,84443,20159,40643,16896,64283,16371,7946,8425
54495,84449,20160,40646,16897,64287,16373,7947,8426
54500,84460,20164,40653,16900,64292,16375,7949,8426
54505,84464,20167,40657,16903,64297,16375,7949,8426
54510,84474,20170,40664,16906,64302,16377,7949,8428
54515,84480,20173,40667,16909,64307,16379,7950,8429
54520,84491,20174,40671,16909,64316,16381,7952,8429
54525,84495,20175,40672,16910,64320,16381,7952,8429
54530,84505,20177,40677,16912,64327,16383,7953,8430
54535,84511,20179,40678,16914,64332,16385,7953,8432
54540,84522,20180,40684,16914,64341,16387,7954,8433
54545,84526,20180,40684,16914,64346,16387,7954,8433
54550,84536,20180,40686,16914,64356,16389,7954,8435
54555,84542,20180,40690,16914,64361,16391,7955,8436
54560,84553,20182,40696,16916,64370,16393,7955,8438
54565,84557,20183,40698,16917,64374,16393,7955,8438
54570,84567,20183,40701,16917,64383,16395,7956,8439
54575,84573,20183,40706,16917,64389,16397,7957,8440
54580,84584,20185,40712,16919,64399,16399,7958,8441
54585,84588,20185,40713,16919,64403,16399,7958,8441
54590,84598,20186,40720,16920,64411,16401,7959,8442
54595,84604,20186,40722,16920,64417,16403,7960,8443
54600,84615,20187,40728,16920,64426,16405,7961,8444
54605,84619,20188,40731,16921,64429,16405,7961,8444
54610,84629,20195,40737,16928,64434,16407,7962,8445
54615,84635,20195,40739,16928,64439,16409,7963,8446
54620,84646,20199,40742,16931,64447,16411,7964,8447
54625,84650,20199,40743,16931,64451,16411,7964,8447
54630,84660,20202,40746,16933,64458,16413,7964,8449
54635,84666,20202,40749,16933,64464,16415,7966,8449
54640,84677,20205,40754,16935,64472,16417,7967,8450
54645,84681,20207,40757,16937,64473,16417,7967,8450
54650,84691,20211,40762,16940,64480,16419,7968,8451
54655,84697,20211,40767,16940,64485,16421,7970,8451
54660,84708,20216,40777,16945,64491,16423,7972,8451
54665,84712,20218,40778,16947,64494,16423,7972,8451
54670,84722,20222,40785,16950,64500,16425,7973,8452
54675,84728,20222,40787,16950,64506,16427,7973,8454
54680,84739,20224,40791,16951,64514,16429,7973,8456
54685,84743,20227,40794,16954,64515,16429,7973,8456
54690,84753,20231,40800,16958,64522,16431,7973,8458
54695,84759,20231,40803,16958,64528,16433,7974,8459
54700,84770,20233,40808,16960,64537,16435,7974,8461
54705,84774,20234,40811,16961,64539,16435,7974,8461
54710,84784,20238,40818,16965,64545,16437,7975,8462
54715,84790,20239,40820,16966,64549,16439,7975,8464
54720,84801,20243,40828,16970,64556,16441,7976,8465
54725,84805,20244,40829,16971,64561,16441,7976,8465
54730,84815,20245,40834,16972,64570,16443,7977,8466
54735,84821,20246,40836,16973,64575,16445,7977,8468
54740,84832,20247,40842,16974,64585,16447,7979,8468
54745,84836,20247,40844,16974,64589,16447,7979,8468
54750,84846,20248,40848,16975,64597,16449,7980,8469
54755,84852,20250,40850,16977,64601,16451,7980,8471
54760,84863,20251,40854,16978,64610,16453,7980,8473
54765,84867,20251,40855,16978,64616,16453,7980,8473
54770,84877,20252,40857,16978,64624,16455,7980,8475
54775,84883,20253,40859,16979,64629,16457,7981,8476
54780,84894,20254,40864,16980,64639,16459,7981,8478
54785,84898,20254,40866,16980,64644,16459,7981,8478
54790,84908,20255,40869,16980,64651,16461,7981,8480
54795,84914,20257,40872,16982,64657,16463,7983,8480
54800,84925,20258,40877,16982,64666,16465,7984,8481
54805,84929,20258,40878,16982,64671,16465,7984,8481
54810,84939,20260,40882,16983,64678,16467,7984,8483
54815,84945,20261,40885,16984,64683,16469,7985,8484
54820,84956,20264,40889,16986,64691,16471,7986,8485
54825,84960,20266,40890,16988,64694,16471,7986,8485
54830,84970,20269,40894,16989,64700,16473,7988,8485
54835,84976,20271,40896,16991,64704,16475,7988,8487
54840,84987,20275,40902,16994,64710,16477,7990,8487
54845,84991,20277,40903,16996,64713,16477,7990,8487
54850,85001,20280,40906,16997,64721,16479,7991,8488
54855,85007,20281,40910,16998,64725,16481,7993,8488
54860,85018,20283,40915,16999,64732,16483,7994,8489
54865,85022,20286,40918,17002,64735,16483,7994,8489
54870,85032,20289,40923,17004,64742,16485,7995,8490
54875,85038,20290,40925,17005,64746,16487,7995,8492
54880,85049,20294,40931,17009,64754,16489,7997,8492
54885,85053,20295,40933,17010,64757,16489,7997,8492
54890,85063,20297,40937,17010,64765,16491,7999,8492
54895,85069,20299,40941,17012,64768,16493,7999,8494
54900,85080,20305,40950,17018,64773,16495,8001,8494
54905,85084,20308,40953,17021,64775,16495,8001,8494
54910,85094,20310,40958,17022,64784,16497,8002,8495
54915,85100,20310,40960,17022,64790,16499,8003,8496
54920,85111,20311,40964,17022,64799,16501,8005,8496
54925,85115,20311,40966,17022,64803,16501,8005,8496
54930,85125,20312,40968,17023,64813,16503,8005,8498
54935,85131,20312,40971,17023,64818,16505,8006,8499
54940,85142,20313,40977,17024,64827,16507,8007,8500
54945,85146,20315,40979,17026,64830,16507,8007,8500
54950,85156,20320,40982,17030,64836,16509,8007,8502
54955,85162,20320,40984,17030,64841,16511,8008,8503
54960,85173,20324,40991,17034,64847,16513,8009,8504
54965,85177,20328,40994,17038,64848,16513,8009,8504
54970,85187,20332,40999,17042,64855,16515,8009,8506
54975,85193,20332,41002,17042,64859,16517,8010,8507
54980,85204,20336,41008,17045,64868,16519,8011,8508
54985,85208,20336,41009,17045,64871,16519,8011,8508
54990,85218,20336,41015,17045,64881,16521,8012,8509
54995,85224,20336,41019,17045,64888,16523,8014,8509
55000,85235,20338,41027,17046,64896,16525,8015,8510
55005,85239,20339,41029,17047,64900,16525,8015,8510
55010,85249,20341,41035,17048,64907,16527,8016,8511
55015,85255,20343,41037,17050,64911,16529,8016,8513
55020,85266,20346,41043,17053,64918,16531,8016,8515
55025,85270,20348,41045,17055,64922,16531,8016,8515
55030,85280,20349,41047,17055,64931,16533,8016,8517
55035,85286,20349,41049,17055,64937,16535,8017,8518
55040,85297,20350,41056,17056,64945,16537,8019,8518
55045,85301,20350,41057,17056,64951,16537,8019,8518
55050,85311,20353,41063,17058,64958,16539,8021,8518
55055,85317,20353,41066,17058,64963,16541,8022,8519
55060,85328,20355,41075,17060,64971,16543,8024,8519
55065,85332,20356,41077,17061,64976,16543,8024,8519
55070,85342,20358,41083,17063,64983,16545,8026,8519
55075,85348,20358,41087,17063,64989,16547,8028,8519
55080,85359,20359,41094,17063,64998,16549,8030,8519
55085,85363,20360,41097,17064,65003,16549,8030,8519
55090,85373,20363,41101,17065,65009,16551,8031,8520
55095,85379,20363,41106,17065,65014,16553,8032,8521
55100,85390,20365,41111,17067,65023,16555,8033,8522
55105,85394,20366,41112,17068,65028,16555,8033,8522
55110,85404,20368,41119,17069,65036,16557,8035,8522
55115,85410,20368,41119,17069,65042,16559,8035,8524
55120,85421,20369,41124,17069,65050,16561,8036,8525
55125,85425,20370,41125,17070,65055,16561,8036,8525
55130,85435,20372,41128,17071,65063,16563,8037,8526
55135,85441,20372,41131,17071,65068,16565,8039,8526
55140,85452,20375,41135,17073,65076,16567,8041,8526
55145,85456,20377,41138,17075,65078,16567,8041,8526
55150,85466,20381,41142,17078,65085,16569,8042,8527
55155,85472,20381,41144,17078,65091,16571,8043,8528
55160,85483,20384,41149,17081,65099,16573,8044,8529
55165,85487,20385,41152,17082,65101,16573,8044,8529
55170,85497,20388,41155,17084,65109,16575,8045,8530
55175,85503,20388,41159,17084,65114,16577,8046,8531
55180,85514,20391,41162,17086,65121,16579,8046,8533
55185,85518,20393,41164,17088,65124,16579,8046,8533
55190,85528,20398,41167,17091,65130,16581,8047,8534
55195,85534,20398,41169,17091,65136,16583,8048,8535
55200,85545,20402,41173,17094,65142,16585,8048,8537
55205,85549,20404,41174,17096,65145,16585,8048,8537
55210,85559,20407,41178,17098,65151,16587,8049,8538
55215,85565,20408,41181,17099,65156,16589,8051,8538
55220,85576,20410,41182,17100,65166,16591,8052,8539
55225,85580,20412,41185,17102,65167,16591,8052,8539
55230,85590,20416,41189,17105,65173,16593,8053,8540
55235,85596,20418,41192,17107,65177,16595,8054,8541
55240,85607,20421,41195,17110,65185,16597,8054,8543
55245,85611,20423,41196,17112,65188,16597,8054,8543
55250,85621,20425,41199,17113,65195,16599,8055,8544
55255,85627,20426,41202,17114,65200,16601,8057,8544
55260,85638,20432,41207,17119,65206,16603,8058,8545
55265,85642,20433,41209,17120,65208,16603,8058,8545
55270,85652,20439,41213,17124,65213,16605,8059,8546
55275,85658,20440,41217,17125,65215,16607,8059,8548
55280,85669,20445,41223,17129,65220,16609,8060,8549
55285,85673,20449,41226,17133,65224,16609,8060,8549
55290,85683,20451,41231,17134,65231,16611,8061,8550
55295,85689,20453,41235,17136,65235,16613,8063,8550
55300,85700,20456,41240,17139,65243,16615,8063,8552
55305,85704,20456,41242,17139,65247,16615,8063,8552
55310,85714,20459,41247,17142,65254,16617,8063,8554
55315,85720,20460,41248,17143,65259,16619,8063,8556
55320,85731,20463,41253,17145,65267,16621,8065,8556
55325,85735,20464,41254,17146,65271,16621,8065,8556
55330,85745,20466,41262,17147,65277,16623,8067,8556
55335,85751,20468,41265,17149,65282,16625,8068,8557
55340,85762,20469,41268,17149,65292,16627,8069,8558
55345,85766,20469,41268,17149,65297,16627,8069,8558
55350,85776,20472,41275,17151,65302,16629,8071,8558
55355,85782,20475,41279,17154,65306,16631,8072,8559
55360,85793,20477,41284,17155,65315,16633,8073,8560
55365,85797,20478,41285,17156,65319,16633,8073,8560
55370,85807,20479,41289,17157,65327,16635,8074,8561
55375,85813,20480,41293,17158,65332,16637,8076,8561
55380,85824,20481,41297,17159,65342,16639,8076,8563
55385,85828,20481,41299,17159,65347,16639,8076,8563
55390,85838,20483,41302,17159,65353,16641,8077,8564
55395,85844,20485,41304,17161,65359,16643,8078,8565
55400,85855,20488,41309,17164,65366,16645,8078,8567
55405,85859,20490,41311,17166,65368,16645,8078,8567
55410,85869,20492,41314,17166,65377,16647,8080,8567
55415,85875,20493,41317,17167,65382,16649,8081,8568
55420,85886,20495,41321,17168,65390,16651,8083,8568
55425,85890,20496,41325,17169,65393,16651,8083,8568
55430,85900,20498,41327,17170,65402,16653,8083,8570
55435,85906,20499,41330,17171,65406,16655,8083,8572
55440,85917,20504,41333,17175,65413,16657,8083,8574
55445,85921,20505,41335,17176,65416,16657,8083,8574
55450,85931,20508,41339,17179,65423,16659,8083,8576
55455,85937,20508,41342,17179,65428,16661,8083,8578
55460,85948,20511,41350,17182,65435,16663,8084,8579
55465,85952,20512,41350,17183,65440,16663,8084,8579
55470,85962,20514,41354,17184,65447,16665,8085,8580
55475,85968,20514,41357,17184,65453,16667,8086,8581
55480,85979,20517,41360,17186,65461,16669,8087,8582
55485,85983,20517,41362,17186,65465,16669,8087,8582
55490,85993,20521,41366,17189,65471,16671,8088,8583
55495,85999,20521,41370,17189,65476,16673,8089,8584
55500,86010,20526,41377,17194,65483,16675,8090,8585
55505,86014,20528,41379,17196,65485,16675,8090,8585
55510,86024,20532,41383,17198,65492,16677,8092,8585
55515,86030,20532,41388,17198,65495,16679,8094,8585
55520,86041,20536,41392,17201,65504,16681,8094,8587
55525,86045,20539,41395,17204,65505,16681,8094,8587
55530,86055,20544,41400,17207,65511,16683,8095,8588
55535,86061,20544,41405,17207,65515,16685,8097,8588
55540,86072,20549,41412,17211,65522,16687,8099,8588
55545,86076,20552,41415,17214,65524,16687,8099,8588
55550,86086,20554,41419,17216,65532,16689,8099,8590
55555,86092,20554,41422,17216,65538,16691,8100,8591
55560,86103,20557,41429,17218,65544,16693,8101,8592
55565,86107,20557,41431,17218,65550,16693,8101,8592
55570,86117,20558,41435,17218,65559,16695,8102,8593
55575,86123,20558,41439,17218,65565,16697,8102,8595
55580,86134,20558,41443,17218,65574,16699,8102,8597
55585,86138,20558,41444,17218,65580,16699,8102,8597
55590,86148,20559,41448,17218,65589,16701,8103,8598
55595,86154,20559,41450,17218,65595,16703,8104,8599
55600,86165,20559,41452,17218,65606,16705,8106,8599
55605,86169,20559,41453,17218,65610,16705,8106,8599
55610,86179,20560,41457,17218,65619,16707,8106,8601
55615,86185,20560,41460,17218,65625,16709,8107,8602
55620,86196,20560,41466,17218,65636,16711,8108,8603
55625,86200,20560,41467,17218,65640,16711,8108,8603
55630,86210,20561,41470,17219,65649,16713,8108,8605
55635,86216,20562,41475,17220,65654,16715,8110,8605
55640,86227,20563,41484,17221,65663,16717,8110,8607
55645,86231,20564,41488,17222,65667,16717,8110,8607
55650,86241,20566,41493,17223,65673,16719,8111,8608
55655,86247,20568,41495,17225,65678,16721,8111,8610
55660,86258,20570,41501,17227,65686,16723,8111,8612
55665,86262,20572,41503,17229,65690,16723,8111,8612
55670,86272,20574,41507,17230,65697,16725,8112,8613
55675,86278,20576,41510,17232,65701,16727,8113,8614
55680,86289,20580,41514,17235,65708,16729,8114,8615
55685,86293,20583,41518,17238,65709,16729,8114,8615
55690,86303,20588,41523,17241,65715,16731,8116,8615
55695,86309,20589,41527,17242,65718,16733,8117,8616
55700,86320,20594,41532,17246,65724,16735,8118,8617
55705,86324,20597,41534,17249,65726,16735,8118,8617
55710,86334,20601,41537,17251,65732,16737,8119,8618
55715,86340,20603,41543,17253,65734,16739,8121,8618
55720,86351,20609,41548,17258,65740,16741,8122,8619
55725,86355,20611,41548,17260,65744,16741,8122,8619
55730,86365,20616,41555,17265,65748,16743,8123,8620
55735,86371,20618,41558,17267,65753,16745,8125,8620
55740,86382,20620,41562,17269,65761,16747,8126,8621
55745,86386,20621,41563,17270,65764,16747,8126,8621
55750,86396,20625,41569,17274,65770,16749,8127,8622
55755,86402,20625,41572,17274,65776,16751,8128,8623
55760,86413,20629,41577,17277,65783,16753,8129,8624
55765,86417,20631,41580,17279,65785,16753,8129,8624
55770,86427,20633,41585,17281,65794,16755,8129,8626
55775,86433,20633,41589,17281,65799,16757,8131,8626
55780,86444,20635,41595,17282,65807,16759,8132,8627
55785,86448,20635,41596,17282,65813,16759,8132,8627
55790,86458,20636,41599,17283,65822,16761,8133,8628
55795,86464,20636,41600,17283,65827,16763,8133,8630
55800,86475,20638,41604,17284,65837,16765,8134,8631
55805,86479,20639,41606,17285,65840,16765,8134,8631
55810,86489,20639,41607,17285,65850,16767,8134,8633
55815,86495,20639,41609,17285,65856,16769,8135,8634
55820,86506,20640,41613,17286,65865,16771,8135,8636
55825,86510,20641,41614,17287,65869,16771,8135,8636
55830,86520,20642,41621,17288,65877,16773,8137,8636
55835,86526,20642,41622,17288,65883,16775,8137,8638
55840,86537,20644,41627,17289,65892,16777,8137,8640
55845,86541,20645,41630,17290,65895,16777,8137,8640
55850,86551,20647,41633,17292,65904,16779,8137,8642
55855,86557,20648,41637,17293,65908,16781,8138,8643
55860,86568,20651,41643,17295,65916,16783,8139,8644
55865,86572,20652,41646,17296,65919,16783,8139,8644
55870,86582,20653,41649,17296,65929,16785,8140,8645
55875,86588,20653,41651,17296,65935,16787,8141,8646
55880,86599,20657,41655,17299,65942,16789,8141,8648
55885,86603,20657,41657,17299,65945,16789,8141,8648
55890,86613,20660,41663,17301,65952,16791,8142,8649
55895,86619,20661,41667,17302,65956,16793,8144,8649
55900,86630,20665,41675,17306,65962,16795,8146,8649
55905,86634,20667,41678,17308,65966,16795,8146,8649
55910,86644,20671,41683,17311,65973,16797,8147,8650
55915,86650,20672,41687,17312,65977,16799,8148,8651
55920,86661,20674,41689,17313,65986,16801,8148,8653
55925,86665,20674,41692,17313,65991,16801,8148,8653
55930,86675,20676,41695,17313,65998,16803,8149,8654
55935,86681,20678,41698,17315,66003,16805,8151,8654
55940,86692,20680,41702,17316,66011,16807,8152,8655
55945,86696,20680,41704,17316,66016,16807,8152,8655
55950,86706,20683,41709,17318,66021,16809,8153,8656
55955,86712,20686,41712,17321,66025,16811,8153,8658
55960,86723,20691,41720,17326,66030,16813,8154,8659
55965,86727,20692,41720,17327,66035,16813,8154,8659
55970,86737,20695,41723,17328,66040,16815,8154,8661
55975,86743,20698,41726,17331,66044,16817,8155,8662
55980,86754,20702,41733,17335,66051,16819,8156,8663
55985,86758,20704,41735,17337,66054,16819,8156,8663
55990,86768,20707,41740,17339,66061,16821,8157,8664
55995,86774,20707,41744,17339,66066,16823,8158,8665
56000,86785,20709,41751,17341,66074,16825,8159,8666
56005,86789,20710,41753,17342,66078,16825,8159,8666
56010,86799,20715,41758,17345,66084,16827,8160,8667
56015,86805,20715,41759,17345,66090,16829,8161,8668
56020,86816,20718,41762,17347,66098,16831,8161,8670
56025,86820,20720,41764,17349,66100,16831,8161,8670
56030,86830,20725,41770,17352,66104,16833,8163,8670
56035,86836,20725,41774,17352,66109,16835,8164,8671
56040,86847,20729,41780,17355,66117,16837,8165,8672
56045,86851,20730,41782,17356,66119,16837,8165,8672
56050,86861,20735,41785,17360,66126,16839,8166,8673
56055,86867,20735,41789,17360,66130,16841,8166,8675
56060,86878,20738,41793,17363,66139,16843,8167,8676
56065,86882,20740,41796,17365,66141,16843,8167,8676
56070,86892,20742,41799,17366,66150,16845,8167,8678
56075,86898,20742,41801,17366,66155,16847,8168,8679
56080,86909,20742,41807,17366,66166,16849,8169,8680
56085,86913,20742,41809,17366,66170,16849,8169,8680
56090,86923,20743,41813,17366,66180,16851,8170,8681
56095,86929,20743,41816,17366,66186,16853,8172,8681
56100,86940,20744,41825,17367,66194,16855,8174,8681
56105,86944,20744,41826,17367,66200,16855,8174,8681
56110,86954,20745,41832,17368,66209,16857,8174,8683
56115,86960,20745,41835,17368,66215,16859,8176,8683
56120,86971,20745,41837,17368,66226,16861,8177,8684
56125,86975,20745,41840,17368,66230,16861,8177,8684
56130,86985,20746,41844,17368,66239,16863,8178,8685
56135,86991,20746,41845,17368,66245,16865,8178,8687
56140,87002,20747,41852,17369,66255,16867,8179,8688
56145,87006,20747,41854,17369,66259,16867,8179,8688
56150,87016,20749,41859,17371,66265,16869,8180,8689
56155,87022,20752,41863,17374,66270,16871,8181,8690
56160,87033,20755,41870,17376,66278,16873,8182,8691
56165,87037,20755,41873,17376,66282,16873,8182,8691
56170,87047,20756,41876,17377,66290,16875,8182,8693
56175,87053,20758,41879,17379,66294,16877,8183,8694
56180,87064,20762,41884,17383,66301,16879,8183,8696
56185,87068,20764,41885,17385,66304,16879,8183,8696
56190,87078,20766,41890,17386,66310,16881,8184,8697
56195,87084,20768,41893,17388,66314,16883,8185,8698
56200,87095,20773,41896,17392,66321,16885,8185,8700
56205,87099,20776,41900,17395,66321,16885,8185,8700
56210,87109,20782,41905,17400,66327,16887,8187,8700
56215,87115,20783,41909,17401,66331,16889,8189,8700
56220,87126,20787,41914,17404,66338,16891,8191,8700
56225,87130,20788,41918,17405,66341,16891,8191,8700
56230,87140,20791,41923,17408,66348,16893,8191,8702
56235,87146,20793,41927,17410,66352,16895,8192,8703
56240,87157,20795,41930,17412,66362,16897,8193,8704
56245,87161,20796,41934,17413,66364,16897,8193,8704
56250,87171,20800,41938,17416,66371,16899,8193,8706
56255,87177,20800,41940,17416,66376,16901,8194,8707
56260,87188,20803,41947,17419,66381,16903,8195,8708
56265,87192,20806,41950,17422,66385,16903,8195,8708
56270,87202,20808,41954,17422,66392,16905,8195,8710
56275,87208,20810,41956,17424,66398,16907,8196,8711
56280,87219,20812,41960,17425,66407,16909,8198,8711
56285,87223,20812,41962,17425,66411,16909,8198,8711
56290,87233,20815,41967,17427,66416,16911,8199,8712
56295,87239,20818,41970,17430,66421,16913,8201,8712
56300,87250,20821,41977,17433,66427,16915,8202,8713
56305,87254,20822,41979,17434,66432,16915,8202,8713
56310,87264,20824,41985,17435,66439,16917,8204,8713
56315,87270,20824,41987,17435,66445,16919,8204,8715
56320,87281,20827,41993,17437,66452,16921,8205,8716
56325,87285,20829,41995,17439,66455,16921,8205,8716
56330,87295,20835,42004,17444,66459,16923,8207,8716
56335,87301,20835,42005,17444,66466,16925,8208,8717
56340,87312,20837,42010,17445,66472,16927,8208,8719
56345,87316,20841,42011,17449,66475,16927,8208,8719
56350,87326,20843,42017,17451,66483,16929,8210,8719
56355,87332,20843,42021,17451,66487,16931,8211,8720
56360,87343,20846,42028,17454,66495,16933,8212,8721
56365,87347,20847,42032,17455,66499,16933,8212,8721
56370,87357,20848,42034,17456,66509,16935,8212,8723
56375,87363,20848,42036,17456,66514,16937,8213,8724
56380,87374,20850,42045,17457,66522,16939,8215,8724
56385,87378,20850,42045,17457,66528,16939,8215,8724
56390,87388,20852,42051,17459,66535,16941,8216,8725
56395,87394,20852,42053,17459,66541,16943,8217,8726
56400,87405,20854,42057,17461,66550,16945,8218,8727
56405,87409,20854,42058,17461,66555,16945,8218,8727
56410,87419,20857,42065,17464,66562,16947,8219,8728
56415,87425,20857,42069,17464,66568,16949,8220,8729
56420,87436,20859,42076,17466,66576,16951,8222,8729
56425,87440,20859,42077,17466,66581,16951,8222,8729
56430,87450,20861,42081,17468,66589,16953,8222,8731
56435,87456,20861,42083,17468,66595,16955,8223,8732
56440,87467,20863,42089,17470,66604,16957,8223,8734
56445,87471,20863,42091,17470,66608,16957,8223,8734
56450,87481,20864,42095,17471,66617,16959,8224,8735
56455,87487,20864,42099,17471,66623,16961,8225,8736
56460,87498,20866,42105,17472,66631,16963,8226,8737
56465,87502,20867,42108,17473,66635,16963,8226,8737
56470,87512,20869,42112,17475,66643,16965,8226,8739
56475,87518,20869,42114,17475,66648,16967,8226,8741
56480,87529,20872,42119,17477,66656,16969,8227,8742
56485,87533,20872,42122,17477,66661,16969,8227,8742
56490,87543,20876,42130,17481,66667,16971,8228,8743
56495,87549,20876,42135,17481,66673,16973,8230,8743
56500,87560,20880,42140,17485,66679,16975,8230,8745
56505,87564,20882,42142,17487,66682,16975,8230,8745
56510,87574,20885,42147,17489,66689,16977,8231,8746
56515,87580,20886,42152,17490,66693,16979,8233,8746
56520,87591,20890,42157,17493,66699,16981,8234,8747
56525,87595,20890,42157,17493,66705,16981,8234,8747
56530,87605,20892,42162,17494,66712,16983,8235,8748
56535,87611,20893,42166,17495,66717,16985,8237,8748
56540,87622,20897,42170,17498,66725,16987,8239,8748
56545,87626,20897,42172,17498,66728,16987,8239,8748
56550,87636,20902,42179,17501,66733,16989,8241,8748
56555,87642,20903,42180,17502,66739,16991,8242,8749
56560,87653,20905,42183,17504,66747,16993,8242,8751
56565,87657,20907,42184,17506,66750,16993,8242,8751
56570,87667,20912,42191,17511,66754,16995,8243,8752
56575,87673,20914,42195,17513,66758,16997,8245,8752
56580,87684,20918,42201,17517,66765,16999,8247,8752
56585,87688,20920,42203,17519,66767,16999,8247,8752
56590,87698,20923,42208,17521,66775,17001,8249,8752
56595,87704,20924,42209,17522,66780,17003,8249,8754
56600,87715,20926,42214,17524,66787,17005,8249,8756
56605,87719,20929,42217,17527,66789,17005,8249,8756
56610,87729,20933,42221,17530,66796,17007,8249,8758
56615,87735,20933,42225,17530,66800,17009,8251,8758
56620,87746,20935,42229,17532,66808,17011,8251,8760
56625,87750,20938,42231,17535,66812,17011,8251,8760
56630,87760,20939,42238,17536,66820,17013,8253,8760
56635,87766,20941,42242,17538,66823,17015,8254,8761
56640,87777,20943,42250,17540,66833,17017,8256,8761
56645,87781,20944,42251,17541,66837,17017,8256,8761
56650,87791,20945,42257,17542,66845,17019,8257,8762
56655,87797,20946,42261,17543,66850,17021,8258,8763
56660,87808,20948,42267,17545,66859,17023,8259,8764
56665,87812,20949,42271,17546,66863,17023,8259,8764
56670,87822,20950,42277,17547,66871,17025,8260,8765
56675,87828,20952,42279,17549,66876,17027,8261,8766
56680,87839,20953,42287,17550,66885,17029,8262,8767
56685,87843,20954,42289,17551,66889,17029,8262,8767
56690,87853,20956,42294,17552,66896,17031,8263,8768
56695,87859,20958,42297,17554,66901,17033,8264,8769
56700,87870,20961,42301,17556,66909,17035,8264,8771
56705,87874,20961,42304,17556,66913,17035,8264,8771
56710,87884,20964,42309,17559,66920,17037,8265,8772
56715,87890,20964,42312,17559,66925,17039,8265,8774
56720,87901,20967,42317,17561,66933,17041,8266,8775
56725,87905,20969,42318,17563,66936,17041,8266,8775
56730,87915,20972,42322,17566,66942,17043,8266,8777
56735,87921,20973,42323,17567,66948,17045,8266,8779
56740,87932,20976,42328,17569,66955,17047,8267,8780
56745,87936,20978,42329,17571,66958,17047,8267,8780
56750,87946,20983,42335,17574,66962,17049,8269,8780
56755,87952,20984,42336,17575,66968,17051,8270,8781
56760,87963,20988,42341,17578,66973,17053,8270,8783
56765,87967,20992,42344,17582,66974,17053,8270,8783
56770,87977,20998,42350,17588,66978,17055,8270,8785
56775,87983,21000,42355,17590,66980,17057,8271,8786
56780,87994,21005,42361,17594,66986,17059,8271,8788
56785,87998,21009,42363,17598,66988,17059,8271,8788
56790,88008,21013,42369,17602,66995,17061,8272,8789
56795,88014,21013,42369,17602,67001,17063,8272,8791
56800,88025,21015,42373,17603,67010,17065,8274,8791
56805,88029,21016,42374,17604,67013,17065,8274,8791
56810,88039,21020,42380,17607,67018,17067,8275,8792
56815,88045,21020,42382,17607,67025,17069,8276,8793
56820,88056,21023,42388,17609,67031,17071,8277,8794
56825,88060,21026,42390,17612,67034,17071,8277,8794
56830,88070,21027,42395,17613,67042,17073,8277,8796
56835,88076,21027,42397,17613,67049,17075,8277,8798
56840,88087,21029,42401,17614,67058,17077,8278,8799
56845,88091,21029,42402,17614,67062,17077,8278,8799
56850,88101,21031,42407,17616,67070,17079,8279,8800
56855,88107,21031,42409,17616,67076,17081,8281,8800
56860,88118,21031,42416,17616,67087,17083,8283,8800
56865,88122,21031,42420,17616,67091,17083,8283,8800
56870,88132,21031,42425,17616,67100,17085,8283,8802
56875,88138,21031,42425,17616,67107,17087,8283,8804
56880,88149,21031,42426,17616,67118,17089,8283,8806
56885,88153,21031,42427,17616,67122,17089,8283,8806
56890,88163,21032,42431,17616,67130,17091,8283,8808
56895,88169,21032,42436,17616,67136,17093,8285,8808
56900,88180,21032,42442,17616,67148,17096,8288,8808
56905,88184,21032,42444,17616,67151,17096,8288,8808
56910,88194,21033,42448,17616,67161,17098,8289,8809
56915,88200,21033,42450,17616,67166,17100,8289,8811
56920,88211,21033,42456,17616,67178,17103,8289,8814
56925,88215,21033,42457,17616,67181,17103,8289,8814
56930,88225,21034,42461,17617,67191,17105,8290,8815
56935,88231,21034,42463,17617,67196,17107,8291,8816
56940,88242,21036,42467,17619,67205,17110,8291,8819
56945,88246,21038,42470,17621,67206,17110,8291,8819
56950,88256,21044,42476,17625,67211,17112,8293,8819
56955,88262,21045,42478,17626,67216,17114,8294,8820
56960,88273,21050,42483,17630,67222,17116,8295,8821
56965,88277,21051,42484,17631,67225,17116,8295,8821
56970,88287,21054,42485,17632,67232,17118,8295,8823
56975,88293,21056,42490,17634,67234,17120,8296,8824
56980,88304,21064,42496,17641,67238,17122,8296,8826
56985,88308,21065,42496,17642,67243,17122,8296,8826
56990,88318,21071,42505,17647,67247,17124,8298,8826
56995,88324,21071,42507,17647,67253,17126,8300,8826
57000,88335,21074,42513,17650,67260,17128,8302,8826
57005,88339,21074,42516,17650,67264,17128,8302,8826
57010,88349,21077,42521,17652,67272,17130,8303,8827
57015,88355,21077,42523,17652,67278,17132,8304,8828
57020,88366,21079,42531,17654,67286,17134,8305,8829
57025,88370,21080,42533,17655,67290,17134,8305,8829
57030,88380,21083,42540,17658,67297,17136,8306,8830
57035,88386,21083,42545,17658,67303,17138,8308,8830
57040,88397,21084,42548,17658,67312,17140,8309,8831
57045,88401,21084,42549,17658,67316,17140,8309,8831
57050,88411,21085,42553,17659,67326,17142,8310,8832
57055,88417,21085,42554,17659,67332,17144,8310,8834
57060,88428,21087,42560,17661,67340,17146,8311,8835
57065,88432,21088,42562,17662,67343,17146,8311,8835
57070,88442,21090,42565,17663,67352,17148,8312,8836
57075,88448,21090,42567,17663,67358,17150,8313,8837
57080,88459,21092,42571,17665,67366,17152,8313,8839
57085,88463,21094,42574,17667,67368,17152,8313,8839
57090,88473,21097,42578,17669,67375,17154,8313,8841
57095,88479,21099,42583,17671,67379,17156,8315,8841
57100,88490,21102,42588,17674,67387,17158,8315,8843
57105,88494,21103,42590,17675,67390,17158,8315,8843
57110,88504,21107,42595,17678,67396,17160,8316,8844
57115,88510,21109,42598,17680,67400,17162,8316,8846
57120,88521,21112,42603,17683,67408,17164,8317,8847
57125,88525,21113,42606,17684,67411,17164,8317,8847
57130,88535,21115,42612,17686,67419,17166,8319,8847
57135,88541,21117,42616,17688,67422,17168,8320,8848
57140,88552,21122,42620,17693,67428,17170,8320,8850
57145,88556,21124,42622,17695,67431,17170,8320,8850
57150,88566,21127,42626,17697,67439,17172,8320,8852
57155,88572,21128,42629,17698,67444,17174,8322,8852
57160,88583,21131,42635,17701,67449,17176,8322,8854
57165,88587,21133,42637,17703,67454,17176,8322,8854
57170,88597,21136,42641,17705,67460,17178,8323,8855
57175,88603,21137,42643,17706,67465,17180,8324,8856
57180,88614,21140,42649,17709,67472,17182,8325,8857
57185,88618,21143,42650,17712,67475,17182,8325,8857
57190,88628,21148,42656,17716,67479,17184,8326,8858
57195,88634,21150,42660,17718,67482,17186,8327,8859
57200,88645,21154,42665,17721,67488,17188,8328,8860
57205,88649,21157,42666,17724,67491,17188,8328,8860
57210,88659,21162,42670,17727,67495,17190,8328,8862
57215,88665,21165,42673,17730,67500,17192,8330,8862
57220,88676,21168,42677,17732,67506,17194,8330,8864
57225,88680,21170,42678,17734,67509,17194,8330,8864
57230,88690,21175,42682,17737,67514,17196,8331,8865
57235,88696,21176,42683,17738,67520,17198,8332,8866
57240,88707,21179,42690,17740,67526,17200,8334,8866
57245,88711,21181,42692,17742,67529,17200,8334,8866
57250,88721,21186,42697,17746,67534,17202,8335,8867
57255,88727,21186,42702,17746,67539,17204,8336,8868
57260,88738,21187,42708,17746,67550,17206,8337,8869
57265,88742,21187,42709,17746,67554,17206,8337,8869
57270,88752,21188,42716,17747,67563,17208,8339,8869
57275,88758,21188,42719,17747,67569,17210,8339,8871
57280,88769,21190,42725,17749,67578,17212,8339,8873
57285,88773,21190,42727,17749,67583,17212,8339,8873
57290,88783,21191,42730,17750,67592,17214,8340,8874
57295,88789,21191,42731,17750,67598,17216,8340,8876
57300,88800,21193,42735,17751,67606,17218,8341,8877
57305,88804,21193,42735,17751,67611,17218,8341,8877
57310,88814,21194,42741,17752,67620,17220,8343,8877
57315,88820,21194,42744,17752,67625,17222,8345,8877
57320,88831,21195,42752,17753,67635,17224,8347,8877
57325,88835,21195,42755,17753,67639,17224,8347,8877
57330,88845,21196,42759,17754,67649,17226,8348,8878
57335,88851,21196,42760,17754,67655,17228,8349,8879
57340,88862,21197,42762,17754,67664,17230,8350,8880
57345,88866,21198,42765,17755,67668,17230,8350,8880
57350,88876,21200,42771,17757,67676,17232,8352,8880
57355,88882,21200,42774,17757,67682,17234,8353,8881
57360,88893,21203,42780,17760,67689,17236,8353,8883
57365,88897,21203,42780,17760,67694,17236,8353,8883
57370,88907,21206,42786,17762,67701,17238,8355,8883
57375,88913,21206,42789,17762,67707,17240,8357,8883
57380,88924,21210,42794,17765,67712,17242,8357,8885
57385,88928,21213,42796,17768,67715,17242,8357,8885
57390,88938,21216,42800,17769,67721,17244,8359,8885
57395,88944,21217,42803,17770,67726,17246,8360,8886
57400,88955,21220,42808,17772,67734,17248,8362,8886
57405,88959,21220,42809,17772,67738,17248,8362,8886
57410,88969,21222,42814,17774,67746,17250,8362,8888
57415,88975,21224,42818,17776,67750,17252,8364,8888
57420,88986,21225,42820,17777,67760,17254,8364,8890
57425,88990,21225,42822,17777,67764,17254,8364,8890
57430,89000,21227,42827,17778,67773,17256,8364,8892
57435,89006,21227,42829,17778,67778,17258,8365,8893
57440,89017,21230,42834,17781,67784,17260,8366,8894
57445,89021,21232,42836,17783,67788,17260,8366,8894
57450,89031,21235,42840,17785,67795,17262,8367,8895
57455,89037,21236,42842,17786,67799,17264,8367,8897
57460,89048,21241,42851,17791,67805,17266,8368,8898
57465,89052,21243,42853,17793,67808,17266,8368,8898
57470,89062,21247,42859,17797,67814,17268,8369,8899
57475,89068,21248,42862,17798,67819,17270,8371,8899
57480,89079,21250,42866,17800,67828,17272,8371,8901
57485,89083,21251,42866,17801,67832,17272,8371,8901
57490,89093,21254,42870,17804,67839,17274,8372,8902
57495,89099,21255,42873,17805,67843,17276,8373,8903
57500,89110,21257,42878,17807,67851,17278,8374,8904
57505,89114,21258,42879,17808,67855,17278,8374,8904
57510,89124,21263,42885,17813,67860,17280,8375,8905
57515,89130,21265,42887,17815,67864,17282,8375,8907
57520,89141,21269,42892,17819,67871,17284,8376,8908
57525,89145,21271,42894,17821,67874,17284,8376,8908
57530,89155,21275,42900,17825,67879,17286,8377,8909
57535,89161,21277,42903,17827,67882,17288,8377,8911
57540,89172,21282,42906,17831,67889,17290,8378,8912
57545,89176,21284,42910,17833,67890,17290,8378,8912
57550,89186,21289,42915,17837,67895,17292,8378,8914
57555,89192,21291,42919,17839,67899,17294,8379,8915
57560,89203,21294,42925,17842,67908,17296,8380,8916
57565,89207,21295,42928,17843,67911,17296,8380,8916
57570,89217,21297,42931,17844,67919,17298,8380,8918
57575,89223,21299,42936,17846,67922,17300,8381,8919
57580,89234,21300,42942,17847,67933,17302,8382,8920
57585,89238,21301,42945,17848,67937,17302,8382,8920
57590,89248,21302,42949,17849,67946,17304,8382,8922
57595,89254,21302,42954,17849,67951,17306,8384,8922
57600,89265,21303,42959,17850,67961,17308,8385,8923
57605,89269,21303,42961,17850,67965,17308,8385,8923
57610,89279,21303,42964,17850,67976,17310,8385,8925
57615,89285,21303,42967,17850,67981,17312,8386,8926
57620,89296,21304,42972,17851,67991,17314,8386,8928
57625,89300,21305,42974,17852,67995,17314,8386,8928
57630,89310,21305,42977,17852,68005,17316,8386,8930
57635,89316,21305,42980,17852,68011,17318,8386,8932
57640,89327,21306,42984,17852,68020,17320,8387,8933
57645,89331,21306,42985,17852,68024,17320,8387,8933
57650,89341,21307,42989,17853,68034,17322,8388,8934
57655,89347,21307,42992,17853,68039,17324,8389,8935
57660,89358,21310,42995,17855,68047,17326,8390,8936
57665,89362,21311,42997,17856,68051,17326,8390,8936
57670,89372,21313,43000,17857,68059,17328,8391,8937
57675,89378,21313,43004,17857,68064,17330,8393,8937
57680,89389,21317,43009,17860,68071,17332,8393,8939
57685,89393,21317,43010,17860,68075,17332,8393,8939
57690,89403,21320,43016,17862,68082,17334,8395,8939
57695,89409,21320,43018,17862,68087,17336,8395,8941
57700,89420,21324,43023,17865,68094,17338,8396,8942
57705,89424,21325,43024,17866,68098,17338,8396,8942
57710,89434,21330,43029,17870,68103,17340,8397,8943
57715,89440,21331,43031,17871,68108,17342,8398,8944
57720,89451,21333,43035,17873,68115,17344,8398,8946
57725,89455,21336,43038,17876,68117,17344,8398,8946
57730,89465,21341,43041,17879,68124,17346,8399,8947
57735,89471,21341,43045,17879,68129,17348,8400,8948
57740,89482,21345,43050,17883,68136,17350,8400,8950
57745,89486,21346,43052,17884,68139,17350,8400,8950
57750,89496,21351,43057,17889,68145,17352,8400,8952
57755,89502,21351,43062,17889,68149,17354,8402,8952
57760,89513,21357,43071,17894,68154,17356,8404,8952
57765,89517,21359,43074,17896,68157,17356,8404,8952
57770,89527,21361,43079,17897,68166,17358,8405,8953
57775,89533,21361,43082,17897,68171,17360,8405,8955
57780,89544,21364,43090,17900,68179,17362,8406,8956
57785,89548,21365,43094,17901,68182,17362,8406,8956
57790,89558,21367,43100,17902,68191,17364,8407,8957
57795,89564,21367,43102,17902,68197,17366,8408,8958
57800,89575,21370,43108,17904,68204,17368,8410,8958
57805,89579,21371,43110,17905,68207,17368,8410,8958
57810,89589,21373,43115,17907,68216,17370,8411,8959
57815,89595,21373,43119,17907,68222,17372,8413,8959
57820,89606,21375,43126,17909,68230,17374,8414,8960
57825,89610,21376,43129,17910,68233,17374,8414,8960
57830,89620,21379,43135,17912,68239,17376,8416,8960
57835,89626,21381,43138,17914,68245,17378,8418,8960
57840,89637,21382,43142,17915,68254,17380,8418,8962
57845,89641,21383,43144,17916,68258,17380,8418,8962
57850,89651,21384,43148,17917,68266,17382,8418,8964
57855,89657,21386,43152,17919,68270,17384,8419,8965
57860,89668,21387,43158,17920,68279,17386,8421,8965
57865,89672,21389,43160,17922,68283,17386,8421,8965
57870,89682,21390,43165,17923,68291,17388,8422,8966
57875,89688,21391,43167,17924,68295,17390,8422,8968
57880,89699,21394,43172,17927,68303,17392,8423,8969
57885,89703,21395,43174,17928,68308,17392,8423,8969
57890,89713,21397,43176,17928,68316,17394,8423,8971
57895,89719,21398,43180,17929,68320,17396,8424,8972
57900,89730,21402,43186,17933,68326,17398,8426,8972
57905,89734,21403,43187,17934,68331,17398,8426,8972
57910,89744,21405,43193,17935,68338,17400,8428,8972
57915,89750,21406,43194,17936,68343,17402,8428,8974
57920,89761,21409,43201,17939,68350,17404,8430,8974
57925,89765,21411,43203,17941,68353,17404,8430,8974
57930,89775,21414,43209,17943,68360,17406,8431,8975
57935,89781,21415,43211,17944,68366,17408,8432,8976
57940,89792,21417,43221,17946,68372,17410,8434,8976
57945,89796,21420,43223,17949,68374,17410,8434,8976
57950,89806,21425,43228,17953,68379,17412,8435,8977
57955,89812,21428,43232,17956,68382,17414,8436,8978
57960,89823,21432,43237,17960,68390,17416,8437,8979
57965,89827,21432,43238,17960,68394,17416,8437,8979
57970,89837,21436,43243,17964,68401,17418,8439,8979
57975,89843,21436,43243,17964,68407,17420,8439,8981
57980,89854,21438,43247,17965,68415,17422,8440,8982
57985,89858,21440,43250,17967,68417,17422,8440,8982
57990,89868,21445,43257,17972,68423,17424,8441,8983
57995,89874,21445,43259,17972,68427,17426,8441,8985
58000,89885,21448,43266,17974,68435,17428,8443,8985
58005,89889,21449,43266,17975,68440,17428,8443,8985
58010,89899,21451,43268,17976,68448,17430,8443,8987
58015,89905,21451,43273,17976,68452,17432,8445,8987
58020,89916,21454,43279,17978,68461,17434,8446,8988
58025,89920,21455,43281,17979,68464,17434,8446,8988
58030,89930,21456,43286,17980,68473,17436,8446,8990
58035,89936,21456,43290,17980,68479,17438,8447,8991
58040,89947,21457,43298,17981,68489,17440,8449,8991
58045,89951,21457,43299,17981,68493,17440,8449,8991
58050,89961,21458,43303,17982,68503,17442,8450,8992
58055,89967,21458,43307,17982,68509,17444,8452,8992
58060,89978,21459,43310,17982,68518,17446,8453,8993
58065,89982,21459,43312,17982,68523,17446,8453,8993
58070,89992,21460,43314,17982,68532,17448,8453,8995
58075,89998,21460,43316,17982,68538,17450,8453,8997
58080,90009,21462,43325,17984,68546,17452,8455,8997
58085,90013,21462,43326,17984,68551,17452,8455,8997
58090,90023,21464,43333,17986,68559,17454,8457,8997
58095,90029,21464,43337,17986,68565,17456,8458,8998
58100,90040,21466,43340,17987,68573,17458,8458,9000
58105,90044,21466,43342,17987,68578,17458,8458,9000
58110,90054,21467,43346,17988,68587,17460,8459,9001
58115,90060,21467,43348,17988,68593,17462,8460,9002
58120,90071,21469,43353,17990,68601,17464,8461,9003
58125,90075,21470,43355,17991,68605,17464,8461,9003
58130,90085,21473,43360,17994,68612,17466,8462,9004
58135,90091,21473,43364,17994,68617,17468,8464,9004
58140,90102,21475,43370,17996,68625,17470,8464,9006
58145,90106,21477,43372,17998,68629,17470,8464,9006
58150,90116,21480,43379,18001,68634,17472,8466,9006
58155,90122,21483,43382,18004,68639,17474,8468,9006
58160,90133,21485,43387,18005,68647,17476,8470,9006
58165,90137,21487,43389,18007,68650,17476,8470,9006
58170,90147,21491,43396,18011,68655,17478,8472,9006
58175,90153,21493,43401,18013,68658,17480,8474,9006
58180,90164,21498,43406,18018,68664,17482,8475,9007
58185,90168,21499,43407,18019,68669,17482,8475,9007
58190,90178,21502,43409,18020,68676,17484,8475,9009
58195,90184,21502,43412,18020,68681,17486,8477,9009
58200,90195,21505,43417,18023,68687,17488,8478,9010
58205,90199,21508,43419,18026,68690,17488,8478,9010
58210,90209,21513,43422,18029,68695,17490,8478,9012
58215,90215,21514,43423,18030,68701,17492,8479,9013
58220,90226,21517,43427,18033,68707,17494,8479,9015
58225,90230,21518,43429,18034,68710,17494,8479,9015
58230,90240,21523,43432,18038,68717,17496,8480,9016
58235,90246,21523,43433,18038,68722,17498,8480,9018
58240,90257,21525,43435,18039,68731,17500,8480,9020
58245,90261,21526,43437,18040,68733,17500,8480,9020
58250,90271,21533,43440,18045,68738,17502,8480,9022
58255,90277,21534,43445,18046,68741,17504,8482,9022
58260,90288,21539,43450,18050,68747,17506,8482,9024
58265,90292,21541,43451,18052,68750,17506,8482,9024
58270,90302,21545,43457,18055,68757,17508,8484,9024
58275,90308,21545,43460,18055,68763,17510,8486,9024
58280,90319,21546,43464,18055,68772,17512,8487,9025
58285,90323,21547,43467,18056,68775,17512,8487,9025
58290,90333,21549,43473,18058,68784,17514,8488,9026
58295,90339,21549,43475,18058,68790,17516,8489,9027
58300,90350,21550,43482,18059,68799,17518,8489,9029
58305,90354,21550,43482,18059,68804,17518,8489,9029
58310,90364,21553,43485,18061,68811,17520,8489,9031
58315,90370,21553,43487,18061,68817,17522,8489,9033
58320,90381,21554,43490,18061,68826,17524,8489,9035
58325,90385,21554,43490,18061,68831,17524,8489,9035
58330,90395,21557,43496,18064,68838,17526,8490,9036
58335,90401,21557,43498,18064,68843,17528,8491,9037
58340,90412,21558,43502,18064,68853,17530,8491,9039
58345,90416,21558,43505,18064,68857,17530,8491,9039
58350,90426,21560,43512,18066,68866,17532,8493,9039
58355,90432,21560,43516,18066,68872,17534,8495,9039
58360,90443,21561,43521,18067,68881,17536,8496,9040
58365,90447,21562,43524,18068,68884,17536,8496,9040
58370,90457,21565,43530,18071,68891,17538,8497,9041
58375,90463,21566,43531,18072,68896,17540,8497,9043
58380,90474,21570,43538,18076,68902,17542,8497,9045
58385,90478,21572,43540,18078,68905,17542,8497,9045
58390,90488,21575,43545,18080,68913,17544,8499,9045
58395,90494,21576,43549,18081,68917,17546,8501,9045
58400,90505,21580,43555,18085,68923,17548,8502,9046
58405,90509,21581,43558,18086,68927,17548,8502,9046
58410,90519,21585,43563,18088,68933,17550,8503,9047
58415,90525,21587,43566,18090,68936,17552,8503,9049
58420,90536,21590,43571,18093,68945,17554,8503,9051
58425,90540,21592,43574,18095,68947,17554,8503,9051
58430,90550,21596,43581,18098,68952,17556,8503,9053
58435,90556,21598,43583,18100,68956,17558,8503,9055
58440,90567,21602,43587,18103,68963,17560,8504,9056
58445,90571,21603,43588,18104,68968,17560,8504,9056
58450,90581,21605,43594,18106,68976,17562,8504,9058
58455,90587,21605,43596,18106,68982,17564,8505,9059
58460,90598,21608,43600,18109,68989,17566,8506,9060
58465,90602,21609,43601,18110,68993,17566,8506,9060
58470,90612,21612,43604,18112,69000,17568,8506,9062
58475,90618,21612,43606,18112,69006,17570,8506,9064
58480,90629,21616,43612,18115,69011,17572,8507,9065
58485,90633,21618,43613,18117,69015,17572,8507,9065
58490,90643,21622,43617,18120,69021,17574,8507,9067
58495,90649,21622,43620,18120,69027,17576,8508,9068
58500,90660,21625,43627,18123,69034,17578,8508,9070
58505,90664,21626,43629,18124,69037,17578,8508,9070
58510,90674,21632,43637,18130,69042,17580,8510,9070
58515,90680,21632,43639,18130,69048,17582,8511,9071
58520,90691,21634,43643,18132,69057,17584,8511,9073
58525,90695,21636,43645,18134,69059,17584,8511,9073
58530,90705,21640,43649,18137,69065,17586,8511,9075
58535,90711,21640,43652,18137,69070,17588,8512,9076
58540,90722,21644,43659,18141,69076,17590,8512,9078
58545,90726,21647,43661,18144,69078,17590,8512,9078
58550,90736,21651,43666,18148,69084,17592,8513,9079
58555,90742,21652,43670,18149,69088,17594,8515,9079
58560,90753,21656,43673,18152,69096,17596,8515,9081
58565,90757,21658,43674,18154,69099,17596,8515,9081
58570,90767,21660,43678,18155,69106,17598,8516,9082
58575,90773,21662,43681,18157,69110,17600,8516,9084
58580,90784,21665,43686,18160,69119,17602,8517,9085
58585,90788,21666,43688,18161,69122,17602,8517,9085
58590,90798,21668,43692,18162,69129,17604,8518,9086
58595,90804,21670,43695,18164,69134,17606,8519,9087
58600,90815,21671,43700,18165,69142,17608,8519,9089
58605,90819,21674,43702,18168,69145,17608,8519,9089
58610,90829,21676,43707,18169,69151,17610,8519,9091
58615,90835,21678,43711,18171,69155,17612,8519,9093
58620,90846,21679,43716,18172,69166,17614,8520,9094
58625,90850,21679,43717,18172,69171,17614,8520,9094
58630,90860,21679,43718,18172,69181,17616,8520,9096
58635,90866,21679,43721,18172,69186,17618,8522,9096
58640,90877,21680,43725,18172,69197,17620,8523,9097
58645,90881,21680,43726,18172,69200,17620,8523,9097
58650,90891,21681,43731,18173,69210,17622,8524,9098
58655,90897,21681,43733,18173,69215,17624,8524,9100
58660,90908,21682,43740,18174,69226,17626,8526,9100
58665,90912,21684,43743,18176,69227,17626,8526,9100
58670,90922,21687,43744,18178,69235,17628,8526,9102
58675,90928,21687,43746,18178,69241,17630,8528,9102
58680,90939,21689,43755,18180,69248,17632,8530,9102
58685,90943,21691,43756,18182,69252,17632,8530,9102
58690,90953,21695,43761,18185,69257,17634,8531,9103
58695,90959,21695,43764,18185,69264,17636,8533,9103
58700,90970,21697,43770,18187,69272,17638,8533,9105
58705,90974,21698,43772,18188,69275,17638,8533,9105
58710,90984,21701,43775,18191,69283,17640,8534,9106
58715,90990,21701,43776,18191,69289,17642,8535,9107
58720,91001,21704,43783,18194,69297,17644,8536,9108
58725,91005,21704,43784,18194,69300,17644,8536,9108
58730,91015,21708,43788,18197,69306,17646,8537,9109
58735,91021,21708,43791,18197,69311,17648,8538,9110
58740,91032,21712,43795,18200,69319,17650,8539,9111
58745,91036,21714,43798,18202,69321,17650,8539,9111
58750,91046,21717,43804,18205,69329,17652,8539,9113
58755,91052,21717,43806,18205,69335,17654,8541,9113
58760,91063,21718,43813,18205,69344,17656,8542,9114
58765,91067,21718,43815,18205,69348,17656,8542,9114
58770,91077,21720,43820,18206,69357,17658,8543,9115
58775,91083,21720,43825,18206,69362,17660,8545,9115
58780,91094,21721,43831,18206,69373,17662,8546,9116
58785,91098,21722,43832,18207,69376,17662,8546,9116
58790,91108,21723,43837,18208,69384,17664,8547,9117
58795,91114,21723,43838,18208,69390,17666,8547,9119
58800,91125,21724,43844,18208,69401,17668,8549,9119
58805,91129,21725,43847,18209,69403,17668,8549,9119
58810,91139,21727,43851,18210,69412,17670,8549,9121
58815,91145,21727,43856,18210,69418,17672,8551,9121
58820,91156,21728,43862,18211,69427,17674,8552,9122
58825,91160,21729,43864,18212,69430,17674,8552,9122
58830,91170,21730,43866,18212,69440,17676,8553,9123
58835,91176,21730,43869,18212,69446,17678,8555,9123
58840,91187,21731,43873,18213,69456,17680,8556,9124
58845,91191,21732,43877,18214,69458,17680,8556,9124
58850,91201,21735,43880,18216,69466,17682,8556,9126
58855,91207,21735,43885,18216,69470,17684,8558,9126
58860,91218,21740,43892,18220,69477,17686,8560,9126
58865,91222,21741,43893,18221,69480,17686,8560,9126
58870,91232,21745,43896,18224,69487,17688,8560,9128
58875,91238,21745,43901,18224,69491,17690,8561,9129
58880,91249,21750,43907,18229,69498,17692,8562,9130
58885,91253,21752,43910,18231,69500,17692,8562,9130
58890,91263,21757,43917,18236,69506,17694,8563,9131
58895,91269,21757,43923,18236,69510,17696,8565,9131
58900,91280,21762,43931,18241,69517,17698,8566,9132
58905,91284,21763,43933,18242,69521,17698,8566,9132
58910,91294,21765,43939,18244,69528,17700,8566,9134
58915,91300,21767,43942,18246,69532,17702,8567,9135
58920,91311,21769,43946,18248,69541,17704,8568,9136
58925,91315,21771,43948,18250,69544,17704,8568,9136
58930,91325,21774,43955,18253,69550,17706,8569,9137
58935,91331,21776,43958,18255,69555,17708,8570,9138
58940,91342,21778,43965,18257,69563,17710,8571,9139
58945,91346,21780,43967,18259,69566,17710,8571,9139
58950,91356,21781,43970,18259,69573,17712,8572,9140
58955,91362,21784,43974,18262,69577,17714,8573,9141
58960,91373,21787,43979,18264,69585,17716,8574,9142
58965,91377,21788,43980,18265,69588,17716,8574,9142
58970,91387,21790,43986,18267,69595,17718,8574,9144
58975,91393,21793,43989,18270,69598,17720,8574,9146
58980,91404,21795,43995,18272,69608,17722,8575,9147
58985,91408,21796,43995,18273,69612,17722,8575,9147
58990,91418,21799,44001,18275,69617,17724,8575,9149
58995,91424,21801,44003,18277,69622,17726,8575,9151
59000,91435,21803,44007,18278,69631,17728,8575,9153
59005,91439,21805,44009,18280,69634,17728,8575,9153
59010,91449,21808,44012,18282,69641,17730,8575,9155
59015,91455,21808,44014,18282,69646,17732,8575,9157
59020,91466,21811,44019,18285,69654,17734,8577,9157
59025,91470,21813,44022,18287,69656,17734,8577,9157
59030,91480,21817,44030,18291,69661,17736,8579,9157
59035,91486,21820,44035,18294,69664,17738,8580,9158
59040,91497,21824,44041,18298,69671,17740,8581,9159
59045,91501,21826,44042,18300,69675,17740,8581,9159
59050,91511,21829,44047,18303,69682,17742,8582,9160
59055,91517,21829,44049,18303,69688,17744,8584,9160
59060,91528,21830,44054,18304,69697,17746,8584,9162
59065,91532,21831,44056,18305,69701,17746,8584,9162
59070,91542,21834,44061,18307,69708,17748,8585,9163
59075,91548,21834,44065,18307,69714,17750,8587,9163
59080,91559,21836,44072,18309,69722,17752,8588,9164
59085,91563,21837,44074,18310,69725,17752,8588,9164
59090,91573,21841,44078,18313,69732,17754,8589,9165
59095,91579,21841,44080,18313,69737,17756,8590,9166
59100,91590,21843,44084,18314,69746,17758,8591,9167
59105,91594,21845,44085,18316,69749,17758,8591,9167
59110,91604,21850,44091,18320,69754,17760,8592,9168
59115,91610,21850,44094,18320,69759,17762,8593,9169
59120,91621,21854,44100,18323,69766,17764,8594,9170
59125,91625,21856,44101,18325,69769,17764,8594,9170
59130,91635,21860,44105,18328,69775,17766,8595,9171
59135,91641,21860,44109,18328,69779,17768,8596,9172
59140,91652,21864,44114,18332,69787,17770,8597,9173
59145,91656,21867,44116,18335,69789,17770,8597,9173
59150,91666,21871,44120,18338,69794,17772,8597,9175
59155,91672,21873,44124,18340,69798,17774,8599,9175
59160,91683,21878,44128,18344,69805,17776,8600,9176
59165,91687,21879,44129,18345,69808,17776,8600,9176
59170,91697,21883,44136,18349,69813,17778,8602,9176
59175,91703,21885,44140,18351,69816,17780,8603,9177
59180,91714,21888,44141,18353,69825,17782,8603,9179
59185,91718,21890,44142,18355,69828,17782,8603,9179
59190,91728,21894,44144,18357,69834,17784,8603,9181
59195,91734,21894,44146,18357,69838,17786,8603,9183
59200,91745,21898,44154,18361,69846,17788,8605,9183
59205,91749,21900,44157,18363,69848,17788,8605,9183
59210,91759,21902,44162,18365,69855,17790,8605,9185
59215,91765,21905,44165,18368,69860,17792,8606,9186
59220,91776,21907,44172,18370,69868,17794,8607,9187
59225,91780,21908,44174,18371,69871,17794,8607,9187
59230,91790,21910,44178,18372,69878,17796,8607,9189
59235,91796,21911,44182,18373,69883,17798,8607,9191
59240,91807,21912,44188,18374,69894,17800,8608,9192
59245,91811,21913,44190,18375,69898,17800,8608,9192
59250,91821,21915,44197,18377,69905,17802,8609,9193
59255,91827,21915,44202,18377,69910,17804,8611,9193
59260,91838,21916,44205,18377,69922,17806,8612,9194
59265,91842,21917,44208,18378,69924,17806,8612,9194
59270,91852,21917,44211,18378,69935,17808,8613,9195
59275,91858,21917,44212,18378,69941,17810,8614,9196
59280,91869,21918,44215,18378,69951,17812,8615,9197
59285,91873,21919,44217,18379,69954,17812,8615,9197
59290,91883,21919,44222,18379,69963,17814,8616,9198
59295,91889,21919,44225,18379,69970,17816,8617,9199
59300,91900,21919,44229,18379,69980,17818,8618,9200
59305,91904,21919,44233,18379,69984,17818,8618,9200
59310,91914,21920,44239,18380,69994,17820,8619,9201
59315,91920,21920,44245,18380,69998,17822,8621,9201
59320,91931,21921,44247,18381,70009,17824,8622,9202
59325,91935,21921,44250,18381,70013,17824,8622,9202
59330,91945,21922,44255,18381,70022,17826,8623,9203
59335,91951,21922,44257,18381,70029,17828,8624,9204
59340,91962,21922,44262,18381,70038,17830,8625,9205
59345,91966,21923,44263,18382,70042,17830,8625,9205
59350,91976,21925,44268,18383,70051,17832,8626,9206
59355,91982,21925,44271,18383,70056,17834,8627,9207
59360,91993,21926,44275,18384,70067,17836,8627,9209
59365,91997,21926,44275,18384,70071,17836,8627,9209
59370,92007,21928,44280,18385,70079,17838,8628,9210
59375,92013,21928,44284,18385,70085,17840,8629,9211
59380,92024,21929,44288,18386,70095,17842,8630,9212
59385,92028,21929,44289,18386,70098,17842,8630,9212
59390,92038,21931,44295,18387,70107,17844,8632,9212
59395,92044,21931,44300,18387,70111,17846,8634,9212
59400,92055,21936,44304,18392,70119,17848,8634,9214
59405,92059,21937,44305,18393,70122,17848,8634,9214
59410,92069,21940,44309,18394,70129,17850,8636,9214
59415,92075,21940,44310,18394,70134,17852,8636,9216
59420,92086,21943,44315,18397,70142,17854,8637,9217
59425,92090,21944,44317,18398,70145,17854,8637,9217
59430,92100,21950,44321,18403,70150,17856,8637,9219
59435,92106,21950,44321,18403,70156,17858,8637,9221
59440,92117,21952,44327,18405,70164,17860,8638,9222
59445,92121,21953,44329,18406,70167,17860,8638,9222
59450,92131,21958,44333,18409,70172,17862,8639,9223
59455,92137,21959,44336,18410,70177,17864,8641,9223
59460,92148,21962,44340,18413,70184,17866,8641,9225
59465,92152,21964,44340,18415,70188,17866,8641,9225
59470,92162,21967,44343,18417,70194,17868,8641,9227
59475,92168,21969,44346,18419,70198,17870,8642,9228
59480,92179,21972,44352,18422,70206,17872,8644,9228
59485,92183,21975,44356,18425,70206,17872,8644,9228
59490,92193,21981,44361,18429,70210,17874,8645,9229
59495,92199,21983,44363,18431,70215,17876,8646,9230
59500,92210,21986,44369,18434,70221,17878,8647,9231
59505,92214,21989,44371,18437,70223,17878,8647,9231
59510,92224,21993,44374,18439,70230,17880,8648,9232
59515,92230,21994,44375,18440,70236,17882,8648,9234
59520,92241,21996,44380,18441,70245,17884,8649,9235
59525,92245,21996,44380,18441,70249,17884,8649,9235
59530,92255,21998,44384,18442,70257,17886,8650,9236
59535,92261,21998,44384,18442,70263,17888,8650,9238
59540,92272,21999,44390,18443,70271,17890,8651,9239
59545,92276,22001,44393,18445,70274,17890,8651,9239
59550,92286,22002,44396,18445,70283,17892,8652,9240
59555,92292,22004,44398,18447,70288,17894,8653,9241
59560,92303,22006,44405,18448,70296,17896,8655,9241
59565,92307,22008,44409,18450,70298,17896,8655,9241
59570,92317,22010,44416,18452,70306,17898,8657,9241
59575,92323,22012,44418,18454,70310,17900,8657,9243
59580,92334,22015,44423,18456,70317,17902,8658,9244
59585,92338,22018,44425,18459,70320,17902,8658,9244
59590,92348,22020,44429,18460,70327,17904,8659,9245
59595,92354,22021,44432,18461,70333,17906,8660,9246
59600,92365,22023,44436,18462,70342,17908,8660,9248
59605,92369,22024,44439,18463,70344,17908,8660,9248
59610,92379,22027,44444,18466,70352,17910,8661,9249
59615,92385,22028,44446,18467,70356,17912,8661,9251
59620,92396,22032,44452,18470,70363,17914,8661,9253
59625,92400,22034,44453,18472,70366,17914,8661,9253
59630,92410,22037,44459,18475,70372,17916,8661,9255
59635,92416,22038,44462,18476,70377,17918,8662,9256
59640,92427,22039,44465,18476,70388,17920,8662,9258
59645,92431,22040,44466,18477,70391,17920,8662,9258
59650,92441,22042,44470,18478,70399,17922,8663,9259
59655,92447,22042,44473,18478,70404,17924,8664,9260
59660,92458,22045,44477,18480,70412,17926,8664,9262
59665,92462,22045,44478,18480,70416,17926,8664,9262
59670,92472,22048,44481,18483,70424,17928,8664,9264
59675,92478,22048,44483,18483,70429,17930,8664,9266
59680,92489,22052,44488,18486,70437,17932,8665,9267
59685,92493,22054,44491,18488,70438,17932,8665,9267
59690,92503,22059,44496,18492,70444,17934,8666,9268
59695,92509,22059,44500,18492,70448,17936,8667,9269
59700,92520,22064,44507,18496,70455,17938,8669,9269
59705,92524,22067,44510,18499,70456,17938,8669,9269
59710,92534,22070,44514,18502,70464,17940,8670,9270
59715,92540,22070,44514,18502,70470,17942,8670,9272
59720,92551,22073,44520,18504,70477,17944,8670,9274
59725,92555,22074,44522,18505,70480,17944,8670,9274
59730,92565,22078,44528,18508,70487,17946,8672,9274
59735,92571,22078,44532,18508,70493,17948,8674,9274
59740,92582,22079,44538,18508,70503,17950,8675,9275
59745,92586,22079,44538,18508,70507,17950,8675,9275
59750,92596,22081,44543,18509,70514,17952,8675,9277
59755,92602,22082,44545,18510,70520,17954,8676,9278
59760,92613,22083,44550,18511,70530,17956,8678,9278
59765,92617,22083,44552,18511,70533,17956,8678,9278
59770,92627,22086,44558,18514,70540,17958,8679,9279
59775,92633,22087,44559,18515,70545,17960,8679,9281
59780,92644,22089,44561,18516,70555,17962,8681,9281
59785,92648,22089,44561,18516,70559,17962,8681,9281
59790,92658,22090,44564,18516,70567,17964,8681,9283
59795,92664,22092,44566,18518,70572,17966,8682,9284
59800,92675,22094,44574,18520,70579,17968,8683,9285
59805,92679,22096,44575,18522,70583,17968,8683,9285
59810,92689,22098,44580,18524,70590,17970,8684,9286
59815,92695,22099,44583,18525,70595,17972,8685,9287
59820,92706,22100,44587,18525,70606,17974,8686,9288
59825,92710,22101,44588,18526,70609,17974,8686,9288
59830,92720,22103,44592,18528,70617,17976,8687,9289
59835,92726,22103,44593,18528,70623,17978,8688,9290
59840,92737,22105,44597,18529,70631,17980,8688,9292
59845,92741,22107,44599,18531,70633,17980,8688,9292
59850,92751,22113,44604,18536,70638,17982,8689,9293
59855,92757,22113,44606,18536,70642,17984,8689,9295
59860,92768,22118,44611,18541,70649,17986,8690,9296
59865,92772,22120,44612,18543,70652,17986,8690,9296
59870,92782,22123,44617,18545,70659,17988,8691,9297
59875,92788,22124,44621,18546,70663,17990,8693,9297
59880,92799,22127,44625,18548,70670,17992,8694,9298
59885,92803,22129,44626,18550,70674,17992,8694,9298
59890,92813,22133,44629,18552,70680,17994,8695,9299
59895,92819,22133,44630,18552,70685,17996,8695,9301
59900,92830,22138,44637,18557,70690,17998,8696,9302
59905,92834,22141,44639,18560,70692,17998,8696,9302
59910,92844,22147,44645,18566,70697,18000,8696,9304
59915,92850,22147,44646,18566,70703,18002,8696,9306
59920,92861,22148,44650,18566,70711,18004,8696,9308
59925,92865,22151,44651,18569,70714,18004,8696,9308
59930,92875,22154,44655,18571,70721,18006,8697,9309
59935,92881,22155,44659,18572,70725,18008,8698,9310
59940,92892,22158,44663,18575,70733,18010,8698,9312
59945,92896,22158,44666,18575,70737,18010,8698,9312
59950,92906,22160,44670,18577,70745,18012,8698,9314
59955,92912,22162,44674,18579,70749,18014,8699,9315
59960,92923,22164,44678,18580,70757,18016,8700,9316
59965,92927,22166,44680,18582,70761,18016,8700,9316
59970,92937,22168,44681,18583,70769,18018,8700,9318
59975,92943,22169,44686,18584,70773,18020,8702,9318
59980,92954,22171,44691,18586,70781,18022,8704,9318
59985,92958,22172,44694,18587,70785,18022,8704,9318
59990,92968,22176,44701,18591,70792,18024,8705,9319
59995,92974,22176,44703,18591,70798,18026,8706,9320
60000,92985,22177,44705,18591,70806,18028,8707,9321
60005,92989,22179,44707,18593,70809,18028,8707,9321
60010,92999,22181,44710,18593,70818,18030,8708,9322
60015,93005,22181,44712,18593,70823,18032,8709,9323
60020,93016,22183,44716,18594,70831,18034,8710,9324
60025,93020,22185,44717,18596,70834,18034,8710,9324
60030,93030,22189,44722,18599,70840,18036,8712,9324
60035,93036,22190,44723,18600,70845,18038,8712,9326
60040,93047,22193,44728,18602,70852,18040,8714,9326
60045,93051,22194,44729,18603,70856,18040,8714,9326
60050,93061,22200,44735,18608,70861,18042,8715,9327
60055,93067,22201,44738,18609,70865,18044,8716,9328
60060,93078,22205,44744,18613,70873,18046,8716,9330
60065,93082,22206,44745,18614,70876,18046,8716,9330
60070,93092,22210,44751,18617,70882,18048,8718,9330
60075,93098,22211,44756,18618,70885,18050,8720,9330
60080,93109,22216,44762,18623,70893,18052,8721,9331
60085,93113,22216,44763,18623,70897,18052,8721,9331
60090,93123,22219,44769,18626,70904,18054,8723,9331
60095,93129,22219,44772,18626,70908,18056,8723,9333
60100,93140,22220,44777,18626,70920,18058,8724,9334
60105,93144,22220,44778,18626,70923,18058,8724,9334
60110,93154,22221,44780,18627,70933,18060,8724,9336
60115,93160,22221,44783,18627,70938,18062,8726,9336
60120,93171,22223,44791,18628,70948,18064,8727,9337
60125,93175,22223,44793,18628,70951,18064,8727,9337
60130,93185,22226,44798,18630,70959,18066,8728,9338
60135,93191,22226,44799,18630,70964,18068,8728,9340
60140,93202,22227,44805,18630,70975,18070,8730,9340
60145,93206,22228,44808,18631,70978,18070,8730,9340
60150,93216,22230,44812,18632,70986,18072,8731,9341
60155,93222,22230,44814,18632,70991,18074,8732,9342
60160,93233,22231,44819,18632,71002,18076,8733,9343
60165,93237,22232,44821,18633,71005,18076,8733,9343
60170,93247,22233,44824,18633,71014,18078,8733,9345
60175,93253,22234,44828,18634,71018,18080,8734,9346
60180,93264,22236,44835,18636,71028,18082,8735,9347
60185,93268,22236,44837,18636,71031,18082,8735,9347
60190,93278,22240,44842,18639,71038,18084,8737,9347
60195,93284,22241,44845,18640,71042,18086,8738,9348
60200,93295,22242,44851,18641,71052,18088,8740,9348
60205,93299,22244,44854,18643,71054,18088,8740,9348
60210,93309,22248,44859,18646,71061,18090,8742,9348
60215,93315,22249,44863,18647,71065,18092,8744,9348
60220,93326,22250,44868,18647,71076,18094,8746,9348
60225,93330,22250,44870,18647,71079,18094,8746,9348
60230,93340,22255,44874,18651,71085,18096,8747,9349
60235,93346,22255,44875,18651,71090,18098,8747,9351
60240,93357,22258,44883,18654,71099,18100,8749,9351
60245,93361,22259,44886,18655,71100,18100,8749,9351
60250,93371,22265,44889,18659,71106,18102,8750,9352
60255,93377,22266,44893,18660,71108,18104,8751,9353
60260,93388,22269,44899,18663,71118,18106,8752,9354
60265,93392,22271,44900,18665,71121,18106,8752,9354
60270,93402,22276,44907,18670,71126,18108,8754,9354
60275,93408,22276,44911,18670,71130,18110,8756,9354
60280,93419,22281,44918,18674,71137,18112,8757,9355
60285,93423,22283,44920,18676,71139,18112,8757,9355
60290,93433,22288,44923,18679,71145,18114,8758,9356
60295,93439,22288,44925,18679,71149,18116,8759,9357
60300,93450,22291,44929,18681,71159,18118,8760,9358
60305,93454,22293,44932,18683,71160,18118,8760,9358
60310,93464,22298,44938,18688,71166,18120,8762,9358
60315,93470,22298,44943,18688,71169,18122,8764,9358
60320,93481,22301,44950,18691,71180,18124,8765,9359
60325,93485,22302,44953,18692,71183,18124,8765,9359
60330,93495,22304,44957,18694,71191,18126,8765,9361
60335,93501,22305,44959,18695,71195,18128,8765,9363
60340,93512,22306,44967,18696,71206,18130,8766,9364
60345,93516,22307,44969,18697,71209,18130,8766,9364
60350,93526,22309,44973,18698,71217,18132,8767,9365
60355,93532,22309,44977,18698,71221,18134,8769,9365
60360,93543,22310,44985,18699,71233,18136,8771,9365
60365,93547,22311,44988,18700,71235,18136,8771,9365
60370,93557,22314,44994,18703,71243,18138,8771,9367
60375,93563,22314,44997,18703,71247,18140,8772,9368
60380,93574,22315,45002,18703,71259,18142,8774,9368
60385,93578,22315,45005,18703,71262,18142,8774,9368
60390,93588,22317,45009,18705,71271,18144,8774,9370
60395,93594,22318,45013,18706,71275,18146,8776,9370
60400,93605,22320,45019,18708,71285,18148,8776,9372
60405,93609,22320,45020,18708,71289,18148,8776,9372
60410,93619,22321,45025,18708,71298,18150,8778,9372
60415,93625,22321,45028,18708,71302,18152,8779,9373
60420,93636,22323,45033,18709,71313,18154,8780,9374
60425,93640,22324,45034,18710,71316,18154,8780,9374
60430,93650,22327,45037,18711,71323,18156,8780,9376
60435,93656,22327,45039,18711,71328,18158,8780,9378
60440,93667,22329,45045,18713,71337,18160,8780,9380
60445,93671,22331,45048,18715,71338,18160,8780,9380
60450,93681,22335,45053,18717,71346,18162,8782,9380
60455,93687,22336,45058,18718,71349,18164,8784,9380
60460,93698,22338,45063,18720,71360,18166,8785,9381
60465,93702,22338,45065,18720,71362,18166,8785,9381
60470,93712,22341,45070,18721,71371,18168,8786,9382
60475,93718,22341,45072,18721,71375,18170,8787,9383
60480,93729,22344,45078,18724,71384,18172,8787,9385
60485,93733,22346,45081,18726,71385,18172,8787,9385
60490,93743,22349,45085,18729,71394,18174,8788,9386
60495,93749,22350,45089,18730,71397,18176,8789,9387
60500,93760,22353,45095,18733,71406,18178,8790,9388
60505,93764,22354,45097,18734,71409,18178,8790,9388
60510,93774,22357,45101,18735,71417,18180,8791,9389
60515,93780,22357,45103,18735,71421,18182,8792,9390
60520,93791,22359,45107,18736,71432,18184,8793,9391
60525,93795,22361,45110,18738,71433,18184,8793,9391
60530,93805,22366,45117,18742,71439,18186,8795,9391
60535,93811,22366,45120,18742,71443,18188,8796,9392
60540,93822,22370,45126,18746,71451,18190,8796,9394
60545,93826,22372,45128,18748,71453,18190,8796,9394
60550,93836,22376,45132,18751,71460,18192,8797,9395
60555,93842,22376,45134,18751,71465,18194,8798,9396
60560,93853,22377,45136,18751,71476,18196,8798,9398
60565,93857,22378,45137,18752,71479,18196,8798,9398
60570,93867,22380,45142,18754,71487,18198,8799,9399
60575,93873,22381,45147,18755,71490,18200,8801,9399
60580,93884,22383,45155,18757,71501,18202,8802,9400
60585,93888,22383,45157,18757,71504,18202,8802,9400
60590,93898,22385,45165,18759,71513,18204,8803,9401
60595,93904,22386,45170,18760,71516,18206,8804,9402
60600,93915,22388,45173,18761,71527,18208,8804,9404
60605,93919,22388,45173,18761,71531,18208,8804,9404
60610,93929,22389,45180,18762,71540,18210,8806,9404
60615,93935,22390,45184,18763,71543,18212,8807,9405
60620,93946,22392,45189,18764,71554,18214,8808,9406
60625,93950,22392,45191,18764,71558,18214,8808,9406
60630,93960,22394,45195,18765,71566,18216,8808,9408
60635,93966,22395,45198,18766,71570,18218,8810,9408
60640,93977,22397,45204,18768,71580,18220,8810,9410
60645,93981,22398,45206,18769,71583,18220,8810,9410
60650,93991,22400,45211,18771,71591,18222,8810,9412
60655,93997,22401,45214,18772,71595,18224,8811,9413
60660,94008,22404,45221,18775,71604,18226,8812,9414
60665,94012,22404,45223,18775,71606,18226,8812,9414
60670,94022,22409,45227,18779,71613,18228,8813,9415
60675,94028,22409,45230,18779,71618,18230,8814,9416
60680,94039,22411,45237,18780,71628,18232,8816,9416
60685,94043,22411,45239,18780,71631,18232,8816,9416
60690,94053,22414,45242,18781,71639,18234,8816,9418
60695,94059,22414,45243,18781,71643,18236,8816,9420
60700,94070,22417,45250,18783,71652,18238,8817,9421
60705,94074,22419,45252,18785,71654,18238,8817,9421
60710,94084,22423,45258,18788,71661,18240,8817,9423
60715,94090,22424,45260,18789,71665,18242,8818,9424
60720,94101,22425,45267,18790,71675,18244,8820,9424
60725,94105,22427,45270,18792,71677,18244,8820,9424
60730,94115,22431,45275,18795,71684,18246,8821,9425
60735,94121,22432,45278,18796,71688,18248,8822,9426
60740,94132,22433,45283,18797,71698,18250,8823,9427
60745,94136,22434,45284,18798,71701,18250,8823,9427
60750,94146,22437,45289,18800,71709,18252,8824,9428
60755,94152,22437,45293,18800,71713,18254,8826,9428
60760,94163,22439,45297,18802,71723,18256,8826,9430
60765,94167,22441,45301,18804,71725,18256,8826,9430
60770,94177,22444,45304,18806,71733,18258,8827,9431
60775,94183,22445,45307,18807,71736,18260,8828,9432
60780,94194,22447,45314,18808,71746,18262,8830,9432
60785,94198,22449,45315,18810,71749,18262,8830,9432
60790,94208,22452,45319,18812,71756,18264,8831,9433
60795,94214,22452,45321,18812,71761,18266,8833,9433
60800,94225,22454,45327,18813,71770,18268,8834,9434
60805,94229,22456,45328,18815,71773,18268,8834,9434
60810,94239,22460,45333,18818,71779,18270,8835,9435
60815,94245,22461,45335,18819,71783,18272,8835,9437
60820,94256,22464,45341,18822,71792,18274,8836,9438
60825,94260,22466,45343,18824,71794,18274,8836,9438
60830,94270,22469,45351,18827,71801,18276,8838,9438
60835,94276,22469,45354,18827,71806,18278,8840,9438
60840,94287,22471,45357,18828,71816,18280,8841,9439
60845,94291,22472,45359,18829,71818,18280,8841,9439
60850,94301,22477,45365,18834,71824,18282,8842,9440
60855,94307,22478,45368,18835,71828,18284,8843,9441
60860,94318,22481,45376,18838,71836,18286,8844,9442
60865,94322,22483,45378,18840,71838,18286,8844,9442
60870,94332,22488,45383,18844,71844,18288,8845,9443
60875,94338,22489,45388,18845,71848,18290,8847,9443
60880,94349,22491,45393,18847,71858,18292,8848,9444
60885,94353,22491,45394,18847,71862,18292,8848,9444
60890,94363,22493,45400,18848,71870,18294,8849,9445
60895,94369,22493,45402,18848,71875,18296,8850,9446
60900,94380,22494,45406,18848,71886,18298,8850,9448
60905,94384,22494,45408,18848,71889,18298,8850,9448
60910,94394,22496,45413,18849,71898,18300,8851,9449
60915,94400,22497,45418,18850,71901,18302,8853,9449
60920,94411,22499,45422,18851,71912,18304,8854,9450
60925,94415,22499,45424,18851,71915,18304,8854,9450
60930,94425,22500,45429,18851,71925,18306,8856,9450
60935,94431,22500,45432,18851,71930,18308,8858,9450
60940,94442,22501,45436,18851,71941,18310,8859,9451
60945,94446,22501,45439,18851,71944,18310,8859,9451
60950,94456,22503,45448,18853,71953,18312,8861,9451
60955,94462,22504,45452,18854,71956,18314,8862,9452
60960,94473,22506,45457,18855,71967,18316,8862,9454
60965,94477,22507,45460,18856,71969,18316,8862,9454
60970,94487,22508,45463,18856,71979,18318,8863,9455
60975,94493,22509,45468,18857,71983,18320,8865,9455
60980,94504,22510,45469,18857,71994,18322,8865,9457
60985,94508,22510,45472,18857,71996,18322,8865,9457
60990,94518,22513,45473,18858,72005,18324,8865,9459
60995,94524,22514,45476,18859,72009,18326,8866,9460
61000,94535,22516,45484,18861,72018,18328,8868,9460
61005,94539,22517,45487,18862,72020,18328,8868,9460
61010,94549,22520,45491,18865,72029,18330,8869,9461
61015,94555,22520,45493,18865,72034,18332,8870,9462
61020,94566,22522,45500,18866,72044,18334,8871,9463
61025,94570,22522,45500,18866,72048,18334,8871,9463
61030,94580,22525,45505,18868,72055,18336,8871,9465
61035,94586,22526,45508,18869,72059,18338,8872,9466
61040,94597,22527,45516,18869,72069,18340,8874,9466
61045,94601,22529,45519,18871,72071,18340,8874,9466
61050,94611,22531,45523,18872,72080,18342,8874,9468
61055,94617,22532,45527,18873,72083,18344,8875,9469
61060,94628,22534,45528,18874,72094,18346,8875,9471
61065,94632,22534,45529,18874,72098,18346,8875,9471
61070,94642,22537,45534,18876,72105,18348,8876,9472
61075,94648,22538,45539,18877,72108,18350,8878,9472
61080,94659,22542,45544,18880,72117,18352,8878,9474
61085,94663,22544,45548,18882,72117,18352,8878,9474
61090,94673,22548,45551,18886,72125,18354,8879,9475
61095,94679,22548,45554,18886,72129,18356,8880,9476
61100,94690,22551,45560,18889,72139,18358,8881,9477
61105,94694,22552,45561,18890,72142,18358,8881,9477
61110,94704,22555,45566,18891,72149,18360,8883,9477
61115,94710,22555,45568,18891,72154,18362,8884,9478
61120,94721,22557,45572,18892,72163,18364,8885,9479
61125,94725,22559,45574,18894,72165,18364,8885,9479
61130,94735,22564,45579,18898,72171,18366,8886,9480
61135,94741,22565,45582,18899,72173,18368,8886,9482
61140,94752,22569,45589,18902,72182,18370,8887,9483
61145,94756,22572,45592,18905,72183,18370,8887,9483
61150,94766,22577,45597,18909,72189,18372,8888,9484
61155,94772,22577,45599,18909,72194,18374,8889,9485
61160,94783,22578,45604,18910,72205,18376,8891,9485
61165,94787,22579,45606,18911,72208,18376,8891,9485
61170,94797,22582,45613,18914,72215,18378,8892,9486
61175,94803,22583,45617,18915,72218,18380,8893,9487
61180,94814,22585,45621,18916,72229,18382,8894,9488
61185,94818,22585,45623,18916,72232,18382,8894,9488
61190,94828,22588,45630,18919,72240,18384,8895,9489
61195,94834,22588,45634,18919,72244,18386,8897,9489
61200,94845,22590,45641,18921,72254,18388,8898,9490
61205,94849,22592,45643,18923,72256,18388,8898,9490
61210,94859,22596,45645,18925,72263,18390,8898,9492
61215,94865,22596,45648,18925,72268,18392,8899,9493
61220,94876,22597,45653,18925,72279,18394,8901,9493
61225,94880,22598,45654,18926,72282,18394,8901,9493
61230,94890,22600,45658,18928,72290,18396,8902,9494
61235,94896,22601,45664,18929,72293,18398,8904,9494
61240,94907,22604,45669,18931,72302,18400,8904,9496
61245,94911,22606,45672,18933,72304,18400,8904,9496
61250,94921,22608,45679,18935,72313,18402,8905,9497
61255,94927,22608,45681,18935,72318,18404,8905,9499
61260,94938,22610,45687,18936,72328,18406,8905,9501
61265,94942,22611,45690,18937,72330,18406,8905,9501
61270,94952,22613,45696,18939,72339,18408,8907,9501
61275,94958,22613,45699,18939,72343,18410,8908,9502
61280,94969,22615,45706,18941,72354,18412,8908,9504
61285,94973,22615,45708,18941,72358,18412,8908,9504
61290,94983,22616,45714,18942,72367,18414,8910,9504
61295,94989,22617,45720,18943,72370,18416,8912,9504
61300,95000,22619,45726,18945,72381,18418,8913,9505
61305,95004,22619,45728,18945,72384,18418,8913,9505
61310,95014,22620,45732,18945,72394,18420,8914,9506
61315,95020,22620,45735,18945,72398,18422,8915,9507
61320,95031,22621,45737,18946,72410,18424,8915,9509
61325,95035,22622,45739,18947,72413,18424,8915,9509
61330,95045,22623,45746,18948,72422,18426,8916,9510
61335,95051,22624,45750,18949,72426,18428,8917,9511
61340,95062,22625,45757,18950,72437,18430,8918,9512
61345,95066,22625,45758,18950,72441,18430,8918,9512
61350,95076,22628,45766,18953,72448,18432,8920,9512
61355,95082,22629,45768,18954,72453,18434,8921,9513
61360,95093,22631,45774,18956,72461,18436,8922,9514
61365,95097,22632,45775,18957,72464,18436,8922,9514
61370,95107,22636,45780,18960,72471,18438,8924,9514
61375,95113,22637,45785,18961,72474,18440,8926,9514
61380,95124,22640,45789,18963,72483,18442,8926,9516
61385,95128,22641,45791,18964,72485,18442,8926,9516
61390,95138,22645,45794,18967,72493,18444,8927,9517
61395,95144,22646,45797,18968,72496,18446,8927,9519
61400,95155,22650,45802,18972,72505,18448,8928,9520
61405,95159,22651,45804,18972,72506,18448,8928,9520
61410,95169,22657,45809,18977,72512,18450,8928,9522
61415,95175,22658,45811,18978,72516,18452,8928,9524
61420,95186,22660,45815,18980,72526,18454,8928,9526
61425,95190,22661,45816,18981,72529,18454,8928,9526
61430,95200,22664,45818,18982,72536,18456,8928,9528
61435,95206,22664,45820,18982,72540,18458,8928,9530
61440,95217,22668,45826,18985,72548,18460,8930,9530
61445,95221,22670,45827,18987,72551,18460,8930,9530
61450,95231,22672,45830,18987,72559,18462,8930,9532
61455,95237,22672,45832,18987,72564,18464,8930,9534
61460,95248,22674,45837,18989,72574,18466,8931,9535
61465,95252,22675,45838,18990,72577,18466,8931,9535
61470,95262,22677,45847,18992,72585,18468,8933,9535
61475,95268,22678,45850,18993,72588,18470,8933,9537
61480,95279,22680,45854,18995,72599,18472,8934,9538
61485,95283,22681,45856,18996,72601,18472,8934,9538
61490,95293,22685,45863,18999,72608,18474,8936,9538
61495,95299,22685,45867,18999,72613,18476,8938,9538
61500,95310,22687,45875,19001,72622,18478,8940,9538
61505,95314,22689,45878,19003,72624,18478,8940,9538
61510,95324,22692,45881,19005,72632,18480,8940,9540
61515,95330,22693,45883,19006,72636,18482,8940,9542
61520,95341,22696,45888,19008,72645,18484,8941,9543
61525,95345,22697,45889,19008,72648,18484,8941,9543
61530,95355,22699,45892,19009,72656,18486,8942,9544
61535,95361,22700,45895,19010,72660,18488,8942,9546
61540,95372,22701,45898,19010,72671,18490,8943,9547
61545,95376,22702,45899,19010,72673,18490,8943,9547
61550,95386,22706,45905,19014,72680,18492,8944,9548
61555,95392,22707,45907,19015,72684,18494,8944,9550
61560,95403,22709,45914,19017,72693,18496,8946,9550
61565,95407,22712,45917,19020,72694,18496,8946,9550
61570,95417,22716,45921,19022,72701,18498,8948,9550
61575,95423,22716,45923,19022,72706,18500,8949,9551
61580,95434,22718,45930,19024,72715,18502,8949,9553
61585,95438,22720,45933,19026,72716,18502,8949,9553
61590,95448,22725,45937,19029,72723,18504,8951,9553
61595,95454,22725,45939,19029,72728,18506,8952,9554
61600,95465,22726,45948,19029,72739,18508,8954,9554
61605,95469,22727,45952,19030,72741,18508,8954,9554
61610,95479,22729,45959,19032,72750,18510,8956,9554
61615,95485,22729,45963,19032,72754,18512,8958,9554
61620,95496,22731,45967,19034,72765,18514,8959,9555
61625,95500,22732,45969,19034,72767,18514,8959,9555
61630,95510,22733,45973,19034,72777,18516,8960,9556
61635,95516,22733,45977,19034,72781,18518,8961,9557
61640,95527,22734,45981,19034,72793,18520,8962,9558
61645,95531,22735,45983,19035,72796,18520,8962,9558
61650,95541,22736,45987,19035,72805,18522,8962,9560
61655,95547,22737,45990,19036,72809,18524,8962,9562
61660,95558,22738,45995,19036,72820,18526,8963,9563
61665,95562,22739,45997,19036,72823,18526,8963,9563
61670,95572,22741,46003,19038,72831,18528,8964,9564
61675,95578,22742,46006,19039,72836,18530,8965,9565
61680,95589,22743,46011,19039,72846,18532,8966,9566
61685,95593,22744,46013,19039,72849,18532,8966,9566
61690,95603,22745,46019,19040,72858,18534,8967,9567
61695,95609,22745,46022,19040,72863,18536,8969,9567
61700,95620,22748,46028,19042,72871,18538,8971,9567
61705,95624,22751,46031,19044,72872,18538,8971,9567
61710,95634,22754,46036,19047,72880,18540,8971,9569
61715,95640,22754,46036,19047,72886,18542,8971,9571
61720,95651,22756,46043,19049,72894,18544,8972,9572
61725,95655,22759,46046,19052,72895,18544,8972,9572
61730,95665,22762,46050,19054,72903,18546,8973,9573
61735,95671,22763,46055,19055,72906,18548,8975,9573
61740,95682,22765,46063,19056,72916,18550,8976,9574
61745,95686,22767,46065,19057,72917,18550,8976,9574
61750,95696,22772,46069,19060,72924,18552,8978,9574
61755,95702,22773,46072,19061,72928,18554,8979,9575
61760,95713,22776,46078,19064,72936,18556,8979,9577
61765,95717,22779,46081,19066,72936,18556,8979,9577
61770,95727,22784,46085,19070,72943,18558,8980,9578
61775,95733,22785,46088,19071,72947,18560,8981,9579
61780,95744,22788,46093,19073,72956,18562,8983,9579
61785,95748,22789,46095,19074,72958,18562,8983,9579
61790,95758,22794,46100,19079,72964,18564,8984,9580
61795,95764,22794,46104,19079,72968,18566,8986,9580
61800,95775,22797,46112,19082,72977,18568,8988,9580
61805,95779,22799,46115,19084,72979,18568,8988,9580
61810,95789,22801,46118,19085,72988,18570,8988,9582
61815,95795,22802,46121,19086,72992,18572,8989,9583
61820,95806,22804,46128,19087,73002,18574,8989,9585
61825,95810,22805,46130,19088,73004,18574,8989,9585
61830,95820,22805,46136,19088,73015,18576,8990,9586
61835,95826,22805,46140,19088,73020,18578,8992,9586
61840,95837,22806,46146,19089,73031,18580,8993,9587
61845,95841,22807,46147,19089,73034,18580,8993,9587
61850,95851,22807,46153,19089,73044,18582,8994,9588
61855,95857,22807,46157,19089,73048,18584,8995,9589
61860,95868,22808,46160,19089,73060,18586,8995,9591
61865,95872,22809,46162,19090,73062,18586,8995,9591
61870,95882,22809,46167,19090,73073,18588,8995,9593
61875,95888,22809,46171,19090,73078,18590,8996,9594
61880,95899,22810,46176,19091,73089,18592,8997,9595
61885,95903,22811,46180,19092,73091,18592,8997,9595
61890,95913,22811,46186,19092,73102,18594,8998,9596
61895,95919,22811,46189,19092,73107,18596,8999,9597
61900,95930,22812,46193,19092,73118,18598,8999,9599
61905,95934,22813,46195,19093,73121,18598,8999,9599
61910,95944,22815,46200,19095,73129,18600,8999,9601
61915,95950,22815,46201,19095,73134,18602,8999,9603
61920,95961,22817,46206,19097,73144,18604,9000,9604
61925,95965,22819,46208,19098,73145,18604,9000,9604
61930,95975,22824,46214,19102,73151,18606,9002,9604
61935,95981,22825,46216,19103,73156,18608,9003,9605
61940,95992,22826,46219,19103,73165,18610,9003,9607
61945,95996,22828,46220,19104,73167,18610,9003,9607
61950,96006,22832,46224,19106,73174,18612,9003,9609
61955,96012,22832,46226,19106,73179,18614,9004,9610
61960,96023,22835,46232,19108,73188,18616,9006,9610
61965,96027,22837,46233,19109,73190,18616,9006,9610
61970,96037,22839,46235,19111,73198,18618,9006,9612
61975,96043,22839,46237,19111,73202,18620,9006,9614
61980,96054,22842,46245,19114,73211,18622,9007,9615
61985,96058,22844,46246,19116,73214,18622,9007,9615
61990,96068,22849,46253,19120,73219,18624,9009,9615
61995,96074,22849,46254,19120,73224,18626,9009,9617
62000,96085,22852,46259,19122,73233,18628,9011,9617
62005,96089,22853,46261,19123,73235,18628,9011,9617
62010,96099,22857,46269,19127,73242,18630,9013,9617
62015,96105,22857,46271,19127,73247,18632,9014,9618
62020,96116,22860,46278,19130,73255,18634,9015,9619
62025,96120,22862,46279,19131,73257,18634,9015,9619
62030,96130,22867,46284,19134,73263,18636,9017,9619
62035,96136,22867,46286,19134,73268,18638,9018,9620
62040,96147,22870,46291,19136,73276,18640,9019,9621
62045,96151,22872,46292,19137,73278,18640,9019,9621
62050,96161,22876,46295,19140,73285,18642,9019,9623
62055,96167,22877,46299,19141,73289,18644,9019,9625
62060,96178,22879,46305,19142,73299,18646,9020,9626
62065,96182,22880,46307,19143,73302,18646,9020,9626
62070,96192,22882,46312,19144,73310,18648,9021,9627
62075,96198,22883,46317,19145,73314,18650,9023,9627
62080,96209,22884,46320,19145,73325,18652,9024,9628
62085,96213,22885,46322,19145,73327,18652,9024,9628
62090,96223,22887,46328,19146,73336,18654,9026,9628
62095,96229,22888,46330,19147,73340,18656,9026,9630
62100,96240,22889,46332,19147,73351,18658,9026,9632
62105,96244,22890,46334,19147,73353,18658,9026,9632
62110,96254,22891,46339,19148,73363,18660,9027,9633
62115,96260,22892,46342,19149,73367,18662,9028,9634
62120,96271,22893,46347,19150,73378,18664,9029,9635
62125,96275,22894,46349,19151,73381,18664,9029,9635
62130,96285,22896,46351,19152,73389,18666,9030,9636
62135,96291,22897,46353,19153,73394,18668,9031,9637
62140,96302,22899,46358,19154,73403,18670,9033,9637
62145,96306,22900,46361,19155,73406,18670,9033,9637
62150,96316,22901,46365,19155,73415,18672,9034,9638
62155,96322,22901,46368,19155,73419,18674,9035,9639
62160,96333,22905,46374,19159,73427,18676,9035,9641
62165,96337,22908,46377,19162,73428,18676,9035,9641
62170,96347,22912,46380,19164,73435,18678,9035,9643
62175,96353,22912,46383,19164,73439,18680,9036,9644
62180,96364,22916,46388,19167,73448,18682,9037,9645
62185,96368,22918,46390,19169,73450,18682,9037,9645
62190,96378,22921,46394,19171,73457,18684,9038,9646
62195,96384,22921,46396,19171,73462,18686,9039,9647
62200,96395,22923,46401,19173,73471,18688,9039,9649
62205,96399,22925,46404,19175,73472,18688,9039,9649
62210,96409,22930,46407,19180,73479,18690,9039,9651
62215,96415,22930,46410,19180,73484,18692,9041,9651
62220,96426,22933,46417,19183,73493,18694,9042,9652
62225,96430,22935,46418,19184,73495,18694,9042,9652
62230,96440,22939,46424,19187,73501,18696,9044,9652
62235,96446,22939,46426,19187,73505,18698,9044,9654
62240,96457,22941,46435,19189,73516,18700,9045,9655
62245,96461,22942,46438,19189,73518,18700,9045,9655
62250,96471,22944,46443,19190,73527,18702,9046,9656
62255,96477,22944,46444,19190,73532,18704,9046,9658
62260,96488,22946,46449,19191,73542,18706,9047,9659
62265,96492,22947,46452,19192,73544,18706,9047,9659
62270,96502,22949,46457,19193,73553,18708,9049,9659
62275,96508,22949,46459,19193,73559,18710,9050,9660
62280,96519,22950,46465,19193,73569,18712,9052,9660
62285,96523,22951,46468,19194,73572,18712,9052,9660
62290,96533,22952,46471,19194,73581,18714,9053,9661
62295,96539,22953,46475,19195,73585,18716,9054,9662
62300,96550,22955,46481,19196,73595,18718,9055,9663
62305,96554,22956,46484,19196,73597,18718,9055,9663
62310,96564,22957,46488,19197,73607,18720,9056,9664
62315,96570,22958,46492,19198,73611,18722,9057,9665
62320,96581,22960,46498,19200,73621,18724,9058,9666
62325,96585,22961,46500,19200,73624,18724,9058,9666
62330,96595,22962,46505,19200,73633,18726,9059,9667
62335,96601,22962,46507,19200,73638,18728,9060,9668
62340,96612,22964,46516,19202,73647,18730,9061,9669
62345,96616,22966,46518,19204,73650,18730,9061,9669
62350,96626,22969,46522,19205,73657,18732,9062,9670
62355,96632,22969,46525,19205,73662,18734,9063,9671
62360,96643,22972,46532,19208,73670,18736,9064,9672
62365,96647,22975,46534,19211,73672,18736,9064,9672
62370,96657,22978,46540,19213,73679,18738,9065,9673
62375,96663,22979,46545,19214,73683,18740,9067,9673
62380,96674,22980,46550,19214,73694,18742,9068,9674
62385,96678,22982,46553,19216,73695,18742,9068,9674
62390,96688,22986,46560,19220,73702,18744,9068,9676
62395,96694,22987,46565,19221,73706,18746,9070,9676
62400,96705,22988,46571,19222,73716,18748,9070,9678
62405,96709,22991,46572,19224,73718,18748,9070,9678
62410,96719,22994,46577,19225,73725,18750,9070,9680
62415,96725,22995,46582,19226,73728,18752,9072,9680
62420,96736,22998,46586,19228,73738,18754,9074,9680
62425,96740,22999,46586,19228,73741,18754,9074,9680
62430,96750,23002,46590,19229,73748,18756,9075,9681
62435,96756,23002,46592,19229,73753,18758,9076,9682
62440,96767,23005,46595,19231,73762,18760,9076,9684
62445,96771,23007,46596,19232,73764,18760,9076,9684
62450,96781,23010,46599,19234,73771,18762,9077,9685
62455,96787,23010,46601,19234,73776,18764,9078,9686
62460,96798,23012,46605,19236,73786,18766,9078,9688
62465,96802,23013,46607,19237,73788,18766,9078,9688
62470,96812,23018,46613,19241,73794,18768,9078,9690
62475,96818,23019,46616,19242,73798,18770,9079,9691
62480,96829,23021,46620,19243,73807,18772,9081,9691
62485,96833,23024,46622,19246,73809,18772,9081,9691
62490,96843,23027,46627,19249,73816,18774,9082,9692
62495,96849,23028,46630,19250,73820,18776,9083,9693
62500,96860,23031,46633,19252,73829,18778,9084,9694
62505,96864,23033,46635,19253,73830,18778,9084,9694
62510,96874,23039,46641,19258,73835,18780,9084,9696
62515,96880,23040,46644,19259,73839,18782,9085,9697
62520,96891,23043,46651,19261,73848,18784,9086,9698
62525,96895,23044,46653,19261,73850,18784,9086,9698
62530,96905,23046,46658,19262,73859,18786,9087,9699
62535,96911,23046,46661,19262,73863,18788,9088,9700
62540,96922,23048,46670,19263,73874,18790,9090,9700
62545,96926,23049,46673,19263,73876,18790,9090,9700
62550,96936,23051,46679,19265,73885,18792,9092,9700
62555,96942,23052,46681,19266,73890,18794,9092,9702
62560,96953,23054,46687,19268,73899,18796,9093,9703
62565,96957,23055,46688,19268,73902,18796,9093,9703
62570,96967,23057,46696,19270,73910,18798,9094,9704
62575,96973,23058,46700,19271,73913,18800,9095,9705
62580,96984,23060,46705,19273,73924,18802,9096,9706
62585,96988,23061,46707,19273,73926,18802,9096,9706
62590,96998,23062,46711,19273,73936,18804,9097,9707
62595,97004,23063,46714,19274,73940,18806,9098,9708
62600,97015,23064,46718,19274,73951,18808,9099,9709
62605,97019,23065,46721,19275,73954,18808,9099,9709
62610,97029,23067,46725,19277,73962,18810,9100,9710
62615,97035,23067,46728,19277,73967,18812,9101,9711
62620,97046,23069,46732,19279,73977,18814,9102,9712
62625,97050,23070,46733,19280,73980,18814,9102,9712
62630,97060,23073,46741,19282,73987,18816,9103,9713
62635,97066,23073,46743,19282,73993,18818,9104,9714
62640,97077,23075,46750,19284,74002,18820,9106,9714
62645,97081,23076,46753,19285,74004,18820,9106,9714
62650,97091,23078,46755,19286,74013,18822,9107,9715
62655,97097,23078,46759,19286,74018,18824,9108,9716
62660,97108,23079,46765,19286,74029,18826,9110,9716
62665,97112,23080,46768,19287,74030,18826,9110,9716
62670,97122,23082,46771,19288,74040,18828,9111,9717
62675,97128,23082,46776,19288,74044,18830,9113,9717
62680,97139,23084,46780,19290,74055,18832,9113,9719
62685,97143,23085,46782,19290,74056,18832,9113,9719
62690,97153,23090,46787,19294,74063,18834,9114,9720
62695,97159,23090,46791,19294,74067,18836,9115,9721
62700,97170,23093,46795,19297,74077,18838,9116,9722
62705,97174,23095,46799,19299,74077,18838,9116,9722
62710,97184,23099,46803,19302,74085,18840,9117,9723
62715,97190,23099,46804,19302,74091,18842,9117,9725
62720,97201,23100,46809,19303,74101,18844,9117,9727
62725,97205,23102,46811,19304,74102,18844,9117,9727
62730,97215,23105,46818,19306,74110,18846,9119,9727
62735,97221,23105,46821,19306,74115,18848,9120,9728
62740,97232,23107,46826,19308,74125,18850,9121,9729
62745,97236,23109,46830,19310,74125,18850,9121,9729
62750,97246,23116,46835,19316,74130,18852,9121,9731
62755,97252,23116,46836,19316,74135,18854,9121,9733
62760,97263,23118,46842,19318,74145,18856,9123,9733
62765,97267,23119,46843,19319,74148,18856,9123,9733
62770,97277,23121,46847,19320,74156,18858,9124,9734
62775,97283,23122,46851,19321,74159,18860,9125,9735
62780,97294,23123,46856,19321,74171,18862,9127,9735
62785,97298,23124,46858,19321,74173,18862,9127,9735
62790,97308,23125,46861,19321,74183,18864,9127,9737
62795,97314,23125,46863,19321,74188,18866,9127,9739
62800,97325,23127,46869,19322,74198,18868,9128,9740
62805,97329,23128,46872,19323,74200,18868,9128,9740
62810,97339,23130,46877,19324,74209,18870,9128,9742
62815,97345,23131,46880,19325,74214,18872,9129,9743
62820,97356,23132,46886,19325,74224,18874,9130,9744
62825,97360,23133,46889,19326,74226,18874,9130,9744
62830,97370,23134,46895,19327,74236,18876,9131,9745
62835,97376,23135,46901,19328,74240,18878,9133,9745
62840,97387,23136,46907,19328,74251,18880,9134,9746
62845,97391,23137,46911,19329,74254,18880,9134,9746
62850,97401,23139,46918,19331,74262,18882,9135,9747
62855,97407,23140,46923,19332,74266,18884,9137,9747
62860,97418,23141,46928,19332,74277,18886,9138,9748
62865,97422,23142,46930,19332,74279,18886,9138,9748
62870,97432,23145,46934,19334,74287,18888,9138,9750
62875,97438,23145,46936,19334,74292,18890,9138,9752
62880,97449,23148,46942,19336,74300,18892,9139,9753
62885,97453,23150,46943,19337,74303,18892,9139,9753
62890,97463,23153,46949,19339,74310,18894,9141,9753
62895,97469,23154,46952,19340,74314,18896,9142,9754
62900,97480,23155,46958,19341,74325,18898,9144,9754
62905,97484,23156,46959,19341,74327,18898,9144,9754
62910,97494,23159,46965,19344,74335,18900,9145,9755
62915,97500,23160,46968,19345,74340,18902,9146,9756
62920,97511,23162,46976,19346,74348,18904,9148,9756
62925,97515,23164,46977,19347,74351,18904,9148,9756
62930,97525,23166,46980,19347,74359,18906,9149,9757
62935,97531,23166,46981,19347,74365,18908,9150,9758
62940,97542,23167,46985,19347,74375,18910,9150,9760
62945,97546,23169,46987,19349,74377,18910,9150,9760
62950,97556,23171,46990,19350,74385,18912,9150,9762
62955,97562,23172,46994,19351,74389,18914,9151,9763
62960,97573,23175,47000,19353,74397,18916,9151,9765
62965,97577,23178,47004,19356,74397,18916,9151,9765
62970,97587,23182,47008,19360,74405,18918,9152,9766
62975,97593,23182,47009,19360,74411,18920,9153,9767
62980,97604,23184,47014,19361,74420,18922,9154,9768
62985,97608,23186,47016,19362,74421,18922,9154,9768
62990,97618,23191,47019,19365,74427,18924,9155,9769
62995,97624,23192,47023,19366,74430,18926,9155,9771
63000,97635,23195,47027,19368,74440,18928,9156,9772
63005,97639,23197,47030,19370,74441,18928,9156,9772
63010,97649,23201,47036,19374,74448,18930,9158,9772
63015,97655,23202,47039,19375,74451,18932,9158,9774
63020,97666,23205,47044,19378,74461,18934,9158,9776
63025,97670,23206,47045,19378,74463,18934,9158,9776
63030,97680,23210,47051,19381,74470,18936,9159,9777
63035,97686,23211,47054,19382,74474,18938,9160,9778
63040,97697,23214,47060,19384,74483,18940,9161,9779
63045,97701,23215,47061,19384,74485,18940,9161,9779
63050,97711,23220,47067,19389,74491,18942,9161,9781
63055,97717,23221,47069,19390,74495,18944,9161,9783
63060,97728,23224,47072,19392,74504,18946,9162,9784
63065,97732,23225,47073,19393,74507,18946,9162,9784
63070,97742,23226,47077,19393,74516,18948,9164,9784
63075,97748,23226,47080,19393,74522,18950,9165,9785
63080,97759,23227,47083,19393,74532,18952,9166,9786
63085,97763,23228,47086,19394,74534,18952,9166,9786
63090,97773,23229,47090,19394,74544,18954,9167,9787
63095,97779,23229,47092,19394,74550,18956,9168,9788
63100,97790,23230,47096,19394,74560,18958,9168,9790
63105,97794,23231,47097,19394,74563,18958,9168,9790
63110,97804,23233,47101,19395,74571,18960,9169,9791
63115,97810,23233,47104,19395,74576,18962,9170,9792
63120,97821,23234,47109,19395,74587,18964,9170,9794
63125,97825,23235,47112,19396,74590,18964,9170,9794
63130,97835,23237,47118,19397,74598,18966,9172,9794
63135,97841,23238,47123,19398,74602,18968,9174,9794
63140,97852,23239,47127,19398,74613,18970,9176,9794
63145,97856,23240,47129,19398,74616,18970,9176,9794
63150,97866,23242,47134,19399,74624,18972,9177,9795
63155,97872,23243,47139,19400,74628,18974,9178,9796
63160,97883,23246,47144,19402,74636,18976,9179,9797
63165,97887,23249,47148,19405,74636,18976,9179,9797
63170,97897,23256,47157,19412,74641,18978,9181,9797
63175,97903,23256,47159,19412,74647,18980,9182,9798
63180,97914,23258,47164,19414,74655,18982,9182,9800
63185,97918,23261,47166,19417,74657,18982,9182,9800
63190,97928,23263,47170,19419,74665,18984,9183,9801
63195,97934,23264,47176,19420,74668,18986,9185,9801
63200,97945,23267,47179,19422,74678,18988,9185,9803
63205,97949,23269,47180,19423,74680,18988,9185,9803
63210,97959,23273,47186,19426,74686,18990,9186,9804
63215,97965,23273,47190,19426,74690,18992,9187,9805
63220,97976,23276,47197,19429,74699,18994,9189,9805
63225,97980,23279,47200,19432,74700,18994,9189,9805
63230,97990,23284,47206,19436,74706,18996,9191,9805
63235,97996,23284,47208,19436,74712,18998,9193,9805
63240,98007,23285,47212,19436,74722,19000,9194,9806
63245,98011,23286,47213,19436,74725,19000,9194,9806
63250,98021,23288,47218,19437,74733,19002,9195,9807
63255,98027,23288,47218,19437,74739,19004,9195,9809
63260,98038,23290,47224,19438,74748,19006,9197,9809
63265,98042,23291,47226,19439,74751,19006,9197,9809
63270,98052,23292,47228,19439,74760,19008,9198,9810
63275,98058,23292,47231,19439,74765,19010,9199,9811
63280,98069,23294,47238,19440,74775,19012,9201,9811
63285,98073,23295,47241,19441,74777,19012,9201,9811
63290,98083,23297,47246,19443,74786,19014,9201,9813
63295,98089,23297,47250,19443,74791,19016,9202,9814
63300,98100,23299,47257,19444,74801,19018,9203,9815
63305,98104,23300,47259,19445,74804,19018,9203,9815
63310,98114,23301,47262,19445,74813,19020,9205,9815
63315,98120,23301,47266,19445,74819,19022,9207,9815
63320,98131,23303,47272,19446,74828,19024,9207,9817
63325,98135,23304,47275,19446,74830,19024,9207,9817
63330,98145,23305,47280,19447,74840,19026,9208,9818
63335,98151,23306,47282,19448,74845,19028,9209,9819
63340,98162,23307,47290,19449,74855,19030,9211,9819
63345,98166,23309,47293,19450,74855,19030,9211,9819
63350,98176,23314,47300,19455,74862,19032,9212,9820
63355,98182,23314,47301,19455,74867,19034,9212,9822
63360,98193,23317,47309,19458,74875,19036,9213,9823
63365,98197,23319,47310,19459,74877,19036,9213,9823
63370,98207,23325,47315,19464,74882,19038,9214,9824
63375,98213,23325,47318,19464,74887,19040,9215,9825
63380,98224,23328,47325,19466,74895,19042,9217,9825
63385,98228,23330,47325,19467,74898,19042,9217,9825
63390,98238,23334,47329,19469,74904,19044,9218,9826
63395,98244,23334,47330,19469,74910,19046,9219,9827
63400,98255,23336,47335,19470,74919,19048,9220,9828
63405,98259,23338,47337,19471,74920,19048,9220,9828
63410,98269,23343,47341,19475,74926,19050,9221,9829
63415,98275,23344,47343,19476,74931,19052,9222,9830
63420,98286,23346,47348,19478,74939,19054,9223,9831
63425,98290,23348,47349,19479,74941,19054,9223,9831
63430,98300,23353,47357,19484,74947,19056,9225,9831
63435,98306,23354,47361,19485,74951,19058,9226,9832
63440,98317,23355,47365,19486,74962,19060,9226,9834
63445,98321,23356,47365,19486,74965,19060,9226,9834
63450,98331,23358,47369,19488,74973,19062,9226,9836
63455,98337,23359,47372,19489,74977,19064,9227,9837
63460,98348,23360,47378,19489,74988,19066,9228,9838
63465,98352,23361,47380,19490,74991,19066,9228,9838
63470,98362,23363,47386,19491,74999,19068,9229,9839
63475,98368,23364,47389,19492,75003,19070,9229,9841
63480,98379,23365,47394,19493,75014,19072,9230,9842
63485,98383,23366,47398,19494,75016,19072,9230,9842
63490,98393,23367,47403,19494,75026,19074,9231,9843
63495,98399,23368,47408,19495,75030,19076,9232,9844
63500,98410,23370,47415,19497,75040,19078,9232,9846
63505,98414,23371,47417,19498,75043,19078,9232,9846
63510,98424,23373,47422,19499,75051,19080,9233,9847
63515,98430,23373,47422,19499,75057,19082,9233,9849
63520,98441,23375,47427,19501,75066,19084,9234,9850
63525,98445,23376,47430,19501,75068,19084,9234,9850
63530,98455,23377,47435,19501,75078,19086,9235,9851
63535,98461,23378,47438,19502,75081,19088,9235,9853
63540,98472,23382,47445,19505,75089,19090,9236,9854
63545,98476,23385,47447,19507,75091,19090,9236,9854
63550,98486,23388,47451,19508,75098,19092,9237,9855
63555,98492,23388,47453,19508,75103,19094,9238,9856
63560,98503,23390,47458,19510,75113,19096,9238,9858
63565,98507,23392,47461,19511,75114,19096,9238,9858
63570,98517,23395,47468,19514,75122,19098,9240,9858
63575,98523,23396,47470,19515,75127,19100,9240,9860
63580,98534,23398,47476,19516,75136,19102,9241,9861
63585,98538,23399,47477,19516,75139,19102,9241,9861
63590,98548,23402,47481,19518,75146,19104,9241,9863
63595,98554,23402,47484,19518,75152,19106,9242,9864
63600,98565,23404,47491,19520,75161,19108,9243,9865
63605,98569,23406,47493,19521,75163,19108,9243,9865
63610,98579,23410,47499,19525,75169,19110,9244,9866
63615,98585,23410,47502,19525,75175,19112,9245,9867
63620,98596,23412,47505,19526,75184,19114,9245,9869
63625,98600,23413,47505,19526,75187,19114,9245,9869
63630,98610,23416,47510,19528,75194,19116,9246,9870
63635,98616,23416,47512,19528,75200,19118,9248,9870
63640,98627,23417,47518,19529,75210,19120,9249,9871
63645,98631,23419,47519,19530,75212,19120,9249,9871
63650,98641,23422,47522,19532,75219,19122,9250,9872
63655,98647,23423,47525,19533,75224,19124,9251,9873
63660,98658,23424,47529,19533,75234,19126,9253,9873
63665,98662,23425,47531,19534,75236,19126,9253,9873
63670,98672,23428,47538,19537,75244,19128,9255,9873
63675,98678,23429,47540,19538,75249,19130,9256,9874
63680,98689,23431,47545,19539,75257,19132,9256,9876
63685,98693,23434,47547,19541,75258,19132,9256,9876
63690,98703,23440,47553,19546,75263,19134,9257,9877
63695,98709,23440,47557,19546,75267,19136,9259,9877
63700,98720,23444,47564,19550,75276,19138,9260,9878
63705,98724,23445,47565,19550,75278,19138,9260,9878
63710,98734,23449,47571,19553,75285,19140,9262,9878
63715,98740,23449,47573,19553,75290,19142,9263,9879
63720,98751,23452,47580,19555,75298,19144,9265,9879
63725,98755,23454,47581,19556,75300,19144,9265,9879
63730,98765,23459,47586,19561,75306,19146,9265,9881
63735,98771,23460,47587,19562,75311,19148,9265,9883
63740,98782,23462,47593,19564,75320,19150,9266,9884
63745,98786,23463,47594,19564,75322,19150,9266,9884
63750,98796,23466,47595,19566,75330,19152,9266,9886
63755,98802,23467,47599,19567,75334,19154,9268,9886
63760,98813,23469,47603,19568,75344,19156,9269,9887
63765,98817,23471,47605,19570,75346,19156,9269,9887
63770,98827,23475,47608,19572,75352,19158,9270,9888
63775,98833,23475,47611,19572,75357,19160,9271,9889
63780,98844,23477,47613,19573,75367,19162,9272,9890
63785,98848,23478,47615,19573,75370,19162,9272,9890
63790,98858,23479,47620,19574,75379,19164,9274,9890
63795,98864,23480,47625,19575,75383,19166,9275,9891
63800,98875,23482,47630,19577,75393,19168,9276,9892
63805,98879,23483,47633,19578,75395,19168,9276,9892
63810,98889,23484,47636,19579,75405,19170,9276,9894
63815,98895,23484,47639,19579,75410,19172,9277,9895
63820,98906,23486,47645,19580,75420,19174,9279,9895
63825,98910,23487,47647,19580,75422,19174,9279,9895
63830,98920,23489,47653,19582,75431,19176,9281,9895
63835,98926,23490,47655,19583,75436,19178,9282,9896
63840,98937,23491,47659,19584,75446,19180,9283,9897
63845,98941,23492,47662,19585,75448,19180,9283,9897
63850,98951,23494,47667,19587,75457,19182,9283,9899
63855,98957,23495,47669,19588,75461,19184,9283,9901
63860,98968,23497,47674,19589,75471,19186,9284,9902
63865,98972,23498,47674,19589,75474,19186,9284,9902
63870,98982,23499,47679,19589,75483,19188,9286,9902
63875,98988,23500,47683,19590,75487,19190,9287,9903
63880,98999,23501,47686,19590,75498,19192,9287,9905
63885,99003,23502,47687,19590,75500,19192,9287,9905
63890,99013,23505,47692,19591,75508,19194,9289,9905
63895,99019,23505,47692,19591,75514,19196,9289,9907
63900,99030,23507,47700,19593,75523,19198,9290,9908
63905,99034,23509,47703,19595,75524,19198,9290,9908
63910,99044,23513,47709,19598,75531,19200,9291,9909
63915,99050,23513,47711,19598,75536,19202,9291,9911
63920,99061,23515,47717,19599,75546,19204,9291,9913
63925,99065,23517,47719,19600,75548,19204,9291,9913
63930,99075,23519,47722,19601,75556,19206,9291,9915
63935,99081,23520,47724,19602,75561,19208,9292,9916
63940,99092,23521,47729,19602,75571,19210,9294,9916
63945,99096,23522,47730,19603,75574,19210,9294,9916
63950,99106,23526,47732,19605,75580,19212,9294,9918
63955,99112,23527,47733,19606,75585,19214,9294,9920
63960,99123,23529,47740,19608,75594,19216,9295,9921
63965,99127,23530,47741,19608,75596,19216,9295,9921
63970,99137,23535,47746,19611,75602,19218,9296,9922
63975,99143,23535,47749,19611,75608,19220,9298,9922
63980,99154,23537,47755,19612,75617,19222,9300,9922
63985,99158,23539,47758,19614,75618,19222,9300,9922
63990,99168,23545,47767,19619,75623,19224,9302,9922
63995,99174,23545,47769,19619,75628,19226,9302,9924
64000,99185,23547,47773,19620,75638,19228,9303,9925
64005,99189,23548,47774,19620,75640,19228,9303,9925
64010,99199,23553,47781,19625,75646,19230,9304,9926
64015,99205,23554,47785,19626,75649,19232,9305,9927
64020,99216,23558,47788,19629,75658,19234,9305,9929
64025,99220,23560,47791,19631,75659,19234,9305,9929
64030,99230,23566,47797,19635,75664,19236,9306,9930
64035,99236,23567,47802,19636,75667,19238,9308,9930
64040,99247,23571,47809,19640,75676,19240,9309,9931
64045,99251,23572,47810,19641,75679,19240,9309,9931
64050,99261,23574,47816,19643,75687,19242,9310,9932
64055,99267,23574,47819,19643,75692,19244,9311,9933
64060,99278,23576,47822,19644,75702,19246,9311,9935
64065,99282,23577,47824,19644,75704,19246,9311,9935
64070,99292,23577,47829,19644,75715,19248,9313,9935
64075,99298,23577,47833,19644,75721,19250,9314,9936
64080,99309,23578,47840,19645,75731,19252,9314,9938
64085,99313,23579,47843,19646,75733,19252,9314,9938
64090,99323,23579,47849,19646,75744,19254,9316,9938
64095,99329,23579,47854,19646,75750,19256,9318,9938
64100,99340,23580,47862,19646,75760,19258,9320,9938
64105,99344,23581,47863,19646,75762,19258,9320,9938
64110,99354,23581,47867,19646,75773,19260,9321,9939
64115,99360,23581,47870,19646,75778,19262,9322,9940
64120,99371,23582,47875,19646,75789,19264,9323,9941
64125,99375,23583,47876,19647,75792,19264,9323,9941
64130,99385,23583,47879,19647,75802,19266,9324,9942
64135,99391,23583,47883,19647,75808,19268,9326,9942
64140,99402,23584,47888,19647,75818,19270,9327,9943
64145,99406,23585,47890,19648,75821,19270,9327,9943
64150,99416,23587,47894,19650,75829,19272,9327,9945
64155,99422,23587,47896,19650,75834,19274,9328,9946
64160,99433,23590,47902,19652,75843,19276,9330,9946
64165,99437,23591,47904,19653,75845,19276,9330,9946
64170,99447,23595,47910,19656,75852,19278,9332,9946
64175,99453,23596,47912,19657,75857,19280,9333,9947
64180,99464,23597,47918,19657,75867,19282,9335,9947
64185,99468,23599,47921,19659,75868,19282,9335,9947
64190,99478,23605,47925,19664,75873,19284,9335,9949
64195,99484,23606,47929,19665,75878,19286,9337,9949
64200,99495,23607,47933,19666,75888,19288,9338,9950
64205,99499,23608,47934,19666,75890,19288,9338,9950
64210,99509,23613,47939,19670,75896,19290,9338,9952
64215,99515,23613,47943,19670,75900,19292,9339,9953
64220,99526,23617,47947,19673,75909,19294,9340,9954
64225,99530,23618,47948,19673,75911,19294,9340,9954
64230,99540,23623,47953,19676,75917,19296,9341,9955
64235,99546,23624,47956,19677,75921,19298,9342,9956
64240,99557,23627,47960,19679,75930,19300,9344,9956
64245,99561,23629,47962,19680,75931,19300,9344,9956
64250,99571,23633,47965,19682,75938,19302,9345,9957
64255,99577,23634,47969,19683,75942,19304,9346,9958
64260,99588,23636,47973,19684,75952,19306,9347,9959
64265,99592,23638,47976,19685,75952,19306,9347,9959
64270,99602,23642,47979,19687,75960,19308,9348,9960
64275,99608,23642,47981,19687,75966,19310,9349,9961
64280,99619,23644,47985,19688,75975,19312,9350,9962
64285,99623,23645,47986,19688,75978,19312,9350,9962
64290,99633,23647,47993,19689,75986,19314,9351,9963
64295,99639,23647,47995,19689,75992,19316,9352,9964
64300,99650,23649,48001,19690,76001,19318,9354,9964
64305,99654,23650,48002,19691,76004,19318,9354,9964
64310,99664,23652,48006,19692,76012,19320,9355,9965
64315,99670,23653,48010,19693,76016,19322,9356,9966
64320,99681,23654,48017,19694,76027,19324,9357,9967
64325,99685,23655,48019,19694,76029,19324,9357,9967
64330,99695,23657,48025,19696,76038,19326,9359,9967
64335,99701,23657,48026,19696,76044,19328,9359,9969
64340,99712,23659,48034,19698,76053,19330,9359,9971
64345,99716,23660,48037,19699,76055,19330,9359,9971
64350,99726,23661,48041,19699,76065,19332,9359,9973
64355,99732,23661,48044,19699,76070,19333,9359,9974
64360,99743,23663,48049,19700,76080,19335,9360,9975
64365,99747,23664,48050,19700,76082,19335,9360,9975
64370,99757,23666,48053,19702,76091,19336,9360,9976
64375,99763,23667,48057,19703,76095,19338,9362,9976
64380,99774,23670,48065,19705,76103,19340,9363,9977
64385,99778,23672,48068,19707,76104,19340,9363,9977
64390,99788,23677,48073,19711,76111,19342,9364,9978
64395,99794,23678,48074,19712,76116,19344,9364,9980
64400,99805,23680,48078,19714,76124,19346,9364,9982
64405,99809,23683,48081,19717,76125,19346,9364,9982
64410,99819,23687,48086,19721,76132,19348,9364,9984
64415,99825,23687,48089,19721,76136,19350,9364,9986
64420,99836,23690,48095,19723,76145,19352,9366,9986
64425,99840,23693,48097,19726,76147,19352,9366,9986
64430,99850,23696,48103,19729,76154,19354,9367,9987
64435,99856,23696,48105,19729,76160,19356,9369,9987
64440,99867,23697,48112,19730,76169,19358,9370,9988
64445,99871,23700,48114,19732,76170,19358,9370,9988
64450,99881,23704,48120,19736,76177,19360,9371,9989
64455,99887,23704,48122,19736,76182,19362,9373,9989
64460,99898,23705,48125,19736,76193,19364,9373,9991
64465,99902,23707,48127,19737,76194,19364,9373,9991
64470,99912,23710,48129,19738,76202,19366,9373,9993
64475,99918,23711,48130,19739,76206,19368,9373,9995
64480,99929,23713,48133,19741,76216,19370,9373,9997
64485,99933,23714,48133,19741,76219,19370,9373,9997
64490,99943,23716,48136,19741,76227,19372,9374,9998
64495,99949,23716,48137,19741,76232,19374,9375,9999
64500,99960,23717,48143,19742,76242,19376,9375,10001
64505,99964,23720,48146,19745,76243,19376,9375,10001
64510,99974,23724,48150,19748,76250,19378,9377,10001
64515,99980,23724,48152,19748,76255,19380,9377,10003
64520,99991,23726,48157,19749,76264,19382,9378,10004
64525,99995,23728,48160,19750,76266,19382,9378,10004
64530,100005,23729,48165,19751,76276,19384,9379,10005
64535,100011,23729,48167,19751,76281,19386,9380,10006
64540,100022,23730,48171,19751,76292,19388,9380,10008
64545,100026,23731,48173,19751,76294,19388,9380,10008
64550,100036,23732,48180,19752,76304,19390,9381,10009
64555,100042,23732,48183,19752,76309,19392,9383,10009
64560,100053,23733,48186,19752,76320,19394,9385,10009
64565,100057,23734,48186,19752,76323,19394,9385,10009
64570,100067,23736,48192,19754,76331,19396,9386,10010
64575,100073,23737,48193,19755,76335,19398,9386,10012
64580,100084,23738,48198,19756,76346,19400,9387,10013
64585,100088,23739,48200,19756,76349,19400,9387,10013
64590,100098,23741,48204,19758,76357,19402,9388,10014
64595,100104,23742,48208,19759,76361,19404,9389,10015
64600,100115,23743,48216,19760,76372,19406,9391,10015
64605,100119,23744,48218,19760,76374,19406,9391,10015
64610,100129,23745,48224,19761,76384,19408,9393,10015
64615,100135,23746,48228,19762,76388,19410,9394,10016
64620,100146,23748,48235,19763,76398,19412,9395,10017
64625,100150,23749,48237,19763,76400,19412,9395,10017
64630,100160,23751,48241,19763,76409,19414,9396,10018
64635,100166,23751,48244,19763,76414,19416,9397,10019
64640,100177,23753,48249,19764,76424,19418,9398,10020
64645,100181,23755,48252,19766,76425,19418,9398,10020
64650,100191,23758,48259,19768,76433,19420,9399,10021
64655,100197,23759,48263,19769,76437,19422,9400,10022
64660,100208,23760,48267,19770,76448,19424,9400,10024
64665,100212,23761,48268,19770,76450,19424,9400,10024
64670,100222,23764,48272,19771,76458,19426,9401,10025
64675,100228,23764,48274,19771,76463,19428,9402,10026
64680,100239,23765,48278,19771,76474,19430,9402,10028
64685,100243,23766,48278,19771,76477,19430,9402,10028
64690,100253,23769,48283,19773,76484,19432,9402,10030
64695,100259,23769,48286,19773,76489,19434,9403,10031
64700,100270,23770,48290,19773,76500,19436,9404,10032
64705,100274,23771,48291,19773,76503,19436,9404,10032
64710,100284,23773,48296,19775,76511,19438,9406,10032
64715,100290,23774,48299,19776,76515,19440,9407,10033
64720,100301,23776,48305,19778,76525,19442,9409,10033
64725,100305,23778,48309,19780,76525,19442,9409,10033
64730,100315,23783,48312,19784,76532,19444,9409,10035
64735,100321,23783,48316,19784,76536,19446,9410,10036
64740,100332,23787,48321,19787,76544,19448,9412,10036
64745,100336,23789,48323,19789,76546,19448,9412,10036
64750,100346,23793,48328,19792,76553,19450,9413,10037
64755,100352,23793,48329,19792,76558,19452,9414,10038
64760,100363,23794,48332,19793,76568,19454,9415,10039
64765,100367,23796,48333,19794,76570,19454,9415,10039
64770,100377,23800,48338,19797,76577,19456,9416,10040
64775,100383,23800,48339,19797,76582,19458,9417,10041
64780,100394,23801,48344,19798,76593,19460,9417,10043
64785,100398,23802,48345,19799,76596,19460,9417,10043
64790,100408,23805,48351,19801,76603,19462,9419,10043
64795,100414,23805,48355,19801,76607,19464,9421,10043
64800,100425,23809,48362,19805,76616,19466,9423,10043
64805,100429,23811,48364,19806,76617,19466,9423,10043
64810,100439,23815,48370,19810,76624,19468,9423,10045
64815,100445,23816,48374,19811,76628,19470,9424,10046
64820,100456,23818,48380,19813,76637,19472,9426,10046
64825,100460,23821,48381,19815,76639,19472,9426,10046
64830,100470,23823,48388,19817,76647,19474,9428,10046
64835,100476,23823,48389,19817,76652,19476,9428,10048
64840,100487,23824,48396,19818,76662,19478,9428,10050
64845,100491,23826,48398,19820,76664,19478,9428,10050
64850,100501,23829,48399,19821,76672,19480,9429,10051
64855,100507,23830,48404,19822,76676,19482,9431,10051
64860,100518,23833,48407,19824,76684,19484,9431,10053
64865,100522,23836,48410,19826,76684,19484,9431,10053
64870,100532,23841,48415,19829,76691,19486,9431,10055
64875,100538,23842,48418,19830,76694,19488,9432,10056
64880,100549,23845,48425,19832,76704,19490,9434,10056
64885,100553,23847,48428,19833,76704,19490,9434,10056
64890,100563,23853,48435,19838,76710,19492,9436,10056
64895,100569,23853,48438,19838,76714,19494,9437,10057
64900,100580,23856,48444,19841,76723,19496,9437,10059
64905,100584,23858,48446,19843,76725,19496,9437,10059
64910,100594,23862,48451,19847,76732,19498,9438,10060
64915,100600,23863,48454,19848,76736,19500,9440,10060
64920,100611,23864,48458,19849,76747,19502,9440,10062
64925,100615,23866,48459,19850,76749,19502,9440,10062
64930,100625,23868,48462,19851,76757,19504,9442,10062
64935,100631,23869,48465,19852,76761,19506,9444,10062
64940,100642,23870,48468,19853,76772,19508,9445,10063
64945,100646,23871,48469,19854,76775,19508,9445,10063
64950,100656,23874,48475,19856,76782,19510,9446,10064
64955,100662,23874,48478,19856,76786,19512,9447,10065
64960,100673,23877,48485,19859,76795,19514,9447,10067
64965,100677,23879,48487,19860,76796,19514,9447,10067
64970,100687,23882,48493,19863,76805,19516,9449,10067
64975,100693,23882,48495,19863,76810,19518,9449,10069
64980,100704,23884,48499,19865,76820,19520,9449,10071
64985,100708,23885,48500,19866,76823,19520,9449,10071
64990,100718,23886,48504,19866,76832,19522,9451,10071
64995,100724,23886,48506,19866,76837,19524,9452,10072
65000,100735,23887,48509,19866,76848,19526,9453,10073
65005,100739,23888,48511,19866,76850,19526,9453,10073
65010,100749,23890,48518,19868,76859,19528,9453,10075
65015,100755,23890,48519,19868,76864,19530,9454,10076
65020,100766,23891,48523,19868,76875,19532,9455,10077
65025,100770,23892,48524,19868,76878,19532,9455,10077
65030,100780,23894,48530,19869,76886,19534,9456,10078
65035,100786,23895,48531,19870,76890,19536,9456,10080
65040,100797,23897,48535,19871,76900,19538,9456,10082
65045,100801,23898,48537,19872,76903,19538,9456,10082
65050,100811,23900,48542,19873,76911,19540,9457,10083
65055,100817,23900,48544,19873,76916,19542,9458,10084
65060,100828,23902,48547,19874,76926,19544,9459,10085
65065,100832,23903,48548,19874,76928,19544,9459,10085
65070,100842,23905,48552,19875,76937,19546,9460,10086
65075,100848,23905,48555,19875,76942,19548,9461,10087
65080,100859,23907,48559,19876,76952,19550,9462,10088
65085,100863,23909,48562,19878,76954,19550,9462,10088
65090,100873,23912,48566,19879,76961,19552,9463,10089
65095,100879,23912,48567,19879,76966,19554,9464,10090
65100,100890,23914,48571,19880,76976,19556,9465,10091
65105,100894,23915,48573,19881,76979,19556,9465,10091
65110,100904,23917,48575,19881,76987,19558,9465,10093
65115,100910,23917,48578,19881,76992,19560,9467,10093
65120,100921,23920,48586,19883,77000,19562,9469,10093
65125,100925,23923,48588,19886,77002,19562,9469,10093
65130,100935,23925,48593,19887,77010,19564,9470,10094
65135,100941,23925,48596,19887,77015,19566,9472,10094
65140,100952,23927,48603,19888,77025,19568,9474,10094
65145,100956,23928,48606,19889,77026,19568,9474,10094
65150,100966,23934,48610,19894,77032,19570,9475,10095
65155,100972,23934,48613,19894,77036,19572,9476,10096
65160,100983,23937,48617,19896,77045,19574,9477,10097
65165,100987,23939,48619,19897,77047,19574,9477,10097
65170,100997,23942,48624,19898,77055,19576,9478,10098
65175,101003,23942,48627,19898,77060,19578,9479,10099
65180,101014,23944,48633,19900,77070,19580,9480,10100
65185,101018,23945,48636,19901,77073,19580,9480,10100
65190,101028,23947,48640,19902,77081,19582,9481,10101
65195,101034,23948,48645,19903,77084,19584,9482,10102
65200,101045,23950,48649,19905,77095,19586,9483,10103
65205,101049,23952,48652,19906,77097,19586,9483,10103
65210,101059,23954,48656,19908,77105,19588,9483,10105
65215,101065,23954,48657,19908,77110,19590,9483,10107
65220,101076,23957,48665,19911,77119,19592,9483,10109
65225,101080,23958,48665,19911,77122,19592,9483,10109
65230,101090,23961,48670,19912,77129,19594,9484,10110
65235,101096,23961,48671,19912,77135,19596,9485,10111
65240,101107,23962,48675,19912,77145,19598,9486,10112
65245,101111,23963,48677,19912,77148,19598,9486,10112
65250,101121,23965,48682,19912,77156,19600,9487,10113
65255,101127,23965,48683,19912,77162,19602,9488,10114
65260,101138,23966,48687,19912,77172,19604,9488,10116
65265,101142,23968,48690,19913,77174,19604,9488,10116
65270,101152,23971,48694,19914,77181,19606,9488,10118
65275,101158,23971,48695,19914,77187,19608,9489,10119
65280,101169,23972,48699,19914,77197,19610,9490,10120
65285,101173,23974,48700,19915,77199,19610,9490,10120
65290,101183,23976,48704,19916,77207,19612,9492,10120
65295,101189,23976,48708,19916,77212,19614,9494,10120
65300,101200,23978,48714,19917,77222,19616,9495,10121
65305,101204,23980,48716,19918,77223,19616,9495,10121
65310,101214,23984,48722,19921,77230,19618,9495,10123
65315,101220,23985,48726,19922,77234,19620,9496,10124
65320,101231,23988,48733,19925,77242,19622,9497,10125
65325,101235,23990,48735,19926,77243,19622,9497,10125
65330,101245,23994,48742,19930,77251,19624,9498,10126
65335,101251,23994,48746,19930,77255,19626,9500,10126
65340,101262,23998,48750,19934,77263,19628,9500,10128
65345,101266,24001,48753,19937,77264,19628,9500,10128
65350,101276,24004,48756,19939,77272,19630,9501,10129
65355,101282,24005,48759,19940,77276,19632,9502,10130
65360,101293,24007,48764,19942,77285,19634,9503,10131
65365,101297,24010,48766,19945,77287,19634,9503,10131
65370,101307,24013,48773,19948,77294,19636,9505,10131
65375,101313,24013,48776,19948,77299,19638,9505,10133
65380,101324,24015,48782,19950,77309,19640,9506,10134
65385,101328,24016,48785,19951,77311,19640,9506,10134
65390,101338,24018,48789,19952,77320,19642,9506,10136
65395,101344,24018,48793,19952,77326,19644,9508,10136
65400,101355,24019,48797,19952,77336,19646,9508,10138
65405,101359,24020,48799,19953,77338,19646,9508,10138
65410,101369,24022,48805,19954,77347,19648,9508,10140
65415,101375,24023,48808,19955,77352,19650,9509,10141
65420,101386,24024,48810,19955,77362,19652,9509,10143
65425,101390,24025,48811,19955,77364,19652,9509,10143
65430,101400,24027,48817,19956,77373,19654,9510,10144
65435,101406,24027,48818,19956,77379,19656,9510,10146
65440,101417,24028,48825,19956,77389,19658,9511,10147
65445,101421,24029,48827,19957,77391,19658,9511,10147
65450,101431,24030,48831,19957,77401,19660,9511,10149
65455,101437,24031,48833,19958,77405,19662,9511,10151
65460,101448,24033,48840,19960,77415,19664,9512,10152
65465,101452,24034,48842,19960,77417,19664,9512,10152
65470,101462,24035,48846,19960,77427,19666,9513,10153
65475,101468,24035,48848,19960,77433,19668,9514,10154
65480,101479,24036,48853,19960,77443,19670,9515,10155
65485,101483,24037,48854,19961,77446,19670,9515,10155
65490,101493,24041,48860,19964,77452,19672,9516,10156
65495,101499,24042,48865,19965,77456,19674,9518,10156
65500,101510,24044,48870,19967,77465,19676,9518,10158
65505,101514,24047,48872,19969,77466,19676,9518,10158
65510,101524,24050,48876,19972,77474,19678,9518,10160
65515,101530,24051,48881,19973,77477,19680,9519,10161
65520,101541,24054,48888,19976,77487,19682,9521,10161
65525,101545,24055,48889,19977,77490,19682,9521,10161
65530,101555,24059,48893,19979,77496,19684,9522,10162
65535,101561,24059,48896,19979,77501,19686,9524,10162
65540,101572,24062,48906,19982,77510,19688,9526,10162
65545,101576,24064,48909,19984,77511,19688,9526,10162
65550,101586,24066,48914,19985,77520,19690,9527,10163
65555,101592,24067,48915,19986,77525,19692,9527,10165
65560,101603,24068,48919,19986,77535,19694,9528,10166
65565,101607,24070,48920,19987,77537,19694,9528,10166
65570,101617,24073,48922,19988,77544,19696,9528,10168
65575,101623,24073,48925,19988,77549,19698,9529,10169
65580,101634,24074,48931,19988,77560,19700,9531,10169
65585,101638,24075,48931,19988,77563,19700,9531,10169
65590,101648,24078,48935,19989,77570,19702,9531,10171
65595,101654,24078,48939,19989,77575,19704,9533,10171
65600,101665,24080,48946,19990,77585,19706,9534,10172
65605,101669,24081,48948,19990,77587,19706,9534,10172
65610,101679,24084,48952,19993,77595,19708,9534,10174
65615,101685,24084,48954,19993,77601,19710,9535,10175
65620,101696,24085,48958,19994,77611,19712,9536,10176
65625,101700,24087,48961,19995,77612,19712,9536,10176
65630,101710,24089,48965,19996,77621,19714,9537,10177
65635,101716,24090,48970,19997,77625,19716,9538,10178
65640,101727,24092,48976,19998,77635,19718,9540,10178
65645,101731,24093,48978,19999,77637,19718,9540,10178
65650,101741,24098,48984,20003,77643,19720,9541,10179
65655,101747,24099,48987,20004,77648,19722,9542,10180
65660,101758,24101,48994,20006,77657,19724,9543,10181
65665,101762,24102,48994,20006,77660,19724,9543,10181
65670,101772,24104,48996,20007,77668,19726,9543,10183
65675,101778,24105,49000,20008,77673,19728,9545,10183
65680,101789,24106,49007,20008,77683,19730,9547,10183
65685,101793,24108,49009,20009,77684,19730,9547,10183
65690,101803,24112,49016,20013,77691,19732,9548,10184
65695,101809,24113,49020,20014,77695,19734,9550,10184
65700,101820,24116,49026,20017,77704,19736,9552,10184
65705,101824,24118,49028,20018,77705,19736,9552,10184
65710,101834,24122,49033,20021,77712,19738,9554,10184
65715,101840,24122,49034,20021,77718,19740,9555,10185
65720,101851,24124,49040,20023,77727,19742,9557,10185
65725,101855,24125,49043,20024,77728,19742,9557,10185
65730,101865,24131,49051,20029,77734,19744,9559,10185
65735,101871,24132,49054,20030,77738,19746,9559,10187
65740,101882,24135,49061,20033,77747,19748,9560,10188
65745,101886,24136,49061,20033,77750,19748,9560,10188
65750,101896,24138,49066,20035,77758,19750,9561,10189
65755,101902,24138,49069,20035,77762,19752,9561,10191
65760,101913,24142,49074,20038,77771,19754,9561,10193
65765,101917,24143,49076,20038,77772,19754,9561,10193
65770,101927,24148,49082,20042,77779,19756,9561,10195
65775,101933,24148,49084,20042,77783,19758,9561,10197
65780,101944,24152,49091,20045,77791,19760,9563,10197
65785,101948,24154,49093,20046,77792,19760,9563,10197
65790,101958,24158,49096,20048,77800,19762,9563,10199
65795,101964,24158,49099,20048,77805,19764,9565,10199
65800,101975,24159,49105,20048,77816,19766,9567,10199
65805,101979,24161,49108,20049,77818,19766,9567,10199
65810,101989,24163,49114,20051,77826,19768,9567,10201
65815,101995,24164,49117,20052,77831,19770,9568,10202
65820,102006,24165,49126,20053,77841,19772,9570,10202
65825,102010,24166,49128,20054,77844,19772,9570,10202
65830,102020,24169,49136,20057,77851,19774,9572,10202
65835,102026,24169,49138,20057,77856,19776,9573,10203
65840,102037,24171,49145,20059,77866,19778,9575,10203
65845,102041,24173,49148,20060,77868,19778,9575,10203
65850,102051,24175,49149,20060,77876,19780,9576,10204
65855,102057,24175,49150,20060,77881,19782,9576,10206
65860,102068,24176,49153,20060,77892,19784,9577,10207
65865,102072,24177,49154,20060,77895,19784,9577,10207
65870,102082,24180,49161,20063,77902,19786,9579,10207
65875,102088,24180,49162,20063,77907,19788,9579,10209
65880,102099,24182,49165,20065,77917,19790,9579,10211
65885,102103,24183,49165,20065,77920,19790,9579,10211
65890,102113,24186,49167,20066,77927,19792,9580,10212
65895,102119,24186,49169,20066,77932,19794,9581,10213
65900,102130,24188,49173,20067,77942,19796,9582,10214
65905,102134,24190,49175,20069,77944,19796,9582,10214
65910,102144,24194,49183,20072,77950,19798,9584,10214
65915,102150,24194,49185,20072,77955,19800,9584,10216
65920,102161,24196,49189,20074,77964,19802,9584,10218
65925,102165,24198,49191,20075,77965,19802,9584,10218
65930,102175,24203,49195,20080,77972,19804,9585,10219
65935,102181,24203,49197,20080,77977,19806,9585,10221
65940,102192,24205,49203,20082,77987,19808,9586,10222
65945,102196,24206,49204,20082,77990,19808,9586,10222
65950,102206,24207,49212,20083,77999,19810,9587,10223
65955,102212,24207,49213,20083,78004,19812,9587,10225
65960,102223,24209,49219,20085,78014,19814,9588,10226
65965,102227,24210,49221,20086,78016,19814,9588,10226
65970,102237,24212,49224,20088,78025,19816,9589,10227
65975,102243,24212,49225,20088,78031,19818,9590,10228
65980,102254,24214,49231,20089,78040,19820,9591,10229
65985,102258,24215,49232,20089,78042,19820,9591,10229
65990,102268,24216,49236,20090,78052,19822,9592,10230
65995,102274,24216,49237,20090,78058,19824,9593,10231
66000,102285,24217,49239,20091,78068,19826,9593,10233
66005,102289,24218,49241,20092,78071,19826,9593,10233
66010,102299,24219,49245,20093,78080,19828,9593,10235
66015,102305,24219,49247,20093,78086,19830,9593,10237
66020,102316,24220,49251,20093,78096,19832,9594,10238
66025,102320,24221,49251,20093,78099,19832,9594,10238
66030,102330,24223,49258,20095,78107,19834,9595,10239
66035,102336,24224,49260,20096,78112,19836,9596,10240
66040,102347,24226,49267,20097,78121,19838,9598,10240
66045,102351,24227,49269,20098,78123,19838,9598,10240
66050,102361,24232,49274,20102,78129,19840,9598,10242
66055,102367,24232,49277,20102,78133,19842,9599,10243
66060,102378,24235,49282,20105,78142,19844,9599,10245
66065,102382,24238,49284,20107,78143,19844,9599,10245
66070,102392,24241,49288,20109,78151,19846,9599,10247
66075,102398,24242,49291,20110,78156,19848,9601,10247
66080,102409,24243,49294,20110,78166,19850,9601,10249
66085,102413,24245,49297,20111,78167,19850,9601,10249
66090,102423,24248,49304,20114,78175,19852,9602,10250
66095,102429,24249,49309,20115,78179,19854,9603,10251
66100,102440,24250,49314,20115,78190,19856,9604,10252
66105,102444,24252,49315,20116,78192,19856,9604,10252
66110,102454,24255,49322,20118,78199,19858,9606,10252
66115,102460,24256,49325,20119,78204,19860,9606,10254
66120,102471,24258,49331,20120,78213,19862,9607,10255
66125,102475,24259,49333,20120,78215,19862,9607,10255
66130,102485,24262,49336,20121,78223,19864,9608,10256
66135,102491,24263,49339,20122,78228,19866,9609,10257
66140,102502,24264,49347,20123,78238,19868,9610,10258
66145,102506,24265,49347,20123,78241,19868,9610,10258
66150,102516,24268,49350,20124,78248,19870,9610,10260
66155,102522,24269,49351,20125,78253,19872,9610,10262
66160,102533,24271,49359,20127,78262,19874,9612,10262
66165,102537,24272,49362,20128,78263,19874,9612,10262
66170,102547,24278,49368,20133,78269,19876,9613,10263
66175,102553,24279,49370,20134,78274,19878,9614,10264
66180,102564,24281,49374,20136,78282,19880,9614,10266
66185,102568,24283,49376,20137,78283,19880,9614,10266
66190,102578,24289,49383,20142,78289,19882,9616,10266
66195,102584,24289,49384,20142,78295,19884,9617,10267
66200,102595,24291,49390,20144,78304,19886,9619,10267
66205,102599,24292,49391,20145,78307,19886,9619,10267
66210,102609,24296,49398,20149,78313,19888,9619,10269
66215,102615,24296,49400,20149,78317,19890,9619,10271
66220,102626,24299,49402,20151,78327,19892,9620,10272
66225,102630,24300,49402,20151,78330,19892,9620,10272
66230,102640,24303,49408,20153,78337,19894,9622,10272
66235,102646,24304,49410,20154,78342,19896,9623,10273
66240,102657,24306,49417,20156,78351,19898,9623,10275
66245,102661,24308,49420,20157,78351,19898,9623,10275
66250,102671,24313,49423,20161,78358,19900,9623,10277
66255,102677,24314,49429,20162,78361,19902,9625,10277
66260,102688,24317,49436,20165,78370,19904,9627,10277
66265,102692,24319,49438,20167,78372,19904,9627,10277
66270,102702,24323,49442,20170,78379,19906,9628,10278
66275,102708,24324,49444,20171,78384,19908,9629,10279
66280,102719,24325,49448,20171,78393,19910,9629,10281
66285,102723,24327,49450,20173,78395,19910,9629,10281
66290,102733,24331,49456,20177,78402,19912,9629,10283
66295,102739,24331,49457,20177,78408,19914,9630,10284
66300,102750,24332,49463,20178,78418,19916,9631,10285
66305,102754,24334,49465,20179,78419,19916,9631,10285
66310,102764,24336,49470,20180,78428,19918,9632,10286
66315,102770,24336,49473,20180,78433,19920,9633,10287
66320,102781,24338,49481,20182,78443,19922,9634,10288
66325,102785,24340,49484,20183,78444,19922,9634,10288
66330,102795,24343,49491,20186,78452,19924,9635,10289
66335,102801,24343,49492,20186,78458,19926,9636,10290
66340,102812,24345,49498,20188,78467,19928,9637,10291
66345,102816,24346,49499,20188,78469,19928,9637,10291
66350,102826,24349,49507,20191,78477,19930,9639,10291
66355,102832,24350,49508,20192,78482,19932,9639,10293
66360,102843,24351,49514,20193,78492,19934,9641,10293
66365,102847,24353,49517,20195,78494,19934,9641,10293
66370,102857,24356,49522,20197,78501,19936,9642,10294
66375,102863,24357,49528,20198,78505,19938,9644,10294
66380,102874,24358,49535,20199,78516,19940,9646,10294
66385,102878,24360,49538,20201,78518,19940,9646,10294
66390,102888,24362,49543,20201,78526,19942,9647,10295
66395,102894,24362,49546,20201,78532,19944,9648,10296
66400,102905,24362,49550,20201,78543,19946,9649,10297
66405,102909,24362,49551,20201,78547,19946,9649,10297
66410,102919,24365,49557,20203,78554,19948,9649,10299
66415,102925,24366,49560,20204,78559,19950,9650,10300
66420,102936,24366,49565,20204,78570,19952,9651,10301
66425,102940,24366,49567,20204,78574,19952,9651,10301
66430,102950,24369,49573,20207,78581,19954,9652,10302
66435,102956,24369,49574,20207,78586,19956,9652,10304
66440,102967,24369,49580,20207,78598,19958,9653,10305
66445,102971,24370,49583,20208,78601,19958,9653,10305
66450,102981,24372,49585,20208,78609,19960,9653,10307
66455,102987,24372,49589,20208,78613,19962,9654,10308
66460,102998,24374,49593,20210,78624,19964,9656,10308
66465,103002,24374,49593,20210,78628,19964,9656,10308
66470,103012,24376,49596,20211,78636,19966,9657,10309
66475,103018,24377,49600,20212,78639,19968,9657,10311
66480,103029,24380,49604,20215,78649,19970,9659,10311
66485,103033,24380,49604,20215,78653,19970,9659,10311
66490,103043,24382,49608,20216,78661,19972,9659,10313
66495,103049,24383,49614,20217,78664,19974,9661,10313
66500,103060,24385,49619,20219,78674,19976,9661,10315
66505,103064,24387,49622,20221,78677,19976,9661,10315
66510,103074,24390,49626,20223,78684,19978,9662,10316
66515,103080,24391,49630,20224,78687,19980,9663,10317
66520,103091,24392,49635,20225,78699,19982,9664,10318
66525,103095,24392,49637,20225,78703,19982,9664,10318
66530,103105,24394,49641,20227,78711,19984,9665,10319
66535,103111,24395,49645,20228,78714,19986,9666,10320
66540,103122,24396,49649,20229,78725,19988,9667,10321
66545,103126,24397,49650,20230,78729,19988,9667,10321
66550,103136,24400,49656,20232,78736,19990,9668,10322
66555,103142,24400,49659,20232,78740,19992,9669,10323
66560,103153,24402,49665,20234,78751,19994,9670,10324
66565,103157,24402,49667,20234,78755,19994,9670,10324
66570,103167,24404,49670,20236,78763,19996,9671,10325
66575,103173,24404,49674,20236,78768,19998,9673,10325
66580,103184,24405,49680,20237,78778,20000,9674,10326
66585,103188,24406,49681,20238,78782,20000,9674,10326
66590,103198,24410,49686,20241,78788,20002,9674,10328
66595,103204,24411,49689,20242,78792,20004,9674,10330
66600,103215,24412,49693,20243,78803,20006,9674,10332
66605,103219,24412,49694,20243,78806,20006,9674,10332
66610,103229,24415,49697,20246,78814,20008,9674,10334
66615,103235,24416,49702,20247,78817,20010,9675,10335
66620,103246,24418,49708,20249,78827,20012,9677,10335
66625,103250,24419,49711,20250,78831,20012,9677,10335
66630,103260,24420,49716,20251,78840,20014,9678,10336
66635,103266,24420,49720,20251,78845,20016,9679,10337
66640,103277,24421,49725,20252,78856,20018,9679,10339
66645,103281,24421,49727,20252,78860,20018,9679,10339
66650,103291,24422,49731,20253,78869,20020,9680,10340
66655,103297,24422,49734,20253,78874,20022,9681,10341
66660,103308,24423,49742,20254,78885,20024,9683,10341
66665,103312,24423,49744,20254,78888,20024,9683,10341
66670,103322,24424,49749,20254,78898,20026,9684,10342
66675,103328,24424,49753,20254,78904,20028,9686,10342
66680,103339,24425,49757,20255,78914,20030,9687,10343
66685,103343,24425,49759,20255,78917,20030,9687,10343
66690,103353,24427,49765,20257,78926,20032,9688,10344
66695,103359,24427,49767,20257,78931,20034,9688,10346
66700,103370,24428,49775,20258,78942,20036,9690,10346
66705,103374,24428,49777,20258,78945,20036,9690,10346
66710,103384,24429,49783,20258,78955,20038,9690,10348
66715,103390,24429,49785,20258,78961,20040,9691,10349
66720,103401,24429,49790,20258,78972,20042,9691,10351
66725,103405,24429,49791,20258,78975,20042,9691,10351
66730,103415,24433,49794,20261,78982,20044,9691,10353
66735,103421,24434,49797,20262,78986,20046,9691,10355
66740,103432,24436,49803,20264,78995,20048,9692,10356
66745,103436,24437,49805,20265,78998,20048,9692,10356
66750,103446,24440,49806,20266,79006,20050,9692,10358
66755,103452,24440,49809,20266,79010,20052,9693,10359
66760,103463,24443,49818,20269,79019,20054,9695,10359
66765,103467,24445,49821,20271,79020,20054,9695,10359
66770,103477,24450,49825,20274,79027,20056,9697,10359
66775,103483,24451,49828,20275,79032,20058,9698,10360
66780,103494,24451,49831,20275,79043,20060,9698,10362
66785,103498,24452,49834,20276,79044,20060,9698,10362
66790,103508,24457,49839,20280,79051,20062,9699,10363
66795,103514,24457,49841,20280,79057,20064,9701,10363
66800,103525,24457,49847,20280,79068,20066,9703,10363
66805,103529,24458,49850,20281,79070,20066,9703,10363
66810,103539,24461,49854,20284,79078,20068,9703,10365
66815,103545,24461,49855,20284,79084,20070,9704,10366
66820,103556,24461,49861,20284,79095,20072,9705,10367
66825,103560,24461,49862,20284,79099,20072,9705,10367
66830,103570,24464,49868,20285,79106,20074,9706,10368
66835,103576,24464,49871,20285,79111,20076,9707,10369
66840,103587,24465,49876,20286,79122,20078,9707,10371
66845,103591,24465,49879,20286,79125,20078,9707,10371
66850,103601,24468,49886,20288,79133,20080,9708,10372
66855,103607,24469,49889,20289,79138,20082,9709,10373
66860,103618,24470,49894,20290,79148,20084,9709,10375
66865,103622,24471,49896,20291,79151,20084,9709,10375
66870,103632,24473,49900,20292,79159,20086,9710,10376
66875,103638,24473,49903,20292,79164,20088,9711,10377
66880,103649,24473,49906,20292,79176,20090,9711,10379
66885,103653,24473,49908,20292,79179,20090,9711,10379
66890,103663,24475,49916,20294,79188,20092,9713,10379
66895,103669,24475,49917,20294,79194,20094,9714,10380
66900,103680,24475,49922,20294,79205,20096,9715,10381
66905,103684,24475,49923,20294,79209,20096,9715,10381
66910,103694,24477,49927,20295,79217,20098,9717,10381
66915,103700,24477,49929,20295,79223,20100,9718,10382
66920,103711,24477,49934,20295,79233,20102,9718,10384
66925,103715,24479,49936,20297,79235,20102,9718,10384
66930,103725,24483,49939,20299,79242,20104,9718,10386
66935,103731,24483,49943,20299,79246,20106,9720,10386
66940,103742,24485,49948,20301,79257,20108,9722,10386
66945,103746,24485,49950,20301,79260,20108,9722,10386
66950,103756,24489,49955,20303,79267,20110,9723,10387
66955,103762,24489,49957,20303,79272,20112,9724,10388
66960,103773,24490,49964,20304,79283,20114,9725,10389
66965,103777,24490,49966,20304,79285,20114,9725,10389
66970,103787,24494,49969,20306,79293,20116,9726,10390
66975,103793,24494,49974,20306,79297,20118,9727,10391
66980,103804,24495,49978,20307,79309,20120,9728,10392
66985,103808,24496,49980,20308,79312,20120,9728,10392
66990,103818,24498,49983,20310,79320,20122,9728,10394
66995,103824,24498,49986,20310,79325,20124,9729,10395
67000,103835,24498,49993,20310,79337,20126,9731,10395
67005,103839,24498,49995,20310,79341,20126,9731,10395
67010,103849,24500,50000,20311,79349,20128,9732,10396
67015,103855,24500,50004,20311,79354,20130,9733,10397
67020,103866,24501,50009,20312,79364,20132,9734,10398
67025,103870,24502,50009,20313,79368,20132,9734,10398
67030,103880,24504,50015,20315,79376,20134,9735,10399
67035,103886,24504,50018,20315,79381,20136,9736,10400
67040,103897,24505,50022,20316,79391,20138,9737,10401
67045,103901,24506,50024,20317,79395,20138,9737,10401
67050,103911,24508,50026,20317,79403,20140,9737,10403
67055,103917,24508,50028,20317,79408,20142,9737,10405
67060,103928,24509,50031,20318,79419,20144,9737,10407
67065,103932,24510,50033,20319,79422,20144,9737,10407
67070,103942,24512,50038,20320,79430,20146,9738,10408
67075,103948,24512,50044,20320,79434,20148,9740,10408
67080,103959,24514,50053,20322,79444,20150,9742,10408
67085,103963,24515,50055,20323,79447,20150,9742,10408
67090,103973,24517,50060,20324,79456,20152,9743,10409
67095,103979,24517,50060,20324,79462,20154,9743,10411
67100,103990,24517,50066,20324,79473,20156,9743,10413
67105,103994,24517,50067,20324,79476,20156,9743,10413
67110,104004,24517,50074,20324,79487,20158,9745,10413
67115,104010,24517,50077,20324,79492,20160,9746,10414
67120,104021,24517,50085,20324,79504,20162,9748,10414
67125,104025,24517,50087,20324,79507,20162,9748,10414
67130,104035,24517,50093,20324,79518,20164,9749,10415
67135,104041,24517,50096,20324,79523,20166,9749,10417
67140,104052,24517,50102,20324,79535,20168,9751,10417
67145,104056,24517,50103,20324,79538,20168,9751,10417
67150,104066,24517,50106,20324,79549,20170,9752,10418
67155,104072,24517,50108,20324,79555,20172,9752,10420
67160,104083,24517,50114,20324,79566,20174,9752,10422
67165,104087,24517,50116,20324,79570,20174,9752,10422
67170,104097,24517,50120,20324,79580,20176,9752,10424
67175,104103,24517,50124,20324,79585,20178,9754,10424
67180,104114,24517,50129,20324,79597,20180,9754,10426
67185,104118,24517,50131,20324,79600,20180,9754,10426
67190,104128,24518,50136,20325,79610,20182,9755,10427
67195,104134,24518,50137,20325,79616,20184,9755,10429
67200,104145,24518,50140,20325,79627,20186,9756,10430
67205,104149,24519,50142,20326,79629,20186,9756,10430
67210,104159,24522,50147,20329,79637,20188,9756,10432
67215,104165,24522,50151,20329,79641,20190,9757,10433
67220,104176,24524,50158,20331,79652,20192,9759,10433
67225,104180,24525,50161,20332,79654,20192,9759,10433
67230,104190,24527,50166,20333,79663,20194,9760,10434
67235,104196,24527,50167,20333,79669,20196,9760,10436
67240,104207,24527,50173,20333,79679,20198,9761,10437
67245,104211,24528,50174,20334,79682,20198,9761,10437
67250,104221,24530,50178,20335,79691,20200,9761,10439
67255,104227,24530,50180,20335,79697,20202,9762,10440
67260,104238,24530,50183,20335,79708,20204,9763,10441
67265,104242,24530,50185,20335,79711,20204,9763,10441
67270,104252,24533,50188,20337,79719,20206,9764,10442
67275,104258,24533,50191,20337,79725,20208,9765,10443
67280,104269,24533,50194,20337,79735,20210,9765,10445
67285,104273,24534,50196,20338,79738,20210,9765,10445
67290,104283,24537,50200,20340,79746,20212,9766,10446
67295,104289,24537,50204,20340,79751,20214,9767,10447
67300,104300,24538,50210,20341,79761,20216,9769,10447
67305,104304,24539,50211,20342,79764,20216,9769,10447
67310,104314,24540,50217,20342,79774,20218,9770,10448
67315,104320,24540,50218,20342,79780,20220,9770,10450
67320,104331,24540,50224,20342,79791,20222,9772,10450
67325,104335,24541,50227,20343,79793,20222,9772,10450
67330,104345,24542,50232,20344,79803,20224,9774,10450
67335,104351,24542,50234,20344,79809,20226,9774,10452
67340,104362,24542,50240,20344,79820,20228,9775,10453
67345,104366,24542,50242,20344,79823,20228,9775,10453
67350,104376,24543,50248,20344,79833,20230,9777,10453
67355,104382,24543,50251,20344,79839,20232,9778,10454
67360,104393,24543,50256,20344,79850,20234,9779,10455
67365,104397,24544,50258,20345,79853,20234,9779,10455
67370,104407,24545,50263,20346,79862,20236,9780,10456
67375,104413,24545,50266,20346,79867,20238,9782,10456
67380,104424,24545,50268,20346,79879,20240,9782,10458
67385,104428,24545,50270,20346,79882,20240,9782,10458
67390,104438,24546,50272,20346,79892,20242,9783,10459
67395,104444,24546,50274,20346,79898,20244,9784,10460
67400,104455,24546,50277,20346,79909,20246,9785,10461
67405,104459,24546,50279,20346,79912,20246,9785,10461
67410,104469,24548,50281,20347,79921,20248,9786,10462
67415,104475,24548,50283,20347,79926,20250,9787,10463
67420,104486,24549,50291,20348,79936,20252,9789,10463
67425,104490,24551,50292,20350,79939,20252,9789,10463
67430,104500,24552,50297,20351,79948,20254,9789,10465
67435,104506,24552,50301,20351,79952,20256,9790,10466
67440,104517,24554,50305,20353,79963,20258,9791,10467
67445,104521,24554,50308,20353,79965,20258,9791,10467
67450,104531,24558,50315,20357,79973,20260,9791,10469
67455,104537,24558,50318,20357,79978,20262,9792,10470
67460,104548,24558,50325,20357,79990,20264,9792,10472
67465,104552,24558,50326,20357,79994,20264,9792,10472
67470,104562,24559,50332,20358,80003,20266,9793,10473
67475,104568,24559,50336,20358,80009,20268,9795,10473
67480,104579,24559,50338,20358,80020,20270,9795,10475
67485,104583,24560,50341,20359,80023,20270,9795,10475
67490,104593,24561,50346,20360,80032,20272,9796,10476
67495,104599,24561,50347,20360,80038,20274,9797,10477
67500,104610,24561,50352,20360,80049,20276,9798,10478
67505,104614,24561,50353,20360,80053,20276,9798,10478
67510,104624,24562,50357,20360,80062,20278,9800,10478
67515,104630,24562,50359,20360,80068,20280,9801,10479
67520,104641,24562,50362,20360,80079,20282,9802,10480
67525,104645,24563,50365,20361,80082,20282,9802,10480
67530,104655,24564,50370,20361,80091,20284,9803,10481
67535,104661,24564,50374,20361,80095,20286,9804,10482
67540,104672,24565,50379,20362,80107,20288,9805,10483
67545,104676,24566,50382,20363,80110,20288,9805,10483
67550,104686,24567,50386,20364,80119,20290,9806,10484
67555,104692,24567,50390,20364,80124,20292,9808,10484
67560,104703,24568,50395,20365,80134,20294,9808,10486
67565,104707,24570,50398,20367,80136,20294,9808,10486
67570,104717,24573,50404,20369,80144,20296,9810,10486
67575,104723,24573,50406,20369,80149,20298,9810,10488
67580,104734,24574,50412,20370,80159,20300,9812,10488
67585,104738,24576,50415,20372,80161,20300,9812,10488
67590,104748,24579,50420,20375,80169,20302,9813,10489
67595,104754,24579,50424,20375,80174,20304,9813,10491
67600,104765,24579,50426,20375,80186,20306,9813,10493
67605,104769,24579,50428,20375,80190,20306,9813,10493
67610,104779,24579,50434,20375,80200,20308,9814,10494
67615,104785,24579,50437,20375,80205,20310,9815,10495
67620,104796,24579,50444,20375,80217,20312,9816,10496
67625,104800,24579,50446,20375,80221,20312,9816,10496
67630,104810,24579,50449,20375,80231,20314,9816,10498
67635,104816,24579,50451,20375,80236,20316,9816,10500
67640,104827,24579,50454,20375,80248,20318,9817,10501
67645,104831,24579,50456,20375,80251,20318,9817,10501
67650,104841,24579,50463,20375,80262,20320,9819,10501
67655,104847,24579,50467,20375,80267,20322,9820,10502
67660,104858,24579,50471,20375,80279,20324,9821,10503
67665,104862,24579,50473,20375,80282,20324,9821,10503
67670,104872,24579,50477,20375,80293,20326,9821,10505
67675,104878,24579,50480,20375,80298,20328,9822,10506
67680,104889,24579,50485,20375,80310,20330,9824,10506
67685,104893,24579,50486,20375,80313,20330,9824,10506
67690,104903,24579,50491,20375,80324,20332,9826,10506
67695,104909,24579,50493,20375,80329,20334,9827,10507
67700,104920,24580,50497,20376,80340,20336,9827,10509
67705,104924,24581,50498,20377,80343,20336,9827,10509
67710,104934,24582,50500,20378,80352,20338,9827,10511
67715,104940,24582,50502,20378,80356,20340,9827,10513
67720,104951,24583,50506,20379,80368,20342,9828,10514
67725,104955,24583,50508,20379,80370,20342,9828,10514
67730,104965,24587,50511,20382,80378,20344,9828,10516
67735,104971,24587,50514,20382,80382,20346,9830,10516
67740,104982,24588,50517,20383,80393,20348,9831,10517
67745,104986,24590,50520,20385,80394,20348,9831,10517
67750,104996,24593,50525,20388,80403,20350,9832,10518
67755,105002,24593,50528,20388,80408,20352,9834,10518
67760,105013,24594,50534,20389,80419,20354,9836,10518
67765,105017,24594,50536,20389,80422,20354,9836,10518
67770,105027,24596,50541,20391,80431,20356,9836,10520
67775,105033,24596,50542,20391,80436,20358,9836,10522
67780,105044,24596,50547,20391,80448,20360,9837,10523
67785,105048,24596,50549,20391,80450,20360,9837,10523
67790,105058,24599,50554,20394,80459,20362,9839,10523
67795,105064,24599,50556,20394,80464,20364,9840,10524
67800,105075,24600,50558,20395,80475,20366,9840,10526
67805,105079,24601,50562,20396,80477,20366,9840,10526
67810,105089,24602,50566,20397,80487,20368,9841,10527
67815,105095,24602,50570,20397,80492,20370,9843,10527
67820,105106,24602,50574,20397,80504,20372,9843,10529
67825,105110,24603,50578,20398,80506,20372,9843,10529
67830,105120,24604,50582,20398,80516,20374,9844,10530
67835,105126,24604,50584,20398,80521,20376,9844,10532
67840,105137,24604,50588,20398,80533,20378,9844,10534
67845,105141,24605,50591,20399,80536,20378,9844,10534
67850,105151,24606,50598,20399,80545,20380,9846,10534
67855,105157,24606,50600,20399,80550,20382,9846,10536
67860,105168,24606,50602,20399,80562,20384,9846,10538
67865,105172,24606,50602,20399,80566,20384,9846,10538
67870,105182,24607,50607,20400,80575,20386,9846,10540
67875,105188,24607,50610,20400,80580,20388,9847,10541
67880,105199,24607,50613,20400,80592,20390,9848,10542
67885,105203,24607,50614,20400,80595,20390,9848,10542
67890,105213,24608,50620,20401,80605,20392,9848,10544
67895,105219,24608,50621,20401,80610,20394,9848,10546
67900,105230,24608,50625,20401,80622,20396,9848,10548
67905,105234,24608,50627,20401,80624,20396,9848,10548
67910,105244,24612,50632,20405,80632,20398,9850,10548
67915,105250,24612,50637,20405,80637,20400,9852,10548
67920,105261,24613,50644,20406,80648,20402,9854,10548
67925,105265,24613,50645,20406,80652,20402,9854,10548
67930,105275,24614,50652,20406,80661,20404,9856,10548
67935,105281,24614,50654,20406,80666,20406,9857,10549
67940,105292,24614,50658,20406,80678,20408,9858,10550
67945,105296,24614,50659,20406,80682,20408,9858,10550
67950,105306,24615,50662,20407,80691,20410,9859,10551
67955,105312,24615,50663,20407,80695,20412,9859,10553
67960,105323,24616,50668,20408,80707,20414,9860,10554
67965,105327,24617,50670,20409,80710,20414,9860,10554
67970,105337,24618,50673,20409,80719,20416,9860,10556
67975,105343,24618,50677,20409,80724,20418,9861,10557
67980,105354,24618,50681,20409,80736,20420,9862,10558
67985,105358,24618,50683,20409,80740,20420,9862,10558
67990,105368,24619,50690,20409,80749,20422,9864,10558
67995,105374,24619,50694,20409,80753,20424,9864,10560
68000,105385,24620,50699,20410,80765,20426,9865,10561
68005,105389,24620,50700,20410,80769,20426,9865,10561
68010,105399,24621,50709,20411,80778,20428,9866,10562
68015,105405,24621,50713,20411,80782,20430,9867,10563
68020,105416,24622,50718,20412,80794,20432,9869,10563
68025,105420,24623,50721,20413,80796,20432,9869,10563
68030,105430,24626,50726,20415,80804,20434,9870,10564
68035,105436,24626,50730,20415,80809,20436,9872,10564
68040,105447,24627,50737,20416,80819,20438,9874,10564
68045,105451,24629,50740,20418,80821,20438,9874,10564
68050,105461,24632,50746,20420,80829,20440,9875,10565
68055,105467,24632,50749,20420,80834,20442,9877,10565
68060,105478,24632,50755,20420,80845,20444,9877,10567
68065,105482,24634,50759,20422,80848,20444,9877,10567
68070,105492,24635,50763,20423,80857,20446,9877,10569
68075,105498,24635,50765,20423,80861,20448,9878,10570
68080,105509,24636,50772,20424,80872,20450,9879,10571
68085,105513,24637,50773,20425,80876,20450,9879,10571
68090,105523,24638,50779,20425,80885,20452,9881,10571
68095,105529,24638,50782,20425,80889,20454,9882,10572
68100,105540,24639,50790,20426,80900,20456,9884,10572
68105,105544,24640,50790,20427,80904,20456,9884,10572
68110,105554,24640,50792,20427,80914,20458,9885,10573
68115,105560,24640,50794,20427,80919,20460,9886,10574
68120,105571,24640,50800,20427,80931,20462,9887,10575
68125,105575,24640,50802,20427,80935,20462,9887,10575
68130,105585,24640,50805,20427,80945,20464,9887,10577
68135,105591,24640,50807,20427,80950,20466,9887,10579
68140,105602,24640,50813,20427,80962,20468,9889,10579
68145,105606,24640,50814,20427,80966,20468,9889,10579
68150,105616,24640,50819,20427,80976,20470,9889,10581
68155,105622,24640,50823,20427,80981,20472,9890,10582
68160,105633,24640,50826,20427,80993,20474,9890,10584
68165,105637,24640,50828,20427,80997,20474,9890,10584
68170,105647,24640,50832,20427,81007,20476,9892,10584
68175,105653,24640,50837,20427,81012,20478,9893,10585
68180,105664,24640,50844,20427,81024,20480,9894,10586
68185,105668,24640,50848,20427,81027,20480,9894,10586
68190,105678,24640,50855,20427,81038,20482,9895,10587
68195,105684,24640,50857,20427,81043,20484,9896,10588
68200,105695,24640,50862,20427,81055,20486,9898,10588
68205,105699,24640,50863,20427,81059,20486,9898,10588
68210,105709,24642,50866,20429,81067,20488,9898,10590
68215,105715,24642,50870,20429,81071,20490,9900,10590
68220,105726,24643,50878,20430,81082,20492,9902,10590
68225,105730,24645,50880,20432,81084,20492,9902,10590
68230,105740,24648,50884,20434,81092,20494,9902,10592
68235,105746,24648,50887,20434,81096,20496,9902,10594
68240,105757,24649,50891,20435,81108,20498,9903,10595
68245,105761,24650,50893,20436,81111,20498,9903,10595
68250,105771,24651,50897,20437,81120,20500,9904,10596
68255,105777,24651,50899,20437,81124,20502,9904,10598
68260,105788,24652,50904,20438,81136,20504,9905,10599
68265,105792,24653,50906,20439,81138,20504,9905,10599
68270,105802,24656,50912,20442,81146,20506,9906,10600
68275,105808,24656,50915,20442,81151,20508,9906,10602
68280,105819,24657,50923,20443,81161,20510,9907,10603
68285,105823,24659,50926,20445,81162,20510,9907,10603
68290,105833,24662,50930,20448,81171,20512,9907,10605
68295,105839,24662,50933,20448,81176,20514,9908,10606
68300,105850,24663,50938,20449,81186,20516,9909,10607
68305,105854,24664,50939,20450,81189,20516,9909,10607
68310,105864,24665,50944,20451,81199,20518,9911,10607
68315,105870,24665,50945,20451,81205,20520,9912,10608
68320,105881,24665,50950,20451,81216,20522,9914,10608
68325,105885,24665,50954,20451,81219,20522,9914,10608
68330,105895,24665,50957,20451,81230,20524,9915,10609
68335,105901,24665,50960,20451,81235,20526,9916,10610
68340,105912,24665,50966,20451,81247,20528,9918,10610
68345,105916,24665,50969,20451,81250,20528,9918,10610
68350,105926,24665,50972,20451,81261,20530,9918,10612
68355,105932,24665,50977,20451,81266,20532,9920,10612
68360,105943,24665,50983,20451,81278,20534,9922,10612
68365,105947,24665,50986,20451,81281,20534,9922,10612
68370,105957,24665,50991,20451,81292,20536,9924,10612
68375,105963,24665,50995,20451,81297,20538,9925,10613
68380,105974,24665,51001,20451,81309,20540,9926,10614
68385,105978,24665,51002,20451,81313,20540,9926,10614
68390,105988,24665,51006,20451,81323,20542,9928,10614
68395,105994,24665,51010,20451,81328,20544,9929,10615
68400,106005,24665,51015,20451,81340,20546,9931,10615
68405,106009,24665,51016,20451,81344,20546,9931,10615
68410,106019,24665,51020,20451,81354,20548,9931,10617
68415,106025,24665,51023,20451,81360,20550,9932,10618
68420,106036,24665,51026,20451,81371,20552,9933,10619
68425,106040,24665,51028,20451,81375,20552,9933,10619
68430,106050,24666,51035,20452,81384,20554,9934,10620
68435,106056,24666,51037,20452,81390,20556,9935,10621
68440,106067,24666,51042,20452,81401,20558,9935,10623
68445,106071,24666,51044,20452,81404,20558,9935,10623
68450,106081,24667,51047,20452,81414,20560,9935,10625
68455,106087,24667,51049,20452,81419,20562,9936,10626
68460,106098,24668,51057,20453,81429,20564,9937,10627
68465,106102,24670,51059,20455,81431,20564,9937,10627
68470,106112,24672,51068,20457,81440,20566,9939,10627
68475,106118,24672,51071,20457,81445,20568,9941,10627
68480,106129,24673,51076,20458,81455,20570,9942,10628
68485,106133,24675,51077,20460,81458,20570,9942,10628
68490,106143,24676,51082,20461,81467,20572,9944,10628
68495,106149,24676,51086,20461,81472,20574,9945,10629
68500,106160,24677,51090,20462,81483,20576,9947,10629
68505,106164,24677,51090,20462,81487,20576,9947,10629
68510,106174,24678,51095,20462,81496,20578,9948,10630
68515,106180,24678,51097,20462,81502,20580,9948,10632
68520,106191,24678,51104,20462,81513,20582,9949,10633
68525,106195,24678,51105,20462,81517,20582,9949,10633
68530,106205,24679,51110,20463,81526,20583,9949,10634
68535,106211,24679,51113,20463,81531,20584,9950,10634
68540,106222,24680,51116,20464,81542,20586,9951,10635
68545,106226,24681,51120,20465,81544,20586,9951,10635
68550,106236,24683,51125,20467,81553,20587,9952,10635
68555,106242,24683,51128,20467,81558,20588,9953,10635
68560,106253,24684,51134,20468,81569,20590,9955,10635
68565,106257,24685,51136,20469,81572,20590,9955,10635
68570,106267,24686,51141,20470,81581,20591,9955,10636
68575,106273,24686,51147,20470,81586,20592,9956,10636
68580,106284,24687,51152,20471,81596,20594,9957,10637
68585,106288,24688,51154,20472,81599,20594,9957,10637
68590,106298,24690,51159,20474,81608,20595,9957,10638
68595,106304,24690,51164,20474,81613,20596,9957,10639
68600,106315,24691,51169,20475,81624,20598,9958,10640
68605,106319,24691,51170,20475,81627,20598,9958,10640
68610,106329,24693,51175,20477,81636,20599,9958,10641
68615,106335,24693,51177,20477,81642,20600,9958,10642
68620,106346,24693,51178,20477,81653,20602,9958,10644
68625,106350,24694,51181,20478,81655,20602,9958,10644
68630,106360,24696,51186,20480,81664,20603,9958,10645
68635,106366,24696,51188,20480,81670,20604,9959,10645
68640,106377,24696,51193,20480,81681,20606,9959,10647
68645,106381,24696,51193,20480,81685,20606,9959,10647
68650,106391,24697,51198,20481,81694,20607,9959,10648
68655,106397,24697,51201,20481,81699,20608,9960,10648
68660,106408,24698,51207,20482,81710,20610,9962,10648
68665,106412,24698,51208,20482,81714,20610,9962,10648
68670,106422,24699,51211,20482,81723,20611,9962,10649
68675,106428,24699,51215,20482,81728,20612,9963,10649
68680,106439,24700,51220,20483,81739,20614,9964,10650
68685,106443,24700,51220,20483,81743,20614,9964,10650
68690,106453,24701,51223,20484,81752,20615,9965,10650
68695,106459,24701,51225,20484,81758,20616,9965,10651
68700,106470,24701,51229,20484,81769,20618,9966,10652
68705,106474,24701,51229,20484,81773,20618,9966,10652
68710,106484,24702,51236,20485,81782,20619,9967,10652
68715,106490,24702,51238,20485,81787,20620,9967,10653
68720,106501,24703,51240,20486,81797,20622,9967,10655
68725,106505,24705,51242,20488,81799,20622,9967,10655
68730,106515,24707,51245,20489,81808,20623,9967,10656
68735,106521,24707,51249,20489,81813,20624,9968,10656
68740,106532,24708,51256,20490,81823,20626,9969,10657
68745,106536,24710,51258,20492,81825,20626,9969,10657
68750,106546,24712,51263,20493,81834,20627,9969,10658
68755,106552,24712,51264,20493,81840,20628,9969,10659
68760,106563,24712,51269,20493,81850,20630,9970,10660
68765,106567,24713,51270,20494,81854,20630,9970,10660
68770,106577,24714,51274,20495,81863,20631,9971,10660
68775,106583,24714,51279,20495,81868,20632,9972,10660
68780,106594,24715,51284,20496,81879,20634,9972,10662
68785,106598,24716,51287,20497,81881,20634,9972,10662
68790,106608,24718,51292,20498,81890,20635,9973,10662
68795,106614,24718,51293,20498,81896,20636,9973,10663
68800,106625,24718,51297,20498,81906,20638,9973,10665
68805,106629,24719,51299,20499,81910,20638,9973,10665
68810,106639,24720,51305,20500,81919,20639,9974,10665
68815,106645,24720,51309,20500,81924,20640,9974,10666
68820,106656,24721,51314,20501,81934,20642,9974,10668
68825,106660,24722,51316,20502,81938,20642,9974,10668
68830,106670,24723,51318,20502,81947,20643,9974,10669
68835,106676,24723,51321,20502,81952,20644,9974,10670
68840,106687,24724,51328,20503,81962,20646,9975,10671
68845,106691,24726,51330,20505,81965,20646,9975,10671
68850,106701,24727,51335,20506,81974,20646,9975,10671
68855,106707,24727,51338,20506,81979,20647,9975,10672
68860,106718,24728,51342,20507,81990,20649,9975,10674
68865,106722,24729,51345,20508,81993,20649,9975,10674
68870,106732,24730,51350,20509,82002,20649,9975,10674
68875,106738,24730,51353,20509,82007,20650,9975,10675
68880,106749,24731,51356,20510,82018,20652,9975,10677
68885,106753,24731,51357,20510,82022,20652,9975,10677
68890,106763,24732,51360,20510,82031,20652,9975,10677
68895,106769,24732,51362,20510,82037,20653,9976,10677
68900,106780,24732,51364,20510,82048,20655,9978,10677
68905,106784,24732,51366,20510,82052,20655,9978,10677
68910,106794,24733,51372,20510,82061,20655,9978,10677
68915,106800,24733,51375,20510,82067,20656,9979,10677
68920,106811,24733,51381,20510,82077,20658,9980,10678
68925,106815,24734,51382,20511,82080,20658,9980,10678
68930,106825,24736,51386,20512,82089,20658,9980,10678
68935,106831,24736,51388,20512,82094,20659,9980,10679
68940,106842,24737,51396,20513,82104,20661,9982,10679
68945,106846,24739,51398,20515,82107,20661,9982,10679
68950,106856,24740,51402,20516,82116,20662,9982,10680
68955,106862,24740,51405,20516,82122,20663,9983,10680
68960,106873,24740,51412,20516,82132,20665,9984,10681
68965,106877,24741,51413,20517,82136,20665,9984,10681
68970,106887,24742,51417,20518,82145,20666,9984,10682
68975,106893,24742,51419,20518,82151,20667,9984,10683
68980,106904,24742,51423,20518,82162,20669,9984,10685
68985,106908,24742,51425,20518,82166,20669,9984,10685
68990,106918,24743,51433,20519,82175,20670,9985,10685
68995,106924,24743,51438,20519,82180,20671,9986,10685
69000,106935,24744,51444,20520,82191,20673,9988,10685
69005,106939,24745,51446,20521,82194,20673,9988,10685
69010,106949,24746,51450,20522,82203,20674,9988,10686
69015,106955,24746,51454,20522,82208,20675,9989,10686
69020,106966,24747,51459,20523,82218,20677,9989,10688
69025,106970,24749,51463,20525,82220,20677,9989,10688
69030,106980,24751,51468,20526,82229,20678,9990,10688
69035,106986,24751,51469,20526,82235,20679,9991,10688
69040,106997,24751,51473,20526,82245,20681,9993,10688
69045,107001,24752,51475,20527,82248,20681,9993,10688
69050,107011,24754,51482,20529,82257,20682,9993,10689
69055,107017,24754,51484,20529,82263,20683,9993,10690
69060,107028,24754,51490,20529,82274,20685,9994,10691
69065,107032,24754,51493,20529,82277,20685,9994,10691
69070,107042,24756,51498,20531,82286,20685,9994,10691
69075,107048,24756,51500,20531,82291,20686,9995,10691
69080,107059,24757,51506,20532,82301,20688,9996,10692
69085,107063,24759,51509,20534,82303,20688,9996,10692
69090,107073,24761,51515,20536,82312,20688,9996,10692
69095,107079,24761,51518,20536,82318,20689,9996,10693
69100,107090,24761,51525,20536,82328,20691,9997,10694
69105,107094,24762,51528,20537,82331,20691,9997,10694
69110,107104,24764,51531,20538,82340,20691,9997,10694
69115,107110,24764,51535,20538,82346,20692,9998,10694
69120,107121,24764,51540,20538,82356,20694,9998,10696
69125,107125,24765,51541,20539,82359,20694,9998,10696
69130,107135,24766,51548,20540,82369,20694,9998,10696
69135,107141,24766,51550,20540,82375,20695,9998,10697
69140,107152,24766,51555,20540,82386,20697,9999,10698
69145,107156,24766,51557,20540,82390,20697,9999,10698
69150,107166,24766,51561,20540,82400,20697,9999,10698
69155,107172,24766,51566,20540,82406,20698,10000,10698
69160,107183,24766,51574,20540,82417,20700,10002,10698
69165,107187,24766,51576,20540,82421,20700,10002,10698
69170,107197,24766,51580,20540,82431,20701,10003,10698
69175,107203,24766,51585,20540,82437,20702,10004,10698
69180,107214,24766,51589,20540,82448,20704,10005,10699
69185,107218,24766,51591,20540,82452,20704,10005,10699
69190,107228,24766,51596,20540,82462,20705,10005,10700
69195,107234,24766,51598,20540,82468,20706,10005,10701
69200,107245,24766,51604,20540,82479,20708,10006,10702
69205,107249,24766,51605,20540,82483,20708,10006,10702
69210,107259,24766,51612,20540,82493,20709,10007,10702
69215,107265,24766,51615,20540,82499,20710,10008,10702
69220,107276,24766,51620,20540,82510,20712,10009,10703
69225,107280,24766,51621,20540,82514,20712,10009,10703
69230,107290,24766,51626,20540,82524,20713,10009,10704
69235,107296,24766,51628,20540,82529,20714,10009,10705
69240,107307,24767,51633,20541,82540,20716,10010,10706
69245,107311,24768,51634,20542,82543,20716,10010,10706
69250,107321,24769,51636,20542,82552,20716,10010,10706
69255,107327,24769,51640,20542,82557,20717,10011,10706
69260,107338,24770,51646,20543,82568,20719,10011,10708
69265,107342,24771,51647,20544,82571,20719,10011,10708
69270,107352,24772,51652,20545,82580,20719,10011,10708
69275,107358,24772,51655,20545,82585,20720,10012,10708
69280,107369,24773,51662,20546,82596,20722,10013,10709
69285,107373,24774,51665,20547,82599,20722,10013,10709
69290,107383,24775,51669,20547,82608,20722,10013,10709
69295,107389,24775,51674,20547,82613,20723,10014,10709
69300,107400,24776,51682,20548,82624,20725,10016,10709
69305,107404,24776,51684,20548,82628,20725,10016,10709
69310,107414,24777,51691,20549,82637,20725,10016,10709
69315,107420,24777,51692,20549,82643,20726,10016,10710
69320,107431,24777,51697,20549,82654,20728,10018,10710
69325,107435,24777,51700,20549,82658,20728,10018,10710
69330,107445,24778,51704,20550,82667,20728,10018,10710
69335,107451,24778,51707,20550,82672,20729,10018,10711
69340,107462,24779,51711,20551,82683,20731,10018,10713
69345,107466,24779,51711,20551,82687,20731,10018,10713
69350,107476,24780,51716,20552,82696,20732,10018,10714
69355,107482,24780,51719,20552,82701,20733,10019,10714
69360,107493,24781,51721,20553,82712,20735,10020,10715
69365,107497,24781,51723,20553,82716,20735,10020,10715
69370,107507,24782,51726,20553,82725,20736,10020,10716
69375,107513,24782,51727,20553,82730,20737,10020,10717
69380,107524,24783,51732,20554,82741,20739,10022,10717
69385,107528,24784,51734,20555,82744,20739,10022,10717
69390,107538,24785,51738,20556,82753,20740,10022,10718
69395,107544,24785,51742,20556,82758,20741,10022,10719
69400,107555,24786,51748,20557,82769,20743,10022,10721
69405,107559,24787,51749,20558,82772,20743,10022,10721
69410,107569,24788,51754,20559,82781,20743,10022,10721
69415,107575,24788,51758,20559,82786,20744,10023,10721
69420,107586,24789,51767,20560,82797,20746,10025,10721
69425,107590,24789,51769,20560,82801,20746,10025,10721
69430,107600,24790,51774,20561,82810,20746,10025,10721
69435,107606,24790,51777,20561,82815,20747,10026,10721
69440,107617,24791,51782,20562,82826,20749,10027,10722
69445,107621,24792,51783,20563,82829,20749,10027,10722
69450,107631,24793,51786,20564,82838,20749,10027,10722
69455,107637,24793,51791,20564,82843,20750,10028,10722
69460,107648,24794,51797,20565,82854,20752,10029,10723
69465,107652,24795,51799,20566,82857,20752,10029,10723
69470,107662,24796,51802,20566,82866,20752,10029,10723
69475,107668,24796,51805,20566,82871,20753,10029,10724
69480,107679,24797,51812,20567,82882,20755,10031,10724
