Time,  Packets Generated,  Packets Reached,High Priority Packets Generated, High Priority Packets reached, Packet Dropped, Packet Dropped due to Faulty Node, High Prio Packet Dropped due to Faulty Node, Low Prio Packet Dropped due to Faulty Node 
5,1,1,1,1,0,0,0,0
10,6,3,5,2,3,3,3,0
15,8,3,6,2,4,4,4,0
20,16,7,10,3,8,8,6,2
25,19,9,11,4,10,10,7,3
30,24,13,13,5,11,11,8,3
35,28,13,15,5,14,14,9,5
40,31,15,16,7,16,16,9,7
45,32,16,17,8,16,16,9,7
50,37,18,19,9,19,19,10,9
55,39,18,21,9,20,20,11,9
60,47,22,23,11,24,24,12,12
65,50,24,26,12,25,25,13,12
70,55,29,29,16,26,26,13,13
75,59,29,30,16,29,29,14,15
80,62,32,31,16,30,30,15,15
85,63,33,31,16,30,30,15,15
90,68,35,32,17,33,33,15,18
95,70,35,34,17,34,34,16,18
100,78,39,36,19,36,36,16,20
105,81,43,37,20,37,37,16,21
110,86,48,39,23,38,38,16,22
115,90,48,41,23,41,41,18,23
120,93,51,43,25,42,42,18,24
125,94,52,44,26,42,42,18,24
130,99,54,45,26,43,43,18,25
135,101,55,46,26,44,44,18,26
140,109,60,50,30,46,46,19,27
145,112,64,53,32,47,47,20,27
150,117,69,56,35,48,48,21,27
155,121,69,58,35,50,50,21,29
160,124,73,60,38,51,51,22,29
165,125,74,60,38,51,51,22,29
170,130,76,63,40,52,52,22,30
175,132,77,64,41,54,53,22,31
180,140,81,68,44,57,55,23,32
185,143,84,70,45,59,56,24,32
190,148,87,72,47,61,57,24,33
195,152,87,74,47,64,59,25,34
200,155,88,76,48,66,59,25,34
205,156,88,77,48,68,60,26,34
210,161,89,80,49,71,61,26,35
215,163,89,80,49,74,63,27,36
220,171,91,85,51,78,65,28,37
225,174,93,87,52,81,68,31,37
230,179,95,91,54,84,70,33,37
235,183,95,93,54,86,72,33,39
240,186,97,94,56,89,73,34,39
245,187,97,94,56,90,73,34,39
250,192,98,96,56,94,74,35,39
255,194,98,96,56,96,75,35,40
260,202,100,101,57,102,77,37,40
265,205,101,103,58,104,78,37,41
270,210,102,106,59,108,79,37,42
275,214,102,106,59,112,81,37,44
280,217,104,107,60,113,81,37,44
285,218,104,108,60,114,81,37,44
290,223,105,110,60,118,82,38,44
295,225,105,110,60,120,83,38,45
300,233,107,113,61,126,85,38,47
305,236,107,115,61,129,86,39,47
310,241,108,117,61,133,87,40,47
315,245,108,119,61,136,89,40,49
320,248,110,120,63,138,89,40,49
325,249,110,121,63,139,89,40,49
330,254,111,124,63,143,90,41,49
335,256,111,124,63,145,91,41,50
340,264,113,131,65,151,92,42,50
345,267,113,132,65,154,93,42,51
350,272,114,133,65,158,94,42,52
355,276,114,136,65,161,96,44,52
360,279,116,137,67,163,96,44,52
365,280,116,137,67,164,96,44,52
370,285,117,139,67,168,96,44,52
375,287,117,140,67,170,97,44,53
380,295,118,144,67,177,98,45,53
385,298,118,144,67,180,99,45,54
390,303,119,148,68,184,100,46,54
395,307,119,150,68,188,102,47,55
400,310,120,152,69,190,102,47,55
405,311,120,152,69,191,102,47,55
410,316,121,157,70,195,102,47,55
415,318,121,157,70,197,103,47,56
420,326,123,161,71,202,105,47,58
425,329,124,163,72,205,105,47,58
430,334,125,165,73,209,106,48,58
435,338,125,168,73,213,108,49,59
440,341,126,171,74,215,108,49,59
445,342,126,171,74,216,108,49,59
450,347,126,172,74,221,108,49,59
455,349,126,173,74,223,109,50,59
460,357,127,177,74,230,110,51,59
465,360,127,178,74,233,110,51,59
470,365,128,181,75,237,111,52,59
475,369,128,182,75,241,113,53,60
480,372,128,184,75,244,113,53,60
485,373,128,185,75,245,113,53,60
490,378,128,186,75,250,113,53,60
495,380,128,188,75,252,114,54,60
500,388,129,193,75,259,115,55,60
505,391,129,194,75,262,115,55,60
510,396,130,197,76,266,116,56,60
515,400,130,199,76,270,118,56,62
520,403,131,200,77,272,118,56,62
525,404,131,200,77,273,118,56,62
530,409,132,201,77,277,119,56,63
535,411,132,202,77,279,120,57,63
540,419,134,205,78,285,122,57,65
545,422,134,206,78,288,123,57,66
550,427,135,207,79,292,124,57,67
555,431,135,209,79,296,126,58,68
560,434,136,210,80,298,126,58,68
565,435,136,211,80,299,126,58,68
570,440,137,213,80,303,127,59,68
575,442,137,213,80,305,128,59,69
580,450,139,218,81,311,129,59,70
585,453,140,221,82,313,130,60,70
590,458,141,222,83,317,131,60,71
595,462,141,223,83,321,133,60,73
600,465,141,223,83,324,133,60,73
605,466,141,224,83,325,133,60,73
610,471,142,225,83,329,133,60,73
615,473,142,226,83,331,134,60,74
620,481,143,227,83,338,135,60,75
625,484,144,228,84,340,135,60,75
630,489,145,230,85,344,136,61,75
635,493,145,231,85,348,138,61,77
640,496,145,231,85,351,138,61,77
645,497,145,231,85,352,138,61,77
650,502,146,235,86,356,138,61,77
655,504,146,236,86,358,139,62,77
660,512,148,241,88,364,141,63,78
665,515,148,242,88,367,142,63,79
670,520,149,242,88,371,143,63,80
675,524,149,244,88,375,144,64,80
680,527,149,245,88,378,144,64,80
685,528,149,245,88,379,144,64,80
690,533,150,247,88,383,144,64,80
695,535,150,249,88,385,145,65,80
700,543,150,252,88,393,146,65,81
705,546,150,253,88,396,147,65,82
710,551,151,254,88,400,148,65,83
715,555,151,255,88,404,150,66,84
720,558,151,256,88,406,150,66,84
725,559,151,256,88,408,150,66,84
730,564,153,257,89,411,151,66,85
735,566,153,259,89,413,152,67,85
740,574,153,261,89,420,153,67,86
745,577,154,263,90,423,154,68,86
750,582,155,267,91,427,155,69,86
755,586,155,269,91,431,157,70,87
760,589,155,271,91,434,157,70,87
765,590,155,271,91,435,157,70,87
770,595,156,275,92,439,158,71,87
775,597,156,277,92,441,159,72,87
780,605,158,281,94,447,161,74,87
785,608,158,282,94,450,161,74,87
790,613,159,283,94,454,161,74,87
795,617,159,286,94,458,162,75,87
800,620,159,286,94,461,162,75,87
805,621,159,287,94,462,162,75,87
810,626,160,291,95,466,162,75,87
815,628,160,291,95,468,163,75,88
820,636,161,296,96,475,163,75,88
825,639,161,297,96,478,163,75,88
830,644,162,299,97,482,163,75,88
835,648,162,300,97,486,164,76,88
840,651,163,302,98,488,164,76,88
845,652,163,303,98,489,164,76,88
850,657,164,307,98,492,164,76,88
855,659,164,309,98,495,165,77,88
860,667,165,312,99,502,165,77,88
865,670,165,314,99,505,165,77,88
870,675,166,318,100,509,165,77,88
875,679,166,321,100,513,166,78,88
880,682,166,322,100,516,166,78,88
885,683,166,323,100,517,166,78,88
890,688,167,326,100,520,167,79,88
895,690,167,328,100,523,169,81,88
900,698,169,333,102,527,171,82,89
905,701,169,334,102,532,173,84,89
910,706,170,336,102,536,173,84,89
915,710,170,339,102,540,173,84,89
920,713,170,341,102,543,173,84,89
925,714,170,342,102,544,173,84,89
930,719,171,345,103,548,173,84,89
935,721,171,346,103,550,174,84,90
940,729,172,350,104,557,174,84,90
945,732,172,353,104,560,174,84,90
950,737,173,356,104,564,174,84,90
955,741,173,356,104,568,174,84,90
960,744,173,357,104,571,174,84,90
965,745,174,358,105,571,174,84,90
970,750,175,361,106,575,175,85,90
975,752,175,362,106,577,176,86,90
980,760,176,365,107,584,177,86,91
985,763,176,367,107,587,177,86,91
990,768,177,371,108,591,177,86,91
995,772,177,373,108,595,178,87,91
1000,775,177,374,108,598,178,87,91
1005,776,177,374,108,599,178,87,91
1010,781,178,376,108,603,179,87,92
1015,783,178,376,108,605,180,87,93
1020,791,180,380,110,610,182,88,94
1025,794,181,381,111,613,182,88,94
1030,799,182,382,111,617,182,88,94
1035,803,182,383,111,621,183,89,94
1040,806,182,384,111,624,183,89,94
1045,807,182,385,111,625,183,89,94
1050,812,183,385,111,629,183,89,94
1055,814,183,385,111,631,184,89,95
1060,822,184,389,111,638,185,90,95
1065,825,184,390,111,641,185,90,95
1070,830,185,391,112,645,185,90,95
1075,834,185,392,112,649,186,90,96
1080,837,185,393,112,652,186,90,96
1085,838,186,394,113,652,186,90,96
1090,843,187,396,113,656,186,90,96
1095,845,187,397,113,658,187,91,96
1100,853,188,401,114,665,189,92,97
1105,856,188,402,114,668,190,92,98
1110,861,189,406,115,672,190,92,98
1115,865,189,407,115,676,192,93,99
1120,868,189,407,115,679,192,93,99
1125,869,189,407,115,680,192,93,99
1130,874,190,411,116,684,192,93,99
1135,876,190,411,116,686,193,93,100
1140,884,193,417,119,691,195,94,101
1145,887,193,418,119,694,195,94,101
1150,892,193,419,119,699,195,94,101
1155,896,193,421,119,703,195,94,101
1160,899,193,422,119,706,195,94,101
1165,900,193,423,119,707,195,94,101
1170,905,194,425,120,711,195,94,101
1175,907,194,427,120,713,196,95,101
1180,915,195,431,120,720,196,95,101
1185,918,195,432,120,723,196,95,101
1190,923,195,435,120,728,196,95,101
1195,927,195,437,120,732,196,95,101
1200,930,195,438,120,735,196,95,101
1205,931,195,438,120,736,196,95,101
1210,936,196,441,121,740,197,95,102
1215,938,196,442,121,742,198,96,102
1220,946,197,446,121,749,198,96,102
1225,949,197,447,121,752,199,96,103
1230,954,197,450,121,757,199,96,103
1235,958,197,453,121,761,200,97,103
1240,961,197,455,121,764,200,97,103
1245,962,197,456,121,765,200,97,103
1250,967,198,458,122,769,201,97,104
1255,969,198,460,122,771,202,98,104
1260,977,199,461,122,778,203,98,105
1265,980,199,461,122,781,203,98,105
1270,985,200,464,122,785,203,98,105
1275,989,200,467,122,788,204,98,106
1280,992,201,468,123,791,204,98,106
1285,993,201,469,123,792,204,98,106
1290,998,202,471,123,796,205,99,106
1295,1000,202,472,123,798,206,100,106
1300,1008,204,478,125,804,207,100,107
1305,1011,204,478,125,807,207,100,107
1310,1016,205,481,125,811,207,100,107
1315,1020,205,482,125,815,209,101,108
1320,1023,206,484,126,817,209,101,108
1325,1024,206,484,126,818,209,101,108
1330,1029,206,486,126,823,210,102,108
1335,1031,206,488,126,825,211,103,108
1340,1039,207,492,126,832,212,104,108
1345,1042,207,493,126,835,213,105,108
1350,1047,208,495,127,839,213,105,108
1355,1051,208,497,127,843,215,106,109
1360,1054,208,498,127,846,215,106,109
1365,1055,208,498,127,847,215,106,109
1370,1060,208,502,127,852,216,107,109
1375,1062,208,504,127,854,217,108,109
1380,1070,209,509,128,861,218,109,109
1385,1073,209,510,128,864,219,110,109
1390,1078,210,512,129,868,220,110,110
1395,1082,210,515,129,872,220,110,110
1400,1085,210,515,129,875,220,110,110
1405,1086,210,515,129,876,220,110,110
1410,1091,210,516,129,881,220,110,110
1415,1093,210,517,129,883,221,110,111
1420,1101,211,520,130,890,221,110,111
1425,1104,211,523,130,893,222,111,111
1430,1109,212,524,130,897,223,111,112
1435,1113,212,526,130,901,223,111,112
1440,1116,213,528,131,903,223,111,112
1445,1117,214,529,132,903,223,111,112
1450,1122,215,533,133,907,223,111,112
1455,1124,215,535,133,909,224,112,112
1460,1132,216,539,134,916,224,112,112
1465,1135,216,542,134,919,224,112,112
1470,1140,217,545,135,923,224,112,112
1475,1144,217,548,135,926,224,112,112
1480,1147,218,549,136,929,224,112,112
1485,1148,218,549,136,930,224,112,112
1490,1153,219,551,136,934,224,112,112
1495,1155,219,551,136,936,225,112,113
1500,1163,220,556,137,943,226,113,113
1505,1166,221,559,138,945,226,113,113
1510,1171,221,562,138,950,226,113,113
1515,1175,221,565,138,954,227,114,113
1520,1178,221,565,138,957,227,114,113
1525,1179,221,566,138,958,227,114,113
1530,1184,221,568,138,963,228,114,114
1535,1186,221,569,138,965,229,114,115
1540,1194,222,571,138,972,230,114,116
1545,1197,223,573,139,974,230,114,116
1550,1202,223,575,139,979,230,114,116
1555,1206,223,578,139,983,231,115,116
1560,1209,223,579,139,986,231,115,116
1565,1210,223,579,139,987,231,115,116
1570,1215,223,582,139,992,232,116,116
1575,1217,223,583,139,994,233,116,117
1580,1225,225,585,140,1000,234,116,118
1585,1228,226,587,141,1002,234,116,118
1590,1233,226,591,141,1007,234,116,118
1595,1237,226,591,141,1011,235,116,119
1600,1240,226,593,141,1014,235,116,119
1605,1241,226,593,141,1015,235,116,119
1610,1246,228,594,142,1018,236,116,120
1615,1248,228,595,142,1020,237,117,120
1620,1256,230,598,144,1026,239,117,122
1625,1259,230,600,144,1029,239,117,122
1630,1264,231,604,145,1033,240,118,122
1635,1268,231,606,145,1037,241,118,123
1640,1271,231,607,145,1040,241,118,123
1645,1272,231,607,145,1041,241,118,123
1650,1277,232,610,146,1045,241,118,123
1655,1279,232,611,146,1047,242,119,123
1660,1287,233,615,147,1054,242,119,123
1665,1290,233,615,147,1057,242,119,123
1670,1295,234,617,148,1061,243,119,124
1675,1299,234,618,148,1065,244,119,125
1680,1302,234,619,148,1068,244,119,125
1685,1303,234,619,148,1069,244,119,125
1690,1308,235,623,149,1073,244,119,125
1695,1310,235,624,149,1075,245,120,125
1700,1318,235,627,149,1083,245,120,125
1705,1321,235,628,149,1086,245,120,125
1710,1326,236,629,149,1090,245,120,125
1715,1330,236,630,149,1094,246,120,126
1720,1333,236,631,149,1097,246,120,126
1725,1334,237,632,150,1097,246,120,126
1730,1339,238,634,151,1101,246,120,126
1735,1341,238,635,151,1103,247,121,126
1740,1349,239,639,151,1110,249,123,126
1745,1352,239,639,151,1113,250,123,127
1750,1357,240,644,152,1117,250,123,127
1755,1361,240,646,152,1121,251,124,127
1760,1364,241,648,153,1123,251,124,127
1765,1365,241,649,153,1124,251,124,127
1770,1370,242,651,153,1128,252,125,127
1775,1372,242,653,153,1130,253,126,127
1780,1380,243,656,153,1136,254,127,127
1785,1383,244,658,154,1139,255,128,127
1790,1388,245,659,154,1143,255,128,127
1795,1392,245,661,154,1147,256,129,127
1800,1395,246,663,155,1149,256,129,127
1805,1396,246,664,155,1150,256,129,127
1810,1401,247,666,155,1154,257,130,127
1815,1403,247,667,155,1156,258,130,128
1820,1411,248,671,156,1163,259,130,129
1825,1414,248,673,156,1166,260,131,129
1830,1419,248,676,156,1171,260,131,129
1835,1423,248,677,156,1175,261,132,129
1840,1426,248,678,156,1178,261,132,129
1845,1427,249,679,157,1178,261,132,129
1850,1432,250,682,158,1182,262,133,129
1855,1434,250,683,158,1183,263,133,130
1860,1442,252,687,160,1190,265,134,131
1865,1445,252,688,160,1193,265,134,131
1870,1450,252,690,160,1198,266,135,131
1875,1454,252,691,160,1202,266,135,131
1880,1457,252,693,160,1205,266,135,131
1885,1458,252,694,160,1206,266,135,131
1890,1463,252,697,160,1211,266,135,131
1895,1465,252,698,160,1213,267,135,132
1900,1473,254,701,162,1219,268,136,132
1905,1476,254,701,162,1222,268,136,132
1910,1481,254,702,162,1227,269,136,133
1915,1485,254,705,162,1231,269,136,133
1920,1488,254,707,162,1234,269,136,133
1925,1489,254,707,162,1235,269,136,133
1930,1494,254,711,162,1240,269,136,133
1935,1496,254,713,162,1242,270,137,133
1940,1504,256,717,163,1248,271,138,133
1945,1507,256,720,163,1251,271,138,133
1950,1512,256,724,163,1256,271,138,133
1955,1516,256,726,163,1260,271,138,133
1960,1519,256,726,163,1263,271,138,133
1965,1520,256,726,163,1264,271,138,133
1970,1525,257,727,163,1268,271,138,133
1975,1527,257,729,163,1269,272,139,133
1980,1535,260,732,166,1274,274,139,135
1985,1538,261,735,167,1277,275,140,135
1990,1543,262,737,167,1281,275,140,135
1995,1547,262,739,167,1285,276,141,135
2000,1550,262,741,167,1288,276,141,135
2005,1551,262,742,167,1289,276,141,135
2010,1556,263,743,167,1293,277,141,136
2015,1558,263,743,167,1295,278,141,137
2020,1566,263,747,167,1303,279,141,138
2025,1569,263,750,167,1306,280,142,138
2030,1574,264,751,167,1310,280,142,138
2035,1578,264,752,167,1314,281,142,139
2040,1581,264,752,167,1317,281,142,139
2045,1582,264,752,167,1318,281,142,139
2050,1587,265,755,168,1322,282,142,140
2055,1589,265,756,168,1324,283,142,141
2060,1597,266,760,168,1331,284,142,142
2065,1600,267,762,169,1333,285,143,142
2070,1605,268,765,169,1337,285,143,142
2075,1609,268,766,169,1341,286,144,142
2080,1612,268,766,169,1344,286,144,142
2085,1613,268,766,169,1345,286,144,142
2090,1618,270,770,171,1348,287,144,143
2095,1620,270,771,171,1349,288,144,144
2100,1628,273,774,174,1354,290,144,146
2105,1631,274,777,175,1357,290,144,146
2110,1636,275,777,175,1361,291,144,147
2115,1640,275,780,175,1365,291,144,147
2120,1643,275,782,175,1368,291,144,147
2125,1644,275,783,175,1369,291,144,147
2130,1649,275,785,175,1374,291,144,147
2135,1651,275,786,175,1376,292,144,148
2140,1659,275,792,175,1384,292,144,148
2145,1662,275,793,175,1387,292,144,148
2150,1667,276,796,175,1391,293,145,148
2155,1671,276,797,175,1395,293,145,148
2160,1674,276,800,175,1398,293,145,148
2165,1675,276,801,175,1399,293,145,148
2170,1680,276,803,175,1404,293,145,148
2175,1682,276,805,175,1406,294,146,148
2180,1690,276,809,175,1414,294,146,148
2185,1693,276,809,175,1417,294,146,148
2190,1698,277,811,176,1421,294,146,148
2195,1702,277,813,176,1425,294,146,148
2200,1705,277,813,176,1428,294,146,148
2205,1706,277,813,176,1429,294,146,148
2210,1711,278,817,177,1432,295,147,148
2215,1713,279,818,178,1433,296,147,149
2220,1721,282,822,181,1439,298,148,150
2225,1724,282,824,181,1442,298,148,150
2230,1729,282,826,181,1447,298,148,150
2235,1733,282,827,181,1451,299,148,151
2240,1736,282,829,181,1454,299,148,151
2245,1737,282,830,181,1455,299,148,151
2250,1742,283,832,181,1459,299,148,151
2255,1744,283,833,181,1461,300,148,152
2260,1752,283,838,181,1469,300,148,152
2265,1755,283,838,181,1472,300,148,152
2270,1760,283,840,181,1477,301,148,153
2275,1764,283,843,181,1481,302,149,153
2280,1767,283,843,181,1484,302,149,153
2285,1768,283,843,181,1485,302,149,153
2290,1773,284,844,182,1489,302,149,153
2295,1775,284,844,182,1491,303,149,154
2300,1783,284,846,182,1499,303,149,154
2305,1786,284,846,182,1502,303,149,154
2310,1791,284,849,182,1507,304,149,155
2315,1795,284,853,182,1511,305,150,155
2320,1798,284,854,182,1514,305,150,155
2325,1799,284,854,182,1515,305,150,155
2330,1804,285,857,182,1519,305,150,155
2335,1806,285,858,182,1520,306,150,156
2340,1814,288,860,185,1526,308,150,158
2345,1817,289,863,186,1528,308,150,158
2350,1822,290,867,187,1532,308,150,158
2355,1826,290,870,187,1536,309,151,158
2360,1829,290,871,187,1539,309,151,158
2365,1830,290,872,187,1540,309,151,158
2370,1835,291,874,187,1544,310,152,158
2375,1837,291,875,187,1546,311,153,158
2380,1845,292,876,187,1553,311,153,158
2385,1848,292,878,187,1556,311,153,158
2390,1853,293,881,187,1560,311,153,158
2395,1857,293,884,187,1564,312,154,158
2400,1860,293,886,187,1567,312,154,158
2405,1861,293,886,187,1568,312,154,158
2410,1866,294,889,187,1572,313,155,158
2415,1868,294,890,187,1574,314,156,158
2420,1876,295,895,188,1581,314,156,158
2425,1879,295,895,188,1584,314,156,158
2430,1884,296,897,189,1588,314,156,158
2435,1888,296,899,189,1592,315,156,159
2440,1891,296,900,189,1595,315,156,159
2445,1892,296,900,189,1596,315,156,159
2450,1897,298,903,190,1599,316,157,159
2455,1899,298,904,190,1600,317,157,160
2460,1907,302,911,194,1604,319,159,160
2465,1910,303,913,195,1607,319,159,160
2470,1915,304,915,196,1611,319,159,160
2475,1919,304,918,196,1615,320,160,160
2480,1922,305,921,197,1617,320,160,160
2485,1923,305,922,197,1618,320,160,160
2490,1928,306,926,198,1622,320,160,160
2495,1930,306,926,198,1624,321,160,161
2500,1938,306,929,198,1632,321,160,161
2505,1941,306,931,198,1635,321,160,161
2510,1946,307,935,198,1639,321,160,161
2515,1950,307,936,198,1643,322,161,161
2520,1953,308,937,199,1645,322,161,161
2525,1954,308,937,199,1646,322,161,161
2530,1959,309,940,200,1650,322,161,161
2535,1961,309,941,200,1652,323,162,161
2540,1969,310,946,201,1659,323,162,161
2545,1972,310,947,201,1662,323,162,161
2550,1977,311,951,202,1666,323,162,161
2555,1981,311,951,202,1670,324,162,162
2560,1984,311,951,202,1673,324,162,162
2565,1985,311,951,202,1674,324,162,162
2570,1990,312,953,203,1678,324,162,162
2575,1992,312,953,203,1680,325,162,163
2580,2000,313,956,204,1686,327,162,165
2585,2003,314,957,205,1689,327,162,165
2590,2008,315,959,205,1693,328,162,166
2595,2012,315,959,205,1697,329,162,167
2600,2015,315,961,205,1700,329,162,167
2605,2016,315,962,205,1701,329,162,167
2610,2021,316,964,205,1705,329,162,167
2615,2023,316,966,205,1707,330,163,167
2620,2031,316,972,205,1715,331,164,167
2625,2034,316,972,205,1718,331,164,167
2630,2039,317,975,206,1722,332,165,167
2635,2043,317,978,206,1725,333,166,167
2640,2046,318,980,207,1728,333,166,167
2645,2047,318,981,207,1729,333,166,167
2650,2052,319,983,208,1733,334,166,168
2655,2054,319,985,208,1735,335,167,168
2660,2062,320,989,209,1742,335,167,168
2665,2065,320,991,209,1745,335,167,168
2670,2070,321,994,210,1749,335,167,168
2675,2074,321,994,210,1753,336,167,169
2680,2077,321,994,210,1756,336,167,169
2685,2078,321,995,210,1757,336,167,169
2690,2083,322,999,210,1761,337,168,169
2695,2085,322,1000,210,1763,338,169,169
2700,2093,324,1006,212,1768,339,169,170
2705,2096,325,1009,213,1771,339,169,170
2710,2101,325,1012,213,1776,339,169,170
2715,2105,325,1014,213,1780,340,170,170
2720,2108,325,1015,213,1783,340,170,170
2725,2109,325,1015,213,1784,340,170,170
2730,2114,326,1016,213,1788,341,170,171
2735,2116,326,1016,213,1790,342,170,172
2740,2124,326,1022,213,1798,342,170,172
2745,2127,326,1024,213,1801,342,170,172
2750,2132,326,1026,213,1806,342,170,172
2755,2136,326,1026,213,1810,343,170,173
2760,2139,326,1028,213,1813,343,170,173
2765,2140,326,1028,213,1814,343,170,173
2770,2145,327,1030,213,1818,344,170,174
2775,2147,327,1032,213,1820,345,171,174
2780,2155,328,1034,214,1827,345,171,174
2785,2158,329,1036,215,1829,345,171,174
2790,2163,329,1038,215,1834,345,171,174
2795,2167,329,1042,215,1838,346,172,174
2800,2170,329,1043,215,1841,346,172,174
2805,2171,330,1044,216,1841,346,172,174
2810,2176,332,1048,218,1844,347,173,174
2815,2178,332,1049,218,1846,348,174,174
2820,2186,333,1051,218,1853,350,175,175
2825,2189,333,1051,218,1856,350,175,175
2830,2194,334,1055,219,1860,350,175,175
2835,2198,334,1059,219,1863,350,175,175
2840,2201,335,1061,220,1866,350,175,175
2845,2202,335,1061,220,1867,350,175,175
2850,2207,335,1065,220,1872,350,175,175
2855,2209,335,1065,220,1874,351,175,176
2860,2217,335,1069,220,1882,351,175,176
2865,2220,335,1071,220,1885,351,175,176
2870,2225,336,1073,221,1889,351,175,176
2875,2229,336,1075,221,1892,351,175,176
2880,2232,337,1077,222,1895,351,175,176
2885,2233,337,1077,222,1896,351,175,176
2890,2238,337,1077,222,1901,351,175,176
2895,2240,337,1079,222,1903,352,176,176
2900,2248,337,1086,222,1911,352,176,176
2905,2251,337,1089,222,1914,352,176,176
2910,2256,338,1092,222,1918,352,176,176
2915,2260,338,1092,222,1922,352,176,176
2920,2263,338,1093,222,1925,352,176,176
2925,2264,338,1094,222,1926,352,176,176
2930,2269,339,1096,223,1930,352,176,176
2935,2271,339,1097,223,1932,353,177,176
2940,2279,342,1100,225,1937,355,178,177
2945,2282,343,1102,226,1939,355,178,177
2950,2287,344,1104,227,1943,356,178,178
2955,2291,344,1105,227,1947,358,178,180
2960,2294,345,1108,228,1949,358,178,180
2965,2295,345,1109,228,1950,358,178,180
2970,2300,346,1110,228,1954,359,179,180
2975,2302,346,1111,228,1956,360,180,180
2980,2310,347,1114,228,1963,361,180,181
2985,2313,347,1115,228,1966,361,180,181
2990,2318,348,1117,229,1970,362,181,181
2995,2322,348,1118,229,1974,364,181,183
3000,2325,348,1119,229,1977,364,181,183
3005,2326,348,1119,229,1978,364,181,183
3010,2331,349,1122,230,1982,365,181,184
3015,2333,349,1123,230,1984,366,181,185
3020,2341,350,1128,230,1991,366,181,185
3025,2344,351,1131,231,1993,366,181,185
3030,2349,352,1133,231,1997,366,181,185
3035,2353,352,1133,231,2001,368,181,187
3040,2356,353,1134,232,2003,368,181,187
3045,2357,353,1134,232,2004,368,181,187
3050,2362,355,1138,233,2007,369,182,187
3055,2364,355,1139,233,2009,370,183,187
3060,2372,357,1143,234,2015,371,184,187
3065,2375,357,1145,234,2018,371,184,187
3070,2380,358,1148,234,2022,371,184,187
3075,2384,358,1151,234,2026,371,184,187
3080,2387,358,1153,234,2029,371,184,187
3085,2388,358,1153,234,2030,371,184,187
3090,2393,359,1155,234,2034,371,184,187
3095,2395,359,1156,234,2036,372,185,187
3100,2403,359,1161,234,2044,372,185,187
3105,2406,359,1162,234,2047,372,185,187
3110,2411,360,1165,234,2051,372,185,187
3115,2415,360,1168,234,2055,372,185,187
3120,2418,360,1169,234,2058,372,185,187
3125,2419,360,1169,234,2059,372,185,187
3130,2424,361,1174,235,2063,372,185,187
3135,2426,361,1174,235,2065,373,185,188
3140,2434,361,1179,235,2073,373,185,188
3145,2437,361,1180,235,2076,373,185,188
3150,2442,362,1181,236,2080,373,185,188
3155,2446,362,1181,236,2084,373,185,188
3160,2449,362,1181,236,2087,373,185,188
3165,2450,362,1181,236,2088,373,185,188
3170,2455,363,1184,237,2092,374,186,188
3175,2457,363,1185,237,2093,375,186,189
3180,2465,365,1188,239,2099,377,187,190
3185,2468,367,1190,241,2101,377,187,190
3190,2473,368,1191,241,2105,378,187,191
3195,2477,368,1191,241,2109,380,187,193
3200,2480,368,1193,241,2112,380,187,193
3205,2481,368,1193,241,2113,380,187,193
3210,2486,369,1195,242,2117,380,187,193
3215,2488,369,1196,242,2119,381,187,194
3220,2496,370,1200,243,2126,382,187,195
3225,2499,371,1203,244,2128,382,187,195
3230,2504,372,1205,244,2132,383,188,195
3235,2508,372,1208,244,2136,385,189,196
3240,2511,373,1210,245,2138,385,189,196
3245,2512,373,1210,245,2139,385,189,196
3250,2517,374,1214,246,2143,385,189,196
3255,2519,374,1215,246,2145,386,190,196
3260,2527,375,1216,246,2152,387,190,197
3265,2530,375,1217,246,2155,387,190,197
3270,2535,376,1220,246,2159,388,190,198
3275,2539,376,1221,246,2163,390,191,199
3280,2542,376,1221,246,2166,390,191,199
3285,2543,377,1222,247,2166,390,191,199
3290,2548,379,1224,249,2169,391,191,200
3295,2550,379,1225,249,2171,392,192,200
3300,2558,381,1230,251,2177,394,194,200
3305,2561,381,1232,251,2180,394,194,200
3310,2566,381,1236,251,2185,394,194,200
3315,2570,381,1239,251,2189,394,194,200
3320,2573,381,1239,251,2192,394,194,200
3325,2574,381,1239,251,2193,394,194,200
3330,2579,382,1242,252,2197,394,194,200
3335,2581,382,1244,252,2199,395,195,200
3340,2589,382,1248,252,2207,395,195,200
3345,2592,382,1248,252,2210,395,195,200
3350,2597,382,1251,252,2215,395,195,200
3355,2601,382,1253,252,2218,395,195,200
3360,2604,383,1253,253,2221,395,195,200
3365,2605,383,1253,253,2222,395,195,200
3370,2610,384,1256,254,2226,395,195,200
3375,2612,384,1257,254,2228,396,195,201
3380,2620,384,1263,254,2236,396,195,201
3385,2623,384,1264,254,2239,396,195,201
3390,2628,384,1267,254,2244,396,195,201
3395,2632,384,1270,254,2247,396,195,201
3400,2635,385,1272,255,2250,396,195,201
3405,2636,385,1272,255,2251,396,195,201
3410,2641,386,1273,255,2255,397,195,202
3415,2643,386,1275,255,2257,398,196,202
3420,2651,388,1280,257,2262,400,197,203
3425,2654,390,1282,259,2264,401,197,204
3430,2659,391,1282,259,2268,402,197,205
3435,2663,391,1282,259,2272,403,197,206
3440,2666,391,1284,259,2275,403,197,206
3445,2667,391,1284,259,2276,403,197,206
3450,2672,392,1287,260,2280,403,197,206
3455,2674,392,1289,260,2282,404,198,206
3460,2682,393,1290,260,2289,404,198,206
3465,2685,394,1293,261,2291,405,199,206
3470,2690,395,1293,261,2295,406,199,207
3475,2694,395,1296,261,2299,407,200,207
3480,2697,395,1297,261,2302,407,200,207
3485,2698,395,1297,261,2303,407,200,207
3490,2703,396,1300,262,2307,407,200,207
3495,2705,396,1302,262,2309,408,201,207
3500,2713,397,1303,262,2316,408,201,207
3505,2716,397,1304,262,2319,408,201,207
3510,2721,398,1308,263,2323,409,202,207
3515,2725,398,1310,263,2327,410,202,208
3520,2728,398,1310,263,2330,410,202,208
3525,2729,398,1310,263,2331,410,202,208
3530,2734,399,1313,264,2335,410,202,208
3535,2736,399,1315,264,2337,411,203,208
3540,2744,400,1319,265,2344,413,204,209
3545,2747,400,1322,265,2347,413,204,209
3550,2752,401,1323,266,2351,413,204,209
3555,2756,401,1323,266,2355,415,204,211
3560,2759,402,1326,267,2357,415,204,211
3565,2760,402,1326,267,2358,415,204,211
3570,2765,403,1328,268,2362,415,204,211
3575,2767,403,1329,268,2364,416,204,212
3580,2775,403,1334,268,2372,416,204,212
3585,2778,403,1336,268,2375,416,204,212
3590,2783,404,1339,268,2379,416,204,212
3595,2787,404,1342,268,2383,418,206,212
3600,2790,405,1344,269,2385,418,206,212
3605,2791,405,1344,269,2386,418,206,212
3610,2796,406,1348,270,2390,419,206,213
3615,2798,406,1349,270,2392,420,207,213
3620,2806,406,1352,270,2400,420,207,213
3625,2809,406,1353,270,2403,421,207,214
3630,2814,407,1355,271,2407,421,207,214
3635,2818,407,1357,271,2411,423,208,215
3640,2821,407,1359,271,2414,423,208,215
3645,2822,407,1359,271,2415,423,208,215
3650,2827,409,1362,272,2418,424,208,216
3655,2829,409,1363,272,2420,425,209,216
3660,2837,411,1367,273,2425,427,210,217
3665,2840,413,1368,275,2427,428,210,218
3670,2845,414,1371,275,2431,429,211,218
3675,2849,414,1375,275,2435,429,211,218
3680,2852,414,1377,275,2438,429,211,218
3685,2853,414,1377,275,2439,429,211,218
3690,2858,415,1378,275,2443,429,211,218
3695,2860,415,1380,275,2445,430,212,218
3700,2868,416,1382,275,2452,431,212,219
3705,2871,416,1383,275,2455,432,213,219
3710,2876,417,1387,276,2459,433,214,219
3715,2880,417,1391,276,2463,433,214,219
3720,2883,417,1391,276,2466,433,214,219
3725,2884,417,1391,276,2467,433,214,219
3730,2889,418,1393,277,2471,433,214,219
3735,2891,418,1395,277,2473,434,215,219
3740,2899,419,1399,277,2480,434,215,219
3745,2902,419,1401,277,2483,435,216,219
3750,2907,420,1402,277,2487,435,216,219
3755,2911,420,1404,277,2491,435,216,219
3760,2914,420,1405,277,2494,435,216,219
3765,2915,420,1405,277,2495,435,216,219
3770,2920,422,1408,279,2498,435,216,219
3775,2922,422,1408,279,2500,436,216,220
3780,2930,424,1413,281,2505,437,217,220
3785,2933,425,1414,282,2508,437,217,220
3790,2938,426,1415,282,2512,437,217,220
3795,2942,426,1415,282,2516,437,217,220
3800,2945,426,1416,282,2519,437,217,220
3805,2946,426,1417,282,2520,437,217,220
3810,2951,426,1421,282,2525,437,217,220
3815,2953,426,1421,282,2527,438,217,221
3820,2961,426,1424,282,2535,438,217,221
3825,2964,426,1426,282,2538,438,217,221
3830,2969,427,1429,282,2542,438,217,221
3835,2973,427,1432,282,2546,438,217,221
3840,2976,427,1434,282,2549,438,217,221
3845,2977,427,1434,282,2550,438,217,221
3850,2982,427,1437,282,2555,438,217,221
3855,2984,427,1437,282,2557,439,217,222
3860,2992,429,1443,284,2563,439,217,222
3865,2995,430,1444,285,2565,439,217,222
3870,3000,431,1447,286,2569,439,217,222
3875,3004,431,1450,286,2573,439,217,222
3880,3007,431,1451,286,2576,439,217,222
3885,3008,431,1451,286,2577,439,217,222
3890,3013,433,1454,288,2580,439,217,222
3895,3015,433,1454,288,2582,440,217,223
3900,3023,436,1458,290,2586,442,217,225
3905,3026,437,1458,291,2589,442,217,225
3910,3031,438,1458,291,2593,442,217,225
3915,3035,438,1461,291,2597,443,217,226
3920,3038,438,1461,291,2600,443,217,226
3925,3039,438,1461,291,2601,443,217,226
3930,3044,439,1463,291,2605,444,217,227
3935,3046,439,1463,291,2607,445,217,228
3940,3054,439,1466,291,2615,445,217,228
3945,3057,439,1468,291,2618,445,217,228
3950,3062,440,1471,292,2622,445,217,228
3955,3066,440,1472,292,2626,446,217,229
3960,3069,440,1473,292,2629,446,217,229
3965,3070,440,1473,292,2630,446,217,229
3970,3075,441,1475,293,2634,447,217,230
3975,3077,441,1476,293,2636,448,217,231
3980,3085,441,1478,293,2644,449,218,231
3985,3088,441,1480,293,2647,449,218,231
3990,3093,441,1484,293,2652,449,218,231
3995,3097,441,1486,293,2656,450,218,232
4000,3100,441,1487,293,2659,450,218,232
4005,3101,442,1488,294,2659,450,218,232
4010,3106,444,1490,295,2662,451,219,232
4015,3108,444,1490,295,2664,452,219,233
4020,3116,445,1497,296,2671,453,220,233
4025,3119,445,1499,296,2674,453,220,233
4030,3124,446,1501,296,2678,453,220,233
4035,3128,446,1501,296,2682,454,220,234
4040,3131,446,1503,296,2685,454,220,234
4045,3132,446,1504,296,2686,454,220,234
4050,3137,446,1505,296,2691,454,220,234
4055,3139,446,1507,296,2693,455,221,234
4060,3147,446,1510,296,2701,455,221,234
4065,3150,446,1510,296,2704,455,221,234
4070,3155,447,1511,296,2708,456,221,235
4075,3159,447,1512,296,2712,457,221,236
4080,3162,447,1514,296,2715,457,221,236
4085,3163,447,1514,296,2716,457,221,236
4090,3168,447,1517,296,2721,457,221,236
4095,3170,447,1517,296,2723,458,221,237
4100,3178,449,1518,297,2729,459,221,238
4105,3181,450,1521,298,2731,459,221,238
4110,3186,450,1524,298,2736,460,221,239
4115,3190,450,1526,298,2740,460,221,239
4120,3193,450,1527,298,2743,460,221,239
4125,3194,450,1528,298,2744,460,221,239
4130,3199,451,1530,298,2748,460,221,239
4135,3201,451,1530,298,2750,461,221,240
4140,3209,452,1532,298,2757,463,221,242
4145,3212,453,1535,299,2759,464,222,242
4150,3217,453,1537,299,2764,464,222,242
4155,3221,453,1540,299,2767,465,223,242
4160,3224,455,1541,301,2769,465,223,242
4165,3225,455,1542,301,2770,465,223,242
4170,3230,456,1546,302,2774,465,223,242
4175,3232,456,1547,302,2776,466,224,242
4180,3240,458,1551,303,2782,467,225,242
4185,3243,459,1553,304,2784,468,225,243
4190,3248,460,1557,305,2788,468,225,243
4195,3252,460,1559,305,2792,470,226,244
4200,3255,461,1561,306,2794,470,226,244
4205,3256,461,1562,306,2795,470,226,244
4210,3261,462,1565,307,2799,470,226,244
4215,3263,462,1565,307,2801,471,226,245
4220,3271,463,1570,308,2807,472,227,245
4225,3274,464,1572,309,2810,473,228,245
4230,3279,465,1573,309,2814,473,228,245
4235,3283,465,1576,309,2818,474,228,246
4240,3286,465,1577,309,2821,474,228,246
4245,3287,465,1577,309,2822,474,228,246
4250,3292,466,1579,310,2826,475,229,246
4255,3294,466,1581,310,2828,476,230,246
4260,3302,467,1584,311,2835,477,231,246
4265,3305,467,1587,311,2838,478,232,246
4270,3310,468,1590,311,2842,478,232,246
4275,3314,468,1594,311,2846,480,234,246
4280,3317,468,1595,311,2849,480,234,246
4285,3318,468,1595,311,2850,480,234,246
4290,3323,469,1599,312,2854,480,234,246
4295,3325,469,1601,312,2856,481,235,246
4300,3333,469,1605,312,2864,482,236,246
4305,3336,469,1607,312,2867,483,237,246
4310,3341,471,1609,314,2870,483,237,246
4315,3345,471,1612,314,2873,485,238,247
4320,3348,473,1613,316,2875,485,238,247
4325,3349,473,1613,316,2876,485,238,247
4330,3354,474,1616,316,2880,485,238,247
4335,3356,474,1618,316,2882,486,239,247
4340,3364,475,1623,316,2888,487,240,247
4345,3367,477,1624,318,2890,488,240,248
4350,3372,477,1628,318,2895,489,240,249
4355,3376,477,1632,318,2898,489,240,249
4360,3379,478,1635,319,2901,489,240,249
4365,3380,478,1636,319,2902,489,240,249
4370,3385,479,1641,320,2906,489,240,249
4375,3387,479,1642,320,2908,490,240,250
4380,3395,480,1646,320,2914,491,241,250
4385,3398,482,1648,322,2916,492,241,251
4390,3403,482,1651,322,2921,492,241,251
4395,3407,482,1654,322,2924,492,241,251
4400,3410,483,1655,323,2927,492,241,251
4405,3411,483,1655,323,2928,492,241,251
4410,3416,484,1658,324,2932,493,241,252
4415,3418,484,1659,324,2934,494,242,252
4420,3426,485,1663,325,2940,494,242,252
4425,3429,487,1665,327,2942,495,243,252
4430,3434,488,1667,327,2946,495,243,252
4435,3438,488,1669,327,2949,496,243,253
4440,3441,489,1669,328,2952,496,243,253
4445,3442,489,1669,328,2953,496,243,253
4450,3447,490,1672,329,2957,497,244,253
4455,3449,490,1673,329,2959,498,244,254
4460,3457,491,1676,329,2966,499,244,255
4465,3460,491,1677,329,2969,499,244,255
4470,3465,492,1678,329,2973,499,244,255
4475,3469,492,1679,329,2977,500,244,256
4480,3472,492,1680,329,2980,500,244,256
4485,3473,493,1681,330,2980,500,244,256
4490,3478,494,1683,331,2984,501,245,256
4495,3480,494,1685,331,2986,502,246,256
4500,3488,496,1689,333,2992,503,246,257
4505,3491,496,1689,333,2995,503,246,257
4510,3496,497,1691,333,2999,503,246,257
4515,3500,497,1692,333,3003,504,246,258
4520,3503,498,1694,334,3005,504,246,258
4525,3504,498,1695,334,3006,504,246,258
4530,3509,498,1695,334,3011,504,246,258
4535,3511,498,1696,334,3013,505,247,258
4540,3519,500,1701,335,3019,506,248,258
4545,3522,501,1703,336,3021,506,248,258
4550,3527,502,1705,337,3025,507,249,258
4555,3531,502,1705,337,3029,508,249,259
4560,3534,502,1705,337,3032,508,249,259
4565,3535,502,1705,337,3033,508,249,259
4570,3540,502,1708,337,3038,508,249,259
4575,3542,502,1710,337,3040,509,250,259
4580,3550,502,1713,337,3048,510,250,260
4585,3553,502,1714,337,3051,510,250,260
4590,3558,503,1714,337,3055,511,250,261
4595,3562,503,1715,337,3059,511,250,261
4600,3565,503,1717,337,3062,511,250,261
4605,3566,503,1717,337,3063,511,250,261
4610,3571,504,1719,338,3067,512,250,262
4615,3573,504,1720,338,3069,513,250,263
4620,3581,504,1723,338,3077,515,251,264
4625,3584,504,1725,338,3080,515,251,264
4630,3589,505,1727,338,3084,516,252,264
4635,3593,505,1728,338,3088,517,252,265
4640,3596,505,1729,338,3091,517,252,265
4645,3597,505,1729,338,3092,517,252,265
4650,3602,506,1732,338,3096,518,253,265
4655,3604,506,1733,338,3098,519,253,266
4660,3612,507,1737,339,3105,520,253,267
4665,3615,507,1738,339,3108,520,253,267
4670,3620,508,1739,339,3112,521,254,267
4675,3624,508,1742,339,3116,523,255,268
4680,3627,508,1743,339,3119,523,255,268
4685,3628,508,1744,339,3120,523,255,268
4690,3633,509,1746,339,3124,523,255,268
4695,3635,509,1747,339,3126,524,256,268
4700,3643,511,1751,341,3132,525,256,269
4705,3646,512,1753,342,3134,525,256,269
4710,3651,513,1755,342,3138,525,256,269
4715,3655,513,1757,342,3142,525,256,269
4720,3658,513,1759,342,3145,525,256,269
4725,3659,513,1760,342,3146,525,256,269
4730,3664,514,1762,342,3150,525,256,269
4735,3666,514,1763,342,3152,526,256,270
4740,3674,517,1767,344,3157,528,257,271
4745,3677,518,1770,345,3159,529,258,271
4750,3682,518,1772,345,3164,529,258,271
4755,3686,518,1774,345,3167,529,258,271
4760,3689,519,1775,346,3170,529,258,271
4765,3690,519,1775,346,3171,529,258,271
4770,3695,520,1777,347,3175,529,258,271
4775,3697,520,1778,347,3177,530,259,271
4780,3705,520,1781,347,3184,530,259,271
4785,3708,521,1782,348,3187,531,259,272
4790,3713,521,1786,348,3192,531,259,272
4795,3717,521,1787,348,3196,532,259,273
4800,3720,521,1788,348,3199,532,259,273
4805,3721,521,1789,348,3200,532,259,273
4810,3726,522,1792,349,3204,533,259,274
4815,3728,522,1793,349,3206,534,259,275
4820,3736,522,1797,349,3214,534,259,275
4825,3739,522,1799,349,3217,535,259,276
4830,3744,522,1800,349,3222,535,259,276
4835,3748,522,1801,349,3226,535,259,276
4840,3751,522,1802,349,3229,535,259,276
4845,3752,522,1802,349,3230,535,259,276
4850,3757,523,1805,350,3234,536,260,276
4855,3759,523,1805,350,3236,537,260,277
4860,3767,524,1809,351,3242,539,261,278
4865,3770,525,1811,352,3245,539,261,278
4870,3775,526,1812,352,3249,540,262,278
4875,3779,526,1815,352,3252,541,262,279
4880,3782,528,1817,354,3254,541,262,279
4885,3783,528,1817,354,3255,541,262,279
4890,3788,529,1818,354,3259,541,262,279
4895,3790,529,1819,354,3261,542,263,279
4900,3798,531,1823,356,3267,543,263,280
4905,3801,531,1824,356,3270,543,263,280
4910,3806,532,1828,357,3274,544,263,281
4915,3810,532,1832,357,3277,546,265,281
4920,3813,533,1833,358,3280,546,265,281
4925,3814,533,1833,358,3281,546,265,281
4930,3819,534,1835,359,3285,546,265,281
4935,3821,534,1836,359,3287,547,265,282
4940,3829,536,1842,360,3293,547,265,282
4945,3832,536,1843,360,3296,547,265,282
4950,3837,536,1846,360,3301,548,265,283
4955,3841,536,1849,360,3304,549,266,283
4960,3844,537,1851,361,3307,549,266,283
4965,3845,537,1851,361,3308,549,266,283
4970,3850,538,1856,362,3312,550,267,283
4975,3852,538,1856,362,3314,551,267,284
4980,3860,541,1862,364,3319,552,268,284
4985,3863,541,1864,364,3322,553,269,284
4990,3868,541,1867,364,3327,553,269,284
4995,3872,541,1868,364,3330,553,269,284
5000,3875,542,1871,365,3333,553,269,284
5005,3876,542,1872,365,3334,553,269,284
5010,3881,543,1875,366,3338,553,269,284
5015,3883,543,1877,366,3340,554,270,284
5020,3891,543,1880,366,3347,554,270,284
5025,3894,544,1883,367,3350,555,271,284
5030,3899,545,1883,367,3354,555,271,284
5035,3903,545,1884,367,3358,556,271,285
5040,3906,545,1886,367,3361,556,271,285
5045,3907,545,1886,367,3362,556,271,285
5050,3912,545,1889,367,3367,557,272,285
5055,3914,545,1890,367,3369,558,273,285
5060,3922,546,1894,367,3376,558,273,285
5065,3925,546,1894,367,3379,558,273,285
5070,3930,547,1894,367,3383,558,273,285
5075,3934,547,1895,367,3387,559,273,286
5080,3937,547,1897,367,3390,559,273,286
5085,3938,547,1898,367,3391,559,273,286
5090,3943,547,1899,367,3396,560,273,287
5095,3945,547,1900,367,3398,561,273,288
5100,3953,548,1906,368,3405,561,273,288
5105,3956,549,1908,369,3407,561,273,288
5110,3961,550,1911,369,3411,562,273,289
5115,3965,550,1914,369,3415,563,274,289
5120,3968,550,1914,369,3418,563,274,289
5125,3969,550,1915,369,3419,563,274,289
5130,3974,550,1916,369,3424,563,274,289
5135,3976,550,1918,369,3426,564,275,289
5140,3984,551,1921,370,3433,566,276,290
5145,3987,552,1923,371,3435,566,276,290
5150,3992,553,1925,371,3439,567,276,291
5155,3996,553,1926,371,3443,568,277,291
5160,3999,554,1928,372,3445,568,277,291
5165,4000,555,1929,373,3445,568,277,291
5170,4005,557,1934,375,3448,568,277,291
5175,4007,557,1935,375,3450,569,278,291
5180,4015,558,1938,376,3457,571,278,293
5185,4018,558,1940,376,3460,571,278,293
5190,4023,559,1943,377,3464,572,278,294
5195,4027,559,1946,377,3467,573,279,294
5200,4030,561,1948,379,3469,573,279,294
5205,4031,561,1948,379,3470,573,279,294
5210,4036,563,1951,381,3473,574,279,295
5215,4038,563,1953,381,3475,575,280,295
5220,4046,565,1956,383,3481,577,280,297
5225,4049,565,1959,383,3484,578,281,297
5230,4054,565,1961,383,3489,578,281,297
5235,4058,565,1961,383,3493,578,281,297
5240,4061,565,1962,383,3496,578,281,297
5245,4062,565,1963,383,3497,578,281,297
5250,4067,566,1965,383,3501,579,282,297
5255,4069,566,1966,383,3503,580,283,297
5260,4077,566,1971,383,3511,580,283,297
5265,4080,566,1973,383,3514,581,284,297
5270,4085,566,1976,383,3519,581,284,297
5275,4089,566,1976,383,3523,582,284,298
5280,4092,566,1976,383,3526,582,284,298
5285,4093,566,1976,383,3527,582,284,298
5290,4098,567,1979,384,3531,583,285,298
5295,4100,567,1980,384,3533,584,285,299
5300,4108,567,1982,384,3541,584,285,299
5305,4111,567,1984,384,3544,585,286,299
5310,4116,567,1988,384,3549,585,286,299
5315,4120,567,1990,384,3553,586,286,300
5320,4123,567,1992,384,3556,586,286,300
5325,4124,567,1992,384,3557,586,286,300
5330,4129,568,1995,384,3561,587,286,301
5335,4131,568,1996,384,3563,588,287,301
5340,4139,569,2001,385,3569,590,289,301
5345,4142,570,2003,386,3572,590,289,301
5350,4147,571,2004,386,3576,590,289,301
5355,4151,571,2005,386,3580,591,289,302
5360,4154,572,2007,387,3582,591,289,302
5365,4155,572,2007,387,3583,591,289,302
5370,4160,573,2009,387,3587,591,289,302
5375,4162,573,2009,387,3589,592,289,303
5380,4170,574,2012,387,3596,592,289,303
5385,4173,575,2015,388,3598,592,289,303
5390,4178,576,2017,389,3602,592,289,303
5395,4182,576,2019,389,3606,593,289,304
5400,4185,577,2021,390,3608,593,289,304
5405,4186,577,2021,390,3609,593,289,304
5410,4191,578,2025,391,3613,593,289,304
5415,4193,578,2026,391,3615,594,290,304
5420,4201,579,2031,391,3622,595,291,304
5425,4204,579,2032,391,3625,596,292,304
5430,4209,580,2035,391,3629,596,292,304
5435,4213,580,2036,391,3633,598,292,306
5440,4216,581,2037,392,3635,598,292,306
5445,4217,582,2038,393,3635,598,292,306
5450,4222,583,2039,393,3639,598,292,306
5455,4224,583,2040,393,3641,599,293,306
5460,4232,586,2043,395,3646,601,293,308
5465,4235,586,2045,395,3649,601,293,308
5470,4240,586,2047,395,3654,602,293,309
5475,4244,586,2050,395,3657,602,293,309
5480,4247,587,2052,396,3660,602,293,309
5485,4248,587,2053,396,3661,602,293,309
5490,4253,588,2055,396,3665,603,294,309
5495,4255,588,2056,396,3667,604,294,310
5500,4263,588,2059,396,3675,605,295,310
5505,4266,588,2061,396,3678,605,295,310
5510,4271,588,2062,396,3683,606,296,310
5515,4275,588,2066,396,3686,606,296,310
5520,4278,589,2067,397,3689,606,296,310
5525,4279,589,2067,397,3690,606,296,310
5530,4284,590,2070,398,3694,607,296,311
5535,4286,590,2071,398,3696,608,296,312
5540,4294,590,2073,398,3704,609,296,313
5545,4297,590,2074,398,3707,609,296,313
5550,4302,590,2078,398,3712,610,297,313
5555,4306,590,2082,398,3715,610,297,313
5560,4309,591,2083,399,3718,610,297,313
5565,4310,591,2084,399,3719,610,297,313
5570,4315,592,2086,399,3723,610,297,313
5575,4317,592,2087,399,3725,611,297,314
5580,4325,595,2092,401,3730,613,299,314
5585,4328,596,2095,402,3732,613,299,314
5590,4333,597,2099,402,3736,613,299,314
5595,4337,597,2100,402,3740,614,300,314
5600,4340,597,2101,402,3743,614,300,314
5605,4341,597,2102,402,3744,614,300,314
5610,4346,598,2105,403,3748,614,300,314
5615,4348,598,2105,403,3750,615,300,315
5620,4356,598,2110,403,3758,615,300,315
5625,4359,598,2111,403,3761,615,300,315
5630,4364,599,2113,403,3765,615,300,315
5635,4368,599,2115,403,3769,616,301,315
5640,4371,599,2117,403,3772,616,301,315
5645,4372,600,2118,404,3772,616,301,315
5650,4377,601,2121,404,3776,617,302,315
5655,4379,601,2123,404,3778,618,303,315
5660,4387,601,2125,404,3786,619,303,316
5665,4390,601,2126,404,3789,619,303,316
5670,4395,602,2128,404,3793,619,303,316
5675,4399,602,2130,404,3797,620,304,316
5680,4402,602,2131,404,3800,620,304,316
5685,4403,603,2132,405,3800,620,304,316
5690,4408,605,2136,407,3803,621,305,316
5695,4410,605,2137,407,3805,622,305,317
5700,4418,606,2142,408,3812,624,307,317
5705,4421,607,2143,409,3814,624,307,317
5710,4426,608,2144,409,3818,625,307,318
5715,4430,608,2144,409,3822,625,307,318
5720,4433,608,2145,409,3825,625,307,318
5725,4434,608,2146,409,3826,625,307,318
5730,4439,608,2148,409,3831,626,307,319
5735,4441,608,2149,409,3833,627,307,320
5740,4449,609,2154,410,3840,627,307,320
5745,4452,610,2157,411,3842,627,307,320
5750,4457,611,2160,412,3846,628,308,320
5755,4461,611,2162,412,3849,628,308,320
5760,4464,612,2164,413,3852,628,308,320
5765,4465,612,2164,413,3853,628,308,320
5770,4470,612,2166,413,3858,628,308,320
5775,4472,612,2166,413,3860,629,308,321
5780,4480,613,2170,414,3867,629,308,321
5785,4483,613,2170,414,3870,629,308,321
5790,4488,614,2173,414,3874,630,309,321
5795,4492,614,2177,414,3877,630,309,321
5800,4495,615,2178,415,3880,630,309,321
5805,4496,615,2179,415,3881,630,309,321
5810,4501,616,2181,416,3885,630,309,321
5815,4503,616,2182,416,3887,631,309,322
5820,4511,619,2188,418,3891,633,311,322
5825,4514,620,2189,419,3894,633,311,322
5830,4519,621,2191,420,3898,633,311,322
5835,4523,621,2194,420,3902,634,312,322
5840,4526,622,2196,421,3904,634,312,322
5845,4527,622,2196,421,3905,634,312,322
5850,4532,623,2198,421,3909,635,312,323
5855,4534,623,2199,421,3911,636,313,323
5860,4542,623,2203,421,3919,636,313,323
5865,4545,623,2204,421,3922,636,313,323
5870,4550,624,2207,422,3926,636,313,323
5875,4554,624,2211,422,3930,637,314,323
5880,4557,624,2213,422,3933,637,314,323
5885,4558,624,2214,422,3934,637,314,323
5890,4563,625,2216,423,3938,638,314,324
5895,4565,625,2217,423,3940,639,314,325
5900,4573,626,2222,423,3947,639,314,325
5905,4576,626,2223,423,3950,639,314,325
5910,4581,627,2225,424,3954,639,314,325
5915,4585,627,2227,424,3958,640,315,325
5920,4588,627,2228,424,3961,640,315,325
5925,4589,628,2229,425,3961,640,315,325
5930,4594,630,2230,426,3964,641,315,326
5935,4596,630,2231,426,3966,642,315,327
5940,4604,632,2235,428,3972,644,317,327
5945,4607,632,2236,428,3975,644,317,327
5950,4612,633,2238,429,3979,645,317,328
5955,4616,633,2238,429,3983,645,317,328
5960,4619,633,2241,429,3986,645,317,328
5965,4620,633,2242,429,3987,645,317,328
5970,4625,634,2243,429,3991,645,317,328
5975,4627,634,2244,429,3993,646,317,329
5980,4635,634,2249,429,4001,647,318,329
5985,4638,634,2249,429,4004,647,318,329
5990,4643,635,2254,430,4008,648,319,329
5995,4647,635,2255,430,4012,648,319,329
6000,4650,635,2257,430,4015,648,319,329
6005,4651,635,2257,430,4016,648,319,329
6010,4656,636,2260,430,4020,648,319,329
6015,4658,636,2261,430,4022,649,319,330
6020,4666,636,2263,430,4030,649,319,330
6025,4669,636,2264,430,4033,649,319,330
6030,4674,637,2266,431,4037,649,319,330
6035,4678,637,2268,431,4041,649,319,330
6040,4681,637,2269,431,4044,649,319,330
6045,4682,637,2269,431,4045,649,319,330
6050,4687,638,2272,432,4049,649,319,330
6055,4689,638,2274,432,4051,650,320,330
6060,4697,640,2278,433,4056,651,321,330
6065,4700,641,2280,434,4059,652,321,331
6070,4705,642,2280,434,4063,652,321,331
6075,4709,642,2282,434,4067,653,321,332
6080,4712,642,2285,434,4070,653,321,332
6085,4713,642,2285,434,4071,653,321,332
6090,4718,643,2288,434,4075,654,322,332
6095,4720,643,2289,434,4077,655,323,332
6100,4728,643,2295,434,4085,655,323,332
6105,4731,643,2296,434,4088,656,323,333
6110,4736,644,2297,434,4092,657,323,334
6115,4740,644,2300,434,4096,658,323,335
6120,4743,644,2302,434,4099,658,323,335
6125,4744,644,2303,434,4100,658,323,335
6130,4749,645,2305,434,4104,659,323,336
6135,4751,645,2307,434,4106,660,324,336
6140,4759,646,2309,434,4112,660,324,336
6145,4762,647,2310,435,4115,661,324,337
6150,4767,648,2312,436,4119,662,324,338
6155,4771,648,2313,436,4123,662,324,338
6160,4774,648,2315,436,4126,662,324,338
6165,4775,648,2315,436,4127,662,324,338
6170,4780,649,2320,437,4131,663,325,338
6175,4782,649,2321,437,4133,664,326,338
6180,4790,651,2325,438,4138,665,327,338
6185,4793,652,2326,439,4141,665,327,338
6190,4798,653,2328,439,4145,665,327,338
6195,4802,653,2329,439,4149,666,328,338
6200,4805,653,2329,439,4152,666,328,338
6205,4806,653,2330,439,4153,666,328,338
6210,4811,654,2334,439,4157,666,328,338
6215,4813,654,2336,439,4159,667,329,338
6220,4821,654,2339,439,4167,667,329,338
6225,4824,654,2339,439,4170,667,329,338
6230,4829,655,2342,440,4174,667,329,338
6235,4833,655,2345,440,4178,668,329,339
6240,4836,655,2346,440,4181,668,329,339
6245,4837,655,2347,440,4182,668,329,339
6250,4842,656,2350,440,4186,668,329,339
6255,4844,656,2350,440,4188,669,329,340
6260,4852,656,2355,440,4196,669,329,340
6265,4855,656,2356,440,4199,669,329,340
6270,4860,657,2357,440,4203,669,329,340
6275,4864,657,2360,440,4207,670,330,340
6280,4867,657,2361,440,4210,670,330,340
6285,4868,657,2361,440,4211,670,330,340
6290,4873,658,2362,440,4215,670,330,340
6295,4875,658,2362,440,4217,671,330,341
6300,4883,659,2364,440,4224,673,331,342
6305,4886,660,2367,441,4226,673,331,342
6310,4891,661,2371,442,4230,674,332,342
6315,4895,661,2372,442,4234,674,332,342
6320,4898,661,2373,442,4237,674,332,342
6325,4899,661,2374,442,4238,674,332,342
6330,4904,662,2377,443,4242,675,332,343
6335,4906,662,2377,443,4244,676,332,344
6340,4914,663,2382,444,4251,677,333,344
6345,4917,663,2384,444,4254,677,333,344
6350,4922,664,2387,445,4258,678,333,345
6355,4926,664,2389,445,4262,678,333,345
6360,4929,664,2390,445,4265,678,333,345
6365,4930,664,2391,445,4266,678,333,345
6370,4935,665,2395,446,4270,679,334,345
6375,4937,665,2397,446,4272,680,335,345
6380,4945,666,2402,447,4279,680,335,345
6385,4948,666,2402,447,4282,680,335,345
6390,4953,667,2403,447,4286,680,335,345
6395,4957,667,2404,447,4290,680,335,345
6400,4960,667,2404,447,4293,680,335,345
6405,4961,667,2405,447,4294,680,335,345
6410,4966,668,2408,447,4298,681,335,346
6415,4968,668,2409,447,4300,682,335,347
6420,4976,671,2412,449,4305,683,335,348
6425,4979,671,2412,449,4308,683,335,348
6430,4984,672,2415,449,4312,683,335,348
6435,4988,672,2417,449,4316,683,335,348
6440,4991,672,2419,449,4319,683,335,348
6445,4992,672,2420,449,4320,683,335,348
6450,4997,673,2423,449,4324,683,335,348
6455,4999,673,2425,449,4326,684,336,348
6460,5007,673,2429,449,4334,684,336,348
6465,5010,673,2432,449,4337,684,336,348
6470,5015,674,2435,450,4341,684,336,348
6475,5019,674,2438,450,4345,684,336,348
6480,5022,674,2440,450,4348,684,336,348
6485,5023,674,2440,450,4349,684,336,348
6490,5028,675,2442,451,4353,684,336,348
6495,5030,675,2443,451,4355,685,337,348
6500,5038,675,2448,451,4363,685,337,348
6505,5041,675,2449,451,4366,685,337,348
6510,5046,676,2450,451,4370,685,337,348
6515,5050,676,2452,451,4374,685,337,348
6520,5053,676,2454,451,4377,685,337,348
6525,5054,677,2455,452,4377,685,337,348
6530,5059,678,2459,453,4381,686,338,348
6535,5061,678,2459,453,4383,687,338,349
6540,5069,679,2463,454,4389,688,338,350
6545,5072,680,2465,455,4392,688,338,350
6550,5077,681,2468,456,4396,688,338,350
6555,5081,681,2469,456,4400,690,339,351
6560,5084,681,2470,456,4403,690,339,351
6565,5085,681,2471,456,4404,690,339,351
6570,5090,682,2473,456,4408,691,340,351
6575,5092,682,2473,456,4410,692,340,352
6580,5100,683,2476,456,4417,692,340,352
6585,5103,683,2478,456,4420,692,340,352
6590,5108,684,2481,457,4424,692,340,352
6595,5112,684,2483,457,4428,694,341,353
6600,5115,684,2484,457,4431,694,341,353
6605,5116,684,2485,457,4432,694,341,353
6610,5121,685,2488,458,4436,695,341,354
6615,5123,685,2489,458,4438,696,342,354
6620,5131,686,2492,458,4445,696,342,354
6625,5134,686,2494,458,4448,696,342,354
6630,5139,687,2497,458,4452,696,342,354
6635,5143,687,2500,458,4456,697,343,354
6640,5146,687,2502,458,4459,697,343,354
6645,5147,687,2502,458,4460,697,343,354
6650,5152,688,2505,459,4464,697,343,354
6655,5154,688,2506,459,4466,698,343,355
6660,5162,689,2509,459,4472,700,345,355
6665,5165,691,2512,461,4474,700,345,355
6670,5170,692,2514,462,4478,701,345,356
6675,5174,692,2518,462,4481,701,345,356
6680,5177,693,2521,463,4484,701,345,356
6685,5178,693,2521,463,4485,701,345,356
6690,5183,694,2524,464,4489,701,345,356
6695,5185,694,2525,464,4491,702,345,357
6700,5193,695,2528,464,4498,704,346,358
6705,5196,696,2530,465,4500,704,346,358
6710,5201,697,2534,466,4504,705,347,358
6715,5205,697,2534,466,4508,705,347,358
6720,5208,697,2535,466,4511,705,347,358
6725,5209,698,2536,467,4511,705,347,358
6730,5214,699,2539,468,4515,706,348,358
6735,5216,699,2540,468,4517,707,348,359
6740,5224,700,2543,468,4524,708,348,360
6745,5227,700,2544,468,4527,708,348,360
6750,5232,701,2545,468,4531,708,348,360
6755,5236,701,2548,468,4534,708,348,360
6760,5239,702,2549,469,4537,708,348,360
6765,5240,702,2549,469,4538,708,348,360
6770,5245,703,2551,469,4542,709,349,360
6775,5247,703,2553,469,4544,710,350,360
6780,5255,705,2558,470,4549,711,351,360
6785,5258,706,2559,471,4552,711,351,360
6790,5263,707,2562,472,4556,711,351,360
6795,5267,707,2565,472,4560,713,352,361
6800,5270,708,2566,473,4562,713,352,361
6805,5271,708,2567,473,4563,713,352,361
6810,5276,709,2570,474,4567,713,352,361
6815,5278,709,2572,474,4569,714,353,361
6820,5286,709,2573,474,4577,714,353,361
6825,5289,709,2575,474,4580,714,353,361
6830,5294,710,2578,475,4584,714,353,361
6835,5298,710,2580,475,4588,716,355,361
6840,5301,711,2582,476,4590,716,355,361
6845,5302,711,2583,476,4591,716,355,361
6850,5307,712,2584,476,4595,716,355,361
6855,5309,712,2585,476,4597,717,356,361
6860,5317,713,2589,477,4604,717,356,361
6865,5320,714,2590,478,4606,717,356,361
6870,5325,715,2594,479,4610,717,356,361
6875,5329,715,2596,479,4614,719,358,361
6880,5332,716,2599,480,4616,719,358,361
6885,5333,716,2599,480,4617,719,358,361
6890,5338,717,2602,481,4621,720,359,361
6895,5340,717,2603,481,4623,721,359,362
6900,5348,718,2606,482,4629,722,359,363
6905,5351,719,2607,483,4632,722,359,363
6910,5356,719,2609,483,4637,722,359,363
6915,5360,719,2611,483,4640,722,359,363
6920,5363,720,2612,484,4643,722,359,363
6925,5364,720,2612,484,4644,722,359,363
6930,5369,721,2614,485,4648,722,359,363
6935,5371,721,2614,485,4650,723,359,364
6940,5379,721,2616,485,4658,723,359,364
6945,5382,721,2618,485,4661,723,359,364
6950,5387,721,2619,485,4666,723,359,364
6955,5391,721,2621,485,4670,723,359,364
6960,5394,721,2623,485,4673,723,359,364
6965,5395,721,2623,485,4674,723,359,364
6970,5400,722,2625,485,4678,723,359,364
6975,5402,722,2626,485,4680,724,359,365
6980,5410,723,2629,486,4687,724,359,365
6985,5413,723,2629,486,4690,724,359,365
6990,5418,723,2633,486,4695,724,359,365
6995,5422,723,2635,486,4699,724,359,365
7000,5425,723,2637,486,4702,724,359,365
7005,5426,724,2638,487,4702,724,359,365
7010,5431,725,2640,488,4706,724,359,365
7015,5433,725,2640,488,4708,725,359,366
7020,5441,727,2644,489,4713,727,360,367
7025,5444,728,2647,490,4716,727,360,367
7030,5449,729,2650,491,4720,728,361,367
7035,5453,729,2650,491,4724,729,361,368
7040,5456,729,2651,491,4727,729,361,368
7045,5457,729,2652,491,4728,729,361,368
7050,5462,729,2654,491,4733,729,361,368
7055,5464,729,2654,491,4735,730,361,369
7060,5472,729,2657,491,4743,730,361,369
7065,5475,729,2657,491,4746,730,361,369
7070,5480,730,2660,491,4750,731,362,369
7075,5484,730,2662,491,4754,732,362,370
7080,5487,731,2664,492,4756,732,362,370
7085,5488,731,2664,492,4757,732,362,370
7090,5493,731,2667,492,4762,732,362,370
7095,5495,731,2668,492,4764,733,362,371
7100,5503,732,2672,492,4771,733,362,371
7105,5506,733,2673,493,4773,733,362,371
7110,5511,734,2675,493,4777,734,362,372
7115,5515,734,2676,493,4781,735,362,373
7120,5518,734,2676,493,4784,735,362,373
7125,5519,734,2677,493,4785,735,362,373
7130,5524,735,2680,493,4789,736,363,373
7135,5526,735,2681,493,4791,737,363,374
7140,5534,736,2683,493,4797,739,364,375
7145,5537,737,2686,494,4800,739,364,375
7150,5542,737,2689,494,4805,739,364,375
7155,5546,737,2691,494,4809,740,365,375
7160,5549,737,2691,494,4812,740,365,375
7165,5550,737,2692,494,4813,740,365,375
7170,5555,738,2693,494,4817,740,365,375
7175,5557,738,2695,494,4819,741,366,375
7180,5565,738,2697,494,4827,741,366,375
7185,5568,738,2699,494,4830,741,366,375
7190,5573,738,2702,494,4835,741,366,375
7195,5577,738,2706,494,4839,742,367,375
7200,5580,738,2708,494,4842,742,367,375
7205,5581,738,2708,494,4843,742,367,375
7210,5586,739,2709,495,4847,742,367,375
7215,5588,739,2709,495,4849,743,367,376
7220,5596,740,2711,496,4856,743,367,376
7225,5599,741,2714,497,4858,743,367,376
7230,5604,742,2716,498,4862,743,367,376
7235,5608,742,2717,498,4866,744,367,377
7240,5611,742,2718,498,4869,744,367,377
7245,5612,742,2718,498,4870,744,367,377
7250,5617,744,2722,500,4873,744,367,377
7255,5619,744,2723,500,4875,745,368,377
7260,5627,747,2729,502,4879,747,370,377
7265,5630,748,2731,503,4882,747,370,377
7270,5635,749,2733,503,4886,748,370,378
7275,5639,749,2734,503,4890,748,370,378
7280,5642,749,2734,503,4893,748,370,378
7285,5643,749,2734,503,4894,748,370,378
7290,5648,750,2736,503,4898,748,370,378
7295,5650,750,2737,503,4900,749,370,379
7300,5658,750,2741,503,4908,750,370,380
7305,5661,750,2742,503,4911,750,370,380
7310,5666,751,2745,504,4915,751,371,380
7315,5670,751,2746,504,4919,751,371,380
7320,5673,751,2748,504,4922,751,371,380
7325,5674,751,2749,504,4923,751,371,380
7330,5679,752,2751,504,4927,751,371,380
7335,5681,752,2751,504,4929,752,371,381
7340,5689,753,2756,505,4936,752,371,381
7345,5692,753,2756,505,4939,752,371,381
7350,5697,754,2757,505,4943,752,371,381
7355,5701,754,2759,505,4946,752,371,381
7360,5704,755,2760,506,4949,752,371,381
7365,5705,755,2760,506,4950,752,371,381
7370,5710,756,2762,506,4954,753,372,381
7375,5712,756,2764,506,4956,754,373,381
7380,5720,757,2768,507,4963,755,373,382
7385,5723,757,2768,507,4966,755,373,382
7390,5728,757,2770,507,4971,755,373,382
7395,5732,757,2774,507,4974,756,374,382
7400,5735,758,2774,508,4977,756,374,382
7405,5736,759,2775,509,4977,756,374,382
7410,5741,760,2777,509,4981,756,374,382
7415,5743,760,2778,509,4983,757,374,383
7420,5751,760,2781,509,4991,758,374,384
7425,5754,760,2782,509,4994,758,374,384
7430,5759,760,2783,509,4998,759,374,385
7435,5763,761,2786,510,5001,760,375,385
7440,5766,762,2787,511,5004,760,375,385
7445,5767,762,2788,511,5005,760,375,385
7450,5772,762,2792,511,5010,760,375,385
7455,5774,762,2792,511,5012,761,375,386
7460,5782,763,2796,511,5019,761,375,386
7465,5785,764,2799,512,5021,762,376,386
7470,5790,764,2801,512,5026,763,377,386
7475,5794,764,2802,512,5030,763,377,386
7480,5797,764,2803,512,5033,763,377,386
7485,5798,764,2803,512,5034,763,377,386
7490,5803,764,2808,512,5039,764,378,386
7495,5805,764,2808,512,5041,765,378,387
7500,5813,765,2812,513,5047,766,378,388
7505,5816,767,2814,515,5049,766,378,388
7510,5821,768,2816,515,5053,766,378,388
7515,5825,768,2819,515,5057,767,379,388
7520,5828,768,2821,515,5060,767,379,388
7525,5829,768,2822,515,5061,767,379,388
7530,5834,769,2823,515,5065,767,379,388
7535,5836,769,2824,515,5067,768,380,388
7540,5844,771,2829,517,5073,769,381,388
7545,5847,772,2831,518,5075,769,381,388
7550,5852,775,2833,520,5077,769,381,388
7555,5856,775,2836,520,5081,771,382,389
7560,5859,775,2837,520,5084,771,382,389
7565,5860,775,2838,520,5085,771,382,389
7570,5865,776,2840,520,5089,771,382,389
7575,5867,776,2842,520,5091,772,383,389
7580,5875,777,2850,521,5098,773,384,389
7585,5878,777,2851,521,5101,773,384,389
7590,5883,778,2854,521,5105,773,384,389
7595,5887,778,2856,521,5109,775,385,390
7600,5890,779,2858,522,5111,775,385,390
7605,5891,779,2858,522,5112,775,385,390
7610,5896,780,2860,522,5116,776,385,391
7615,5898,780,2860,522,5118,777,385,392
7620,5906,781,2864,523,5125,779,385,394
7625,5909,782,2867,524,5127,780,386,394
7630,5914,783,2870,524,5131,781,387,394
7635,5918,783,2870,524,5135,783,387,396
7640,5921,783,2870,524,5138,783,387,396
7645,5922,783,2870,524,5139,783,387,396
7650,5927,784,2874,525,5143,784,388,396
7655,5929,784,2874,525,5145,785,388,397
7660,5937,785,2879,526,5152,786,388,398
7665,5940,785,2879,526,5155,787,388,399
7670,5945,787,2882,528,5158,788,388,400
7675,5949,787,2885,528,5161,790,390,400
7680,5952,788,2886,529,5164,790,390,400
7685,5953,788,2886,529,5165,790,390,400
7690,5958,789,2888,529,5169,791,391,400
7695,5960,789,2890,529,5171,792,392,400
7700,5968,789,2897,529,5179,792,392,400
7705,5971,789,2897,529,5182,792,392,400
7710,5976,790,2901,530,5186,792,392,400
7715,5980,790,2901,530,5190,793,392,401
7720,5983,791,2904,531,5192,793,392,401
7725,5984,791,2905,531,5193,793,392,401
7730,5989,792,2909,532,5197,793,392,401
7735,5991,792,2910,532,5199,794,392,402
7740,5999,792,2916,532,5207,795,393,402
7745,6002,792,2917,532,5210,795,393,402
7750,6007,793,2918,532,5214,795,393,402
7755,6011,793,2920,532,5218,795,393,402
7760,6014,793,2922,532,5221,795,393,402
7765,6015,794,2923,533,5221,795,393,402
7770,6020,795,2925,533,5225,795,393,402
7775,6022,795,2926,533,5227,796,393,403
7780,6030,795,2928,533,5235,797,393,404
7785,6033,795,2930,533,5238,797,393,404
7790,6038,796,2932,533,5242,798,394,404
7795,6042,796,2933,533,5246,799,395,404
7800,6045,796,2934,533,5249,799,395,404
7805,6046,797,2935,534,5249,799,395,404
7810,6051,798,2937,534,5253,799,395,404
7815,6053,798,2939,534,5255,800,396,404
7820,6061,800,2944,535,5260,802,397,405
7825,6064,801,2944,536,5263,803,397,406
7830,6069,802,2946,537,5267,804,397,407
7835,6073,802,2949,537,5271,805,398,407
7840,6076,802,2951,537,5274,805,398,407
7845,6077,803,2952,538,5274,805,398,407
7850,6082,804,2953,538,5278,806,398,408
7855,6084,804,2953,538,5280,807,398,409
7860,6092,805,2955,538,5287,809,399,410
7865,6095,805,2957,538,5290,810,400,410
7870,6100,806,2957,538,5294,811,400,411
7875,6104,806,2959,538,5298,813,402,411
7880,6107,806,2961,538,5301,813,402,411
7885,6108,806,2961,538,5302,813,402,411
7890,6113,807,2964,538,5306,814,403,411
7895,6115,807,2965,538,5308,815,404,411
7900,6123,808,2968,538,5315,815,404,411
7905,6126,809,2970,539,5317,816,404,412
7910,6131,810,2972,540,5321,817,405,412
7915,6135,810,2976,540,5325,819,407,412
7920,6138,811,2979,541,5327,819,407,412
7925,6139,811,2979,541,5328,819,407,412
7930,6144,812,2984,542,5332,820,408,412
7935,6146,812,2985,542,5334,821,409,412
7940,6154,812,2988,542,5342,822,409,413
7945,6157,812,2989,542,5345,822,409,413
7950,6162,813,2993,543,5349,822,409,413
7955,6166,813,2995,543,5353,823,409,414
7960,6169,813,2997,543,5356,823,409,414
7965,6170,813,2997,543,5357,823,409,414
7970,6175,815,2999,544,5360,824,409,415
7975,6177,815,3001,544,5362,825,410,415
7980,6185,815,3004,544,5370,827,411,416
7985,6188,815,3004,544,5373,827,411,416
7990,6193,816,3008,545,5377,827,411,416
7995,6197,816,3011,545,5380,827,411,416
8000,6200,817,3014,546,5383,827,411,416
8005,6201,817,3014,546,5384,827,411,416
8010,6206,818,3015,546,5388,827,411,416
8015,6208,818,3017,546,5390,828,412,416
8020,6216,818,3021,546,5398,828,412,416
8025,6219,818,3023,546,5401,828,412,416
8030,6224,819,3027,547,5405,828,412,416
8035,6228,819,3028,547,5409,829,412,417
8040,6231,820,3029,548,5411,829,412,417
8045,6232,820,3029,548,5412,829,412,417
8050,6237,821,3029,548,5416,829,412,417
8055,6239,821,3031,548,5418,830,413,417
8060,6247,823,3037,550,5424,831,414,417
8065,6250,823,3038,550,5427,831,414,417
8070,6255,823,3039,550,5432,831,414,417
8075,6259,823,3040,550,5436,832,414,418
8080,6262,823,3041,550,5439,832,414,418
8085,6263,823,3042,550,5440,832,414,418
8090,6268,825,3046,552,5443,832,414,418
8095,6270,825,3046,552,5445,833,414,419
8100,6278,827,3051,554,5451,834,415,419
8105,6281,828,3053,555,5453,834,415,419
8110,6286,828,3053,555,5458,834,415,419
8115,6290,828,3054,555,5462,836,415,421
8120,6293,828,3056,555,5465,836,415,421
8125,6294,828,3057,555,5466,836,415,421
8130,6299,828,3059,555,5471,837,415,422
8135,6301,828,3060,555,5473,838,416,422
8140,6309,830,3066,556,5479,838,416,422
8145,6312,831,3068,557,5481,838,416,422
8150,6317,832,3071,558,5485,839,417,422
8155,6321,832,3074,558,5488,840,418,422
8160,6324,834,3076,560,5490,840,418,422
8165,6325,834,3076,560,5491,840,418,422
8170,6330,836,3080,562,5494,840,418,422
8175,6332,836,3080,562,5496,841,418,423
8180,6340,837,3083,563,5503,843,418,425
8185,6343,838,3085,564,5505,844,419,425
8190,6348,839,3086,565,5509,844,419,425
8195,6352,839,3089,565,5513,845,420,425
8200,6355,840,3092,566,5515,845,420,425
8205,6356,841,3093,567,5515,845,420,425
8210,6361,843,3097,569,5518,845,420,425
8215,6363,843,3099,569,5520,846,421,425
8220,6371,844,3102,570,5527,848,422,426
8225,6374,844,3103,570,5530,849,423,426
8230,6379,845,3106,570,5534,850,424,426
8235,6383,845,3107,570,5538,852,424,428
8240,6386,846,3108,571,5540,852,424,428
8245,6387,846,3108,571,5541,852,424,428
8250,6392,847,3112,572,5545,852,424,428
8255,6394,847,3114,572,5547,853,425,428
8260,6402,847,3117,572,5555,853,425,428
8265,6405,847,3119,572,5558,854,425,429
8270,6410,848,3120,572,5562,855,425,430
8275,6414,848,3122,572,5566,857,426,431
8280,6417,849,3123,573,5568,857,426,431
8285,6418,849,3124,573,5569,857,426,431
8290,6423,850,3127,573,5573,858,427,431
8295,6425,850,3128,573,5575,859,428,431
8300,6433,850,3130,573,5583,860,428,432
8305,6436,850,3132,573,5586,860,428,432
8310,6441,850,3134,573,5591,860,428,432
8315,6445,850,3136,573,5595,860,428,432
8320,6448,850,3137,573,5598,860,428,432
8325,6449,850,3137,573,5599,860,428,432
8330,6454,851,3139,573,5603,861,429,432
8335,6456,851,3139,573,5605,862,429,433
8340,6464,851,3141,573,5613,863,430,433
8345,6467,851,3142,573,5616,863,430,433
8350,6472,851,3146,573,5621,863,430,433
8355,6476,851,3147,573,5625,863,430,433
8360,6479,851,3149,573,5628,863,430,433
8365,6480,851,3149,573,5629,863,430,433
8370,6485,852,3151,574,5633,863,430,433
8375,6487,852,3151,574,5635,864,430,434
8380,6495,852,3155,574,5643,865,430,435
8385,6498,852,3158,574,5646,865,430,435
8390,6503,854,3162,576,5649,865,430,435
8395,6507,854,3165,576,5653,866,431,435
8400,6510,854,3167,576,5656,866,431,435
8405,6511,854,3167,576,5657,866,431,435
8410,6516,856,3169,577,5660,867,431,436
8415,6518,856,3170,577,5662,868,432,436
8420,6526,857,3175,578,5669,870,433,437
8425,6529,857,3176,578,5672,871,433,438
8430,6534,858,3176,578,5676,872,433,439
8435,6538,858,3178,578,5680,872,433,439
8440,6541,858,3180,578,5683,872,433,439
8445,6542,858,3180,578,5684,872,433,439
8450,6547,859,3182,578,5688,873,434,439
8455,6549,859,3182,578,5690,874,434,440
8460,6557,860,3187,578,5697,876,436,440
8465,6560,860,3189,578,5700,877,437,440
8470,6565,861,3190,578,5704,878,437,441
8475,6569,861,3191,578,5708,879,438,441
8480,6572,861,3192,578,5711,879,438,441
8485,6573,861,3193,578,5712,879,438,441
8490,6578,862,3196,579,5716,879,438,441
8495,6580,862,3198,579,5718,880,439,441
8500,6588,863,3202,580,5725,880,439,441
8505,6591,863,3203,580,5728,881,439,442
8510,6596,864,3206,581,5732,882,440,442
8515,6600,864,3207,581,5736,884,440,444
8520,6603,864,3208,581,5739,884,440,444
8525,6604,864,3208,581,5740,884,440,444
8530,6609,865,3210,581,5744,884,440,444
8535,6611,865,3211,581,5746,885,440,445
8540,6619,866,3216,581,5753,885,440,445
8545,6622,867,3219,582,5755,885,440,445
8550,6627,868,3219,582,5759,886,440,446
8555,6631,868,3220,582,5763,887,440,447
8560,6634,868,3221,582,5766,887,440,447
8565,6635,868,3222,582,5767,887,440,447
8570,6640,869,3225,582,5771,887,440,447
8575,6642,869,3226,582,5773,888,441,447
8580,6650,870,3228,582,5780,890,443,447
8585,6653,870,3229,582,5783,890,443,447
8590,6658,871,3231,583,5787,890,443,447
8595,6662,871,3232,583,5791,890,443,447
8600,6665,871,3235,583,5794,890,443,447
8605,6666,871,3235,583,5795,890,443,447
8610,6671,872,3236,583,5799,891,443,448
8615,6673,872,3236,583,5801,892,443,449
8620,6681,873,3239,584,5808,892,443,449
8625,6684,874,3241,585,5810,892,443,449
8630,6689,875,3245,586,5814,892,443,449
8635,6693,875,3248,586,5817,893,444,449
8640,6696,877,3250,588,5819,893,444,449
8645,6697,877,3250,588,5820,893,444,449
8650,6702,878,3252,589,5824,894,445,449
8655,6704,878,3254,589,5826,895,446,449
8660,6712,879,3256,589,5833,895,446,449
8665,6715,880,3257,590,5835,895,446,449
8670,6720,881,3260,591,5839,895,446,449
8675,6724,881,3260,591,5843,895,446,449
8680,6727,881,3261,591,5846,895,446,449
8685,6728,882,3262,592,5846,895,446,449
8690,6733,884,3265,593,5849,896,446,450
8695,6735,884,3265,593,5851,897,446,451
8700,6743,886,3270,594,5857,898,446,452
8705,6746,886,3271,594,5860,898,446,452
8710,6751,887,3274,595,5864,898,446,452
8715,6755,887,3277,595,5868,898,446,452
8720,6758,887,3279,595,5871,898,446,452
8725,6759,887,3279,595,5872,898,446,452
8730,6764,887,3282,595,5877,898,446,452
8735,6766,887,3282,595,5879,899,446,453
8740,6774,887,3285,595,5887,899,446,453
8745,6777,887,3287,595,5890,899,446,453
8750,6782,888,3290,595,5894,900,447,453
8755,6786,888,3293,595,5898,901,448,453
8760,6789,889,3296,596,5900,901,448,453
8765,6790,889,3297,596,5901,901,448,453
8770,6795,889,3300,596,5906,901,448,453
8775,6797,889,3301,596,5908,902,449,453
8780,6805,889,3305,596,5916,903,450,453
8785,6808,889,3305,596,5919,903,450,453
8790,6813,890,3308,597,5923,904,450,454
8795,6817,890,3310,597,5927,905,450,455
8800,6820,891,3312,598,5929,905,450,455
8805,6821,891,3312,598,5930,905,450,455
8810,6826,892,3315,599,5934,905,450,455
8815,6828,892,3317,599,5936,906,451,455
8820,6836,894,3322,601,5941,908,451,457
8825,6839,896,3323,603,5943,908,451,457
8830,6844,896,3325,603,5948,908,451,457
8835,6848,896,3326,603,5952,909,451,458
8840,6851,896,3329,603,5955,909,451,458
8845,6852,896,3330,603,5956,909,451,458
8850,6857,896,3332,603,5961,909,451,458
8855,6859,896,3332,603,5963,910,451,459
8860,6867,898,3338,605,5969,910,451,459
8865,6870,899,3339,606,5971,910,451,459
8870,6875,899,3341,606,5976,910,451,459
8875,6879,899,3343,606,5980,911,452,459
8880,6882,899,3343,606,5983,911,452,459
8885,6883,899,3343,606,5984,911,452,459
8890,6888,899,3346,606,5989,911,452,459
8895,6890,899,3346,606,5991,912,452,460
8900,6898,900,3350,607,5998,912,452,460
8905,6901,900,3352,607,6001,912,452,460
8910,6906,901,3353,608,6005,912,452,460
8915,6910,901,3355,608,6009,912,452,460
8920,6913,901,3357,608,6012,912,452,460
8925,6914,901,3357,608,6013,912,452,460
8930,6919,902,3358,608,6017,913,452,461
8935,6921,902,3358,608,6019,914,452,462
8940,6929,904,3363,610,6024,916,453,463
8945,6932,905,3366,611,6027,916,453,463
8950,6937,906,3369,611,6031,916,453,463
8955,6941,906,3370,611,6035,916,453,463
8960,6944,906,3372,611,6038,916,453,463
8965,6945,906,3372,611,6039,916,453,463
8970,6950,906,3373,611,6044,916,453,463
8975,6952,906,3375,611,6046,917,454,463
8980,6960,906,3378,611,6054,917,454,463
8985,6963,906,3379,611,6057,917,454,463
8990,6968,907,3382,612,6061,917,454,463
8995,6972,907,3384,612,6065,917,454,463
9000,6975,907,3384,612,6068,917,454,463
9005,6976,907,3385,612,6069,917,454,463
9010,6981,908,3389,613,6073,917,454,463
9015,6983,908,3389,613,6075,918,454,464
9020,6991,909,3393,614,6082,919,455,464
9025,6994,909,3395,614,6085,919,455,464
9030,6999,910,3399,615,6089,919,455,464
9035,7003,910,3401,615,6092,919,455,464
9040,7006,911,3401,616,6095,919,455,464
9045,7007,911,3402,616,6096,919,455,464
9050,7012,912,3403,616,6100,920,455,465
9055,7014,912,3403,616,6102,921,455,466
9060,7022,913,3409,617,6108,922,456,466
9065,7025,914,3410,618,6111,922,456,466
9070,7030,915,3414,619,6115,922,456,466
9075,7034,915,3415,619,6119,922,456,466
9080,7037,915,3416,619,6122,922,456,466
9085,7038,915,3417,619,6123,922,456,466
9090,7043,915,3419,619,6128,922,456,466
9095,7045,915,3419,619,6130,923,456,467
9100,7053,915,3422,619,6138,923,456,467
9105,7056,915,3424,619,6141,923,456,467
9110,7061,916,3425,619,6145,923,456,467
9115,7065,916,3426,619,6149,924,456,468
9120,7068,917,3427,620,6151,924,456,468
9125,7069,917,3428,620,6152,924,456,468
9130,7074,917,3430,620,6157,924,456,468
9135,7076,917,3430,620,6159,925,456,469
9140,7084,919,3432,622,6165,926,456,470
9145,7087,919,3433,622,6168,927,456,471
9150,7092,920,3436,623,6172,927,456,471
9155,7096,920,3438,623,6175,928,457,471
9160,7099,922,3440,625,6177,928,457,471
9165,7100,922,3441,625,6177,928,457,471
9170,7105,924,3444,627,6180,929,458,471
9175,7107,925,3444,628,6182,930,458,472
9180,7115,928,3449,630,6187,931,459,472
9185,7118,928,3450,630,6190,931,459,472
9190,7123,929,3453,630,6194,932,459,473
9195,7127,929,3455,630,6198,932,459,473
9200,7130,929,3456,630,6201,932,459,473
9205,7131,929,3457,630,6202,932,459,473
9210,7136,930,3460,630,6206,932,459,473
9215,7138,930,3461,630,6208,933,460,473
9220,7146,931,3464,631,6215,934,461,473
9225,7149,932,3466,632,6217,934,461,473
9230,7154,933,3468,632,6221,935,462,473
9235,7158,933,3471,632,6225,936,463,473
9240,7161,934,3472,633,6227,936,463,473
9245,7162,934,3473,633,6228,936,463,473
9250,7167,935,3477,634,6232,936,463,473
9255,7169,935,3477,634,6234,937,463,474
9260,7177,935,3480,634,6241,937,463,474
9265,7180,936,3482,635,6244,938,463,475
9270,7185,936,3486,635,6249,938,463,475
9275,7189,936,3487,635,6253,939,463,476
9280,7192,936,3489,635,6256,939,463,476
9285,7193,937,3490,636,6256,939,463,476
9290,7198,939,3495,638,6259,939,463,476
9295,7200,939,3497,638,6261,940,464,476
9300,7208,939,3499,638,6268,941,465,476
9305,7211,940,3500,639,6271,942,465,477
9310,7216,940,3501,639,6276,942,465,477
9315,7220,940,3503,639,6280,943,466,477
9320,7223,940,3504,639,6283,943,466,477
9325,7224,940,3504,639,6284,943,466,477
9330,7229,941,3507,639,6288,943,466,477
9335,7231,941,3508,639,6290,944,467,477
9340,7239,941,3511,639,6298,944,467,477
9345,7242,941,3513,639,6301,945,467,478
9350,7247,941,3517,639,6305,946,468,478
9355,7251,942,3519,640,6309,947,468,479
9360,7254,942,3520,640,6312,947,468,479
9365,7255,942,3520,640,6313,947,468,479
9370,7260,943,3522,641,6317,947,468,479
9375,7262,943,3522,641,6319,948,468,480
9380,7270,944,3527,642,6326,948,468,480
9385,7273,945,3528,643,6328,948,468,480
9390,7278,946,3532,643,6332,948,468,480
9395,7282,946,3535,643,6335,948,468,480
9400,7285,947,3537,644,6338,948,468,480
9405,7286,947,3538,644,6339,948,468,480
9410,7291,948,3542,645,6343,948,468,480
9415,7293,948,3543,645,6345,949,469,480
9420,7301,949,3546,645,6352,950,470,480
9425,7304,949,3546,645,6355,950,470,480
9430,7309,950,3549,645,6359,951,471,480
9435,7313,950,3552,645,6362,951,471,480
9440,7316,951,3553,646,6365,951,471,480
9445,7317,951,3553,646,6366,951,471,480
9450,7322,952,3558,647,6370,951,471,480
9455,7324,952,3558,647,6372,952,471,481
9460,7332,953,3561,647,6379,953,472,481
9465,7335,954,3564,648,6381,953,472,481
9470,7340,957,3566,650,6383,954,472,482
9475,7344,957,3568,650,6387,955,473,482
9480,7347,958,3571,651,6389,955,473,482
9485,7348,958,3572,651,6390,955,473,482
9490,7353,959,3576,652,6394,956,474,482
9495,7355,959,3577,652,6396,957,475,482
9500,7363,961,3584,654,6402,957,475,482
9505,7366,962,3586,655,6404,957,475,482
9510,7371,963,3589,655,6408,957,475,482
9515,7375,963,3592,655,6412,958,476,482
9520,7378,964,3594,656,6414,958,476,482
9525,7379,965,3595,657,6414,958,476,482
9530,7384,967,3600,659,6417,959,477,482
9535,7386,967,3602,659,6419,960,478,482
9540,7394,969,3605,660,6424,961,478,483
9545,7397,970,3606,661,6427,961,478,483
9550,7402,971,3608,661,6431,961,478,483
9555,7406,971,3611,661,6435,963,479,484
9560,7409,972,3612,662,6437,963,479,484
9565,7410,972,3612,662,6438,963,479,484
9570,7415,973,3614,662,6442,963,479,484
9575,7417,973,3615,662,6444,964,479,485
9580,7425,973,3621,662,6452,964,479,485
9585,7428,973,3622,662,6455,964,479,485
9590,7433,974,3627,663,6459,965,480,485
9595,7437,974,3630,663,6463,967,482,485
9600,7440,974,3632,663,6466,967,482,485
9605,7441,974,3632,663,6467,967,482,485
9610,7446,975,3635,664,6471,967,482,485
9615,7448,975,3636,664,6473,968,482,486
9620,7456,975,3640,664,6481,969,483,486
9625,7459,975,3642,664,6484,969,483,486
9630,7464,976,3644,665,6488,970,483,487
9635,7468,976,3646,665,6492,971,483,488
9640,7471,976,3648,665,6495,971,483,488
9645,7472,976,3649,665,6496,971,483,488
9650,7477,978,3654,667,6499,971,483,488
9655,7479,978,3655,667,6501,972,484,488
9660,7487,981,3660,670,6506,974,485,489
9665,7490,982,3661,671,6508,974,485,489
9670,7495,983,3664,672,6512,974,485,489
9675,7499,983,3665,672,6516,974,485,489
9680,7502,983,3665,672,6519,974,485,489
9685,7503,983,3666,672,6520,974,485,489
9690,7508,984,3667,673,6524,975,485,490
9695,7510,984,3668,673,6526,976,485,491
9700,7518,985,3672,673,6533,976,485,491
9705,7521,986,3674,674,6535,976,485,491
9710,7526,987,3675,674,6539,976,485,491
9715,7530,987,3677,674,6543,977,486,491
9720,7533,987,3678,674,6546,977,486,491
9725,7534,987,3678,674,6547,977,486,491
9730,7539,988,3679,674,6551,978,486,492
9735,7541,988,3679,674,6553,979,486,493
9740,7549,990,3681,675,6559,979,486,493
9745,7552,990,3681,675,6562,979,486,493
9750,7557,991,3681,675,6566,979,486,493
9755,7561,991,3682,675,6570,980,486,494
9760,7564,992,3685,676,6572,980,486,494
9765,7565,993,3686,677,6572,980,486,494
9770,7570,994,3689,678,6576,980,486,494
9775,7572,994,3690,678,6578,981,487,494
9780,7580,995,3692,678,6584,982,488,494
9785,7583,996,3694,679,6587,982,488,494
9790,7588,997,3695,679,6591,982,488,494
9795,7592,997,3696,679,6595,983,488,495
9800,7595,998,3698,680,6597,983,488,495
9805,7596,998,3699,680,6598,983,488,495
9810,7601,999,3703,681,6602,983,488,495
9815,7603,999,3704,681,6604,984,488,496
9820,7611,999,3708,681,6612,984,488,496
9825,7614,999,3710,681,6615,984,488,496
9830,7619,1000,3712,681,6619,984,488,496
9835,7623,1000,3715,681,6623,985,489,496
9840,7626,1000,3715,681,6626,985,489,496
9845,7627,1000,3716,681,6627,985,489,496
9850,7632,1001,3716,681,6631,986,489,497
9855,7634,1001,3718,681,6633,987,490,497
9860,7642,1001,3723,681,6641,988,491,497
9865,7645,1001,3725,681,6644,988,491,497
9870,7650,1002,3726,682,6648,988,491,497
9875,7654,1002,3727,682,6652,989,492,497
9880,7657,1002,3728,682,6655,989,492,497
9885,7658,1003,3729,683,6655,989,492,497
9890,7663,1004,3732,684,6659,990,493,497
9895,7665,1004,3732,684,6661,991,493,498
9900,7673,1006,3736,685,6666,993,494,499
9905,7676,1008,3739,687,6668,993,494,499
9910,7681,1009,3743,688,6672,993,494,499
9915,7685,1009,3744,688,6676,993,494,499
9920,7688,1009,3747,688,6679,993,494,499
9925,7689,1009,3748,688,6680,993,494,499
9930,7694,1009,3751,688,6685,994,494,500
9935,7696,1009,3753,688,6687,995,495,500
9940,7704,1011,3760,690,6693,995,495,500
9945,7707,1011,3762,690,6696,995,495,500
9950,7712,1012,3765,690,6700,995,495,500
9955,7716,1012,3768,690,6704,996,495,501
9960,7719,1013,3770,691,6706,996,495,501
9965,7720,1013,3770,691,6707,996,495,501
9970,7725,1014,3772,692,6711,997,495,502
9975,7727,1014,3774,692,6713,998,496,502
9980,7735,1016,3778,694,6719,999,496,503
9985,7738,1016,3778,694,6722,1000,496,504
9990,7743,1016,3780,694,6727,1000,496,504
9995,7747,1016,3784,694,6730,1001,497,504
10000,7750,1017,3784,695,6733,1001,497,504
10005,7751,1017,3785,695,6734,1001,497,504
10010,7756,1018,3787,695,6738,1002,498,504
10015,7758,1018,3788,695,6740,1003,498,505
10020,7766,1020,3793,697,6746,1005,499,506
10025,7769,1020,3793,697,6749,1006,499,507
10030,7774,1020,3794,697,6754,1007,499,508
10035,7778,1020,3797,697,6758,1008,499,509
10040,7781,1020,3798,697,6761,1008,499,509
10045,7782,1020,3798,697,6762,1008,499,509
10050,7787,1020,3798,697,6767,1008,499,509
10055,7789,1020,3799,697,6769,1009,499,510
10060,7797,1021,3802,698,6776,1010,499,511
10065,7800,1021,3802,698,6779,1011,499,512
10070,7805,1022,3803,698,6783,1012,499,513
10075,7809,1022,3807,698,6787,1013,500,513
10080,7812,1022,3808,698,6790,1013,500,513
10085,7813,1022,3808,698,6791,1013,500,513
10090,7818,1022,3811,698,6796,1013,500,513
10095,7820,1022,3813,698,6798,1014,501,513
10100,7828,1023,3818,698,6805,1014,501,513
10105,7831,1024,3820,699,6807,1014,501,513
10110,7836,1025,3822,699,6811,1015,502,513
10115,7840,1025,3824,699,6814,1016,502,514
10120,7843,1026,3825,700,6817,1016,502,514
10125,7844,1026,3826,700,6817,1016,502,514
10130,7849,1028,3830,701,6820,1016,502,514
10135,7851,1029,3832,702,6822,1017,503,514
10140,7859,1030,3837,703,6829,1018,504,514
10145,7862,1030,3839,703,6832,1018,504,514
10150,7867,1031,3841,703,6836,1018,504,514
10155,7871,1031,3841,703,6840,1018,504,514
10160,7874,1031,3842,703,6843,1018,504,514
10165,7875,1031,3843,703,6844,1018,504,514
10170,7880,1032,3844,703,6848,1018,504,514
10175,7882,1032,3844,703,6850,1019,504,515
10180,7890,1032,3849,703,6858,1019,504,515
10185,7893,1032,3852,703,6861,1019,504,515
10190,7898,1034,3855,705,6864,1019,504,515
10195,7902,1034,3856,705,6868,1020,505,515
10200,7905,1034,3858,705,6871,1020,505,515
10205,7906,1034,3859,705,6872,1020,505,515
10210,7911,1035,3863,706,6876,1020,505,515
10215,7913,1035,3864,706,6878,1021,505,516
10220,7921,1035,3866,706,6886,1021,505,516
10225,7924,1035,3867,706,6889,1021,505,516
10230,7929,1036,3870,706,6893,1021,505,516
10235,7933,1036,3871,706,6897,1022,505,517
10240,7936,1036,3872,706,6900,1022,505,517
10245,7937,1036,3873,706,6901,1022,505,517
10250,7942,1037,3877,707,6904,1023,506,517
10255,7944,1038,3879,708,6906,1024,507,517
10260,7952,1040,3881,709,6912,1025,507,518
10265,7955,1041,3883,710,6914,1026,507,519
10270,7960,1042,3884,710,6918,1026,507,519
10275,7964,1042,3886,710,6922,1026,507,519
10280,7967,1042,3886,710,6925,1026,507,519
10285,7968,1042,3887,710,6926,1026,507,519
10290,7973,1043,3889,710,6930,1026,507,519
10295,7975,1043,3891,710,6932,1027,508,519
10300,7983,1044,3895,710,6939,1027,508,519
10305,7986,1044,3895,710,6942,1028,508,520
10310,7991,1045,3897,711,6946,1029,509,520
10315,7995,1045,3900,711,6950,1030,510,520
10320,7998,1045,3901,711,6953,1030,510,520
10325,7999,1045,3902,711,6954,1030,510,520
10330,8004,1046,3902,711,6958,1030,510,520
10335,8006,1046,3902,711,6960,1031,510,521
10340,8014,1047,3904,711,6967,1031,510,521
10345,8017,1047,3906,711,6970,1032,511,521
10350,8022,1048,3908,712,6974,1032,511,521
10355,8026,1048,3909,712,6978,1032,511,521
10360,8029,1048,3911,712,6981,1032,511,521
10365,8030,1048,3912,712,6982,1032,511,521
10370,8035,1049,3913,712,6986,1033,511,522
10375,8037,1049,3914,712,6988,1034,512,522
10380,8045,1050,3917,712,6994,1035,513,522
10385,8048,1052,3919,714,6996,1035,513,522
10390,8053,1053,3920,715,7000,1035,513,522
10395,8057,1053,3920,715,7004,1035,513,522
10400,8060,1053,3923,715,7007,1035,513,522
10405,8061,1053,3923,715,7008,1035,513,522
10410,8066,1054,3924,716,7012,1035,513,522
10415,8068,1054,3925,716,7014,1036,513,523
10420,8076,1055,3931,717,7021,1036,513,523
10425,8079,1055,3932,717,7024,1036,513,523
10430,8084,1056,3934,718,7028,1037,513,524
10435,8088,1056,3935,718,7032,1038,513,525
10440,8091,1056,3935,718,7035,1038,513,525
10445,8092,1056,3935,718,7036,1038,513,525
10450,8097,1057,3937,718,7040,1038,513,525
10455,8099,1057,3938,718,7042,1039,513,526
10460,8107,1059,3945,720,7047,1040,514,526
10465,8110,1061,3946,722,7049,1041,514,527
10470,8115,1062,3950,723,7053,1042,515,527
10475,8119,1062,3953,723,7056,1043,515,528
10480,8122,1063,3954,724,7059,1043,515,528
10485,8123,1064,3955,725,7059,1043,515,528
10490,8128,1065,3957,725,7063,1043,515,528
10495,8130,1065,3958,725,7065,1044,516,528
10500,8138,1068,3963,727,7069,1046,516,530
10505,8141,1069,3963,728,7072,1046,516,530
10510,8146,1069,3966,728,7077,1046,516,530
10515,8150,1069,3969,728,7081,1048,518,530
10520,8153,1069,3971,728,7084,1048,518,530
10525,8154,1069,3972,728,7085,1048,518,530
10530,8159,1070,3975,729,7089,1049,519,530
10535,8161,1070,3976,729,7091,1050,520,530
10540,8169,1070,3981,729,7099,1050,520,530
10545,8172,1070,3982,729,7102,1050,520,530
10550,8177,1070,3986,729,7107,1050,520,530
10555,8181,1070,3987,729,7111,1052,520,532
10560,8184,1070,3988,729,7114,1052,520,532
10565,8185,1070,3988,729,7115,1052,520,532
10570,8190,1071,3990,729,7119,1053,520,533
10575,8192,1071,3991,729,7121,1054,520,534
10580,8200,1071,3994,729,7129,1054,520,534
10585,8203,1071,3996,729,7132,1054,520,534
10590,8208,1073,4000,731,7135,1054,520,534
10595,8212,1073,4003,731,7139,1056,521,535
10600,8215,1073,4003,731,7142,1056,521,535
10605,8216,1073,4003,731,7143,1056,521,535
10610,8221,1074,4005,731,7147,1056,521,535
10615,8223,1074,4007,731,7149,1057,522,535
10620,8231,1075,4009,731,7155,1059,523,536
10625,8234,1077,4010,733,7157,1059,523,536
10630,8239,1078,4013,733,7161,1059,523,536
10635,8243,1078,4013,733,7165,1059,523,536
10640,8246,1078,4014,733,7168,1059,523,536
10645,8247,1078,4015,733,7169,1059,523,536
10650,8252,1079,4016,733,7173,1059,523,536
10655,8254,1079,4017,733,7175,1060,523,537
10660,8262,1080,4022,734,7182,1060,523,537
10665,8265,1080,4023,734,7185,1060,523,537
10670,8270,1081,4023,734,7189,1060,523,537
10675,8274,1081,4026,734,7192,1061,523,538
10680,8277,1083,4029,736,7194,1061,523,538
10685,8278,1083,4030,736,7195,1061,523,538
10690,8283,1084,4031,736,7199,1062,523,539
10695,8285,1084,4032,736,7201,1063,524,539
10700,8293,1085,4035,737,7208,1063,524,539
10705,8296,1086,4037,738,7210,1063,524,539
10710,8301,1088,4041,740,7213,1063,524,539
10715,8305,1088,4043,740,7216,1064,524,540
10720,8308,1090,4045,742,7218,1064,524,540
10725,8309,1091,4046,743,7218,1064,524,540
10730,8314,1093,4049,744,7221,1065,525,540
10735,8316,1093,4051,744,7223,1066,526,540
10740,8324,1095,4052,745,7229,1068,526,542
10745,8327,1095,4053,745,7232,1069,526,543
10750,8332,1095,4055,745,7237,1070,526,544
10755,8336,1095,4055,745,7241,1071,526,545
10760,8339,1095,4057,745,7244,1071,526,545
10765,8340,1095,4057,745,7245,1071,526,545
10770,8345,1095,4061,745,7250,1071,526,545
10775,8347,1095,4062,745,7252,1072,526,546
10780,8355,1095,4065,745,7260,1073,526,547
10785,8358,1095,4067,745,7263,1074,527,547
10790,8363,1095,4069,745,7268,1075,527,548
10795,8367,1095,4069,745,7272,1076,527,549
10800,8370,1095,4071,745,7275,1076,527,549
10805,8371,1095,4072,745,7276,1076,527,549
10810,8376,1095,4074,745,7281,1076,527,549
10815,8378,1095,4075,745,7283,1077,528,549
10820,8386,1095,4079,745,7291,1078,529,549
10825,8389,1095,4082,745,7294,1079,530,549
10830,8394,1095,4084,745,7299,1080,531,549
10835,8398,1095,4086,745,7303,1081,532,549
10840,8401,1095,4087,745,7306,1081,532,549
10845,8402,1095,4087,745,7307,1081,532,549
10850,8407,1097,4090,746,7310,1081,532,549
10855,8409,1097,4091,746,7312,1082,533,549
10860,8417,1099,4094,747,7317,1084,533,551
10865,8420,1101,4097,749,7319,1084,533,551
10870,8425,1102,4100,749,7323,1084,533,551
10875,8429,1102,4102,749,7326,1084,533,551
10880,8432,1103,4105,750,7329,1084,533,551
10885,8433,1103,4105,750,7330,1084,533,551
10890,8438,1104,4107,751,7334,1085,534,551
10895,8440,1104,4107,751,7336,1086,534,552
10900,8448,1105,4112,752,7343,1086,534,552
10905,8451,1105,4113,752,7346,1086,534,552
10910,8456,1106,4117,753,7350,1086,534,552
10915,8460,1106,4118,753,7353,1086,534,552
10920,8463,1107,4119,754,7356,1086,534,552
10925,8464,1107,4119,754,7357,1086,534,552
10930,8469,1108,4119,754,7361,1087,534,553
10935,8471,1108,4120,754,7363,1088,534,554
10940,8479,1109,4124,755,7370,1088,534,554
10945,8482,1110,4127,756,7372,1088,534,554
10950,8487,1111,4130,757,7376,1088,534,554
10955,8491,1111,4133,757,7379,1088,534,554
10960,8494,1112,4134,758,7382,1088,534,554
10965,8495,1112,4135,758,7383,1088,534,554
10970,8500,1113,4138,758,7387,1089,535,554
10975,8502,1113,4139,758,7389,1090,536,554
10980,8510,1115,4143,760,7395,1091,537,554
10985,8513,1115,4146,760,7398,1091,537,554
10990,8518,1115,4147,760,7403,1092,537,555
10995,8522,1115,4149,760,7407,1093,538,555
11000,8525,1115,4150,760,7410,1093,538,555
11005,8526,1115,4151,760,7411,1093,538,555
11010,8531,1116,4153,761,7415,1093,538,555
11015,8533,1116,4154,761,7417,1094,538,556
11020,8541,1116,4159,761,7425,1095,539,556
11025,8544,1116,4160,761,7428,1095,539,556
11030,8549,1116,4161,761,7433,1096,539,557
11035,8553,1116,4163,761,7437,1097,539,558
11040,8556,1116,4166,761,7440,1097,539,558
11045,8557,1116,4167,761,7441,1097,539,558
11050,8562,1117,4170,762,7445,1097,539,558
11055,8564,1117,4171,762,7447,1098,540,558
11060,8572,1117,4175,762,7455,1099,541,558
11065,8575,1117,4176,762,7458,1099,541,558
11070,8580,1117,4179,762,7463,1100,541,559
11075,8584,1117,4181,762,7467,1101,541,560
11080,8587,1117,4183,762,7470,1101,541,560
11085,8588,1117,4183,762,7471,1101,541,560
11090,8593,1119,4187,764,7474,1101,541,560
11095,8595,1119,4188,764,7476,1102,542,560
11100,8603,1121,4194,766,7481,1104,544,560
11105,8606,1122,4196,767,7484,1104,544,560
11110,8611,1123,4198,768,7488,1104,544,560
11115,8615,1123,4200,768,7492,1104,544,560
11120,8618,1123,4201,768,7495,1104,544,560
11125,8619,1123,4202,768,7496,1104,544,560
11130,8624,1123,4204,768,7501,1104,544,560
11135,8626,1123,4205,768,7503,1105,545,560
11140,8634,1124,4212,769,7510,1105,545,560
11145,8637,1125,4214,770,7512,1105,545,560
11150,8642,1126,4216,771,7516,1105,545,560
11155,8646,1126,4217,771,7520,1105,545,560
11160,8649,1126,4219,771,7523,1105,545,560
11165,8650,1126,4219,771,7524,1105,545,560
11170,8655,1126,4221,771,7529,1105,545,560
11175,8657,1126,4222,771,7531,1106,545,561
11180,8665,1127,4226,772,7538,1106,545,561
11185,8668,1127,4227,772,7541,1106,545,561
11190,8673,1128,4231,773,7545,1106,545,561
11195,8677,1128,4233,773,7549,1106,545,561
11200,8680,1128,4235,773,7552,1106,545,561
11205,8681,1128,4235,773,7553,1106,545,561
11210,8686,1129,4236,773,7557,1106,545,561
11215,8688,1129,4238,773,7559,1107,546,561
11220,8696,1132,4242,776,7564,1108,546,562
11225,8699,1132,4244,776,7567,1108,546,562
11230,8704,1133,4247,776,7571,1109,546,563
11235,8708,1133,4249,776,7575,1110,547,563
11240,8711,1133,4250,776,7578,1110,547,563
11245,8712,1133,4250,776,7579,1110,547,563
11250,8717,1134,4250,776,7583,1110,547,563
11255,8719,1134,4251,776,7585,1111,547,564
11260,8727,1134,4252,776,7593,1112,548,564
11265,8730,1134,4253,776,7596,1112,548,564
11270,8735,1135,4256,777,7600,1113,549,564
11275,8739,1135,4257,777,7604,1114,549,565
11280,8742,1135,4258,777,7607,1114,549,565
11285,8743,1135,4258,777,7608,1114,549,565
11290,8748,1136,4260,778,7612,1114,549,565
11295,8750,1136,4261,778,7614,1115,549,566
11300,8758,1136,4266,778,7622,1116,550,566
11305,8761,1136,4267,778,7625,1116,550,566
11310,8766,1137,4269,778,7629,1117,551,566
11315,8770,1137,4270,778,7633,1118,551,567
11320,8773,1138,4273,779,7635,1118,551,567
11325,8774,1138,4273,779,7636,1118,551,567
11330,8779,1140,4278,781,7639,1118,551,567
11335,8781,1140,4280,781,7641,1119,552,567
11340,8789,1141,4282,781,7648,1121,554,567
11345,8792,1142,4283,782,7650,1121,554,567
11350,8797,1143,4286,783,7654,1121,554,567
11355,8801,1143,4288,783,7658,1122,555,567
11360,8804,1143,4288,783,7661,1122,555,567
11365,8805,1143,4289,783,7662,1122,555,567
11370,8810,1144,4292,783,7666,1122,555,567
11375,8812,1144,4294,783,7668,1123,556,567
11380,8820,1145,4298,783,7675,1123,556,567
11385,8823,1145,4299,783,7678,1123,556,567
11390,8828,1146,4302,784,7682,1123,556,567
11395,8832,1146,4304,784,7686,1124,556,568
11400,8835,1146,4305,784,7689,1124,556,568
11405,8836,1146,4305,784,7690,1124,556,568
11410,8841,1147,4305,784,7694,1124,556,568
11415,8843,1147,4306,784,7696,1125,556,569
11420,8851,1148,4311,785,7703,1125,556,569
11425,8854,1148,4312,785,7706,1125,556,569
11430,8859,1149,4313,785,7710,1125,556,569
11435,8863,1149,4313,785,7714,1126,556,570
11440,8866,1149,4314,785,7717,1126,556,570
11445,8867,1149,4314,785,7718,1126,556,570
11450,8872,1151,4316,786,7721,1126,556,570
11455,8874,1151,4317,786,7723,1127,556,571
11460,8882,1153,4322,788,7729,1129,558,571
11465,8885,1153,4323,788,7732,1129,558,571
11470,8890,1154,4326,788,7736,1130,558,572
11475,8894,1154,4326,788,7740,1130,558,572
11480,8897,1154,4327,788,7743,1130,558,572
11485,8898,1154,4328,788,7744,1130,558,572
11490,8903,1155,4331,788,7748,1130,558,572
11495,8905,1155,4331,788,7750,1131,558,573
11500,8913,1156,4335,789,7757,1131,558,573
11505,8916,1157,4338,790,7759,1131,558,573
11510,8921,1158,4342,791,7763,1132,559,573
11515,8925,1158,4344,791,7767,1132,559,573
11520,8928,1158,4346,791,7770,1132,559,573
11525,8929,1158,4347,791,7771,1132,559,573
11530,8934,1159,4350,792,7775,1132,559,573
11535,8936,1159,4351,792,7777,1133,559,574
11540,8944,1160,4353,792,7784,1133,559,574
11545,8947,1160,4353,792,7787,1133,559,574
11550,8952,1161,4356,792,7791,1134,559,575
11555,8956,1161,4359,792,7795,1134,559,575
11560,8959,1161,4360,792,7798,1134,559,575
11565,8960,1161,4360,792,7799,1134,559,575
11570,8965,1162,4361,792,7803,1135,559,576
11575,8967,1162,4362,792,7805,1136,560,576
11580,8975,1164,4365,793,7811,1138,560,578
11585,8978,1164,4365,793,7814,1138,560,578
11590,8983,1165,4367,794,7818,1138,560,578
11595,8987,1165,4368,794,7822,1139,561,578
11600,8990,1165,4369,794,7825,1139,561,578
11605,8991,1165,4369,794,7826,1139,561,578
11610,8996,1166,4371,794,7830,1139,561,578
11615,8998,1166,4372,794,7832,1140,561,579
11620,9006,1166,4377,794,7840,1140,561,579
11625,9009,1166,4378,794,7843,1140,561,579
11630,9014,1167,4379,794,7847,1140,561,579
11635,9018,1167,4381,794,7851,1141,561,580
11640,9021,1167,4384,794,7854,1141,561,580
11645,9022,1167,4385,794,7855,1141,561,580
11650,9027,1168,4388,794,7859,1141,561,580
11655,9029,1168,4388,794,7861,1142,561,581
11660,9037,1168,4391,794,7869,1142,561,581
11665,9040,1168,4394,794,7872,1142,561,581
11670,9045,1169,4397,794,7876,1142,561,581
11675,9049,1169,4399,794,7880,1143,562,581
11680,9052,1169,4401,794,7883,1143,562,581
11685,9053,1169,4402,794,7884,1143,562,581
11690,9058,1170,4405,795,7888,1143,562,581
11695,9060,1170,4406,795,7890,1144,563,581
11700,9068,1172,4410,797,7895,1146,564,582
11705,9071,1173,4412,798,7898,1146,564,582
11710,9076,1174,4415,798,7902,1147,564,583
11715,9080,1174,4418,798,7905,1148,565,583
11720,9083,1176,4421,800,7907,1148,565,583
11725,9084,1176,4422,800,7908,1148,565,583
11730,9089,1177,4427,801,7912,1148,565,583
11735,9091,1177,4427,801,7914,1149,565,584
11740,9099,1178,4430,801,7920,1150,565,585
11745,9102,1180,4432,803,7922,1151,566,585
11750,9107,1181,4435,803,7926,1152,567,585
11755,9111,1181,4437,803,7929,1153,567,586
11760,9114,1183,4439,805,7931,1153,567,586
11765,9115,1183,4440,805,7932,1153,567,586
11770,9120,1184,4443,805,7936,1153,567,586
11775,9122,1184,4445,805,7938,1154,568,586
11780,9130,1185,4450,806,7945,1154,568,586
11785,9133,1186,4453,807,7947,1155,569,586
11790,9138,1187,4453,807,7951,1155,569,586
11795,9142,1187,4455,807,7955,1156,570,586
11800,9145,1187,4456,807,7958,1156,570,586
11805,9146,1187,4456,807,7959,1156,570,586
11810,9151,1188,4457,808,7963,1157,570,587
11815,9153,1188,4458,808,7965,1158,571,587
11820,9161,1190,4463,810,7970,1159,572,587
11825,9164,1191,4464,811,7973,1159,572,587
11830,9169,1192,4465,811,7977,1159,572,587
11835,9173,1192,4467,811,7981,1160,572,588
11840,9176,1192,4469,811,7984,1160,572,588
11845,9177,1192,4470,811,7985,1160,572,588
11850,9182,1193,4473,811,7989,1160,572,588
11855,9184,1193,4474,811,7991,1161,572,589
11860,9192,1194,4477,812,7998,1161,572,589
11865,9195,1194,4479,812,8001,1161,572,589
11870,9200,1195,4481,813,8005,1161,572,589
11875,9204,1195,4481,813,8009,1162,572,590
11880,9207,1196,4484,814,8011,1162,572,590
11885,9208,1196,4484,814,8012,1162,572,590
11890,9213,1197,4488,815,8016,1162,572,590
11895,9215,1197,4489,815,8018,1163,572,591
11900,9223,1199,4491,816,8023,1163,572,591
11905,9226,1201,4494,818,8025,1164,573,591
11910,9231,1202,4497,819,8029,1164,573,591
11915,9235,1202,4498,819,8033,1164,573,591
11920,9238,1202,4501,819,8036,1164,573,591
11925,9239,1203,4502,820,8036,1164,573,591
11930,9244,1205,4505,822,8039,1164,573,591
11935,9246,1205,4506,822,8041,1165,573,592
11940,9254,1207,4511,823,8046,1167,574,593
11945,9257,1208,4513,824,8049,1167,574,593
11950,9262,1209,4515,825,8053,1167,574,593
11955,9266,1209,4516,825,8057,1167,574,593
11960,9269,1209,4518,825,8060,1167,574,593
11965,9270,1209,4518,825,8061,1167,574,593
11970,9275,1210,4520,825,8065,1168,575,593
11975,9277,1210,4522,825,8067,1169,576,593
11980,9285,1210,4525,825,8075,1169,576,593
11985,9288,1210,4525,825,8078,1169,576,593
11990,9293,1211,4525,825,8082,1169,576,593
11995,9297,1211,4527,825,8086,1169,576,593
12000,9300,1211,4529,825,8089,1169,576,593
12005,9301,1211,4530,825,8090,1169,576,593
12010,9306,1212,4532,826,8094,1170,576,594
12015,9308,1212,4532,826,8096,1171,576,595
12020,9316,1212,4537,826,8104,1171,576,595
12025,9319,1212,4537,826,8107,1171,576,595
12030,9324,1213,4541,827,8111,1171,576,595
12035,9328,1213,4542,827,8115,1171,576,595
12040,9331,1213,4543,827,8118,1171,576,595
12045,9332,1213,4543,827,8119,1171,576,595
12050,9337,1215,4545,829,8122,1171,576,595
12055,9339,1215,4545,829,8124,1172,576,596
12060,9347,1217,4550,831,8129,1174,577,597
12065,9350,1218,4551,832,8132,1174,577,597
12070,9355,1219,4553,832,8136,1175,577,598
12075,9359,1219,4555,832,8140,1176,577,599
12080,9362,1219,4556,832,8143,1176,577,599
12085,9363,1219,4557,832,8144,1176,577,599
12090,9368,1220,4559,832,8148,1176,577,599
12095,9370,1220,4559,832,8150,1177,577,600
12100,9378,1221,4562,833,8157,1178,577,601
12105,9381,1222,4564,834,8159,1178,577,601
12110,9386,1223,4568,835,8163,1179,578,601
12115,9390,1223,4569,835,8167,1180,578,602
12120,9393,1224,4570,836,8169,1180,578,602
12125,9394,1224,4570,836,8170,1180,578,602
12130,9399,1225,4574,837,8174,1181,579,602
12135,9401,1225,4574,837,8176,1182,579,603
12140,9409,1226,4578,837,8183,1183,580,603
12145,9412,1227,4580,838,8185,1183,580,603
12150,9417,1228,4581,838,8189,1184,581,603
12155,9421,1228,4582,838,8193,1185,581,604
12160,9424,1229,4585,839,8195,1185,581,604
12165,9425,1230,4586,840,8195,1185,581,604
12170,9430,1231,4588,841,8199,1186,581,605
12175,9432,1231,4588,841,8201,1187,581,606
12180,9440,1234,4595,844,8205,1189,583,606
12185,9443,1235,4597,845,8208,1189,583,606
12190,9448,1235,4600,845,8213,1189,583,606
12195,9452,1235,4604,845,8217,1189,583,606
12200,9455,1235,4605,845,8220,1189,583,606
12205,9456,1235,4605,845,8221,1189,583,606
12210,9461,1236,4609,845,8225,1189,583,606
12215,9463,1236,4611,845,8227,1190,584,606
12220,9471,1236,4615,845,8235,1190,584,606
12225,9474,1236,4616,845,8238,1190,584,606
12230,9479,1236,4621,845,8243,1190,584,606
12235,9483,1236,4622,845,8247,1190,584,606
12240,9486,1236,4623,845,8250,1190,584,606
12245,9487,1236,4624,845,8251,1190,584,606
12250,9492,1237,4628,846,8255,1190,584,606
12255,9494,1237,4629,846,8257,1191,585,606
12260,9502,1238,4634,847,8264,1191,585,606
12265,9505,1238,4635,847,8267,1191,585,606
12270,9510,1238,4637,847,8272,1191,585,606
12275,9514,1238,4639,847,8276,1191,585,606
12280,9517,1238,4641,847,8279,1191,585,606
12285,9518,1238,4642,847,8280,1191,585,606
12290,9523,1240,4646,849,8283,1192,585,607
12295,9525,1240,4647,849,8285,1193,586,607
12300,9533,1242,4652,851,8290,1195,587,608
12305,9536,1243,4653,852,8293,1196,588,608
12310,9541,1244,4654,852,8297,1197,589,608
12315,9545,1244,4656,852,8301,1198,590,608
12320,9548,1244,4657,852,8304,1198,590,608
12325,9549,1244,4658,852,8305,1198,590,608
12330,9554,1245,4660,852,8309,1198,590,608
12335,9556,1245,4661,852,8311,1199,590,609
12340,9564,1245,4666,852,8319,1200,591,609
12345,9567,1245,4667,852,8322,1201,591,610
12350,9572,1246,4669,852,8326,1202,591,611
12355,9576,1246,4670,852,8330,1203,592,611
12360,9579,1246,4672,852,8333,1203,592,611
12365,9580,1246,4672,852,8334,1203,592,611
12370,9585,1247,4676,852,8338,1203,592,611
12375,9587,1247,4678,852,8340,1204,593,611
12380,9595,1247,4684,852,8347,1205,594,611
12385,9598,1248,4685,853,8350,1206,594,612
12390,9603,1249,4690,854,8354,1206,594,612
12395,9607,1249,4691,854,8358,1207,594,613
12400,9610,1249,4694,854,8361,1207,594,613
12405,9611,1250,4695,855,8361,1207,594,613
12410,9616,1251,4697,856,8365,1208,594,614
12415,9618,1251,4698,856,8367,1209,594,615
12420,9626,1251,4702,856,8375,1210,595,615
12425,9629,1251,4704,856,8378,1210,595,615
12430,9634,1252,4708,857,8382,1210,595,615
12435,9638,1252,4710,857,8385,1210,595,615
12440,9641,1253,4710,858,8388,1210,595,615
12445,9642,1253,4711,858,8389,1210,595,615
12450,9647,1254,4714,858,8393,1210,595,615
12455,9649,1254,4714,858,8395,1211,595,616
12460,9657,1254,4721,858,8403,1211,595,616
12465,9660,1254,4723,858,8406,1211,595,616
12470,9665,1255,4726,858,8410,1212,596,616
12475,9669,1255,4728,858,8413,1213,596,617
12480,9672,1257,4730,860,8415,1213,596,617
12485,9673,1257,4730,860,8416,1213,596,617
12490,9678,1258,4732,860,8420,1213,596,617
12495,9680,1258,4733,860,8422,1214,596,618
12500,9688,1260,4736,861,8428,1215,596,619
12505,9691,1261,4737,862,8430,1215,596,619
12510,9696,1261,4740,862,8435,1216,596,620
12515,9700,1261,4742,862,8439,1217,597,620
12520,9703,1261,4743,862,8442,1217,597,620
12525,9704,1261,4744,862,8443,1217,597,620
12530,9709,1262,4745,862,8447,1217,597,620
12535,9711,1262,4746,862,8449,1218,597,621
12540,9719,1264,4751,864,8455,1220,598,622
12545,9722,1264,4752,864,8458,1220,598,622
12550,9727,1264,4754,864,8463,1220,598,622
12555,9731,1264,4756,864,8466,1221,599,622
12560,9734,1265,4759,865,8469,1221,599,622
12565,9735,1265,4759,865,8470,1221,599,622
12570,9740,1266,4762,866,8474,1221,599,622
12575,9742,1266,4762,866,8476,1222,599,623
12580,9750,1268,4769,868,8482,1222,599,623
12585,9753,1269,4771,869,8484,1222,599,623
12590,9758,1270,4772,869,8488,1222,599,623
12595,9762,1270,4774,869,8492,1223,600,623
12600,9765,1271,4776,870,8494,1223,600,623
12605,9766,1271,4777,870,8495,1223,600,623
12610,9771,1272,4779,870,8499,1223,600,623
12615,9773,1272,4780,870,8501,1224,600,624
12620,9781,1272,4783,870,8509,1224,600,624
12625,9784,1272,4784,870,8512,1224,600,624
12630,9789,1273,4787,870,8516,1224,600,624
12635,9793,1273,4789,870,8520,1224,600,624
12640,9796,1273,4790,870,8523,1224,600,624
12645,9797,1274,4791,871,8523,1224,600,624
12650,9802,1276,4793,872,8526,1225,600,625
12655,9804,1276,4793,872,8528,1226,600,626
12660,9812,1276,4795,872,8536,1228,601,627
12665,9815,1276,4796,872,8539,1229,601,628
12670,9820,1277,4796,872,8543,1229,601,628
12675,9824,1277,4798,872,8547,1230,602,628
12680,9827,1277,4799,872,8550,1230,602,628
12685,9828,1277,4800,872,8551,1230,602,628
12690,9833,1278,4804,872,8555,1230,602,628
12695,9835,1278,4805,872,8557,1231,603,628
12700,9843,1278,4809,872,8565,1231,603,628
12705,9846,1278,4810,872,8568,1232,603,629
12710,9851,1279,4811,872,8572,1232,603,629
12715,9855,1279,4814,872,8576,1234,605,629
12720,9858,1279,4816,872,8579,1234,605,629
12725,9859,1279,4817,872,8580,1234,605,629
12730,9864,1280,4819,873,8584,1234,605,629
12735,9866,1280,4821,873,8586,1235,606,629
12740,9874,1281,4825,873,8593,1235,606,629
12745,9877,1281,4827,873,8596,1235,606,629
12750,9882,1282,4830,874,8600,1235,606,629
12755,9886,1282,4833,874,8604,1236,607,629
12760,9889,1283,4834,875,8606,1236,607,629
12765,9890,1284,4835,876,8606,1236,607,629
12770,9895,1286,4837,877,8609,1237,607,630
12775,9897,1286,4838,877,8611,1238,608,630
12780,9905,1287,4843,878,8618,1240,609,631
12785,9908,1287,4845,878,8621,1241,610,631
12790,9913,1288,4848,879,8625,1242,610,632
12795,9917,1288,4850,879,8629,1242,610,632
12800,9920,1288,4852,879,8632,1242,610,632
12805,9921,1288,4852,879,8633,1242,610,632
12810,9926,1289,4854,879,8637,1242,610,632
12815,9928,1289,4855,879,8639,1243,610,633
12820,9936,1291,4859,881,8645,1243,610,633
12825,9939,1291,4861,881,8648,1244,611,633
12830,9944,1292,4862,881,8652,1245,612,633
12835,9948,1292,4863,881,8656,1245,612,633
12840,9951,1292,4865,881,8659,1245,612,633
12845,9952,1292,4865,881,8660,1245,612,633
12850,9957,1293,4867,882,8664,1245,612,633
12855,9959,1293,4868,882,8666,1246,613,633
12860,9967,1293,4871,882,8674,1246,613,633
12865,9970,1293,4872,882,8677,1246,613,633
12870,9975,1294,4873,882,8681,1247,613,634
12875,9979,1294,4874,882,8685,1247,613,634
12880,9982,1294,4876,882,8688,1247,613,634
12885,9983,1294,4876,882,8689,1247,613,634
12890,9988,1295,4878,882,8693,1248,614,634
12895,9990,1295,4878,882,8695,1249,614,635
12900,9998,1296,4879,883,8702,1251,614,637
12905,10001,1296,4880,883,8705,1251,614,637
12910,10006,1296,4882,883,8710,1251,614,637
12915,10010,1296,4884,883,8714,1251,614,637
12920,10013,1296,4885,883,8717,1251,614,637
12925,10014,1296,4886,883,8718,1251,614,637
12930,10019,1297,4889,884,8722,1251,614,637
12935,10021,1297,4891,884,8724,1252,615,637
12940,10029,1297,4896,884,8732,1252,615,637
12945,10032,1297,4898,884,8735,1252,615,637
12950,10037,1297,4900,884,8740,1252,615,637
12955,10041,1297,4901,884,8743,1252,615,637
12960,10044,1298,4901,885,8746,1252,615,637
12965,10045,1298,4901,885,8747,1252,615,637
12970,10050,1299,4904,885,8751,1252,615,637
12975,10052,1299,4906,885,8753,1253,616,637
12980,10060,1300,4909,885,8760,1253,616,637
12985,10063,1301,4911,886,8762,1253,616,637
12990,10068,1301,4915,886,8767,1253,616,637
12995,10072,1301,4916,886,8771,1253,616,637
13000,10075,1301,4916,886,8774,1253,616,637
13005,10076,1302,4917,887,8774,1253,616,637
13010,10081,1304,4920,888,8777,1253,616,637
13015,10083,1304,4922,888,8779,1254,617,637
13020,10091,1306,4926,889,8785,1256,618,638
13025,10094,1306,4926,889,8788,1256,618,638
13030,10099,1307,4927,889,8792,1256,618,638
13035,10103,1307,4928,889,8796,1256,618,638
13040,10106,1307,4929,889,8799,1256,618,638
13045,10107,1307,4929,889,8800,1256,618,638
13050,10112,1308,4932,890,8804,1256,618,638
13055,10114,1308,4934,890,8806,1257,619,638
13060,10122,1309,4940,890,8813,1257,619,638
13065,10125,1310,4942,891,8815,1257,619,638
13070,10130,1311,4946,892,8819,1257,619,638
13075,10134,1311,4948,892,8823,1257,619,638
13080,10137,1311,4951,892,8826,1257,619,638
13085,10138,1311,4951,892,8827,1257,619,638
13090,10143,1312,4952,892,8831,1257,619,638
13095,10145,1312,4953,892,8833,1258,619,639
13100,10153,1312,4957,892,8841,1259,620,639
13105,10156,1312,4959,892,8844,1259,620,639
13110,10161,1313,4960,892,8848,1259,620,639
13115,10165,1313,4962,892,8852,1260,621,639
13120,10168,1314,4964,893,8854,1260,621,639
13125,10169,1315,4965,894,8854,1260,621,639
13130,10174,1317,4969,896,8857,1261,622,639
13135,10176,1317,4970,896,8859,1262,623,639
13140,10184,1317,4971,896,8867,1264,623,641
13145,10187,1317,4973,896,8870,1264,623,641
13150,10192,1318,4976,896,8874,1265,624,641
13155,10196,1318,4978,896,8878,1266,624,642
13160,10199,1318,4979,896,8881,1266,624,642
13165,10200,1318,4979,896,8882,1266,624,642
13170,10205,1319,4981,896,8886,1267,624,643
13175,10207,1319,4981,896,8888,1268,624,644
13180,10215,1319,4985,896,8896,1268,624,644
13185,10218,1319,4986,896,8899,1268,624,644
13190,10223,1320,4989,897,8903,1269,625,644
13195,10227,1320,4990,897,8907,1271,626,645
13200,10230,1320,4992,897,8910,1271,626,645
13205,10231,1320,4992,897,8911,1271,626,645
13210,10236,1321,4994,897,8915,1271,626,645
13215,10238,1321,4995,897,8917,1272,627,645
13220,10246,1322,5001,898,8924,1272,627,645
13225,10249,1323,5003,899,8926,1273,628,645
13230,10254,1323,5005,899,8931,1273,628,645
13235,10258,1323,5006,899,8935,1273,628,645
13240,10261,1323,5007,899,8938,1273,628,645
13245,10262,1323,5007,899,8939,1273,628,645
13250,10267,1324,5008,899,8943,1273,628,645
13255,10269,1324,5010,899,8945,1274,629,645
13260,10277,1325,5013,899,8952,1276,629,647
13265,10280,1325,5013,899,8955,1277,629,648
13270,10285,1327,5015,900,8958,1277,629,648
13275,10289,1327,5018,900,8962,1278,630,648
13280,10292,1327,5019,900,8965,1278,630,648
13285,10293,1327,5020,900,8966,1278,630,648
13290,10298,1328,5021,900,8970,1279,630,649
13295,10300,1328,5022,900,8972,1280,631,649
13300,10308,1330,5026,902,8978,1280,631,649
13305,10311,1330,5027,902,8981,1281,631,650
13310,10316,1332,5032,904,8984,1281,631,650
13315,10320,1332,5035,904,8987,1283,632,651
13320,10323,1335,5038,907,8988,1283,632,651
13325,10324,1335,5039,907,8989,1283,632,651
13330,10329,1336,5041,907,8993,1283,632,651
13335,10331,1336,5043,907,8995,1284,633,651
13340,10339,1336,5045,907,9003,1284,633,651
13345,10342,1336,5047,907,9006,1284,633,651
13350,10347,1336,5051,907,9011,1284,633,651
13355,10351,1336,5053,907,9014,1285,633,652
13360,10354,1337,5054,908,9017,1285,633,652
13365,10355,1337,5054,908,9018,1285,633,652
13370,10360,1338,5056,908,9022,1285,633,652
13375,10362,1338,5057,908,9024,1286,634,652
13380,10370,1338,5060,908,9032,1288,635,653
13385,10373,1338,5062,908,9035,1288,635,653
13390,10378,1338,5067,908,9040,1289,636,653
13395,10382,1338,5070,908,9044,1289,636,653
13400,10385,1338,5073,908,9047,1289,636,653
13405,10386,1339,5074,909,9047,1289,636,653
13410,10391,1340,5078,910,9051,1290,637,653
13415,10393,1340,5079,910,9053,1291,638,653
13420,10401,1340,5085,910,9061,1293,640,653
13425,10404,1340,5085,910,9064,1293,640,653
13430,10409,1341,5089,911,9068,1294,641,653
13435,10413,1341,5091,911,9072,1294,641,653
13440,10416,1341,5092,911,9075,1294,641,653
13445,10417,1341,5093,911,9076,1294,641,653
13450,10422,1341,5096,911,9081,1295,642,653
13455,10424,1341,5098,911,9083,1296,643,653
13460,10432,1342,5102,912,9090,1297,644,653
13465,10435,1343,5103,913,9092,1297,644,653
13470,10440,1344,5105,913,9096,1297,644,653
13475,10444,1344,5105,913,9100,1297,644,653
13480,10447,1344,5106,913,9103,1297,644,653
13485,10448,1344,5107,913,9103,1297,644,653
13490,10453,1345,5108,914,9108,1298,644,654
13495,10455,1345,5109,914,9110,1299,644,655
13500,10463,1347,5113,915,9116,1300,645,655
13505,10466,1347,5114,915,9119,1300,645,655
13510,10471,1348,5115,915,9123,1300,645,655
13515,10475,1348,5118,915,9126,1301,646,655
13520,10478,1350,5120,917,9128,1301,646,655
13525,10479,1350,5121,917,9129,1301,646,655
13530,10484,1350,5121,917,9134,1301,646,655
13535,10486,1350,5123,917,9136,1302,647,655
13540,10494,1351,5126,917,9143,1302,647,655
13545,10497,1352,5127,918,9145,1302,647,655
13550,10502,1353,5129,918,9149,1303,648,655
13555,10506,1353,5131,918,9152,1304,648,656
13560,10509,1355,5134,920,9154,1304,648,656
13565,10510,1355,5135,920,9155,1304,648,656
13570,10515,1356,5137,920,9159,1304,648,656
13575,10517,1356,5137,920,9161,1305,648,657
13580,10525,1356,5140,920,9169,1306,649,657
13585,10528,1356,5143,920,9172,1307,650,657
13590,10533,1356,5145,920,9177,1307,650,657
13595,10537,1356,5148,920,9181,1308,651,657
13600,10540,1356,5150,920,9184,1308,651,657
13605,10541,1356,5151,920,9185,1308,651,657
13610,10546,1357,5155,921,9189,1309,651,658
13615,10548,1357,5156,921,9191,1310,651,659
13620,10556,1357,5161,921,9199,1310,651,659
13625,10559,1357,5164,921,9202,1311,652,659
13630,10564,1357,5166,921,9207,1311,652,659
13635,10568,1357,5168,921,9211,1312,652,660
13640,10571,1357,5168,921,9214,1312,652,660
13645,10572,1357,5168,921,9215,1312,652,660
13650,10577,1359,5172,922,9218,1313,653,660
13655,10579,1359,5173,922,9220,1314,653,661
13660,10587,1359,5176,922,9228,1315,654,661
13665,10590,1359,5176,922,9231,1316,654,662
13670,10595,1360,5177,923,9235,1316,654,662
13675,10599,1360,5177,923,9239,1318,654,664
13680,10602,1361,5179,924,9241,1318,654,664
13685,10603,1361,5180,924,9242,1318,654,664
13690,10608,1362,5182,925,9246,1318,654,664
13695,10610,1362,5184,925,9248,1319,655,664
13700,10618,1365,5188,928,9253,1321,655,666
13705,10621,1366,5191,929,9255,1321,655,666
13710,10626,1367,5194,930,9259,1322,656,666
13715,10630,1367,5197,930,9262,1322,656,666
13720,10633,1368,5200,931,9265,1322,656,666
13725,10634,1368,5200,931,9266,1322,656,666
13730,10639,1369,5202,931,9270,1322,656,666
13735,10641,1369,5202,931,9272,1323,656,667
13740,10649,1370,5204,932,9279,1325,657,668
13745,10652,1370,5205,932,9282,1325,657,668
13750,10657,1371,5206,933,9286,1325,657,668
13755,10661,1371,5208,933,9289,1325,657,668
13760,10664,1372,5210,934,9292,1325,657,668
13765,10665,1372,5210,934,9293,1325,657,668
13770,10670,1373,5213,935,9297,1325,657,668
13775,10672,1373,5215,935,9299,1326,658,668
13780,10680,1373,5218,935,9307,1326,658,668
13785,10683,1373,5219,935,9310,1326,658,668
13790,10688,1375,5222,937,9313,1326,658,668
13795,10692,1375,5223,937,9317,1328,659,669
13800,10695,1376,5224,938,9319,1328,659,669
13805,10696,1377,5225,939,9319,1328,659,669
13810,10701,1379,5228,941,9322,1328,659,669
13815,10703,1379,5230,941,9324,1329,660,669
13820,10711,1380,5234,942,9331,1330,661,669
13825,10714,1380,5234,942,9334,1331,661,670
13830,10719,1380,5236,942,9339,1331,661,670
13835,10723,1380,5238,942,9343,1331,661,670
13840,10726,1380,5241,942,9346,1331,661,670
13845,10727,1381,5242,943,9346,1331,661,670
13850,10732,1383,5245,945,9349,1332,662,670
13855,10734,1383,5246,945,9351,1333,662,671
13860,10742,1384,5250,946,9358,1334,662,672
13865,10745,1384,5252,946,9361,1335,663,672
13870,10750,1384,5253,946,9366,1335,663,672
13875,10754,1384,5254,946,9370,1335,663,672
13880,10757,1384,5256,946,9373,1335,663,672
13885,10758,1384,5256,946,9374,1335,663,672
13890,10763,1385,5259,947,9378,1335,663,672
13895,10765,1385,5260,947,9380,1336,663,673
13900,10773,1386,5264,948,9387,1336,663,673
13905,10776,1386,5265,948,9390,1337,664,673
13910,10781,1388,5267,950,9393,1338,664,674
13915,10785,1388,5271,950,9396,1340,666,674
13920,10788,1390,5273,952,9398,1340,666,674
13925,10789,1390,5274,952,9399,1340,666,674
13930,10794,1391,5276,952,9403,1340,666,674
13935,10796,1391,5278,952,9405,1341,667,674
13940,10804,1392,5282,952,9412,1341,667,674
13945,10807,1393,5284,953,9414,1341,667,674
13950,10812,1394,5287,954,9418,1342,667,675
13955,10816,1394,5290,954,9422,1343,668,675
13960,10819,1394,5291,954,9425,1343,668,675
13965,10820,1394,5292,954,9426,1343,668,675
13970,10825,1395,5294,955,9430,1344,668,676
13975,10827,1395,5295,955,9432,1345,668,677
13980,10835,1396,5300,955,9439,1345,668,677
13985,10838,1396,5301,955,9442,1345,668,677
13990,10843,1397,5303,955,9446,1346,668,678
13995,10847,1397,5303,955,9450,1347,668,679
14000,10850,1397,5303,955,9453,1347,668,679
14005,10851,1397,5303,955,9454,1347,668,679
14010,10856,1398,5304,956,9458,1347,668,679
14015,10858,1398,5305,956,9460,1348,669,679
14020,10866,1399,5311,956,9467,1349,669,680
14025,10869,1399,5312,956,9470,1349,669,680
14030,10874,1401,5315,957,9473,1350,670,680
14035,10878,1401,5317,957,9477,1352,672,680
14040,10881,1401,5318,957,9480,1352,672,680
14045,10882,1402,5319,958,9480,1352,672,680
14050,10887,1403,5322,959,9484,1352,672,680
14055,10889,1403,5323,959,9486,1353,672,681
14060,10897,1403,5328,959,9494,1354,673,681
14065,10900,1403,5331,959,9497,1355,674,681
14070,10905,1404,5334,959,9501,1355,674,681
14075,10909,1404,5336,959,9505,1355,674,681
14080,10912,1404,5336,959,9508,1355,674,681
14085,10913,1405,5337,960,9508,1355,674,681
14090,10918,1407,5340,961,9511,1356,675,681
14095,10920,1407,5341,961,9513,1357,675,682
14100,10928,1407,5346,961,9521,1358,676,682
14105,10931,1407,5347,961,9524,1359,677,682
14110,10936,1408,5351,962,9528,1359,677,682
14115,10940,1408,5352,962,9532,1359,677,682
14120,10943,1408,5354,962,9535,1359,677,682
14125,10944,1409,5355,963,9535,1359,677,682
14130,10949,1411,5359,964,9538,1359,677,682
14135,10951,1411,5361,964,9540,1360,678,682
14140,10959,1411,5367,964,9548,1361,679,682
14145,10962,1411,5368,964,9551,1362,679,683
14150,10967,1412,5369,965,9555,1363,679,684
14155,10971,1412,5372,965,9558,1365,681,684
14160,10974,1414,5373,967,9560,1365,681,684
14165,10975,1414,5374,967,9561,1365,681,684
14170,10980,1415,5377,968,9565,1366,682,684
14175,10982,1415,5378,968,9567,1367,683,684
14180,10990,1416,5381,968,9574,1368,683,685
14185,10993,1417,5384,969,9576,1368,683,685
14190,10998,1417,5387,969,9581,1369,684,685
14195,11002,1417,5390,969,9585,1370,685,685
14200,11005,1417,5393,969,9588,1370,685,685
14205,11006,1417,5393,969,9589,1370,685,685
14210,11011,1418,5396,970,9593,1371,686,685
14215,11013,1418,5397,970,9595,1372,687,685
14220,11021,1419,5401,971,9602,1373,688,685
14225,11024,1419,5402,971,9605,1373,688,685
14230,11029,1419,5405,971,9610,1373,688,685
14235,11033,1419,5409,971,9614,1374,689,685
14240,11036,1419,5409,971,9617,1374,689,685
14245,11037,1419,5410,971,9618,1374,689,685
14250,11042,1420,5410,971,9622,1375,689,686
14255,11044,1420,5411,971,9624,1376,690,686
14260,11052,1421,5415,972,9631,1376,690,686
14265,11055,1421,5416,972,9634,1376,690,686
14270,11060,1422,5419,972,9638,1376,690,686
14275,11064,1422,5421,972,9642,1378,691,687
14280,11067,1423,5422,973,9644,1378,691,687
14285,11068,1423,5422,973,9645,1378,691,687
14290,11073,1424,5425,973,9649,1379,692,687
14295,11075,1424,5426,973,9651,1380,692,688
14300,11083,1424,5429,973,9659,1380,692,688
14305,11086,1424,5431,973,9662,1380,692,688
14310,11091,1424,5432,973,9667,1380,692,688
14315,11095,1424,5434,973,9671,1381,693,688
14320,11098,1424,5437,973,9674,1381,693,688
14325,11099,1424,5438,973,9675,1381,693,688
14330,11104,1425,5440,974,9679,1382,693,689
14335,11106,1425,5440,974,9681,1383,693,690
14340,11114,1425,5444,974,9689,1383,693,690
14345,11117,1425,5446,974,9692,1383,693,690
14350,11122,1425,5449,974,9697,1383,693,690
14355,11126,1425,5450,974,9701,1383,693,690
14360,11129,1425,5453,974,9704,1383,693,690
14365,11130,1425,5454,974,9705,1383,693,690
14370,11135,1426,5456,974,9709,1383,693,690
14375,11137,1426,5456,974,9711,1384,693,691
14380,11145,1426,5461,974,9719,1384,693,691
14385,11148,1426,5462,974,9722,1384,693,691
14390,11153,1427,5466,974,9726,1384,693,691
14395,11157,1427,5466,974,9730,1386,693,693
14400,11160,1427,5468,974,9733,1386,693,693
14405,11161,1428,5469,975,9733,1386,693,693
14410,11166,1429,5471,976,9737,1386,693,693
14415,11168,1429,5472,976,9739,1387,693,694
14420,11176,1430,5474,977,9746,1388,693,695
14425,11179,1430,5475,977,9749,1389,694,695
14430,11184,1431,5477,977,9753,1389,694,695
14435,11188,1431,5479,977,9757,1390,695,695
14440,11191,1431,5480,977,9760,1390,695,695
14445,11192,1431,5481,977,9761,1390,695,695
14450,11197,1432,5485,977,9765,1390,695,695
14455,11199,1432,5486,977,9767,1391,695,696
14460,11207,1433,5489,977,9774,1393,695,698
14465,11210,1434,5492,978,9776,1394,696,698
14470,11215,1435,5494,979,9780,1395,696,699
14475,11219,1435,5497,979,9784,1396,697,699
14480,11222,1435,5499,979,9787,1396,697,699
14485,11223,1435,5499,979,9788,1396,697,699
14490,11228,1436,5503,980,9792,1396,697,699
14495,11230,1436,5503,980,9794,1397,697,700
14500,11238,1437,5509,980,9801,1398,698,700
14505,11241,1437,5511,980,9804,1399,699,700
14510,11246,1438,5513,980,9808,1400,700,700
14515,11250,1438,5515,980,9812,1402,702,700
14520,11253,1440,5518,982,9813,1402,702,700
14525,11254,1440,5519,982,9814,1402,702,700
14530,11259,1440,5523,982,9819,1402,702,700
14535,11261,1440,5524,982,9821,1403,702,701
14540,11269,1440,5529,982,9829,1403,702,701
14545,11272,1440,5530,982,9832,1403,702,701
14550,11277,1441,5532,983,9836,1403,702,701
14555,11281,1441,5533,983,9840,1405,703,702
14560,11284,1442,5536,984,9842,1405,703,702
14565,11285,1442,5537,984,9843,1405,703,702
14570,11290,1442,5538,984,9848,1406,704,702
14575,11292,1442,5539,984,9850,1407,705,702
14580,11300,1442,5542,984,9858,1407,705,702
14585,11303,1442,5543,984,9861,1407,705,702
14590,11308,1443,5544,984,9865,1407,705,702
14595,11312,1443,5547,984,9869,1408,706,702
14600,11315,1443,5550,984,9872,1408,706,702
14605,11316,1443,5551,984,9873,1408,706,702
14610,11321,1443,5553,984,9878,1408,706,702
14615,11323,1443,5553,984,9880,1409,706,703
14620,11331,1443,5557,984,9888,1409,706,703
14625,11334,1443,5559,984,9891,1409,706,703
14630,11339,1444,5561,984,9895,1410,707,703
14635,11343,1444,5563,984,9898,1412,708,704
14640,11346,1445,5563,985,9901,1412,708,704
14645,11347,1445,5563,985,9902,1412,708,704
14650,11352,1446,5565,985,9906,1412,708,704
14655,11354,1446,5566,985,9908,1413,708,705
14660,11362,1447,5567,985,9915,1415,708,707
14665,11365,1448,5569,986,9917,1415,708,707
14670,11370,1449,5571,987,9921,1416,708,708
14675,11374,1449,5573,987,9925,1417,709,708
14680,11377,1449,5574,987,9928,1417,709,708
14685,11378,1449,5574,987,9929,1417,709,708
14690,11383,1450,5576,988,9933,1418,710,708
14695,11385,1450,5577,988,9935,1419,710,709
14700,11393,1452,5581,989,9941,1421,711,710
14705,11396,1452,5583,989,9944,1421,711,710
14710,11401,1453,5584,990,9948,1421,711,710
14715,11405,1453,5585,990,9952,1421,711,710
14720,11408,1453,5587,990,9955,1421,711,710
14725,11409,1453,5588,990,9956,1421,711,710
14730,11414,1454,5590,990,9960,1422,712,710
14735,11416,1454,5591,990,9962,1423,712,711
14740,11424,1456,5593,992,9968,1423,712,711
14745,11427,1456,5594,992,9971,1423,712,711
14750,11432,1457,5596,992,9975,1423,712,711
14755,11436,1457,5597,992,9978,1425,712,713
14760,11439,1460,5599,995,9979,1425,712,713
14765,11440,1460,5600,995,9980,1425,712,713
14770,11445,1461,5604,996,9984,1425,712,713
14775,11447,1461,5605,996,9986,1426,713,713
14780,11455,1461,5607,996,9994,1426,713,713
14785,11458,1461,5608,996,9997,1427,713,714
14790,11463,1461,5611,996,10002,1427,713,714
14795,11467,1461,5614,996,10006,1429,715,714
14800,11470,1461,5616,996,10009,1429,715,714
14805,11471,1461,5616,996,10010,1429,715,714
14810,11476,1462,5619,997,10014,1429,715,714
14815,11478,1462,5620,997,10016,1430,716,714
14820,11486,1462,5623,997,10024,1430,716,714
14825,11489,1462,5626,997,10027,1431,717,714
14830,11494,1462,5629,997,10032,1431,717,714
14835,11498,1462,5629,997,10036,1432,717,715
14840,11501,1462,5631,997,10039,1432,717,715
14845,11502,1462,5631,997,10040,1432,717,715
14850,11507,1463,5633,998,10044,1432,717,715
14855,11509,1463,5635,998,10046,1433,718,715
14860,11517,1463,5636,998,10054,1433,718,715
14865,11520,1463,5637,998,10057,1434,719,715
14870,11525,1464,5639,998,10061,1435,720,715
14875,11529,1464,5641,998,10065,1436,721,715
14880,11532,1464,5641,998,10068,1436,721,715
14885,11533,1464,5641,998,10069,1436,721,715
14890,11538,1465,5643,998,10073,1436,721,715
14895,11540,1465,5644,998,10075,1437,722,715
14900,11548,1466,5644,998,10082,1438,722,716
14905,11551,1467,5645,999,10084,1438,722,716
14910,11556,1468,5649,1000,10088,1439,723,716
14915,11560,1468,5650,1000,10091,1440,723,717
14920,11563,1469,5652,1001,10094,1440,723,717
14925,11564,1469,5652,1001,10095,1440,723,717
14930,11569,1470,5653,1001,10099,1441,724,717
14935,11571,1470,5653,1001,10101,1442,724,718
14940,11579,1471,5656,1001,10108,1443,724,719
14945,11582,1471,5656,1001,10111,1443,724,719
14950,11587,1471,5658,1001,10116,1444,725,719
14955,11591,1471,5659,1001,10120,1444,725,719
14960,11594,1471,5661,1001,10123,1444,725,719
14965,11595,1471,5661,1001,10124,1444,725,719
14970,11600,1472,5663,1002,10128,1444,725,719
14975,11602,1472,5665,1002,10130,1445,726,719
14980,11610,1474,5668,1004,10136,1445,726,719
14985,11613,1475,5670,1005,10138,1445,726,719
14990,11618,1476,5673,1006,10142,1446,727,719
14995,11622,1476,5675,1006,10145,1448,727,721
15000,11625,1477,5675,1007,10148,1448,727,721
15005,11626,1477,5676,1007,10149,1448,727,721
15010,11631,1478,5678,1007,10153,1448,727,721
15015,11633,1478,5679,1007,10155,1449,727,722
15020,11641,1478,5683,1007,10163,1449,727,722
15025,11644,1478,5684,1007,10166,1450,727,723
15030,11649,1478,5687,1007,10171,1451,727,724
15035,11653,1478,5689,1007,10175,1452,727,725
15040,11656,1478,5691,1007,10178,1452,727,725
15045,11657,1478,5691,1007,10179,1452,727,725
15050,11662,1479,5691,1007,10183,1453,727,726
15055,11664,1479,5692,1007,10185,1454,727,727
15060,11672,1479,5697,1007,10193,1455,727,728
15065,11675,1479,5698,1007,10196,1456,727,729
15070,11680,1480,5700,1008,10200,1457,727,730
15075,11684,1480,5703,1008,10204,1459,729,730
15080,11687,1480,5704,1008,10207,1459,729,730
15085,11688,1480,5704,1008,10208,1459,729,730
15090,11693,1481,5705,1008,10212,1460,729,731
15095,11695,1481,5705,1008,10214,1461,729,732
15100,11703,1481,5707,1008,10222,1462,730,732
15105,11706,1481,5709,1008,10225,1463,731,732
15110,11711,1482,5713,1008,10228,1464,732,732
15115,11715,1483,5717,1009,10231,1466,734,732
15120,11718,1485,5718,1011,10233,1466,734,732
15125,11719,1485,5719,1011,10234,1466,734,732
15130,11724,1486,5720,1011,10238,1466,734,732
15135,11726,1486,5720,1011,10240,1467,734,733
15140,11734,1487,5725,1012,10247,1467,734,733
15145,11737,1488,5728,1013,10249,1467,734,733
15150,11742,1489,5731,1013,10253,1467,734,733
15155,11746,1489,5733,1013,10257,1468,734,734
15160,11749,1490,5735,1014,10259,1468,734,734
15165,11750,1490,5736,1014,10260,1468,734,734
15170,11755,1491,5739,1015,10264,1468,734,734
15175,11757,1491,5740,1015,10266,1469,735,734
15180,11765,1492,5744,1016,10273,1470,735,735
15185,11768,1492,5745,1016,10276,1470,735,735
15190,11773,1493,5747,1017,10280,1470,735,735
15195,11777,1493,5749,1017,10283,1470,735,735
15200,11780,1494,5750,1018,10286,1470,735,735
15205,11781,1494,5750,1018,10287,1470,735,735
15210,11786,1495,5753,1018,10291,1471,736,735
15215,11788,1495,5753,1018,10293,1472,736,736
15220,11796,1496,5756,1019,10300,1472,736,736
15225,11799,1497,5758,1020,10302,1472,736,736
15230,11804,1498,5759,1020,10306,1473,736,737
15235,11808,1498,5759,1020,10310,1474,736,738
15240,11811,1498,5760,1020,10313,1474,736,738
15245,11812,1498,5760,1020,10314,1474,736,738
15250,11817,1499,5762,1021,10318,1475,736,739
15255,11819,1499,5764,1021,10320,1476,737,739
15260,11827,1500,5768,1022,10327,1476,737,739
15265,11830,1501,5771,1023,10329,1477,738,739
15270,11835,1502,5775,1024,10333,1477,738,739
15275,11839,1502,5775,1024,10337,1478,738,740
15280,11842,1502,5777,1024,10340,1478,738,740
15285,11843,1502,5777,1024,10341,1478,738,740
15290,11848,1503,5779,1024,10345,1479,738,741
15295,11850,1503,5780,1024,10347,1480,738,742
15300,11858,1504,5783,1024,10354,1481,738,743
15305,11861,1505,5786,1025,10356,1482,739,743
15310,11866,1506,5790,1026,10360,1482,739,743
15315,11870,1506,5793,1026,10364,1483,740,743
15320,11873,1506,5793,1026,10367,1483,740,743
15325,11874,1506,5793,1026,10368,1483,740,743
15330,11879,1507,5797,1026,10372,1483,740,743
15335,11881,1507,5798,1026,10374,1484,741,743
15340,11889,1508,5803,1027,10381,1486,742,744
15345,11892,1508,5805,1027,10384,1487,743,744
15350,11897,1509,5808,1028,10388,1488,743,745
15355,11901,1509,5811,1028,10392,1489,744,745
15360,11904,1510,5813,1029,10394,1489,744,745
15365,11905,1510,5813,1029,10395,1489,744,745
15370,11910,1511,5815,1029,10399,1489,744,745
15375,11912,1511,5816,1029,10401,1490,744,746
15380,11920,1512,5823,1030,10408,1491,745,746
15385,11923,1512,5825,1030,10411,1491,745,746
15390,11928,1513,5827,1030,10415,1491,745,746
15395,11932,1513,5829,1030,10419,1492,745,747
15400,11935,1513,5830,1030,10422,1492,745,747
15405,11936,1514,5831,1031,10422,1492,745,747
15410,11941,1515,5832,1032,10426,1492,745,747
15415,11943,1515,5832,1032,10428,1493,745,748
15420,11951,1516,5837,1033,10435,1494,745,749
15425,11954,1516,5838,1033,10438,1494,745,749
15430,11959,1516,5841,1033,10443,1494,745,749
15435,11963,1516,5843,1033,10447,1494,745,749
15440,11966,1516,5845,1033,10450,1494,745,749
15445,11967,1516,5846,1033,10451,1494,745,749
15450,11972,1516,5846,1033,10456,1495,745,750
15455,11974,1516,5847,1033,10458,1496,745,751
15460,11982,1516,5851,1033,10466,1496,745,751
15465,11985,1516,5853,1033,10469,1496,745,751
15470,11990,1516,5856,1033,10474,1497,745,752
15475,11994,1516,5857,1033,10478,1497,745,752
15480,11997,1516,5857,1033,10481,1497,745,752
15485,11998,1516,5857,1033,10482,1497,745,752
15490,12003,1516,5860,1033,10487,1498,746,752
15495,12005,1516,5862,1033,10489,1499,747,752
15500,12013,1519,5866,1035,10494,1500,748,752
15505,12016,1519,5868,1035,10497,1500,748,752
15510,12021,1519,5870,1035,10502,1501,748,753
15515,12025,1519,5873,1035,10506,1501,748,753
15520,12028,1519,5875,1035,10509,1501,748,753
15525,12029,1520,5876,1036,10509,1501,748,753
15530,12034,1521,5878,1036,10513,1502,749,753
15535,12036,1521,5879,1036,10515,1503,750,753
15540,12044,1522,5883,1037,10522,1504,751,753
15545,12047,1523,5885,1038,10524,1504,751,753
15550,12052,1524,5885,1038,10528,1504,751,753
15555,12056,1524,5887,1038,10532,1504,751,753
15560,12059,1524,5890,1038,10535,1504,751,753
15565,12060,1524,5891,1038,10536,1504,751,753
15570,12065,1525,5894,1039,10540,1504,751,753
15575,12067,1525,5895,1039,10542,1505,752,753
15580,12075,1526,5899,1039,10549,1505,752,753
15585,12078,1526,5901,1039,10552,1505,752,753
15590,12083,1527,5904,1040,10556,1505,752,753
15595,12087,1527,5905,1040,10560,1505,752,753
15600,12090,1527,5908,1040,10563,1505,752,753
15605,12091,1527,5909,1040,10564,1505,752,753
15610,12096,1528,5914,1041,10568,1505,752,753
15615,12098,1528,5914,1041,10570,1506,752,754
15620,12106,1529,5917,1041,10576,1506,752,754
15625,12109,1531,5918,1043,10578,1507,752,755
15630,12114,1532,5919,1043,10582,1507,752,755
15635,12118,1532,5921,1043,10585,1508,752,756
15640,12121,1534,5924,1045,10587,1508,752,756
15645,12122,1534,5925,1045,10588,1508,752,756
15650,12127,1535,5929,1046,10592,1509,753,756
15655,12129,1535,5930,1046,10594,1510,753,757
15660,12137,1536,5936,1046,10600,1512,755,757
15665,12140,1537,5937,1047,10603,1513,756,757
15670,12145,1538,5939,1048,10607,1513,756,757
15675,12149,1538,5939,1048,10611,1514,756,758
15680,12152,1538,5941,1048,10614,1514,756,758
15685,12153,1538,5941,1048,10615,1514,756,758
15690,12158,1539,5944,1049,10619,1514,756,758
15695,12160,1539,5944,1049,10621,1515,756,759
15700,12168,1540,5949,1049,10628,1515,756,759
15705,12171,1541,5951,1050,10630,1516,756,760
15710,12176,1542,5953,1051,10634,1516,756,760
15715,12180,1542,5955,1051,10638,1517,756,761
15720,12183,1542,5956,1051,10641,1517,756,761
15725,12184,1542,5957,1051,10642,1517,756,761
15730,12189,1543,5959,1051,10646,1517,756,761
15735,12191,1543,5959,1051,10648,1518,756,762
15740,12199,1544,5960,1051,10655,1518,756,762
15745,12202,1544,5961,1051,10658,1519,757,762
15750,12207,1545,5966,1052,10662,1519,757,762
15755,12211,1545,5966,1052,10666,1520,757,763
15760,12214,1545,5967,1052,10669,1520,757,763
15765,12215,1545,5968,1052,10670,1520,757,763
15770,12220,1546,5972,1053,10674,1521,758,763
15775,12222,1546,5973,1053,10676,1522,758,764
15780,12230,1548,5978,1055,10682,1524,759,765
15785,12233,1548,5978,1055,10685,1524,759,765
15790,12238,1549,5981,1056,10689,1524,759,765
15795,12242,1549,5984,1056,10692,1525,760,765
15800,12245,1551,5986,1058,10694,1525,760,765
15805,12246,1551,5987,1058,10695,1525,760,765
15810,12251,1552,5987,1058,10699,1525,760,765
15815,12253,1552,5989,1058,10701,1526,761,765
15820,12261,1552,5992,1058,10709,1526,761,765
15825,12264,1552,5992,1058,10712,1526,761,765
15830,12269,1553,5992,1058,10716,1526,761,765
15835,12273,1553,5993,1058,10720,1527,761,766
15840,12276,1554,5995,1059,10722,1527,761,766
15845,12277,1554,5995,1059,10723,1527,761,766
15850,12282,1555,5996,1059,10727,1527,761,766
15855,12284,1555,5996,1059,10729,1528,761,767
15860,12292,1556,6001,1060,10736,1529,762,767
15865,12295,1556,6002,1060,10739,1529,762,767
15870,12300,1556,6003,1060,10744,1529,762,767
15875,12304,1556,6004,1060,10748,1530,762,768
15880,12307,1556,6005,1060,10751,1530,762,768
15885,12308,1556,6005,1060,10752,1530,762,768
15890,12313,1557,6006,1060,10756,1530,762,768
15895,12315,1557,6006,1060,10758,1531,762,769
15900,12323,1558,6010,1061,10765,1533,764,769
15905,12326,1558,6012,1061,10768,1534,765,769
15910,12331,1558,6015,1061,10773,1534,765,769
15915,12335,1558,6016,1061,10777,1535,765,770
15920,12338,1558,6018,1061,10780,1535,765,770
15925,12339,1558,6018,1061,10781,1535,765,770
15930,12344,1559,6020,1061,10785,1535,765,770
15935,12346,1559,6022,1061,10787,1536,766,770
15940,12354,1559,6024,1061,10795,1537,766,771
15945,12357,1559,6024,1061,10798,1538,766,772
15950,12362,1560,6025,1062,10802,1538,766,772
15955,12366,1560,6026,1062,10805,1539,766,773
15960,12369,1562,6028,1064,10807,1539,766,773
15965,12370,1562,6028,1064,10808,1539,766,773
15970,12375,1563,6031,1065,10812,1539,766,773
15975,12377,1563,6031,1065,10814,1540,766,774
15980,12385,1564,6032,1065,10821,1540,766,774
15985,12388,1564,6032,1065,10824,1540,766,774
15990,12393,1565,6033,1066,10828,1540,766,774
15995,12397,1565,6036,1066,10832,1540,766,774
16000,12400,1565,6036,1066,10835,1540,766,774
16005,12401,1565,6036,1066,10836,1540,766,774
16010,12406,1566,6038,1066,10840,1540,766,774
16015,12408,1566,6040,1066,10842,1541,767,774
16020,12416,1567,6042,1066,10849,1543,767,776
16025,12419,1568,6044,1067,10851,1544,768,776
16030,12424,1569,6045,1067,10855,1545,768,777
16035,12428,1569,6046,1067,10859,1546,768,778
16040,12431,1570,6048,1068,10861,1546,768,778
16045,12432,1570,6048,1068,10862,1546,768,778
16050,12437,1571,6050,1069,10866,1546,768,778
16055,12439,1571,6051,1069,10868,1547,769,778
16060,12447,1572,6054,1069,10875,1549,769,780
16065,12450,1572,6055,1069,10878,1550,769,781
16070,12455,1574,6060,1071,10881,1551,770,781
16075,12459,1574,6063,1071,10884,1553,771,782
16080,12462,1576,6065,1073,10886,1553,771,782
16085,12463,1576,6065,1073,10887,1553,771,782
16090,12468,1576,6065,1073,10892,1553,771,782
16095,12470,1576,6065,1073,10894,1554,771,783
16100,12478,1577,6066,1073,10901,1554,771,783
16105,12481,1578,6068,1074,10903,1554,771,783
16110,12486,1579,6072,1075,10907,1554,771,783
16115,12490,1579,6074,1075,10911,1554,771,783
16120,12493,1579,6076,1075,10914,1554,771,783
16125,12494,1579,6076,1075,10915,1554,771,783
16130,12499,1579,6078,1075,10920,1555,772,783
16135,12501,1579,6080,1075,10922,1556,773,783
16140,12509,1580,6083,1075,10929,1556,773,783
16145,12512,1580,6084,1075,10932,1556,773,783
16150,12517,1581,6084,1075,10936,1556,773,783
16155,12521,1581,6085,1075,10939,1556,773,783
16160,12524,1582,6088,1076,10942,1556,773,783
16165,12525,1582,6088,1076,10943,1556,773,783
16170,12530,1582,6091,1076,10948,1556,773,783
16175,12532,1582,6092,1076,10950,1557,774,783
16180,12540,1583,6096,1076,10957,1558,774,784
16185,12543,1583,6097,1076,10960,1558,774,784
16190,12548,1584,6101,1077,10964,1559,774,785
16195,12552,1584,6102,1077,10967,1560,774,786
16200,12555,1585,6102,1078,10970,1560,774,786
16205,12556,1585,6102,1078,10971,1560,774,786
16210,12561,1586,6104,1078,10975,1560,774,786
16215,12563,1586,6106,1078,10977,1561,775,786
16220,12571,1588,6109,1079,10983,1561,775,786
16225,12574,1588,6110,1079,10986,1561,775,786
16230,12579,1589,6113,1080,10990,1562,775,787
16235,12583,1589,6116,1080,10994,1562,775,787
16240,12586,1589,6117,1080,10997,1562,775,787
16245,12587,1589,6118,1080,10998,1562,775,787
16250,12592,1590,6119,1080,11002,1563,776,787
16255,12594,1590,6120,1080,11004,1564,776,788
16260,12602,1591,6125,1081,11010,1564,776,788
16265,12605,1593,6127,1083,11012,1564,776,788
16270,12610,1594,6130,1084,11016,1565,777,788
16275,12614,1594,6132,1084,11020,1566,777,789
16280,12617,1594,6134,1084,11023,1566,777,789
16285,12618,1594,6134,1084,11024,1566,777,789
16290,12623,1595,6136,1084,11028,1566,777,789
16295,12625,1595,6138,1084,11030,1567,778,789
16300,12633,1596,6143,1084,11037,1567,778,789
16305,12636,1597,6144,1085,11039,1567,778,789
16310,12641,1598,6147,1086,11043,1567,778,789
16315,12645,1598,6148,1086,11047,1569,779,790
16320,12648,1599,6149,1087,11049,1569,779,790
16325,12649,1599,6149,1087,11050,1569,779,790
16330,12654,1600,6152,1088,11054,1569,779,790
16335,12656,1600,6152,1088,11056,1570,779,791
16340,12664,1600,6155,1088,11064,1570,779,791
16345,12667,1600,6158,1088,11067,1570,779,791
16350,12672,1601,6159,1088,11071,1570,779,791
16355,12676,1601,6162,1088,11075,1571,779,792
16360,12679,1601,6163,1088,11078,1571,779,792
16365,12680,1601,6164,1088,11079,1571,779,792
16370,12685,1602,6167,1089,11083,1572,780,792
16375,12687,1602,6168,1089,11085,1573,781,792
16380,12695,1602,6171,1089,11093,1573,781,792
16385,12698,1602,6174,1089,11096,1573,781,792
16390,12703,1603,6175,1089,11100,1573,781,792
16395,12707,1603,6175,1089,11104,1574,781,793
16400,12710,1604,6177,1090,11106,1574,781,793
16405,12711,1604,6177,1090,11107,1574,781,793
16410,12716,1605,6179,1091,11111,1575,782,793
16415,12718,1605,6179,1091,11113,1576,782,794
16420,12726,1605,6181,1091,11121,1576,782,794
16425,12729,1605,6183,1091,11124,1576,782,794
16430,12734,1606,6186,1092,11128,1577,783,794
16435,12738,1606,6188,1092,11131,1579,784,795
16440,12741,1607,6188,1093,11134,1579,784,795
16445,12742,1608,6189,1094,11134,1579,784,795
16450,12747,1609,6189,1094,11138,1579,784,795
16455,12749,1609,6189,1094,11140,1580,784,796
16460,12757,1611,6190,1095,11146,1580,784,796
16465,12760,1611,6192,1095,11149,1580,784,796
16470,12765,1611,6195,1095,11154,1580,784,796
16475,12769,1611,6197,1095,11158,1580,784,796
16480,12772,1611,6198,1095,11161,1580,784,796
16485,12773,1611,6199,1095,11162,1580,784,796
16490,12778,1612,6200,1095,11166,1580,784,796
16495,12780,1612,6201,1095,11168,1581,784,797
16500,12788,1613,6206,1096,11175,1581,784,797
16505,12791,1613,6207,1096,11178,1581,784,797
16510,12796,1613,6210,1096,11183,1581,784,797
16515,12800,1613,6213,1096,11187,1581,784,797
16520,12803,1613,6214,1096,11190,1581,784,797
16525,12804,1613,6214,1096,11191,1581,784,797
16530,12809,1614,6216,1097,11195,1581,784,797
16535,12811,1614,6217,1097,11197,1582,784,798
16540,12819,1615,6220,1098,11204,1582,784,798
16545,12822,1616,6222,1099,11206,1582,784,798
16550,12827,1617,6226,1100,11210,1583,785,798
16555,12831,1617,6228,1100,11213,1585,786,799
16560,12834,1619,6230,1102,11215,1585,786,799
16565,12835,1619,6230,1102,11216,1585,786,799
16570,12840,1619,6232,1102,11221,1585,786,799
16575,12842,1619,6234,1102,11223,1586,787,799
16580,12850,1619,6239,1102,11231,1586,787,799
16585,12853,1619,6241,1102,11234,1587,787,800
16590,12858,1620,6243,1103,11238,1587,787,800
16595,12862,1620,6244,1103,11242,1587,787,800
16600,12865,1620,6247,1103,11245,1587,787,800
16605,12866,1620,6247,1103,11246,1587,787,800
16610,12871,1620,6251,1103,11251,1588,788,800
16615,12873,1620,6252,1103,11253,1589,788,801
16620,12881,1620,6256,1103,11261,1589,788,801
16625,12884,1620,6258,1103,11264,1590,789,801
16630,12889,1621,6260,1103,11268,1590,789,801
16635,12893,1621,6262,1103,11272,1590,789,801
16640,12896,1621,6263,1103,11275,1590,789,801
16645,12897,1621,6264,1103,11276,1590,789,801
16650,12902,1621,6266,1103,11281,1591,790,801
16655,12904,1621,6267,1103,11283,1592,791,801
16660,12912,1621,6271,1103,11291,1592,791,801
16665,12915,1621,6272,1103,11294,1593,791,802
16670,12920,1622,6273,1103,11298,1594,792,802
16675,12924,1622,6275,1103,11301,1596,793,803
16680,12927,1623,6275,1104,11304,1596,793,803
16685,12928,1623,6275,1104,11305,1596,793,803
16690,12933,1623,6278,1104,11310,1596,793,803
16695,12935,1623,6280,1104,11312,1597,794,803
16700,12943,1624,6283,1104,11319,1597,794,803
16705,12946,1625,6285,1105,11321,1597,794,803
16710,12951,1626,6287,1105,11325,1597,794,803
16715,12955,1626,6290,1105,11329,1598,795,803
16720,12958,1627,6292,1106,11331,1598,795,803
16725,12959,1627,6292,1106,11332,1598,795,803
16730,12964,1627,6294,1106,11337,1598,795,803
16735,12966,1627,6296,1106,11339,1599,796,803
16740,12974,1628,6301,1106,11346,1599,796,803
16745,12977,1629,6303,1107,11348,1599,796,803
16750,12982,1630,6307,1108,11352,1599,796,803
16755,12986,1630,6310,1108,11356,1599,796,803
16760,12989,1630,6311,1108,11359,1599,796,803
16765,12990,1630,6312,1108,11360,1599,796,803
16770,12995,1630,6315,1108,11365,1599,796,803
16775,12997,1630,6317,1108,11367,1600,797,803
16780,13005,1631,6321,1108,11374,1600,797,803
16785,13008,1632,6323,1109,11376,1600,797,803
16790,13013,1634,6325,1110,11379,1601,797,804
16795,13017,1634,6328,1110,11382,1603,799,804
16800,13020,1635,6328,1111,11385,1603,799,804
16805,13021,1635,6329,1111,11386,1603,799,804
16810,13026,1636,6332,1112,11390,1604,799,805
16815,13028,1636,6334,1112,11392,1605,800,805
16820,13036,1636,6339,1112,11400,1605,800,805
16825,13039,1636,6341,1112,11403,1605,800,805
16830,13044,1637,6344,1113,11407,1606,801,805
16835,13048,1637,6346,1113,11411,1607,802,805
16840,13051,1637,6348,1113,11414,1607,802,805
16845,13052,1637,6349,1113,11415,1607,802,805
16850,13057,1638,6352,1114,11419,1607,802,805
16855,13059,1638,6353,1114,11421,1608,803,805
16860,13067,1638,6358,1114,11429,1608,803,805
16865,13070,1638,6358,1114,11432,1608,803,805
16870,13075,1639,6361,1114,11436,1609,804,805
16875,13079,1639,6363,1114,11440,1610,805,805
16880,13082,1639,6364,1114,11443,1610,805,805
16885,13083,1639,6364,1114,11444,1610,805,805
16890,13088,1640,6366,1115,11448,1610,805,805
16895,13090,1640,6367,1115,11450,1611,805,806
16900,13098,1640,6368,1115,11458,1611,805,806
16905,13101,1640,6368,1115,11461,1611,805,806
16910,13106,1643,6371,1117,11463,1612,806,806
16915,13110,1643,6373,1117,11466,1614,806,808
16920,13113,1644,6373,1118,11469,1614,806,808
16925,13114,1644,6373,1118,11470,1614,806,808
16930,13119,1644,6376,1118,11475,1615,807,808
16935,13121,1644,6377,1118,11477,1616,808,808
16940,13129,1645,6382,1119,11484,1616,808,808
16945,13132,1646,6384,1120,11486,1617,809,808
16950,13137,1647,6386,1121,11490,1617,809,808
16955,13141,1647,6387,1121,11494,1617,809,808
16960,13144,1647,6387,1121,11497,1617,809,808
16965,13145,1647,6387,1121,11498,1617,809,808
16970,13150,1647,6389,1121,11503,1617,809,808
16975,13152,1647,6390,1121,11505,1618,810,808
16980,13160,1648,6394,1122,11512,1618,810,808
16985,13163,1649,6395,1123,11514,1619,810,809
16990,13168,1650,6398,1124,11518,1619,810,809
16995,13172,1650,6399,1124,11522,1619,810,809
17000,13175,1650,6402,1124,11525,1619,810,809
17005,13176,1650,6402,1124,11526,1619,810,809
17010,13181,1650,6405,1124,11531,1619,810,809
17015,13183,1650,6407,1124,11533,1620,811,809
17020,13191,1651,6410,1125,11540,1620,811,809
17025,13194,1652,6413,1126,11542,1621,812,809
17030,13199,1653,6414,1127,11546,1622,812,810
17035,13203,1653,6416,1127,11550,1624,813,811
17040,13206,1653,6417,1127,11553,1624,813,811
17045,13207,1653,6417,1127,11554,1624,813,811
17050,13212,1654,6420,1128,11558,1624,813,811
17055,13214,1654,6421,1128,11560,1625,814,811
17060,13222,1654,6423,1128,11568,1626,814,812
17065,13225,1654,6424,1128,11571,1626,814,812
17070,13230,1655,6427,1129,11575,1626,814,812
17075,13234,1655,6430,1129,11579,1626,814,812
17080,13237,1655,6432,1129,11582,1626,814,812
17085,13238,1655,6432,1129,11583,1626,814,812
17090,13243,1656,6433,1129,11587,1626,814,812
17095,13245,1656,6434,1129,11589,1627,815,812
17100,13253,1656,6440,1129,11597,1628,816,812
17105,13256,1656,6442,1129,11600,1628,816,812
17110,13261,1657,6443,1130,11604,1628,816,812
17115,13265,1657,6445,1130,11608,1628,816,812
17120,13268,1657,6445,1130,11611,1628,816,812
17125,13269,1657,6445,1130,11612,1628,816,812
17130,13274,1658,6446,1130,11616,1628,816,812
17135,13276,1658,6446,1130,11618,1629,816,813
17140,13284,1658,6449,1130,11626,1630,816,814
17145,13287,1658,6451,1130,11629,1630,816,814
17150,13292,1659,6453,1130,11633,1631,817,814
17155,13296,1659,6455,1130,11637,1633,818,815
17160,13299,1660,6457,1131,11639,1633,818,815
17165,13300,1660,6458,1131,11640,1633,818,815
17170,13305,1661,6462,1132,11644,1634,819,815
17175,13307,1661,6463,1132,11646,1635,819,816
17180,13315,1662,6465,1133,11653,1635,819,816
17185,13318,1663,6466,1134,11655,1636,819,817
17190,13323,1664,6468,1134,11659,1636,819,817
17195,13327,1664,6472,1134,11663,1636,819,817
17200,13330,1664,6474,1134,11666,1636,819,817
17205,13331,1664,6475,1134,11667,1636,819,817
17210,13336,1665,6479,1135,11671,1636,819,817
17215,13338,1665,6480,1135,11673,1637,819,818
17220,13346,1666,6486,1136,11680,1637,819,818
17225,13349,1667,6488,1137,11682,1638,819,819
17230,13354,1668,6490,1138,11686,1638,819,819
17235,13358,1668,6490,1138,11690,1638,819,819
17240,13361,1668,6491,1138,11693,1638,819,819
17245,13362,1668,6492,1138,11694,1638,819,819
17250,13367,1669,6495,1139,11698,1638,819,819
17255,13369,1669,6496,1139,11700,1639,819,820
17260,13377,1670,6501,1140,11707,1639,819,820
17265,13380,1670,6502,1140,11710,1640,819,821
17270,13385,1671,6503,1140,11714,1641,819,822
17275,13389,1671,6504,1140,11718,1642,820,822
17280,13392,1672,6507,1141,11720,1642,820,822
17285,13393,1672,6507,1141,11721,1642,820,822
17290,13398,1672,6511,1141,11726,1643,821,822
17295,13400,1672,6513,1141,11728,1644,822,822
17300,13408,1672,6517,1141,11736,1644,822,822
17305,13411,1672,6519,1141,11739,1644,822,822
17310,13416,1673,6523,1142,11743,1645,822,823
17315,13420,1673,6526,1142,11747,1645,822,823
17320,13423,1673,6528,1142,11750,1645,822,823
17325,13424,1673,6529,1142,11751,1645,822,823
17330,13429,1673,6530,1142,11756,1645,822,823
17335,13431,1673,6531,1142,11758,1646,823,823
17340,13439,1673,6536,1142,11766,1646,823,823
17345,13442,1673,6538,1142,11769,1646,823,823
17350,13447,1674,6538,1142,11773,1647,823,824
17355,13451,1674,6541,1142,11777,1647,823,824
17360,13454,1674,6541,1142,11780,1647,823,824
17365,13455,1674,6541,1142,11781,1647,823,824
17370,13460,1674,6544,1142,11786,1648,824,824
17375,13462,1674,6545,1142,11788,1649,825,824
17380,13470,1675,6550,1143,11795,1650,825,825
17385,13473,1675,6553,1143,11798,1650,825,825
17390,13478,1676,6555,1144,11802,1651,825,826
17395,13482,1676,6556,1144,11806,1653,825,828
17400,13485,1676,6556,1144,11809,1653,825,828
17405,13486,1676,6556,1144,11810,1653,825,828
17410,13491,1677,6558,1144,11814,1654,826,828
17415,13493,1677,6560,1144,11816,1655,827,828
17420,13501,1678,6563,1144,11823,1655,827,828
17425,13504,1679,6566,1145,11825,1655,827,828
17430,13509,1680,6568,1145,11829,1655,827,828
17435,13513,1680,6570,1145,11833,1655,827,828
17440,13516,1680,6572,1145,11836,1655,827,828
17445,13517,1680,6573,1145,11837,1655,827,828
17450,13522,1681,6575,1145,11841,1656,828,828
17455,13524,1681,6577,1145,11843,1657,829,828
17460,13532,1682,6582,1145,11850,1657,829,828
17465,13535,1683,6585,1146,11852,1657,829,828
17470,13540,1684,6589,1146,11856,1657,829,828
17475,13544,1684,6590,1146,11860,1657,829,828
17480,13547,1684,6590,1146,11863,1657,829,828
17485,13548,1684,6591,1146,11864,1657,829,828
17490,13553,1685,6592,1147,11868,1657,829,828
17495,13555,1685,6594,1147,11870,1658,830,828
17500,13563,1686,6598,1147,11877,1658,830,828
17505,13566,1686,6600,1147,11880,1658,830,828
17510,13571,1688,6603,1148,11883,1659,831,828
17515,13575,1688,6605,1148,11887,1661,833,828
17520,13578,1689,6607,1149,11889,1661,833,828
17525,13579,1689,6608,1149,11890,1661,833,828
17530,13584,1689,6612,1149,11895,1661,833,828
17535,13586,1689,6613,1149,11897,1662,834,828
17540,13594,1690,6616,1150,11904,1663,835,828
17545,13597,1690,6618,1150,11907,1663,835,828
17550,13602,1691,6621,1150,11911,1663,835,828
17555,13606,1691,6622,1150,11915,1664,835,829
17560,13609,1692,6623,1151,11917,1664,835,829
17565,13610,1692,6623,1151,11918,1664,835,829
17570,13615,1692,6624,1151,11923,1665,835,830
17575,13617,1692,6626,1151,11925,1666,836,830
17580,13625,1693,6628,1151,11932,1667,836,831
17585,13628,1694,6631,1152,11934,1667,836,831
17590,13633,1695,6634,1152,11938,1668,837,831
17595,13637,1695,6634,1152,11942,1668,837,831
17600,13640,1695,6635,1152,11945,1668,837,831
17605,13641,1695,6635,1152,11946,1668,837,831
17610,13646,1695,6638,1152,11951,1669,838,831
17615,13648,1695,6639,1152,11953,1670,839,831
17620,13656,1697,6642,1153,11959,1670,839,831
17625,13659,1698,6643,1154,11961,1670,839,831
17630,13664,1699,6647,1154,11965,1671,840,831
17635,13668,1699,6647,1154,11969,1673,840,833
17640,13671,1700,6649,1155,11971,1673,840,833
17645,13672,1700,6650,1155,11972,1673,840,833
17650,13677,1701,6652,1155,11976,1674,841,833
17655,13679,1701,6653,1155,11978,1675,841,834
17660,13687,1701,6658,1155,11986,1675,841,834
17665,13690,1701,6659,1155,11989,1675,841,834
17670,13695,1702,6661,1155,11993,1675,841,834
17675,13699,1702,6664,1155,11997,1676,842,834
17680,13702,1702,6664,1155,12000,1676,842,834
17685,13703,1702,6665,1155,12001,1676,842,834
17690,13708,1703,6667,1156,12005,1676,842,834
17695,13710,1703,6667,1156,12007,1677,842,835
17700,13718,1703,6669,1156,12015,1677,842,835
17705,13721,1703,6671,1156,12018,1677,842,835
17710,13726,1704,6673,1156,12022,1677,842,835
17715,13730,1704,6673,1156,12026,1678,842,836
17720,13733,1704,6674,1156,12029,1678,842,836
17725,13734,1704,6674,1156,12030,1678,842,836
17730,13739,1705,6677,1157,12034,1678,842,836
17735,13741,1705,6677,1157,12036,1679,842,837
17740,13749,1705,6683,1157,12044,1679,842,837
17745,13752,1705,6683,1157,12047,1679,842,837
17750,13757,1706,6684,1157,12051,1679,842,837
17755,13761,1706,6685,1157,12054,1681,842,839
17760,13764,1708,6687,1159,12056,1681,842,839
17765,13765,1708,6687,1159,12057,1681,842,839
17770,13770,1709,6688,1159,12061,1681,842,839
17775,13772,1709,6688,1159,12063,1682,842,840
17780,13780,1711,6693,1160,12069,1683,842,841
17785,13783,1712,6695,1161,12071,1683,842,841
17790,13788,1713,6698,1162,12075,1684,843,841
17795,13792,1713,6700,1162,12079,1685,843,842
17800,13795,1714,6701,1163,12081,1685,843,842
17805,13796,1714,6701,1163,12082,1685,843,842
17810,13801,1715,6705,1164,12086,1685,843,842
17815,13803,1715,6707,1164,12088,1686,844,842
17820,13811,1716,6710,1165,12095,1687,844,843
17825,13814,1717,6713,1166,12097,1687,844,843
17830,13819,1718,6715,1167,12101,1688,844,844
17835,13823,1718,6718,1167,12105,1688,844,844
17840,13826,1718,6719,1167,12108,1688,844,844
17845,13827,1719,6720,1168,12108,1688,844,844
17850,13832,1720,6721,1169,12112,1688,844,844
17855,13834,1720,6722,1169,12114,1689,845,844
17860,13842,1721,6727,1170,12121,1690,846,844
17865,13845,1721,6728,1170,12124,1690,846,844
17870,13850,1722,6729,1170,12128,1691,847,844
17875,13854,1722,6730,1170,12132,1693,847,846
17880,13857,1723,6732,1171,12134,1693,847,846
17885,13858,1723,6732,1171,12135,1693,847,846
17890,13863,1724,6733,1171,12139,1694,847,847
17895,13865,1724,6734,1171,12141,1695,848,847
17900,13873,1725,6736,1171,12148,1695,848,847
17905,13876,1725,6737,1171,12151,1696,849,847
17910,13881,1725,6739,1171,12156,1696,849,847
17915,13885,1725,6741,1171,12160,1696,849,847
17920,13888,1725,6741,1171,12163,1696,849,847
17925,13889,1725,6741,1171,12164,1696,849,847
17930,13894,1726,6743,1171,12168,1696,849,847
17935,13896,1726,6744,1171,12170,1697,849,848
17940,13904,1727,6746,1171,12177,1697,849,848
17945,13907,1728,6747,1172,12179,1698,849,849
17950,13912,1728,6751,1172,12184,1698,849,849
17955,13916,1728,6753,1172,12188,1698,849,849
17960,13919,1728,6753,1172,12191,1698,849,849
17965,13920,1728,6754,1172,12192,1698,849,849
17970,13925,1729,6754,1172,12196,1698,849,849
17975,13927,1729,6755,1172,12198,1699,849,850
17980,13935,1730,6758,1173,12205,1699,849,850
17985,13938,1731,6759,1174,12207,1700,849,851
17990,13943,1732,6762,1175,12211,1701,850,851
17995,13947,1732,6765,1175,12214,1703,852,851
18000,13950,1734,6766,1177,12216,1703,852,851
18005,13951,1734,6767,1177,12217,1703,852,851
18010,13956,1734,6769,1177,12222,1704,853,851
18015,13958,1734,6770,1177,12224,1705,853,852
18020,13966,1734,6772,1177,12232,1705,853,852
18025,13969,1734,6773,1177,12235,1705,853,852
18030,13974,1735,6774,1177,12239,1705,853,852
18035,13978,1735,6777,1177,12243,1706,854,852
18040,13981,1735,6778,1177,12246,1706,854,852
18045,13982,1735,6778,1177,12247,1706,854,852
18050,13987,1735,6782,1177,12252,1707,855,852
18055,13989,1735,6783,1177,12254,1708,856,852
18060,13997,1735,6787,1177,12262,1708,856,852
18065,14000,1735,6787,1177,12265,1708,856,852
18070,14005,1736,6789,1177,12269,1708,856,852
18075,14009,1736,6790,1177,12273,1709,856,853
18080,14012,1736,6791,1177,12276,1709,856,853
18085,14013,1736,6791,1177,12277,1709,856,853
18090,14018,1736,6795,1177,12282,1710,857,853
18095,14020,1736,6796,1177,12284,1711,858,853
18100,14028,1736,6799,1177,12292,1711,858,853
18105,14031,1736,6799,1177,12295,1711,858,853
18110,14036,1737,6801,1178,12299,1712,858,854
18115,14040,1737,6802,1178,12302,1714,858,856
18120,14043,1738,6802,1179,12305,1714,858,856
18125,14044,1738,6802,1179,12306,1714,858,856
18130,14049,1738,6805,1179,12311,1714,858,856
18135,14051,1738,6806,1179,12313,1715,859,856
18140,14059,1739,6810,1180,12320,1715,859,856
18145,14062,1740,6812,1181,12322,1715,859,856
18150,14067,1741,6815,1182,12326,1716,860,856
18155,14071,1741,6818,1182,12330,1716,860,856
18160,14074,1741,6820,1182,12333,1716,860,856
18165,14075,1741,6820,1182,12334,1716,860,856
18170,14080,1741,6822,1182,12339,1716,860,856
18175,14082,1741,6823,1182,12341,1717,861,856
18180,14090,1742,6829,1182,12348,1717,861,856
18185,14093,1743,6832,1183,12350,1717,861,856
18190,14098,1744,6834,1183,12354,1718,862,856
18195,14102,1744,6834,1183,12358,1718,862,856
18200,14105,1744,6837,1183,12361,1718,862,856
18205,14106,1744,6838,1183,12362,1718,862,856
18210,14111,1744,6838,1183,12367,1718,862,856
18215,14113,1744,6838,1183,12369,1719,862,857
18220,14121,1745,6843,1183,12376,1720,863,857
18225,14124,1745,6843,1183,12379,1720,863,857
18230,14129,1747,6845,1185,12382,1721,863,858
18235,14133,1747,6847,1185,12386,1723,865,858
18240,14136,1748,6849,1186,12388,1723,865,858
18245,14137,1748,6850,1186,12389,1723,865,858
18250,14142,1749,6853,1187,12393,1724,865,859
18255,14144,1749,6853,1187,12395,1725,865,860
18260,14152,1750,6856,1188,12402,1725,865,860
18265,14155,1750,6856,1188,12405,1725,865,860
18270,14160,1751,6858,1189,12409,1725,865,860
18275,14164,1751,6860,1189,12413,1725,865,860
18280,14167,1751,6863,1189,12416,1725,865,860
18285,14168,1751,6863,1189,12417,1725,865,860
18290,14173,1752,6864,1189,12421,1726,865,861
18295,14175,1752,6864,1189,12423,1727,865,862
18300,14183,1753,6868,1190,12430,1727,865,862
18305,14186,1753,6868,1190,12433,1727,865,862
18310,14191,1754,6870,1190,12437,1727,865,862
18315,14195,1754,6872,1190,12441,1727,865,862
18320,14198,1754,6873,1190,12444,1727,865,862
18325,14199,1754,6873,1190,12445,1727,865,862
18330,14204,1755,6874,1190,12449,1727,865,862
18335,14206,1755,6876,1190,12451,1728,866,862
18340,14214,1756,6878,1191,12458,1728,866,862
18345,14217,1757,6880,1192,12460,1728,866,862
18350,14222,1758,6883,1193,12464,1729,867,862
18355,14226,1758,6886,1193,12468,1731,869,862
18360,14229,1758,6886,1193,12471,1731,869,862
18365,14230,1758,6886,1193,12472,1731,869,862
18370,14235,1758,6887,1193,12477,1731,869,862
18375,14237,1758,6889,1193,12479,1732,870,862
18380,14245,1758,6895,1193,12487,1733,871,862
18385,14248,1758,6897,1193,12490,1733,871,862
18390,14253,1759,6899,1194,12494,1734,871,863
18395,14257,1759,6901,1194,12498,1735,871,864
18400,14260,1759,6903,1194,12501,1735,871,864
18405,14261,1759,6904,1194,12502,1735,871,864
18410,14266,1759,6909,1194,12507,1736,872,864
18415,14268,1759,6911,1194,12509,1737,873,864
18420,14276,1759,6914,1194,12517,1737,873,864
18425,14279,1759,6916,1194,12520,1737,873,864
18430,14284,1760,6920,1194,12524,1738,874,864
18435,14288,1760,6922,1194,12528,1739,874,865
18440,14291,1760,6924,1194,12531,1739,874,865
18445,14292,1760,6924,1194,12532,1739,874,865
18450,14297,1760,6926,1194,12537,1739,874,865
18455,14299,1760,6927,1194,12539,1740,874,866
18460,14307,1760,6930,1194,12547,1740,874,866
18465,14310,1760,6931,1194,12550,1740,874,866
18470,14315,1761,6933,1194,12554,1741,874,867
18475,14319,1761,6935,1194,12557,1743,875,868
18480,14322,1764,6937,1197,12558,1743,875,868
18485,14323,1764,6938,1197,12559,1743,875,868
18490,14328,1764,6942,1197,12564,1743,875,868
18495,14330,1764,6944,1197,12566,1744,876,868
18500,14338,1766,6947,1198,12572,1745,877,868
18505,14341,1767,6948,1199,12574,1745,877,868
18510,14346,1767,6950,1199,12579,1745,877,868
18515,14350,1767,6953,1199,12583,1745,877,868
18520,14353,1767,6953,1199,12586,1745,877,868
18525,14354,1767,6953,1199,12587,1745,877,868
18530,14359,1767,6955,1199,12592,1746,877,869
18535,14361,1767,6955,1199,12594,1747,877,870
18540,14369,1769,6956,1200,12600,1748,877,871
18545,14372,1769,6958,1200,12603,1748,877,871
18550,14377,1769,6958,1200,12608,1748,877,871
18555,14381,1769,6962,1200,12612,1748,877,871
18560,14384,1769,6965,1200,12615,1748,877,871
18565,14385,1769,6966,1200,12616,1748,877,871
18570,14390,1769,6967,1200,12621,1749,878,871
18575,14392,1769,6967,1200,12623,1750,878,872
18580,14400,1769,6972,1200,12631,1750,878,872
18585,14403,1769,6974,1200,12634,1750,878,872
18590,14408,1770,6976,1200,12638,1750,878,872
18595,14412,1770,6976,1200,12642,1752,878,874
18600,14415,1771,6977,1201,12644,1752,878,874
18605,14416,1771,6978,1201,12645,1752,878,874
18610,14421,1772,6979,1201,12649,1752,878,874
18615,14423,1772,6980,1201,12651,1753,878,875
18620,14431,1773,6985,1202,12658,1753,878,875
18625,14434,1773,6986,1202,12661,1754,879,875
18630,14439,1774,6988,1202,12665,1754,879,875
18635,14443,1774,6991,1202,12669,1755,879,876
18640,14446,1775,6993,1203,12671,1755,879,876
18645,14447,1775,6994,1203,12672,1755,879,876
18650,14452,1776,6996,1204,12676,1755,879,876
18655,14454,1776,6998,1204,12678,1756,880,876
18660,14462,1777,7001,1205,12684,1757,880,877
18665,14465,1779,7003,1207,12686,1757,880,877
18670,14470,1780,7006,1208,12690,1757,880,877
18675,14474,1780,7009,1208,12694,1757,880,877
18680,14477,1780,7010,1208,12697,1757,880,877
18685,14478,1780,7011,1208,12698,1757,880,877
18690,14483,1781,7012,1208,12702,1757,880,877
18695,14485,1781,7013,1208,12704,1758,880,878
18700,14493,1782,7015,1208,12711,1759,880,879
18705,14496,1783,7016,1209,12713,1759,880,879
18710,14501,1784,7019,1210,12717,1759,880,879
18715,14505,1784,7020,1210,12721,1760,880,880
18720,14508,1784,7021,1210,12724,1760,880,880
18725,14509,1784,7021,1210,12725,1760,880,880
18730,14514,1785,7024,1210,12729,1761,881,880
18735,14516,1785,7024,1210,12731,1762,881,881
18740,14524,1786,7028,1211,12738,1762,881,881
18745,14527,1787,7029,1212,12740,1762,881,881
18750,14532,1788,7031,1212,12744,1762,881,881
18755,14536,1788,7033,1212,12748,1762,881,881
18760,14539,1788,7035,1212,12751,1762,881,881
18765,14540,1788,7035,1212,12752,1762,881,881
18770,14545,1789,7038,1212,12756,1763,881,882
18775,14547,1789,7039,1212,12758,1764,882,882
18780,14555,1791,7044,1214,12764,1765,883,882
18785,14558,1792,7046,1215,12766,1766,884,882
18790,14563,1793,7049,1216,12770,1767,885,882
18795,14567,1793,7050,1216,12773,1768,885,883
18800,14570,1794,7052,1217,12776,1768,885,883
18805,14571,1794,7052,1217,12777,1768,885,883
18810,14576,1795,7056,1217,12781,1768,885,883
18815,14578,1795,7057,1217,12783,1769,886,883
18820,14586,1797,7062,1219,12788,1769,886,883
18825,14589,1799,7065,1221,12790,1770,887,883
18830,14594,1800,7070,1222,12794,1771,888,883
18835,14598,1800,7070,1222,12798,1773,888,885
18840,14601,1801,7072,1223,12800,1773,888,885
18845,14602,1801,7073,1223,12801,1773,888,885
18850,14607,1802,7076,1223,12805,1774,889,885
18855,14609,1802,7076,1223,12807,1775,889,886
18860,14617,1804,7079,1224,12812,1775,889,886
18865,14620,1805,7079,1225,12815,1776,889,887
18870,14625,1805,7081,1225,12820,1776,889,887
18875,14629,1805,7082,1225,12824,1777,889,888
18880,14632,1805,7083,1225,12827,1777,889,888
18885,14633,1805,7084,1225,12828,1777,889,888
18890,14638,1806,7086,1225,12832,1778,889,889
18895,14640,1806,7087,1225,12834,1779,889,890
18900,14648,1807,7090,1225,12840,1780,889,891
18905,14651,1808,7091,1226,12843,1781,890,891
18910,14656,1808,7095,1226,12848,1781,890,891
18915,14660,1808,7096,1226,12852,1781,890,891
18920,14663,1808,7097,1226,12855,1781,890,891
18925,14664,1808,7097,1226,12856,1781,890,891
18930,14669,1809,7099,1227,12860,1781,890,891
18935,14671,1809,7101,1227,12862,1782,891,891
18940,14679,1810,7103,1227,12869,1782,891,891
18945,14682,1811,7105,1228,12871,1783,892,891
18950,14687,1812,7107,1229,12875,1783,892,891
18955,14691,1812,7109,1229,12879,1784,893,891
18960,14694,1812,7109,1229,12882,1784,893,891
18965,14695,1812,7110,1229,12883,1784,893,891
18970,14700,1813,7111,1229,12887,1784,893,891
18975,14702,1813,7113,1229,12889,1785,894,891
18980,14710,1815,7119,1230,12895,1785,894,891
18985,14713,1815,7120,1230,12898,1785,894,891
18990,14718,1816,7121,1230,12902,1785,894,891
18995,14722,1816,7122,1230,12905,1785,894,891
19000,14725,1817,7124,1231,12908,1785,894,891
19005,14726,1817,7124,1231,12909,1785,894,891
19010,14731,1818,7128,1232,12913,1786,894,892
19015,14733,1818,7129,1232,12915,1787,895,892
19020,14741,1819,7134,1233,12922,1788,895,893
19025,14744,1819,7134,1233,12925,1789,895,894
19030,14749,1820,7136,1233,12929,1790,895,895
19035,14753,1820,7138,1233,12933,1791,895,896
19040,14756,1821,7141,1234,12935,1791,895,896
19045,14757,1821,7141,1234,12936,1791,895,896
19050,14762,1822,7145,1235,12940,1792,896,896
19055,14764,1822,7146,1235,12942,1793,897,896
19060,14772,1823,7150,1235,12948,1793,897,896
19065,14775,1825,7153,1237,12950,1794,898,896
19070,14780,1826,7157,1238,12954,1795,899,896
19075,14784,1826,7159,1238,12958,1797,901,896
19080,14787,1828,7161,1240,12959,1797,901,896
19085,14788,1828,7162,1240,12960,1797,901,896
19090,14793,1829,7164,1240,12964,1797,901,896
19095,14795,1829,7166,1240,12966,1798,902,896
19100,14803,1829,7170,1240,12974,1798,902,896
19105,14806,1829,7172,1240,12977,1798,902,896
19110,14811,1829,7173,1240,12982,1799,903,896
19115,14815,1829,7176,1240,12986,1801,904,897
19120,14818,1829,7177,1240,12989,1801,904,897
19125,14819,1829,7177,1240,12990,1801,904,897
19130,14824,1830,7181,1240,12994,1801,904,897
19135,14826,1830,7182,1240,12996,1802,905,897
19140,14834,1830,7185,1240,13004,1803,905,898
19145,14837,1830,7186,1240,13007,1803,905,898
19150,14842,1830,7186,1240,13012,1803,905,898
19155,14846,1830,7187,1240,13016,1803,905,898
19160,14849,1830,7189,1240,13019,1803,905,898
19165,14850,1830,7189,1240,13020,1803,905,898
19170,14855,1831,7192,1241,13024,1803,905,898
19175,14857,1831,7194,1241,13026,1804,906,898
19180,14865,1831,7198,1241,13034,1804,906,898
19185,14868,1831,7200,1241,13037,1804,906,898
19190,14873,1832,7200,1241,13041,1804,906,898
19195,14877,1832,7201,1241,13045,1804,906,898
19200,14880,1832,7201,1241,13048,1804,906,898
19205,14881,1832,7201,1241,13049,1804,906,898
19210,14886,1833,7203,1242,13053,1804,906,898
19215,14888,1833,7205,1242,13055,1805,907,898
19220,14896,1834,7209,1243,13061,1805,907,898
19225,14899,1835,7211,1244,13064,1806,908,898
19230,14904,1836,7214,1245,13068,1806,908,898
19235,14908,1836,7216,1245,13071,1806,908,898
19240,14911,1837,7217,1246,13074,1806,908,898
19245,14912,1837,7217,1246,13075,1806,908,898
19250,14917,1838,7218,1246,13079,1807,909,898
19255,14919,1838,7219,1246,13081,1808,909,899
19260,14927,1839,7220,1247,13088,1809,909,900
19265,14930,1840,7222,1248,13090,1810,909,901
19270,14935,1841,7225,1248,13094,1811,909,902
19275,14939,1841,7227,1248,13098,1811,909,902
19280,14942,1841,7229,1248,13101,1811,909,902
19285,14943,1841,7230,1248,13102,1811,909,902
19290,14948,1842,7233,1248,13106,1812,909,903
19295,14950,1842,7233,1248,13108,1813,909,904
19300,14958,1843,7237,1249,13115,1813,909,904
19305,14961,1844,7239,1250,13117,1814,909,905
19310,14966,1845,7240,1250,13121,1815,909,906
19315,14970,1845,7242,1250,13125,1817,911,906
19320,14973,1845,7244,1250,13128,1817,911,906
19325,14974,1846,7245,1251,13128,1817,911,906
19330,14979,1846,7248,1251,13133,1817,911,906
19335,14981,1846,7250,1251,13135,1818,912,906
19340,14989,1847,7253,1251,13142,1818,912,906
19345,14992,1847,7254,1251,13145,1818,912,906
19350,14997,1848,7255,1252,13149,1819,912,907
19355,15001,1848,7256,1252,13153,1821,912,909
19360,15004,1848,7256,1252,13156,1821,912,909
19365,15005,1848,7257,1252,13157,1821,912,909
19370,15010,1848,7259,1252,13162,1821,912,909
19375,15012,1848,7260,1252,13164,1822,913,909
19380,15020,1849,7263,1253,13171,1823,914,909
19385,15023,1850,7265,1254,13173,1823,914,909
19390,15028,1851,7268,1254,13177,1824,915,909
19395,15032,1851,7270,1254,13181,1825,916,909
19400,15035,1851,7271,1254,13184,1825,916,909
19405,15036,1851,7272,1254,13185,1825,916,909
19410,15041,1851,7274,1254,13190,1825,916,909
19415,15043,1851,7274,1254,13192,1826,916,910
19420,15051,1853,7280,1256,13198,1827,917,910
19425,15054,1854,7283,1257,13200,1827,917,910
19430,15059,1855,7285,1258,13204,1828,917,911
19435,15063,1855,7286,1258,13207,1829,917,912
19440,15066,1857,7289,1260,13209,1829,917,912
19445,15067,1857,7290,1260,13210,1829,917,912
19450,15072,1858,7293,1260,13214,1830,917,913
19455,15074,1858,7295,1260,13216,1831,918,913
19460,15082,1858,7298,1260,13224,1831,918,913
19465,15085,1858,7299,1260,13227,1831,918,913
19470,15090,1858,7300,1260,13232,1831,918,913
19475,15094,1858,7303,1260,13235,1831,918,913
19480,15097,1859,7304,1261,13238,1831,918,913
19485,15098,1859,7304,1261,13239,1831,918,913
19490,15103,1860,7306,1262,13243,1831,918,913
19495,15105,1860,7307,1262,13245,1832,919,913
19500,15113,1860,7313,1262,13253,1832,919,913
19505,15116,1860,7314,1262,13256,1832,919,913
19510,15121,1860,7317,1262,13261,1832,919,913
19515,15125,1860,7319,1262,13264,1832,919,913
19520,15128,1861,7321,1263,13267,1832,919,913
19525,15129,1861,7322,1263,13268,1832,919,913
19530,15134,1862,7324,1264,13272,1832,919,913
19535,15136,1862,7324,1264,13274,1833,919,914
19540,15144,1862,7331,1264,13282,1833,919,914
19545,15147,1862,7333,1264,13285,1833,919,914
19550,15152,1865,7336,1267,13287,1834,919,915
19555,15156,1865,7338,1267,13291,1836,920,916
19560,15159,1866,7340,1268,13293,1836,920,916
19565,15160,1867,7341,1269,13293,1836,920,916
19570,15165,1867,7344,1269,13298,1837,920,917
19575,15167,1867,7346,1269,13300,1838,921,917
19580,15175,1868,7349,1270,13307,1838,921,917
19585,15178,1868,7349,1270,13310,1839,921,918
19590,15183,1869,7351,1270,13314,1839,921,918
19595,15187,1869,7353,1270,13318,1840,921,919
19600,15190,1869,7354,1270,13321,1840,921,919
19605,15191,1869,7355,1270,13322,1840,921,919
19610,15196,1869,7356,1270,13327,1841,921,920
19615,15198,1869,7356,1270,13329,1842,921,921
19620,15206,1870,7356,1270,13336,1842,921,921
19625,15209,1871,7358,1271,13338,1843,921,922
19630,15214,1872,7362,1272,13342,1843,921,922
19635,15218,1872,7365,1272,13346,1844,921,923
19640,15221,1873,7367,1273,13348,1844,921,923
19645,15222,1873,7368,1273,13349,1844,921,923
19650,15227,1873,7370,1273,13354,1844,921,923
19655,15229,1873,7372,1273,13356,1845,922,923
19660,15237,1874,7373,1273,13363,1845,922,923
19665,15240,1874,7373,1273,13366,1846,922,924
19670,15245,1875,7375,1273,13370,1847,923,924
19675,15249,1875,7378,1273,13373,1849,924,925
19680,15252,1878,7381,1276,13374,1849,924,925
19685,15253,1878,7382,1276,13375,1849,924,925
19690,15258,1878,7384,1276,13380,1849,924,925
19695,15260,1878,7384,1276,13382,1850,924,926
19700,15268,1878,7386,1276,13390,1850,924,926
19705,15271,1878,7387,1276,13393,1850,924,926
19710,15276,1879,7389,1276,13397,1850,924,926
19715,15280,1879,7391,1276,13401,1850,924,926
19720,15283,1879,7391,1276,13404,1850,924,926
19725,15284,1879,7391,1276,13405,1850,924,926
19730,15289,1879,7392,1276,13410,1851,925,926
19735,15291,1879,7392,1276,13412,1852,925,927
19740,15299,1879,7395,1276,13420,1852,925,927
19745,15302,1879,7396,1276,13423,1852,925,927
19750,15307,1880,7399,1276,13427,1853,926,927
19755,15311,1880,7402,1276,13431,1853,926,927
19760,15314,1880,7405,1276,13434,1853,926,927
19765,15315,1880,7405,1276,13435,1853,926,927
19770,15320,1880,7407,1276,13440,1853,926,927
19775,15322,1880,7409,1276,13442,1854,927,927
19780,15330,1880,7413,1276,13450,1855,927,928
19785,15333,1880,7415,1276,13453,1855,927,928
19790,15338,1881,7417,1277,13457,1856,927,929
19795,15342,1881,7418,1277,13461,1858,927,931
19800,15345,1883,7421,1279,13462,1858,927,931
19805,15346,1883,7421,1279,13463,1858,927,931
19810,15351,1884,7425,1280,13467,1858,927,931
19815,15353,1884,7425,1280,13469,1859,927,932
19820,15361,1885,7431,1280,13476,1859,927,932
19825,15364,1886,7434,1281,13478,1859,927,932
19830,15369,1887,7436,1281,13482,1859,927,932
19835,15373,1887,7438,1281,13486,1860,927,933
19840,15376,1888,7439,1282,13488,1860,927,933
19845,15377,1889,7440,1283,13488,1860,927,933
19850,15382,1890,7443,1283,13492,1860,927,933
19855,15384,1890,7443,1283,13494,1861,927,934
19860,15392,1891,7448,1284,13501,1861,927,934
19865,15395,1891,7448,1284,13504,1861,927,934
19870,15400,1892,7451,1285,13508,1861,927,934
19875,15404,1892,7452,1285,13512,1862,928,934
19880,15407,1893,7454,1286,13514,1862,928,934
19885,15408,1894,7455,1287,13514,1862,928,934
19890,15413,1895,7457,1288,13518,1863,929,934
19895,15415,1895,7457,1288,13520,1864,929,935
19900,15423,1896,7459,1288,13527,1864,929,935
19905,15426,1897,7461,1289,13529,1864,929,935
19910,15431,1898,7462,1289,13533,1865,929,936
19915,15435,1898,7463,1289,13537,1867,930,937
19920,15438,1899,7465,1290,13539,1867,930,937
19925,15439,1899,7465,1290,13540,1867,930,937
19930,15444,1900,7469,1291,13544,1867,930,937
19935,15446,1900,7470,1291,13546,1868,930,938
19940,15454,1900,7473,1291,13554,1869,930,939
19945,15457,1900,7474,1291,13557,1869,930,939
19950,15462,1900,7476,1291,13562,1870,930,940
19955,15466,1900,7478,1291,13566,1870,930,940
19960,15469,1900,7478,1291,13569,1870,930,940
19965,15470,1900,7479,1291,13570,1870,930,940
19970,15475,1901,7481,1292,13574,1870,930,940
19975,15477,1901,7483,1292,13576,1871,931,940
19980,15485,1901,7488,1292,13584,1872,931,941
19985,15488,1901,7489,1292,13587,1872,931,941
19990,15493,1901,7493,1292,13592,1872,931,941
19995,15497,1901,7495,1292,13596,1872,931,941
20000,15500,1901,7496,1292,13599,1872,931,941
20005,15501,1901,7496,1292,13600,1872,931,941
20010,15506,1902,7498,1292,13604,1873,932,941
20015,15508,1902,7500,1292,13606,1874,933,941
20020,15516,1902,7504,1292,13614,1874,933,941
20025,15519,1902,7506,1292,13617,1874,933,941
20030,15524,1903,7508,1292,13621,1874,933,941
20035,15528,1903,7510,1292,13625,1876,935,941
20040,15531,1904,7511,1293,13627,1876,935,941
20045,15532,1904,7512,1293,13628,1876,935,941
20050,15537,1905,7514,1293,13632,1877,935,942
20055,15539,1905,7515,1293,13634,1878,935,943
20060,15547,1906,7520,1293,13641,1878,935,943
20065,15550,1906,7522,1293,13644,1878,935,943
20070,15555,1907,7524,1294,13648,1878,935,943
20075,15559,1907,7526,1294,13652,1878,935,943
20080,15562,1907,7528,1294,13655,1878,935,943
20085,15563,1907,7529,1294,13656,1878,935,943
20090,15568,1908,7531,1294,13660,1878,935,943
20095,15570,1908,7532,1294,13662,1879,935,944
20100,15578,1909,7537,1294,13669,1879,935,944
20105,15581,1909,7538,1294,13672,1879,935,944
20110,15586,1910,7541,1294,13676,1879,935,944
20115,15590,1910,7544,1294,13680,1879,935,944
20120,15593,1910,7544,1294,13683,1879,935,944
20125,15594,1910,7545,1294,13684,1879,935,944
20130,15599,1911,7548,1295,13688,1879,935,944
20135,15601,1911,7550,1295,13690,1880,936,944
20140,15609,1912,7554,1295,13697,1880,936,944
20145,15612,1913,7556,1296,13699,1880,936,944
20150,15617,1915,7560,1298,13702,1880,936,944
20155,15621,1915,7561,1298,13706,1882,936,946
20160,15624,1917,7564,1300,13707,1882,936,946
20165,15625,1917,7564,1300,13708,1882,936,946
20170,15630,1917,7568,1300,13713,1882,936,946
20175,15632,1917,7569,1300,13715,1883,937,946
20180,15640,1918,7576,1301,13722,1883,937,946
20185,15643,1918,7577,1301,13725,1884,937,947
20190,15648,1919,7580,1302,13729,1884,937,947
20195,15652,1919,7582,1302,13733,1885,938,947
20200,15655,1920,7584,1303,13735,1885,938,947
20205,15656,1920,7584,1303,13736,1885,938,947
20210,15661,1920,7586,1303,13741,1885,938,947
20215,15663,1920,7588,1303,13743,1886,939,947
20220,15671,1921,7594,1304,13750,1887,940,947
20225,15674,1922,7597,1305,13752,1888,941,947
20230,15679,1923,7601,1306,13756,1889,942,947
20235,15683,1923,7601,1306,13760,1890,942,948
20240,15686,1924,7604,1307,13762,1890,942,948
20245,15687,1924,7605,1307,13763,1890,942,948
20250,15692,1924,7607,1307,13768,1891,942,949
20255,15694,1924,7607,1307,13770,1892,942,950
20260,15702,1926,7610,1309,13775,1893,942,951
20265,15705,1927,7611,1310,13778,1894,942,952
20270,15710,1928,7614,1311,13782,1895,943,952
20275,15714,1928,7615,1311,13786,1897,944,953
20280,15717,1929,7617,1312,13788,1897,944,953
20285,15718,1929,7618,1312,13789,1897,944,953
20290,15723,1930,7621,1312,13793,1897,944,953
20295,15725,1930,7623,1312,13795,1898,945,953
20300,15733,1930,7626,1312,13803,1898,945,953
20305,15736,1930,7627,1312,13806,1898,945,953
20310,15741,1930,7631,1312,13811,1899,946,953
20315,15745,1930,7632,1312,13815,1900,946,954
20320,15748,1930,7634,1312,13818,1900,946,954
20325,15749,1930,7635,1312,13819,1900,946,954
20330,15754,1931,7639,1313,13823,1900,946,954
20335,15756,1931,7639,1313,13825,1901,946,955
20340,15764,1931,7643,1313,13833,1901,946,955
20345,15767,1931,7643,1313,13836,1901,946,955
20350,15772,1931,7646,1313,13841,1901,946,955
20355,15776,1931,7648,1313,13845,1901,946,955
20360,15779,1931,7650,1313,13848,1901,946,955
20365,15780,1931,7650,1313,13849,1901,946,955
20370,15785,1932,7654,1314,13853,1901,946,955
20375,15787,1932,7654,1314,13855,1902,946,956
20380,15795,1932,7658,1314,13863,1902,946,956
20385,15798,1932,7659,1314,13866,1902,946,956
20390,15803,1933,7661,1314,13870,1902,946,956
20395,15807,1933,7661,1314,13874,1903,946,957
20400,15810,1933,7661,1314,13877,1903,946,957
20405,15811,1934,7662,1315,13877,1903,946,957
20410,15816,1935,7665,1315,13881,1904,947,957
20415,15818,1935,7666,1315,13883,1905,948,957
20420,15826,1936,7673,1316,13890,1906,949,957
20425,15829,1936,7675,1316,13893,1907,950,957
20430,15834,1937,7677,1317,13897,1907,950,957
20435,15838,1937,7679,1317,13901,1907,950,957
20440,15841,1937,7680,1317,13904,1907,950,957
20445,15842,1937,7680,1317,13905,1907,950,957
20450,15847,1938,7684,1318,13909,1908,951,957
20455,15849,1938,7685,1318,13911,1909,952,957
20460,15857,1939,7689,1319,13918,1910,952,958
20465,15860,1940,7692,1320,13920,1911,953,958
20470,15865,1941,7693,1321,13924,1911,953,958
20475,15869,1941,7697,1321,13928,1911,953,958
20480,15872,1941,7699,1321,13931,1911,953,958
20485,15873,1941,7699,1321,13932,1911,953,958
20490,15878,1942,7702,1321,13936,1911,953,958
20495,15880,1942,7703,1321,13938,1912,953,959
20500,15888,1943,7705,1321,13945,1912,953,959
20505,15891,1943,7706,1321,13948,1913,953,960
20510,15896,1944,7708,1321,13952,1913,953,960
20515,15900,1944,7709,1321,13956,1915,954,961
20520,15903,1945,7711,1322,13958,1915,954,961
20525,15904,1945,7711,1322,13959,1915,954,961
20530,15909,1945,7714,1322,13964,1916,955,961
20535,15911,1945,7715,1322,13966,1917,956,961
20540,15919,1946,7718,1322,13973,1917,956,961
20545,15922,1946,7719,1322,13976,1917,956,961
20550,15927,1947,7720,1322,13980,1917,956,961
20555,15931,1947,7720,1322,13984,1917,956,961
20560,15934,1947,7722,1322,13987,1917,956,961
20565,15935,1947,7722,1322,13988,1917,956,961
20570,15940,1947,7725,1322,13993,1918,957,961
20575,15942,1947,7725,1322,13995,1919,957,962
20580,15950,1948,7730,1322,14002,1919,957,962
20585,15953,1948,7730,1322,14005,1919,957,962
20590,15958,1949,7732,1322,14009,1919,957,962
20595,15962,1949,7735,1322,14013,1919,957,962
20600,15965,1949,7736,1322,14016,1919,957,962
20605,15966,1949,7737,1322,14017,1919,957,962
20610,15971,1949,7740,1322,14022,1919,957,962
20615,15973,1949,7742,1322,14024,1920,958,962
20620,15981,1950,7747,1322,14031,1920,958,962
20625,15984,1951,7749,1323,14033,1920,958,962
20630,15989,1953,7754,1325,14036,1921,959,962
20635,15993,1953,7757,1325,14040,1923,961,962
20640,15996,1954,7758,1326,14042,1923,961,962
20645,15997,1954,7758,1326,14043,1923,961,962
20650,16002,1955,7760,1326,14047,1923,961,962
20655,16004,1955,7762,1326,14049,1924,962,962
20660,16012,1955,7767,1326,14057,1924,962,962
20665,16015,1955,7768,1326,14060,1924,962,962
20670,16020,1956,7771,1327,14064,1924,962,962
20675,16024,1956,7775,1327,14068,1924,962,962
20680,16027,1956,7777,1327,14071,1924,962,962
20685,16028,1956,7777,1327,14072,1924,962,962
20690,16033,1957,7780,1327,14076,1925,963,962
20695,16035,1957,7780,1327,14078,1926,963,963
20700,16043,1957,7783,1327,14086,1926,963,963
20705,16046,1957,7785,1327,14089,1926,963,963
20710,16051,1958,7790,1328,14093,1926,963,963
20715,16055,1958,7792,1328,14097,1926,963,963
20720,16058,1958,7793,1328,14100,1926,963,963
20725,16059,1958,7794,1328,14101,1926,963,963
20730,16064,1959,7796,1329,14105,1927,963,964
20735,16066,1959,7798,1329,14107,1928,964,964
20740,16074,1959,7800,1329,14115,1928,964,964
20745,16077,1959,7801,1329,14118,1928,964,964
20750,16082,1960,7803,1330,14122,1929,964,965
20755,16086,1960,7806,1330,14125,1931,966,965
20760,16089,1963,7809,1333,14126,1931,966,965
20765,16090,1963,7809,1333,14127,1931,966,965
20770,16095,1964,7812,1334,14131,1932,967,965
20775,16097,1964,7812,1334,14133,1933,967,966
20780,16105,1965,7818,1335,14140,1933,967,966
20785,16108,1966,7820,1336,14142,1933,967,966
20790,16113,1967,7823,1337,14146,1934,968,966
20795,16117,1967,7824,1337,14150,1935,968,967
20800,16120,1968,7826,1338,14152,1935,968,967
20805,16121,1968,7827,1338,14153,1935,968,967
20810,16126,1969,7830,1338,14157,1936,968,968
20815,16128,1969,7832,1338,14159,1937,969,968
20820,16136,1970,7839,1339,14166,1937,969,968
20825,16139,1971,7841,1340,14168,1937,969,968
20830,16144,1972,7843,1341,14172,1938,969,969
20835,16148,1972,7847,1341,14176,1939,970,969
20840,16151,1972,7848,1341,14179,1939,970,969
20845,16152,1972,7849,1341,14180,1939,970,969
20850,16157,1973,7852,1341,14184,1940,971,969
20855,16159,1973,7853,1341,14186,1941,972,969
20860,16167,1974,7857,1341,14193,1941,972,969
20865,16170,1974,7857,1341,14196,1941,972,969
20870,16175,1975,7859,1341,14200,1942,973,969
20875,16179,1975,7860,1341,14204,1944,974,970
20880,16182,1976,7861,1342,14206,1944,974,970
20885,16183,1976,7861,1342,14207,1944,974,970
20890,16188,1976,7864,1342,14212,1944,974,970
20895,16190,1976,7864,1342,14214,1945,974,971
20900,16198,1976,7866,1342,14222,1945,974,971
20905,16201,1976,7868,1342,14225,1945,974,971
20910,16206,1977,7870,1342,14229,1945,974,971
20915,16210,1977,7873,1342,14233,1945,974,971
20920,16213,1977,7874,1342,14236,1945,974,971
20925,16214,1977,7875,1342,14237,1945,974,971
20930,16219,1977,7879,1342,14242,1945,974,971
20935,16221,1977,7881,1342,14244,1946,975,971
20940,16229,1977,7884,1342,14252,1946,975,971
20945,16232,1977,7886,1342,14255,1946,975,971
20950,16237,1978,7887,1342,14259,1946,975,971
20955,16241,1978,7889,1342,14263,1946,975,971
20960,16244,1978,7891,1342,14266,1946,975,971
20965,16245,1978,7891,1342,14267,1946,975,971
20970,16250,1978,7893,1342,14272,1946,975,971
20975,16252,1978,7894,1342,14274,1947,976,971
20980,16260,1978,7899,1342,14282,1947,976,971
20985,16263,1978,7901,1342,14285,1947,976,971
20990,16268,1979,7902,1342,14289,1948,976,972
20995,16272,1979,7904,1342,14293,1950,977,973
21000,16275,1979,7904,1342,14296,1950,977,973
21005,16276,1980,7905,1343,14296,1950,977,973
21010,16281,1981,7907,1343,14300,1950,977,973
21015,16283,1981,7908,1343,14302,1951,978,973
21020,16291,1982,7912,1344,14309,1951,978,973
21025,16294,1983,7915,1345,14311,1951,978,973
21030,16299,1984,7918,1346,14315,1951,978,973
21035,16303,1984,7919,1346,14319,1952,978,974
21040,16306,1984,7921,1346,14322,1952,978,974
21045,16307,1984,7922,1346,14323,1952,978,974
21050,16312,1985,7924,1346,14327,1952,978,974
21055,16314,1985,7926,1346,14329,1953,979,974
21060,16322,1986,7930,1346,14336,1953,979,974
21065,16325,1987,7931,1347,14338,1953,979,974
21070,16330,1988,7934,1348,14342,1954,980,974
21075,16334,1988,7937,1348,14346,1955,981,974
21080,16337,1988,7938,1348,14349,1955,981,974
21085,16338,1988,7939,1348,14350,1955,981,974
21090,16343,1989,7941,1348,14354,1955,981,974
21095,16345,1989,7941,1348,14356,1956,981,975
21100,16353,1990,7944,1348,14363,1956,981,975
21105,16356,1990,7945,1348,14366,1956,981,975
21110,16361,1991,7947,1348,14370,1957,981,976
21115,16365,1991,7950,1348,14374,1959,983,976
21120,16368,1992,7952,1349,14376,1959,983,976
21125,16369,1992,7952,1349,14377,1959,983,976
21130,16374,1993,7954,1349,14381,1960,983,977
21135,16376,1993,7956,1349,14383,1961,984,977
21140,16384,1993,7959,1349,14391,1961,984,977
21145,16387,1993,7961,1349,14394,1961,984,977
21150,16392,1994,7963,1349,14398,1961,984,977
21155,16396,1994,7966,1349,14402,1961,984,977
21160,16399,1994,7968,1349,14405,1961,984,977
21165,16400,1994,7969,1349,14406,1961,984,977
21170,16405,1995,7971,1350,14410,1962,984,978
21175,16407,1995,7972,1350,14412,1963,985,978
21180,16415,1995,7977,1350,14420,1963,985,978
21185,16418,1995,7978,1350,14423,1963,985,978
21190,16423,1996,7980,1351,14427,1963,985,978
21195,16427,1996,7984,1351,14431,1963,985,978
21200,16430,1996,7986,1351,14434,1963,985,978
21205,16431,1996,7986,1351,14435,1963,985,978
21210,16436,1997,7986,1351,14439,1964,985,979
21215,16438,1997,7987,1351,14441,1965,986,979
21220,16446,1997,7990,1351,14449,1965,986,979
21225,16449,1997,7993,1351,14452,1965,986,979
21230,16454,1998,7996,1351,14456,1966,987,979
21235,16458,1998,7997,1351,14459,1968,987,981
21240,16461,2000,7998,1353,14461,1968,987,981
21245,16462,2000,7999,1353,14462,1968,987,981
21250,16467,2000,8001,1353,14467,1968,987,981
21255,16469,2000,8002,1353,14469,1969,988,981
21260,16477,2001,8007,1354,14476,1969,988,981
21265,16480,2001,8009,1354,14479,1969,988,981
21270,16485,2001,8012,1354,14484,1969,988,981
21275,16489,2001,8012,1354,14488,1970,988,982
21280,16492,2001,8013,1354,14491,1970,988,982
21285,16493,2001,8013,1354,14492,1970,988,982
21290,16498,2001,8015,1354,14497,1970,988,982
21295,16500,2001,8015,1354,14499,1971,988,983
21300,16508,2002,8019,1355,14506,1971,988,983
21305,16511,2002,8020,1355,14509,1971,988,983
21310,16516,2002,8023,1355,14514,1971,988,983
21315,16520,2002,8025,1355,14518,1972,989,983
21320,16523,2002,8027,1355,14521,1972,989,983
21325,16524,2002,8027,1355,14522,1972,989,983
21330,16529,2002,8028,1355,14527,1972,989,983
21335,16531,2002,8028,1355,14529,1973,989,984
21340,16539,2003,8032,1355,14536,1973,989,984
21345,16542,2003,8032,1355,14539,1973,989,984
21350,16547,2004,8037,1356,14543,1973,989,984
21355,16551,2004,8040,1356,14547,1975,991,984
21360,16554,2004,8041,1356,14550,1975,991,984
21365,16555,2004,8041,1356,14551,1975,991,984
21370,16560,2005,8044,1357,14555,1975,991,984
21375,16562,2005,8046,1357,14557,1976,992,984
21380,16570,2006,8048,1357,14564,1977,992,985
21385,16573,2007,8051,1358,14566,1978,993,985
21390,16578,2008,8053,1359,14570,1979,993,986
21395,16582,2008,8054,1359,14574,1979,993,986
21400,16585,2008,8054,1359,14577,1979,993,986
21405,16586,2008,8055,1359,14578,1979,993,986
21410,16591,2009,8058,1360,14582,1979,993,986
21415,16593,2009,8058,1360,14584,1980,993,987
21420,16601,2010,8060,1360,14591,1981,994,987
21425,16604,2010,8062,1360,14594,1982,995,987
21430,16609,2011,8064,1360,14598,1982,995,987
21435,16613,2011,8067,1360,14602,1982,995,987
21440,16616,2011,8069,1360,14605,1982,995,987
21445,16617,2011,8069,1360,14606,1982,995,987
21450,16622,2012,8070,1360,14610,1982,995,987
21455,16624,2012,8072,1360,14612,1983,996,987
21460,16632,2013,8075,1360,14619,1983,996,987
21465,16635,2014,8076,1361,14621,1984,996,988
21470,16640,2015,8078,1361,14625,1984,996,988
21475,16644,2015,8080,1361,14629,1986,998,988
21480,16647,2017,8082,1363,14630,1986,998,988
21485,16648,2017,8082,1363,14631,1986,998,988
21490,16653,2018,8084,1363,14635,1987,999,988
21495,16655,2018,8085,1363,14637,1988,999,989
21500,16663,2019,8090,1364,14644,1988,999,989
21505,16666,2019,8091,1364,14647,1988,999,989
21510,16671,2020,8092,1364,14651,1988,999,989
21515,16675,2020,8095,1364,14655,1988,999,989
21520,16678,2020,8096,1364,14658,1988,999,989
21525,16679,2020,8097,1364,14659,1988,999,989
21530,16684,2021,8100,1364,14663,1988,999,989
21535,16686,2021,8102,1364,14665,1989,1000,989
21540,16694,2021,8105,1364,14673,1989,1000,989
21545,16697,2021,8105,1364,14676,1989,1000,989
21550,16702,2022,8107,1364,14680,1989,1000,989
21555,16706,2022,8108,1364,14684,1989,1000,989
21560,16709,2022,8108,1364,14687,1989,1000,989
21565,16710,2022,8109,1364,14688,1989,1000,989
21570,16715,2023,8111,1365,14692,1989,1000,989
21575,16717,2023,8112,1365,14694,1990,1000,990
21580,16725,2023,8114,1365,14702,1990,1000,990
21585,16728,2023,8114,1365,14705,1990,1000,990
21590,16733,2025,8117,1367,14708,1990,1000,990
21595,16737,2025,8118,1367,14712,1992,1001,991
21600,16740,2025,8118,1367,14715,1992,1001,991
21605,16741,2025,8118,1367,14716,1992,1001,991
21610,16746,2026,8120,1368,14720,1992,1001,991
21615,16748,2026,8120,1368,14722,1993,1001,992
21620,16756,2027,8125,1369,14729,1994,1001,993
21625,16759,2028,8128,1370,14731,1995,1002,993
21630,16764,2029,8130,1370,14735,1996,1002,994
21635,16768,2029,8131,1370,14739,1996,1002,994
21640,16771,2029,8131,1370,14742,1996,1002,994
21645,16772,2029,8132,1370,14743,1996,1002,994
21650,16777,2030,8134,1371,14747,1996,1002,994
21655,16779,2030,8136,1371,14749,1997,1003,994
21660,16787,2031,8139,1371,14756,1998,1004,994
21665,16790,2031,8140,1371,14759,1999,1004,995
21670,16795,2032,8142,1371,14763,2000,1004,996
21675,16799,2032,8143,1371,14767,2000,1004,996
21680,16802,2032,8145,1371,14770,2000,1004,996
21685,16803,2032,8146,1371,14771,2000,1004,996
21690,16808,2033,8148,1371,14775,2000,1004,996
21695,16810,2033,8150,1371,14777,2001,1005,996
21700,16818,2034,8154,1371,14784,2002,1006,996
21705,16821,2034,8156,1371,14787,2003,1007,996
21710,16826,2035,8159,1372,14791,2004,1007,997
21715,16830,2035,8162,1372,14795,2006,1009,997
21720,16833,2035,8162,1372,14798,2006,1009,997
21725,16834,2035,8163,1372,14799,2006,1009,997
21730,16839,2035,8166,1372,14804,2006,1009,997
21735,16841,2035,8167,1372,14806,2007,1009,998
21740,16849,2036,8169,1372,14813,2007,1009,998
21745,16852,2037,8172,1373,14815,2007,1009,998
21750,16857,2038,8174,1374,14819,2007,1009,998
21755,16861,2038,8175,1374,14823,2008,1010,998
21760,16864,2038,8176,1374,14826,2008,1010,998
21765,16865,2038,8177,1374,14827,2008,1010,998
21770,16870,2038,8178,1374,14832,2008,1010,998
21775,16872,2038,8179,1374,14834,2009,1011,998
21780,16880,2039,8183,1374,14841,2009,1011,998
21785,16883,2039,8184,1374,14844,2009,1011,998
21790,16888,2040,8187,1375,14848,2009,1011,998
21795,16892,2040,8190,1375,14852,2010,1011,999
21800,16895,2041,8191,1376,14854,2010,1011,999
21805,16896,2041,8191,1376,14855,2010,1011,999
21810,16901,2041,8193,1376,14860,2010,1011,999
21815,16903,2041,8195,1376,14862,2011,1012,999
21820,16911,2042,8200,1377,14869,2011,1012,999
21825,16914,2042,8202,1377,14872,2011,1012,999
21830,16919,2043,8205,1377,14876,2012,1013,999
21835,16923,2043,8206,1377,14880,2014,1014,1000
21840,16926,2045,8209,1379,14881,2014,1014,1000
21845,16927,2045,8209,1379,14882,2014,1014,1000
21850,16932,2046,8211,1379,14886,2015,1014,1001
21855,16934,2046,8212,1379,14888,2016,1014,1002
21860,16942,2047,8215,1379,14895,2016,1014,1002
21865,16945,2047,8216,1379,14898,2017,1015,1002
21870,16950,2048,8217,1379,14902,2017,1015,1002
21875,16954,2048,8220,1379,14906,2017,1015,1002
21880,16957,2048,8221,1379,14909,2017,1015,1002
21885,16958,2049,8222,1380,14909,2017,1015,1002
21890,16963,2050,8225,1381,14913,2017,1015,1002
21895,16965,2050,8226,1381,14915,2018,1015,1003
21900,16973,2051,8229,1381,14922,2018,1015,1003
21905,16976,2051,8231,1381,14925,2019,1016,1003
21910,16981,2052,8233,1382,14929,2019,1016,1003
21915,16985,2052,8235,1382,14933,2019,1016,1003
21920,16988,2052,8237,1382,14936,2019,1016,1003
21925,16989,2053,8238,1383,14936,2019,1016,1003
21930,16994,2054,8240,1383,14940,2020,1016,1004
21935,16996,2054,8240,1383,14942,2021,1016,1005
21940,17004,2055,8244,1384,14949,2021,1016,1005
21945,17007,2055,8246,1384,14952,2022,1017,1005
21950,17012,2056,8249,1385,14956,2023,1017,1006
21955,17016,2056,8251,1385,14960,2025,1018,1007
21960,17019,2056,8251,1385,14963,2025,1018,1007
21965,17020,2056,8251,1385,14964,2025,1018,1007
21970,17025,2057,8253,1386,14968,2025,1018,1007
21975,17027,2057,8254,1386,14970,2026,1019,1007
21980,17035,2058,8258,1387,14977,2027,1019,1008
21985,17038,2058,8259,1387,14980,2028,1019,1009
21990,17043,2059,8262,1387,14984,2029,1020,1009
21995,17047,2059,8266,1387,14987,2030,1021,1009
22000,17050,2060,8267,1388,14990,2030,1021,1009
22005,17051,2060,8267,1388,14991,2030,1021,1009
22010,17056,2061,8270,1389,14995,2030,1021,1009
22015,17058,2061,8272,1389,14997,2031,1022,1009
22020,17066,2062,8276,1389,15004,2032,1023,1009
22025,17069,2062,8277,1389,15007,2032,1023,1009
22030,17074,2063,8281,1389,15011,2033,1024,1009
22035,17078,2063,8282,1389,15015,2033,1024,1009
22040,17081,2063,8285,1389,15018,2033,1024,1009
22045,17082,2063,8285,1389,15019,2033,1024,1009
22050,17087,2064,8288,1389,15023,2033,1024,1009
22055,17089,2064,8290,1389,15025,2034,1025,1009
22060,17097,2065,8293,1390,15032,2034,1025,1009
22065,17100,2065,8295,1390,15035,2034,1025,1009
22070,17105,2066,8298,1391,15039,2035,1025,1010
22075,17109,2066,8300,1391,15043,2036,1025,1011
22080,17112,2067,8303,1392,15045,2036,1025,1011
22085,17113,2067,8303,1392,15046,2036,1025,1011
22090,17118,2068,8306,1393,15050,2036,1025,1011
22095,17120,2068,8307,1393,15052,2037,1025,1012
22100,17128,2070,8310,1395,15057,2037,1025,1012
22105,17131,2071,8311,1396,15060,2038,1026,1012
22110,17136,2071,8312,1396,15065,2038,1026,1012
22115,17140,2071,8315,1396,15069,2039,1027,1012
22120,17143,2071,8315,1396,15072,2039,1027,1012
22125,17144,2071,8315,1396,15073,2039,1027,1012
22130,17149,2072,8319,1397,15077,2039,1027,1012
22135,17151,2072,8319,1397,15079,2040,1027,1013
22140,17159,2074,8322,1398,15085,2040,1027,1013
22145,17162,2075,8325,1399,15087,2041,1028,1013
22150,17167,2075,8329,1399,15092,2041,1028,1013
22155,17171,2075,8332,1399,15096,2042,1029,1013
22160,17174,2075,8334,1399,15099,2042,1029,1013
22165,17175,2076,8335,1400,15099,2042,1029,1013
22170,17180,2077,8338,1401,15103,2042,1029,1013
22175,17182,2077,8339,1401,15105,2043,1029,1014
22180,17190,2077,8343,1401,15113,2043,1029,1014
22185,17193,2077,8346,1401,15116,2044,1030,1014
22190,17198,2078,8347,1401,15120,2045,1030,1015
22195,17202,2078,8349,1401,15124,2047,1032,1015
22200,17205,2079,8351,1402,15126,2047,1032,1015
22205,17206,2079,8352,1402,15127,2047,1032,1015
22210,17211,2080,8353,1402,15131,2047,1032,1015
22215,17213,2080,8354,1402,15133,2048,1032,1016
22220,17221,2081,8356,1403,15140,2050,1032,1018
22225,17224,2081,8357,1403,15143,2051,1033,1018
22230,17229,2082,8359,1404,15147,2051,1033,1018
22235,17233,2082,8361,1404,15151,2052,1034,1018
22240,17236,2082,8363,1404,15154,2052,1034,1018
22245,17237,2082,8363,1404,15155,2052,1034,1018
22250,17242,2083,8364,1404,15159,2052,1034,1018
22255,17244,2083,8365,1404,15161,2053,1034,1019
22260,17252,2083,8369,1404,15169,2054,1034,1020
22265,17255,2083,8370,1404,15172,2054,1034,1020
22270,17260,2084,8371,1404,15176,2054,1034,1020
22275,17264,2084,8371,1404,15180,2054,1034,1020
22280,17267,2084,8373,1404,15183,2054,1034,1020
22285,17268,2084,8374,1404,15184,2054,1034,1020
22290,17273,2085,8377,1404,15188,2054,1034,1020
22295,17275,2085,8379,1404,15190,2055,1035,1020
22300,17283,2085,8380,1404,15198,2056,1035,1021
22305,17286,2085,8381,1404,15201,2056,1035,1021
22310,17291,2086,8382,1404,15205,2057,1035,1022
22315,17295,2086,8385,1404,15208,2058,1035,1023
22320,17298,2087,8386,1405,15211,2058,1035,1023
22325,17299,2087,8386,1405,15212,2058,1035,1023
22330,17304,2088,8389,1406,15216,2058,1035,1023
22335,17306,2088,8390,1406,15218,2059,1035,1024
22340,17314,2089,8394,1406,15225,2060,1036,1024
22345,17317,2090,8397,1407,15227,2060,1036,1024
22350,17322,2091,8401,1407,15231,2060,1036,1024
22355,17326,2091,8403,1407,15235,2061,1036,1025
22360,17329,2091,8404,1407,15238,2061,1036,1025
22365,17330,2092,8405,1408,15238,2061,1036,1025
22370,17335,2093,8407,1409,15242,2061,1036,1025
22375,17337,2093,8409,1409,15244,2062,1037,1025
22380,17345,2095,8411,1410,15250,2063,1037,1026
22385,17348,2095,8412,1410,15253,2063,1037,1026
22390,17353,2096,8416,1411,15257,2064,1037,1027
22395,17357,2096,8417,1411,15261,2065,1038,1027
22400,17360,2096,8418,1411,15264,2065,1038,1027
22405,17361,2096,8418,1411,15265,2065,1038,1027
22410,17366,2097,8418,1411,15269,2065,1038,1027
22415,17368,2097,8418,1411,15271,2066,1038,1028
22420,17376,2098,8421,1412,15278,2067,1038,1029
22425,17379,2098,8421,1412,15281,2067,1038,1029
22430,17384,2099,8424,1412,15285,2068,1039,1029
22435,17388,2099,8425,1412,15289,2070,1040,1030
22440,17391,2099,8425,1412,15292,2070,1040,1030
22445,17392,2099,8425,1412,15293,2070,1040,1030
22450,17397,2099,8427,1412,15298,2070,1040,1030
22455,17399,2099,8429,1412,15300,2071,1041,1030
22460,17407,2100,8432,1412,15307,2071,1041,1030
22465,17410,2100,8433,1412,15310,2072,1041,1031
22470,17415,2101,8436,1412,15314,2072,1041,1031
22475,17419,2101,8439,1412,15318,2072,1041,1031
22480,17422,2101,8441,1412,15321,2072,1041,1031
22485,17423,2101,8441,1412,15322,2072,1041,1031
22490,17428,2101,8443,1412,15327,2072,1041,1031
22495,17430,2101,8444,1412,15329,2073,1042,1031
22500,17438,2102,8448,1412,15336,2073,1042,1031
22505,17441,2103,8450,1413,15338,2074,1042,1032
22510,17446,2104,8452,1413,15342,2074,1042,1032
22515,17450,2104,8455,1413,15346,2074,1042,1032
22520,17453,2104,8455,1413,15349,2074,1042,1032
22525,17454,2104,8455,1413,15350,2074,1042,1032
22530,17459,2104,8457,1413,15355,2074,1042,1032
22535,17461,2104,8458,1413,15357,2075,1043,1032
22540,17469,2105,8461,1413,15364,2075,1043,1032
22545,17472,2105,8462,1413,15367,2076,1044,1032
22550,17477,2106,8464,1414,15371,2077,1044,1033
22555,17481,2106,8467,1414,15375,2079,1046,1033
22560,17484,2108,8470,1416,15376,2079,1046,1033
22565,17485,2108,8471,1416,15377,2079,1046,1033
22570,17490,2109,8473,1417,15381,2079,1046,1033
22575,17492,2109,8474,1417,15383,2080,1047,1033
22580,17500,2110,8476,1418,15390,2080,1047,1033
22585,17503,2111,8479,1419,15392,2080,1047,1033
22590,17508,2112,8481,1420,15396,2081,1047,1034
22595,17512,2112,8483,1420,15400,2081,1047,1034
22600,17515,2112,8486,1420,15403,2081,1047,1034
22605,17516,2112,8486,1420,15404,2081,1047,1034
22610,17521,2113,8487,1420,15408,2081,1047,1034
22615,17523,2113,8488,1420,15410,2082,1047,1035
22620,17531,2114,8490,1421,15417,2082,1047,1035
22625,17534,2115,8493,1422,15419,2082,1047,1035
22630,17539,2116,8496,1422,15423,2083,1048,1035
22635,17543,2116,8498,1422,15427,2083,1048,1035
22640,17546,2116,8500,1422,15430,2083,1048,1035
22645,17547,2116,8501,1422,15431,2083,1048,1035
22650,17552,2117,8503,1422,15435,2083,1048,1035
22655,17554,2117,8503,1422,15437,2084,1048,1036
22660,17562,2118,8506,1422,15444,2084,1048,1036
22665,17565,2119,8509,1423,15446,2084,1048,1036
22670,17570,2120,8512,1424,15450,2085,1048,1037
22675,17574,2120,8513,1424,15454,2087,1049,1038
22680,17577,2122,8516,1426,15455,2087,1049,1038
22685,17578,2122,8516,1426,15456,2087,1049,1038
22690,17583,2123,8520,1426,15460,2088,1050,1038
22695,17585,2123,8521,1426,15462,2089,1050,1039
22700,17593,2123,8523,1426,15470,2090,1050,1040
22705,17596,2123,8524,1426,15473,2090,1050,1040
22710,17601,2124,8527,1426,15477,2090,1050,1040
22715,17605,2124,8530,1426,15481,2090,1050,1040
22720,17608,2124,8533,1426,15484,2090,1050,1040
22725,17609,2124,8534,1426,15485,2090,1050,1040
22730,17614,2125,8536,1427,15489,2090,1050,1040
22735,17616,2125,8537,1427,15491,2091,1051,1040
22740,17624,2125,8539,1427,15499,2091,1051,1040
22745,17627,2125,8540,1427,15502,2091,1051,1040
22750,17632,2126,8541,1428,15506,2091,1051,1040
22755,17636,2126,8543,1428,15510,2091,1051,1040
22760,17639,2126,8546,1428,15513,2091,1051,1040
22765,17640,2126,8547,1428,15514,2091,1051,1040
22770,17645,2127,8548,1428,15518,2091,1051,1040
22775,17647,2127,8550,1428,15520,2092,1052,1040
22780,17655,2128,8556,1429,15527,2092,1052,1040
22785,17658,2128,8557,1429,15530,2092,1052,1040
22790,17663,2129,8561,1430,15534,2093,1053,1040
22795,17667,2129,8562,1430,15538,2095,1054,1041
22800,17670,2129,8562,1430,15541,2095,1054,1041
22805,17671,2129,8563,1430,15542,2095,1054,1041
22810,17676,2130,8566,1431,15546,2095,1054,1041
22815,17678,2130,8567,1431,15548,2096,1054,1042
22820,17686,2131,8571,1432,15555,2096,1054,1042
22825,17689,2131,8571,1432,15558,2096,1054,1042
22830,17694,2132,8571,1432,15562,2097,1054,1043
22835,17698,2132,8573,1432,15566,2097,1054,1043
22840,17701,2132,8575,1432,15569,2097,1054,1043
22845,17702,2132,8575,1432,15570,2097,1054,1043
22850,17707,2133,8578,1432,15574,2097,1054,1043
22855,17709,2133,8579,1432,15576,2098,1055,1043
22860,17717,2134,8583,1433,15583,2098,1055,1043
22865,17720,2134,8584,1433,15586,2098,1055,1043
22870,17725,2135,8587,1434,15590,2099,1055,1044
22875,17729,2135,8589,1434,15594,2099,1055,1044
22880,17732,2135,8590,1434,15597,2099,1055,1044
22885,17733,2135,8591,1434,15598,2099,1055,1044
22890,17738,2136,8593,1435,15602,2099,1055,1044
22895,17740,2136,8594,1435,15604,2100,1055,1045
22900,17748,2137,8597,1435,15611,2101,1056,1045
22905,17751,2137,8597,1435,15614,2102,1056,1046
22910,17756,2139,8602,1437,15617,2103,1057,1046
22915,17760,2139,8602,1437,15621,2105,1057,1048
22920,17763,2140,8603,1438,15623,2105,1057,1048
22925,17764,2140,8603,1438,15624,2105,1057,1048
22930,17769,2141,8606,1438,15628,2106,1058,1048
22935,17771,2141,8607,1438,15630,2107,1059,1048
22940,17779,2142,8611,1438,15637,2107,1059,1048
22945,17782,2142,8611,1438,15640,2107,1059,1048
22950,17787,2143,8614,1439,15644,2107,1059,1048
22955,17791,2143,8616,1439,15648,2107,1059,1048
22960,17794,2143,8617,1439,15651,2107,1059,1048
22965,17795,2143,8617,1439,15652,2107,1059,1048
22970,17800,2144,8619,1439,15656,2108,1060,1048
22975,17802,2144,8619,1439,15658,2109,1060,1049
22980,17810,2145,8624,1440,15665,2109,1060,1049
22985,17813,2145,8626,1440,15668,2109,1060,1049
22990,17818,2146,8628,1440,15672,2109,1060,1049
22995,17822,2146,8630,1440,15676,2109,1060,1049
23000,17825,2146,8631,1440,15679,2109,1060,1049
23005,17826,2146,8632,1440,15680,2109,1060,1049
23010,17831,2147,8633,1440,15684,2110,1061,1049
23015,17833,2147,8634,1440,15686,2111,1062,1049
23020,17841,2148,8638,1440,15693,2111,1062,1049
23025,17844,2149,8641,1441,15695,2111,1062,1049
23030,17849,2150,8643,1441,15699,2112,1062,1050
23035,17853,2150,8645,1441,15703,2114,1064,1050
23040,17856,2151,8646,1442,15705,2114,1064,1050
23045,17857,2151,8647,1442,15706,2114,1064,1050
23050,17862,2152,8650,1443,15710,2114,1064,1050
23055,17864,2152,8651,1443,15712,2115,1064,1051
23060,17872,2152,8655,1443,15720,2115,1064,1051
23065,17875,2152,8656,1443,15723,2115,1064,1051
23070,17880,2153,8659,1444,15727,2116,1064,1052
23075,17884,2153,8662,1444,15731,2116,1064,1052
23080,17887,2153,8664,1444,15734,2116,1064,1052
23085,17888,2153,8665,1444,15735,2116,1064,1052
23090,17893,2154,8667,1444,15739,2116,1064,1052
23095,17895,2154,8668,1444,15741,2117,1064,1053
23100,17903,2154,8674,1444,15749,2117,1064,1053
23105,17906,2154,8674,1444,15752,2117,1064,1053
23110,17911,2155,8677,1445,15756,2118,1064,1054
23115,17915,2155,8678,1445,15760,2118,1064,1054
23120,17918,2155,8679,1445,15763,2118,1064,1054
23125,17919,2155,8679,1445,15764,2118,1064,1054
23130,17924,2156,8681,1445,15768,2118,1064,1054
23135,17926,2156,8682,1445,15770,2119,1065,1054
23140,17934,2156,8688,1445,15778,2119,1065,1054
23145,17937,2156,8690,1445,15781,2119,1065,1054
23150,17942,2157,8692,1446,15785,2120,1065,1055
23155,17946,2157,8693,1446,15789,2122,1065,1057
23160,17949,2159,8696,1448,15790,2122,1065,1057
23165,17950,2159,8697,1448,15791,2122,1065,1057
23170,17955,2160,8699,1448,15795,2123,1065,1058
23175,17957,2160,8699,1448,15797,2124,1065,1059
23180,17965,2161,8705,1449,15804,2124,1065,1059
23185,17968,2162,8707,1450,15806,2124,1065,1059
23190,17973,2162,8710,1450,15811,2124,1065,1059
23195,17977,2162,8712,1450,15815,2125,1066,1059
23200,17980,2162,8714,1450,15818,2125,1066,1059
23205,17981,2162,8714,1450,15819,2125,1066,1059
23210,17986,2163,8716,1451,15823,2126,1067,1059
23215,17988,2163,8718,1451,15825,2127,1068,1059
23220,17996,2164,8723,1452,15832,2127,1068,1059
23225,17999,2165,8724,1453,15834,2127,1068,1059
23230,18004,2165,8727,1453,15839,2127,1068,1059
23235,18008,2165,8729,1453,15843,2128,1068,1060
23240,18011,2165,8731,1453,15846,2128,1068,1060
23245,18012,2165,8732,1453,15847,2128,1068,1060
23250,18017,2166,8735,1453,15851,2129,1069,1060
23255,18019,2166,8736,1453,15853,2130,1069,1061
23260,18027,2167,8743,1454,15860,2130,1069,1061
23265,18030,2167,8744,1454,15863,2130,1069,1061
23270,18035,2168,8747,1454,15867,2131,1069,1062
23275,18039,2168,8748,1454,15871,2133,1069,1064
23280,18042,2170,8750,1456,15872,2133,1069,1064
23285,18043,2170,8750,1456,15873,2133,1069,1064
23290,18048,2171,8755,1457,15877,2133,1069,1064
23295,18050,2171,8755,1457,15879,2134,1069,1065
23300,18058,2171,8759,1457,15887,2134,1069,1065
23305,18061,2171,8762,1457,15890,2134,1069,1065
23310,18066,2172,8764,1457,15894,2134,1069,1065
23315,18070,2172,8768,1457,15898,2134,1069,1065
23320,18073,2172,8770,1457,15901,2134,1069,1065
23325,18074,2172,8771,1457,15902,2134,1069,1065
23330,18079,2173,8772,1457,15906,2134,1069,1065
23335,18081,2173,8772,1457,15908,2135,1069,1066
23340,18089,2173,8774,1457,15916,2135,1069,1066
23345,18092,2173,8774,1457,15919,2135,1069,1066
23350,18097,2174,8776,1458,15923,2135,1069,1066
23355,18101,2174,8777,1458,15927,2135,1069,1066
23360,18104,2174,8778,1458,15930,2135,1069,1066
23365,18105,2174,8779,1458,15931,2135,1069,1066
23370,18110,2175,8782,1459,15935,2135,1069,1066
23375,18112,2175,8783,1459,15937,2136,1070,1066
23380,18120,2176,8786,1460,15944,2136,1070,1066
23385,18123,2176,8788,1460,15947,2136,1070,1066
23390,18128,2178,8791,1462,15950,2137,1070,1067
23395,18132,2178,8792,1462,15954,2139,1071,1068
23400,18135,2179,8793,1463,15956,2139,1071,1068
23405,18136,2179,8794,1463,15957,2139,1071,1068
23410,18141,2180,8797,1464,15961,2140,1071,1069
23415,18143,2180,8799,1464,15963,2141,1072,1069
23420,18151,2181,8802,1464,15970,2141,1072,1069
23425,18154,2182,8805,1465,15972,2141,1072,1069
23430,18159,2182,8808,1465,15977,2141,1072,1069
23435,18163,2182,8809,1465,15981,2141,1072,1069
23440,18166,2182,8809,1465,15984,2141,1072,1069
23445,18167,2182,8809,1465,15985,2141,1072,1069
23450,18172,2183,8810,1465,15989,2142,1072,1070
23455,18174,2183,8811,1465,15991,2143,1072,1071
23460,18182,2184,8815,1465,15998,2143,1072,1071
23465,18185,2185,8816,1466,16000,2143,1072,1071
23470,18190,2185,8820,1466,16005,2143,1072,1071
23475,18194,2185,8823,1466,16009,2143,1072,1071
23480,18197,2185,8824,1466,16012,2143,1072,1071
23485,18198,2185,8825,1466,16013,2143,1072,1071
23490,18203,2186,8829,1467,16017,2144,1072,1072
23495,18205,2186,8830,1467,16019,2145,1072,1073
23500,18213,2187,8832,1467,16026,2145,1072,1073
23505,18216,2187,8833,1467,16029,2145,1072,1073
23510,18221,2188,8836,1468,16033,2146,1073,1073
23515,18225,2188,8839,1468,16036,2148,1075,1073
23520,18228,2190,8841,1470,16038,2148,1075,1073
23525,18229,2190,8842,1470,16039,2148,1075,1073
23530,18234,2191,8845,1471,16043,2148,1075,1073
23535,18236,2191,8845,1471,16045,2149,1075,1074
23540,18244,2191,8850,1471,16053,2150,1076,1074
23545,18247,2191,8853,1471,16056,2150,1076,1074
23550,18252,2191,8855,1471,16061,2151,1076,1075
23555,18256,2191,8857,1471,16065,2151,1076,1075
23560,18259,2191,8858,1471,16068,2151,1076,1075
23565,18260,2191,8859,1471,16069,2151,1076,1075
23570,18265,2192,8860,1471,16073,2151,1076,1075
23575,18267,2192,8861,1471,16075,2152,1077,1075
23580,18275,2192,8867,1471,16083,2152,1077,1075
23585,18278,2192,8868,1471,16086,2152,1077,1075
23590,18283,2192,8871,1471,16091,2152,1077,1075
23595,18287,2192,8872,1471,16095,2152,1077,1075
23600,18290,2192,8873,1471,16098,2152,1077,1075
23605,18291,2192,8873,1471,16099,2152,1077,1075
23610,18296,2193,8873,1471,16103,2152,1077,1075
23615,18298,2193,8873,1471,16105,2153,1077,1076
23620,18306,2193,8878,1471,16113,2153,1077,1076
23625,18309,2193,8878,1471,16116,2153,1077,1076
23630,18314,2194,8881,1472,16120,2153,1077,1076
23635,18318,2194,8883,1472,16123,2155,1077,1078
23640,18321,2196,8885,1474,16125,2155,1077,1078
23645,18322,2196,8885,1474,16126,2155,1077,1078
23650,18327,2197,8888,1474,16130,2156,1078,1078
23655,18329,2197,8889,1474,16132,2157,1079,1078
23660,18337,2198,8893,1474,16139,2157,1079,1078
23665,18340,2199,8895,1475,16141,2158,1080,1078
23670,18345,2199,8898,1475,16146,2158,1080,1078
23675,18349,2199,8899,1475,16150,2159,1080,1079
23680,18352,2199,8901,1475,16153,2159,1080,1079
23685,18353,2199,8901,1475,16154,2159,1080,1079
23690,18358,2200,8904,1475,16158,2160,1081,1079
23695,18360,2200,8905,1475,16160,2161,1082,1079
23700,18368,2201,8910,1475,16167,2161,1082,1079
23705,18371,2202,8912,1476,16169,2162,1082,1080
23710,18376,2202,8914,1476,16174,2162,1082,1080
23715,18380,2202,8917,1476,16178,2163,1082,1081
23720,18383,2202,8919,1476,16181,2163,1082,1081
23725,18384,2202,8920,1476,16182,2163,1082,1081
23730,18389,2203,8923,1476,16186,2163,1082,1081
23735,18391,2203,8925,1476,16188,2164,1083,1081
23740,18399,2204,8930,1476,16195,2164,1083,1081
23745,18402,2205,8931,1477,16197,2165,1083,1082
23750,18407,2207,8934,1478,16200,2166,1083,1083
23755,18411,2207,8937,1478,16203,2168,1084,1084
23760,18414,2209,8939,1480,16205,2168,1084,1084
23765,18415,2210,8940,1481,16205,2168,1084,1084
23770,18420,2211,8944,1481,16209,2168,1084,1084
23775,18422,2211,8944,1481,16211,2169,1084,1085
23780,18430,2212,8950,1482,16218,2171,1086,1085
23785,18433,2212,8951,1482,16221,2171,1086,1085
23790,18438,2213,8953,1482,16225,2171,1086,1085
23795,18442,2213,8955,1482,16229,2171,1086,1085
23800,18445,2213,8956,1482,16232,2171,1086,1085
23805,18446,2213,8956,1482,16233,2171,1086,1085
23810,18451,2214,8961,1483,16237,2171,1086,1085
23815,18453,2214,8962,1483,16239,2172,1086,1086
23820,18461,2214,8967,1483,16247,2174,1088,1086
23825,18464,2214,8968,1483,16250,2174,1088,1086
23830,18469,2215,8971,1484,16254,2174,1088,1086
23835,18473,2215,8971,1484,16258,2174,1088,1086
23840,18476,2215,8972,1484,16261,2174,1088,1086
23845,18477,2215,8972,1484,16262,2174,1088,1086
23850,18482,2217,8974,1486,16265,2174,1088,1086
23855,18484,2217,8976,1486,16267,2175,1089,1086
23860,18492,2218,8978,1487,16274,2177,1089,1088
23865,18495,2218,8980,1487,16277,2177,1089,1088
23870,18500,2219,8980,1487,16281,2178,1089,1089
23875,18504,2219,8984,1487,16284,2180,1091,1089
23880,18507,2221,8986,1489,16286,2180,1091,1089
23885,18508,2221,8987,1489,16287,2180,1091,1089
23890,18513,2222,8989,1489,16291,2181,1092,1089
23895,18515,2222,8990,1489,16293,2182,1093,1089
23900,18523,2223,8993,1489,16300,2182,1093,1089
23905,18526,2223,8994,1489,16303,2182,1093,1089
23910,18531,2223,8997,1489,16308,2182,1093,1089
23915,18535,2223,8998,1489,16312,2184,1093,1091
23920,18538,2223,8999,1489,16315,2184,1093,1091
23925,18539,2223,9000,1489,16316,2184,1093,1091
23930,18544,2224,9001,1490,16320,2184,1093,1091
23935,18546,2224,9001,1490,16322,2185,1093,1092
23940,18554,2225,9005,1491,16329,2185,1093,1092
23945,18557,2225,9006,1491,16332,2185,1093,1092
23950,18562,2225,9011,1491,16337,2186,1094,1092
23955,18566,2225,9013,1491,16341,2188,1095,1093
23960,18569,2225,9015,1491,16344,2188,1095,1093
23965,18570,2225,9016,1491,16345,2188,1095,1093
23970,18575,2226,9020,1492,16349,2188,1095,1093
23975,18577,2226,9021,1492,16351,2189,1095,1094
23980,18585,2227,9025,1493,16358,2190,1095,1095
23985,18588,2228,9026,1494,16360,2191,1095,1096
23990,18593,2229,9029,1495,16364,2192,1095,1097
23995,18597,2229,9032,1495,16368,2194,1097,1097
24000,18600,2229,9032,1495,16371,2194,1097,1097
24005,18601,2229,9033,1495,16372,2194,1097,1097
24010,18606,2230,9035,1496,16376,2194,1097,1097
24015,18608,2230,9035,1496,16378,2195,1097,1098
24020,18616,2231,9038,1497,16385,2195,1097,1098
24025,18619,2231,9040,1497,16388,2195,1097,1098
24030,18624,2232,9042,1498,16392,2195,1097,1098
24035,18628,2232,9043,1498,16396,2196,1097,1099
24040,18631,2233,9045,1499,16398,2196,1097,1099
24045,18632,2233,9046,1499,16399,2196,1097,1099
24050,18637,2234,9046,1499,16403,2196,1097,1099
24055,18639,2234,9046,1499,16405,2197,1097,1100
24060,18647,2236,9053,1501,16411,2197,1097,1100
24065,18650,2237,9055,1502,16413,2197,1097,1100
24070,18655,2238,9059,1502,16417,2197,1097,1100
24075,18659,2238,9060,1502,16421,2198,1097,1101
24080,18662,2238,9061,1502,16424,2198,1097,1101
24085,18663,2238,9061,1502,16425,2198,1097,1101
24090,18668,2239,9065,1502,16429,2199,1098,1101
24095,18670,2239,9066,1502,16431,2200,1098,1102
24100,18678,2241,9072,1504,16437,2200,1098,1102
24105,18681,2241,9072,1504,16440,2200,1098,1102
24110,18686,2243,9074,1506,16443,2201,1098,1103
24115,18690,2243,9076,1506,16446,2203,1099,1104
24120,18693,2244,9076,1507,16449,2203,1099,1104
24125,18694,2244,9076,1507,16450,2203,1099,1104
24130,18699,2245,9078,1508,16454,2203,1099,1104
24135,18701,2245,9078,1508,16456,2204,1099,1105
24140,18709,2245,9082,1508,16464,2204,1099,1105
24145,18712,2245,9082,1508,16467,2205,1099,1106
24150,18717,2245,9085,1508,16472,2205,1099,1106
24155,18721,2245,9087,1508,16475,2206,1099,1107
24160,18724,2246,9089,1509,16478,2206,1099,1107
24165,18725,2246,9089,1509,16479,2206,1099,1107
24170,18730,2247,9094,1510,16483,2206,1099,1107
24175,18732,2247,9096,1510,16485,2207,1100,1107
24180,18740,2247,9101,1510,16492,2207,1100,1107
24185,18743,2248,9104,1511,16495,2208,1101,1107
24190,18748,2248,9106,1511,16500,2208,1101,1107
24195,18752,2248,9109,1511,16503,2208,1101,1107
24200,18755,2249,9109,1512,16506,2208,1101,1107
24205,18756,2249,9109,1512,16507,2208,1101,1107
24210,18761,2250,9113,1513,16511,2208,1101,1107
24215,18763,2250,9113,1513,16513,2209,1101,1108
24220,18771,2250,9115,1513,16521,2209,1101,1108
24225,18774,2250,9117,1513,16524,2210,1102,1108
24230,18779,2251,9118,1514,16528,2211,1102,1109
24235,18783,2251,9118,1514,16532,2212,1102,1110
24240,18786,2252,9120,1515,16534,2212,1102,1110
24245,18787,2252,9121,1515,16535,2212,1102,1110
24250,18792,2253,9123,1515,16539,2212,1102,1110
24255,18794,2253,9125,1515,16541,2213,1103,1110
24260,18802,2255,9132,1517,16547,2214,1104,1110
24265,18805,2255,9132,1517,16550,2214,1104,1110
24270,18810,2256,9135,1518,16554,2214,1104,1110
24275,18814,2256,9136,1518,16558,2215,1104,1111
24280,18817,2256,9137,1518,16561,2215,1104,1111
24285,18818,2256,9137,1518,16562,2215,1104,1111
24290,18823,2257,9139,1518,16566,2215,1104,1111
24295,18825,2257,9139,1518,16568,2216,1104,1112
24300,18833,2258,9142,1519,16575,2217,1104,1113
24305,18836,2258,9144,1519,16578,2217,1104,1113
24310,18841,2259,9148,1520,16582,2217,1104,1113
24315,18845,2259,9151,1520,16586,2218,1105,1113
24320,18848,2259,9153,1520,16589,2218,1105,1113
24325,18849,2259,9154,1520,16590,2218,1105,1113
24330,18854,2260,9156,1521,16594,2218,1105,1113
24335,18856,2260,9158,1521,16596,2219,1106,1113
24340,18864,2260,9162,1521,16604,2219,1106,1113
24345,18867,2260,9164,1521,16607,2219,1106,1113
24350,18872,2262,9167,1523,16610,2220,1107,1113
24355,18876,2262,9170,1523,16613,2222,1108,1114
24360,18879,2265,9173,1526,16614,2222,1108,1114
24365,18880,2265,9173,1526,16615,2222,1108,1114
24370,18885,2266,9176,1527,16619,2222,1108,1114
24375,18887,2266,9178,1527,16621,2223,1109,1114
24380,18895,2267,9179,1527,16628,2223,1109,1114
24385,18898,2267,9180,1527,16631,2224,1110,1114
24390,18903,2268,9185,1528,16635,2224,1110,1114
24395,18907,2268,9188,1528,16638,2224,1110,1114
24400,18910,2269,9189,1529,16641,2224,1110,1114
24405,18911,2269,9189,1529,16642,2224,1110,1114
24410,18916,2270,9191,1529,16646,2224,1110,1114
24415,18918,2270,9192,1529,16648,2225,1111,1114
24420,18926,2271,9195,1529,16655,2226,1111,1115
24425,18929,2272,9197,1530,16657,2227,1111,1116
24430,18934,2273,9199,1530,16661,2227,1111,1116
24435,18938,2273,9201,1530,16664,2227,1111,1116
24440,18941,2274,9201,1531,16667,2227,1111,1116
24445,18942,2275,9202,1532,16667,2227,1111,1116
24450,18947,2276,9206,1533,16671,2227,1111,1116
24455,18949,2276,9207,1533,16673,2228,1111,1117
24460,18957,2277,9209,1534,16680,2229,1111,1118
24465,18960,2278,9210,1535,16682,2230,1111,1119
24470,18965,2279,9211,1536,16686,2231,1111,1120
24475,18969,2279,9215,1536,16689,2233,1113,1120
24480,18972,2282,9217,1539,16690,2233,1113,1120
24485,18973,2282,9217,1539,16691,2233,1113,1120
24490,18978,2282,9221,1539,16696,2234,1114,1120
24495,18980,2282,9222,1539,16698,2235,1115,1120
24500,18988,2283,9226,1540,16705,2236,1115,1121
24505,18991,2283,9227,1540,16708,2236,1115,1121
24510,18996,2284,9228,1540,16712,2237,1115,1122
24515,19000,2284,9229,1540,16716,2238,1116,1122
24520,19003,2284,9230,1540,16719,2238,1116,1122
24525,19004,2284,9230,1540,16720,2238,1116,1122
24530,19009,2284,9232,1540,16725,2239,1116,1123
24535,19011,2284,9232,1540,16727,2240,1116,1124
24540,19019,2285,9236,1541,16734,2241,1116,1125
24545,19022,2285,9238,1541,16737,2241,1116,1125
24550,19027,2286,9240,1541,16741,2241,1116,1125
24555,19031,2286,9241,1541,16745,2242,1116,1126
24560,19034,2286,9244,1541,16748,2242,1116,1126
24565,19035,2286,9245,1541,16749,2242,1116,1126
24570,19040,2286,9247,1541,16754,2243,1117,1126
24575,19042,2286,9248,1541,16756,2244,1117,1127
24580,19050,2287,9252,1542,16763,2244,1117,1127
24585,19053,2287,9254,1542,16766,2244,1117,1127
24590,19058,2288,9254,1542,16770,2244,1117,1127
24595,19062,2288,9256,1542,16773,2245,1117,1128
24600,19065,2289,9256,1543,16776,2245,1117,1128
24605,19066,2290,9257,1544,16776,2245,1117,1128
24610,19071,2291,9259,1544,16780,2245,1117,1128
24615,19073,2291,9261,1544,16782,2246,1118,1128
24620,19081,2292,9266,1544,16789,2248,1120,1128
24625,19084,2292,9266,1544,16792,2249,1120,1129
24630,19089,2293,9270,1545,16796,2250,1121,1129
24635,19093,2293,9274,1545,16800,2250,1121,1129
24640,19096,2293,9276,1545,16803,2250,1121,1129
24645,19097,2294,9277,1546,16803,2250,1121,1129
24650,19102,2295,9279,1547,16807,2250,1121,1129
24655,19104,2295,9280,1547,16809,2251,1122,1129
24660,19112,2296,9283,1547,16816,2253,1124,1129
24665,19115,2296,9283,1547,16819,2254,1124,1130
24670,19120,2297,9287,1548,16823,2255,1124,1131
24675,19124,2297,9290,1548,16827,2255,1124,1131
24680,19127,2297,9292,1548,16830,2255,1124,1131
24685,19128,2297,9293,1548,16831,2255,1124,1131
24690,19133,2298,9296,1549,16835,2256,1125,1131
24695,19135,2298,9297,1549,16837,2257,1126,1131
24700,19143,2299,9302,1550,16844,2258,1127,1131
24705,19146,2299,9303,1550,16847,2259,1127,1132
24710,19151,2300,9304,1551,16851,2260,1127,1133
24715,19155,2300,9305,1551,16855,2262,1127,1135
24720,19158,2301,9306,1552,16857,2262,1127,1135
24725,19159,2301,9306,1552,16858,2262,1127,1135
24730,19164,2302,9309,1552,16862,2262,1127,1135
24735,19166,2302,9310,1552,16864,2263,1128,1135
24740,19174,2303,9312,1552,16871,2263,1128,1135
24745,19177,2304,9314,1553,16873,2263,1128,1135
24750,19182,2305,9317,1554,16877,2263,1128,1135
24755,19186,2305,9319,1554,16881,2265,1129,1136
24760,19189,2306,9321,1555,16883,2265,1129,1136
24765,19190,2306,9322,1555,16884,2265,1129,1136
24770,19195,2307,9326,1556,16888,2265,1129,1136
24775,19197,2307,9328,1556,16890,2266,1130,1136
24780,19205,2308,9333,1557,16897,2266,1130,1136
24785,19208,2308,9334,1557,16900,2266,1130,1136
24790,19213,2309,9336,1557,16904,2266,1130,1136
24795,19217,2309,9337,1557,16908,2268,1131,1137
24800,19220,2310,9340,1558,16910,2268,1131,1137
24805,19221,2310,9340,1558,16911,2268,1131,1137
24810,19226,2311,9342,1559,16915,2268,1131,1137
24815,19228,2311,9342,1559,16917,2269,1131,1138
24820,19236,2312,9346,1559,16924,2269,1131,1138
24825,19239,2312,9346,1559,16927,2269,1131,1138
24830,19244,2313,9348,1559,16931,2270,1132,1138
24835,19248,2313,9350,1559,16935,2272,1134,1138
24840,19251,2313,9350,1559,16938,2272,1134,1138
24845,19252,2313,9351,1559,16939,2272,1134,1138
24850,19257,2314,9353,1559,16943,2272,1134,1138
24855,19259,2314,9355,1559,16945,2273,1135,1138
24860,19267,2315,9358,1560,16952,2273,1135,1138
24865,19270,2315,9360,1560,16955,2274,1136,1138
24870,19275,2316,9363,1560,16959,2274,1136,1138
24875,19279,2316,9365,1560,16962,2274,1136,1138
24880,19282,2317,9366,1561,16965,2274,1136,1138
24885,19283,2317,9366,1561,16966,2274,1136,1138
24890,19288,2318,9368,1561,16970,2275,1137,1138
24895,19290,2318,9368,1561,16972,2276,1137,1139
24900,19298,2319,9371,1562,16978,2276,1137,1139
24905,19301,2321,9373,1564,16980,2277,1138,1139
24910,19306,2322,9374,1565,16984,2277,1138,1139
24915,19310,2322,9376,1565,16988,2277,1138,1139
24920,19313,2322,9377,1565,16991,2277,1138,1139
24925,19314,2322,9377,1565,16992,2277,1138,1139
24930,19319,2323,9380,1566,16996,2277,1138,1139
24935,19321,2323,9381,1566,16998,2278,1138,1140
24940,19329,2324,9385,1567,17005,2278,1138,1140
24945,19332,2324,9387,1567,17008,2279,1139,1140
24950,19337,2325,9391,1568,17012,2280,1140,1140
24955,19341,2325,9392,1568,17016,2282,1140,1142
24960,19344,2326,9394,1569,17018,2282,1140,1142
24965,19345,2326,9394,1569,17019,2282,1140,1142
24970,19350,2326,9397,1569,17024,2282,1140,1142
24975,19352,2326,9398,1569,17026,2283,1141,1142
24980,19360,2328,9402,1571,17032,2284,1141,1143
24985,19363,2328,9402,1571,17035,2284,1141,1143
24990,19368,2328,9406,1571,17040,2284,1141,1143
24995,19372,2328,9409,1571,17044,2285,1142,1143
25000,19375,2328,9409,1571,17047,2285,1142,1143
25005,19376,2328,9409,1571,17048,2285,1142,1143
25010,19381,2328,9413,1571,17053,2285,1142,1143
25015,19383,2328,9414,1571,17055,2286,1143,1143
25020,19391,2329,9417,1572,17062,2287,1143,1144
25025,19394,2329,9417,1572,17065,2287,1143,1144
25030,19399,2329,9420,1572,17070,2287,1143,1144
25035,19403,2329,9422,1572,17074,2288,1143,1145
25040,19406,2329,9423,1572,17077,2288,1143,1145
25045,19407,2329,9424,1572,17078,2288,1143,1145
25050,19412,2329,9426,1572,17083,2289,1144,1145
25055,19414,2329,9428,1572,17085,2290,1145,1145
25060,19422,2329,9433,1572,17093,2290,1145,1145
25065,19425,2329,9434,1572,17096,2290,1145,1145
25070,19430,2330,9435,1573,17100,2291,1145,1146
25075,19434,2330,9439,1573,17103,2293,1147,1146
25080,19437,2331,9440,1574,17106,2293,1147,1146
25085,19438,2331,9440,1574,17107,2293,1147,1146
25090,19443,2332,9443,1575,17111,2294,1148,1146
25095,19445,2332,9444,1575,17113,2295,1149,1146
25100,19453,2333,9449,1576,17119,2295,1149,1146
25105,19456,2334,9451,1577,17122,2296,1150,1146
25110,19461,2335,9454,1577,17126,2296,1150,1146
25115,19465,2335,9455,1577,17130,2296,1150,1146
25120,19468,2335,9456,1577,17133,2296,1150,1146
25125,19469,2335,9457,1577,17134,2296,1150,1146
25130,19474,2336,9460,1578,17138,2297,1151,1146
25135,19476,2336,9460,1578,17140,2298,1151,1147
25140,19484,2338,9464,1579,17146,2298,1151,1147
25145,19487,2339,9466,1580,17148,2298,1151,1147
25150,19492,2340,9470,1580,17152,2298,1151,1147
25155,19496,2340,9471,1580,17156,2298,1151,1147
25160,19499,2340,9472,1580,17159,2298,1151,1147
25165,19500,2340,9472,1580,17160,2298,1151,1147
25170,19505,2341,9473,1580,17164,2299,1151,1148
25175,19507,2341,9475,1580,17166,2300,1152,1148
25180,19515,2343,9478,1581,17172,2300,1152,1148
25185,19518,2344,9480,1582,17174,2300,1152,1148
25190,19523,2346,9484,1583,17177,2301,1153,1148
25195,19527,2346,9486,1583,17180,2303,1154,1149
25200,19530,2348,9488,1585,17182,2303,1154,1149
25205,19531,2348,9489,1585,17183,2303,1154,1149
25210,19536,2349,9490,1586,17187,2303,1154,1149
25215,19538,2349,9490,1586,17189,2304,1154,1150
25220,19546,2350,9496,1587,17196,2304,1154,1150
25225,19549,2351,9499,1588,17198,2304,1154,1150
25230,19554,2351,9500,1588,17203,2304,1154,1150
25235,19558,2351,9501,1588,17207,2304,1154,1150
25240,19561,2351,9502,1588,17210,2304,1154,1150
25245,19562,2351,9503,1588,17211,2304,1154,1150
25250,19567,2352,9505,1588,17215,2304,1154,1150
25255,19569,2352,9506,1588,17217,2305,1155,1150
25260,19577,2353,9510,1589,17224,2305,1155,1150
25265,19580,2354,9512,1590,17226,2305,1155,1150
25270,19585,2354,9514,1590,17231,2305,1155,1150
25275,19589,2354,9517,1590,17235,2305,1155,1150
25280,19592,2354,9517,1590,17238,2305,1155,1150
25285,19593,2354,9518,1590,17239,2305,1155,1150
25290,19598,2355,9521,1590,17243,2306,1156,1150
25295,19600,2355,9523,1590,17245,2307,1157,1150
25300,19608,2356,9525,1590,17252,2307,1157,1150
25305,19611,2356,9526,1590,17255,2307,1157,1150
25310,19616,2357,9528,1590,17259,2308,1158,1150
25315,19620,2357,9529,1590,17263,2310,1158,1152
25320,19623,2357,9530,1590,17266,2310,1158,1152
25325,19624,2358,9531,1591,17266,2310,1158,1152
25330,19629,2359,9533,1592,17270,2311,1158,1153
25335,19631,2359,9534,1592,17272,2312,1158,1154
25340,19639,2360,9540,1593,17279,2313,1159,1154
25345,19642,2360,9541,1593,17282,2313,1159,1154
25350,19647,2361,9542,1594,17286,2314,1159,1155
25355,19651,2361,9543,1594,17290,2314,1159,1155
25360,19654,2361,9544,1594,17293,2314,1159,1155
25365,19655,2362,9545,1595,17293,2314,1159,1155
25370,19660,2364,9549,1597,17296,2315,1160,1155
25375,19662,2364,9549,1597,17298,2316,1160,1156
25380,19670,2365,9554,1598,17305,2317,1161,1156
25385,19673,2365,9555,1598,17308,2317,1161,1156
25390,19678,2366,9557,1598,17312,2318,1162,1156
25395,19682,2366,9559,1598,17316,2318,1162,1156
25400,19685,2366,9560,1598,17319,2318,1162,1156
25405,19686,2367,9561,1599,17319,2318,1162,1156
25410,19691,2369,9564,1600,17322,2319,1163,1156
25415,19693,2369,9565,1600,17324,2320,1163,1157
25420,19701,2370,9570,1601,17331,2321,1163,1158
25425,19704,2370,9571,1601,17334,2321,1163,1158
25430,19709,2371,9573,1601,17338,2322,1164,1158
25435,19713,2371,9575,1601,17342,2324,1165,1159
25440,19716,2373,9577,1603,17343,2324,1165,1159
25445,19717,2373,9577,1603,17344,2324,1165,1159
25450,19722,2373,9578,1603,17349,2324,1165,1159
25455,19724,2373,9579,1603,17351,2325,1165,1160
25460,19732,2374,9585,1603,17358,2325,1165,1160
25465,19735,2375,9587,1604,17360,2326,1165,1161
25470,19740,2375,9590,1604,17365,2326,1165,1161
25475,19744,2375,9594,1604,17369,2328,1167,1161
25480,19747,2375,9596,1604,17372,2328,1167,1161
25485,19748,2375,9597,1604,17373,2328,1167,1161
25490,19753,2375,9599,1604,17378,2328,1167,1161
25495,19755,2375,9600,1604,17380,2329,1168,1161
25500,19763,2376,9604,1604,17387,2329,1168,1161
25505,19766,2376,9604,1604,17390,2330,1168,1162
25510,19771,2376,9607,1604,17395,2330,1168,1162
25515,19775,2376,9608,1604,17399,2332,1169,1163
25520,19778,2376,9611,1604,17402,2332,1169,1163
25525,19779,2376,9612,1604,17403,2332,1169,1163
25530,19784,2376,9613,1604,17408,2332,1169,1163
25535,19786,2376,9614,1604,17410,2333,1169,1164
25540,19794,2377,9617,1604,17417,2333,1169,1164
25545,19797,2377,9619,1604,17420,2334,1170,1164
25550,19802,2378,9621,1605,17424,2335,1170,1165
25555,19806,2378,9625,1605,17427,2337,1172,1165
25560,19809,2381,9628,1608,17428,2337,1172,1165
25565,19810,2381,9628,1608,17429,2337,1172,1165
25570,19815,2382,9630,1609,17433,2338,1172,1166
25575,19817,2382,9631,1609,17435,2339,1173,1166
25580,19825,2383,9634,1609,17442,2339,1173,1166
25585,19828,2383,9636,1609,17445,2339,1173,1166
25590,19833,2384,9637,1609,17449,2339,1173,1166
25595,19837,2384,9640,1609,17452,2339,1173,1166
25600,19840,2385,9641,1610,17455,2339,1173,1166
25605,19841,2385,9642,1610,17456,2339,1173,1166
25610,19846,2386,9646,1611,17460,2340,1173,1167
25615,19848,2386,9646,1611,17462,2341,1173,1168
25620,19856,2387,9651,1611,17469,2341,1173,1168
25625,19859,2387,9652,1611,17472,2341,1173,1168
25630,19864,2388,9657,1612,17476,2341,1173,1168
25635,19868,2388,9658,1612,17479,2341,1173,1168
25640,19871,2389,9660,1613,17482,2341,1173,1168
25645,19872,2389,9661,1613,17483,2341,1173,1168
25650,19877,2390,9663,1614,17487,2341,1173,1168
25655,19879,2390,9663,1614,17489,2342,1173,1169
25660,19887,2391,9666,1614,17496,2342,1173,1169
25665,19890,2392,9668,1615,17498,2342,1173,1169
25670,19895,2393,9670,1615,17502,2343,1174,1169
25675,19899,2393,9673,1615,17505,2345,1175,1170
25680,19902,2395,9674,1617,17507,2345,1175,1170
25685,19903,2395,9674,1617,17508,2345,1175,1170
25690,19908,2396,9676,1618,17512,2345,1175,1170
25695,19910,2396,9677,1618,17514,2346,1176,1170
25700,19918,2396,9680,1618,17522,2347,1176,1171
25705,19921,2396,9682,1618,17525,2347,1176,1171
25710,19926,2396,9684,1618,17530,2347,1176,1171
25715,19930,2396,9686,1618,17534,2348,1177,1171
25720,19933,2396,9687,1618,17537,2348,1177,1171
25725,19934,2397,9688,1619,17537,2348,1177,1171
25730,19939,2399,9690,1620,17540,2348,1177,1171
25735,19941,2399,9691,1620,17542,2349,1178,1171
25740,19949,2399,9693,1620,17550,2350,1178,1172
25745,19952,2399,9695,1620,17553,2350,1178,1172
25750,19957,2399,9697,1620,17558,2350,1178,1172
25755,19961,2399,9697,1620,17562,2351,1178,1173
25760,19964,2399,9699,1620,17565,2351,1178,1173
25765,19965,2399,9699,1620,17566,2351,1178,1173
25770,19970,2400,9702,1620,17570,2352,1179,1173
25775,19972,2400,9703,1620,17572,2353,1180,1173
25780,19980,2400,9707,1620,17580,2353,1180,1173
25785,19983,2400,9708,1620,17583,2353,1180,1173
25790,19988,2401,9709,1620,17587,2354,1180,1174
25795,19992,2401,9710,1620,17591,2356,1181,1175
25800,19995,2402,9712,1621,17593,2356,1181,1175
25805,19996,2402,9713,1621,17594,2356,1181,1175
25810,20001,2403,9715,1621,17598,2356,1181,1175
25815,20003,2403,9716,1621,17600,2357,1182,1175
25820,20011,2404,9720,1621,17607,2358,1182,1176
25825,20014,2405,9721,1622,17609,2358,1182,1176
25830,20019,2406,9725,1623,17613,2358,1182,1176
25835,20023,2406,9728,1623,17617,2359,1183,1176
25840,20026,2406,9729,1623,17620,2359,1183,1176
25845,20027,2406,9729,1623,17621,2359,1183,1176
25850,20032,2407,9730,1623,17625,2359,1183,1176
25855,20034,2407,9731,1623,17627,2360,1184,1176
25860,20042,2408,9735,1624,17634,2361,1185,1176
25865,20045,2408,9736,1624,17637,2361,1185,1176
25870,20050,2409,9738,1624,17641,2361,1185,1176
25875,20054,2409,9741,1624,17645,2362,1185,1177
25880,20057,2409,9743,1624,17648,2362,1185,1177
25885,20058,2409,9744,1624,17649,2362,1185,1177
25890,20063,2410,9749,1625,17653,2363,1186,1177
25895,20065,2410,9749,1625,17655,2364,1186,1178
25900,20073,2411,9754,1626,17662,2365,1187,1178
25905,20076,2412,9756,1627,17664,2366,1187,1179
25910,20081,2414,9758,1629,17667,2367,1187,1180
25915,20085,2414,9760,1629,17671,2369,1189,1180
25920,20088,2416,9762,1631,17672,2369,1189,1180
25925,20089,2416,9762,1631,17673,2369,1189,1180
25930,20094,2416,9765,1631,17678,2369,1189,1180
25935,20096,2416,9767,1631,17680,2370,1190,1180
25940,20104,2417,9772,1632,17687,2370,1190,1180
25945,20107,2418,9773,1633,17689,2370,1190,1180
25950,20112,2419,9774,1633,17693,2370,1190,1180
25955,20116,2419,9774,1633,17697,2371,1190,1181
25960,20119,2419,9775,1633,17700,2371,1190,1181
25965,20120,2419,9776,1633,17701,2371,1190,1181
25970,20125,2419,9777,1633,17706,2371,1190,1181
25975,20127,2419,9777,1633,17708,2372,1190,1182
25980,20135,2420,9781,1633,17715,2372,1190,1182
25985,20138,2421,9783,1634,17717,2372,1190,1182
25990,20143,2422,9786,1635,17721,2372,1190,1182
25995,20147,2422,9787,1635,17725,2373,1190,1183
26000,20150,2422,9788,1635,17728,2373,1190,1183
26005,20151,2422,9788,1635,17729,2373,1190,1183
26010,20156,2422,9790,1635,17734,2373,1190,1183
26015,20158,2422,9791,1635,17736,2374,1191,1183
26020,20166,2423,9794,1636,17743,2374,1191,1183
26025,20169,2423,9794,1636,17746,2374,1191,1183
26030,20174,2424,9795,1636,17750,2375,1192,1183
26035,20178,2424,9798,1636,17753,2377,1194,1183
26040,20181,2426,9800,1638,17755,2377,1194,1183
26045,20182,2426,9801,1638,17756,2377,1194,1183
26050,20187,2427,9802,1639,17760,2377,1194,1183
26055,20189,2427,9803,1639,17762,2378,1195,1183
26060,20197,2427,9808,1639,17770,2378,1195,1183
26065,20200,2427,9810,1639,17773,2378,1195,1183
26070,20205,2428,9811,1639,17777,2379,1195,1184
26075,20209,2428,9813,1639,17781,2379,1195,1184
26080,20212,2428,9815,1639,17784,2379,1195,1184
26085,20213,2428,9816,1639,17785,2379,1195,1184
26090,20218,2429,9819,1639,17789,2379,1195,1184
26095,20220,2429,9820,1639,17791,2380,1196,1184
26100,20228,2429,9822,1639,17799,2380,1196,1184
26105,20231,2429,9823,1639,17802,2380,1196,1184
26110,20236,2430,9827,1640,17806,2381,1197,1184
26115,20240,2430,9829,1640,17810,2381,1197,1184
26120,20243,2430,9829,1640,17813,2381,1197,1184
26125,20244,2430,9830,1640,17814,2381,1197,1184
26130,20249,2431,9831,1640,17818,2381,1197,1184
26135,20251,2431,9833,1640,17820,2382,1198,1184
26140,20259,2431,9836,1640,17828,2382,1198,1184
26145,20262,2431,9836,1640,17831,2382,1198,1184
26150,20267,2432,9839,1641,17835,2383,1199,1184
26155,20271,2432,9841,1641,17838,2385,1199,1186
26160,20274,2433,9842,1642,17841,2385,1199,1186
26165,20275,2434,9843,1643,17841,2385,1199,1186
26170,20280,2435,9845,1643,17845,2385,1199,1186
26175,20282,2435,9845,1643,17847,2386,1199,1187
26180,20290,2436,9846,1643,17854,2387,1199,1188
26185,20293,2436,9846,1643,17857,2387,1199,1188
26190,20298,2437,9848,1643,17861,2387,1199,1188
26195,20302,2437,9850,1643,17865,2388,1199,1189
26200,20305,2437,9852,1643,17868,2388,1199,1189
26205,20306,2438,9853,1644,17868,2388,1199,1189
26210,20311,2439,9855,1645,17872,2389,1199,1190
26215,20313,2439,9856,1645,17874,2390,1199,1191
26220,20321,2440,9858,1645,17881,2391,1200,1191
26225,20324,2441,9860,1646,17883,2391,1200,1191
26230,20329,2442,9863,1646,17887,2391,1200,1191
26235,20333,2442,9866,1646,17891,2392,1200,1192
26240,20336,2443,9867,1647,17893,2392,1200,1192
26245,20337,2443,9868,1647,17894,2392,1200,1192
26250,20342,2444,9870,1648,17898,2392,1200,1192
26255,20344,2444,9870,1648,17900,2393,1200,1193
26260,20352,2445,9873,1648,17907,2393,1200,1193
26265,20355,2445,9874,1648,17910,2393,1200,1193
26270,20360,2446,9875,1648,17914,2394,1200,1194
26275,20364,2446,9878,1648,17917,2396,1201,1195
26280,20367,2448,9880,1650,17919,2396,1201,1195
26285,20368,2448,9881,1650,17920,2396,1201,1195
26290,20373,2449,9883,1651,17924,2396,1201,1195
26295,20375,2449,9884,1651,17926,2397,1202,1195
26300,20383,2449,9890,1651,17934,2398,1203,1195
26305,20386,2449,9892,1651,17937,2398,1203,1195
26310,20391,2450,9894,1652,17941,2399,1204,1195
26315,20395,2450,9897,1652,17945,2399,1204,1195
26320,20398,2450,9899,1652,17948,2399,1204,1195
26325,20399,2450,9899,1652,17949,2399,1204,1195
26330,20404,2451,9900,1653,17953,2400,1204,1196
26335,20406,2451,9900,1653,17955,2401,1204,1197
26340,20414,2451,9906,1653,17963,2402,1205,1197
26345,20417,2451,9907,1653,17966,2402,1205,1197
26350,20422,2452,9909,1653,17970,2402,1205,1197
26355,20426,2452,9911,1653,17974,2402,1205,1197
26360,20429,2452,9912,1653,17977,2402,1205,1197
26365,20430,2452,9912,1653,17978,2402,1205,1197
26370,20435,2453,9915,1654,17982,2403,1206,1197
26375,20437,2453,9915,1654,17984,2404,1206,1198
26380,20445,2453,9920,1654,17992,2404,1206,1198
26385,20448,2453,9922,1654,17995,2404,1206,1198
26390,20453,2454,9924,1655,17999,2404,1206,1198
26395,20457,2454,9924,1655,18003,2406,1206,1200
26400,20460,2454,9924,1655,18006,2406,1206,1200
26405,20461,2454,9925,1655,18007,2406,1206,1200
26410,20466,2455,9930,1656,18011,2406,1206,1200
26415,20468,2455,9932,1656,18013,2407,1207,1200
26420,20476,2456,9934,1656,18020,2407,1207,1200
26425,20479,2456,9936,1656,18023,2407,1207,1200
26430,20484,2457,9939,1657,18027,2407,1207,1200
26435,20488,2457,9940,1657,18031,2407,1207,1200
26440,20491,2457,9942,1657,18034,2407,1207,1200
26445,20492,2457,9943,1657,18035,2407,1207,1200
26450,20497,2458,9946,1658,18039,2407,1207,1200
26455,20499,2458,9947,1658,18041,2408,1208,1200
26460,20507,2459,9951,1658,18048,2408,1208,1200
26465,20510,2459,9952,1658,18051,2408,1208,1200
26470,20515,2460,9956,1659,18055,2408,1208,1200
26475,20519,2460,9958,1659,18059,2408,1208,1200
26480,20522,2460,9959,1659,18062,2408,1208,1200
26485,20523,2460,9960,1659,18063,2408,1208,1200
26490,20528,2461,9962,1660,18067,2409,1208,1201
26495,20530,2461,9963,1660,18069,2410,1208,1202
26500,20538,2462,9964,1660,18076,2410,1208,1202
26505,20541,2463,9966,1661,18078,2410,1208,1202
26510,20546,2464,9968,1661,18082,2410,1208,1202
26515,20550,2464,9970,1661,18085,2412,1209,1203
26520,20553,2467,9972,1664,18086,2412,1209,1203
26525,20554,2467,9972,1664,18087,2412,1209,1203
26530,20559,2468,9974,1665,18091,2413,1209,1204
26535,20561,2468,9974,1665,18093,2414,1209,1205
26540,20569,2471,9978,1668,18098,2414,1209,1205
26545,20572,2471,9979,1668,18101,2415,1209,1206
26550,20577,2472,9982,1668,18105,2415,1209,1206
26555,20581,2472,9984,1668,18109,2416,1209,1207
26560,20584,2472,9984,1668,18112,2416,1209,1207
26565,20585,2473,9985,1669,18112,2416,1209,1207
26570,20590,2474,9986,1669,18116,2417,1209,1208
26575,20592,2474,9988,1669,18118,2418,1210,1208
26580,20600,2475,9992,1670,18125,2419,1211,1208
26585,20603,2475,9994,1670,18128,2419,1211,1208
26590,20608,2476,9999,1671,18132,2419,1211,1208
26595,20612,2476,10003,1671,18136,2420,1212,1208
26600,20615,2477,10006,1672,18138,2420,1212,1208
26605,20616,2477,10006,1672,18139,2420,1212,1208
26610,20621,2478,10010,1673,18143,2420,1212,1208
26615,20623,2478,10011,1673,18145,2421,1213,1208
26620,20631,2479,10016,1674,18152,2422,1214,1208
26625,20634,2479,10017,1674,18155,2422,1214,1208
26630,20639,2480,10019,1674,18159,2423,1214,1209
26635,20643,2480,10021,1674,18163,2425,1215,1210
26640,20646,2480,10022,1674,18166,2425,1215,1210
26645,20647,2480,10022,1674,18167,2425,1215,1210
26650,20652,2481,10024,1675,18171,2425,1215,1210
26655,20654,2481,10025,1675,18173,2426,1215,1211
26660,20662,2482,10029,1676,18179,2427,1216,1211
26665,20665,2483,10030,1677,18182,2428,1216,1212
26670,20670,2483,10033,1677,18187,2429,1217,1212
26675,20674,2483,10036,1677,18190,2429,1217,1212
26680,20677,2484,10036,1678,18193,2429,1217,1212
26685,20678,2484,10037,1678,18194,2429,1217,1212
26690,20683,2485,10039,1678,18198,2430,1218,1212
26695,20685,2485,10040,1678,18200,2431,1219,1212
26700,20693,2486,10043,1679,18206,2433,1220,1213
26705,20696,2487,10044,1680,18209,2434,1221,1213
26710,20701,2487,10047,1680,18214,2434,1221,1213
26715,20705,2487,10049,1680,18218,2435,1221,1214
26720,20708,2487,10049,1680,18221,2435,1221,1214
26725,20709,2487,10049,1680,18222,2435,1221,1214
26730,20714,2488,10051,1680,18226,2435,1221,1214
26735,20716,2488,10051,1680,18228,2436,1221,1215
26740,20724,2489,10054,1681,18235,2437,1221,1216
26745,20727,2489,10055,1681,18238,2438,1221,1217
26750,20732,2490,10058,1682,18242,2438,1221,1217
26755,20736,2490,10061,1682,18245,2440,1223,1217
26760,20739,2492,10063,1684,18247,2440,1223,1217
26765,20740,2492,10064,1684,18248,2440,1223,1217
26770,20745,2493,10068,1685,18252,2440,1223,1217
26775,20747,2493,10068,1685,18254,2441,1223,1218
26780,20755,2494,10070,1685,18261,2441,1223,1218
26785,20758,2495,10072,1686,18263,2441,1223,1218
26790,20763,2495,10076,1686,18268,2441,1223,1218
26795,20767,2495,10077,1686,18272,2441,1223,1218
26800,20770,2495,10078,1686,18275,2441,1223,1218
26805,20771,2495,10078,1686,18276,2441,1223,1218
26810,20776,2496,10079,1687,18280,2442,1223,1219
26815,20778,2496,10080,1687,18282,2443,1223,1220
26820,20786,2497,10083,1687,18289,2444,1223,1221
26825,20789,2498,10084,1688,18291,2445,1223,1222
26830,20794,2499,10087,1689,18295,2446,1223,1223
26835,20798,2499,10089,1689,18298,2446,1223,1223
26840,20801,2500,10092,1690,18301,2446,1223,1223
26845,20802,2500,10092,1690,18302,2446,1223,1223
26850,20807,2501,10095,1690,18306,2447,1224,1223
26855,20809,2501,10096,1690,18308,2448,1224,1224
26860,20817,2503,10101,1691,18314,2449,1225,1224
26865,20820,2503,10102,1691,18317,2450,1225,1225
26870,20825,2504,10105,1692,18321,2451,1226,1225
26875,20829,2504,10106,1692,18325,2453,1226,1227
26880,20832,2506,10109,1694,18326,2453,1226,1227
26885,20833,2506,10109,1694,18327,2453,1226,1227
26890,20838,2507,10113,1695,18331,2454,1227,1227
26895,20840,2507,10113,1695,18333,2455,1227,1228
26900,20848,2508,10119,1695,18340,2455,1227,1228
26905,20851,2509,10120,1696,18342,2456,1227,1229
26910,20856,2509,10124,1696,18347,2456,1227,1229
26915,20860,2509,10124,1696,18351,2457,1227,1230
26920,20863,2509,10127,1696,18354,2457,1227,1230
26925,20864,2509,10128,1696,18355,2457,1227,1230
26930,20869,2510,10130,1696,18359,2458,1227,1231
26935,20871,2510,10130,1696,18361,2459,1227,1232
26940,20879,2511,10133,1696,18367,2460,1228,1232
26945,20882,2513,10134,1698,18369,2461,1228,1233
26950,20887,2513,10136,1698,18374,2461,1228,1233
26955,20891,2513,10138,1698,18378,2462,1228,1234
26960,20894,2513,10138,1698,18381,2462,1228,1234
26965,20895,2513,10139,1698,18382,2462,1228,1234
26970,20900,2514,10142,1698,18386,2462,1228,1234
26975,20902,2514,10144,1698,18388,2463,1229,1234
26980,20910,2515,10149,1699,18395,2463,1229,1234
26985,20913,2516,10151,1700,18397,2464,1229,1235
26990,20918,2517,10152,1700,18401,2465,1229,1236
26995,20922,2517,10154,1700,18404,2467,1229,1238
27000,20925,2519,10155,1702,18406,2467,1229,1238
27005,20926,2520,10156,1703,18406,2467,1229,1238
27010,20931,2521,10158,1703,18410,2467,1229,1238
27015,20933,2521,10160,1703,18412,2468,1230,1238
27020,20941,2521,10163,1703,18420,2469,1230,1239
27025,20944,2521,10163,1703,18423,2469,1230,1239
27030,20949,2521,10164,1703,18428,2469,1230,1239
27035,20953,2521,10166,1703,18431,2469,1230,1239
27040,20956,2522,10168,1704,18434,2469,1230,1239
27045,20957,2522,10168,1704,18435,2469,1230,1239
27050,20962,2523,10169,1704,18439,2469,1230,1239
27055,20964,2523,10169,1704,18441,2470,1230,1240
27060,20972,2524,10175,1705,18448,2471,1230,1241
27065,20975,2524,10176,1705,18451,2471,1230,1241
27070,20980,2524,10178,1705,18456,2471,1230,1241
27075,20984,2524,10181,1705,18460,2471,1230,1241
27080,20987,2524,10181,1705,18463,2471,1230,1241
27085,20988,2524,10182,1705,18464,2471,1230,1241
27090,20993,2524,10185,1705,18469,2472,1231,1241
27095,20995,2524,10186,1705,18471,2473,1231,1242
27100,21003,2524,10189,1705,18479,2474,1232,1242
27105,21006,2524,10192,1705,18482,2474,1232,1242
27110,21011,2525,10193,1705,18486,2475,1232,1243
27115,21015,2525,10193,1705,18490,2477,1232,1245
27120,21018,2525,10193,1705,18493,2477,1232,1245
27125,21019,2525,10193,1705,18494,2477,1232,1245
27130,21024,2525,10196,1705,18499,2478,1232,1246
27135,21026,2525,10197,1705,18501,2479,1232,1247
27140,21034,2526,10200,1706,18508,2479,1232,1247
27145,21037,2527,10201,1707,18510,2479,1232,1247
27150,21042,2528,10203,1707,18514,2480,1232,1248
27155,21046,2528,10205,1707,18518,2481,1233,1248
27160,21049,2529,10208,1708,18520,2481,1233,1248
27165,21050,2529,10208,1708,18521,2481,1233,1248
27170,21055,2530,10212,1709,18525,2482,1234,1248
27175,21057,2530,10212,1709,18527,2483,1234,1249
27180,21065,2532,10216,1710,18533,2485,1235,1250
27185,21068,2532,10216,1710,18536,2485,1235,1250
27190,21073,2533,10218,1711,18540,2485,1235,1250
27195,21077,2533,10220,1711,18544,2486,1235,1251
27200,21080,2533,10221,1711,18547,2486,1235,1251
27205,21081,2533,10221,1711,18548,2486,1235,1251
27210,21086,2535,10226,1713,18551,2486,1235,1251
27215,21088,2535,10227,1713,18553,2487,1236,1251
27220,21096,2536,10230,1714,18560,2488,1237,1251
27225,21099,2536,10230,1714,18563,2489,1237,1252
27230,21104,2537,10234,1715,18567,2489,1237,1252
27235,21108,2537,10234,1715,18571,2491,1237,1254
27240,21111,2537,10236,1715,18574,2491,1237,1254
27245,21112,2537,10237,1715,18575,2491,1237,1254
27250,21117,2538,10239,1716,18579,2491,1237,1254
27255,21119,2538,10239,1716,18581,2492,1237,1255
27260,21127,2540,10244,1718,18586,2493,1238,1255
27265,21130,2542,10247,1720,18588,2494,1239,1255
27270,21135,2544,10250,1721,18591,2494,1239,1255
27275,21139,2544,10252,1721,18595,2495,1239,1256
27280,21142,2544,10252,1721,18598,2495,1239,1256
27285,21143,2544,10252,1721,18599,2495,1239,1256
27290,21148,2545,10254,1721,18603,2495,1239,1256
27295,21150,2545,10255,1721,18605,2496,1239,1257
27300,21158,2546,10259,1722,18611,2498,1240,1258
27305,21161,2548,10260,1724,18613,2499,1240,1259
27310,21166,2548,10262,1724,18618,2500,1241,1259
27315,21170,2548,10263,1724,18622,2500,1241,1259
27320,21173,2548,10263,1724,18625,2500,1241,1259
27325,21174,2548,10263,1724,18626,2500,1241,1259
27330,21179,2549,10267,1725,18630,2501,1242,1259
27335,21181,2549,10268,1725,18632,2502,1243,1259
27340,21189,2550,10272,1725,18639,2502,1243,1259
27345,21192,2550,10272,1725,18642,2503,1243,1260
27350,21197,2550,10273,1725,18647,2504,1243,1261
27355,21201,2550,10276,1725,18651,2504,1243,1261
27360,21204,2550,10277,1725,18654,2504,1243,1261
27365,21205,2550,10277,1725,18655,2504,1243,1261
27370,21210,2551,10279,1726,18659,2505,1243,1262
27375,21212,2551,10281,1726,18661,2506,1244,1262
27380,21220,2552,10286,1727,18668,2506,1244,1262
27385,21223,2553,10288,1728,18670,2507,1244,1263
27390,21228,2554,10292,1729,18674,2508,1244,1264
27395,21232,2554,10294,1729,18678,2508,1244,1264
27400,21235,2555,10297,1730,18680,2508,1244,1264
27405,21236,2556,10298,1731,18680,2508,1244,1264
27410,21241,2557,10300,1731,18684,2509,1245,1264
27415,21243,2557,10301,1731,18686,2510,1246,1264
27420,21251,2560,10306,1733,18690,2512,1247,1265
27425,21254,2562,10308,1735,18692,2512,1247,1265
27430,21259,2563,10312,1736,18696,2512,1247,1265
27435,21263,2563,10312,1736,18700,2513,1247,1266
27440,21266,2564,10314,1737,18702,2513,1247,1266
27445,21267,2564,10314,1737,18703,2513,1247,1266
27450,21272,2565,10316,1738,18707,2514,1247,1267
27455,21274,2565,10316,1738,18709,2515,1247,1268
27460,21282,2566,10317,1738,18716,2515,1247,1268
27465,21285,2566,10319,1738,18719,2515,1247,1268
27470,21290,2567,10323,1739,18723,2515,1247,1268
27475,21294,2567,10325,1739,18727,2517,1249,1268
27480,21297,2569,10327,1741,18728,2517,1249,1268
27485,21298,2569,10327,1741,18729,2517,1249,1268
27490,21303,2570,10328,1741,18733,2518,1249,1269
27495,21305,2570,10329,1741,18735,2519,1250,1269
27500,21313,2571,10333,1742,18742,2519,1250,1269
27505,21316,2571,10333,1742,18745,2520,1250,1270
27510,21321,2571,10333,1742,18750,2520,1250,1270
27515,21325,2571,10335,1742,18754,2521,1251,1270
27520,21328,2571,10336,1742,18757,2521,1251,1270
27525,21329,2571,10336,1742,18758,2521,1251,1270
27530,21334,2572,10339,1742,18762,2522,1252,1270
27535,21336,2572,10341,1742,18764,2523,1253,1270
27540,21344,2575,10346,1745,18768,2525,1253,1272
27545,21347,2576,10348,1746,18771,2525,1253,1272
27550,21352,2576,10350,1746,18776,2526,1253,1273
27555,21356,2576,10350,1746,18780,2526,1253,1273
27560,21359,2576,10352,1746,18783,2526,1253,1273
27565,21360,2576,10353,1746,18784,2526,1253,1273
27570,21365,2577,10355,1747,18788,2526,1253,1273
27575,21367,2577,10356,1747,18790,2527,1254,1273
27580,21375,2579,10360,1748,18796,2528,1254,1274
27585,21378,2579,10361,1748,18799,2528,1254,1274
27590,21383,2580,10365,1749,18803,2529,1255,1274
27595,21387,2580,10367,1749,18806,2530,1255,1275
27600,21390,2581,10368,1750,18809,2530,1255,1275
27605,21391,2582,10369,1751,18809,2530,1255,1275
27610,21396,2583,10371,1751,18813,2530,1255,1275
27615,21398,2583,10373,1751,18815,2531,1256,1275
27620,21406,2584,10377,1752,18822,2531,1256,1275
27625,21409,2584,10377,1752,18825,2531,1256,1275
27630,21414,2585,10380,1752,18829,2531,1256,1275
27635,21418,2585,10381,1752,18833,2532,1257,1275
27640,21421,2585,10382,1752,18836,2532,1257,1275
27645,21422,2585,10382,1752,18837,2532,1257,1275
27650,21427,2586,10383,1752,18841,2533,1258,1275
27655,21429,2586,10385,1752,18843,2534,1259,1275
27660,21437,2588,10391,1754,18849,2535,1259,1276
27665,21440,2588,10391,1754,18852,2536,1259,1277
27670,21445,2589,10393,1754,18856,2536,1259,1277
27675,21449,2589,10396,1754,18860,2536,1259,1277
27680,21452,2589,10399,1754,18863,2536,1259,1277
27685,21453,2589,10400,1754,18864,2536,1259,1277
27690,21458,2590,10401,1755,18868,2537,1259,1278
27695,21460,2590,10403,1755,18870,2538,1260,1278
27700,21468,2590,10409,1755,18878,2538,1260,1278
27705,21471,2590,10411,1755,18881,2539,1261,1278
27710,21476,2591,10416,1756,18885,2539,1261,1278
27715,21480,2591,10418,1756,18889,2539,1261,1278
27720,21483,2591,10420,1756,18892,2539,1261,1278
27725,21484,2591,10421,1756,18893,2539,1261,1278
27730,21489,2592,10421,1756,18897,2540,1261,1279
27735,21491,2592,10422,1756,18899,2541,1262,1279
27740,21499,2592,10424,1756,18907,2541,1262,1279
27745,21502,2592,10426,1756,18910,2542,1263,1279
27750,21507,2593,10427,1756,18914,2542,1263,1279
27755,21511,2593,10429,1756,18918,2542,1263,1279
27760,21514,2593,10429,1756,18921,2542,1263,1279
27765,21515,2593,10429,1756,18922,2542,1263,1279
27770,21520,2594,10432,1756,18926,2543,1264,1279
27775,21522,2594,10433,1756,18928,2544,1264,1280
27780,21530,2597,10438,1758,18933,2546,1266,1280
27785,21533,2597,10439,1758,18936,2547,1267,1280
27790,21538,2598,10440,1758,18940,2548,1267,1281
27795,21542,2598,10443,1758,18944,2548,1267,1281
27800,21545,2598,10444,1758,18947,2548,1267,1281
27805,21546,2598,10444,1758,18948,2548,1267,1281
27810,21551,2598,10447,1758,18953,2549,1268,1281
27815,21553,2598,10449,1758,18955,2550,1269,1281
27820,21561,2599,10452,1758,18962,2551,1270,1281
27825,21564,2599,10453,1758,18965,2552,1270,1282
27830,21569,2600,10458,1759,18969,2553,1271,1282
27835,21573,2600,10461,1759,18973,2553,1271,1282
27840,21576,2600,10463,1759,18976,2553,1271,1282
27845,21577,2600,10463,1759,18977,2553,1271,1282
27850,21582,2600,10466,1759,18982,2554,1272,1282
27855,21584,2600,10468,1759,18984,2555,1273,1282
27860,21592,2601,10472,1760,18991,2555,1273,1282
27865,21595,2601,10472,1760,18994,2556,1273,1283
27870,21600,2602,10475,1761,18998,2556,1273,1283
27875,21604,2602,10477,1761,19002,2556,1273,1283
27880,21607,2602,10480,1761,19005,2556,1273,1283
27885,21608,2602,10481,1761,19006,2556,1273,1283
27890,21613,2603,10485,1762,19010,2557,1273,1284
27895,21615,2603,10487,1762,19012,2558,1274,1284
27900,21623,2605,10490,1764,19018,2559,1274,1285
27905,21626,2605,10490,1764,19021,2559,1274,1285
27910,21631,2606,10494,1764,19025,2559,1274,1285
27915,21635,2606,10494,1764,19029,2559,1274,1285
27920,21638,2606,10495,1764,19032,2559,1274,1285
27925,21639,2607,10496,1765,19032,2559,1274,1285
27930,21644,2608,10500,1766,19036,2559,1274,1285
27935,21646,2608,10501,1766,19038,2560,1275,1285
27940,21654,2608,10506,1766,19046,2560,1275,1285
27945,21657,2608,10507,1766,19049,2560,1275,1285
27950,21662,2609,10511,1767,19053,2560,1275,1285
27955,21666,2609,10513,1767,19057,2560,1275,1285
27960,21669,2609,10515,1767,19060,2560,1275,1285
27965,21670,2610,10516,1768,19060,2560,1275,1285
27970,21675,2611,10516,1768,19064,2560,1275,1285
27975,21677,2611,10517,1768,19066,2561,1275,1286
27980,21685,2611,10521,1768,19074,2561,1275,1286
27985,21688,2611,10523,1768,19077,2561,1275,1286
27990,21693,2612,10526,1769,19081,2561,1275,1286
27995,21697,2612,10527,1769,19085,2561,1275,1286
28000,21700,2612,10529,1769,19088,2561,1275,1286
28005,21701,2613,10530,1770,19088,2561,1275,1286
28010,21706,2614,10534,1771,19092,2561,1275,1286
28015,21708,2614,10535,1771,19094,2562,1276,1286
28020,21716,2615,10537,1771,19101,2564,1277,1287
28025,21719,2616,10539,1772,19103,2565,1278,1287
28030,21724,2617,10541,1772,19107,2566,1279,1287
28035,21728,2617,10542,1772,19111,2566,1279,1287
28040,21731,2617,10543,1772,19114,2566,1279,1287
28045,21732,2617,10543,1772,19115,2566,1279,1287
28050,21737,2617,10545,1772,19120,2567,1280,1287
28055,21739,2617,10546,1772,19122,2568,1281,1287
28060,21747,2618,10550,1773,19129,2569,1282,1287
28065,21750,2618,10550,1773,19132,2570,1282,1288
28070,21755,2619,10553,1774,19136,2571,1283,1288
28075,21759,2619,10555,1774,19140,2571,1283,1288
28080,21762,2619,10557,1774,19143,2571,1283,1288
28085,21763,2619,10558,1774,19144,2571,1283,1288
28090,21768,2619,10560,1774,19149,2572,1283,1289
28095,21770,2619,10561,1774,19151,2573,1284,1289
28100,21778,2620,10565,1775,19158,2574,1285,1289
28105,21781,2620,10566,1775,19161,2575,1286,1289
28110,21786,2621,10568,1775,19165,2576,1287,1289
28115,21790,2621,10570,1775,19169,2576,1287,1289
28120,21793,2621,10571,1775,19172,2576,1287,1289
28125,21794,2621,10571,1775,19173,2576,1287,1289
28130,21799,2622,10572,1775,19177,2577,1288,1289
28135,21801,2622,10572,1775,19179,2578,1288,1290
28140,21809,2624,10575,1777,19184,2580,1288,1292
28145,21812,2625,10575,1778,19187,2580,1288,1292
28150,21817,2626,10578,1779,19191,2580,1288,1292
28155,21821,2626,10581,1779,19195,2580,1288,1292
28160,21824,2626,10582,1779,19198,2580,1288,1292
28165,21825,2626,10582,1779,19199,2580,1288,1292
28170,21830,2627,10586,1780,19203,2580,1288,1292
28175,21832,2627,10587,1780,19205,2581,1288,1293
28180,21840,2627,10593,1780,19213,2581,1288,1293
28185,21843,2627,10596,1780,19216,2581,1288,1293
28190,21848,2628,10600,1781,19220,2581,1288,1293
28195,21852,2628,10601,1781,19224,2581,1288,1293
28200,21855,2628,10603,1781,19227,2581,1288,1293
28205,21856,2628,10603,1781,19228,2581,1288,1293
28210,21861,2629,10606,1781,19232,2581,1288,1293
28215,21863,2629,10607,1781,19234,2582,1288,1294
28220,21871,2629,10612,1781,19242,2582,1288,1294
28225,21874,2629,10612,1781,19245,2582,1288,1294
28230,21879,2630,10615,1782,19249,2582,1288,1294
28235,21883,2630,10618,1782,19253,2582,1288,1294
28240,21886,2630,10619,1782,19256,2582,1288,1294
28245,21887,2630,10619,1782,19257,2582,1288,1294
28250,21892,2631,10624,1783,19261,2582,1288,1294
28255,21894,2631,10625,1783,19263,2583,1289,1294
28260,21902,2633,10629,1785,19269,2584,1289,1295
28265,21905,2633,10629,1785,19272,2584,1289,1295
28270,21910,2634,10630,1785,19276,2584,1289,1295
28275,21914,2634,10633,1785,19280,2584,1289,1295
28280,21917,2634,10636,1785,19283,2584,1289,1295
28285,21918,2634,10637,1785,19284,2584,1289,1295
28290,21923,2634,10640,1785,19289,2585,1290,1295
28295,21925,2634,10640,1785,19291,2586,1290,1296
28300,21933,2635,10645,1786,19298,2586,1290,1296
28305,21936,2636,10648,1787,19300,2586,1290,1296
28310,21941,2637,10650,1788,19304,2586,1290,1296
28315,21945,2637,10653,1788,19308,2586,1290,1296
28320,21948,2637,10654,1788,19311,2586,1290,1296
28325,21949,2637,10654,1788,19312,2586,1290,1296
28330,21954,2637,10657,1788,19317,2587,1291,1296
28335,21956,2637,10658,1788,19319,2588,1291,1297
28340,21964,2638,10661,1789,19326,2588,1291,1297
28345,21967,2639,10663,1790,19328,2588,1291,1297
28350,21972,2640,10665,1790,19332,2588,1291,1297
28355,21976,2640,10666,1790,19336,2588,1291,1297
28360,21979,2640,10668,1790,19339,2588,1291,1297
28365,21980,2640,10669,1790,19340,2588,1291,1297
28370,21985,2641,10672,1790,19344,2589,1291,1298
28375,21987,2641,10673,1790,19346,2590,1291,1299
28380,21995,2642,10675,1790,19353,2592,1292,1300
28385,21998,2642,10675,1790,19356,2593,1292,1301
28390,22003,2643,10678,1791,19360,2593,1292,1301
28395,22007,2643,10680,1791,19364,2594,1292,1302
28400,22010,2643,10681,1791,19367,2594,1292,1302
28405,22011,2643,10681,1791,19368,2594,1292,1302
28410,22016,2644,10685,1792,19372,2594,1292,1302
28415,22018,2644,10686,1792,19374,2595,1293,1302
28420,22026,2644,10689,1792,19382,2595,1293,1302
28425,22029,2644,10691,1792,19385,2596,1294,1302
28430,22034,2645,10693,1793,19389,2596,1294,1302
28435,22038,2645,10694,1793,19392,2597,1294,1303
28440,22041,2647,10695,1795,19394,2597,1294,1303
28445,22042,2647,10695,1795,19395,2597,1294,1303
28450,22047,2648,10697,1795,19399,2597,1294,1303
28455,22049,2648,10699,1795,19401,2598,1295,1303
28460,22057,2648,10703,1795,19409,2598,1295,1303
28465,22060,2648,10705,1795,19412,2598,1295,1303
28470,22065,2649,10707,1796,19416,2598,1295,1303
28475,22069,2649,10708,1796,19420,2598,1295,1303
28480,22072,2649,10709,1796,19423,2598,1295,1303
28485,22073,2649,10709,1796,19424,2598,1295,1303
28490,22078,2650,10710,1796,19428,2599,1296,1303
28495,22080,2650,10711,1796,19430,2600,1297,1303
28500,22088,2652,10715,1798,19436,2602,1297,1305
28505,22091,2653,10717,1799,19438,2602,1297,1305
28510,22096,2654,10720,1799,19442,2602,1297,1305
28515,22100,2654,10721,1799,19446,2603,1297,1306
28520,22103,2654,10722,1799,19449,2603,1297,1306
28525,22104,2655,10723,1800,19449,2603,1297,1306
28530,22109,2656,10724,1800,19453,2604,1298,1306
28535,22111,2656,10726,1800,19455,2605,1299,1306
28540,22119,2657,10731,1800,19462,2605,1299,1306
28545,22122,2658,10732,1801,19464,2605,1299,1306
28550,22127,2659,10733,1801,19468,2605,1299,1306
28555,22131,2659,10735,1801,19472,2606,1299,1307
28560,22134,2660,10736,1802,19474,2606,1299,1307
28565,22135,2661,10737,1803,19474,2606,1299,1307
28570,22140,2662,10738,1803,19478,2607,1299,1308
28575,22142,2662,10738,1803,19480,2608,1299,1309
28580,22150,2663,10741,1804,19487,2608,1299,1309
28585,22153,2664,10742,1805,19489,2608,1299,1309
28590,22158,2665,10745,1806,19493,2608,1299,1309
28595,22162,2665,10746,1806,19497,2609,1299,1310
28600,22165,2665,10747,1806,19500,2609,1299,1310
28605,22166,2665,10747,1806,19501,2609,1299,1310
28610,22171,2666,10749,1807,19505,2610,1300,1310
28615,22173,2666,10750,1807,19507,2611,1300,1311
28620,22181,2669,10754,1809,19511,2613,1300,1313
28625,22184,2670,10756,1810,19514,2613,1300,1313
28630,22189,2671,10757,1811,19518,2614,1300,1314
28635,22193,2671,10759,1811,19522,2615,1300,1315
28640,22196,2671,10759,1811,19525,2615,1300,1315
28645,22197,2671,10759,1811,19526,2615,1300,1315
28650,22202,2672,10761,1811,19530,2615,1300,1315
28655,22204,2672,10763,1811,19532,2616,1301,1315
28660,22212,2672,10768,1811,19540,2616,1301,1315
28665,22215,2672,10768,1811,19543,2616,1301,1315
28670,22220,2673,10770,1811,19547,2617,1301,1316
28675,22224,2673,10772,1811,19551,2618,1302,1316
28680,22227,2673,10773,1811,19554,2618,1302,1316
28685,22228,2673,10773,1811,19555,2618,1302,1316
28690,22233,2674,10776,1812,19559,2618,1302,1316
28695,22235,2674,10777,1812,19561,2619,1302,1317
28700,22243,2674,10779,1812,19569,2621,1304,1317
28705,22246,2674,10781,1812,19572,2621,1304,1317
28710,22251,2675,10782,1813,19576,2622,1304,1318
28715,22255,2675,10784,1813,19580,2623,1305,1318
28720,22258,2675,10785,1813,19583,2623,1305,1318
28725,22259,2675,10785,1813,19584,2623,1305,1318
28730,22264,2676,10788,1813,19588,2623,1305,1318
28735,22266,2676,10789,1813,19590,2624,1306,1318
28740,22274,2676,10793,1813,19598,2626,1308,1318
28745,22277,2676,10795,1813,19601,2627,1309,1318
28750,22282,2677,10798,1814,19605,2627,1309,1318
28755,22286,2677,10799,1814,19609,2628,1309,1319
28760,22289,2677,10801,1814,19612,2628,1309,1319
28765,22290,2677,10801,1814,19613,2628,1309,1319
28770,22295,2678,10802,1814,19617,2628,1309,1319
28775,22297,2678,10802,1814,19619,2629,1309,1320
28780,22305,2679,10805,1815,19626,2629,1309,1320
28785,22308,2679,10807,1815,19629,2630,1310,1320
28790,22313,2680,10808,1815,19633,2630,1310,1320
28795,22317,2680,10811,1815,19637,2631,1311,1320
28800,22320,2681,10813,1816,19639,2631,1311,1320
28805,22321,2682,10814,1817,19639,2631,1311,1320
28810,22326,2683,10816,1818,19643,2631,1311,1320
28815,22328,2683,10817,1818,19645,2632,1311,1321
28820,22336,2684,10821,1819,19652,2632,1311,1321
28825,22339,2684,10821,1819,19655,2633,1311,1322
28830,22344,2685,10824,1819,19659,2633,1311,1322
28835,22348,2685,10826,1819,19663,2633,1311,1322
28840,22351,2685,10827,1819,19666,2633,1311,1322
28845,22352,2685,10827,1819,19667,2633,1311,1322
28850,22357,2686,10829,1819,19671,2634,1311,1323
28855,22359,2686,10829,1819,19673,2635,1311,1324
28860,22367,2687,10832,1819,19680,2635,1311,1324
28865,22370,2687,10834,1819,19683,2636,1312,1324
28870,22375,2688,10837,1820,19687,2637,1313,1324
28875,22379,2688,10839,1820,19691,2637,1313,1324
28880,22382,2688,10841,1820,19694,2637,1313,1324
28885,22383,2688,10841,1820,19695,2637,1313,1324
28890,22388,2689,10845,1821,19699,2638,1314,1324
28895,22390,2689,10847,1821,19701,2639,1315,1324
28900,22398,2690,10852,1821,19708,2640,1316,1324
28905,22401,2691,10854,1822,19710,2641,1316,1325
28910,22406,2692,10855,1822,19714,2642,1317,1325
28915,22410,2692,10858,1822,19718,2643,1318,1325
28920,22413,2692,10859,1822,19721,2643,1318,1325
28925,22414,2693,10860,1823,19721,2643,1318,1325
28930,22419,2694,10862,1823,19725,2644,1319,1325
28935,22421,2694,10863,1823,19727,2645,1320,1325
28940,22429,2695,10867,1824,19734,2645,1320,1325
28945,22432,2695,10868,1824,19737,2646,1320,1326
28950,22437,2696,10871,1825,19741,2646,1320,1326
28955,22441,2696,10872,1825,19745,2647,1321,1326
28960,22444,2696,10874,1825,19748,2647,1321,1326
28965,22445,2697,10875,1826,19748,2647,1321,1326
28970,22450,2698,10877,1827,19752,2648,1321,1327
28975,22452,2698,10878,1827,19754,2649,1322,1327
28980,22460,2700,10882,1829,19759,2649,1322,1327
28985,22463,2701,10883,1830,19762,2649,1322,1327
28990,22468,2702,10886,1831,19766,2649,1322,1327
28995,22472,2702,10887,1831,19770,2650,1322,1328
29000,22475,2702,10888,1831,19773,2650,1322,1328
29005,22476,2703,10889,1832,19773,2650,1322,1328
29010,22481,2704,10890,1832,19777,2650,1322,1328
29015,22483,2704,10890,1832,19779,2651,1322,1329
29020,22491,2705,10894,1832,19786,2651,1322,1329
29025,22494,2705,10895,1832,19789,2651,1322,1329
29030,22499,2706,10897,1833,19793,2651,1322,1329
29035,22503,2706,10899,1833,19797,2652,1323,1329
29040,22506,2706,10899,1833,19800,2652,1323,1329
29045,22507,2707,10900,1834,19800,2652,1323,1329
29050,22512,2708,10903,1835,19804,2652,1323,1329
29055,22514,2708,10904,1835,19806,2653,1323,1330
29060,22522,2709,10908,1835,19813,2653,1323,1330
29065,22525,2709,10908,1835,19816,2653,1323,1330
29070,22530,2710,10909,1835,19820,2653,1323,1330
29075,22534,2710,10911,1835,19824,2654,1324,1330
29080,22537,2710,10913,1835,19827,2654,1324,1330
29085,22538,2711,10914,1836,19827,2654,1324,1330
29090,22543,2712,10918,1837,19831,2655,1325,1330
29095,22545,2712,10919,1837,19833,2656,1325,1331
29100,22553,2713,10923,1838,19840,2657,1326,1331
29105,22556,2713,10923,1838,19843,2657,1326,1331
29110,22561,2714,10926,1839,19847,2658,1327,1331
29115,22565,2714,10929,1839,19850,2658,1327,1331
29120,22568,2715,10930,1840,19853,2658,1327,1331
29125,22569,2715,10930,1840,19854,2658,1327,1331
29130,22574,2716,10935,1841,19858,2659,1328,1331
29135,22576,2716,10935,1841,19860,2660,1328,1332
29140,22584,2717,10940,1841,19867,2660,1328,1332
29145,22587,2718,10943,1842,19869,2660,1328,1332
29150,22592,2719,10945,1842,19873,2660,1328,1332
29155,22596,2719,10947,1842,19876,2661,1329,1332
29160,22599,2720,10948,1843,19879,2661,1329,1332
29165,22600,2720,10948,1843,19880,2661,1329,1332
29170,22605,2721,10950,1844,19884,2662,1329,1333
29175,22607,2721,10951,1844,19886,2663,1329,1334
29180,22615,2721,10953,1844,19894,2663,1329,1334
29185,22618,2721,10955,1844,19897,2663,1329,1334
29190,22623,2722,10958,1845,19901,2663,1329,1334
29195,22627,2722,10961,1845,19905,2664,1330,1334
29200,22630,2722,10963,1845,19908,2664,1330,1334
29205,22631,2722,10963,1845,19909,2664,1330,1334
29210,22636,2723,10966,1845,19913,2665,1331,1334
29215,22638,2723,10968,1845,19915,2666,1332,1334
29220,22646,2723,10972,1845,19923,2667,1333,1334
29225,22649,2723,10974,1845,19926,2667,1333,1334
29230,22654,2724,10975,1846,19930,2667,1333,1334
29235,22658,2724,10976,1846,19934,2669,1334,1335
29240,22661,2724,10977,1846,19937,2669,1334,1335
29245,22662,2724,10977,1846,19938,2669,1334,1335
29250,22667,2725,10982,1847,19942,2669,1334,1335
29255,22669,2725,10982,1847,19944,2670,1334,1336
29260,22677,2725,10987,1847,19952,2670,1334,1336
29265,22680,2725,10987,1847,19955,2670,1334,1336
29270,22685,2726,10992,1848,19959,2670,1334,1336
29275,22689,2726,10992,1848,19963,2672,1334,1338
29280,22692,2727,10993,1849,19965,2672,1334,1338
29285,22693,2727,10993,1849,19966,2672,1334,1338
29290,22698,2728,10996,1849,19970,2672,1334,1338
29295,22700,2728,10997,1849,19972,2673,1334,1339
29300,22708,2729,11001,1850,19978,2673,1334,1339
29305,22711,2730,11002,1851,19981,2674,1335,1339
29310,22716,2731,11005,1852,19985,2674,1335,1339
29315,22720,2731,11007,1852,19989,2674,1335,1339
29320,22723,2731,11008,1852,19992,2674,1335,1339
29325,22724,2731,11008,1852,19993,2674,1335,1339
29330,22729,2732,11009,1852,19997,2674,1335,1339
29335,22731,2732,11011,1852,19999,2675,1336,1339
29340,22739,2733,11015,1852,20006,2675,1336,1339
29345,22742,2734,11017,1853,20008,2676,1337,1339
29350,22747,2735,11019,1854,20012,2676,1337,1339
29355,22751,2735,11020,1854,20016,2676,1337,1339
29360,22754,2735,11023,1854,20019,2676,1337,1339
29365,22755,2735,11023,1854,20020,2676,1337,1339
29370,22760,2736,11026,1855,20024,2677,1338,1339
29375,22762,2736,11026,1855,20026,2678,1338,1340
29380,22770,2738,11032,1856,20031,2678,1338,1340
29385,22773,2739,11033,1857,20034,2679,1338,1341
29390,22778,2741,11036,1859,20037,2680,1338,1342
29395,22782,2741,11036,1859,20041,2682,1338,1344
29400,22785,2742,11038,1860,20043,2682,1338,1344
29405,22786,2742,11038,1860,20044,2682,1338,1344
29410,22791,2742,11041,1860,20049,2683,1338,1345
29415,22793,2742,11041,1860,20051,2684,1338,1346
29420,22801,2743,11046,1861,20058,2684,1338,1346
29425,22804,2744,11047,1862,20060,2684,1338,1346
29430,22809,2745,11049,1862,20064,2685,1339,1346
29435,22813,2745,11053,1862,20068,2686,1340,1346
29440,22816,2745,11053,1862,20071,2686,1340,1346
29445,22817,2745,11053,1862,20072,2686,1340,1346
29450,22822,2745,11056,1862,20077,2686,1340,1346
29455,22824,2745,11057,1862,20079,2687,1340,1347
29460,22832,2746,11062,1862,20086,2687,1340,1347
29465,22835,2747,11065,1863,20088,2687,1340,1347
29470,22840,2748,11066,1863,20092,2688,1340,1348
29475,22844,2748,11067,1863,20096,2689,1340,1349
29480,22847,2748,11067,1863,20099,2689,1340,1349
29485,22848,2748,11068,1863,20100,2689,1340,1349
29490,22853,2748,11072,1863,20105,2689,1340,1349
29495,22855,2748,11073,1863,20107,2690,1340,1350
29500,22863,2749,11078,1864,20114,2691,1341,1350
29505,22866,2749,11079,1864,20117,2691,1341,1350
29510,22871,2751,11083,1865,20120,2692,1342,1350
29515,22875,2751,11085,1865,20124,2694,1343,1351
29520,22878,2752,11087,1866,20126,2694,1343,1351
29525,22879,2753,11088,1867,20126,2694,1343,1351
29530,22884,2754,11092,1867,20130,2695,1344,1351
29535,22886,2754,11093,1867,20132,2696,1344,1352
29540,22894,2755,11096,1867,20139,2696,1344,1352
29545,22897,2756,11098,1868,20141,2696,1344,1352
29550,22902,2757,11101,1868,20145,2696,1344,1352
29555,22906,2757,11102,1868,20149,2696,1344,1352
29560,22909,2757,11104,1868,20152,2696,1344,1352
29565,22910,2758,11105,1869,20152,2696,1344,1352
29570,22915,2759,11107,1870,20156,2697,1344,1353
29575,22917,2759,11107,1870,20158,2698,1344,1354
29580,22925,2760,11112,1871,20165,2698,1344,1354
29585,22928,2761,11114,1872,20167,2698,1344,1354
29590,22933,2762,11115,1872,20171,2698,1344,1354
29595,22937,2762,11118,1872,20175,2698,1344,1354
29600,22940,2762,11121,1872,20178,2698,1344,1354
29605,22941,2763,11122,1873,20178,2698,1344,1354
29610,22946,2764,11124,1873,20182,2699,1345,1354
29615,22948,2764,11126,1873,20184,2700,1346,1354
29620,22956,2765,11131,1873,20191,2700,1346,1354
29625,22959,2766,11133,1874,20193,2700,1346,1354
29630,22964,2767,11133,1874,20197,2701,1346,1355
29635,22968,2767,11133,1874,20201,2703,1346,1357
29640,22971,2769,11136,1876,20202,2703,1346,1357
29645,22972,2769,11136,1876,20203,2703,1346,1357
29650,22977,2770,11139,1877,20207,2704,1346,1358
29655,22979,2770,11140,1877,20209,2705,1347,1358
29660,22987,2770,11145,1877,20216,2706,1348,1358
29665,22990,2771,11147,1878,20219,2707,1349,1358
29670,22995,2772,11151,1879,20223,2707,1349,1358
29675,22999,2772,11151,1879,20227,2708,1349,1359
29680,23002,2772,11152,1879,20230,2708,1349,1359
29685,23003,2772,11152,1879,20231,2708,1349,1359
29690,23008,2773,11154,1879,20235,2709,1349,1360
29695,23010,2773,11156,1879,20237,2710,1350,1360
29700,23018,2773,11161,1879,20244,2710,1350,1360
29705,23021,2774,11163,1880,20247,2711,1351,1360
29710,23026,2775,11167,1881,20251,2711,1351,1360
29715,23030,2775,11168,1881,20255,2712,1351,1361
29720,23033,2775,11169,1881,20258,2712,1351,1361
29725,23034,2775,11169,1881,20259,2712,1351,1361
29730,23039,2776,11172,1881,20263,2712,1351,1361
29735,23041,2776,11173,1881,20265,2713,1352,1361
29740,23049,2776,11175,1881,20273,2713,1352,1361
29745,23052,2776,11177,1881,20276,2714,1352,1362
29750,23057,2777,11180,1882,20280,2714,1352,1362
29755,23061,2777,11182,1882,20283,2715,1352,1363
29760,23064,2778,11182,1883,20286,2715,1352,1363
29765,23065,2778,11182,1883,20287,2715,1352,1363
29770,23070,2779,11185,1884,20291,2715,1352,1363
29775,23072,2779,11186,1884,20293,2716,1353,1363
29780,23080,2780,11190,1885,20300,2716,1353,1363
29785,23083,2780,11190,1885,20303,2716,1353,1363
29790,23088,2780,11192,1885,20308,2717,1354,1363
29795,23092,2780,11195,1885,20312,2717,1354,1363
29800,23095,2780,11196,1885,20315,2717,1354,1363
29805,23096,2781,11197,1886,20315,2717,1354,1363
29810,23101,2782,11199,1886,20319,2717,1354,1363
29815,23103,2782,11201,1886,20321,2718,1355,1363
29820,23111,2783,11207,1887,20328,2718,1355,1363
29825,23114,2783,11208,1887,20331,2718,1355,1363
29830,23119,2783,11209,1887,20336,2719,1356,1363
29835,23123,2783,11212,1887,20339,2719,1356,1363
29840,23126,2784,11213,1888,20342,2719,1356,1363
29845,23127,2784,11213,1888,20343,2719,1356,1363
29850,23132,2785,11215,1889,20347,2720,1356,1364
29855,23134,2785,11217,1889,20349,2721,1357,1364
29860,23142,2786,11219,1889,20356,2722,1358,1364
29865,23145,2786,11220,1889,20359,2722,1358,1364
29870,23150,2787,11223,1889,20363,2723,1359,1364
29875,23154,2787,11225,1889,20367,2725,1360,1365
29880,23157,2788,11226,1890,20369,2725,1360,1365
29885,23158,2788,11227,1890,20370,2725,1360,1365
29890,23163,2788,11231,1890,20375,2726,1361,1365
29895,23165,2788,11232,1890,20377,2727,1362,1365
29900,23173,2789,11234,1891,20383,2727,1362,1365
29905,23176,2790,11235,1892,20386,2728,1363,1365
29910,23181,2791,11238,1893,20390,2728,1363,1365
29915,23185,2791,11238,1893,20394,2729,1363,1366
29920,23188,2791,11239,1893,20397,2729,1363,1366
29925,23189,2791,11239,1893,20398,2729,1363,1366
29930,23194,2791,11241,1893,20403,2730,1363,1367
29935,23196,2791,11241,1893,20405,2731,1363,1368
29940,23204,2792,11243,1893,20412,2731,1363,1368
29945,23207,2793,11245,1894,20414,2732,1363,1369
29950,23212,2794,11248,1895,20418,2732,1363,1369
29955,23216,2794,11251,1895,20422,2733,1364,1369
29960,23219,2795,11252,1896,20424,2733,1364,1369
29965,23220,2795,11253,1896,20425,2733,1364,1369
29970,23225,2795,11257,1896,20430,2733,1364,1369
29975,23227,2795,11257,1896,20432,2734,1364,1370
29980,23235,2796,11259,1897,20439,2734,1364,1370
29985,23238,2796,11259,1897,20442,2735,1364,1371
29990,23243,2797,11259,1897,20446,2736,1364,1372
29995,23247,2797,11261,1897,20449,2738,1364,1374
30000,23250,2798,11262,1898,20452,2738,1364,1374
30005,23251,2798,11263,1898,20453,2738,1364,1374
30010,23256,2798,11265,1898,20458,2738,1364,1374
30015,23258,2798,11266,1898,20460,2739,1365,1374
30020,23266,2799,11273,1899,20467,2739,1365,1374
30025,23269,2799,11275,1899,20470,2739,1365,1374
30030,23274,2800,11278,1900,20474,2739,1365,1374
30035,23278,2800,11280,1900,20478,2739,1365,1374
30040,23281,2800,11282,1900,20481,2739,1365,1374
30045,23282,2800,11283,1900,20482,2739,1365,1374
30050,23287,2800,11287,1900,20487,2739,1365,1374
30055,23289,2800,11287,1900,20489,2740,1365,1375
30060,23297,2801,11291,1901,20496,2740,1365,1375
30065,23300,2802,11294,1902,20498,2740,1365,1375
30070,23305,2803,11296,1903,20502,2741,1366,1375
30075,23309,2803,11296,1903,20506,2741,1366,1375
30080,23312,2803,11296,1903,20509,2741,1366,1375
30085,23313,2803,11296,1903,20510,2741,1366,1375
30090,23318,2803,11298,1903,20515,2742,1367,1375
30095,23320,2803,11299,1903,20517,2743,1367,1376
30100,23328,2804,11304,1904,20524,2743,1367,1376
30105,23331,2805,11306,1905,20526,2743,1367,1376
30110,23336,2807,11310,1907,20529,2744,1367,1377
30115,23340,2807,11311,1907,20532,2746,1367,1379
30120,23343,2809,11312,1909,20534,2746,1367,1379
30125,23344,2809,11313,1909,20535,2746,1367,1379
30130,23349,2810,11315,1910,20539,2746,1367,1379
30135,23351,2810,11315,1910,20541,2747,1367,1380
30140,23359,2810,11319,1910,20549,2747,1367,1380
30145,23362,2810,11320,1910,20552,2747,1367,1380
30150,23367,2810,11322,1910,20557,2747,1367,1380
30155,23371,2810,11323,1910,20561,2748,1367,1381
30160,23374,2810,11324,1910,20564,2748,1367,1381
30165,23375,2810,11324,1910,20565,2748,1367,1381
30170,23380,2811,11325,1910,20569,2748,1367,1381
30175,23382,2811,11326,1910,20571,2749,1368,1381
30180,23390,2811,11331,1910,20579,2749,1368,1381
30185,23393,2811,11332,1910,20582,2749,1368,1381
30190,23398,2811,11333,1910,20587,2749,1368,1381
30195,23402,2811,11334,1910,20591,2750,1368,1382
30200,23405,2811,11336,1910,20594,2750,1368,1382
30205,23406,2811,11337,1910,20595,2750,1368,1382
30210,23411,2812,11338,1911,20599,2750,1368,1382
30215,23413,2812,11339,1911,20601,2751,1368,1383
30220,23421,2812,11345,1911,20609,2751,1368,1383
30225,23424,2812,11346,1911,20612,2751,1368,1383
30230,23429,2813,11350,1912,20616,2752,1369,1383
30235,23433,2813,11351,1912,20620,2754,1370,1384
30240,23436,2815,11353,1914,20621,2754,1370,1384
30245,23437,2815,11354,1914,20622,2754,1370,1384
30250,23442,2816,11357,1915,20626,2754,1370,1384
30255,23444,2816,11358,1915,20628,2755,1371,1384
30260,23452,2817,11363,1916,20635,2755,1371,1384
30265,23455,2817,11364,1916,20638,2755,1371,1384
30270,23460,2817,11365,1916,20643,2755,1371,1384
30275,23464,2817,11366,1916,20647,2756,1371,1385
30280,23467,2817,11368,1916,20650,2756,1371,1385
30285,23468,2817,11368,1916,20651,2756,1371,1385
30290,23473,2818,11371,1917,20655,2756,1371,1385
30295,23475,2818,11371,1917,20657,2757,1371,1386
30300,23483,2819,11376,1917,20664,2757,1371,1386
30305,23486,2819,11377,1917,20667,2757,1371,1386
30310,23491,2819,11380,1917,20672,2757,1371,1386
30315,23495,2819,11383,1917,20676,2757,1371,1386
30320,23498,2819,11385,1917,20679,2757,1371,1386
30325,23499,2819,11385,1917,20680,2757,1371,1386
30330,23504,2820,11387,1918,20684,2757,1371,1386
30335,23506,2820,11387,1918,20686,2758,1371,1387
30340,23514,2821,11392,1919,20693,2759,1371,1388
30345,23517,2822,11395,1920,20695,2760,1372,1388
30350,23522,2823,11396,1921,20699,2761,1372,1389
30355,23526,2823,11400,1921,20702,2762,1373,1389
30360,23529,2824,11400,1922,20705,2762,1373,1389
30365,23530,2824,11401,1922,20706,2762,1373,1389
30370,23535,2825,11404,1923,20710,2763,1373,1390
30375,23537,2825,11404,1923,20712,2764,1373,1391
30380,23545,2825,11409,1923,20720,2765,1374,1391
30385,23548,2825,11411,1923,20723,2765,1374,1391
30390,23553,2826,11413,1924,20727,2766,1375,1391
30395,23557,2826,11416,1924,20731,2767,1376,1391
30400,23560,2827,11418,1925,20733,2767,1376,1391
30405,23561,2827,11418,1925,20734,2767,1376,1391
30410,23566,2828,11421,1925,20738,2768,1377,1391
30415,23568,2828,11421,1925,20740,2769,1377,1392
30420,23576,2828,11424,1925,20748,2770,1378,1392
30425,23579,2828,11425,1925,20751,2770,1378,1392
30430,23584,2829,11427,1926,20755,2770,1378,1392
30435,23588,2829,11428,1926,20759,2770,1378,1392
30440,23591,2829,11431,1926,20762,2770,1378,1392
30445,23592,2829,11432,1926,20763,2770,1378,1392
30450,23597,2830,11436,1927,20767,2771,1378,1393
30455,23599,2830,11436,1927,20769,2772,1378,1394
30460,23607,2830,11439,1927,20777,2772,1378,1394
30465,23610,2830,11440,1927,20780,2772,1378,1394
30470,23615,2831,11442,1927,20784,2772,1378,1394
30475,23619,2831,11445,1927,20787,2772,1378,1394
30480,23622,2833,11446,1929,20789,2772,1378,1394
30485,23623,2834,11447,1930,20789,2772,1378,1394
30490,23628,2835,11448,1931,20793,2772,1378,1394
30495,23630,2835,11450,1931,20795,2773,1379,1394
30500,23638,2836,11454,1931,20802,2773,1379,1394
30505,23641,2837,11457,1932,20804,2774,1380,1394
30510,23646,2838,11459,1932,20808,2774,1380,1394
30515,23650,2838,11461,1932,20812,2774,1380,1394
30520,23653,2838,11463,1932,20815,2774,1380,1394
30525,23654,2838,11463,1932,20816,2774,1380,1394
30530,23659,2839,11463,1932,20820,2774,1380,1394
30535,23661,2839,11464,1932,20822,2775,1380,1395
30540,23669,2840,11468,1932,20829,2775,1380,1395
30545,23672,2841,11470,1933,20831,2776,1381,1395
30550,23677,2842,11472,1934,20835,2776,1381,1395
30555,23681,2842,11473,1934,20839,2776,1381,1395
30560,23684,2842,11474,1934,20842,2776,1381,1395
30565,23685,2843,11475,1935,20842,2776,1381,1395
30570,23690,2844,11476,1935,20846,2776,1381,1395
30575,23692,2844,11477,1935,20848,2777,1381,1396
30580,23700,2845,11481,1935,20855,2777,1381,1396
30585,23703,2845,11482,1935,20858,2778,1381,1397
30590,23708,2846,11485,1936,20862,2778,1381,1397
30595,23712,2846,11487,1936,20865,2779,1382,1397
30600,23715,2848,11488,1938,20867,2779,1382,1397
30605,23716,2848,11489,1938,20868,2779,1382,1397
30610,23721,2848,11492,1938,20873,2780,1382,1398
30615,23723,2848,11493,1938,20875,2781,1382,1399
30620,23731,2849,11495,1939,20882,2782,1382,1400
30625,23734,2849,11495,1939,20885,2782,1382,1400
30630,23739,2850,11498,1940,20889,2782,1382,1400
30635,23743,2850,11500,1940,20893,2782,1382,1400
30640,23746,2850,11500,1940,20896,2782,1382,1400
30645,23747,2850,11500,1940,20897,2782,1382,1400
30650,23752,2850,11503,1940,20902,2783,1382,1401
30655,23754,2850,11503,1940,20904,2784,1382,1402
30660,23762,2851,11506,1941,20911,2786,1382,1404
30665,23765,2851,11507,1941,20914,2786,1382,1404
30670,23770,2851,11507,1941,20919,2787,1382,1405
30675,23774,2851,11508,1941,20923,2787,1382,1405
30680,23777,2851,11508,1941,20926,2787,1382,1405
30685,23778,2851,11508,1941,20927,2787,1382,1405
30690,23783,2851,11511,1941,20932,2787,1382,1405
30695,23785,2851,11511,1941,20934,2788,1382,1406
30700,23793,2851,11514,1941,20942,2789,1382,1407
30705,23796,2851,11516,1941,20945,2789,1382,1407
30710,23801,2851,11518,1941,20950,2790,1382,1408
30715,23805,2851,11521,1941,20953,2790,1382,1408
30720,23808,2852,11522,1942,20956,2790,1382,1408
30725,23809,2852,11523,1942,20957,2790,1382,1408
30730,23814,2853,11527,1942,20961,2790,1382,1408
30735,23816,2853,11529,1942,20963,2791,1383,1408
30740,23824,2855,11534,1943,20969,2792,1384,1408
30745,23827,2856,11535,1944,20971,2793,1384,1409
30750,23832,2856,11537,1944,20976,2793,1384,1409
30755,23836,2856,11541,1944,20980,2793,1384,1409
30760,23839,2856,11544,1944,20983,2793,1384,1409
30765,23840,2856,11544,1944,20984,2793,1384,1409
30770,23845,2857,11546,1944,20988,2793,1384,1409
30775,23847,2857,11546,1944,20990,2794,1384,1410
30780,23855,2859,11551,1946,20995,2795,1385,1410
30785,23858,2860,11552,1947,20998,2795,1385,1410
30790,23863,2861,11556,1948,21002,2795,1385,1410
30795,23867,2861,11558,1948,21006,2795,1385,1410
30800,23870,2861,11560,1948,21009,2795,1385,1410
30805,23871,2861,11560,1948,21010,2795,1385,1410
30810,23876,2862,11564,1949,21014,2795,1385,1410
30815,23878,2862,11566,1949,21016,2796,1386,1410
30820,23886,2863,11571,1949,21023,2797,1387,1410
30825,23889,2863,11571,1949,21026,2797,1387,1410
30830,23894,2864,11572,1949,21030,2798,1387,1411
30835,23898,2864,11574,1949,21034,2798,1387,1411
30840,23901,2864,11576,1949,21037,2798,1387,1411
30845,23902,2865,11577,1950,21037,2798,1387,1411
30850,23907,2866,11581,1951,21041,2798,1387,1411
30855,23909,2866,11583,1951,21043,2799,1388,1411
30860,23917,2867,11586,1952,21050,2801,1389,1412
30865,23920,2868,11588,1953,21052,2802,1389,1413
30870,23925,2869,11592,1954,21056,2803,1390,1413
30875,23929,2869,11593,1954,21060,2803,1390,1413
30880,23932,2869,11595,1954,21063,2803,1390,1413
30885,23933,2869,11595,1954,21064,2803,1390,1413
30890,23938,2870,11599,1955,21068,2804,1390,1414
30895,23940,2870,11600,1955,21070,2805,1391,1414
30900,23948,2872,11604,1956,21075,2807,1393,1414
30905,23951,2873,11605,1957,21078,2807,1393,1414
30910,23956,2874,11607,1958,21082,2807,1393,1414
30915,23960,2874,11609,1958,21086,2807,1393,1414
30920,23963,2874,11609,1958,21089,2807,1393,1414
30925,23964,2874,11610,1958,21090,2807,1393,1414
30930,23969,2874,11612,1958,21095,2807,1393,1414
30935,23971,2874,11612,1958,21097,2808,1393,1415
30940,23979,2875,11615,1958,21104,2808,1393,1415
30945,23982,2875,11617,1958,21107,2808,1393,1415
30950,23987,2876,11622,1959,21111,2808,1393,1415
30955,23991,2876,11625,1959,21115,2808,1393,1415
30960,23994,2876,11627,1959,21118,2808,1393,1415
30965,23995,2876,11627,1959,21119,2808,1393,1415
30970,24000,2876,11631,1959,21124,2808,1393,1415
30975,24002,2876,11631,1959,21126,2809,1393,1416
30980,24010,2877,11634,1960,21133,2810,1393,1417
30985,24013,2877,11634,1960,21136,2810,1393,1417
30990,24018,2879,11637,1961,21139,2811,1394,1417
30995,24022,2879,11640,1961,21143,2812,1394,1418
31000,24025,2880,11641,1962,21145,2812,1394,1418
31005,24026,2880,11642,1962,21146,2812,1394,1418
31010,24031,2881,11645,1963,21150,2812,1394,1418
31015,24033,2881,11647,1963,21152,2813,1395,1418
31020,24041,2883,11653,1965,21157,2815,1395,1420
31025,24044,2885,11656,1967,21159,2816,1396,1420
31030,24049,2886,11657,1967,21163,2816,1396,1420
31035,24053,2886,11659,1967,21167,2817,1397,1420
31040,24056,2886,11660,1967,21170,2817,1397,1420
31045,24057,2886,11660,1967,21171,2817,1397,1420
31050,24062,2887,11660,1967,21175,2817,1397,1420
31055,24064,2887,11661,1967,21177,2818,1398,1420
31060,24072,2888,11664,1968,21184,2818,1398,1420
31065,24075,2888,11665,1968,21187,2819,1399,1420
31070,24080,2889,11666,1969,21191,2819,1399,1420
31075,24084,2889,11669,1969,21195,2820,1399,1421
31080,24087,2889,11670,1969,21198,2820,1399,1421
31085,24088,2889,11670,1969,21199,2820,1399,1421
31090,24093,2890,11672,1969,21203,2820,1399,1421
31095,24095,2890,11674,1969,21205,2821,1400,1421
31100,24103,2892,11677,1971,21211,2821,1400,1421
31105,24106,2892,11678,1971,21214,2822,1401,1421
31110,24111,2893,11681,1972,21218,2822,1401,1421
31115,24115,2893,11682,1972,21222,2823,1402,1421
31120,24118,2894,11684,1973,21224,2823,1402,1421
31125,24119,2894,11684,1973,21225,2823,1402,1421
31130,24124,2895,11685,1973,21229,2824,1403,1421
31135,24126,2895,11686,1973,21231,2825,1404,1421
31140,24134,2897,11690,1975,21237,2827,1405,1422
31145,24137,2897,11690,1975,21240,2827,1405,1422
31150,24142,2898,11693,1975,21244,2827,1405,1422
31155,24146,2898,11694,1975,21248,2827,1405,1422
31160,24149,2898,11696,1975,21251,2827,1405,1422
31165,24150,2898,11696,1975,21252,2827,1405,1422
31170,24155,2898,11697,1975,21257,2828,1405,1423
31175,24157,2898,11698,1975,21259,2829,1406,1423
31180,24165,2898,11700,1975,21267,2829,1406,1423
31185,24168,2898,11700,1975,21270,2829,1406,1423
31190,24173,2899,11702,1976,21274,2829,1406,1423
31195,24177,2899,11705,1976,21277,2829,1406,1423
31200,24180,2900,11707,1977,21280,2829,1406,1423
31205,24181,2900,11707,1977,21281,2829,1406,1423
31210,24186,2900,11708,1977,21286,2829,1406,1423
31215,24188,2900,11710,1977,21288,2830,1407,1423
31220,24196,2900,11715,1977,21296,2830,1407,1423
31225,24199,2900,11716,1977,21299,2830,1407,1423
31230,24204,2901,11716,1977,21303,2830,1407,1423
31235,24208,2901,11718,1977,21307,2830,1407,1423
31240,24211,2901,11721,1977,21310,2830,1407,1423
31245,24212,2901,11721,1977,21311,2830,1407,1423
31250,24217,2902,11724,1977,21315,2830,1407,1423
31255,24219,2902,11725,1977,21317,2831,1407,1424
31260,24227,2903,11728,1977,21324,2833,1408,1425
31265,24230,2903,11729,1977,21327,2834,1409,1425
31270,24235,2904,11729,1977,21331,2835,1409,1426
31275,24239,2904,11732,1977,21335,2836,1410,1426
31280,24242,2904,11732,1977,21338,2836,1410,1426
31285,24243,2905,11733,1978,21338,2836,1410,1426
31290,24248,2906,11736,1979,21342,2836,1410,1426
31295,24250,2906,11737,1979,21344,2837,1411,1426
31300,24258,2907,11741,1980,21351,2838,1412,1426
31305,24261,2907,11742,1980,21354,2839,1412,1427
31310,24266,2908,11744,1981,21358,2840,1413,1427
31315,24270,2908,11748,1981,21362,2841,1414,1427
31320,24273,2908,11748,1981,21365,2841,1414,1427
31325,24274,2908,11748,1981,21366,2841,1414,1427
31330,24279,2909,11751,1982,21370,2841,1414,1427
31335,24281,2909,11751,1982,21372,2842,1414,1428
31340,24289,2910,11754,1982,21379,2843,1415,1428
31345,24292,2910,11754,1982,21382,2844,1415,1429
31350,24297,2911,11758,1983,21386,2845,1416,1429
31355,24301,2911,11761,1983,21390,2846,1417,1429
31360,24304,2912,11763,1984,21392,2846,1417,1429
31365,24305,2913,11764,1985,21392,2846,1417,1429
31370,24310,2914,11767,1986,21396,2847,1417,1430
31375,24312,2914,11767,1986,21398,2848,1417,1431
31380,24320,2915,11771,1986,21404,2850,1418,1432
31385,24323,2917,11773,1988,21406,2850,1418,1432
31390,24328,2918,11776,1988,21410,2850,1418,1432
31395,24332,2918,11779,1988,21414,2850,1418,1432
31400,24335,2918,11782,1988,21417,2850,1418,1432
31405,24336,2918,11782,1988,21418,2850,1418,1432
31410,24341,2918,11784,1988,21423,2851,1418,1433
31415,24343,2918,11785,1988,21425,2852,1418,1434
31420,24351,2919,11788,1988,21432,2852,1418,1434
31425,24354,2919,11788,1988,21435,2852,1418,1434
31430,24359,2920,11791,1988,21439,2852,1418,1434
31435,24363,2920,11793,1988,21443,2852,1418,1434
31440,24366,2920,11795,1988,21446,2852,1418,1434
31445,24367,2920,11796,1988,21447,2852,1418,1434
31450,24372,2920,11799,1988,21452,2852,1418,1434
31455,24374,2920,11800,1988,21454,2853,1419,1434
31460,24382,2921,11806,1989,21461,2853,1419,1434
31465,24385,2922,11808,1990,21463,2853,1419,1434
31470,24390,2923,11810,1991,21467,2853,1419,1434
31475,24394,2923,11812,1991,21471,2853,1419,1434
31480,24397,2923,11815,1991,21474,2853,1419,1434
31485,24398,2924,11816,1992,21474,2853,1419,1434
31490,24403,2925,11818,1992,21478,2853,1419,1434
31495,24405,2925,11818,1992,21480,2854,1419,1435
31500,24413,2927,11819,1993,21486,2856,1419,1437
31505,24416,2927,11821,1993,21489,2856,1419,1437
31510,24421,2928,11822,1993,21493,2856,1419,1437
31515,24425,2928,11824,1993,21497,2856,1419,1437
31520,24428,2928,11824,1993,21500,2856,1419,1437
31525,24429,2928,11824,1993,21501,2856,1419,1437
31530,24434,2928,11827,1993,21506,2856,1419,1437
31535,24436,2928,11827,1993,21508,2857,1419,1438
31540,24444,2928,11831,1993,21516,2857,1419,1438
31545,24447,2928,11832,1993,21519,2857,1419,1438
31550,24452,2929,11834,1993,21523,2857,1419,1438
31555,24456,2929,11836,1993,21527,2857,1419,1438
31560,24459,2929,11837,1993,21530,2857,1419,1438
31565,24460,2929,11838,1993,21531,2857,1419,1438
31570,24465,2929,11840,1993,21536,2857,1419,1438
31575,24467,2929,11841,1993,21538,2858,1420,1438
31580,24475,2929,11846,1993,21546,2858,1420,1438
31585,24478,2929,11846,1993,21549,2858,1420,1438
31590,24483,2930,11847,1993,21553,2858,1420,1438
31595,24487,2930,11848,1993,21557,2858,1420,1438
31600,24490,2930,11851,1993,21560,2858,1420,1438
31605,24491,2930,11852,1993,21561,2858,1420,1438
31610,24496,2931,11855,1994,21565,2858,1420,1438
31615,24498,2931,11856,1994,21567,2859,1420,1439
31620,24506,2934,11863,1997,21571,2861,1421,1440
31625,24509,2935,11864,1998,21574,2861,1421,1440
31630,24514,2936,11866,1998,21578,2861,1421,1440
31635,24518,2936,11869,1998,21582,2861,1421,1440
31640,24521,2936,11869,1998,21585,2861,1421,1440
31645,24522,2936,11869,1998,21586,2861,1421,1440
31650,24527,2936,11873,1998,21591,2861,1421,1440
31655,24529,2936,11874,1998,21593,2862,1422,1440
31660,24537,2936,11878,1998,21601,2862,1422,1440
31665,24540,2936,11880,1998,21604,2862,1422,1440
31670,24545,2937,11883,1999,21608,2862,1422,1440
31675,24549,2937,11886,1999,21612,2862,1422,1440
31680,24552,2937,11886,1999,21615,2862,1422,1440
31685,24553,2937,11886,1999,21616,2862,1422,1440
31690,24558,2937,11890,1999,21621,2863,1423,1440
31695,24560,2937,11891,1999,21623,2864,1423,1441
31700,24568,2938,11892,2000,21630,2864,1423,1441
31705,24571,2939,11894,2001,21632,2864,1423,1441
31710,24576,2940,11896,2002,21636,2864,1423,1441
31715,24580,2940,11898,2002,21640,2864,1423,1441
31720,24583,2940,11899,2002,21643,2864,1423,1441
31725,24584,2940,11900,2002,21644,2864,1423,1441
31730,24589,2941,11902,2003,21648,2865,1423,1442
31735,24591,2941,11903,2003,21650,2866,1423,1443
31740,24599,2942,11905,2003,21656,2868,1423,1445
31745,24602,2943,11907,2004,21659,2868,1423,1445
31750,24607,2944,11907,2004,21663,2868,1423,1445
31755,24611,2944,11910,2004,21667,2868,1423,1445
31760,24614,2944,11912,2004,21670,2868,1423,1445
31765,24615,2944,11912,2004,21671,2868,1423,1445
31770,24620,2944,11914,2004,21676,2868,1423,1445
31775,24622,2944,11915,2004,21678,2869,1424,1445
31780,24630,2944,11918,2004,21686,2869,1424,1445
31785,24633,2944,11918,2004,21689,2869,1424,1445
31790,24638,2945,11919,2005,21693,2869,1424,1445
31795,24642,2945,11921,2005,21697,2869,1424,1445
31800,24645,2945,11923,2005,21700,2869,1424,1445
31805,24646,2945,11923,2005,21701,2869,1424,1445
31810,24651,2945,11927,2005,21706,2870,1425,1445
31815,24653,2945,11928,2005,21708,2871,1426,1445
31820,24661,2946,11931,2006,21715,2871,1426,1445
31825,24664,2946,11931,2006,21718,2871,1426,1445
31830,24669,2947,11932,2007,21722,2871,1426,1445
31835,24673,2947,11935,2007,21726,2871,1426,1445
31840,24676,2947,11935,2007,21729,2871,1426,1445
31845,24677,2947,11935,2007,21730,2871,1426,1445
31850,24682,2948,11937,2007,21734,2871,1426,1445
31855,24684,2948,11938,2007,21736,2872,1426,1446
31860,24692,2951,11941,2009,21741,2874,1427,1447
31865,24695,2951,11943,2009,21744,2874,1427,1447
31870,24700,2952,11948,2010,21748,2874,1427,1447
31875,24704,2952,11951,2010,21752,2874,1427,1447
31880,24707,2952,11952,2010,21755,2874,1427,1447
31885,24708,2953,11953,2011,21755,2874,1427,1447
31890,24713,2954,11955,2011,21759,2874,1427,1447
31895,24715,2954,11956,2011,21761,2875,1427,1448
31900,24723,2954,11961,2011,21769,2875,1427,1448
31905,24726,2954,11962,2011,21772,2875,1427,1448
31910,24731,2955,11965,2012,21776,2875,1427,1448
31915,24735,2955,11967,2012,21780,2875,1427,1448
31920,24738,2955,11969,2012,21783,2875,1427,1448
31925,24739,2955,11969,2012,21784,2875,1427,1448
31930,24744,2956,11970,2013,21788,2875,1427,1448
31935,24746,2956,11971,2013,21790,2876,1428,1448
31940,24754,2956,11977,2013,21798,2876,1428,1448
31945,24757,2956,11979,2013,21801,2876,1428,1448
31950,24762,2957,11981,2013,21805,2876,1428,1448
31955,24766,2957,11982,2013,21809,2876,1428,1448
31960,24769,2957,11982,2013,21812,2876,1428,1448
31965,24770,2957,11982,2013,21813,2876,1428,1448
31970,24775,2958,11984,2013,21817,2876,1428,1448
31975,24777,2958,11986,2013,21819,2877,1429,1448
31980,24785,2960,11991,2015,21825,2879,1431,1448
31985,24788,2961,11994,2016,21827,2879,1431,1448
31990,24793,2962,11997,2016,21831,2879,1431,1448
31995,24797,2962,11999,2016,21835,2880,1431,1449
32000,24800,2962,12000,2016,21838,2880,1431,1449
32005,24801,2962,12001,2016,21839,2880,1431,1449
32010,24806,2962,12003,2016,21844,2881,1431,1450
32015,24808,2962,12004,2016,21846,2882,1432,1450
32020,24816,2963,12009,2017,21853,2882,1432,1450
32025,24819,2963,12011,2017,21856,2882,1432,1450
32030,24824,2964,12013,2017,21860,2882,1432,1450
32035,24828,2964,12015,2017,21864,2883,1433,1450
32040,24831,2965,12018,2018,21866,2883,1433,1450
32045,24832,2965,12018,2018,21867,2883,1433,1450
32050,24837,2965,12021,2018,21872,2884,1434,1450
32055,24839,2965,12022,2018,21874,2885,1435,1450
32060,24847,2966,12026,2018,21881,2885,1435,1450
32065,24850,2967,12029,2019,21883,2885,1435,1450
32070,24855,2968,12031,2019,21887,2885,1435,1450
32075,24859,2968,12031,2019,21891,2886,1435,1451
32080,24862,2969,12033,2020,21893,2886,1435,1451
32085,24863,2969,12034,2020,21894,2886,1435,1451
32090,24868,2970,12038,2020,21898,2887,1436,1451
32095,24870,2970,12039,2020,21900,2888,1437,1451
32100,24878,2972,12041,2021,21906,2890,1438,1452
32105,24881,2972,12041,2021,21909,2890,1438,1452
32110,24886,2973,12042,2021,21913,2890,1438,1452
32115,24890,2973,12045,2021,21917,2890,1438,1452
32120,24893,2973,12046,2021,21920,2890,1438,1452
32125,24894,2973,12046,2021,21921,2890,1438,1452
32130,24899,2974,12047,2021,21925,2890,1438,1452
32135,24901,2974,12048,2021,21927,2891,1438,1453
32140,24909,2974,12054,2021,21935,2891,1438,1453
32145,24912,2974,12055,2021,21938,2891,1438,1453
32150,24917,2975,12057,2021,21942,2891,1438,1453
32155,24921,2975,12059,2021,21946,2891,1438,1453
32160,24924,2975,12060,2021,21949,2891,1438,1453
32165,24925,2975,12060,2021,21950,2891,1438,1453
32170,24930,2976,12062,2021,21954,2891,1438,1453
32175,24932,2976,12062,2021,21956,2892,1438,1454
32180,24940,2976,12066,2021,21964,2892,1438,1454
32185,24943,2976,12067,2021,21967,2892,1438,1454
32190,24948,2977,12069,2021,21971,2892,1438,1454
32195,24952,2977,12071,2021,21975,2892,1438,1454
32200,24955,2977,12074,2021,21978,2892,1438,1454
32205,24956,2977,12074,2021,21979,2892,1438,1454
32210,24961,2978,12077,2022,21983,2893,1438,1455
32215,24963,2978,12077,2022,21985,2894,1438,1456
32220,24971,2980,12081,2023,21990,2896,1440,1456
32225,24974,2981,12082,2024,21993,2897,1441,1456
32230,24979,2982,12083,2025,21997,2898,1441,1457
32235,24983,2982,12084,2025,22001,2899,1441,1458
32240,24986,2982,12085,2025,22004,2899,1441,1458
32245,24987,2983,12086,2026,22004,2899,1441,1458
32250,24992,2984,12087,2026,22008,2900,1442,1458
32255,24994,2984,12087,2026,22010,2901,1442,1459
32260,25002,2985,12089,2026,22017,2901,1442,1459
32265,25005,2986,12090,2027,22019,2902,1442,1460
32270,25010,2987,12090,2027,22023,2903,1442,1461
32275,25014,2987,12091,2027,22027,2904,1442,1462
32280,25017,2987,12092,2027,22030,2904,1442,1462
32285,25018,2987,12092,2027,22031,2904,1442,1462
32290,25023,2988,12094,2028,22035,2905,1442,1463
32295,25025,2988,12095,2028,22037,2906,1443,1463
32300,25033,2989,12098,2028,22044,2906,1443,1463
32305,25036,2990,12099,2029,22046,2907,1443,1464
32310,25041,2991,12102,2029,22050,2908,1444,1464
32315,25045,2991,12104,2029,22054,2909,1444,1465
32320,25048,2992,12107,2030,22056,2909,1444,1465
32325,25049,2992,12107,2030,22057,2909,1444,1465
32330,25054,2993,12109,2030,22061,2910,1444,1466
32335,25056,2993,12111,2030,22063,2911,1445,1466
32340,25064,2994,12113,2030,22070,2913,1445,1468
32345,25067,2994,12114,2030,22073,2913,1445,1468
32350,25072,2995,12116,2031,22077,2913,1445,1468
32355,25076,2995,12117,2031,22081,2913,1445,1468
32360,25079,2995,12120,2031,22084,2913,1445,1468
32365,25080,2995,12120,2031,22085,2913,1445,1468
32370,25085,2995,12123,2031,22090,2913,1445,1468
32375,25087,2995,12123,2031,22092,2914,1445,1469
32380,25095,2995,12128,2031,22100,2914,1445,1469
32385,25098,2995,12129,2031,22103,2914,1445,1469
32390,25103,2996,12131,2032,22107,2914,1445,1469
32395,25107,2996,12133,2032,22111,2914,1445,1469
32400,25110,2996,12136,2032,22114,2914,1445,1469
32405,25111,2996,12137,2032,22115,2914,1445,1469
32410,25116,2996,12139,2032,22120,2914,1445,1469
32415,25118,2996,12141,2032,22122,2915,1446,1469
32420,25126,2996,12146,2032,22130,2915,1446,1469
32425,25129,2996,12147,2032,22133,2915,1446,1469
32430,25134,2997,12149,2032,22137,2915,1446,1469
32435,25138,2997,12150,2032,22141,2915,1446,1469
32440,25141,2997,12151,2032,22144,2915,1446,1469
32445,25142,2997,12151,2032,22145,2915,1446,1469
32450,25147,2998,12154,2033,22149,2915,1446,1469
32455,25149,2998,12155,2033,22151,2916,1447,1469
32460,25157,3001,12159,2035,22155,2918,1448,1470
32465,25160,3002,12161,2036,22158,2918,1448,1470
32470,25165,3003,12165,2037,22162,2918,1448,1470
32475,25169,3003,12167,2037,22166,2918,1448,1470
32480,25172,3003,12168,2037,22169,2918,1448,1470
32485,25173,3003,12169,2037,22170,2918,1448,1470
32490,25178,3004,12173,2038,22174,2918,1448,1470
32495,25180,3004,12173,2038,22176,2919,1448,1471
32500,25188,3004,12176,2038,22184,2919,1448,1471
32505,25191,3004,12177,2038,22187,2919,1448,1471
32510,25196,3005,12178,2038,22191,2919,1448,1471
32515,25200,3005,12180,2038,22195,2919,1448,1471
32520,25203,3005,12182,2038,22198,2919,1448,1471
32525,25204,3005,12183,2038,22199,2919,1448,1471
32530,25209,3006,12185,2038,22203,2919,1448,1471
32535,25211,3006,12185,2038,22205,2920,1448,1472
32540,25219,3007,12189,2039,22212,2920,1448,1472
32545,25222,3008,12191,2040,22214,2920,1448,1472
32550,25227,3009,12194,2040,22218,2920,1448,1472
32555,25231,3009,12196,2040,22222,2920,1448,1472
32560,25234,3009,12197,2040,22225,2920,1448,1472
32565,25235,3009,12197,2040,22226,2920,1448,1472
32570,25240,3010,12199,2040,22230,2920,1448,1472
32575,25242,3010,12200,2040,22232,2921,1448,1473
32580,25250,3011,12205,2041,22238,2923,1449,1474
32585,25253,3012,12206,2042,22241,2923,1449,1474
32590,25258,3013,12208,2042,22245,2923,1449,1474
32595,25262,3013,12209,2042,22249,2923,1449,1474
32600,25265,3013,12211,2042,22252,2923,1449,1474
32605,25266,3013,12211,2042,22253,2923,1449,1474
32610,25271,3013,12213,2042,22258,2923,1449,1474
32615,25273,3013,12214,2042,22260,2924,1450,1474
32620,25281,3013,12219,2042,22268,2924,1450,1474
32625,25284,3013,12219,2042,22271,2924,1450,1474
32630,25289,3014,12219,2042,22275,2924,1450,1474
32635,25293,3014,12221,2042,22279,2924,1450,1474
32640,25296,3014,12222,2042,22282,2924,1450,1474
32645,25297,3014,12223,2042,22283,2924,1450,1474
32650,25302,3014,12224,2042,22288,2924,1450,1474
32655,25304,3014,12225,2042,22290,2925,1451,1474
32660,25312,3015,12227,2042,22297,2925,1451,1474
32665,25315,3016,12230,2043,22299,2925,1451,1474
32670,25320,3017,12232,2043,22303,2925,1451,1474
32675,25324,3017,12233,2043,22307,2925,1451,1474
32680,25327,3017,12235,2043,22310,2925,1451,1474
32685,25328,3017,12235,2043,22311,2925,1451,1474
32690,25333,3018,12236,2043,22315,2926,1452,1474
32695,25335,3018,12237,2043,22317,2927,1452,1475
32700,25343,3020,12243,2045,22322,2929,1453,1476
32705,25346,3021,12243,2046,22325,2929,1453,1476
32710,25351,3022,12245,2046,22329,2929,1453,1476
32715,25355,3022,12247,2046,22333,2929,1453,1476
32720,25358,3022,12249,2046,22336,2929,1453,1476
32725,25359,3022,12250,2046,22337,2929,1453,1476
32730,25364,3022,12251,2046,22342,2929,1453,1476
32735,25366,3022,12252,2046,22344,2930,1454,1476
32740,25374,3022,12256,2046,22352,2930,1454,1476
32745,25377,3022,12256,2046,22355,2930,1454,1476
32750,25382,3023,12259,2047,22359,2930,1454,1476
32755,25386,3023,12260,2047,22363,2930,1454,1476
32760,25389,3023,12262,2047,22366,2930,1454,1476
32765,25390,3023,12262,2047,22367,2930,1454,1476
32770,25395,3023,12263,2047,22372,2930,1454,1476
32775,25397,3023,12263,2047,22374,2931,1454,1477
32780,25405,3024,12268,2047,22381,2931,1454,1477
32785,25408,3025,12270,2048,22383,2931,1454,1477
32790,25413,3026,12273,2048,22387,2931,1454,1477
32795,25417,3026,12274,2048,22391,2931,1454,1477
32800,25420,3026,12274,2048,22394,2931,1454,1477
32805,25421,3026,12274,2048,22395,2931,1454,1477
32810,25426,3027,12275,2049,22399,2931,1454,1477
32815,25428,3027,12277,2049,22401,2932,1455,1477
32820,25436,3028,12280,2050,22407,2934,1456,1478
32825,25439,3029,12280,2051,22410,2934,1456,1478
32830,25444,3030,12282,2051,22414,2934,1456,1478
32835,25448,3030,12283,2051,22418,2934,1456,1478
32840,25451,3030,12285,2051,22421,2934,1456,1478
32845,25452,3030,12285,2051,22422,2934,1456,1478
32850,25457,3030,12287,2051,22427,2935,1456,1479
32855,25459,3030,12288,2051,22429,2936,1457,1479
32860,25467,3030,12290,2051,22437,2936,1457,1479
32865,25470,3030,12293,2051,22440,2936,1457,1479
32870,25475,3031,12296,2051,22444,2936,1457,1479
32875,25479,3031,12300,2051,22448,2936,1457,1479
32880,25482,3031,12300,2051,22451,2936,1457,1479
32885,25483,3031,12300,2051,22452,2936,1457,1479
32890,25488,3031,12301,2051,22457,2937,1457,1480
32895,25490,3031,12301,2051,22459,2938,1457,1481
32900,25498,3032,12305,2052,22466,2938,1457,1481
32905,25501,3033,12306,2053,22468,2938,1457,1481
32910,25506,3034,12308,2054,22472,2938,1457,1481
32915,25510,3034,12311,2054,22476,2938,1457,1481
32920,25513,3034,12312,2054,22479,2938,1457,1481
32925,25514,3035,12313,2055,22479,2938,1457,1481
32930,25519,3036,12314,2055,22483,2939,1457,1482
32935,25521,3036,12315,2055,22485,2940,1457,1483
32940,25529,3039,12319,2057,22490,2942,1458,1484
32945,25532,3039,12321,2057,22493,2942,1458,1484
32950,25537,3040,12323,2057,22497,2942,1458,1484
32955,25541,3040,12326,2057,22501,2942,1458,1484
32960,25544,3040,12326,2057,22504,2942,1458,1484
32965,25545,3040,12327,2057,22505,2942,1458,1484
32970,25550,3040,12328,2057,22510,2942,1458,1484
32975,25552,3040,12329,2057,22512,2943,1458,1485
32980,25560,3040,12333,2057,22520,2943,1458,1485
32985,25563,3040,12334,2057,22523,2943,1458,1485
32990,25568,3041,12336,2058,22527,2943,1458,1485
32995,25572,3041,12337,2058,22531,2943,1458,1485
33000,25575,3041,12338,2058,22534,2943,1458,1485
33005,25576,3041,12339,2058,22535,2943,1458,1485
33010,25581,3041,12340,2058,22540,2943,1458,1485
33015,25583,3041,12342,2058,22542,2944,1459,1485
33020,25591,3041,12347,2058,22550,2944,1459,1485
33025,25594,3041,12349,2058,22553,2944,1459,1485
33030,25599,3042,12351,2058,22557,2944,1459,1485
33035,25603,3042,12352,2058,22561,2944,1459,1485
33040,25606,3042,12354,2058,22564,2944,1459,1485
33045,25607,3042,12355,2058,22565,2944,1459,1485
33050,25612,3043,12358,2059,22569,2945,1459,1486
33055,25614,3043,12359,2059,22571,2946,1460,1486
33060,25622,3044,12362,2060,22578,2948,1462,1486
33065,25625,3044,12363,2060,22581,2949,1463,1486
33070,25630,3045,12368,2061,22585,2950,1464,1486
33075,25634,3045,12370,2061,22589,2950,1464,1486
33080,25637,3045,12372,2061,22592,2950,1464,1486
33085,25638,3045,12373,2061,22593,2950,1464,1486
33090,25643,3045,12375,2061,22598,2950,1464,1486
33095,25645,3045,12376,2061,22600,2951,1465,1486
33100,25653,3046,12381,2061,22607,2951,1465,1486
33105,25656,3046,12383,2061,22610,2952,1466,1486
33110,25661,3047,12386,2062,22614,2953,1467,1486
33115,25665,3047,12388,2062,22618,2953,1467,1486
33120,25668,3047,12390,2062,22621,2953,1467,1486
33125,25669,3047,12391,2062,22622,2953,1467,1486
33130,25674,3047,12393,2062,22627,2953,1467,1486
33135,25676,3047,12394,2062,22629,2954,1468,1486
33140,25684,3048,12400,2062,22636,2954,1468,1486
33145,25687,3048,12402,2062,22639,2955,1469,1486
33150,25692,3049,12404,2063,22643,2956,1469,1487
33155,25696,3049,12407,2063,22647,2956,1469,1487
33160,25699,3049,12408,2063,22650,2956,1469,1487
33165,25700,3049,12409,2063,22651,2956,1469,1487
33170,25705,3050,12412,2063,22655,2957,1470,1487
33175,25707,3050,12413,2063,22657,2958,1471,1487
33180,25715,3052,12418,2065,22663,2960,1473,1487
33185,25718,3052,12418,2065,22666,2960,1473,1487
33190,25723,3053,12420,2065,22670,2960,1473,1487
33195,25727,3053,12423,2065,22674,2960,1473,1487
33200,25730,3053,12425,2065,22677,2960,1473,1487
33205,25731,3053,12425,2065,22678,2960,1473,1487
33210,25736,3053,12427,2065,22683,2960,1473,1487
33215,25738,3053,12427,2065,22685,2961,1473,1488
33220,25746,3053,12428,2065,22693,2961,1473,1488
33225,25749,3053,12429,2065,22696,2961,1473,1488
33230,25754,3054,12431,2066,22700,2961,1473,1488
33235,25758,3054,12433,2066,22704,2961,1473,1488
33240,25761,3054,12434,2066,22707,2961,1473,1488
33245,25762,3054,12435,2066,22708,2961,1473,1488
33250,25767,3054,12437,2066,22713,2961,1473,1488
33255,25769,3054,12438,2066,22715,2962,1474,1488
33260,25777,3054,12441,2066,22723,2962,1474,1488
33265,25780,3054,12443,2066,22726,2962,1474,1488
33270,25785,3055,12447,2067,22730,2962,1474,1488
33275,25789,3055,12449,2067,22734,2962,1474,1488
33280,25792,3055,12451,2067,22737,2962,1474,1488
33285,25793,3055,12451,2067,22738,2962,1474,1488
33290,25798,3056,12455,2067,22742,2963,1475,1488
33295,25800,3056,12455,2067,22744,2964,1475,1489
33300,25808,3059,12462,2070,22748,2966,1477,1489
33305,25811,3060,12464,2071,22751,2966,1477,1489
33310,25816,3061,12466,2072,22755,2966,1477,1489
33315,25820,3061,12467,2072,22759,2966,1477,1489
33320,25823,3061,12468,2072,22762,2966,1477,1489
33325,25824,3061,12468,2072,22763,2966,1477,1489
33330,25829,3061,12470,2072,22768,2967,1477,1490
33335,25831,3061,12472,2072,22770,2968,1478,1490
33340,25839,3061,12477,2072,22778,2968,1478,1490
33345,25842,3061,12477,2072,22781,2968,1478,1490
33350,25847,3062,12480,2073,22785,2968,1478,1490
33355,25851,3062,12482,2073,22789,2968,1478,1490
33360,25854,3062,12483,2073,22792,2968,1478,1490
33365,25855,3062,12484,2073,22793,2968,1478,1490
33370,25860,3062,12487,2073,22798,2969,1478,1491
33375,25862,3062,12487,2073,22800,2970,1478,1492
33380,25870,3063,12490,2074,22807,2970,1478,1492
33385,25873,3064,12491,2075,22809,2970,1478,1492
33390,25878,3065,12494,2076,22813,2970,1478,1492
33395,25882,3065,12494,2076,22817,2970,1478,1492
33400,25885,3065,12494,2076,22820,2970,1478,1492
33405,25886,3065,12495,2076,22821,2970,1478,1492
33410,25891,3066,12497,2076,22825,2970,1478,1492
33415,25893,3066,12498,2076,22827,2971,1479,1492
33420,25901,3068,12502,2077,22833,2973,1481,1492
33425,25904,3068,12503,2077,22836,2973,1481,1492
33430,25909,3069,12505,2078,22840,2973,1481,1492
33435,25913,3069,12507,2078,22843,2973,1481,1492
33440,25916,3070,12508,2079,22846,2973,1481,1492
33445,25917,3070,12509,2079,22847,2973,1481,1492
33450,25922,3071,12512,2080,22851,2973,1481,1492
33455,25924,3071,12514,2080,22853,2974,1482,1492
33460,25932,3071,12518,2080,22861,2974,1482,1492
33465,25935,3071,12519,2080,22864,2974,1482,1492
33470,25940,3072,12520,2080,22868,2974,1482,1492
33475,25944,3072,12523,2080,22872,2974,1482,1492
33480,25947,3072,12524,2080,22875,2974,1482,1492
33485,25948,3073,12525,2081,22875,2974,1482,1492
33490,25953,3074,12527,2082,22879,2975,1482,1493
33495,25955,3074,12529,2082,22881,2976,1483,1493
33500,25963,3074,12532,2082,22889,2976,1483,1493
33505,25966,3074,12533,2082,22892,2976,1483,1493
33510,25971,3075,12536,2082,22896,2976,1483,1493
33515,25975,3075,12537,2082,22900,2976,1483,1493
33520,25978,3075,12539,2082,22903,2976,1483,1493
33525,25979,3076,12540,2083,22903,2976,1483,1493
33530,25984,3077,12542,2083,22907,2977,1484,1493
33535,25986,3077,12542,2083,22909,2978,1484,1494
33540,25994,3079,12546,2085,22914,2980,1484,1496
33545,25997,3081,12549,2087,22916,2981,1485,1496
33550,26002,3082,12551,2087,22920,2982,1486,1496
33555,26006,3082,12552,2087,22924,2983,1486,1497
33560,26009,3083,12554,2088,22926,2983,1486,1497
33565,26010,3083,12555,2088,22927,2983,1486,1497
33570,26015,3083,12558,2088,22932,2983,1486,1497
33575,26017,3083,12560,2088,22934,2984,1487,1497
33580,26025,3084,12564,2089,22941,2984,1487,1497
33585,26028,3084,12565,2089,22944,2985,1487,1498
33590,26033,3085,12569,2090,22948,2986,1488,1498
33595,26037,3085,12570,2090,22952,2987,1488,1499
33600,26040,3085,12572,2090,22955,2987,1488,1499
33605,26041,3085,12573,2090,22956,2987,1488,1499
33610,26046,3085,12576,2090,22961,2987,1488,1499
33615,26048,3085,12578,2090,22963,2988,1489,1499
33620,26056,3086,12582,2090,22970,2988,1489,1499
33625,26059,3086,12582,2090,22973,2989,1489,1500
33630,26064,3087,12584,2090,22977,2990,1490,1500
33635,26068,3087,12586,2090,22981,2990,1490,1500
33640,26071,3087,12588,2090,22984,2990,1490,1500
33645,26072,3087,12589,2090,22985,2990,1490,1500
33650,26077,3088,12590,2091,22989,2991,1490,1501
33655,26079,3088,12591,2091,22991,2992,1491,1501
33660,26087,3089,12594,2092,22997,2994,1492,1502
33665,26090,3091,12596,2094,22999,2994,1492,1502
33670,26095,3092,12599,2095,23003,2994,1492,1502
33675,26099,3092,12601,2095,23006,2994,1492,1502
33680,26102,3093,12602,2096,23009,2994,1492,1502
33685,26103,3093,12602,2096,23010,2994,1492,1502
33690,26108,3094,12605,2096,23014,2994,1492,1502
33695,26110,3094,12606,2096,23016,2995,1493,1502
33700,26118,3094,12608,2096,23024,2995,1493,1502
33705,26121,3094,12609,2096,23027,2995,1493,1502
33710,26126,3095,12611,2097,23031,2995,1493,1502
33715,26130,3095,12613,2097,23034,2995,1493,1502
33720,26133,3096,12613,2098,23037,2995,1493,1502
33725,26134,3096,12613,2098,23038,2995,1493,1502
33730,26139,3097,12614,2098,23042,2995,1493,1502
33735,26141,3097,12615,2098,23044,2996,1493,1503
33740,26149,3098,12619,2099,23051,2996,1493,1503
33745,26152,3098,12620,2099,23054,2996,1493,1503
33750,26157,3099,12624,2100,23058,2996,1493,1503
33755,26161,3099,12624,2100,23062,2996,1493,1503
33760,26164,3099,12625,2100,23065,2996,1493,1503
33765,26165,3099,12625,2100,23066,2996,1493,1503
33770,26170,3100,12627,2100,23070,2996,1493,1503
33775,26172,3100,12627,2100,23072,2997,1493,1504
33780,26180,3103,12633,2102,23076,2999,1494,1505
33785,26183,3104,12634,2103,23079,3000,1494,1506
33790,26188,3104,12638,2103,23084,3001,1495,1506
33795,26192,3104,12640,2103,23088,3002,1496,1506
33800,26195,3104,12642,2103,23091,3002,1496,1506
33805,26196,3105,12643,2104,23091,3002,1496,1506
33810,26201,3106,12647,2104,23095,3003,1497,1506
33815,26203,3106,12648,2104,23097,3004,1497,1507
33820,26211,3107,12652,2104,23104,3004,1497,1507
33825,26214,3108,12655,2105,23106,3005,1498,1507
33830,26219,3108,12658,2105,23111,3006,1498,1508
33835,26223,3108,12660,2105,23115,3007,1499,1508
33840,26226,3108,12661,2105,23118,3007,1499,1508
33845,26227,3109,12662,2106,23118,3007,1499,1508
33850,26232,3110,12664,2106,23122,3007,1499,1508
33855,26234,3110,12666,2106,23124,3008,1500,1508
33860,26242,3111,12671,2106,23131,3008,1500,1508
33865,26245,3111,12672,2106,23134,3009,1501,1508
33870,26250,3111,12674,2106,23139,3010,1501,1509
33875,26254,3111,12676,2106,23143,3011,1501,1510
33880,26257,3111,12678,2106,23146,3011,1501,1510
33885,26258,3111,12678,2106,23147,3011,1501,1510
33890,26263,3112,12681,2106,23151,3011,1501,1510
33895,26265,3112,12683,2106,23153,3012,1502,1510
33900,26273,3114,12687,2108,23158,3014,1503,1511
33905,26276,3115,12688,2109,23161,3014,1503,1511
33910,26281,3116,12691,2110,23165,3014,1503,1511
33915,26285,3116,12693,2110,23169,3014,1503,1511
33920,26288,3116,12693,2110,23172,3014,1503,1511
33925,26289,3116,12694,2110,23173,3014,1503,1511
33930,26294,3116,12697,2110,23178,3014,1503,1511
33935,26296,3116,12699,2110,23180,3015,1504,1511
33940,26304,3116,12703,2110,23188,3015,1504,1511
33945,26307,3116,12704,2110,23191,3015,1504,1511
33950,26312,3117,12707,2111,23195,3015,1504,1511
33955,26316,3117,12709,2111,23199,3015,1504,1511
33960,26319,3117,12710,2111,23202,3015,1504,1511
33965,26320,3117,12711,2111,23203,3015,1504,1511
33970,26325,3117,12712,2111,23208,3016,1504,1512
33975,26327,3117,12713,2111,23210,3017,1505,1512
33980,26335,3118,12718,2112,23217,3017,1505,1512
33985,26338,3118,12720,2112,23220,3017,1505,1512
33990,26343,3119,12723,2113,23224,3017,1505,1512
33995,26347,3119,12724,2113,23228,3017,1505,1512
34000,26350,3119,12726,2113,23231,3017,1505,1512
34005,26351,3119,12727,2113,23232,3017,1505,1512
34010,26356,3120,12729,2114,23236,3018,1505,1513
34015,26358,3120,12730,2114,23238,3019,1506,1513
34020,26366,3122,12733,2116,23243,3021,1506,1515
34025,26369,3123,12735,2117,23246,3021,1506,1515
34030,26374,3124,12736,2117,23250,3022,1506,1516
34035,26378,3124,12738,2117,23254,3022,1506,1516
34040,26381,3124,12740,2117,23257,3022,1506,1516
34045,26382,3124,12740,2117,23258,3022,1506,1516
34050,26387,3124,12742,2117,23263,3023,1506,1517
34055,26389,3124,12742,2117,23265,3024,1506,1518
34060,26397,3124,12746,2117,23273,3025,1506,1519
34065,26400,3124,12749,2117,23276,3025,1506,1519
34070,26405,3125,12752,2117,23280,3026,1507,1519
34075,26409,3125,12755,2117,23284,3026,1507,1519
34080,26412,3125,12755,2117,23287,3026,1507,1519
34085,26413,3125,12756,2117,23288,3026,1507,1519
34090,26418,3125,12758,2117,23293,3026,1507,1519
34095,26420,3125,12760,2117,23295,3027,1508,1519
34100,26428,3126,12765,2118,23302,3027,1508,1519
34105,26431,3127,12767,2119,23304,3027,1508,1519
34110,26436,3128,12770,2119,23308,3027,1508,1519
34115,26440,3128,12771,2119,23312,3027,1508,1519
34120,26443,3128,12771,2119,23315,3027,1508,1519
34125,26444,3128,12772,2119,23316,3027,1508,1519
34130,26449,3129,12774,2119,23320,3027,1508,1519
34135,26451,3129,12775,2119,23322,3028,1509,1519
34140,26459,3131,12781,2121,23327,3029,1509,1520
34145,26462,3132,12781,2122,23330,3029,1509,1520
34150,26467,3133,12782,2123,23334,3029,1509,1520
34155,26471,3133,12784,2123,23338,3029,1509,1520
34160,26474,3133,12785,2123,23341,3029,1509,1520
34165,26475,3133,12786,2123,23342,3029,1509,1520
34170,26480,3133,12790,2123,23347,3029,1509,1520
34175,26482,3133,12791,2123,23349,3030,1509,1521
34180,26490,3133,12795,2123,23357,3030,1509,1521
34185,26493,3133,12797,2123,23360,3030,1509,1521
34190,26498,3134,12801,2124,23364,3030,1509,1521
34195,26502,3134,12802,2124,23368,3030,1509,1521
34200,26505,3134,12803,2124,23371,3030,1509,1521
34205,26506,3134,12804,2124,23372,3030,1509,1521
34210,26511,3134,12806,2124,23377,3031,1509,1522
34215,26513,3134,12807,2124,23379,3032,1510,1522
34220,26521,3135,12809,2125,23386,3032,1510,1522
34225,26524,3136,12811,2126,23388,3032,1510,1522
34230,26529,3137,12815,2127,23392,3032,1510,1522
34235,26533,3137,12818,2127,23396,3032,1510,1522
34240,26536,3137,12819,2127,23399,3032,1510,1522
34245,26537,3137,12819,2127,23400,3032,1510,1522
34250,26542,3138,12821,2128,23404,3033,1510,1523
34255,26544,3138,12823,2128,23406,3034,1511,1523
34260,26552,3141,12828,2131,23411,3036,1512,1524
34265,26555,3141,12828,2131,23414,3036,1512,1524
34270,26560,3141,12830,2131,23419,3036,1512,1524
34275,26564,3141,12831,2131,23423,3036,1512,1524
34280,26567,3141,12833,2131,23426,3036,1512,1524
34285,26568,3141,12834,2131,23427,3036,1512,1524
34290,26573,3142,12836,2131,23431,3036,1512,1524
34295,26575,3142,12836,2131,23433,3037,1512,1525
34300,26583,3142,12839,2131,23441,3037,1512,1525
34305,26586,3142,12841,2131,23444,3037,1512,1525
34310,26591,3142,12845,2131,23449,3037,1512,1525
34315,26595,3142,12846,2131,23453,3037,1512,1525
34320,26598,3142,12847,2131,23456,3037,1512,1525
34325,26599,3142,12847,2131,23457,3037,1512,1525
34330,26604,3143,12850,2132,23461,3037,1512,1525
34335,26606,3143,12851,2132,23463,3038,1513,1525
34340,26614,3143,12854,2132,23471,3038,1513,1525
34345,26617,3143,12856,2132,23474,3038,1513,1525
34350,26622,3143,12859,2132,23479,3038,1513,1525
34355,26626,3143,12862,2132,23483,3038,1513,1525
34360,26629,3143,12864,2132,23486,3038,1513,1525
34365,26630,3143,12864,2132,23487,3038,1513,1525
34370,26635,3144,12865,2132,23491,3038,1513,1525
34375,26637,3144,12866,2132,23493,3039,1514,1525
34380,26645,3146,12870,2134,23498,3041,1514,1527
34385,26648,3147,12871,2135,23501,3042,1515,1527
34390,26653,3148,12875,2136,23505,3043,1516,1527
34395,26657,3148,12875,2136,23509,3044,1516,1528
34400,26660,3149,12876,2137,23511,3044,1516,1528
34405,26661,3149,12877,2137,23512,3044,1516,1528
34410,26666,3149,12879,2137,23517,3045,1516,1529
34415,26668,3149,12880,2137,23519,3046,1516,1530
34420,26676,3150,12885,2138,23526,3046,1516,1530
34425,26679,3151,12887,2139,23528,3047,1516,1531
34430,26684,3152,12890,2139,23532,3048,1517,1531
34435,26688,3152,12891,2139,23536,3049,1517,1532
34440,26691,3152,12892,2139,23539,3049,1517,1532
34445,26692,3152,12893,2139,23540,3049,1517,1532
34450,26697,3152,12895,2139,23545,3049,1517,1532
34455,26699,3152,12897,2139,23547,3050,1518,1532
34460,26707,3153,12900,2140,23554,3050,1518,1532
34465,26710,3153,12901,2140,23557,3051,1518,1533
34470,26715,3154,12904,2140,23561,3052,1519,1533
34475,26719,3154,12905,2140,23565,3052,1519,1533
34480,26722,3154,12907,2140,23568,3052,1519,1533
34485,26723,3154,12907,2140,23569,3052,1519,1533
34490,26728,3155,12910,2140,23573,3052,1519,1533
34495,26730,3155,12911,2140,23575,3053,1519,1534
34500,26738,3158,12915,2143,23580,3055,1520,1535
34505,26741,3158,12917,2143,23583,3055,1520,1535
34510,26746,3159,12919,2143,23587,3055,1520,1535
34515,26750,3159,12922,2143,23591,3055,1520,1535
34520,26753,3159,12923,2143,23594,3055,1520,1535
34525,26754,3159,12923,2143,23595,3055,1520,1535
34530,26759,3159,12926,2143,23600,3056,1520,1536
34535,26761,3159,12928,2143,23602,3057,1521,1536
34540,26769,3160,12934,2144,23609,3057,1521,1536
34545,26772,3160,12936,2144,23612,3057,1521,1536
34550,26777,3161,12938,2144,23616,3057,1521,1536
34555,26781,3161,12941,2144,23620,3057,1521,1536
34560,26784,3161,12943,2144,23623,3057,1521,1536
34565,26785,3161,12943,2144,23624,3057,1521,1536
34570,26790,3161,12944,2144,23629,3058,1522,1536
34575,26792,3161,12945,2144,23631,3059,1523,1536
34580,26800,3162,12952,2145,23638,3059,1523,1536
34585,26803,3162,12954,2145,23641,3059,1523,1536
34590,26808,3163,12957,2145,23645,3059,1523,1536
34595,26812,3163,12958,2145,23649,3059,1523,1536
34600,26815,3163,12960,2145,23652,3059,1523,1536
34605,26816,3163,12960,2145,23653,3059,1523,1536
34610,26821,3164,12961,2145,23657,3060,1523,1537
34615,26823,3164,12962,2145,23659,3061,1524,1537
34620,26831,3167,12967,2147,23663,3063,1526,1537
34625,26834,3169,12969,2149,23665,3064,1526,1538
34630,26839,3170,12973,2150,23669,3064,1526,1538
34635,26843,3170,12977,2150,23673,3065,1527,1538
34640,26846,3171,12980,2151,23675,3065,1527,1538
34645,26847,3171,12981,2151,23676,3065,1527,1538
34650,26852,3172,12985,2152,23680,3066,1527,1539
34655,26854,3172,12987,2152,23682,3067,1528,1539
34660,26862,3173,12991,2152,23689,3067,1528,1539
34665,26865,3173,12992,2152,23692,3068,1528,1540
34670,26870,3174,12995,2153,23696,3068,1528,1540
34675,26874,3174,12996,2153,23700,3069,1528,1541
34680,26877,3175,12997,2154,23702,3069,1528,1541
34685,26878,3175,12997,2154,23703,3069,1528,1541
34690,26883,3176,12999,2154,23707,3069,1528,1541
34695,26885,3176,12999,2154,23709,3070,1528,1542
34700,26893,3177,13002,2155,23716,3070,1528,1542
34705,26896,3177,13002,2155,23719,3071,1528,1543
34710,26901,3178,13006,2156,23723,3072,1529,1543
34715,26905,3178,13008,2156,23727,3073,1529,1544
34720,26908,3178,13010,2156,23730,3073,1529,1544
34725,26909,3178,13010,2156,23731,3073,1529,1544
34730,26914,3179,13012,2156,23735,3073,1529,1544
34735,26916,3179,13012,2156,23737,3074,1529,1545
34740,26924,3181,13017,2158,23743,3076,1530,1546
34745,26927,3181,13018,2158,23746,3076,1530,1546
34750,26932,3181,13021,2158,23751,3076,1530,1546
34755,26936,3181,13023,2158,23755,3076,1530,1546
34760,26939,3181,13025,2158,23758,3076,1530,1546
34765,26940,3181,13025,2158,23759,3076,1530,1546
34770,26945,3182,13026,2158,23763,3076,1530,1546
34775,26947,3182,13028,2158,23765,3077,1531,1546
34780,26955,3182,13034,2158,23773,3077,1531,1546
34785,26958,3182,13036,2158,23776,3077,1531,1546
34790,26963,3182,13037,2158,23781,3077,1531,1546
34795,26967,3182,13039,2158,23785,3077,1531,1546
34800,26970,3182,13041,2158,23788,3077,1531,1546
34805,26971,3182,13041,2158,23789,3077,1531,1546
34810,26976,3183,13044,2159,23793,3078,1531,1547
34815,26978,3183,13045,2159,23795,3079,1531,1548
34820,26986,3183,13049,2159,23803,3079,1531,1548
34825,26989,3183,13051,2159,23806,3079,1531,1548
34830,26994,3183,13052,2159,23811,3079,1531,1548
34835,26998,3183,13054,2159,23815,3079,1531,1548
34840,27001,3183,13057,2159,23818,3079,1531,1548
34845,27002,3184,13058,2160,23818,3079,1531,1548
34850,27007,3185,13060,2160,23822,3080,1532,1548
34855,27009,3185,13061,2160,23824,3081,1532,1549
34860,27017,3187,13065,2162,23830,3083,1533,1550
34865,27020,3188,13067,2163,23832,3083,1533,1550
34870,27025,3189,13069,2163,23836,3083,1533,1550
34875,27029,3189,13070,2163,23840,3083,1533,1550
34880,27032,3189,13072,2163,23843,3083,1533,1550
34885,27033,3190,13073,2164,23843,3083,1533,1550
34890,27038,3191,13077,2165,23847,3084,1534,1550
34895,27040,3191,13078,2165,23849,3085,1534,1551
34900,27048,3192,13084,2166,23856,3085,1534,1551
34905,27051,3193,13085,2167,23858,3085,1534,1551
34910,27056,3194,13089,2168,23862,3085,1534,1551
34915,27060,3194,13092,2168,23866,3085,1534,1551
34920,27063,3194,13093,2168,23869,3085,1534,1551
34925,27064,3195,13094,2169,23869,3085,1534,1551
34930,27069,3196,13096,2170,23873,3086,1535,1551
34935,27071,3196,13098,2170,23875,3087,1536,1551
34940,27079,3197,13103,2171,23882,3087,1536,1551
34945,27082,3197,13104,2171,23885,3087,1536,1551
34950,27087,3198,13106,2171,23889,3088,1537,1551
34955,27091,3198,13108,2171,23893,3088,1537,1551
34960,27094,3198,13109,2171,23896,3088,1537,1551
34965,27095,3198,13110,2171,23897,3088,1537,1551
34970,27100,3199,13113,2172,23901,3088,1537,1551
34975,27102,3199,13115,2172,23903,3089,1538,1551
34980,27110,3201,13120,2173,23908,3091,1540,1551
34985,27113,3202,13123,2174,23911,3091,1540,1551
34990,27118,3202,13124,2174,23916,3091,1540,1551
34995,27122,3202,13127,2174,23920,3091,1540,1551
35000,27125,3202,13129,2174,23923,3091,1540,1551
35005,27126,3202,13129,2174,23924,3091,1540,1551
35010,27131,3203,13132,2175,23928,3091,1540,1551
35015,27133,3203,13133,2175,23930,3092,1541,1551
35020,27141,3203,13138,2175,23938,3092,1541,1551
35025,27144,3203,13138,2175,23941,3092,1541,1551
35030,27149,3203,13140,2175,23946,3092,1541,1551
35035,27153,3203,13143,2175,23950,3092,1541,1551
35040,27156,3203,13144,2175,23953,3092,1541,1551
35045,27157,3204,13145,2176,23953,3092,1541,1551
35050,27162,3205,13147,2176,23957,3093,1541,1552
35055,27164,3205,13149,2176,23959,3094,1542,1552
35060,27172,3205,13154,2176,23967,3095,1543,1552
35065,27175,3205,13157,2176,23970,3095,1543,1552
35070,27180,3206,13158,2176,23974,3095,1543,1552
35075,27184,3206,13158,2176,23978,3095,1543,1552
35080,27187,3206,13159,2176,23981,3095,1543,1552
35085,27188,3206,13159,2176,23982,3095,1543,1552
35090,27193,3207,13161,2176,23986,3096,1543,1553
35095,27195,3207,13162,2176,23988,3097,1543,1554
35100,27203,3207,13163,2176,23996,3099,1544,1555
35105,27206,3207,13166,2176,23999,3099,1544,1555
35110,27211,3208,13169,2177,24003,3099,1544,1555
35115,27215,3208,13171,2177,24007,3099,1544,1555
35120,27218,3208,13172,2177,24010,3099,1544,1555
35125,27219,3208,13172,2177,24011,3099,1544,1555
35130,27224,3209,13174,2177,24015,3099,1544,1555
35135,27226,3209,13175,2177,24017,3100,1545,1555
35140,27234,3210,13182,2178,24024,3100,1545,1555
35145,27237,3210,13183,2178,24027,3100,1545,1555
35150,27242,3211,13186,2179,24031,3100,1545,1555
35155,27246,3211,13188,2179,24035,3100,1545,1555
35160,27249,3212,13189,2180,24037,3100,1545,1555
35165,27250,3212,13189,2180,24038,3100,1545,1555
35170,27255,3212,13193,2180,24043,3100,1545,1555
35175,27257,3212,13194,2180,24045,3101,1546,1555
35180,27265,3213,13199,2181,24051,3102,1547,1555
35185,27268,3215,13201,2183,24053,3103,1547,1556
35190,27273,3216,13202,2183,24057,3103,1547,1556
35195,27277,3216,13206,2183,24060,3103,1547,1556
35200,27280,3217,13208,2184,24063,3103,1547,1556
35205,27281,3217,13209,2184,24064,3103,1547,1556
35210,27286,3217,13213,2184,24069,3103,1547,1556
35215,27288,3217,13213,2184,24071,3104,1547,1557
35220,27296,3218,13215,2184,24077,3106,1548,1558
35225,27299,3220,13217,2186,24079,3106,1548,1558
35230,27304,3220,13220,2186,24084,3106,1548,1558
35235,27308,3220,13221,2186,24088,3106,1548,1558
35240,27311,3220,13223,2186,24091,3106,1548,1558
35245,27312,3220,13224,2186,24092,3106,1548,1558
35250,27317,3220,13226,2186,24097,3106,1548,1558
35255,27319,3220,13228,2186,24099,3107,1549,1558
35260,27327,3221,13229,2187,24106,3107,1549,1558
35265,27330,3222,13230,2188,24108,3107,1549,1558
35270,27335,3222,13231,2188,24113,3107,1549,1558
35275,27339,3222,13234,2188,24116,3107,1549,1558
35280,27342,3223,13236,2189,24119,3107,1549,1558
35285,27343,3223,13236,2189,24120,3107,1549,1558
35290,27348,3224,13237,2189,24124,3107,1549,1558
35295,27350,3224,13238,2189,24126,3108,1550,1558
35300,27358,3225,13242,2190,24133,3108,1550,1558
35305,27361,3225,13244,2190,24136,3108,1550,1558
35310,27366,3225,13247,2190,24141,3108,1550,1558
35315,27370,3225,13249,2190,24145,3108,1550,1558
35320,27373,3225,13250,2190,24148,3108,1550,1558
35325,27374,3225,13250,2190,24149,3108,1550,1558
35330,27379,3226,13255,2191,24153,3108,1550,1558
35335,27381,3226,13256,2191,24155,3109,1550,1559
35340,27389,3227,13258,2192,24162,3110,1550,1560
35345,27392,3228,13259,2193,24164,3110,1550,1560
35350,27397,3229,13262,2194,24168,3111,1551,1560
35355,27401,3229,13263,2194,24172,3111,1551,1560
35360,27404,3229,13265,2194,24175,3111,1551,1560
35365,27405,3229,13265,2194,24176,3111,1551,1560
35370,27410,3230,13268,2194,24180,3111,1551,1560
35375,27412,3230,13268,2194,24182,3112,1551,1561
35380,27420,3231,13269,2195,24189,3113,1551,1562
35385,27423,3232,13270,2196,24191,3113,1551,1562
35390,27428,3233,13272,2196,24195,3114,1551,1563
35395,27432,3233,13275,2196,24199,3114,1551,1563
35400,27435,3233,13275,2196,24202,3114,1551,1563
35405,27436,3234,13276,2197,24202,3114,1551,1563
35410,27441,3235,13279,2198,24206,3114,1551,1563
35415,27443,3235,13280,2198,24208,3115,1551,1564
35420,27451,3237,13283,2199,24213,3116,1552,1564
35425,27454,3238,13284,2200,24216,3117,1552,1565
35430,27459,3239,13286,2201,24220,3117,1552,1565
35435,27463,3239,13286,2201,24224,3117,1552,1565
35440,27466,3239,13287,2201,24227,3117,1552,1565
35445,27467,3239,13288,2201,24228,3117,1552,1565
35450,27472,3240,13290,2201,24232,3117,1552,1565
35455,27474,3240,13291,2201,24234,3118,1552,1566
35460,27482,3242,13294,2202,24240,3119,1552,1567
35465,27485,3242,13295,2202,24243,3119,1552,1567
35470,27490,3243,13298,2202,24247,3119,1552,1567
35475,27494,3243,13300,2202,24251,3119,1552,1567
35480,27497,3243,13301,2202,24254,3119,1552,1567
35485,27498,3244,13302,2203,24254,3119,1552,1567
35490,27503,3245,13304,2204,24258,3120,1552,1568
35495,27505,3245,13305,2204,24260,3121,1553,1568
35500,27513,3245,13310,2204,24268,3121,1553,1568
35505,27516,3245,13312,2204,24271,3121,1553,1568
35510,27521,3246,13314,2204,24275,3122,1553,1569
35515,27525,3246,13316,2204,24279,3122,1553,1569
35520,27528,3246,13316,2204,24282,3122,1553,1569
35525,27529,3247,13317,2205,24282,3122,1553,1569
35530,27534,3248,13318,2205,24286,3123,1554,1569
35535,27536,3248,13318,2205,24288,3124,1554,1570
35540,27544,3248,13322,2205,24296,3124,1554,1570
35545,27547,3248,13323,2205,24299,3124,1554,1570
35550,27552,3249,13326,2206,24303,3125,1555,1570
35555,27556,3249,13328,2206,24307,3125,1555,1570
35560,27559,3249,13329,2206,24310,3125,1555,1570
35565,27560,3249,13329,2206,24311,3125,1555,1570
35570,27565,3250,13333,2207,24315,3126,1556,1570
35575,27567,3250,13333,2207,24317,3127,1556,1571
35580,27575,3251,13334,2207,24324,3128,1556,1572
35585,27578,3251,13334,2207,24327,3129,1556,1573
35590,27583,3252,13336,2207,24331,3129,1556,1573
35595,27587,3252,13340,2207,24335,3130,1557,1573
35600,27590,3252,13340,2207,24338,3130,1557,1573
35605,27591,3252,13341,2207,24339,3130,1557,1573
35610,27596,3253,13343,2207,24343,3130,1557,1573
35615,27598,3253,13344,2207,24345,3131,1558,1573
35620,27606,3254,13347,2208,24352,3131,1558,1573
35625,27609,3254,13347,2208,24355,3132,1558,1574
35630,27614,3255,13348,2208,24359,3132,1558,1574
35635,27618,3255,13350,2208,24363,3133,1559,1574
35640,27621,3256,13352,2209,24365,3133,1559,1574
35645,27622,3256,13353,2209,24366,3133,1559,1574
35650,27627,3257,13354,2209,24370,3133,1559,1574
35655,27629,3257,13354,2209,24372,3134,1559,1575
35660,27637,3258,13355,2210,24379,3134,1559,1575
35665,27640,3258,13356,2210,24382,3135,1560,1575
35670,27645,3259,13358,2210,24386,3135,1560,1575
35675,27649,3259,13361,2210,24390,3136,1561,1575
35680,27652,3260,13363,2211,24392,3136,1561,1575
35685,27653,3260,13363,2211,24393,3136,1561,1575
35690,27658,3261,13365,2211,24397,3136,1561,1575
35695,27660,3261,13366,2211,24399,3137,1562,1575
35700,27668,3264,13370,2214,24404,3139,1562,1577
35705,27671,3264,13373,2214,24407,3139,1562,1577
35710,27676,3265,13375,2215,24411,3139,1562,1577
35715,27680,3265,13376,2215,24415,3139,1562,1577
35720,27683,3265,13379,2215,24418,3139,1562,1577
35725,27684,3266,13380,2216,24418,3139,1562,1577
35730,27689,3267,13384,2217,24422,3139,1562,1577
35735,27691,3267,13384,2217,24424,3140,1562,1578
35740,27699,3267,13387,2217,24432,3140,1562,1578
35745,27702,3267,13388,2217,24435,3140,1562,1578
35750,27707,3268,13390,2217,24439,3140,1562,1578
35755,27711,3268,13391,2217,24443,3140,1562,1578
35760,27714,3268,13392,2217,24446,3140,1562,1578
35765,27715,3269,13393,2218,24446,3140,1562,1578
35770,27720,3270,13394,2219,24450,3140,1562,1578
35775,27722,3270,13395,2219,24452,3141,1562,1579
35780,27730,3270,13396,2219,24460,3141,1562,1579
35785,27733,3270,13398,2219,24463,3141,1562,1579
35790,27738,3271,13399,2219,24467,3141,1562,1579
35795,27742,3271,13401,2219,24471,3141,1562,1579
35800,27745,3271,13402,2219,24474,3141,1562,1579
35805,27746,3272,13403,2220,24474,3141,1562,1579
35810,27751,3273,13406,2220,24478,3141,1562,1579
35815,27753,3273,13406,2220,24480,3142,1562,1580
35820,27761,3274,13408,2220,24487,3144,1563,1581
35825,27764,3274,13410,2220,24490,3144,1563,1581
35830,27769,3275,13415,2221,24494,3145,1564,1581
35835,27773,3275,13419,2221,24497,3146,1565,1581
35840,27776,3277,13421,2223,24499,3146,1565,1581
35845,27777,3277,13422,2223,24500,3146,1565,1581
35850,27782,3277,13425,2223,24505,3147,1565,1582
35855,27784,3277,13426,2223,24507,3148,1566,1582
35860,27792,3278,13427,2224,24514,3149,1566,1583
35865,27795,3278,13429,2224,24517,3149,1566,1583
35870,27800,3279,13430,2224,24521,3150,1566,1584
35875,27804,3279,13430,2224,24525,3150,1566,1584
35880,27807,3280,13432,2225,24527,3150,1566,1584
35885,27808,3280,13432,2225,24528,3150,1566,1584
35890,27813,3280,13434,2225,24533,3151,1566,1585
35895,27815,3280,13436,2225,24535,3152,1567,1585
35900,27823,3281,13439,2225,24542,3152,1567,1585
35905,27826,3281,13440,2225,24545,3152,1567,1585
35910,27831,3281,13442,2225,24550,3152,1567,1585
35915,27835,3281,13445,2225,24554,3152,1567,1585
35920,27838,3281,13447,2225,24557,3152,1567,1585
35925,27839,3281,13448,2225,24558,3152,1567,1585
35930,27844,3282,13450,2226,24562,3153,1567,1586
35935,27846,3282,13450,2226,24564,3154,1567,1587
35940,27854,3284,13454,2228,24569,3155,1568,1587
35945,27857,3285,13455,2229,24572,3156,1568,1588
35950,27862,3286,13457,2229,24576,3156,1568,1588
35955,27866,3286,13459,2229,24580,3156,1568,1588
35960,27869,3286,13461,2229,24583,3156,1568,1588
35965,27870,3286,13461,2229,24584,3156,1568,1588
35970,27875,3287,13462,2229,24588,3156,1568,1588
35975,27877,3287,13464,2229,24590,3157,1569,1588
35980,27885,3288,13469,2230,24597,3157,1569,1588
35985,27888,3288,13471,2230,24600,3158,1570,1588
35990,27893,3289,13474,2231,24604,3158,1570,1588
35995,27897,3289,13478,2231,24608,3158,1570,1588
36000,27900,3289,13479,2231,24611,3158,1570,1588
36005,27901,3290,13480,2232,24611,3158,1570,1588
36010,27906,3291,13481,2232,24615,3158,1570,1588
36015,27908,3291,13483,2232,24617,3159,1571,1588
36020,27916,3292,13488,2233,24624,3159,1571,1588
36025,27919,3292,13489,2233,24627,3160,1572,1588
36030,27924,3293,13490,2233,24631,3160,1572,1588
36035,27928,3293,13494,2233,24635,3160,1572,1588
36040,27931,3293,13494,2233,24638,3160,1572,1588
36045,27932,3294,13495,2234,24638,3160,1572,1588
36050,27937,3295,13499,2235,24642,3161,1573,1588
36055,27939,3295,13500,2235,24644,3162,1573,1589
36060,27947,3298,13503,2237,24648,3164,1573,1591
36065,27950,3299,13505,2238,24651,3164,1573,1591
36070,27955,3300,13508,2239,24655,3164,1573,1591
36075,27959,3300,13509,2239,24659,3164,1573,1591
36080,27962,3300,13511,2239,24662,3164,1573,1591
36085,27963,3300,13512,2239,24663,3164,1573,1591
36090,27968,3300,13514,2239,24668,3165,1573,1592
36095,27970,3300,13515,2239,24670,3166,1573,1593
36100,27978,3300,13520,2239,24678,3166,1573,1593
36105,27981,3300,13521,2239,24681,3166,1573,1593
36110,27986,3301,13522,2239,24685,3166,1573,1593
36115,27990,3301,13524,2239,24689,3166,1573,1593
36120,27993,3301,13525,2239,24692,3166,1573,1593
36125,27994,3301,13525,2239,24693,3166,1573,1593
36130,27999,3301,13526,2239,24698,3167,1574,1593
36135,28001,3301,13527,2239,24700,3168,1575,1593
36140,28009,3302,13531,2240,24707,3168,1575,1593
36145,28012,3303,13532,2241,24709,3168,1575,1593
36150,28017,3304,13536,2242,24713,3168,1575,1593
36155,28021,3304,13537,2242,24717,3168,1575,1593
36160,28024,3304,13538,2242,24720,3168,1575,1593
36165,28025,3304,13539,2242,24721,3168,1575,1593
36170,28030,3305,13541,2242,24725,3169,1575,1594
36175,28032,3305,13542,2242,24727,3170,1576,1594
36180,28040,3307,13545,2243,24732,3172,1576,1596
36185,28043,3308,13548,2244,24735,3172,1576,1596
36190,28048,3309,13551,2245,24739,3173,1576,1597
36195,28052,3309,13554,2245,24742,3173,1576,1597
36200,28055,3310,13556,2246,24745,3173,1576,1597
36205,28056,3310,13556,2246,24746,3173,1576,1597
36210,28061,3310,13558,2246,24751,3173,1576,1597
36215,28063,3310,13559,2246,24753,3174,1577,1597
36220,28071,3310,13561,2246,24761,3174,1577,1597
36225,28074,3310,13562,2246,24764,3174,1577,1597
36230,28079,3311,13564,2246,24768,3175,1578,1597
36235,28083,3311,13564,2246,24772,3175,1578,1597
36240,28086,3311,13565,2246,24775,3175,1578,1597
36245,28087,3311,13566,2246,24776,3175,1578,1597
36250,28092,3311,13569,2246,24781,3175,1578,1597
36255,28094,3311,13570,2246,24783,3176,1579,1597
36260,28102,3312,13574,2246,24790,3176,1579,1597
36265,28105,3313,13576,2247,24792,3176,1579,1597
36270,28110,3314,13577,2247,24796,3177,1579,1598
36275,28114,3314,13578,2247,24800,3177,1579,1598
36280,28117,3314,13578,2247,24803,3177,1579,1598
36285,28118,3314,13579,2247,24804,3177,1579,1598
36290,28123,3315,13580,2247,24808,3178,1579,1599
36295,28125,3315,13580,2247,24810,3179,1579,1600
36300,28133,3317,13584,2248,24815,3181,1581,1600
36305,28136,3318,13586,2249,24818,3181,1581,1600
36310,28141,3318,13588,2249,24823,3181,1581,1600
36315,28145,3318,13589,2249,24827,3181,1581,1600
36320,28148,3318,13591,2249,24830,3181,1581,1600
36325,28149,3319,13592,2250,24830,3181,1581,1600
36330,28154,3320,13594,2250,24834,3182,1582,1600
36335,28156,3320,13595,2250,24836,3183,1583,1600
36340,28164,3320,13599,2250,24844,3183,1583,1600
36345,28167,3320,13599,2250,24847,3183,1583,1600
36350,28172,3320,13602,2250,24852,3183,1583,1600
36355,28176,3320,13603,2250,24856,3183,1583,1600
36360,28179,3320,13604,2250,24859,3183,1583,1600
36365,28180,3320,13604,2250,24860,3183,1583,1600
36370,28185,3321,13607,2250,24864,3184,1583,1601
36375,28187,3321,13609,2250,24866,3185,1584,1601
36380,28195,3322,13617,2251,24873,3185,1584,1601
36385,28198,3323,13619,2252,24875,3185,1584,1601
36390,28203,3323,13621,2252,24880,3185,1584,1601
36395,28207,3323,13623,2252,24884,3185,1584,1601
36400,28210,3323,13624,2252,24887,3185,1584,1601
36405,28211,3323,13624,2252,24888,3185,1584,1601
36410,28216,3324,13626,2252,24892,3186,1584,1602
36415,28218,3324,13626,2252,24894,3187,1584,1603
36420,28226,3325,13628,2252,24900,3189,1585,1604
36425,28229,3326,13629,2253,24903,3189,1585,1604
36430,28234,3327,13633,2254,24907,3190,1585,1605
36435,28238,3327,13635,2254,24911,3190,1585,1605
36440,28241,3327,13637,2254,24914,3190,1585,1605
36445,28242,3327,13638,2254,24915,3190,1585,1605
36450,28247,3328,13642,2254,24919,3191,1586,1605
36455,28249,3328,13643,2254,24921,3192,1586,1606
36460,28257,3328,13645,2254,24929,3192,1586,1606
36465,28260,3328,13645,2254,24932,3192,1586,1606
36470,28265,3329,13647,2255,24936,3193,1586,1607
36475,28269,3329,13648,2255,24940,3193,1586,1607
36480,28272,3329,13649,2255,24943,3193,1586,1607
36485,28273,3330,13650,2256,24943,3193,1586,1607
36490,28278,3331,13654,2257,24947,3193,1586,1607
36495,28280,3331,13654,2257,24949,3194,1586,1608
36500,28288,3332,13660,2258,24956,3194,1586,1608
36505,28291,3332,13661,2258,24959,3195,1587,1608
36510,28296,3333,13665,2259,24963,3196,1588,1608
36515,28300,3333,13667,2259,24967,3196,1588,1608
36520,28303,3333,13669,2259,24970,3196,1588,1608
36525,28304,3333,13669,2259,24971,3196,1588,1608
36530,28309,3334,13671,2260,24975,3196,1588,1608
36535,28311,3334,13672,2260,24977,3197,1589,1608
36540,28319,3334,13674,2260,24985,3198,1589,1609
36545,28322,3334,13676,2260,24988,3198,1589,1609
36550,28327,3334,13677,2260,24993,3198,1589,1609
36555,28331,3334,13677,2260,24997,3199,1589,1610
36560,28334,3334,13679,2260,25000,3199,1589,1610
36565,28335,3334,13679,2260,25001,3199,1589,1610
36570,28340,3335,13679,2260,25005,3200,1589,1611
36575,28342,3335,13679,2260,25007,3201,1589,1612
36580,28350,3335,13683,2260,25015,3201,1589,1612
36585,28353,3335,13684,2260,25018,3201,1589,1612
36590,28358,3335,13687,2260,25023,3201,1589,1612
36595,28362,3335,13688,2260,25027,3201,1589,1612
36600,28365,3335,13688,2260,25030,3201,1589,1612
36605,28366,3335,13688,2260,25031,3201,1589,1612
36610,28371,3335,13690,2260,25036,3201,1589,1612
36615,28373,3335,13692,2260,25038,3202,1590,1612
36620,28381,3336,13696,2261,25045,3202,1590,1612
36625,28384,3336,13697,2261,25048,3202,1590,1612
36630,28389,3336,13700,2261,25053,3202,1590,1612
36635,28393,3336,13700,2261,25057,3202,1590,1612
36640,28396,3336,13700,2261,25060,3202,1590,1612
36645,28397,3336,13700,2261,25061,3202,1590,1612
36650,28402,3336,13703,2261,25066,3202,1590,1612
36655,28404,3336,13705,2261,25068,3203,1591,1612
36660,28412,3337,13708,2261,25075,3204,1591,1613
36665,28415,3337,13710,2261,25078,3204,1591,1613
36670,28420,3338,13711,2261,25082,3205,1591,1614
36675,28424,3338,13712,2261,25086,3205,1591,1614
36680,28427,3339,13715,2262,25088,3205,1591,1614
36685,28428,3339,13715,2262,25089,3205,1591,1614
36690,28433,3339,13717,2262,25094,3205,1591,1614
36695,28435,3339,13719,2262,25096,3206,1592,1614
36700,28443,3340,13723,2262,25102,3207,1593,1614
36705,28446,3341,13725,2263,25105,3208,1594,1614
36710,28451,3342,13726,2263,25109,3209,1594,1615
36715,28455,3342,13729,2263,25113,3209,1594,1615
36720,28458,3343,13731,2264,25115,3209,1594,1615
36725,28459,3343,13732,2264,25116,3209,1594,1615
36730,28464,3344,13734,2265,25120,3210,1594,1616
36735,28466,3344,13735,2265,25122,3211,1595,1616
36740,28474,3345,13740,2266,25129,3211,1595,1616
36745,28477,3345,13741,2266,25132,3212,1595,1617
36750,28482,3346,13743,2266,25136,3212,1595,1617
36755,28486,3346,13744,2266,25140,3212,1595,1617
36760,28489,3346,13745,2266,25143,3212,1595,1617
36765,28490,3346,13746,2266,25144,3212,1595,1617
36770,28495,3347,13749,2267,25148,3212,1595,1617
36775,28497,3347,13751,2267,25150,3213,1596,1617
36780,28505,3349,13754,2268,25156,3213,1596,1617
36785,28508,3350,13756,2269,25158,3214,1596,1618
36790,28513,3351,13759,2270,25162,3214,1596,1618
36795,28517,3351,13762,2270,25166,3215,1596,1619
36800,28520,3352,13764,2271,25168,3215,1596,1619
36805,28521,3352,13765,2271,25169,3215,1596,1619
36810,28526,3353,13767,2271,25173,3215,1596,1619
36815,28528,3353,13769,2271,25175,3216,1597,1619
36820,28536,3354,13773,2272,25182,3216,1597,1619
36825,28539,3355,13775,2273,25184,3217,1598,1619
36830,28544,3356,13778,2274,25188,3218,1598,1620
36835,28548,3356,13779,2274,25192,3219,1599,1620
36840,28551,3356,13780,2274,25195,3219,1599,1620
36845,28552,3356,13780,2274,25196,3219,1599,1620
36850,28557,3357,13783,2274,25200,3220,1600,1620
36855,28559,3357,13784,2274,25202,3221,1600,1621
36860,28567,3359,13787,2275,25208,3221,1600,1621
36865,28570,3359,13787,2275,25211,3221,1600,1621
36870,28575,3360,13789,2275,25215,3222,1601,1621
36875,28579,3360,13790,2275,25219,3222,1601,1621
36880,28582,3360,13792,2275,25222,3222,1601,1621
36885,28583,3360,13792,2275,25223,3222,1601,1621
36890,28588,3361,13794,2275,25227,3223,1601,1622
36895,28590,3361,13795,2275,25229,3224,1601,1623
36900,28598,3362,13798,2276,25236,3224,1601,1623
36905,28601,3362,13800,2276,25239,3225,1602,1623
36910,28606,3363,13804,2277,25243,3226,1603,1623
36915,28610,3363,13806,2277,25247,3226,1603,1623
36920,28613,3363,13808,2277,25250,3226,1603,1623
36925,28614,3363,13809,2277,25251,3226,1603,1623
36930,28619,3364,13812,2277,25255,3226,1603,1623
36935,28621,3364,13814,2277,25257,3227,1604,1623
36940,28629,3365,13816,2278,25263,3228,1604,1624
36945,28632,3366,13817,2279,25266,3229,1605,1624
36950,28637,3367,13819,2280,25270,3230,1605,1625
36955,28641,3367,13820,2280,25274,3231,1606,1625
36960,28644,3367,13820,2280,25277,3231,1606,1625
36965,28645,3367,13820,2280,25278,3231,1606,1625
36970,28650,3368,13823,2281,25282,3232,1607,1625
36975,28652,3368,13823,2281,25284,3233,1607,1626
36980,28660,3368,13825,2281,25292,3234,1607,1627
36985,28663,3368,13827,2281,25295,3234,1607,1627
36990,28668,3369,13829,2281,25299,3234,1607,1627
36995,28672,3369,13831,2281,25303,3234,1607,1627
37000,28675,3369,13831,2281,25306,3234,1607,1627
37005,28676,3369,13831,2281,25307,3234,1607,1627
37010,28681,3370,13836,2282,25311,3235,1608,1627
37015,28683,3370,13836,2282,25313,3236,1608,1628
37020,28691,3371,13840,2283,25320,3237,1608,1629
37025,28694,3371,13841,2283,25323,3237,1608,1629
37030,28699,3372,13845,2284,25327,3237,1608,1629
37035,28703,3372,13846,2284,25331,3237,1608,1629
37040,28706,3372,13847,2284,25334,3237,1608,1629
37045,28707,3373,13848,2285,25334,3237,1608,1629
37050,28712,3374,13852,2286,25338,3238,1609,1629
37055,28714,3374,13853,2286,25340,3239,1610,1629
37060,28722,3375,13857,2287,25347,3239,1610,1629
37065,28725,3375,13860,2287,25350,3239,1610,1629
37070,28730,3376,13863,2287,25354,3239,1610,1629
37075,28734,3376,13865,2287,25358,3239,1610,1629
37080,28737,3376,13868,2287,25361,3239,1610,1629
37085,28738,3376,13868,2287,25362,3239,1610,1629
37090,28743,3377,13870,2288,25366,3239,1610,1629
37095,28745,3377,13871,2288,25368,3240,1611,1629
37100,28753,3378,13874,2289,25375,3240,1611,1629
37105,28756,3379,13877,2290,25377,3240,1611,1629
37110,28761,3380,13879,2291,25381,3241,1612,1629
37115,28765,3380,13881,2291,25385,3241,1612,1629
37120,28768,3380,13883,2291,25388,3241,1612,1629
37125,28769,3380,13883,2291,25389,3241,1612,1629
37130,28774,3381,13885,2292,25393,3241,1612,1629
37135,28776,3381,13887,2292,25395,3242,1613,1629
37140,28784,3382,13890,2292,25402,3243,1614,1629
37145,28787,3383,13892,2293,25404,3244,1615,1629
37150,28792,3384,13896,2294,25408,3244,1615,1629
37155,28796,3384,13898,2294,25412,3244,1615,1629
37160,28799,3384,13900,2294,25415,3244,1615,1629
37165,28800,3385,13901,2295,25415,3244,1615,1629
37170,28805,3386,13902,2295,25419,3245,1616,1629
37175,28807,3386,13902,2295,25421,3246,1616,1630
37180,28815,3387,13906,2295,25428,3246,1616,1630
37185,28818,3388,13907,2296,25430,3247,1616,1631
37190,28823,3389,13909,2297,25434,3247,1616,1631
37195,28827,3389,13912,2297,25437,3248,1617,1631
37200,28830,3391,13913,2299,25439,3248,1617,1631
37205,28831,3391,13914,2299,25440,3248,1617,1631
37210,28836,3391,13915,2299,25445,3248,1617,1631
37215,28838,3391,13915,2299,25447,3249,1617,1632
37220,28846,3392,13918,2299,25454,3249,1617,1632
37225,28849,3392,13920,2299,25457,3250,1618,1632
37230,28854,3393,13922,2299,25461,3250,1618,1632
37235,28858,3393,13922,2299,25465,3251,1618,1633
37240,28861,3394,13924,2300,25467,3251,1618,1633
37245,28862,3394,13925,2300,25468,3251,1618,1633
37250,28867,3394,13928,2300,25473,3251,1618,1633
37255,28869,3394,13929,2300,25475,3252,1619,1633
37260,28877,3395,13935,2301,25482,3253,1620,1633
37265,28880,3395,13935,2301,25485,3254,1620,1634
37270,28885,3396,13937,2302,25489,3255,1621,1634
37275,28889,3396,13938,2302,25493,3255,1621,1634
37280,28892,3396,13939,2302,25496,3255,1621,1634
37285,28893,3396,13939,2302,25497,3255,1621,1634
37290,28898,3396,13940,2302,25502,3255,1621,1634
37295,28900,3396,13941,2302,25504,3256,1622,1634
37300,28908,3397,13945,2302,25510,3257,1622,1635
37305,28911,3398,13947,2303,25513,3258,1623,1635
37310,28916,3399,13948,2303,25517,3259,1624,1635
37315,28920,3399,13950,2303,25521,3259,1624,1635
37320,28923,3399,13951,2303,25524,3259,1624,1635
37325,28924,3400,13952,2304,25524,3259,1624,1635
37330,28929,3401,13954,2304,25528,3259,1624,1635
37335,28931,3401,13955,2304,25530,3260,1625,1635
37340,28939,3403,13960,2306,25536,3260,1625,1635
37345,28942,3403,13961,2306,25539,3261,1625,1636
37350,28947,3403,13963,2306,25544,3262,1626,1636
37355,28951,3403,13966,2306,25548,3262,1626,1636
37360,28954,3403,13969,2306,25551,3262,1626,1636
37365,28955,3403,13969,2306,25552,3262,1626,1636
37370,28960,3404,13972,2306,25556,3262,1626,1636
37375,28962,3404,13972,2306,25558,3263,1626,1637
37380,28970,3406,13976,2308,25564,3263,1626,1637
37385,28973,3406,13977,2308,25567,3264,1627,1637
37390,28978,3407,13977,2308,25571,3264,1627,1637
37395,28982,3407,13979,2308,25575,3264,1627,1637
37400,28985,3407,13979,2308,25578,3264,1627,1637
37405,28986,3408,13980,2309,25578,3264,1627,1637
37410,28991,3409,13984,2309,25582,3264,1627,1637
37415,28993,3409,13985,2309,25584,3265,1627,1638
37420,29001,3410,13986,2309,25591,3265,1627,1638
37425,29004,3410,13986,2309,25594,3266,1627,1639
37430,29009,3411,13989,2309,25598,3266,1627,1639
37435,29013,3411,13990,2309,25601,3266,1627,1639
37440,29016,3412,13990,2310,25604,3266,1627,1639
37445,29017,3412,13990,2310,25605,3266,1627,1639
37450,29022,3412,13992,2310,25610,3267,1627,1640
37455,29024,3412,13993,2310,25612,3268,1628,1640
37460,29032,3413,13995,2310,25619,3268,1628,1640
37465,29035,3413,13995,2310,25622,3269,1628,1641
37470,29040,3414,13996,2310,25626,3269,1628,1641
37475,29044,3414,13997,2310,25630,3269,1628,1641
37480,29047,3414,13998,2310,25633,3269,1628,1641
37485,29048,3414,13999,2310,25634,3269,1628,1641
37490,29053,3414,14004,2310,25639,3270,1629,1641
37495,29055,3414,14005,2310,25641,3271,1629,1642
37500,29063,3416,14010,2312,25647,3271,1629,1642
37505,29066,3417,14012,2313,25649,3271,1629,1642
37510,29071,3418,14014,2313,25653,3271,1629,1642
37515,29075,3418,14016,2313,25657,3272,1630,1642
37520,29078,3418,14017,2313,25660,3272,1630,1642
37525,29079,3418,14017,2313,25661,3272,1630,1642
37530,29084,3418,14020,2313,25666,3273,1630,1643
37535,29086,3418,14022,2313,25668,3274,1631,1643
37540,29094,3418,14024,2313,25676,3274,1631,1643
37545,29097,3418,14024,2313,25679,3274,1631,1643
37550,29102,3419,14027,2313,25683,3275,1632,1643
37555,29106,3419,14029,2313,25687,3276,1633,1643
37560,29109,3420,14031,2314,25689,3276,1633,1643
37565,29110,3421,14032,2315,25689,3276,1633,1643
37570,29115,3422,14036,2315,25693,3276,1633,1643
37575,29117,3422,14037,2315,25695,3277,1634,1643
37580,29125,3422,14041,2315,25703,3277,1634,1643
37585,29128,3422,14043,2315,25706,3277,1634,1643
37590,29133,3422,14047,2315,25711,3277,1634,1643
37595,29137,3422,14048,2315,25715,3277,1634,1643
37600,29140,3422,14049,2315,25718,3277,1634,1643
37605,29141,3422,14049,2315,25719,3277,1634,1643
37610,29146,3423,14051,2315,25723,3277,1634,1643
37615,29148,3423,14052,2315,25725,3278,1635,1643
37620,29156,3423,14054,2315,25733,3278,1635,1643
37625,29159,3423,14057,2315,25736,3278,1635,1643
37630,29164,3423,14060,2315,25741,3279,1636,1643
37635,29168,3423,14062,2315,25745,3279,1636,1643
37640,29171,3423,14063,2315,25748,3279,1636,1643
37645,29172,3424,14064,2316,25748,3279,1636,1643
37650,29177,3425,14067,2317,25752,3279,1636,1643
37655,29179,3425,14069,2317,25754,3280,1637,1643
37660,29187,3425,14072,2317,25762,3280,1637,1643
37665,29190,3425,14072,2317,25765,3280,1637,1643
37670,29195,3426,14075,2318,25769,3281,1637,1644
37675,29199,3426,14078,2318,25772,3281,1637,1644
37680,29202,3429,14080,2321,25773,3281,1637,1644
37685,29203,3429,14080,2321,25774,3281,1637,1644
37690,29208,3429,14082,2321,25779,3282,1637,1645
37695,29210,3429,14084,2321,25781,3283,1638,1645
37700,29218,3430,14091,2322,25788,3283,1638,1645
37705,29221,3431,14092,2323,25790,3283,1638,1645
37710,29226,3432,14096,2323,25794,3283,1638,1645
37715,29230,3432,14099,2323,25798,3283,1638,1645
37720,29233,3432,14100,2323,25801,3283,1638,1645
37725,29234,3432,14101,2323,25802,3283,1638,1645
37730,29239,3432,14103,2323,25807,3284,1639,1645
37735,29241,3432,14105,2323,25809,3285,1640,1645
37740,29249,3433,14108,2324,25816,3285,1640,1645
37745,29252,3434,14111,2325,25818,3285,1640,1645
37750,29257,3435,14113,2325,25822,3285,1640,1645
37755,29261,3435,14115,2325,25826,3285,1640,1645
37760,29264,3435,14116,2325,25829,3285,1640,1645
37765,29265,3435,14117,2325,25830,3285,1640,1645
37770,29270,3435,14119,2325,25835,3285,1640,1645
37775,29272,3435,14121,2325,25837,3286,1641,1645
37780,29280,3436,14125,2326,25844,3286,1641,1645
37785,29283,3436,14127,2326,25847,3286,1641,1645
37790,29288,3437,14130,2327,25851,3287,1641,1646
37795,29292,3437,14131,2327,25854,3288,1641,1647
37800,29295,3438,14132,2328,25857,3288,1641,1647
37805,29296,3438,14133,2328,25858,3288,1641,1647
37810,29301,3439,14136,2328,25862,3288,1641,1647
37815,29303,3439,14136,2328,25864,3289,1641,1648
37820,29311,3440,14139,2329,25871,3289,1641,1648
37825,29314,3440,14140,2329,25874,3289,1641,1648
37830,29319,3441,14141,2329,25878,3289,1641,1648
37835,29323,3441,14143,2329,25882,3289,1641,1648
37840,29326,3441,14146,2329,25885,3289,1641,1648
37845,29327,3441,14146,2329,25886,3289,1641,1648
37850,29332,3442,14148,2330,25890,3289,1641,1648
37855,29334,3442,14148,2330,25892,3290,1641,1649
37860,29342,3443,14152,2331,25899,3290,1641,1649
37865,29345,3443,14153,2331,25902,3290,1641,1649
37870,29350,3444,14155,2331,25906,3290,1641,1649
37875,29354,3444,14156,2331,25910,3290,1641,1649
37880,29357,3444,14157,2331,25913,3290,1641,1649
37885,29358,3445,14158,2332,25913,3290,1641,1649
37890,29363,3446,14160,2332,25917,3291,1642,1649
37895,29365,3446,14161,2332,25919,3292,1642,1650
37900,29373,3447,14167,2333,25926,3292,1642,1650
37905,29376,3447,14167,2333,25929,3292,1642,1650
37910,29381,3448,14168,2333,25933,3292,1642,1650
37915,29385,3448,14170,2333,25937,3293,1643,1650
37920,29388,3449,14171,2334,25939,3293,1643,1650
37925,29389,3449,14172,2334,25940,3293,1643,1650
37930,29394,3450,14174,2334,25944,3293,1643,1650
37935,29396,3450,14174,2334,25946,3294,1643,1651
37940,29404,3451,14179,2335,25953,3294,1643,1651
37945,29407,3451,14179,2335,25956,3295,1643,1652
37950,29412,3452,14181,2335,25960,3296,1643,1653
37955,29416,3452,14182,2335,25964,3297,1644,1653
37960,29419,3453,14184,2336,25966,3297,1644,1653
37965,29420,3453,14185,2336,25967,3297,1644,1653
37970,29425,3454,14187,2336,25971,3297,1644,1653
37975,29427,3454,14188,2336,25973,3298,1645,1653
37980,29435,3455,14194,2337,25980,3298,1645,1653
37985,29438,3455,14196,2337,25983,3299,1646,1653
37990,29443,3456,14199,2337,25987,3300,1646,1654
37995,29447,3456,14200,2337,25991,3301,1646,1655
38000,29450,3457,14203,2338,25993,3301,1646,1655
38005,29451,3457,14203,2338,25994,3301,1646,1655
38010,29456,3458,14206,2339,25998,3301,1646,1655
38015,29458,3458,14208,2339,26000,3302,1647,1655
38020,29466,3459,14213,2340,26007,3302,1647,1655
38025,29469,3459,14214,2340,26010,3303,1647,1656
38030,29474,3460,14216,2341,26014,3304,1648,1656
38035,29478,3460,14218,2341,26018,3305,1649,1656
38040,29481,3461,14220,2342,26020,3305,1649,1656
38045,29482,3461,14220,2342,26021,3305,1649,1656
38050,29487,3462,14222,2342,26025,3305,1649,1656
38055,29489,3462,14223,2342,26027,3306,1650,1656
38060,29497,3463,14227,2342,26034,3306,1650,1656
38065,29500,3464,14229,2343,26036,3306,1650,1656
38070,29505,3464,14232,2343,26041,3306,1650,1656
38075,29509,3464,14235,2343,26045,3306,1650,1656
38080,29512,3464,14236,2343,26048,3306,1650,1656
38085,29513,3464,14236,2343,26049,3306,1650,1656
38090,29518,3465,14239,2343,26053,3307,1651,1656
38095,29520,3465,14241,2343,26055,3308,1652,1656
38100,29528,3466,14248,2344,26062,3308,1652,1656
38105,29531,3467,14250,2345,26064,3308,1652,1656
38110,29536,3467,14254,2345,26069,3308,1652,1656
38115,29540,3467,14256,2345,26073,3308,1652,1656
38120,29543,3467,14257,2345,26076,3308,1652,1656
38125,29544,3467,14257,2345,26077,3308,1652,1656
38130,29549,3468,14258,2345,26081,3309,1652,1657
38135,29551,3468,14260,2345,26083,3310,1653,1657
38140,29559,3469,14265,2345,26090,3310,1653,1657
38145,29562,3469,14266,2345,26093,3310,1653,1657
38150,29567,3471,14268,2347,26096,3311,1653,1658
38155,29571,3471,14268,2347,26100,3312,1653,1659
38160,29574,3473,14270,2349,26101,3312,1653,1659
38165,29575,3474,14271,2350,26101,3312,1653,1659
38170,29580,3475,14274,2351,26105,3313,1654,1659
38175,29582,3475,14275,2351,26107,3314,1655,1659
38180,29590,3475,14277,2351,26115,3315,1655,1660
38185,29593,3475,14278,2351,26118,3316,1655,1661
38190,29598,3476,14281,2351,26122,3317,1656,1661
38195,29602,3476,14283,2351,26126,3318,1656,1662
38200,29605,3476,14284,2351,26129,3318,1656,1662
38205,29606,3477,14285,2352,26129,3318,1656,1662
38210,29611,3478,14288,2353,26133,3318,1656,1662
38215,29613,3478,14288,2353,26135,3319,1656,1663
38220,29621,3478,14292,2353,26143,3319,1656,1663
38225,29624,3478,14293,2353,26146,3320,1656,1664
38230,29629,3479,14296,2354,26150,3320,1656,1664
38235,29633,3479,14299,2354,26154,3321,1656,1665
38240,29636,3479,14300,2354,26157,3321,1656,1665
38245,29637,3480,14301,2355,26157,3321,1656,1665
38250,29642,3481,14303,2355,26161,3321,1656,1665
38255,29644,3481,14305,2355,26163,3322,1657,1665
38260,29652,3481,14309,2355,26171,3322,1657,1665
38265,29655,3481,14312,2355,26174,3323,1658,1665
38270,29660,3483,14315,2356,26177,3323,1658,1665
38275,29664,3483,14318,2356,26180,3324,1658,1666
38280,29667,3486,14321,2359,26181,3324,1658,1666
38285,29668,3486,14322,2359,26182,3324,1658,1666
38290,29673,3486,14324,2359,26187,3324,1658,1666
38295,29675,3486,14326,2359,26189,3325,1659,1666
38300,29683,3488,14330,2360,26195,3327,1660,1667
38305,29686,3488,14330,2360,26198,3328,1660,1668
38310,29691,3489,14331,2360,26202,3328,1660,1668
38315,29695,3489,14334,2360,26205,3328,1660,1668
38320,29698,3491,14337,2362,26207,3328,1660,1668
38325,29699,3491,14337,2362,26208,3328,1660,1668
38330,29704,3491,14339,2362,26213,3328,1660,1668
38335,29706,3491,14340,2362,26215,3329,1661,1668
38340,29714,3492,14343,2363,26222,3331,1662,1669
38345,29717,3493,14345,2364,26224,3332,1662,1670
38350,29722,3494,14346,2364,26228,3332,1662,1670
38355,29726,3494,14349,2364,26232,3332,1662,1670
38360,29729,3494,14350,2364,26235,3332,1662,1670
38365,29730,3494,14350,2364,26236,3332,1662,1670
38370,29735,3494,14353,2364,26241,3332,1662,1670
38375,29737,3494,14354,2364,26243,3333,1663,1670
38380,29745,3496,14359,2366,26249,3334,1663,1671
38385,29748,3496,14359,2366,26252,3335,1663,1672
38390,29753,3497,14362,2367,26256,3335,1663,1672
38395,29757,3497,14365,2367,26259,3336,1664,1672
38400,29760,3500,14367,2370,26260,3336,1664,1672
38405,29761,3501,14368,2371,26260,3336,1664,1672
38410,29766,3502,14370,2371,26264,3337,1664,1673
38415,29768,3502,14371,2371,26266,3338,1664,1674
38420,29776,3503,14376,2372,26272,3338,1664,1674
38425,29779,3504,14379,2373,26275,3339,1665,1674
38430,29784,3505,14382,2373,26279,3339,1665,1674
38435,29788,3505,14385,2373,26283,3340,1666,1674
38440,29791,3506,14387,2374,26285,3340,1666,1674
38445,29792,3506,14387,2374,26286,3340,1666,1674
38450,29797,3507,14390,2374,26290,3341,1666,1675
38455,29799,3507,14391,2374,26292,3342,1667,1675
38460,29807,3508,14396,2375,26298,3342,1667,1675
38465,29810,3509,14396,2376,26301,3343,1667,1676
38470,29815,3509,14398,2376,26306,3343,1667,1676
38475,29819,3509,14400,2376,26310,3344,1668,1676
38480,29822,3509,14401,2376,26313,3344,1668,1676
38485,29823,3509,14401,2376,26314,3344,1668,1676
38490,29828,3510,14405,2377,26318,3345,1669,1676
38495,29830,3510,14406,2377,26320,3346,1670,1676
38500,29838,3510,14411,2377,26328,3346,1670,1676
38505,29841,3510,14414,2377,26331,3347,1671,1676
38510,29846,3510,14417,2377,26336,3348,1672,1676
38515,29850,3510,14419,2377,26340,3349,1672,1677
38520,29853,3510,14419,2377,26343,3349,1672,1677
38525,29854,3511,14420,2378,26343,3349,1672,1677
38530,29859,3512,14421,2379,26347,3349,1672,1677
38535,29861,3512,14423,2379,26349,3350,1673,1677
38540,29869,3513,14426,2379,26356,3351,1673,1678
38545,29872,3514,14428,2380,26358,3352,1673,1679
38550,29877,3514,14429,2380,26363,3353,1674,1679
38555,29881,3514,14430,2380,26367,3353,1674,1679
38560,29884,3514,14430,2380,26370,3353,1674,1679
38565,29885,3514,14430,2380,26371,3353,1674,1679
38570,29890,3515,14434,2381,26375,3353,1674,1679
38575,29892,3515,14435,2381,26377,3354,1675,1679
38580,29900,3516,14440,2382,26384,3355,1675,1680
38585,29903,3516,14441,2382,26387,3356,1676,1680
38590,29908,3516,14444,2382,26392,3356,1676,1680
38595,29912,3516,14446,2382,26396,3357,1677,1680
38600,29915,3516,14448,2382,26399,3357,1677,1680
38605,29916,3516,14448,2382,26400,3357,1677,1680
38610,29921,3517,14451,2383,26404,3357,1677,1680
38615,29923,3517,14453,2383,26406,3358,1678,1680
38620,29931,3518,14456,2383,26413,3358,1678,1680
38625,29934,3519,14457,2384,26415,3359,1678,1681
38630,29939,3519,14459,2384,26419,3359,1678,1681
38635,29943,3520,14460,2385,26422,3360,1678,1682
38640,29946,3522,14461,2387,26424,3360,1678,1682
38645,29947,3522,14462,2387,26425,3360,1678,1682
38650,29952,3523,14465,2387,26429,3360,1678,1682
38655,29954,3523,14466,2387,26431,3361,1679,1682
38660,29962,3523,14472,2387,26439,3362,1680,1682
38665,29965,3523,14474,2387,26442,3362,1680,1682
38670,29970,3524,14475,2387,26446,3362,1680,1682
38675,29974,3524,14476,2387,26450,3362,1680,1682
38680,29977,3524,14479,2387,26453,3362,1680,1682
38685,29978,3524,14480,2387,26454,3362,1680,1682
38690,29983,3525,14483,2388,26458,3362,1680,1682
38695,29985,3525,14484,2388,26460,3363,1680,1683
38700,29993,3525,14487,2388,26468,3364,1681,1683
38705,29996,3525,14490,2388,26471,3364,1681,1683
38710,30001,3526,14492,2389,26475,3364,1681,1683
38715,30005,3526,14495,2389,26478,3364,1681,1683
38720,30008,3527,14496,2390,26481,3364,1681,1683
38725,30009,3527,14497,2390,26482,3364,1681,1683
38730,30014,3528,14500,2391,26486,3364,1681,1683
38735,30016,3528,14500,2391,26488,3365,1681,1684
38740,30024,3528,14506,2391,26496,3365,1681,1684
38745,30027,3528,14508,2391,26499,3365,1681,1684
38750,30032,3529,14512,2392,26503,3365,1681,1684
38755,30036,3529,14515,2392,26506,3366,1682,1684
38760,30039,3530,14515,2393,26509,3366,1682,1684
38765,30040,3531,14516,2394,26509,3366,1682,1684
38770,30045,3531,14516,2394,26514,3367,1682,1685
38775,30047,3531,14517,2394,26516,3368,1683,1685
38780,30055,3532,14518,2394,26523,3368,1683,1685
38785,30058,3533,14520,2395,26525,3368,1683,1685
38790,30063,3534,14524,2395,26529,3368,1683,1685
38795,30067,3534,14526,2395,26533,3369,1684,1685
38800,30070,3534,14528,2395,26536,3369,1684,1685
38805,30071,3534,14528,2395,26537,3369,1684,1685
38810,30076,3534,14529,2395,26542,3370,1684,1686
38815,30078,3534,14529,2395,26544,3371,1684,1687
38820,30086,3535,14533,2395,26551,3371,1684,1687
38825,30089,3535,14533,2395,26554,3371,1684,1687
38830,30094,3536,14537,2396,26558,3372,1684,1688
38835,30098,3536,14539,2396,26562,3372,1684,1688
38840,30101,3537,14542,2397,26564,3372,1684,1688
38845,30102,3537,14543,2397,26565,3372,1684,1688
38850,30107,3537,14545,2397,26570,3372,1684,1688
38855,30109,3537,14547,2397,26572,3373,1685,1688
38860,30117,3538,14552,2398,26579,3374,1685,1689
38865,30120,3538,14552,2398,26582,3374,1685,1689
38870,30125,3539,14552,2398,26586,3375,1685,1690
38875,30129,3539,14555,2398,26589,3375,1685,1690
38880,30132,3540,14556,2399,26592,3375,1685,1690
38885,30133,3540,14557,2399,26593,3375,1685,1690
38890,30138,3540,14558,2399,26598,3375,1685,1690
38895,30140,3540,14559,2399,26600,3376,1685,1691
38900,30148,3541,14563,2400,26607,3376,1685,1691
38905,30151,3541,14564,2400,26610,3376,1685,1691
38910,30156,3542,14565,2400,26614,3376,1685,1691
38915,30160,3542,14567,2400,26618,3376,1685,1691
38920,30163,3542,14567,2400,26621,3376,1685,1691
38925,30164,3542,14567,2400,26622,3376,1685,1691
38930,30169,3542,14569,2400,26627,3377,1686,1691
38935,30171,3542,14570,2400,26629,3378,1687,1691
38940,30179,3543,14574,2401,26636,3378,1687,1691
38945,30182,3544,14577,2402,26638,3379,1688,1691
38950,30187,3545,14579,2402,26642,3379,1688,1691
38955,30191,3545,14582,2402,26646,3379,1688,1691
38960,30194,3545,14583,2402,26649,3379,1688,1691
38965,30195,3545,14583,2402,26650,3379,1688,1691
38970,30200,3546,14586,2403,26654,3379,1688,1691
38975,30202,3546,14587,2403,26656,3380,1688,1692
38980,30210,3547,14591,2404,26663,3380,1688,1692
38985,30213,3547,14592,2404,26666,3381,1689,1692
38990,30218,3548,14593,2405,26670,3382,1689,1693
38995,30222,3548,14594,2405,26674,3383,1689,1694
39000,30225,3548,14595,2405,26677,3383,1689,1694
39005,30226,3548,14595,2405,26678,3383,1689,1694
39010,30231,3549,14598,2405,26682,3383,1689,1694
39015,30233,3549,14599,2405,26684,3384,1690,1694
39020,30241,3552,14604,2407,26689,3386,1691,1695
39025,30244,3552,14605,2407,26692,3386,1691,1695
39030,30249,3553,14606,2407,26696,3387,1691,1696
39035,30253,3553,14609,2407,26700,3388,1692,1696
39040,30256,3554,14611,2408,26702,3388,1692,1696
39045,30257,3554,14612,2408,26703,3388,1692,1696
39050,30262,3555,14615,2409,26707,3389,1692,1697
39055,30264,3555,14616,2409,26709,3390,1693,1697
39060,30272,3556,14617,2409,26716,3392,1693,1699
39065,30275,3557,14620,2410,26718,3392,1693,1699
39070,30280,3558,14620,2410,26722,3393,1693,1700
39075,30284,3558,14622,2410,26726,3394,1693,1701
39080,30287,3559,14624,2411,26728,3394,1693,1701
39085,30288,3560,14625,2412,26728,3394,1693,1701
39090,30293,3561,14628,2412,26732,3394,1693,1701
39095,30295,3561,14629,2412,26734,3395,1693,1702
39100,30303,3562,14631,2413,26741,3395,1693,1702
39105,30306,3562,14632,2413,26744,3395,1693,1702
39110,30311,3564,14634,2415,26747,3396,1693,1703
39115,30315,3564,14636,2415,26750,3397,1693,1704
39120,30318,3566,14637,2417,26752,3397,1693,1704
39125,30319,3567,14638,2418,26752,3397,1693,1704
39130,30324,3568,14641,2419,26756,3397,1693,1704
39135,30326,3568,14642,2419,26758,3398,1693,1705
39140,30334,3568,14647,2419,26766,3398,1693,1705
39145,30337,3568,14649,2419,26769,3398,1693,1705
39150,30342,3568,14650,2419,26774,3398,1693,1705
39155,30346,3568,14652,2419,26778,3398,1693,1705
39160,30349,3568,14652,2419,26781,3398,1693,1705
39165,30350,3569,14653,2420,26781,3398,1693,1705
39170,30355,3570,14656,2420,26785,3399,1694,1705
39175,30357,3570,14657,2420,26787,3400,1695,1705
39180,30365,3573,14662,2422,26791,3401,1695,1706
39185,30368,3574,14662,2423,26794,3402,1695,1707
39190,30373,3574,14664,2423,26799,3402,1695,1707
39195,30377,3574,14666,2423,26803,3402,1695,1707
39200,30380,3574,14667,2423,26806,3402,1695,1707
39205,30381,3574,14667,2423,26807,3402,1695,1707
39210,30386,3574,14670,2423,26812,3402,1695,1707
39215,30388,3574,14671,2423,26814,3403,1696,1707
39220,30396,3575,14676,2423,26821,3403,1696,1707
39225,30399,3575,14676,2423,26824,3404,1696,1708
39230,30404,3576,14679,2423,26828,3405,1697,1708
39235,30408,3576,14682,2423,26832,3406,1698,1708
39240,30411,3576,14684,2423,26835,3406,1698,1708
39245,30412,3576,14684,2423,26836,3406,1698,1708
39250,30417,3576,14687,2423,26841,3406,1698,1708
39255,30419,3576,14688,2423,26843,3407,1698,1709
39260,30427,3577,14693,2423,26849,3408,1699,1709
39265,30430,3579,14695,2425,26851,3409,1699,1710
39270,30435,3580,14698,2426,26855,3410,1700,1710
39275,30439,3580,14699,2426,26859,3411,1700,1711
39280,30442,3581,14700,2427,26861,3411,1700,1711
39285,30443,3581,14700,2427,26862,3411,1700,1711
39290,30448,3582,14702,2427,26866,3412,1700,1712
39295,30450,3582,14703,2427,26868,3413,1701,1712
39300,30458,3584,14707,2428,26874,3415,1702,1713
39305,30461,3584,14707,2428,26877,3415,1702,1713
39310,30466,3585,14707,2428,26881,3416,1702,1714
39315,30470,3585,14709,2428,26885,3417,1703,1714
39320,30473,3586,14711,2429,26887,3417,1703,1714
39325,30474,3586,14711,2429,26888,3417,1703,1714
39330,30479,3586,14715,2429,26893,3418,1703,1715
39335,30481,3586,14715,2429,26895,3419,1703,1716
39340,30489,3588,14720,2431,26901,3419,1703,1716
39345,30492,3588,14722,2431,26904,3419,1703,1716
39350,30497,3589,14724,2432,26908,3420,1704,1716
39355,30501,3589,14727,2432,26912,3421,1705,1716
39360,30504,3589,14728,2432,26915,3421,1705,1716
39365,30505,3589,14728,2432,26916,3421,1705,1716
39370,30510,3589,14730,2432,26921,3421,1705,1716
39375,30512,3589,14730,2432,26923,3422,1705,1717
39380,30520,3590,14733,2432,26930,3422,1705,1717
39385,30523,3591,14735,2433,26932,3422,1705,1717
39390,30528,3592,14740,2434,26936,3423,1706,1717
39395,30532,3592,14741,2434,26940,3423,1706,1717
39400,30535,3592,14743,2434,26943,3423,1706,1717
39405,30536,3592,14744,2434,26944,3423,1706,1717
39410,30541,3593,14744,2434,26948,3423,1706,1717
39415,30543,3593,14746,2434,26950,3424,1707,1717
39420,30551,3594,14748,2435,26957,3426,1707,1719
39425,30554,3594,14749,2435,26960,3426,1707,1719
39430,30559,3595,14752,2435,26964,3426,1707,1719
39435,30563,3595,14754,2435,26968,3426,1707,1719
39440,30566,3595,14756,2435,26971,3426,1707,1719
39445,30567,3595,14756,2435,26972,3426,1707,1719
39450,30572,3595,14761,2435,26977,3427,1708,1719
39455,30574,3595,14763,2435,26979,3428,1709,1719
39460,30582,3596,14768,2435,26986,3428,1709,1719
39465,30585,3597,14771,2436,26988,3428,1709,1719
39470,30590,3598,14774,2437,26992,3428,1709,1719
39475,30594,3598,14777,2437,26996,3428,1709,1719
39480,30597,3598,14779,2437,26999,3428,1709,1719
39485,30598,3598,14780,2437,27000,3428,1709,1719
39490,30603,3598,14784,2437,27005,3429,1710,1719
39495,30605,3598,14785,2437,27007,3430,1710,1720
39500,30613,3599,14789,2438,27014,3430,1710,1720
39505,30616,3599,14790,2438,27017,3430,1710,1720
39510,30621,3600,14792,2438,27021,3430,1710,1720
39515,30625,3600,14795,2438,27025,3430,1710,1720
39520,30628,3600,14796,2438,27028,3430,1710,1720
39525,30629,3600,14796,2438,27029,3430,1710,1720
39530,30634,3601,14800,2439,27033,3431,1710,1721
39535,30636,3601,14801,2439,27035,3432,1711,1721
39540,30644,3603,14805,2440,27040,3434,1713,1721
39545,30647,3604,14806,2441,27043,3434,1713,1721
39550,30652,3605,14808,2442,27047,3434,1713,1721
39555,30656,3605,14812,2442,27051,3434,1713,1721
39560,30659,3605,14812,2442,27054,3434,1713,1721
39565,30660,3606,14813,2443,27054,3434,1713,1721
39570,30665,3607,14817,2443,27058,3435,1714,1721
39575,30667,3607,14818,2443,27060,3436,1715,1721
39580,30675,3607,14823,2443,27068,3436,1715,1721
39585,30678,3607,14825,2443,27071,3436,1715,1721
39590,30683,3608,14828,2443,27075,3436,1715,1721
39595,30687,3608,14831,2443,27079,3436,1715,1721
39600,30690,3608,14832,2443,27082,3436,1715,1721
39605,30691,3608,14832,2443,27083,3436,1715,1721
39610,30696,3609,14835,2444,27087,3437,1716,1721
39615,30698,3609,14836,2444,27089,3438,1717,1721
39620,30706,3610,14840,2444,27096,3438,1717,1721
39625,30709,3610,14842,2444,27099,3439,1718,1721
39630,30714,3611,14843,2445,27103,3439,1718,1721
39635,30718,3611,14843,2445,27107,3439,1718,1721
39640,30721,3611,14844,2445,27110,3439,1718,1721
39645,30722,3611,14844,2445,27111,3439,1718,1721
39650,30727,3612,14846,2446,27115,3440,1718,1722
39655,30729,3612,14847,2446,27117,3441,1719,1722
39660,30737,3614,14850,2447,27122,3442,1719,1723
39665,30740,3615,14850,2448,27125,3442,1719,1723
39670,30745,3616,14851,2448,27129,3442,1719,1723
39675,30749,3616,14852,2448,27133,3443,1719,1724
39680,30752,3617,14854,2449,27135,3443,1719,1724
39685,30753,3617,14854,2449,27136,3443,1719,1724
39690,30758,3617,14857,2449,27141,3443,1719,1724
39695,30760,3617,14859,2449,27143,3444,1720,1724
39700,30768,3618,14866,2450,27150,3444,1720,1724
39705,30771,3618,14868,2450,27153,3444,1720,1724
39710,30776,3619,14869,2450,27157,3445,1721,1724
39715,30780,3619,14870,2450,27161,3446,1721,1725
39720,30783,3620,14872,2451,27163,3446,1721,1725
39725,30784,3620,14873,2451,27164,3446,1721,1725
39730,30789,3620,14876,2451,27169,3446,1721,1725
39735,30791,3620,14878,2451,27171,3447,1722,1725
39740,30799,3621,14882,2452,27178,3448,1723,1725
39745,30802,3621,14884,2452,27181,3448,1723,1725
39750,30807,3622,14887,2453,27185,3449,1724,1725
39755,30811,3622,14888,2453,27189,3450,1724,1726
39760,30814,3623,14889,2454,27191,3450,1724,1726
39765,30815,3623,14890,2454,27192,3450,1724,1726
39770,30820,3624,14893,2455,27196,3450,1724,1726
39775,30822,3624,14894,2455,27198,3451,1724,1727
39780,30830,3626,14898,2457,27204,3453,1725,1728
39785,30833,3626,14898,2457,27207,3453,1725,1728
39790,30838,3626,14902,2457,27212,3454,1726,1728
39795,30842,3626,14903,2457,27216,3455,1726,1729
39800,30845,3626,14905,2457,27219,3455,1726,1729
39805,30846,3626,14906,2457,27220,3455,1726,1729
39810,30851,3626,14907,2457,27225,3455,1726,1729
39815,30853,3626,14908,2457,27227,3456,1726,1730
39820,30861,3627,14911,2458,27234,3456,1726,1730
39825,30864,3628,14913,2459,27236,3456,1726,1730
39830,30869,3628,14916,2459,27241,3457,1727,1730
39835,30873,3628,14917,2459,27245,3458,1727,1731
39840,30876,3628,14918,2459,27248,3458,1727,1731
39845,30877,3628,14918,2459,27249,3458,1727,1731
39850,30882,3628,14921,2459,27254,3458,1727,1731
39855,30884,3628,14922,2459,27256,3459,1727,1732
39860,30892,3629,14924,2460,27263,3459,1727,1732
39865,30895,3630,14926,2461,27265,3459,1727,1732
39870,30900,3630,14928,2461,27270,3459,1727,1732
39875,30904,3630,14931,2461,27274,3459,1727,1732
39880,30907,3630,14933,2461,27277,3459,1727,1732
39885,30908,3630,14933,2461,27278,3459,1727,1732
39890,30913,3631,14935,2461,27282,3459,1727,1732
39895,30915,3631,14937,2461,27284,3460,1728,1732
39900,30923,3633,14942,2463,27290,3462,1730,1732
39905,30926,3633,14942,2463,27293,3462,1730,1732
39910,30931,3634,14946,2463,27297,3462,1730,1732
39915,30935,3634,14949,2463,27301,3462,1730,1732
39920,30938,3634,14951,2463,27304,3462,1730,1732
39925,30939,3634,14951,2463,27305,3462,1730,1732
39930,30944,3635,14954,2463,27309,3462,1730,1732
39935,30946,3635,14954,2463,27311,3463,1730,1733
39940,30954,3635,14956,2463,27319,3463,1730,1733
39945,30957,3635,14958,2463,27322,3463,1730,1733
39950,30962,3636,14961,2463,27326,3463,1730,1733
39955,30966,3636,14962,2463,27330,3464,1730,1734
39960,30969,3636,14962,2463,27333,3464,1730,1734
39965,30970,3637,14963,2464,27333,3464,1730,1734
39970,30975,3638,14966,2465,27337,3464,1730,1734
39975,30977,3638,14968,2465,27339,3465,1731,1734
39980,30985,3639,14971,2466,27346,3465,1731,1734
39985,30988,3640,14974,2467,27348,3465,1731,1734
39990,30993,3641,14978,2468,27352,3465,1731,1734
39995,30997,3641,14981,2468,27356,3466,1732,1734
40000,31000,3641,14983,2468,27359,3466,1732,1734
40005,31001,3642,14984,2469,27359,3466,1732,1734
40010,31006,3643,14986,2469,27363,3467,1732,1735
40015,31008,3643,14988,2469,27365,3468,1733,1735
40020,31016,3645,14993,2471,27370,3470,1734,1736
40025,31019,3647,14996,2473,27372,3471,1735,1736
40030,31024,3648,14997,2474,27376,3472,1735,1737
40035,31028,3648,15000,2474,27380,3472,1735,1737
40040,31031,3648,15001,2474,27383,3472,1735,1737
40045,31032,3648,15001,2474,27384,3472,1735,1737
40050,31037,3649,15003,2474,27388,3472,1735,1737
40055,31039,3649,15003,2474,27390,3473,1735,1738
40060,31047,3650,15007,2474,27397,3473,1735,1738
40065,31050,3650,15007,2474,27400,3474,1735,1739
40070,31055,3651,15010,2474,27404,3475,1735,1740
40075,31059,3651,15012,2474,27408,3475,1735,1740
40080,31062,3651,15013,2474,27411,3475,1735,1740
40085,31063,3652,15014,2475,27411,3475,1735,1740
40090,31068,3653,15018,2476,27415,3475,1735,1740
40095,31070,3653,15019,2476,27417,3476,1736,1740
40100,31078,3654,15020,2476,27424,3476,1736,1740
40105,31081,3655,15022,2477,27426,3477,1737,1740
40110,31086,3656,15024,2477,27430,3478,1738,1740
40115,31090,3656,15026,2477,27434,3478,1738,1740
40120,31093,3656,15028,2477,27437,3478,1738,1740
40125,31094,3656,15028,2477,27438,3478,1738,1740
40130,31099,3657,15029,2477,27442,3479,1739,1740
40135,31101,3657,15030,2477,27444,3480,1740,1740
40140,31109,3660,15034,2479,27449,3482,1741,1741
40145,31112,3660,15036,2479,27452,3482,1741,1741
40150,31117,3661,15038,2479,27456,3482,1741,1741
40155,31121,3661,15040,2479,27460,3483,1742,1741
40160,31124,3661,15041,2479,27463,3483,1742,1741
40165,31125,3661,15042,2479,27464,3483,1742,1741
40170,31130,3662,15045,2479,27468,3483,1742,1741
40175,31132,3662,15046,2479,27470,3484,1743,1741
40180,31140,3662,15048,2479,27478,3484,1743,1741
40185,31143,3662,15049,2479,27481,3484,1743,1741
40190,31148,3663,15051,2479,27485,3484,1743,1741
40195,31152,3663,15053,2479,27488,3485,1743,1742
40200,31155,3665,15055,2481,27490,3485,1743,1742
40205,31156,3666,15056,2482,27490,3485,1743,1742
40210,31161,3667,15058,2482,27494,3485,1743,1742
40215,31163,3667,15058,2482,27496,3486,1743,1743
40220,31171,3667,15060,2482,27504,3486,1743,1743
40225,31174,3667,15060,2482,27507,3487,1743,1744
40230,31179,3668,15062,2482,27511,3487,1743,1744
40235,31183,3668,15064,2482,27515,3488,1743,1745
40240,31186,3668,15064,2482,27518,3488,1743,1745
40245,31187,3668,15064,2482,27519,3488,1743,1745
40250,31192,3669,15066,2482,27523,3489,1743,1746
40255,31194,3669,15068,2482,27525,3490,1744,1746
40260,31202,3670,15071,2483,27531,3492,1744,1748
40265,31205,3671,15071,2484,27534,3493,1744,1749
40270,31210,3672,15073,2484,27538,3493,1744,1749
40275,31214,3672,15073,2484,27542,3493,1744,1749
40280,31217,3672,15073,2484,27545,3493,1744,1749
40285,31218,3672,15074,2484,27546,3493,1744,1749
40290,31223,3672,15074,2484,27551,3493,1744,1749
40295,31225,3672,15075,2484,27553,3494,1745,1749
40300,31233,3673,15079,2484,27560,3494,1745,1749
40305,31236,3673,15079,2484,27563,3495,1745,1750
40310,31241,3674,15083,2485,27567,3495,1745,1750
40315,31245,3674,15086,2485,27571,3495,1745,1750
40320,31248,3674,15088,2485,27574,3495,1745,1750
40325,31249,3674,15089,2485,27575,3495,1745,1750
40330,31254,3674,15092,2485,27580,3495,1745,1750
40335,31256,3674,15092,2485,27582,3496,1745,1751
40340,31264,3675,15098,2485,27589,3496,1745,1751
40345,31267,3675,15100,2485,27592,3497,1746,1751
40350,31272,3676,15101,2485,27596,3497,1746,1751
40355,31276,3676,15104,2485,27600,3497,1746,1751
40360,31279,3676,15106,2485,27603,3497,1746,1751
40365,31280,3676,15107,2485,27604,3497,1746,1751
40370,31285,3677,15110,2485,27608,3498,1746,1752
40375,31287,3677,15112,2485,27610,3499,1747,1752
40380,31295,3679,15117,2486,27616,3501,1749,1752
40385,31298,3680,15118,2487,27618,3501,1749,1752
40390,31303,3681,15120,2488,27622,3501,1749,1752
40395,31307,3681,15121,2488,27626,3502,1749,1753
40400,31310,3682,15124,2489,27628,3502,1749,1753
40405,31311,3682,15124,2489,27629,3502,1749,1753
40410,31316,3682,15126,2489,27634,3502,1749,1753
40415,31318,3682,15126,2489,27636,3503,1749,1754
40420,31326,3683,15131,2489,27643,3503,1749,1754
40425,31329,3684,15132,2490,27645,3503,1749,1754
40430,31334,3685,15135,2491,27649,3503,1749,1754
40435,31338,3685,15136,2491,27653,3504,1749,1755
40440,31341,3686,15138,2492,27655,3504,1749,1755
40445,31342,3686,15139,2492,27656,3504,1749,1755
40450,31347,3686,15139,2492,27661,3504,1749,1755
40455,31349,3686,15140,2492,27663,3505,1749,1756
40460,31357,3687,15145,2493,27670,3505,1749,1756
40465,31360,3688,15147,2494,27672,3505,1749,1756
40470,31365,3689,15149,2494,27676,3505,1749,1756
40475,31369,3689,15151,2494,27680,3506,1750,1756
40480,31372,3689,15152,2494,27683,3506,1750,1756
40485,31373,3689,15152,2494,27684,3506,1750,1756
40490,31378,3690,15155,2495,27688,3507,1751,1756
40495,31380,3690,15155,2495,27690,3508,1751,1757
40500,31388,3691,15157,2495,27696,3510,1752,1758
40505,31391,3692,15158,2496,27699,3510,1752,1758
40510,31396,3693,15163,2497,27703,3511,1753,1758
40515,31400,3693,15165,2497,27707,3511,1753,1758
40520,31403,3693,15167,2497,27710,3511,1753,1758
40525,31404,3693,15167,2497,27711,3511,1753,1758
40530,31409,3694,15170,2498,27715,3512,1754,1758
40535,31411,3694,15170,2498,27717,3513,1754,1759
40540,31419,3694,15173,2498,27725,3514,1755,1759
40545,31422,3694,15173,2498,27728,3514,1755,1759
40550,31427,3695,15175,2498,27732,3515,1756,1759
40555,31431,3695,15176,2498,27736,3515,1756,1759
40560,31434,3695,15178,2498,27739,3515,1756,1759
40565,31435,3695,15178,2498,27740,3515,1756,1759
40570,31440,3696,15181,2499,27744,3516,1757,1759
40575,31442,3696,15183,2499,27746,3517,1758,1759
40580,31450,3698,15186,2500,27752,3517,1758,1759
40585,31453,3698,15187,2500,27755,3517,1758,1759
40590,31458,3699,15188,2500,27759,3517,1758,1759
40595,31462,3699,15191,2500,27763,3517,1758,1759
40600,31465,3699,15194,2500,27766,3517,1758,1759
40605,31466,3700,15195,2501,27766,3517,1758,1759
40610,31471,3701,15200,2502,27770,3518,1759,1759
40615,31473,3701,15202,2502,27772,3519,1760,1759
40620,31481,3704,15206,2504,27776,3520,1761,1759
40625,31484,3705,15206,2505,27779,3520,1761,1759
40630,31489,3705,15207,2505,27784,3520,1761,1759
40635,31493,3705,15209,2505,27788,3520,1761,1759
40640,31496,3705,15210,2505,27791,3520,1761,1759
40645,31497,3705,15210,2505,27792,3520,1761,1759
40650,31502,3705,15215,2505,27797,3520,1761,1759
40655,31504,3705,15216,2505,27799,3521,1762,1759
40660,31512,3705,15218,2505,27807,3521,1762,1759
40665,31515,3705,15220,2505,27810,3521,1762,1759
40670,31520,3705,15221,2505,27815,3521,1762,1759
40675,31524,3705,15224,2505,27819,3521,1762,1759
40680,31527,3705,15225,2505,27822,3521,1762,1759
40685,31528,3705,15226,2505,27823,3521,1762,1759
40690,31533,3705,15228,2505,27828,3521,1762,1759
40695,31535,3705,15229,2505,27830,3522,1763,1759
40700,31543,3706,15232,2505,27837,3522,1763,1759
40705,31546,3706,15232,2505,27840,3523,1763,1760
40710,31551,3707,15235,2505,27844,3523,1763,1760
40715,31555,3707,15238,2505,27847,3523,1763,1760
40720,31558,3708,15238,2506,27850,3523,1763,1760
40725,31559,3708,15238,2506,27851,3523,1763,1760
40730,31564,3709,15240,2506,27855,3523,1763,1760
40735,31566,3709,15241,2506,27857,3524,1763,1761
40740,31574,3710,15244,2507,27864,3526,1763,1763
40745,31577,3711,15245,2508,27866,3526,1763,1763
40750,31582,3712,15248,2509,27870,3527,1763,1764
40755,31586,3712,15248,2509,27874,3527,1763,1764
40760,31589,3712,15250,2509,27877,3527,1763,1764
40765,31590,3712,15250,2509,27878,3527,1763,1764
40770,31595,3712,15254,2509,27883,3528,1763,1765
40775,31597,3712,15256,2509,27885,3529,1764,1765
40780,31605,3713,15262,2510,27892,3530,1764,1766
40785,31608,3713,15264,2510,27895,3530,1764,1766
40790,31613,3714,15266,2511,27899,3531,1764,1767
40795,31617,3714,15268,2511,27903,3532,1764,1768
40800,31620,3715,15269,2512,27905,3532,1764,1768
40805,31621,3715,15269,2512,27906,3532,1764,1768
40810,31626,3716,15271,2512,27910,3533,1764,1769
40815,31628,3716,15272,2512,27912,3534,1765,1769
40820,31636,3716,15274,2512,27920,3534,1765,1769
40825,31639,3716,15274,2512,27923,3535,1765,1770
40830,31644,3716,15277,2512,27928,3535,1765,1770
40835,31648,3716,15278,2512,27932,3536,1765,1771
40840,31651,3716,15279,2512,27935,3536,1765,1771
40845,31652,3716,15279,2512,27936,3536,1765,1771
40850,31657,3717,15281,2512,27940,3536,1765,1771
40855,31659,3717,15283,2512,27942,3537,1766,1771
40860,31667,3717,15287,2512,27949,3538,1766,1772
40865,31670,3717,15289,2512,27953,3538,1766,1772
40870,31675,3717,15292,2512,27958,3539,1767,1772
40875,31679,3717,15294,2512,27962,3539,1767,1772
40880,31682,3717,15296,2512,27965,3539,1767,1772
40885,31683,3717,15296,2512,27966,3539,1767,1772
40890,31688,3718,15296,2512,27970,3539,1767,1772
40895,31690,3718,15297,2512,27972,3540,1767,1773
40900,31698,3719,15300,2513,27979,3541,1767,1774
40905,31701,3719,15301,2513,27982,3541,1767,1774
40910,31706,3721,15303,2514,27985,3542,1767,1775
40915,31710,3721,15306,2514,27988,3542,1767,1775
40920,31713,3723,15309,2516,27990,3542,1767,1775
40925,31714,3723,15309,2516,27991,3542,1767,1775
40930,31719,3723,15313,2516,27996,3543,1768,1775
40935,31721,3723,15315,2516,27998,3544,1769,1775
40940,31729,3723,15320,2516,28006,3544,1769,1775
40945,31732,3723,15322,2516,28009,3544,1769,1775
40950,31737,3724,15324,2517,28013,3545,1769,1776
40955,31741,3724,15326,2517,28017,3545,1769,1776
40960,31744,3724,15329,2517,28020,3545,1769,1776
40965,31745,3724,15330,2517,28021,3545,1769,1776
40970,31750,3724,15333,2517,28026,3546,1770,1776
40975,31752,3724,15333,2517,28028,3547,1770,1777
40980,31760,3725,15336,2518,28035,3547,1770,1777
40985,31763,3725,15337,2518,28038,3547,1770,1777
40990,31768,3726,15341,2519,28042,3547,1770,1777
40995,31772,3726,15343,2519,28046,3548,1771,1777
41000,31775,3727,15345,2520,28048,3548,1771,1777
41005,31776,3728,15346,2521,28048,3548,1771,1777
41010,31781,3729,15349,2522,28052,3548,1771,1777
41015,31783,3729,15350,2522,28054,3549,1771,1778
41020,31791,3730,15351,2523,28061,3549,1771,1778
41025,31794,3731,15352,2524,28063,3550,1771,1779
41030,31799,3732,15353,2524,28067,3550,1771,1779
41035,31803,3732,15355,2524,28071,3551,1772,1779
41040,31806,3732,15356,2524,28074,3551,1772,1779
41045,31807,3732,15356,2524,28075,3551,1772,1779
41050,31812,3733,15358,2524,28079,3551,1772,1779
41055,31814,3733,15359,2524,28081,3552,1773,1779
41060,31822,3734,15363,2524,28088,3553,1773,1780
41065,31825,3734,15364,2524,28091,3553,1773,1780
41070,31830,3735,15368,2525,28095,3554,1773,1781
41075,31834,3735,15370,2525,28099,3555,1774,1781
41080,31837,3736,15372,2526,28101,3555,1774,1781
41085,31838,3736,15372,2526,28102,3555,1774,1781
41090,31843,3737,15374,2527,28106,3556,1774,1782
41095,31845,3737,15375,2527,28108,3557,1775,1782
41100,31853,3738,15380,2528,28115,3558,1776,1782
41105,31856,3738,15380,2528,28118,3558,1776,1782
41110,31861,3739,15381,2528,28122,3559,1776,1783
41115,31865,3739,15382,2528,28126,3560,1777,1783
41120,31868,3739,15383,2528,28129,3560,1777,1783
41125,31869,3739,15383,2528,28130,3560,1777,1783
41130,31874,3740,15387,2529,28134,3560,1777,1783
41135,31876,3740,15389,2529,28136,3561,1778,1783
41140,31884,3742,15391,2530,28142,3562,1778,1784
41145,31887,3742,15392,2530,28145,3562,1778,1784
41150,31892,3743,15395,2530,28149,3563,1779,1784
41155,31896,3743,15398,2530,28152,3564,1780,1784
41160,31899,3745,15399,2532,28154,3564,1780,1784
41165,31900,3745,15400,2532,28155,3564,1780,1784
41170,31905,3746,15403,2532,28159,3564,1780,1784
41175,31907,3746,15405,2532,28161,3565,1781,1784
41180,31915,3746,15409,2532,28169,3565,1781,1784
41185,31918,3746,15410,2532,28172,3565,1781,1784
41190,31923,3746,15412,2532,28177,3565,1781,1784
41195,31927,3746,15415,2532,28180,3565,1781,1784
41200,31930,3747,15416,2533,28183,3565,1781,1784
41205,31931,3747,15416,2533,28184,3565,1781,1784
41210,31936,3748,15418,2534,28188,3566,1781,1785
41215,31938,3748,15419,2534,28190,3567,1781,1786
41220,31946,3748,15424,2534,28198,3567,1781,1786
41225,31949,3748,15427,2534,28201,3567,1781,1786
41230,31954,3748,15429,2534,28206,3567,1781,1786
41235,31958,3748,15431,2534,28210,3567,1781,1786
41240,31961,3748,15433,2534,28213,3567,1781,1786
41245,31962,3748,15433,2534,28214,3567,1781,1786
41250,31967,3749,15434,2534,28218,3567,1781,1786
41255,31969,3749,15436,2534,28220,3568,1782,1786
41260,31977,3749,15442,2534,28228,3568,1782,1786
41265,31980,3749,15444,2534,28231,3568,1782,1786
41270,31985,3750,15445,2535,28235,3569,1782,1787
41275,31989,3750,15447,2535,28239,3570,1782,1788
41280,31992,3750,15448,2535,28242,3570,1782,1788
41285,31993,3750,15449,2535,28243,3570,1782,1788
41290,31998,3750,15452,2535,28248,3570,1782,1788
41295,32000,3750,15453,2535,28250,3571,1782,1789
41300,32008,3751,15457,2536,28257,3571,1782,1789
41305,32011,3751,15458,2536,28260,3571,1782,1789
41310,32016,3752,15458,2536,28264,3572,1782,1790
41315,32020,3752,15461,2536,28268,3572,1782,1790
41320,32023,3752,15462,2536,28271,3572,1782,1790
41325,32024,3752,15462,2536,28272,3572,1782,1790
41330,32029,3752,15465,2536,28277,3573,1783,1790
41335,32031,3752,15466,2536,28279,3574,1783,1791
41340,32039,3753,15471,2537,28286,3575,1783,1792
41345,32042,3754,15472,2538,28288,3575,1783,1792
41350,32047,3755,15475,2538,28292,3575,1783,1792
41355,32051,3755,15476,2538,28296,3575,1783,1792
41360,32054,3755,15478,2538,28299,3575,1783,1792
41365,32055,3755,15479,2538,28300,3575,1783,1792
41370,32060,3755,15481,2538,28305,3575,1783,1792
41375,32062,3755,15483,2538,28307,3576,1784,1792
41380,32070,3756,15489,2538,28314,3577,1785,1792
41385,32073,3756,15491,2538,28317,3577,1785,1792
41390,32078,3757,15494,2538,28321,3577,1785,1792
41395,32082,3757,15495,2538,28325,3578,1785,1793
41400,32085,3757,15496,2538,28328,3578,1785,1793
41405,32086,3757,15497,2538,28329,3578,1785,1793
41410,32091,3758,15500,2539,28333,3578,1785,1793
41415,32093,3758,15500,2539,28335,3579,1785,1794
41420,32101,3758,15504,2539,28343,3580,1785,1795
41425,32104,3758,15505,2539,28346,3581,1785,1796
41430,32109,3759,15508,2540,28350,3581,1785,1796
41435,32113,3759,15511,2540,28354,3581,1785,1796
41440,32116,3759,15511,2540,28357,3581,1785,1796
41445,32117,3759,15511,2540,28358,3581,1785,1796
41450,32122,3760,15512,2540,28362,3582,1785,1797
41455,32124,3760,15512,2540,28364,3583,1785,1798
41460,32132,3760,15515,2540,28372,3584,1785,1799
41465,32135,3760,15517,2540,28375,3585,1786,1799
41470,32140,3761,15519,2540,28379,3586,1786,1800
41475,32144,3761,15522,2540,28383,3586,1786,1800
41480,32147,3762,15525,2541,28385,3586,1786,1800
41485,32148,3762,15526,2541,28386,3586,1786,1800
41490,32153,3763,15529,2542,28390,3586,1786,1800
41495,32155,3763,15529,2542,28392,3587,1786,1801
41500,32163,3763,15533,2542,28400,3587,1786,1801
41505,32166,3763,15533,2542,28403,3588,1786,1802
41510,32171,3764,15535,2542,28407,3589,1787,1802
41515,32175,3764,15538,2542,28411,3589,1787,1802
41520,32178,3764,15538,2542,28414,3589,1787,1802
41525,32179,3764,15539,2542,28415,3589,1787,1802
41530,32184,3764,15541,2542,28420,3589,1787,1802
41535,32186,3764,15542,2542,28422,3590,1788,1802
41540,32194,3765,15545,2542,28429,3590,1788,1802
41545,32197,3765,15547,2542,28432,3590,1788,1802
41550,32202,3766,15549,2543,28436,3591,1789,1802
41555,32206,3766,15551,2543,28440,3591,1789,1802
41560,32209,3766,15553,2543,28443,3591,1789,1802
41565,32210,3766,15553,2543,28444,3591,1789,1802
41570,32215,3766,15556,2543,28449,3592,1789,1803
41575,32217,3766,15556,2543,28451,3593,1789,1804
41580,32225,3768,15561,2545,28457,3594,1789,1805
41585,32228,3768,15561,2545,28460,3594,1789,1805
41590,32233,3769,15563,2545,28464,3595,1789,1806
41595,32237,3769,15565,2545,28467,3596,1789,1807
41600,32240,3770,15566,2546,28470,3596,1789,1807
41605,32241,3770,15567,2546,28471,3596,1789,1807
41610,32246,3770,15570,2546,28476,3597,1789,1808
41615,32248,3770,15572,2546,28478,3598,1790,1808
41620,32256,3772,15576,2548,28484,3599,1791,1808
41625,32259,3772,15578,2548,28487,3599,1791,1808
41630,32264,3774,15582,2550,28490,3600,1791,1809
41635,32268,3774,15585,2550,28493,3601,1792,1809
41640,32271,3776,15586,2552,28495,3601,1792,1809
41645,32272,3776,15586,2552,28496,3601,1792,1809
41650,32277,3777,15589,2552,28500,3601,1792,1809
41655,32279,3777,15591,2552,28502,3602,1793,1809
41660,32287,3777,15596,2552,28510,3602,1793,1809
41665,32290,3777,15596,2552,28513,3603,1793,1810
41670,32295,3777,15599,2552,28518,3603,1793,1810
41675,32299,3777,15600,2552,28522,3604,1793,1811
41680,32302,3777,15603,2552,28525,3604,1793,1811
41685,32303,3777,15603,2552,28526,3604,1793,1811
41690,32308,3778,15605,2553,28530,3604,1793,1811
41695,32310,3778,15605,2553,28532,3605,1793,1812
41700,32318,3778,15609,2553,28540,3605,1793,1812
41705,32321,3778,15609,2553,28543,3606,1793,1813
41710,32326,3778,15611,2553,28548,3606,1793,1813
41715,32330,3778,15613,2553,28552,3606,1793,1813
41720,32333,3778,15614,2553,28555,3606,1793,1813
41725,32334,3778,15614,2553,28556,3606,1793,1813
41730,32339,3779,15616,2553,28560,3607,1793,1814
41735,32341,3779,15617,2553,28562,3608,1793,1815
41740,32349,3779,15620,2553,28570,3608,1793,1815
41745,32352,3779,15622,2553,28573,3609,1794,1815
41750,32357,3780,15623,2553,28577,3610,1794,1816
41755,32361,3780,15625,2553,28581,3610,1794,1816
41760,32364,3780,15626,2553,28584,3610,1794,1816
41765,32365,3780,15626,2553,28585,3610,1794,1816
41770,32370,3781,15629,2553,28589,3611,1795,1816
41775,32372,3781,15630,2553,28591,3612,1795,1817
41780,32380,3783,15633,2554,28597,3612,1795,1817
41785,32383,3783,15634,2554,28600,3612,1795,1817
41790,32388,3784,15636,2555,28604,3612,1795,1817
41795,32392,3784,15639,2555,28607,3612,1795,1817
41800,32395,3785,15641,2556,28610,3612,1795,1817
41805,32396,3786,15642,2557,28610,3612,1795,1817
41810,32401,3787,15645,2557,28614,3613,1795,1818
41815,32403,3787,15646,2557,28616,3614,1795,1819
41820,32411,3789,15652,2559,28622,3615,1796,1819
41825,32414,3789,15653,2559,28625,3616,1796,1820
41830,32419,3790,15657,2560,28629,3617,1797,1820
41835,32423,3790,15660,2560,28632,3617,1797,1820
41840,32426,3791,15661,2561,28635,3617,1797,1820
41845,32427,3791,15662,2561,28636,3617,1797,1820
41850,32432,3791,15664,2561,28641,3618,1798,1820
41855,32434,3791,15665,2561,28643,3619,1798,1821
41860,32442,3792,15668,2562,28650,3620,1798,1822
41865,32445,3792,15670,2562,28653,3621,1799,1822
41870,32450,3794,15673,2564,28656,3622,1799,1823
41875,32454,3794,15675,2564,28659,3623,1800,1823
41880,32457,3797,15677,2567,28660,3623,1800,1823
41885,32458,3797,15677,2567,28661,3623,1800,1823
41890,32463,3797,15680,2567,28666,3624,1801,1823
41895,32465,3797,15681,2567,28668,3625,1801,1824
41900,32473,3797,15687,2567,28676,3626,1802,1824
41905,32476,3797,15689,2567,28679,3627,1803,1824
41910,32481,3797,15692,2567,28684,3627,1803,1824
41915,32485,3797,15693,2567,28688,3628,1803,1825
41920,32488,3797,15695,2567,28691,3628,1803,1825
41925,32489,3797,15695,2567,28692,3628,1803,1825
41930,32494,3798,15699,2568,28696,3629,1804,1825
41935,32496,3798,15701,2568,28698,3630,1805,1825
41940,32504,3799,15705,2569,28705,3631,1806,1825
41945,32507,3800,15707,2570,28707,3632,1806,1826
41950,32512,3800,15711,2570,28712,3632,1806,1826
41955,32516,3800,15714,2570,28716,3632,1806,1826
41960,32519,3801,15716,2571,28718,3632,1806,1826
41965,32520,3801,15716,2571,28719,3632,1806,1826
41970,32525,3802,15719,2571,28723,3632,1806,1826
41975,32527,3802,15721,2571,28725,3633,1807,1826
41980,32535,3804,15727,2573,28731,3633,1807,1826
41985,32538,3804,15728,2573,28734,3634,1808,1826
41990,32543,3805,15731,2574,28738,3635,1809,1826
41995,32547,3805,15733,2574,28741,3635,1809,1826
42000,32550,3808,15736,2577,28742,3635,1809,1826
42005,32551,3808,15736,2577,28743,3635,1809,1826
42010,32556,3809,15740,2578,28747,3635,1809,1826
42015,32558,3809,15741,2578,28749,3636,1809,1827
42020,32566,3810,15744,2578,28756,3636,1809,1827
42025,32569,3810,15745,2578,28759,3636,1809,1827
42030,32574,3811,15746,2578,28763,3637,1809,1828
42035,32578,3811,15746,2578,28767,3637,1809,1828
42040,32581,3811,15746,2578,28770,3637,1809,1828
42045,32582,3811,15746,2578,28771,3637,1809,1828
42050,32587,3812,15747,2578,28775,3637,1809,1828
42055,32589,3812,15747,2578,28777,3638,1809,1829
42060,32597,3813,15751,2579,28784,3639,1810,1829
42065,32600,3814,15753,2580,28786,3639,1810,1829
42070,32605,3815,15755,2581,28790,3639,1810,1829
42075,32609,3815,15756,2581,28794,3639,1810,1829
42080,32612,3815,15757,2581,28797,3639,1810,1829
42085,32613,3815,15757,2581,28798,3639,1810,1829
42090,32618,3816,15760,2581,28802,3640,1811,1829
42095,32620,3816,15760,2581,28804,3641,1811,1830
42100,32628,3817,15764,2582,28811,3641,1811,1830
42105,32631,3818,15766,2583,28813,3641,1811,1830
42110,32636,3819,15767,2583,28817,3641,1811,1830
42115,32640,3819,15770,2583,28821,3642,1812,1830
42120,32643,3820,15771,2584,28823,3642,1812,1830
42125,32644,3821,15772,2585,28823,3642,1812,1830
42130,32649,3821,15774,2585,28828,3643,1812,1831
42135,32651,3821,15774,2585,28830,3644,1812,1832
42140,32659,3822,15777,2585,28837,3644,1812,1832
42145,32662,3822,15779,2585,28840,3645,1813,1832
42150,32667,3823,15781,2586,28844,3645,1813,1832
42155,32671,3823,15782,2586,28848,3645,1813,1832
42160,32674,3823,15784,2586,28851,3645,1813,1832
42165,32675,3823,15785,2586,28852,3645,1813,1832
42170,32680,3823,15787,2586,28857,3645,1813,1832
42175,32682,3823,15787,2586,28859,3646,1813,1833
42180,32690,3824,15791,2586,28866,3647,1814,1833
42185,32693,3825,15792,2587,28868,3648,1814,1834
42190,32698,3826,15794,2587,28872,3649,1815,1834
42195,32702,3826,15794,2587,28876,3649,1815,1834
42200,32705,3826,15795,2587,28879,3649,1815,1834
42205,32706,3826,15796,2587,28880,3649,1815,1834
42210,32711,3826,15797,2587,28885,3649,1815,1834
42215,32713,3826,15797,2587,28887,3650,1815,1835
42220,32721,3827,15802,2588,28894,3650,1815,1835
42225,32724,3828,15804,2589,28896,3651,1815,1836
42230,32729,3830,15809,2591,28899,3651,1815,1836
42235,32733,3830,15811,2591,28903,3652,1816,1836
42240,32736,3830,15811,2591,28906,3652,1816,1836
42245,32737,3830,15812,2591,28907,3652,1816,1836
42250,32742,3831,15812,2591,28911,3653,1816,1837
42255,32744,3831,15813,2591,28913,3654,1817,1837
42260,32752,3831,15816,2591,28921,3654,1817,1837
42265,32755,3831,15817,2591,28924,3654,1817,1837
42270,32760,3832,15820,2591,28928,3654,1817,1837
42275,32764,3832,15824,2591,28931,3654,1817,1837
42280,32767,3833,15824,2592,28934,3654,1817,1837
42285,32768,3833,15825,2592,28935,3654,1817,1837
42290,32773,3834,15827,2593,28939,3654,1817,1837
42295,32775,3834,15829,2593,28941,3655,1818,1837
42300,32783,3835,15832,2594,28948,3656,1818,1838
42305,32786,3835,15834,2594,28951,3657,1819,1838
42310,32791,3837,15836,2595,28954,3658,1819,1839
42315,32795,3837,15839,2595,28957,3658,1819,1839
42320,32798,3838,15840,2596,28960,3658,1819,1839
42325,32799,3839,15841,2597,28960,3658,1819,1839
42330,32804,3840,15845,2597,28964,3658,1819,1839
42335,32806,3840,15845,2597,28966,3659,1819,1840
42340,32814,3840,15850,2597,28974,3660,1820,1840
42345,32817,3840,15852,2597,28977,3661,1821,1840
42350,32822,3841,15853,2597,28981,3662,1822,1840
42355,32826,3841,15856,2597,28984,3662,1822,1840
42360,32829,3842,15858,2598,28987,3662,1822,1840
42365,32830,3842,15859,2598,28988,3662,1822,1840
42370,32835,3842,15863,2598,28993,3663,1823,1840
42375,32837,3842,15864,2598,28995,3664,1824,1840
42380,32845,3843,15867,2599,29002,3664,1824,1840
42385,32848,3843,15868,2599,29005,3665,1824,1841
42390,32853,3844,15871,2599,29009,3665,1824,1841
42395,32857,3844,15872,2599,29013,3665,1824,1841
42400,32860,3844,15873,2599,29016,3665,1824,1841
42405,32861,3844,15874,2599,29017,3665,1824,1841
42410,32866,3844,15876,2599,29022,3666,1825,1841
42415,32868,3844,15877,2599,29024,3667,1826,1841
42420,32876,3845,15882,2599,29031,3667,1826,1841
42425,32879,3845,15883,2599,29034,3668,1827,1841
42430,32884,3847,15886,2600,29037,3669,1827,1842
42435,32888,3847,15887,2600,29041,3670,1828,1842
42440,32891,3848,15890,2601,29043,3670,1828,1842
42445,32892,3848,15891,2601,29044,3670,1828,1842
42450,32897,3848,15892,2601,29049,3670,1828,1842
42455,32899,3848,15892,2601,29051,3671,1828,1843
42460,32907,3849,15896,2602,29058,3671,1828,1843
42465,32910,3849,15897,2602,29061,3672,1829,1843
42470,32915,3850,15897,2602,29065,3672,1829,1843
42475,32919,3850,15900,2602,29069,3673,1830,1843
42480,32922,3851,15901,2603,29071,3673,1830,1843
42485,32923,3851,15901,2603,29072,3673,1830,1843
42490,32928,3851,15902,2603,29077,3673,1830,1843
42495,32930,3851,15904,2603,29079,3674,1831,1843
42500,32938,3852,15909,2604,29086,3674,1831,1843
42505,32941,3852,15909,2604,29089,3675,1831,1844
42510,32946,3853,15913,2604,29093,3675,1831,1844
42515,32950,3853,15916,2604,29096,3675,1831,1844
42520,32953,3855,15918,2606,29098,3675,1831,1844
42525,32954,3855,15919,2606,29099,3675,1831,1844
42530,32959,3855,15922,2606,29104,3675,1831,1844
42535,32961,3855,15922,2606,29106,3676,1831,1845
42540,32969,3856,15925,2607,29113,3677,1832,1845
42545,32972,3857,15928,2608,29115,3678,1833,1845
42550,32977,3858,15932,2608,29119,3679,1834,1845
42555,32981,3858,15936,2608,29122,3679,1834,1845
42560,32984,3860,15938,2610,29124,3679,1834,1845
42565,32985,3860,15938,2610,29125,3679,1834,1845
42570,32990,3860,15940,2610,29130,3680,1835,1845
42575,32992,3860,15942,2610,29132,3681,1836,1845
42580,33000,3861,15945,2610,29139,3682,1836,1846
42585,33003,3862,15947,2611,29141,3683,1836,1847
42590,33008,3863,15949,2612,29145,3684,1836,1848
42595,33012,3863,15949,2612,29149,3685,1836,1849
42600,33015,3863,15949,2612,29152,3685,1836,1849
42605,33016,3863,15950,2612,29153,3685,1836,1849
42610,33021,3864,15951,2612,29157,3686,1836,1850
42615,33023,3864,15951,2612,29159,3687,1836,1851
42620,33031,3864,15955,2612,29167,3687,1836,1851
42625,33034,3864,15957,2612,29170,3688,1836,1852
42630,33039,3864,15959,2612,29175,3688,1836,1852
42635,33043,3864,15960,2612,29179,3689,1836,1853
42640,33046,3864,15963,2612,29182,3689,1836,1853
42645,33047,3864,15963,2612,29183,3689,1836,1853
42650,33052,3865,15966,2613,29187,3690,1836,1854
42655,33054,3865,15968,2613,29189,3691,1837,1854
42660,33062,3865,15973,2613,29197,3691,1837,1854
42665,33065,3865,15974,2613,29200,3692,1838,1854
42670,33070,3865,15977,2613,29205,3692,1838,1854
42675,33074,3865,15979,2613,29209,3692,1838,1854
42680,33077,3865,15980,2613,29212,3692,1838,1854
42685,33078,3865,15980,2613,29213,3692,1838,1854
42690,33083,3866,15983,2613,29217,3692,1838,1854
42695,33085,3866,15983,2613,29219,3693,1838,1855
42700,33093,3866,15987,2613,29227,3693,1838,1855
42705,33096,3866,15989,2613,29230,3694,1839,1855
42710,33101,3867,15991,2614,29234,3694,1839,1855
42715,33105,3867,15994,2614,29237,3694,1839,1855
42720,33108,3868,15995,2615,29240,3694,1839,1855
42725,33109,3869,15996,2616,29240,3694,1839,1855
42730,33114,3870,15999,2617,29244,3695,1840,1855
42735,33116,3870,16000,2617,29246,3696,1841,1855
42740,33124,3872,16003,2618,29252,3697,1841,1856
42745,33127,3872,16004,2618,29255,3697,1841,1856
42750,33132,3873,16007,2618,29259,3697,1841,1856
42755,33136,3873,16008,2618,29263,3697,1841,1856
42760,33139,3873,16010,2618,29266,3697,1841,1856
42765,33140,3874,16011,2619,29266,3697,1841,1856
42770,33145,3875,16015,2620,29270,3698,1842,1856
42775,33147,3875,16015,2620,29272,3699,1842,1857
42780,33155,3876,16017,2621,29279,3700,1842,1858
42785,33158,3876,16018,2621,29282,3700,1842,1858
42790,33163,3877,16020,2621,29286,3701,1842,1859
42795,33167,3877,16022,2621,29289,3702,1842,1860
42800,33170,3879,16024,2623,29291,3702,1842,1860
42805,33171,3879,16025,2623,29292,3702,1842,1860
42810,33176,3879,16026,2623,29297,3702,1842,1860
42815,33178,3879,16026,2623,29299,3703,1842,1861
42820,33186,3880,16028,2624,29306,3704,1842,1862
42825,33189,3880,16030,2624,29309,3704,1842,1862
42830,33194,3882,16033,2626,29312,3705,1842,1863
42835,33198,3882,16036,2626,29315,3706,1842,1864
42840,33201,3884,16038,2628,29317,3706,1842,1864
42845,33202,3884,16039,2628,29318,3706,1842,1864
42850,33207,3884,16041,2628,29323,3706,1842,1864
42855,33209,3884,16041,2628,29325,3707,1842,1865
42860,33217,3886,16045,2629,29330,3708,1842,1866
42865,33220,3888,16047,2631,29332,3709,1842,1867
42870,33225,3888,16049,2631,29337,3709,1842,1867
42875,33229,3888,16050,2631,29341,3709,1842,1867
42880,33232,3888,16052,2631,29344,3709,1842,1867
42885,33233,3888,16053,2631,29345,3709,1842,1867
42890,33238,3889,16056,2632,29349,3709,1842,1867
42895,33240,3889,16057,2632,29351,3710,1843,1867
42900,33248,3891,16061,2634,29357,3711,1843,1868
42905,33251,3891,16062,2634,29360,3712,1844,1868
42910,33256,3891,16063,2634,29365,3712,1844,1868
42915,33260,3891,16063,2634,29369,3712,1844,1868
42920,33263,3891,16064,2634,29372,3712,1844,1868
42925,33264,3892,16065,2635,29372,3712,1844,1868
42930,33269,3893,16066,2636,29376,3712,1844,1868
42935,33271,3893,16067,2636,29378,3713,1845,1868
42940,33279,3893,16073,2636,29386,3713,1845,1868
42945,33282,3893,16075,2636,29389,3714,1846,1868
42950,33287,3894,16078,2636,29393,3715,1846,1869
42955,33291,3894,16080,2636,29397,3716,1846,1870
42960,33294,3894,16081,2636,29400,3716,1846,1870
42965,33295,3894,16081,2636,29401,3716,1846,1870
42970,33300,3895,16085,2637,29405,3717,1847,1870
42975,33302,3895,16085,2637,29407,3718,1847,1871
42980,33310,3897,16090,2639,29413,3718,1847,1871
42985,33313,3897,16091,2639,29416,3718,1847,1871
42990,33318,3898,16094,2640,29420,3719,1848,1871
42995,33322,3898,16096,2640,29424,3719,1848,1871
43000,33325,3899,16097,2641,29426,3719,1848,1871
43005,33326,3899,16097,2641,29427,3719,1848,1871
43010,33331,3900,16100,2642,29431,3720,1849,1871
43015,33333,3900,16101,2642,29433,3721,1850,1871
43020,33341,3901,16103,2643,29440,3722,1850,1872
43025,33344,3901,16105,2643,29443,3722,1850,1872
43030,33349,3902,16110,2644,29447,3722,1850,1872
43035,33353,3902,16112,2644,29451,3723,1851,1872
43040,33356,3903,16114,2645,29453,3723,1851,1872
43045,33357,3903,16114,2645,29454,3723,1851,1872
43050,33362,3904,16115,2645,29458,3724,1851,1873
43055,33364,3904,16117,2645,29460,3725,1852,1873
43060,33372,3904,16119,2645,29468,3725,1852,1873
43065,33375,3904,16120,2645,29471,3725,1852,1873
43070,33380,3905,16123,2646,29475,3725,1852,1873
43075,33384,3905,16127,2646,29479,3726,1853,1873
43080,33387,3905,16128,2646,29482,3726,1853,1873
43085,33388,3906,16129,2647,29482,3726,1853,1873
43090,33393,3907,16131,2647,29486,3727,1854,1873
43095,33395,3907,16133,2647,29488,3728,1855,1873
43100,33403,3907,16136,2647,29496,3729,1855,1874
43105,33406,3907,16139,2647,29499,3729,1855,1874
43110,33411,3907,16143,2647,29504,3729,1855,1874
43115,33415,3907,16145,2647,29507,3729,1855,1874
43120,33418,3908,16147,2648,29510,3729,1855,1874
43125,33419,3908,16147,2648,29511,3729,1855,1874
43130,33424,3909,16149,2649,29515,3729,1855,1874
43135,33426,3909,16151,2649,29517,3730,1856,1874
43140,33434,3910,16155,2650,29524,3731,1856,1875
43145,33437,3910,16156,2650,29527,3731,1856,1875
43150,33442,3910,16158,2650,29532,3732,1857,1875
43155,33446,3910,16161,2650,29536,3732,1857,1875
43160,33449,3910,16163,2650,29539,3732,1857,1875
43165,33450,3911,16164,2651,29539,3732,1857,1875
43170,33455,3912,16167,2651,29543,3732,1857,1875
43175,33457,3912,16168,2651,29545,3733,1857,1876
43180,33465,3913,16175,2651,29552,3733,1857,1876
43185,33468,3914,16178,2652,29554,3733,1857,1876
43190,33473,3915,16182,2653,29558,3733,1857,1876
43195,33477,3915,16184,2653,29562,3734,1858,1876
43200,33480,3916,16186,2654,29564,3734,1858,1876
43205,33481,3916,16186,2654,29565,3734,1858,1876
43210,33486,3917,16190,2655,29569,3735,1859,1876
43215,33488,3917,16191,2655,29571,3736,1860,1876
43220,33496,3919,16195,2657,29577,3736,1860,1876
43225,33499,3919,16195,2657,29580,3737,1860,1877
43230,33504,3920,16198,2657,29584,3737,1860,1877
43235,33508,3920,16200,2657,29588,3738,1861,1877
43240,33511,3920,16201,2657,29591,3738,1861,1877
43245,33512,3920,16202,2657,29592,3738,1861,1877
43250,33517,3921,16205,2658,29596,3739,1862,1877
43255,33519,3921,16207,2658,29598,3740,1863,1877
43260,33527,3923,16212,2660,29603,3741,1863,1878
43265,33530,3924,16214,2661,29606,3741,1863,1878
43270,33535,3925,16218,2662,29610,3742,1864,1878
43275,33539,3925,16218,2662,29614,3742,1864,1878
43280,33542,3925,16221,2662,29617,3742,1864,1878
43285,33543,3925,16221,2662,29618,3742,1864,1878
43290,33548,3926,16223,2662,29622,3743,1864,1879
43295,33550,3926,16223,2662,29624,3744,1864,1880
43300,33558,3926,16224,2662,29632,3744,1864,1880
43305,33561,3926,16224,2662,29635,3744,1864,1880
43310,33566,3927,16228,2663,29639,3745,1865,1880
43315,33570,3927,16230,2663,29643,3745,1865,1880
43320,33573,3928,16233,2664,29645,3745,1865,1880
43325,33574,3929,16234,2665,29645,3745,1865,1880
43330,33579,3930,16235,2665,29649,3746,1865,1881
43335,33581,3930,16236,2665,29651,3747,1865,1882
43340,33589,3931,16240,2665,29658,3747,1865,1882
43345,33592,3931,16240,2665,29661,3747,1865,1882
43350,33597,3932,16245,2666,29665,3748,1866,1882
43355,33601,3932,16249,2666,29669,3748,1866,1882
43360,33604,3932,16250,2666,29672,3748,1866,1882
43365,33605,3932,16250,2666,29673,3748,1866,1882
43370,33610,3933,16253,2667,29677,3748,1866,1882
43375,33612,3933,16254,2667,29679,3749,1867,1882
43380,33620,3934,16257,2668,29686,3750,1867,1883
43385,33623,3934,16258,2668,29689,3750,1867,1883
43390,33628,3936,16261,2670,29692,3750,1867,1883
43395,33632,3936,16262,2670,29696,3750,1867,1883
43400,33635,3936,16264,2670,29699,3750,1867,1883
43405,33636,3936,16264,2670,29700,3750,1867,1883
43410,33641,3937,16266,2671,29704,3750,1867,1883
43415,33643,3937,16267,2671,29706,3751,1868,1883
43420,33651,3938,16271,2672,29713,3751,1868,1883
43425,33654,3939,16273,2673,29715,3751,1868,1883
43430,33659,3941,16277,2675,29718,3751,1868,1883
43435,33663,3941,16278,2675,29722,3751,1868,1883
43440,33666,3942,16280,2676,29724,3751,1868,1883
43445,33667,3942,16280,2676,29725,3751,1868,1883
43450,33672,3943,16282,2676,29729,3752,1868,1884
43455,33674,3943,16283,2676,29731,3753,1868,1885
43460,33682,3945,16287,2677,29737,3753,1868,1885
43465,33685,3945,16289,2677,29740,3753,1868,1885
43470,33690,3946,16293,2678,29744,3753,1868,1885
43475,33694,3946,16294,2678,29748,3753,1868,1885
43480,33697,3946,16297,2678,29751,3753,1868,1885
43485,33698,3946,16297,2678,29752,3753,1868,1885
43490,33703,3947,16299,2679,29756,3754,1869,1885
43495,33705,3947,16299,2679,29758,3755,1869,1886
43500,33713,3949,16304,2680,29764,3755,1869,1886
43505,33716,3950,16305,2681,29766,3755,1869,1886
43510,33721,3951,16308,2682,29770,3755,1869,1886
43515,33725,3951,16308,2682,29774,3755,1869,1886
43520,33728,3951,16309,2682,29777,3755,1869,1886
43525,33729,3952,16310,2683,29777,3755,1869,1886
43530,33734,3953,16313,2684,29781,3756,1869,1887
43535,33736,3953,16314,2684,29783,3757,1870,1887
43540,33744,3955,16319,2685,29789,3757,1870,1887
43545,33747,3956,16321,2686,29791,3757,1870,1887
43550,33752,3958,16322,2687,29794,3758,1870,1888
43555,33756,3958,16323,2687,29798,3759,1870,1889
43560,33759,3960,16326,2689,29799,3759,1870,1889
43565,33760,3960,16326,2689,29800,3759,1870,1889
43570,33765,3960,16328,2689,29805,3759,1870,1889
43575,33767,3960,16329,2689,29807,3760,1871,1889
43580,33775,3960,16335,2689,29815,3761,1872,1889
43585,33778,3960,16336,2689,29818,3761,1872,1889
43590,33783,3960,16336,2689,29823,3761,1872,1889
43595,33787,3960,16338,2689,29827,3761,1872,1889
43600,33790,3960,16339,2689,29830,3761,1872,1889
43605,33791,3960,16339,2689,29831,3761,1872,1889
43610,33796,3960,16341,2689,29836,3761,1872,1889
43615,33798,3960,16342,2689,29838,3762,1872,1890
43620,33806,3960,16348,2689,29846,3762,1872,1890
43625,33809,3960,16350,2689,29849,3762,1872,1890
43630,33814,3960,16352,2689,29854,3762,1872,1890
43635,33818,3960,16355,2689,29858,3762,1872,1890
43640,33821,3960,16358,2689,29861,3762,1872,1890
43645,33822,3960,16358,2689,29862,3762,1872,1890
43650,33827,3960,16358,2689,29867,3762,1872,1890
43655,33829,3960,16358,2689,29869,3763,1872,1891
43660,33837,3960,16364,2689,29877,3763,1872,1891
43665,33840,3960,16366,2689,29880,3763,1872,1891
43670,33845,3961,16370,2689,29884,3763,1872,1891
43675,33849,3961,16371,2689,29888,3764,1873,1891
43680,33852,3963,16374,2691,29889,3764,1873,1891
43685,33853,3963,16374,2691,29890,3764,1873,1891
43690,33858,3964,16376,2692,29894,3764,1873,1891
43695,33860,3964,16378,2692,29896,3765,1874,1891
43700,33868,3966,16383,2694,29902,3766,1875,1891
43705,33871,3966,16384,2694,29905,3767,1876,1891
43710,33876,3968,16387,2696,29908,3768,1876,1892
43715,33880,3968,16388,2696,29912,3768,1876,1892
43720,33883,3968,16389,2696,29915,3768,1876,1892
43725,33884,3969,16390,2697,29915,3768,1876,1892
43730,33889,3970,16391,2697,29919,3768,1876,1892
43735,33891,3970,16391,2697,29921,3769,1876,1893
43740,33899,3972,16396,2699,29927,3770,1877,1893
43745,33902,3973,16397,2700,29929,3770,1877,1893
43750,33907,3973,16398,2700,29934,3770,1877,1893
43755,33911,3973,16401,2700,29938,3770,1877,1893
43760,33914,3973,16402,2700,29941,3770,1877,1893
43765,33915,3974,16403,2701,29941,3770,1877,1893
43770,33920,3975,16406,2702,29945,3770,1877,1893
43775,33922,3975,16407,2702,29947,3771,1878,1893
43780,33930,3977,16411,2703,29953,3771,1878,1893
43785,33933,3978,16413,2704,29955,3771,1878,1893
43790,33938,3978,16416,2704,29960,3771,1878,1893
43795,33942,3978,16417,2704,29964,3772,1878,1894
43800,33945,3979,16419,2705,29966,3772,1878,1894
43805,33946,3979,16419,2705,29967,3772,1878,1894
43810,33951,3979,16422,2705,29972,3772,1878,1894
43815,33953,3979,16423,2705,29974,3773,1878,1895
43820,33961,3979,16429,2705,29982,3773,1878,1895
43825,33964,3979,16430,2705,29985,3773,1878,1895
43830,33969,3979,16433,2705,29990,3774,1878,1896
43835,33973,3979,16434,2705,29994,3774,1878,1896
43840,33976,3979,16434,2705,29997,3774,1878,1896
43845,33977,3979,16435,2705,29998,3774,1878,1896
43850,33982,3979,16437,2705,30003,3774,1878,1896
43855,33984,3979,16438,2705,30005,3775,1879,1896
43860,33992,3979,16442,2705,30013,3775,1879,1896
43865,33995,3979,16444,2705,30016,3775,1879,1896
43870,34000,3979,16447,2705,30021,3776,1880,1896
43875,34004,3979,16448,2705,30025,3776,1880,1896
43880,34007,3979,16450,2705,30028,3776,1880,1896
43885,34008,3979,16450,2705,30029,3776,1880,1896
43890,34013,3979,16454,2705,30034,3776,1880,1896
43895,34015,3979,16455,2705,30036,3777,1880,1897
43900,34023,3979,16457,2705,30044,3778,1880,1898
43905,34026,3979,16457,2705,30047,3778,1880,1898
43910,34031,3980,16459,2705,30051,3779,1880,1899
43915,34035,3980,16460,2705,30055,3780,1880,1900
43920,34038,3981,16461,2706,30057,3780,1880,1900
43925,34039,3981,16462,2706,30058,3780,1880,1900
43930,34044,3982,16464,2707,30062,3780,1880,1900
43935,34046,3982,16464,2707,30064,3781,1880,1901
43940,34054,3983,16468,2707,30071,3782,1881,1901
43945,34057,3984,16470,2708,30073,3783,1882,1901
43950,34062,3985,16472,2708,30077,3783,1882,1901
43955,34066,3985,16475,2708,30081,3783,1882,1901
43960,34069,3985,16477,2708,30084,3783,1882,1901
43965,34070,3985,16478,2708,30085,3783,1882,1901
43970,34075,3986,16479,2709,30089,3783,1882,1901
43975,34077,3986,16479,2709,30091,3784,1882,1902
43980,34085,3988,16482,2710,30097,3785,1883,1902
43985,34088,3988,16484,2710,30100,3786,1884,1902
43990,34093,3989,16484,2710,30104,3786,1884,1902
43995,34097,3989,16487,2710,30108,3786,1884,1902
44000,34100,3990,16490,2711,30110,3786,1884,1902
44005,34101,3990,16491,2711,30111,3786,1884,1902
44010,34106,3991,16494,2712,30115,3786,1884,1902
44015,34108,3991,16496,2712,30117,3787,1885,1902
44020,34116,3992,16499,2713,30124,3788,1885,1903
44025,34119,3993,16501,2714,30126,3789,1885,1904
44030,34124,3994,16502,2715,30130,3790,1885,1905
44035,34128,3994,16503,2715,30134,3791,1885,1906
44040,34131,3996,16506,2717,30135,3791,1885,1906
44045,34132,3996,16507,2717,30136,3791,1885,1906
44050,34137,3996,16511,2717,30141,3791,1885,1906
44055,34139,3996,16513,2717,30143,3792,1886,1906
44060,34147,3996,16518,2717,30151,3793,1887,1906
44065,34150,3996,16520,2717,30154,3793,1887,1906
44070,34155,3996,16524,2717,30159,3794,1888,1906
44075,34159,3996,16525,2717,30163,3794,1888,1906
44080,34162,3996,16527,2717,30166,3794,1888,1906
44085,34163,3996,16527,2717,30167,3794,1888,1906
44090,34168,3996,16529,2717,30172,3794,1888,1906
44095,34170,3996,16530,2717,30174,3795,1888,1907
44100,34178,3996,16535,2717,30182,3796,1888,1908
44105,34181,3996,16537,2717,30185,3796,1888,1908
44110,34186,3996,16540,2717,30190,3797,1889,1908
44115,34190,3996,16543,2717,30194,3797,1889,1908
44120,34193,3996,16544,2717,30197,3797,1889,1908
44125,34194,3996,16544,2717,30198,3797,1889,1908
44130,34199,3996,16547,2717,30203,3797,1889,1908
44135,34201,3996,16548,2717,30205,3798,1889,1909
44140,34209,3996,16551,2717,30213,3799,1889,1910
44145,34212,3996,16551,2717,30216,3799,1889,1910
44150,34217,3997,16555,2718,30220,3800,1889,1911
44155,34221,3997,16559,2718,30223,3801,1890,1911
44160,34224,3999,16560,2720,30225,3801,1890,1911
44165,34225,3999,16560,2720,30226,3801,1890,1911
44170,34230,4000,16564,2721,30230,3801,1890,1911
44175,34232,4000,16564,2721,30232,3802,1890,1912
44180,34240,4001,16570,2722,30239,3802,1890,1912
44185,34243,4002,16571,2723,30241,3803,1890,1913
44190,34248,4003,16574,2723,30245,3803,1890,1913
44195,34252,4003,16576,2723,30249,3803,1890,1913
44200,34255,4003,16578,2723,30252,3803,1890,1913
44205,34256,4003,16578,2723,30253,3803,1890,1913
44210,34261,4004,16581,2723,30257,3803,1890,1913
44215,34263,4004,16582,2723,30259,3804,1890,1914
44220,34271,4005,16588,2724,30266,3804,1890,1914
44225,34274,4005,16589,2724,30269,3805,1890,1915
44230,34279,4006,16591,2724,30273,3805,1890,1915
44235,34283,4006,16593,2724,30277,3805,1890,1915
44240,34286,4006,16594,2724,30280,3805,1890,1915
44245,34287,4007,16595,2725,30280,3805,1890,1915
44250,34292,4008,16596,2725,30284,3805,1890,1915
44255,34294,4008,16596,2725,30286,3806,1890,1916
44260,34302,4009,16601,2725,30293,3806,1890,1916
44265,34305,4010,16604,2726,30295,3807,1891,1916
44270,34310,4011,16605,2726,30299,3808,1891,1917
44275,34314,4011,16606,2726,30303,3809,1891,1918
44280,34317,4011,16606,2726,30306,3809,1891,1918
44285,34318,4012,16607,2727,30306,3809,1891,1918
44290,34323,4013,16608,2727,30310,3809,1891,1918
44295,34325,4013,16609,2727,30312,3810,1891,1919
44300,34333,4015,16613,2728,30318,3810,1891,1919
44305,34336,4015,16614,2728,30321,3811,1891,1920
44310,34341,4016,16617,2729,30325,3811,1891,1920
44315,34345,4016,16621,2729,30329,3811,1891,1920
44320,34348,4017,16623,2730,30331,3811,1891,1920
44325,34349,4017,16623,2730,30332,3811,1891,1920
44330,34354,4018,16626,2731,30336,3811,1891,1920
44335,34356,4018,16626,2731,30338,3812,1891,1921
44340,34364,4020,16629,2732,30343,3812,1891,1921
44345,34367,4021,16631,2733,30346,3812,1891,1921
44350,34372,4022,16632,2733,30350,3812,1891,1921
44355,34376,4022,16635,2733,30354,3812,1891,1921
44360,34379,4022,16636,2733,30357,3812,1891,1921
44365,34380,4022,16636,2733,30358,3812,1891,1921
44370,34385,4023,16640,2734,30362,3812,1891,1921
44375,34387,4023,16642,2734,30364,3813,1892,1921
44380,34395,4023,16645,2734,30372,3813,1892,1921
44385,34398,4023,16648,2734,30375,3813,1892,1921
44390,34403,4024,16648,2734,30379,3814,1892,1922
44395,34407,4024,16648,2734,30383,3814,1892,1922
44400,34410,4025,16650,2735,30385,3814,1892,1922
44405,34411,4025,16651,2735,30386,3814,1892,1922
44410,34416,4026,16655,2736,30390,3815,1893,1922
44415,34418,4026,16656,2736,30392,3816,1893,1923
44420,34426,4027,16660,2737,30399,3816,1893,1923
44425,34429,4027,16662,2737,30402,3816,1893,1923
44430,34434,4028,16665,2738,30406,3816,1893,1923
44435,34438,4028,16668,2738,30410,3816,1893,1923
44440,34441,4029,16670,2739,30412,3816,1893,1923
44445,34442,4029,16671,2739,30413,3816,1893,1923
44450,34447,4030,16671,2739,30417,3816,1893,1923
44455,34449,4030,16672,2739,30419,3817,1894,1923
44460,34457,4030,16677,2739,30427,3817,1894,1923
44465,34460,4030,16679,2739,30430,3817,1894,1923
44470,34465,4031,16682,2739,30434,3817,1894,1923
44475,34469,4031,16683,2739,30438,3817,1894,1923
44480,34472,4031,16684,2739,30441,3817,1894,1923
44485,34473,4031,16685,2739,30442,3817,1894,1923
44490,34478,4032,16689,2739,30446,3817,1894,1923
44495,34480,4032,16691,2739,30448,3818,1895,1923
44500,34488,4032,16695,2739,30456,3818,1895,1923
44505,34491,4032,16697,2739,30459,3819,1895,1924
44510,34496,4033,16700,2739,30463,3820,1896,1924
44515,34500,4033,16701,2739,30467,3820,1896,1924
44520,34503,4033,16701,2739,30470,3820,1896,1924
44525,34504,4033,16701,2739,30471,3820,1896,1924
44530,34509,4034,16705,2740,30475,3821,1896,1925
44535,34511,4034,16705,2740,30477,3822,1896,1926
44540,34519,4035,16710,2740,30484,3822,1896,1926
44545,34522,4035,16711,2740,30487,3823,1897,1926
44550,34527,4035,16713,2740,30492,3823,1897,1926
44555,34531,4035,16714,2740,30496,3823,1897,1926
44560,34534,4035,16717,2740,30499,3823,1897,1926
44565,34535,4036,16718,2741,30499,3823,1897,1926
44570,34540,4037,16721,2742,30503,3823,1897,1926
44575,34542,4037,16722,2742,30505,3824,1898,1926
44580,34550,4038,16726,2742,30512,3824,1898,1926
44585,34553,4038,16727,2742,30515,3825,1899,1926
44590,34558,4038,16728,2742,30520,3825,1899,1926
44595,34562,4038,16730,2742,30524,3825,1899,1926
44600,34565,4038,16732,2742,30527,3825,1899,1926
44605,34566,4038,16732,2742,30528,3825,1899,1926
44610,34571,4039,16733,2742,30532,3825,1899,1926
44615,34573,4039,16734,2742,30534,3826,1899,1927
44620,34581,4040,16738,2742,30541,3826,1899,1927
44625,34584,4041,16739,2743,30543,3827,1899,1928
44630,34589,4042,16743,2743,30547,3828,1900,1928
44635,34593,4042,16744,2743,30551,3828,1900,1928
44640,34596,4043,16745,2744,30553,3828,1900,1928
44645,34597,4043,16745,2744,30554,3828,1900,1928
44650,34602,4043,16746,2744,30559,3829,1900,1929
44655,34604,4043,16747,2744,30561,3830,1901,1929
44660,34612,4044,16750,2745,30568,3831,1902,1929
44665,34615,4044,16751,2745,30571,3832,1902,1930
44670,34620,4045,16754,2745,30575,3833,1903,1930
44675,34624,4045,16756,2745,30579,3833,1903,1930
44680,34627,4046,16758,2746,30581,3833,1903,1930
44685,34628,4046,16758,2746,30582,3833,1903,1930
44690,34633,4046,16760,2746,30587,3833,1903,1930
44695,34635,4046,16761,2746,30589,3834,1904,1930
44700,34643,4048,16765,2747,30595,3835,1905,1930
44705,34646,4049,16767,2748,30597,3836,1905,1931
44710,34651,4050,16771,2749,30601,3836,1905,1931
44715,34655,4050,16773,2749,30605,3836,1905,1931
44720,34658,4051,16775,2750,30607,3836,1905,1931
44725,34659,4051,16776,2750,30608,3836,1905,1931
44730,34664,4051,16778,2750,30613,3837,1905,1932
44735,34666,4051,16779,2750,30615,3838,1905,1933
44740,34674,4052,16784,2751,30622,3838,1905,1933
44745,34677,4052,16784,2751,30625,3839,1905,1934
44750,34682,4053,16786,2751,30629,3839,1905,1934
44755,34686,4053,16788,2751,30632,3839,1905,1934
44760,34689,4055,16790,2753,30634,3839,1905,1934
44765,34690,4055,16790,2753,30635,3839,1905,1934
44770,34695,4056,16792,2753,30639,3840,1906,1934
44775,34697,4056,16792,2753,30641,3841,1906,1935
44780,34705,4057,16797,2754,30648,3842,1907,1935
44785,34708,4057,16798,2754,30651,3842,1907,1935
44790,34713,4057,16801,2754,30656,3843,1908,1935
44795,34717,4057,16802,2754,30660,3843,1908,1935
44800,34720,4057,16803,2754,30663,3843,1908,1935
44805,34721,4057,16803,2754,30664,3843,1908,1935
44810,34726,4058,16805,2755,30668,3844,1908,1936
44815,34728,4058,16806,2755,30670,3845,1908,1937
44820,34736,4059,16811,2756,30677,3846,1909,1937
44825,34739,4059,16812,2756,30680,3846,1909,1937
44830,34744,4059,16813,2756,30685,3846,1909,1937
44835,34748,4059,16816,2756,30689,3846,1909,1937
44840,34751,4059,16817,2756,30692,3846,1909,1937
44845,34752,4059,16817,2756,30693,3846,1909,1937
44850,34757,4059,16819,2756,30698,3846,1909,1937
44855,34759,4059,16819,2756,30700,3847,1909,1938
44860,34767,4059,16823,2756,30708,3848,1910,1938
44865,34770,4059,16823,2756,30711,3848,1910,1938
44870,34775,4060,16828,2757,30715,3848,1910,1938
44875,34779,4060,16830,2757,30719,3848,1910,1938
44880,34782,4060,16830,2757,30722,3848,1910,1938
44885,34783,4060,16830,2757,30723,3848,1910,1938
44890,34788,4060,16832,2757,30728,3848,1910,1938
44895,34790,4060,16833,2757,30730,3849,1911,1938
44900,34798,4062,16836,2759,30736,3849,1911,1938
44905,34801,4062,16838,2759,30739,3850,1912,1938
44910,34806,4063,16839,2759,30743,3850,1912,1938
44915,34810,4063,16841,2759,30747,3850,1912,1938
44920,34813,4065,16844,2761,30748,3850,1912,1938
44925,34814,4065,16845,2761,30749,3850,1912,1938
44930,34819,4066,16849,2762,30753,3851,1913,1938
44935,34821,4066,16851,2762,30755,3852,1914,1938
44940,34829,4067,16853,2762,30762,3853,1915,1938
44945,34832,4068,16856,2763,30764,3854,1916,1938
44950,34837,4069,16859,2764,30768,3854,1916,1938
44955,34841,4069,16862,2764,30772,3854,1916,1938
44960,34844,4070,16864,2765,30774,3854,1916,1938
44965,34845,4070,16865,2765,30775,3854,1916,1938
44970,34850,4071,16866,2765,30779,3854,1916,1938
44975,34852,4071,16867,2765,30781,3855,1916,1939
44980,34860,4073,16872,2767,30787,3855,1916,1939
44985,34863,4074,16874,2768,30789,3856,1916,1940
44990,34868,4075,16876,2768,30793,3856,1916,1940
44995,34872,4075,16877,2768,30797,3856,1916,1940
45000,34875,4076,16878,2769,30799,3856,1916,1940
45005,34876,4076,16878,2769,30800,3856,1916,1940
45010,34881,4077,16879,2769,30804,3856,1916,1940
45015,34883,4077,16879,2769,30806,3857,1916,1941
45020,34891,4077,16882,2769,30814,3857,1916,1941
45025,34894,4077,16883,2769,30817,3857,1916,1941
45030,34899,4078,16885,2770,30821,3857,1916,1941
45035,34903,4078,16888,2770,30825,3857,1916,1941
45040,34906,4078,16889,2770,30828,3857,1916,1941
45045,34907,4079,16890,2771,30828,3857,1916,1941
45050,34912,4080,16893,2772,30832,3857,1916,1941
45055,34914,4080,16893,2772,30834,3858,1916,1942
45060,34922,4080,16896,2772,30842,3859,1916,1943
45065,34925,4080,16897,2772,30845,3859,1916,1943
45070,34930,4080,16900,2772,30850,3859,1916,1943
45075,34934,4080,16903,2772,30853,3859,1916,1943
45080,34937,4081,16904,2773,30856,3859,1916,1943
45085,34938,4081,16904,2773,30857,3859,1916,1943
45090,34943,4082,16908,2774,30861,3860,1917,1943
45095,34945,4082,16908,2774,30863,3861,1917,1944
45100,34953,4082,16911,2774,30871,3861,1917,1944
45105,34956,4082,16913,2774,30874,3861,1917,1944
45110,34961,4082,16916,2774,30879,3861,1917,1944
45115,34965,4082,16917,2774,30883,3861,1917,1944
45120,34968,4082,16918,2774,30886,3861,1917,1944
45125,34969,4083,16919,2775,30886,3861,1917,1944
45130,34974,4084,16920,2775,30890,3861,1917,1944
45135,34976,4084,16920,2775,30892,3862,1917,1945
45140,34984,4086,16923,2776,30898,3862,1917,1945
45145,34987,4086,16925,2776,30901,3862,1917,1945
45150,34992,4086,16929,2776,30906,3862,1917,1945
45155,34996,4086,16930,2776,30909,3862,1917,1945
45160,34999,4087,16931,2777,30912,3862,1917,1945
45165,35000,4087,16931,2777,30913,3862,1917,1945
45170,35005,4088,16934,2778,30917,3862,1917,1945
45175,35007,4088,16936,2778,30919,3863,1918,1945
45180,35015,4089,16939,2778,30925,3864,1918,1946
45185,35018,4090,16939,2779,30928,3865,1918,1947
45190,35023,4091,16943,2780,30932,3865,1918,1947
45195,35027,4091,16945,2780,30936,3865,1918,1947
45200,35030,4091,16946,2780,30939,3865,1918,1947
45205,35031,4091,16946,2780,30940,3865,1918,1947
45210,35036,4091,16950,2780,30945,3866,1919,1947
45215,35038,4091,16951,2780,30947,3867,1920,1947
45220,35046,4092,16953,2781,30954,3868,1921,1947
45225,35049,4092,16954,2781,30957,3869,1921,1948
45230,35054,4093,16955,2781,30961,3869,1921,1948
45235,35058,4093,16957,2781,30965,3869,1921,1948
45240,35061,4094,16959,2782,30967,3869,1921,1948
45245,35062,4094,16959,2782,30968,3869,1921,1948
45250,35067,4095,16962,2782,30972,3870,1922,1948
45255,35069,4095,16964,2782,30974,3871,1923,1948
45260,35077,4097,16972,2784,30979,3872,1924,1948
45265,35080,4098,16974,2785,30982,3873,1925,1948
45270,35085,4099,16977,2785,30986,3873,1925,1948
45275,35089,4099,16978,2785,30990,3873,1925,1948
45280,35092,4099,16978,2785,30993,3873,1925,1948
45285,35093,4100,16979,2786,30993,3873,1925,1948
45290,35098,4101,16983,2787,30997,3874,1926,1948
45295,35100,4101,16984,2787,30999,3875,1927,1948
45300,35108,4103,16987,2789,31005,3877,1928,1949
45305,35111,4103,16987,2789,31008,3878,1928,1950
45310,35116,4104,16989,2789,31012,3879,1928,1951
45315,35120,4104,16990,2789,31016,3879,1928,1951
45320,35123,4105,16991,2790,31018,3879,1928,1951
45325,35124,4105,16992,2790,31019,3879,1928,1951
45330,35129,4105,16994,2790,31024,3880,1928,1952
45335,35131,4105,16994,2790,31026,3881,1928,1953
45340,35139,4105,16998,2790,31034,3882,1929,1953
45345,35142,4105,17001,2790,31037,3883,1930,1953
45350,35147,4106,17003,2790,31041,3884,1930,1954
45355,35151,4106,17005,2790,31045,3884,1930,1954
45360,35154,4107,17006,2791,31047,3884,1930,1954
45365,35155,4107,17006,2791,31048,3884,1930,1954
45370,35160,4107,17011,2791,31053,3885,1931,1954
45375,35162,4107,17013,2791,31055,3886,1932,1954
45380,35170,4108,17017,2792,31062,3886,1932,1954
45385,35173,4108,17019,2792,31065,3887,1932,1955
45390,35178,4109,17021,2792,31069,3887,1932,1955
45395,35182,4109,17024,2792,31073,3887,1932,1955
45400,35185,4109,17025,2792,31076,3887,1932,1955
45405,35186,4110,17026,2793,31076,3887,1932,1955
45410,35191,4111,17027,2793,31080,3888,1932,1956
45415,35193,4111,17028,2793,31082,3889,1933,1956
45420,35201,4114,17035,2796,31086,3890,1934,1956
45425,35204,4116,17037,2798,31088,3891,1934,1957
45430,35209,4117,17038,2798,31092,3891,1934,1957
45435,35213,4117,17040,2798,31096,3891,1934,1957
45440,35216,4117,17040,2798,31099,3891,1934,1957
45445,35217,4117,17041,2798,31100,3891,1934,1957
45450,35222,4117,17042,2798,31105,3891,1934,1957
45455,35224,4117,17043,2798,31107,3892,1935,1957
45460,35232,4118,17047,2798,31114,3892,1935,1957
45465,35235,4118,17048,2798,31117,3893,1936,1957
45470,35240,4119,17051,2799,31121,3893,1936,1957
45475,35244,4119,17053,2799,31125,3893,1936,1957
45480,35247,4119,17055,2799,31128,3893,1936,1957
45485,35248,4119,17056,2799,31129,3893,1936,1957
45490,35253,4119,17060,2799,31134,3893,1936,1957
45495,35255,4119,17060,2799,31136,3894,1936,1958
45500,35263,4120,17062,2800,31143,3894,1936,1958
45505,35266,4120,17064,2800,31146,3895,1937,1958
45510,35271,4121,17068,2801,31150,3896,1938,1958
45515,35275,4121,17068,2801,31154,3896,1938,1958
45520,35278,4121,17069,2801,31157,3896,1938,1958
45525,35279,4121,17069,2801,31158,3896,1938,1958
45530,35284,4122,17070,2801,31162,3896,1938,1958
45535,35286,4122,17072,2801,31164,3897,1939,1958
45540,35294,4123,17076,2802,31171,3899,1940,1959
45545,35297,4123,17076,2802,31174,3900,1940,1960
45550,35302,4124,17078,2802,31178,3901,1940,1961
45555,35306,4124,17080,2802,31182,3901,1940,1961
45560,35309,4124,17082,2802,31185,3901,1940,1961
45565,35310,4124,17082,2802,31186,3901,1940,1961
45570,35315,4124,17085,2802,31191,3902,1940,1962
45575,35317,4124,17087,2802,31193,3903,1941,1962
45580,35325,4125,17091,2803,31200,3904,1941,1963
45585,35328,4125,17091,2803,31203,3905,1941,1964
45590,35333,4126,17093,2804,31207,3906,1941,1965
45595,35337,4126,17095,2804,31211,3906,1941,1965
45600,35340,4127,17097,2805,31213,3906,1941,1965
45605,35341,4127,17098,2805,31214,3906,1941,1965
45610,35346,4127,17098,2805,31219,3906,1941,1965
45615,35348,4127,17098,2805,31221,3907,1941,1966
45620,35356,4128,17099,2805,31228,3908,1941,1967
45625,35359,4128,17100,2805,31231,3909,1942,1967
45630,35364,4129,17104,2806,31235,3910,1943,1967
45635,35368,4129,17108,2806,31239,3910,1943,1967
45640,35371,4129,17110,2806,31242,3910,1943,1967
45645,35372,4129,17111,2806,31243,3910,1943,1967
45650,35377,4130,17113,2806,31247,3910,1943,1967
45655,35379,4130,17114,2806,31249,3911,1943,1968
45660,35387,4132,17117,2807,31255,3913,1944,1969
45665,35390,4132,17118,2807,31258,3913,1944,1969
45670,35395,4133,17122,2807,31262,3913,1944,1969
45675,35399,4133,17124,2807,31266,3913,1944,1969
45680,35402,4134,17126,2808,31268,3913,1944,1969
45685,35403,4135,17127,2809,31268,3913,1944,1969
45690,35408,4136,17130,2810,31272,3913,1944,1969
45695,35410,4136,17131,2810,31274,3914,1945,1969
45700,35418,4137,17134,2811,31281,3915,1945,1970
45705,35421,4137,17137,2811,31284,3915,1945,1970
45710,35426,4138,17139,2811,31288,3915,1945,1970
45715,35430,4138,17140,2811,31292,3915,1945,1970
45720,35433,4139,17141,2812,31294,3915,1945,1970
45725,35434,4139,17141,2812,31295,3915,1945,1970
45730,35439,4139,17144,2812,31300,3916,1945,1971
45735,35441,4139,17145,2812,31302,3917,1946,1971
45740,35449,4139,17148,2812,31310,3917,1946,1971
45745,35452,4139,17148,2812,31313,3917,1946,1971
45750,35457,4140,17152,2813,31317,3917,1946,1971
45755,35461,4140,17153,2813,31321,3917,1946,1971
45760,35464,4140,17154,2813,31324,3917,1946,1971
45765,35465,4140,17154,2813,31325,3917,1946,1971
45770,35470,4140,17157,2813,31330,3918,1946,1972
45775,35472,4140,17159,2813,31332,3919,1947,1972
45780,35480,4142,17164,2815,31338,3919,1947,1972
45785,35483,4143,17165,2816,31340,3920,1947,1973
45790,35488,4143,17167,2816,31345,3920,1947,1973
45795,35492,4143,17168,2816,31349,3920,1947,1973
45800,35495,4143,17169,2816,31352,3920,1947,1973
45805,35496,4143,17170,2816,31353,3920,1947,1973
45810,35501,4143,17175,2816,31358,3920,1947,1973
45815,35503,4143,17177,2816,31360,3921,1948,1973
45820,35511,4144,17182,2816,31367,3922,1949,1973
45825,35514,4144,17183,2816,31370,3923,1950,1973
45830,35519,4144,17185,2816,31375,3923,1950,1973
45835,35523,4144,17187,2816,31379,3923,1950,1973
45840,35526,4144,17187,2816,31382,3923,1950,1973
45845,35527,4144,17187,2816,31383,3923,1950,1973
45850,35532,4145,17191,2817,31387,3923,1950,1973
45855,35534,4145,17192,2817,31389,3924,1951,1973
45860,35542,4146,17195,2818,31396,3924,1951,1973
45865,35545,4146,17196,2818,31399,3925,1951,1974
45870,35550,4146,17199,2818,31404,3925,1951,1974
45875,35554,4146,17201,2818,31408,3925,1951,1974
45880,35557,4146,17202,2818,31411,3925,1951,1974
45885,35558,4146,17202,2818,31412,3925,1951,1974
45890,35563,4147,17206,2819,31416,3926,1952,1974
45895,35565,4147,17207,2819,31418,3927,1953,1974
45900,35573,4148,17211,2819,31424,3928,1953,1975
45905,35576,4149,17211,2820,31427,3929,1953,1976
45910,35581,4150,17213,2821,31431,3930,1953,1977
45915,35585,4150,17216,2821,31435,3930,1953,1977
45920,35588,4150,17217,2821,31438,3930,1953,1977
45925,35589,4150,17217,2821,31439,3930,1953,1977
45930,35594,4151,17221,2822,31443,3930,1953,1977
45935,35596,4151,17223,2822,31445,3931,1954,1977
45940,35604,4152,17227,2823,31452,3932,1954,1978
45945,35607,4152,17229,2823,31455,3933,1955,1978
45950,35612,4153,17230,2823,31459,3934,1955,1979
45955,35616,4153,17233,2823,31463,3934,1955,1979
45960,35619,4154,17235,2824,31465,3934,1955,1979
45965,35620,4154,17236,2824,31466,3934,1955,1979
45970,35625,4155,17238,2824,31470,3934,1955,1979
45975,35627,4155,17238,2824,31472,3935,1955,1980
45980,35635,4156,17240,2824,31479,3936,1956,1980
45985,35638,4156,17242,2824,31482,3936,1956,1980
45990,35643,4157,17244,2825,31486,3936,1956,1980
45995,35647,4157,17246,2825,31490,3936,1956,1980
46000,35650,4157,17247,2825,31493,3936,1956,1980
46005,35651,4157,17247,2825,31494,3936,1956,1980
46010,35656,4158,17249,2825,31498,3937,1957,1980
46015,35658,4158,17250,2825,31500,3938,1957,1981
46020,35666,4161,17256,2828,31505,3939,1957,1982
46025,35669,4161,17257,2828,31508,3939,1957,1982
46030,35674,4161,17259,2828,31513,3939,1957,1982
46035,35678,4161,17262,2828,31517,3939,1957,1982
46040,35681,4161,17262,2828,31520,3939,1957,1982
46045,35682,4161,17262,2828,31521,3939,1957,1982
46050,35687,4162,17264,2828,31525,3939,1957,1982
46055,35689,4162,17264,2828,31527,3940,1957,1983
46060,35697,4162,17270,2828,31535,3940,1957,1983
46065,35700,4162,17270,2828,31538,3940,1957,1983
46070,35705,4162,17271,2828,31543,3941,1957,1984
46075,35709,4162,17274,2828,31547,3941,1957,1984
46080,35712,4162,17274,2828,31550,3941,1957,1984
46085,35713,4163,17275,2829,31550,3941,1957,1984
46090,35718,4164,17278,2830,31554,3941,1957,1984
46095,35720,4164,17278,2830,31556,3942,1957,1985
46100,35728,4164,17282,2830,31564,3942,1957,1985
46105,35731,4164,17283,2830,31567,3942,1957,1985
46110,35736,4165,17286,2831,31571,3942,1957,1985
46115,35740,4165,17288,2831,31575,3942,1957,1985
46120,35743,4166,17291,2832,31577,3942,1957,1985
46125,35744,4167,17292,2833,31577,3942,1957,1985
46130,35749,4168,17296,2833,31581,3943,1958,1985
46135,35751,4168,17296,2833,31583,3944,1958,1986
46140,35759,4170,17301,2835,31589,3945,1959,1986
46145,35762,4170,17302,2835,31592,3946,1959,1987
46150,35767,4171,17303,2836,31596,3947,1959,1988
46155,35771,4171,17304,2836,31600,3947,1959,1988
46160,35774,4172,17305,2837,31602,3947,1959,1988
46165,35775,4172,17306,2837,31603,3947,1959,1988
46170,35780,4173,17311,2838,31607,3948,1960,1988
46175,35782,4173,17312,2838,31609,3949,1961,1988
46180,35790,4175,17317,2839,31615,3950,1962,1988
46185,35793,4175,17319,2839,31618,3951,1963,1988
46190,35798,4176,17323,2840,31622,3952,1964,1988
46195,35802,4176,17326,2840,31626,3952,1964,1988
46200,35805,4176,17326,2840,31629,3952,1964,1988
46205,35806,4176,17326,2840,31630,3952,1964,1988
46210,35811,4177,17326,2840,31634,3952,1964,1988
46215,35813,4177,17327,2840,31636,3953,1965,1988
46220,35821,4178,17330,2840,31643,3953,1965,1988
46225,35824,4179,17331,2841,31645,3954,1965,1989
46230,35829,4180,17335,2842,31649,3954,1965,1989
46235,35833,4180,17336,2842,31653,3954,1965,1989
46240,35836,4180,17339,2842,31656,3954,1965,1989
46245,35837,4180,17339,2842,31657,3954,1965,1989
46250,35842,4181,17341,2842,31661,3954,1965,1989
46255,35844,4181,17341,2842,31663,3955,1965,1990
46260,35852,4183,17346,2843,31668,3956,1966,1990
46265,35855,4184,17347,2844,31671,3956,1966,1990
46270,35860,4185,17350,2845,31675,3956,1966,1990
46275,35864,4185,17352,2845,31679,3956,1966,1990
46280,35867,4185,17354,2845,31682,3956,1966,1990
46285,35868,4186,17355,2846,31682,3956,1966,1990
46290,35873,4187,17358,2847,31686,3957,1967,1990
46295,35875,4187,17360,2847,31688,3958,1968,1990
46300,35883,4187,17363,2847,31696,3958,1968,1990
46305,35886,4187,17365,2847,31699,3958,1968,1990
46310,35891,4188,17369,2848,31703,3959,1968,1991
46315,35895,4188,17370,2848,31706,3959,1968,1991
46320,35898,4191,17372,2851,31707,3959,1968,1991
46325,35899,4192,17373,2852,31707,3959,1968,1991
46330,35904,4193,17376,2853,31711,3960,1968,1992
46335,35906,4193,17376,2853,31713,3961,1968,1993
46340,35914,4195,17380,2854,31719,3961,1968,1993
46345,35917,4196,17381,2855,31721,3961,1968,1993
46350,35922,4196,17382,2855,31726,3961,1968,1993
46355,35926,4196,17383,2855,31730,3961,1968,1993
46360,35929,4196,17384,2855,31733,3961,1968,1993
46365,35930,4197,17385,2856,31733,3961,1968,1993
46370,35935,4198,17388,2857,31737,3962,1969,1993
46375,35937,4198,17390,2857,31739,3963,1970,1993
46380,35945,4200,17395,2858,31744,3964,1971,1993
46385,35948,4201,17395,2859,31747,3964,1971,1993
46390,35953,4201,17400,2859,31752,3965,1972,1993
46395,35957,4201,17401,2859,31756,3965,1972,1993
46400,35960,4201,17404,2859,31759,3965,1972,1993
46405,35961,4201,17405,2859,31760,3965,1972,1993
46410,35966,4201,17408,2859,31765,3966,1973,1993
46415,35968,4201,17409,2859,31767,3967,1974,1993
46420,35976,4201,17413,2859,31775,3968,1975,1993
46425,35979,4201,17416,2859,31778,3968,1975,1993
46430,35984,4202,17417,2859,31782,3969,1975,1994
46435,35988,4202,17420,2859,31786,3969,1975,1994
46440,35991,4202,17421,2859,31789,3969,1975,1994
46445,35992,4202,17422,2859,31790,3969,1975,1994
46450,35997,4202,17425,2859,31795,3969,1975,1994
46455,35999,4202,17426,2859,31797,3970,1975,1995
46460,36007,4203,17430,2860,31804,3971,1976,1995
46465,36010,4203,17432,2860,31807,3971,1976,1995
46470,36015,4204,17434,2860,31811,3971,1976,1995
46475,36019,4204,17435,2860,31815,3971,1976,1995
46480,36022,4205,17436,2861,31817,3971,1976,1995
46485,36023,4205,17436,2861,31818,3971,1976,1995
46490,36028,4206,17440,2862,31822,3971,1976,1995
46495,36030,4206,17440,2862,31824,3972,1976,1996
46500,36038,4207,17444,2863,31831,3973,1977,1996
46505,36041,4207,17446,2863,31834,3973,1977,1996
46510,36046,4208,17448,2863,31838,3974,1977,1997
46515,36050,4208,17450,2863,31842,3974,1977,1997
46520,36053,4208,17452,2863,31845,3974,1977,1997
46525,36054,4208,17452,2863,31846,3974,1977,1997
46530,36059,4209,17456,2864,31850,3975,1978,1997
46535,36061,4209,17456,2864,31852,3976,1978,1998
46540,36069,4210,17460,2865,31859,3976,1978,1998
46545,36072,4210,17463,2865,31862,3977,1979,1998
46550,36077,4211,17465,2866,31866,3978,1979,1999
46555,36081,4211,17467,2866,31870,3978,1979,1999
46560,36084,4212,17470,2867,31872,3978,1979,1999
46565,36085,4213,17471,2868,31872,3978,1979,1999
46570,36090,4214,17473,2868,31876,3979,1980,1999
46575,36092,4214,17475,2868,31878,3980,1981,1999
46580,36100,4215,17479,2869,31885,3980,1981,1999
46585,36103,4215,17480,2869,31888,3981,1982,1999
46590,36108,4216,17484,2870,31892,3982,1983,1999
46595,36112,4216,17487,2870,31896,3982,1983,1999
46600,36115,4216,17488,2870,31899,3982,1983,1999
46605,36116,4216,17488,2870,31900,3982,1983,1999
46610,36121,4217,17491,2871,31904,3983,1984,1999
46615,36123,4217,17493,2871,31906,3984,1985,1999
46620,36131,4218,17496,2871,31913,3985,1985,2000
46625,36134,4219,17498,2872,31915,3986,1985,2001
46630,36139,4220,17501,2873,31919,3986,1985,2001
46635,36143,4220,17504,2873,31923,3986,1985,2001
46640,36146,4220,17506,2873,31926,3986,1985,2001
46645,36147,4220,17506,2873,31927,3986,1985,2001
46650,36152,4221,17509,2873,31931,3986,1985,2001
46655,36154,4221,17511,2873,31933,3987,1986,2001
46660,36162,4222,17514,2873,31940,3987,1986,2001
46665,36165,4223,17515,2874,31942,3988,1986,2002
46670,36170,4224,17516,2875,31946,3988,1986,2002
46675,36174,4224,17517,2875,31950,3988,1986,2002
46680,36177,4224,17517,2875,31953,3988,1986,2002
46685,36178,4224,17517,2875,31954,3988,1986,2002
46690,36183,4225,17518,2875,31958,3988,1986,2002
46695,36185,4225,17520,2875,31960,3989,1987,2002
46700,36193,4226,17523,2875,31967,3989,1987,2002
46705,36196,4227,17526,2876,31969,3989,1987,2002
46710,36201,4228,17527,2876,31973,3989,1987,2002
46715,36205,4228,17529,2876,31977,3989,1987,2002
46720,36208,4228,17531,2876,31980,3989,1987,2002
46725,36209,4229,17532,2877,31980,3989,1987,2002
46730,36214,4230,17535,2878,31984,3990,1988,2002
46735,36216,4230,17536,2878,31986,3991,1988,2003
46740,36224,4232,17541,2879,31992,3992,1988,2004
46745,36227,4232,17542,2879,31995,3992,1988,2004
46750,36232,4233,17545,2880,31999,3992,1988,2004
46755,36236,4233,17548,2880,32003,3992,1988,2004
46760,36239,4233,17549,2880,32006,3992,1988,2004
46765,36240,4234,17550,2881,32006,3992,1988,2004
46770,36245,4235,17552,2882,32010,3992,1988,2004
46775,36247,4235,17553,2882,32012,3993,1988,2005
46780,36255,4237,17557,2883,32018,3993,1988,2005
46785,36258,4238,17558,2884,32020,3993,1988,2005
46790,36263,4239,17561,2884,32024,3993,1988,2005
46795,36267,4239,17565,2884,32027,3993,1988,2005
46800,36270,4241,17566,2886,32029,3993,1988,2005
46805,36271,4241,17567,2886,32030,3993,1988,2005
46810,36276,4242,17570,2886,32034,3993,1988,2005
46815,36278,4242,17572,2886,32036,3994,1989,2005
46820,36286,4243,17577,2887,32043,3994,1989,2005
46825,36289,4243,17579,2887,32046,3994,1989,2005
46830,36294,4244,17581,2887,32050,3994,1989,2005
46835,36298,4244,17582,2887,32054,3994,1989,2005
46840,36301,4244,17583,2887,32057,3994,1989,2005
46845,36302,4244,17584,2887,32058,3994,1989,2005
46850,36307,4245,17589,2888,32062,3994,1989,2005
46855,36309,4245,17589,2888,32064,3995,1989,2006
46860,36317,4245,17590,2888,32072,3996,1989,2007
46865,36320,4245,17592,2888,32075,3996,1989,2007
46870,36325,4246,17593,2889,32079,3996,1989,2007
46875,36329,4246,17596,2889,32083,3996,1989,2007
46880,36332,4246,17597,2889,32086,3996,1989,2007
46885,36333,4246,17598,2889,32087,3996,1989,2007
46890,36338,4247,17600,2890,32091,3996,1989,2007
46895,36340,4247,17600,2890,32093,3997,1989,2008
46900,36348,4247,17602,2890,32101,3997,1989,2008
46905,36351,4247,17604,2890,32104,3997,1989,2008
46910,36356,4248,17606,2891,32108,3997,1989,2008
46915,36360,4248,17608,2891,32112,3997,1989,2008
46920,36363,4248,17609,2891,32115,3997,1989,2008
46925,36364,4248,17609,2891,32116,3997,1989,2008
46930,36369,4249,17613,2891,32120,3998,1990,2008
46935,36371,4249,17614,2891,32122,3999,1990,2009
46940,36379,4250,17618,2891,32129,3999,1990,2009
46945,36382,4251,17620,2892,32131,3999,1990,2009
46950,36387,4251,17624,2892,32136,3999,1990,2009
46955,36391,4251,17627,2892,32140,3999,1990,2009
46960,36394,4251,17628,2892,32143,3999,1990,2009
46965,36395,4251,17628,2892,32144,3999,1990,2009
46970,36400,4252,17629,2892,32148,4000,1990,2010
46975,36402,4252,17629,2892,32150,4001,1990,2011
46980,36410,4253,17634,2893,32157,4002,1991,2011
46985,36413,4254,17635,2894,32159,4002,1991,2011
46990,36418,4254,17639,2894,32164,4003,1992,2011
46995,36422,4254,17641,2894,32168,4003,1992,2011
47000,36425,4254,17642,2894,32171,4003,1992,2011
47005,36426,4255,17643,2895,32171,4003,1992,2011
47010,36431,4256,17646,2896,32175,4003,1992,2011
47015,36433,4256,17647,2896,32177,4004,1992,2012
47020,36441,4257,17650,2896,32184,4004,1992,2012
47025,36444,4257,17651,2896,32187,4005,1992,2013
47030,36449,4258,17651,2896,32191,4006,1992,2014
47035,36453,4258,17652,2896,32194,4006,1992,2014
47040,36456,4260,17653,2898,32196,4006,1992,2014
47045,36457,4260,17653,2898,32197,4006,1992,2014
47050,36462,4260,17655,2898,32202,4006,1992,2014
47055,36464,4260,17657,2898,32204,4007,1993,2014
47060,36472,4260,17660,2898,32212,4007,1993,2014
47065,36475,4260,17662,2898,32215,4007,1993,2014
47070,36480,4261,17663,2898,32219,4007,1993,2014
47075,36484,4261,17665,2898,32223,4007,1993,2014
47080,36487,4262,17666,2899,32225,4007,1993,2014
47085,36488,4262,17667,2899,32226,4007,1993,2014
47090,36493,4262,17670,2899,32231,4008,1993,2015
47095,36495,4262,17671,2899,32233,4009,1994,2015
47100,36503,4263,17674,2900,32240,4009,1994,2015
47105,36506,4263,17676,2900,32243,4009,1994,2015
47110,36511,4264,17678,2900,32247,4009,1994,2015
47115,36515,4264,17680,2900,32251,4009,1994,2015
47120,36518,4265,17683,2901,32253,4009,1994,2015
47125,36519,4265,17684,2901,32254,4009,1994,2015
47130,36524,4265,17686,2901,32259,4009,1994,2015
47135,36526,4265,17686,2901,32261,4010,1994,2016
47140,36534,4265,17691,2901,32269,4010,1994,2016
47145,36537,4265,17693,2901,32272,4010,1994,2016
47150,36542,4266,17695,2902,32276,4011,1994,2017
47155,36546,4266,17696,2902,32279,4011,1994,2017
47160,36549,4267,17697,2903,32282,4011,1994,2017
47165,36550,4267,17697,2903,32283,4011,1994,2017
47170,36555,4268,17699,2904,32287,4011,1994,2017
47175,36557,4268,17700,2904,32289,4012,1995,2017
47180,36565,4269,17704,2904,32296,4012,1995,2017
47185,36568,4269,17704,2904,32299,4012,1995,2017
47190,36573,4269,17707,2904,32304,4012,1995,2017
47195,36577,4269,17707,2904,32308,4012,1995,2017
47200,36580,4269,17709,2904,32311,4012,1995,2017
47205,36581,4270,17710,2905,32311,4012,1995,2017
47210,36586,4271,17712,2905,32315,4013,1996,2017
47215,36588,4271,17713,2905,32317,4014,1996,2018
47220,36596,4272,17717,2905,32324,4014,1996,2018
47225,36599,4273,17719,2906,32326,4014,1996,2018
47230,36604,4273,17722,2906,32331,4014,1996,2018
47235,36608,4273,17723,2906,32335,4014,1996,2018
47240,36611,4273,17725,2906,32338,4014,1996,2018
47245,36612,4274,17726,2907,32338,4014,1996,2018
47250,36617,4275,17727,2907,32342,4015,1996,2019
47255,36619,4275,17727,2907,32344,4016,1996,2020
47260,36627,4276,17730,2908,32351,4016,1996,2020
47265,36630,4277,17731,2909,32353,4016,1996,2020
47270,36635,4278,17732,2909,32357,4017,1996,2021
47275,36639,4278,17733,2909,32361,4017,1996,2021
47280,36642,4278,17734,2909,32364,4017,1996,2021
47285,36643,4278,17735,2909,32365,4017,1996,2021
47290,36648,4278,17738,2909,32370,4017,1996,2021
47295,36650,4278,17739,2909,32372,4018,1996,2022
47300,36658,4279,17743,2910,32379,4019,1996,2023
47305,36661,4279,17744,2910,32382,4019,1996,2023
47310,36666,4280,17748,2911,32386,4020,1996,2024
47315,36670,4280,17748,2911,32390,4020,1996,2024
47320,36673,4280,17749,2911,32393,4020,1996,2024
47325,36674,4280,17750,2911,32394,4020,1996,2024
47330,36679,4280,17751,2911,32399,4020,1996,2024
47335,36681,4280,17753,2911,32401,4021,1997,2024
47340,36689,4280,17758,2911,32409,4022,1998,2024
47345,36692,4280,17758,2911,32412,4022,1998,2024
47350,36697,4281,17762,2912,32416,4022,1998,2024
47355,36701,4281,17765,2912,32420,4022,1998,2024
47360,36704,4281,17766,2912,32423,4022,1998,2024
47365,36705,4281,17766,2912,32424,4022,1998,2024
47370,36710,4281,17768,2912,32429,4022,1998,2024
47375,36712,4281,17768,2912,32431,4023,1998,2025
47380,36720,4282,17771,2913,32438,4023,1998,2025
47385,36723,4282,17771,2913,32441,4023,1998,2025
47390,36728,4283,17773,2913,32445,4023,1998,2025
47395,36732,4283,17776,2913,32448,4023,1998,2025
47400,36735,4285,17778,2915,32450,4023,1998,2025
47405,36736,4285,17778,2915,32451,4023,1998,2025
47410,36741,4286,17780,2916,32455,4023,1998,2025
47415,36743,4286,17782,2916,32457,4024,1999,2025
47420,36751,4287,17786,2916,32464,4024,1999,2025
47425,36754,4287,17787,2916,32467,4024,1999,2025
47430,36759,4288,17789,2916,32471,4024,1999,2025
47435,36763,4288,17791,2916,32475,4024,1999,2025
47440,36766,4288,17793,2916,32478,4024,1999,2025
47445,36767,4288,17793,2916,32479,4024,1999,2025
47450,36772,4289,17795,2916,32483,4024,1999,2025
47455,36774,4289,17796,2916,32485,4025,1999,2026
47460,36782,4290,17799,2917,32492,4025,1999,2026
47465,36785,4291,17802,2918,32494,4025,1999,2026
47470,36790,4292,17806,2918,32498,4025,1999,2026
47475,36794,4292,17809,2918,32502,4025,1999,2026
47480,36797,4293,17810,2919,32504,4025,1999,2026
47485,36798,4293,17810,2919,32505,4025,1999,2026
47490,36803,4294,17814,2920,32509,4025,1999,2026
47495,36805,4294,17814,2920,32511,4026,1999,2027
47500,36813,4295,17817,2921,32518,4026,1999,2027
47505,36816,4296,17819,2922,32520,4026,1999,2027
47510,36821,4297,17822,2922,32524,4026,1999,2027
47515,36825,4297,17823,2922,32528,4026,1999,2027
47520,36828,4298,17824,2923,32530,4026,1999,2027
47525,36829,4298,17824,2923,32531,4026,1999,2027
47530,36834,4299,17826,2923,32535,4027,1999,2028
47535,36836,4299,17826,2923,32537,4028,1999,2029
47540,36844,4300,17829,2924,32544,4028,1999,2029
47545,36847,4300,17830,2924,32547,4028,1999,2029
47550,36852,4301,17832,2924,32551,4028,1999,2029
47555,36856,4301,17835,2924,32555,4028,1999,2029
47560,36859,4302,17838,2925,32557,4028,1999,2029
47565,36860,4302,17838,2925,32558,4028,1999,2029
47570,36865,4303,17839,2926,32562,4028,1999,2029
47575,36867,4303,17840,2926,32564,4029,2000,2029
47580,36875,4304,17844,2927,32571,4030,2001,2029
47585,36878,4304,17845,2927,32574,4030,2001,2029
47590,36883,4305,17848,2928,32578,4030,2001,2029
47595,36887,4305,17849,2928,32582,4030,2001,2029
47600,36890,4305,17849,2928,32585,4030,2001,2029
47605,36891,4306,17850,2929,32585,4030,2001,2029
47610,36896,4307,17853,2929,32589,4030,2001,2029
47615,36898,4307,17854,2929,32591,4031,2002,2029
47620,36906,4308,17859,2930,32598,4031,2002,2029
47625,36909,4308,17859,2930,32601,4031,2002,2029
47630,36914,4309,17863,2931,32605,4031,2002,2029
47635,36918,4309,17864,2931,32609,4031,2002,2029
47640,36921,4310,17866,2932,32611,4031,2002,2029
47645,36922,4310,17866,2932,32612,4031,2002,2029
47650,36927,4311,17869,2932,32616,4031,2002,2029
47655,36929,4311,17869,2932,32618,4032,2002,2030
47660,36937,4312,17871,2932,32624,4032,2002,2030
47665,36940,4313,17871,2933,32627,4032,2002,2030
47670,36945,4313,17874,2933,32632,4033,2002,2031
47675,36949,4313,17875,2933,32636,4033,2002,2031
47680,36952,4313,17877,2933,32639,4033,2002,2031
47685,36953,4313,17878,2933,32640,4033,2002,2031
47690,36958,4314,17880,2933,32644,4033,2002,2031
47695,36960,4314,17882,2933,32646,4034,2003,2031
47700,36968,4315,17885,2934,32653,4035,2004,2031
47705,36971,4316,17887,2935,32655,4035,2004,2031
47710,36976,4316,17889,2935,32660,4035,2004,2031
47715,36980,4316,17889,2935,32664,4035,2004,2031
47720,36983,4316,17890,2935,32667,4035,2004,2031
47725,36984,4316,17891,2935,32668,4035,2004,2031
47730,36989,4317,17893,2935,32672,4035,2004,2031
47735,36991,4317,17894,2935,32674,4036,2004,2032
47740,36999,4318,17897,2936,32681,4036,2004,2032
47745,37002,4319,17898,2937,32683,4037,2004,2033
47750,37007,4320,17902,2938,32687,4037,2004,2033
47755,37011,4320,17904,2938,32691,4037,2004,2033
47760,37014,4321,17905,2939,32693,4037,2004,2033
47765,37015,4321,17905,2939,32694,4037,2004,2033
47770,37020,4321,17908,2939,32699,4037,2004,2033
47775,37022,4321,17908,2939,32701,4038,2004,2034
47780,37030,4322,17914,2940,32708,4038,2004,2034
47785,37033,4323,17917,2941,32710,4039,2005,2034
47790,37038,4324,17919,2941,32714,4039,2005,2034
47795,37042,4324,17920,2941,32718,4039,2005,2034
47800,37045,4324,17920,2941,32721,4039,2005,2034
47805,37046,4324,17920,2941,32722,4039,2005,2034
47810,37051,4324,17923,2941,32727,4039,2005,2034
47815,37053,4324,17925,2941,32729,4040,2006,2034
47820,37061,4325,17930,2942,32736,4040,2006,2034
47825,37064,4326,17933,2943,32738,4041,2007,2034
47830,37069,4327,17935,2943,32742,4041,2007,2034
47835,37073,4327,17938,2943,32746,4041,2007,2034
47840,37076,4327,17941,2943,32749,4041,2007,2034
47845,37077,4327,17941,2943,32750,4041,2007,2034
47850,37082,4327,17942,2943,32755,4041,2007,2034
47855,37084,4327,17944,2943,32757,4042,2008,2034
47860,37092,4328,17947,2943,32764,4042,2008,2034
47865,37095,4328,17948,2943,32767,4043,2009,2034
47870,37100,4329,17951,2944,32771,4044,2009,2035
47875,37104,4329,17952,2944,32775,4044,2009,2035
47880,37107,4331,17954,2946,32776,4044,2009,2035
47885,37108,4331,17955,2946,32777,4044,2009,2035
47890,37113,4332,17956,2946,32781,4044,2009,2035
47895,37115,4332,17958,2946,32783,4045,2010,2035
47900,37123,4332,17962,2946,32791,4045,2010,2035
47905,37126,4332,17962,2946,32794,4046,2010,2036
47910,37131,4333,17963,2947,32798,4046,2010,2036
47915,37135,4333,17964,2947,32802,4046,2010,2036
47920,37138,4334,17967,2948,32804,4046,2010,2036
47925,37139,4334,17967,2948,32805,4046,2010,2036
47930,37144,4335,17969,2949,32809,4046,2010,2036
47935,37146,4335,17970,2949,32811,4047,2010,2037
47940,37154,4335,17976,2949,32819,4047,2010,2037
47945,37157,4335,17977,2949,32822,4048,2010,2038
47950,37162,4336,17979,2950,32826,4048,2010,2038
47955,37166,4336,17980,2950,32830,4048,2010,2038
47960,37169,4336,17981,2950,32833,4048,2010,2038
47965,37170,4336,17981,2950,32834,4048,2010,2038
47970,37175,4337,17983,2950,32838,4048,2010,2038
47975,37177,4337,17983,2950,32840,4049,2010,2039
47980,37185,4337,17986,2950,32848,4049,2010,2039
47985,37188,4337,17988,2950,32851,4050,2011,2039
47990,37193,4338,17989,2950,32855,4051,2011,2040
47995,37197,4338,17990,2950,32859,4051,2011,2040
48000,37200,4339,17992,2951,32861,4051,2011,2040
48005,37201,4339,17992,2951,32862,4051,2011,2040
48010,37206,4339,17993,2951,32867,4052,2011,2041
48015,37208,4339,17993,2951,32869,4053,2011,2042
48020,37216,4340,17996,2951,32876,4053,2011,2042
48025,37219,4340,17996,2951,32879,4054,2011,2043
48030,37224,4341,17999,2952,32883,4054,2011,2043
48035,37228,4341,18000,2952,32887,4054,2011,2043
48040,37231,4342,18002,2953,32889,4054,2011,2043
48045,37232,4342,18003,2953,32890,4054,2011,2043
48050,37237,4342,18006,2953,32895,4055,2012,2043
48055,37239,4342,18006,2953,32897,4056,2012,2044
48060,37247,4343,18011,2954,32904,4056,2012,2044
48065,37250,4343,18012,2954,32907,4057,2012,2045
48070,37255,4344,18013,2954,32911,4057,2012,2045
48075,37259,4344,18016,2954,32914,4057,2012,2045
48080,37262,4345,18016,2955,32917,4057,2012,2045
48085,37263,4345,18017,2955,32918,4057,2012,2045
48090,37268,4345,18020,2955,32923,4057,2012,2045
48095,37270,4345,18022,2955,32925,4058,2013,2045
48100,37278,4346,18025,2955,32932,4058,2013,2045
48105,37281,4347,18027,2956,32934,4059,2013,2046
48110,37286,4348,18031,2957,32938,4059,2013,2046
48115,37290,4348,18032,2957,32942,4059,2013,2046
48120,37293,4348,18034,2957,32945,4059,2013,2046
48125,37294,4349,18035,2958,32945,4059,2013,2046
48130,37299,4350,18038,2959,32949,4059,2013,2046
48135,37301,4350,18039,2959,32951,4060,2013,2047
48140,37309,4352,18045,2960,32957,4061,2014,2047
48145,37312,4352,18046,2960,32960,4062,2014,2048
48150,37317,4353,18049,2961,32964,4063,2014,2049
48155,37321,4353,18051,2961,32968,4063,2014,2049
48160,37324,4354,18054,2962,32970,4063,2014,2049
48165,37325,4354,18054,2962,32971,4063,2014,2049
48170,37330,4355,18055,2962,32975,4064,2015,2049
48175,37332,4355,18056,2962,32977,4065,2016,2049
48180,37340,4357,18061,2963,32983,4066,2017,2049
48185,37343,4358,18064,2964,32985,4067,2018,2049
48190,37348,4359,18067,2964,32989,4067,2018,2049
48195,37352,4359,18070,2964,32993,4067,2018,2049
48200,37355,4360,18072,2965,32995,4067,2018,2049
48205,37356,4360,18072,2965,32996,4067,2018,2049
48210,37361,4361,18075,2965,33000,4067,2018,2049
48215,37363,4361,18077,2965,33002,4068,2019,2049
48220,37371,4362,18081,2966,33009,4068,2019,2049
48225,37374,4363,18083,2967,33011,4069,2020,2049
48230,37379,4364,18086,2967,33015,4069,2020,2049
48235,37383,4364,18089,2967,33018,4069,2020,2049
48240,37386,4366,18091,2969,33020,4069,2020,2049
48245,37387,4366,18091,2969,33021,4069,2020,2049
48250,37392,4367,18092,2969,33025,4069,2020,2049
48255,37394,4367,18093,2969,33027,4070,2021,2049
48260,37402,4369,18099,2971,33033,4071,2021,2050
48265,37405,4369,18100,2971,33036,4072,2021,2051
48270,37410,4370,18102,2971,33040,4072,2021,2051
48275,37414,4370,18105,2971,33043,4072,2021,2051
48280,37417,4372,18106,2973,33045,4072,2021,2051
48285,37418,4372,18106,2973,33046,4072,2021,2051
48290,37423,4373,18108,2973,33050,4072,2021,2051
48295,37425,4373,18109,2973,33052,4073,2021,2052
48300,37433,4374,18114,2974,33059,4074,2021,2053
48305,37436,4374,18116,2974,33062,4074,2021,2053
48310,37441,4374,18118,2974,33067,4074,2021,2053
48315,37445,4374,18120,2974,33071,4074,2021,2053
48320,37448,4374,18121,2974,33074,4074,2021,2053
48325,37449,4374,18121,2974,33075,4074,2021,2053
48330,37454,4374,18125,2974,33080,4074,2021,2053
48335,37456,4374,18126,2974,33082,4075,2021,2054
48340,37464,4374,18129,2974,33090,4075,2021,2054
48345,37467,4374,18129,2974,33093,4075,2021,2054
48350,37472,4374,18131,2974,33098,4075,2021,2054
48355,37476,4374,18132,2974,33102,4075,2021,2054
48360,37479,4374,18133,2974,33105,4075,2021,2054
48365,37480,4374,18133,2974,33106,4075,2021,2054
48370,37485,4375,18135,2974,33110,4075,2021,2054
48375,37487,4375,18135,2974,33112,4076,2021,2055
48380,37495,4376,18137,2975,33119,4077,2021,2056
48385,37498,4376,18138,2975,33122,4077,2021,2056
48390,37503,4377,18139,2975,33126,4077,2021,2056
48395,37507,4377,18139,2975,33130,4077,2021,2056
48400,37510,4377,18140,2975,33133,4077,2021,2056
48405,37511,4377,18140,2975,33134,4077,2021,2056
48410,37516,4378,18142,2976,33138,4077,2021,2056
48415,37518,4378,18143,2976,33140,4078,2021,2057
48420,37526,4380,18147,2977,33146,4080,2022,2058
48425,37529,4380,18147,2977,33149,4081,2022,2059
48430,37534,4381,18151,2978,33153,4082,2023,2059
48435,37538,4381,18153,2978,33157,4082,2023,2059
48440,37541,4381,18155,2978,33160,4082,2023,2059
48445,37542,4381,18155,2978,33161,4082,2023,2059
48450,37547,4381,18159,2978,33166,4083,2023,2060
48455,37549,4381,18160,2978,33168,4084,2024,2060
48460,37557,4382,18165,2979,33175,4085,2025,2060
48465,37560,4383,18168,2980,33177,4086,2026,2060
48470,37565,4384,18170,2980,33181,4087,2027,2060
48475,37569,4384,18170,2980,33185,4087,2027,2060
48480,37572,4385,18172,2981,33187,4087,2027,2060
48485,37573,4385,18173,2981,33188,4087,2027,2060
48490,37578,4385,18176,2981,33193,4088,2028,2060
48495,37580,4385,18178,2981,33195,4089,2029,2060
48500,37588,4387,18182,2983,33201,4089,2029,2060
48505,37591,4388,18185,2984,33203,4089,2029,2060
48510,37596,4389,18188,2985,33207,4089,2029,2060
48515,37600,4389,18189,2985,33211,4089,2029,2060
48520,37603,4389,18190,2985,33214,4089,2029,2060
48525,37604,4389,18191,2985,33215,4089,2029,2060
48530,37609,4390,18194,2985,33219,4090,2029,2061
48535,37611,4390,18194,2985,33221,4091,2029,2062
48540,37619,4392,18197,2986,33227,4091,2029,2062
48545,37622,4392,18199,2986,33230,4091,2029,2062
48550,37627,4393,18200,2986,33234,4091,2029,2062
48555,37631,4393,18203,2986,33238,4091,2029,2062
48560,37634,4393,18204,2986,33241,4091,2029,2062
48565,37635,4393,18205,2986,33242,4091,2029,2062
48570,37640,4394,18207,2986,33246,4092,2029,2063
48575,37642,4394,18207,2986,33248,4093,2029,2064
48580,37650,4394,18209,2986,33256,4093,2029,2064
48585,37653,4394,18211,2986,33259,4093,2029,2064
48590,37658,4395,18214,2986,33263,4094,2029,2065
48595,37662,4395,18217,2986,33266,4094,2029,2065
48600,37665,4398,18220,2989,33267,4094,2029,2065
48605,37666,4398,18220,2989,33268,4094,2029,2065
48610,37671,4399,18221,2989,33272,4094,2029,2065
48615,37673,4399,18222,2989,33274,4095,2029,2066
48620,37681,4399,18227,2989,33282,4096,2029,2067
48625,37684,4399,18227,2989,33285,4097,2029,2068
48630,37689,4399,18231,2989,33290,4098,2029,2069
48635,37693,4399,18233,2989,33294,4098,2029,2069
48640,37696,4399,18233,2989,33297,4098,2029,2069
48645,37697,4400,18234,2990,33297,4098,2029,2069
48650,37702,4401,18236,2990,33301,4098,2029,2069
48655,37704,4401,18236,2990,33303,4099,2029,2070
48660,37712,4401,18239,2990,33311,4100,2030,2070
48665,37715,4401,18240,2990,33314,4100,2030,2070
48670,37720,4401,18242,2990,33319,4100,2030,2070
48675,37724,4401,18245,2990,33323,4100,2030,2070
48680,37727,4401,18247,2990,33326,4100,2030,2070
48685,37728,4402,18248,2991,33326,4100,2030,2070
48690,37733,4403,18250,2991,33330,4100,2030,2070
48695,37735,4403,18252,2991,33332,4101,2031,2070
48700,37743,4403,18257,2991,33340,4101,2031,2070
48705,37746,4403,18258,2991,33343,4101,2031,2070
48710,37751,4404,18261,2992,33347,4101,2031,2070
48715,37755,4404,18263,2992,33350,4101,2031,2070
48720,37758,4405,18264,2993,33353,4101,2031,2070
48725,37759,4406,18265,2994,33353,4101,2031,2070
48730,37764,4407,18266,2994,33357,4102,2031,2071
48735,37766,4407,18267,2994,33359,4103,2031,2072
48740,37774,4408,18272,2995,33366,4103,2031,2072
48745,37777,4409,18275,2996,33368,4103,2031,2072
48750,37782,4410,18278,2996,33372,4104,2032,2072
48755,37786,4410,18280,2996,33376,4104,2032,2072
48760,37789,4410,18280,2996,33379,4104,2032,2072
48765,37790,4411,18281,2997,33379,4104,2032,2072
48770,37795,4412,18284,2998,33383,4105,2033,2072
48775,37797,4412,18284,2998,33385,4106,2033,2073
48780,37805,4414,18288,2999,33391,4107,2033,2074
48785,37808,4415,18289,3000,33393,4108,2033,2075
48790,37813,4415,18292,3000,33398,4109,2033,2076
48795,37817,4415,18292,3000,33402,4109,2033,2076
48800,37820,4415,18293,3000,33405,4109,2033,2076
48805,37821,4415,18294,3000,33406,4109,2033,2076
48810,37826,4415,18297,3000,33411,4110,2034,2076
48815,37828,4415,18298,3000,33413,4111,2035,2076
48820,37836,4416,18304,3001,33420,4112,2036,2076
48825,37839,4417,18305,3002,33422,4113,2036,2077
48830,37844,4417,18307,3002,33427,4113,2036,2077
48835,37848,4417,18308,3002,33431,4113,2036,2077
48840,37851,4417,18310,3002,33434,4113,2036,2077
48845,37852,4417,18310,3002,33435,4113,2036,2077
48850,37857,4418,18313,3002,33439,4114,2037,2077
48855,37859,4418,18314,3002,33441,4115,2037,2078
48860,37867,4418,18316,3002,33449,4116,2038,2078
48865,37870,4418,18318,3002,33452,4116,2038,2078
48870,37875,4418,18321,3002,33457,4116,2038,2078
48875,37879,4418,18322,3002,33461,4116,2038,2078
48880,37882,4419,18325,3003,33463,4116,2038,2078
48885,37883,4419,18325,3003,33464,4116,2038,2078
48890,37888,4420,18327,3003,33468,4116,2038,2078
48895,37890,4420,18327,3003,33470,4117,2038,2079
48900,37898,4420,18331,3003,33478,4117,2038,2079
48905,37901,4420,18333,3003,33481,4117,2038,2079
48910,37906,4421,18334,3003,33485,4117,2038,2079
48915,37910,4421,18337,3003,33489,4117,2038,2079
48920,37913,4421,18339,3003,33492,4117,2038,2079
48925,37914,4422,18340,3004,33492,4117,2038,2079
48930,37919,4423,18342,3005,33496,4118,2038,2080
48935,37921,4423,18342,3005,33498,4119,2038,2081
48940,37929,4424,18348,3006,33505,4120,2039,2081
48945,37932,4424,18348,3006,33508,4120,2039,2081
48950,37937,4425,18350,3007,33512,4120,2039,2081
48955,37941,4425,18353,3007,33516,4120,2039,2081
48960,37944,4426,18354,3008,33518,4120,2039,2081
48965,37945,4427,18355,3009,33518,4120,2039,2081
48970,37950,4428,18356,3009,33522,4120,2039,2081
48975,37952,4428,18357,3009,33524,4121,2040,2081
48980,37960,4429,18361,3009,33531,4123,2042,2081
48985,37963,4430,18363,3010,33533,4124,2042,2082
48990,37968,4431,18365,3011,33537,4124,2042,2082
48995,37972,4431,18367,3011,33541,4124,2042,2082
49000,37975,4432,18368,3012,33543,4124,2042,2082
49005,37976,4433,18369,3013,33543,4124,2042,2082
49010,37981,4434,18371,3013,33547,4124,2042,2082
49015,37983,4434,18371,3013,33549,4125,2042,2083
49020,37991,4436,18378,3015,33554,4127,2044,2083
49025,37994,4437,18378,3016,33557,4128,2044,2084
49030,37999,4438,18381,3017,33561,4128,2044,2084
49035,38003,4438,18383,3017,33565,4128,2044,2084
49040,38006,4439,18384,3018,33567,4128,2044,2084
49045,38007,4440,18385,3019,33567,4128,2044,2084
49050,38012,4441,18387,3019,33571,4128,2044,2084
49055,38014,4441,18388,3019,33573,4129,2045,2084
49060,38022,4442,18392,3020,33580,4129,2045,2084
49065,38025,4443,18395,3021,33582,4130,2046,2084
49070,38030,4444,18400,3022,33586,4130,2046,2084
49075,38034,4444,18401,3022,33590,4130,2046,2084
49080,38037,4446,18404,3024,33591,4130,2046,2084
49085,38038,4446,18404,3024,33592,4130,2046,2084
49090,38043,4447,18408,3025,33596,4130,2046,2084
49095,38045,4447,18409,3025,33598,4131,2047,2084
49100,38053,4448,18411,3025,33605,4131,2047,2084
49105,38056,4449,18414,3026,33607,4132,2048,2084
49110,38061,4450,18417,3027,33611,4132,2048,2084
49115,38065,4450,18419,3027,33615,4132,2048,2084
49120,38068,4450,18419,3027,33618,4132,2048,2084
49125,38069,4450,18419,3027,33619,4132,2048,2084
49130,38074,4451,18421,3027,33623,4133,2048,2085
49135,38076,4451,18423,3027,33625,4134,2049,2085
49140,38084,4454,18429,3030,33629,4135,2049,2086
49145,38087,4456,18432,3032,33631,4135,2049,2086
49150,38092,4457,18433,3033,33635,4135,2049,2086
49155,38096,4457,18435,3033,33639,4135,2049,2086
49160,38099,4457,18436,3033,33642,4135,2049,2086
49165,38100,4457,18436,3033,33643,4135,2049,2086
49170,38105,4457,18439,3033,33648,4136,2050,2086
49175,38107,4457,18440,3033,33650,4137,2050,2087
49180,38115,4458,18446,3034,33657,4137,2050,2087
49185,38118,4459,18447,3035,33659,4137,2050,2087
49190,38123,4460,18450,3036,33663,4137,2050,2087
49195,38127,4460,18452,3036,33667,4137,2050,2087
49200,38130,4461,18453,3037,33669,4137,2050,2087
49205,38131,4461,18453,3037,33670,4137,2050,2087
49210,38136,4462,18455,3037,33674,4138,2051,2087
49215,38138,4462,18456,3037,33676,4139,2052,2087
49220,38146,4464,18460,3039,33682,4140,2052,2088
49225,38149,4464,18462,3039,33685,4141,2053,2088
49230,38154,4465,18463,3039,33689,4141,2053,2088
49235,38158,4465,18465,3039,33693,4141,2053,2088
49240,38161,4466,18467,3040,33695,4141,2053,2088
49245,38162,4467,18468,3041,33695,4141,2053,2088
49250,38167,4468,18472,3042,33699,4142,2054,2088
49255,38169,4468,18473,3042,33701,4143,2055,2088
49260,38177,4470,18477,3044,33707,4145,2056,2089
49265,38180,4470,18477,3044,33710,4145,2056,2089
49270,38185,4470,18481,3044,33715,4145,2056,2089
49275,38189,4470,18481,3044,33719,4145,2056,2089
49280,38192,4470,18482,3044,33722,4145,2056,2089
49285,38193,4470,18483,3044,33723,4145,2056,2089
49290,38198,4470,18484,3044,33728,4146,2056,2090
49295,38200,4470,18485,3044,33730,4147,2056,2091
49300,38208,4470,18489,3044,33738,4147,2056,2091
49305,38211,4470,18490,3044,33741,4147,2056,2091
49310,38216,4470,18492,3044,33746,4147,2056,2091
49315,38220,4470,18493,3044,33750,4147,2056,2091
49320,38223,4470,18495,3044,33753,4147,2056,2091
49325,38224,4470,18495,3044,33754,4147,2056,2091
49330,38229,4470,18498,3044,33759,4147,2056,2091
49335,38231,4470,18498,3044,33761,4148,2056,2092
49340,38239,4470,18503,3044,33769,4148,2056,2092
49345,38242,4470,18505,3044,33772,4148,2056,2092
49350,38247,4470,18507,3044,33777,4148,2056,2092
49355,38251,4470,18508,3044,33781,4148,2056,2092
49360,38254,4470,18511,3044,33784,4148,2056,2092
49365,38255,4470,18512,3044,33785,4148,2056,2092
49370,38260,4471,18515,3045,33789,4148,2056,2092
49375,38262,4471,18516,3045,33791,4149,2057,2092
49380,38270,4473,18518,3046,33797,4151,2058,2093
49385,38273,4473,18519,3046,33800,4152,2059,2093
49390,38278,4474,18523,3047,33804,4153,2059,2094
49395,38282,4474,18526,3047,33808,4153,2059,2094
49400,38285,4474,18526,3047,33811,4153,2059,2094
49405,38286,4474,18527,3047,33812,4153,2059,2094
49410,38291,4475,18528,3048,33816,4154,2059,2095
49415,38293,4475,18528,3048,33818,4155,2059,2096
49420,38301,4476,18533,3048,33825,4155,2059,2096
49425,38304,4476,18533,3048,33828,4156,2059,2097
49430,38309,4477,18535,3049,33832,4157,2059,2098
49435,38313,4477,18539,3049,33836,4157,2059,2098
49440,38316,4477,18539,3049,33839,4157,2059,2098
49445,38317,4477,18539,3049,33840,4157,2059,2098
49450,38322,4478,18543,3049,33844,4158,2060,2098
49455,38324,4478,18544,3049,33846,4159,2061,2098
49460,38332,4479,18547,3049,33853,4160,2061,2099
49465,38335,4480,18548,3050,33855,4161,2061,2100
49470,38340,4481,18551,3051,33859,4162,2062,2100
49475,38344,4481,18553,3051,33863,4162,2062,2100
49480,38347,4482,18555,3052,33865,4162,2062,2100
49485,38348,4482,18555,3052,33866,4162,2062,2100
49490,38353,4483,18557,3053,33870,4163,2062,2101
49495,38355,4483,18558,3053,33872,4164,2062,2102
49500,38363,4486,18561,3055,33877,4166,2063,2103
49505,38366,4487,18563,3056,33879,4166,2063,2103
49510,38371,4488,18565,3056,33883,4166,2063,2103
49515,38375,4488,18567,3056,33887,4166,2063,2103
49520,38378,4489,18569,3057,33889,4166,2063,2103
49525,38379,4490,18570,3058,33889,4166,2063,2103
49530,38384,4491,18572,3059,33893,4166,2063,2103
49535,38386,4491,18573,3059,33895,4167,2063,2104
49540,38394,4492,18577,3059,33902,4167,2063,2104
49545,38397,4492,18578,3059,33905,4167,2063,2104
49550,38402,4493,18581,3060,33909,4167,2063,2104
49555,38406,4493,18581,3060,33913,4167,2063,2104
49560,38409,4494,18584,3061,33915,4167,2063,2104
49565,38410,4494,18584,3061,33916,4167,2063,2104
49570,38415,4495,18586,3062,33920,4167,2063,2104
49575,38417,4495,18587,3062,33922,4168,2063,2105
49580,38425,4497,18591,3063,33928,4168,2063,2105
49585,38428,4498,18592,3064,33930,4168,2063,2105
49590,38433,4499,18594,3065,33934,4168,2063,2105
49595,38437,4499,18595,3065,33938,4168,2063,2105
49600,38440,4500,18597,3066,33940,4168,2063,2105
49605,38441,4501,18598,3067,33940,4168,2063,2105
49610,38446,4502,18602,3068,33944,4169,2064,2105
49615,38448,4502,18604,3068,33946,4170,2065,2105
49620,38456,4505,18608,3071,33951,4172,2066,2106
49625,38459,4505,18608,3071,33954,4173,2066,2107
49630,38464,4505,18609,3071,33959,4174,2066,2108
49635,38468,4505,18610,3071,33963,4174,2066,2108
49640,38471,4505,18612,3071,33966,4174,2066,2108
49645,38472,4505,18612,3071,33967,4174,2066,2108
49650,38477,4506,18612,3071,33971,4175,2066,2109
49655,38479,4506,18613,3071,33973,4176,2067,2109
49660,38487,4506,18614,3071,33981,4176,2067,2109
49665,38490,4506,18614,3071,33984,4177,2067,2110
49670,38495,4506,18616,3071,33989,4178,2068,2110
49675,38499,4506,18620,3071,33993,4178,2068,2110
49680,38502,4506,18621,3071,33996,4178,2068,2110
49685,38503,4506,18621,3071,33997,4178,2068,2110
49690,38508,4507,18623,3072,34001,4178,2068,2110
49695,38510,4507,18625,3072,34003,4179,2069,2110
49700,38518,4507,18629,3072,34011,4179,2069,2110
49705,38521,4507,18631,3072,34014,4180,2070,2110
49710,38526,4507,18634,3072,34019,4181,2071,2110
49715,38530,4507,18635,3072,34023,4181,2071,2110
49720,38533,4507,18637,3072,34026,4181,2071,2110
49725,38534,4507,18637,3072,34027,4181,2071,2110
49730,38539,4508,18639,3072,34031,4181,2071,2110
49735,38541,4508,18639,3072,34033,4182,2071,2111
49740,38549,4511,18642,3074,34037,4184,2071,2113
49745,38552,4512,18644,3075,34040,4184,2071,2113
49750,38557,4513,18646,3076,34044,4184,2071,2113
49755,38561,4513,18648,3076,34048,4184,2071,2113
49760,38564,4514,18650,3077,34050,4184,2071,2113
49765,38565,4514,18651,3077,34051,4184,2071,2113
49770,38570,4514,18654,3077,34056,4185,2071,2114
49775,38572,4514,18655,3077,34058,4186,2071,2115
49780,38580,4515,18658,3077,34065,4187,2071,2116
49785,38583,4515,18659,3077,34068,4187,2071,2116
49790,38588,4516,18662,3078,34072,4187,2071,2116
49795,38592,4516,18663,3078,34076,4187,2071,2116
49800,38595,4517,18665,3079,34078,4187,2071,2116
49805,38596,4518,18666,3080,34078,4187,2071,2116
49810,38601,4519,18669,3080,34082,4188,2071,2117
49815,38603,4519,18670,3080,34084,4189,2072,2117
49820,38611,4520,18671,3080,34091,4189,2072,2117
49825,38614,4521,18673,3081,34093,4189,2072,2117
49830,38619,4521,18675,3081,34098,4189,2072,2117
49835,38623,4521,18679,3081,34102,4189,2072,2117
49840,38626,4521,18680,3081,34105,4189,2072,2117
49845,38627,4521,18680,3081,34106,4189,2072,2117
49850,38632,4522,18682,3082,34110,4190,2072,2118
49855,38634,4522,18683,3082,34112,4191,2072,2119
49860,38642,4524,18687,3083,34118,4192,2073,2119
49865,38645,4524,18687,3083,34121,4193,2073,2120
49870,38650,4524,18689,3083,34126,4193,2073,2120
49875,38654,4524,18692,3083,34130,4193,2073,2120
49880,38657,4524,18694,3083,34133,4193,2073,2120
49885,38658,4524,18695,3083,34134,4193,2073,2120
49890,38663,4524,18697,3083,34139,4194,2074,2120
49895,38665,4524,18697,3083,34141,4195,2074,2121
49900,38673,4524,18700,3083,34149,4195,2074,2121
49905,38676,4524,18702,3083,34152,4196,2075,2121
49910,38681,4524,18704,3083,34157,4196,2075,2121
49915,38685,4524,18705,3083,34161,4196,2075,2121
49920,38688,4524,18705,3083,34164,4196,2075,2121
49925,38689,4524,18705,3083,34165,4196,2075,2121
49930,38694,4524,18708,3083,34170,4196,2075,2121
49935,38696,4524,18709,3083,34172,4197,2076,2121
49940,38704,4524,18711,3083,34180,4197,2076,2121
49945,38707,4524,18712,3083,34183,4198,2077,2121
49950,38712,4524,18714,3083,34188,4198,2077,2121
49955,38716,4524,18716,3083,34192,4198,2077,2121
49960,38719,4524,18718,3083,34195,4198,2077,2121
49965,38720,4524,18719,3083,34196,4198,2077,2121
49970,38725,4525,18723,3084,34200,4198,2077,2121
49975,38727,4525,18724,3084,34202,4199,2078,2121
49980,38735,4528,18730,3087,34206,4200,2079,2121
49985,38738,4529,18731,3088,34209,4200,2079,2121
49990,38743,4530,18736,3089,34213,4201,2080,2121
49995,38747,4530,18738,3089,34216,4201,2080,2121
50000,38750,4531,18738,3090,34219,4201,2080,2121
50005,38751,4531,18738,3090,34220,4201,2080,2121
50010,38756,4532,18742,3091,34224,4202,2081,2121
50015,38758,4532,18744,3091,34226,4203,2082,2121
50020,38766,4534,18749,3093,34232,4203,2082,2121
50025,38769,4534,18751,3093,34235,4203,2082,2121
50030,38774,4535,18753,3093,34239,4204,2083,2121
50035,38778,4535,18755,3093,34243,4204,2083,2121
50040,38781,4535,18756,3093,34246,4204,2083,2121
50045,38782,4535,18756,3093,34247,4204,2083,2121
50050,38787,4536,18759,3093,34251,4205,2083,2122
50055,38789,4536,18759,3093,34253,4206,2083,2123
50060,38797,4537,18760,3093,34260,4206,2083,2123
50065,38800,4537,18761,3093,34263,4206,2083,2123
50070,38805,4538,18763,3094,34267,4206,2083,2123
50075,38809,4538,18765,3094,34271,4206,2083,2123
50080,38812,4539,18767,3095,34273,4206,2083,2123
50085,38813,4539,18767,3095,34274,4206,2083,2123
50090,38818,4540,18770,3096,34278,4207,2084,2123
50095,38820,4540,18771,3096,34280,4208,2085,2123
50100,38828,4541,18774,3096,34287,4209,2086,2123
50105,38831,4541,18777,3096,34290,4210,2087,2123
50110,38836,4541,18779,3096,34295,4210,2087,2123
50115,38840,4541,18783,3096,34299,4210,2087,2123
50120,38843,4541,18783,3096,34302,4210,2087,2123
50125,38844,4541,18783,3096,34303,4210,2087,2123
50130,38849,4542,18787,3096,34307,4211,2088,2123
50135,38851,4542,18788,3096,34309,4212,2089,2123
50140,38859,4542,18794,3096,34317,4212,2089,2123
50145,38862,4542,18795,3096,34320,4212,2089,2123
50150,38867,4542,18800,3096,34325,4212,2089,2123
50155,38871,4542,18803,3096,34329,4212,2089,2123
50160,38874,4542,18804,3096,34332,4212,2089,2123
50165,38875,4543,18805,3097,34332,4212,2089,2123
50170,38880,4544,18808,3097,34336,4212,2089,2123
50175,38882,4544,18809,3097,34338,4213,2089,2124
50180,38890,4545,18813,3098,34345,4214,2089,2125
50185,38893,4545,18815,3098,34348,4214,2089,2125
50190,38898,4546,18819,3099,34352,4214,2089,2125
50195,38902,4546,18821,3099,34356,4214,2089,2125
50200,38905,4546,18822,3099,34359,4214,2089,2125
50205,38906,4546,18822,3099,34360,4214,2089,2125
50210,38911,4547,18822,3099,34364,4214,2089,2125
50215,38913,4547,18822,3099,34366,4215,2089,2126
50220,38921,4549,18827,3101,34372,4216,2090,2126
50225,38924,4550,18828,3102,34374,4216,2090,2126
50230,38929,4551,18831,3103,34378,4217,2091,2126
50235,38933,4551,18834,3103,34382,4217,2091,2126
50240,38936,4551,18835,3103,34385,4217,2091,2126
50245,38937,4551,18835,3103,34386,4217,2091,2126
50250,38942,4551,18837,3103,34391,4217,2091,2126
50255,38944,4551,18839,3103,34393,4218,2092,2126
50260,38952,4552,18845,3104,34400,4218,2092,2126
50265,38955,4552,18846,3104,34403,4219,2093,2126
50270,38960,4553,18848,3105,34407,4220,2093,2127
50275,38964,4553,18850,3105,34411,4220,2093,2127
50280,38967,4553,18852,3105,34414,4220,2093,2127
50285,38968,4553,18853,3105,34415,4220,2093,2127
50290,38973,4553,18856,3105,34420,4221,2094,2127
50295,38975,4553,18856,3105,34422,4222,2094,2128
50300,38983,4554,18859,3105,34429,4223,2094,2129
50305,38986,4555,18860,3106,34431,4224,2094,2130
50310,38991,4556,18864,3107,34435,4225,2095,2130
50315,38995,4556,18867,3107,34439,4225,2095,2130
50320,38998,4557,18868,3108,34441,4225,2095,2130
50325,38999,4557,18868,3108,34442,4225,2095,2130
50330,39004,4558,18871,3109,34446,4226,2096,2130
50335,39006,4558,18871,3109,34448,4227,2096,2131
50340,39014,4559,18872,3109,34455,4229,2096,2133
50345,39017,4560,18875,3110,34457,4229,2096,2133
50350,39022,4561,18878,3111,34461,4229,2096,2133
50355,39026,4561,18880,3111,34465,4229,2096,2133
50360,39029,4561,18882,3111,34468,4229,2096,2133
50365,39030,4561,18883,3111,34469,4229,2096,2133
50370,39035,4561,18887,3111,34474,4229,2096,2133
50375,39037,4561,18888,3111,34476,4230,2096,2134
50380,39045,4562,18895,3112,34483,4230,2096,2134
50385,39048,4562,18896,3112,34486,4230,2096,2134
50390,39053,4563,18896,3112,34490,4230,2096,2134
50395,39057,4563,18899,3112,34494,4230,2096,2134
50400,39060,4564,18901,3113,34496,4230,2096,2134
50405,39061,4564,18901,3113,34497,4230,2096,2134
50410,39066,4564,18903,3113,34502,4230,2096,2134
50415,39068,4564,18904,3113,34504,4231,2097,2134
50420,39076,4564,18908,3113,34512,4231,2097,2134
50425,39079,4564,18910,3113,34515,4231,2097,2134
50430,39084,4565,18913,3114,34519,4231,2097,2134
50435,39088,4565,18914,3114,34523,4231,2097,2134
50440,39091,4565,18915,3114,34526,4231,2097,2134
50445,39092,4565,18916,3114,34527,4231,2097,2134
50450,39097,4566,18920,3115,34531,4231,2097,2134
50455,39099,4566,18920,3115,34533,4232,2097,2135
50460,39107,4567,18923,3115,34540,4234,2099,2135
50465,39110,4567,18924,3115,34543,4234,2099,2135
50470,39115,4567,18926,3115,34548,4235,2100,2135
50475,39119,4567,18929,3115,34551,4235,2100,2135
50480,39122,4568,18929,3116,34554,4235,2100,2135
50485,39123,4569,18930,3117,34554,4235,2100,2135
50490,39128,4570,18932,3117,34558,4236,2101,2135
50495,39130,4570,18933,3117,34560,4237,2101,2136
50500,39138,4571,18938,3117,34567,4238,2102,2136
50505,39141,4572,18939,3118,34569,4238,2102,2136
50510,39146,4572,18942,3118,34574,4239,2102,2137
50515,39150,4572,18942,3118,34578,4239,2102,2137
50520,39153,4572,18943,3118,34581,4239,2102,2137
50525,39154,4573,18944,3119,34581,4239,2102,2137
50530,39159,4574,18947,3120,34585,4240,2103,2137
50535,39161,4574,18948,3120,34587,4241,2104,2137
50540,39169,4575,18953,3121,34594,4241,2104,2137
50545,39172,4576,18954,3122,34596,4241,2104,2137
50550,39177,4576,18957,3122,34601,4241,2104,2137
50555,39181,4576,18960,3122,34605,4241,2104,2137
50560,39184,4576,18961,3122,34608,4241,2104,2137
50565,39185,4577,18962,3123,34608,4241,2104,2137
50570,39190,4578,18965,3123,34612,4242,2105,2137
50575,39192,4578,18966,3123,34614,4243,2105,2138
50580,39200,4581,18971,3125,34619,4244,2106,2138
50585,39203,4581,18973,3125,34622,4245,2106,2139
50590,39208,4582,18975,3125,34626,4245,2106,2139
50595,39212,4582,18977,3125,34630,4245,2106,2139
50600,39215,4583,18980,3126,34632,4245,2106,2139
50605,39216,4583,18981,3126,34633,4245,2106,2139
50610,39221,4583,18983,3126,34638,4245,2106,2139
50615,39223,4583,18984,3126,34640,4246,2107,2139
50620,39231,4584,18988,3127,34647,4246,2107,2139
50625,39234,4584,18989,3127,34650,4247,2108,2139
50630,39239,4585,18991,3127,34654,4247,2108,2139
50635,39243,4585,18993,3127,34658,4247,2108,2139
50640,39246,4585,18995,3127,34661,4247,2108,2139
50645,39247,4585,18995,3127,34662,4247,2108,2139
50650,39252,4585,18996,3127,34667,4247,2108,2139
50655,39254,4585,18996,3127,34669,4248,2108,2140
50660,39262,4585,19000,3127,34677,4248,2108,2140
50665,39265,4585,19000,3127,34680,4249,2108,2141
50670,39270,4586,19004,3128,34684,4249,2108,2141
50675,39274,4586,19006,3128,34688,4249,2108,2141
50680,39277,4586,19007,3128,34691,4249,2108,2141
50685,39278,4586,19008,3128,34692,4249,2108,2141
50690,39283,4587,19009,3128,34696,4250,2108,2142
50695,39285,4587,19010,3128,34698,4251,2109,2142
50700,39293,4590,19015,3131,34703,4253,2110,2143
50705,39296,4591,19018,3132,34705,4253,2110,2143
50710,39301,4592,19020,3132,34709,4253,2110,2143
50715,39305,4592,19022,3132,34713,4253,2110,2143
50720,39308,4592,19024,3132,34716,4253,2110,2143
50725,39309,4592,19024,3132,34717,4253,2110,2143
50730,39314,4592,19027,3132,34722,4254,2110,2144
50735,39316,4592,19029,3132,34724,4255,2111,2144
50740,39324,4593,19033,3132,34731,4255,2111,2144
50745,39327,4594,19035,3133,34733,4255,2111,2144
50750,39332,4595,19038,3133,34737,4255,2111,2144
50755,39336,4595,19040,3133,34740,4255,2111,2144
50760,39339,4596,19043,3134,34743,4255,2111,2144
50765,39340,4596,19043,3134,34744,4255,2111,2144
50770,39345,4596,19047,3134,34749,4255,2111,2144
50775,39347,4596,19049,3134,34751,4256,2112,2144
50780,39355,4597,19054,3134,34758,4256,2112,2144
50785,39358,4598,19057,3135,34760,4256,2112,2144
50790,39363,4599,19061,3136,34764,4256,2112,2144
50795,39367,4599,19063,3136,34767,4256,2112,2144
50800,39370,4600,19064,3137,34770,4256,2112,2144
50805,39371,4600,19064,3137,34771,4256,2112,2144
50810,39376,4601,19066,3138,34775,4256,2112,2144
50815,39378,4601,19066,3138,34777,4257,2112,2145
50820,39386,4604,19070,3141,34782,4259,2112,2147
50825,39389,4604,19072,3141,34785,4260,2113,2147
50830,39394,4605,19074,3142,34789,4261,2113,2148
50835,39398,4605,19075,3142,34793,4261,2113,2148
50840,39401,4605,19075,3142,34796,4261,2113,2148
50845,39402,4605,19076,3142,34797,4261,2113,2148
50850,39407,4605,19079,3142,34802,4262,2113,2149
50855,39409,4605,19080,3142,34804,4263,2114,2149
50860,39417,4606,19083,3143,34811,4263,2114,2149
50865,39420,4607,19085,3144,34813,4264,2114,2150
50870,39425,4608,19086,3144,34817,4265,2115,2150
50875,39429,4608,19089,3144,34821,4265,2115,2150
50880,39432,4608,19090,3144,34824,4265,2115,2150
50885,39433,4608,19091,3144,34825,4265,2115,2150
50890,39438,4608,19093,3144,34830,4266,2115,2151
50895,39440,4608,19094,3144,34832,4267,2116,2151
50900,39448,4609,19096,3145,34839,4267,2116,2151
50905,39451,4609,19098,3145,34842,4268,2117,2151
50910,39456,4610,19099,3146,34846,4269,2117,2152
50915,39460,4610,19100,3146,34850,4269,2117,2152
50920,39463,4611,19103,3147,34852,4269,2117,2152
50925,39464,4611,19104,3147,34853,4269,2117,2152
50930,39469,4612,19109,3148,34857,4270,2118,2152
50935,39471,4612,19110,3148,34859,4271,2118,2153
50940,39479,4614,19113,3150,34865,4273,2119,2154
50945,39482,4614,19114,3150,34868,4273,2119,2154
50950,39487,4615,19117,3151,34872,4273,2119,2154
50955,39491,4615,19118,3151,34876,4273,2119,2154
50960,39494,4616,19121,3152,34878,4273,2119,2154
50965,39495,4616,19122,3152,34879,4273,2119,2154
50970,39500,4616,19126,3152,34884,4274,2120,2154
50975,39502,4616,19127,3152,34886,4275,2120,2155
50980,39510,4616,19133,3152,34894,4275,2120,2155
50985,39513,4616,19134,3152,34897,4275,2120,2155
50990,39518,4617,19136,3152,34901,4275,2120,2155
50995,39522,4617,19139,3152,34904,4275,2120,2155
51000,39525,4618,19140,3153,34907,4275,2120,2155
51005,39526,4618,19140,3153,34908,4275,2120,2155
51010,39531,4618,19145,3153,34913,4276,2121,2155
51015,39533,4618,19146,3153,34915,4277,2122,2155
51020,39541,4620,19150,3155,34921,4277,2122,2155
51025,39544,4620,19151,3155,34924,4277,2122,2155
51030,39549,4620,19154,3155,34929,4277,2122,2155
51035,39553,4620,19157,3155,34933,4277,2122,2155
51040,39556,4620,19159,3155,34936,4277,2122,2155
51045,39557,4620,19160,3155,34937,4277,2122,2155
51050,39562,4621,19163,3156,34941,4278,2122,2156
51055,39564,4621,19163,3156,34943,4279,2122,2157
51060,39572,4624,19165,3158,34948,4280,2122,2158
51065,39575,4624,19166,3158,34951,4281,2122,2159
51070,39580,4624,19169,3158,34956,4281,2122,2159
51075,39584,4624,19169,3158,34960,4281,2122,2159
51080,39587,4624,19171,3158,34963,4281,2122,2159
51085,39588,4624,19171,3158,34964,4281,2122,2159
51090,39593,4625,19173,3159,34968,4281,2122,2159
51095,39595,4625,19174,3159,34970,4282,2122,2160
51100,39603,4625,19177,3159,34978,4282,2122,2160
51105,39606,4625,19179,3159,34981,4283,2123,2160
51110,39611,4626,19182,3160,34985,4283,2123,2160
51115,39615,4626,19184,3160,34989,4283,2123,2160
51120,39618,4626,19187,3160,34992,4283,2123,2160
51125,39619,4627,19188,3161,34992,4283,2123,2160
51130,39624,4628,19192,3162,34996,4283,2123,2160
51135,39626,4628,19192,3162,34998,4284,2123,2161
51140,39634,4628,19194,3162,35006,4284,2123,2161
51145,39637,4628,19196,3162,35009,4285,2124,2161
51150,39642,4629,19200,3163,35013,4285,2124,2161
51155,39646,4629,19203,3163,35017,4285,2124,2161
51160,39649,4629,19204,3163,35020,4285,2124,2161
51165,39650,4629,19204,3163,35021,4285,2124,2161
51170,39655,4630,19206,3163,35025,4285,2124,2161
51175,39657,4630,19207,3163,35027,4286,2124,2162
51180,39665,4632,19213,3165,35032,4287,2125,2162
51185,39668,4634,19214,3167,35034,4287,2125,2162
51190,39673,4635,19216,3167,35038,4288,2125,2163
51195,39677,4635,19217,3167,35042,4288,2125,2163
51200,39680,4635,19217,3167,35045,4288,2125,2163
51205,39681,4635,19218,3167,35046,4288,2125,2163
51210,39686,4635,19221,3167,35051,4289,2126,2163
51215,39688,4635,19223,3167,35053,4290,2127,2163
51220,39696,4636,19227,3168,35060,4291,2128,2163
51225,39699,4637,19228,3169,35062,4291,2128,2163
51230,39704,4638,19231,3169,35066,4292,2129,2163
51235,39708,4638,19233,3169,35070,4292,2129,2163
51240,39711,4639,19236,3170,35072,4292,2129,2163
51245,39712,4639,19236,3170,35073,4292,2129,2163
51250,39717,4639,19237,3170,35078,4293,2129,2164
51255,39719,4639,19239,3170,35080,4294,2130,2164
51260,39727,4641,19243,3171,35086,4295,2131,2164
51265,39730,4641,19245,3171,35089,4295,2131,2164
51270,39735,4642,19248,3171,35093,4296,2132,2164
51275,39739,4642,19251,3171,35097,4296,2132,2164
51280,39742,4643,19252,3172,35099,4296,2132,2164
51285,39743,4643,19253,3172,35100,4296,2132,2164
51290,39748,4644,19255,3172,35104,4297,2133,2164
51295,39750,4644,19255,3172,35106,4298,2133,2165
51300,39758,4645,19259,3172,35112,4300,2135,2165
51305,39761,4646,19259,3173,35115,4301,2135,2166
51310,39766,4647,19260,3173,35119,4301,2135,2166
51315,39770,4647,19262,3173,35123,4301,2135,2166
51320,39773,4648,19264,3174,35125,4301,2135,2166
51325,39774,4648,19264,3174,35126,4301,2135,2166
51330,39779,4649,19266,3174,35130,4301,2135,2166
51335,39781,4649,19266,3174,35132,4302,2135,2167
51340,39789,4649,19267,3174,35140,4302,2135,2167
51345,39792,4649,19268,3174,35143,4303,2136,2167
51350,39797,4650,19271,3175,35147,4303,2136,2167
51355,39801,4650,19273,3175,35151,4303,2136,2167
51360,39804,4651,19275,3176,35153,4303,2136,2167
51365,39805,4651,19275,3176,35154,4303,2136,2167
51370,39810,4652,19278,3177,35158,4303,2136,2167
51375,39812,4652,19278,3177,35160,4304,2136,2168
51380,39820,4652,19286,3177,35168,4304,2136,2168
51385,39823,4652,19286,3177,35171,4305,2136,2169
51390,39828,4653,19290,3178,35175,4305,2136,2169
51395,39832,4653,19294,3178,35179,4305,2136,2169
51400,39835,4653,19295,3178,35182,4305,2136,2169
51405,39836,4654,19296,3179,35182,4305,2136,2169
51410,39841,4655,19297,3180,35186,4306,2136,2170
51415,39843,4655,19298,3180,35188,4307,2137,2170
51420,39851,4657,19300,3181,35194,4309,2138,2171
51425,39854,4658,19302,3182,35196,4309,2138,2171
51430,39859,4659,19303,3183,35200,4310,2138,2172
51435,39863,4659,19306,3183,35203,4310,2138,2172
51440,39866,4661,19307,3185,35205,4310,2138,2172
51445,39867,4661,19307,3185,35206,4310,2138,2172
51450,39872,4661,19308,3185,35211,4310,2138,2172
51455,39874,4661,19308,3185,35213,4311,2138,2173
51460,39882,4662,19311,3186,35220,4312,2138,2174
51465,39885,4663,19313,3187,35222,4312,2138,2174
51470,39890,4664,19315,3187,35226,4313,2138,2175
51475,39894,4664,19318,3187,35230,4313,2138,2175
51480,39897,4665,19321,3188,35232,4313,2138,2175
51485,39898,4665,19322,3188,35233,4313,2138,2175
51490,39903,4665,19325,3188,35238,4313,2138,2175
51495,39905,4665,19325,3188,35240,4314,2138,2176
51500,39913,4666,19327,3188,35247,4315,2139,2176
51505,39916,4667,19329,3189,35249,4315,2139,2176
51510,39921,4667,19329,3189,35254,4316,2139,2177
51515,39925,4667,19331,3189,35258,4316,2139,2177
51520,39928,4667,19333,3189,35261,4316,2139,2177
51525,39929,4667,19333,3189,35262,4316,2139,2177
51530,39934,4668,19335,3189,35266,4317,2139,2178
51535,39936,4668,19335,3189,35268,4318,2139,2179
51540,39944,4670,19338,3191,35274,4320,2140,2180
51545,39947,4670,19340,3191,35277,4321,2141,2180
51550,39952,4670,19342,3191,35282,4321,2141,2180
51555,39956,4670,19342,3191,35286,4321,2141,2180
51560,39959,4670,19343,3191,35289,4321,2141,2180
51565,39960,4670,19343,3191,35290,4321,2141,2180
51570,39965,4671,19346,3192,35294,4321,2141,2180
51575,39967,4671,19346,3192,35296,4322,2141,2181
51580,39975,4671,19350,3192,35304,4322,2141,2181
51585,39978,4671,19351,3192,35307,4322,2141,2181
51590,39983,4672,19354,3192,35311,4322,2141,2181
51595,39987,4672,19354,3192,35315,4322,2141,2181
51600,39990,4672,19355,3192,35318,4322,2141,2181
51605,39991,4672,19355,3192,35319,4322,2141,2181
51610,39996,4673,19357,3192,35323,4322,2141,2181
51615,39998,4673,19357,3192,35325,4323,2141,2182
51620,40006,4674,19361,3193,35332,4323,2141,2182
51625,40009,4674,19363,3193,35335,4323,2141,2182
51630,40014,4675,19365,3193,35339,4323,2141,2182
51635,40018,4675,19368,3193,35343,4323,2141,2182
51640,40021,4675,19368,3193,35346,4323,2141,2182
51645,40022,4675,19368,3193,35347,4323,2141,2182
51650,40027,4676,19370,3193,35351,4324,2141,2183
51655,40029,4676,19371,3193,35353,4325,2141,2184
51660,40037,4677,19375,3193,35360,4326,2142,2184
51665,40040,4678,19378,3194,35362,4326,2142,2184
51670,40045,4679,19380,3194,35366,4327,2143,2184
51675,40049,4679,19383,3194,35370,4327,2143,2184
51680,40052,4680,19386,3195,35372,4327,2143,2184
51685,40053,4680,19387,3195,35373,4327,2143,2184
51690,40058,4681,19392,3196,35377,4327,2143,2184
51695,40060,4681,19394,3196,35379,4328,2144,2184
51700,40068,4682,19399,3197,35386,4329,2144,2185
51705,40071,4682,19401,3197,35389,4330,2145,2185
51710,40076,4683,19402,3197,35393,4331,2145,2186
51715,40080,4683,19404,3197,35397,4331,2145,2186
51720,40083,4684,19406,3198,35399,4331,2145,2186
51725,40084,4684,19406,3198,35400,4331,2145,2186
51730,40089,4685,19407,3198,35404,4331,2145,2186
51735,40091,4685,19407,3198,35406,4332,2145,2187
51740,40099,4686,19409,3198,35413,4333,2145,2188
51745,40102,4686,19410,3198,35416,4334,2145,2189
51750,40107,4687,19413,3198,35420,4335,2146,2189
51755,40111,4687,19414,3198,35424,4335,2146,2189
51760,40114,4687,19415,3198,35427,4335,2146,2189
51765,40115,4688,19416,3199,35427,4335,2146,2189
51770,40120,4689,19418,3199,35431,4336,2146,2190
51775,40122,4689,19420,3199,35433,4337,2147,2190
51780,40130,4691,19425,3200,35439,4339,2149,2190
51785,40133,4692,19428,3201,35441,4339,2149,2190
51790,40138,4693,19432,3202,35445,4339,2149,2190
51795,40142,4693,19432,3202,35449,4339,2149,2190
51800,40145,4693,19433,3202,35452,4339,2149,2190
51805,40146,4693,19433,3202,35453,4339,2149,2190
51810,40151,4693,19436,3202,35458,4339,2149,2190
51815,40153,4693,19436,3202,35460,4340,2149,2191
51820,40161,4694,19441,3203,35467,4340,2149,2191
51825,40164,4694,19442,3203,35470,4340,2149,2191
51830,40169,4695,19444,3204,35474,4340,2149,2191
51835,40173,4695,19445,3204,35478,4340,2149,2191
51840,40176,4695,19446,3204,35481,4340,2149,2191
51845,40177,4695,19446,3204,35482,4340,2149,2191
51850,40182,4695,19450,3204,35487,4340,2149,2191
51855,40184,4695,19451,3204,35489,4341,2149,2192
51860,40192,4697,19456,3205,35494,4341,2149,2192
51865,40195,4698,19456,3206,35497,4342,2149,2193
51870,40200,4699,19457,3206,35501,4342,2149,2193
51875,40204,4699,19458,3206,35504,4342,2149,2193
51880,40207,4700,19460,3207,35507,4342,2149,2193
51885,40208,4700,19460,3207,35508,4342,2149,2193
51890,40213,4701,19462,3207,35512,4342,2149,2193
51895,40215,4701,19462,3207,35514,4343,2149,2194
51900,40223,4703,19464,3208,35520,4344,2149,2195
51905,40226,4703,19467,3208,35523,4344,2149,2195
51910,40231,4704,19468,3208,35527,4344,2149,2195
51915,40235,4704,19470,3208,35531,4344,2149,2195
51920,40238,4704,19470,3208,35534,4344,2149,2195
51925,40239,4705,19471,3209,35534,4344,2149,2195
51930,40244,4706,19475,3210,35538,4344,2149,2195
51935,40246,4706,19476,3210,35540,4345,2150,2195
51940,40254,4706,19481,3210,35548,4345,2150,2195
51945,40257,4706,19482,3210,35551,4345,2150,2195
51950,40262,4707,19484,3211,35555,4345,2150,2195
51955,40266,4707,19487,3211,35559,4345,2150,2195
51960,40269,4707,19487,3211,35562,4345,2150,2195
51965,40270,4707,19487,3211,35563,4345,2150,2195
51970,40275,4708,19490,3211,35567,4345,2150,2195
51975,40277,4708,19490,3211,35569,4346,2150,2196
51980,40285,4708,19494,3211,35577,4346,2150,2196
51985,40288,4708,19495,3211,35580,4346,2150,2196
51990,40293,4709,19496,3211,35584,4346,2150,2196
51995,40297,4709,19497,3211,35588,4346,2150,2196
52000,40300,4710,19500,3212,35590,4346,2150,2196
52005,40301,4710,19501,3212,35591,4346,2150,2196
52010,40306,4711,19505,3213,35595,4346,2150,2196
52015,40308,4711,19506,3213,35597,4347,2151,2196
52020,40316,4714,19511,3215,35601,4348,2152,2196
52025,40319,4715,19512,3216,35604,4348,2152,2196
52030,40324,4715,19514,3216,35609,4349,2152,2197
52035,40328,4715,19516,3216,35613,4349,2152,2197
52040,40331,4715,19517,3216,35616,4349,2152,2197
52045,40332,4715,19517,3216,35617,4349,2152,2197
52050,40337,4716,19519,3216,35621,4349,2152,2197
52055,40339,4716,19520,3216,35623,4350,2152,2198
52060,40347,4717,19524,3216,35630,4350,2152,2198
52065,40350,4718,19527,3217,35632,4350,2152,2198
52070,40355,4718,19531,3217,35637,4350,2152,2198
52075,40359,4718,19533,3217,35641,4350,2152,2198
52080,40362,4718,19535,3217,35644,4350,2152,2198
52085,40363,4718,19535,3217,35645,4350,2152,2198
52090,40368,4719,19537,3217,35649,4350,2152,2198
52095,40370,4719,19537,3217,35651,4351,2152,2199
52100,40378,4720,19538,3217,35658,4351,2152,2199
52105,40381,4720,19538,3217,35661,4351,2152,2199
52110,40386,4720,19541,3217,35666,4352,2153,2199
52115,40390,4720,19543,3217,35670,4352,2153,2199
52120,40393,4720,19545,3217,35673,4352,2153,2199
52125,40394,4721,19546,3218,35673,4352,2153,2199
52130,40399,4722,19547,3218,35677,4352,2153,2199
52135,40401,4722,19549,3218,35679,4353,2154,2199
52140,40409,4724,19553,3220,35685,4354,2154,2200
52145,40412,4724,19554,3220,35688,4354,2154,2200
52150,40417,4725,19556,3221,35692,4354,2154,2200
52155,40421,4725,19556,3221,35696,4354,2154,2200
52160,40424,4726,19558,3222,35698,4354,2154,2200
52165,40425,4727,19559,3223,35698,4354,2154,2200
52170,40430,4728,19560,3223,35702,4355,2155,2200
52175,40432,4728,19561,3223,35704,4356,2155,2201
52180,40440,4729,19563,3224,35711,4356,2155,2201
52185,40443,4729,19564,3224,35714,4356,2155,2201
52190,40448,4730,19566,3224,35718,4356,2155,2201
52195,40452,4730,19568,3224,35722,4356,2155,2201
52200,40455,4731,19570,3225,35724,4356,2155,2201
52205,40456,4732,19571,3226,35724,4356,2155,2201
52210,40461,4733,19574,3227,35728,4356,2155,2201
52215,40463,4733,19575,3227,35730,4357,2155,2202
52220,40471,4734,19582,3228,35737,4357,2155,2202
52225,40474,4734,19583,3228,35740,4357,2155,2202
52230,40479,4735,19586,3228,35744,4357,2155,2202
52235,40483,4735,19587,3228,35748,4357,2155,2202
52240,40486,4735,19588,3228,35751,4357,2155,2202
52245,40487,4736,19589,3229,35751,4357,2155,2202
52250,40492,4737,19592,3230,35755,4357,2155,2202
52255,40494,4737,19593,3230,35757,4358,2155,2203
52260,40502,4739,19598,3231,35762,4359,2156,2203
52265,40505,4740,19598,3232,35765,4360,2156,2204
52270,40510,4740,19601,3232,35770,4360,2156,2204
52275,40514,4740,19602,3232,35774,4360,2156,2204
52280,40517,4740,19604,3232,35777,4360,2156,2204
52285,40518,4740,19604,3232,35778,4360,2156,2204
52290,40523,4740,19605,3232,35783,4360,2156,2204
52295,40525,4740,19606,3232,35785,4361,2157,2204
52300,40533,4741,19609,3232,35792,4361,2157,2204
52305,40536,4741,19610,3232,35795,4362,2157,2205
52310,40541,4741,19610,3232,35800,4362,2157,2205
52315,40545,4741,19611,3232,35804,4362,2157,2205
52320,40548,4741,19612,3232,35807,4362,2157,2205
52325,40549,4741,19613,3232,35808,4362,2157,2205
52330,40554,4741,19615,3232,35813,4362,2157,2205
52335,40556,4741,19615,3232,35815,4363,2157,2206
52340,40564,4742,19619,3232,35822,4363,2157,2206
52345,40567,4743,19621,3233,35824,4364,2158,2206
52350,40572,4743,19625,3233,35829,4364,2158,2206
52355,40576,4743,19626,3233,35833,4364,2158,2206
52360,40579,4743,19628,3233,35836,4364,2158,2206
52365,40580,4743,19629,3233,35837,4364,2158,2206
52370,40585,4744,19632,3234,35841,4364,2158,2206
52375,40587,4744,19632,3234,35843,4365,2158,2207
52380,40595,4746,19635,3235,35848,4366,2158,2208
52385,40598,4747,19637,3236,35851,4366,2158,2208
52390,40603,4748,19638,3237,35855,4367,2158,2209
52395,40607,4748,19641,3237,35859,4367,2158,2209
52400,40610,4749,19642,3238,35861,4367,2158,2209
52405,40611,4749,19642,3238,35862,4367,2158,2209
52410,40616,4750,19644,3239,35866,4367,2158,2209
52415,40618,4750,19646,3239,35868,4368,2159,2209
52420,40626,4750,19650,3239,35876,4368,2159,2209
52425,40629,4750,19653,3239,35879,4368,2159,2209
52430,40634,4751,19654,3239,35883,4369,2159,2210
52435,40638,4751,19654,3239,35887,4369,2159,2210
52440,40641,4751,19655,3239,35890,4369,2159,2210
52445,40642,4752,19656,3240,35890,4369,2159,2210
52450,40647,4753,19658,3240,35894,4370,2160,2210
52455,40649,4753,19659,3240,35896,4371,2161,2210
52460,40657,4753,19664,3240,35904,4371,2161,2210
52465,40660,4753,19664,3240,35907,4371,2161,2210
52470,40665,4754,19665,3240,35911,4372,2162,2210
52475,40669,4754,19667,3240,35915,4372,2162,2210
52480,40672,4754,19667,3240,35918,4372,2162,2210
52485,40673,4754,19667,3240,35919,4372,2162,2210
52490,40678,4755,19669,3241,35923,4373,2163,2210
52495,40680,4755,19670,3241,35925,4374,2163,2211
52500,40688,4756,19672,3241,35932,4375,2164,2211
52505,40691,4756,19674,3241,35935,4376,2165,2211
52510,40696,4757,19677,3242,35939,4376,2165,2211
52515,40700,4757,19678,3242,35943,4376,2165,2211
52520,40703,4757,19680,3242,35946,4376,2165,2211
52525,40704,4757,19680,3242,35947,4376,2165,2211
52530,40709,4758,19681,3242,35951,4376,2165,2211
52535,40711,4758,19681,3242,35953,4377,2165,2212
52540,40719,4759,19683,3242,35960,4377,2165,2212
52545,40722,4760,19686,3243,35962,4378,2166,2212
52550,40727,4761,19688,3244,35966,4378,2166,2212
52555,40731,4761,19691,3244,35970,4378,2166,2212
52560,40734,4761,19691,3244,35973,4378,2166,2212
52565,40735,4761,19691,3244,35974,4378,2166,2212
52570,40740,4762,19694,3244,35978,4378,2166,2212
52575,40742,4762,19696,3244,35980,4379,2167,2212
52580,40750,4763,19699,3244,35987,4379,2167,2212
52585,40753,4763,19699,3244,35990,4380,2167,2213
52590,40758,4764,19702,3244,35994,4380,2167,2213
52595,40762,4764,19704,3244,35998,4380,2167,2213
52600,40765,4765,19705,3245,36000,4380,2167,2213
52605,40766,4765,19705,3245,36001,4380,2167,2213
52610,40771,4766,19709,3245,36005,4381,2168,2213
52615,40773,4766,19711,3245,36007,4382,2169,2213
52620,40781,4768,19714,3247,36012,4383,2169,2214
52625,40784,4770,19716,3249,36014,4384,2169,2215
52630,40789,4771,19720,3250,36018,4384,2169,2215
52635,40793,4771,19724,3250,36022,4384,2169,2215
52640,40796,4771,19725,3250,36025,4384,2169,2215
52645,40797,4771,19726,3250,36026,4384,2169,2215
52650,40802,4771,19727,3250,36031,4385,2169,2216
52655,40804,4771,19729,3250,36033,4386,2170,2216
52660,40812,4772,19730,3250,36040,4386,2170,2216
52665,40815,4772,19732,3250,36043,4387,2171,2216
52670,40820,4773,19733,3250,36047,4387,2171,2216
52675,40824,4773,19734,3250,36051,4387,2171,2216
52680,40827,4774,19736,3251,36053,4387,2171,2216
52685,40828,4774,19737,3251,36054,4387,2171,2216
52690,40833,4774,19738,3251,36059,4388,2171,2217
52695,40835,4774,19739,3251,36061,4389,2171,2218
52700,40843,4774,19742,3251,36069,4389,2171,2218
52705,40846,4774,19745,3251,36072,4390,2172,2218
52710,40851,4775,19748,3252,36076,4390,2172,2218
52715,40855,4775,19751,3252,36080,4390,2172,2218
52720,40858,4775,19753,3252,36083,4390,2172,2218
52725,40859,4775,19754,3252,36084,4390,2172,2218
52730,40864,4776,19757,3252,36088,4391,2173,2218
52735,40866,4776,19757,3252,36090,4392,2173,2219
52740,40874,4777,19761,3253,36097,4393,2174,2219
52745,40877,4777,19763,3253,36100,4393,2174,2219
52750,40882,4778,19765,3253,36104,4394,2174,2220
52755,40886,4778,19767,3253,36108,4394,2174,2220
52760,40889,4778,19768,3253,36111,4394,2174,2220
52765,40890,4778,19769,3253,36112,4394,2174,2220
52770,40895,4779,19772,3254,36116,4394,2174,2220
52775,40897,4779,19773,3254,36118,4395,2175,2220
52780,40905,4779,19776,3254,36126,4395,2175,2220
52785,40908,4779,19778,3254,36129,4395,2175,2220
52790,40913,4780,19781,3254,36133,4396,2176,2220
52795,40917,4780,19783,3254,36137,4396,2176,2220
52800,40920,4781,19784,3255,36139,4396,2176,2220
52805,40921,4781,19785,3255,36140,4396,2176,2220
52810,40926,4782,19788,3255,36144,4396,2176,2220
52815,40928,4782,19789,3255,36146,4397,2177,2220
52820,40936,4782,19792,3255,36154,4397,2177,2220
52825,40939,4782,19795,3255,36157,4397,2177,2220
52830,40944,4783,19799,3256,36161,4397,2177,2220
52835,40948,4783,19801,3256,36165,4397,2177,2220
52840,40951,4783,19802,3256,36168,4397,2177,2220
52845,40952,4783,19802,3256,36169,4397,2177,2220
52850,40957,4784,19804,3257,36173,4397,2177,2220
52855,40959,4784,19804,3257,36175,4398,2177,2221
52860,40967,4786,19807,3258,36181,4399,2177,2222
52865,40970,4786,19808,3258,36184,4400,2178,2222
52870,40975,4787,19811,3259,36188,4401,2178,2223
52875,40979,4787,19812,3259,36192,4401,2178,2223
52880,40982,4787,19812,3259,36195,4401,2178,2223
52885,40983,4788,19813,3260,36195,4401,2178,2223
52890,40988,4789,19816,3260,36199,4402,2178,2224
52895,40990,4789,19818,3260,36201,4403,2179,2224
52900,40998,4790,19822,3260,36208,4404,2179,2225
52905,41001,4790,19823,3260,36211,4405,2180,2225
52910,41006,4791,19827,3261,36215,4406,2180,2226
52915,41010,4791,19829,3261,36219,4406,2180,2226
52920,41013,4791,19829,3261,36222,4406,2180,2226
52925,41014,4792,19830,3262,36222,4406,2180,2226
52930,41019,4793,19831,3262,36226,4407,2180,2227
52935,41021,4793,19833,3262,36228,4408,2181,2227
52940,41029,4794,19839,3263,36235,4409,2181,2228
52945,41032,4795,19841,3264,36237,4410,2182,2228
52950,41037,4796,19846,3265,36241,4411,2183,2228
52955,41041,4796,19847,3265,36245,4411,2183,2228
52960,41044,4797,19849,3266,36247,4411,2183,2228
52965,41045,4798,19850,3267,36247,4411,2183,2228
52970,41050,4799,19853,3268,36251,4411,2183,2228
52975,41052,4799,19854,3268,36253,4412,2183,2229
52980,41060,4801,19859,3270,36259,4413,2184,2229
52985,41063,4801,19862,3270,36262,4414,2185,2229
52990,41068,4801,19864,3270,36267,4414,2185,2229
52995,41072,4801,19865,3270,36271,4414,2185,2229
53000,41075,4801,19868,3270,36274,4414,2185,2229
53005,41076,4801,19868,3270,36275,4414,2185,2229
53010,41081,4801,19871,3270,36280,4414,2185,2229
53015,41083,4801,19872,3270,36282,4415,2185,2230
53020,41091,4801,19877,3270,36290,4415,2185,2230
53025,41094,4801,19879,3270,36293,4416,2185,2231
53030,41099,4801,19881,3270,36298,4416,2185,2231
53035,41103,4801,19882,3270,36302,4416,2185,2231
53040,41106,4801,19883,3270,36305,4416,2185,2231
53045,41107,4801,19884,3270,36306,4416,2185,2231
53050,41112,4801,19887,3270,36311,4416,2185,2231
53055,41114,4801,19889,3270,36313,4417,2186,2231
53060,41122,4801,19894,3270,36321,4417,2186,2231
53065,41125,4801,19896,3270,36324,4418,2187,2231
53070,41130,4801,19899,3270,36329,4418,2187,2231
53075,41134,4801,19901,3270,36333,4418,2187,2231
53080,41137,4801,19902,3270,36336,4418,2187,2231
53085,41138,4801,19902,3270,36337,4418,2187,2231
53090,41143,4802,19906,3271,36341,4419,2188,2231
53095,41145,4802,19908,3271,36343,4420,2189,2231
53100,41153,4805,19911,3273,36347,4421,2189,2232
53105,41156,4806,19912,3274,36350,4422,2190,2232
53110,41161,4807,19915,3275,36354,4422,2190,2232
53115,41165,4807,19917,3275,36358,4422,2190,2232
53120,41168,4807,19919,3275,36361,4422,2190,2232
53125,41169,4807,19919,3275,36362,4422,2190,2232
53130,41174,4808,19924,3276,36366,4422,2190,2232
53135,41176,4808,19925,3276,36368,4423,2191,2232
53140,41184,4810,19932,3278,36374,4423,2191,2232
53145,41187,4811,19934,3279,36376,4424,2191,2233
53150,41192,4812,19938,3280,36380,4424,2191,2233
53155,41196,4812,19941,3280,36384,4424,2191,2233
53160,41199,4813,19943,3281,36386,4424,2191,2233
53165,41200,4813,19943,3281,36387,4424,2191,2233
53170,41205,4814,19945,3282,36391,4425,2191,2234
53175,41207,4814,19946,3282,36393,4426,2192,2234
53180,41215,4815,19948,3282,36400,4426,2192,2234
53185,41218,4816,19950,3283,36402,4427,2193,2234
53190,41223,4817,19954,3284,36406,4427,2193,2234
53195,41227,4817,19954,3284,36410,4427,2193,2234
53200,41230,4818,19957,3285,36412,4427,2193,2234
53205,41231,4819,19958,3286,36412,4427,2193,2234
53210,41236,4820,19961,3287,36416,4428,2193,2235
53215,41238,4820,19961,3287,36418,4429,2193,2236
53220,41246,4821,19963,3288,36425,4430,2193,2237
53225,41249,4821,19964,3288,36428,4430,2193,2237
53230,41254,4821,19967,3288,36433,4431,2194,2237
53235,41258,4821,19968,3288,36437,4431,2194,2237
53240,41261,4821,19971,3288,36440,4431,2194,2237
53245,41262,4821,19972,3288,36441,4431,2194,2237
53250,41267,4821,19973,3288,36446,4431,2194,2237
53255,41269,4821,19974,3288,36448,4432,2195,2237
53260,41277,4821,19979,3288,36456,4433,2195,2238
53265,41280,4821,19980,3288,36459,4433,2195,2238
53270,41285,4821,19982,3288,36464,4434,2196,2238
53275,41289,4821,19985,3288,36468,4434,2196,2238
53280,41292,4821,19988,3288,36471,4434,2196,2238
53285,41293,4821,19988,3288,36472,4434,2196,2238
53290,41298,4821,19989,3288,36477,4434,2196,2238
53295,41300,4821,19990,3288,36479,4435,2196,2239
53300,41308,4821,19993,3288,36487,4436,2196,2240
53305,41311,4821,19994,3288,36490,4436,2196,2240
53310,41316,4821,19996,3288,36495,4437,2196,2241
53315,41320,4821,19998,3288,36499,4437,2196,2241
53320,41323,4821,19998,3288,36502,4437,2196,2241
53325,41324,4821,19998,3288,36503,4437,2196,2241
53330,41329,4822,20001,3289,36507,4438,2196,2242
53335,41331,4822,20003,3289,36509,4439,2197,2242
53340,41339,4824,20009,3291,36515,4439,2197,2242
53345,41342,4824,20010,3291,36518,4440,2197,2243
53350,41347,4825,20014,3291,36522,4440,2197,2243
53355,41351,4825,20015,3291,36526,4440,2197,2243
53360,41354,4825,20016,3291,36529,4440,2197,2243
53365,41355,4826,20017,3292,36529,4440,2197,2243
53370,41360,4827,20019,3293,36533,4441,2197,2244
53375,41362,4827,20020,3293,36535,4442,2198,2244
53380,41370,4828,20024,3294,36541,4442,2198,2244
53385,41373,4829,20025,3295,36544,4443,2198,2245
53390,41378,4830,20027,3296,36548,4443,2198,2245
53395,41382,4830,20031,3296,36552,4443,2198,2245
53400,41385,4830,20032,3296,36555,4443,2198,2245
53405,41386,4830,20032,3296,36556,4443,2198,2245
53410,41391,4831,20034,3296,36560,4444,2199,2245
53415,41393,4831,20035,3296,36562,4445,2199,2246
53420,41401,4832,20036,3296,36569,4446,2200,2246
53425,41404,4832,20037,3296,36572,4446,2200,2246
53430,41409,4833,20038,3296,36576,4447,2200,2247
53435,41413,4833,20040,3296,36580,4447,2200,2247
53440,41416,4833,20041,3296,36583,4447,2200,2247
53445,41417,4833,20041,3296,36584,4447,2200,2247
53450,41422,4834,20045,3297,36588,4448,2201,2247
53455,41424,4834,20046,3297,36590,4449,2202,2247
53460,41432,4836,20048,3298,36596,4450,2203,2247
53465,41435,4837,20050,3299,36598,4450,2203,2247
53470,41440,4837,20051,3299,36603,4451,2203,2248
53475,41444,4837,20052,3299,36606,4451,2203,2248
53480,41447,4838,20053,3300,36609,4451,2203,2248
53485,41448,4838,20054,3300,36610,4451,2203,2248
53490,41453,4839,20056,3301,36614,4451,2203,2248
53495,41455,4839,20056,3301,36616,4452,2203,2249
53500,41463,4840,20058,3302,36623,4453,2204,2249
53505,41466,4840,20058,3302,36626,4453,2204,2249
53510,41471,4840,20060,3302,36631,4454,2204,2250
53515,41475,4840,20061,3302,36634,4454,2204,2250
53520,41478,4841,20061,3303,36637,4454,2204,2250
53525,41479,4841,20062,3303,36638,4454,2204,2250
53530,41484,4842,20065,3304,36642,4454,2204,2250
53535,41486,4842,20065,3304,36644,4455,2204,2251
53540,41494,4842,20067,3304,36651,4455,2204,2251
53545,41497,4843,20069,3305,36654,4456,2205,2251
53550,41502,4843,20072,3305,36659,4456,2205,2251
53555,41506,4843,20075,3305,36663,4456,2205,2251
53560,41509,4843,20076,3305,36666,4456,2205,2251
53565,41510,4843,20076,3305,36667,4456,2205,2251
53570,41515,4844,20078,3306,36671,4457,2206,2251
53575,41517,4844,20080,3306,36673,4458,2207,2251
53580,41525,4844,20084,3306,36681,4458,2207,2251
53585,41528,4844,20085,3306,36684,4459,2207,2252
53590,41533,4845,20089,3307,36688,4459,2207,2252
53595,41537,4845,20091,3307,36692,4459,2207,2252
53600,41540,4845,20092,3307,36695,4459,2207,2252
53605,41541,4845,20092,3307,36696,4459,2207,2252
53610,41546,4846,20095,3307,36700,4459,2207,2252
53615,41548,4846,20095,3307,36702,4460,2207,2253
53620,41556,4846,20099,3307,36710,4460,2207,2253
53625,41559,4846,20101,3307,36713,4460,2207,2253
53630,41564,4847,20105,3308,36717,4461,2208,2253
53635,41568,4847,20106,3308,36721,4461,2208,2253
53640,41571,4848,20108,3309,36723,4461,2208,2253
53645,41572,4848,20108,3309,36724,4461,2208,2253
53650,41577,4849,20110,3309,36728,4461,2208,2253
53655,41579,4849,20110,3309,36730,4462,2208,2254
53660,41587,4850,20116,3310,36736,4462,2208,2254
53665,41590,4852,20119,3312,36738,4462,2208,2254
53670,41595,4853,20122,3312,36742,4462,2208,2254
53675,41599,4853,20125,3312,36746,4462,2208,2254
53680,41602,4854,20128,3313,36748,4462,2208,2254
53685,41603,4854,20128,3313,36749,4462,2208,2254
53690,41608,4855,20132,3314,36753,4463,2209,2254
53695,41610,4855,20133,3314,36755,4464,2210,2254
53700,41618,4857,20137,3315,36760,4464,2210,2254
53705,41621,4858,20139,3316,36763,4464,2210,2254
53710,41626,4859,20142,3316,36767,4464,2210,2254
53715,41630,4859,20143,3316,36771,4464,2210,2254
53720,41633,4860,20144,3317,36773,4464,2210,2254
53725,41634,4860,20144,3317,36774,4464,2210,2254
53730,41639,4861,20147,3317,36778,4464,2210,2254
53735,41641,4861,20149,3317,36780,4465,2211,2254
53740,41649,4862,20151,3318,36787,4466,2211,2255
53745,41652,4863,20153,3319,36789,4466,2211,2255
53750,41657,4864,20154,3320,36793,4467,2211,2256
53755,41661,4864,20156,3320,36796,4467,2211,2256
53760,41664,4866,20158,3322,36798,4467,2211,2256
53765,41665,4866,20158,3322,36799,4467,2211,2256
53770,41670,4867,20160,3322,36803,4467,2211,2256
53775,41672,4867,20161,3322,36805,4468,2212,2256
53780,41680,4868,20167,3323,36812,4469,2212,2257
53785,41683,4868,20168,3323,36815,4469,2212,2257
53790,41688,4869,20171,3324,36819,4470,2212,2258
53795,41692,4869,20173,3324,36823,4470,2212,2258
53800,41695,4869,20174,3324,36826,4470,2212,2258
53805,41696,4869,20174,3324,36827,4470,2212,2258
53810,41701,4870,20177,3324,36831,4471,2213,2258
53815,41703,4870,20178,3324,36833,4472,2214,2258
53820,41711,4873,20184,3327,36837,4473,2214,2259
53825,41714,4874,20186,3328,36840,4473,2214,2259
53830,41719,4875,20188,3329,36844,4473,2214,2259
53835,41723,4875,20190,3329,36848,4473,2214,2259
53840,41726,4875,20192,3329,36851,4473,2214,2259
53845,41727,4876,20193,3330,36851,4473,2214,2259
53850,41732,4877,20196,3331,36855,4474,2215,2259
53855,41734,4877,20197,3331,36857,4475,2215,2260
53860,41742,4878,20202,3332,36864,4475,2215,2260
53865,41745,4878,20203,3332,36867,4475,2215,2260
53870,41750,4879,20206,3333,36871,4475,2215,2260
53875,41754,4879,20208,3333,36875,4475,2215,2260
53880,41757,4880,20209,3334,36877,4475,2215,2260
53885,41758,4880,20210,3334,36878,4475,2215,2260
53890,41763,4880,20213,3334,36883,4476,2216,2260
53895,41765,4880,20215,3334,36885,4477,2217,2260
53900,41773,4880,20218,3334,36893,4477,2217,2260
53905,41776,4880,20219,3334,36896,4477,2217,2260
53910,41781,4881,20221,3335,36900,4477,2217,2260
53915,41785,4881,20222,3335,36904,4477,2217,2260
53920,41788,4882,20224,3336,36906,4477,2217,2260
53925,41789,4882,20225,3336,36907,4477,2217,2260
53930,41794,4882,20226,3336,36912,4477,2217,2260
53935,41796,4882,20226,3336,36914,4478,2217,2261
53940,41804,4883,20228,3336,36921,4479,2217,2262
53945,41807,4884,20231,3337,36923,4479,2217,2262
53950,41812,4885,20234,3337,36927,4480,2217,2263
53955,41816,4885,20235,3337,36931,4480,2217,2263
53960,41819,4885,20236,3337,36934,4480,2217,2263
53965,41820,4885,20236,3337,36935,4480,2217,2263
53970,41825,4885,20238,3337,36940,4480,2217,2263
53975,41827,4885,20239,3337,36942,4481,2218,2263
53980,41835,4886,20243,3338,36949,4481,2218,2263
53985,41838,4887,20245,3339,36951,4481,2218,2263
53990,41843,4888,20248,3339,36955,4482,2219,2263
53995,41847,4888,20250,3339,36959,4482,2219,2263
54000,41850,4888,20251,3339,36962,4482,2219,2263
54005,41851,4888,20252,3339,36963,4482,2219,2263
54010,41856,4889,20254,3339,36967,4482,2219,2263
54015,41858,4889,20255,3339,36969,4483,2219,2264
54020,41866,4892,20259,3341,36974,4483,2219,2264
54025,41869,4892,20260,3341,36977,4483,2219,2264
54030,41874,4892,20263,3341,36982,4484,2219,2265
54035,41878,4892,20265,3341,36986,4484,2219,2265
54040,41881,4892,20265,3341,36989,4484,2219,2265
54045,41882,4892,20266,3341,36990,4484,2219,2265
54050,41887,4893,20268,3341,36994,4484,2219,2265
54055,41889,4893,20269,3341,36996,4485,2219,2266
54060,41897,4895,20274,3343,37002,4486,2220,2266
54065,41900,4895,20275,3343,37005,4486,2220,2266
54070,41905,4895,20276,3343,37010,4486,2220,2266
54075,41909,4895,20278,3343,37014,4486,2220,2266
54080,41912,4895,20281,3343,37017,4486,2220,2266
54085,41913,4895,20281,3343,37018,4486,2220,2266
54090,41918,4896,20284,3343,37022,4486,2220,2266
54095,41920,4896,20285,3343,37024,4487,2221,2266
54100,41928,4896,20289,3343,37032,4487,2221,2266
54105,41931,4896,20290,3343,37035,4487,2221,2266
54110,41936,4897,20291,3343,37039,4487,2221,2266
54115,41940,4897,20294,3343,37042,4487,2221,2266
54120,41943,4898,20295,3344,37045,4487,2221,2266
54125,41944,4899,20296,3345,37045,4487,2221,2266
54130,41949,4900,20298,3345,37049,4488,2221,2267
54135,41951,4900,20298,3345,37051,4489,2221,2268
54140,41959,4901,20301,3346,37058,4489,2221,2268
54145,41962,4901,20301,3346,37061,4489,2221,2268
54150,41967,4902,20303,3346,37065,4489,2221,2268
54155,41971,4902,20304,3346,37069,4489,2221,2268
54160,41974,4903,20307,3347,37071,4489,2221,2268
54165,41975,4903,20307,3347,37072,4489,2221,2268
54170,41980,4904,20310,3347,37076,4490,2222,2268
54175,41982,4904,20311,3347,37078,4491,2222,2269
54180,41990,4906,20316,3348,37084,4492,2222,2270
54185,41993,4907,20317,3349,37086,4492,2222,2270
54190,41998,4908,20321,3350,37090,4492,2222,2270
54195,42002,4908,20322,3350,37094,4492,2222,2270
54200,42005,4908,20324,3350,37097,4492,2222,2270
54205,42006,4909,20325,3351,37097,4492,2222,2270
54210,42011,4910,20327,3351,37101,4492,2222,2270
54215,42013,4910,20328,3351,37103,4493,2222,2271
54220,42021,4911,20330,3351,37110,4494,2223,2271
54225,42024,4912,20332,3352,37112,4494,2223,2271
54230,42029,4913,20333,3352,37116,4494,2223,2271
54235,42033,4913,20335,3352,37119,4494,2223,2271
54240,42036,4915,20336,3354,37121,4494,2223,2271
54245,42037,4915,20336,3354,37122,4494,2223,2271
54250,42042,4916,20339,3354,37126,4494,2223,2271
54255,42044,4916,20340,3354,37128,4495,2224,2271
54260,42052,4916,20343,3354,37136,4495,2224,2271
54265,42055,4916,20344,3354,37139,4495,2224,2271
54270,42060,4916,20346,3354,37144,4496,2225,2271
54275,42064,4916,20349,3354,37148,4496,2225,2271
54280,42067,4916,20352,3354,37151,4496,2225,2271
54285,42068,4917,20353,3355,37151,4496,2225,2271
54290,42073,4918,20355,3355,37155,4496,2225,2271
54295,42075,4918,20356,3355,37157,4497,2225,2272
54300,42083,4918,20358,3355,37165,4497,2225,2272
54305,42086,4918,20359,3355,37168,4497,2225,2272
54310,42091,4918,20361,3355,37173,4498,2225,2273
54315,42095,4918,20363,3355,37177,4498,2225,2273
54320,42098,4918,20364,3355,37180,4498,2225,2273
54325,42099,4918,20364,3355,37181,4498,2225,2273
54330,42104,4919,20367,3355,37185,4499,2225,2274
54335,42106,4919,20368,3355,37187,4500,2225,2275
54340,42114,4919,20372,3355,37195,4500,2225,2275
54345,42117,4919,20373,3355,37198,4500,2225,2275
54350,42122,4919,20376,3355,37203,4501,2226,2275
54355,42126,4919,20377,3355,37206,4501,2226,2275
54360,42129,4920,20378,3356,37209,4501,2226,2275
54365,42130,4920,20378,3356,37210,4501,2226,2275
54370,42135,4921,20382,3357,37214,4501,2226,2275
54375,42137,4921,20383,3357,37216,4502,2227,2275
54380,42145,4922,20387,3357,37223,4503,2228,2275
54385,42148,4922,20387,3357,37226,4503,2228,2275
54390,42153,4923,20390,3357,37230,4504,2229,2275
54395,42157,4923,20392,3357,37234,4504,2229,2275
54400,42160,4923,20394,3357,37237,4504,2229,2275
54405,42161,4923,20394,3357,37238,4504,2229,2275
54410,42166,4924,20396,3357,37242,4504,2229,2275
54415,42168,4924,20397,3357,37244,4505,2230,2275
54420,42176,4926,20402,3358,37250,4506,2231,2275
54425,42179,4926,20405,3358,37253,4506,2231,2275
54430,42184,4927,20408,3359,37257,4506,2231,2275
54435,42188,4927,20411,3359,37261,4506,2231,2275
54440,42191,4928,20414,3360,37263,4506,2231,2275
54445,42192,4928,20414,3360,37264,4506,2231,2275
54450,42197,4929,20416,3361,37268,4506,2231,2275
54455,42199,4929,20417,3361,37270,4507,2231,2276
54460,42207,4929,20420,3361,37278,4507,2231,2276
54465,42210,4929,20423,3361,37281,4507,2231,2276
54470,42215,4930,20427,3362,37285,4507,2231,2276
54475,42219,4930,20429,3362,37288,4507,2231,2276
54480,42222,4932,20431,3364,37290,4507,2231,2276
54485,42223,4932,20432,3364,37291,4507,2231,2276
54490,42228,4932,20433,3364,37296,4508,2231,2277
54495,42230,4932,20435,3364,37298,4509,2232,2277
54500,42238,4932,20440,3364,37306,4509,2232,2277
54505,42241,4932,20442,3364,37309,4509,2232,2277
54510,42246,4932,20445,3364,37314,4510,2233,2277
54515,42250,4932,20446,3364,37318,4510,2233,2277
54520,42253,4932,20447,3364,37321,4510,2233,2277
54525,42254,4932,20448,3364,37322,4510,2233,2277
54530,42259,4932,20450,3364,37327,4510,2233,2277
54535,42261,4932,20450,3364,37329,4511,2233,2278
54540,42269,4932,20452,3364,37337,4511,2233,2278
54545,42272,4932,20455,3364,37340,4511,2233,2278
54550,42277,4933,20458,3365,37344,4511,2233,2278
54555,42281,4933,20461,3365,37348,4511,2233,2278
54560,42284,4933,20461,3365,37351,4511,2233,2278
54565,42285,4933,20462,3365,37352,4511,2233,2278
54570,42290,4933,20465,3365,37357,4511,2233,2278
54575,42292,4933,20466,3365,37359,4512,2234,2278
54580,42300,4934,20470,3366,37366,4512,2234,2278
54585,42303,4934,20471,3366,37369,4512,2234,2278
54590,42308,4935,20471,3366,37373,4512,2234,2278
54595,42312,4935,20474,3366,37377,4512,2234,2278
54600,42315,4935,20475,3366,37380,4512,2234,2278
54605,42316,4936,20476,3367,37380,4512,2234,2278
54610,42321,4937,20478,3367,37384,4512,2234,2278
54615,42323,4937,20479,3367,37386,4513,2235,2278
54620,42331,4938,20484,3368,37392,4513,2235,2278
54625,42334,4940,20486,3370,37394,4513,2235,2278
54630,42339,4941,20489,3370,37398,4513,2235,2278
54635,42343,4941,20492,3370,37402,4513,2235,2278
54640,42346,4941,20493,3370,37405,4513,2235,2278
54645,42347,4941,20493,3370,37406,4513,2235,2278
54650,42352,4942,20495,3371,37410,4513,2235,2278
54655,42354,4942,20496,3371,37412,4514,2235,2279
54660,42362,4943,20499,3372,37419,4515,2235,2280
54665,42365,4943,20500,3372,37422,4515,2235,2280
54670,42370,4944,20503,3372,37426,4516,2236,2280
54675,42374,4944,20504,3372,37430,4516,2236,2280
54680,42377,4945,20505,3373,37432,4516,2236,2280
54685,42378,4946,20506,3374,37432,4516,2236,2280
54690,42383,4947,20508,3374,37436,4517,2236,2281
54695,42385,4947,20509,3374,37438,4518,2237,2281
54700,42393,4948,20512,3375,37445,4519,2237,2282
54705,42396,4948,20512,3375,37448,4519,2237,2282
54710,42401,4949,20515,3375,37452,4520,2238,2282
54715,42405,4949,20517,3375,37456,4520,2238,2282
54720,42408,4950,20519,3376,37458,4520,2238,2282
54725,42409,4951,20520,3377,37458,4520,2238,2282
54730,42414,4952,20522,3378,37462,4520,2238,2282
54735,42416,4952,20523,3378,37464,4521,2238,2283
54740,42424,4953,20527,3379,37470,4522,2238,2284
54745,42427,4954,20527,3380,37473,4522,2238,2284
54750,42432,4954,20530,3380,37478,4523,2238,2285
54755,42436,4954,20530,3380,37482,4523,2238,2285
54760,42439,4954,20531,3380,37485,4523,2238,2285
54765,42440,4954,20531,3380,37486,4523,2238,2285
54770,42445,4955,20534,3380,37490,4523,2238,2285
54775,42447,4955,20536,3380,37492,4524,2239,2285
54780,42455,4958,20543,3383,37496,4525,2240,2285
54785,42458,4959,20544,3384,37499,4525,2240,2285
54790,42463,4959,20545,3384,37504,4526,2241,2285
54795,42467,4959,20548,3384,37508,4526,2241,2285
54800,42470,4959,20551,3384,37511,4526,2241,2285
54805,42471,4959,20551,3384,37512,4526,2241,2285
54810,42476,4960,20553,3384,37516,4526,2241,2285
54815,42478,4960,20554,3384,37518,4527,2242,2285
54820,42486,4961,20556,3384,37525,4528,2242,2286
54825,42489,4961,20557,3384,37528,4528,2242,2286
54830,42494,4962,20559,3384,37532,4528,2242,2286
54835,42498,4962,20561,3384,37535,4528,2242,2286
54840,42501,4963,20563,3385,37538,4528,2242,2286
54845,42502,4963,20564,3385,37539,4528,2242,2286
54850,42507,4964,20566,3385,37543,4529,2242,2287
54855,42509,4964,20566,3385,37545,4530,2242,2288
54860,42517,4965,20570,3386,37552,4531,2243,2288
54865,42520,4965,20572,3386,37555,4531,2243,2288
54870,42525,4966,20574,3386,37559,4531,2243,2288
54875,42529,4966,20577,3386,37563,4531,2243,2288
54880,42532,4967,20580,3387,37565,4531,2243,2288
54885,42533,4967,20580,3387,37566,4531,2243,2288
54890,42538,4968,20584,3388,37570,4532,2243,2289
54895,42540,4968,20584,3388,37572,4533,2243,2290
54900,42548,4969,20589,3389,37578,4534,2244,2290
54905,42551,4970,20590,3390,37581,4534,2244,2290
54910,42556,4971,20594,3391,37585,4535,2245,2290
54915,42560,4971,20594,3391,37589,4535,2245,2290
54920,42563,4971,20595,3391,37592,4535,2245,2290
54925,42564,4971,20595,3391,37593,4535,2245,2290
54930,42569,4972,20598,3392,37597,4535,2245,2290
54935,42571,4972,20599,3392,37599,4536,2245,2291
54940,42579,4975,20605,3394,37603,4536,2245,2291
54945,42582,4976,20607,3395,37606,4536,2245,2291
54950,42587,4977,20610,3395,37610,4537,2246,2291
54955,42591,4977,20612,3395,37614,4537,2246,2291
54960,42594,4978,20615,3396,37616,4537,2246,2291
54965,42595,4978,20615,3396,37617,4537,2246,2291
54970,42600,4979,20619,3397,37621,4537,2246,2291
54975,42602,4979,20620,3397,37623,4538,2246,2292
54980,42610,4980,20620,3397,37630,4538,2246,2292
54985,42613,4980,20620,3397,37633,4538,2246,2292
54990,42618,4980,20622,3397,37638,4539,2247,2292
54995,42622,4980,20623,3397,37642,4539,2247,2292
55000,42625,4980,20623,3397,37645,4539,2247,2292
55005,42626,4981,20624,3398,37645,4539,2247,2292
55010,42631,4982,20625,3398,37649,4540,2247,2293
55015,42633,4982,20625,3398,37651,4541,2247,2294
55020,42641,4983,20632,3399,37658,4542,2248,2294
55025,42644,4983,20635,3399,37661,4542,2248,2294
55030,42649,4983,20635,3399,37666,4542,2248,2294
55035,42653,4983,20637,3399,37670,4542,2248,2294
55040,42656,4983,20639,3399,37673,4542,2248,2294
55045,42657,4984,20640,3400,37673,4542,2248,2294
55050,42662,4985,20644,3400,37677,4543,2249,2294
55055,42664,4985,20645,3400,37679,4544,2250,2294
55060,42672,4986,20649,3400,37686,4544,2250,2294
55065,42675,4986,20651,3400,37689,4544,2250,2294
55070,42680,4987,20651,3400,37693,4544,2250,2294
55075,42684,4987,20653,3400,37696,4544,2250,2294
55080,42687,4988,20653,3401,37699,4544,2250,2294
55085,42688,4989,20654,3402,37699,4544,2250,2294
55090,42693,4989,20656,3402,37704,4544,2250,2294
55095,42695,4989,20657,3402,37706,4545,2251,2294
55100,42703,4991,20659,3403,37712,4545,2251,2294
55105,42706,4991,20661,3403,37715,4545,2251,2294
55110,42711,4992,20665,3404,37719,4545,2251,2294
55115,42715,4992,20667,3404,37723,4545,2251,2294
55120,42718,4992,20668,3404,37726,4545,2251,2294
55125,42719,4992,20668,3404,37727,4545,2251,2294
55130,42724,4992,20669,3404,37732,4545,2251,2294
55135,42726,4992,20671,3404,37734,4546,2252,2294
55140,42734,4995,20676,3407,37739,4547,2252,2295
55145,42737,4995,20678,3407,37742,4547,2252,2295
55150,42742,4996,20681,3408,37746,4548,2252,2296
55155,42746,4996,20684,3408,37750,4548,2252,2296
55160,42749,4996,20686,3408,37753,4548,2252,2296
55165,42750,4996,20687,3408,37754,4548,2252,2296
55170,42755,4996,20687,3408,37759,4548,2252,2296
55175,42757,4996,20687,3408,37761,4549,2252,2297
55180,42765,4998,20691,3409,37766,4550,2253,2297
55185,42768,4999,20693,3410,37769,4550,2253,2297
55190,42773,5000,20694,3410,37773,4551,2254,2297
55195,42777,5000,20697,3410,37776,4551,2254,2297
55200,42780,5002,20699,3412,37778,4551,2254,2297
55205,42781,5002,20699,3412,37779,4551,2254,2297
55210,42786,5003,20701,3412,37783,4551,2254,2297
55215,42788,5003,20702,3412,37785,4552,2255,2297
55220,42796,5004,20707,3413,37792,4553,2256,2297
55225,42799,5004,20708,3413,37795,4553,2256,2297
55230,42804,5004,20709,3413,37800,4554,2256,2298
55235,42808,5004,20712,3413,37804,4554,2256,2298
55240,42811,5004,20713,3413,37807,4554,2256,2298
55245,42812,5005,20714,3414,37807,4554,2256,2298
55250,42817,5006,20718,3415,37811,4554,2256,2298
55255,42819,5006,20718,3415,37813,4555,2256,2299
55260,42827,5007,20723,3416,37820,4556,2256,2300
55265,42830,5007,20724,3416,37823,4556,2256,2300
55270,42835,5007,20726,3416,37828,4556,2256,2300
55275,42839,5007,20729,3416,37832,4556,2256,2300
55280,42842,5007,20730,3416,37835,4556,2256,2300
55285,42843,5008,20731,3417,37835,4556,2256,2300
55290,42848,5009,20734,3417,37839,4556,2256,2300
55295,42850,5009,20736,3417,37841,4557,2257,2300
55300,42858,5011,20741,3419,37847,4558,2258,2300
55305,42861,5011,20742,3419,37850,4558,2258,2300
55310,42866,5012,20745,3420,37854,4558,2258,2300
55315,42870,5012,20748,3420,37858,4558,2258,2300
55320,42873,5013,20751,3421,37860,4558,2258,2300
55325,42874,5013,20751,3421,37861,4558,2258,2300
55330,42879,5014,20753,3421,37865,4559,2258,2301
55335,42881,5014,20754,3421,37867,4560,2258,2302
55340,42889,5015,20757,3421,37873,4561,2258,2303
55345,42892,5016,20757,3422,37876,4561,2258,2303
55350,42897,5017,20759,3423,37880,4561,2258,2303
55355,42901,5017,20760,3423,37884,4561,2258,2303
55360,42904,5017,20761,3423,37887,4561,2258,2303
55365,42905,5017,20762,3423,37888,4561,2258,2303
55370,42910,5018,20762,3423,37892,4562,2258,2304
55375,42912,5018,20763,3423,37894,4563,2259,2304
55380,42920,5020,20767,3424,37899,4564,2259,2305
55385,42923,5021,20768,3425,37902,4564,2259,2305
55390,42928,5022,20771,3426,37906,4564,2259,2305
55395,42932,5022,20774,3426,37910,4564,2259,2305
55400,42935,5022,20774,3426,37913,4564,2259,2305
55405,42936,5023,20775,3427,37913,4564,2259,2305
55410,42941,5024,20777,3427,37917,4565,2260,2305
55415,42943,5024,20778,3427,37919,4566,2260,2306
55420,42951,5025,20782,3428,37926,4566,2260,2306
55425,42954,5025,20784,3428,37929,4566,2260,2306
55430,42959,5026,20787,3429,37933,4566,2260,2306
55435,42963,5026,20790,3429,37936,4566,2260,2306
55440,42966,5027,20791,3430,37939,4566,2260,2306
55445,42967,5027,20791,3430,37940,4566,2260,2306
55450,42972,5028,20792,3430,37944,4566,2260,2306
55455,42974,5028,20792,3430,37946,4567,2260,2307
55460,42982,5030,20794,3431,37952,4567,2260,2307
55465,42985,5030,20794,3431,37955,4567,2260,2307
55470,42990,5031,20794,3431,37959,4567,2260,2307
55475,42994,5031,20796,3431,37963,4567,2260,2307
55480,42997,5032,20797,3432,37965,4567,2260,2307
55485,42998,5033,20798,3433,37965,4567,2260,2307
55490,43003,5034,20800,3434,37969,4567,2260,2307
55495,43005,5034,20800,3434,37971,4568,2260,2308
55500,43013,5036,20805,3435,37977,4569,2261,2308
55505,43016,5036,20807,3435,37980,4569,2261,2308
55510,43021,5037,20809,3436,37984,4569,2261,2308
55515,43025,5037,20812,3436,37988,4569,2261,2308
55520,43028,5038,20814,3437,37990,4569,2261,2308
55525,43029,5039,20815,3438,37990,4569,2261,2308
55530,43034,5040,20817,3438,37994,4569,2261,2308
55535,43036,5040,20817,3438,37996,4570,2261,2309
55540,43044,5042,20823,3440,38002,4571,2261,2310
55545,43047,5042,20824,3440,38005,4571,2261,2310
55550,43052,5043,20825,3440,38009,4571,2261,2310
55555,43056,5043,20827,3440,38013,4571,2261,2310
55560,43059,5043,20827,3440,38016,4571,2261,2310
55565,43060,5043,20827,3440,38017,4571,2261,2310
55570,43065,5044,20830,3441,38021,4571,2261,2310
55575,43067,5044,20831,3441,38023,4572,2262,2310
55580,43075,5045,20833,3441,38030,4573,2262,2311
55585,43078,5045,20835,3441,38033,4573,2262,2311
55590,43083,5045,20838,3441,38038,4573,2262,2311
55595,43087,5045,20839,3441,38042,4573,2262,2311
55600,43090,5045,20842,3441,38045,4573,2262,2311
55605,43091,5046,20843,3442,38045,4573,2262,2311
55610,43096,5047,20845,3443,38049,4574,2263,2311
55615,43098,5047,20845,3443,38051,4575,2263,2312
55620,43106,5048,20848,3443,38057,4576,2264,2312
55625,43109,5049,20851,3444,38060,4576,2264,2312
55630,43114,5049,20853,3444,38065,4576,2264,2312
55635,43118,5049,20853,3444,38069,4576,2264,2312
55640,43121,5049,20853,3444,38072,4576,2264,2312
55645,43122,5049,20853,3444,38073,4576,2264,2312
55650,43127,5050,20854,3444,38077,4576,2264,2312
55655,43129,5050,20855,3444,38079,4577,2264,2313
55660,43137,5051,20858,3445,38086,4578,2264,2314
55665,43140,5051,20859,3445,38089,4578,2264,2314
55670,43145,5051,20861,3445,38094,4578,2264,2314
55675,43149,5051,20863,3445,38097,4578,2264,2314
55680,43152,5052,20864,3446,38100,4578,2264,2314
55685,43153,5052,20864,3446,38101,4578,2264,2314
55690,43158,5053,20868,3447,38105,4578,2264,2314
55695,43160,5053,20868,3447,38107,4579,2264,2315
55700,43168,5054,20869,3447,38114,4580,2264,2316
55705,43171,5054,20871,3447,38117,4580,2264,2316
55710,43176,5055,20874,3448,38121,4580,2264,2316
55715,43180,5055,20877,3448,38125,4580,2264,2316
55720,43183,5056,20879,3449,38127,4580,2264,2316
55725,43184,5056,20879,3449,38128,4580,2264,2316
55730,43189,5057,20882,3450,38132,4581,2265,2316
55735,43191,5057,20883,3450,38134,4582,2265,2317
55740,43199,5058,20887,3451,38141,4583,2266,2317
55745,43202,5058,20889,3451,38144,4583,2266,2317
55750,43207,5059,20891,3452,38148,4583,2266,2317
55755,43211,5059,20893,3452,38152,4583,2266,2317
55760,43214,5059,20894,3452,38155,4583,2266,2317
55765,43215,5060,20895,3453,38155,4583,2266,2317
55770,43220,5061,20899,3454,38159,4583,2266,2317
55775,43222,5061,20899,3454,38161,4584,2266,2318
55780,43230,5062,20900,3454,38167,4584,2266,2318
55785,43233,5063,20900,3455,38170,4584,2266,2318
55790,43238,5064,20902,3455,38174,4584,2266,2318
55795,43242,5064,20903,3455,38178,4584,2266,2318
55800,43245,5064,20904,3455,38181,4584,2266,2318
55805,43246,5064,20904,3455,38182,4584,2266,2318
55810,43251,5064,20905,3455,38187,4585,2267,2318
55815,43253,5064,20905,3455,38189,4586,2267,2319
55820,43261,5066,20911,3457,38195,4586,2267,2319
55825,43264,5066,20913,3457,38198,4586,2267,2319
55830,43269,5066,20914,3457,38203,4586,2267,2319
55835,43273,5066,20918,3457,38207,4586,2267,2319
55840,43276,5066,20920,3457,38210,4586,2267,2319
55845,43277,5066,20920,3457,38211,4586,2267,2319
55850,43282,5066,20924,3457,38216,4586,2267,2319
55855,43284,5066,20925,3457,38218,4587,2267,2320
55860,43292,5067,20928,3458,38225,4588,2268,2320
55865,43295,5067,20930,3458,38228,4588,2268,2320
55870,43300,5067,20934,3458,38233,4588,2268,2320
55875,43304,5067,20937,3458,38237,4588,2268,2320
55880,43307,5067,20938,3458,38240,4588,2268,2320
55885,43308,5067,20938,3458,38241,4588,2268,2320
55890,43313,5067,20939,3458,38246,4588,2268,2320
55895,43315,5067,20941,3458,38248,4589,2269,2320
55900,43323,5069,20945,3459,38254,4590,2270,2320
55905,43326,5069,20946,3459,38257,4590,2270,2320
55910,43331,5070,20948,3459,38261,4590,2270,2320
55915,43335,5070,20949,3459,38264,4590,2270,2320
55920,43338,5072,20952,3461,38266,4590,2270,2320
55925,43339,5073,20953,3462,38266,4590,2270,2320
55930,43344,5074,20955,3462,38270,4590,2270,2320
55935,43346,5074,20956,3462,38272,4591,2270,2321
55940,43354,5076,20960,3463,38278,4592,2271,2321
55945,43357,5076,20961,3463,38281,4592,2271,2321
55950,43362,5077,20963,3463,38285,4592,2271,2321
55955,43366,5077,20964,3463,38289,4592,2271,2321
55960,43369,5077,20964,3463,38292,4592,2271,2321
55965,43370,5077,20964,3463,38293,4592,2271,2321
55970,43375,5078,20966,3464,38297,4593,2272,2321
55975,43377,5078,20967,3464,38299,4594,2273,2321
55980,43385,5080,20972,3466,38304,4595,2274,2321
55985,43388,5081,20972,3467,38307,4595,2274,2321
55990,43393,5082,20973,3467,38311,4595,2274,2321
55995,43397,5082,20974,3467,38315,4595,2274,2321
56000,43400,5082,20975,3467,38318,4595,2274,2321
56005,43401,5082,20975,3467,38319,4595,2274,2321
56010,43406,5083,20976,3467,38323,4596,2274,2322
56015,43408,5083,20977,3467,38325,4597,2274,2323
56020,43416,5085,20982,3468,38331,4598,2275,2323
56025,43419,5085,20983,3468,38334,4598,2275,2323
56030,43424,5086,20986,3468,38338,4598,2275,2323
56035,43428,5086,20988,3468,38341,4598,2275,2323
56040,43431,5087,20990,3469,38344,4598,2275,2323
56045,43432,5088,20991,3470,38344,4598,2275,2323
56050,43437,5089,20995,3471,38348,4598,2275,2323
56055,43439,5089,20995,3471,38350,4599,2275,2324
56060,43447,5090,21000,3471,38357,4600,2276,2324
56065,43450,5090,21001,3471,38360,4600,2276,2324
56070,43455,5090,21005,3471,38365,4600,2276,2324
56075,43459,5090,21006,3471,38369,4600,2276,2324
56080,43462,5090,21007,3471,38372,4600,2276,2324
56085,43463,5091,21008,3472,38372,4600,2276,2324
56090,43468,5092,21010,3473,38376,4600,2276,2324
56095,43470,5092,21012,3473,38378,4601,2277,2324
56100,43478,5093,21014,3474,38385,4602,2278,2324
56105,43481,5093,21015,3474,38388,4602,2278,2324
56110,43486,5093,21016,3474,38393,4602,2278,2324
56115,43490,5093,21017,3474,38397,4602,2278,2324
56120,43493,5093,21019,3474,38400,4602,2278,2324
56125,43494,5093,21019,3474,38401,4602,2278,2324
56130,43499,5094,21021,3474,38405,4602,2278,2324
56135,43501,5094,21022,3474,38407,4603,2278,2325
56140,43509,5096,21028,3476,38412,4604,2279,2325
56145,43512,5097,21030,3477,38415,4604,2279,2325
56150,43517,5098,21033,3478,38419,4604,2279,2325
56155,43521,5098,21035,3478,38422,4604,2279,2325
56160,43524,5100,21038,3480,38424,4604,2279,2325
56165,43525,5100,21039,3480,38425,4604,2279,2325
56170,43530,5100,21041,3480,38430,4604,2279,2325
56175,43532,5100,21041,3480,38432,4605,2279,2326
56180,43540,5101,21045,3481,38439,4606,2279,2327
56185,43543,5101,21046,3481,38442,4606,2279,2327
56190,43548,5102,21048,3481,38446,4606,2279,2327
56195,43552,5102,21050,3481,38450,4606,2279,2327
56200,43555,5103,21051,3482,38452,4606,2279,2327
56205,43556,5103,21051,3482,38453,4606,2279,2327
56210,43561,5103,21055,3482,38458,4606,2279,2327
56215,43563,5103,21057,3482,38460,4607,2280,2327
56220,43571,5105,21062,3484,38466,4608,2281,2327
56225,43574,5105,21064,3484,38469,4608,2281,2327
56230,43579,5106,21066,3484,38473,4608,2281,2327
56235,43583,5106,21068,3484,38477,4608,2281,2327
56240,43586,5107,21071,3485,38479,4608,2281,2327
56245,43587,5107,21071,3485,38480,4608,2281,2327
56250,43592,5107,21072,3485,38485,4608,2281,2327
56255,43594,5107,21073,3485,38487,4609,2282,2327
56260,43602,5108,21074,3485,38494,4610,2282,2328
56265,43605,5108,21077,3485,38497,4610,2282,2328
56270,43610,5109,21079,3485,38501,4610,2282,2328
56275,43614,5109,21081,3485,38504,4610,2282,2328
56280,43617,5110,21083,3486,38507,4610,2282,2328
56285,43618,5111,21084,3487,38507,4610,2282,2328
56290,43623,5112,21086,3488,38511,4611,2283,2328
56295,43625,5112,21088,3488,38513,4612,2284,2328
56300,43633,5113,21094,3489,38519,4613,2285,2328
56305,43636,5114,21096,3490,38522,4613,2285,2328
56310,43641,5114,21100,3490,38527,4613,2285,2328
56315,43645,5114,21101,3490,38531,4613,2285,2328
56320,43648,5114,21102,3490,38534,4613,2285,2328
56325,43649,5115,21103,3491,38534,4613,2285,2328
56330,43654,5116,21107,3492,38538,4613,2285,2328
56335,43656,5116,21108,3492,38540,4614,2286,2328
56340,43664,5117,21113,3493,38546,4615,2287,2328
56345,43667,5118,21115,3494,38549,4615,2287,2328
56350,43672,5118,21116,3494,38554,4615,2287,2328
56355,43676,5118,21117,3494,38558,4615,2287,2328
56360,43679,5118,21119,3494,38561,4615,2287,2328
56365,43680,5118,21119,3494,38562,4615,2287,2328
56370,43685,5119,21122,3494,38566,4616,2288,2328
56375,43687,5119,21123,3494,38568,4617,2288,2329
56380,43695,5120,21129,3495,38575,4618,2289,2329
56385,43698,5120,21130,3495,38578,4618,2289,2329
56390,43703,5121,21132,3496,38582,4618,2289,2329
56395,43707,5121,21134,3496,38585,4618,2289,2329
56400,43710,5122,21135,3497,38588,4618,2289,2329
56405,43711,5122,21135,3497,38589,4618,2289,2329
56410,43716,5123,21136,3497,38593,4619,2290,2329
56415,43718,5123,21136,3497,38595,4620,2290,2330
56420,43726,5124,21140,3497,38602,4620,2290,2330
56425,43729,5124,21141,3497,38605,4620,2290,2330
56430,43734,5125,21143,3498,38609,4620,2290,2330
56435,43738,5125,21144,3498,38613,4620,2290,2330
56440,43741,5126,21146,3499,38615,4620,2290,2330
56445,43742,5126,21147,3499,38616,4620,2290,2330
56450,43747,5127,21149,3500,38620,4621,2290,2331
56455,43749,5127,21150,3500,38622,4622,2291,2331
56460,43757,5129,21154,3502,38628,4622,2291,2331
56465,43760,5129,21156,3502,38631,4622,2291,2331
56470,43765,5130,21161,3503,38635,4622,2291,2331
56475,43769,5130,21161,3503,38639,4622,2291,2331
56480,43772,5130,21162,3503,38642,4622,2291,2331
56485,43773,5131,21163,3504,38642,4622,2291,2331
56490,43778,5132,21165,3504,38646,4622,2291,2331
56495,43780,5132,21165,3504,38648,4623,2291,2332
56500,43788,5134,21169,3506,38653,4623,2291,2332
56505,43791,5135,21171,3507,38656,4623,2291,2332
56510,43796,5136,21174,3507,38660,4623,2291,2332
56515,43800,5136,21178,3507,38663,4623,2291,2332
56520,43803,5137,21178,3508,38666,4623,2291,2332
56525,43804,5138,21179,3509,38666,4623,2291,2332
56530,43809,5139,21182,3509,38670,4623,2291,2332
56535,43811,5139,21183,3509,38672,4624,2292,2332
56540,43819,5141,21188,3510,38678,4625,2292,2333
56545,43822,5141,21190,3510,38681,4625,2292,2333
56550,43827,5141,21192,3510,38686,4625,2292,2333
56555,43831,5141,21194,3510,38690,4625,2292,2333
56560,43834,5141,21196,3510,38693,4625,2292,2333
56565,43835,5142,21197,3511,38693,4625,2292,2333
56570,43840,5143,21197,3511,38697,4625,2292,2333
56575,43842,5143,21199,3511,38699,4626,2293,2333
56580,43850,5145,21203,3512,38705,4627,2294,2333
56585,43853,5145,21205,3512,38708,4627,2294,2333
56590,43858,5145,21207,3512,38713,4627,2294,2333
56595,43862,5145,21208,3512,38717,4627,2294,2333
56600,43865,5145,21208,3512,38720,4627,2294,2333
56605,43866,5145,21208,3512,38721,4627,2294,2333
56610,43871,5146,21209,3513,38725,4628,2294,2334
56615,43873,5146,21210,3513,38727,4629,2294,2335
56620,43881,5148,21216,3515,38733,4630,2294,2336
56625,43884,5148,21217,3515,38736,4630,2294,2336
56630,43889,5149,21219,3516,38740,4630,2294,2336
56635,43893,5149,21222,3516,38743,4630,2294,2336
56640,43896,5151,21223,3518,38745,4630,2294,2336
56645,43897,5151,21223,3518,38746,4630,2294,2336
56650,43902,5152,21225,3519,38750,4631,2294,2337
56655,43904,5152,21225,3519,38752,4632,2294,2338
56660,43912,5153,21227,3519,38758,4633,2295,2338
56665,43915,5154,21227,3520,38761,4633,2295,2338
56670,43920,5155,21229,3520,38765,4633,2295,2338
56675,43924,5155,21230,3520,38769,4633,2295,2338
56680,43927,5155,21231,3520,38772,4633,2295,2338
56685,43928,5155,21231,3520,38773,4633,2295,2338
56690,43933,5156,21233,3520,38777,4634,2295,2339
56695,43935,5156,21234,3520,38779,4635,2295,2340
56700,43943,5157,21235,3520,38786,4636,2295,2341
56705,43946,5157,21236,3520,38789,4636,2295,2341
56710,43951,5158,21238,3520,38793,4636,2295,2341
56715,43955,5158,21240,3520,38797,4636,2295,2341
56720,43958,5159,21242,3521,38799,4636,2295,2341
56725,43959,5159,21242,3521,38800,4636,2295,2341
56730,43964,5160,21245,3521,38804,4636,2295,2341
56735,43966,5160,21245,3521,38806,4637,2295,2342
56740,43974,5161,21249,3521,38813,4638,2295,2343
56745,43977,5161,21250,3521,38816,4638,2295,2343
56750,43982,5162,21252,3521,38820,4638,2295,2343
56755,43986,5162,21256,3521,38823,4638,2295,2343
56760,43989,5163,21257,3522,38826,4638,2295,2343
56765,43990,5164,21258,3523,38826,4638,2295,2343
56770,43995,5165,21261,3523,38830,4638,2295,2343
56775,43997,5165,21262,3523,38832,4639,2295,2344
56780,44005,5167,21266,3524,38838,4640,2295,2345
56785,44008,5167,21266,3524,38841,4640,2295,2345
56790,44013,5167,21268,3524,38846,4640,2295,2345
56795,44017,5167,21270,3524,38850,4640,2295,2345
56800,44020,5167,21272,3524,38853,4640,2295,2345
56805,44021,5167,21272,3524,38854,4640,2295,2345
56810,44026,5168,21275,3525,38858,4640,2295,2345
56815,44028,5168,21276,3525,38860,4641,2296,2345
56820,44036,5170,21280,3527,38866,4642,2297,2345
56825,44039,5170,21281,3527,38869,4642,2297,2345
56830,44044,5170,21285,3527,38874,4642,2297,2345
56835,44048,5170,21286,3527,38878,4642,2297,2345
56840,44051,5170,21288,3527,38881,4642,2297,2345
56845,44052,5170,21289,3527,38882,4642,2297,2345
56850,44057,5171,21290,3527,38886,4643,2297,2346
56855,44059,5171,21290,3527,38888,4644,2297,2347
56860,44067,5174,21294,3529,38893,4645,2297,2348
56865,44070,5174,21296,3529,38896,4645,2297,2348
56870,44075,5174,21300,3529,38901,4645,2297,2348
56875,44079,5174,21301,3529,38905,4645,2297,2348
56880,44082,5174,21302,3529,38908,4645,2297,2348
56885,44083,5174,21303,3529,38909,4645,2297,2348
56890,44088,5175,21304,3529,38913,4646,2297,2349
56895,44090,5175,21304,3529,38915,4647,2297,2350
56900,44098,5177,21307,3531,38921,4647,2297,2350
56905,44101,5177,21310,3531,38924,4647,2297,2350
56910,44106,5178,21313,3531,38928,4647,2297,2350
56915,44110,5178,21315,3531,38932,4647,2297,2350
56920,44113,5179,21317,3532,38934,4647,2297,2350
56925,44114,5179,21317,3532,38935,4647,2297,2350
56930,44119,5180,21320,3533,38939,4647,2297,2350
56935,44121,5180,21322,3533,38941,4648,2298,2350
56940,44129,5182,21325,3534,38947,4648,2298,2350
56945,44132,5182,21326,3534,38950,4648,2298,2350
56950,44137,5183,21329,3535,38954,4648,2298,2350
56955,44141,5183,21332,3535,38958,4648,2298,2350
56960,44144,5183,21334,3535,38961,4648,2298,2350
56965,44145,5184,21335,3536,38961,4648,2298,2350
56970,44150,5185,21337,3537,38965,4649,2299,2350
56975,44152,5185,21339,3537,38967,4650,2300,2350
56980,44160,5186,21343,3537,38974,4650,2300,2350
56985,44163,5186,21346,3537,38977,4650,2300,2350
56990,44168,5187,21350,3537,38981,4650,2300,2350
56995,44172,5187,21352,3537,38985,4650,2300,2350
57000,44175,5187,21354,3537,38988,4650,2300,2350
57005,44176,5188,21355,3538,38988,4650,2300,2350
57010,44181,5189,21356,3538,38992,4651,2300,2351
57015,44183,5189,21357,3538,38994,4652,2301,2351
57020,44191,5190,21362,3539,39000,4653,2302,2351
57025,44194,5191,21364,3540,39003,4653,2302,2351
57030,44199,5191,21367,3540,39008,4653,2302,2351
57035,44203,5191,21369,3540,39012,4653,2302,2351
57040,44206,5191,21371,3540,39015,4653,2302,2351
57045,44207,5191,21371,3540,39016,4653,2302,2351
57050,44212,5192,21375,3541,39020,4653,2302,2351
57055,44214,5192,21375,3541,39022,4654,2302,2352
57060,44222,5194,21379,3543,39027,4655,2302,2353
57065,44225,5195,21380,3544,39030,4655,2302,2353
57070,44230,5195,21382,3544,39035,4655,2302,2353
57075,44234,5195,21383,3544,39039,4655,2302,2353
57080,44237,5195,21383,3544,39042,4655,2302,2353
57085,44238,5196,21384,3545,39042,4655,2302,2353
57090,44243,5197,21386,3546,39046,4655,2302,2353
57095,44245,5197,21386,3546,39048,4656,2302,2354
57100,44253,5199,21390,3547,39054,4657,2303,2354
57105,44256,5199,21393,3547,39057,4657,2303,2354
57110,44261,5200,21397,3547,39061,4657,2303,2354
57115,44265,5200,21399,3547,39065,4657,2303,2354
57120,44268,5200,21400,3547,39068,4657,2303,2354
57125,44269,5200,21401,3547,39069,4657,2303,2354
57130,44274,5200,21402,3547,39074,4657,2303,2354
57135,44276,5200,21404,3547,39076,4658,2304,2354
57140,44284,5202,21409,3549,39082,4659,2304,2355
57145,44287,5202,21412,3549,39085,4659,2304,2355
57150,44292,5203,21414,3549,39089,4659,2304,2355
57155,44296,5203,21414,3549,39093,4659,2304,2355
57160,44299,5203,21415,3549,39096,4659,2304,2355
57165,44300,5203,21416,3549,39097,4659,2304,2355
57170,44305,5203,21418,3549,39102,4659,2304,2355
57175,44307,5203,21419,3549,39104,4660,2305,2355
57180,44315,5205,21421,3550,39109,4661,2305,2356
57185,44318,5206,21423,3551,39112,4661,2305,2356
57190,44323,5207,21426,3552,39116,4661,2305,2356
57195,44327,5207,21427,3552,39120,4661,2305,2356
57200,44330,5208,21430,3553,39122,4661,2305,2356
57205,44331,5208,21430,3553,39123,4661,2305,2356
57210,44336,5209,21431,3553,39127,4661,2305,2356
57215,44338,5209,21432,3553,39129,4662,2306,2356
57220,44346,5211,21436,3554,39135,4663,2306,2357
57225,44349,5211,21438,3554,39138,4663,2306,2357
57230,44354,5212,21442,3555,39142,4663,2306,2357
57235,44358,5212,21444,3555,39146,4663,2306,2357
57240,44361,5212,21444,3555,39149,4663,2306,2357
57245,44362,5212,21444,3555,39150,4663,2306,2357
57250,44367,5212,21449,3555,39155,4664,2307,2357
57255,44369,5212,21450,3555,39157,4665,2308,2357
57260,44377,5214,21455,3556,39162,4666,2308,2358
57265,44380,5215,21457,3557,39165,4666,2308,2358
57270,44385,5216,21461,3557,39169,4666,2308,2358
57275,44389,5216,21464,3557,39173,4666,2308,2358
57280,44392,5216,21466,3557,39176,4666,2308,2358
57285,44393,5216,21467,3557,39177,4666,2308,2358
57290,44398,5216,21471,3557,39182,4667,2309,2358
57295,44400,5216,21472,3557,39184,4668,2310,2358
57300,44408,5217,21477,3558,39190,4669,2311,2358
57305,44411,5218,21478,3559,39193,4669,2311,2358
57310,44416,5219,21481,3560,39197,4669,2311,2358
57315,44420,5219,21483,3560,39201,4669,2311,2358
57320,44423,5219,21485,3560,39204,4669,2311,2358
57325,44424,5219,21486,3560,39205,4669,2311,2358
57330,44429,5219,21487,3560,39210,4670,2311,2359
57335,44431,5219,21487,3560,39212,4671,2311,2360
57340,44439,5221,21490,3561,39218,4672,2311,2361
57345,44442,5221,21493,3561,39221,4672,2311,2361
57350,44447,5222,21496,3562,39225,4672,2311,2361
57355,44451,5222,21498,3562,39228,4672,2311,2361
57360,44454,5224,21501,3564,39230,4672,2311,2361
57365,44455,5224,21501,3564,39231,4672,2311,2361
57370,44460,5225,21504,3565,39235,4672,2311,2361
57375,44462,5225,21504,3565,39237,4673,2311,2362
57380,44470,5227,21508,3567,39242,4674,2311,2363
57385,44473,5228,21509,3568,39245,4674,2311,2363
57390,44478,5228,21512,3568,39250,4674,2311,2363
57395,44482,5228,21513,3568,39254,4674,2311,2363
57400,44485,5228,21515,3568,39257,4674,2311,2363
57405,44486,5229,21516,3569,39257,4674,2311,2363
57410,44491,5230,21518,3569,39261,4674,2311,2363
57415,44493,5230,21519,3569,39263,4675,2311,2364
57420,44501,5231,21521,3569,39269,4676,2311,2365
57425,44504,5232,21523,3570,39272,4676,2311,2365
57430,44509,5232,21527,3570,39277,4676,2311,2365
57435,44513,5232,21529,3570,39281,4676,2311,2365
57440,44516,5232,21530,3570,39284,4676,2311,2365
57445,44517,5232,21530,3570,39285,4676,2311,2365
57450,44522,5233,21534,3571,39289,4676,2311,2365
57455,44524,5233,21535,3571,39291,4677,2311,2366
57460,44532,5234,21540,3572,39298,4678,2312,2366
57465,44535,5234,21541,3572,39301,4678,2312,2366
57470,44540,5235,21543,3572,39305,4678,2312,2366
57475,44544,5235,21543,3572,39309,4678,2312,2366
57480,44547,5236,21545,3573,39311,4678,2312,2366
57485,44548,5237,21546,3574,39311,4678,2312,2366
57490,44553,5238,21548,3574,39315,4679,2313,2366
57495,44555,5238,21549,3574,39317,4680,2314,2366
57500,44563,5239,21552,3575,39324,4680,2314,2366
57505,44566,5239,21553,3575,39327,4680,2314,2366
57510,44571,5240,21553,3575,39331,4680,2314,2366
57515,44575,5240,21557,3575,39335,4680,2314,2366
57520,44578,5240,21558,3575,39338,4680,2314,2366
57525,44579,5241,21559,3576,39338,4680,2314,2366
57530,44584,5242,21560,3576,39342,4681,2315,2366
57535,44586,5242,21561,3576,39344,4682,2315,2367
57540,44594,5243,21565,3577,39350,4682,2315,2367
57545,44597,5244,21568,3578,39353,4682,2315,2367
57550,44602,5245,21571,3579,39357,4682,2315,2367
57555,44606,5245,21574,3579,39361,4682,2315,2367
57560,44609,5245,21575,3579,39364,4682,2315,2367
57565,44610,5246,21576,3580,39364,4682,2315,2367
57570,44615,5247,21577,3581,39368,4682,2315,2367
57575,44617,5247,21577,3581,39370,4683,2315,2368
57580,44625,5248,21577,3581,39377,4683,2315,2368
57585,44628,5248,21580,3581,39380,4683,2315,2368
57590,44633,5249,21584,3582,39384,4683,2315,2368
57595,44637,5249,21587,3582,39387,4683,2315,2368
57600,44640,5250,21588,3583,39390,4683,2315,2368
57605,44641,5250,21588,3583,39391,4683,2315,2368
57610,44646,5250,21590,3583,39396,4683,2315,2368
57615,44648,5250,21591,3583,39398,4684,2316,2368
57620,44656,5251,21593,3583,39405,4685,2317,2368
57625,44659,5251,21594,3583,39408,4685,2317,2368
57630,44664,5251,21597,3583,39413,4685,2317,2368
57635,44668,5251,21599,3583,39417,4685,2317,2368
57640,44671,5251,21600,3583,39420,4685,2317,2368
57645,44672,5251,21600,3583,39421,4685,2317,2368
57650,44677,5251,21603,3583,39426,4685,2317,2368
57655,44679,5251,21604,3583,39428,4686,2317,2369
57660,44687,5253,21605,3584,39434,4687,2317,2370
57665,44690,5253,21607,3584,39437,4687,2317,2370
57670,44695,5253,21610,3584,39442,4687,2317,2370
57675,44699,5253,21611,3584,39446,4687,2317,2370
57680,44702,5253,21613,3584,39449,4687,2317,2370
57685,44703,5253,21613,3584,39450,4687,2317,2370
57690,44708,5253,21615,3584,39455,4687,2317,2370
57695,44710,5253,21617,3584,39457,4688,2318,2370
57700,44718,5255,21620,3585,39463,4689,2319,2370
57705,44721,5255,21621,3585,39466,4689,2319,2370
57710,44726,5256,21623,3586,39470,4689,2319,2370
57715,44730,5256,21625,3586,39474,4689,2319,2370
57720,44733,5256,21626,3586,39477,4689,2319,2370
57725,44734,5256,21626,3586,39478,4689,2319,2370
57730,44739,5257,21629,3587,39482,4690,2319,2371
57735,44741,5257,21629,3587,39484,4691,2319,2372
57740,44749,5259,21632,3588,39490,4692,2320,2372
57745,44752,5259,21633,3588,39493,4692,2320,2372
57750,44757,5260,21634,3588,39497,4692,2320,2372
57755,44761,5260,21635,3588,39501,4692,2320,2372
57760,44764,5260,21636,3588,39504,4692,2320,2372
57765,44765,5260,21637,3588,39505,4692,2320,2372
57770,44770,5261,21640,3588,39509,4693,2321,2372
57775,44772,5261,21641,3588,39511,4694,2321,2373
57780,44780,5263,21644,3589,39517,4695,2321,2374
57785,44783,5263,21645,3589,39520,4695,2321,2374
57790,44788,5264,21647,3589,39524,4695,2321,2374
57795,44792,5264,21649,3589,39528,4695,2321,2374
57800,44795,5264,21649,3589,39531,4695,2321,2374
57805,44796,5264,21649,3589,39532,4695,2321,2374
57810,44801,5265,21650,3589,39536,4695,2321,2374
57815,44803,5265,21651,3589,39538,4696,2322,2374
57820,44811,5267,21656,3590,39544,4697,2322,2375
57825,44814,5267,21657,3590,39547,4697,2322,2375
57830,44819,5268,21658,3590,39551,4697,2322,2375
57835,44823,5268,21661,3590,39554,4697,2322,2375
57840,44826,5269,21662,3591,39557,4697,2322,2375
57845,44827,5269,21662,3591,39558,4697,2322,2375
57850,44832,5270,21664,3592,39562,4698,2323,2375
57855,44834,5270,21665,3592,39564,4699,2323,2376
57860,44842,5271,21669,3593,39571,4700,2324,2376
57865,44845,5271,21671,3593,39574,4700,2324,2376
57870,44850,5271,21673,3593,39579,4700,2324,2376
57875,44854,5271,21673,3593,39583,4700,2324,2376
57880,44857,5271,21674,3593,39586,4700,2324,2376
57885,44858,5271,21674,3593,39587,4700,2324,2376
57890,44863,5272,21674,3593,39591,4701,2324,2377
57895,44865,5272,21675,3593,39593,4702,2324,2378
57900,44873,5275,21680,3595,39597,4703,2325,2378
57905,44876,5276,21682,3596,39600,4703,2325,2378
57910,44881,5276,21685,3596,39605,4703,2325,2378
57915,44885,5276,21688,3596,39609,4703,2325,2378
57920,44888,5276,21690,3596,39612,4703,2325,2378
57925,44889,5277,21691,3597,39612,4703,2325,2378
57930,44894,5278,21692,3597,39616,4703,2325,2378
57935,44896,5278,21692,3597,39618,4704,2325,2379
57940,44904,5279,21696,3598,39625,4704,2325,2379
57945,44907,5279,21697,3598,39628,4704,2325,2379
57950,44912,5280,21699,3599,39632,4704,2325,2379
57955,44916,5280,21700,3599,39636,4704,2325,2379
57960,44919,5280,21702,3599,39639,4704,2325,2379
57965,44920,5281,21703,3600,39639,4704,2325,2379
57970,44925,5282,21706,3600,39643,4704,2325,2379
57975,44927,5282,21707,3600,39645,4705,2326,2379
57980,44935,5284,21711,3601,39651,4705,2326,2379
57985,44938,5284,21714,3601,39654,4705,2326,2379
57990,44943,5285,21717,3602,39658,4705,2326,2379
57995,44947,5285,21720,3602,39662,4705,2326,2379
58000,44950,5286,21722,3603,39664,4705,2326,2379
58005,44951,5286,21723,3603,39665,4705,2326,2379
58010,44956,5287,21726,3604,39669,4705,2326,2379
58015,44958,5287,21728,3604,39671,4706,2327,2379
58020,44966,5289,21730,3605,39677,4707,2328,2379
58025,44969,5289,21732,3605,39680,4707,2328,2379
58030,44974,5290,21735,3605,39684,4707,2328,2379
58035,44978,5290,21738,3605,39688,4707,2328,2379
58040,44981,5291,21740,3606,39690,4707,2328,2379
58045,44982,5291,21740,3606,39691,4707,2328,2379
58050,44987,5292,21742,3607,39695,4708,2328,2380
58055,44989,5292,21744,3607,39697,4709,2329,2380
58060,44997,5294,21750,3609,39703,4710,2329,2381
58065,45000,5294,21751,3609,39706,4710,2329,2381
58070,45005,5295,21755,3610,39710,4710,2329,2381
58075,45009,5295,21758,3610,39713,4710,2329,2381
58080,45012,5297,21759,3612,39715,4710,2329,2381
58085,45013,5297,21760,3612,39716,4710,2329,2381
58090,45018,5297,21763,3612,39721,4710,2329,2381
58095,45020,5297,21763,3612,39723,4711,2329,2382
58100,45028,5299,21766,3614,39729,4712,2330,2382
58105,45031,5299,21767,3614,39732,4712,2330,2382
58110,45036,5300,21768,3615,39736,4712,2330,2382
58115,45040,5300,21770,3615,39740,4712,2330,2382
58120,45043,5300,21771,3615,39743,4712,2330,2382
58125,45044,5300,21772,3615,39744,4712,2330,2382
58130,45049,5300,21774,3615,39749,4712,2330,2382
58135,45051,5300,21774,3615,39751,4713,2330,2383
58140,45059,5301,21777,3616,39758,4714,2330,2384
58145,45062,5301,21778,3616,39761,4714,2330,2384
58150,45067,5302,21778,3616,39765,4714,2330,2384
58155,45071,5302,21780,3616,39769,4714,2330,2384
58160,45074,5302,21781,3616,39772,4714,2330,2384
58165,45075,5302,21782,3616,39773,4714,2330,2384
58170,45080,5302,21784,3616,39778,4715,2330,2385
58175,45082,5302,21786,3616,39780,4716,2331,2385
58180,45090,5303,21789,3616,39787,4717,2332,2385
58185,45093,5303,21790,3616,39790,4717,2332,2385
58190,45098,5304,21792,3616,39794,4717,2332,2385
58195,45102,5304,21794,3616,39798,4717,2332,2385
58200,45105,5305,21796,3617,39800,4717,2332,2385
58205,45106,5305,21796,3617,39801,4717,2332,2385
58210,45111,5306,21800,3618,39805,4718,2333,2385
58215,45113,5306,21800,3618,39807,4719,2333,2386
58220,45121,5307,21804,3618,39814,4720,2333,2387
58225,45124,5307,21805,3618,39817,4720,2333,2387
58230,45129,5308,21809,3619,39821,4720,2333,2387
58235,45133,5308,21811,3619,39825,4720,2333,2387
58240,45136,5308,21812,3619,39828,4720,2333,2387
58245,45137,5308,21812,3619,39829,4720,2333,2387
58250,45142,5309,21812,3619,39833,4720,2333,2387
58255,45144,5309,21812,3619,39835,4721,2333,2388
58260,45152,5311,21817,3621,39841,4722,2333,2389
58265,45155,5311,21817,3621,39844,4722,2333,2389
58270,45160,5312,21819,3622,39848,4722,2333,2389
58275,45164,5312,21821,3622,39852,4722,2333,2389
58280,45167,5313,21823,3623,39854,4722,2333,2389
58285,45168,5313,21823,3623,39855,4722,2333,2389
58290,45173,5314,21826,3623,39859,4722,2333,2389
58295,45175,5314,21827,3623,39861,4723,2334,2389
58300,45183,5316,21832,3625,39867,4724,2335,2389
58305,45186,5316,21834,3625,39870,4724,2335,2389
58310,45191,5317,21836,3625,39874,4724,2335,2389
58315,45195,5317,21836,3625,39878,4724,2335,2389
58320,45198,5318,21837,3626,39880,4724,2335,2389
58325,45199,5319,21838,3627,39880,4724,2335,2389
58330,45204,5320,21839,3628,39884,4724,2335,2389
58335,45206,5320,21841,3628,39886,4725,2336,2389
58340,45214,5322,21846,3629,39891,4726,2337,2389
58345,45217,5323,21848,3630,39894,4726,2337,2389
58350,45222,5323,21851,3630,39899,4726,2337,2389
58355,45226,5323,21854,3630,39903,4726,2337,2389
58360,45229,5323,21855,3630,39906,4726,2337,2389
58365,45230,5324,21856,3631,39906,4726,2337,2389
58370,45235,5325,21858,3631,39910,4726,2337,2389
58375,45237,5325,21860,3631,39912,4727,2338,2389
58380,45245,5327,21864,3632,39918,4728,2339,2389
58385,45248,5327,21865,3632,39921,4728,2339,2389
58390,45253,5327,21867,3632,39926,4728,2339,2389
58395,45257,5327,21868,3632,39930,4728,2339,2389
58400,45260,5327,21868,3632,39933,4728,2339,2389
58405,45261,5328,21869,3633,39933,4728,2339,2389
58410,45266,5329,21870,3634,39937,4728,2339,2389
58415,45268,5329,21871,3634,39939,4729,2340,2389
58420,45276,5331,21877,3636,39945,4730,2340,2390
58425,45279,5331,21880,3636,39948,4730,2340,2390
58430,45284,5332,21880,3636,39952,4730,2340,2390
58435,45288,5332,21883,3636,39955,4730,2340,2390
58440,45291,5333,21883,3637,39958,4730,2340,2390
58445,45292,5334,21884,3638,39958,4730,2340,2390
58450,45297,5335,21884,3638,39962,4731,2340,2391
58455,45299,5335,21885,3638,39964,4732,2341,2391
58460,45307,5336,21889,3639,39971,4733,2342,2391
58465,45310,5336,21889,3639,39974,4733,2342,2391
58470,45315,5337,21890,3639,39978,4733,2342,2391
58475,45319,5337,21893,3639,39982,4733,2342,2391
58480,45322,5337,21893,3639,39985,4733,2342,2391
58485,45323,5337,21894,3639,39986,4733,2342,2391
58490,45328,5338,21897,3639,39990,4734,2342,2392
58495,45330,5338,21897,3639,39992,4735,2342,2393
58500,45338,5340,21903,3641,39998,4736,2343,2393
58505,45341,5340,21905,3641,40001,4736,2343,2393
58510,45346,5341,21909,3642,40005,4736,2343,2393
58515,45350,5341,21913,3642,40009,4736,2343,2393
58520,45353,5341,21915,3642,40012,4736,2343,2393
58525,45354,5341,21915,3642,40013,4736,2343,2393
58530,45359,5342,21919,3643,40017,4737,2343,2394
58535,45361,5342,21920,3643,40019,4738,2344,2394
58540,45369,5344,21921,3644,40025,4739,2344,2395
58545,45372,5344,21923,3644,40028,4739,2344,2395
58550,45377,5345,21927,3645,40032,4739,2344,2395
58555,45381,5345,21929,3645,40035,4739,2344,2395
58560,45384,5346,21930,3646,40038,4739,2344,2395
58565,45385,5346,21931,3646,40039,4739,2344,2395
58570,45390,5346,21932,3646,40044,4739,2344,2395
58575,45392,5346,21934,3646,40046,4740,2345,2395
58580,45400,5347,21937,3646,40052,4741,2346,2395
58585,45403,5348,21939,3647,40055,4741,2346,2395
58590,45408,5348,21942,3647,40060,4741,2346,2395
58595,45412,5348,21944,3647,40064,4741,2346,2395
58600,45415,5348,21946,3647,40067,4741,2346,2395
58605,45416,5348,21946,3647,40068,4741,2346,2395
58610,45421,5348,21949,3647,40073,4741,2346,2395
58615,45423,5348,21950,3647,40075,4742,2347,2395
58620,45431,5349,21955,3648,40082,4743,2347,2396
58625,45434,5349,21957,3648,40085,4743,2347,2396
58630,45439,5349,21959,3648,40090,4743,2347,2396
58635,45443,5349,21960,3648,40094,4743,2347,2396
58640,45446,5349,21961,3648,40097,4743,2347,2396
58645,45447,5349,21961,3648,40098,4743,2347,2396
58650,45452,5349,21963,3648,40103,4743,2347,2396
58655,45454,5349,21964,3648,40105,4744,2347,2397
58660,45462,5351,21967,3650,40111,4745,2347,2398
58665,45465,5351,21968,3650,40114,4745,2347,2398
58670,45470,5352,21971,3650,40118,4745,2347,2398
58675,45474,5352,21972,3650,40122,4745,2347,2398
58680,45477,5352,21973,3650,40125,4745,2347,2398
58685,45478,5352,21973,3650,40126,4745,2347,2398
58690,45483,5353,21974,3650,40130,4746,2348,2398
58695,45485,5353,21976,3650,40132,4747,2349,2398
58700,45493,5355,21980,3651,40138,4748,2350,2398
58705,45496,5355,21982,3651,40141,4748,2350,2398
58710,45501,5356,21985,3651,40145,4748,2350,2398
58715,45505,5356,21987,3651,40149,4748,2350,2398
58720,45508,5357,21988,3652,40151,4748,2350,2398
58725,45509,5357,21988,3652,40152,4748,2350,2398
58730,45514,5358,21990,3652,40156,4749,2351,2398
58735,45516,5358,21992,3652,40158,4750,2352,2398
58740,45524,5360,21996,3653,40163,4751,2353,2398
58745,45527,5361,21997,3654,40166,4751,2353,2398
58750,45532,5362,21998,3655,40170,4751,2353,2398
58755,45536,5362,22000,3655,40174,4751,2353,2398
58760,45539,5362,22002,3655,40177,4751,2353,2398
58765,45540,5363,22003,3656,40177,4751,2353,2398
58770,45545,5364,22007,3657,40181,4752,2354,2398
58775,45547,5364,22007,3657,40183,4753,2354,2399
58780,45555,5365,22011,3658,40190,4754,2354,2400
58785,45558,5365,22014,3658,40193,4754,2354,2400
58790,45563,5366,22014,3658,40197,4754,2354,2400
58795,45567,5366,22018,3658,40200,4754,2354,2400
58800,45570,5368,22020,3660,40202,4754,2354,2400
58805,45571,5368,22020,3660,40203,4754,2354,2400
58810,45576,5369,22023,3661,40207,4754,2354,2400
58815,45578,5369,22024,3661,40209,4755,2354,2401
58820,45586,5371,22030,3663,40215,4756,2355,2401
58825,45589,5371,22031,3663,40218,4756,2355,2401
58830,45594,5371,22034,3663,40223,4756,2355,2401
58835,45598,5371,22037,3663,40227,4756,2355,2401
58840,45601,5371,22039,3663,40230,4756,2355,2401
58845,45602,5371,22040,3663,40231,4756,2355,2401
58850,45607,5372,22043,3664,40235,4756,2355,2401
58855,45609,5372,22043,3664,40237,4757,2355,2402
58860,45617,5374,22048,3666,40242,4758,2355,2403
58865,45620,5375,22050,3667,40245,4758,2355,2403
58870,45625,5375,22054,3667,40250,4758,2355,2403
58875,45629,5375,22056,3667,40254,4758,2355,2403
58880,45632,5375,22057,3667,40257,4758,2355,2403
58885,45633,5375,22058,3667,40258,4758,2355,2403
58890,45638,5376,22060,3667,40262,4759,2356,2403
58895,45640,5376,22061,3667,40264,4760,2356,2404
58900,45648,5377,22065,3668,40270,4760,2356,2404
58905,45651,5378,22065,3669,40273,4760,2356,2404
58910,45656,5379,22067,3670,40277,4760,2356,2404
58915,45660,5379,22069,3670,40280,4760,2356,2404
58920,45663,5380,22070,3671,40283,4760,2356,2404
58925,45664,5381,22071,3672,40283,4760,2356,2404
58930,45669,5382,22073,3673,40287,4760,2356,2404
58935,45671,5382,22074,3673,40289,4761,2356,2405
58940,45679,5383,22076,3673,40296,4761,2356,2405
58945,45682,5383,22077,3673,40299,4761,2356,2405
58950,45687,5384,22079,3673,40303,4761,2356,2405
58955,45691,5384,22081,3673,40307,4761,2356,2405
58960,45694,5384,22081,3673,40310,4761,2356,2405
58965,45695,5385,22082,3674,40310,4761,2356,2405
58970,45700,5386,22084,3675,40314,4761,2356,2405
58975,45702,5386,22085,3675,40316,4762,2356,2406
58980,45710,5388,22088,3676,40322,4763,2356,2407
58985,45713,5388,22091,3676,40325,4763,2356,2407
58990,45718,5389,22094,3677,40329,4763,2356,2407
58995,45722,5389,22096,3677,40333,4763,2356,2407
59000,45725,5389,22097,3677,40336,4763,2356,2407
59005,45726,5390,22098,3678,40336,4763,2356,2407
59010,45731,5391,22100,3678,40340,4763,2356,2407
59015,45733,5391,22100,3678,40342,4764,2356,2408
59020,45741,5393,22103,3679,40348,4765,2356,2409
59025,45744,5393,22105,3679,40351,4765,2356,2409
59030,45749,5394,22107,3679,40355,4765,2356,2409
59035,45753,5394,22108,3679,40359,4765,2356,2409
59040,45756,5394,22109,3679,40362,4765,2356,2409
59045,45757,5394,22109,3679,40363,4765,2356,2409
59050,45762,5394,22110,3679,40368,4766,2356,2410
59055,45764,5394,22111,3679,40370,4767,2357,2410
59060,45772,5396,22117,3681,40375,4768,2357,2411
59065,45775,5397,22120,3682,40378,4768,2357,2411
59070,45780,5397,22122,3682,40383,4768,2357,2411
59075,45784,5397,22124,3682,40387,4768,2357,2411
59080,45787,5397,22126,3682,40390,4768,2357,2411
59085,45788,5397,22127,3682,40391,4768,2357,2411
59090,45793,5397,22131,3682,40396,4769,2357,2412
59095,45795,5397,22132,3682,40398,4770,2357,2413
59100,45803,5398,22135,3682,40404,4771,2357,2414
59105,45806,5399,22137,3683,40407,4771,2357,2414
59110,45811,5399,22138,3683,40412,4771,2357,2414
59115,45815,5399,22141,3683,40416,4771,2357,2414
59120,45818,5399,22143,3683,40419,4771,2357,2414
59125,45819,5399,22144,3683,40420,4771,2357,2414
59130,45824,5399,22146,3683,40425,4771,2357,2414
59135,45826,5399,22146,3683,40427,4772,2357,2415
59140,45834,5400,22149,3684,40434,4773,2357,2416
59145,45837,5400,22152,3684,40437,4773,2357,2416
59150,45842,5401,22154,3684,40441,4773,2357,2416
59155,45846,5401,22158,3684,40445,4773,2357,2416
59160,45849,5401,22159,3684,40448,4773,2357,2416
59165,45850,5401,22159,3684,40449,4773,2357,2416
59170,45855,5402,22163,3685,40453,4773,2357,2416
59175,45857,5402,22164,3685,40455,4774,2358,2416
59180,45865,5405,22169,3687,40459,4775,2358,2417
59185,45868,5406,22171,3688,40462,4775,2358,2417
59190,45873,5406,22175,3688,40467,4775,2358,2417
59195,45877,5406,22178,3688,40471,4775,2358,2417
59200,45880,5406,22179,3688,40474,4775,2358,2417
59205,45881,5406,22179,3688,40475,4775,2358,2417
59210,45886,5407,22181,3689,40479,4776,2358,2418
59215,45888,5407,22182,3689,40481,4777,2359,2418
59220,45896,5409,22188,3691,40487,4778,2360,2418
59225,45899,5409,22189,3691,40490,4778,2360,2418
59230,45904,5409,22192,3691,40495,4778,2360,2418
59235,45908,5409,22195,3691,40499,4778,2360,2418
59240,45911,5409,22198,3691,40502,4778,2360,2418
59245,45912,5409,22198,3691,40503,4778,2360,2418
59250,45917,5410,22200,3691,40507,4778,2360,2418
59255,45919,5410,22201,3691,40509,4778,2360,2418
59260,45927,5412,22206,3692,40515,4779,2360,2419
59265,45930,5412,22208,3692,40518,4779,2360,2419
59270,45935,5412,22210,3692,40523,4779,2360,2419
59275,45939,5412,22211,3692,40527,4779,2360,2419
59280,45942,5412,22213,3692,40530,4779,2360,2419
59285,45943,5412,22214,3692,40531,4779,2360,2419
59290,45948,5413,22218,3693,40535,4779,2360,2419
59295,45950,5413,22219,3693,40537,4779,2360,2419
59300,45958,5415,22225,3695,40543,4779,2360,2419
59305,45961,5415,22225,3695,40546,4779,2360,2419
59310,45966,5415,22226,3695,40551,4779,2360,2419
59315,45970,5415,22228,3695,40555,4779,2360,2419
59320,45973,5415,22229,3695,40558,4779,2360,2419
59325,45974,5415,22230,3695,40559,4779,2360,2419
59330,45979,5416,22232,3695,40563,4779,2360,2419
59335,45981,5416,22233,3695,40565,4779,2360,2419
59340,45989,5417,22236,3696,40571,4779,2360,2419
59345,45992,5418,22238,3697,40574,4779,2360,2419
59350,45997,5418,22240,3697,40579,4779,2360,2419
59355,46001,5418,22244,3697,40582,4779,2360,2419
59360,46004,5419,22245,3698,40585,4779,2360,2419
59365,46005,5419,22245,3698,40586,4779,2360,2419
59370,46010,5420,22247,3698,40590,4779,2360,2419
59375,46012,5420,22248,3698,40592,4779,2360,2419
59380,46020,5421,22251,3699,40598,4779,2360,2419
59385,46023,5422,22253,3700,40601,4779,2360,2419
59390,46028,5422,22257,3700,40606,4779,2360,2419
59395,46032,5422,22259,3700,40610,4779,2360,2419
59400,46035,5422,22260,3700,40613,4779,2360,2419
59405,46036,5422,22260,3700,40614,4779,2360,2419
59410,46041,5423,22261,3700,40618,4780,2360,2420
59415,46043,5423,22262,3700,40620,4780,2360,2420
59420,46051,5424,22266,3701,40627,4781,2360,2421
59425,46054,5424,22267,3701,40630,4781,2360,2421
59430,46059,5424,22269,3701,40635,4781,2360,2421
59435,46063,5424,22270,3701,40639,4781,2360,2421
59440,46066,5424,22271,3701,40642,4781,2360,2421
59445,46067,5424,22271,3701,40643,4781,2360,2421
59450,46072,5425,22274,3702,40647,4782,2360,2422
59455,46074,5425,22274,3702,40649,4782,2360,2422
59460,46082,5426,22276,3702,40656,4783,2361,2422
59465,46085,5426,22277,3702,40659,4783,2361,2422
59470,46090,5426,22280,3702,40664,4783,2361,2422
59475,46094,5426,22282,3702,40668,4783,2361,2422
59480,46097,5426,22283,3702,40671,4783,2361,2422
59485,46098,5426,22283,3702,40672,4783,2361,2422
59490,46103,5427,22287,3703,40676,4783,2361,2422
59495,46105,5427,22288,3703,40678,4783,2361,2422
59500,46113,5429,22294,3704,40684,4784,2362,2422
59505,46116,5429,22296,3704,40687,4784,2362,2422
59510,46121,5429,22298,3704,40692,4784,2362,2422
59515,46125,5429,22299,3704,40695,4784,2362,2422
59520,46128,5430,22300,3705,40698,4784,2362,2422
59525,46129,5430,22300,3705,40699,4784,2362,2422
59530,46134,5431,22304,3706,40703,4784,2362,2422
59535,46136,5431,22305,3706,40705,4784,2362,2422
59540,46144,5433,22308,3707,40711,4785,2363,2422
59545,46147,5433,22310,3707,40714,4785,2363,2422
59550,46152,5433,22312,3707,40719,4785,2363,2422
59555,46156,5433,22314,3707,40722,4785,2363,2422
59560,46159,5434,22316,3708,40725,4785,2363,2422
59565,46160,5434,22316,3708,40726,4785,2363,2422
59570,46165,5435,22318,3708,40730,4786,2363,2423
59575,46167,5435,22320,3708,40732,4786,2363,2423
59580,46175,5436,22321,3708,40739,4786,2363,2423
59585,46178,5436,22323,3708,40742,4786,2363,2423
59590,46183,5436,22327,3708,40747,4786,2363,2423
59595,46187,5436,22328,3708,40751,4786,2363,2423
59600,46190,5436,22331,3708,40754,4786,2363,2423
59605,46191,5436,22332,3708,40755,4786,2363,2423
59610,46196,5437,22335,3708,40759,4787,2364,2423
59615,46198,5437,22337,3708,40761,4787,2364,2423
59620,46206,5439,22343,3710,40767,4787,2364,2423
59625,46209,5439,22344,3710,40770,4787,2364,2423
59630,46214,5439,22347,3710,40775,4787,2364,2423
59635,46218,5439,22349,3710,40779,4787,2364,2423
59640,46221,5439,22349,3710,40782,4787,2364,2423
59645,46222,5439,22349,3710,40783,4787,2364,2423
59650,46227,5440,22351,3711,40787,4787,2364,2423
59655,46229,5440,22353,3711,40789,4787,2364,2423
59660,46237,5443,22357,3713,40794,4787,2364,2423
59665,46240,5443,22360,3713,40797,4787,2364,2423
59670,46245,5443,22363,3713,40802,4787,2364,2423
59675,46249,5443,22365,3713,40806,4787,2364,2423
59680,46252,5443,22366,3713,40809,4787,2364,2423
59685,46253,5444,22367,3714,40809,4787,2364,2423
59690,46258,5445,22369,3715,40813,4787,2364,2423
59695,46260,5445,22370,3715,40815,4787,2364,2423
59700,46268,5447,22374,3716,40821,4787,2364,2423
59705,46271,5447,22376,3716,40824,4787,2364,2423
59710,46276,5447,22378,3716,40829,4787,2364,2423
59715,46280,5447,22379,3716,40833,4787,2364,2423
59720,46283,5447,22382,3716,40836,4787,2364,2423
59725,46284,5447,22382,3716,40837,4787,2364,2423
59730,46289,5447,22385,3716,40842,4787,2364,2423
59735,46291,5447,22387,3716,40844,4787,2364,2423
59740,46299,5448,22391,3717,40851,4787,2364,2423
59745,46302,5448,22392,3717,40854,4787,2364,2423
59750,46307,5448,22395,3717,40859,4787,2364,2423
59755,46311,5448,22398,3717,40863,4787,2364,2423
59760,46314,5448,22399,3717,40866,4787,2364,2423
59765,46315,5448,22400,3717,40867,4787,2364,2423
59770,46320,5448,22401,3717,40872,4788,2364,2424
59775,46322,5448,22402,3717,40874,4788,2364,2424
59780,46330,5450,22408,3719,40880,4788,2364,2424
59785,46333,5450,22410,3719,40883,4788,2364,2424
59790,46338,5450,22412,3719,40888,4788,2364,2424
59795,46342,5450,22416,3719,40892,4788,2364,2424
59800,46345,5450,22417,3719,40895,4788,2364,2424
59805,46346,5450,22418,3719,40896,4788,2364,2424
59810,46351,5450,22419,3719,40901,4789,2364,2425
59815,46353,5450,22420,3719,40903,4789,2364,2425
59820,46361,5452,22424,3721,40909,4789,2364,2425
59825,46364,5452,22426,3721,40912,4789,2364,2425
59830,46369,5452,22428,3721,40917,4789,2364,2425
59835,46373,5452,22430,3721,40920,4789,2364,2425
59840,46376,5453,22430,3722,40923,4789,2364,2425
59845,46377,5453,22431,3722,40924,4789,2364,2425
59850,46382,5453,22434,3722,40929,4789,2364,2425
59855,46384,5453,22434,3722,40931,4789,2364,2425
59860,46392,5455,22437,3724,40937,4789,2364,2425
59865,46395,5455,22439,3724,40940,4789,2364,2425
59870,46400,5455,22443,3724,40945,4789,2364,2425
59875,46404,5455,22444,3724,40949,4789,2364,2425
59880,46407,5455,22445,3724,40952,4789,2364,2425
59885,46408,5455,22446,3724,40953,4789,2364,2425
59890,46413,5455,22446,3724,40958,4789,2364,2425
59895,46415,5455,22447,3724,40960,4789,2364,2425
59900,46423,5458,22451,3727,40965,4789,2364,2425
59905,46426,5458,22452,3727,40968,4789,2364,2425
59910,46431,5458,22457,3727,40973,4789,2364,2425
59915,46435,5458,22458,3727,40977,4789,2364,2425
59920,46438,5458,22460,3727,40980,4789,2364,2425
59925,46439,5458,22461,3727,40981,4789,2364,2425
59930,46444,5458,22464,3727,40986,4790,2364,2426
59935,46446,5458,22466,3727,40988,4790,2364,2426
59940,46454,5460,22472,3729,40994,4790,2364,2426
59945,46457,5460,22472,3729,40997,4790,2364,2426
59950,46462,5460,22474,3729,41002,4790,2364,2426
59955,46466,5460,22476,3729,41006,4790,2364,2426
59960,46469,5460,22476,3729,41009,4790,2364,2426
59965,46470,5460,22476,3729,41010,4790,2364,2426
59970,46475,5460,22479,3729,41015,4791,2365,2426
59975,46477,5460,22479,3729,41017,4791,2365,2426
59980,46485,5462,22480,3730,41023,4791,2365,2426
59985,46488,5462,22482,3730,41026,4791,2365,2426
59990,46493,5462,22486,3730,41031,4791,2365,2426
59995,46497,5462,22488,3730,41034,4791,2365,2426
60000,46500,5462,22489,3730,41038,4791,2365,2426
60005,46501,5462,22489,3730,41039,4791,2365,2426
60010,46506,5462,22491,3730,41044,4791,2365,2426
60015,46508,5462,22492,3730,41046,4791,2365,2426
60020,46516,5465,22496,3732,41051,4791,2365,2426
60025,46519,5465,22497,3732,41054,4791,2365,2426
60030,46524,5465,22501,3732,41059,4791,2365,2426
60035,46528,5465,22503,3732,41062,4791,2365,2426
60040,46531,5466,22503,3733,41065,4791,2365,2426
60045,46532,5466,22504,3733,41066,4791,2365,2426
60050,46537,5466,22505,3733,41071,4791,2365,2426
60055,46539,5466,22506,3733,41073,4791,2365,2426
60060,46547,5468,22509,3735,41079,4791,2365,2426
60065,46550,5468,22510,3735,41082,4791,2365,2426
60070,46555,5468,22511,3735,41087,4791,2365,2426
60075,46559,5468,22515,3735,41091,4791,2365,2426
60080,46562,5468,22517,3735,41094,4791,2365,2426
60085,46563,5468,22517,3735,41095,4791,2365,2426
60090,46568,5468,22520,3735,41100,4791,2365,2426
60095,46570,5468,22520,3735,41102,4791,2365,2426
60100,46578,5469,22524,3736,41109,4791,2365,2426
60105,46581,5469,22525,3736,41112,4791,2365,2426
60110,46586,5469,22528,3736,41117,4791,2365,2426
60115,46590,5469,22532,3736,41121,4791,2365,2426
60120,46593,5469,22533,3736,41124,4791,2365,2426
60125,46594,5469,22534,3736,41125,4791,2365,2426
60130,46599,5469,22537,3736,41130,4792,2366,2426
60135,46601,5469,22538,3736,41132,4792,2366,2426
60140,46609,5470,22540,3737,41139,4792,2366,2426
60145,46612,5470,22542,3737,41142,4792,2366,2426
60150,46617,5470,22544,3737,41147,4792,2366,2426
60155,46621,5470,22545,3737,41151,4792,2366,2426
60160,46624,5470,22546,3737,41154,4792,2366,2426
60165,46625,5470,22546,3737,41155,4792,2366,2426
60170,46630,5470,22549,3737,41160,4793,2367,2426
60175,46632,5470,22551,3737,41162,4793,2367,2426
60180,46640,5472,22553,3738,41168,4793,2367,2426
60185,46643,5472,22554,3738,41171,4793,2367,2426
60190,46648,5472,22558,3738,41176,4793,2367,2426
60195,46652,5472,22560,3738,41180,4793,2367,2426
60200,46655,5472,22561,3738,41183,4793,2367,2426
60205,46656,5472,22561,3738,41184,4793,2367,2426
60210,46661,5472,22564,3738,41189,4793,2367,2426
60215,46663,5472,22565,3738,41191,4793,2367,2426
60220,46671,5475,22571,3741,41195,4793,2367,2426
60225,46674,5476,22571,3742,41198,4793,2367,2426
60230,46679,5476,22573,3742,41203,4793,2367,2426
60235,46683,5476,22575,3742,41207,4793,2367,2426
60240,46686,5476,22577,3742,41210,4793,2367,2426
60245,46687,5476,22577,3742,41211,4793,2367,2426
60250,46692,5476,22581,3742,41216,4793,2367,2426
60255,46694,5476,22582,3742,41218,4793,2367,2426
60260,46702,5478,22587,3744,41224,4793,2367,2426
60265,46705,5478,22588,3744,41227,4793,2367,2426
60270,46710,5478,22590,3744,41232,4793,2367,2426
60275,46714,5478,22593,3744,41236,4793,2367,2426
60280,46717,5478,22595,3744,41239,4793,2367,2426
60285,46718,5478,22595,3744,41240,4793,2367,2426
60290,46723,5478,22597,3744,41245,4794,2367,2427
60295,46725,5478,22598,3744,41247,4794,2367,2427
60300,46733,5480,22602,3746,41253,4794,2367,2427
60305,46736,5480,22605,3746,41256,4794,2367,2427
60310,46741,5480,22606,3746,41261,4794,2367,2427
60315,46745,5480,22608,3746,41265,4794,2367,2427
60320,46748,5480,22610,3746,41268,4794,2367,2427
60325,46749,5480,22610,3746,41269,4794,2367,2427
60330,46754,5480,22612,3746,41274,4795,2367,2428
60335,46756,5480,22614,3746,41276,4795,2367,2428
60340,46764,5482,22617,3747,41282,4795,2367,2428
60345,46767,5482,22618,3747,41285,4795,2367,2428
60350,46772,5482,22623,3747,41290,4795,2367,2428
60355,46776,5482,22627,3747,41294,4795,2367,2428
60360,46779,5482,22629,3747,41297,4795,2367,2428
60365,46780,5482,22629,3747,41298,4795,2367,2428
60370,46785,5482,22630,3747,41303,4795,2367,2428
60375,46787,5482,22631,3747,41305,4795,2367,2428
60380,46795,5484,22636,3749,41310,4795,2367,2428
60385,46798,5485,22637,3750,41313,4795,2367,2428
60390,46803,5485,22639,3750,41318,4795,2367,2428
60395,46807,5485,22639,3750,41322,4795,2367,2428
60400,46810,5485,22640,3750,41325,4795,2367,2428
60405,46811,5485,22641,3750,41326,4795,2367,2428
60410,46816,5485,22641,3750,41331,4795,2367,2428
60415,46818,5485,22641,3750,41333,4795,2367,2428
60420,46826,5486,22644,3750,41339,4795,2367,2428
60425,46829,5487,22645,3751,41342,4795,2367,2428
60430,46834,5487,22647,3751,41347,4795,2367,2428
60435,46838,5487,22649,3751,41351,4795,2367,2428
60440,46841,5487,22651,3751,41354,4795,2367,2428
60445,46842,5487,22651,3751,41355,4795,2367,2428
60450,46847,5487,22653,3751,41360,4795,2367,2428
60455,46849,5487,22654,3751,41362,4795,2367,2428
60460,46857,5489,22659,3753,41367,4795,2367,2428
60465,46860,5490,22661,3754,41370,4795,2367,2428
60470,46865,5490,22664,3754,41375,4795,2367,2428
60475,46869,5490,22665,3754,41379,4795,2367,2428
60480,46872,5490,22666,3754,41382,4795,2367,2428
60485,46873,5490,22666,3754,41383,4795,2367,2428
60490,46878,5490,22668,3754,41388,4795,2367,2428
60495,46880,5490,22669,3754,41390,4795,2367,2428
60500,46888,5492,22673,3755,41396,4795,2367,2428
60505,46891,5492,22674,3755,41399,4795,2367,2428
60510,46896,5492,22677,3755,41404,4795,2367,2428
60515,46900,5492,22678,3755,41408,4795,2367,2428
60520,46903,5492,22680,3755,41411,4795,2367,2428
60525,46904,5492,22681,3755,41412,4795,2367,2428
60530,46909,5492,22685,3755,41417,4795,2367,2428
60535,46911,5492,22685,3755,41419,4795,2367,2428
60540,46919,5493,22688,3756,41426,4795,2367,2428
60545,46922,5493,22690,3756,41429,4795,2367,2428
60550,46927,5493,22693,3756,41434,4795,2367,2428
60555,46931,5493,22696,3756,41438,4795,2367,2428
60560,46934,5493,22698,3756,41441,4795,2367,2428
60565,46935,5493,22699,3756,41442,4795,2367,2428
60570,46940,5493,22703,3756,41447,4795,2367,2428
60575,46942,5493,22703,3756,41449,4795,2367,2428
60580,46950,5494,22706,3757,41456,4795,2367,2428
60585,46953,5494,22709,3757,41459,4795,2367,2428
60590,46958,5494,22711,3757,41464,4795,2367,2428
60595,46962,5494,22713,3757,41468,4795,2367,2428
60600,46965,5494,22716,3757,41471,4795,2367,2428
60605,46966,5494,22717,3757,41472,4795,2367,2428
60610,46971,5494,22720,3757,41477,4795,2367,2428
60615,46973,5494,22722,3757,41479,4795,2367,2428
60620,46981,5496,22725,3758,41485,4795,2367,2428
60625,46984,5496,22728,3758,41488,4795,2367,2428
60630,46989,5496,22729,3758,41493,4795,2367,2428
60635,46993,5496,22732,3758,41497,4795,2367,2428
60640,46996,5496,22733,3758,41500,4795,2367,2428
60645,46997,5496,22733,3758,41501,4795,2367,2428
60650,47002,5496,22737,3758,41506,4795,2367,2428
60655,47004,5496,22738,3758,41508,4795,2367,2428
60660,47012,5498,22742,3760,41514,4795,2367,2428
60665,47015,5498,22742,3760,41517,4795,2367,2428
60670,47020,5498,22743,3760,41522,4795,2367,2428
60675,47024,5498,22745,3760,41526,4795,2367,2428
60680,47027,5498,22747,3760,41529,4795,2367,2428
60685,47028,5498,22747,3760,41530,4795,2367,2428
60690,47033,5498,22749,3760,41535,4796,2368,2428
60695,47035,5498,22749,3760,41537,4796,2368,2428
60700,47043,5499,22751,3760,41544,4796,2368,2428
60705,47046,5499,22751,3760,41547,4796,2368,2428
60710,47051,5499,22755,3760,41552,4796,2368,2428
60715,47055,5499,22756,3760,41556,4796,2368,2428
60720,47058,5499,22758,3760,41559,4796,2368,2428
60725,47059,5499,22759,3760,41560,4796,2368,2428
60730,47064,5499,22762,3760,41565,4796,2368,2428
60735,47066,5499,22763,3760,41567,4796,2368,2428
60740,47074,5501,22767,3762,41573,4796,2368,2428
60745,47077,5501,22768,3762,41576,4796,2368,2428
60750,47082,5501,22769,3762,41581,4796,2368,2428
60755,47086,5501,22772,3762,41585,4796,2368,2428
60760,47089,5501,22774,3762,41588,4796,2368,2428
60765,47090,5501,22775,3762,41589,4796,2368,2428
60770,47095,5501,22777,3762,41594,4796,2368,2428
60775,47097,5501,22778,3762,41596,4796,2368,2428
60780,47105,5503,22781,3764,41602,4796,2368,2428
60785,47108,5503,22784,3764,41605,4796,2368,2428
60790,47113,5503,22787,3764,41610,4796,2368,2428
60795,47117,5503,22788,3764,41614,4796,2368,2428
60800,47120,5503,22790,3764,41617,4796,2368,2428
60805,47121,5503,22790,3764,41618,4796,2368,2428
60810,47126,5503,22792,3764,41623,4796,2368,2428
60815,47128,5503,22794,3764,41625,4796,2368,2428
60820,47136,5505,22797,3765,41631,4796,2368,2428
60825,47139,5505,22797,3765,41634,4796,2368,2428
60830,47144,5505,22799,3765,41639,4796,2368,2428
60835,47148,5505,22801,3765,41643,4796,2368,2428
60840,47151,5505,22802,3765,41646,4796,2368,2428
60845,47152,5505,22803,3765,41647,4796,2368,2428
60850,47157,5505,22805,3765,41652,4797,2369,2428
60855,47159,5505,22805,3765,41654,4797,2369,2428
60860,47167,5507,22807,3766,41660,4797,2369,2428
60865,47170,5507,22808,3766,41663,4797,2369,2428
60870,47175,5507,22811,3766,41668,4797,2369,2428
60875,47179,5507,22812,3766,41672,4797,2369,2428
60880,47182,5507,22813,3766,41675,4797,2369,2428
60885,47183,5507,22813,3766,41676,4797,2369,2428
60890,47188,5507,22814,3766,41681,4797,2369,2428
60895,47190,5507,22816,3766,41683,4797,2369,2428
60900,47198,5510,22820,3768,41688,4797,2369,2428
60905,47201,5510,22821,3768,41691,4797,2369,2428
60910,47206,5510,22825,3768,41696,4797,2369,2428
60915,47210,5510,22828,3768,41700,4797,2369,2428
60920,47213,5510,22829,3768,41703,4797,2369,2428
60925,47214,5510,22830,3768,41704,4797,2369,2428
60930,47219,5510,22834,3768,41709,4798,2370,2428
60935,47221,5510,22835,3768,41711,4798,2370,2428
60940,47229,5513,22839,3770,41715,4798,2370,2428
60945,47232,5514,22841,3771,41718,4798,2370,2428
60950,47237,5514,22843,3771,41723,4798,2370,2428
60955,47241,5514,22847,3771,41727,4798,2370,2428
60960,47244,5514,22849,3771,41730,4798,2370,2428
60965,47245,5514,22849,3771,41731,4798,2370,2428
60970,47250,5514,22850,3771,41736,4798,2370,2428
60975,47252,5514,22851,3771,41738,4798,2370,2428
60980,47260,5517,22855,3773,41742,4798,2370,2428
60985,47263,5518,22855,3774,41745,4798,2370,2428
60990,47268,5518,22857,3774,41750,4798,2370,2428
60995,47272,5518,22858,3774,41754,4798,2370,2428
61000,47275,5518,22859,3774,41757,4798,2370,2428
61005,47276,5518,22859,3774,41758,4798,2370,2428
61010,47281,5518,22860,3774,41763,4798,2370,2428
61015,47283,5518,22862,3774,41765,4798,2370,2428
61020,47291,5519,22866,3774,41772,4798,2370,2428
61025,47294,5519,22867,3774,41775,4798,2370,2428
61030,47299,5519,22870,3774,41780,4798,2370,2428
61035,47303,5519,22871,3774,41784,4798,2370,2428
61040,47306,5519,22872,3774,41787,4798,2370,2428
61045,47307,5519,22872,3774,41788,4798,2370,2428
61050,47312,5519,22874,3774,41793,4798,2370,2428
61055,47314,5519,22876,3774,41795,4798,2370,2428
61060,47322,5520,22879,3774,41802,4798,2370,2428
61065,47325,5520,22881,3774,41805,4798,2370,2428
61070,47330,5520,22882,3774,41810,4798,2370,2428
61075,47334,5520,22884,3774,41814,4798,2370,2428
61080,47337,5520,22887,3774,41817,4798,2370,2428
61085,47338,5520,22888,3774,41818,4798,2370,2428
61090,47343,5520,22889,3774,41823,4799,2370,2429
61095,47345,5520,22890,3774,41825,4799,2370,2429
61100,47353,5523,22894,3776,41830,4799,2370,2429
61105,47356,5523,22895,3776,41833,4799,2370,2429
61110,47361,5523,22897,3776,41838,4799,2370,2429
61115,47365,5523,22900,3776,41842,4799,2370,2429
61120,47368,5523,22901,3776,41845,4799,2370,2429
61125,47369,5523,22901,3776,41846,4799,2370,2429
61130,47374,5523,22903,3776,41851,4799,2370,2429
61135,47376,5523,22904,3776,41853,4799,2370,2429
61140,47384,5525,22907,3777,41859,4799,2370,2429
61145,47387,5525,22908,3777,41862,4799,2370,2429
61150,47392,5525,22911,3777,41867,4799,2370,2429
61155,47396,5525,22914,3777,41871,4799,2370,2429
61160,47399,5525,22915,3777,41874,4799,2370,2429
61165,47400,5525,22915,3777,41875,4799,2370,2429
61170,47405,5525,22916,3777,41880,4799,2370,2429
61175,47407,5525,22917,3777,41882,4799,2370,2429
61180,47415,5527,22920,3778,41888,4799,2370,2429
61185,47418,5527,22921,3778,41891,4799,2370,2429
61190,47423,5527,22923,3778,41896,4799,2370,2429
61195,47427,5527,22925,3778,41900,4799,2370,2429
61200,47430,5527,22925,3778,41903,4799,2370,2429
61205,47431,5527,22925,3778,41904,4799,2370,2429
61210,47436,5527,22925,3778,41909,4800,2370,2430
61215,47438,5527,22926,3778,41911,4800,2370,2430
61220,47446,5529,22929,3780,41917,4800,2370,2430
61225,47449,5529,22929,3780,41920,4800,2370,2430
61230,47454,5529,22931,3780,41925,4800,2370,2430
61235,47458,5529,22933,3780,41929,4800,2370,2430
61240,47461,5529,22935,3780,41932,4800,2370,2430
61245,47462,5529,22936,3780,41933,4800,2370,2430
61250,47467,5529,22939,3780,41938,4801,2370,2431
61255,47469,5529,22940,3780,41940,4801,2370,2431
61260,47477,5531,22942,3781,41946,4801,2370,2431
61265,47480,5531,22943,3781,41949,4801,2370,2431
61270,47485,5531,22946,3781,41954,4801,2370,2431
61275,47489,5531,22947,3781,41958,4801,2370,2431
61280,47492,5531,22950,3781,41961,4801,2370,2431
61285,47493,5531,22951,3781,41962,4801,2370,2431
61290,47498,5531,22955,3781,41967,4802,2371,2431
61295,47500,5531,22956,3781,41969,4802,2371,2431
61300,47508,5532,22959,3781,41976,4802,2371,2431
61305,47511,5532,22960,3781,41979,4802,2371,2431
61310,47516,5532,22961,3781,41984,4802,2371,2431
61315,47520,5532,22961,3781,41988,4802,2371,2431
61320,47523,5532,22961,3781,41991,4802,2371,2431
61325,47524,5532,22962,3781,41992,4802,2371,2431
61330,47529,5532,22963,3781,41997,4802,2371,2431
61335,47531,5532,22964,3781,41999,4802,2371,2431
61340,47539,5533,22965,3782,42006,4802,2371,2431
61345,47542,5533,22968,3782,42009,4802,2371,2431
61350,47547,5533,22968,3782,42014,4802,2371,2431
61355,47551,5533,22970,3782,42018,4802,2371,2431
61360,47554,5533,22971,3782,42021,4802,2371,2431
61365,47555,5533,22972,3782,42022,4802,2371,2431
61370,47560,5533,22974,3782,42027,4802,2371,2431
61375,47562,5533,22974,3782,42029,4802,2371,2431
61380,47570,5534,22976,3783,42036,4802,2371,2431
61385,47573,5534,22978,3783,42039,4802,2371,2431
61390,47578,5534,22982,3783,42044,4802,2371,2431
61395,47582,5534,22983,3783,42048,4802,2371,2431
61400,47585,5534,22985,3783,42051,4802,2371,2431
61405,47586,5534,22986,3783,42052,4802,2371,2431
61410,47591,5534,22988,3783,42057,4802,2371,2431
61415,47593,5534,22989,3783,42059,4802,2371,2431
61420,47601,5536,22994,3785,42064,4802,2371,2431
61425,47604,5537,22997,3786,42067,4802,2371,2431
61430,47609,5537,22999,3786,42072,4802,2371,2431
61435,47613,5537,23001,3786,42076,4802,2371,2431
61440,47616,5537,23004,3786,42079,4802,2371,2431
61445,47617,5537,23004,3786,42080,4802,2371,2431
61450,47622,5537,23005,3786,42085,4803,2371,2432
61455,47624,5537,23007,3786,42087,4803,2371,2432
61460,47632,5539,23011,3788,42092,4803,2371,2432
61465,47635,5540,23014,3789,42095,4803,2371,2432
61470,47640,5540,23017,3789,42100,4803,2371,2432
61475,47644,5540,23018,3789,42104,4803,2371,2432
61480,47647,5540,23019,3789,42107,4803,2371,2432
61485,47648,5540,23019,3789,42108,4803,2371,2432
61490,47653,5540,23022,3789,42113,4804,2371,2433
61495,47655,5540,23023,3789,42115,4804,2371,2433
61500,47663,5542,23026,3790,42121,4804,2371,2433
61505,47666,5542,23028,3790,42124,4804,2371,2433
61510,47671,5542,23029,3790,42129,4804,2371,2433
61515,47675,5542,23032,3790,42133,4804,2371,2433
61520,47678,5542,23035,3790,42136,4804,2371,2433
61525,47679,5542,23036,3790,42137,4804,2371,2433
61530,47684,5542,23039,3790,42142,4804,2371,2433
61535,47686,5542,23040,3790,42144,4804,2371,2433
61540,47694,5543,23044,3791,42151,4804,2371,2433
61545,47697,5543,23045,3791,42154,4804,2371,2433
61550,47702,5543,23048,3791,42159,4804,2371,2433
61555,47706,5543,23051,3791,42163,4804,2371,2433
61560,47709,5543,23052,3791,42166,4804,2371,2433
61565,47710,5543,23053,3791,42167,4804,2371,2433
61570,47715,5543,23057,3791,42172,4804,2371,2433
61575,47717,5543,23058,3791,42174,4804,2371,2433
61580,47725,5544,23062,3792,42181,4804,2371,2433
61585,47728,5544,23065,3792,42184,4804,2371,2433
61590,47733,5544,23068,3792,42189,4804,2371,2433
61595,47737,5544,23070,3792,42193,4804,2371,2433
61600,47740,5544,23071,3792,42196,4804,2371,2433
61605,47741,5544,23072,3792,42197,4804,2371,2433
61610,47746,5544,23076,3792,42202,4804,2371,2433
61615,47748,5544,23077,3792,42204,4804,2371,2433
61620,47756,5546,23081,3792,42210,4804,2371,2433
61625,47759,5546,23083,3792,42213,4804,2371,2433
61630,47764,5546,23086,3792,42218,4804,2371,2433
61635,47768,5546,23087,3792,42222,4804,2371,2433
61640,47771,5546,23089,3792,42225,4804,2371,2433
61645,47772,5546,23089,3792,42226,4804,2371,2433
61650,47777,5546,23092,3792,42231,4805,2372,2433
61655,47779,5546,23093,3792,42233,4805,2372,2433
61660,47787,5549,23096,3793,42237,4805,2372,2433
61665,47790,5550,23097,3794,42240,4805,2372,2433
61670,47795,5550,23101,3794,42245,4805,2372,2433
61675,47799,5550,23104,3794,42249,4805,2372,2433
61680,47802,5550,23105,3794,42252,4805,2372,2433
61685,47803,5550,23106,3794,42253,4805,2372,2433
61690,47808,5550,23108,3794,42258,4806,2372,2434
61695,47810,5550,23109,3794,42260,4806,2372,2434
61700,47818,5553,23112,3796,42265,4806,2372,2434
61705,47821,5553,23114,3796,42268,4806,2372,2434
61710,47826,5553,23117,3796,42273,4806,2372,2434
61715,47830,5553,23120,3796,42277,4806,2372,2434
61720,47833,5553,23122,3796,42280,4806,2372,2434
61725,47834,5553,23123,3796,42281,4806,2372,2434
61730,47839,5553,23125,3796,42286,4807,2373,2434
61735,47841,5553,23126,3796,42288,4807,2373,2434
61740,47849,5556,23130,3799,42293,4807,2373,2434
61745,47852,5556,23131,3799,42296,4807,2373,2434
61750,47857,5556,23133,3799,42301,4807,2373,2434
61755,47861,5556,23135,3799,42305,4807,2373,2434
61760,47864,5556,23137,3799,42308,4807,2373,2434
61765,47865,5556,23138,3799,42309,4807,2373,2434
61770,47870,5556,23139,3799,42314,4807,2373,2434
61775,47872,5556,23140,3799,42316,4807,2373,2434
61780,47880,5559,23143,3799,42321,4807,2373,2434
61785,47883,5559,23143,3799,42324,4807,2373,2434
61790,47888,5559,23144,3799,42329,4807,2373,2434
61795,47892,5559,23145,3799,42333,4807,2373,2434
61800,47895,5559,23146,3799,42336,4807,2373,2434
61805,47896,5559,23146,3799,42337,4807,2373,2434
61810,47901,5559,23148,3799,42342,4807,2373,2434
61815,47903,5559,23149,3799,42344,4807,2373,2434
61820,47911,5561,23149,3799,42350,4807,2373,2434
61825,47914,5561,23150,3799,42353,4807,2373,2434
61830,47919,5561,23153,3799,42358,4807,2373,2434
61835,47923,5561,23156,3799,42362,4807,2373,2434
61840,47926,5561,23157,3799,42365,4807,2373,2434
61845,47927,5561,23157,3799,42366,4807,2373,2434
61850,47932,5561,23159,3799,42371,4808,2373,2435
61855,47934,5561,23160,3799,42373,4808,2373,2435
61860,47942,5563,23166,3801,42379,4808,2373,2435
61865,47945,5563,23167,3801,42382,4808,2373,2435
61870,47950,5563,23170,3801,42387,4808,2373,2435
61875,47954,5563,23172,3801,42391,4808,2373,2435
61880,47957,5563,23174,3801,42394,4808,2373,2435
61885,47958,5563,23174,3801,42395,4808,2373,2435
61890,47963,5563,23177,3801,42400,4808,2373,2435
61895,47965,5563,23178,3801,42402,4808,2373,2435
61900,47973,5565,23180,3802,42408,4808,2373,2435
61905,47976,5565,23181,3802,42411,4808,2373,2435
61910,47981,5565,23184,3802,42416,4808,2373,2435
61915,47985,5565,23186,3802,42420,4808,2373,2435
61920,47988,5565,23188,3802,42423,4808,2373,2435
61925,47989,5565,23189,3802,42424,4808,2373,2435
61930,47994,5565,23192,3802,42429,4808,2373,2435
61935,47996,5565,23192,3802,42431,4808,2373,2435
61940,48004,5568,23195,3803,42435,4808,2373,2435
61945,48007,5569,23196,3804,42438,4808,2373,2435
61950,48012,5569,23200,3804,42443,4808,2373,2435
61955,48016,5569,23202,3804,42447,4808,2373,2435
61960,48019,5569,23203,3804,42450,4808,2373,2435
61965,48020,5569,23204,3804,42451,4808,2373,2435
61970,48025,5569,23206,3804,42456,4808,2373,2435
61975,48027,5569,23206,3804,42458,4808,2373,2435
61980,48035,5572,23209,3805,42463,4808,2373,2435
61985,48038,5572,23212,3805,42466,4808,2373,2435
61990,48043,5572,23216,3805,42471,4808,2373,2435
61995,48047,5572,23217,3805,42475,4808,2373,2435
62000,48050,5572,23219,3805,42478,4808,2373,2435
62005,48051,5572,23219,3805,42479,4808,2373,2435
62010,48056,5572,23222,3805,42484,4808,2373,2435
62015,48058,5572,23224,3805,42486,4808,2373,2435
62020,48066,5575,23226,3806,42491,4808,2373,2435
62025,48069,5575,23228,3806,42494,4808,2373,2435
62030,48074,5575,23231,3806,42499,4808,2373,2435
62035,48078,5575,23232,3806,42503,4808,2373,2435
62040,48081,5575,23234,3806,42506,4808,2373,2435
62045,48082,5575,23235,3806,42507,4808,2373,2435
62050,48087,5575,23235,3806,42512,4809,2373,2436
62055,48089,5575,23235,3806,42514,4809,2373,2436
62060,48097,5577,23241,3808,42520,4809,2373,2436
62065,48100,5577,23243,3808,42523,4809,2373,2436
62070,48105,5577,23246,3808,42528,4809,2373,2436
62075,48109,5577,23246,3808,42532,4809,2373,2436
62080,48112,5577,23249,3808,42535,4809,2373,2436
62085,48113,5577,23249,3808,42536,4809,2373,2436
62090,48118,5577,23252,3808,42541,4809,2373,2436
62095,48120,5577,23253,3808,42543,4809,2373,2436
62100,48128,5579,23256,3809,42549,4809,2373,2436
62105,48131,5579,23259,3809,42552,4809,2373,2436
62110,48136,5579,23262,3809,42557,4809,2373,2436
62115,48140,5579,23265,3809,42561,4809,2373,2436
62120,48143,5579,23266,3809,42564,4809,2373,2436
62125,48144,5579,23267,3809,42565,4809,2373,2436
62130,48149,5579,23271,3809,42570,4809,2373,2436
62135,48151,5579,23272,3809,42572,4809,2373,2436
62140,48159,5581,23277,3810,42578,4809,2373,2436
62145,48162,5581,23277,3810,42581,4809,2373,2436
62150,48167,5581,23281,3810,42586,4809,2373,2436
62155,48171,5581,23285,3810,42590,4809,2373,2436
62160,48174,5581,23286,3810,42593,4809,2373,2436
62165,48175,5581,23287,3810,42594,4809,2373,2436
62170,48180,5581,23289,3810,42599,4810,2374,2436
62175,48182,5581,23290,3810,42601,4810,2374,2436
62180,48190,5584,23291,3811,42606,4810,2374,2436
62185,48193,5584,23293,3811,42609,4810,2374,2436
62190,48198,5584,23295,3811,42614,4810,2374,2436
62195,48202,5584,23296,3811,42618,4810,2374,2436
62200,48205,5584,23296,3811,42621,4810,2374,2436
62205,48206,5584,23297,3811,42622,4810,2374,2436
62210,48211,5584,23297,3811,42627,4811,2374,2437
62215,48213,5584,23299,3811,42629,4811,2374,2437
62220,48221,5587,23302,3813,42634,4811,2374,2437
62225,48224,5587,23302,3813,42637,4811,2374,2437
62230,48229,5587,23304,3813,42642,4811,2374,2437
62235,48233,5587,23306,3813,42646,4811,2374,2437
62240,48236,5587,23307,3813,42649,4811,2374,2437
62245,48237,5587,23308,3813,42650,4811,2374,2437
62250,48242,5587,23313,3813,42655,4811,2374,2437
62255,48244,5587,23314,3813,42657,4811,2374,2437
62260,48252,5590,23317,3813,42662,4811,2374,2437
62265,48255,5590,23318,3813,42665,4811,2374,2437
62270,48260,5590,23322,3813,42670,4811,2374,2437
62275,48264,5590,23323,3813,42674,4811,2374,2437
62280,48267,5590,23324,3813,42677,4811,2374,2437
62285,48268,5590,23325,3813,42678,4811,2374,2437
62290,48273,5590,23329,3813,42683,4811,2374,2437
62295,48275,5590,23330,3813,42685,4811,2374,2437
62300,48283,5592,23333,3815,42691,4811,2374,2437
62305,48286,5592,23335,3815,42694,4811,2374,2437
62310,48291,5592,23337,3815,42699,4811,2374,2437
62315,48295,5592,23338,3815,42703,4811,2374,2437
62320,48298,5592,23340,3815,42706,4811,2374,2437
62325,48299,5592,23341,3815,42707,4811,2374,2437
62330,48304,5592,23342,3815,42712,4812,2374,2438
62335,48306,5592,23343,3815,42714,4812,2374,2438
62340,48314,5594,23348,3816,42720,4812,2374,2438
62345,48317,5594,23350,3816,42723,4812,2374,2438
62350,48322,5594,23352,3816,42728,4812,2374,2438
62355,48326,5594,23353,3816,42732,4812,2374,2438
62360,48329,5594,23355,3816,42735,4812,2374,2438
62365,48330,5594,23356,3816,42736,4812,2374,2438
62370,48335,5594,23357,3816,42741,4812,2374,2438
62375,48337,5594,23358,3816,42743,4812,2374,2438
62380,48345,5596,23364,3818,42749,4812,2374,2438
62385,48348,5596,23365,3818,42752,4812,2374,2438
62390,48353,5596,23369,3818,42757,4812,2374,2438
62395,48357,5596,23371,3818,42761,4812,2374,2438
62400,48360,5596,23372,3818,42764,4812,2374,2438
62405,48361,5596,23373,3818,42765,4812,2374,2438
62410,48366,5596,23374,3818,42770,4812,2374,2438
62415,48368,5596,23374,3818,42772,4812,2374,2438
62420,48376,5599,23376,3818,42777,4812,2374,2438
62425,48379,5599,23377,3818,42780,4812,2374,2438
62430,48384,5599,23380,3818,42785,4812,2374,2438
62435,48388,5599,23381,3818,42789,4812,2374,2438
62440,48391,5599,23382,3818,42792,4812,2374,2438
62445,48392,5599,23382,3818,42793,4812,2374,2438
62450,48397,5599,23385,3818,42798,4812,2374,2438
62455,48399,5599,23385,3818,42800,4812,2374,2438
62460,48407,5602,23389,3820,42805,4812,2374,2438
62465,48410,5602,23389,3820,42808,4812,2374,2438
62470,48415,5602,23390,3820,42813,4812,2374,2438
62475,48419,5602,23394,3820,42817,4812,2374,2438
62480,48422,5602,23396,3820,42820,4812,2374,2438
62485,48423,5602,23397,3820,42821,4812,2374,2438
62490,48428,5602,23399,3820,42826,4813,2375,2438
62495,48430,5602,23399,3820,42828,4813,2375,2438
62500,48438,5605,23404,3823,42833,4813,2375,2438
62505,48441,5605,23405,3823,42836,4813,2375,2438
62510,48446,5605,23408,3823,42841,4813,2375,2438
62515,48450,5605,23411,3823,42845,4813,2375,2438
62520,48453,5605,23411,3823,42848,4813,2375,2438
62525,48454,5605,23412,3823,42849,4813,2375,2438
62530,48459,5605,23415,3823,42854,4814,2376,2438
62535,48461,5605,23416,3823,42856,4814,2376,2438
62540,48469,5607,23420,3825,42862,4814,2376,2438
62545,48472,5607,23422,3825,42865,4814,2376,2438
62550,48477,5607,23424,3825,42870,4814,2376,2438
62555,48481,5607,23426,3825,42874,4814,2376,2438
62560,48484,5607,23428,3825,42877,4814,2376,2438
62565,48485,5607,23428,3825,42878,4814,2376,2438
62570,48490,5607,23431,3825,42883,4814,2376,2438
62575,48492,5607,23432,3825,42885,4814,2376,2438
62580,48500,5609,23436,3825,42891,4814,2376,2438
62585,48503,5609,23437,3825,42894,4814,2376,2438
62590,48508,5609,23439,3825,42899,4814,2376,2438
62595,48512,5609,23442,3825,42903,4814,2376,2438
62600,48515,5609,23443,3825,42906,4814,2376,2438
62605,48516,5609,23443,3825,42907,4814,2376,2438
62610,48521,5609,23446,3825,42912,4814,2376,2438
62615,48523,5609,23447,3825,42914,4814,2376,2438
62620,48531,5611,23451,3826,42920,4814,2376,2438
62625,48534,5611,23453,3826,42923,4814,2376,2438
62630,48539,5611,23456,3826,42928,4814,2376,2438
62635,48543,5611,23458,3826,42932,4814,2376,2438
62640,48546,5611,23460,3826,42935,4814,2376,2438
62645,48547,5611,23460,3826,42936,4814,2376,2438
62650,48552,5611,23462,3826,42941,4815,2376,2439
62655,48554,5611,23464,3826,42943,4815,2376,2439
62660,48562,5614,23467,3828,42948,4815,2376,2439
62665,48565,5614,23470,3828,42951,4815,2376,2439
62670,48570,5614,23471,3828,42956,4815,2376,2439
62675,48574,5614,23471,3828,42960,4815,2376,2439
62680,48577,5614,23472,3828,42963,4815,2376,2439
62685,48578,5614,23473,3828,42964,4815,2376,2439
62690,48583,5614,23473,3828,42969,4816,2376,2440
62695,48585,5614,23474,3828,42971,4816,2376,2440
62700,48593,5614,23477,3828,42979,4816,2376,2440
62705,48596,5614,23479,3828,42982,4816,2376,2440
62710,48601,5614,23482,3828,42987,4816,2376,2440
62715,48605,5614,23482,3828,42991,4816,2376,2440
62720,48608,5614,23483,3828,42994,4816,2376,2440
62725,48609,5614,23483,3828,42995,4816,2376,2440
62730,48614,5614,23487,3828,43000,4816,2376,2440
62735,48616,5614,23489,3828,43002,4816,2376,2440
62740,48624,5614,23493,3828,43010,4816,2376,2440
62745,48627,5614,23494,3828,43013,4816,2376,2440
62750,48632,5614,23496,3828,43018,4816,2376,2440
62755,48636,5614,23500,3828,43022,4816,2376,2440
62760,48639,5614,23501,3828,43025,4816,2376,2440
62765,48640,5614,23501,3828,43026,4816,2376,2440
62770,48645,5614,23505,3828,43031,4816,2376,2440
62775,48647,5614,23505,3828,43033,4816,2376,2440
62780,48655,5614,23509,3828,43041,4816,2376,2440
62785,48658,5614,23511,3828,43044,4816,2376,2440
62790,48663,5614,23513,3828,43049,4816,2376,2440
62795,48667,5614,23514,3828,43053,4816,2376,2440
62800,48670,5614,23516,3828,43056,4816,2376,2440
62805,48671,5614,23516,3828,43057,4816,2376,2440
62810,48676,5614,23520,3828,43062,4817,2377,2440
62815,48678,5614,23522,3828,43064,4817,2377,2440
62820,48686,5614,23527,3828,43072,4817,2377,2440
62825,48689,5614,23527,3828,43075,4817,2377,2440
62830,48694,5614,23530,3828,43080,4817,2377,2440
62835,48698,5614,23531,3828,43084,4817,2377,2440
62840,48701,5614,23534,3828,43087,4817,2377,2440
62845,48702,5614,23534,3828,43088,4817,2377,2440
62850,48707,5614,23536,3828,43093,4818,2378,2440
62855,48709,5614,23537,3828,43095,4818,2378,2440
62860,48717,5614,23541,3828,43103,4818,2378,2440
62865,48720,5614,23542,3828,43106,4818,2378,2440
62870,48725,5614,23545,3828,43111,4818,2378,2440
62875,48729,5614,23547,3828,43115,4818,2378,2440
62880,48732,5614,23550,3828,43118,4818,2378,2440
62885,48733,5614,23551,3828,43119,4818,2378,2440
62890,48738,5614,23554,3828,43124,4818,2378,2440
62895,48740,5614,23555,3828,43126,4818,2378,2440
62900,48748,5614,23560,3828,43134,4818,2378,2440
62905,48751,5614,23561,3828,43137,4818,2378,2440
62910,48756,5614,23563,3828,43142,4818,2378,2440
62915,48760,5614,23564,3828,43146,4818,2378,2440
62920,48763,5614,23566,3828,43149,4818,2378,2440
62925,48764,5614,23566,3828,43150,4818,2378,2440
62930,48769,5614,23570,3828,43155,4818,2378,2440
62935,48771,5614,23570,3828,43157,4818,2378,2440
62940,48779,5614,23574,3828,43165,4818,2378,2440
62945,48782,5614,23576,3828,43168,4818,2378,2440
62950,48787,5614,23577,3828,43173,4818,2378,2440
62955,48791,5614,23579,3828,43177,4818,2378,2440
62960,48794,5614,23579,3828,43180,4818,2378,2440
62965,48795,5614,23580,3828,43181,4818,2378,2440
62970,48800,5614,23580,3828,43186,4819,2378,2441
62975,48802,5614,23581,3828,43188,4819,2378,2441
62980,48810,5614,23584,3828,43196,4819,2378,2441
62985,48813,5614,23586,3828,43199,4819,2378,2441
62990,48818,5614,23589,3828,43204,4819,2378,2441
62995,48822,5614,23591,3828,43208,4819,2378,2441
63000,48825,5614,23594,3828,43211,4819,2378,2441
63005,48826,5614,23594,3828,43212,4819,2378,2441
63010,48831,5614,23598,3828,43217,4819,2378,2441
63015,48833,5614,23599,3828,43219,4819,2378,2441
63020,48841,5614,23602,3828,43227,4819,2378,2441
63025,48844,5614,23604,3828,43230,4819,2378,2441
63030,48849,5614,23605,3828,43235,4819,2378,2441
63035,48853,5614,23607,3828,43239,4819,2378,2441
63040,48856,5614,23607,3828,43242,4819,2378,2441
63045,48857,5614,23607,3828,43243,4819,2378,2441
63050,48862,5614,23608,3828,43248,4819,2378,2441
63055,48864,5614,23608,3828,43250,4819,2378,2441
63060,48872,5614,23610,3828,43258,4819,2378,2441
63065,48875,5614,23611,3828,43261,4819,2378,2441
63070,48880,5614,23613,3828,43266,4819,2378,2441
63075,48884,5614,23616,3828,43270,4819,2378,2441
63080,48887,5614,23617,3828,43273,4819,2378,2441
63085,48888,5614,23617,3828,43274,4819,2378,2441
63090,48893,5614,23619,3828,43279,4819,2378,2441
63095,48895,5614,23619,3828,43281,4819,2378,2441
63100,48903,5614,23623,3828,43289,4819,2378,2441
63105,48906,5614,23623,3828,43292,4819,2378,2441
63110,48911,5614,23624,3828,43297,4819,2378,2441
63115,48915,5614,23627,3828,43301,4819,2378,2441
63120,48918,5614,23628,3828,43304,4819,2378,2441
63125,48919,5614,23628,3828,43305,4819,2378,2441
63130,48924,5614,23630,3828,43310,4819,2378,2441
63135,48926,5614,23631,3828,43312,4819,2378,2441
63140,48934,5614,23638,3828,43320,4819,2378,2441
63145,48937,5614,23640,3828,43323,4819,2378,2441
63150,48942,5614,23641,3828,43328,4819,2378,2441
63155,48946,5614,23642,3828,43332,4819,2378,2441
63160,48949,5614,23642,3828,43335,4819,2378,2441
63165,48950,5614,23643,3828,43336,4819,2378,2441
63170,48955,5614,23647,3828,43341,4819,2378,2441
63175,48957,5614,23649,3828,43343,4819,2378,2441
63180,48965,5614,23651,3828,43351,4819,2378,2441
63185,48968,5614,23653,3828,43354,4819,2378,2441
63190,48973,5614,23654,3828,43359,4819,2378,2441
63195,48977,5614,23656,3828,43363,4819,2378,2441
63200,48980,5614,23656,3828,43366,4819,2378,2441
63205,48981,5614,23656,3828,43367,4819,2378,2441
63210,48986,5614,23657,3828,43372,4819,2378,2441
63215,48988,5614,23657,3828,43374,4819,2378,2441
63220,48996,5614,23661,3828,43382,4819,2378,2441
63225,48999,5614,23662,3828,43385,4819,2378,2441
63230,49004,5614,23665,3828,43390,4819,2378,2441
63235,49008,5614,23669,3828,43394,4819,2378,2441
63240,49011,5614,23672,3828,43397,4819,2378,2441
63245,49012,5614,23673,3828,43398,4819,2378,2441
63250,49017,5614,23677,3828,43403,4819,2378,2441
63255,49019,5614,23679,3828,43405,4819,2378,2441
63260,49027,5614,23681,3828,43413,4819,2378,2441
63265,49030,5614,23683,3828,43416,4819,2378,2441
63270,49035,5614,23685,3828,43421,4819,2378,2441
63275,49039,5614,23686,3828,43425,4819,2378,2441
63280,49042,5614,23688,3828,43428,4819,2378,2441
63285,49043,5614,23688,3828,43429,4819,2378,2441
63290,49048,5614,23693,3828,43434,4819,2378,2441
63295,49050,5614,23694,3828,43436,4819,2378,2441
63300,49058,5614,23700,3828,43444,4819,2378,2441
63305,49061,5614,23702,3828,43447,4819,2378,2441
63310,49066,5614,23704,3828,43452,4819,2378,2441
63315,49070,5614,23705,3828,43456,4819,2378,2441
63320,49073,5614,23706,3828,43459,4819,2378,2441
63325,49074,5614,23706,3828,43460,4819,2378,2441
63330,49079,5614,23709,3828,43465,4819,2378,2441
63335,49081,5614,23710,3828,43467,4819,2378,2441
63340,49089,5614,23715,3828,43475,4819,2378,2441
63345,49092,5614,23716,3828,43478,4819,2378,2441
63350,49097,5614,23720,3828,43483,4819,2378,2441
63355,49101,5614,23723,3828,43487,4819,2378,2441
63360,49104,5614,23725,3828,43490,4819,2378,2441
63365,49105,5614,23725,3828,43491,4819,2378,2441
63370,49110,5614,23727,3828,43496,4819,2378,2441
63375,49112,5614,23729,3828,43498,4819,2378,2441
63380,49120,5614,23733,3828,43506,4819,2378,2441
63385,49123,5614,23734,3828,43509,4819,2378,2441
63390,49128,5614,23737,3828,43514,4819,2378,2441
63395,49132,5614,23739,3828,43518,4819,2378,2441
63400,49135,5614,23740,3828,43521,4819,2378,2441
63405,49136,5614,23741,3828,43522,4819,2378,2441
63410,49141,5614,23743,3828,43527,4819,2378,2441
63415,49143,5614,23743,3828,43529,4819,2378,2441
63420,49151,5614,23748,3828,43537,4819,2378,2441
63425,49154,5614,23749,3828,43540,4819,2378,2441
63430,49159,5614,23753,3828,43545,4819,2378,2441
63435,49163,5614,23757,3828,43549,4819,2378,2441
63440,49166,5614,23760,3828,43552,4819,2378,2441
63445,49167,5614,23761,3828,43553,4819,2378,2441
63450,49172,5614,23762,3828,43558,4819,2378,2441
63455,49174,5614,23762,3828,43560,4819,2378,2441
63460,49182,5614,23764,3828,43568,4819,2378,2441
63465,49185,5614,23766,3828,43571,4819,2378,2441
63470,49190,5614,23769,3828,43576,4819,2378,2441
63475,49194,5614,23770,3828,43580,4819,2378,2441
63480,49197,5614,23770,3828,43583,4819,2378,2441
63485,49198,5614,23770,3828,43584,4819,2378,2441
63490,49203,5614,23772,3828,43589,4819,2378,2441
63495,49205,5614,23774,3828,43591,4819,2378,2441
63500,49213,5614,23776,3828,43599,4819,2378,2441
63505,49216,5614,23777,3828,43602,4819,2378,2441
63510,49221,5614,23781,3828,43607,4819,2378,2441
63515,49225,5614,23784,3828,43611,4819,2378,2441
63520,49228,5614,23786,3828,43614,4819,2378,2441
63525,49229,5614,23786,3828,43615,4819,2378,2441
63530,49234,5614,23790,3828,43620,4819,2378,2441
63535,49236,5614,23792,3828,43622,4819,2378,2441
63540,49244,5614,23796,3828,43630,4819,2378,2441
63545,49247,5614,23796,3828,43633,4819,2378,2441
63550,49252,5614,23797,3828,43638,4819,2378,2441
63555,49256,5614,23799,3828,43642,4819,2378,2441
63560,49259,5614,23802,3828,43645,4819,2378,2441
63565,49260,5614,23803,3828,43646,4819,2378,2441
63570,49265,5614,23806,3828,43651,4819,2378,2441
63575,49267,5614,23806,3828,43653,4819,2378,2441
63580,49275,5614,23811,3828,43661,4819,2378,2441
63585,49278,5614,23812,3828,43664,4819,2378,2441
63590,49283,5614,23815,3828,43669,4819,2378,2441
63595,49287,5614,23816,3828,43673,4819,2378,2441
63600,49290,5614,23817,3828,43676,4819,2378,2441
63605,49291,5614,23817,3828,43677,4819,2378,2441
63610,49296,5614,23820,3828,43682,4819,2378,2441
63615,49298,5614,23820,3828,43684,4819,2378,2441
63620,49306,5614,23823,3828,43692,4819,2378,2441
63625,49309,5614,23825,3828,43695,4819,2378,2441
63630,49314,5614,23827,3828,43700,4819,2378,2441
63635,49318,5614,23828,3828,43704,4819,2378,2441
63640,49321,5614,23830,3828,43707,4819,2378,2441
63645,49322,5614,23831,3828,43708,4819,2378,2441
63650,49327,5614,23833,3828,43713,4819,2378,2441
63655,49329,5614,23833,3828,43715,4819,2378,2441
63660,49337,5614,23835,3828,43723,4819,2378,2441
63665,49340,5614,23837,3828,43726,4819,2378,2441
63670,49345,5614,23839,3828,43731,4819,2378,2441
63675,49349,5614,23840,3828,43735,4819,2378,2441
63680,49352,5614,23842,3828,43738,4819,2378,2441
63685,49353,5614,23842,3828,43739,4819,2378,2441
63690,49358,5614,23845,3828,43744,4819,2378,2441
63695,49360,5614,23847,3828,43746,4819,2378,2441
63700,49368,5614,23850,3828,43754,4819,2378,2441
63705,49371,5614,23852,3828,43757,4819,2378,2441
63710,49376,5614,23855,3828,43762,4819,2378,2441
63715,49380,5614,23858,3828,43766,4819,2378,2441
63720,49383,5614,23860,3828,43769,4819,2378,2441
63725,49384,5614,23860,3828,43770,4819,2378,2441
63730,49389,5614,23864,3828,43775,4819,2378,2441
63735,49391,5614,23864,3828,43777,4819,2378,2441
63740,49399,5614,23869,3828,43785,4819,2378,2441
63745,49402,5614,23869,3828,43788,4819,2378,2441
63750,49407,5614,23873,3828,43793,4819,2378,2441
63755,49411,5614,23876,3828,43797,4819,2378,2441
63760,49414,5614,23876,3828,43800,4819,2378,2441
63765,49415,5614,23877,3828,43801,4819,2378,2441
63770,49420,5614,23881,3828,43806,4819,2378,2441
63775,49422,5614,23883,3828,43808,4819,2378,2441
63780,49430,5614,23884,3828,43816,4819,2378,2441
63785,49433,5614,23886,3828,43819,4819,2378,2441
63790,49438,5614,23888,3828,43824,4819,2378,2441
63795,49442,5614,23890,3828,43828,4819,2378,2441
63800,49445,5614,23892,3828,43831,4819,2378,2441
63805,49446,5614,23893,3828,43832,4819,2378,2441
63810,49451,5614,23894,3828,43837,4819,2378,2441
63815,49453,5614,23895,3828,43839,4819,2378,2441
63820,49461,5614,23899,3828,43847,4819,2378,2441
63825,49464,5614,23901,3828,43850,4819,2378,2441
63830,49469,5614,23902,3828,43855,4819,2378,2441
63835,49473,5614,23903,3828,43859,4819,2378,2441
63840,49476,5614,23904,3828,43862,4819,2378,2441
63845,49477,5614,23904,3828,43863,4819,2378,2441
63850,49482,5614,23908,3828,43868,4819,2378,2441
63855,49484,5614,23909,3828,43870,4819,2378,2441
63860,49492,5614,23912,3828,43878,4819,2378,2441
63865,49495,5614,23913,3828,43881,4819,2378,2441
63870,49500,5614,23916,3828,43886,4819,2378,2441
63875,49504,5614,23918,3828,43890,4819,2378,2441
63880,49507,5614,23920,3828,43893,4819,2378,2441
63885,49508,5614,23921,3828,43894,4819,2378,2441
63890,49513,5614,23923,3828,43899,4819,2378,2441
63895,49515,5614,23923,3828,43901,4819,2378,2441
63900,49523,5614,23928,3828,43909,4819,2378,2441
63905,49526,5614,23930,3828,43912,4819,2378,2441
63910,49531,5614,23930,3828,43917,4819,2378,2441
63915,49535,5614,23931,3828,43921,4819,2378,2441
63920,49538,5614,23932,3828,43924,4819,2378,2441
63925,49539,5614,23933,3828,43925,4819,2378,2441
63930,49544,5614,23937,3828,43930,4819,2378,2441
63935,49546,5614,23939,3828,43932,4819,2378,2441
63940,49554,5614,23942,3828,43940,4819,2378,2441
63945,49557,5614,23944,3828,43943,4819,2378,2441
63950,49562,5614,23945,3828,43948,4819,2378,2441
63955,49566,5614,23947,3828,43952,4819,2378,2441
63960,49569,5614,23948,3828,43955,4819,2378,2441
63965,49570,5614,23948,3828,43956,4819,2378,2441
63970,49575,5614,23950,3828,43961,4819,2378,2441
63975,49577,5614,23950,3828,43963,4819,2378,2441
63980,49585,5614,23954,3828,43971,4819,2378,2441
63985,49588,5614,23955,3828,43974,4819,2378,2441
63990,49593,5614,23959,3828,43979,4819,2378,2441
63995,49597,5614,23963,3828,43983,4819,2378,2441
64000,49600,5614,23965,3828,43986,4819,2378,2441
64005,49601,5614,23965,3828,43987,4819,2378,2441
64010,49606,5614,23968,3828,43992,4819,2378,2441
64015,49608,5614,23969,3828,43994,4819,2378,2441
64020,49616,5614,23971,3828,44002,4819,2378,2441
64025,49619,5614,23972,3828,44005,4819,2378,2441
64030,49624,5614,23976,3828,44010,4819,2378,2441
64035,49628,5614,23977,3828,44014,4819,2378,2441
64040,49631,5614,23979,3828,44017,4819,2378,2441
64045,49632,5614,23980,3828,44018,4819,2378,2441
64050,49637,5614,23982,3828,44023,4819,2378,2441
64055,49639,5614,23982,3828,44025,4819,2378,2441
64060,49647,5614,23985,3828,44033,4819,2378,2441
64065,49650,5614,23987,3828,44036,4819,2378,2441
64070,49655,5614,23991,3828,44041,4819,2378,2441
64075,49659,5614,23992,3828,44045,4819,2378,2441
64080,49662,5614,23993,3828,44048,4819,2378,2441
64085,49663,5614,23994,3828,44049,4819,2378,2441
64090,49668,5614,23998,3828,44054,4819,2378,2441
64095,49670,5614,23999,3828,44056,4819,2378,2441
64100,49678,5614,24004,3828,44064,4819,2378,2441
64105,49681,5614,24006,3828,44067,4819,2378,2441
64110,49686,5614,24008,3828,44072,4819,2378,2441
64115,49690,5614,24010,3828,44076,4819,2378,2441
64120,49693,5614,24012,3828,44079,4819,2378,2441
64125,49694,5614,24013,3828,44080,4819,2378,2441
64130,49699,5614,24015,3828,44085,4819,2378,2441
64135,49701,5614,24017,3828,44087,4819,2378,2441
64140,49709,5614,24022,3828,44095,4819,2378,2441
64145,49712,5614,24023,3828,44098,4819,2378,2441
64150,49717,5614,24024,3828,44103,4819,2378,2441
64155,49721,5614,24026,3828,44107,4819,2378,2441
64160,49724,5614,24028,3828,44110,4819,2378,2441
64165,49725,5614,24028,3828,44111,4819,2378,2441
64170,49730,5614,24030,3828,44116,4819,2378,2441
64175,49732,5614,24031,3828,44118,4819,2378,2441
64180,49740,5614,24035,3828,44126,4819,2378,2441
64185,49743,5614,24036,3828,44129,4819,2378,2441
64190,49748,5614,24038,3828,44134,4819,2378,2441
64195,49752,5614,24040,3828,44138,4819,2378,2441
64200,49755,5614,24040,3828,44141,4819,2378,2441
64205,49756,5614,24040,3828,44142,4819,2378,2441
64210,49761,5614,24042,3828,44147,4819,2378,2441
64215,49763,5614,24044,3828,44149,4819,2378,2441
64220,49771,5614,24045,3828,44157,4819,2378,2441
64225,49774,5614,24048,3828,44160,4819,2378,2441
64230,49779,5614,24050,3828,44165,4819,2378,2441
64235,49783,5614,24053,3828,44169,4819,2378,2441
64240,49786,5614,24054,3828,44172,4819,2378,2441
64245,49787,5614,24055,3828,44173,4819,2378,2441
64250,49792,5614,24058,3828,44178,4819,2378,2441
64255,49794,5614,24059,3828,44180,4819,2378,2441
64260,49802,5614,24063,3828,44188,4819,2378,2441
64265,49805,5614,24065,3828,44191,4819,2378,2441
64270,49810,5614,24067,3828,44196,4819,2378,2441
64275,49814,5614,24067,3828,44200,4819,2378,2441
64280,49817,5614,24069,3828,44203,4819,2378,2441
64285,49818,5614,24069,3828,44204,4819,2378,2441
64290,49823,5614,24072,3828,44209,4819,2378,2441
64295,49825,5614,24074,3828,44211,4819,2378,2441
64300,49833,5614,24076,3828,44219,4819,2378,2441
64305,49836,5614,24078,3828,44222,4819,2378,2441
64310,49841,5614,24081,3828,44227,4819,2378,2441
64315,49845,5614,24082,3828,44231,4819,2378,2441
64320,49848,5614,24083,3828,44234,4819,2378,2441
64325,49849,5614,24083,3828,44235,4819,2378,2441
64330,49854,5614,24086,3828,44240,4819,2378,2441
64335,49856,5614,24086,3828,44242,4819,2378,2441
64340,49864,5614,24087,3828,44250,4819,2378,2441
64345,49867,5614,24088,3828,44253,4819,2378,2441
64350,49872,5614,24091,3828,44258,4819,2378,2441
64355,49876,5614,24092,3828,44262,4819,2378,2441
64360,49879,5614,24092,3828,44265,4819,2378,2441
64365,49880,5614,24092,3828,44266,4819,2378,2441
64370,49885,5614,24096,3828,44271,4819,2378,2441
64375,49887,5614,24097,3828,44273,4819,2378,2441
64380,49895,5614,24102,3828,44281,4819,2378,2441
64385,49898,5614,24103,3828,44284,4819,2378,2441
64390,49903,5614,24104,3828,44289,4819,2378,2441
64395,49907,5614,24107,3828,44293,4819,2378,2441
64400,49910,5614,24108,3828,44296,4819,2378,2441
64405,49911,5614,24108,3828,44297,4819,2378,2441
64410,49916,5614,24110,3828,44302,4819,2378,2441
64415,49918,5614,24112,3828,44304,4819,2378,2441
64420,49926,5614,24117,3828,44312,4819,2378,2441
64425,49929,5614,24118,3828,44315,4819,2378,2441
64430,49934,5614,24120,3828,44320,4819,2378,2441
64435,49938,5614,24123,3828,44324,4819,2378,2441
64440,49941,5614,24125,3828,44327,4819,2378,2441
64445,49942,5614,24125,3828,44328,4819,2378,2441
64450,49947,5614,24128,3828,44333,4819,2378,2441
64455,49949,5614,24129,3828,44335,4819,2378,2441
64460,49957,5614,24134,3828,44343,4819,2378,2441
64465,49960,5614,24137,3828,44346,4819,2378,2441
64470,49965,5614,24140,3828,44351,4819,2378,2441
64475,49969,5614,24141,3828,44355,4819,2378,2441
64480,49972,5614,24142,3828,44358,4819,2378,2441
64485,49973,5614,24142,3828,44359,4819,2378,2441
64490,49978,5614,24145,3828,44364,4819,2378,2441
64495,49980,5614,24147,3828,44366,4819,2378,2441
64500,49988,5614,24150,3828,44374,4819,2378,2441
64505,49991,5614,24151,3828,44377,4819,2378,2441
64510,49996,5614,24152,3828,44382,4819,2378,2441
64515,50000,5614,24152,3828,44386,4819,2378,2441
64520,50003,5614,24154,3828,44389,4819,2378,2441
64525,50004,5614,24155,3828,44390,4819,2378,2441
64530,50009,5614,24159,3828,44395,4819,2378,2441
64535,50011,5614,24159,3828,44397,4819,2378,2441
64540,50019,5614,24163,3828,44405,4819,2378,2441
64545,50022,5614,24164,3828,44408,4819,2378,2441
64550,50027,5614,24166,3828,44413,4819,2378,2441
64555,50031,5614,24168,3828,44417,4819,2378,2441
64560,50034,5614,24168,3828,44420,4819,2378,2441
64565,50035,5614,24169,3828,44421,4819,2378,2441
64570,50040,5614,24169,3828,44426,4819,2378,2441
64575,50042,5614,24169,3828,44428,4819,2378,2441
64580,50050,5614,24173,3828,44436,4819,2378,2441
64585,50053,5614,24174,3828,44439,4819,2378,2441
64590,50058,5614,24177,3828,44444,4819,2378,2441
64595,50062,5614,24179,3828,44448,4819,2378,2441
64600,50065,5614,24179,3828,44451,4819,2378,2441
64605,50066,5614,24180,3828,44452,4819,2378,2441
64610,50071,5614,24181,3828,44457,4819,2378,2441
64615,50073,5614,24183,3828,44459,4819,2378,2441
64620,50081,5614,24185,3828,44467,4819,2378,2441
64625,50084,5614,24187,3828,44470,4819,2378,2441
64630,50089,5614,24187,3828,44475,4819,2378,2441
64635,50093,5614,24190,3828,44479,4819,2378,2441
64640,50096,5614,24191,3828,44482,4819,2378,2441
64645,50097,5614,24191,3828,44483,4819,2378,2441
64650,50102,5614,24193,3828,44488,4819,2378,2441
64655,50104,5614,24194,3828,44490,4819,2378,2441
64660,50112,5614,24196,3828,44498,4819,2378,2441
64665,50115,5614,24197,3828,44501,4819,2378,2441
64670,50120,5614,24199,3828,44506,4819,2378,2441
64675,50124,5614,24201,3828,44510,4819,2378,2441
64680,50127,5614,24203,3828,44513,4819,2378,2441
64685,50128,5614,24204,3828,44514,4819,2378,2441
64690,50133,5614,24207,3828,44519,4819,2378,2441
64695,50135,5614,24208,3828,44521,4819,2378,2441
64700,50143,5614,24213,3828,44529,4819,2378,2441
64705,50146,5614,24215,3828,44532,4819,2378,2441
64710,50151,5614,24216,3828,44537,4819,2378,2441
64715,50155,5614,24218,3828,44541,4819,2378,2441
64720,50158,5614,24220,3828,44544,4819,2378,2441
64725,50159,5614,24221,3828,44545,4819,2378,2441
64730,50164,5614,24224,3828,44550,4819,2378,2441
64735,50166,5614,24225,3828,44552,4819,2378,2441
64740,50174,5614,24227,3828,44560,4819,2378,2441
64745,50177,5614,24228,3828,44563,4819,2378,2441
64750,50182,5614,24229,3828,44568,4819,2378,2441
64755,50186,5614,24231,3828,44572,4819,2378,2441
64760,50189,5614,24232,3828,44575,4819,2378,2441
64765,50190,5614,24232,3828,44576,4819,2378,2441
64770,50195,5614,24235,3828,44581,4819,2378,2441
64775,50197,5614,24236,3828,44583,4819,2378,2441
64780,50205,5614,24239,3828,44591,4819,2378,2441
64785,50208,5614,24241,3828,44594,4819,2378,2441
64790,50213,5614,24241,3828,44599,4819,2378,2441
64795,50217,5614,24242,3828,44603,4819,2378,2441
64800,50220,5614,24244,3828,44606,4819,2378,2441
64805,50221,5614,24245,3828,44607,4819,2378,2441
64810,50226,5614,24249,3828,44612,4819,2378,2441
64815,50228,5614,24250,3828,44614,4819,2378,2441
64820,50236,5614,24254,3828,44622,4819,2378,2441
64825,50239,5614,24256,3828,44625,4819,2378,2441
64830,50244,5614,24259,3828,44630,4819,2378,2441
64835,50248,5614,24262,3828,44634,4819,2378,2441
64840,50251,5614,24265,3828,44637,4819,2378,2441
64845,50252,5614,24265,3828,44638,4819,2378,2441
64850,50257,5614,24269,3828,44643,4819,2378,2441
64855,50259,5614,24270,3828,44645,4819,2378,2441
64860,50267,5614,24274,3828,44653,4819,2378,2441
64865,50270,5614,24275,3828,44656,4819,2378,2441
64870,50275,5614,24279,3828,44661,4819,2378,2441
64875,50279,5614,24281,3828,44665,4819,2378,2441
64880,50282,5614,24282,3828,44668,4819,2378,2441
64885,50283,5614,24283,3828,44669,4819,2378,2441
64890,50288,5614,24285,3828,44674,4819,2378,2441
64895,50290,5614,24287,3828,44676,4819,2378,2441
64900,50298,5614,24289,3828,44684,4819,2378,2441
64905,50301,5614,24290,3828,44687,4819,2378,2441
64910,50306,5614,24292,3828,44692,4819,2378,2441
64915,50310,5614,24296,3828,44696,4819,2378,2441
64920,50313,5614,24297,3828,44699,4819,2378,2441
64925,50314,5614,24298,3828,44700,4819,2378,2441
64930,50319,5614,24301,3828,44705,4819,2378,2441
64935,50321,5614,24302,3828,44707,4819,2378,2441
64940,50329,5614,24304,3828,44715,4819,2378,2441
64945,50332,5614,24306,3828,44718,4819,2378,2441
64950,50337,5614,24310,3828,44723,4819,2378,2441
64955,50341,5614,24311,3828,44727,4819,2378,2441
64960,50344,5614,24312,3828,44730,4819,2378,2441
64965,50345,5614,24312,3828,44731,4819,2378,2441
64970,50350,5614,24314,3828,44736,4819,2378,2441
64975,50352,5614,24316,3828,44738,4819,2378,2441
64980,50360,5614,24320,3828,44746,4819,2378,2441
64985,50363,5614,24322,3828,44749,4819,2378,2441
64990,50368,5614,24324,3828,44754,4819,2378,2441
64995,50372,5614,24327,3828,44758,4819,2378,2441
65000,50375,5614,24328,3828,44761,4819,2378,2441
65005,50376,5614,24329,3828,44762,4819,2378,2441
65010,50381,5614,24332,3828,44767,4819,2378,2441
65015,50383,5614,24333,3828,44769,4819,2378,2441
65020,50391,5614,24336,3828,44777,4819,2378,2441
65025,50394,5614,24338,3828,44780,4819,2378,2441
65030,50399,5614,24340,3828,44785,4819,2378,2441
65035,50403,5614,24342,3828,44789,4819,2378,2441
65040,50406,5614,24343,3828,44792,4819,2378,2441
65045,50407,5614,24343,3828,44793,4819,2378,2441
65050,50412,5614,24347,3828,44798,4819,2378,2441
65055,50414,5614,24349,3828,44800,4819,2378,2441
65060,50422,5614,24352,3828,44808,4819,2378,2441
65065,50425,5614,24353,3828,44811,4819,2378,2441
65070,50430,5614,24357,3828,44816,4819,2378,2441
65075,50434,5614,24358,3828,44820,4819,2378,2441
65080,50437,5614,24360,3828,44823,4819,2378,2441
65085,50438,5614,24361,3828,44824,4819,2378,2441
65090,50443,5614,24363,3828,44829,4819,2378,2441
65095,50445,5614,24364,3828,44831,4819,2378,2441
65100,50453,5614,24369,3828,44839,4819,2378,2441
65105,50456,5614,24370,3828,44842,4819,2378,2441
65110,50461,5614,24373,3828,44847,4819,2378,2441
65115,50465,5614,24375,3828,44851,4819,2378,2441
65120,50468,5614,24377,3828,44854,4819,2378,2441
65125,50469,5614,24378,3828,44855,4819,2378,2441
65130,50474,5614,24380,3828,44860,4819,2378,2441
65135,50476,5614,24381,3828,44862,4819,2378,2441
65140,50484,5614,24384,3828,44870,4819,2378,2441
65145,50487,5614,24386,3828,44873,4819,2378,2441
65150,50492,5614,24386,3828,44878,4819,2378,2441
65155,50496,5614,24389,3828,44882,4819,2378,2441
65160,50499,5614,24391,3828,44885,4819,2378,2441
65165,50500,5614,24391,3828,44886,4819,2378,2441
65170,50505,5614,24395,3828,44891,4819,2378,2441
65175,50507,5614,24395,3828,44893,4819,2378,2441
65180,50515,5614,24397,3828,44901,4819,2378,2441
65185,50518,5614,24397,3828,44904,4819,2378,2441
65190,50523,5614,24399,3828,44909,4819,2378,2441
65195,50527,5614,24400,3828,44913,4819,2378,2441
65200,50530,5614,24402,3828,44916,4819,2378,2441
65205,50531,5614,24402,3828,44917,4819,2378,2441
65210,50536,5614,24403,3828,44922,4819,2378,2441
65215,50538,5614,24404,3828,44924,4819,2378,2441
65220,50546,5614,24408,3828,44932,4819,2378,2441
65225,50549,5614,24409,3828,44935,4819,2378,2441
65230,50554,5614,24411,3828,44940,4819,2378,2441
65235,50558,5614,24412,3828,44944,4819,2378,2441
65240,50561,5614,24414,3828,44947,4819,2378,2441
65245,50562,5614,24414,3828,44948,4819,2378,2441
65250,50567,5614,24417,3828,44953,4819,2378,2441
65255,50569,5614,24418,3828,44955,4819,2378,2441
65260,50577,5614,24419,3828,44963,4819,2378,2441
65265,50580,5614,24421,3828,44966,4819,2378,2441
65270,50585,5614,24423,3828,44971,4819,2378,2441
65275,50589,5614,24425,3828,44975,4819,2378,2441
65280,50592,5614,24426,3828,44978,4819,2378,2441
65285,50593,5614,24427,3828,44979,4819,2378,2441
65290,50598,5614,24429,3828,44984,4819,2378,2441
65295,50600,5614,24430,3828,44986,4819,2378,2441
65300,50608,5614,24436,3828,44994,4819,2378,2441
65305,50611,5614,24439,3828,44997,4819,2378,2441
65310,50616,5614,24443,3828,45002,4819,2378,2441
65315,50620,5614,24444,3828,45006,4819,2378,2441
65320,50623,5614,24445,3828,45009,4819,2378,2441
65325,50624,5614,24446,3828,45010,4819,2378,2441
65330,50629,5614,24447,3828,45015,4819,2378,2441
65335,50631,5614,24447,3828,45017,4819,2378,2441
65340,50639,5614,24450,3828,45025,4819,2378,2441
65345,50642,5614,24451,3828,45028,4819,2378,2441
65350,50647,5614,24454,3828,45033,4819,2378,2441
65355,50651,5614,24456,3828,45037,4819,2378,2441
65360,50654,5614,24457,3828,45040,4819,2378,2441
65365,50655,5614,24457,3828,45041,4819,2378,2441
65370,50660,5614,24460,3828,45046,4819,2378,2441
65375,50662,5614,24462,3828,45048,4819,2378,2441
65380,50670,5614,24466,3828,45056,4819,2378,2441
65385,50673,5614,24467,3828,45059,4819,2378,2441
65390,50678,5614,24469,3828,45064,4819,2378,2441
65395,50682,5614,24473,3828,45068,4819,2378,2441
65400,50685,5614,24475,3828,45071,4819,2378,2441
65405,50686,5614,24476,3828,45072,4819,2378,2441
65410,50691,5614,24477,3828,45077,4819,2378,2441
65415,50693,5614,24477,3828,45079,4819,2378,2441
65420,50701,5614,24481,3828,45087,4819,2378,2441
65425,50704,5614,24483,3828,45090,4819,2378,2441
65430,50709,5614,24485,3828,45095,4819,2378,2441
65435,50713,5614,24488,3828,45099,4819,2378,2441
65440,50716,5614,24490,3828,45102,4819,2378,2441
65445,50717,5614,24490,3828,45103,4819,2378,2441
65450,50722,5614,24494,3828,45108,4819,2378,2441
65455,50724,5614,24495,3828,45110,4819,2378,2441
65460,50732,5614,24501,3828,45118,4819,2378,2441
65465,50735,5614,24502,3828,45121,4819,2378,2441
65470,50740,5614,24504,3828,45126,4819,2378,2441
65475,50744,5614,24508,3828,45130,4819,2378,2441
65480,50747,5614,24510,3828,45133,4819,2378,2441
65485,50748,5614,24510,3828,45134,4819,2378,2441
65490,50753,5614,24512,3828,45139,4819,2378,2441
65495,50755,5614,24512,3828,45141,4819,2378,2441
65500,50763,5614,24514,3828,45149,4819,2378,2441
65505,50766,5614,24514,3828,45152,4819,2378,2441
65510,50771,5614,24516,3828,45157,4819,2378,2441
65515,50775,5614,24518,3828,45161,4819,2378,2441
65520,50778,5614,24519,3828,45164,4819,2378,2441
65525,50779,5614,24519,3828,45165,4819,2378,2441
65530,50784,5614,24522,3828,45170,4819,2378,2441
65535,50786,5614,24522,3828,45172,4819,2378,2441
65540,50794,5614,24526,3828,45180,4819,2378,2441
65545,50797,5614,24528,3828,45183,4819,2378,2441
65550,50802,5614,24531,3828,45188,4819,2378,2441
65555,50806,5614,24533,3828,45192,4819,2378,2441
