Time,  Packets Generated,  Packets Reached,High Priority Packets Generated, High Priority Packets reached, Packet Dropped, Packet Dropped due to Faulty Node, High Prio Packet Dropped due to Faulty Node, Low Prio Packet Dropped due to Faulty Node 
5,1,1,1,1,0,0,0,0
10,6,4,5,3,2,2,2,0
15,8,4,6,3,3,3,3,0
20,16,8,10,4,4,4,4,0
25,20,14,11,7,5,5,4,1
30,30,22,16,10,8,8,6,2
35,36,22,19,10,11,11,8,3
40,47,29,23,13,14,14,9,5
45,51,35,27,16,15,15,10,5
50,61,43,30,19,18,18,11,7
55,67,43,32,19,21,21,13,8
60,78,50,36,21,24,24,14,10
65,82,56,37,22,24,24,14,10
70,92,65,43,27,25,25,14,11
75,98,68,44,29,27,27,15,12
80,109,76,50,32,28,28,16,12
85,113,83,54,36,28,28,16,12
90,123,92,59,42,30,29,17,12
95,129,94,63,43,32,31,18,13
100,140,100,68,47,36,32,19,13
105,144,105,70,50,37,32,19,13
110,154,112,75,55,41,33,20,13
115,160,114,79,56,44,35,22,13
120,171,119,85,60,47,36,22,14
125,175,124,88,64,49,36,22,14
130,185,130,94,70,54,37,23,14
135,191,131,95,70,59,40,24,16
140,202,136,101,72,62,41,24,17
145,206,141,104,77,63,41,24,17
150,216,146,107,81,69,43,24,19
155,222,148,110,82,72,46,25,21
160,233,153,113,84,77,47,26,21
165,237,156,115,86,79,47,26,21
170,247,160,120,89,85,49,27,22
175,253,163,123,91,88,52,29,23
180,264,169,131,95,90,53,29,24
185,268,172,132,98,95,53,29,24
190,278,176,137,102,101,54,29,25
195,284,177,138,103,106,56,29,27
200,295,180,144,106,114,57,30,27
205,299,181,145,107,117,57,30,27
210,309,184,151,109,123,58,31,27
215,315,187,156,112,125,60,32,28
220,326,191,161,116,133,61,33,28
225,330,192,163,117,136,61,33,28
230,340,197,170,122,141,62,34,28
235,346,199,172,124,146,64,35,29
240,357,199,177,124,157,67,38,29
245,361,200,178,125,161,67,38,29
250,371,201,183,125,170,68,38,30
255,377,201,186,125,176,70,40,30
260,388,202,193,126,186,71,40,31
265,392,202,194,126,190,71,40,31
270,402,203,200,127,199,71,40,31
275,408,203,200,127,205,73,40,33
280,419,203,205,127,216,74,41,33
285,423,203,206,127,220,74,41,33
290,433,204,210,127,229,74,41,33
295,439,204,212,127,235,76,42,34
300,450,204,218,127,246,77,43,34
305,454,204,221,127,250,77,43,34
310,464,205,223,127,259,77,43,34
315,470,205,225,127,264,79,44,35
320,481,207,227,129,274,80,44,36
325,485,207,228,129,278,80,44,36
330,495,207,231,129,288,80,44,36
335,501,207,234,129,294,82,44,38
340,512,207,241,129,305,83,45,38
345,516,207,242,129,309,83,45,38
350,526,208,245,129,317,83,45,38
355,532,208,247,129,323,85,45,40
360,543,213,252,133,328,86,45,41
365,547,214,253,134,333,86,45,41
370,557,214,255,134,343,86,45,41
375,563,214,257,134,349,87,46,41
380,574,216,261,135,358,88,46,42
385,578,216,264,135,362,88,46,42
390,588,216,270,135,372,88,46,42
395,594,216,274,135,378,89,47,42
400,605,219,281,138,386,90,47,43
405,609,219,283,138,390,90,47,43
410,619,219,286,138,400,90,47,43
415,625,219,290,138,406,91,47,44
420,636,220,296,139,416,92,47,45
425,640,220,297,139,420,92,47,45
430,650,220,302,139,430,92,47,45
435,656,220,306,139,436,93,47,46
440,667,220,312,139,447,94,48,46
445,671,220,315,139,451,94,48,46
450,681,220,322,139,461,94,48,46
455,687,220,325,139,467,95,48,47
460,698,220,333,139,478,96,48,48
465,702,220,335,139,482,96,48,48
470,712,223,340,140,487,97,49,48
475,718,225,344,142,491,99,51,48
480,729,229,350,146,497,100,51,49
485,733,230,353,147,503,100,51,49
490,743,231,357,148,512,101,51,50
495,749,231,360,148,518,103,52,51
500,760,232,365,149,527,103,52,51
505,764,233,368,150,531,103,52,51
510,774,234,374,150,540,103,52,51
515,780,234,375,150,545,104,52,52
520,791,236,380,152,554,104,52,52
525,795,237,381,153,558,104,52,52
530,805,238,384,154,567,104,52,52
535,811,238,385,154,573,106,53,53
540,822,239,389,154,583,106,53,53
545,826,239,390,154,587,106,53,53
550,836,240,392,154,596,106,53,53
555,842,240,396,154,602,107,54,53
560,853,242,401,155,611,107,54,53
565,857,242,402,155,615,107,54,53
570,867,243,407,155,624,107,54,53
575,873,243,410,155,630,108,54,54
580,884,244,417,156,640,108,54,54
585,888,244,418,156,644,108,54,54
590,898,246,422,158,650,108,54,54
595,904,249,425,161,654,110,55,55
600,915,252,431,163,659,111,56,55
605,919,254,433,165,665,111,56,55
610,929,255,437,166,674,111,56,55
615,935,255,440,166,679,112,57,55
620,946,257,446,168,689,112,57,55
625,950,257,448,168,693,112,57,55
630,960,258,454,169,702,112,57,55
635,966,258,458,169,708,113,58,55
640,977,259,461,169,718,113,58,55
645,981,259,462,169,722,113,58,55
650,991,260,467,170,731,113,58,55
655,997,260,471,170,736,114,59,55
660,1008,262,478,171,746,114,59,55
665,1012,262,479,171,750,114,59,55
670,1022,264,483,173,758,114,59,55
675,1028,264,486,173,763,115,60,55
680,1039,266,492,174,773,115,60,55
685,1043,266,494,174,777,115,60,55
690,1053,268,497,174,785,115,60,55
695,1059,268,501,174,790,116,61,55
700,1070,270,509,176,800,116,61,55
705,1074,270,511,176,804,116,61,55
710,1084,272,515,176,810,117,61,56
715,1090,274,515,178,816,119,61,58
720,1101,276,520,180,824,120,62,58
725,1105,276,523,180,829,120,62,58
730,1115,276,527,180,839,121,63,58
735,1121,276,533,180,845,123,65,58
740,1132,276,539,180,856,124,66,58
745,1136,276,543,180,860,124,66,58
750,1146,276,548,180,870,125,67,58
755,1152,276,551,180,876,127,68,59
760,1163,276,556,180,887,127,68,59
765,1167,276,560,180,891,127,68,59
770,1177,276,565,180,901,128,68,60
775,1183,276,567,180,907,130,69,61
780,1194,276,571,180,918,130,69,61
785,1198,276,573,180,922,130,69,61
790,1208,276,579,180,932,130,69,61
795,1214,276,581,180,938,131,69,62
800,1225,277,585,181,948,131,69,62
805,1229,278,587,182,951,131,69,62
810,1239,278,593,182,961,131,69,62
815,1245,278,594,182,967,132,69,63
820,1256,279,598,182,977,132,69,63
825,1260,280,600,183,980,132,69,63
830,1270,282,607,184,988,132,69,63
835,1276,282,609,184,994,134,69,65
840,1287,284,615,186,1003,135,69,66
845,1291,284,616,186,1007,135,69,66
850,1301,286,619,186,1015,135,69,66
855,1307,286,622,186,1021,137,69,68
860,1318,287,627,187,1031,137,69,68
865,1322,287,628,187,1035,137,69,68
870,1332,289,631,188,1043,137,69,68
875,1338,289,634,188,1049,139,70,69
880,1349,290,639,189,1059,139,70,69
885,1353,290,640,189,1063,139,70,69
890,1363,292,648,191,1071,139,70,69
895,1369,292,650,191,1077,141,71,70
900,1380,293,656,192,1087,141,71,70
905,1384,293,659,192,1090,141,71,70
910,1394,297,662,195,1097,141,71,70
915,1400,297,665,195,1103,143,73,70
920,1411,298,671,196,1113,143,73,70
925,1415,298,673,196,1117,143,73,70
930,1425,300,678,197,1125,143,73,70
935,1431,300,682,197,1131,144,73,71
940,1442,301,687,197,1141,144,73,71
945,1446,301,689,197,1145,144,73,71
950,1456,303,693,198,1152,144,73,71
955,1462,303,697,198,1158,145,73,72
960,1473,306,701,200,1167,146,74,72
965,1477,306,701,200,1171,146,74,72
970,1487,307,706,201,1180,146,74,72
975,1493,307,710,201,1185,147,75,72
980,1504,309,717,203,1195,147,75,72
985,1508,309,720,203,1199,147,75,72
990,1518,310,726,204,1208,147,75,72
995,1524,310,727,204,1213,148,75,73
1000,1535,312,732,205,1223,148,75,73
1005,1539,312,735,205,1227,148,75,73
1010,1549,313,740,206,1236,149,75,74
1015,1555,313,743,206,1242,150,76,74
1020,1566,314,747,206,1252,151,77,74
1025,1570,316,750,208,1254,151,77,74
1030,1580,317,752,208,1263,151,77,74
1035,1586,317,754,208,1268,152,77,75
1040,1597,319,760,210,1277,152,77,75
1045,1601,321,763,212,1280,152,77,75
1050,1611,322,766,212,1287,152,77,75
1055,1617,324,769,214,1292,153,77,76
1060,1628,326,774,216,1302,153,77,76
1065,1632,327,777,217,1305,153,77,76
1070,1642,328,781,217,1313,154,78,76
1075,1648,329,785,218,1318,155,79,76
1080,1659,332,792,220,1326,156,80,76
1085,1663,333,794,221,1330,156,80,76
1090,1673,334,799,222,1339,156,80,76
1095,1679,334,803,222,1345,157,81,76
1100,1690,334,809,222,1356,158,81,77
1105,1694,334,809,222,1360,158,81,77
1110,1704,335,813,222,1369,158,81,77
1115,1710,335,816,222,1375,159,81,78
1120,1721,335,822,222,1386,160,81,79
1125,1725,335,824,222,1390,160,81,79
1130,1735,336,829,223,1399,160,81,79
1135,1741,336,832,223,1405,161,81,80
1140,1752,336,838,223,1416,162,82,80
1145,1756,336,839,223,1420,162,82,80
1150,1766,339,843,224,1427,162,82,80
1155,1772,339,844,224,1433,163,82,81
1160,1783,340,846,225,1443,163,82,81
1165,1787,340,847,225,1447,163,82,81
1170,1797,341,853,225,1455,163,82,81
1175,1803,342,856,226,1460,164,83,81
1180,1814,345,860,229,1469,164,83,81
1185,1818,345,864,229,1471,164,83,81
1190,1828,348,870,231,1475,165,83,82
1195,1834,349,874,232,1480,167,85,82
1200,1845,355,876,237,1489,167,85,82
1205,1849,356,879,238,1493,167,85,82
1210,1859,356,886,238,1503,167,85,82
1215,1865,356,888,238,1509,168,85,83
1220,1876,358,895,240,1518,168,85,83
1225,1880,358,895,240,1522,168,85,83
1230,1890,358,900,240,1532,168,85,83
1235,1896,358,902,240,1538,169,85,84
1240,1907,361,911,243,1546,169,85,84
1245,1911,362,914,244,1549,169,85,84
1250,1921,362,920,244,1559,169,85,84
1255,1927,362,925,244,1565,170,86,84
1260,1938,363,929,245,1575,171,86,85
1265,1942,363,932,245,1579,171,86,85
1270,1952,364,937,246,1588,171,86,85
1275,1958,364,940,246,1594,172,86,86
1280,1969,364,946,246,1605,172,86,86
1285,1973,365,947,247,1608,172,86,86
1290,1983,366,951,248,1617,172,86,86
1295,1989,366,953,248,1623,173,86,87
1300,2000,366,956,248,1634,173,86,87
1305,2004,367,958,249,1637,173,86,87
1310,2014,368,960,249,1646,173,86,87
1315,2020,368,963,249,1652,175,88,87
1320,2031,368,972,249,1663,175,88,87
1325,2035,368,972,249,1667,175,88,87
1330,2045,369,980,249,1676,175,88,87
1335,2051,369,983,249,1682,176,88,88
1340,2062,369,989,249,1693,176,88,88
1345,2066,369,991,249,1697,176,88,88
1350,2076,370,994,250,1706,176,88,88
1355,2082,370,998,250,1712,177,88,89
1360,2093,370,1006,250,1723,177,88,89
1365,2097,370,1009,250,1727,177,88,89
1370,2107,373,1014,252,1734,177,88,89
1375,2113,373,1016,252,1739,178,89,89
1380,2124,377,1022,255,1746,179,90,89
1385,2128,378,1024,256,1750,179,90,89
1390,2138,380,1027,256,1758,180,90,90
1395,2144,380,1030,256,1764,181,91,90
1400,2155,381,1034,256,1774,181,91,90
1405,2159,381,1037,256,1778,181,91,90
1410,2169,383,1043,257,1786,182,92,90
1415,2175,383,1047,257,1792,183,92,91
1420,2186,384,1051,258,1802,183,92,91
1425,2190,384,1052,258,1806,183,92,91
1430,2200,386,1060,259,1813,184,93,91
1435,2206,386,1064,259,1818,186,94,92
1440,2217,389,1069,262,1825,187,94,93
1445,2221,391,1072,264,1830,187,94,93
1450,2231,393,1077,265,1838,187,94,93
1455,2237,393,1077,265,1844,188,94,94
1460,2248,395,1086,266,1853,188,94,94
1465,2252,396,1090,267,1856,188,94,94
1470,2262,398,1093,269,1864,188,94,94
1475,2268,398,1096,269,1870,189,94,95
1480,2279,400,1100,270,1879,189,94,95
1485,2283,401,1103,271,1882,189,94,95
1490,2293,403,1107,272,1890,189,94,95
1495,2299,403,1110,272,1896,190,95,95
1500,2310,406,1114,274,1904,191,96,95
1505,2314,406,1115,274,1908,191,96,95
1510,2324,406,1118,274,1918,191,96,95
1515,2330,406,1121,274,1924,193,97,96
1520,2341,406,1128,274,1935,193,97,96
1525,2345,406,1131,274,1939,193,97,96
1530,2355,406,1134,274,1949,193,97,96
1535,2361,406,1137,274,1955,195,97,98
1540,2372,406,1143,274,1966,195,97,98
1545,2376,406,1146,274,1970,195,97,98
1550,2386,406,1153,274,1980,196,97,99
1555,2392,406,1154,274,1986,198,97,101
1560,2403,406,1161,274,1995,198,97,101
1565,2407,406,1163,274,2001,198,97,101
1570,2417,406,1169,274,2011,199,98,101
1575,2423,406,1173,274,2017,200,98,102
1580,2434,408,1179,276,2026,200,98,102
1585,2438,408,1180,276,2030,200,98,102
1590,2448,408,1181,276,2040,201,98,103
1595,2454,408,1184,276,2046,202,98,104
1600,2465,409,1188,276,2056,202,98,104
1605,2469,409,1190,276,2060,202,98,104
1610,2479,411,1192,277,2068,203,98,105
1615,2485,411,1195,277,2073,204,99,105
1620,2496,413,1200,278,2082,205,99,106
1625,2500,416,1203,281,2083,205,99,106
1630,2510,419,1210,283,2089,206,100,106
1635,2516,421,1213,285,2095,207,100,107
1640,2527,422,1216,286,2104,208,100,108
1645,2531,422,1218,286,2108,208,100,108
1650,2541,425,1221,288,2116,208,100,108
1655,2547,425,1224,288,2122,209,100,109
1660,2558,426,1230,288,2132,210,100,110
1665,2562,427,1233,289,2134,210,100,110
1670,2572,430,1239,291,2142,210,100,110
1675,2578,430,1242,291,2148,211,100,111
1680,2589,432,1248,292,2157,212,101,111
1685,2593,432,1249,292,2161,212,101,111
1690,2603,434,1253,292,2169,212,101,111
1695,2609,434,1256,292,2175,213,101,112
1700,2620,435,1263,292,2185,213,101,112
1705,2624,436,1264,293,2188,213,101,112
1710,2634,439,1271,296,2195,213,101,112
1715,2640,439,1273,296,2201,214,102,112
1720,2651,440,1280,296,2211,214,102,112
1725,2655,440,1282,296,2215,214,102,112
1730,2665,442,1284,297,2223,214,102,112
1735,2671,443,1286,298,2227,216,102,114
1740,2682,446,1290,301,2236,217,103,114
1745,2686,448,1293,303,2238,217,103,114
1750,2696,449,1297,303,2247,217,103,114
1755,2702,449,1299,303,2253,218,103,115
1760,2713,449,1303,303,2264,218,103,115
1765,2717,449,1304,303,2268,218,103,115
1770,2727,450,1310,304,2277,218,103,115
1775,2733,450,1313,304,2282,219,103,116
1780,2744,451,1319,305,2293,219,103,116
1785,2748,451,1322,305,2297,219,103,116
1790,2758,452,1325,305,2306,219,103,116
1795,2764,452,1328,305,2311,220,104,116
1800,2775,453,1334,306,2322,220,104,116
1805,2779,453,1337,306,2326,220,104,116
1810,2789,453,1343,306,2336,220,104,116
1815,2795,453,1347,306,2342,221,105,116
1820,2806,453,1352,306,2353,221,105,116
1825,2810,453,1353,306,2357,221,105,116
1830,2820,453,1358,306,2367,221,105,116
1835,2826,453,1361,306,2373,222,106,116
1840,2837,453,1367,306,2384,222,106,116
1845,2841,453,1369,306,2388,222,106,116
1850,2851,454,1376,307,2397,222,106,116
1855,2857,454,1378,307,2403,224,107,117
1860,2868,454,1382,307,2414,224,107,117
1865,2872,454,1384,307,2418,224,107,117
1870,2882,455,1391,307,2427,225,108,117
1875,2888,455,1393,307,2433,227,108,119
1880,2899,455,1399,307,2444,227,108,119
1885,2903,455,1401,307,2448,227,108,119
1890,2913,456,1404,307,2457,228,109,119
1895,2919,456,1407,307,2463,229,110,119
1900,2930,457,1413,308,2473,229,110,119
1905,2934,457,1415,308,2477,229,110,119
1910,2944,459,1416,308,2485,230,110,120
1915,2950,459,1420,308,2490,232,111,121
1920,2961,461,1424,310,2500,233,112,121
1925,2965,461,1427,310,2504,233,112,121
1930,2975,463,1434,312,2511,233,112,121
1935,2981,463,1437,312,2517,234,112,122
1940,2992,465,1443,313,2526,234,112,122
1945,2996,466,1445,314,2530,234,112,122
1950,3006,468,1450,314,2538,234,112,122
1955,3012,468,1454,314,2544,235,113,122
1960,3023,469,1458,314,2553,235,113,122
1965,3027,470,1458,315,2557,235,113,122
1970,3037,472,1461,315,2565,235,113,122
1975,3043,472,1462,315,2570,236,113,123
1980,3054,474,1466,317,2580,236,113,123
1985,3058,474,1468,317,2584,236,113,123
1990,3068,476,1472,317,2592,237,113,124
1995,3074,476,1475,317,2598,238,114,124
2000,3085,477,1478,317,2608,238,114,124
2005,3089,477,1481,317,2612,238,114,124
2010,3099,479,1487,318,2620,239,115,124
2015,3105,479,1490,318,2626,240,115,125
2020,3116,480,1497,318,2636,240,115,125
2025,3120,481,1499,319,2639,240,115,125
2030,3130,484,1502,320,2646,241,115,126
2035,3136,484,1505,320,2652,243,117,126
2040,3147,487,1510,322,2658,244,117,127
2045,3151,488,1510,323,2663,244,117,127
2050,3161,490,1513,324,2671,244,117,127
2055,3167,490,1517,324,2677,245,118,127
2060,3178,491,1518,324,2687,246,119,127
2065,3182,491,1521,324,2691,246,119,127
2070,3192,493,1527,326,2699,246,119,127
2075,3198,493,1530,326,2705,247,119,128
2080,3209,494,1532,326,2715,248,119,129
2085,3213,494,1535,326,2719,248,119,129
2090,3223,496,1541,326,2727,248,119,129
2095,3229,496,1545,326,2732,249,119,130
2100,3240,500,1551,330,2740,250,119,131
2105,3244,500,1554,330,2744,250,119,131
2110,3254,501,1560,330,2753,250,119,131
2115,3260,501,1564,330,2759,251,120,131
2120,3271,502,1570,331,2769,251,120,131
2125,3275,502,1573,331,2773,251,120,131
2130,3285,503,1577,331,2782,251,120,131
2135,3291,503,1579,331,2788,252,120,132
2140,3302,504,1584,331,2798,252,120,132
2145,3306,505,1588,332,2801,252,120,132
2150,3316,507,1594,334,2808,253,121,132
2155,3322,508,1599,335,2810,254,122,132
2160,3333,514,1605,340,2815,254,122,132
2165,3337,517,1607,343,2820,254,122,132
2170,3347,517,1613,343,2830,254,122,132
2175,3353,517,1615,343,2836,255,122,133
2180,3364,518,1623,344,2846,255,122,133
2185,3368,519,1625,345,2849,255,122,133
2190,3378,520,1634,346,2858,255,122,133
2195,3384,520,1640,346,2864,256,123,133
2200,3395,521,1646,347,2874,256,123,133
2205,3399,522,1649,348,2877,256,123,133
2210,3409,524,1654,349,2885,256,123,133
2215,3415,524,1658,349,2890,257,124,133
2220,3426,527,1663,351,2898,258,124,134
2225,3430,528,1666,352,2902,258,124,134
2230,3440,529,1669,352,2911,258,124,134
2235,3446,529,1671,352,2917,259,124,135
2240,3457,530,1676,353,2927,259,124,135
2245,3461,530,1677,353,2931,259,124,135
2250,3471,531,1679,353,2940,259,124,135
2255,3477,531,1683,353,2946,260,125,135
2260,3488,532,1689,354,2955,260,125,135
2265,3492,533,1689,355,2959,260,125,135
2270,3502,534,1693,356,2968,260,125,135
2275,3508,534,1695,356,2974,261,126,135
2280,3519,534,1701,356,2984,261,126,135
2285,3523,535,1703,357,2988,261,126,135
2290,3533,535,1705,357,2998,262,126,136
2295,3539,535,1708,357,3004,264,126,138
2300,3550,535,1713,357,3015,264,126,138
2305,3554,535,1714,357,3019,264,126,138
2310,3564,535,1716,357,3029,265,126,139
2315,3570,535,1718,357,3035,267,127,140
2320,3581,535,1723,357,3046,267,127,140
2325,3585,535,1726,357,3050,267,127,140
2330,3595,536,1728,357,3059,268,127,141
2335,3601,536,1731,357,3065,270,128,142
2340,3612,538,1737,359,3073,271,129,142
2345,3616,538,1738,359,3078,271,129,142
2350,3626,538,1743,359,3088,271,129,142
2355,3632,538,1745,359,3094,272,129,143
2360,3643,539,1751,360,3104,272,129,143
2365,3647,540,1753,361,3107,272,129,143
2370,3657,540,1758,361,3117,272,129,143
2375,3663,540,1761,361,3123,273,130,143
2380,3674,542,1767,363,3132,273,130,143
2385,3678,543,1771,364,3135,273,130,143
2390,3688,543,1775,364,3145,273,130,143
2395,3694,543,1776,364,3150,274,130,144
2400,3705,546,1781,367,3159,274,130,144
2405,3709,547,1782,368,3162,274,130,144
2410,3719,547,1788,368,3172,274,130,144
2415,3725,547,1792,368,3178,276,131,145
2420,3736,549,1797,369,3187,276,131,145
2425,3740,550,1799,370,3190,276,131,145
2430,3750,550,1801,370,3200,276,131,145
2435,3756,550,1805,370,3206,278,132,146
2440,3767,551,1809,370,3216,278,132,146
2445,3771,551,1811,370,3220,278,132,146
2450,3781,555,1816,373,3226,278,132,146
2455,3787,555,1817,373,3232,280,133,147
2460,3798,559,1823,377,3238,281,133,148
2465,3802,561,1825,379,3241,281,133,148
2470,3812,564,1832,381,3248,281,133,148
2475,3818,564,1835,381,3254,282,134,148
2480,3829,564,1842,381,3265,282,134,148
2485,3833,564,1844,381,3269,282,134,148
2490,3843,565,1851,382,3278,282,134,148
2495,3849,565,1855,382,3284,283,134,149
2500,3860,565,1862,382,3295,283,134,149
2505,3864,565,1864,382,3299,283,134,149
2510,3874,566,1870,383,3307,283,134,149
2515,3880,566,1874,383,3314,284,135,149
2520,3891,566,1880,383,3325,284,135,149
2525,3895,566,1883,383,3329,284,135,149
2530,3905,567,1885,384,3338,284,135,149
2535,3911,567,1889,384,3344,285,136,149
2540,3922,567,1894,384,3355,285,136,149
2545,3926,567,1894,384,3359,285,136,149
2550,3936,568,1896,385,3368,285,136,149
2555,3942,568,1899,385,3374,286,137,149
2560,3953,568,1906,385,3385,286,137,149
2565,3957,568,1909,385,3389,286,137,149
2570,3967,570,1914,386,3397,287,137,150
2575,3973,570,1916,386,3403,288,137,151
2580,3984,573,1921,388,3411,289,137,152
2585,3988,574,1924,389,3414,289,137,152
2590,3998,575,1928,390,3423,289,137,152
2595,4004,575,1933,390,3428,290,137,153
2600,4015,577,1938,392,3438,290,137,153
2605,4019,577,1941,392,3442,290,137,153
2610,4029,578,1948,392,3451,290,137,153
2615,4035,578,1950,392,3457,291,137,154
2620,4046,580,1956,394,3466,291,137,154
2625,4050,581,1959,395,3469,291,137,154
2630,4060,582,1962,396,3478,291,137,154
2635,4066,582,1964,396,3484,292,137,155
2640,4077,584,1971,398,3492,292,137,155
2645,4081,585,1974,399,3496,292,137,155
2650,4091,586,1976,400,3505,292,137,155
2655,4097,586,1979,400,3510,293,137,156
2660,4108,589,1982,402,3519,293,137,156
2665,4112,589,1985,402,3523,293,137,156
2670,4122,590,1991,403,3532,293,137,156
2675,4128,590,1994,403,3537,294,138,156
2680,4139,592,2001,405,3547,294,138,156
2685,4143,593,2003,406,3550,294,138,156
2690,4153,595,2006,407,3558,294,138,156
2695,4159,595,2008,407,3563,295,139,156
2700,4170,598,2012,410,3572,296,139,157
2705,4174,598,2015,410,3576,296,139,157
2710,4184,599,2020,411,3585,296,139,157
2715,4190,599,2024,411,3591,297,140,157
2720,4201,600,2031,412,3601,297,140,157
2725,4205,600,2033,412,3605,297,140,157
2730,4215,601,2037,413,3614,298,140,158
2735,4221,601,2038,413,3620,299,140,159
2740,4232,602,2043,414,3630,299,140,159
2745,4236,602,2046,414,3634,299,140,159
2750,4246,603,2051,414,3643,300,140,160
2755,4252,603,2055,414,3649,301,141,160
2760,4263,603,2059,414,3660,301,141,160
2765,4267,603,2061,414,3664,301,141,160
2770,4277,604,2067,415,3673,301,141,160
2775,4283,604,2069,415,3679,302,141,161
2780,4294,605,2073,416,3689,303,142,161
2785,4298,605,2074,416,3693,303,142,161
2790,4308,606,2083,416,3702,303,142,161
2795,4314,606,2086,416,3708,304,142,162
2800,4325,607,2092,417,3718,305,143,162
2805,4329,607,2096,417,3722,305,143,162
2810,4339,609,2100,418,3730,305,143,162
2815,4345,609,2104,418,3736,306,144,162
2820,4356,611,2110,420,3744,307,145,162
2825,4360,612,2111,421,3748,307,145,162
2830,4370,614,2116,422,3756,307,145,162
2835,4376,614,2120,422,3761,308,146,162
2840,4387,616,2125,424,3771,308,146,162
2845,4391,616,2127,424,3775,308,146,162
2850,4401,618,2130,424,3783,308,146,162
2855,4407,618,2136,424,3788,309,147,162
2860,4418,620,2142,425,3798,309,147,162
2865,4422,620,2143,425,3802,309,147,162
2870,4432,622,2145,426,3810,310,147,163
2875,4438,622,2147,426,3816,311,147,164
2880,4449,623,2154,427,3823,311,147,164
2885,4453,625,2157,429,3827,311,147,164
2890,4463,627,2163,430,3836,311,147,164
2895,4469,627,2166,430,3842,312,148,164
2900,4480,628,2170,430,3852,312,148,164
2905,4484,628,2170,430,3856,312,148,164
2910,4494,629,2178,431,3865,312,148,164
2915,4500,629,2181,431,3871,313,148,165
2920,4511,630,2188,431,3880,313,148,165
2925,4515,632,2189,433,3883,313,148,165
2930,4525,633,2195,433,3892,313,148,165
2935,4531,633,2198,433,3897,314,149,165
2940,4542,636,2203,435,3906,315,150,165
2945,4546,637,2204,436,3909,315,150,165
2950,4556,638,2212,436,3918,316,151,165
2955,4562,638,2216,436,3924,317,152,165
2960,4573,640,2222,437,3933,318,153,165
2965,4577,640,2223,437,3937,318,153,165
2970,4587,641,2227,437,3946,319,153,166
2975,4593,641,2230,437,3952,320,154,166
2980,4604,643,2235,438,3961,320,154,166
2985,4608,643,2236,438,3965,320,154,166
2990,4618,644,2240,439,3974,320,154,166
2995,4624,644,2243,439,3980,321,155,166
3000,4635,647,2249,441,3988,321,155,166
3005,4639,647,2250,441,3992,321,155,166
3010,4649,647,2256,441,4002,321,155,166
3015,4655,647,2259,441,4008,322,156,166
3020,4666,647,2263,441,4019,322,156,166
3025,4670,647,2264,441,4023,322,156,166
3030,4680,647,2269,441,4033,322,156,166
3035,4686,647,2271,441,4039,323,156,167
3040,4697,647,2278,441,4050,323,156,167
3045,4701,647,2280,441,4054,323,156,167
3050,4711,648,2284,441,4063,323,156,167
3055,4717,648,2287,441,4069,324,157,167
3060,4728,648,2295,441,4080,324,157,167
3065,4732,648,2297,441,4084,324,157,167
3070,4742,649,2302,441,4093,324,157,167
3075,4748,649,2305,441,4098,325,157,168
3080,4759,650,2309,442,4109,325,157,168
3085,4763,650,2310,442,4113,325,157,168
3090,4773,651,2315,443,4122,325,157,168
3095,4779,651,2319,443,4127,326,157,169
3100,4790,652,2325,444,4138,326,157,169
3105,4794,652,2327,444,4142,326,157,169
3110,4804,654,2329,444,4150,326,157,169
3115,4810,654,2333,444,4155,327,157,170
3120,4821,658,2339,448,4162,328,157,171
3125,4825,658,2340,448,4167,328,157,171
3130,4835,660,2346,448,4175,329,158,171
3135,4841,660,2349,448,4181,330,158,172
3140,4852,661,2355,449,4191,331,159,172
3145,4856,662,2356,450,4194,331,159,172
3150,4866,664,2360,450,4202,332,160,172
3155,4872,664,2362,450,4208,333,161,172
3160,4883,665,2364,450,4218,334,161,173
3165,4887,667,2368,452,4220,334,161,173
3170,4897,669,2373,452,4228,335,162,173
3175,4903,669,2377,452,4234,336,162,174
3180,4914,671,2382,453,4243,337,163,174
3185,4918,671,2385,453,4247,337,163,174
3190,4928,672,2390,453,4256,337,163,174
3195,4934,672,2394,453,4262,338,163,175
3200,4945,674,2402,455,4271,338,163,175
3205,4949,674,2402,455,4275,338,163,175
3210,4959,675,2404,455,4284,338,163,175
3215,4965,675,2407,455,4290,339,163,176
3220,4976,676,2412,456,4300,339,163,176
3225,4980,676,2413,456,4304,339,163,176
3230,4990,677,2418,457,4313,340,164,176
3235,4996,677,2423,457,4318,341,165,176
3240,5007,679,2429,458,4325,341,165,176
3245,5011,681,2432,460,4330,341,165,176
3250,5021,683,2440,462,4338,342,165,177
3255,5027,683,2442,462,4344,343,165,178
3260,5038,683,2448,462,4355,343,165,178
3265,5042,683,2450,462,4359,343,165,178
3270,5052,685,2453,462,4367,344,166,178
3275,5058,685,2458,462,4373,345,167,178
3280,5069,685,2463,462,4384,345,167,178
3285,5073,685,2466,462,4388,345,167,178
3290,5083,687,2469,463,4396,346,167,179
3295,5089,687,2473,463,4401,347,168,179
3300,5100,689,2476,465,4411,348,168,180
3305,5104,689,2479,465,4415,348,168,180
3310,5114,690,2483,465,4424,348,168,180
3315,5120,690,2487,465,4430,349,169,180
3320,5131,691,2492,466,4440,350,170,180
3325,5135,691,2495,466,4444,350,170,180
3330,5145,692,2501,466,4453,350,170,180
3335,5151,692,2505,466,4458,351,171,180
3340,5162,695,2509,468,4467,352,171,181
3345,5166,696,2513,469,4470,352,171,181
3350,5176,697,2520,470,4479,352,171,181
3355,5182,697,2523,470,4484,353,172,181
3360,5193,700,2528,473,4493,354,172,182
3365,5197,700,2531,473,4497,354,172,182
3370,5207,700,2535,473,4507,354,172,182
3375,5213,700,2539,473,4513,355,172,183
3380,5224,700,2543,473,4524,355,172,183
3385,5228,700,2544,473,4528,355,172,183
3390,5238,700,2549,473,4538,355,172,183
3395,5244,700,2550,473,4544,356,172,184
3400,5255,700,2558,473,4555,356,172,184
3405,5259,700,2559,473,4559,356,172,184
3410,5269,701,2566,474,4568,357,173,184
3415,5275,701,2569,474,4574,358,173,185
3420,5286,701,2573,474,4584,358,173,185
3425,5290,702,2576,475,4588,358,173,185
3430,5300,703,2582,476,4597,358,173,185
3435,5306,703,2584,476,4603,359,173,186
3440,5317,703,2589,476,4614,359,173,186
3445,5321,703,2591,476,4618,359,173,186
3450,5331,704,2598,476,4627,359,173,186
3455,5337,704,2602,476,4633,360,174,186
3460,5348,704,2606,476,4644,360,174,186
3465,5352,704,2608,476,4648,360,174,186
3470,5362,706,2612,476,4656,360,174,186
3475,5368,706,2613,476,4662,361,174,187
3480,5379,707,2616,477,4672,361,174,187
3485,5383,708,2619,478,4675,361,174,187
3490,5393,710,2622,478,4683,361,174,187
3495,5399,710,2625,478,4689,362,175,187
3500,5410,712,2629,479,4698,363,175,188
3505,5414,712,2629,479,4702,363,175,188
3510,5424,715,2637,482,4709,363,175,188
3515,5430,715,2640,482,4715,364,175,189
3520,5441,716,2644,482,4725,365,175,190
3525,5445,717,2647,483,4728,365,175,190
3530,5455,720,2651,484,4733,365,175,190
3535,5461,723,2654,487,4738,366,175,191
3540,5472,724,2657,487,4748,367,176,191
3545,5476,724,2658,487,4752,367,176,191
3550,5486,726,2664,489,4760,367,176,191
3555,5492,726,2667,489,4765,368,176,192
3560,5503,728,2672,490,4774,368,176,192
3565,5507,729,2673,491,4778,368,176,192
3570,5517,731,2676,492,4786,369,177,192
3575,5523,731,2679,492,4791,370,177,193
3580,5534,733,2683,494,4800,370,177,193
3585,5538,735,2686,496,4803,370,177,193
3590,5548,738,2691,498,4810,371,178,193
3595,5554,738,2692,498,4816,372,178,194
3600,5565,739,2697,499,4825,372,178,194
3605,5569,740,2700,500,4829,372,178,194
3610,5579,743,2707,502,4836,373,179,194
3615,5585,743,2709,502,4842,374,180,194
3620,5596,744,2711,502,4852,374,180,194
3625,5600,744,2714,502,4856,374,180,194
3630,5610,746,2717,503,4864,375,181,194
3635,5616,746,2721,503,4870,377,182,195
3640,5627,748,2729,505,4879,377,182,195
3645,5631,748,2731,505,4883,377,182,195
3650,5641,750,2734,506,4891,378,182,196
3655,5647,750,2735,506,4897,380,182,198
3660,5658,751,2741,507,4905,381,182,199
3665,5662,751,2743,507,4911,381,182,199
3670,5672,753,2748,508,4919,382,183,199
3675,5678,753,2751,508,4925,383,183,200
3680,5689,753,2756,508,4936,384,184,200
3685,5693,753,2756,508,4940,384,184,200
3690,5703,755,2760,509,4948,385,185,200
3695,5709,755,2762,509,4954,386,185,201
3700,5720,757,2768,511,4963,387,186,201
3705,5724,757,2768,511,4967,387,186,201
3710,5734,759,2774,512,4975,388,187,201
3715,5740,759,2776,512,4981,389,187,202
3720,5751,760,2781,513,4991,390,187,203
3725,5755,760,2782,513,4995,390,187,203
3730,5765,762,2787,513,5003,390,187,203
3735,5771,762,2791,513,5009,391,187,204
3740,5782,762,2796,513,5020,392,187,205
3745,5786,762,2799,513,5024,392,187,205
3750,5796,764,2803,513,5032,392,187,205
3755,5802,764,2807,513,5038,393,187,206
3760,5813,764,2812,513,5049,394,188,206
3765,5817,764,2814,513,5053,394,188,206
3770,5827,767,2821,515,5060,394,188,206
3775,5833,767,2823,515,5066,395,188,207
3780,5844,770,2829,517,5074,396,188,208
3785,5848,770,2831,517,5078,396,188,208
3790,5858,771,2836,517,5087,396,188,208
3795,5864,771,2839,517,5093,397,189,208
3800,5875,773,2850,519,5102,397,189,208
3805,5879,773,2852,519,5106,397,189,208
3810,5889,774,2857,520,5115,397,189,208
3815,5895,774,2859,520,5121,398,190,208
3820,5906,775,2864,521,5131,398,190,208
3825,5910,775,2868,521,5135,398,190,208
3830,5920,776,2870,521,5144,398,190,208
3835,5926,776,2873,521,5150,399,190,209
3840,5937,777,2879,522,5160,399,190,209
3845,5941,777,2880,522,5164,399,190,209
3850,5951,778,2885,522,5173,399,190,209
3855,5957,778,2888,522,5179,400,191,209
3860,5968,780,2897,523,5188,400,191,209
3865,5972,780,2898,523,5192,400,191,209
3870,5982,781,2903,524,5201,400,191,209
3875,5988,781,2908,524,5207,401,192,209
3880,5999,783,2916,526,5216,401,192,209
3885,6003,783,2917,526,5220,401,192,209
3890,6013,785,2921,526,5227,401,192,209
3895,6019,786,2924,527,5232,403,194,209
3900,6030,789,2928,530,5240,404,195,209
3905,6034,789,2930,530,5245,404,195,209
3910,6044,789,2934,530,5255,404,195,209
3915,6050,789,2936,530,5261,405,195,210
3920,6061,789,2944,530,5272,405,195,210
3925,6065,789,2944,530,5276,405,195,210
3930,6075,789,2950,530,5286,405,195,210
3935,6081,789,2953,530,5292,406,196,210
3940,6092,789,2955,530,5303,406,196,210
3945,6096,789,2957,530,5307,406,196,210
3950,6106,789,2960,530,5317,406,196,210
3955,6112,789,2964,530,5323,407,197,210
3960,6123,789,2968,530,5334,407,197,210
3965,6127,789,2970,530,5338,407,197,210
3970,6137,789,2978,530,5348,408,198,210
3975,6143,789,2983,530,5354,409,199,210
3980,6154,789,2988,530,5365,409,199,210
3985,6158,789,2990,530,5369,409,199,210
3990,6168,789,2996,530,5379,409,199,210
3995,6174,789,2999,530,5385,410,200,210
4000,6185,789,3004,530,5396,410,200,210
4005,6189,789,3004,530,5400,410,200,210
4010,6199,791,3013,532,5408,410,200,210
4015,6205,791,3015,532,5414,411,201,210
4020,6216,793,3021,533,5422,411,201,210
4025,6220,794,3024,534,5426,411,201,210
4030,6230,796,3029,536,5434,411,201,210
4035,6236,796,3029,536,5440,412,201,211
4040,6247,800,3037,539,5447,412,201,211
4045,6251,800,3038,539,5451,412,201,211
4050,6261,802,3040,539,5459,412,201,211
4055,6267,803,3046,540,5463,413,202,211
4060,6278,805,3051,541,5473,413,202,211
4065,6282,805,3053,541,5477,413,202,211
4070,6292,808,3055,543,5484,413,202,211
4075,6298,808,3058,543,5490,414,203,211
4080,6309,811,3066,546,5497,415,204,211
4085,6313,811,3069,546,5502,415,204,211
4090,6323,812,3075,546,5511,415,204,211
4095,6329,812,3080,546,5517,416,205,211
4100,6340,812,3083,546,5528,417,205,212
4105,6344,812,3085,546,5532,417,205,212
4110,6354,813,3091,547,5541,417,205,212
4115,6360,813,3097,547,5547,418,206,212
4120,6371,813,3102,547,5558,419,206,213
4125,6375,813,3104,547,5562,419,206,213
4130,6385,814,3108,548,5571,419,206,213
4135,6391,814,3111,548,5577,420,206,214
4140,6402,814,3117,548,5588,421,206,215
4145,6406,814,3119,548,5592,421,206,215
4150,6416,815,3123,549,5601,421,206,215
4155,6422,815,3126,549,5607,423,207,216
4160,6433,815,3130,549,5618,423,207,216
4165,6437,815,3132,549,5622,423,207,216
4170,6447,816,3137,550,5631,423,207,216
4175,6453,816,3138,550,5637,425,207,218
4180,6464,816,3141,550,5648,425,207,218
4185,6468,816,3143,550,5652,425,207,218
4190,6478,818,3149,552,5660,425,207,218
4195,6484,818,3151,552,5666,426,207,219
4200,6495,821,3155,554,5672,426,207,219
4205,6499,824,3159,557,5675,426,207,219
4210,6509,825,3166,557,5684,426,207,219
4215,6515,825,3169,557,5690,427,208,219
4220,6526,827,3175,558,5699,428,208,220
4225,6530,827,3176,558,5703,428,208,220
4230,6540,828,3179,558,5712,428,208,220
4235,6546,828,3181,558,5718,429,209,220
4240,6557,830,3187,560,5727,430,210,220
4245,6561,831,3189,561,5730,430,210,220
4250,6571,832,3191,562,5739,431,210,221
4255,6577,832,3196,562,5745,432,211,221
4260,6588,833,3202,562,5755,433,211,222
4265,6592,833,3203,562,5759,433,211,222
4270,6602,835,3208,562,5767,433,211,222
4275,6608,835,3209,562,5772,434,211,223
4280,6619,837,3216,564,5782,434,211,223
4285,6623,837,3219,564,5786,434,211,223
4290,6633,839,3220,564,5794,434,211,223
4295,6639,839,3224,564,5800,435,212,223
4300,6650,841,3228,566,5809,435,212,223
4305,6654,841,3230,566,5813,435,212,223
4310,6664,843,3234,567,5821,435,212,223
4315,6670,843,3236,567,5827,436,213,223
4320,6681,844,3239,567,5837,436,213,223
4325,6685,845,3241,568,5840,436,213,223
4330,6695,847,3249,570,5848,436,213,223
4335,6701,847,3252,570,5854,438,214,224
4340,6712,849,3256,571,5863,438,214,224
4345,6716,850,3258,572,5866,438,214,224
4350,6726,852,3261,573,5874,438,214,224
4355,6732,852,3264,573,5880,440,215,225
4360,6743,853,3270,574,5890,440,215,225
4365,6747,853,3271,574,5894,440,215,225
4370,6757,855,3279,576,5902,440,215,225
4375,6763,855,3281,576,5907,442,215,227
4380,6774,858,3285,579,5916,443,215,228
4385,6778,858,3287,579,5920,443,215,228
4390,6788,858,3295,579,5930,443,215,228
4395,6794,858,3299,579,5936,444,216,228
4400,6805,858,3305,579,5947,445,217,228
4405,6809,858,3306,579,5951,445,217,228
4410,6819,858,3312,579,5961,445,217,228
4415,6825,858,3314,579,5967,446,217,229
4420,6836,858,3322,579,5978,447,218,229
4425,6840,858,3324,579,5982,447,218,229
4430,6850,858,3328,579,5992,447,218,229
4435,6856,858,3331,579,5998,448,219,229
4440,6867,858,3338,579,6009,449,220,229
4445,6871,858,3340,579,6013,449,220,229
4450,6881,858,3343,579,6023,449,220,229
4455,6887,858,3345,579,6029,450,220,230
4460,6898,858,3350,579,6040,451,220,231
4465,6902,858,3352,579,6044,451,220,231
4470,6912,858,3356,579,6054,451,220,231
4475,6918,858,3357,579,6060,452,221,231
4480,6929,858,3363,579,6071,453,222,231
4485,6933,858,3367,579,6075,453,222,231
4490,6943,860,3372,581,6083,454,222,232
4495,6949,860,3373,581,6089,456,222,234
4500,6960,863,3378,583,6097,456,222,234
4505,6964,863,3380,583,6101,456,222,234
4510,6974,865,3384,584,6109,456,222,234
4515,6980,865,3388,584,6114,457,222,235
4520,6991,868,3393,587,6123,457,222,235
4525,6995,868,3396,587,6127,457,222,235
4530,7005,870,3401,588,6135,457,222,235
4535,7011,870,3402,588,6141,458,222,236
4540,7022,871,3409,589,6150,458,222,236
4545,7026,872,3411,590,6154,458,222,236
4550,7036,874,3415,591,6162,458,222,236
4555,7042,874,3419,591,6167,459,223,236
4560,7053,876,3422,592,6177,459,223,236
4565,7057,877,3424,593,6180,459,223,236
4570,7067,879,3427,594,6188,459,223,236
4575,7073,879,3429,594,6194,460,223,237
4580,7084,880,3432,595,6204,460,223,237
4585,7088,880,3434,595,6208,460,223,237
4590,7098,882,3439,595,6216,460,223,237
4595,7104,882,3444,595,6222,461,224,237
4600,7115,883,3449,595,6232,462,225,237
4605,7119,883,3451,595,6236,462,225,237
4610,7129,886,3456,597,6243,463,225,238
4615,7135,886,3459,597,6249,464,225,239
4620,7146,888,3464,599,6257,465,225,240
4625,7150,889,3466,600,6261,465,225,240
4630,7160,890,3472,601,6270,465,225,240
4635,7166,891,3477,602,6275,466,225,241
4640,7177,891,3480,602,6286,467,225,242
4645,7181,891,3482,602,6290,467,225,242
4650,7191,892,3488,603,6299,467,225,242
4655,7197,893,3494,604,6304,468,226,242
4660,7208,894,3499,605,6314,469,226,243
4665,7212,894,3500,605,6318,469,226,243
4670,7222,895,3503,605,6327,469,226,243
4675,7228,895,3506,605,6332,470,227,243
4680,7239,897,3511,607,6342,471,228,243
4685,7243,898,3514,608,6345,471,228,243
4690,7253,899,3519,608,6354,471,228,243
4695,7259,900,3522,609,6359,472,229,243
4700,7270,901,3527,609,6369,472,229,243
4705,7274,902,3529,610,6372,472,229,243
4710,7284,903,3536,610,6381,472,229,243
4715,7290,904,3541,611,6385,473,230,243
4720,7301,907,3546,614,6394,473,230,243
4725,7305,907,3546,614,6398,473,230,243
4730,7315,908,3552,614,6407,474,231,243
4735,7321,909,3557,615,6411,475,232,243
4740,7332,911,3561,617,6420,475,232,243
4745,7336,911,3564,617,6425,475,232,243
4750,7346,911,3570,617,6435,475,232,243
4755,7352,911,3576,617,6441,476,233,243
4760,7363,911,3584,617,6452,476,233,243
4765,7367,911,3587,617,6456,476,233,243
4770,7377,911,3593,617,6466,476,233,243
4775,7383,911,3599,617,6472,477,234,243
4780,7394,911,3605,617,6483,477,234,243
4785,7398,911,3607,617,6487,477,234,243
4790,7408,912,3612,617,6496,477,234,243
4795,7414,912,3613,617,6501,478,234,244
4800,7425,915,3621,620,6509,479,235,244
4805,7429,916,3623,621,6513,479,235,244
4810,7439,916,3631,621,6523,479,235,244
4815,7445,916,3634,621,6529,480,236,244
4820,7456,918,3640,623,6538,480,236,244
4825,7460,918,3643,623,6542,480,236,244
4830,7470,919,3648,624,6551,480,236,244
4835,7476,919,3653,624,6557,481,236,245
4840,7487,921,3660,626,6566,481,236,245
4845,7491,921,3662,626,6570,481,236,245
4850,7501,923,3665,627,6578,482,237,245
4855,7507,923,3667,627,6583,483,237,246
4860,7518,925,3672,628,6591,483,237,246
4865,7522,925,3675,628,6597,483,237,246
4870,7532,927,3677,628,6605,483,237,246
4875,7538,927,3679,628,6611,485,238,247
4880,7549,927,3681,628,6622,486,238,248
4885,7553,927,3681,628,6626,486,238,248
4890,7563,929,3684,629,6634,486,238,248
4895,7569,929,3688,629,6640,487,239,248
4900,7580,929,3692,629,6651,488,239,249
4905,7584,929,3694,629,6655,488,239,249
4910,7594,931,3697,630,6663,488,239,249
4915,7600,931,3702,630,6669,489,240,249
4920,7611,932,3708,631,6679,490,241,249
4925,7615,932,3710,631,6683,490,241,249
4930,7625,934,3715,632,6691,490,241,249
4935,7631,934,3716,632,6697,491,241,250
4940,7642,935,3723,633,6707,492,242,250
4945,7646,935,3725,633,6711,492,242,250
4950,7656,937,3728,634,6719,492,242,250
4955,7662,937,3731,634,6725,493,242,251
4960,7673,937,3736,634,6736,494,243,251
4965,7677,937,3740,634,6740,494,243,251
4970,7687,939,3746,635,6748,494,243,251
4975,7693,939,3750,635,6754,495,244,251
4980,7704,941,3760,637,6762,496,245,251
4985,7708,942,3763,638,6766,496,245,251
4990,7718,943,3770,639,6775,496,245,251
4995,7724,943,3772,639,6781,498,245,253
5000,7735,943,3778,639,6792,499,246,253
5005,7739,943,3779,639,6796,499,246,253
5010,7749,944,3784,639,6805,499,246,253
5015,7755,944,3786,639,6811,501,247,254
5020,7766,944,3793,639,6822,502,248,254
5025,7770,944,3793,639,6826,502,248,254
5030,7780,945,3798,640,6835,502,248,254
5035,7786,945,3798,640,6841,504,248,256
5040,7797,946,3802,640,6851,505,249,256
5045,7801,946,3803,640,6855,505,249,256
5050,7811,947,3807,640,6864,506,250,256
5055,7817,947,3810,640,6870,507,251,256
5060,7828,948,3818,641,6880,507,251,256
5065,7832,949,3821,642,6883,507,251,256
5070,7842,950,3824,642,6892,508,251,257
5075,7848,950,3829,642,6898,509,252,257
5080,7859,951,3837,643,6908,509,252,257
5085,7863,952,3840,644,6911,509,252,257
5090,7873,953,3842,644,6920,509,252,257
5095,7879,953,3844,644,6926,510,252,258
5100,7890,954,3849,644,6936,510,252,258
5105,7894,955,3852,645,6939,510,252,258
5110,7904,956,3857,645,6948,510,252,258
5115,7910,956,3862,645,6954,511,253,258
5120,7921,957,3866,646,6964,511,253,258
5125,7925,957,3868,646,6968,511,253,258
5130,7935,958,3872,647,6977,511,253,258
5135,7941,958,3877,647,6983,512,253,259
5140,7952,959,3881,647,6993,512,253,259
5145,7956,960,3883,648,6996,512,253,259
5150,7966,962,3886,648,7004,512,253,259
5155,7972,962,3889,648,7009,514,254,260
5160,7983,967,3895,652,7015,514,254,260
5165,7987,968,3895,653,7019,514,254,260
5170,7997,969,3900,653,7028,514,254,260
5175,8003,969,3902,653,7034,516,256,260
5180,8014,969,3904,653,7045,517,256,261
5185,8018,969,3906,653,7049,517,256,261
5190,8028,970,3911,654,7058,517,256,261
5195,8034,970,3913,654,7064,519,257,262
5200,8045,970,3917,654,7075,520,257,263
5205,8049,970,3919,654,7079,520,257,263
5210,8059,971,3922,655,7088,521,257,264
5215,8065,971,3924,655,7094,523,258,265
5220,8076,971,3931,655,7105,524,259,265
5225,8080,971,3932,655,7109,524,259,265
5230,8090,973,3935,656,7117,524,259,265
5235,8096,973,3937,656,7123,525,259,266
5240,8107,973,3945,656,7134,525,259,266
5245,8111,973,3947,656,7138,525,259,266
5250,8121,975,3953,656,7146,525,259,266
5255,8127,975,3957,656,7152,526,260,266
5260,8138,975,3963,656,7163,526,260,266
5265,8142,975,3964,656,7167,526,260,266
5270,8152,978,3970,659,7174,526,260,266
5275,8158,979,3975,660,7179,527,261,266
5280,8169,982,3981,662,7187,527,261,266
5285,8173,982,3983,662,7191,527,261,266
5290,8183,984,3988,664,7199,527,261,266
5295,8189,984,3989,664,7205,528,261,267
5300,8200,986,3994,666,7213,528,261,267
5305,8204,987,3997,667,7217,528,261,267
5310,8214,989,4003,667,7225,528,261,267
5315,8220,989,4005,667,7231,529,261,268
5320,8231,992,4009,669,7238,529,261,268
5325,8235,993,4011,670,7242,529,261,268
5330,8245,995,4014,671,7250,529,261,268
5335,8251,995,4015,671,7256,531,262,269
5340,8262,998,4022,674,7263,532,263,269
5345,8266,999,4023,675,7267,532,263,269
5350,8276,999,4028,675,7277,532,263,269
5355,8282,999,4031,675,7283,533,264,269
5360,8293,1000,4035,675,7293,534,264,270
5365,8297,1000,4037,675,7297,534,264,270
5370,8307,1000,4044,675,7307,534,264,270
5375,8313,1000,4048,675,7313,535,265,270
5380,8324,1002,4052,677,7322,536,266,270
5385,8328,1002,4053,677,7326,536,266,270
5390,8338,1002,4056,677,7336,536,266,270
5395,8344,1002,4060,677,7342,537,267,270
5400,8355,1004,4065,679,7351,538,268,270
5405,8359,1004,4067,679,7355,538,268,270
5410,8369,1005,4070,680,7364,538,268,270
5415,8375,1005,4073,680,7370,539,269,270
5420,8386,1005,4079,680,7381,539,269,270
5425,8390,1005,4082,680,7385,539,269,270
5430,8400,1006,4087,680,7394,539,269,270
5435,8406,1006,4089,680,7400,540,269,271
5440,8417,1006,4094,680,7411,540,269,271
5445,8421,1006,4098,680,7415,540,269,271
5450,8431,1008,4104,681,7423,540,269,271
5455,8437,1008,4107,681,7429,542,270,272
5460,8448,1008,4112,681,7440,542,270,272
5465,8452,1008,4114,681,7444,542,270,272
5470,8462,1009,4119,682,7453,542,270,272
5475,8468,1009,4119,682,7459,543,270,273
5480,8479,1011,4124,683,7468,543,270,273
5485,8483,1011,4127,683,7472,543,270,273
5490,8493,1012,4134,683,7481,543,270,273
5495,8499,1012,4138,683,7487,544,270,274
5500,8510,1013,4143,683,7497,544,270,274
5505,8514,1013,4146,683,7501,544,270,274
5510,8524,1014,4150,683,7510,544,270,274
5515,8530,1014,4153,683,7516,545,270,275
5520,8541,1016,4159,684,7525,545,270,275
5525,8545,1016,4160,684,7529,545,270,275
5530,8555,1017,4165,685,7538,545,270,275
5535,8561,1017,4169,685,7544,546,271,275
5540,8572,1018,4175,686,7554,546,271,275
5545,8576,1018,4177,686,7558,546,271,275
5550,8586,1019,4182,687,7567,546,271,275
5555,8592,1019,4186,687,7573,547,272,275
5560,8603,1020,4194,688,7583,547,272,275
5565,8607,1021,4196,689,7586,547,272,275
5570,8617,1023,4201,690,7594,547,272,275
5575,8623,1023,4203,690,7600,549,273,276
5580,8634,1026,4212,693,7608,549,273,276
5585,8638,1027,4214,694,7611,549,273,276
5590,8648,1029,4218,694,7619,549,273,276
5595,8654,1029,4220,694,7625,550,274,276
5600,8665,1030,4226,695,7635,550,274,276
5605,8669,1031,4228,696,7638,550,274,276
5610,8679,1033,4235,697,7646,550,274,276
5615,8685,1033,4236,697,7652,551,274,277
5620,8696,1034,4242,697,7662,551,274,277
5625,8700,1035,4245,698,7665,551,274,277
5630,8710,1037,4249,699,7673,551,274,277
5635,8716,1037,4250,699,7679,552,275,277
5640,8727,1039,4252,700,7688,552,275,277
5645,8731,1040,4253,701,7691,552,275,277
5650,8741,1042,4258,701,7699,552,275,277
5655,8747,1042,4259,701,7705,553,275,278
5660,8758,1043,4266,702,7715,554,276,278
5665,8762,1043,4267,702,7719,554,276,278
5670,8772,1045,4272,703,7727,554,276,278
5675,8778,1045,4277,703,7733,555,277,278
5680,8789,1046,4282,704,7743,556,277,279
5685,8793,1046,4284,704,7747,556,277,279
5690,8803,1048,4288,705,7755,556,277,279
5695,8809,1048,4291,705,7761,558,278,280
5700,8820,1050,4298,707,7770,559,278,281
5705,8824,1050,4300,707,7774,559,278,281
5710,8834,1051,4305,707,7783,559,278,281
5715,8840,1051,4305,707,7789,560,278,282
5720,8851,1054,4311,709,7797,561,278,283
5725,8855,1054,4312,709,7801,561,278,283
5730,8865,1055,4314,710,7810,561,278,283
5735,8871,1055,4316,710,7815,562,278,284
5740,8882,1060,4322,714,7822,563,278,285
5745,8886,1060,4324,714,7826,563,278,285
5750,8896,1061,4327,714,7835,563,278,285
5755,8902,1061,4330,714,7840,564,278,286
5760,8913,1064,4335,717,7849,565,279,286
5765,8917,1065,4339,718,7852,565,279,286
5770,8927,1065,4345,718,7862,565,279,286
5775,8933,1065,4350,718,7868,566,280,286
5780,8944,1065,4353,718,7879,566,280,286
5785,8948,1065,4354,718,7883,566,280,286
5790,8958,1065,4359,718,7893,566,280,286
5795,8964,1065,4361,718,7899,567,281,286
5800,8975,1065,4365,718,7910,567,281,286
5805,8979,1065,4365,718,7914,567,281,286
5810,8989,1066,4369,718,7923,567,281,286
5815,8995,1066,4370,718,7929,569,281,288
5820,9006,1068,4377,720,7936,569,281,288
5825,9010,1070,4378,722,7940,569,281,288
5830,9020,1071,4383,722,7949,569,281,288
5835,9026,1071,4387,722,7955,570,282,288
5840,9037,1071,4391,722,7966,570,282,288
5845,9041,1071,4395,722,7970,570,282,288
5850,9051,1072,4401,723,7979,570,282,288
5855,9057,1072,4405,723,7985,571,282,289
5860,9068,1072,4410,723,7996,571,282,289
5865,9072,1072,4413,723,8000,571,282,289
5870,9082,1074,4420,725,8008,571,282,289
5875,9088,1074,4426,725,8014,572,283,289
5880,9099,1076,4430,727,8023,573,283,290
5885,9103,1077,4432,728,8026,573,283,290
5890,9113,1079,4439,730,8034,573,283,290
5895,9119,1079,4442,730,8039,574,283,291
5900,9130,1081,4450,732,8049,575,283,292
5905,9134,1082,4453,733,8052,575,283,292
5910,9144,1084,4456,733,8060,575,283,292
5915,9150,1084,4457,733,8066,576,283,293
5920,9161,1085,4463,733,8076,577,283,294
5925,9165,1085,4464,733,8080,577,283,294
5930,9175,1087,4469,734,8088,577,283,294
5935,9181,1087,4473,734,8093,579,284,295
5940,9192,1089,4477,735,8103,580,284,296
5945,9196,1089,4480,735,8107,580,284,296
5950,9206,1091,4483,737,8115,580,284,296
5955,9212,1091,4487,737,8121,581,285,296
5960,9223,1093,4491,739,8129,582,285,297
5965,9227,1095,4495,741,8132,582,285,297
5970,9237,1097,4500,743,8140,582,285,297
5975,9243,1097,4504,743,8146,583,286,297
5980,9254,1099,4511,745,8155,584,286,298
5985,9258,1099,4513,745,8159,584,286,298
5990,9268,1100,4517,745,8168,584,286,298
5995,9274,1100,4519,745,8174,585,287,298
6000,9285,1101,4525,746,8184,586,287,299
6005,9289,1101,4525,746,8188,586,287,299
6010,9299,1102,4528,746,8197,586,287,299
6015,9305,1102,4531,746,8203,587,288,299
6020,9316,1103,4537,747,8213,587,288,299
6025,9320,1103,4538,747,8217,587,288,299
6030,9330,1104,4542,747,8226,587,288,299
6035,9336,1104,4545,747,8232,588,289,299
6040,9347,1105,4550,747,8242,588,289,299
6045,9351,1105,4551,747,8246,588,289,299
6050,9361,1106,4556,747,8255,588,289,299
6055,9367,1106,4558,747,8261,589,289,300
6060,9378,1107,4562,748,8271,589,289,300
6065,9382,1107,4565,748,8275,589,289,300
6070,9392,1108,4570,749,8284,589,289,300
6075,9398,1108,4574,749,8290,590,289,301
6080,9409,1109,4578,749,8300,590,289,301
6085,9413,1110,4580,750,8303,590,289,301
6090,9423,1112,4584,752,8311,590,289,301
6095,9429,1112,4588,752,8317,591,290,301
6100,9440,1114,4595,753,8326,591,290,301
6105,9444,1115,4598,754,8328,591,290,301
6110,9454,1119,4604,756,8335,591,290,301
6115,9460,1119,4608,756,8340,592,291,301
6120,9471,1123,4615,760,8348,593,292,301
6125,9475,1124,4617,761,8351,593,292,301
6130,9485,1125,4622,761,8360,593,292,301
6135,9491,1125,4628,761,8365,594,293,301
6140,9502,1128,4634,763,8374,595,294,301
6145,9506,1128,4635,763,8378,595,294,301
6150,9516,1129,4640,763,8387,595,294,301
6155,9522,1129,4645,763,8392,596,295,301
6160,9533,1131,4652,765,8402,597,296,301
6165,9537,1131,4653,765,8406,597,296,301
6170,9547,1132,4657,766,8415,597,296,301
6175,9553,1132,4659,766,8421,598,296,302
6180,9564,1133,4666,767,8431,599,297,302
6185,9568,1134,4667,768,8434,599,297,302
6190,9578,1135,4672,769,8443,599,297,302
6195,9584,1135,4675,769,8448,600,297,303
6200,9595,1137,4684,771,8458,601,297,304
6205,9599,1137,4686,771,8462,601,297,304
6210,9609,1138,4693,772,8471,601,297,304
6215,9615,1138,4697,772,8476,602,298,304
6220,9626,1141,4702,774,8485,603,298,305
6225,9630,1141,4704,774,8489,603,298,305
6230,9640,1144,4710,776,8496,603,298,305
6235,9646,1144,4713,776,8502,604,298,306
6240,9657,1146,4721,778,8510,604,298,306
6245,9661,1148,4723,780,8513,604,298,306
6250,9671,1150,4730,782,8521,604,298,306
6255,9677,1150,4731,782,8527,605,298,307
6260,9688,1151,4736,783,8537,605,298,307
6265,9692,1151,4738,783,8541,605,298,307
6270,9702,1153,4743,785,8549,605,298,307
6275,9708,1153,4744,785,8555,606,298,308
6280,9719,1154,4751,786,8565,606,298,308
6285,9723,1154,4753,786,8569,606,298,308
6290,9733,1156,4758,788,8577,606,298,308
6295,9739,1156,4761,788,8583,608,299,309
6300,9750,1156,4769,788,8594,608,299,309
6305,9754,1156,4771,788,8598,608,299,309
6310,9764,1158,4776,789,8606,608,299,309
6315,9770,1158,4779,789,8612,609,299,310
6320,9781,1160,4783,791,8621,609,299,310
6325,9785,1160,4784,791,8625,609,299,310
6330,9795,1162,4790,792,8633,609,299,310
6335,9801,1162,4793,792,8639,610,299,311
6340,9812,1162,4795,792,8650,611,299,312
6345,9816,1162,4796,792,8654,611,299,312
6350,9826,1164,4799,792,8662,611,299,312
6355,9832,1164,4803,792,8667,612,299,313
6360,9843,1166,4809,794,8677,613,299,314
6365,9847,1166,4810,794,8681,613,299,314
6370,9857,1167,4815,794,8690,613,299,314
6375,9863,1167,4818,794,8696,614,300,314
6380,9874,1168,4825,795,8706,614,300,314
6385,9878,1168,4827,795,8710,614,300,314
6390,9888,1169,4834,796,8719,614,300,314
6395,9894,1169,4837,796,8724,615,300,315
6400,9905,1171,4843,798,8734,615,300,315
6405,9909,1171,4845,798,8738,615,300,315
6410,9919,1172,4851,798,8747,615,300,315
6415,9925,1172,4853,798,8752,617,301,316
6420,9936,1176,4859,802,8760,617,301,316
6425,9940,1176,4861,802,8764,617,301,316
6430,9950,1176,4865,802,8774,617,301,316
6435,9956,1176,4867,802,8780,618,301,317
6440,9967,1177,4871,802,8790,618,301,317
6445,9971,1178,4872,803,8793,618,301,317
6450,9981,1178,4875,803,8803,618,301,317
6455,9987,1178,4877,803,8809,619,302,317
6460,9998,1179,4879,804,8819,619,302,317
6465,10002,1179,4880,804,8823,619,302,317
6470,10012,1180,4885,805,8832,619,302,317
6475,10018,1180,4889,805,8838,620,302,318
6480,10029,1183,4896,807,8846,620,302,318
6485,10033,1183,4898,807,8850,620,302,318
6490,10043,1184,4901,808,8859,620,302,318
6495,10049,1184,4903,808,8865,621,302,319
6500,10060,1186,4909,810,8874,621,302,319
6505,10064,1186,4912,810,8878,621,302,319
6510,10074,1187,4916,811,8887,621,302,319
6515,10080,1187,4919,811,8893,622,302,320
6520,10091,1189,4926,813,8902,622,302,320
6525,10095,1189,4926,813,8906,622,302,320
6530,10105,1191,4929,814,8914,622,302,320
6535,10111,1191,4931,814,8920,624,302,322
6540,10122,1193,4940,816,8929,625,303,322
6545,10126,1193,4943,816,8933,625,303,322
6550,10136,1195,4950,817,8941,625,303,322
6555,10142,1195,4952,817,8947,626,304,322
6560,10153,1197,4957,818,8956,627,305,322
6565,10157,1198,4960,819,8959,627,305,322
6570,10167,1200,4964,820,8967,627,305,322
6575,10173,1200,4968,820,8973,628,305,323
6580,10184,1202,4971,822,8982,629,305,324
6585,10188,1202,4973,822,8986,629,305,324
6590,10198,1204,4978,823,8994,629,305,324
6595,10204,1204,4980,823,8999,630,306,324
6600,10215,1206,4985,825,9009,631,307,324
6605,10219,1206,4987,825,9013,631,307,324
6610,10229,1207,4991,826,9022,631,307,324
6615,10235,1207,4993,826,9028,632,308,324
6620,10246,1208,5001,827,9038,632,308,324
6625,10250,1209,5004,828,9041,632,308,324
6630,10260,1210,5007,828,9050,632,308,324
6635,10266,1210,5007,828,9056,633,308,325
6640,10277,1211,5013,829,9066,633,308,325
6645,10281,1211,5014,829,9070,633,308,325
6650,10291,1212,5019,830,9079,633,308,325
6655,10297,1212,5021,830,9085,634,308,326
6660,10308,1214,5026,831,9094,634,308,326
6665,10312,1214,5028,831,9098,634,308,326
6670,10322,1215,5037,832,9107,634,308,326
6675,10328,1215,5040,832,9113,635,309,326
6680,10339,1217,5045,834,9122,635,309,326
6685,10343,1217,5048,834,9126,635,309,326
6690,10353,1218,5053,834,9135,635,309,326
6695,10359,1218,5055,834,9141,636,310,326
6700,10370,1220,5060,836,9150,636,310,326
6705,10374,1220,5063,836,9154,636,310,326
6710,10384,1222,5072,838,9162,636,310,326
6715,10390,1222,5077,838,9167,637,311,326
6720,10401,1226,5085,842,9174,637,311,326
6725,10405,1227,5086,843,9178,637,311,326
6730,10415,1229,5091,843,9186,637,311,326
6735,10421,1229,5095,843,9192,638,312,326
6740,10432,1231,5102,845,9201,639,312,327
6745,10436,1231,5104,845,9205,639,312,327
6750,10446,1233,5106,846,9213,639,312,327
6755,10452,1233,5107,846,9219,640,312,328
6760,10463,1235,5113,848,9228,641,312,329
6765,10467,1236,5114,849,9231,641,312,329
6770,10477,1238,5119,851,9239,641,312,329
6775,10483,1238,5121,851,9245,642,313,329
6780,10494,1240,5126,852,9254,643,314,329
6785,10498,1240,5127,852,9258,643,314,329
6790,10508,1240,5133,852,9268,643,314,329
6795,10514,1240,5136,852,9274,645,316,329
6800,10525,1240,5140,852,9285,646,317,329
6805,10529,1240,5143,852,9289,646,317,329
6810,10539,1240,5149,852,9299,646,317,329
6815,10545,1240,5154,852,9305,647,318,329
6820,10556,1240,5161,852,9316,648,319,329
6825,10560,1240,5164,852,9320,648,319,329
6830,10570,1240,5168,852,9330,648,319,329
6835,10576,1240,5171,852,9336,649,319,330
6840,10587,1240,5176,852,9347,650,319,331
6845,10591,1240,5176,852,9351,650,319,331
6850,10601,1241,5178,852,9360,650,319,331
6855,10607,1241,5182,852,9366,651,320,331
6860,10618,1241,5188,852,9377,651,320,331
6865,10622,1242,5191,853,9380,651,320,331
6870,10632,1243,5199,853,9389,651,320,331
6875,10638,1243,5202,853,9395,652,321,331
6880,10649,1243,5204,853,9406,652,321,331
6885,10653,1243,5205,853,9410,652,321,331
6890,10663,1245,5209,853,9417,652,321,331
6895,10669,1246,5213,854,9422,653,322,331
6900,10680,1248,5218,855,9430,653,322,331
6905,10684,1250,5219,857,9434,653,322,331
6910,10694,1251,5224,857,9443,653,322,331
6915,10700,1251,5227,857,9449,654,322,332
6920,10711,1253,5234,859,9458,654,322,332
6925,10715,1253,5235,859,9462,654,322,332
6930,10725,1254,5240,860,9471,654,322,332
6935,10731,1254,5245,860,9477,655,323,332
6940,10742,1255,5250,860,9487,655,323,332
6945,10746,1255,5252,860,9491,655,323,332
6950,10756,1256,5255,861,9500,655,323,332
6955,10762,1256,5259,861,9506,656,324,332
6960,10773,1257,5264,861,9516,657,324,333
6965,10777,1257,5265,861,9520,657,324,333
6970,10787,1258,5272,862,9529,657,324,333
6975,10793,1258,5275,862,9535,658,325,333
6980,10804,1261,5282,865,9543,659,325,334
6985,10808,1261,5285,865,9547,659,325,334
6990,10818,1262,5291,865,9556,659,325,334
6995,10824,1262,5294,865,9562,660,325,335
7000,10835,1264,5300,866,9571,661,326,335
7005,10839,1264,5302,866,9575,661,326,335
7010,10849,1265,5303,866,9584,661,326,335
7015,10855,1265,5304,866,9590,662,326,336
7020,10866,1268,5311,868,9598,663,327,336
7025,10870,1268,5313,868,9602,663,327,336
7030,10880,1269,5317,868,9611,663,327,336
7035,10886,1269,5321,868,9617,664,328,336
7040,10897,1270,5328,869,9627,664,328,336
7045,10901,1270,5332,869,9631,664,328,336
7050,10911,1271,5336,869,9640,664,328,336
7055,10917,1271,5339,869,9646,665,328,337
7060,10928,1272,5346,870,9656,665,328,337
7065,10932,1272,5348,870,9660,665,328,337
7070,10942,1274,5354,872,9668,665,328,337
7075,10948,1274,5358,872,9673,666,328,338
7080,10959,1276,5367,874,9683,667,329,338
7085,10963,1276,5368,874,9687,667,329,338
7090,10973,1279,5373,876,9694,667,329,338
7095,10979,1279,5376,876,9700,668,329,339
7100,10990,1280,5381,877,9710,669,330,339
7105,10994,1280,5385,877,9714,669,330,339
7110,11004,1282,5392,878,9722,669,330,339
7115,11010,1282,5395,878,9728,670,331,339
7120,11021,1283,5401,879,9738,671,331,340
7125,11025,1283,5402,879,9742,671,331,340
7130,11035,1286,5409,881,9749,671,331,340
7135,11041,1286,5410,881,9755,672,331,341
7140,11052,1288,5415,882,9764,673,332,341
7145,11056,1288,5417,882,9768,673,332,341
7150,11066,1290,5422,882,9776,673,332,341
7155,11072,1290,5425,882,9781,674,332,342
7160,11083,1293,5429,884,9790,674,332,342
7165,11087,1294,5432,885,9793,674,332,342
7170,11097,1296,5436,886,9801,674,332,342
7175,11103,1296,5439,886,9807,675,333,342
7180,11114,1297,5444,887,9817,675,333,342
7185,11118,1298,5446,888,9820,675,333,342
7190,11128,1300,5452,890,9828,675,333,342
7195,11134,1300,5455,890,9833,676,334,342
7200,11145,1302,5461,892,9843,676,334,342
7205,11149,1302,5463,892,9847,676,334,342
7210,11159,1302,5467,892,9857,676,334,342
7215,11165,1302,5471,892,9863,677,335,342
7220,11176,1302,5474,892,9874,677,335,342
7225,11180,1302,5475,892,9878,677,335,342
7230,11190,1302,5480,892,9888,677,335,342
7235,11196,1302,5484,892,9894,678,335,343
7240,11207,1302,5489,892,9905,678,335,343
7245,11211,1302,5492,892,9909,678,335,343
7250,11221,1302,5499,892,9919,678,335,343
7255,11227,1302,5502,892,9925,680,335,345
7260,11238,1302,5509,892,9936,680,335,345
7265,11242,1302,5511,892,9940,680,335,345
7270,11252,1302,5517,892,9950,680,335,345
7275,11258,1302,5522,892,9956,681,336,345
7280,11269,1302,5529,892,9967,681,336,345
7285,11273,1302,5530,892,9971,681,336,345
7290,11283,1302,5535,892,9981,681,336,345
7295,11289,1302,5538,892,9987,682,337,345
7300,11300,1302,5542,892,9998,682,337,345
7305,11304,1302,5544,892,10002,682,337,345
7310,11314,1304,5549,893,10010,682,337,345
7315,11320,1304,5553,893,10015,683,338,345
7320,11331,1308,5557,896,10023,684,338,346
7325,11335,1308,5560,896,10027,684,338,346
7330,11345,1309,5563,896,10036,684,338,346
7335,11351,1309,5564,896,10041,685,338,347
7340,11362,1312,5567,899,10050,686,338,348
7345,11366,1313,5569,900,10053,686,338,348
7350,11376,1314,5573,900,10062,686,338,348
7355,11382,1314,5576,900,10068,687,339,348
7360,11393,1316,5581,901,10077,688,340,348
7365,11397,1316,5583,901,10081,688,340,348
7370,11407,1317,5586,901,10090,688,340,348
7375,11413,1317,5589,901,10096,689,341,348
7380,11424,1320,5593,904,10104,690,341,349
7385,11428,1320,5595,904,10108,690,341,349
7390,11438,1321,5599,905,10117,690,341,349
7395,11444,1321,5604,905,10122,691,341,350
7400,11455,1323,5607,907,10132,692,341,351
7405,11459,1323,5609,907,10136,692,341,351
7410,11469,1324,5616,908,10145,692,341,351
7415,11475,1324,5618,908,10151,693,341,352
7420,11486,1325,5623,909,10161,694,341,353
7425,11490,1325,5626,909,10165,694,341,353
7430,11500,1327,5630,911,10173,694,341,353
7435,11506,1327,5633,911,10179,695,342,353
7440,11517,1329,5636,913,10188,696,342,354
7445,11521,1329,5637,913,10192,696,342,354
7450,11531,1330,5641,914,10201,696,342,354
7455,11537,1330,5643,914,10207,697,342,355
7460,11548,1332,5644,915,10216,697,342,355
7465,11552,1332,5646,915,10220,697,342,355
7470,11562,1335,5651,917,10227,697,342,355
7475,11568,1335,5653,917,10233,698,343,355
7480,11579,1336,5656,917,10243,698,343,355
7485,11583,1336,5656,917,10247,698,343,355
7490,11593,1337,5660,917,10256,698,343,355
7495,11599,1337,5663,917,10262,700,344,356
7500,11610,1339,5668,918,10271,700,344,356
7505,11614,1340,5671,919,10274,700,344,356
7510,11624,1341,5675,919,10283,700,344,356
7515,11630,1341,5677,919,10289,701,344,357
7520,11641,1343,5683,921,10298,701,344,357
7525,11645,1343,5685,921,10302,701,344,357
7530,11655,1344,5690,921,10311,701,344,357
7535,11661,1344,5691,921,10317,702,345,357
7540,11672,1346,5697,922,10326,702,345,357
7545,11676,1346,5699,922,10330,702,345,357
7550,11686,1347,5704,922,10339,702,345,357
7555,11692,1347,5705,922,10345,703,345,358
7560,11703,1348,5707,922,10355,704,345,359
7565,11707,1348,5710,922,10359,704,345,359
7570,11717,1350,5718,923,10367,704,345,359
7575,11723,1350,5720,923,10373,705,345,360
7580,11734,1352,5725,925,10382,706,345,361
7585,11738,1353,5728,926,10385,706,345,361
7590,11748,1354,5734,927,10394,706,345,361
7595,11754,1354,5738,927,10400,707,346,361
7600,11765,1355,5744,928,10410,708,347,361
7605,11769,1355,5745,928,10414,708,347,361
7610,11779,1356,5749,928,10423,708,347,361
7615,11785,1356,5752,928,10428,710,348,362
7620,11796,1358,5756,930,10438,711,348,363
7625,11800,1359,5758,931,10441,711,348,363
7630,11810,1360,5759,931,10450,711,348,363
7635,11816,1360,5762,931,10456,713,349,364
7640,11827,1363,5768,933,10464,713,349,364
7645,11831,1364,5772,934,10467,713,349,364
7650,11841,1365,5776,934,10476,713,349,364
7655,11847,1365,5778,934,10481,714,350,364
7660,11858,1368,5783,937,10490,714,350,364
7665,11862,1369,5787,938,10493,714,350,364
7670,11872,1371,5793,938,10501,714,350,364
7675,11878,1371,5796,938,10506,715,350,365
7680,11889,1374,5803,941,10515,715,350,365
7685,11893,1375,5806,942,10518,715,350,365
7690,11903,1377,5813,944,10526,715,350,365
7695,11909,1377,5814,944,10532,716,350,366
7700,11920,1379,5823,946,10541,716,350,366
7705,11924,1380,5825,947,10544,716,350,366
7710,11934,1381,5830,948,10553,716,350,366
7715,11940,1381,5832,948,10559,717,350,367
7720,11951,1383,5837,949,10568,717,350,367
7725,11955,1384,5839,950,10571,717,350,367
7730,11965,1385,5845,951,10580,717,350,367
7735,11971,1385,5846,951,10586,718,350,368
7740,11982,1388,5851,953,10594,718,350,368
7745,11986,1388,5853,953,10598,718,350,368
7750,11996,1389,5857,953,10607,718,350,368
7755,12002,1389,5860,953,10613,720,350,370
7760,12013,1391,5866,955,10622,720,350,370
7765,12017,1391,5868,955,10626,720,350,370
7770,12027,1391,5874,955,10636,720,350,370
7775,12033,1391,5877,955,10642,722,352,370
7780,12044,1391,5883,955,10653,722,352,370
7785,12048,1391,5885,955,10657,722,352,370
7790,12058,1391,5889,955,10667,722,352,370
7795,12064,1391,5894,955,10673,724,354,370
7800,12075,1391,5899,955,10684,725,354,371
7805,12079,1391,5901,955,10688,725,354,371
7810,12089,1391,5907,955,10698,725,354,371
7815,12095,1391,5913,955,10704,726,355,371
7820,12106,1391,5917,955,10715,727,355,372
7825,12110,1391,5918,955,10719,727,355,372
7830,12120,1391,5923,955,10729,727,355,372
7835,12126,1391,5928,955,10735,728,356,372
7840,12137,1391,5936,955,10746,729,357,372
7845,12141,1391,5937,955,10750,729,357,372
7850,12151,1392,5940,955,10759,729,357,372
7855,12157,1392,5944,955,10765,730,358,372
7860,12168,1394,5949,956,10774,731,359,372
7865,12172,1395,5952,957,10777,731,359,372
7870,12182,1396,5955,957,10786,731,359,372
7875,12188,1396,5958,957,10792,732,360,372
7880,12199,1397,5960,958,10802,733,360,373
7885,12203,1397,5962,958,10806,733,360,373
7890,12213,1398,5966,958,10815,733,360,373
7895,12219,1398,5971,958,10821,734,361,373
7900,12230,1399,5978,959,10831,735,362,373
7905,12234,1399,5978,959,10835,735,362,373
7910,12244,1400,5986,960,10844,735,362,373
7915,12250,1400,5987,960,10850,737,363,374
7920,12261,1402,5992,961,10859,738,364,374
7925,12265,1402,5992,961,10863,738,364,374
7930,12275,1403,5994,962,10872,738,364,374
7935,12281,1403,5996,962,10878,739,365,374
7940,12292,1404,6001,962,10888,739,365,374
7945,12296,1404,6003,962,10892,739,365,374
7950,12306,1405,6005,963,10901,739,365,374
7955,12312,1405,6005,963,10907,740,365,375
7960,12323,1406,6010,964,10917,740,365,375
7965,12327,1406,6013,964,10921,740,365,375
7970,12337,1408,6017,966,10929,740,365,375
7975,12343,1408,6020,966,10934,741,366,375
7980,12354,1413,6024,970,10941,741,366,375
7985,12358,1413,6024,970,10945,741,366,375
7990,12368,1414,6028,970,10954,741,366,375
7995,12374,1414,6031,970,10960,742,366,376
8000,12385,1415,6032,970,10970,742,366,376
8005,12389,1415,6032,970,10974,742,366,376
8010,12399,1416,6036,970,10983,742,366,376
8015,12405,1416,6037,970,10989,743,366,377
8020,12416,1418,6042,972,10998,743,366,377
8025,12420,1419,6044,973,11001,743,366,377
8030,12430,1420,6048,973,11010,743,366,377
8035,12436,1420,6049,973,11016,745,366,379
8040,12447,1421,6054,974,11026,746,367,379
8045,12451,1421,6056,974,11030,746,367,379
8050,12461,1421,6064,974,11040,746,367,379
8055,12467,1421,6065,974,11046,747,368,379
8060,12478,1422,6066,974,11056,748,369,379
8065,12482,1423,6068,975,11059,748,369,379
8070,12492,1423,6075,975,11069,748,369,379
8075,12498,1423,6078,975,11075,749,370,379
8080,12509,1425,6083,976,11084,750,371,379
8085,12513,1425,6084,976,11088,750,371,379
8090,12523,1425,6087,976,11098,750,371,379
8095,12529,1425,6090,976,11103,751,372,379
8100,12540,1429,6096,980,11110,752,372,380
8105,12544,1431,6098,982,11113,752,372,380
8110,12554,1433,6102,983,11121,752,372,380
8115,12560,1433,6103,983,11127,753,372,381
8120,12571,1433,6109,983,11138,754,372,382
8125,12575,1433,6111,983,11142,754,372,382
8130,12585,1435,6117,984,11150,754,372,382
8135,12591,1435,6119,984,11156,755,372,383
8140,12602,1435,6125,984,11167,756,372,384
8145,12606,1435,6127,984,11171,756,372,384
8150,12616,1437,6133,985,11179,756,372,384
8155,12622,1437,6136,985,11185,758,373,385
8160,12633,1437,6143,985,11196,759,373,386
8165,12637,1437,6145,985,11200,759,373,386
8170,12647,1438,6149,986,11209,759,373,386
8175,12653,1438,6152,986,11215,761,373,388
8180,12664,1438,6155,986,11226,761,373,388
8185,12668,1438,6158,986,11230,761,373,388
8190,12678,1439,6163,986,11239,761,373,388
8195,12684,1439,6166,986,11245,762,373,389
8200,12695,1440,6171,987,11255,762,373,389
8205,12699,1440,6175,987,11259,762,373,389
8210,12709,1441,6176,988,11268,762,373,389
8215,12715,1441,6179,988,11274,763,374,389
8220,12726,1441,6181,988,11285,763,374,389
8225,12730,1442,6184,989,11288,763,374,389
8230,12740,1443,6188,989,11297,763,374,389
8235,12746,1443,6189,989,11303,764,374,390
8240,12757,1443,6190,989,11314,764,374,390
8245,12761,1444,6192,990,11317,764,374,390
8250,12771,1445,6198,991,11326,764,374,390
8255,12777,1445,6200,991,11332,765,374,391
8260,12788,1447,6206,993,11341,765,374,391
8265,12792,1448,6208,994,11344,765,374,391
8270,12802,1449,6213,995,11353,765,374,391
8275,12808,1449,6216,995,11359,766,375,391
8280,12819,1452,6220,997,11367,767,375,392
8285,12823,1453,6223,998,11370,767,375,392
8290,12833,1453,6230,998,11380,767,375,392
8295,12839,1453,6231,998,11386,768,375,393
8300,12850,1456,6239,1001,11394,769,376,393
8305,12854,1457,6241,1002,11397,769,376,393
8310,12864,1457,6246,1002,11407,769,376,393
8315,12870,1457,6250,1002,11413,770,377,393
8320,12881,1460,6256,1005,11421,771,378,393
8325,12885,1460,6259,1005,11425,771,378,393
8330,12895,1462,6262,1006,11433,771,378,393
8335,12901,1462,6266,1006,11439,773,380,393
8340,12912,1464,6271,1007,11447,774,381,393
8345,12916,1465,6272,1008,11451,774,381,393
8350,12926,1466,6275,1008,11460,774,381,393
8355,12932,1466,6277,1008,11466,775,381,394
8360,12943,1467,6283,1009,11476,776,381,395
8365,12947,1467,6286,1009,11480,776,381,395
8370,12957,1468,6291,1010,11489,776,381,395
8375,12963,1468,6293,1010,11495,777,382,395
8380,12974,1469,6301,1011,11505,778,383,395
8385,12978,1469,6303,1011,11509,778,383,395
8390,12988,1470,6310,1011,11518,778,383,395
8395,12994,1470,6314,1011,11524,779,384,395
8400,13005,1471,6321,1012,11534,780,385,395
8405,13009,1472,6324,1013,11537,780,385,395
8410,13019,1474,6328,1013,11545,780,385,395
8415,13025,1474,6331,1013,11551,781,385,396
8420,13036,1475,6339,1014,11561,782,386,396
8425,13040,1475,6342,1014,11565,782,386,396
8430,13050,1477,6347,1014,11573,782,386,396
8435,13056,1477,6351,1014,11579,783,387,396
8440,13067,1478,6358,1015,11589,784,388,396
8445,13071,1478,6359,1015,11593,784,388,396
8450,13081,1480,6363,1015,11601,784,388,396
8455,13087,1480,6366,1015,11606,785,389,396
8460,13098,1482,6368,1016,11615,786,389,397
8465,13102,1483,6368,1017,11619,786,389,397
8470,13112,1485,6373,1018,11627,786,389,397
8475,13118,1485,6376,1018,11632,787,389,398
8480,13129,1487,6382,1019,11642,788,390,398
8485,13133,1489,6385,1021,11644,788,390,398
8490,13143,1491,6387,1021,11652,788,390,398
8495,13149,1491,6389,1021,11658,789,390,399
8500,13160,1492,6394,1021,11668,790,390,400
8505,13164,1493,6396,1022,11671,790,390,400
8510,13174,1495,6401,1023,11679,790,390,400
8515,13180,1495,6404,1023,11685,791,391,400
8520,13191,1498,6410,1026,11693,792,392,400
8525,13195,1498,6413,1026,11697,792,392,400
8530,13205,1498,6416,1026,11707,792,392,400
8535,13211,1498,6419,1026,11713,793,393,400
8540,13222,1498,6423,1026,11724,793,393,400
8545,13226,1498,6425,1026,11728,793,393,400
8550,13236,1498,6432,1026,11738,793,393,400
8555,13242,1498,6433,1026,11744,794,393,401
8560,13253,1498,6440,1026,11755,794,393,401
8565,13257,1498,6442,1026,11759,794,393,401
8570,13267,1498,6445,1026,11769,794,393,401
8575,13273,1498,6445,1026,11775,795,393,402
8580,13284,1498,6449,1026,11786,795,393,402
8585,13288,1498,6452,1026,11790,795,393,402
8590,13298,1498,6456,1026,11800,795,393,402
8595,13304,1498,6461,1026,11806,796,394,402
8600,13315,1498,6465,1026,11817,796,394,402
8605,13319,1498,6466,1026,11821,796,394,402
8610,13329,1498,6474,1026,11831,796,394,402
8615,13335,1498,6478,1026,11837,797,394,403
8620,13346,1498,6486,1026,11848,797,394,403
8625,13350,1498,6488,1026,11852,797,394,403
8630,13360,1500,6491,1027,11860,797,394,403
8635,13366,1500,6495,1027,11865,798,394,404
8640,13377,1504,6501,1030,11872,799,395,404
8645,13381,1505,6503,1031,11876,799,395,404
8650,13391,1507,6506,1032,11884,799,395,404
8655,13397,1507,6511,1032,11889,800,396,404
8660,13408,1510,6517,1034,11897,800,396,404
8665,13412,1511,6520,1035,11901,800,396,404
8670,13422,1513,6528,1037,11909,800,396,404
8675,13428,1513,6530,1037,11914,801,396,405
8680,13439,1516,6536,1039,11922,801,396,405
8685,13443,1517,6538,1040,11926,801,396,405
8690,13453,1519,6541,1040,11934,801,396,405
8695,13459,1519,6543,1040,11940,802,396,406
8700,13470,1521,6550,1042,11949,802,396,406
8705,13474,1522,6554,1043,11952,802,396,406
8710,13484,1524,6556,1043,11960,802,396,406
8715,13490,1524,6558,1043,11966,803,396,407
8720,13501,1526,6563,1044,11975,804,397,407
8725,13505,1527,6566,1045,11978,804,397,407
8730,13515,1529,6571,1047,11986,804,397,407
8735,13521,1529,6575,1047,11992,805,398,407
8740,13532,1531,6582,1048,12001,806,399,407
8745,13536,1532,6586,1049,12004,806,399,407
8750,13546,1534,6590,1050,12012,806,399,407
8755,13552,1534,6592,1050,12018,807,399,408
8760,13563,1537,6598,1052,12026,808,400,408
8765,13567,1537,6600,1052,12030,808,400,408
8770,13577,1537,6606,1052,12040,808,400,408
8775,13583,1537,6611,1052,12046,809,401,408
8780,13594,1538,6616,1053,12056,809,401,408
8785,13598,1538,6619,1053,12060,809,401,408
8790,13608,1538,6623,1053,12070,809,401,408
8795,13614,1538,6624,1053,12076,810,401,409
8800,13625,1540,6628,1054,12085,810,401,409
8805,13629,1541,6632,1055,12088,810,401,409
8810,13639,1541,6634,1055,12098,810,401,409
8815,13645,1541,6637,1055,12104,811,402,409
8820,13656,1543,6642,1057,12113,811,402,409
8825,13660,1543,6644,1057,12117,811,402,409
8830,13670,1543,6649,1057,12127,811,402,409
8835,13676,1543,6652,1057,12133,812,402,410
8840,13687,1543,6658,1057,12144,812,402,410
8845,13691,1543,6660,1057,12148,812,402,410
8850,13701,1543,6664,1057,12158,812,402,410
8855,13707,1543,6667,1057,12164,813,402,411
8860,13718,1543,6669,1057,12175,813,402,411
8865,13722,1543,6671,1057,12179,813,402,411
8870,13732,1545,6673,1058,12187,813,402,411
8875,13738,1545,6677,1058,12193,814,403,411
8880,13749,1546,6683,1059,12202,815,404,411
8885,13753,1547,6684,1060,12206,815,404,411
8890,13763,1549,6686,1060,12214,815,404,411
8895,13769,1549,6688,1060,12220,816,405,411
8900,13780,1550,6693,1061,12230,817,405,412
8905,13784,1550,6695,1061,12234,817,405,412
8910,13794,1552,6701,1062,12242,817,405,412
8915,13800,1552,6704,1062,12247,818,405,413
8920,13811,1555,6710,1065,12256,819,406,413
8925,13815,1555,6713,1065,12260,819,406,413
8930,13825,1557,6719,1066,12268,819,406,413
8935,13831,1557,6721,1066,12274,820,406,414
8940,13842,1559,6727,1067,12283,821,406,415
8945,13846,1559,6728,1067,12287,821,406,415
8950,13856,1560,6731,1067,12296,821,406,415
8955,13862,1560,6732,1067,12302,822,407,415
8960,13873,1562,6736,1069,12311,822,407,415
8965,13877,1562,6737,1069,12315,822,407,415
8970,13887,1563,6741,1069,12324,822,407,415
8975,13893,1563,6743,1069,12330,823,407,416
8980,13904,1565,6746,1070,12339,823,407,416
8985,13908,1566,6747,1071,12342,823,407,416
8990,13918,1567,6753,1072,12351,823,407,416
8995,13924,1567,6754,1072,12357,824,407,417
9000,13935,1568,6758,1072,12367,825,407,418
9005,13939,1568,6760,1072,12371,825,407,418
9010,13949,1569,6766,1072,12380,825,407,418
9015,13955,1569,6769,1072,12386,826,407,419
9020,13966,1571,6772,1073,12395,827,407,420
9025,13970,1571,6773,1073,12399,827,407,420
9030,13980,1572,6777,1073,12408,827,407,420
9035,13986,1572,6781,1073,12414,828,408,420
9040,13997,1573,6787,1074,12424,829,409,420
9045,14001,1573,6788,1074,12428,829,409,420
9050,14011,1575,6791,1074,12436,829,409,420
9055,14017,1575,6794,1074,12442,831,409,422
9060,14028,1577,6799,1076,12451,832,409,423
9065,14032,1577,6800,1076,12455,832,409,423
9070,14042,1580,6802,1077,12462,832,409,423
9075,14048,1580,6804,1077,12468,834,409,425
9080,14059,1581,6810,1078,12478,834,409,425
9085,14063,1581,6812,1078,12482,834,409,425
9090,14073,1584,6820,1081,12489,834,409,425
9095,14079,1584,6821,1081,12495,836,409,427
9100,14090,1586,6829,1083,12504,836,409,427
9105,14094,1587,6832,1084,12507,836,409,427
9110,14104,1589,6836,1086,12515,836,409,427
9115,14110,1589,6838,1086,12521,838,411,427
9120,14121,1590,6843,1086,12531,838,411,427
9125,14125,1590,6843,1086,12535,838,411,427
9130,14135,1591,6848,1086,12544,838,411,427
9135,14141,1591,6853,1086,12550,839,412,427
9140,14152,1591,6856,1086,12561,839,412,427
9145,14156,1591,6856,1086,12565,839,412,427
9150,14166,1592,6862,1087,12574,839,412,427
9155,14172,1592,6864,1087,12580,840,413,427
9160,14183,1592,6868,1087,12591,840,413,427
9165,14187,1592,6868,1087,12595,840,413,427
9170,14197,1593,6873,1088,12604,840,413,427
9175,14203,1593,6874,1088,12610,841,413,428
9180,14214,1594,6878,1089,12620,842,413,429
9185,14218,1595,6880,1090,12623,842,413,429
9190,14228,1596,6886,1090,12632,842,413,429
9195,14234,1596,6887,1090,12638,843,413,430
9200,14245,1597,6895,1091,12648,844,413,431
9205,14249,1597,6898,1091,12652,844,413,431
9210,14259,1598,6902,1092,12661,844,413,431
9215,14265,1598,6908,1092,12666,845,414,431
9220,14276,1600,6914,1094,12676,846,414,432
9225,14280,1600,6917,1094,12680,846,414,432
9230,14290,1601,6924,1095,12689,846,414,432
9235,14296,1601,6926,1095,12694,848,414,434
9240,14307,1603,6930,1096,12704,849,414,435
9245,14311,1603,6931,1096,12708,849,414,435
9250,14321,1604,6937,1097,12717,849,414,435
9255,14327,1604,6941,1097,12723,850,414,436
9260,14338,1606,6947,1099,12732,850,414,436
9265,14342,1606,6948,1099,12736,850,414,436
9270,14352,1607,6953,1099,12745,850,414,436
9275,14358,1607,6955,1099,12751,851,414,437
9280,14369,1609,6956,1100,12760,851,414,437
9285,14373,1609,6958,1100,12764,851,414,437
9290,14383,1610,6964,1101,12773,851,414,437
9295,14389,1610,6967,1101,12779,852,415,437
9300,14400,1611,6972,1101,12789,852,415,437
9305,14404,1611,6975,1101,12793,852,415,437
9310,14414,1613,6977,1101,12801,852,415,437
9315,14420,1613,6978,1101,12807,853,415,438
9320,14431,1615,6985,1103,12816,853,415,438
9325,14435,1615,6986,1103,12820,853,415,438
9330,14445,1617,6992,1105,12828,853,415,438
9335,14451,1617,6995,1105,12834,854,416,438
9340,14462,1618,7001,1106,12844,854,416,438
9345,14466,1618,7004,1106,12848,854,416,438
9350,14476,1620,7010,1106,12856,854,416,438
9355,14482,1620,7012,1106,12861,856,417,439
9360,14493,1624,7015,1109,12869,857,417,440
9365,14497,1625,7016,1110,12872,857,417,440
9370,14507,1626,7021,1111,12881,857,417,440
9375,14513,1626,7023,1111,12887,858,417,441
9380,14524,1626,7028,1111,12898,858,417,441
9385,14528,1626,7030,1111,12902,858,417,441
9390,14538,1627,7034,1111,12911,858,417,441
9395,14544,1627,7037,1111,12917,859,418,441
9400,14555,1627,7044,1111,12928,859,418,441
9405,14559,1628,7047,1112,12931,859,418,441
9410,14569,1629,7051,1112,12940,859,418,441
9415,14575,1629,7055,1112,12946,860,419,441
9420,14586,1629,7062,1112,12957,860,419,441
9425,14590,1629,7066,1112,12961,860,419,441
9430,14600,1630,7071,1113,12970,860,419,441
9435,14606,1630,7076,1113,12976,861,420,441
9440,14617,1630,7079,1113,12987,861,420,441
9445,14621,1630,7080,1113,12991,861,420,441
9450,14631,1631,7083,1113,13000,861,420,441
9455,14637,1631,7085,1113,13006,862,420,442
9460,14648,1631,7090,1113,13017,862,420,442
9465,14652,1631,7091,1113,13021,862,420,442
9470,14662,1633,7097,1115,13029,862,420,442
9475,14668,1633,7099,1115,13035,864,420,444
9480,14679,1635,7103,1116,13044,865,421,444
9485,14683,1635,7105,1116,13048,865,421,444
9490,14693,1637,7109,1117,13056,865,421,444
9495,14699,1637,7111,1117,13062,866,421,445
9500,14710,1639,7119,1119,13071,867,422,445
9505,14714,1639,7120,1119,13075,867,422,445
9510,14724,1641,7124,1120,13083,867,422,445
9515,14730,1641,7127,1120,13089,868,422,446
9520,14741,1642,7134,1121,13099,869,423,446
9525,14745,1642,7135,1121,13103,869,423,446
9530,14755,1644,7140,1122,13111,869,423,446
9535,14761,1644,7144,1122,13117,870,424,446
9540,14772,1645,7150,1123,13127,871,425,446
9545,14776,1645,7154,1123,13131,871,425,446
9550,14786,1647,7161,1124,13139,871,425,446
9555,14792,1647,7163,1124,13145,872,425,447
9560,14803,1649,7170,1126,13154,873,426,447
9565,14807,1649,7172,1126,13158,873,426,447
9570,14817,1651,7177,1127,13166,873,426,447
9575,14823,1651,7180,1127,13172,874,426,448
9580,14834,1652,7185,1128,13182,875,426,449
9585,14838,1652,7186,1128,13186,875,426,449
9590,14848,1655,7188,1130,13193,875,426,449
9595,14854,1655,7192,1130,13198,877,427,450
9600,14865,1659,7198,1133,13205,878,427,451
9605,14869,1661,7200,1135,13208,878,427,451
9610,14879,1661,7201,1135,13218,878,427,451
9615,14885,1661,7202,1135,13224,879,427,452
9620,14896,1662,7209,1136,13234,879,427,452
9625,14900,1662,7211,1136,13238,879,427,452
9630,14910,1662,7216,1136,13248,879,427,452
9635,14916,1662,7218,1136,13254,880,428,452
9640,14927,1663,7220,1136,13264,880,428,452
9645,14931,1664,7223,1137,13267,880,428,452
9650,14941,1664,7228,1137,13277,880,428,452
9655,14947,1664,7232,1137,13283,881,429,452
9660,14958,1665,7237,1138,13293,881,429,452
9665,14962,1666,7239,1139,13296,881,429,452
9670,14972,1666,7243,1139,13306,881,429,452
9675,14978,1666,7247,1139,13312,882,430,452
9680,14989,1667,7253,1140,13322,882,430,452
9685,14993,1667,7254,1140,13326,882,430,452
9690,15003,1667,7256,1140,13336,882,430,452
9695,15009,1667,7258,1140,13342,883,430,453
9700,15020,1668,7263,1141,13352,883,430,453
9705,15024,1668,7266,1141,13356,883,430,453
9710,15034,1671,7271,1142,13363,883,430,453
9715,15040,1671,7274,1142,13368,885,431,454
9720,15051,1674,7280,1144,13377,885,431,454
9725,15055,1674,7284,1144,13381,885,431,454
9730,15065,1676,7288,1145,13389,885,431,454
9735,15071,1676,7292,1145,13395,886,432,454
9740,15082,1679,7298,1148,13403,887,432,455
9745,15086,1679,7299,1148,13407,887,432,455
9750,15096,1681,7303,1148,13415,887,432,455
9755,15102,1681,7306,1148,13421,888,433,455
9760,15113,1683,7313,1149,13430,889,433,456
9765,15117,1683,7315,1149,13434,889,433,456
9770,15127,1685,7321,1150,13442,889,433,456
9775,15133,1685,7324,1150,13448,890,433,457
9780,15144,1686,7331,1150,13458,891,434,457
9785,15148,1687,7333,1151,13461,891,434,457
9790,15158,1689,7339,1153,13469,891,434,457
9795,15164,1689,7343,1153,13475,892,435,457
9800,15175,1692,7349,1156,13483,893,435,458
9805,15179,1692,7349,1156,13487,893,435,458
9810,15189,1694,7353,1157,13495,893,435,458
9815,15195,1694,7355,1157,13501,894,436,458
9820,15206,1695,7356,1158,13511,895,436,459
9825,15210,1696,7359,1159,13514,895,436,459
9830,15220,1698,7366,1161,13522,895,436,459
9835,15226,1698,7369,1161,13527,897,438,459
9840,15237,1702,7373,1165,13535,898,438,460
9845,15241,1702,7373,1165,13539,898,438,460
9850,15251,1703,7380,1166,13548,898,438,460
9855,15257,1703,7383,1166,13554,899,439,460
9860,15268,1703,7386,1166,13565,899,439,460
9865,15272,1703,7387,1166,13569,899,439,460
9870,15282,1704,7391,1167,13578,899,439,460
9875,15288,1704,7392,1167,13584,900,439,461
9880,15299,1704,7395,1167,13595,900,439,461
9885,15303,1704,7397,1167,13599,900,439,461
9890,15313,1705,7404,1167,13608,900,439,461
9895,15319,1705,7407,1167,13614,901,440,461
9900,15330,1705,7413,1167,13625,901,440,461
9905,15334,1705,7415,1167,13629,901,440,461
9910,15344,1706,7420,1167,13638,901,440,461
9915,15350,1706,7424,1167,13644,902,441,461
9920,15361,1706,7431,1167,13655,902,441,461
9925,15365,1706,7435,1167,13659,902,441,461
9930,15375,1707,7439,1168,13668,902,441,461
9935,15381,1707,7442,1168,13674,903,441,462
9940,15392,1707,7448,1168,13685,903,441,462
9945,15396,1707,7448,1168,13689,903,441,462
9950,15406,1709,7454,1170,13697,903,441,462
9955,15412,1709,7457,1170,13703,905,442,463
9960,15423,1709,7459,1170,13714,905,442,463
9965,15427,1710,7461,1171,13717,905,442,463
9970,15437,1712,7464,1171,13725,905,442,463
9975,15443,1712,7469,1171,13730,906,443,463
9980,15454,1715,7473,1173,13739,906,443,463
9985,15458,1716,7474,1174,13742,906,443,463
9990,15468,1718,7478,1175,13750,906,443,463
9995,15474,1718,7481,1175,13756,907,443,464
10000,15485,1720,7488,1176,13765,907,443,464
10005,15489,1720,7490,1176,13769,907,443,464
10010,15499,1721,7495,1176,13778,907,443,464
10015,15505,1721,7498,1176,13784,908,444,464
10020,15516,1723,7504,1177,13793,908,444,464
10025,15520,1723,7507,1177,13797,908,444,464
10030,15530,1724,7511,1178,13806,908,444,464
10035,15536,1724,7514,1178,13812,909,444,465
10040,15547,1726,7520,1179,13821,910,445,465
10045,15551,1726,7523,1179,13825,910,445,465
10050,15561,1727,7527,1180,13834,910,445,465
10055,15567,1727,7530,1180,13840,911,446,465
10060,15578,1729,7537,1182,13849,912,446,466
10065,15582,1729,7539,1182,13853,912,446,466
10070,15592,1730,7544,1182,13862,912,446,466
10075,15598,1730,7547,1182,13868,914,447,467
10080,15609,1734,7554,1186,13875,915,448,467
10085,15613,1734,7557,1186,13879,915,448,467
10090,15623,1735,7563,1187,13888,915,448,467
10095,15629,1735,7568,1187,13894,916,449,467
10100,15640,1736,7576,1188,13904,917,450,467
10105,15644,1736,7578,1188,13908,917,450,467
10110,15654,1738,7583,1190,13916,917,450,467
10115,15660,1738,7586,1190,13921,918,451,467
10120,15671,1741,7594,1193,13930,919,452,467
10125,15675,1742,7598,1194,13933,919,452,467
10130,15685,1744,7603,1196,13941,919,452,467
10135,15691,1744,7607,1196,13947,920,453,467
10140,15702,1744,7610,1196,13958,921,453,468
10145,15706,1744,7611,1196,13962,921,453,468
10150,15716,1746,7616,1197,13970,921,453,468
10155,15722,1746,7620,1197,13976,922,454,468
10160,15733,1747,7626,1198,13985,923,454,469
10165,15737,1749,7628,1200,13988,923,454,469
10170,15747,1752,7633,1202,13995,923,454,469
10175,15753,1752,7638,1202,14001,924,455,469
10180,15764,1752,7643,1202,14012,925,455,470
10185,15768,1752,7644,1202,14016,925,455,470
10190,15778,1755,7649,1203,14023,925,455,470
10195,15784,1755,7653,1203,14029,927,456,471
10200,15795,1757,7658,1205,14038,928,456,472
10205,15799,1758,7659,1206,14041,928,456,472
10210,15809,1760,7661,1207,14049,928,456,472
10215,15815,1760,7664,1207,14055,929,456,473
10220,15826,1761,7673,1208,14065,930,457,473
10225,15830,1762,7675,1209,14068,930,457,473
10230,15840,1764,7680,1211,14076,930,457,473
10235,15846,1764,7683,1211,14082,931,457,474
10240,15857,1765,7689,1212,14092,932,457,475
10245,15861,1767,7692,1214,14094,932,457,475
10250,15871,1769,7699,1215,14102,932,457,475
10255,15877,1769,7702,1215,14107,933,457,476
10260,15888,1772,7705,1217,14116,934,457,477
10265,15892,1772,7706,1217,14120,934,457,477
10270,15902,1772,7710,1217,14130,934,457,477
10275,15908,1772,7714,1217,14136,935,458,477
10280,15919,1773,7718,1217,14146,935,458,477
10285,15923,1773,7719,1217,14150,935,458,477
10290,15933,1773,7722,1217,14160,935,458,477
10295,15939,1773,7725,1217,14166,936,458,478
10300,15950,1774,7730,1217,14176,936,458,478
10305,15954,1774,7731,1217,14180,936,458,478
10310,15964,1774,7736,1217,14190,936,458,478
10315,15970,1774,7739,1217,14196,938,459,479
10320,15981,1777,7747,1220,14204,938,459,479
10325,15985,1777,7750,1220,14208,938,459,479
10330,15995,1777,7758,1220,14218,938,459,479
10335,16001,1777,7759,1220,14224,939,459,480
10340,16012,1777,7767,1220,14235,939,459,480
10345,16016,1777,7769,1220,14239,939,459,480
10350,16026,1777,7776,1220,14249,939,459,480
10355,16032,1777,7779,1220,14255,940,460,480
10360,16043,1777,7783,1220,14266,940,460,480
10365,16047,1777,7786,1220,14270,940,460,480
10370,16057,1778,7793,1221,14279,940,460,480
10375,16063,1778,7795,1221,14285,941,460,481
10380,16074,1779,7800,1222,14295,942,460,482
10385,16078,1779,7801,1222,14299,942,460,482
10390,16088,1780,7808,1222,14308,942,460,482
10395,16094,1780,7812,1222,14314,943,461,482
10400,16105,1780,7818,1222,14325,944,462,482
10405,16109,1780,7821,1222,14329,944,462,482
10410,16119,1781,7825,1222,14338,944,462,482
10415,16125,1781,7829,1222,14343,945,463,482
10420,16136,1783,7839,1224,14353,946,464,482
10425,16140,1783,7841,1224,14357,946,464,482
10430,16150,1786,7847,1226,14364,946,464,482
10435,16156,1786,7852,1226,14369,948,466,482
10440,16167,1788,7857,1227,14379,949,467,482
10445,16171,1788,7857,1227,14383,949,467,482
10450,16181,1789,7861,1228,14392,949,467,482
10455,16187,1789,7863,1228,14398,950,467,483
10460,16198,1790,7866,1229,14408,950,467,483
10465,16202,1791,7868,1230,14411,950,467,483
10470,16212,1792,7873,1230,14420,950,467,483
10475,16218,1792,7879,1230,14426,951,468,483
10480,16229,1794,7884,1231,14435,951,468,483
10485,16233,1794,7886,1231,14439,951,468,483
10490,16243,1795,7890,1232,14448,951,468,483
10495,16249,1795,7893,1232,14454,952,469,483
10500,16260,1797,7899,1233,14463,952,469,483
10505,16264,1797,7901,1233,14467,952,469,483
10510,16274,1798,7904,1233,14476,952,469,483
10515,16280,1798,7907,1233,14482,953,469,484
10520,16291,1799,7912,1233,14492,953,469,484
10525,16295,1800,7915,1234,14495,953,469,484
10530,16305,1801,7920,1234,14504,953,469,484
10535,16311,1801,7923,1234,14510,954,470,484
10540,16322,1802,7930,1235,14520,954,470,484
10545,16326,1803,7931,1236,14523,954,470,484
10550,16336,1805,7937,1236,14531,954,470,484
10555,16342,1805,7941,1236,14536,956,472,484
10560,16353,1808,7944,1238,14544,957,473,484
10565,16357,1809,7946,1239,14548,957,473,484
10570,16367,1809,7951,1239,14558,957,473,484
10575,16373,1809,7954,1239,14564,958,474,484
10580,16384,1809,7959,1239,14575,958,474,484
10585,16388,1809,7962,1239,14579,958,474,484
10590,16398,1809,7967,1239,14589,958,474,484
10595,16404,1809,7971,1239,14595,959,475,484
10600,16415,1809,7977,1239,14606,959,475,484
10605,16419,1809,7978,1239,14610,959,475,484
10610,16429,1809,7985,1239,14620,959,475,484
10615,16435,1809,7986,1239,14626,960,476,484
10620,16446,1809,7990,1239,14637,960,476,484
10625,16450,1810,7994,1240,14640,960,476,484
10630,16460,1811,7998,1240,14649,960,476,484
10635,16466,1811,8001,1240,14655,961,476,485
10640,16477,1812,8007,1241,14664,962,476,486
10645,16481,1813,8010,1242,14668,962,476,486
10650,16491,1814,8013,1242,14677,962,476,486
10655,16497,1814,8015,1242,14683,963,476,487
10660,16508,1815,8019,1243,14692,963,476,487
10665,16512,1816,8020,1244,14696,963,476,487
10670,16522,1818,8027,1245,14704,963,476,487
10675,16528,1818,8028,1245,14710,965,476,489
10680,16539,1819,8032,1245,14719,966,476,490
10685,16543,1820,8033,1246,14723,966,476,490
10690,16553,1821,8040,1246,14732,966,476,490
10695,16559,1821,8044,1246,14738,967,477,490
10700,16570,1823,8048,1247,14747,967,477,490
10705,16574,1823,8052,1247,14751,967,477,490
10710,16584,1824,8054,1247,14760,967,477,490
10715,16590,1824,8058,1247,14766,968,477,491
10720,16601,1825,8060,1247,14776,968,477,491
10725,16605,1825,8063,1247,14780,968,477,491
10730,16615,1826,8068,1247,14789,968,477,491
10735,16621,1826,8070,1247,14795,969,478,491
10740,16632,1828,8075,1248,14804,969,478,491
10745,16636,1828,8076,1248,14808,969,478,491
10750,16646,1830,8082,1250,14816,969,478,491
10755,16652,1830,8084,1250,14822,970,478,492
10760,16663,1832,8090,1251,14831,970,478,492
10765,16667,1833,8091,1252,14834,970,478,492
10770,16677,1835,8096,1253,14842,970,478,492
10775,16683,1835,8100,1253,14848,971,478,493
10780,16694,1837,8105,1254,14857,971,478,493
10785,16698,1837,8105,1254,14861,971,478,493
10790,16708,1839,8108,1255,14869,971,478,493
10795,16714,1839,8111,1255,14875,973,479,494
10800,16725,1841,8114,1256,14884,974,479,495
10805,16729,1841,8114,1256,14888,974,479,495
10810,16739,1842,8118,1256,14897,974,479,495
10815,16745,1842,8120,1256,14903,975,479,496
10820,16756,1843,8125,1257,14913,975,479,496
10825,16760,1843,8129,1257,14917,975,479,496
10830,16770,1844,8131,1257,14926,975,479,496
10835,16776,1844,8134,1257,14932,976,479,497
10840,16787,1846,8139,1259,14941,976,479,497
10845,16791,1846,8140,1259,14945,976,479,497
10850,16801,1848,8145,1261,14953,976,479,497
10855,16807,1848,8148,1261,14958,977,479,498
10860,16818,1851,8154,1264,14967,977,479,498
10865,16822,1852,8157,1265,14970,977,479,498
10870,16832,1854,8162,1266,14978,977,479,498
10875,16838,1854,8165,1266,14984,978,479,499
10880,16849,1855,8169,1267,14994,979,480,499
10885,16853,1856,8172,1268,14997,979,480,499
10890,16863,1858,8175,1268,15005,979,480,499
10895,16869,1858,8178,1268,15011,980,481,499
10900,16880,1859,8183,1269,15021,981,481,500
10905,16884,1860,8185,1270,15024,981,481,500
10910,16894,1862,8191,1271,15032,981,481,500
10915,16900,1862,8193,1271,15037,983,481,502
10920,16911,1867,8200,1275,15044,984,481,503
10925,16915,1867,8203,1275,15048,984,481,503
10930,16925,1867,8208,1275,15058,984,481,503
10935,16931,1867,8211,1275,15064,985,482,503
10940,16942,1868,8215,1275,15074,985,482,503
10945,16946,1868,8216,1275,15078,985,482,503
10950,16956,1868,8221,1275,15088,985,482,503
10955,16962,1868,8225,1275,15094,986,482,504
10960,16973,1869,8229,1275,15104,986,482,504
10965,16977,1869,8231,1275,15108,986,482,504
10970,16987,1869,8236,1275,15118,986,482,504
10975,16993,1869,8239,1275,15124,987,483,504
10980,17004,1870,8244,1276,15134,987,483,504
10985,17008,1870,8246,1276,15138,987,483,504
10990,17018,1870,8251,1276,15148,987,483,504
10995,17024,1870,8253,1276,15154,988,483,505
11000,17035,1871,8258,1276,15164,988,483,505
11005,17039,1871,8260,1276,15168,988,483,505
11010,17049,1871,8266,1276,15178,988,483,505
11015,17055,1871,8269,1276,15184,989,484,505
11020,17066,1872,8276,1277,15194,989,484,505
11025,17070,1872,8278,1277,15198,989,484,505
11030,17080,1874,8284,1279,15206,989,484,505
11035,17086,1874,8287,1279,15211,991,485,506
11040,17097,1879,8293,1284,15218,992,485,507
11045,17101,1880,8296,1285,15221,992,485,507
11050,17111,1882,8302,1286,15229,992,485,507
11055,17117,1882,8305,1286,15235,993,486,507
11060,17128,1884,8310,1288,15244,993,486,507
11065,17132,1885,8311,1289,15247,993,486,507
11070,17142,1887,8315,1290,15255,993,486,507
11075,17148,1887,8318,1290,15261,994,486,508
11080,17159,1888,8322,1291,15271,994,486,508
11085,17163,1890,8326,1293,15273,994,486,508
11090,17173,1892,8333,1294,15281,994,486,508
11095,17179,1892,8338,1294,15287,995,487,508
11100,17190,1894,8343,1295,15296,995,487,508
11105,17194,1896,8347,1297,15298,995,487,508
11110,17204,1898,8350,1298,15306,995,487,508
11115,17210,1898,8353,1298,15312,996,488,508
11120,17221,1899,8356,1299,15322,996,488,508
11125,17225,1900,8357,1300,15325,996,488,508
11130,17235,1902,8362,1302,15333,996,488,508
11135,17241,1902,8364,1302,15339,997,489,508
11140,17252,1903,8369,1303,15349,997,489,508
11145,17256,1903,8371,1303,15353,997,489,508
11150,17266,1905,8372,1304,15361,997,489,508
11155,17272,1905,8376,1304,15367,999,491,508
11160,17283,1906,8380,1305,15377,1000,491,509
11165,17287,1907,8381,1306,15380,1000,491,509
11170,17297,1909,8386,1307,15388,1000,491,509
11175,17303,1909,8389,1307,15394,1001,491,510
11180,17314,1910,8394,1307,15404,1002,491,511
11185,17318,1911,8398,1308,15407,1002,491,511
11190,17328,1913,8404,1309,15415,1002,491,511
11195,17334,1913,8407,1309,15421,1003,491,512
11200,17345,1915,8411,1310,15430,1004,491,513
11205,17349,1915,8413,1310,15434,1004,491,513
11210,17359,1916,8417,1310,15443,1004,491,513
11215,17365,1916,8418,1310,15449,1005,492,513
11220,17376,1918,8421,1311,15458,1006,493,513
11225,17380,1918,8422,1311,15462,1006,493,513
11230,17390,1919,8425,1311,15471,1006,493,513
11235,17396,1919,8426,1311,15477,1007,493,514
11240,17407,1920,8432,1312,15487,1008,493,515
11245,17411,1920,8434,1312,15491,1008,493,515
11250,17421,1922,8441,1314,15499,1008,493,515
11255,17427,1922,8442,1314,15505,1009,493,516
11260,17438,1922,8448,1314,15516,1010,493,517
11265,17442,1922,8450,1314,15520,1010,493,517
11270,17452,1923,8455,1314,15529,1010,493,517
11275,17458,1923,8457,1314,15534,1012,493,519
11280,17469,1925,8461,1316,15543,1013,494,519
11285,17473,1927,8462,1318,15546,1013,494,519
11290,17483,1928,8469,1319,15555,1013,494,519
11295,17489,1928,8473,1319,15561,1014,495,519
11300,17500,1929,8476,1319,15571,1014,495,519
11305,17504,1930,8479,1320,15574,1014,495,519
11310,17514,1931,8485,1320,15583,1014,495,519
11315,17520,1931,8487,1320,15589,1015,496,519
11320,17531,1933,8490,1321,15598,1015,496,519
11325,17535,1934,8494,1322,15601,1015,496,519
11330,17545,1935,8499,1322,15610,1015,496,519
11335,17551,1935,8502,1322,15616,1016,497,519
11340,17562,1936,8506,1323,15626,1016,497,519
11345,17566,1937,8509,1324,15629,1016,497,519
11350,17576,1938,8515,1325,15638,1016,497,519
11355,17582,1938,8519,1325,15643,1017,498,519
11360,17593,1941,8523,1328,15652,1017,498,519
11365,17597,1942,8525,1329,15655,1017,498,519
11370,17607,1943,8532,1330,15664,1017,498,519
11375,17613,1943,8536,1330,15670,1018,499,519
11380,17624,1945,8539,1331,15679,1018,499,519
11385,17628,1945,8540,1331,15683,1018,499,519
11390,17638,1946,8545,1332,15692,1018,499,519
11395,17644,1946,8548,1332,15697,1020,501,519
11400,17655,1951,8556,1336,15703,1021,502,519
11405,17659,1952,8558,1337,15707,1021,502,519
11410,17669,1952,8562,1337,15717,1021,502,519
11415,17675,1952,8565,1337,15723,1022,502,520
11420,17686,1952,8571,1337,15734,1023,503,520
11425,17690,1952,8571,1337,15738,1023,503,520
11430,17700,1952,8574,1337,15748,1023,503,520
11435,17706,1952,8578,1337,15754,1024,504,520
11440,17717,1952,8583,1337,15765,1025,504,521
11445,17721,1952,8585,1337,15769,1025,504,521
11450,17731,1953,8590,1338,15778,1025,504,521
11455,17737,1953,8593,1338,15784,1026,504,522
11460,17748,1954,8597,1339,15794,1027,504,523
11465,17752,1954,8598,1339,15798,1027,504,523
11470,17762,1956,8603,1341,15806,1027,504,523
11475,17768,1956,8606,1341,15811,1028,504,524
11480,17779,1957,8611,1342,15822,1028,504,524
11485,17783,1957,8612,1342,15826,1028,504,524
11490,17793,1959,8617,1342,15834,1028,504,524
11495,17799,1959,8618,1342,15840,1029,504,525
11500,17810,1960,8624,1343,15850,1029,504,525
11505,17814,1961,8627,1344,15853,1029,504,525
11510,17824,1963,8631,1344,15861,1029,504,525
11515,17830,1963,8633,1344,15867,1031,505,526
11520,17841,1966,8638,1346,15875,1031,505,526
11525,17845,1968,8642,1348,15877,1031,505,526
11530,17855,1969,8646,1348,15886,1031,505,526
11535,17861,1969,8650,1348,15891,1032,505,527
11540,17872,1972,8655,1350,15900,1032,505,527
11545,17876,1972,8657,1350,15904,1032,505,527
11550,17886,1973,8663,1351,15913,1032,505,527
11555,17892,1973,8667,1351,15918,1033,506,527
11560,17903,1976,8674,1353,15927,1033,506,527
11565,17907,1976,8674,1353,15931,1033,506,527
11570,17917,1977,8678,1354,15940,1033,506,527
11575,17923,1977,8681,1354,15946,1034,507,527
11580,17934,1979,8688,1355,15955,1035,507,528
11585,17938,1979,8691,1355,15959,1035,507,528
11590,17948,1979,8695,1355,15969,1035,507,528
11595,17954,1979,8698,1355,15975,1036,508,528
11600,17965,1980,8705,1356,15985,1037,509,528
11605,17969,1980,8708,1356,15989,1037,509,528
11610,17979,1980,8713,1356,15999,1037,509,528
11615,17985,1980,8716,1356,16005,1038,510,528
11620,17996,1981,8723,1356,16015,1038,510,528
11625,18000,1981,8725,1356,16019,1038,510,528
11630,18010,1982,8730,1357,16028,1038,510,528
11635,18016,1982,8735,1357,16033,1040,512,528
11640,18027,1985,8743,1359,16042,1040,512,528
11645,18031,1985,8745,1359,16046,1040,512,528
11650,18041,1986,8750,1360,16055,1040,512,528
11655,18047,1986,8754,1360,16061,1042,512,530
11660,18058,1987,8759,1361,16071,1042,512,530
11665,18062,1987,8762,1361,16075,1042,512,530
11670,18072,1988,8769,1361,16084,1042,512,530
11675,18078,1988,8772,1361,16090,1043,513,530
11680,18089,1989,8774,1361,16100,1043,513,530
11685,18093,1989,8774,1361,16104,1043,513,530
11690,18103,1991,8777,1361,16112,1043,513,530
11695,18109,1991,8782,1361,16118,1044,514,530
11700,18120,1993,8786,1362,16127,1044,514,530
11705,18124,1993,8789,1362,16131,1044,514,530
11710,18134,1995,8793,1362,16139,1044,514,530
11715,18140,1995,8797,1362,16145,1045,514,531
11720,18151,1996,8802,1363,16155,1046,514,532
11725,18155,1997,8806,1364,16158,1046,514,532
11730,18165,1999,8809,1364,16166,1046,514,532
11735,18171,1999,8809,1364,16172,1047,514,533
11740,18182,2000,8815,1365,16182,1048,515,533
11745,18186,2000,8817,1365,16186,1048,515,533
11750,18196,2002,8823,1365,16194,1048,515,533
11755,18202,2002,8828,1365,16200,1049,516,533
11760,18213,2003,8832,1366,16210,1050,516,534
11765,18217,2004,8834,1367,16213,1050,516,534
11770,18227,2006,8840,1367,16221,1050,516,534
11775,18233,2006,8845,1367,16227,1052,518,534
11780,18244,2006,8850,1367,16238,1053,519,534
11785,18248,2007,8853,1368,16241,1053,519,534
11790,18258,2009,8858,1368,16249,1053,519,534
11795,18264,2009,8860,1368,16255,1054,519,535
11800,18275,2009,8867,1368,16266,1055,520,535
11805,18279,2009,8869,1368,16270,1055,520,535
11810,18289,2011,8872,1368,16278,1055,520,535
11815,18295,2011,8873,1368,16284,1056,521,535
11820,18306,2014,8878,1370,16291,1057,521,536
11825,18310,2015,8878,1371,16295,1057,521,536
11830,18320,2016,8884,1372,16304,1057,521,536
11835,18326,2016,8888,1372,16310,1058,522,536
11840,18337,2018,8893,1373,16319,1059,523,536
11845,18341,2018,8896,1373,16323,1059,523,536
11850,18351,2019,8900,1374,16332,1059,523,536
11855,18357,2019,8904,1374,16338,1060,524,536
11860,18368,2021,8910,1375,16347,1061,524,537
11865,18372,2021,8913,1375,16351,1061,524,537
11870,18382,2022,8918,1376,16360,1061,524,537
11875,18388,2022,8923,1376,16366,1062,525,537
11880,18399,2024,8930,1377,16375,1063,526,537
11885,18403,2024,8932,1377,16379,1063,526,537
11890,18413,2025,8938,1377,16388,1063,526,537
11895,18419,2025,8943,1377,16394,1064,527,537
11900,18430,2026,8950,1378,16404,1064,527,537
11905,18434,2026,8951,1378,16408,1064,527,537
11910,18444,2027,8956,1379,16417,1064,527,537
11915,18450,2027,8960,1379,16423,1065,527,538
11920,18461,2028,8967,1380,16433,1065,527,538
11925,18465,2028,8968,1380,16437,1065,527,538
11930,18475,2030,8971,1381,16445,1065,527,538
11935,18481,2030,8974,1381,16451,1066,528,538
11940,18492,2034,8978,1384,16458,1067,529,538
11945,18496,2034,8980,1384,16462,1067,529,538
11950,18506,2035,8985,1384,16471,1067,529,538
11955,18512,2035,8989,1384,16477,1068,530,538
11960,18523,2035,8993,1384,16488,1069,530,539
11965,18527,2035,8994,1384,16492,1069,530,539
11970,18537,2036,8999,1385,16501,1069,530,539
11975,18543,2036,9001,1385,16507,1070,530,540
11980,18554,2036,9005,1385,16518,1071,531,540
11985,18558,2036,9007,1385,16522,1071,531,540
11990,18568,2037,9014,1386,16531,1071,531,540
11995,18574,2037,9019,1386,16537,1072,532,540
12000,18585,2038,9025,1387,16547,1073,533,540
12005,18589,2038,9027,1387,16551,1073,533,540
12010,18599,2039,9032,1388,16560,1073,533,540
12015,18605,2039,9034,1388,16566,1074,533,541
12020,18616,2039,9038,1388,16577,1074,533,541
12025,18620,2039,9041,1388,16581,1074,533,541
12030,18630,2040,9044,1388,16590,1074,533,541
12035,18636,2040,9046,1388,16596,1075,534,541
12040,18647,2040,9053,1388,16607,1075,534,541
12045,18651,2040,9056,1388,16611,1075,534,541
12050,18661,2042,9060,1389,16619,1075,534,541
12055,18667,2042,9064,1389,16624,1076,535,541
12060,18678,2046,9072,1393,16632,1076,535,541
12065,18682,2046,9072,1393,16636,1076,535,541
12070,18692,2048,9076,1393,16644,1076,535,541
12075,18698,2048,9078,1393,16650,1077,535,542
12080,18709,2049,9082,1393,16660,1077,535,542
12085,18713,2049,9083,1393,16664,1077,535,542
12090,18723,2051,9088,1394,16672,1077,535,542
12095,18729,2051,9093,1394,16678,1078,536,542
12100,18740,2052,9101,1395,16688,1078,536,542
12105,18744,2053,9104,1396,16691,1078,536,542
12110,18754,2055,9109,1397,16699,1078,536,542
12115,18760,2055,9113,1397,16705,1079,536,543
12120,18771,2056,9115,1397,16715,1079,536,543
12125,18775,2056,9117,1397,16719,1079,536,543
12130,18785,2057,9119,1397,16728,1079,536,543
12135,18791,2057,9123,1397,16734,1080,537,543
12140,18802,2058,9132,1397,16744,1081,538,543
12145,18806,2058,9133,1397,16748,1081,538,543
12150,18816,2059,9137,1398,16757,1081,538,543
12155,18822,2059,9139,1398,16763,1083,538,545
12160,18833,2060,9142,1398,16773,1084,538,546
12165,18837,2060,9144,1398,16777,1084,538,546
12170,18847,2061,9152,1398,16786,1084,538,546
12175,18853,2061,9156,1398,16792,1085,539,546
12180,18864,2063,9162,1399,16801,1086,540,546
12185,18868,2065,9164,1401,16803,1086,540,546
12190,18878,2067,9172,1402,16811,1086,540,546
12195,18884,2067,9176,1402,16816,1087,541,546
12200,18895,2070,9179,1404,16825,1088,541,547
12205,18899,2071,9181,1405,16828,1088,541,547
12210,18909,2073,9189,1407,16836,1088,541,547
12215,18915,2073,9191,1407,16841,1089,541,548
12220,18926,2076,9195,1409,16850,1090,541,549
12225,18930,2077,9197,1410,16853,1090,541,549
12230,18940,2079,9201,1411,16861,1090,541,549
12235,18946,2079,9206,1411,16866,1091,541,550
12240,18957,2083,9209,1414,16874,1091,541,550
12245,18961,2083,9210,1414,16878,1091,541,550
12250,18971,2083,9217,1414,16888,1091,541,550
12255,18977,2083,9220,1414,16894,1092,541,551
12260,18988,2083,9226,1414,16905,1092,541,551
12265,18992,2083,9228,1414,16909,1092,541,551
12270,19002,2083,9230,1414,16919,1092,541,551
12275,19008,2083,9231,1414,16925,1093,541,552
12280,19019,2083,9236,1414,16936,1093,541,552
12285,19023,2083,9238,1414,16940,1093,541,552
12290,19033,2083,9243,1414,16950,1093,541,552
12295,19039,2083,9246,1414,16956,1095,543,552
12300,19050,2083,9252,1414,16967,1095,543,552
12305,19054,2083,9254,1414,16971,1095,543,552
12310,19064,2084,9256,1414,16980,1095,543,552
12315,19070,2084,9259,1414,16986,1096,543,553
12320,19081,2084,9266,1414,16997,1096,543,553
12325,19085,2084,9267,1414,17001,1096,543,553
12330,19095,2085,9276,1415,17010,1096,543,553
12335,19101,2085,9279,1415,17016,1097,543,554
12340,19112,2085,9283,1415,17027,1098,543,555
12345,19116,2085,9284,1415,17031,1098,543,555
12350,19126,2086,9292,1416,17040,1098,543,555
12355,19132,2086,9295,1416,17046,1099,543,556
12360,19143,2089,9302,1419,17053,1100,544,556
12365,19147,2090,9303,1420,17057,1100,544,556
12370,19157,2092,9306,1420,17065,1100,544,556
12375,19163,2092,9309,1420,17071,1101,544,557
12380,19174,2094,9312,1421,17080,1102,544,558
12385,19178,2096,9314,1423,17082,1102,544,558
12390,19188,2098,9321,1425,17090,1102,544,558
12395,19194,2098,9326,1425,17096,1103,544,559
12400,19205,2101,9333,1427,17104,1104,544,560
12405,19209,2102,9334,1428,17107,1104,544,560
12410,19219,2104,9339,1430,17115,1104,544,560
12415,19225,2104,9342,1430,17121,1106,545,561
12420,19236,2105,9346,1430,17131,1107,545,562
12425,19240,2105,9346,1430,17135,1107,545,562
12430,19250,2106,9350,1430,17144,1107,545,562
12435,19256,2106,9353,1430,17150,1108,545,563
12440,19267,2108,9358,1431,17159,1108,545,563
12445,19271,2108,9360,1431,17163,1108,545,563
12450,19281,2109,9365,1431,17172,1108,545,563
12455,19287,2109,9368,1431,17178,1109,546,563
12460,19298,2110,9371,1431,17188,1109,546,563
12465,19302,2111,9373,1432,17191,1109,546,563
12470,19312,2112,9377,1432,17200,1109,546,563
12475,19318,2112,9380,1432,17205,1110,546,564
12480,19329,2116,9385,1435,17212,1110,546,564
12485,19333,2117,9388,1436,17216,1110,546,564
12490,19343,2117,9394,1436,17226,1110,546,564
12495,19349,2117,9397,1436,17232,1111,546,565
12500,19360,2117,9402,1436,17243,1111,546,565
12505,19364,2117,9403,1436,17247,1111,546,565
12510,19374,2117,9409,1436,17257,1111,546,565
12515,19380,2117,9412,1436,17263,1112,546,566
12520,19391,2117,9417,1436,17274,1112,546,566
12525,19395,2117,9418,1436,17278,1112,546,566
12530,19405,2117,9423,1436,17288,1112,546,566
12535,19411,2117,9426,1436,17294,1114,547,567
12540,19422,2117,9433,1436,17305,1115,548,567
12545,19426,2117,9434,1436,17309,1115,548,567
12550,19436,2117,9439,1436,17319,1115,548,567
12555,19442,2117,9443,1436,17325,1116,549,567
12560,19453,2117,9449,1436,17336,1117,550,567
12565,19457,2117,9452,1436,17340,1117,550,567
12570,19467,2117,9456,1436,17350,1117,550,567
12575,19473,2117,9460,1436,17356,1118,550,568
12580,19484,2117,9464,1436,17367,1119,551,568
12585,19488,2117,9467,1436,17371,1119,551,568
12590,19498,2118,9472,1437,17380,1119,551,568
12595,19504,2118,9473,1437,17385,1120,551,569
12600,19515,2122,9478,1440,17392,1121,551,570
12605,19519,2124,9481,1442,17395,1121,551,570
12610,19529,2125,9487,1443,17404,1121,551,570
12615,19535,2125,9490,1443,17410,1122,552,570
12620,19546,2127,9496,1444,17418,1123,553,570
12625,19550,2129,9499,1446,17421,1123,553,570
12630,19560,2130,9502,1446,17430,1123,553,570
12635,19566,2130,9505,1446,17435,1124,553,571
12640,19577,2133,9510,1448,17443,1125,554,571
12645,19581,2134,9513,1449,17447,1125,554,571
12650,19591,2135,9517,1449,17456,1125,554,571
12655,19597,2135,9520,1449,17462,1127,555,572
12660,19608,2136,9525,1450,17472,1128,555,573
12665,19612,2136,9526,1450,17476,1128,555,573
12670,19622,2136,9529,1450,17486,1128,555,573
12675,19628,2136,9533,1450,17492,1129,556,573
12680,19639,2137,9540,1450,17502,1129,556,573
12685,19643,2138,9541,1451,17505,1129,556,573
12690,19653,2138,9544,1451,17515,1129,556,573
12695,19659,2138,9548,1451,17521,1130,556,574
12700,19670,2139,9554,1452,17531,1130,556,574
12705,19674,2140,9556,1453,17534,1130,556,574
12710,19684,2141,9559,1453,17543,1130,556,574
12715,19690,2141,9563,1453,17549,1131,557,574
12720,19701,2143,9570,1455,17558,1132,558,574
12725,19705,2143,9571,1455,17562,1132,558,574
12730,19715,2145,9577,1456,17570,1132,558,574
12735,19721,2145,9578,1456,17576,1133,558,575
12740,19732,2146,9585,1457,17586,1133,558,575
12745,19736,2146,9587,1457,17590,1133,558,575
12750,19746,2148,9595,1459,17598,1133,558,575
12755,19752,2148,9599,1459,17604,1134,559,575
12760,19763,2149,9604,1460,17614,1134,559,575
12765,19767,2149,9605,1460,17618,1134,559,575
12770,19777,2151,9610,1462,17626,1134,559,575
12775,19783,2151,9613,1462,17632,1136,561,575
12780,19794,2152,9617,1463,17642,1136,561,575
12785,19798,2153,9620,1464,17645,1136,561,575
12790,19808,2156,9627,1466,17652,1136,561,575
12795,19814,2156,9630,1466,17658,1137,562,575
12800,19825,2157,9634,1467,17667,1137,562,575
12805,19829,2159,9636,1469,17670,1137,562,575
12810,19839,2162,9641,1471,17677,1137,562,575
12815,19845,2162,9645,1471,17682,1138,562,576
12820,19856,2164,9651,1473,17692,1138,562,576
12825,19860,2165,9653,1474,17695,1138,562,576
12830,19870,2168,9659,1477,17702,1138,562,576
12835,19876,2168,9662,1477,17708,1139,563,576
12840,19887,2169,9666,1478,17717,1140,563,577
12845,19891,2171,9669,1480,17720,1140,563,577
12850,19901,2172,9674,1481,17729,1140,563,577
12855,19907,2172,9676,1481,17734,1141,563,578
12860,19918,2174,9680,1482,17744,1142,563,579
12865,19922,2175,9682,1483,17747,1142,563,579
12870,19932,2176,9686,1483,17756,1142,563,579
12875,19938,2176,9689,1483,17762,1143,564,579
12880,19949,2178,9693,1485,17771,1144,564,580
12885,19953,2179,9696,1486,17774,1144,564,580
12890,19963,2180,9698,1486,17783,1144,564,580
12895,19969,2180,9701,1486,17788,1145,565,580
12900,19980,2182,9707,1488,17798,1146,566,580
12905,19984,2182,9709,1488,17802,1146,566,580
12910,19994,2183,9711,1488,17811,1146,566,580
12915,20000,2183,9714,1488,17816,1147,567,580
12920,20011,2186,9720,1491,17825,1148,568,580
12925,20015,2187,9722,1492,17828,1148,568,580
12930,20025,2188,9728,1492,17837,1148,568,580
12935,20031,2188,9730,1492,17843,1149,569,580
12940,20042,2191,9735,1494,17851,1150,569,581
12945,20046,2191,9737,1494,17855,1150,569,581
12950,20056,2193,9743,1496,17863,1150,569,581
12955,20062,2193,9748,1496,17868,1151,569,582
12960,20073,2196,9754,1499,17877,1152,570,582
12965,20077,2196,9756,1499,17881,1152,570,582
12970,20087,2197,9762,1499,17890,1152,570,582
12975,20093,2197,9765,1499,17896,1153,570,583
12980,20104,2198,9772,1500,17906,1154,570,584
12985,20108,2198,9773,1500,17910,1154,570,584
12990,20118,2199,9774,1500,17919,1154,570,584
12995,20124,2199,9777,1500,17925,1155,571,584
13000,20135,2199,9781,1500,17936,1155,571,584
13005,20139,2199,9784,1500,17940,1155,571,584
13010,20149,2200,9787,1500,17949,1155,571,584
13015,20155,2200,9790,1500,17955,1156,572,584
13020,20166,2200,9794,1500,17966,1156,572,584
13025,20170,2200,9794,1500,17970,1156,572,584
13030,20180,2201,9799,1500,17979,1156,572,584
13035,20186,2201,9802,1500,17985,1158,574,584
13040,20197,2201,9808,1500,17996,1158,574,584
13045,20201,2201,9810,1500,18000,1158,574,584
13050,20211,2202,9814,1500,18009,1158,574,584
13055,20217,2202,9818,1500,18015,1160,576,584
13060,20228,2202,9822,1500,18026,1160,576,584
13065,20232,2202,9824,1500,18030,1160,576,584
13070,20242,2204,9829,1500,18038,1160,576,584
13075,20248,2204,9831,1500,18044,1161,576,585
13080,20259,2206,9836,1501,18053,1161,576,585
13085,20263,2206,9836,1501,18057,1161,576,585
13090,20273,2208,9841,1502,18065,1161,576,585
13095,20279,2208,9844,1502,18071,1162,577,585
13100,20290,2209,9846,1503,18081,1163,577,586
13105,20294,2209,9846,1503,18085,1163,577,586
13110,20304,2211,9851,1504,18093,1163,577,586
13115,20310,2211,9855,1504,18099,1164,578,586
13120,20321,2213,9858,1505,18108,1165,578,587
13125,20325,2214,9861,1506,18111,1165,578,587
13130,20335,2216,9867,1508,18119,1165,578,587
13135,20341,2216,9869,1508,18125,1166,578,588
13140,20352,2217,9873,1509,18135,1167,578,589
13145,20356,2217,9874,1509,18139,1167,578,589
13150,20366,2218,9879,1509,18148,1167,578,589
13155,20372,2218,9883,1509,18154,1168,579,589
13160,20383,2221,9890,1511,18162,1168,579,589
13165,20387,2222,9892,1512,18165,1168,579,589
13170,20397,2223,9899,1513,18174,1168,579,589
13175,20403,2223,9900,1513,18180,1169,579,590
13180,20414,2225,9906,1514,18189,1169,579,590
13185,20418,2226,9907,1515,18192,1169,579,590
13190,20428,2227,9912,1516,18201,1169,579,590
13195,20434,2227,9915,1516,18207,1170,579,591
13200,20445,2229,9920,1517,18215,1170,579,591
13205,20449,2231,9922,1519,18218,1170,579,591
13210,20459,2232,9924,1519,18227,1170,579,591
13215,20465,2232,9929,1519,18233,1171,579,592
13220,20476,2235,9934,1522,18241,1172,579,593
13225,20480,2236,9936,1523,18244,1172,579,593
13230,20490,2237,9941,1524,18253,1172,579,593
13235,20496,2237,9946,1524,18259,1173,580,593
13240,20507,2238,9951,1524,18269,1174,581,593
13245,20511,2239,9952,1525,18272,1174,581,593
13250,20521,2241,9958,1527,18280,1174,581,593
13255,20527,2241,9962,1527,18286,1175,582,593
13260,20538,2243,9964,1528,18295,1176,582,594
13265,20542,2243,9966,1528,18299,1176,582,594
13270,20552,2243,9972,1528,18309,1176,582,594
13275,20558,2243,9973,1528,18315,1177,582,595
13280,20569,2243,9978,1528,18326,1177,582,595
13285,20573,2243,9980,1528,18330,1177,582,595
13290,20583,2243,9984,1528,18340,1177,582,595
13295,20589,2243,9985,1528,18346,1178,582,596
13300,20600,2243,9992,1528,18357,1178,582,596
13305,20604,2243,9995,1528,18361,1178,582,596
13310,20614,2243,10005,1528,18371,1178,582,596
13315,20620,2243,10009,1528,18377,1179,583,596
13320,20631,2243,10016,1528,18388,1179,583,596
13325,20635,2243,10018,1528,18392,1179,583,596
13330,20645,2243,10021,1528,18402,1179,583,596
13335,20651,2243,10023,1528,18408,1180,584,596
13340,20662,2244,10029,1529,18418,1180,584,596
13345,20666,2244,10031,1529,18422,1180,584,596
13350,20676,2244,10036,1529,18432,1180,584,596
13355,20682,2244,10039,1529,18438,1181,584,597
13360,20693,2245,10043,1529,18448,1181,584,597
13365,20697,2245,10044,1529,18452,1181,584,597
13370,20707,2247,10049,1530,18460,1181,584,597
13375,20713,2247,10050,1530,18465,1182,584,598
13380,20724,2250,10054,1533,18474,1183,584,599
13385,20728,2250,10055,1533,18478,1183,584,599
13390,20738,2253,10062,1536,18485,1183,584,599
13395,20744,2253,10067,1536,18491,1184,585,599
13400,20755,2255,10070,1538,18500,1185,585,600
13405,20759,2255,10072,1538,18504,1185,585,600
13410,20769,2257,10078,1539,18512,1185,585,600
13415,20775,2257,10079,1539,18518,1186,585,601
13420,20786,2259,10083,1540,18527,1187,586,601
13425,20790,2259,10085,1540,18531,1187,586,601
13430,20800,2262,10091,1542,18538,1187,586,601
13435,20806,2262,10094,1542,18544,1188,587,601
13440,20817,2265,10101,1545,18552,1189,588,601
13445,20821,2265,10103,1545,18556,1189,588,601
13450,20831,2267,10108,1546,18564,1189,588,601
13455,20837,2267,10112,1546,18570,1190,589,601
13460,20848,2267,10119,1546,18581,1191,590,601
13465,20852,2267,10121,1546,18585,1191,590,601
13470,20862,2269,10126,1547,18593,1191,590,601
13475,20868,2269,10129,1547,18599,1192,591,601
13480,20879,2269,10133,1547,18610,1193,591,602
13485,20883,2269,10134,1547,18614,1193,591,602
13490,20893,2271,10138,1548,18622,1193,591,602
13495,20899,2271,10141,1548,18627,1194,591,603
13500,20910,2275,10149,1552,18635,1195,592,603
13505,20914,2276,10152,1553,18638,1195,592,603
13510,20924,2276,10155,1553,18648,1195,592,603
13515,20930,2276,10157,1553,18654,1196,592,604
13520,20941,2276,10163,1553,18665,1196,592,604
13525,20945,2276,10163,1553,18669,1196,592,604
13530,20955,2276,10168,1553,18679,1196,592,604
13535,20961,2276,10169,1553,18685,1197,592,605
13540,20972,2276,10175,1553,18696,1197,592,605
13545,20976,2276,10177,1553,18700,1197,592,605
13550,20986,2276,10181,1553,18710,1197,592,605
13555,20992,2276,10184,1553,18716,1198,592,606
13560,21003,2276,10189,1553,18727,1198,592,606
13565,21007,2276,10192,1553,18731,1198,592,606
13570,21017,2276,10193,1553,18741,1198,592,606
13575,21023,2276,10196,1553,18747,1199,592,607
13580,21034,2276,10200,1553,18758,1199,592,607
13585,21038,2276,10201,1553,18762,1199,592,607
13590,21048,2276,10207,1553,18772,1199,592,607
13595,21054,2276,10211,1553,18778,1200,593,607
13600,21065,2276,10216,1553,18789,1200,593,607
13605,21069,2276,10216,1553,18793,1200,593,607
13610,21079,2278,10221,1554,18801,1200,593,607
13615,21085,2278,10225,1554,18807,1201,593,608
13620,21096,2279,10230,1555,18817,1201,593,608
13625,21100,2279,10231,1555,18821,1201,593,608
13630,21110,2281,10235,1555,18829,1201,593,608
13635,21116,2281,10239,1555,18835,1203,595,608
13640,21127,2282,10244,1555,18845,1204,596,608
13645,21131,2282,10247,1555,18849,1204,596,608
13650,21141,2284,10252,1556,18857,1204,596,608
13655,21147,2284,10253,1556,18863,1205,596,609
13660,21158,2286,10259,1558,18872,1206,596,610
13665,21162,2286,10260,1558,18876,1206,596,610
13670,21172,2288,10263,1558,18884,1206,596,610
13675,21178,2288,10266,1558,18890,1207,596,611
13680,21189,2290,10272,1560,18899,1208,596,612
13685,21193,2290,10272,1560,18903,1208,596,612
13690,21203,2292,10276,1560,18911,1208,596,612
13695,21209,2292,10279,1560,18917,1209,597,612
13700,21220,2295,10286,1562,18925,1210,597,613
13705,21224,2295,10289,1562,18929,1210,597,613
13710,21234,2297,10296,1564,18937,1210,597,613
13715,21240,2297,10299,1564,18943,1211,598,613
13720,21251,2299,10306,1566,18952,1212,599,613
13725,21255,2299,10308,1566,18956,1212,599,613
13730,21265,2301,10314,1568,18964,1212,599,613
13735,21271,2301,10316,1568,18970,1213,599,614
13740,21282,2302,10317,1568,18980,1214,599,615
13745,21286,2303,10320,1569,18983,1214,599,615
13750,21296,2305,10327,1570,18991,1214,599,615
13755,21302,2305,10327,1570,18997,1215,599,616
13760,21313,2307,10333,1572,19006,1216,600,616
13765,21317,2307,10333,1572,19010,1216,600,616
13770,21327,2309,10335,1572,19018,1216,600,616
13775,21333,2309,10339,1572,19023,1218,601,617
13780,21344,2312,10346,1574,19032,1219,602,617
13785,21348,2313,10348,1575,19035,1219,602,617
13790,21358,2315,10351,1577,19043,1219,602,617
13795,21364,2315,10355,1577,19049,1220,603,617
13800,21375,2317,10360,1578,19058,1221,604,617
13805,21379,2318,10362,1579,19061,1221,604,617
13810,21389,2320,10367,1580,19069,1221,604,617
13815,21395,2320,10371,1580,19075,1222,605,617
13820,21406,2321,10377,1580,19085,1223,605,618
13825,21410,2321,10378,1580,19089,1223,605,618
13830,21420,2323,10382,1581,19097,1223,605,618
13835,21426,2323,10383,1581,19103,1224,605,619
13840,21437,2324,10391,1581,19113,1225,605,620
13845,21441,2324,10391,1581,19117,1225,605,620
13850,21451,2326,10398,1583,19125,1225,605,620
13855,21457,2326,10401,1583,19131,1226,606,620
13860,21468,2329,10409,1585,19139,1227,607,620
13865,21472,2329,10412,1585,19143,1227,607,620
13870,21482,2330,10419,1586,19152,1227,607,620
13875,21488,2330,10421,1586,19158,1228,608,620
13880,21499,2331,10424,1586,19168,1228,608,620
13885,21503,2331,10427,1586,19172,1228,608,620
13890,21513,2332,10429,1586,19181,1228,608,620
13895,21519,2332,10431,1586,19187,1230,608,622
13900,21530,2335,10438,1589,19195,1230,608,622
13905,21534,2335,10440,1589,19199,1230,608,622
13910,21544,2336,10443,1589,19208,1230,608,622
13915,21550,2336,10447,1589,19214,1232,609,623
13920,21561,2340,10452,1592,19221,1232,609,623
13925,21565,2340,10454,1592,19225,1232,609,623
13930,21575,2341,10462,1593,19234,1232,609,623
13935,21581,2341,10465,1593,19240,1233,610,623
13940,21592,2343,10472,1595,19249,1233,610,623
13945,21596,2343,10473,1595,19253,1233,610,623
13950,21606,2344,10479,1596,19262,1233,610,623
13955,21612,2344,10484,1596,19268,1234,611,623
13960,21623,2346,10490,1598,19277,1234,611,623
13965,21627,2346,10491,1598,19281,1234,611,623
13970,21637,2347,10494,1598,19290,1234,611,623
13975,21643,2347,10499,1598,19295,1235,612,623
13980,21654,2349,10506,1600,19305,1236,612,624
13985,21658,2349,10508,1600,19309,1236,612,624
13990,21668,2350,10514,1601,19318,1236,612,624
13995,21674,2350,10516,1601,19324,1237,613,624
14000,21685,2351,10521,1602,19334,1238,613,625
14005,21689,2351,10524,1602,19338,1238,613,625
14010,21699,2352,10528,1602,19347,1238,613,625
14015,21705,2352,10533,1602,19353,1239,614,625
14020,21716,2352,10537,1602,19364,1240,614,626
14025,21720,2353,10540,1603,19367,1240,614,626
14030,21730,2354,10543,1603,19376,1240,614,626
14035,21736,2354,10545,1603,19382,1242,614,628
14040,21747,2355,10550,1603,19392,1243,614,629
14045,21751,2355,10550,1603,19396,1243,614,629
14050,21761,2356,10556,1604,19405,1243,614,629
14055,21767,2356,10559,1604,19411,1244,615,629
14060,21778,2357,10565,1605,19421,1244,615,629
14065,21782,2357,10566,1605,19425,1244,615,629
14070,21792,2358,10570,1605,19434,1244,615,629
14075,21798,2358,10572,1605,19440,1245,616,629
14080,21809,2359,10575,1605,19450,1245,616,629
14085,21813,2359,10575,1605,19454,1245,616,629
14090,21823,2360,10581,1605,19463,1245,616,629
14095,21829,2360,10585,1605,19468,1246,617,629
14100,21840,2362,10593,1607,19478,1246,617,629
14105,21844,2364,10597,1609,19480,1246,617,629
14110,21854,2366,10603,1611,19488,1246,617,629
14115,21860,2366,10606,1611,19493,1247,617,630
14120,21871,2369,10612,1613,19502,1247,617,630
14125,21875,2369,10612,1613,19506,1247,617,630
14130,21885,2371,10619,1613,19514,1247,617,630
14135,21891,2371,10623,1613,19519,1248,617,631
14140,21902,2374,10629,1616,19528,1248,617,631
14145,21906,2374,10629,1616,19532,1248,617,631
14150,21916,2376,10635,1617,19540,1248,617,631
14155,21922,2376,10639,1617,19546,1250,619,631
14160,21933,2378,10645,1619,19555,1250,619,631
14165,21937,2378,10648,1619,19559,1250,619,631
14170,21947,2378,10653,1619,19569,1250,619,631
14175,21953,2378,10657,1619,19575,1251,620,631
14180,21964,2378,10661,1619,19586,1251,620,631
14185,21968,2378,10663,1619,19590,1251,620,631
14190,21978,2378,10667,1619,19600,1251,620,631
14195,21984,2378,10671,1619,19606,1252,621,631
14200,21995,2378,10675,1619,19617,1252,621,631
14205,21999,2378,10676,1619,19621,1252,621,631
14210,22009,2378,10681,1619,19631,1252,621,631
14215,22015,2378,10685,1619,19637,1253,621,632
14220,22026,2378,10689,1619,19648,1253,621,632
14225,22030,2378,10691,1619,19652,1253,621,632
14230,22040,2378,10695,1619,19662,1253,621,632
14235,22046,2378,10697,1619,19668,1254,621,633
14240,22057,2378,10703,1619,19679,1254,621,633
14245,22061,2378,10705,1619,19683,1254,621,633
14250,22071,2378,10709,1619,19693,1254,621,633
14255,22077,2378,10710,1619,19699,1255,621,634
14260,22088,2378,10715,1619,19710,1256,622,634
14265,22092,2378,10718,1619,19714,1256,622,634
14270,22102,2380,10721,1620,19722,1256,622,634
14275,22108,2380,10724,1620,19728,1257,623,634
14280,22119,2382,10731,1621,19737,1258,623,635
14285,22123,2383,10733,1622,19740,1258,623,635
14290,22133,2385,10736,1623,19748,1258,623,635
14295,22139,2385,10738,1623,19754,1259,623,636
14300,22150,2386,10741,1623,19764,1259,623,636
14305,22154,2387,10742,1624,19767,1259,623,636
14310,22164,2389,10747,1624,19775,1259,623,636
14315,22170,2389,10749,1624,19781,1260,623,637
14320,22181,2390,10754,1624,19791,1260,623,637
14325,22185,2391,10756,1625,19794,1260,623,637
14330,22195,2393,10759,1625,19802,1260,623,637
14335,22201,2393,10761,1625,19808,1261,623,638
14340,22212,2395,10768,1626,19817,1261,623,638
14345,22216,2395,10768,1626,19821,1261,623,638
14350,22226,2397,10772,1627,19829,1261,623,638
14355,22232,2397,10776,1627,19835,1262,624,638
14360,22243,2398,10779,1627,19845,1262,624,638
14365,22247,2399,10781,1628,19848,1262,624,638
14370,22257,2401,10785,1629,19856,1262,624,638
14375,22263,2401,10787,1629,19862,1263,624,639
14380,22274,2402,10793,1630,19872,1263,624,639
14385,22278,2403,10796,1631,19875,1263,624,639
14390,22288,2405,10801,1633,19883,1263,624,639
14395,22294,2405,10801,1633,19889,1264,624,640
14400,22305,2407,10805,1635,19898,1265,624,641
14405,22309,2407,10807,1635,19902,1265,624,641
14410,22319,2408,10812,1635,19911,1265,624,641
14415,22325,2408,10816,1635,19917,1266,625,641
14420,22336,2408,10821,1635,19928,1267,626,641
14425,22340,2408,10822,1635,19932,1267,626,641
14430,22350,2409,10826,1635,19941,1267,626,641
14435,22356,2409,10828,1635,19947,1268,627,641
14440,22367,2409,10832,1635,19958,1269,628,641
14445,22371,2409,10834,1635,19962,1269,628,641
14450,22381,2410,10841,1636,19971,1269,628,641
14455,22387,2410,10844,1636,19977,1270,628,642
14460,22398,2410,10852,1636,19988,1271,629,642
14465,22402,2410,10854,1636,19992,1271,629,642
14470,22412,2411,10859,1636,20001,1271,629,642
14475,22418,2411,10861,1636,20007,1272,629,643
14480,22429,2411,10867,1636,20018,1273,629,644
14485,22433,2411,10868,1636,20022,1273,629,644
14490,22443,2412,10873,1636,20031,1273,629,644
14495,22449,2412,10877,1636,20037,1274,630,644
14500,22460,2412,10882,1636,20048,1275,630,645
14505,22464,2412,10883,1636,20052,1275,630,645
14510,22474,2414,10888,1637,20060,1275,630,645
14515,22480,2414,10890,1637,20066,1276,630,646
14520,22491,2415,10894,1637,20076,1277,631,646
14525,22495,2416,10895,1638,20079,1277,631,646
14530,22505,2418,10899,1638,20087,1277,631,646
14535,22511,2418,10903,1638,20093,1278,631,647
14540,22522,2420,10908,1639,20102,1278,631,647
14545,22526,2420,10908,1639,20106,1278,631,647
14550,22536,2422,10912,1640,20114,1278,631,647
14555,22542,2422,10917,1640,20120,1279,632,647
14560,22553,2423,10923,1641,20130,1279,632,647
14565,22557,2423,10924,1641,20134,1279,632,647
14570,22567,2425,10930,1642,20142,1279,632,647
14575,22573,2425,10934,1642,20148,1280,632,648
14580,22584,2427,10940,1644,20157,1280,632,648
14585,22588,2428,10944,1645,20160,1280,632,648
14590,22598,2429,10947,1646,20169,1280,632,648
14595,22604,2429,10950,1646,20175,1281,633,648
14600,22615,2430,10953,1646,20185,1281,633,648
14605,22619,2431,10955,1647,20188,1281,633,648
14610,22629,2432,10962,1647,20197,1281,633,648
14615,22635,2432,10966,1647,20203,1282,634,648
14620,22646,2434,10972,1648,20212,1282,634,648
14625,22650,2434,10974,1648,20216,1282,634,648
14630,22660,2435,10976,1648,20225,1282,634,648
14635,22666,2435,10981,1648,20231,1283,635,648
14640,22677,2437,10987,1650,20240,1284,635,649
14645,22681,2437,10988,1650,20244,1284,635,649
14650,22691,2438,10993,1650,20253,1284,635,649
14655,22697,2438,10995,1650,20259,1285,635,650
14660,22708,2439,11001,1651,20269,1285,635,650
14665,22712,2439,11003,1651,20273,1285,635,650
14670,22722,2440,11007,1651,20282,1285,635,650
14675,22728,2440,11009,1651,20288,1286,636,650
14680,22739,2441,11015,1651,20298,1286,636,650
14685,22743,2442,11017,1652,20301,1286,636,650
14690,22753,2443,11022,1653,20310,1286,636,650
14695,22759,2443,11026,1653,20316,1287,637,650
14700,22770,2444,11032,1653,20326,1287,637,650
14705,22774,2444,11033,1653,20330,1287,637,650
14710,22784,2445,11037,1654,20339,1287,637,650
14715,22790,2445,11040,1654,20345,1288,638,650
14720,22801,2446,11046,1655,20355,1288,638,650
14725,22805,2447,11048,1656,20358,1288,638,650
14730,22815,2448,11053,1656,20367,1288,638,650
14735,22821,2448,11056,1656,20373,1289,638,651
14740,22832,2449,11062,1656,20383,1289,638,651
14745,22836,2450,11065,1657,20386,1289,638,651
14750,22846,2452,11067,1658,20394,1289,638,651
14755,22852,2452,11071,1658,20399,1290,638,652
14760,22863,2455,11078,1661,20408,1290,638,652
14765,22867,2456,11080,1662,20411,1290,638,652
14770,22877,2457,11086,1663,20420,1290,638,652
14775,22883,2457,11091,1663,20426,1291,639,652
14780,22894,2459,11096,1665,20435,1291,639,652
14785,22898,2459,11098,1665,20439,1291,639,652
14790,22908,2459,11104,1665,20449,1291,639,652
14795,22914,2459,11106,1665,20455,1292,639,653
14800,22925,2461,11112,1667,20464,1292,639,653
14805,22929,2461,11114,1667,20468,1292,639,653
14810,22939,2461,11120,1667,20478,1292,639,653
14815,22945,2461,11124,1667,20484,1293,640,653
14820,22956,2464,11131,1669,20492,1294,641,653
14825,22960,2464,11133,1669,20496,1294,641,653
14830,22970,2464,11135,1669,20506,1294,641,653
14835,22976,2464,11138,1669,20512,1295,642,653
14840,22987,2464,11145,1669,20523,1296,643,653
14845,22991,2464,11147,1669,20527,1296,643,653
14850,23001,2464,11151,1669,20537,1296,643,653
14855,23007,2464,11153,1669,20543,1297,644,653
14860,23018,2464,11161,1669,20554,1298,645,653
14865,23022,2464,11164,1669,20558,1298,645,653
14870,23032,2465,11168,1669,20567,1298,645,653
14875,23038,2465,11171,1669,20572,1300,646,654
14880,23049,2467,11175,1671,20582,1301,646,655
14885,23053,2467,11177,1671,20586,1301,646,655
14890,23063,2469,11182,1672,20594,1301,646,655
14895,23069,2469,11184,1672,20600,1302,646,656
14900,23080,2470,11190,1673,20610,1302,646,656
14905,23084,2470,11190,1673,20614,1302,646,656
14910,23094,2472,11196,1673,20622,1302,646,656
14915,23100,2472,11199,1673,20628,1303,646,657
14920,23111,2473,11207,1674,20638,1303,646,657
14925,23115,2473,11208,1674,20642,1303,646,657
14930,23125,2475,11213,1674,20650,1303,646,657
14935,23131,2475,11214,1674,20656,1304,646,658
14940,23142,2477,11219,1676,20665,1304,646,658
14945,23146,2478,11221,1677,20668,1304,646,658
14950,23156,2480,11226,1678,20676,1304,646,658
14955,23162,2480,11230,1678,20682,1305,646,659
14960,23173,2481,11234,1679,20692,1305,646,659
14965,23177,2482,11235,1680,20695,1305,646,659
14970,23187,2484,11238,1681,20703,1305,646,659
14975,23193,2484,11240,1681,20709,1306,647,659
14980,23204,2485,11243,1682,20719,1306,647,659
14985,23208,2486,11245,1683,20722,1306,647,659
14990,23218,2488,11252,1685,20730,1306,647,659
14995,23224,2488,11256,1685,20736,1308,648,660
15000,23235,2489,11259,1686,20746,1309,648,661
15005,23239,2489,11259,1686,20750,1309,648,661
15010,23249,2491,11261,1686,20758,1309,648,661
15015,23255,2491,11265,1686,20764,1310,649,661
15020,23266,2493,11273,1687,20773,1311,650,661
15025,23270,2494,11276,1688,20776,1311,650,661
15030,23280,2496,11282,1690,20784,1311,650,661
15035,23286,2496,11286,1690,20790,1312,650,662
15040,23297,2497,11291,1691,20800,1313,651,662
15045,23301,2498,11294,1692,20803,1313,651,662
15050,23311,2500,11296,1692,20811,1313,651,662
15055,23317,2500,11297,1692,20817,1314,651,663
15060,23328,2502,11304,1694,20826,1315,652,663
15065,23332,2502,11307,1694,20830,1315,652,663
15070,23342,2503,11312,1694,20839,1315,652,663
15075,23348,2503,11315,1694,20845,1316,652,664
15080,23359,2504,11319,1694,20855,1316,652,664
15085,23363,2504,11321,1694,20859,1316,652,664
15090,23373,2505,11324,1694,20868,1316,652,664
15095,23379,2505,11325,1694,20874,1317,652,665
15100,23390,2507,11331,1695,20883,1317,652,665
15105,23394,2507,11332,1695,20887,1317,652,665
15110,23404,2508,11335,1696,20896,1317,652,665
15115,23410,2508,11338,1696,20902,1319,654,665
15120,23421,2509,11345,1696,20912,1319,654,665
15125,23425,2509,11346,1696,20916,1319,654,665
15130,23435,2510,11353,1697,20925,1319,654,665
15135,23441,2510,11357,1697,20931,1320,654,666
15140,23452,2512,11363,1698,20940,1320,654,666
15145,23456,2512,11364,1698,20944,1320,654,666
15150,23466,2513,11367,1698,20953,1320,654,666
15155,23472,2513,11370,1698,20959,1321,655,666
15160,23483,2514,11376,1699,20969,1321,655,666
15165,23487,2514,11378,1699,20973,1321,655,666
15170,23497,2516,11384,1699,20981,1321,655,666
15175,23503,2516,11386,1699,20987,1322,656,666
15180,23514,2517,11392,1700,20997,1323,656,667
15185,23518,2517,11395,1700,21001,1323,656,667
15190,23528,2518,11400,1700,21010,1323,656,667
15195,23534,2518,11403,1700,21016,1324,656,668
15200,23545,2518,11409,1700,21027,1324,656,668
15205,23549,2518,11411,1700,21031,1324,656,668
15210,23559,2519,11418,1700,21040,1324,656,668
15215,23565,2519,11421,1700,21045,1325,656,669
15220,23576,2520,11424,1701,21056,1325,656,669
15225,23580,2520,11425,1701,21060,1325,656,669
15230,23590,2521,11430,1701,21069,1325,656,669
15235,23596,2521,11435,1701,21074,1327,658,669
15240,23607,2522,11439,1702,21085,1327,658,669
15245,23611,2522,11441,1702,21089,1327,658,669
15250,23621,2523,11446,1702,21098,1327,658,669
15255,23627,2523,11448,1702,21104,1328,658,670
15260,23638,2523,11454,1702,21115,1329,659,670
15265,23642,2524,11457,1703,21118,1329,659,670
15270,23652,2525,11462,1704,21127,1329,659,670
15275,23658,2525,11463,1704,21133,1330,660,670
15280,23669,2525,11468,1704,21144,1331,661,670
15285,23673,2526,11470,1705,21147,1331,661,670
15290,23683,2528,11473,1705,21155,1331,661,670
15295,23689,2528,11475,1705,21161,1332,662,670
15300,23700,2531,11481,1708,21169,1333,662,671
15305,23704,2531,11482,1708,21173,1333,662,671
15310,23714,2532,11488,1708,21182,1333,662,671
15315,23720,2532,11491,1708,21188,1334,662,672
15320,23731,2532,11495,1708,21199,1334,662,672
15325,23735,2532,11495,1708,21203,1334,662,672
15330,23745,2533,11500,1708,21212,1334,662,672
15335,23751,2533,11502,1708,21218,1335,662,673
15340,23762,2533,11506,1708,21229,1335,662,673
15345,23766,2533,11507,1708,21233,1335,662,673
15350,23776,2534,11508,1708,21242,1335,662,673
15355,23782,2534,11510,1708,21248,1336,662,674
15360,23793,2534,11514,1708,21259,1336,662,674
15365,23797,2534,11517,1708,21263,1336,662,674
15370,23807,2535,11521,1708,21272,1336,662,674
15375,23813,2535,11526,1708,21278,1337,663,674
15380,23824,2535,11534,1708,21289,1337,663,674
15385,23828,2535,11535,1708,21293,1337,663,674
15390,23838,2536,11543,1709,21302,1337,663,674
15395,23844,2536,11545,1709,21308,1338,664,674
15400,23855,2536,11551,1709,21319,1338,664,674
15405,23859,2536,11553,1709,21323,1338,664,674
15410,23869,2538,11559,1711,21331,1338,664,674
15415,23875,2538,11564,1711,21336,1340,665,675
15420,23886,2541,11571,1713,21345,1340,665,675
15425,23890,2541,11571,1713,21349,1340,665,675
15430,23900,2543,11575,1714,21357,1340,665,675
15435,23906,2543,11580,1714,21363,1341,666,675
15440,23917,2544,11586,1715,21373,1342,666,676
15445,23921,2544,11589,1715,21377,1342,666,676
15450,23931,2546,11594,1716,21385,1342,666,676
15455,23937,2546,11598,1716,21390,1343,667,676
15460,23948,2548,11604,1718,21400,1344,668,676
15465,23952,2548,11605,1718,21404,1344,668,676
15470,23962,2550,11609,1718,21412,1344,668,676
15475,23968,2550,11611,1718,21417,1345,668,677
15480,23979,2552,11615,1720,21427,1346,668,678
15485,23983,2553,11618,1721,21430,1346,668,678
15490,23993,2555,11626,1722,21438,1346,668,678
15495,23999,2555,11630,1722,21443,1347,669,678
15500,24010,2557,11634,1724,21453,1348,670,678
15505,24014,2557,11635,1724,21457,1348,670,678
15510,24024,2559,11641,1725,21465,1348,670,678
15515,24030,2559,11645,1725,21470,1349,670,679
15520,24041,2561,11653,1726,21480,1350,671,679
15525,24045,2562,11656,1727,21483,1350,671,679
15530,24055,2564,11659,1727,21491,1350,671,679
15535,24061,2564,11660,1727,21497,1352,672,680
15540,24072,2566,11664,1728,21506,1353,672,681
15545,24076,2566,11665,1728,21510,1353,672,681
15550,24086,2567,11670,1728,21519,1353,672,681
15555,24092,2567,11671,1728,21525,1354,672,682
15560,24103,2570,11677,1731,21533,1355,673,682
15565,24107,2570,11679,1731,21537,1355,673,682
15570,24117,2571,11684,1732,21546,1355,673,682
15575,24123,2571,11685,1732,21552,1356,673,683
15580,24134,2573,11690,1733,21561,1357,674,683
15585,24138,2573,11691,1733,21565,1357,674,683
15590,24148,2574,11695,1733,21574,1357,674,683
15595,24154,2574,11697,1733,21580,1358,675,683
15600,24165,2576,11700,1734,21589,1359,675,684
15605,24169,2576,11700,1734,21593,1359,675,684
15610,24179,2577,11707,1735,21602,1359,675,684
15615,24185,2577,11707,1735,21608,1360,675,685
15620,24196,2579,11715,1737,21617,1361,676,685
15625,24200,2579,11716,1737,21621,1361,676,685
15630,24210,2580,11720,1738,21630,1361,676,685
15635,24216,2580,11723,1738,21636,1362,677,685
15640,24227,2582,11728,1740,21645,1363,677,686
15645,24231,2582,11729,1740,21649,1363,677,686
15650,24241,2584,11732,1740,21657,1363,677,686
15655,24247,2584,11735,1740,21663,1365,678,687
15660,24258,2585,11741,1741,21673,1366,678,688
15665,24262,2585,11742,1741,21677,1366,678,688
15670,24272,2587,11748,1741,21685,1366,678,688
15675,24278,2587,11750,1741,21691,1367,678,689
15680,24289,2588,11754,1742,21701,1367,678,689
15685,24293,2588,11755,1742,21705,1367,678,689
15690,24303,2590,11763,1744,21713,1367,678,689
15695,24309,2590,11767,1744,21719,1368,678,690
15700,24320,2592,11771,1745,21728,1368,678,690
15705,24324,2592,11774,1745,21732,1368,678,690
15710,24334,2594,11781,1746,21740,1368,678,690
15715,24340,2594,11783,1746,21746,1369,679,690
15720,24351,2596,11788,1748,21755,1369,679,690
15725,24355,2596,11788,1748,21759,1369,679,690
15730,24365,2598,11794,1750,21767,1369,679,690
15735,24371,2598,11798,1750,21773,1370,680,690
15740,24382,2599,11806,1751,21783,1370,680,690
15745,24386,2599,11808,1751,21787,1370,680,690
15750,24396,2601,11814,1752,21795,1370,680,690
15755,24402,2601,11817,1752,21801,1371,681,690
15760,24413,2601,11819,1752,21812,1371,681,690
15765,24417,2601,11822,1752,21816,1371,681,690
15770,24427,2603,11824,1752,21824,1371,681,690
15775,24433,2603,11826,1752,21830,1373,681,692
15780,24444,2603,11831,1752,21841,1374,682,692
15785,24448,2603,11833,1752,21845,1374,682,692
15790,24458,2604,11836,1752,21854,1374,682,692
15795,24464,2604,11839,1752,21860,1375,683,692
15800,24475,2604,11846,1752,21871,1375,683,692
15805,24479,2604,11846,1752,21875,1375,683,692
15810,24489,2605,11850,1753,21884,1375,683,692
15815,24495,2605,11855,1753,21890,1376,684,692
15820,24506,2605,11863,1753,21901,1376,684,692
15825,24510,2605,11864,1753,21905,1376,684,692
15830,24520,2606,11869,1753,21914,1376,684,692
15835,24526,2606,11873,1753,21920,1377,684,693
15840,24537,2606,11878,1753,21931,1377,684,693
15845,24541,2606,11880,1753,21935,1377,684,693
15850,24551,2607,11886,1753,21944,1377,684,693
15855,24557,2607,11889,1753,21950,1378,684,694
15860,24568,2607,11892,1753,21961,1378,684,694
15865,24572,2607,11895,1753,21965,1378,684,694
15870,24582,2608,11899,1754,21974,1378,684,694
15875,24588,2608,11901,1754,21980,1379,684,695
15880,24599,2608,11905,1754,21991,1379,684,695
15885,24603,2608,11907,1754,21995,1379,684,695
15890,24613,2610,11911,1755,22003,1379,684,695
15895,24619,2610,11914,1755,22009,1381,685,696
15900,24630,2612,11918,1756,22018,1382,686,696
15905,24634,2612,11918,1756,22022,1382,686,696
15910,24644,2614,11922,1756,22030,1382,686,696
15915,24650,2614,11927,1756,22036,1383,687,696
15920,24661,2616,11931,1757,22045,1384,688,696
15925,24665,2616,11931,1757,22049,1384,688,696
15930,24675,2618,11935,1757,22057,1384,688,696
15935,24681,2618,11937,1757,22063,1385,688,697
15940,24692,2620,11941,1758,22072,1386,689,697
15945,24696,2621,11944,1759,22075,1386,689,697
15950,24706,2623,11951,1760,22083,1386,689,697
15955,24712,2623,11954,1760,22089,1387,690,697
15960,24723,2625,11961,1762,22098,1388,691,697
15965,24727,2626,11963,1763,22101,1388,691,697
15970,24737,2628,11968,1764,22109,1388,691,697
15975,24743,2628,11970,1764,22115,1389,692,697
15980,24754,2629,11977,1764,22125,1390,693,697
15985,24758,2630,11979,1765,22128,1390,693,697
15990,24768,2632,11982,1766,22136,1390,693,697
15995,24774,2632,11984,1766,22142,1391,693,698
16000,24785,2633,11991,1766,22152,1392,694,698
16005,24789,2635,11995,1768,22154,1392,694,698
16010,24799,2637,11999,1769,22162,1392,694,698
16015,24805,2637,12002,1769,22167,1393,695,698
16020,24816,2640,12009,1772,22176,1394,696,698
16025,24820,2640,12012,1772,22180,1394,696,698
16030,24830,2642,12017,1773,22188,1394,696,698
16035,24836,2642,12021,1773,22194,1396,697,699
16040,24847,2642,12026,1773,22205,1397,698,699
16045,24851,2642,12030,1773,22209,1397,698,699
16050,24861,2644,12033,1774,22217,1397,698,699
16055,24867,2644,12037,1774,22223,1398,698,700
16060,24878,2645,12041,1775,22233,1399,698,701
16065,24882,2645,12041,1775,22237,1399,698,701
16070,24892,2647,12046,1776,22245,1399,698,701
16075,24898,2647,12046,1776,22251,1400,698,702
16080,24909,2649,12054,1778,22260,1401,698,703
16085,24913,2649,12056,1778,22264,1401,698,703
16090,24923,2651,12059,1779,22272,1401,698,703
16095,24929,2651,12061,1779,22278,1402,699,703
16100,24940,2651,12066,1779,22289,1403,700,703
16105,24944,2651,12067,1779,22293,1403,700,703
16110,24954,2653,12073,1781,22301,1403,700,703
16115,24960,2653,12076,1781,22307,1404,701,703
16120,24971,2654,12081,1782,22317,1405,701,704
16125,24975,2654,12082,1782,22321,1405,701,704
16130,24985,2656,12084,1782,22329,1405,701,704
16135,24991,2656,12087,1782,22335,1406,702,704
16140,25002,2658,12089,1783,22344,1407,702,705
16145,25006,2659,12090,1784,22347,1407,702,705
16150,25016,2659,12091,1784,22357,1407,702,705
16155,25022,2659,12093,1784,22363,1409,703,706
16160,25033,2660,12098,1785,22373,1409,703,706
16165,25037,2660,12100,1785,22377,1409,703,706
16170,25047,2660,12106,1785,22387,1409,703,706
16175,25053,2660,12108,1785,22393,1411,704,707
16180,25064,2661,12113,1786,22403,1411,704,707
16185,25068,2661,12114,1786,22407,1411,704,707
16190,25078,2661,12119,1786,22417,1411,704,707
16195,25084,2661,12123,1786,22423,1413,705,708
16200,25095,2662,12128,1786,22433,1413,705,708
16205,25099,2662,12130,1786,22437,1413,705,708
16210,25109,2662,12135,1786,22447,1413,705,708
16215,25115,2662,12138,1786,22453,1414,706,708
16220,25126,2663,12146,1787,22463,1414,706,708
16225,25130,2663,12147,1787,22467,1414,706,708
16230,25140,2663,12151,1787,22477,1414,706,708
16235,25146,2663,12154,1787,22483,1415,706,709
16240,25157,2664,12159,1787,22493,1415,706,709
16245,25161,2665,12162,1788,22496,1415,706,709
16250,25171,2666,12168,1788,22505,1415,706,709
16255,25177,2666,12172,1788,22511,1416,706,710
16260,25188,2668,12176,1790,22520,1417,706,711
16265,25192,2668,12177,1790,22524,1417,706,711
16270,25202,2670,12181,1792,22532,1417,706,711
16275,25208,2670,12184,1792,22538,1418,707,711
16280,25219,2671,12189,1793,22548,1419,708,711
16285,25223,2673,12192,1795,22550,1419,708,711
16290,25233,2675,12197,1797,22558,1419,708,711
16295,25239,2675,12198,1797,22564,1420,708,712
16300,25250,2676,12205,1798,22574,1421,708,713
16305,25254,2677,12206,1799,22577,1421,708,713
16310,25264,2679,12211,1801,22585,1421,708,713
16315,25270,2679,12213,1801,22591,1423,708,715
16320,25281,2681,12219,1802,22600,1424,708,716
16325,25285,2681,12219,1802,22604,1424,708,716
16330,25295,2683,12222,1802,22612,1424,708,716
16335,25301,2683,12223,1802,22618,1425,708,717
16340,25312,2684,12227,1803,22628,1426,709,717
16345,25316,2686,12231,1805,22630,1426,709,717
16350,25326,2688,12234,1806,22638,1426,709,717
16355,25332,2688,12236,1806,22644,1427,710,717
16360,25343,2689,12243,1806,22654,1428,710,718
16365,25347,2689,12243,1806,22658,1428,710,718
16370,25357,2691,12249,1808,22666,1428,710,718
16375,25363,2691,12251,1808,22672,1429,710,719
16380,25374,2692,12256,1808,22682,1430,710,720
16385,25378,2692,12256,1808,22686,1430,710,720
16390,25388,2693,12261,1808,22695,1430,710,720
16395,25394,2693,12263,1808,22701,1431,711,720
16400,25405,2693,12268,1808,22712,1431,711,720
16405,25409,2693,12271,1808,22716,1431,711,720
16410,25419,2694,12274,1808,22725,1431,711,720
16415,25425,2694,12275,1808,22731,1432,711,721
16420,25436,2694,12280,1808,22742,1432,711,721
16425,25440,2694,12281,1808,22746,1432,711,721
16430,25450,2695,12284,1808,22755,1432,711,721
16435,25456,2695,12287,1808,22761,1433,712,721
16440,25467,2695,12290,1808,22772,1433,712,721
16445,25471,2695,12293,1808,22776,1433,712,721
16450,25481,2696,12300,1808,22785,1433,712,721
16455,25487,2696,12300,1808,22791,1435,712,723
16460,25498,2696,12305,1808,22802,1435,712,723
16465,25502,2696,12306,1808,22806,1435,712,723
16470,25512,2697,12312,1808,22815,1435,712,723
16475,25518,2697,12314,1808,22821,1436,712,724
16480,25529,2697,12319,1808,22832,1436,712,724
16485,25533,2697,12322,1808,22836,1436,712,724
16490,25543,2699,12326,1809,22844,1436,712,724
16495,25549,2699,12328,1809,22850,1437,712,725
16500,25560,2702,12333,1811,22858,1438,713,725
16505,25564,2702,12334,1811,22862,1438,713,725
16510,25574,2703,12338,1812,22871,1438,713,725
16515,25580,2703,12339,1812,22877,1439,713,726
16520,25591,2706,12347,1815,22885,1440,714,726
16525,25595,2706,12349,1815,22889,1440,714,726
16530,25605,2707,12353,1815,22898,1440,714,726
16535,25611,2707,12357,1815,22904,1441,715,726
16540,25622,2709,12362,1817,22913,1442,715,727
16545,25626,2709,12364,1817,22917,1442,715,727
16550,25636,2710,12371,1818,22926,1442,715,727
16555,25642,2710,12375,1818,22932,1443,716,727
16560,25653,2712,12381,1819,22941,1444,717,727
16565,25657,2712,12384,1819,22945,1444,717,727
16570,25667,2713,12389,1819,22954,1444,717,727
16575,25673,2713,12392,1819,22960,1446,719,727
16580,25684,2714,12400,1820,22970,1447,720,727
16585,25688,2714,12403,1820,22974,1447,720,727
16590,25698,2715,12407,1820,22983,1447,720,727
16595,25704,2715,12411,1820,22989,1448,721,727
16600,25715,2716,12418,1821,22999,1449,721,728
16605,25719,2716,12419,1821,23003,1449,721,728
16610,25729,2718,12424,1821,23011,1449,721,728
16615,25735,2718,12427,1821,23017,1450,722,728
16620,25746,2719,12428,1821,23027,1451,722,729
16625,25750,2719,12429,1821,23031,1451,722,729
16630,25760,2721,12433,1821,23039,1451,722,729
16635,25766,2721,12436,1821,23045,1452,723,729
16640,25777,2722,12441,1822,23055,1452,723,729
16645,25781,2723,12444,1823,23058,1452,723,729
16650,25791,2725,12451,1824,23066,1452,723,729
16655,25797,2725,12454,1824,23072,1453,723,730
16660,25808,2726,12462,1825,23082,1453,723,730
16665,25812,2727,12465,1826,23085,1453,723,730
16670,25822,2729,12468,1826,23093,1453,723,730
16675,25828,2729,12470,1826,23098,1454,723,731
16680,25839,2732,12477,1829,23107,1454,723,731
16685,25843,2732,12478,1829,23111,1454,723,731
16690,25853,2733,12483,1829,23120,1454,723,731
16695,25859,2733,12486,1829,23125,1456,724,732
16700,25870,2734,12490,1830,23136,1456,724,732
16705,25874,2734,12492,1830,23140,1456,724,732
16710,25884,2735,12494,1830,23149,1456,724,732
16715,25890,2735,12497,1830,23154,1458,725,733
16720,25901,2736,12502,1831,23165,1458,725,733
16725,25905,2736,12504,1831,23169,1458,725,733
16730,25915,2737,12508,1831,23178,1458,725,733
16735,25921,2737,12512,1831,23183,1459,725,734
16740,25932,2741,12518,1834,23191,1460,725,735
16745,25936,2741,12519,1834,23195,1460,725,735
16750,25946,2741,12523,1834,23205,1460,725,735
16755,25952,2741,12526,1834,23211,1461,726,735
16760,25963,2743,12532,1836,23220,1462,726,736
16765,25967,2744,12534,1837,23223,1462,726,736
16770,25977,2744,12538,1837,23233,1462,726,736
16775,25983,2744,12542,1837,23239,1463,727,736
16780,25994,2745,12546,1837,23249,1464,727,737
16785,25998,2745,12550,1837,23253,1464,727,737
16790,26008,2746,12553,1838,23262,1464,727,737
16795,26014,2746,12558,1838,23268,1465,728,737
16800,26025,2749,12564,1840,23276,1466,729,737
16805,26029,2749,12565,1840,23280,1466,729,737
16810,26039,2750,12571,1840,23289,1466,729,737
16815,26045,2750,12575,1840,23295,1467,730,737
16820,26056,2754,12582,1844,23302,1468,731,737
16825,26060,2754,12583,1844,23306,1468,731,737
16830,26070,2755,12587,1844,23315,1468,731,737
16835,26076,2755,12590,1844,23321,1470,733,737
16840,26087,2757,12594,1845,23330,1471,733,738
16845,26091,2757,12597,1845,23334,1471,733,738
16850,26101,2759,12601,1845,23342,1471,733,738
16855,26107,2759,12604,1845,23347,1473,734,739
16860,26118,2762,12608,1848,23356,1474,734,740
16865,26122,2762,12609,1848,23360,1474,734,740
16870,26132,2764,12613,1848,23368,1474,734,740
16875,26138,2764,12614,1848,23374,1475,734,741
16880,26149,2765,12619,1848,23384,1475,734,741
16885,26153,2765,12621,1848,23388,1475,734,741
16890,26163,2767,12625,1849,23396,1475,734,741
16895,26169,2767,12627,1849,23402,1476,734,742
16900,26180,2768,12633,1849,23412,1476,734,742
16905,26184,2768,12635,1849,23416,1476,734,742
16910,26194,2770,12641,1849,23424,1476,734,742
16915,26200,2770,12646,1849,23430,1477,735,742
16920,26211,2771,12652,1850,23440,1477,735,742
16925,26215,2772,12656,1851,23443,1477,735,742
16930,26225,2774,12661,1852,23451,1477,735,742
16935,26231,2774,12664,1852,23457,1478,735,743
16940,26242,2775,12671,1852,23467,1478,735,743
16945,26246,2775,12673,1852,23471,1478,735,743
16950,26256,2777,12677,1854,23479,1478,735,743
16955,26262,2777,12680,1854,23485,1479,736,743
16960,26273,2778,12687,1855,23495,1479,736,743
16965,26277,2779,12688,1856,23498,1479,736,743
16970,26287,2781,12693,1856,23506,1479,736,743
16975,26293,2781,12696,1856,23512,1481,737,744
16980,26304,2785,12703,1860,23519,1481,737,744
16985,26308,2785,12704,1860,23523,1481,737,744
16990,26318,2786,12709,1861,23532,1481,737,744
16995,26324,2786,12711,1861,23538,1482,738,744
17000,26335,2786,12718,1861,23549,1483,739,744
17005,26339,2787,12720,1862,23552,1483,739,744
17010,26349,2788,12725,1862,23561,1483,739,744
17015,26355,2788,12729,1862,23567,1484,740,744
17020,26366,2788,12733,1862,23578,1485,741,744
17025,26370,2788,12735,1862,23582,1485,741,744
17030,26380,2789,12739,1863,23591,1485,741,744
17035,26386,2789,12741,1863,23597,1486,742,744
17040,26397,2789,12746,1863,23608,1487,743,744
17045,26401,2789,12749,1863,23612,1487,743,744
17050,26411,2790,12755,1864,23621,1487,743,744
17055,26417,2790,12758,1864,23627,1488,743,745
17060,26428,2790,12765,1864,23638,1488,743,745
17065,26432,2790,12768,1864,23642,1488,743,745
17070,26442,2791,12771,1865,23651,1488,743,745
17075,26448,2791,12774,1865,23657,1489,743,746
17080,26459,2791,12781,1865,23668,1489,743,746
17085,26463,2791,12781,1865,23672,1489,743,746
17090,26473,2793,12785,1866,23680,1489,743,746
17095,26479,2793,12789,1866,23685,1491,744,747
17100,26490,2795,12795,1868,23695,1491,744,747
17105,26494,2796,12798,1869,23698,1491,744,747
17110,26504,2798,12802,1870,23706,1491,744,747
17115,26510,2798,12806,1870,23711,1493,746,747
17120,26521,2802,12809,1873,23719,1494,746,748
17125,26525,2804,12811,1875,23721,1494,746,748
17130,26535,2806,12819,1877,23729,1494,746,748
17135,26541,2806,12820,1877,23735,1496,746,750
17140,26552,2810,12828,1881,23742,1497,747,750
17145,26556,2810,12829,1881,23746,1497,747,750
17150,26566,2812,12832,1881,23754,1497,747,750
17155,26572,2812,12835,1881,23760,1498,748,750
17160,26583,2814,12839,1883,23769,1499,748,751
17165,26587,2814,12841,1883,23773,1499,748,751
17170,26597,2815,12847,1883,23782,1499,748,751
17175,26603,2815,12849,1883,23788,1500,748,752
17180,26614,2815,12854,1883,23799,1500,748,752
17185,26618,2815,12857,1883,23803,1500,748,752
17190,26628,2816,12863,1883,23812,1500,748,752
17195,26634,2816,12864,1883,23818,1501,749,752
17200,26645,2816,12870,1883,23829,1501,749,752
17205,26649,2816,12872,1883,23833,1501,749,752
17210,26659,2817,12876,1884,23842,1501,749,752
17215,26665,2817,12879,1884,23848,1502,749,753
17220,26676,2818,12885,1885,23858,1502,749,753
17225,26680,2818,12888,1885,23862,1502,749,753
17230,26690,2819,12892,1885,23871,1502,749,753
17235,26696,2819,12894,1885,23877,1503,749,754
17240,26707,2819,12900,1885,23888,1503,749,754
17245,26711,2819,12901,1885,23892,1503,749,754
17250,26721,2820,12907,1886,23901,1503,749,754
17255,26727,2820,12909,1886,23907,1504,749,755
17260,26738,2820,12915,1886,23918,1504,749,755
17265,26742,2820,12918,1886,23922,1504,749,755
17270,26752,2822,12923,1886,23930,1504,749,755
17275,26758,2822,12925,1886,23936,1506,749,757
17280,26769,2824,12934,1888,23945,1507,749,758
17285,26773,2826,12937,1890,23947,1507,749,758
17290,26783,2828,12942,1890,23955,1507,749,758
17295,26789,2828,12944,1890,23961,1508,750,758
17300,26800,2829,12952,1890,23971,1509,751,758
17305,26804,2831,12954,1892,23973,1509,751,758
17310,26814,2833,12960,1894,23981,1509,751,758
17315,26820,2833,12960,1894,23987,1510,751,759
17320,26831,2834,12967,1895,23997,1511,752,759
17325,26835,2835,12970,1896,24000,1511,752,759
17330,26845,2837,12979,1897,24008,1511,752,759
17335,26851,2837,12984,1897,24014,1512,753,759
17340,26862,2839,12991,1899,24023,1513,754,759
17345,26866,2839,12993,1899,24027,1513,754,759
17350,26876,2840,12997,1900,24036,1513,754,759
17355,26882,2840,12999,1900,24042,1514,754,760
17360,26893,2842,13002,1901,24051,1515,755,760
17365,26897,2842,13003,1901,24055,1515,755,760
17370,26907,2843,13009,1901,24064,1515,755,760
17375,26913,2843,13012,1901,24069,1516,756,760
17380,26924,2846,13017,1903,24078,1517,756,761
17385,26928,2847,13018,1904,24081,1517,756,761
17390,26938,2848,13024,1904,24090,1517,756,761
17395,26944,2848,13026,1904,24096,1519,757,762
17400,26955,2850,13034,1905,24105,1520,758,762
17405,26959,2850,13036,1905,24109,1520,758,762
17410,26969,2852,13041,1906,24117,1520,758,762
17415,26975,2852,13043,1906,24123,1521,758,763
17420,26986,2852,13049,1906,24134,1521,758,763
17425,26990,2852,13051,1906,24138,1521,758,763
17430,27000,2853,13056,1907,24147,1521,758,763
17435,27006,2853,13060,1907,24152,1522,759,763
17440,27017,2854,13065,1908,24163,1522,759,763
17445,27021,2854,13068,1908,24167,1522,759,763
17450,27031,2855,13071,1908,24176,1522,759,763
17455,27037,2855,13076,1908,24182,1523,760,763
17460,27048,2855,13084,1908,24193,1523,760,763
17465,27052,2855,13085,1908,24197,1523,760,763
17470,27062,2856,13093,1908,24206,1523,760,763
17475,27068,2856,13096,1908,24212,1524,760,764
17480,27079,2859,13103,1910,24220,1524,760,764
17485,27083,2859,13104,1910,24224,1524,760,764
17490,27093,2860,13108,1910,24233,1524,760,764
17495,27099,2860,13113,1910,24239,1525,761,764
17500,27110,2862,13120,1911,24248,1525,761,764
17505,27114,2862,13123,1911,24252,1525,761,764
17510,27124,2863,13128,1911,24261,1525,761,764
17515,27130,2863,13131,1911,24267,1527,762,765
17520,27141,2865,13138,1913,24276,1528,763,765
17525,27145,2865,13139,1913,24280,1528,763,765
17530,27155,2866,13144,1913,24289,1528,763,765
17535,27161,2866,13146,1913,24294,1529,763,766
17540,27172,2867,13154,1914,24305,1530,763,767
17545,27176,2868,13157,1915,24308,1530,763,767
17550,27186,2869,13158,1915,24317,1530,763,767
17555,27192,2869,13160,1915,24323,1531,764,767
17560,27203,2869,13163,1915,24334,1532,764,768
17565,27207,2870,13167,1916,24337,1532,764,768
17570,27217,2871,13172,1917,24346,1532,764,768
17575,27223,2871,13173,1917,24352,1533,764,769
17580,27234,2871,13182,1917,24363,1534,765,769
17585,27238,2871,13184,1917,24367,1534,765,769
17590,27248,2871,13189,1917,24377,1534,765,769
17595,27254,2871,13192,1917,24383,1535,765,770
17600,27265,2872,13199,1918,24393,1535,765,770
17605,27269,2873,13201,1919,24396,1535,765,770
17610,27279,2873,13207,1919,24406,1535,765,770
17615,27285,2873,13212,1919,24412,1536,766,770
17620,27296,2874,13215,1920,24422,1536,766,770
17625,27300,2875,13218,1921,24425,1536,766,770
17630,27310,2876,13223,1922,24434,1536,766,770
17635,27316,2876,13225,1922,24439,1538,767,771
17640,27327,2878,13229,1924,24449,1538,767,771
17645,27331,2879,13231,1925,24452,1538,767,771
17650,27341,2881,13235,1926,24460,1538,767,771
17655,27347,2881,13237,1926,24466,1539,768,771
17660,27358,2882,13242,1926,24476,1540,768,772
17665,27362,2883,13244,1927,24479,1540,768,772
17670,27372,2885,13249,1928,24487,1540,768,772
17675,27378,2885,13254,1928,24492,1541,769,772
17680,27389,2888,13258,1931,24501,1542,769,773
17685,27393,2889,13259,1932,24504,1542,769,773
17690,27403,2891,13264,1934,24512,1542,769,773
17695,27409,2891,13267,1934,24518,1543,770,773
17700,27420,2892,13269,1935,24528,1544,770,774
17705,27424,2892,13270,1935,24532,1544,770,774
17710,27434,2894,13275,1936,24540,1544,770,774
17715,27440,2894,13279,1936,24546,1545,770,775
17720,27451,2895,13283,1937,24556,1545,770,775
17725,27455,2895,13284,1937,24560,1545,770,775
17730,27465,2897,13286,1937,24568,1545,770,775
17735,27471,2897,13290,1937,24574,1546,771,775
17740,27482,2898,13294,1938,24584,1546,771,775
17745,27486,2898,13295,1938,24588,1546,771,775
17750,27496,2900,13301,1939,24596,1546,771,775
17755,27502,2900,13304,1939,24602,1548,772,776
17760,27513,2901,13310,1940,24612,1548,772,776
17765,27517,2902,13313,1941,24615,1548,772,776
17770,27527,2904,13316,1942,24623,1548,772,776
17775,27533,2904,13318,1942,24629,1549,772,777
17780,27544,2906,13322,1943,24638,1549,772,777
17785,27548,2907,13324,1944,24641,1549,772,777
17790,27558,2909,13329,1944,24649,1549,772,777
17795,27564,2909,13332,1944,24655,1550,772,778
17800,27575,2910,13334,1945,24665,1550,772,778
17805,27579,2910,13335,1945,24669,1550,772,778
17810,27589,2912,13340,1945,24677,1550,772,778
17815,27595,2912,13342,1945,24682,1551,772,779
17820,27606,2914,13347,1947,24692,1552,772,780
17825,27610,2914,13347,1947,24696,1552,772,780
17830,27620,2915,13351,1948,24705,1552,772,780
17835,27626,2915,13353,1948,24711,1553,773,780
17840,27637,2915,13355,1948,24722,1553,773,780
17845,27641,2915,13356,1948,24726,1553,773,780
17850,27651,2916,13362,1949,24735,1553,773,780
17855,27657,2916,13365,1949,24741,1554,774,780
17860,27668,2916,13370,1949,24752,1554,774,780
17865,27672,2916,13374,1949,24756,1554,774,780
17870,27682,2917,13378,1950,24765,1554,774,780
17875,27688,2917,13384,1950,24771,1555,775,780
17880,27699,2917,13387,1950,24782,1555,775,780
17885,27703,2917,13388,1950,24786,1555,775,780
17890,27713,2918,13392,1950,24795,1555,775,780
17895,27719,2918,13394,1950,24801,1556,775,781
17900,27730,2918,13396,1950,24812,1556,775,781
17905,27734,2918,13399,1950,24816,1556,775,781
17910,27744,2919,13402,1951,24825,1556,775,781
17915,27750,2919,13406,1951,24831,1557,775,782
17920,27761,2919,13408,1951,24842,1557,775,782
17925,27765,2919,13411,1951,24846,1557,775,782
17930,27775,2921,13420,1952,24854,1557,775,782
17935,27781,2921,13425,1952,24859,1558,776,782
17940,27792,2924,13427,1954,24868,1559,776,783
17945,27796,2925,13430,1955,24871,1559,776,783
17950,27806,2927,13431,1955,24879,1559,776,783
17955,27812,2927,13434,1955,24884,1560,777,783
17960,27823,2931,13439,1958,24892,1560,777,783
17965,27827,2931,13440,1958,24896,1560,777,783
17970,27837,2933,13447,1959,24904,1560,777,783
17975,27843,2933,13449,1959,24910,1561,777,784
17980,27854,2935,13454,1961,24919,1561,777,784
17985,27858,2935,13456,1961,24923,1561,777,784
17990,27868,2937,13460,1962,24931,1561,777,784
17995,27874,2937,13462,1962,24937,1563,778,785
18000,27885,2939,13469,1963,24946,1563,778,785
18005,27889,2940,13471,1964,24949,1563,778,785
18010,27899,2942,13479,1965,24957,1563,778,785
18015,27905,2942,13481,1965,24963,1564,778,786
18020,27916,2945,13488,1967,24971,1564,778,786
18025,27920,2946,13490,1968,24974,1564,778,786
18030,27930,2948,13494,1968,24982,1564,778,786
18035,27936,2948,13498,1968,24988,1565,778,787
18040,27947,2950,13503,1970,24997,1565,778,787
18045,27951,2951,13505,1971,25000,1565,778,787
18050,27961,2953,13510,1973,25008,1565,778,787
18055,27967,2953,13513,1973,25014,1566,779,787
18060,27978,2955,13520,1975,25023,1567,779,788
18065,27982,2955,13521,1975,25027,1567,779,788
18070,27992,2955,13525,1975,25037,1567,779,788
18075,27998,2955,13526,1975,25043,1568,779,789
18080,28009,2955,13531,1975,25054,1569,779,790
18085,28013,2955,13532,1975,25058,1569,779,790
18090,28023,2955,13538,1975,25068,1569,779,790
18095,28029,2955,13540,1975,25074,1570,779,791
18100,28040,2955,13545,1975,25085,1571,779,792
18105,28044,2955,13549,1975,25089,1571,779,792
18110,28054,2955,13555,1975,25099,1571,779,792
18115,28060,2955,13557,1975,25105,1573,780,793
18120,28071,2955,13561,1975,25116,1574,781,793
18125,28075,2955,13562,1975,25120,1574,781,793
18130,28085,2955,13565,1975,25130,1574,781,793
18135,28091,2955,13568,1975,25136,1575,781,794
18140,28102,2955,13574,1975,25147,1575,781,794
18145,28106,2955,13576,1975,25151,1575,781,794
18150,28116,2955,13578,1975,25161,1575,781,794
18155,28122,2955,13579,1975,25167,1576,781,795
18160,28133,2955,13584,1975,25178,1576,781,795
18165,28137,2955,13586,1975,25182,1576,781,795
18170,28147,2957,13591,1976,25190,1576,781,795
18175,28153,2957,13594,1976,25195,1577,781,796
18180,28164,2961,13599,1979,25203,1577,781,796
18185,28168,2961,13600,1979,25207,1577,781,796
18190,28178,2963,13604,1980,25215,1577,781,796
18195,28184,2963,13606,1980,25220,1578,781,797
18200,28195,2966,13617,1983,25229,1578,781,797
18205,28199,2968,13619,1985,25231,1578,781,797
18210,28209,2970,13624,1985,25239,1578,781,797
18215,28215,2970,13625,1985,25245,1579,781,798
18220,28226,2971,13628,1986,25255,1579,781,798
18225,28230,2972,13630,1987,25258,1579,781,798
18230,28240,2974,13636,1989,25266,1579,781,798
18235,28246,2974,13641,1989,25271,1581,783,798
18240,28257,2976,13645,1991,25281,1582,783,799
18245,28261,2976,13645,1991,25285,1582,783,799
18250,28271,2976,13649,1991,25295,1582,783,799
18255,28277,2976,13653,1991,25301,1583,783,800
18260,28288,2977,13660,1992,25311,1583,783,800
18265,28292,2977,13661,1992,25315,1583,783,800
18270,28302,2977,13668,1992,25325,1583,783,800
18275,28308,2977,13671,1992,25331,1584,784,800
18280,28319,2978,13674,1992,25341,1584,784,800
18285,28323,2979,13676,1993,25344,1584,784,800
18290,28333,2979,13679,1993,25354,1584,784,800
18295,28339,2979,13679,1993,25360,1585,784,801
18300,28350,2981,13683,1994,25369,1585,784,801
18305,28354,2981,13684,1994,25373,1585,784,801
18310,28364,2982,13688,1994,25382,1585,784,801
18315,28370,2982,13690,1994,25388,1586,784,802
18320,28381,2983,13696,1995,25398,1586,784,802
18325,28385,2983,13697,1995,25402,1586,784,802
18330,28395,2984,13700,1995,25411,1586,784,802
18335,28401,2984,13703,1995,25417,1587,784,803
18340,28412,2984,13708,1995,25428,1587,784,803
18345,28416,2984,13710,1995,25432,1587,784,803
18350,28426,2986,13714,1997,25440,1587,784,803
18355,28432,2986,13717,1997,25446,1589,785,804
18360,28443,2987,13723,1998,25456,1590,785,805
18365,28447,2987,13725,1998,25460,1590,785,805
18370,28457,2988,13731,1999,25469,1590,785,805
18375,28463,2988,13734,1999,25475,1592,786,806
18380,28474,2989,13740,1999,25485,1593,787,806
18385,28478,2989,13742,1999,25489,1593,787,806
18390,28488,2990,13745,2000,25498,1593,787,806
18395,28494,2990,13748,2000,25504,1595,788,807
18400,28505,2993,13754,2003,25512,1596,788,808
18405,28509,2993,13756,2003,25516,1596,788,808
18410,28519,2994,13763,2004,25525,1596,788,808
18415,28525,2994,13766,2004,25531,1597,789,808
18420,28536,2998,13773,2008,25538,1598,789,809
18425,28540,2998,13776,2008,25542,1598,789,809
18430,28550,2999,13779,2008,25551,1598,789,809
18435,28556,2999,13783,2008,25557,1599,790,809
18440,28567,2999,13787,2008,25568,1600,790,810
18445,28571,2999,13788,2008,25572,1600,790,810
18450,28581,3000,13791,2009,25581,1600,790,810
18455,28587,3000,13793,2009,25587,1601,791,810
18460,28598,3000,13798,2009,25598,1602,791,811
18465,28602,3000,13801,2009,25602,1602,791,811
18470,28612,3002,13807,2009,25610,1602,791,811
18475,28618,3002,13811,2009,25616,1603,792,811
18480,28629,3003,13816,2010,25626,1604,792,812
18485,28633,3003,13817,2010,25630,1604,792,812
18490,28643,3004,13820,2011,25639,1604,792,812
18495,28649,3004,13823,2011,25644,1605,792,813
18500,28660,3005,13825,2012,25655,1605,792,813
18505,28664,3005,13827,2012,25659,1605,792,813
18510,28674,3006,13831,2013,25668,1605,792,813
18515,28680,3006,13835,2013,25673,1607,792,815
18520,28691,3007,13840,2014,25684,1607,792,815
18525,28695,3007,13842,2014,25688,1607,792,815
18530,28705,3008,13847,2015,25697,1607,792,815
18535,28711,3008,13851,2015,25703,1608,792,816
18540,28722,3009,13857,2016,25713,1608,792,816
18545,28726,3009,13861,2016,25717,1608,792,816
18550,28736,3010,13867,2017,25726,1608,792,816
18555,28742,3010,13870,2017,25732,1609,793,816
18560,28753,3011,13874,2017,25742,1609,793,816
18565,28757,3011,13877,2017,25746,1609,793,816
18570,28767,3012,13882,2017,25755,1609,793,816
18575,28773,3012,13885,2017,25761,1610,794,816
18580,28784,3014,13890,2018,25770,1610,794,816
18585,28788,3014,13893,2018,25774,1610,794,816
18590,28798,3016,13899,2020,25782,1610,794,816
18595,28804,3016,13902,2020,25788,1611,795,816
18600,28815,3017,13906,2020,25798,1612,796,816
18605,28819,3017,13907,2020,25802,1612,796,816
18610,28829,3019,13913,2021,25810,1612,796,816
18615,28835,3019,13915,2021,25816,1613,796,817
18620,28846,3020,13918,2021,25826,1613,796,817
18625,28850,3020,13920,2021,25830,1613,796,817
18630,28860,3022,13923,2023,25838,1613,796,817
18635,28866,3022,13928,2023,25844,1615,798,817
18640,28877,3025,13935,2025,25852,1615,798,817
18645,28881,3025,13935,2025,25856,1615,798,817
18650,28891,3027,13939,2025,25864,1615,798,817
18655,28897,3027,13940,2025,25869,1617,798,819
18660,28908,3030,13945,2027,25878,1618,798,820
18665,28912,3031,13947,2028,25881,1618,798,820
18670,28922,3033,13951,2029,25889,1618,798,820
18675,28928,3033,13954,2029,25895,1619,798,821
18680,28939,3034,13960,2029,25905,1620,799,821
18685,28943,3034,13961,2029,25909,1620,799,821
18690,28953,3036,13968,2031,25917,1620,799,821
18695,28959,3036,13971,2031,25923,1621,800,821
18700,28970,3037,13976,2032,25933,1622,801,821
18705,28974,3038,13977,2033,25936,1622,801,821
18710,28984,3040,13979,2033,25944,1622,801,821
18715,28990,3040,13983,2033,25950,1623,801,822
18720,29001,3042,13986,2035,25959,1624,801,823
18725,29005,3042,13987,2035,25963,1624,801,823
18730,29015,3043,13990,2035,25972,1624,801,823
18735,29021,3043,13992,2035,25978,1625,801,824
18740,29032,3044,13995,2035,25988,1625,801,824
18745,29036,3044,13995,2035,25992,1625,801,824
18750,29046,3045,13998,2035,26001,1625,801,824
18755,29052,3045,14003,2035,26007,1626,801,825
18760,29063,3046,14010,2036,26017,1626,801,825
18765,29067,3047,14012,2037,26020,1626,801,825
18770,29077,3048,14017,2037,26029,1626,801,825
18775,29083,3048,14019,2037,26035,1628,801,827
18780,29094,3050,14024,2039,26044,1628,801,827
18785,29098,3050,14024,2039,26048,1628,801,827
18790,29108,3051,14030,2039,26057,1628,801,827
18795,29114,3051,14035,2039,26063,1629,802,827
18800,29125,3053,14041,2041,26072,1629,802,827
18805,29129,3054,14044,2042,26075,1629,802,827
18810,29139,3055,14048,2042,26084,1629,802,827
18815,29145,3055,14051,2042,26090,1630,803,827
18820,29156,3057,14054,2043,26099,1630,803,827
18825,29160,3058,14057,2044,26102,1630,803,827
18830,29170,3060,14062,2045,26110,1630,803,827
18835,29176,3060,14067,2045,26115,1631,804,827
18840,29187,3064,14072,2048,26123,1632,804,828
18845,29191,3064,14073,2048,26127,1632,804,828
18850,29201,3064,14080,2048,26137,1632,804,828
18855,29207,3064,14081,2048,26143,1633,804,829
18860,29218,3066,14091,2050,26152,1633,804,829
18865,29222,3066,14093,2050,26156,1633,804,829
18870,29232,3066,14100,2050,26166,1633,804,829
18875,29238,3066,14103,2050,26172,1634,804,830
18880,29249,3068,14108,2051,26181,1634,804,830
18885,29253,3068,14111,2051,26185,1634,804,830
18890,29263,3068,14115,2051,26195,1634,804,830
18895,29269,3068,14118,2051,26201,1636,806,830
18900,29280,3070,14125,2053,26210,1636,806,830
18905,29284,3070,14128,2053,26214,1636,806,830
18910,29294,3070,14131,2053,26224,1636,806,830
18915,29300,3070,14135,2053,26230,1637,807,830
18920,29311,3070,14139,2053,26241,1637,807,830
18925,29315,3070,14140,2053,26245,1637,807,830
18930,29325,3070,14145,2053,26255,1637,807,830
18935,29331,3070,14148,2053,26261,1638,808,830
18940,29342,3070,14152,2053,26272,1638,808,830
18945,29346,3070,14154,2053,26276,1638,808,830
18950,29356,3071,14157,2054,26285,1638,808,830
18955,29362,3071,14159,2054,26291,1639,808,831
18960,29373,3073,14167,2056,26300,1639,808,831
18965,29377,3073,14167,2056,26304,1639,808,831
18970,29387,3075,14171,2057,26312,1639,808,831
18975,29393,3075,14174,2057,26318,1640,808,832
18980,29404,3076,14179,2057,26328,1640,808,832
18985,29408,3076,14180,2057,26332,1640,808,832
18990,29418,3078,14184,2058,26340,1640,808,832
18995,29424,3078,14187,2058,26346,1641,808,833
19000,29435,3080,14194,2059,26355,1641,808,833
19005,29439,3081,14197,2060,26358,1641,808,833
19010,29449,3083,14202,2062,26366,1641,808,833
19015,29455,3083,14206,2062,26372,1643,809,834
19020,29466,3086,14213,2064,26380,1644,809,835
19025,29470,3086,14214,2064,26384,1644,809,835
19030,29480,3088,14219,2064,26392,1644,809,835
19035,29486,3088,14222,2064,26398,1645,810,835
19040,29497,3089,14227,2065,26408,1646,810,836
19045,29501,3089,14229,2065,26412,1646,810,836
19050,29511,3091,14236,2067,26420,1646,810,836
19055,29517,3091,14238,2067,26426,1647,810,837
19060,29528,3093,14248,2069,26435,1648,811,837
19065,29532,3094,14251,2070,26438,1648,811,837
19070,29542,3096,14257,2071,26446,1648,811,837
19075,29548,3096,14257,2071,26452,1649,811,838
19080,29559,3098,14265,2073,26461,1650,812,838
19085,29563,3098,14266,2073,26465,1650,812,838
19090,29573,3099,14270,2074,26474,1650,812,838
19095,29579,3099,14273,2074,26480,1651,812,839
19100,29590,3100,14277,2075,26490,1651,812,839
19105,29594,3100,14279,2075,26494,1651,812,839
19110,29604,3101,14284,2075,26503,1651,812,839
19115,29610,3101,14288,2075,26508,1652,812,840
19120,29621,3102,14292,2076,26519,1652,812,840
19125,29625,3102,14293,2076,26523,1652,812,840
19130,29635,3103,14299,2076,26532,1652,812,840
19135,29641,3103,14303,2076,26537,1654,814,840
19140,29652,3108,14309,2080,26544,1655,815,840
19145,29656,3108,14313,2080,26548,1655,815,840
19150,29666,3108,14320,2080,26558,1655,815,840
19155,29672,3108,14324,2080,26564,1656,816,840
19160,29683,3109,14330,2080,26574,1656,816,840
19165,29687,3109,14330,2080,26578,1656,816,840
19170,29697,3109,14336,2080,26588,1656,816,840
19175,29703,3109,14339,2080,26594,1657,817,840
19180,29714,3110,14343,2080,26604,1657,817,840
19185,29718,3110,14345,2080,26608,1657,817,840
19190,29728,3111,14350,2080,26617,1657,817,840
19195,29734,3111,14352,2080,26623,1658,817,841
19200,29745,3113,14359,2082,26632,1658,817,841
19205,29749,3113,14359,2082,26636,1658,817,841
19210,29759,3114,14367,2083,26645,1658,817,841
19215,29765,3114,14370,2083,26651,1659,817,842
19220,29776,3115,14376,2083,26661,1659,817,842
19225,29780,3116,14380,2084,26664,1659,817,842
19230,29790,3117,14386,2085,26673,1659,817,842
19235,29796,3117,14389,2085,26679,1660,818,842
19240,29807,3118,14396,2086,26689,1660,818,842
19245,29811,3118,14396,2086,26693,1660,818,842
19250,29821,3120,14401,2087,26701,1660,818,842
19255,29827,3120,14404,2087,26707,1662,818,844
19260,29838,3122,14411,2089,26716,1663,818,845
19265,29842,3124,14415,2091,26718,1663,818,845
19270,29852,3126,14419,2091,26726,1663,818,845
19275,29858,3126,14421,2091,26732,1664,818,846
19280,29869,3127,14426,2092,26742,1664,818,846
19285,29873,3127,14428,2092,26746,1664,818,846
19290,29883,3129,14430,2092,26754,1664,818,846
19295,29889,3129,14434,2092,26760,1665,818,847
19300,29900,3130,14440,2093,26770,1665,818,847
19305,29904,3131,14441,2094,26773,1665,818,847
19310,29914,3133,14447,2096,26781,1665,818,847
19315,29920,3133,14451,2096,26787,1666,819,847
19320,29931,3133,14456,2096,26798,1667,820,847
19325,29935,3133,14457,2096,26802,1667,820,847
19330,29945,3135,14461,2097,26810,1667,820,847
19335,29951,3135,14464,2097,26816,1668,820,848
19340,29962,3135,14472,2097,26827,1668,820,848
19345,29966,3135,14474,2097,26831,1668,820,848
19350,29976,3137,14478,2098,26839,1668,820,848
19355,29982,3137,14482,2098,26845,1669,821,848
19360,29993,3137,14487,2098,26856,1669,821,848
19365,29997,3137,14490,2098,26860,1669,821,848
19370,30007,3139,14496,2098,26868,1669,821,848
19375,30013,3139,14500,2098,26873,1671,822,849
19380,30024,3142,14506,2100,26882,1672,823,849
19385,30028,3142,14508,2100,26886,1672,823,849
19390,30038,3144,14515,2101,26894,1672,823,849
19395,30044,3144,14516,2101,26900,1673,823,850
19400,30055,3144,14518,2101,26911,1674,823,851
19405,30059,3144,14521,2101,26915,1674,823,851
19410,30069,3146,14527,2102,26923,1674,823,851
19415,30075,3146,14529,2102,26929,1675,824,851
19420,30086,3146,14533,2102,26940,1676,824,852
19425,30090,3146,14534,2102,26944,1676,824,852
19430,30100,3148,14541,2104,26952,1676,824,852
19435,30106,3148,14545,2104,26958,1677,825,852
19440,30117,3150,14552,2106,26967,1678,826,852
19445,30121,3150,14552,2106,26971,1678,826,852
19450,30131,3152,14555,2106,26979,1678,826,852
19455,30137,3152,14558,2106,26985,1679,827,852
19460,30148,3153,14563,2107,26995,1680,828,852
19465,30152,3154,14565,2108,26998,1680,828,852
19470,30162,3156,14567,2108,27006,1680,828,852
19475,30168,3156,14569,2108,27012,1681,828,853
19480,30179,3157,14574,2109,27022,1682,829,853
19485,30183,3158,14577,2110,27025,1682,829,853
19490,30193,3160,14582,2111,27033,1682,829,853
19495,30199,3160,14586,2111,27039,1684,830,854
19500,30210,3162,14591,2112,27048,1685,831,854
19505,30214,3162,14592,2112,27052,1685,831,854
19510,30224,3162,14595,2112,27062,1685,831,854
19515,30230,3162,14597,2112,27068,1686,831,855
19520,30241,3163,14604,2113,27078,1686,831,855
19525,30245,3163,14605,2113,27082,1686,831,855
19530,30255,3163,14611,2113,27092,1686,831,855
19535,30261,3163,14614,2113,27098,1687,831,856
19540,30272,3164,14617,2114,27108,1687,831,856
19545,30276,3165,14620,2115,27111,1687,831,856
19550,30286,3165,14624,2115,27121,1687,831,856
19555,30292,3165,14627,2115,27127,1688,831,857
19560,30303,3166,14631,2116,27137,1688,831,857
19565,30307,3166,14632,2116,27141,1688,831,857
19570,30317,3166,14637,2116,27151,1688,831,857
19575,30323,3166,14640,2116,27157,1689,831,858
19580,30334,3167,14647,2117,27167,1689,831,858
19585,30338,3167,14650,2117,27171,1689,831,858
19590,30348,3167,14652,2117,27181,1689,831,858
19595,30354,3167,14655,2117,27187,1690,831,859
19600,30365,3168,14662,2118,27197,1690,831,859
19605,30369,3168,14662,2118,27201,1690,831,859
19610,30379,3170,14667,2120,27209,1690,831,859
19615,30385,3170,14670,2120,27215,1692,831,861
19620,30396,3172,14676,2121,27224,1693,832,861
19625,30400,3172,14677,2121,27228,1693,832,861
19630,30410,3174,14683,2121,27236,1693,832,861
19635,30416,3174,14686,2121,27242,1694,833,861
19640,30427,3175,14693,2122,27252,1695,834,861
19645,30431,3175,14695,2122,27256,1695,834,861
19650,30441,3177,14700,2123,27264,1695,834,861
19655,30447,3177,14702,2123,27270,1696,834,862
19660,30458,3180,14707,2125,27278,1697,834,863
19665,30462,3180,14707,2125,27282,1697,834,863
19670,30472,3182,14711,2126,27290,1697,834,863
19675,30478,3182,14714,2126,27296,1698,834,864
19680,30489,3184,14720,2128,27305,1699,834,865
19685,30493,3185,14722,2129,27308,1699,834,865
19690,30503,3187,14727,2129,27316,1699,834,865
19695,30509,3187,14730,2129,27322,1700,835,865
19700,30520,3188,14733,2129,27332,1701,835,866
19705,30524,3190,14736,2131,27334,1701,835,866
19710,30534,3192,14742,2133,27342,1701,835,866
19715,30540,3192,14744,2133,27348,1702,836,866
19720,30551,3194,14748,2134,27357,1703,836,867
19725,30555,3194,14750,2134,27361,1703,836,867
19730,30565,3196,14755,2136,27369,1703,836,867
19735,30571,3196,14760,2136,27374,1705,837,868
19740,30582,3200,14768,2140,27382,1706,837,869
19745,30586,3201,14772,2141,27385,1706,837,869
19750,30596,3201,14779,2141,27395,1706,837,869
19755,30602,3201,14783,2141,27401,1707,837,870
19760,30613,3201,14789,2141,27412,1708,837,871
19765,30617,3201,14791,2141,27416,1708,837,871
19770,30627,3201,14796,2141,27426,1708,837,871
19775,30633,3201,14799,2141,27432,1709,837,872
19780,30644,3201,14805,2141,27443,1710,837,873
19785,30648,3201,14807,2141,27447,1710,837,873
19790,30658,3201,14812,2141,27457,1710,837,873
19795,30664,3201,14816,2141,27463,1711,837,874
19800,30675,3201,14823,2141,27474,1711,837,874
19805,30679,3201,14826,2141,27478,1711,837,874
19810,30689,3201,14831,2141,27488,1711,837,874
19815,30695,3201,14835,2141,27494,1712,838,874
19820,30706,3201,14840,2141,27505,1712,838,874
19825,30710,3201,14842,2141,27509,1712,838,874
19830,30720,3201,14843,2141,27519,1712,838,874
19835,30726,3201,14845,2141,27525,1713,839,874
19840,30737,3201,14850,2141,27536,1713,839,874
19845,30741,3201,14851,2141,27540,1713,839,874
19850,30751,3203,14853,2142,27548,1713,839,874
19855,30757,3203,14856,2142,27554,1715,840,875
19860,30768,3207,14866,2146,27561,1715,840,875
19865,30772,3208,14868,2147,27564,1715,840,875
19870,30782,3209,14871,2148,27573,1715,840,875
19875,30788,3209,14876,2148,27579,1716,841,875
19880,30799,3211,14882,2149,27588,1716,841,875
19885,30803,3211,14884,2149,27592,1716,841,875
19890,30813,3212,14889,2150,27601,1716,841,875
19895,30819,3212,14893,2150,27607,1717,841,876
19900,30830,3213,14898,2150,27617,1717,841,876
19905,30834,3213,14899,2150,27621,1717,841,876
19910,30844,3214,14904,2150,27630,1717,841,876
19915,30850,3214,14907,2150,27636,1718,842,876
19920,30861,3215,14911,2150,27646,1718,842,876
19925,30865,3215,14914,2150,27650,1718,842,876
19930,30875,3216,14918,2151,27659,1718,842,876
19935,30881,3216,14920,2151,27665,1719,842,877
19940,30892,3217,14924,2152,27675,1719,842,877
19945,30896,3217,14927,2152,27679,1719,842,877
19950,30906,3218,14932,2153,27688,1719,842,877
19955,30912,3218,14934,2153,27694,1720,843,877
19960,30923,3220,14942,2155,27703,1720,843,877
19965,30927,3220,14943,2155,27707,1720,843,877
19970,30937,3222,14950,2156,27715,1720,843,877
19975,30943,3222,14953,2156,27720,1722,844,878
19980,30954,3224,14956,2158,27730,1723,844,879
19985,30958,3224,14959,2158,27734,1723,844,879
19990,30968,3225,14962,2158,27743,1723,844,879
19995,30974,3225,14966,2158,27748,1724,844,880
20000,30985,3227,14971,2159,27758,1724,844,880
20005,30989,3228,14975,2160,27761,1724,844,880
20010,30999,3229,14982,2160,27770,1724,844,880
20015,31005,3229,14985,2160,27775,1725,845,880
20020,31016,3231,14993,2162,27785,1725,845,880
20025,31020,3232,14996,2163,27788,1725,845,880
20030,31030,3233,15000,2163,27797,1725,845,880
20035,31036,3233,15002,2163,27802,1726,846,880
20040,31047,3235,15007,2165,27812,1726,846,880
20045,31051,3235,15008,2165,27816,1726,846,880
20050,31061,3236,15013,2166,27825,1726,846,880
20055,31067,3236,15017,2166,27831,1727,846,881
20060,31078,3237,15020,2167,27841,1727,846,881
20065,31082,3238,15023,2168,27844,1727,846,881
20070,31092,3239,15027,2169,27853,1727,846,881
20075,31098,3239,15029,2169,27859,1728,847,881
20080,31109,3240,15034,2169,27869,1728,847,881
20085,31113,3241,15037,2170,27872,1728,847,881
20090,31123,3243,15040,2170,27880,1728,847,881
20095,31129,3243,15044,2170,27886,1730,849,881
20100,31140,3245,15048,2172,27895,1731,849,882
20105,31144,3246,15049,2173,27898,1731,849,882
20110,31154,3247,15054,2173,27907,1731,849,882
20115,31160,3247,15058,2173,27913,1732,850,882
20120,31171,3247,15060,2173,27924,1733,850,883
20125,31175,3247,15060,2173,27928,1733,850,883
20130,31185,3248,15064,2173,27937,1733,850,883
20135,31191,3248,15065,2173,27943,1734,850,884
20140,31202,3249,15071,2174,27953,1735,850,885
20145,31206,3249,15072,2174,27957,1735,850,885
20150,31216,3250,15073,2174,27966,1735,850,885
20155,31222,3250,15074,2174,27972,1736,850,886
20160,31233,3250,15079,2174,27983,1736,850,886
20165,31237,3250,15080,2174,27987,1736,850,886
20170,31247,3251,15087,2175,27996,1736,850,886
20175,31253,3251,15091,2175,28002,1737,851,886
20180,31264,3251,15098,2175,28013,1737,851,886
20185,31268,3251,15100,2175,28017,1737,851,886
20190,31278,3252,15106,2175,28026,1737,851,886
20195,31284,3252,15109,2175,28032,1738,851,887
20200,31295,3253,15117,2176,28042,1738,851,887
20205,31299,3253,15118,2176,28046,1738,851,887
20210,31309,3255,15123,2177,28054,1738,851,887
20215,31315,3255,15125,2177,28059,1740,852,888
20220,31326,3258,15131,2180,28068,1740,852,888
20225,31330,3258,15132,2180,28072,1740,852,888
20230,31340,3260,15138,2181,28080,1740,852,888
20235,31346,3260,15139,2181,28086,1741,852,889
20240,31357,3261,15145,2181,28096,1741,852,889
20245,31361,3261,15148,2181,28100,1741,852,889
20250,31371,3263,15152,2181,28108,1741,852,889
20255,31377,3263,15155,2181,28113,1742,852,890
20260,31388,3265,15157,2182,28123,1743,852,891
20265,31392,3265,15159,2182,28127,1743,852,891
20270,31402,3267,15166,2184,28135,1743,852,891
20275,31408,3267,15170,2184,28140,1744,853,891
20280,31419,3269,15173,2185,28150,1745,853,892
20285,31423,3269,15173,2185,28154,1745,853,892
20290,31433,3270,15177,2185,28163,1745,853,892
20295,31439,3270,15180,2185,28169,1746,854,892
20300,31450,3272,15186,2187,28178,1747,854,893
20305,31454,3272,15187,2187,28182,1747,854,893
20310,31464,3273,15193,2188,28191,1747,854,893
20315,31470,3273,15199,2188,28197,1748,855,893
20320,31481,3275,15206,2190,28206,1749,856,893
20325,31485,3275,15206,2190,28210,1749,856,893
20330,31495,3276,15210,2190,28219,1749,856,893
20335,31501,3276,15214,2190,28225,1751,856,895
20340,31512,3278,15218,2192,28234,1752,856,896
20345,31516,3279,15220,2193,28237,1752,856,896
20350,31526,3280,15225,2194,28246,1752,856,896
20355,31532,3280,15227,2194,28252,1753,856,897
20360,31543,3282,15232,2196,28261,1754,856,898
20365,31547,3282,15233,2196,28265,1754,856,898
20370,31557,3283,15238,2196,28274,1754,856,898
20375,31563,3283,15240,2196,28280,1755,856,899
20380,31574,3285,15244,2197,28289,1756,856,900
20385,31578,3286,15245,2198,28292,1756,856,900
20390,31588,3288,15250,2200,28300,1756,856,900
20395,31594,3288,15253,2200,28305,1757,856,901
20400,31605,3292,15262,2204,28313,1757,856,901
20405,31609,3293,15265,2205,28316,1757,856,901
20410,31619,3295,15269,2206,28324,1757,856,901
20415,31625,3295,15271,2206,28329,1758,856,902
20420,31636,3296,15274,2207,28340,1758,856,902
20425,31640,3296,15275,2207,28344,1758,856,902
20430,31650,3298,15279,2209,28352,1758,856,902
20435,31656,3298,15281,2209,28358,1759,856,903
20440,31667,3299,15287,2210,28368,1759,856,903
20445,31671,3299,15289,2210,28372,1759,856,903
20450,31681,3301,15295,2212,28380,1759,856,903
20455,31687,3301,15296,2212,28386,1761,857,904
20460,31698,3302,15300,2213,28396,1761,857,904
20465,31702,3302,15302,2213,28400,1761,857,904
20470,31712,3303,15308,2214,28409,1761,857,904
20475,31718,3303,15312,2214,28415,1763,858,905
20480,31729,3304,15320,2215,28425,1763,858,905
20485,31733,3304,15323,2215,28429,1763,858,905
20490,31743,3305,15328,2216,28438,1763,858,905
20495,31749,3305,15332,2216,28444,1764,859,905
20500,31760,3305,15336,2216,28455,1765,859,906
20505,31764,3305,15337,2216,28459,1765,859,906
20510,31774,3306,15344,2216,28468,1765,859,906
20515,31780,3306,15348,2216,28474,1766,860,906
20520,31791,3308,15351,2218,28483,1767,860,907
20525,31795,3308,15352,2218,28487,1767,860,907
20530,31805,3310,15355,2218,28495,1767,860,907
20535,31811,3310,15358,2218,28500,1768,861,907
20540,31822,3312,15363,2219,28510,1769,862,907
20545,31826,3312,15365,2219,28514,1769,862,907
20550,31836,3314,15371,2221,28522,1769,862,907
20555,31842,3314,15374,2221,28527,1770,863,907
20560,31853,3316,15380,2222,28537,1771,863,908
20565,31857,3316,15380,2222,28541,1771,863,908
20570,31867,3318,15382,2222,28549,1771,863,908
20575,31873,3318,15387,2222,28554,1772,864,908
20580,31884,3322,15391,2225,28562,1773,864,909
20585,31888,3322,15393,2225,28566,1773,864,909
20590,31898,3324,15399,2226,28574,1773,864,909
20595,31904,3324,15402,2226,28580,1775,865,910
20600,31915,3325,15409,2227,28590,1775,865,910
20605,31919,3325,15411,2227,28594,1775,865,910
20610,31929,3327,15416,2228,28602,1775,865,910
20615,31935,3327,15418,2228,28608,1777,865,912
20620,31946,3328,15424,2228,28618,1777,865,912
20625,31950,3329,15428,2229,28621,1777,865,912
20630,31960,3331,15433,2230,28629,1777,865,912
20635,31966,3331,15434,2230,28634,1779,865,914
20640,31977,3334,15442,2232,28643,1780,866,914
20645,31981,3336,15444,2234,28645,1780,866,914
20650,31991,3338,15448,2234,28653,1780,866,914
20655,31997,3338,15452,2234,28659,1781,866,915
20660,32008,3340,15457,2235,28668,1782,867,915
20665,32012,3340,15458,2235,28672,1782,867,915
20670,32022,3342,15461,2235,28680,1782,867,915
20675,32028,3342,15465,2235,28686,1783,868,915
20680,32039,3345,15471,2237,28694,1784,868,916
20685,32043,3346,15472,2238,28697,1784,868,916
20690,32053,3348,15477,2239,28705,1784,868,916
20695,32059,3348,15481,2239,28711,1785,869,916
20700,32070,3352,15489,2242,28718,1786,870,916
20705,32074,3352,15491,2242,28722,1786,870,916
20710,32084,3352,15495,2242,28732,1786,870,916
20715,32090,3352,15500,2242,28738,1787,871,916
20720,32101,3352,15504,2242,28749,1787,871,916
20725,32105,3352,15506,2242,28753,1787,871,916
20730,32115,3352,15511,2242,28763,1787,871,916
20735,32121,3352,15512,2242,28769,1788,871,917
20740,32132,3352,15515,2242,28780,1788,871,917
20745,32136,3352,15517,2242,28784,1788,871,917
20750,32146,3352,15524,2242,28794,1788,871,917
20755,32152,3352,15529,2242,28800,1790,873,917
20760,32163,3352,15533,2242,28811,1790,873,917
20765,32167,3352,15533,2242,28815,1790,873,917
20770,32177,3353,15538,2242,28824,1790,873,917
20775,32183,3353,15541,2242,28830,1791,873,918
20780,32194,3353,15545,2242,28841,1791,873,918
20785,32198,3353,15547,2242,28845,1791,873,918
20790,32208,3354,15552,2242,28854,1791,873,918
20795,32214,3354,15555,2242,28860,1792,874,918
20800,32225,3354,15561,2242,28871,1792,874,918
20805,32229,3354,15561,2242,28875,1792,874,918
20810,32239,3356,15566,2243,28883,1792,874,918
20815,32245,3356,15570,2243,28888,1793,874,919
20820,32256,3359,15576,2245,28897,1794,874,920
20825,32260,3360,15579,2246,28900,1794,874,920
20830,32270,3362,15586,2247,28908,1794,874,920
20835,32276,3362,15588,2247,28914,1795,874,921
20840,32287,3364,15596,2249,28923,1796,875,921
20845,32291,3364,15597,2249,28927,1796,875,921
20850,32301,3366,15602,2250,28935,1796,875,921
20855,32307,3366,15604,2250,28941,1797,876,921
20860,32318,3367,15609,2251,28951,1798,877,921
20865,32322,3367,15609,2251,28955,1798,877,921
20870,32332,3369,15613,2251,28963,1798,877,921
20875,32338,3369,15615,2251,28969,1800,878,922
20880,32349,3371,15620,2253,28978,1801,879,922
20885,32353,3371,15623,2253,28982,1801,879,922
20890,32363,3372,15626,2253,28991,1801,879,922
20895,32369,3372,15628,2253,28997,1802,879,923
20900,32380,3373,15633,2254,29007,1802,879,923
20905,32384,3373,15634,2254,29011,1802,879,923
20910,32394,3374,15641,2255,29020,1802,879,923
20915,32400,3374,15644,2255,29026,1803,879,924
20920,32411,3375,15652,2256,29036,1803,879,924
20925,32415,3375,15654,2256,29040,1803,879,924
20930,32425,3376,15661,2257,29049,1803,879,924
20935,32431,3376,15664,2257,29055,1804,879,925
20940,32442,3378,15668,2258,29064,1804,879,925
20945,32446,3379,15671,2259,29067,1804,879,925
20950,32456,3381,15677,2260,29075,1804,879,925
20955,32462,3381,15680,2260,29080,1805,879,926
20960,32473,3384,15687,2262,29089,1806,879,927
20965,32477,3385,15690,2263,29092,1806,879,927
20970,32487,3387,15694,2264,29100,1806,879,927
20975,32493,3387,15698,2264,29106,1807,880,927
20980,32504,3390,15705,2267,29114,1808,880,928
20985,32508,3391,15708,2268,29117,1808,880,928
20990,32518,3393,15715,2269,29125,1808,880,928
20995,32524,3393,15718,2269,29131,1810,881,929
21000,32535,3396,15727,2272,29139,1811,882,929
21005,32539,3396,15728,2272,29143,1811,882,929
21010,32549,3397,15735,2273,29152,1811,882,929
21015,32555,3397,15740,2273,29158,1812,883,929
21020,32566,3397,15744,2273,29169,1812,883,929
21025,32570,3397,15745,2273,29173,1812,883,929
21030,32580,3398,15746,2273,29182,1812,883,929
21035,32586,3398,15747,2273,29188,1813,883,930
21040,32597,3398,15751,2273,29199,1813,883,930
21045,32601,3398,15753,2273,29203,1813,883,930
21050,32611,3399,15756,2273,29212,1813,883,930
21055,32617,3399,15760,2273,29218,1814,884,930
21060,32628,3399,15764,2273,29229,1814,884,930
21065,32632,3401,15766,2275,29231,1814,884,930
21070,32642,3403,15771,2276,29239,1814,884,930
21075,32648,3403,15773,2276,29245,1815,884,931
21080,32659,3404,15777,2277,29255,1815,884,931
21085,32663,3405,15779,2278,29258,1815,884,931
21090,32673,3407,15783,2280,29266,1815,884,931
21095,32679,3407,15786,2280,29272,1816,885,931
21100,32690,3408,15791,2281,29282,1816,885,931
21105,32694,3409,15792,2282,29285,1816,885,931
21110,32704,3411,15795,2283,29293,1816,885,931
21115,32710,3411,15796,2283,29299,1817,885,932
21120,32721,3412,15802,2284,29309,1818,885,933
21125,32725,3412,15805,2284,29313,1818,885,933
21130,32735,3413,15811,2284,29322,1818,885,933
21135,32741,3413,15812,2284,29328,1820,886,934
21140,32752,3414,15816,2285,29338,1820,886,934
21145,32756,3414,15817,2285,29342,1820,886,934
21150,32766,3415,15824,2285,29351,1820,886,934
21155,32772,3415,15827,2285,29357,1821,886,935
21160,32783,3416,15832,2286,29367,1821,886,935
21165,32787,3416,15835,2286,29371,1821,886,935
21170,32797,3417,15839,2286,29380,1821,886,935
21175,32803,3417,15844,2286,29386,1822,887,935
21180,32814,3417,15850,2286,29397,1822,887,935
21185,32818,3417,15852,2286,29401,1822,887,935
21190,32828,3418,15857,2287,29410,1822,887,935
21195,32834,3418,15862,2287,29416,1823,888,935
21200,32845,3418,15867,2287,29427,1823,888,935
21205,32849,3418,15869,2287,29431,1823,888,935
21210,32859,3419,15872,2287,29440,1823,888,935
21215,32865,3419,15876,2287,29446,1824,889,935
21220,32876,3419,15882,2287,29457,1824,889,935
21225,32880,3419,15884,2287,29461,1824,889,935
21230,32890,3421,15889,2289,29469,1824,889,935
21235,32896,3421,15892,2289,29475,1825,890,935
21240,32907,3422,15896,2289,29485,1825,890,935
21245,32911,3422,15897,2289,29489,1825,890,935
21250,32921,3424,15901,2290,29497,1825,890,935
21255,32927,3424,15902,2290,29503,1826,890,936
21260,32938,3426,15909,2291,29512,1826,890,936
21265,32942,3426,15910,2291,29516,1826,890,936
21270,32952,3428,15918,2293,29524,1826,890,936
21275,32958,3428,15921,2293,29530,1827,890,937
21280,32969,3429,15925,2294,29540,1827,890,937
21285,32973,3429,15929,2294,29544,1827,890,937
21290,32983,3431,15938,2296,29552,1827,890,937
21295,32989,3431,15939,2296,29558,1828,890,938
21300,33000,3433,15945,2298,29567,1829,890,939
21305,33004,3433,15947,2298,29571,1829,890,939
21310,33014,3435,15949,2299,29579,1829,890,939
21315,33020,3435,15950,2299,29585,1830,890,940
21320,33031,3436,15955,2300,29595,1831,890,941
21325,33035,3436,15958,2300,29599,1831,890,941
21330,33045,3438,15962,2301,29607,1831,890,941
21335,33051,3438,15965,2301,29613,1832,891,941
21340,33062,3440,15973,2303,29622,1833,891,942
21345,33066,3440,15974,2303,29626,1833,891,942
21350,33076,3442,15980,2305,29634,1833,891,942
21355,33082,3442,15982,2305,29639,1834,891,943
21360,33093,3444,15987,2307,29649,1835,892,943
21365,33097,3445,15990,2308,29652,1835,892,943
21370,33107,3447,15994,2308,29660,1835,892,943
21375,33113,3447,15999,2308,29666,1836,893,943
21380,33124,3448,16003,2309,29676,1836,893,943
21385,33128,3448,16005,2309,29680,1836,893,943
21390,33138,3450,16009,2310,29688,1836,893,943
21395,33144,3450,16015,2310,29694,1837,894,943
21400,33155,3450,16017,2310,29705,1837,894,943
21405,33159,3450,16019,2310,29709,1837,894,943
21410,33169,3452,16024,2312,29717,1837,894,943
21415,33175,3452,16025,2312,29723,1838,894,944
21420,33186,3452,16028,2312,29734,1839,894,945
21425,33190,3453,16030,2313,29737,1839,894,945
21430,33200,3455,16037,2315,29745,1839,894,945
21435,33206,3455,16041,2315,29751,1840,895,945
21440,33217,3455,16045,2315,29762,1841,896,945
21445,33221,3455,16047,2315,29766,1841,896,945
21450,33231,3457,16051,2316,29774,1841,896,945
21455,33237,3457,16056,2316,29780,1842,897,945
21460,33248,3457,16061,2316,29791,1843,898,945
21465,33252,3458,16062,2317,29794,1843,898,945
21470,33262,3460,16064,2317,29802,1843,898,945
21475,33268,3460,16066,2317,29808,1844,898,946
21480,33279,3462,16073,2318,29817,1845,899,946
21485,33283,3462,16076,2318,29821,1845,899,946
21490,33293,3463,16080,2318,29830,1845,899,946
21495,33299,3463,16085,2318,29835,1846,900,946
21500,33310,3464,16090,2319,29846,1846,900,946
21505,33314,3464,16092,2319,29850,1846,900,946
21510,33324,3465,16097,2320,29859,1846,900,946
21515,33330,3465,16100,2320,29864,1847,900,947
21520,33341,3467,16103,2322,29874,1847,900,947
21525,33345,3467,16106,2322,29878,1847,900,947
21530,33355,3468,16113,2323,29887,1847,900,947
21535,33361,3468,16115,2323,29893,1848,901,947
21540,33372,3469,16119,2324,29903,1848,901,947
21545,33376,3469,16121,2324,29907,1848,901,947
21550,33386,3470,16127,2324,29916,1848,901,947
21555,33392,3470,16131,2324,29922,1849,902,947
21560,33403,3471,16136,2325,29932,1849,902,947
21565,33407,3471,16140,2325,29936,1849,902,947
21570,33417,3472,16146,2325,29945,1849,902,947
21575,33423,3472,16149,2325,29951,1850,903,947
21580,33434,3473,16155,2326,29961,1850,903,947
21585,33438,3473,16156,2326,29965,1850,903,947
21590,33448,3475,16162,2327,29973,1850,903,947
21595,33454,3475,16166,2327,29979,1852,905,947
21600,33465,3478,16175,2330,29987,1853,906,947
21605,33469,3478,16179,2330,29991,1853,906,947
21610,33479,3479,16186,2331,30000,1853,906,947
21615,33485,3479,16189,2331,30005,1854,906,948
21620,33496,3481,16195,2333,30015,1854,906,948
21625,33500,3481,16196,2333,30019,1854,906,948
21630,33510,3482,16201,2333,30028,1854,906,948
21635,33516,3482,16204,2333,30034,1855,906,949
21640,33527,3483,16212,2334,30044,1855,906,949
21645,33531,3483,16215,2334,30048,1855,906,949
21650,33541,3484,16220,2334,30057,1855,906,949
21655,33547,3484,16222,2334,30063,1856,907,949
21660,33558,3485,16224,2335,30073,1856,907,949
21665,33562,3485,16225,2335,30077,1856,907,949
21670,33572,3487,16232,2336,30085,1856,907,949
21675,33578,3487,16235,2336,30091,1857,908,949
21680,33589,3489,16240,2337,30100,1857,908,949
21685,33593,3489,16241,2337,30104,1857,908,949
21690,33603,3491,16250,2338,30112,1857,908,949
21695,33609,3491,16252,2338,30118,1858,908,950
21700,33620,3493,16257,2340,30127,1858,908,950
21705,33624,3493,16259,2340,30131,1858,908,950
21710,33634,3495,16263,2340,30139,1858,908,950
21715,33640,3495,16266,2340,30145,1860,909,951
21720,33651,3498,16271,2342,30153,1861,910,951
21725,33655,3500,16274,2344,30155,1861,910,951
21730,33665,3502,16279,2344,30163,1861,910,951
21735,33671,3502,16281,2344,30169,1862,911,951
21740,33682,3504,16287,2346,30178,1862,911,951
21745,33686,3505,16290,2347,30181,1862,911,951
21750,33696,3507,16296,2349,30189,1862,911,951
21755,33702,3507,16299,2349,30195,1863,912,951
21760,33713,3508,16304,2349,30205,1863,912,951
21765,33717,3509,16306,2350,30208,1863,912,951
21770,33727,3511,16308,2351,30216,1863,912,951
21775,33733,3511,16312,2351,30222,1864,913,951
21780,33744,3512,16319,2352,30232,1864,913,951
21785,33748,3513,16321,2353,30235,1864,913,951
21790,33758,3515,16325,2354,30243,1864,913,951
21795,33764,3515,16327,2354,30249,1865,914,951
21800,33775,3516,16335,2355,30259,1865,914,951
21805,33779,3516,16336,2355,30263,1865,914,951
21810,33789,3518,16339,2355,30271,1865,914,951
21815,33795,3518,16341,2355,30276,1866,914,952
21820,33806,3521,16348,2357,30285,1866,914,952
21825,33810,3522,16350,2358,30288,1866,914,952
21830,33820,3524,16357,2359,30296,1866,914,952
21835,33826,3524,16358,2359,30302,1868,915,953
21840,33837,3526,16364,2360,30311,1869,916,953
21845,33841,3526,16367,2360,30315,1869,916,953
21850,33851,3527,16373,2361,30324,1869,916,953
21855,33857,3527,16376,2361,30330,1870,917,953
21860,33868,3529,16383,2363,30339,1871,917,954
21865,33872,3529,16385,2363,30343,1871,917,954
21870,33882,3530,16388,2363,30352,1871,917,954
21875,33888,3530,16391,2363,30358,1872,918,954
21880,33899,3531,16396,2364,30368,1873,919,954
21885,33903,3531,16397,2364,30372,1873,919,954
21890,33913,3532,16402,2365,30381,1873,919,954
21895,33919,3532,16406,2365,30387,1874,919,955
21900,33930,3534,16411,2367,30396,1875,920,955
21905,33934,3534,16413,2367,30400,1875,920,955
21910,33944,3535,16419,2368,30409,1875,920,955
21915,33950,3535,16421,2368,30415,1876,920,956
21920,33961,3536,16429,2369,30425,1877,921,956
21925,33965,3536,16431,2369,30429,1877,921,956
21930,33975,3537,16434,2369,30438,1877,921,956
21935,33981,3537,16436,2369,30444,1878,921,957
21940,33992,3537,16442,2369,30455,1879,921,958
21945,33996,3537,16444,2369,30459,1879,921,958
21950,34006,3539,16449,2370,30467,1879,921,958
21955,34012,3539,16453,2370,30472,1881,922,959
21960,34023,3542,16457,2373,30481,1881,922,959
21965,34027,3542,16458,2373,30485,1881,922,959
21970,34037,3544,16461,2373,30493,1881,922,959
21975,34043,3544,16464,2373,30499,1883,923,960
21980,34054,3545,16468,2373,30509,1883,923,960
21985,34058,3545,16470,2373,30513,1883,923,960
21990,34068,3547,16476,2374,30521,1883,923,960
21995,34074,3547,16479,2374,30527,1884,924,960
22000,34085,3548,16482,2374,30537,1884,924,960
22005,34089,3548,16484,2374,30541,1884,924,960
22010,34099,3550,16489,2375,30549,1884,924,960
22015,34105,3550,16494,2375,30555,1885,925,960
22020,34116,3553,16499,2377,30563,1885,925,960
22025,34120,3553,16501,2377,30567,1885,925,960
22030,34130,3555,16505,2378,30575,1885,925,960
22035,34136,3555,16510,2378,30580,1886,926,960
22040,34147,3559,16518,2382,30588,1886,926,960
22045,34151,3559,16521,2382,30592,1886,926,960
22050,34161,3561,16526,2383,30600,1886,926,960
22055,34167,3561,16529,2383,30605,1887,927,960
22060,34178,3564,16535,2385,30614,1888,927,961
22065,34182,3566,16538,2387,30616,1888,927,961
22070,34192,3568,16543,2388,30624,1888,927,961
22075,34198,3568,16546,2388,30629,1889,928,961
22080,34209,3572,16551,2392,30637,1890,928,962
22085,34213,3572,16552,2392,30641,1890,928,962
22090,34223,3572,16560,2392,30651,1890,928,962
22095,34229,3572,16563,2392,30657,1891,928,963
22100,34240,3573,16570,2393,30667,1892,929,963
22105,34244,3574,16572,2394,30670,1892,929,963
22110,34254,3574,16577,2394,30680,1892,929,963
22115,34260,3574,16580,2394,30686,1893,930,963
22120,34271,3577,16588,2397,30694,1894,931,963
22125,34275,3577,16589,2397,30698,1894,931,963
22130,34285,3577,16594,2397,30708,1894,931,963
22135,34291,3577,16595,2397,30714,1895,931,964
22140,34302,3579,16601,2399,30723,1896,931,965
22145,34306,3579,16605,2399,30727,1896,931,965
22150,34316,3579,16606,2399,30737,1896,931,965
22155,34322,3579,16608,2399,30743,1897,931,966
22160,34333,3580,16613,2399,30753,1897,931,966
22165,34337,3580,16614,2399,30757,1897,931,966
22170,34347,3580,16623,2399,30767,1897,931,966
22175,34353,3580,16625,2399,30773,1898,931,967
22180,34364,3581,16629,2400,30783,1898,931,967
22185,34368,3581,16631,2400,30787,1898,931,967
22190,34378,3583,16635,2400,30795,1898,931,967
22195,34384,3583,16639,2400,30801,1900,932,968
22200,34395,3585,16645,2402,30810,1901,932,969
22205,34399,3585,16648,2402,30814,1901,932,969
22210,34409,3587,16650,2403,30822,1901,932,969
22215,34415,3587,16654,2403,30828,1902,932,970
22220,34426,3590,16660,2406,30836,1903,933,970
22225,34430,3590,16663,2406,30840,1903,933,970
22230,34440,3592,16670,2407,30848,1903,933,970
22235,34446,3592,16671,2407,30854,1904,933,971
22240,34457,3593,16677,2407,30864,1905,934,971
22245,34461,3593,16680,2407,30868,1905,934,971
22250,34471,3595,16684,2408,30876,1905,934,971
22255,34477,3595,16688,2408,30881,1906,934,972
22260,34488,3598,16695,2411,30890,1907,935,972
22265,34492,3599,16697,2412,30893,1907,935,972
22270,34502,3601,16701,2413,30901,1907,935,972
22275,34508,3601,16704,2413,30907,1908,935,973
22280,34519,3602,16710,2414,30917,1908,935,973
22285,34523,3602,16712,2414,30921,1908,935,973
22290,34533,3604,16716,2415,30929,1908,935,973
22295,34539,3604,16720,2415,30935,1909,936,973
22300,34550,3605,16726,2416,30945,1909,936,973
22305,34554,3606,16727,2417,30948,1909,936,973
22310,34564,3608,16731,2417,30956,1909,936,973
22315,34570,3608,16733,2417,30962,1911,937,974
22320,34581,3610,16738,2418,30971,1911,937,974
22325,34585,3610,16740,2418,30975,1911,937,974
22330,34595,3611,16745,2419,30984,1911,937,974
22335,34601,3611,16746,2419,30990,1912,937,975
22340,34612,3612,16750,2420,31000,1912,937,975
22345,34616,3612,16752,2420,31004,1912,937,975
22350,34626,3613,16758,2421,31013,1912,937,975
22355,34632,3613,16760,2421,31019,1913,937,976
22360,34643,3614,16765,2422,31029,1913,937,976
22365,34647,3614,16768,2422,31033,1913,937,976
22370,34657,3615,16775,2423,31042,1913,937,976
22375,34663,3615,16778,2423,31048,1914,937,977
22380,34674,3615,16784,2423,31059,1914,937,977
22385,34678,3615,16785,2423,31063,1914,937,977
22390,34688,3616,16789,2423,31072,1914,937,977
22395,34694,3616,16792,2423,31077,1915,938,977
22400,34705,3618,16797,2424,31087,1915,938,977
22405,34709,3618,16799,2424,31091,1915,938,977
22410,34719,3619,16803,2424,31100,1915,938,977
22415,34725,3619,16805,2424,31105,1916,938,978
22420,34736,3622,16811,2426,31114,1916,938,978
22425,34740,3622,16812,2426,31118,1916,938,978
22430,34750,3624,16816,2427,31126,1916,938,978
22435,34756,3624,16819,2427,31132,1918,939,979
22440,34767,3625,16823,2427,31142,1919,940,979
22445,34771,3625,16824,2427,31146,1919,940,979
22450,34781,3627,16830,2428,31154,1919,940,979
22455,34787,3627,16831,2428,31160,1921,940,981
22460,34798,3627,16836,2428,31171,1922,940,982
22465,34802,3627,16839,2428,31175,1922,940,982
22470,34812,3629,16843,2429,31183,1922,940,982
22475,34818,3629,16848,2429,31189,1923,941,982
22480,34829,3630,16853,2430,31199,1924,941,983
22485,34833,3630,16857,2430,31203,1924,941,983
22490,34843,3632,16863,2431,31211,1924,941,983
22495,34849,3632,16866,2431,31217,1925,942,983
22500,34860,3633,16872,2432,31227,1926,942,984
22505,34864,3633,16875,2432,31231,1926,942,984
22510,34874,3635,16878,2433,31239,1926,942,984
22515,34880,3635,16879,2433,31245,1927,942,985
22520,34891,3635,16882,2433,31256,1928,943,985
22525,34895,3635,16883,2433,31260,1928,943,985
22530,34905,3637,16888,2434,31268,1928,943,985
22535,34911,3637,16892,2434,31274,1929,944,985
22540,34922,3637,16896,2434,31285,1930,944,986
22545,34926,3638,16897,2435,31288,1930,944,986
22550,34936,3640,16904,2436,31296,1930,944,986
22555,34942,3640,16907,2436,31302,1931,944,987
22560,34953,3641,16911,2437,31312,1932,945,987
22565,34957,3641,16914,2437,31316,1932,945,987
22570,34967,3641,16918,2437,31326,1932,945,987
22575,34973,3641,16920,2437,31332,1933,945,988
22580,34984,3642,16923,2437,31342,1933,945,988
22585,34988,3642,16925,2437,31346,1933,945,988
22590,34998,3642,16931,2437,31356,1933,945,988
22595,35004,3642,16934,2437,31362,1934,945,989
22600,35015,3643,16939,2437,31372,1934,945,989
22605,35019,3643,16940,2437,31376,1934,945,989
22610,35029,3643,16946,2437,31386,1934,945,989
22615,35035,3643,16949,2437,31392,1936,945,991
22620,35046,3644,16953,2438,31402,1936,945,991
22625,35050,3644,16954,2438,31406,1936,945,991
22630,35060,3644,16958,2438,31416,1936,945,991
22635,35066,3644,16961,2438,31422,1937,946,991
22640,35077,3645,16972,2439,31432,1937,946,991
22645,35081,3645,16975,2439,31436,1937,946,991
22650,35091,3645,16978,2439,31446,1937,946,991
22655,35097,3645,16982,2439,31452,1938,946,992
22660,35108,3646,16987,2440,31462,1938,946,992
22665,35112,3646,16988,2440,31466,1938,946,992
22670,35122,3648,16991,2441,31474,1938,946,992
22675,35128,3648,16994,2441,31479,1939,946,993
22680,35139,3651,16998,2443,31488,1940,947,993
22685,35143,3653,17002,2445,31490,1940,947,993
22690,35153,3654,17006,2446,31499,1940,947,993
22695,35159,3654,17010,2446,31505,1941,947,994
22700,35170,3656,17017,2448,31514,1942,947,995
22705,35174,3657,17020,2449,31517,1942,947,995
22710,35184,3658,17024,2449,31526,1942,947,995
22715,35190,3658,17027,2449,31532,1943,948,995
22720,35201,3660,17035,2450,31541,1943,948,995
22725,35205,3661,17037,2451,31544,1943,948,995
22730,35215,3662,17040,2451,31553,1943,948,995
22735,35221,3662,17041,2451,31559,1945,949,996
22740,35232,3664,17047,2453,31568,1945,949,996
22745,35236,3664,17049,2453,31572,1945,949,996
22750,35246,3665,17054,2453,31581,1945,949,996
22755,35252,3665,17059,2453,31587,1946,950,996
22760,35263,3666,17062,2454,31597,1946,950,996
22765,35267,3666,17065,2454,31601,1946,950,996
22770,35277,3667,17069,2455,31610,1946,950,996
22775,35283,3667,17070,2455,31616,1947,950,997
22780,35294,3669,17076,2456,31625,1947,950,997
22785,35298,3669,17077,2456,31629,1947,950,997
22790,35308,3670,17081,2456,31638,1947,950,997
22795,35314,3670,17085,2456,31643,1948,951,997
22800,35325,3674,17091,2459,31651,1948,951,997
22805,35329,3674,17091,2459,31655,1948,951,997
22810,35339,3675,17096,2460,31664,1948,951,997
22815,35345,3675,17098,2460,31670,1949,952,997
22820,35356,3675,17099,2460,31681,1950,952,998
22825,35360,3676,17100,2461,31684,1950,952,998
22830,35370,3677,17109,2462,31693,1950,952,998
22835,35376,3677,17112,2462,31698,1951,953,998
22840,35387,3679,17117,2464,31708,1952,954,998
22845,35391,3679,17119,2464,31712,1952,954,998
22850,35401,3680,17125,2465,31721,1952,954,998
22855,35407,3680,17129,2465,31727,1953,955,998
22860,35418,3680,17134,2465,31738,1954,956,998
22865,35422,3680,17137,2465,31742,1954,956,998
22870,35432,3680,17141,2465,31752,1954,956,998
22875,35438,3680,17144,2465,31758,1955,956,999
22880,35449,3680,17148,2465,31769,1955,956,999
22885,35453,3680,17148,2465,31773,1955,956,999
22890,35463,3680,17153,2465,31783,1955,956,999
22895,35469,3680,17156,2465,31789,1956,957,999
22900,35480,3680,17164,2465,31800,1956,957,999
22905,35484,3680,17166,2465,31804,1956,957,999
22910,35494,3680,17169,2465,31814,1956,957,999
22915,35500,3680,17174,2465,31820,1957,957,1000
22920,35511,3682,17182,2467,31829,1958,957,1001
22925,35515,3683,17184,2468,31832,1958,957,1001
22930,35525,3685,17187,2468,31840,1958,957,1001
22935,35531,3685,17190,2468,31845,1959,957,1002
22940,35542,3688,17195,2471,31854,1959,957,1002
22945,35546,3688,17197,2471,31858,1959,957,1002
22950,35556,3690,17202,2472,31866,1959,957,1002
22955,35562,3690,17205,2472,31872,1960,957,1003
22960,35573,3692,17211,2474,31881,1960,957,1003
22965,35577,3692,17211,2474,31885,1960,957,1003
22970,35587,3694,17217,2475,31893,1960,957,1003
22975,35593,3694,17221,2475,31899,1961,957,1004
22980,35604,3696,17227,2476,31908,1961,957,1004
22985,35608,3697,17229,2477,31911,1961,957,1004
22990,35618,3699,17235,2479,31919,1961,957,1004
22995,35624,3699,17238,2479,31925,1962,957,1005
23000,35635,3700,17240,2479,31935,1962,957,1005
23005,35639,3701,17243,2480,31938,1962,957,1005
23010,35649,3703,17247,2480,31946,1962,957,1005
23015,35655,3703,17249,2480,31952,1963,957,1006
23020,35666,3704,17256,2480,31962,1963,957,1006
23025,35670,3704,17257,2480,31966,1963,957,1006
23030,35680,3706,17262,2481,31974,1963,957,1006
23035,35686,3706,17263,2481,31980,1964,957,1007
23040,35697,3708,17270,2483,31989,1965,958,1007
23045,35701,3708,17270,2483,31993,1965,958,1007
23050,35711,3710,17274,2483,32001,1965,958,1007
23055,35717,3710,17277,2483,32007,1966,958,1008
23060,35728,3710,17282,2483,32018,1967,958,1009
23065,35732,3710,17284,2483,32022,1967,958,1009
23070,35742,3712,17290,2484,32030,1967,958,1009
23075,35748,3712,17295,2484,32035,1968,959,1009
23080,35759,3713,17301,2485,32046,1969,960,1009
23085,35763,3713,17302,2485,32050,1969,960,1009
23090,35773,3715,17305,2486,32058,1969,960,1009
23095,35779,3715,17310,2486,32063,1970,960,1010
23100,35790,3718,17317,2489,32072,1971,961,1010
23105,35794,3718,17320,2489,32076,1971,961,1010
23110,35804,3720,17326,2490,32084,1971,961,1010
23115,35810,3720,17326,2490,32090,1973,961,1012
23120,35821,3720,17330,2490,32101,1973,961,1012
23125,35825,3720,17331,2490,32105,1973,961,1012
23130,35835,3721,17338,2491,32114,1973,961,1012
23135,35841,3721,17341,2491,32120,1974,962,1012
23140,35852,3721,17346,2491,32131,1974,962,1012
23145,35856,3721,17347,2491,32135,1974,962,1012
23150,35866,3722,17353,2492,32144,1974,962,1012
23155,35872,3722,17358,2492,32150,1975,963,1012
23160,35883,3724,17363,2493,32159,1976,964,1012
23165,35887,3724,17366,2493,32163,1976,964,1012
23170,35897,3725,17372,2494,32172,1976,964,1012
23175,35903,3725,17376,2494,32177,1977,964,1013
23180,35914,3727,17380,2495,32187,1978,964,1014
23185,35918,3727,17381,2495,32191,1978,964,1014
23190,35928,3728,17384,2496,32200,1978,964,1014
23195,35934,3728,17388,2496,32206,1979,964,1015
23200,35945,3730,17395,2497,32215,1980,965,1015
23205,35949,3730,17396,2497,32219,1980,965,1015
23210,35959,3731,17403,2498,32228,1980,965,1015
23215,35965,3731,17407,2498,32234,1981,966,1015
23220,35976,3733,17413,2500,32243,1982,966,1016
23225,35980,3734,17416,2501,32246,1982,966,1016
23230,35990,3734,17421,2501,32256,1982,966,1016
23235,35996,3734,17424,2501,32262,1984,967,1017
23240,36007,3737,17430,2504,32270,1984,967,1017
23245,36011,3737,17433,2504,32274,1984,967,1017
23250,36021,3737,17436,2504,32284,1984,967,1017
23255,36027,3737,17439,2504,32290,1985,967,1018
23260,36038,3738,17444,2505,32300,1985,967,1018
23265,36042,3738,17446,2505,32304,1985,967,1018
23270,36052,3739,17451,2506,32313,1985,967,1018
23275,36058,3739,17455,2506,32319,1986,968,1018
23280,36069,3741,17460,2508,32328,1986,968,1018
23285,36073,3741,17464,2508,32332,1986,968,1018
23290,36083,3742,17469,2508,32341,1986,968,1018
23295,36089,3742,17473,2508,32347,1987,969,1018
23300,36100,3742,17479,2508,32358,1987,969,1018
23305,36104,3742,17480,2508,32362,1987,969,1018
23310,36114,3743,17488,2509,32371,1987,969,1018
23315,36120,3743,17491,2509,32377,1988,969,1019
23320,36131,3743,17496,2509,32388,1988,969,1019
23325,36135,3743,17499,2509,32392,1988,969,1019
23330,36145,3745,17505,2509,32400,1988,969,1019
23335,36151,3745,17508,2509,32406,1989,970,1019
23340,36162,3745,17514,2509,32417,1990,970,1020
23345,36166,3745,17515,2509,32421,1990,970,1020
23350,36176,3747,17517,2509,32429,1990,970,1020
23355,36182,3747,17517,2509,32435,1992,970,1022
23360,36193,3748,17523,2510,32445,1993,970,1023
23365,36197,3748,17526,2510,32449,1993,970,1023
23370,36207,3750,17530,2510,32457,1993,970,1023
23375,36213,3750,17534,2510,32463,1994,971,1023
23380,36224,3752,17541,2512,32472,1995,972,1023
23385,36228,3752,17543,2512,32476,1995,972,1023
23390,36238,3754,17548,2512,32484,1995,972,1023
23395,36244,3754,17552,2512,32490,1996,973,1023
23400,36255,3757,17557,2514,32498,1997,974,1023
23405,36259,3758,17558,2515,32501,1997,974,1023
23410,36269,3760,17566,2517,32509,1997,974,1023
23415,36275,3760,17569,2517,32515,1998,974,1024
23420,36286,3763,17577,2520,32523,1999,975,1024
23425,36290,3764,17580,2521,32526,1999,975,1024
23430,36300,3766,17583,2521,32534,1999,975,1024
23435,36306,3766,17588,2521,32540,2000,975,1025
23440,36317,3767,17590,2522,32550,2001,975,1026
23445,36321,3768,17592,2523,32553,2001,975,1026
23450,36331,3770,17597,2523,32561,2001,975,1026
23455,36337,3770,17600,2523,32567,2002,975,1027
23460,36348,3771,17602,2523,32577,2003,975,1028
23465,36352,3773,17605,2525,32579,2003,975,1028
23470,36362,3775,17609,2525,32587,2003,975,1028
23475,36368,3775,17612,2525,32593,2004,975,1029
23480,36379,3776,17618,2526,32603,2005,976,1029
23485,36383,3778,17621,2528,32605,2005,976,1029
23490,36393,3780,17628,2529,32613,2005,976,1029
23495,36399,3780,17629,2529,32619,2007,976,1031
23500,36410,3781,17634,2529,32629,2008,976,1032
23505,36414,3782,17636,2530,32632,2008,976,1032
23510,36424,3784,17642,2531,32640,2008,976,1032
23515,36430,3784,17646,2531,32645,2010,977,1033
23520,36441,3786,17650,2532,32655,2011,978,1033
23525,36445,3786,17651,2532,32659,2011,978,1033
23530,36455,3787,17653,2533,32668,2011,978,1033
23535,36461,3787,17654,2533,32674,2012,978,1034
23540,36472,3787,17660,2533,32685,2012,978,1034
23545,36476,3787,17662,2533,32689,2012,978,1034
23550,36486,3788,17666,2534,32698,2012,978,1034
23555,36492,3788,17669,2534,32704,2013,978,1035
23560,36503,3788,17674,2534,32715,2013,978,1035
23565,36507,3788,17677,2534,32719,2013,978,1035
23570,36517,3789,17682,2535,32728,2013,978,1035
23575,36523,3789,17686,2535,32733,2014,979,1035
23580,36534,3790,17691,2536,32744,2014,979,1035
23585,36538,3790,17693,2536,32748,2014,979,1035
23590,36548,3791,17696,2536,32757,2014,979,1035
23595,36554,3791,17699,2536,32762,2015,980,1035
23600,36565,3792,17704,2537,32773,2015,980,1035
23605,36569,3792,17704,2537,32777,2015,980,1035
23610,36579,3793,17709,2538,32786,2015,980,1035
23615,36585,3793,17711,2538,32792,2016,980,1036
23620,36596,3793,17717,2538,32803,2016,980,1036
23625,36600,3793,17720,2538,32807,2016,980,1036
23630,36610,3795,17724,2540,32815,2016,980,1036
23635,36616,3795,17727,2540,32820,2017,981,1036
23640,36627,3797,17730,2541,32830,2018,981,1037
23645,36631,3798,17731,2542,32833,2018,981,1037
23650,36641,3800,17733,2543,32841,2018,981,1037
23655,36647,3800,17737,2543,32847,2019,982,1037
23660,36658,3802,17743,2545,32856,2019,982,1037
23665,36662,3802,17745,2545,32860,2019,982,1037
23670,36672,3804,17748,2546,32868,2019,982,1037
23675,36678,3804,17751,2546,32874,2020,983,1037
23680,36689,3806,17758,2547,32883,2020,983,1037
23685,36693,3806,17759,2547,32887,2020,983,1037
23690,36703,3808,17765,2548,32895,2020,983,1037
23695,36709,3808,17768,2548,32901,2021,984,1037
23700,36720,3810,17771,2549,32910,2021,984,1037
23705,36724,3810,17772,2549,32914,2021,984,1037
23710,36734,3812,17777,2550,32922,2021,984,1037
23715,36740,3812,17779,2550,32928,2022,985,1037
23720,36751,3815,17786,2553,32936,2022,985,1037
23725,36755,3815,17788,2553,32940,2022,985,1037
23730,36765,3817,17792,2553,32948,2022,985,1037
23735,36771,3817,17795,2553,32954,2023,986,1037
23740,36782,3819,17799,2554,32963,2023,986,1037
23745,36786,3821,17803,2556,32965,2023,986,1037
23750,36796,3823,17810,2558,32973,2023,986,1037
23755,36802,3823,17814,2558,32978,2024,986,1038
23760,36813,3826,17817,2560,32987,2025,987,1038
23765,36817,3826,17820,2560,32991,2025,987,1038
23770,36827,3827,17824,2561,33000,2025,987,1038
23775,36833,3827,17826,2561,33005,2026,987,1039
23780,36844,3828,17829,2562,33016,2027,987,1040
23785,36848,3828,17831,2562,33020,2027,987,1040
23790,36858,3829,17837,2563,33029,2027,987,1040
23795,36864,3829,17839,2563,33035,2028,988,1040
23800,36875,3829,17844,2563,33046,2029,989,1040
23805,36879,3830,17845,2564,33049,2029,989,1040
23810,36889,3831,17849,2565,33058,2029,989,1040
23815,36895,3831,17853,2565,33063,2030,989,1041
23820,36906,3832,17859,2566,33074,2031,989,1042
23825,36910,3832,17860,2566,33078,2031,989,1042
23830,36920,3833,17866,2567,33087,2031,989,1042
23835,36926,3833,17869,2567,33093,2032,989,1043
23840,36937,3833,17871,2567,33104,2032,989,1043
23845,36941,3833,17871,2567,33108,2032,989,1043
23850,36951,3834,17876,2568,33117,2032,989,1043
23855,36957,3834,17879,2568,33123,2033,990,1043
23860,36968,3834,17885,2568,33134,2033,990,1043
23865,36972,3834,17887,2568,33138,2033,990,1043
23870,36982,3836,17890,2570,33146,2033,990,1043
23875,36988,3836,17892,2570,33152,2034,990,1044
23880,36999,3837,17897,2571,33162,2034,990,1044
23885,37003,3838,17898,2572,33165,2034,990,1044
23890,37013,3840,17905,2573,33173,2034,990,1044
23895,37019,3840,17907,2573,33179,2036,990,1046
23900,37030,3841,17914,2574,33189,2037,991,1046
23905,37034,3843,17918,2576,33191,2037,991,1046
23910,37044,3845,17920,2577,33199,2037,991,1046
23915,37050,3845,17923,2577,33205,2038,991,1047
23920,37061,3847,17930,2578,33214,2039,992,1047
23925,37065,3849,17933,2580,33216,2039,992,1047
23930,37075,3851,17940,2582,33224,2039,992,1047
23935,37081,3851,17942,2582,33230,2040,993,1047
23940,37092,3853,17947,2583,33239,2041,994,1047
23945,37096,3853,17949,2583,33243,2041,994,1047
23950,37106,3854,17954,2584,33252,2041,994,1047
23955,37112,3854,17955,2584,33258,2042,994,1048
23960,37123,3854,17962,2584,33269,2042,994,1048
23965,37127,3854,17962,2584,33273,2042,994,1048
23970,37137,3855,17966,2585,33282,2042,994,1048
23975,37143,3855,17969,2585,33288,2043,995,1048
23980,37154,3855,17976,2585,33299,2043,995,1048
23985,37158,3855,17977,2585,33303,2043,995,1048
23990,37168,3856,17980,2585,33312,2043,995,1048
23995,37174,3856,17982,2585,33318,2044,996,1048
24000,37185,3856,17986,2585,33329,2044,996,1048
24005,37189,3857,17988,2586,33332,2044,996,1048
24010,37199,3859,17991,2588,33340,2044,996,1048
24015,37205,3859,17993,2588,33346,2045,997,1048
24020,37216,3860,17996,2588,33356,2045,997,1048
24025,37220,3860,17996,2588,33360,2045,997,1048
24030,37230,3862,18001,2590,33368,2045,997,1048
24035,37236,3862,18005,2590,33374,2046,998,1048
24040,37247,3863,18011,2591,33384,2046,998,1048
24045,37251,3863,18012,2591,33388,2046,998,1048
24050,37261,3865,18016,2591,33396,2046,998,1048
24055,37267,3865,18020,2591,33401,2047,998,1049
24060,37278,3869,18025,2594,33409,2048,999,1049
24065,37282,3869,18028,2594,33413,2048,999,1049
24070,37292,3870,18033,2595,33422,2048,999,1049
24075,37298,3870,18037,2595,33428,2049,1000,1049
24080,37309,3872,18045,2597,33437,2050,1001,1049
24085,37313,3872,18047,2597,33441,2050,1001,1049
24090,37323,3873,18053,2598,33450,2050,1001,1049
24095,37329,3873,18055,2598,33456,2051,1002,1049
24100,37340,3875,18061,2599,33465,2052,1003,1049
24105,37344,3875,18065,2599,33469,2052,1003,1049
24110,37354,3876,18071,2600,33478,2052,1003,1049
24115,37360,3876,18074,2600,33484,2054,1004,1050
24120,37371,3879,18081,2603,33492,2055,1005,1050
24125,37375,3879,18084,2603,33496,2055,1005,1050
24130,37385,3879,18091,2603,33506,2055,1005,1050
24135,37391,3879,18091,2603,33512,2056,1005,1051
24140,37402,3879,18099,2603,33523,2056,1005,1051
24145,37406,3879,18101,2603,33527,2056,1005,1051
24150,37416,3879,18106,2603,33537,2056,1005,1051
24155,37422,3879,18107,2603,33543,2057,1005,1052
24160,37433,3879,18114,2603,33554,2057,1005,1052
24165,37437,3879,18116,2603,33558,2057,1005,1052
24170,37447,3880,18120,2604,33567,2057,1005,1052
24175,37453,3880,18124,2604,33572,2058,1006,1052
24180,37464,3881,18129,2605,33583,2058,1006,1052
24185,37468,3881,18129,2605,33587,2058,1006,1052
24190,37478,3883,18133,2605,33595,2058,1006,1052
24195,37484,3883,18135,2605,33601,2059,1006,1053
24200,37495,3884,18137,2605,33611,2060,1006,1054
24205,37499,3884,18138,2605,33615,2060,1006,1054
24210,37509,3886,18140,2607,33623,2060,1006,1054
24215,37515,3886,18142,2607,33629,2061,1006,1055
24220,37526,3889,18147,2609,33637,2062,1007,1055
24225,37530,3889,18148,2609,33641,2062,1007,1055
24230,37540,3891,18154,2609,33649,2062,1007,1055
24235,37546,3891,18158,2609,33655,2063,1008,1055
24240,37557,3893,18165,2611,33664,2064,1009,1055
24245,37561,3895,18169,2613,33666,2064,1009,1055
24250,37571,3897,18172,2614,33674,2064,1009,1055
24255,37577,3897,18175,2614,33680,2065,1009,1056
24260,37588,3898,18182,2615,33690,2066,1009,1057
24265,37592,3898,18186,2615,33694,2066,1009,1057
24270,37602,3900,18190,2615,33702,2066,1009,1057
24275,37608,3900,18193,2615,33708,2067,1009,1058
24280,37619,3900,18197,2615,33719,2068,1009,1059
24285,37623,3900,18199,2615,33723,2068,1009,1059
24290,37633,3902,18203,2615,33731,2068,1009,1059
24295,37639,3902,18206,2615,33737,2069,1010,1059
24300,37650,3902,18209,2615,33748,2070,1010,1060
24305,37654,3903,18212,2616,33751,2070,1010,1060
24310,37664,3905,18219,2618,33759,2070,1010,1060
24315,37670,3905,18220,2618,33765,2071,1011,1060
24320,37681,3905,18227,2618,33776,2072,1012,1060
24325,37685,3905,18228,2618,33780,2072,1012,1060
24330,37695,3907,18233,2619,33788,2072,1012,1060
24335,37701,3907,18236,2619,33794,2073,1012,1061
24340,37712,3907,18239,2619,33805,2074,1013,1061
24345,37716,3907,18240,2619,33809,2074,1013,1061
24350,37726,3909,18247,2620,33817,2074,1013,1061
24355,37732,3909,18250,2620,33822,2076,1014,1062
24360,37743,3914,18257,2624,33829,2077,1015,1062
24365,37747,3915,18258,2625,33832,2077,1015,1062
24370,37757,3916,18264,2625,33841,2077,1015,1062
24375,37763,3916,18265,2625,33847,2078,1015,1063
24380,37774,3918,18272,2627,33856,2078,1015,1063
24385,37778,3919,18276,2628,33859,2078,1015,1063
24390,37788,3920,18280,2628,33868,2078,1015,1063
24395,37794,3920,18284,2628,33874,2079,1015,1064
24400,37805,3921,18288,2628,33884,2079,1015,1064
24405,37809,3922,18290,2629,33887,2079,1015,1064
24410,37819,3923,18293,2629,33896,2079,1015,1064
24415,37825,3923,18296,2629,33901,2080,1015,1065
24420,37836,3925,18304,2631,33911,2080,1015,1065
24425,37840,3926,18305,2632,33914,2080,1015,1065
24430,37850,3927,18310,2633,33923,2080,1015,1065
24435,37856,3927,18313,2633,33928,2081,1015,1066
24440,37867,3928,18316,2634,33939,2081,1015,1066
24445,37871,3928,18318,2634,33943,2081,1015,1066
24450,37881,3929,18324,2635,33952,2081,1015,1066
24455,37887,3929,18327,2635,33958,2082,1016,1066
24460,37898,3929,18331,2635,33969,2082,1016,1066
24465,37902,3930,18333,2636,33972,2082,1016,1066
24470,37912,3932,18338,2636,33980,2082,1016,1066
24475,37918,3932,18342,2636,33986,2084,1018,1066
24480,37929,3933,18348,2637,33996,2085,1019,1066
24485,37933,3933,18349,2637,34000,2085,1019,1066
24490,37943,3935,18354,2638,34008,2085,1019,1066
24495,37949,3935,18356,2638,34014,2086,1019,1067
24500,37960,3938,18361,2640,34022,2087,1019,1068
24505,37964,3939,18363,2641,34025,2087,1019,1068
24510,37974,3941,18368,2642,34033,2087,1019,1068
24515,37980,3941,18371,2642,34039,2088,1019,1069
24520,37991,3942,18378,2642,34049,2089,1020,1069
24525,37995,3942,18378,2642,34053,2089,1020,1069
24530,38005,3944,18384,2643,34061,2089,1020,1069
24535,38011,3944,18386,2643,34067,2090,1020,1070
24540,38022,3947,18392,2646,34075,2091,1020,1071
24545,38026,3948,18396,2647,34078,2091,1020,1071
24550,38036,3949,18403,2648,34087,2091,1020,1071
24555,38042,3949,18407,2648,34093,2092,1021,1071
24560,38053,3949,18411,2648,34104,2093,1021,1072
24565,38057,3950,18415,2649,34107,2093,1021,1072
24570,38067,3951,18419,2649,34116,2093,1021,1072
24575,38073,3951,18420,2649,34122,2094,1021,1073
24580,38084,3952,18429,2650,34132,2095,1022,1073
24585,38088,3953,18432,2651,34135,2095,1022,1073
24590,38098,3954,18436,2651,34144,2095,1022,1073
24595,38104,3954,18438,2651,34150,2097,1022,1075
24600,38115,3955,18446,2652,34160,2098,1023,1075
24605,38119,3955,18447,2652,34164,2098,1023,1075
24610,38129,3956,18453,2653,34173,2098,1023,1075
24615,38135,3956,18455,2653,34179,2099,1023,1076
24620,38146,3958,18460,2655,34188,2099,1023,1076
24625,38150,3958,18462,2655,34192,2099,1023,1076
24630,38160,3959,18466,2656,34201,2099,1023,1076
24635,38166,3959,18472,2656,34206,2100,1024,1076
24640,38177,3961,18477,2658,34216,2100,1024,1076
24645,38181,3961,18477,2658,34220,2100,1024,1076
24650,38191,3962,18482,2659,34229,2100,1024,1076
24655,38197,3962,18484,2659,34235,2101,1024,1077
24660,38208,3963,18489,2659,34245,2101,1024,1077
24665,38212,3963,18490,2659,34249,2101,1024,1077
24670,38222,3964,18494,2660,34258,2101,1024,1077
24675,38228,3964,18497,2660,34264,2102,1025,1077
24680,38239,3965,18503,2661,34274,2102,1025,1077
24685,38243,3965,18506,2661,34278,2102,1025,1077
24690,38253,3966,18510,2662,34287,2102,1025,1077
24695,38259,3966,18514,2662,34293,2103,1026,1077
24700,38270,3967,18518,2663,34303,2103,1026,1077
24705,38274,3967,18520,2663,34307,2103,1026,1077
24710,38284,3969,18526,2664,34315,2103,1026,1077
24715,38290,3969,18528,2664,34321,2105,1027,1078
24720,38301,3970,18533,2664,34331,2105,1027,1078
24725,38305,3970,18533,2664,34335,2105,1027,1078
24730,38315,3971,18539,2664,34344,2105,1027,1078
24735,38321,3971,18542,2664,34350,2106,1027,1079
24740,38332,3973,18547,2666,34359,2107,1027,1080
24745,38336,3974,18548,2667,34362,2107,1027,1080
24750,38346,3975,18554,2667,34371,2107,1027,1080
24755,38352,3975,18557,2667,34377,2108,1028,1080
24760,38363,3978,18561,2669,34385,2109,1029,1080
24765,38367,3979,18563,2670,34388,2109,1029,1080
24770,38377,3980,18568,2670,34397,2109,1029,1080
24775,38383,3980,18572,2670,34403,2110,1030,1080
24780,38394,3982,18577,2671,34412,2111,1031,1080
24785,38398,3982,18578,2671,34416,2111,1031,1080
24790,38408,3984,18583,2673,34424,2111,1031,1080
24795,38414,3984,18585,2673,34430,2112,1032,1080
24800,38425,3984,18591,2673,34441,2113,1032,1081
24805,38429,3984,18592,2673,34445,2113,1032,1081
24810,38439,3986,18597,2674,34453,2113,1032,1081
24815,38445,3986,18601,2674,34459,2114,1032,1082
24820,38456,3987,18608,2675,34469,2115,1033,1082
24825,38460,3987,18608,2675,34473,2115,1033,1082
24830,38470,3989,18611,2675,34481,2115,1033,1082
24835,38476,3989,18612,2675,34487,2117,1034,1083
24840,38487,3990,18614,2676,34497,2118,1034,1084
24845,38491,3990,18614,2676,34501,2118,1034,1084
24850,38501,3991,18621,2677,34510,2118,1034,1084
24855,38507,3991,18623,2677,34516,2119,1034,1085
24860,38518,3992,18629,2678,34526,2119,1034,1085
24865,38522,3992,18631,2678,34530,2119,1034,1085
24870,38532,3993,18636,2678,34539,2119,1034,1085
24875,38538,3993,18638,2678,34545,2120,1035,1085
24880,38549,3994,18642,2679,34555,2120,1035,1085
24885,38553,3994,18645,2679,34559,2120,1035,1085
24890,38563,3995,18650,2680,34568,2120,1035,1085
24895,38569,3995,18653,2680,34574,2121,1035,1086
24900,38580,3997,18658,2682,34583,2122,1036,1086
24905,38584,3997,18659,2682,34587,2122,1036,1086
24910,38594,3998,18664,2683,34596,2122,1036,1086
24915,38600,3998,18668,2683,34602,2123,1037,1086
24920,38611,4000,18671,2685,34611,2124,1037,1087
24925,38615,4001,18673,2686,34614,2124,1037,1087
24930,38625,4002,18680,2687,34623,2124,1037,1087
24935,38631,4002,18682,2687,34629,2125,1037,1088
24940,38642,4004,18687,2688,34638,2126,1037,1089
24945,38646,4004,18687,2688,34642,2126,1037,1089
24950,38656,4006,18693,2688,34650,2126,1037,1089
24955,38662,4006,18697,2688,34656,2128,1039,1089
24960,38673,4007,18700,2688,34666,2129,1039,1090
24965,38677,4008,18703,2689,34669,2129,1039,1090
24970,38687,4009,18705,2690,34678,2129,1039,1090
24975,38693,4009,18707,2690,34683,2130,1039,1091
24980,38704,4010,18711,2691,34694,2130,1039,1091
24985,38708,4011,18712,2692,34697,2130,1039,1091
24990,38718,4012,18717,2692,34706,2130,1039,1091
24995,38724,4012,18722,2692,34712,2131,1040,1091
25000,38735,4012,18730,2692,34723,2131,1040,1091
25005,38739,4012,18732,2692,34727,2131,1040,1091
25010,38749,4013,18738,2693,34736,2131,1040,1091
25015,38755,4013,18741,2693,34741,2132,1040,1092
25020,38766,4014,18749,2694,34752,2132,1040,1092
25025,38770,4015,18751,2695,34755,2132,1040,1092
25030,38780,4015,18756,2695,34765,2132,1040,1092
25035,38786,4015,18758,2695,34771,2133,1040,1093
25040,38797,4015,18760,2695,34782,2133,1040,1093
25045,38801,4015,18762,2695,34786,2133,1040,1093
25050,38811,4015,18766,2695,34796,2133,1040,1093
25055,38817,4015,18770,2695,34802,2134,1041,1093
25060,38828,4015,18774,2695,34813,2134,1041,1093
25065,38832,4015,18777,2695,34817,2134,1041,1093
25070,38842,4015,18783,2695,34827,2134,1041,1093
25075,38848,4015,18786,2695,34833,2136,1041,1095
25080,38859,4016,18794,2696,34843,2137,1042,1095
25085,38863,4016,18796,2696,34847,2137,1042,1095
25090,38873,4017,18804,2696,34856,2137,1042,1095
25095,38879,4017,18807,2696,34862,2138,1042,1096
25100,38890,4018,18813,2697,34872,2138,1042,1096
25105,38894,4018,18816,2697,34876,2138,1042,1096
25110,38904,4019,18822,2697,34885,2138,1042,1096
25115,38910,4019,18822,2697,34891,2139,1042,1097
25120,38921,4020,18827,2697,34901,2139,1042,1097
25125,38925,4020,18828,2697,34905,2139,1042,1097
25130,38935,4021,18834,2697,34914,2139,1042,1097
25135,38941,4021,18837,2697,34920,2140,1043,1097
25140,38952,4023,18845,2698,34929,2140,1043,1097
25145,38956,4023,18846,2698,34933,2140,1043,1097
25150,38966,4024,18851,2698,34942,2140,1043,1097
25155,38972,4024,18855,2698,34948,2141,1044,1097
25160,38983,4025,18859,2699,34958,2141,1044,1097
25165,38987,4025,18861,2699,34962,2141,1044,1097
25170,38997,4026,18868,2700,34971,2141,1044,1097
25175,39003,4026,18870,2700,34977,2142,1044,1098
25180,39014,4027,18872,2701,34987,2142,1044,1098
25185,39018,4027,18875,2701,34991,2142,1044,1098
25190,39028,4029,18881,2702,34999,2142,1044,1098
25195,39034,4029,18886,2702,35005,2144,1046,1098
25200,39045,4032,18895,2705,35013,2145,1047,1098
25205,39049,4032,18896,2705,35017,2145,1047,1098
25210,39059,4033,18900,2705,35026,2145,1047,1098
25215,39065,4033,18902,2705,35032,2146,1048,1098
25220,39076,4033,18908,2705,35043,2147,1048,1099
25225,39080,4033,18911,2705,35047,2147,1048,1099
25230,39090,4034,18915,2705,35056,2147,1048,1099
25235,39096,4034,18919,2705,35062,2148,1048,1100
25240,39107,4034,18923,2705,35073,2148,1048,1100
25245,39111,4034,18924,2705,35077,2148,1048,1100
25250,39121,4035,18929,2705,35086,2148,1048,1100
25255,39127,4035,18931,2705,35092,2149,1048,1101
25260,39138,4035,18938,2705,35103,2149,1048,1101
25265,39142,4035,18940,2705,35107,2149,1048,1101
25270,39152,4036,18942,2705,35116,2149,1048,1101
25275,39158,4036,18947,2705,35122,2150,1049,1101
25280,39169,4036,18953,2705,35133,2150,1049,1101
25285,39173,4036,18955,2705,35137,2150,1049,1101
25290,39183,4037,18961,2705,35146,2150,1049,1101
25295,39189,4037,18964,2705,35152,2151,1049,1102
25300,39200,4037,18971,2705,35163,2151,1049,1102
25305,39204,4037,18973,2705,35167,2151,1049,1102
25310,39214,4039,18979,2707,35175,2151,1049,1102
25315,39220,4039,18983,2707,35180,2153,1051,1102
25320,39231,4042,18988,2709,35189,2154,1051,1103
25325,39235,4043,18990,2710,35192,2154,1051,1103
25330,39245,4045,18994,2710,35200,2154,1051,1103
25335,39251,4045,18996,2710,35205,2155,1052,1103
25340,39262,4047,19000,2711,35215,2156,1053,1103
25345,39266,4047,19000,2711,35219,2156,1053,1103
25350,39276,4049,19007,2712,35227,2156,1053,1103
25355,39282,4049,19009,2712,35233,2157,1053,1104
25360,39293,4051,19015,2713,35242,2158,1054,1104
25365,39297,4053,19018,2715,35244,2158,1054,1104
25370,39307,4055,19023,2716,35252,2158,1054,1104
25375,39313,4055,19026,2716,35258,2159,1055,1104
25380,39324,4058,19033,2719,35266,2160,1056,1104
25385,39328,4058,19036,2719,35270,2160,1056,1104
25390,39338,4059,19042,2720,35279,2160,1056,1104
25395,39344,4059,19046,2720,35285,2161,1057,1104
25400,39355,4060,19054,2721,35295,2161,1057,1104
25405,39359,4060,19058,2721,35299,2161,1057,1104
25410,39369,4061,19063,2721,35308,2161,1057,1104
25415,39375,4061,19066,2721,35313,2162,1058,1104
25420,39386,4062,19070,2722,35324,2162,1058,1104
25425,39390,4062,19072,2722,35328,2162,1058,1104
25430,39400,4063,19075,2722,35337,2162,1058,1104
25435,39406,4063,19079,2722,35342,2164,1059,1105
25440,39417,4065,19083,2724,35352,2164,1059,1105
25445,39421,4066,19085,2725,35355,2164,1059,1105
25450,39431,4067,19090,2725,35364,2164,1059,1105
25455,39437,4067,19092,2725,35370,2165,1059,1106
25460,39448,4069,19096,2727,35379,2165,1059,1106
25465,39452,4070,19098,2728,35382,2165,1059,1106
25470,39462,4071,19102,2729,35391,2165,1059,1106
25475,39468,4071,19108,2729,35397,2166,1060,1106
25480,39479,4074,19113,2732,35405,2166,1060,1106
25485,39483,4074,19114,2732,35409,2166,1060,1106
25490,39493,4076,19120,2733,35417,2166,1060,1106
25495,39499,4076,19125,2733,35423,2167,1061,1106
25500,39510,4079,19133,2736,35431,2168,1061,1107
25505,39514,4079,19134,2736,35435,2168,1061,1107
25510,39524,4080,19139,2737,35444,2168,1061,1107
25515,39530,4080,19144,2737,35449,2169,1062,1107
25520,39541,4081,19150,2738,35460,2170,1062,1108
25525,39545,4081,19152,2738,35464,2170,1062,1108
25530,39555,4082,19158,2739,35473,2170,1062,1108
25535,39561,4082,19162,2739,35478,2171,1063,1108
25540,39572,4083,19165,2740,35489,2172,1064,1108
25545,39576,4083,19167,2740,35493,2172,1064,1108
25550,39586,4084,19170,2740,35502,2172,1064,1108
25555,39592,4084,19172,2740,35508,2174,1065,1109
25560,39603,4084,19177,2740,35519,2175,1066,1109
25565,39607,4084,19179,2740,35523,2175,1066,1109
25570,39617,4084,19186,2740,35533,2175,1066,1109
25575,39623,4084,19191,2740,35539,2176,1067,1109
25580,39634,4084,19194,2740,35550,2176,1067,1109
25585,39638,4084,19196,2740,35554,2176,1067,1109
25590,39648,4084,19203,2740,35564,2176,1067,1109
25595,39654,4084,19206,2740,35570,2177,1068,1109
25600,39665,4084,19213,2740,35581,2177,1068,1109
25605,39669,4084,19215,2740,35585,2177,1068,1109
25610,39679,4085,19217,2740,35594,2177,1068,1109
25615,39685,4085,19221,2740,35600,2178,1068,1110
25620,39696,4088,19227,2742,35608,2179,1069,1110
25625,39700,4089,19229,2743,35611,2179,1069,1110
25630,39710,4091,19235,2745,35619,2179,1069,1110
25635,39716,4091,19237,2745,35624,2180,1070,1110
25640,39727,4094,19243,2747,35633,2181,1070,1111
25645,39731,4095,19246,2748,35636,2181,1070,1111
25650,39741,4097,19252,2749,35644,2181,1070,1111
25655,39747,4097,19255,2749,35649,2182,1070,1112
25660,39758,4099,19259,2750,35659,2183,1070,1113
25665,39762,4099,19260,2750,35663,2183,1070,1113
25670,39772,4101,19263,2751,35671,2183,1070,1113
25675,39778,4101,19265,2751,35677,2185,1071,1114
25680,39789,4102,19267,2752,35687,2186,1071,1115
25685,39793,4103,19268,2753,35690,2186,1071,1115
25690,39803,4105,19275,2754,35698,2186,1071,1115
25695,39809,4105,19277,2754,35704,2187,1071,1116
25700,39820,4106,19286,2755,35714,2188,1072,1116
25705,39824,4106,19287,2755,35718,2188,1072,1116
25710,39834,4108,19295,2756,35726,2188,1072,1116
25715,39840,4108,19297,2756,35732,2189,1072,1117
25720,39851,4109,19300,2756,35742,2190,1072,1118
25725,39855,4110,19302,2757,35745,2190,1072,1118
25730,39865,4112,19307,2758,35753,2190,1072,1118
25735,39871,4112,19307,2758,35759,2191,1072,1119
25740,39882,4113,19311,2759,35769,2192,1072,1120
25745,39886,4113,19314,2759,35773,2192,1072,1120
25750,39896,4115,19320,2760,35781,2192,1072,1120
25755,39902,4115,19325,2760,35787,2193,1073,1120
25760,39913,4115,19327,2760,35798,2194,1073,1121
25765,39917,4115,19329,2760,35802,2194,1073,1121
25770,39927,4117,19332,2761,35810,2194,1073,1121
25775,39933,4117,19335,2761,35816,2195,1074,1121
25780,39944,4118,19338,2762,35826,2196,1074,1122
25785,39948,4119,19340,2763,35829,2196,1074,1122
25790,39958,4121,19343,2764,35837,2196,1074,1122
25795,39964,4121,19346,2764,35843,2198,1074,1124
25800,39975,4121,19350,2764,35854,2199,1075,1124
25805,39979,4121,19352,2764,35858,2199,1075,1124
25810,39989,4121,19354,2764,35868,2199,1075,1124
25815,39995,4121,19357,2764,35874,2200,1076,1124
25820,40006,4121,19361,2764,35885,2200,1076,1124
25825,40010,4121,19363,2764,35889,2200,1076,1124
25830,40020,4121,19368,2764,35899,2200,1076,1124
25835,40026,4121,19369,2764,35905,2201,1076,1125
25840,40037,4121,19375,2764,35916,2201,1076,1125
25845,40041,4121,19378,2764,35920,2201,1076,1125
25850,40051,4121,19385,2764,35930,2201,1076,1125
25855,40057,4121,19391,2764,35936,2202,1077,1125
25860,40068,4122,19399,2765,35946,2202,1077,1125
25865,40072,4122,19402,2765,35950,2202,1077,1125
25870,40082,4122,19406,2765,35960,2202,1077,1125
25875,40088,4122,19407,2765,35966,2203,1077,1126
25880,40099,4123,19409,2765,35976,2203,1077,1126
25885,40103,4123,19411,2765,35980,2203,1077,1126
25890,40113,4123,19415,2765,35990,2203,1077,1126
25895,40119,4123,19418,2765,35996,2204,1077,1127
25900,40130,4125,19425,2766,36005,2204,1077,1127
25905,40134,4125,19428,2766,36009,2204,1077,1127
25910,40144,4127,19433,2767,36017,2204,1077,1127
25915,40150,4127,19435,2767,36023,2206,1077,1129
25920,40161,4128,19441,2768,36033,2207,1077,1130
25925,40165,4128,19442,2768,36037,2207,1077,1130
25930,40175,4130,19446,2768,36045,2207,1077,1130
25935,40181,4130,19449,2768,36050,2208,1077,1131
25940,40192,4133,19456,2771,36059,2209,1078,1131
25945,40196,4133,19456,2771,36063,2209,1078,1131
25950,40206,4135,19459,2773,36071,2209,1078,1131
25955,40212,4135,19462,2773,36076,2210,1079,1131
25960,40223,4138,19464,2775,36085,2211,1079,1132
25965,40227,4140,19467,2777,36087,2211,1079,1132
25970,40237,4142,19470,2777,36095,2211,1079,1132
25975,40243,4142,19474,2777,36100,2212,1079,1133
25980,40254,4144,19481,2779,36110,2213,1080,1133
25985,40258,4145,19482,2780,36113,2213,1080,1133
25990,40268,4147,19487,2780,36121,2213,1080,1133
25995,40274,4147,19490,2780,36126,2214,1080,1134
26000,40285,4149,19494,2781,36136,2215,1081,1134
26005,40289,4149,19496,2781,36140,2215,1081,1134
26010,40299,4150,19499,2782,36149,2215,1081,1134
26015,40305,4150,19504,2782,36155,2216,1082,1134
26020,40316,4151,19511,2783,36165,2217,1083,1134
26025,40320,4151,19512,2783,36169,2217,1083,1134
26030,40330,4152,19517,2783,36178,2217,1083,1134
26035,40336,4152,19519,2783,36183,2219,1083,1136
26040,40347,4155,19524,2785,36192,2220,1084,1136
26045,40351,4156,19528,2786,36195,2220,1084,1136
26050,40361,4158,19535,2788,36203,2220,1084,1136
26055,40367,4158,19537,2788,36209,2221,1084,1137
26060,40378,4159,19538,2788,36219,2221,1084,1137
26065,40382,4159,19538,2788,36223,2221,1084,1137
26070,40392,4161,19544,2790,36231,2221,1084,1137
26075,40398,4161,19547,2790,36237,2222,1085,1137
26080,40409,4164,19553,2792,36245,2222,1085,1137
26085,40413,4164,19554,2792,36249,2222,1085,1137
26090,40423,4166,19557,2793,36257,2222,1085,1137
26095,40429,4166,19560,2793,36263,2223,1086,1137
26100,40440,4168,19563,2794,36272,2223,1086,1137
26105,40444,4168,19564,2794,36276,2223,1086,1137
26110,40454,4169,19570,2795,36285,2223,1086,1137
26115,40460,4169,19573,2795,36291,2224,1086,1138
26120,40471,4171,19582,2797,36300,2224,1086,1138
26125,40475,4171,19583,2797,36304,2224,1086,1138
26130,40485,4172,19587,2797,36313,2224,1086,1138
26135,40491,4172,19592,2797,36319,2225,1087,1138
26140,40502,4174,19598,2798,36328,2225,1087,1138
26145,40506,4174,19598,2798,36332,2225,1087,1138
26150,40516,4175,19603,2799,36341,2225,1087,1138
26155,40522,4175,19605,2799,36347,2227,1088,1139
26160,40533,4177,19609,2800,36356,2228,1088,1140
26165,40537,4177,19610,2800,36360,2228,1088,1140
26170,40547,4178,19611,2800,36369,2228,1088,1140
26175,40553,4178,19615,2800,36374,2229,1089,1140
26180,40564,4180,19619,2802,36384,2230,1089,1141
26185,40568,4180,19621,2802,36388,2230,1089,1141
26190,40578,4181,19628,2803,36397,2230,1089,1141
26195,40584,4181,19631,2803,36403,2231,1089,1142
26200,40595,4181,19635,2803,36414,2232,1090,1142
26205,40599,4181,19637,2803,36418,2232,1090,1142
26210,40609,4183,19642,2804,36426,2232,1090,1142
26215,40615,4183,19644,2804,36431,2233,1090,1143
26220,40626,4186,19650,2807,36440,2234,1091,1143
26225,40630,4186,19653,2807,36444,2234,1091,1143
26230,40640,4188,19655,2807,36452,2234,1091,1143
26235,40646,4188,19657,2807,36458,2235,1091,1144
26240,40657,4189,19664,2808,36468,2235,1091,1144
26245,40661,4189,19664,2808,36472,2235,1091,1144
26250,40671,4191,19667,2808,36480,2235,1091,1144
26255,40677,4191,19669,2808,36486,2236,1091,1145
26260,40688,4191,19672,2808,36497,2236,1091,1145
26265,40692,4191,19675,2808,36501,2236,1091,1145
26270,40702,4193,19679,2808,36509,2236,1091,1145
26275,40708,4193,19681,2808,36515,2238,1092,1146
26280,40719,4194,19683,2808,36525,2238,1092,1146
26285,40723,4195,19686,2809,36528,2238,1092,1146
26290,40733,4197,19691,2809,36536,2238,1092,1146
26295,40739,4197,19693,2809,36541,2239,1092,1147
26300,40750,4201,19699,2813,36549,2239,1092,1147
26305,40754,4201,19700,2813,36553,2239,1092,1147
26310,40764,4203,19705,2815,36561,2239,1092,1147
26315,40770,4203,19708,2815,36566,2240,1092,1148
26320,40781,4207,19714,2819,36574,2240,1092,1148
26325,40785,4208,19716,2820,36577,2240,1092,1148
26330,40795,4210,19725,2821,36585,2240,1092,1148
26335,40801,4210,19727,2821,36591,2241,1092,1149
26340,40812,4213,19730,2823,36599,2241,1092,1149
26345,40816,4213,19732,2823,36603,2241,1092,1149
26350,40826,4214,19736,2824,36612,2241,1092,1149
26355,40832,4214,19737,2824,36618,2242,1092,1150
26360,40843,4215,19742,2825,36628,2242,1092,1150
26365,40847,4216,19746,2826,36631,2242,1092,1150
26370,40857,4217,19752,2826,36640,2242,1092,1150
26375,40863,4217,19757,2826,36646,2243,1093,1150
26380,40874,4218,19761,2826,36656,2243,1093,1150
26385,40878,4219,19763,2827,36659,2243,1093,1150
26390,40888,4220,19768,2827,36668,2243,1093,1150
26395,40894,4220,19772,2827,36674,2244,1093,1151
26400,40905,4222,19776,2828,36683,2244,1093,1151
26405,40909,4222,19778,2828,36687,2244,1093,1151
26410,40919,4222,19784,2828,36697,2244,1093,1151
26415,40925,4222,19788,2828,36703,2245,1093,1152
26420,40936,4223,19792,2828,36713,2245,1093,1152
26425,40940,4223,19796,2828,36717,2245,1093,1152
26430,40950,4223,19802,2828,36727,2245,1093,1152
26435,40956,4223,19804,2828,36733,2246,1093,1153
26440,40967,4224,19807,2828,36743,2246,1093,1153
26445,40971,4224,19808,2828,36747,2246,1093,1153
26450,40981,4225,19812,2829,36756,2246,1093,1153
26455,40987,4225,19815,2829,36761,2248,1094,1154
26460,40998,4228,19822,2832,36770,2249,1094,1155
26465,41002,4229,19824,2833,36773,2249,1094,1155
26470,41012,4230,19829,2834,36782,2249,1094,1155
26475,41018,4230,19831,2834,36788,2251,1095,1156
26480,41029,4231,19839,2834,36798,2252,1096,1156
26485,41033,4232,19842,2835,36801,2252,1096,1156
26490,41043,4233,19849,2836,36810,2252,1096,1156
26495,41049,4233,19852,2836,36816,2254,1097,1157
26500,41060,4234,19859,2837,36826,2255,1097,1158
26505,41064,4235,19863,2838,36829,2255,1097,1158
26510,41074,4237,19867,2839,36837,2255,1097,1158
26515,41080,4237,19870,2839,36843,2256,1098,1158
26520,41091,4239,19877,2841,36852,2257,1098,1159
26525,41095,4240,19880,2842,36855,2257,1098,1159
26530,41105,4242,19883,2843,36863,2257,1098,1159
26535,41111,4242,19886,2843,36869,2258,1098,1160
26540,41122,4244,19894,2845,36878,2259,1098,1161
26545,41126,4245,19897,2846,36881,2259,1098,1161
26550,41136,4247,19902,2847,36889,2259,1098,1161
26555,41142,4247,19905,2847,36895,2260,1098,1162
26560,41153,4249,19911,2849,36904,2261,1099,1162
26565,41157,4250,19912,2850,36907,2261,1099,1162
26570,41167,4252,19918,2851,36915,2261,1099,1162
26575,41173,4252,19923,2851,36920,2262,1100,1162
26580,41184,4255,19932,2854,36929,2263,1101,1162
26585,41188,4255,19935,2854,36933,2263,1101,1162
26590,41198,4257,19943,2856,36941,2263,1101,1162
26595,41204,4257,19944,2856,36947,2264,1101,1163
26600,41215,4257,19948,2856,36958,2264,1101,1163
26605,41219,4257,19951,2856,36962,2264,1101,1163
26610,41229,4259,19956,2857,36970,2264,1101,1163
26615,41235,4259,19960,2857,36976,2265,1102,1163
26620,41246,4259,19963,2857,36987,2265,1102,1163
26625,41250,4259,19964,2857,36991,2265,1102,1163
26630,41260,4261,19970,2859,36999,2265,1102,1163
26635,41266,4261,19973,2859,37005,2267,1104,1163
26640,41277,4262,19979,2859,37015,2268,1105,1163
26645,41281,4262,19980,2859,37019,2268,1105,1163
26650,41291,4263,19987,2860,37028,2268,1105,1163
26655,41297,4263,19989,2860,37034,2269,1106,1163
26660,41308,4265,19993,2861,37043,2270,1107,1163
26665,41312,4265,19995,2861,37047,2270,1107,1163
26670,41322,4266,19998,2861,37056,2270,1107,1163
26675,41328,4266,20000,2861,37062,2271,1107,1164
26680,41339,4268,20009,2863,37071,2272,1108,1164
26685,41343,4268,20011,2863,37075,2272,1108,1164
26690,41353,4269,20015,2863,37084,2272,1108,1164
26695,41359,4269,20018,2863,37090,2273,1109,1164
26700,41370,4271,20024,2865,37099,2274,1109,1165
26705,41374,4271,20026,2865,37103,2274,1109,1165
26710,41384,4273,20032,2865,37111,2274,1109,1165
26715,41390,4273,20033,2865,37117,2275,1109,1166
26720,41401,4273,20036,2865,37128,2276,1109,1167
26725,41405,4274,20037,2866,37131,2276,1109,1167
26730,41415,4276,20040,2867,37139,2276,1109,1167
26735,41421,4276,20045,2867,37144,2277,1110,1167
26740,41432,4278,20048,2869,37154,2278,1110,1168
26745,41436,4278,20050,2869,37158,2278,1110,1168
26750,41446,4280,20052,2869,37166,2278,1110,1168
26755,41452,4280,20056,2869,37172,2280,1112,1168
26760,41463,4280,20058,2869,37183,2281,1112,1169
26765,41467,4280,20058,2869,37187,2281,1112,1169
26770,41477,4282,20061,2869,37195,2281,1112,1169
26775,41483,4282,20064,2869,37201,2282,1112,1170
26780,41494,4282,20067,2869,37212,2282,1112,1170
26785,41498,4283,20070,2870,37215,2282,1112,1170
26790,41508,4285,20076,2870,37223,2282,1112,1170
26795,41514,4285,20078,2870,37229,2283,1112,1171
26800,41525,4285,20084,2870,37240,2283,1112,1171
26805,41529,4285,20086,2870,37244,2283,1112,1171
26810,41539,4287,20091,2870,37252,2283,1112,1171
26815,41545,4287,20094,2870,37258,2284,1113,1171
26820,41556,4288,20099,2871,37268,2284,1113,1171
26825,41560,4288,20102,2871,37272,2284,1113,1171
26830,41570,4289,20107,2872,37281,2284,1113,1171
26835,41576,4289,20109,2872,37287,2285,1114,1171
26840,41587,4290,20116,2873,37297,2285,1114,1171
26845,41591,4291,20120,2874,37300,2285,1114,1171
26850,41601,4292,20127,2875,37309,2285,1114,1171
26855,41607,4292,20131,2875,37315,2286,1115,1171
26860,41618,4293,20137,2876,37325,2286,1115,1171
26865,41622,4293,20139,2876,37329,2286,1115,1171
26870,41632,4294,20144,2877,37338,2286,1115,1171
26875,41638,4294,20146,2877,37344,2287,1115,1172
26880,41649,4297,20151,2880,37352,2288,1115,1173
26885,41653,4298,20153,2881,37355,2288,1115,1173
26890,41663,4299,20158,2882,37364,2288,1115,1173
26895,41669,4299,20160,2882,37370,2290,1115,1175
26900,41680,4300,20167,2883,37380,2291,1116,1175
26905,41684,4300,20169,2883,37384,2291,1116,1175
26910,41694,4301,20173,2883,37393,2291,1116,1175
26915,41700,4301,20176,2883,37399,2292,1117,1175
26920,41711,4302,20184,2884,37409,2293,1118,1175
26925,41715,4302,20186,2884,37413,2293,1118,1175
26930,41725,4304,20191,2884,37421,2293,1118,1175
26935,41731,4304,20195,2884,37427,2294,1119,1175
26940,41742,4306,20202,2886,37436,2295,1120,1175
26945,41746,4307,20204,2887,37439,2295,1120,1175
26950,41756,4307,20209,2887,37449,2295,1120,1175
26955,41762,4307,20213,2887,37455,2296,1120,1176
26960,41773,4308,20218,2887,37465,2296,1120,1176
26965,41777,4308,20219,2887,37469,2296,1120,1176
26970,41787,4308,20223,2887,37479,2296,1120,1176
26975,41793,4308,20226,2887,37485,2297,1121,1176
26980,41804,4309,20228,2887,37495,2297,1121,1176
26985,41808,4310,20232,2888,37498,2297,1121,1176
26990,41818,4310,20236,2888,37508,2297,1121,1176
26995,41824,4310,20238,2888,37514,2298,1121,1177
27000,41835,4311,20243,2888,37524,2298,1121,1177
27005,41839,4311,20246,2888,37528,2298,1121,1177
27010,41849,4311,20250,2888,37538,2298,1121,1177
27015,41855,4311,20253,2888,37544,2299,1122,1177
27020,41866,4313,20259,2890,37553,2299,1122,1177
27025,41870,4313,20261,2890,37557,2299,1122,1177
27030,41880,4313,20265,2890,37567,2299,1122,1177
27035,41886,4313,20267,2890,37573,2300,1122,1178
27040,41897,4315,20274,2892,37582,2300,1122,1178
27045,41901,4315,20275,2892,37586,2300,1122,1178
27050,41911,4316,20280,2892,37595,2300,1122,1178
27055,41917,4316,20283,2892,37600,2301,1123,1178
27060,41928,4319,20289,2895,37609,2302,1123,1179
27065,41932,4319,20290,2895,37613,2302,1123,1179
27070,41942,4321,20295,2895,37621,2302,1123,1179
27075,41948,4321,20297,2895,37627,2303,1123,1180
27080,41959,4322,20301,2896,37637,2303,1123,1180
27085,41963,4322,20302,2896,37641,2303,1123,1180
27090,41973,4324,20306,2897,37649,2303,1123,1180
27095,41979,4324,20309,2897,37655,2304,1124,1180
27100,41990,4325,20316,2898,37665,2304,1124,1180
27105,41994,4326,20317,2899,37668,2304,1124,1180
27110,42004,4328,20323,2900,37676,2304,1124,1180
27115,42010,4328,20327,2900,37682,2305,1125,1180
27120,42021,4329,20330,2900,37692,2305,1125,1180
27125,42025,4330,20332,2901,37695,2305,1125,1180
27130,42035,4332,20336,2902,37703,2305,1125,1180
27135,42041,4332,20338,2902,37709,2306,1125,1181
27140,42052,4334,20343,2904,37718,2306,1125,1181
27145,42056,4334,20344,2904,37722,2306,1125,1181
27150,42066,4336,20351,2906,37730,2306,1125,1181
27155,42072,4336,20354,2906,37736,2307,1126,1181
27160,42083,4337,20358,2907,37746,2307,1126,1181
27165,42087,4337,20359,2907,37750,2307,1126,1181
27170,42097,4339,20364,2909,37758,2307,1126,1181
27175,42103,4339,20366,2909,37763,2309,1126,1183
27180,42114,4343,20372,2913,37771,2310,1126,1184
27185,42118,4343,20374,2913,37775,2310,1126,1184
27190,42128,4344,20377,2913,37784,2310,1126,1184
27195,42134,4344,20381,2913,37790,2311,1127,1184
27200,42145,4344,20387,2913,37801,2311,1127,1184
27205,42149,4344,20388,2913,37805,2311,1127,1184
27210,42159,4345,20393,2913,37814,2311,1127,1184
27215,42165,4345,20396,2913,37820,2312,1128,1184
27220,42176,4345,20402,2913,37831,2312,1128,1184
27225,42180,4345,20406,2913,37835,2312,1128,1184
27230,42190,4346,20413,2914,37844,2312,1128,1184
27235,42196,4346,20415,2914,37850,2313,1129,1184
27240,42207,4346,20420,2914,37861,2313,1129,1184
27245,42211,4346,20424,2914,37865,2313,1129,1184
27250,42221,4347,20430,2915,37874,2313,1129,1184
27255,42227,4347,20432,2915,37880,2314,1130,1184
27260,42238,4347,20440,2915,37891,2314,1130,1184
27265,42242,4347,20443,2915,37895,2314,1130,1184
27270,42252,4348,20447,2915,37904,2314,1130,1184
27275,42258,4348,20450,2915,37910,2315,1130,1185
27280,42269,4348,20452,2915,37921,2315,1130,1185
27285,42273,4348,20455,2915,37925,2315,1130,1185
27290,42283,4350,20461,2916,37933,2315,1130,1185
27295,42289,4350,20464,2916,37938,2316,1130,1186
27300,42300,4354,20470,2920,37946,2317,1130,1187
27305,42304,4354,20471,2920,37950,2317,1130,1187
27310,42314,4355,20475,2920,37959,2317,1130,1187
27315,42320,4355,20478,2920,37965,2318,1130,1188
27320,42331,4357,20484,2921,37974,2318,1130,1188
27325,42335,4358,20486,2922,37977,2318,1130,1188
27330,42345,4359,20493,2922,37986,2318,1130,1188
27335,42351,4359,20494,2922,37992,2319,1130,1189
27340,42362,4360,20499,2923,38002,2319,1130,1189
27345,42366,4360,20501,2923,38006,2319,1130,1189
27350,42376,4361,20505,2924,38015,2319,1130,1189
27355,42382,4361,20508,2924,38021,2320,1130,1190
27360,42393,4363,20512,2925,38030,2320,1130,1190
27365,42397,4363,20513,2925,38034,2320,1130,1190
27370,42407,4364,20519,2926,38043,2320,1130,1190
27375,42413,4364,20522,2926,38049,2321,1130,1191
27380,42424,4365,20527,2926,38059,2321,1130,1191
27385,42428,4365,20527,2926,38063,2321,1130,1191
27390,42438,4366,20531,2926,38072,2321,1130,1191
27395,42444,4366,20534,2926,38078,2322,1130,1192
27400,42455,4367,20543,2926,38088,2322,1130,1192
27405,42459,4367,20544,2926,38092,2322,1130,1192
27410,42469,4369,20550,2927,38100,2322,1130,1192
27415,42475,4369,20552,2927,38106,2323,1131,1192
27420,42486,4370,20556,2928,38116,2324,1132,1192
27425,42490,4370,20557,2928,38120,2324,1132,1192
27430,42500,4371,20562,2928,38129,2324,1132,1192
27435,42506,4371,20565,2928,38135,2326,1134,1192
27440,42517,4372,20570,2929,38145,2326,1134,1192
27445,42521,4373,20572,2930,38148,2326,1134,1192
27450,42531,4374,20579,2931,38157,2326,1134,1192
27455,42537,4374,20583,2931,38163,2328,1135,1193
27460,42548,4375,20589,2932,38173,2328,1135,1193
27465,42552,4375,20591,2932,38177,2328,1135,1193
27470,42562,4376,20594,2932,38186,2328,1135,1193
27475,42568,4376,20598,2932,38192,2330,1136,1194
27480,42579,4378,20605,2933,38201,2330,1136,1194
27485,42583,4378,20608,2933,38205,2330,1136,1194
27490,42593,4379,20614,2934,38214,2330,1136,1194
27495,42599,4379,20618,2934,38220,2331,1137,1194
27500,42610,4379,20620,2934,38231,2331,1137,1194
27505,42614,4379,20621,2934,38235,2331,1137,1194
27510,42624,4380,20623,2934,38244,2331,1137,1194
27515,42630,4380,20625,2934,38250,2332,1137,1195
27520,42641,4380,20632,2934,38261,2332,1137,1195
27525,42645,4380,20635,2934,38265,2332,1137,1195
27530,42655,4382,20639,2935,38273,2332,1137,1195
27535,42661,4382,20643,2935,38278,2333,1137,1196
27540,42672,4384,20649,2937,38288,2333,1137,1196
27545,42676,4385,20651,2938,38291,2333,1137,1196
27550,42686,4386,20653,2938,38300,2333,1137,1196
27555,42692,4386,20656,2938,38306,2334,1137,1197
27560,42703,4386,20659,2938,38317,2335,1138,1197
27565,42707,4387,20662,2939,38320,2335,1138,1197
27570,42717,4388,20668,2940,38329,2335,1138,1197
27575,42723,4388,20669,2940,38335,2336,1138,1198
27580,42734,4389,20676,2941,38345,2337,1139,1198
27585,42738,4390,20679,2942,38348,2337,1139,1198
27590,42748,4391,20685,2943,38357,2337,1139,1198
27595,42754,4391,20687,2943,38363,2338,1140,1198
27600,42765,4391,20691,2943,38374,2339,1141,1198
27605,42769,4391,20693,2943,38378,2339,1141,1198
27610,42779,4391,20698,2943,38388,2339,1141,1198
27615,42785,4391,20700,2943,38394,2340,1142,1198
27620,42796,4391,20707,2943,38405,2341,1143,1198
27625,42800,4391,20708,2943,38409,2341,1143,1198
27630,42810,4391,20712,2943,38419,2341,1143,1198
27635,42816,4391,20717,2943,38425,2342,1144,1198
27640,42827,4391,20723,2943,38436,2343,1145,1198
27645,42831,4391,20725,2943,38440,2343,1145,1198
27650,42841,4391,20729,2943,38450,2343,1145,1198
27655,42847,4391,20733,2943,38455,2344,1146,1198
27660,42858,4395,20741,2947,38463,2344,1146,1198
27665,42862,4396,20742,2948,38466,2344,1146,1198
27670,42872,4397,20750,2949,38475,2344,1146,1198
27675,42878,4397,20752,2949,38481,2345,1147,1198
27680,42889,4398,20757,2950,38491,2345,1147,1198
27685,42893,4398,20757,2950,38495,2345,1147,1198
27690,42903,4399,20760,2950,38504,2345,1147,1198
27695,42909,4399,20762,2950,38510,2346,1148,1198
27700,42920,4401,20767,2951,38519,2346,1148,1198
27705,42924,4401,20768,2951,38523,2346,1148,1198
27710,42934,4403,20774,2952,38531,2346,1148,1198
27715,42940,4403,20776,2952,38537,2347,1148,1199
27720,42951,4404,20782,2953,38547,2347,1148,1199
27725,42955,4404,20784,2953,38551,2347,1148,1199
27730,42965,4406,20790,2954,38559,2347,1148,1199
27735,42971,4406,20792,2954,38565,2348,1149,1199
27740,42982,4407,20794,2954,38575,2348,1149,1199
27745,42986,4407,20794,2954,38579,2348,1149,1199
27750,42996,4409,20797,2955,38587,2348,1149,1199
27755,43002,4409,20800,2955,38593,2349,1149,1200
27760,43013,4410,20805,2955,38603,2350,1150,1200
27765,43017,4410,20807,2955,38607,2350,1150,1200
27770,43027,4412,20814,2956,38615,2350,1150,1200
27775,43033,4412,20817,2956,38621,2351,1150,1201
27780,43044,4414,20823,2957,38630,2352,1151,1201
27785,43048,4414,20824,2957,38634,2352,1151,1201
27790,43058,4416,20827,2957,38642,2352,1151,1201
27795,43064,4416,20829,2957,38648,2353,1151,1202
27800,43075,4416,20833,2957,38659,2353,1151,1202
27805,43079,4416,20836,2957,38663,2353,1151,1202
27810,43089,4418,20841,2959,38671,2353,1151,1202
27815,43095,4418,20845,2959,38677,2354,1152,1202
27820,43106,4418,20848,2959,38688,2354,1152,1202
27825,43110,4418,20851,2959,38692,2354,1152,1202
27830,43120,4420,20853,2959,38700,2354,1152,1202
27835,43126,4420,20854,2959,38706,2355,1152,1203
27840,43137,4420,20858,2959,38717,2355,1152,1203
27845,43141,4420,20860,2959,38721,2355,1152,1203
27850,43151,4422,20864,2959,38729,2355,1152,1203
27855,43157,4422,20867,2959,38735,2356,1152,1204
27860,43168,4422,20869,2959,38746,2356,1152,1204
27865,43172,4422,20872,2959,38750,2356,1152,1204
27870,43182,4424,20879,2961,38758,2356,1152,1204
27875,43188,4424,20881,2961,38764,2357,1152,1205
27880,43199,4424,20887,2961,38775,2357,1152,1205
27885,43203,4425,20889,2962,38778,2357,1152,1205
27890,43213,4427,20894,2962,38786,2357,1152,1205
27895,43219,4427,20898,2962,38791,2359,1153,1206
27900,43230,4429,20900,2964,38801,2360,1153,1207
27905,43234,4429,20901,2964,38805,2360,1153,1207
27910,43244,4429,20903,2964,38815,2360,1153,1207
27915,43250,4429,20905,2964,38821,2361,1154,1207
27920,43261,4430,20911,2964,38831,2361,1154,1207
27925,43265,4431,20913,2965,38834,2361,1154,1207
27930,43275,4431,20919,2965,38844,2361,1154,1207
27935,43281,4431,20924,2965,38850,2362,1155,1207
27940,43292,4432,20928,2965,38860,2362,1155,1207
27945,43296,4433,20930,2966,38863,2362,1155,1207
27950,43306,4433,20938,2966,38873,2362,1155,1207
27955,43312,4433,20939,2966,38879,2363,1155,1208
27960,43323,4434,20945,2966,38889,2363,1155,1208
27965,43327,4434,20946,2966,38893,2363,1155,1208
27970,43337,4434,20951,2966,38903,2363,1155,1208
27975,43343,4434,20955,2966,38909,2364,1156,1208
27980,43354,4435,20960,2966,38919,2364,1156,1208
27985,43358,4435,20961,2966,38923,2364,1156,1208
27990,43368,4435,20964,2966,38933,2364,1156,1208
27995,43374,4435,20966,2966,38939,2365,1156,1209
28000,43385,4436,20972,2966,38949,2365,1156,1209
28005,43389,4436,20972,2966,38953,2365,1156,1209
28010,43399,4438,20975,2967,38961,2365,1156,1209
28015,43405,4438,20976,2967,38967,2367,1156,1211
28020,43416,4440,20982,2968,38976,2367,1156,1211
28025,43420,4441,20983,2969,38979,2367,1156,1211
28030,43430,4443,20989,2970,38987,2367,1156,1211
28035,43436,4443,20995,2970,38992,2368,1157,1211
28040,43447,4444,21000,2971,39003,2368,1157,1211
28045,43451,4444,21002,2971,39007,2368,1157,1211
28050,43461,4446,21007,2971,39015,2368,1157,1211
28055,43467,4446,21009,2971,39021,2369,1157,1212
28060,43478,4447,21014,2972,39031,2369,1157,1212
28065,43482,4448,21015,2973,39034,2369,1157,1212
28070,43492,4450,21018,2974,39042,2369,1157,1212
28075,43498,4450,21020,2974,39048,2370,1158,1212
28080,43509,4451,21028,2975,39058,2371,1159,1212
28085,43513,4451,21030,2975,39062,2371,1159,1212
28090,43523,4453,21037,2976,39070,2371,1159,1212
28095,43529,4453,21041,2976,39076,2372,1160,1212
28100,43540,4453,21045,2976,39087,2373,1161,1212
28105,43544,4453,21047,2976,39091,2373,1161,1212
28110,43554,4455,21051,2978,39099,2373,1161,1212
28115,43560,4455,21055,2978,39105,2374,1161,1213
28120,43571,4456,21062,2979,39115,2375,1161,1214
28125,43575,4456,21065,2979,39119,2375,1161,1214
28130,43585,4458,21070,2981,39127,2375,1161,1214
28135,43591,4458,21071,2981,39133,2377,1162,1215
28140,43602,4460,21074,2983,39142,2378,1162,1216
28145,43606,4461,21077,2984,39145,2378,1162,1216
28150,43616,4463,21082,2985,39153,2378,1162,1216
28155,43622,4463,21086,2985,39159,2379,1163,1216
28160,43633,4466,21094,2987,39167,2380,1163,1217
28165,43637,4467,21096,2988,39170,2380,1163,1217
28170,43647,4469,21102,2990,39178,2380,1163,1217
28175,43653,4469,21106,2990,39183,2381,1163,1218
28180,43664,4472,21113,2993,39192,2382,1163,1219
28185,43668,4473,21115,2994,39195,2382,1163,1219
28190,43678,4475,21119,2995,39203,2382,1163,1219
28195,43684,4475,21121,2995,39208,2383,1163,1220
28200,43695,4478,21129,2998,39217,2384,1164,1220
28205,43699,4478,21130,2998,39221,2384,1164,1220
28210,43709,4479,21135,2998,39230,2384,1164,1220
28215,43715,4479,21136,2998,39236,2385,1164,1221
28220,43726,4479,21140,2998,39247,2385,1164,1221
28225,43730,4479,21141,2998,39251,2385,1164,1221
28230,43740,4480,21145,2999,39260,2385,1164,1221
28235,43746,4480,21149,2999,39266,2386,1165,1221
28240,43757,4480,21154,2999,39277,2386,1165,1221
28245,43761,4480,21157,2999,39281,2386,1165,1221
28250,43771,4481,21161,2999,39290,2386,1165,1221
28255,43777,4481,21165,2999,39296,2388,1167,1221
28260,43788,4481,21169,2999,39307,2388,1167,1221
28265,43792,4482,21172,3000,39310,2388,1167,1221
28270,43802,4483,21178,3000,39319,2388,1167,1221
28275,43808,4483,21181,3000,39325,2389,1167,1222
28280,43819,4485,21188,3002,39334,2389,1167,1222
28285,43823,4486,21191,3003,39337,2389,1167,1222
28290,43833,4487,21195,3003,39346,2389,1167,1222
28295,43839,4487,21197,3003,39352,2390,1168,1222
28300,43850,4490,21203,3005,39360,2390,1168,1222
28305,43854,4491,21205,3006,39363,2390,1168,1222
28310,43864,4493,21208,3006,39371,2390,1168,1222
28315,43870,4493,21209,3006,39377,2391,1168,1223
28320,43881,4496,21216,3008,39385,2392,1169,1223
28325,43885,4496,21217,3008,39389,2392,1169,1223
28330,43895,4498,21223,3009,39397,2392,1169,1223
28335,43901,4498,21225,3009,39403,2393,1169,1224
28340,43912,4498,21227,3009,39414,2394,1169,1225
28345,43916,4498,21228,3009,39418,2394,1169,1225
28350,43926,4500,21231,3009,39426,2394,1169,1225
28355,43932,4500,21232,3009,39432,2395,1169,1226
28360,43943,4500,21235,3009,39443,2396,1169,1227
28365,43947,4501,21236,3010,39446,2396,1169,1227
28370,43957,4503,21241,3012,39454,2396,1169,1227
28375,43963,4503,21244,3012,39460,2398,1170,1228
28380,43974,4503,21249,3012,39471,2399,1171,1228
28385,43978,4504,21250,3013,39474,2399,1171,1228
28390,43988,4506,21257,3014,39482,2399,1171,1228
28395,43994,4506,21260,3014,39488,2400,1171,1229
28400,44005,4506,21266,3014,39499,2401,1172,1229
28405,44009,4506,21267,3014,39503,2401,1172,1229
28410,44019,4508,21271,3014,39511,2401,1172,1229
28415,44025,4508,21274,3014,39517,2402,1173,1229
28420,44036,4508,21280,3014,39528,2403,1173,1230
28425,44040,4508,21282,3014,39532,2403,1173,1230
28430,44050,4510,21287,3014,39540,2403,1173,1230
28435,44056,4510,21290,3014,39546,2404,1174,1230
28440,44067,4511,21294,3015,39556,2405,1175,1230
28445,44071,4511,21297,3015,39560,2405,1175,1230
28450,44081,4513,21301,3016,39568,2405,1175,1230
28455,44087,4513,21303,3016,39574,2406,1176,1230
28460,44098,4514,21307,3017,39584,2406,1176,1230
28465,44102,4514,21311,3017,39588,2406,1176,1230
28470,44112,4516,21316,3019,39596,2406,1176,1230
28475,44118,4516,21320,3019,39601,2407,1177,1230
28480,44129,4519,21325,3021,39610,2407,1177,1230
28485,44133,4519,21327,3021,39614,2407,1177,1230
28490,44143,4521,21333,3022,39622,2407,1177,1230
28495,44149,4521,21337,3022,39628,2409,1179,1230
28500,44160,4523,21343,3023,39637,2409,1179,1230
28505,44164,4524,21347,3024,39640,2409,1179,1230
28510,44174,4526,21353,3025,39648,2409,1179,1230
28515,44180,4526,21355,3025,39654,2410,1180,1230
28520,44191,4527,21362,3026,39664,2411,1180,1231
28525,44195,4528,21364,3027,39667,2411,1180,1231
28530,44205,4530,21370,3029,39675,2411,1180,1231
28535,44211,4530,21374,3029,39680,2412,1181,1231
28540,44222,4532,21379,3031,39690,2413,1182,1231
28545,44226,4532,21381,3031,39694,2413,1182,1231
28550,44236,4534,21383,3031,39702,2413,1182,1231
28555,44242,4534,21386,3031,39708,2414,1182,1232
28560,44253,4536,21390,3032,39717,2415,1183,1232
28565,44257,4537,21394,3033,39720,2415,1183,1232
28570,44267,4538,21400,3033,39729,2415,1183,1232
28575,44273,4538,21402,3033,39735,2416,1183,1233
28580,44284,4539,21409,3034,39745,2416,1183,1233
28585,44288,4539,21413,3034,39749,2416,1183,1233
28590,44298,4540,21414,3034,39758,2416,1183,1233
28595,44304,4540,21418,3034,39764,2417,1184,1233
28600,44315,4540,21421,3034,39775,2417,1184,1233
28605,44319,4540,21424,3034,39779,2417,1184,1233
28610,44329,4541,21429,3035,39788,2417,1184,1233
28615,44335,4541,21431,3035,39794,2419,1185,1234
28620,44346,4542,21436,3036,39804,2419,1185,1234
28625,44350,4542,21439,3036,39808,2419,1185,1234
28630,44360,4543,21444,3036,39817,2419,1185,1234
28635,44366,4543,21448,3036,39823,2421,1185,1236
28640,44377,4544,21455,3037,39833,2421,1185,1236
28645,44381,4544,21458,3037,39837,2421,1185,1236
28650,44391,4545,21465,3037,39846,2421,1185,1236
28655,44397,4545,21470,3037,39852,2422,1186,1236
28660,44408,4546,21477,3038,39862,2422,1186,1236
28665,44412,4546,21478,3038,39866,2422,1186,1236
28670,44422,4548,21484,3039,39874,2422,1186,1236
28675,44428,4548,21486,3039,39880,2423,1187,1236
28680,44439,4549,21490,3040,39890,2424,1187,1237
28685,44443,4550,21493,3041,39893,2424,1187,1237
28690,44453,4551,21500,3041,39902,2424,1187,1237
28695,44459,4551,21503,3041,39907,2425,1188,1237
28700,44470,4553,21508,3043,39917,2426,1189,1237
28705,44474,4554,21510,3044,39920,2426,1189,1237
28710,44484,4555,21514,3044,39929,2426,1189,1237
28715,44490,4555,21517,3044,39935,2427,1190,1237
28720,44501,4557,21521,3046,39944,2428,1190,1238
28725,44505,4558,21524,3047,39947,2428,1190,1238
28730,44515,4559,21529,3048,39956,2428,1190,1238
28735,44521,4559,21533,3048,39961,2429,1191,1238
28740,44532,4562,21540,3051,39970,2430,1192,1238
28745,44536,4562,21541,3051,39974,2430,1192,1238
28750,44546,4562,21545,3051,39984,2430,1192,1238
28755,44552,4562,21548,3051,39990,2431,1192,1239
28760,44563,4563,21552,3051,40000,2431,1192,1239
28765,44567,4563,21553,3051,40004,2431,1192,1239
28770,44577,4563,21557,3051,40014,2431,1192,1239
28775,44583,4563,21560,3051,40020,2432,1193,1239
28780,44594,4564,21565,3051,40030,2432,1193,1239
28785,44598,4564,21568,3051,40034,2432,1193,1239
28790,44608,4565,21575,3051,40043,2432,1193,1239
28795,44614,4565,21577,3051,40049,2434,1194,1240
28800,44625,4566,21577,3051,40059,2434,1194,1240
28805,44629,4567,21580,3052,40062,2434,1194,1240
28810,44639,4568,21587,3052,40071,2434,1194,1240
28815,44645,4568,21590,3052,40077,2435,1195,1240
28820,44656,4569,21593,3052,40087,2435,1195,1240
28825,44660,4570,21595,3053,40090,2435,1195,1240
28830,44670,4571,21599,3053,40099,2435,1195,1240
28835,44676,4571,21602,3053,40105,2436,1196,1240
28840,44687,4572,21605,3054,40115,2436,1196,1240
28845,44691,4573,21608,3055,40118,2436,1196,1240
28850,44701,4575,21612,3057,40126,2436,1196,1240
28855,44707,4575,21615,3057,40132,2437,1197,1240
28860,44718,4576,21620,3057,40142,2437,1197,1240
28865,44722,4577,21621,3058,40145,2437,1197,1240
28870,44732,4579,21626,3058,40153,2437,1197,1240
28875,44738,4579,21629,3058,40159,2438,1197,1241
28880,44749,4580,21632,3058,40169,2438,1197,1241
28885,44753,4581,21634,3059,40172,2438,1197,1241
28890,44763,4583,21635,3059,40180,2438,1197,1241
28895,44769,4583,21640,3059,40186,2439,1198,1241
28900,44780,4584,21644,3059,40196,2439,1198,1241
28905,44784,4585,21646,3060,40199,2439,1198,1241
28910,44794,4587,21649,3061,40207,2439,1198,1241
28915,44800,4587,21650,3061,40213,2440,1198,1242
28920,44811,4590,21656,3063,40221,2441,1199,1242
28925,44815,4590,21657,3063,40225,2441,1199,1242
28930,44825,4592,21661,3064,40233,2441,1199,1242
28935,44831,4592,21664,3064,40239,2442,1200,1242
28940,44842,4593,21669,3065,40249,2443,1201,1242
28945,44846,4593,21671,3065,40253,2443,1201,1242
28950,44856,4595,21673,3066,40261,2443,1201,1242
28955,44862,4595,21674,3066,40267,2444,1202,1242
28960,44873,4597,21680,3068,40276,2445,1203,1242
28965,44877,4597,21682,3068,40280,2445,1203,1242
28970,44887,4599,21689,3070,40288,2445,1203,1242
28975,44893,4599,21692,3070,40294,2446,1204,1242
28980,44904,4599,21696,3070,40305,2447,1204,1243
28985,44908,4599,21697,3070,40309,2447,1204,1243
28990,44918,4600,21701,3070,40318,2447,1204,1243
28995,44924,4600,21706,3070,40323,2448,1205,1243
29000,44935,4602,21711,3072,40333,2449,1206,1243
29005,44939,4602,21715,3072,40337,2449,1206,1243
29010,44949,4603,21721,3073,40346,2449,1206,1243
29015,44955,4603,21726,3073,40352,2450,1207,1243
29020,44966,4604,21730,3074,40362,2451,1207,1244
29025,44970,4604,21733,3074,40366,2451,1207,1244
29030,44980,4605,21740,3075,40375,2451,1207,1244
29035,44986,4605,21742,3075,40380,2452,1207,1245
29040,44997,4609,21750,3078,40388,2453,1208,1245
29045,45001,4609,21751,3078,40392,2453,1208,1245
29050,45011,4610,21759,3079,40401,2453,1208,1245
29055,45017,4610,21763,3079,40406,2454,1208,1246
29060,45028,4612,21766,3080,40416,2455,1208,1247
29065,45032,4612,21767,3080,40420,2455,1208,1247
29070,45042,4613,21771,3080,40429,2455,1208,1247
29075,45048,4613,21774,3080,40434,2456,1208,1248
29080,45059,4615,21777,3081,40444,2457,1208,1249
29085,45063,4616,21778,3082,40447,2457,1208,1249
29090,45073,4618,21781,3082,40455,2457,1208,1249
29095,45079,4618,21783,3082,40461,2458,1208,1250
29100,45090,4621,21789,3085,40469,2459,1208,1251
29105,45094,4622,21791,3086,40472,2459,1208,1251
29110,45104,4623,21796,3086,40481,2459,1208,1251
29115,45110,4623,21799,3086,40487,2460,1208,1252
29120,45121,4624,21804,3087,40497,2461,1209,1252
29125,45125,4624,21806,3087,40501,2461,1209,1252
29130,45135,4625,21811,3087,40510,2461,1209,1252
29135,45141,4625,21812,3087,40516,2462,1210,1252
29140,45152,4626,21817,3087,40526,2463,1211,1252
29145,45156,4626,21817,3087,40530,2463,1211,1252
29150,45166,4627,21822,3088,40539,2463,1211,1252
29155,45172,4627,21825,3088,40545,2464,1212,1252
29160,45183,4628,21832,3089,40555,2465,1213,1252
29165,45187,4629,21835,3090,40558,2465,1213,1252
29170,45197,4630,21837,3090,40567,2465,1213,1252
29175,45203,4630,21839,3090,40573,2466,1213,1253
29180,45214,4631,21846,3090,40583,2466,1213,1253
29185,45218,4633,21849,3092,40585,2466,1213,1253
29190,45228,4634,21854,3092,40594,2466,1213,1253
29195,45234,4634,21857,3092,40600,2467,1214,1253
29200,45245,4635,21864,3093,40610,2467,1214,1253
29205,45249,4636,21865,3094,40613,2467,1214,1253
29210,45259,4638,21868,3095,40621,2467,1214,1253
29215,45265,4638,21870,3095,40627,2468,1214,1254
29220,45276,4641,21877,3097,40635,2468,1214,1254
29225,45280,4641,21880,3097,40639,2468,1214,1254
29230,45290,4642,21883,3097,40648,2468,1214,1254
29235,45296,4642,21884,3097,40654,2469,1214,1255
29240,45307,4643,21889,3098,40664,2469,1214,1255
29245,45311,4643,21890,3098,40668,2469,1214,1255
29250,45321,4644,21893,3098,40677,2469,1214,1255
29255,45327,4644,21896,3098,40683,2470,1214,1256
29260,45338,4644,21903,3098,40694,2470,1214,1256
29265,45342,4644,21905,3098,40698,2470,1214,1256
29270,45352,4645,21914,3098,40707,2470,1214,1256
29275,45358,4645,21918,3098,40713,2471,1215,1256
29280,45369,4645,21921,3098,40724,2472,1216,1256
29285,45373,4645,21923,3098,40728,2472,1216,1256
29290,45383,4646,21929,3098,40737,2472,1216,1256
29295,45389,4646,21931,3098,40743,2473,1217,1256
29300,45400,4646,21937,3098,40754,2474,1217,1257
29305,45404,4646,21939,3098,40758,2474,1217,1257
29310,45414,4647,21946,3099,40767,2474,1217,1257
29315,45420,4647,21948,3099,40773,2475,1217,1258
29320,45431,4647,21955,3099,40784,2476,1218,1258
29325,45435,4647,21958,3099,40788,2476,1218,1258
29330,45445,4649,21961,3101,40796,2476,1218,1258
29335,45451,4649,21963,3101,40802,2477,1218,1259
29340,45462,4652,21967,3103,40810,2478,1218,1260
29345,45466,4652,21969,3103,40814,2478,1218,1260
29350,45476,4654,21972,3103,40822,2478,1218,1260
29355,45482,4654,21974,3103,40828,2479,1219,1260
29360,45493,4656,21980,3104,40837,2480,1219,1261
29365,45497,4657,21982,3105,40840,2480,1219,1261
29370,45507,4659,21988,3107,40848,2480,1219,1261
29375,45513,4659,21990,3107,40854,2482,1219,1263
29380,45524,4661,21996,3108,40863,2483,1219,1264
29385,45528,4662,21997,3109,40866,2483,1219,1264
29390,45538,4664,22001,3109,40874,2483,1219,1264
29395,45544,4664,22006,3109,40879,2484,1220,1264
29400,45555,4666,22011,3111,40889,2485,1221,1264
29405,45559,4668,22014,3113,40891,2485,1221,1264
29410,45569,4669,22019,3113,40900,2485,1221,1264
29415,45575,4669,22023,3113,40905,2486,1222,1264
29420,45586,4671,22030,3114,40915,2486,1222,1264
29425,45590,4671,22032,3114,40919,2486,1222,1264
29430,45600,4672,22038,3114,40928,2486,1222,1264
29435,45606,4672,22042,3114,40934,2487,1223,1264
29440,45617,4673,22048,3115,40944,2487,1223,1264
29445,45621,4674,22051,3116,40947,2487,1223,1264
29450,45631,4675,22056,3117,40956,2487,1223,1264
29455,45637,4675,22060,3117,40962,2488,1224,1264
29460,45648,4677,22065,3118,40971,2489,1224,1265
29465,45652,4677,22065,3118,40975,2489,1224,1265
29470,45662,4678,22069,3119,40984,2489,1224,1265
29475,45668,4678,22073,3119,40990,2490,1225,1265
29480,45679,4680,22076,3120,40999,2490,1225,1265
29485,45683,4680,22077,3120,41003,2490,1225,1265
29490,45693,4681,22081,3121,41012,2490,1225,1265
29495,45699,4681,22084,3121,41018,2491,1225,1266
29500,45710,4684,22088,3123,41026,2491,1225,1266
29505,45714,4685,22092,3124,41029,2491,1225,1266
29510,45724,4686,22096,3124,41038,2491,1225,1266
29515,45730,4686,22100,3124,41044,2493,1227,1266
29520,45741,4688,22103,3125,41053,2493,1227,1266
29525,45745,4688,22106,3125,41057,2493,1227,1266
29530,45755,4688,22108,3125,41067,2493,1227,1266
29535,45761,4688,22110,3125,41073,2494,1228,1266
29540,45772,4688,22117,3125,41084,2494,1228,1266
29545,45776,4688,22121,3125,41088,2494,1228,1266
29550,45786,4688,22126,3125,41098,2494,1228,1266
29555,45792,4688,22130,3125,41104,2495,1228,1267
29560,45803,4688,22135,3125,41115,2495,1228,1267
29565,45807,4688,22138,3125,41119,2495,1228,1267
29570,45817,4689,22142,3125,41128,2495,1228,1267
29575,45823,4689,22146,3125,41134,2496,1229,1267
29580,45834,4689,22149,3125,41145,2496,1229,1267
29585,45838,4689,22153,3125,41149,2496,1229,1267
29590,45848,4690,22159,3125,41158,2496,1229,1267
29595,45854,4690,22162,3125,41164,2497,1229,1268
29600,45865,4691,22169,3126,41174,2497,1229,1268
29605,45869,4691,22171,3126,41178,2497,1229,1268
29610,45879,4692,22178,3126,41187,2497,1229,1268
29615,45885,4692,22181,3126,41193,2498,1230,1268
29620,45896,4693,22188,3127,41203,2498,1230,1268
29625,45900,4693,22190,3127,41207,2498,1230,1268
29630,45910,4694,22197,3128,41216,2498,1230,1268
29635,45916,4694,22199,3128,41222,2500,1231,1269
29640,45927,4697,22206,3131,41230,2500,1231,1269
29645,45931,4699,22208,3133,41232,2500,1231,1269
29650,45941,4701,22212,3134,41240,2500,1231,1269
29655,45947,4701,22217,3134,41246,2501,1232,1269
29660,45958,4703,22225,3136,41255,2501,1232,1269
29665,45962,4703,22225,3136,41259,2501,1232,1269
29670,45972,4705,22229,3137,41267,2501,1232,1269
29675,45978,4705,22232,3137,41273,2502,1232,1270
29680,45989,4706,22236,3137,41283,2502,1232,1270
29685,45993,4707,22239,3138,41286,2502,1232,1270
29690,46003,4709,22245,3139,41294,2502,1232,1270
29695,46009,4709,22246,3139,41300,2503,1232,1271
29700,46020,4711,22251,3141,41309,2504,1232,1272
29705,46024,4711,22254,3141,41313,2504,1232,1272
29710,46034,4712,22260,3142,41322,2504,1232,1272
29715,46040,4712,22261,3142,41328,2505,1232,1273
29720,46051,4714,22266,3143,41337,2506,1232,1274
29725,46055,4714,22267,3143,41341,2506,1232,1274
29730,46065,4715,22271,3143,41350,2506,1232,1274
29735,46071,4715,22274,3143,41356,2507,1232,1275
29740,46082,4716,22276,3143,41366,2508,1232,1276
29745,46086,4716,22278,3143,41370,2508,1232,1276
29750,46096,4717,22283,3143,41379,2508,1232,1276
29755,46102,4717,22286,3143,41385,2510,1232,1278
29760,46113,4720,22294,3146,41393,2511,1233,1278
29765,46117,4720,22297,3146,41397,2511,1233,1278
29770,46127,4722,22299,3146,41405,2511,1233,1278
29775,46133,4722,22304,3146,41410,2513,1234,1279
29780,46144,4725,22308,3148,41419,2513,1234,1279
29785,46148,4725,22310,3148,41423,2513,1234,1279
29790,46158,4727,22315,3150,41431,2513,1234,1279
29795,46164,4727,22318,3150,41436,2514,1235,1279
29800,46175,4729,22321,3151,41446,2514,1235,1279
29805,46179,4729,22324,3151,41450,2514,1235,1279
29810,46189,4731,22330,3153,41458,2514,1235,1279
29815,46195,4731,22335,3153,41463,2515,1236,1279
29820,46206,4734,22343,3155,41472,2515,1236,1279
29825,46210,4734,22344,3155,41476,2515,1236,1279
29830,46220,4736,22349,3156,41484,2515,1236,1279
29835,46226,4736,22350,3156,41490,2516,1236,1280
29840,46237,4737,22357,3157,41500,2516,1236,1280
29845,46241,4738,22361,3158,41503,2516,1236,1280
29850,46251,4740,22366,3160,41511,2516,1236,1280
29855,46257,4740,22369,3160,41517,2517,1236,1281
29860,46268,4741,22374,3160,41527,2517,1236,1281
29865,46272,4742,22376,3161,41530,2517,1236,1281
29870,46282,4744,22381,3162,41538,2517,1236,1281
29875,46288,4744,22384,3162,41544,2518,1237,1281
29880,46299,4747,22391,3165,41552,2519,1238,1281
29885,46303,4747,22393,3165,41556,2519,1238,1281
29890,46313,4747,22398,3165,41566,2519,1238,1281
29895,46319,4747,22401,3165,41572,2521,1240,1281
29900,46330,4747,22408,3165,41583,2521,1240,1281
29905,46334,4747,22410,3165,41587,2521,1240,1281
29910,46344,4747,22417,3165,41597,2521,1240,1281
29915,46350,4747,22418,3165,41603,2523,1241,1282
29920,46361,4747,22424,3165,41614,2523,1241,1282
29925,46365,4747,22426,3165,41618,2523,1241,1282
29930,46375,4747,22430,3165,41628,2523,1241,1282
29935,46381,4747,22433,3165,41634,2524,1241,1283
29940,46392,4747,22437,3165,41645,2524,1241,1283
29945,46396,4747,22440,3165,41649,2524,1241,1283
29950,46406,4747,22444,3165,41659,2524,1241,1283
29955,46412,4747,22446,3165,41665,2525,1242,1283
29960,46423,4747,22451,3165,41676,2525,1242,1283
29965,46427,4747,22453,3165,41680,2525,1242,1283
29970,46437,4747,22460,3165,41690,2525,1242,1283
29975,46443,4747,22463,3165,41696,2526,1242,1284
29980,46454,4747,22472,3165,41707,2526,1242,1284
29985,46458,4747,22472,3165,41711,2526,1242,1284
29990,46468,4749,22476,3166,41719,2526,1242,1284
29995,46474,4749,22478,3166,41725,2527,1242,1285
30000,46485,4751,22480,3168,41734,2528,1242,1286
30005,46489,4752,22483,3169,41737,2528,1242,1286
30010,46499,4754,22489,3171,41745,2528,1242,1286
30015,46505,4754,22490,3171,41750,2529,1242,1287
30020,46516,4756,22496,3173,41760,2530,1243,1287
30025,46520,4757,22498,3174,41763,2530,1243,1287
30030,46530,4759,22503,3175,41771,2530,1243,1287
30035,46536,4759,22505,3175,41776,2532,1244,1288
30040,46547,4762,22509,3177,41785,2533,1245,1288
30045,46551,4762,22510,3177,41789,2533,1245,1288
30050,46561,4764,22517,3178,41797,2533,1245,1288
30055,46567,4764,22519,3178,41802,2535,1245,1290
30060,46578,4766,22524,3180,41812,2536,1245,1291
30065,46582,4766,22526,3180,41816,2536,1245,1291
30070,46592,4767,22533,3180,41825,2536,1245,1291
30075,46598,4767,22536,3180,41830,2537,1245,1292
30080,46609,4768,22540,3181,41841,2537,1245,1292
30085,46613,4768,22543,3181,41845,2537,1245,1292
30090,46623,4769,22545,3181,41854,2537,1245,1292
30095,46629,4769,22549,3181,41859,2538,1246,1292
30100,46640,4770,22553,3182,41870,2538,1246,1292
30105,46644,4770,22555,3182,41874,2538,1246,1292
30110,46654,4771,22561,3182,41883,2538,1246,1292
30115,46660,4771,22563,3182,41888,2539,1246,1293
30120,46671,4772,22571,3183,41899,2539,1246,1293
30125,46675,4772,22572,3183,41903,2539,1246,1293
30130,46685,4772,22577,3183,41913,2539,1246,1293
30135,46691,4772,22580,3183,41919,2540,1246,1294
30140,46702,4775,22587,3186,41927,2541,1246,1295
30145,46706,4775,22588,3186,41931,2541,1246,1295
30150,46716,4775,22595,3186,41941,2541,1246,1295
30155,46722,4775,22597,3186,41947,2542,1246,1296
30160,46733,4778,22602,3188,41955,2543,1246,1297
30165,46737,4778,22605,3188,41959,2543,1246,1297
30170,46747,4779,22610,3188,41968,2543,1246,1297
30175,46753,4779,22612,3188,41974,2545,1246,1299
30180,46764,4782,22617,3190,41982,2546,1247,1299
30185,46768,4782,22619,3190,41986,2546,1247,1299
30190,46778,4783,22628,3191,41995,2546,1247,1299
30195,46784,4783,22630,3191,42001,2547,1248,1299
30200,46795,4783,22636,3191,42012,2547,1248,1299
30205,46799,4783,22637,3191,42016,2547,1248,1299
30210,46809,4784,22640,3191,42025,2547,1248,1299
30215,46815,4784,22641,3191,42031,2548,1248,1300
30220,46826,4784,22644,3191,42042,2548,1248,1300
30225,46830,4784,22646,3191,42046,2548,1248,1300
30230,46840,4786,22651,3192,42054,2548,1248,1300
30235,46846,4786,22652,3192,42060,2549,1248,1301
30240,46857,4786,22659,3192,42071,2549,1248,1301
30245,46861,4786,22662,3192,42075,2549,1248,1301
30250,46871,4788,22666,3193,42083,2549,1248,1301
30255,46877,4788,22668,3193,42088,2550,1248,1302
30260,46888,4790,22673,3195,42098,2550,1248,1302
30265,46892,4790,22675,3195,42102,2550,1248,1302
30270,46902,4792,22680,3197,42110,2550,1248,1302
30275,46908,4792,22684,3197,42115,2551,1248,1303
30280,46919,4793,22688,3198,42126,2551,1248,1303
30285,46923,4793,22691,3198,42130,2551,1248,1303
30290,46933,4795,22697,3198,42138,2551,1248,1303
30295,46939,4795,22702,3198,42144,2553,1250,1303
30300,46950,4796,22706,3199,42154,2554,1250,1304
30305,46954,4798,22710,3201,42156,2554,1250,1304
30310,46964,4800,22715,3202,42164,2554,1250,1304
30315,46970,4800,22720,3202,42170,2555,1251,1304
30320,46981,4802,22725,3203,42179,2556,1251,1305
30325,46985,4804,22728,3205,42181,2556,1251,1305
30330,46995,4806,22732,3205,42189,2556,1251,1305
30335,47001,4806,22736,3205,42195,2557,1252,1305
30340,47012,4807,22742,3206,42205,2558,1252,1306
30345,47016,4807,22742,3206,42209,2558,1252,1306
30350,47026,4809,22747,3207,42217,2558,1252,1306
30355,47032,4809,22748,3207,42223,2559,1252,1307
30360,47043,4810,22751,3208,42233,2560,1252,1308
30365,47047,4810,22752,3208,42237,2560,1252,1308
30370,47057,4811,22758,3209,42246,2560,1252,1308
30375,47063,4811,22762,3209,42252,2561,1252,1309
30380,47074,4811,22767,3209,42263,2562,1252,1310
30385,47078,4811,22769,3209,42267,2562,1252,1310
30390,47088,4812,22773,3209,42276,2562,1252,1310
30395,47094,4812,22777,3209,42282,2563,1253,1310
30400,47105,4812,22781,3209,42293,2563,1253,1310
30405,47109,4812,22784,3209,42297,2563,1253,1310
30410,47119,4813,22790,3210,42306,2563,1253,1310
30415,47125,4813,22792,3210,42312,2565,1253,1312
30420,47136,4813,22797,3210,42323,2565,1253,1312
30425,47140,4813,22797,3210,42327,2565,1253,1312
30430,47150,4814,22802,3210,42336,2565,1253,1312
30435,47156,4814,22805,3210,42342,2566,1253,1313
30440,47167,4814,22807,3210,42353,2566,1253,1313
30445,47171,4814,22809,3210,42357,2566,1253,1313
30450,47181,4815,22812,3210,42366,2566,1253,1313
30455,47187,4815,22814,3210,42372,2567,1254,1313
30460,47198,4815,22820,3210,42383,2567,1254,1313
30465,47202,4815,22821,3210,42387,2567,1254,1313
30470,47212,4817,22828,3211,42395,2567,1254,1313
30475,47218,4817,22834,3211,42400,2568,1255,1313
30480,47229,4821,22839,3214,42408,2568,1255,1313
30485,47233,4821,22841,3214,42412,2568,1255,1313
30490,47243,4822,22849,3215,42421,2568,1255,1313
30495,47249,4822,22850,3215,42427,2569,1255,1314
30500,47260,4824,22855,3216,42436,2570,1256,1314
30505,47264,4824,22855,3216,42440,2570,1256,1314
30510,47274,4825,22859,3217,42449,2570,1256,1314
30515,47280,4825,22860,3217,42454,2571,1256,1315
30520,47291,4827,22866,3218,42464,2572,1257,1315
30525,47295,4827,22867,3218,42468,2572,1257,1315
30530,47305,4828,22872,3218,42477,2572,1257,1315
30535,47311,4828,22874,3218,42482,2574,1257,1317
30540,47322,4830,22879,3219,42492,2575,1257,1318
30545,47326,4831,22881,3220,42495,2575,1257,1318
30550,47336,4832,22886,3220,42504,2575,1257,1318
30555,47342,4832,22889,3220,42509,2576,1258,1318
30560,47353,4835,22894,3222,42518,2577,1259,1318
30565,47357,4836,22896,3223,42521,2577,1259,1318
30570,47367,4837,22901,3223,42530,2577,1259,1318
30575,47373,4837,22902,3223,42536,2578,1259,1319
30580,47384,4838,22907,3224,42546,2579,1260,1319
30585,47388,4839,22909,3225,42549,2579,1260,1319
30590,47398,4841,22915,3226,42557,2579,1260,1319
30595,47404,4841,22916,3226,42563,2580,1260,1320
30600,47415,4843,22920,3227,42572,2581,1261,1320
30605,47419,4843,22921,3227,42576,2581,1261,1320
30610,47429,4844,22925,3227,42585,2581,1261,1320
30615,47435,4844,22925,3227,42591,2582,1261,1321
30620,47446,4846,22929,3228,42600,2582,1261,1321
30625,47450,4846,22930,3228,42604,2582,1261,1321
30630,47460,4847,22934,3228,42613,2582,1261,1321
30635,47466,4847,22938,3228,42619,2583,1262,1321
30640,47477,4849,22942,3230,42628,2583,1262,1321
30645,47481,4849,22944,3230,42632,2583,1262,1321
30650,47491,4850,22949,3231,42641,2583,1262,1321
30655,47497,4850,22954,3231,42647,2585,1264,1321
30660,47508,4852,22959,3233,42656,2585,1264,1321
30665,47512,4852,22960,3233,42660,2585,1264,1321
30670,47522,4853,22961,3233,42669,2585,1264,1321
30675,47528,4853,22962,3233,42675,2586,1264,1322
30680,47539,4855,22965,3235,42684,2586,1264,1322
30685,47543,4855,22968,3235,42688,2586,1264,1322
30690,47553,4856,22970,3235,42697,2586,1264,1322
30695,47559,4856,22973,3235,42703,2587,1265,1322
30700,47570,4857,22976,3236,42713,2587,1265,1322
30705,47574,4857,22978,3236,42717,2587,1265,1322
30710,47584,4859,22985,3238,42725,2587,1265,1322
30715,47590,4859,22987,3238,42730,2588,1265,1323
30720,47601,4862,22994,3241,42739,2589,1266,1323
30725,47605,4862,22997,3241,42743,2589,1266,1323
30730,47615,4863,23003,3242,42752,2589,1266,1323
30735,47621,4863,23005,3242,42758,2590,1267,1323
30740,47632,4863,23011,3242,42769,2591,1268,1323
30745,47636,4863,23014,3242,42773,2591,1268,1323
30750,47646,4864,23019,3243,42782,2591,1268,1323
30755,47652,4864,23021,3243,42788,2592,1268,1324
30760,47663,4864,23026,3243,42799,2593,1269,1324
30765,47667,4864,23028,3243,42803,2593,1269,1324
30770,47677,4865,23034,3244,42812,2593,1269,1324
30775,47683,4865,23038,3244,42818,2594,1270,1324
30780,47694,4865,23044,3244,42829,2595,1271,1324
30785,47698,4865,23046,3244,42833,2595,1271,1324
30790,47708,4866,23052,3244,42842,2595,1271,1324
30795,47714,4866,23057,3244,42848,2596,1271,1325
30800,47725,4866,23062,3244,42859,2596,1271,1325
30805,47729,4866,23066,3244,42863,2596,1271,1325
30810,47739,4867,23071,3245,42872,2596,1271,1325
30815,47745,4867,23075,3245,42878,2597,1271,1326
30820,47756,4867,23081,3245,42889,2597,1271,1326
30825,47760,4867,23083,3245,42893,2597,1271,1326
30830,47770,4869,23088,3246,42901,2597,1271,1326
30835,47776,4869,23091,3246,42907,2598,1272,1326
30840,47787,4871,23096,3248,42916,2599,1273,1326
30845,47791,4871,23098,3248,42920,2599,1273,1326
30850,47801,4873,23104,3249,42928,2599,1273,1326
30855,47807,4873,23107,3249,42934,2600,1274,1326
30860,47818,4875,23112,3251,42943,2600,1274,1326
30865,47822,4876,23114,3252,42946,2600,1274,1326
30870,47832,4878,23121,3253,42954,2600,1274,1326
30875,47838,4878,23124,3253,42960,2601,1275,1326
30880,47849,4880,23130,3255,42969,2601,1275,1326
30885,47853,4880,23131,3255,42973,2601,1275,1326
30890,47863,4882,23136,3255,42981,2601,1275,1326
30895,47869,4882,23139,3255,42987,2603,1277,1326
30900,47880,4884,23143,3256,42996,2603,1277,1326
30905,47884,4884,23143,3256,43000,2603,1277,1326
30910,47894,4884,23146,3256,43010,2603,1277,1326
30915,47900,4884,23148,3256,43016,2604,1277,1327
30920,47911,4885,23149,3256,43026,2604,1277,1327
30925,47915,4885,23151,3256,43030,2604,1277,1327
30930,47925,4885,23156,3256,43040,2604,1277,1327
30935,47931,4885,23158,3256,43046,2605,1278,1327
30940,47942,4886,23166,3257,43056,2605,1278,1327
30945,47946,4886,23168,3257,43060,2605,1278,1327
30950,47956,4886,23174,3257,43070,2605,1278,1327
30955,47962,4886,23177,3257,43076,2606,1278,1328
30960,47973,4887,23180,3257,43086,2606,1278,1328
30965,47977,4888,23182,3258,43089,2606,1278,1328
30970,47987,4888,23188,3258,43099,2606,1278,1328
30975,47993,4888,23191,3258,43105,2607,1278,1329
30980,48004,4889,23195,3259,43115,2607,1278,1329
30985,48008,4890,23197,3260,43118,2607,1278,1329
30990,48018,4890,23202,3260,43128,2607,1278,1329
30995,48024,4890,23206,3260,43134,2608,1279,1329
31000,48035,4891,23209,3260,43144,2608,1279,1329
31005,48039,4892,23213,3261,43147,2608,1279,1329
31010,48049,4893,23219,3262,43156,2608,1279,1329
31015,48055,4893,23221,3262,43162,2610,1279,1331
31020,48066,4895,23226,3264,43171,2611,1280,1331
31025,48070,4895,23229,3264,43175,2611,1280,1331
31030,48080,4896,23234,3265,43184,2611,1280,1331
31035,48086,4896,23235,3265,43190,2612,1280,1332
31040,48097,4896,23241,3265,43201,2612,1280,1332
31045,48101,4896,23243,3265,43205,2612,1280,1332
31050,48111,4897,23248,3266,43214,2612,1280,1332
31055,48117,4897,23251,3266,43220,2613,1281,1332
31060,48128,4898,23256,3267,43230,2613,1281,1332
31065,48132,4898,23259,3267,43234,2613,1281,1332
31070,48142,4899,23265,3267,43243,2613,1281,1332
31075,48148,4899,23270,3267,43249,2614,1282,1332
31080,48159,4899,23277,3267,43260,2614,1282,1332
31085,48163,4899,23278,3267,43264,2614,1282,1332
31090,48173,4900,23286,3267,43273,2614,1282,1332
31095,48179,4900,23288,3267,43279,2615,1282,1333
31100,48190,4901,23291,3268,43289,2615,1282,1333
31105,48194,4901,23294,3268,43293,2615,1282,1333
31110,48204,4902,23296,3268,43302,2615,1282,1333
31115,48210,4902,23297,3268,43308,2616,1282,1334
31120,48221,4903,23302,3269,43318,2616,1282,1334
31125,48225,4903,23303,3269,43322,2616,1282,1334
31130,48235,4905,23307,3269,43330,2616,1282,1334
31135,48241,4905,23312,3269,43336,2618,1283,1335
31140,48252,4907,23317,3271,43345,2618,1283,1335
31145,48256,4908,23319,3272,43348,2618,1283,1335
31150,48266,4909,23323,3272,43357,2618,1283,1335
31155,48272,4909,23329,3272,43362,2619,1284,1335
31160,48283,4911,23333,3273,43372,2620,1284,1336
31165,48287,4912,23336,3274,43375,2620,1284,1336
31170,48297,4913,23339,3274,43384,2620,1284,1336
31175,48303,4913,23342,3274,43390,2621,1285,1336
31180,48314,4914,23348,3274,43400,2622,1286,1336
31185,48318,4914,23350,3274,43404,2622,1286,1336
31190,48328,4915,23354,3274,43413,2622,1286,1336
31195,48334,4915,23357,3274,43419,2623,1287,1336
31200,48345,4916,23364,3274,43429,2623,1287,1336
31205,48349,4916,23366,3274,43433,2623,1287,1336
31210,48359,4916,23372,3274,43443,2623,1287,1336
31215,48365,4916,23373,3274,43449,2624,1287,1337
31220,48376,4917,23376,3275,43459,2624,1287,1337
31225,48380,4917,23377,3275,43463,2624,1287,1337
31230,48390,4917,23382,3275,43473,2624,1287,1337
31235,48396,4917,23384,3275,43479,2625,1287,1338
31240,48407,4918,23389,3276,43489,2625,1287,1338
31245,48411,4918,23389,3276,43493,2625,1287,1338
31250,48421,4918,23396,3276,43503,2625,1287,1338
31255,48427,4918,23399,3276,43508,2626,1287,1339
31260,48438,4921,23404,3278,43517,2626,1287,1339
31265,48442,4921,23405,3278,43521,2626,1287,1339
31270,48452,4923,23411,3279,43529,2626,1287,1339
31275,48458,4923,23415,3279,43535,2627,1287,1340
31280,48469,4925,23420,3280,43544,2627,1287,1340
31285,48473,4925,23422,3280,43548,2627,1287,1340
31290,48483,4927,23427,3281,43556,2627,1287,1340
31295,48489,4927,23430,3281,43562,2628,1288,1340
31300,48500,4929,23436,3283,43571,2629,1289,1340
31305,48504,4929,23438,3283,43575,2629,1289,1340
31310,48514,4931,23442,3284,43583,2629,1289,1340
31315,48520,4931,23445,3284,43589,2630,1290,1340
31320,48531,4933,23451,3286,43598,2631,1291,1340
31325,48535,4934,23454,3287,43601,2631,1291,1340
31330,48545,4934,23459,3287,43611,2631,1291,1340
31335,48551,4934,23461,3287,43617,2632,1292,1340
31340,48562,4936,23467,3289,43626,2633,1293,1340
31345,48566,4937,23470,3290,43629,2633,1293,1340
31350,48576,4937,23472,3290,43639,2633,1293,1340
31355,48582,4937,23473,3290,43645,2634,1293,1341
31360,48593,4939,23477,3291,43654,2635,1294,1341
31365,48597,4939,23479,3291,43658,2635,1294,1341
31370,48607,4939,23482,3291,43668,2635,1294,1341
31375,48613,4939,23486,3291,43674,2637,1295,1342
31380,48624,4942,23493,3294,43682,2638,1295,1343
31385,48628,4942,23495,3294,43686,2638,1295,1343
31390,48638,4942,23501,3294,43696,2638,1295,1343
31395,48644,4942,23504,3294,43702,2639,1295,1344
31400,48655,4942,23509,3294,43713,2639,1295,1344
31405,48659,4942,23512,3294,43717,2639,1295,1344
31410,48669,4942,23515,3294,43727,2639,1295,1344
31415,48675,4942,23519,3294,43733,2640,1296,1344
31420,48686,4942,23527,3294,43744,2640,1296,1344
31425,48690,4942,23528,3294,43748,2640,1296,1344
31430,48700,4942,23533,3294,43758,2640,1296,1344
31435,48706,4942,23536,3294,43764,2641,1297,1344
31440,48717,4942,23541,3294,43775,2641,1297,1344
31445,48721,4942,23542,3294,43779,2641,1297,1344
31450,48731,4942,23549,3294,43789,2641,1297,1344
31455,48737,4942,23553,3294,43795,2642,1298,1344
31460,48748,4942,23560,3294,43806,2642,1298,1344
31465,48752,4942,23562,3294,43810,2642,1298,1344
31470,48762,4942,23566,3294,43820,2642,1298,1344
31475,48768,4942,23569,3294,43826,2643,1298,1345
31480,48779,4942,23574,3294,43837,2643,1298,1345
31485,48783,4942,23577,3294,43841,2643,1298,1345
31490,48793,4944,23579,3294,43849,2643,1298,1345
31495,48799,4944,23580,3294,43855,2644,1298,1346
31500,48810,4946,23584,3295,43864,2645,1298,1347
31505,48814,4946,23587,3295,43868,2645,1298,1347
31510,48824,4947,23593,3296,43877,2645,1298,1347
31515,48830,4947,23597,3296,43883,2646,1299,1347
31520,48841,4948,23602,3297,43893,2646,1299,1347
31525,48845,4948,23604,3297,43897,2646,1299,1347
31530,48855,4949,23607,3297,43906,2646,1299,1347
31535,48861,4949,23608,3297,43912,2647,1299,1348
31540,48872,4950,23610,3297,43922,2647,1299,1348
31545,48876,4950,23611,3297,43926,2647,1299,1348
31550,48886,4951,23617,3298,43935,2647,1299,1348
31555,48892,4951,23619,3298,43941,2648,1299,1349
31560,48903,4952,23623,3298,43951,2648,1299,1349
31565,48907,4952,23623,3298,43955,2648,1299,1349
31570,48917,4953,23627,3298,43964,2648,1299,1349
31575,48923,4953,23629,3298,43970,2649,1300,1349
31580,48934,4954,23638,3299,43980,2649,1300,1349
31585,48938,4954,23641,3299,43984,2649,1300,1349
31590,48948,4955,23642,3299,43993,2649,1300,1349
31595,48954,4955,23646,3299,43999,2650,1300,1350
31600,48965,4956,23651,3300,44009,2650,1300,1350
31605,48969,4956,23653,3300,44013,2650,1300,1350
31610,48979,4958,23656,3300,44021,2650,1300,1350
31615,48985,4958,23657,3300,44026,2651,1300,1351
31620,48996,4960,23661,3301,44036,2652,1301,1351
31625,49000,4960,23662,3301,44040,2652,1301,1351
31630,49010,4961,23671,3302,44049,2652,1301,1351
31635,49016,4961,23676,3302,44055,2653,1302,1351
31640,49027,4963,23681,3304,44064,2654,1302,1352
31645,49031,4963,23683,3304,44068,2654,1302,1352
31650,49041,4964,23687,3305,44077,2654,1302,1352
31655,49047,4964,23692,3305,44083,2655,1303,1352
31660,49058,4966,23700,3307,44092,2656,1303,1353
31665,49062,4966,23702,3307,44096,2656,1303,1353
31670,49072,4967,23706,3307,44105,2656,1303,1353
31675,49078,4967,23708,3307,44111,2657,1303,1354
31680,49089,4969,23715,3309,44120,2658,1304,1354
31685,49093,4969,23717,3309,44124,2658,1304,1354
31690,49103,4970,23724,3310,44133,2658,1304,1354
31695,49109,4970,23727,3310,44139,2659,1305,1354
31700,49120,4971,23733,3311,44149,2660,1305,1355
31705,49124,4971,23734,3311,44153,2660,1305,1355
31710,49134,4972,23739,3311,44162,2660,1305,1355
31715,49140,4972,23743,3311,44168,2661,1306,1355
31720,49151,4972,23748,3311,44179,2661,1306,1355
31725,49155,4972,23750,3311,44183,2661,1306,1355
31730,49165,4974,23759,3313,44191,2661,1306,1355
31735,49171,4974,23762,3313,44196,2662,1307,1355
31740,49182,4975,23764,3314,44207,2662,1307,1355
31745,49186,4976,23767,3315,44210,2662,1307,1355
31750,49196,4978,23770,3316,44218,2662,1307,1355
31755,49202,4978,23771,3316,44224,2663,1307,1356
31760,49213,4979,23776,3317,44234,2663,1307,1356
31765,49217,4979,23778,3317,44238,2663,1307,1356
31770,49227,4981,23785,3318,44246,2663,1307,1356
31775,49233,4981,23789,3318,44252,2664,1308,1356
31780,49244,4983,23796,3320,44261,2664,1308,1356
31785,49248,4983,23797,3320,44265,2664,1308,1356
31790,49258,4985,23801,3321,44273,2664,1308,1356
31795,49264,4985,23805,3321,44279,2665,1309,1356
31800,49275,4987,23811,3323,44288,2665,1309,1356
31805,49279,4988,23813,3324,44291,2665,1309,1356
31810,49289,4990,23816,3325,44299,2665,1309,1356
31815,49295,4990,23820,3325,44305,2666,1310,1356
31820,49306,4991,23823,3325,44315,2666,1310,1356
31825,49310,4992,23825,3326,44318,2666,1310,1356
31830,49320,4994,23829,3327,44326,2666,1310,1356
31835,49326,4994,23833,3327,44332,2668,1312,1356
31840,49337,4995,23835,3327,44342,2668,1312,1356
31845,49341,4996,23837,3328,44345,2668,1312,1356
31850,49351,4998,23841,3329,44353,2668,1312,1356
31855,49357,4998,23845,3329,44358,2669,1313,1356
31860,49368,5002,23850,3332,44366,2670,1313,1357
31865,49372,5002,23853,3332,44370,2670,1313,1357
31870,49382,5003,23860,3333,44379,2670,1313,1357
31875,49388,5003,23863,3333,44384,2671,1313,1358
31880,49399,5004,23869,3334,44395,2672,1314,1358
31885,49403,5004,23870,3334,44399,2672,1314,1358
31890,49413,5005,23876,3334,44408,2672,1314,1358
31895,49419,5005,23881,3334,44413,2673,1314,1359
31900,49430,5007,23884,3336,44423,2674,1314,1360
31905,49434,5007,23886,3336,44427,2674,1314,1360
31910,49444,5008,23892,3337,44436,2674,1314,1360
31915,49450,5008,23894,3337,44441,2675,1314,1361
31920,49461,5009,23899,3338,44452,2676,1314,1362
31925,49465,5009,23901,3338,44456,2676,1314,1362
31930,49475,5010,23904,3338,44465,2676,1314,1362
31935,49481,5010,23908,3338,44471,2677,1314,1363
31940,49492,5010,23912,3338,44482,2678,1315,1363
31945,49496,5010,23913,3338,44486,2678,1315,1363
31950,49506,5011,23919,3339,44495,2678,1315,1363
31955,49512,5011,23922,3339,44501,2679,1316,1363
31960,49523,5011,23928,3339,44512,2680,1316,1364
31965,49527,5011,23930,3339,44516,2680,1316,1364
31970,49537,5013,23931,3339,44524,2680,1316,1364
31975,49543,5013,23937,3339,44530,2682,1318,1364
31980,49554,5016,23942,3341,44538,2683,1319,1364
31985,49558,5016,23944,3341,44542,2683,1319,1364
31990,49568,5016,23947,3341,44552,2683,1319,1364
31995,49574,5016,23949,3341,44558,2684,1320,1364
32000,49585,5017,23954,3342,44568,2684,1320,1364
32005,49589,5017,23956,3342,44572,2684,1320,1364
32010,49599,5017,23964,3342,44582,2684,1320,1364
32015,49605,5017,23967,3342,44588,2685,1321,1364
32020,49616,5018,23971,3343,44598,2685,1321,1364
32025,49620,5018,23973,3343,44602,2685,1321,1364
32030,49630,5018,23978,3343,44612,2685,1321,1364
32035,49636,5018,23982,3343,44618,2686,1322,1364
32040,49647,5019,23985,3343,44628,2686,1322,1364
32045,49651,5019,23988,3343,44632,2686,1322,1364
32050,49661,5019,23993,3343,44642,2686,1322,1364
32055,49667,5019,23997,3343,44648,2687,1322,1365
32060,49678,5020,24004,3344,44658,2687,1322,1365
32065,49682,5020,24006,3344,44662,2687,1322,1365
32070,49692,5020,24011,3344,44672,2687,1322,1365
32075,49698,5020,24014,3344,44678,2688,1323,1365
32080,49709,5021,24022,3345,44688,2688,1323,1365
32085,49713,5021,24023,3345,44692,2688,1323,1365
32090,49723,5023,24027,3345,44700,2688,1323,1365
32095,49729,5023,24030,3345,44706,2690,1324,1366
32100,49740,5026,24035,3347,44714,2691,1325,1366
32105,49744,5027,24036,3348,44717,2691,1325,1366
32110,49754,5028,24040,3348,44726,2691,1325,1366
32115,49760,5028,24042,3348,44732,2692,1325,1367
32120,49771,5029,24045,3349,44742,2693,1325,1368
32125,49775,5029,24048,3349,44746,2693,1325,1368
32130,49785,5030,24053,3349,44755,2693,1325,1368
32135,49791,5030,24057,3349,44761,2694,1326,1368
32140,49802,5031,24063,3350,44771,2695,1327,1368
32145,49806,5031,24065,3350,44775,2695,1327,1368
32150,49816,5032,24068,3350,44784,2695,1327,1368
32155,49822,5032,24071,3350,44790,2696,1328,1368
32160,49833,5033,24076,3351,44800,2697,1328,1369
32165,49837,5033,24079,3351,44804,2697,1328,1369
32170,49847,5034,24083,3351,44813,2697,1328,1369
32175,49853,5034,24086,3351,44819,2698,1328,1370
32180,49864,5034,24087,3351,44830,2699,1328,1371
32185,49868,5034,24088,3351,44834,2699,1328,1371
32190,49878,5035,24092,3351,44843,2699,1328,1371
32195,49884,5035,24096,3351,44849,2700,1328,1372
32200,49895,5036,24102,3352,44859,2701,1328,1373
32205,49899,5036,24103,3352,44863,2701,1328,1373
32210,49909,5037,24107,3352,44872,2701,1328,1373
32215,49915,5037,24109,3352,44878,2703,1329,1374
32220,49926,5041,24117,3356,44885,2704,1329,1375
32225,49930,5041,24118,3356,44889,2704,1329,1375
32230,49940,5041,24124,3356,44899,2704,1329,1375
32235,49946,5041,24127,3356,44905,2705,1330,1375
32240,49957,5042,24134,3357,44915,2705,1330,1375
32245,49961,5043,24138,3358,44918,2705,1330,1375
32250,49971,5043,24142,3358,44928,2705,1330,1375
32255,49977,5043,24145,3358,44934,2706,1330,1376
32260,49988,5044,24150,3358,44944,2706,1330,1376
32265,49992,5044,24151,3358,44948,2706,1330,1376
32270,50002,5044,24153,3358,44958,2706,1330,1376
32275,50008,5044,24159,3358,44964,2707,1331,1376
32280,50019,5045,24163,3358,44974,2707,1331,1376
32285,50023,5045,24164,3358,44978,2707,1331,1376
32290,50033,5045,24168,3358,44988,2707,1331,1376
32295,50039,5045,24169,3358,44994,2708,1331,1377
32300,50050,5046,24173,3358,45004,2708,1331,1377
32305,50054,5046,24174,3358,45008,2708,1331,1377
32310,50064,5046,24179,3358,45018,2708,1331,1377
32315,50070,5046,24181,3358,45024,2709,1331,1378
32320,50081,5047,24185,3358,45034,2709,1331,1378
32325,50085,5047,24187,3358,45038,2709,1331,1378
32330,50095,5049,24190,3358,45046,2709,1331,1378
32335,50101,5049,24192,3358,45052,2710,1332,1378
32340,50112,5051,24196,3360,45061,2711,1332,1379
32345,50116,5051,24197,3360,45065,2711,1332,1379
32350,50126,5052,24202,3361,45074,2711,1332,1379
32355,50132,5052,24206,3361,45080,2712,1333,1379
32360,50143,5053,24213,3362,45090,2712,1333,1379
32365,50147,5053,24215,3362,45094,2712,1333,1379
32370,50157,5054,24219,3363,45103,2712,1333,1379
32375,50163,5054,24223,3363,45109,2713,1334,1379
32380,50174,5055,24227,3364,45119,2713,1334,1379
32385,50178,5055,24228,3364,45123,2713,1334,1379
32390,50188,5056,24231,3364,45132,2713,1334,1379
32395,50194,5056,24234,3364,45138,2714,1335,1379
32400,50205,5057,24239,3365,45148,2714,1335,1379
32405,50209,5057,24241,3365,45152,2714,1335,1379
32410,50219,5058,24243,3366,45161,2714,1335,1379
32415,50225,5058,24248,3366,45167,2715,1336,1379
32420,50236,5059,24254,3367,45177,2715,1336,1379
32425,50240,5059,24257,3367,45181,2715,1336,1379
32430,50250,5060,24264,3368,45190,2715,1336,1379
32435,50256,5060,24268,3368,45196,2717,1337,1380
32440,50267,5061,24274,3369,45206,2717,1337,1380
32445,50271,5061,24276,3369,45210,2717,1337,1380
32450,50281,5063,24282,3369,45218,2717,1337,1380
32455,50287,5063,24285,3369,45224,2719,1338,1381
32460,50298,5066,24289,3371,45232,2719,1338,1381
32465,50302,5067,24290,3372,45235,2719,1338,1381
32470,50312,5067,24297,3372,45245,2719,1338,1381
32475,50318,5067,24300,3372,45251,2720,1338,1382
32480,50329,5068,24304,3373,45261,2720,1338,1382
32485,50333,5068,24307,3373,45265,2720,1338,1382
32490,50343,5068,24312,3373,45275,2720,1338,1382
32495,50349,5068,24313,3373,45281,2721,1338,1383
32500,50360,5070,24320,3375,45290,2722,1339,1383
32505,50364,5071,24323,3376,45293,2722,1339,1383
32510,50374,5071,24328,3376,45303,2722,1339,1383
32515,50380,5071,24331,3376,45309,2723,1339,1384
32520,50391,5073,24336,3378,45318,2724,1339,1385
32525,50395,5073,24339,3378,45322,2724,1339,1385
32530,50405,5073,24342,3378,45332,2724,1339,1385
32535,50411,5073,24346,3378,45338,2725,1340,1385
32540,50422,5073,24352,3378,45349,2726,1341,1385
32545,50426,5073,24354,3378,45353,2726,1341,1385
32550,50436,5073,24360,3378,45363,2726,1341,1385
32555,50442,5073,24363,3378,45369,2727,1341,1386
32560,50453,5073,24369,3378,45380,2728,1342,1386
32565,50457,5073,24371,3378,45384,2728,1342,1386
32570,50467,5074,24376,3378,45393,2728,1342,1386
32575,50473,5074,24380,3378,45399,2730,1344,1386
32580,50484,5075,24384,3379,45409,2731,1345,1386
32585,50488,5076,24386,3380,45412,2731,1345,1386
32590,50498,5078,24390,3381,45420,2731,1345,1386
32595,50504,5078,24394,3381,45426,2732,1346,1386
32600,50515,5079,24397,3382,45436,2732,1346,1386
32605,50519,5079,24397,3382,45440,2732,1346,1386
32610,50529,5081,24402,3383,45448,2732,1346,1386
32615,50535,5081,24403,3383,45454,2733,1346,1387
32620,50546,5084,24408,3385,45462,2733,1346,1387
32625,50550,5084,24410,3385,45466,2733,1346,1387
32630,50560,5086,24413,3385,45474,2733,1346,1387
32635,50566,5086,24416,3385,45480,2734,1347,1387
32640,50577,5088,24419,3387,45489,2734,1347,1387
32645,50581,5088,24421,3387,45493,2734,1347,1387
32650,50591,5089,24425,3387,45502,2734,1347,1387
32655,50597,5089,24429,3387,45508,2735,1348,1387
32660,50608,5091,24436,3388,45517,2735,1348,1387
32665,50612,5092,24440,3389,45520,2735,1348,1387
32670,50622,5093,24445,3390,45529,2735,1348,1387
32675,50628,5093,24447,3390,45535,2736,1348,1388
32680,50639,5094,24450,3390,45545,2736,1348,1388
32685,50643,5095,24452,3391,45548,2736,1348,1388
32690,50653,5096,24457,3392,45557,2736,1348,1388
32695,50659,5096,24459,3392,45562,2738,1348,1390
32700,50670,5099,24466,3395,45571,2739,1349,1390
32705,50674,5099,24468,3395,45575,2739,1349,1390
32710,50684,5099,24474,3395,45585,2739,1349,1390
32715,50690,5099,24477,3395,45591,2740,1350,1390
32720,50701,5099,24481,3395,45602,2740,1350,1390
32725,50705,5099,24483,3395,45606,2740,1350,1390
32730,50715,5099,24489,3395,45616,2740,1350,1390
32735,50721,5099,24494,3395,45622,2741,1351,1390
32740,50732,5099,24501,3395,45633,2741,1351,1390
32745,50736,5099,24503,3395,45637,2741,1351,1390
32750,50746,5099,24509,3395,45647,2741,1351,1390
32755,50752,5099,24511,3395,45653,2742,1352,1390
32760,50763,5099,24514,3395,45664,2742,1352,1390
32765,50767,5099,24515,3395,45668,2742,1352,1390
32770,50777,5099,24519,3395,45678,2742,1352,1390
32775,50783,5099,24521,3395,45684,2743,1352,1391
32780,50794,5099,24526,3395,45695,2743,1352,1391
32785,50798,5099,24528,3395,45699,2743,1352,1391
32790,50808,5099,24535,3395,45709,2743,1352,1391
32795,50814,5099,24540,3395,45715,2744,1353,1391
32800,50825,5099,24546,3395,45726,2744,1353,1391
32805,50829,5099,24549,3395,45730,2744,1353,1391
32810,50839,5101,24553,3395,45738,2744,1353,1391
32815,50845,5101,24557,3395,45744,2746,1354,1392
32820,50856,5103,24562,3396,45753,2747,1355,1392
32825,50860,5104,24565,3397,45756,2747,1355,1392
32830,50870,5105,24569,3398,45765,2747,1355,1392
32835,50876,5105,24573,3398,45771,2748,1356,1392
32840,50887,5106,24579,3399,45781,2748,1356,1392
32845,50891,5107,24581,3400,45784,2748,1356,1392
32850,50901,5108,24585,3400,45793,2748,1356,1392
32855,50907,5108,24587,3400,45799,2749,1356,1393
32860,50918,5109,24590,3400,45809,2749,1356,1393
32865,50922,5109,24590,3400,45813,2749,1356,1393
32870,50932,5110,24597,3401,45822,2749,1356,1393
32875,50938,5110,24598,3401,45828,2750,1356,1394
32880,50949,5112,24602,3402,45837,2750,1356,1394
32885,50953,5112,24604,3402,45841,2750,1356,1394
32890,50963,5113,24608,3403,45850,2750,1356,1394
32895,50969,5113,24613,3403,45856,2751,1357,1394
32900,50980,5114,24618,3404,45866,2751,1357,1394
32905,50984,5114,24621,3404,45870,2751,1357,1394
32910,50994,5115,24625,3404,45879,2751,1357,1394
32915,51000,5115,24630,3404,45885,2752,1357,1395
32920,51011,5116,24633,3405,45895,2752,1357,1395
32925,51015,5116,24634,3405,45899,2752,1357,1395
32930,51025,5118,24640,3406,45907,2752,1357,1395
32935,51031,5118,24641,3406,45913,2754,1358,1396
32940,51042,5119,24646,3406,45923,2754,1358,1396
32945,51046,5121,24649,3408,45925,2754,1358,1396
32950,51056,5123,24655,3410,45933,2754,1358,1396
32955,51062,5123,24658,3410,45939,2755,1358,1397
32960,51073,5124,24664,3411,45949,2755,1358,1397
32965,51077,5124,24666,3411,45953,2755,1358,1397
32970,51087,5125,24673,3412,45962,2755,1358,1397
32975,51093,5125,24675,3412,45968,2756,1358,1398
32980,51104,5125,24680,3412,45979,2756,1358,1398
32985,51108,5125,24682,3412,45983,2756,1358,1398
32990,51118,5126,24687,3413,45992,2756,1358,1398
32995,51124,5126,24689,3413,45998,2757,1358,1399
33000,51135,5126,24692,3413,46009,2758,1358,1400
33005,51139,5126,24692,3413,46013,2758,1358,1400
33010,51149,5127,24699,3414,46022,2758,1358,1400
33015,51155,5127,24702,3414,46028,2759,1359,1400
33020,51166,5128,24709,3415,46038,2760,1359,1401
33025,51170,5128,24713,3415,46042,2760,1359,1401
33030,51180,5129,24717,3415,46051,2760,1359,1401
33035,51186,5129,24719,3415,46057,2761,1360,1401
33040,51197,5130,24725,3416,46067,2762,1360,1402
33045,51201,5130,24726,3416,46071,2762,1360,1402
33050,51211,5131,24733,3417,46080,2762,1360,1402
33055,51217,5131,24736,3417,46085,2764,1361,1403
33060,51228,5133,24740,3419,46095,2765,1361,1404
33065,51232,5133,24741,3419,46099,2765,1361,1404
33070,51242,5134,24746,3419,46108,2765,1361,1404
33075,51248,5134,24749,3419,46114,2766,1362,1404
33080,51259,5135,24752,3419,46124,2766,1362,1404
33085,51263,5137,24756,3421,46126,2766,1362,1404
33090,51273,5138,24760,3422,46135,2766,1362,1404
33095,51279,5138,24765,3422,46141,2767,1363,1404
33100,51290,5139,24770,3422,46151,2767,1363,1404
33105,51294,5139,24771,3422,46155,2767,1363,1404
33110,51304,5140,24778,3423,46164,2767,1363,1404
33115,51310,5140,24781,3423,46170,2768,1364,1404
33120,51321,5141,24787,3424,46180,2768,1364,1404
33125,51325,5143,24790,3426,46182,2768,1364,1404
33130,51335,5144,24794,3426,46191,2768,1364,1404
33135,51341,5144,24798,3426,46197,2769,1364,1405
33140,51352,5145,24800,3427,46207,2769,1364,1405
33145,51356,5147,24803,3429,46209,2769,1364,1405
33150,51366,5148,24809,3429,46218,2769,1364,1405
33155,51372,5148,24810,3429,46224,2770,1364,1406
33160,51383,5149,24815,3429,46234,2770,1364,1406
33165,51387,5149,24816,3429,46238,2770,1364,1406
33170,51397,5151,24821,3431,46246,2770,1364,1406
33175,51403,5151,24822,3431,46252,2772,1365,1407
33180,51414,5153,24827,3433,46261,2773,1365,1408
33185,51418,5153,24829,3433,46265,2773,1365,1408
33190,51428,5154,24837,3433,46274,2773,1365,1408
33195,51434,5154,24841,3433,46280,2774,1366,1408
33200,51445,5155,24847,3434,46290,2775,1367,1408
33205,51449,5155,24848,3434,46294,2775,1367,1408
33210,51459,5156,24852,3435,46303,2775,1367,1408
33215,51465,5156,24854,3435,46309,2776,1367,1409
33220,51476,5157,24858,3436,46319,2777,1367,1410
33225,51480,5157,24860,3436,46323,2777,1367,1410
33230,51490,5158,24866,3437,46332,2777,1367,1410
33235,51496,5158,24867,3437,46338,2778,1367,1411
33240,51507,5160,24872,3439,46347,2779,1367,1412
33245,51511,5160,24873,3439,46351,2779,1367,1412
33250,51521,5161,24876,3440,46360,2779,1367,1412
33255,51527,5161,24877,3440,46366,2780,1368,1412
33260,51538,5161,24883,3440,46377,2780,1368,1412
33265,51542,5161,24886,3440,46381,2780,1368,1412
33270,51552,5162,24888,3440,46390,2780,1368,1412
33275,51558,5162,24892,3440,46396,2781,1369,1412
33280,51569,5163,24898,3441,46406,2781,1369,1412
33285,51573,5163,24900,3441,46410,2781,1369,1412
33290,51583,5165,24903,3441,46418,2781,1369,1412
33295,51589,5165,24907,3441,46424,2783,1370,1413
33300,51600,5168,24914,3444,46432,2783,1370,1413
33305,51604,5169,24916,3445,46435,2783,1370,1413
33310,51614,5171,24919,3445,46443,2783,1370,1413
33315,51620,5171,24921,3445,46449,2784,1371,1413
33320,51631,5173,24925,3446,46458,2784,1371,1413
33325,51635,5174,24926,3447,46461,2784,1371,1413
33330,51645,5176,24931,3447,46469,2784,1371,1413
33335,51651,5176,24934,3447,46475,2785,1371,1414
33340,51662,5177,24940,3448,46485,2785,1371,1414
33345,51666,5178,24941,3449,46488,2785,1371,1414
33350,51676,5180,24945,3449,46496,2785,1371,1414
33355,51682,5180,24948,3449,46502,2786,1372,1414
33360,51693,5182,24953,3450,46511,2787,1373,1414
33365,51697,5182,24956,3450,46515,2787,1373,1414
33370,51707,5184,24959,3451,46523,2787,1373,1414
33375,51713,5184,24961,3451,46529,2788,1373,1415
33380,51724,5184,24966,3451,46540,2789,1374,1415
33385,51728,5185,24969,3452,46543,2789,1374,1415
33390,51738,5187,24974,3453,46551,2789,1374,1415
33395,51744,5187,24977,3453,46557,2790,1375,1415
33400,51755,5187,24982,3453,46568,2791,1376,1415
33405,51759,5188,24984,3454,46571,2791,1376,1415
33410,51769,5190,24992,3456,46579,2791,1376,1415
33415,51775,5190,24995,3456,46584,2793,1378,1415
33420,51786,5192,25000,3458,46594,2794,1378,1416
33425,51790,5192,25002,3458,46598,2794,1378,1416
33430,51800,5193,25008,3459,46607,2794,1378,1416
33435,51806,5193,25009,3459,46612,2795,1378,1417
33440,51817,5195,25014,3461,46622,2796,1378,1418
33445,51821,5195,25016,3461,46626,2796,1378,1418
33450,51831,5196,25023,3461,46635,2796,1378,1418
33455,51837,5196,25028,3461,46641,2797,1379,1418
33460,51848,5199,25036,3463,46649,2798,1380,1418
33465,51852,5199,25038,3463,46653,2798,1380,1418
33470,51862,5200,25043,3464,46662,2798,1380,1418
33475,51868,5200,25045,3464,46668,2799,1380,1419
33480,51879,5202,25048,3465,46677,2800,1380,1420
33485,51883,5203,25050,3466,46680,2800,1380,1420
33490,51893,5203,25053,3466,46690,2800,1380,1420
33495,51899,5203,25057,3466,46696,2801,1381,1420
33500,51910,5205,25061,3467,46705,2801,1381,1420
33505,51914,5205,25064,3467,46709,2801,1381,1420
33510,51924,5205,25068,3467,46719,2801,1381,1420
33515,51930,5205,25072,3467,46725,2802,1381,1421
33520,51941,5207,25075,3468,46734,2802,1381,1421
33525,51945,5207,25077,3468,46738,2802,1381,1421
33530,51955,5208,25083,3468,46747,2802,1381,1421
33535,51961,5208,25085,3468,46753,2804,1382,1422
33540,51972,5210,25092,3470,46762,2804,1382,1422
33545,51976,5210,25094,3470,46766,2804,1382,1422
33550,51986,5211,25099,3470,46775,2804,1382,1422
33555,51992,5211,25101,3470,46781,2805,1382,1423
33560,52003,5211,25105,3470,46792,2805,1382,1423
33565,52007,5211,25106,3470,46796,2805,1382,1423
33570,52017,5212,25112,3471,46805,2805,1382,1423
33575,52023,5212,25116,3471,46810,2806,1382,1424
33580,52034,5214,25120,3473,46820,2806,1382,1424
33585,52038,5214,25122,3473,46824,2806,1382,1424
33590,52048,5215,25129,3474,46833,2806,1382,1424
33595,52054,5215,25133,3474,46839,2807,1383,1424
33600,52065,5215,25138,3474,46850,2808,1384,1424
33605,52069,5215,25140,3474,46854,2808,1384,1424
33610,52079,5215,25148,3474,46864,2808,1384,1424
33615,52085,5215,25151,3474,46870,2809,1385,1424
33620,52096,5215,25154,3474,46881,2810,1386,1424
33625,52100,5215,25155,3474,46885,2810,1386,1424
33630,52110,5215,25158,3474,46895,2810,1386,1424
33635,52116,5215,25159,3474,46901,2811,1386,1425
33640,52127,5215,25162,3474,46912,2812,1386,1426
33645,52131,5215,25163,3474,46916,2812,1386,1426
33650,52141,5216,25167,3475,46925,2812,1386,1426
33655,52147,5216,25170,3475,46931,2814,1388,1426
33660,52158,5219,25176,3477,46939,2815,1388,1427
33665,52162,5219,25177,3477,46943,2815,1388,1427
33670,52172,5220,25182,3478,46952,2815,1388,1427
33675,52178,5220,25185,3478,46958,2816,1388,1428
33680,52189,5223,25190,3481,46966,2817,1389,1428
33685,52193,5223,25192,3481,46970,2817,1389,1428
33690,52203,5224,25196,3481,46979,2817,1389,1428
33695,52209,5224,25198,3481,46985,2818,1390,1428
33700,52220,5227,25204,3484,46993,2819,1390,1429
33705,52224,5227,25208,3484,46997,2819,1390,1429
33710,52234,5229,25216,3485,47005,2819,1390,1429
33715,52240,5229,25218,3485,47011,2820,1390,1430
33720,52251,5230,25221,3486,47021,2821,1391,1430
33725,52255,5230,25224,3486,47025,2821,1391,1430
33730,52265,5231,25231,3486,47034,2821,1391,1430
33735,52271,5231,25232,3486,47040,2822,1391,1431
33740,52282,5232,25241,3487,47050,2823,1392,1431
33745,52286,5232,25243,3487,47054,2823,1392,1431
33750,52296,5233,25250,3487,47063,2823,1392,1431
33755,52302,5233,25255,3487,47068,2824,1392,1432
33760,52313,5235,25261,3489,47078,2824,1392,1432
33765,52317,5235,25262,3489,47082,2824,1392,1432
33770,52327,5236,25266,3489,47091,2824,1392,1432
33775,52333,5236,25269,3489,47096,2826,1393,1433
33780,52344,5238,25272,3490,47106,2826,1393,1433
33785,52348,5240,25274,3492,47108,2826,1393,1433
33790,52358,5241,25280,3492,47117,2826,1393,1433
33795,52364,5241,25281,3492,47123,2827,1393,1434
33800,52375,5243,25286,3493,47132,2827,1393,1434
33805,52379,5245,25288,3495,47134,2827,1393,1434
33810,52389,5246,25293,3495,47143,2827,1393,1434
33815,52395,5246,25296,3495,47149,2828,1393,1435
33820,52406,5247,25301,3495,47159,2828,1393,1435
33825,52410,5248,25303,3496,47162,2828,1393,1435
33830,52420,5250,25307,3496,47170,2828,1393,1435
33835,52426,5250,25309,3496,47176,2829,1394,1435
33840,52437,5251,25314,3497,47186,2829,1394,1435
33845,52441,5251,25314,3497,47190,2829,1394,1435
33850,52451,5252,25318,3497,47199,2829,1394,1435
33855,52457,5252,25321,3497,47205,2830,1394,1436
33860,52468,5252,25327,3497,47216,2830,1394,1436
33865,52472,5252,25328,3497,47220,2830,1394,1436
33870,52482,5253,25334,3498,47229,2830,1394,1436
33875,52488,5253,25336,3498,47235,2831,1394,1437
33880,52499,5253,25343,3498,47246,2832,1394,1438
33885,52503,5253,25344,3498,47250,2832,1394,1438
33890,52513,5254,25347,3498,47259,2832,1394,1438
33895,52519,5254,25350,3498,47265,2834,1395,1439
33900,52530,5254,25357,3498,47276,2835,1395,1440
33905,52534,5254,25358,3498,47280,2835,1395,1440
33910,52544,5255,25359,3498,47289,2835,1395,1440
33915,52550,5255,25361,3498,47295,2836,1396,1440
33920,52561,5255,25366,3498,47306,2836,1396,1440
33925,52565,5255,25367,3498,47310,2836,1396,1440
33930,52575,5256,25373,3498,47319,2836,1396,1440
33935,52581,5256,25373,3498,47325,2837,1396,1441
33940,52592,5256,25379,3498,47336,2837,1396,1441
33945,52596,5256,25381,3498,47340,2837,1396,1441
33950,52606,5258,25387,3499,47348,2837,1396,1441
33955,52612,5258,25390,3499,47354,2838,1397,1441
33960,52623,5261,25395,3502,47362,2839,1398,1441
33965,52627,5261,25397,3502,47366,2839,1398,1441
33970,52637,5263,25403,3503,47374,2839,1398,1441
33975,52643,5263,25403,3503,47380,2840,1398,1442
33980,52654,5264,25406,3503,47390,2841,1398,1443
33985,52658,5264,25406,3503,47394,2841,1398,1443
33990,52668,5266,25412,3503,47402,2841,1398,1443
33995,52674,5266,25415,3503,47408,2842,1398,1444
34000,52685,5268,25420,3505,47417,2843,1398,1445
34005,52689,5268,25421,3505,47421,2843,1398,1445
34010,52699,5270,25426,3507,47429,2843,1398,1445
34015,52705,5270,25427,3507,47435,2845,1399,1446
34020,52716,5272,25431,3508,47444,2846,1400,1446
34025,52720,5272,25431,3508,47448,2846,1400,1446
34030,52730,5274,25435,3509,47456,2846,1400,1446
34035,52736,5274,25437,3509,47462,2847,1401,1446
34040,52747,5276,25444,3510,47471,2848,1401,1447
34045,52751,5277,25446,3511,47474,2848,1401,1447
34050,52761,5279,25453,3513,47482,2848,1401,1447
34055,52767,5279,25456,3513,47488,2849,1402,1447
34060,52778,5281,25461,3514,47497,2850,1403,1447
34065,52782,5281,25463,3514,47501,2850,1403,1447
34070,52792,5283,25467,3515,47509,2850,1403,1447
34075,52798,5283,25472,3515,47515,2851,1404,1447
34080,52809,5285,25477,3517,47524,2852,1404,1448
34085,52813,5286,25480,3518,47527,2852,1404,1448
34090,52823,5288,25483,3518,47535,2852,1404,1448
34095,52829,5288,25485,3518,47541,2853,1404,1449
34100,52840,5289,25492,3519,47551,2853,1404,1449
34105,52844,5290,25495,3520,47554,2853,1404,1449
34110,52854,5292,25499,3521,47562,2853,1404,1449
34115,52860,5292,25502,3521,47568,2854,1405,1449
34120,52871,5293,25507,3522,47578,2854,1405,1449
34125,52875,5293,25509,3522,47582,2854,1405,1449
34130,52885,5295,25515,3522,47590,2854,1405,1449
34135,52891,5295,25519,3522,47595,2856,1406,1450
34140,52902,5296,25525,3523,47606,2856,1406,1450
34145,52906,5297,25529,3524,47609,2856,1406,1450
34150,52916,5299,25531,3524,47617,2856,1406,1450
34155,52922,5299,25535,3524,47623,2857,1406,1451
34160,52933,5300,25538,3525,47633,2857,1406,1451
34165,52937,5300,25539,3525,47637,2857,1406,1451
34170,52947,5302,25545,3525,47645,2857,1406,1451
34175,52953,5302,25548,3525,47651,2858,1406,1452
34180,52964,5303,25553,3526,47661,2858,1406,1452
34185,52968,5303,25553,3526,47665,2858,1406,1452
34190,52978,5305,25557,3527,47673,2858,1406,1452
34195,52984,5305,25560,3527,47679,2859,1407,1452
34200,52995,5307,25566,3529,47688,2860,1407,1453
34205,52999,5308,25568,3530,47691,2860,1407,1453
34210,53009,5308,25575,3530,47701,2860,1407,1453
34215,53015,5308,25576,3530,47707,2861,1407,1454
34220,53026,5309,25583,3531,47717,2862,1407,1455
34225,53030,5310,25586,3532,47720,2862,1407,1455
34230,53040,5310,25593,3532,47730,2862,1407,1455
34235,53046,5310,25597,3532,47736,2863,1408,1455
34240,53057,5311,25603,3533,47746,2864,1408,1456
34245,53061,5311,25605,3533,47750,2864,1408,1456
34250,53071,5311,25609,3533,47760,2864,1408,1456
34255,53077,5311,25611,3533,47766,2866,1409,1457
34260,53088,5312,25616,3534,47776,2866,1409,1457
34265,53092,5312,25619,3534,47780,2866,1409,1457
34270,53102,5312,25623,3534,47790,2866,1409,1457
34275,53108,5312,25628,3534,47796,2867,1410,1457
34280,53119,5313,25632,3535,47806,2867,1410,1457
34285,53123,5313,25634,3535,47810,2867,1410,1457
34290,53133,5313,25638,3535,47820,2867,1410,1457
34295,53139,5313,25640,3535,47826,2868,1410,1458
34300,53150,5314,25644,3535,47836,2868,1410,1458
34305,53154,5314,25644,3535,47840,2868,1410,1458
34310,53164,5316,25650,3536,47848,2868,1410,1458
34315,53170,5316,25652,3536,47854,2869,1410,1459
34320,53181,5319,25657,3539,47862,2869,1410,1459
34325,53185,5320,25658,3540,47865,2869,1410,1459
34330,53195,5322,25660,3540,47873,2869,1410,1459
34335,53201,5322,25665,3540,47879,2870,1411,1459
34340,53212,5323,25671,3541,47889,2870,1411,1459
34345,53216,5324,25675,3542,47892,2870,1411,1459
34350,53226,5326,25681,3543,47900,2870,1411,1459
34355,53232,5326,25684,3543,47906,2871,1412,1459
34360,53243,5329,25690,3546,47914,2872,1412,1460
34365,53247,5329,25692,3546,47918,2872,1412,1460
34370,53257,5331,25698,3547,47926,2872,1412,1460
34375,53263,5331,25700,3547,47932,2874,1412,1462
34380,53274,5334,25706,3549,47940,2875,1413,1462
34385,53278,5334,25708,3549,47944,2875,1413,1462
34390,53288,5335,25711,3550,47953,2875,1413,1462
34395,53294,5335,25713,3550,47959,2876,1413,1463
34400,53305,5335,25718,3550,47970,2877,1413,1464
34405,53309,5335,25722,3550,47974,2877,1413,1464
34410,53319,5336,25726,3550,47983,2877,1413,1464
34415,53325,5336,25730,3550,47989,2878,1414,1464
34420,53336,5337,25737,3551,47999,2879,1415,1464
34425,53340,5337,25739,3551,48003,2879,1415,1464
34430,53350,5338,25746,3551,48012,2879,1415,1464
34435,53356,5338,25748,3551,48018,2880,1416,1464
34440,53367,5339,25753,3552,48028,2881,1417,1464
34445,53371,5339,25756,3552,48032,2881,1417,1464
34450,53381,5339,25759,3552,48042,2881,1417,1464
34455,53387,5339,25761,3552,48048,2882,1417,1465
34460,53398,5339,25763,3552,48059,2883,1417,1466
34465,53402,5339,25766,3552,48063,2883,1417,1466
34470,53412,5339,25770,3552,48073,2883,1417,1466
34475,53418,5339,25772,3552,48079,2884,1417,1467
34480,53429,5339,25774,3552,48090,2884,1417,1467
34485,53433,5339,25774,3552,48094,2884,1417,1467
34490,53443,5340,25781,3553,48103,2884,1417,1467
34495,53449,5340,25785,3553,48109,2886,1418,1468
34500,53460,5341,25790,3553,48119,2886,1418,1468
34505,53464,5342,25791,3554,48122,2886,1418,1468
34510,53474,5344,25796,3555,48130,2886,1418,1468
34515,53480,5344,25800,3555,48136,2888,1419,1469
34520,53491,5346,25808,3556,48145,2888,1419,1469
34525,53495,5347,25810,3557,48148,2888,1419,1469
34530,53505,5349,25816,3559,48156,2888,1419,1469
34535,53511,5349,25820,3559,48162,2889,1420,1469
34540,53522,5350,25825,3560,48172,2889,1420,1469
34545,53526,5351,25827,3561,48175,2889,1420,1469
34550,53536,5353,25831,3562,48183,2889,1420,1469
34555,53542,5353,25833,3562,48189,2890,1420,1470
34560,53553,5355,25840,3564,48198,2890,1420,1470
34565,53557,5355,25842,3564,48202,2890,1420,1470
34570,53567,5356,25849,3565,48211,2890,1420,1470
34575,53573,5356,25852,3565,48217,2891,1421,1470
34580,53584,5358,25857,3566,48226,2891,1421,1470
34585,53588,5359,25858,3567,48229,2891,1421,1470
34590,53598,5360,25860,3568,48238,2891,1421,1470
34595,53604,5360,25861,3568,48244,2892,1421,1471
34600,53615,5362,25868,3570,48253,2892,1421,1471
34605,53619,5363,25869,3571,48256,2892,1421,1471
34610,53629,5364,25871,3571,48265,2892,1421,1471
34615,53635,5364,25872,3571,48271,2893,1421,1472
34620,53646,5367,25882,3574,48279,2894,1422,1472
34625,53650,5368,25886,3575,48282,2894,1422,1472
34630,53660,5368,25890,3575,48292,2894,1422,1472
34635,53666,5368,25893,3575,48298,2896,1422,1474
34640,53677,5368,25899,3575,48309,2897,1423,1474
34645,53681,5368,25901,3575,48313,2897,1423,1474
34650,53691,5368,25907,3575,48323,2897,1423,1474
34655,53697,5368,25912,3575,48329,2899,1425,1474
34660,53708,5368,25916,3575,48340,2900,1425,1475
34665,53712,5368,25918,3575,48344,2900,1425,1475
34670,53722,5369,25925,3576,48353,2900,1425,1475
34675,53728,5369,25929,3576,48359,2901,1425,1476
34680,53739,5369,25936,3576,48370,2902,1426,1476
34685,53743,5370,25939,3577,48373,2902,1426,1476
34690,53753,5372,25945,3579,48381,2902,1426,1476
34695,53759,5372,25948,3579,48387,2903,1426,1477
34700,53770,5374,25953,3581,48396,2904,1427,1477
34705,53774,5375,25956,3582,48399,2904,1427,1477
34710,53784,5377,25963,3583,48407,2904,1427,1477
34715,53790,5377,25964,3583,48413,2905,1427,1478
34720,53801,5379,25969,3584,48422,2906,1427,1479
34725,53805,5381,25972,3586,48424,2906,1427,1479
34730,53815,5383,25978,3587,48432,2906,1427,1479
34735,53821,5383,25980,3587,48437,2907,1427,1480
34740,53832,5387,25984,3590,48445,2908,1427,1481
34745,53836,5387,25984,3590,48449,2908,1427,1481
34750,53846,5388,25990,3591,48458,2908,1427,1481
34755,53852,5388,25991,3591,48464,2909,1427,1482
34760,53863,5389,25999,3592,48474,2909,1427,1482
34765,53867,5389,26001,3592,48478,2909,1427,1482
34770,53877,5390,26005,3592,48487,2909,1427,1482
34775,53883,5390,26008,3592,48493,2910,1427,1483
34780,53894,5392,26014,3594,48502,2910,1427,1483
34785,53898,5392,26015,3594,48506,2910,1427,1483
34790,53908,5393,26018,3594,48515,2910,1427,1483
34795,53914,5393,26020,3594,48521,2912,1428,1484
34800,53925,5393,26025,3594,48532,2912,1428,1484
34805,53929,5393,26025,3594,48536,2912,1428,1484
34810,53939,5393,26030,3594,48546,2912,1428,1484
34815,53945,5393,26032,3594,48552,2913,1428,1485
34820,53956,5393,26037,3594,48563,2913,1428,1485
34825,53960,5393,26040,3594,48567,2913,1428,1485
34830,53970,5393,26042,3594,48577,2913,1428,1485
34835,53976,5393,26042,3594,48583,2914,1428,1486
34840,53987,5393,26047,3594,48594,2914,1428,1486
34845,53991,5393,26049,3594,48598,2914,1428,1486
34850,54001,5394,26054,3594,48607,2914,1428,1486
34855,54007,5394,26056,3594,48613,2915,1429,1486
34860,54018,5395,26062,3594,48623,2915,1429,1486
34865,54022,5395,26064,3594,48627,2915,1429,1486
34870,54032,5396,26066,3594,48636,2915,1429,1486
34875,54038,5396,26069,3594,48642,2916,1430,1486
34880,54049,5397,26074,3594,48652,2916,1430,1486
34885,54053,5397,26077,3594,48656,2916,1430,1486
34890,54063,5398,26083,3594,48665,2916,1430,1486
34895,54069,5398,26085,3594,48671,2917,1430,1487
34900,54080,5399,26092,3595,48681,2917,1430,1487
34905,54084,5399,26094,3595,48685,2917,1430,1487
34910,54094,5401,26100,3597,48693,2917,1430,1487
34915,54100,5401,26103,3597,48699,2919,1431,1488
34920,54111,5402,26107,3597,48709,2919,1431,1488
34925,54115,5402,26110,3597,48713,2919,1431,1488
34930,54125,5404,26117,3598,48721,2919,1431,1488
34935,54131,5404,26117,3598,48727,2920,1431,1489
34940,54142,5406,26122,3600,48736,2920,1431,1489
34945,54146,5406,26124,3600,48740,2920,1431,1489
34950,54156,5408,26129,3600,48748,2920,1431,1489
34955,54162,5408,26133,3600,48754,2921,1432,1489
34960,54173,5410,26139,3602,48763,2921,1432,1489
34965,54177,5410,26141,3602,48767,2921,1432,1489
34970,54187,5412,26143,3602,48775,2921,1432,1489
34975,54193,5412,26146,3602,48780,2922,1432,1490
34980,54204,5416,26152,3606,48788,2923,1433,1490
34985,54208,5418,26154,3608,48790,2923,1433,1490
34990,54218,5420,26160,3609,48798,2923,1433,1490
34995,54224,5420,26164,3609,48803,2924,1434,1490
35000,54235,5422,26167,3610,48813,2925,1434,1491
35005,54239,5422,26168,3610,48817,2925,1434,1491
35010,54249,5424,26173,3612,48825,2925,1434,1491
35015,54255,5424,26175,3612,48831,2926,1434,1492
35020,54266,5425,26181,3613,48841,2927,1434,1493
35025,54270,5425,26182,3613,48845,2927,1434,1493
35030,54280,5427,26187,3614,48853,2927,1434,1493
35035,54286,5427,26191,3614,48858,2929,1436,1493
35040,54297,5429,26193,3615,48868,2930,1436,1494
35045,54301,5430,26196,3616,48871,2930,1436,1494
35050,54311,5431,26199,3616,48880,2930,1436,1494
35055,54317,5431,26202,3616,48886,2931,1437,1494
35060,54328,5432,26207,3616,48896,2931,1437,1494
35065,54332,5432,26208,3616,48900,2931,1437,1494
35070,54342,5433,26214,3616,48909,2931,1437,1494
35075,54348,5433,26217,3616,48915,2932,1437,1495
35080,54359,5434,26223,3617,48925,2932,1437,1495
35085,54363,5434,26224,3617,48929,2932,1437,1495
35090,54373,5435,26226,3618,48938,2932,1437,1495
35095,54379,5435,26230,3618,48944,2933,1438,1495
35100,54390,5437,26234,3619,48953,2933,1438,1495
35105,54394,5437,26234,3619,48957,2933,1438,1495
35110,54404,5437,26240,3619,48967,2933,1438,1495
35115,54410,5437,26243,3619,48973,2934,1439,1495
35120,54421,5438,26246,3619,48983,2934,1439,1495
35125,54425,5438,26247,3619,48987,2934,1439,1495
35130,54435,5438,26250,3619,48997,2934,1439,1495
35135,54441,5438,26253,3619,49003,2935,1439,1496
35140,54452,5440,26260,3621,49012,2935,1439,1496
35145,54456,5440,26263,3621,49016,2935,1439,1496
35150,54466,5441,26269,3621,49025,2935,1439,1496
35155,54472,5441,26271,3621,49030,2937,1440,1497
35160,54483,5444,26280,3624,49039,2938,1441,1497
35165,54487,5445,26281,3625,49042,2938,1441,1497
35170,54497,5446,26283,3625,49051,2938,1441,1497
35175,54503,5446,26286,3625,49056,2939,1442,1497
35180,54514,5448,26291,3626,49066,2940,1443,1497
35185,54518,5449,26294,3627,49069,2940,1443,1497
35190,54528,5450,26300,3628,49078,2940,1443,1497
35195,54534,5450,26303,3628,49084,2941,1444,1497
35200,54545,5451,26305,3628,49094,2942,1444,1498
35205,54549,5452,26306,3629,49097,2942,1444,1498
35210,54559,5454,26309,3630,49105,2942,1444,1498
35215,54565,5454,26313,3630,49110,2943,1444,1499
35220,54576,5456,26316,3632,49120,2944,1444,1500
35225,54580,5457,26317,3633,49123,2944,1444,1500
35230,54590,5459,26324,3635,49131,2944,1444,1500
35235,54596,5459,26327,3635,49137,2945,1445,1500
35240,54607,5461,26332,3636,49146,2946,1445,1501
35245,54611,5461,26333,3636,49150,2946,1445,1501
35250,54621,5463,26336,3638,49158,2946,1445,1501
35255,54627,5463,26339,3638,49164,2947,1445,1502
35260,54638,5465,26343,3640,49173,2948,1445,1503
35265,54642,5466,26346,3641,49176,2948,1445,1503
35270,54652,5468,26349,3642,49184,2948,1445,1503
35275,54658,5468,26353,3642,49190,2950,1446,1504
35280,54669,5470,26359,3644,49199,2951,1446,1505
35285,54673,5470,26361,3644,49203,2951,1446,1505
35290,54683,5472,26366,3644,49211,2951,1446,1505
35295,54689,5472,26372,3644,49217,2952,1447,1505
35300,54700,5474,26375,3645,49226,2953,1448,1505
35305,54704,5475,26377,3646,49229,2953,1448,1505
35310,54714,5477,26382,3647,49237,2953,1448,1505
35315,54720,5477,26383,3647,49243,2954,1448,1506
35320,54731,5478,26388,3648,49253,2955,1449,1506
35325,54735,5479,26391,3649,49256,2955,1449,1506
35330,54745,5481,26395,3650,49264,2955,1449,1506
35335,54751,5481,26397,3650,49270,2956,1449,1507
35340,54762,5484,26403,3652,49278,2957,1450,1507
35345,54766,5484,26405,3652,49282,2957,1450,1507
35350,54776,5485,26408,3653,49291,2957,1450,1507
35355,54782,5485,26410,3653,49296,2958,1450,1508
35360,54793,5487,26415,3655,49306,2958,1450,1508
35365,54797,5487,26415,3655,49310,2958,1450,1508
35370,54807,5488,26418,3655,49319,2958,1450,1508
35375,54813,5488,26420,3655,49325,2959,1450,1509
35380,54824,5489,26427,3656,49335,2959,1450,1509
35385,54828,5489,26429,3656,49339,2959,1450,1509
35390,54838,5490,26434,3657,49348,2959,1450,1509
35395,54844,5490,26436,3657,49354,2961,1450,1511
35400,54855,5491,26442,3658,49364,2961,1450,1511
35405,54859,5491,26445,3658,49368,2961,1450,1511
35410,54869,5491,26450,3658,49378,2961,1450,1511
35415,54875,5491,26454,3658,49384,2962,1451,1511
35420,54886,5491,26460,3658,49395,2962,1451,1511
35425,54890,5491,26463,3658,49399,2962,1451,1511
35430,54900,5491,26468,3658,49409,2962,1451,1511
35435,54906,5491,26472,3658,49415,2963,1452,1511
35440,54917,5491,26478,3658,49426,2963,1452,1511
35445,54921,5491,26479,3658,49430,2963,1452,1511
35450,54931,5492,26481,3658,49439,2963,1452,1511
35455,54937,5492,26483,3658,49445,2964,1453,1511
35460,54948,5493,26486,3658,49455,2964,1453,1511
35465,54952,5495,26490,3660,49457,2964,1453,1511
35470,54962,5496,26497,3661,49466,2964,1453,1511
35475,54968,5496,26503,3661,49471,2965,1454,1511
35480,54979,5499,26510,3663,49480,2965,1454,1511
35485,54983,5499,26510,3663,49484,2965,1454,1511
35490,54993,5500,26515,3664,49493,2965,1454,1511
35495,54999,5500,26520,3664,49499,2966,1455,1511
35500,55010,5502,26525,3665,49508,2966,1455,1511
35505,55014,5503,26528,3666,49511,2966,1455,1511
35510,55024,5504,26533,3667,49520,2966,1455,1511
35515,55030,5504,26535,3667,49526,2968,1455,1513
35520,55041,5506,26542,3669,49535,2969,1456,1513
35525,55045,5507,26545,3670,49538,2969,1456,1513
35530,55055,5507,26548,3670,49548,2969,1456,1513
35535,55061,5507,26553,3670,49554,2970,1457,1513
35540,55072,5508,26560,3671,49564,2971,1457,1514
35545,55076,5508,26561,3671,49568,2971,1457,1514
35550,55086,5508,26567,3671,49578,2971,1457,1514
35555,55092,5508,26570,3671,49584,2972,1457,1515
35560,55103,5509,26576,3671,49594,2973,1458,1515
35565,55107,5509,26578,3671,49598,2973,1458,1515
35570,55117,5510,26583,3671,49607,2973,1458,1515
35575,55123,5510,26584,3671,49613,2974,1458,1516
35580,55134,5513,26588,3673,49621,2975,1458,1517
35585,55138,5513,26589,3673,49625,2975,1458,1517
35590,55148,5514,26596,3674,49634,2975,1458,1517
35595,55154,5514,26599,3674,49640,2976,1458,1518
35600,55165,5515,26602,3675,49650,2976,1458,1518
35605,55169,5515,26603,3675,49654,2976,1458,1518
35610,55179,5516,26607,3675,49663,2976,1458,1518
35615,55185,5516,26608,3675,49669,2977,1458,1519
35620,55196,5517,26616,3675,49679,2977,1458,1519
35625,55200,5517,26618,3675,49683,2977,1458,1519
35630,55210,5519,26620,3676,49691,2977,1458,1519
35635,55216,5519,26623,3676,49697,2979,1459,1520
35640,55227,5521,26628,3677,49706,2980,1460,1520
35645,55231,5522,26629,3678,49709,2980,1460,1520
35650,55241,5524,26632,3679,49717,2980,1460,1520
35655,55247,5524,26634,3679,49723,2981,1460,1521
35660,55258,5527,26638,3681,49731,2982,1460,1522
35665,55262,5527,26638,3681,49735,2982,1460,1522
35670,55272,5529,26645,3683,49743,2982,1460,1522
35675,55278,5529,26647,3683,49749,2983,1460,1523
35680,55289,5532,26657,3686,49757,2984,1461,1523
35685,55293,5532,26660,3686,49761,2984,1461,1523
35690,55303,5534,26664,3687,49769,2984,1461,1523
35695,55309,5534,26668,3687,49775,2985,1462,1523
35700,55320,5536,26672,3689,49784,2986,1463,1523
35705,55324,5537,26675,3690,49787,2986,1463,1523
35710,55334,5539,26678,3690,49795,2986,1463,1523
35715,55340,5539,26682,3690,49801,2987,1463,1524
35720,55351,5540,26687,3691,49811,2987,1463,1524
35725,55355,5540,26688,3691,49815,2987,1463,1524
35730,55365,5542,26690,3691,49823,2987,1463,1524
35735,55371,5542,26692,3691,49829,2988,1464,1524
35740,55382,5544,26698,3693,49838,2988,1464,1524
35745,55386,5545,26699,3694,49841,2988,1464,1524
35750,55396,5547,26703,3694,49849,2988,1464,1524
35755,55402,5547,26707,3694,49854,2990,1465,1525
35760,55413,5549,26710,3696,49864,2990,1465,1525
35765,55417,5549,26713,3696,49868,2990,1465,1525
35770,55427,5550,26719,3696,49877,2990,1465,1525
35775,55433,5550,26724,3696,49882,2991,1466,1525
35780,55444,5551,26731,3697,49893,2991,1466,1525
35785,55448,5551,26732,3697,49897,2991,1466,1525
35790,55458,5552,26737,3697,49906,2991,1466,1525
35795,55464,5552,26740,3697,49912,2992,1466,1526
35800,55475,5552,26745,3697,49923,2992,1466,1526
35805,55479,5552,26747,3697,49927,2992,1466,1526
35810,55489,5553,26753,3698,49936,2992,1466,1526
35815,55495,5553,26755,3698,49942,2993,1467,1526
35820,55506,5555,26763,3700,49951,2994,1468,1526
35825,55510,5556,26765,3701,49954,2994,1468,1526
35830,55520,5557,26767,3701,49963,2994,1468,1526
35835,55526,5557,26769,3701,49968,2995,1468,1527
35840,55537,5559,26774,3702,49978,2996,1468,1528
35845,55541,5560,26778,3703,49981,2996,1468,1528
35850,55551,5561,26781,3703,49990,2996,1468,1528
35855,55557,5561,26784,3703,49996,2997,1468,1529
35860,55568,5562,26788,3703,50006,2998,1468,1530
35865,55572,5563,26790,3704,50009,2998,1468,1530
35870,55582,5564,26794,3704,50018,2998,1468,1530
35875,55588,5564,26796,3704,50024,3000,1469,1531
35880,55599,5565,26801,3705,50034,3001,1469,1532
35885,55603,5565,26804,3705,50038,3001,1469,1532
35890,55613,5566,26810,3706,50047,3001,1469,1532
35895,55619,5566,26814,3706,50052,3002,1470,1532
35900,55630,5568,26818,3708,50062,3002,1470,1532
35905,55634,5568,26820,3708,50066,3002,1470,1532
35910,55644,5569,26824,3708,50075,3002,1470,1532
35915,55650,5569,26826,3708,50081,3003,1470,1533
35920,55661,5570,26831,3709,50091,3003,1470,1533
35925,55665,5570,26833,3709,50095,3003,1470,1533
35930,55675,5571,26837,3709,50104,3003,1470,1533
35935,55681,5571,26837,3709,50110,3004,1470,1534
35940,55692,5573,26842,3711,50119,3004,1470,1534
35945,55696,5574,26844,3712,50122,3004,1470,1534
35950,55706,5576,26847,3712,50130,3004,1470,1534
35955,55712,5576,26849,3712,50136,3005,1470,1535
35960,55723,5579,26854,3714,50144,3005,1470,1535
35965,55727,5579,26855,3714,50148,3005,1470,1535
35970,55737,5581,26858,3714,50156,3005,1470,1535
35975,55743,5581,26862,3714,50162,3006,1470,1536
35980,55754,5583,26866,3715,50171,3006,1470,1536
35985,55758,5585,26869,3717,50173,3006,1470,1536
35990,55768,5587,26874,3717,50181,3006,1470,1536
35995,55774,5587,26879,3717,50187,3008,1472,1536
36000,55785,5589,26884,3719,50196,3008,1472,1536
36005,55789,5590,26886,3720,50199,3008,1472,1536
36010,55799,5591,26891,3721,50208,3008,1472,1536
36015,55805,5591,26894,3721,50214,3010,1473,1537
36020,55816,5591,26899,3721,50225,3010,1473,1537
36025,55820,5591,26901,3721,50229,3010,1473,1537
36030,55830,5592,26907,3721,50238,3010,1473,1537
36035,55836,5592,26910,3721,50244,3011,1473,1538
36040,55847,5592,26914,3721,50255,3011,1473,1538
36045,55851,5592,26915,3721,50259,3011,1473,1538
36050,55861,5593,26920,3722,50268,3011,1473,1538
36055,55867,5593,26922,3722,50274,3012,1474,1538
36060,55878,5593,26928,3722,50285,3013,1475,1538
36065,55882,5593,26931,3722,50289,3013,1475,1538
36070,55892,5595,26935,3724,50297,3013,1475,1538
36075,55898,5595,26939,3724,50302,3014,1476,1538
36080,55909,5598,26947,3727,50311,3014,1476,1538
36085,55913,5598,26947,3727,50315,3014,1476,1538
36090,55923,5600,26950,3727,50323,3014,1476,1538
36095,55929,5600,26951,3727,50329,3015,1477,1538
36100,55940,5602,26956,3728,50338,3015,1477,1538
36105,55944,5602,26957,3728,50342,3015,1477,1538
36110,55954,5604,26963,3729,50350,3015,1477,1538
36115,55960,5604,26966,3729,50356,3016,1478,1538
36120,55971,5605,26970,3729,50366,3016,1478,1538
36125,55975,5605,26971,3729,50370,3016,1478,1538
36130,55985,5607,26975,3729,50378,3016,1478,1538
36135,55991,5607,26979,3729,50384,3018,1479,1539
36140,56002,5609,26983,3730,50393,3019,1479,1540
36145,56006,5609,26985,3730,50397,3019,1479,1540
36150,56016,5611,26987,3730,50405,3019,1479,1540
36155,56022,5611,26990,3730,50411,3021,1481,1540
36160,56033,5612,26994,3731,50421,3022,1481,1541
36165,56037,5612,26996,3731,50425,3022,1481,1541
36170,56047,5614,26998,3731,50433,3022,1481,1541
36175,56053,5614,27000,3731,50439,3024,1481,1543
36180,56064,5615,27003,3732,50449,3025,1482,1543
36185,56068,5615,27005,3732,50453,3025,1482,1543
36190,56078,5615,27009,3732,50463,3025,1482,1543
36195,56084,5615,27014,3732,50469,3026,1482,1544
36200,56095,5615,27018,3732,50480,3026,1482,1544
36205,56099,5615,27020,3732,50484,3026,1482,1544
36210,56109,5615,27026,3732,50494,3026,1482,1544
36215,56115,5615,27029,3732,50500,3027,1483,1544
36220,56126,5615,27034,3732,50511,3027,1483,1544
36225,56130,5615,27036,3732,50515,3027,1483,1544
36230,56140,5615,27037,3732,50525,3027,1483,1544
36235,56146,5615,27038,3732,50531,3028,1484,1544
36240,56157,5615,27042,3732,50542,3028,1484,1544
36245,56161,5615,27045,3732,50546,3028,1484,1544
36250,56171,5615,27050,3732,50556,3028,1484,1544
36255,56177,5615,27053,3732,50562,3029,1485,1544
36260,56188,5615,27059,3732,50573,3029,1485,1544
36265,56192,5615,27062,3732,50577,3029,1485,1544
36270,56202,5615,27068,3732,50587,3029,1485,1544
36275,56208,5615,27072,3732,50593,3030,1486,1544
36280,56219,5615,27076,3732,50604,3030,1486,1544
36285,56223,5615,27078,3732,50608,3030,1486,1544
36290,56233,5617,27082,3732,50616,3030,1486,1544
36295,56239,5617,27086,3732,50621,3032,1487,1545
36300,56250,5621,27091,3735,50629,3033,1487,1546
36305,56254,5622,27095,3736,50632,3033,1487,1546
36310,56264,5624,27101,3737,50640,3033,1487,1546
36315,56270,5624,27104,3737,50646,3034,1488,1546
36320,56281,5626,27110,3738,50655,3035,1488,1547
36325,56285,5626,27111,3738,50659,3035,1488,1547
36330,56295,5627,27114,3738,50668,3035,1488,1547
36335,56301,5627,27116,3738,50674,3036,1489,1547
36340,56312,5628,27119,3738,50684,3037,1489,1548
36345,56316,5628,27122,3738,50688,3037,1489,1548
36350,56326,5629,27127,3738,50697,3037,1489,1548
36355,56332,5629,27129,3738,50703,3038,1490,1548
36360,56343,5632,27136,3740,50711,3039,1491,1548
36365,56347,5632,27137,3740,50715,3039,1491,1548
36370,56357,5633,27143,3740,50724,3039,1491,1548
36375,56363,5633,27145,3740,50730,3040,1492,1548
36380,56374,5634,27150,3740,50740,3041,1492,1549
36385,56378,5634,27151,3740,50744,3041,1492,1549
36390,56388,5635,27156,3741,50753,3041,1492,1549
36395,56394,5635,27160,3741,50759,3042,1493,1549
36400,56405,5637,27165,3743,50768,3043,1494,1549
36405,56409,5637,27167,3743,50772,3043,1494,1549
36410,56419,5638,27172,3743,50781,3043,1494,1549
36415,56425,5638,27176,3743,50786,3045,1494,1551
36420,56436,5642,27183,3746,50794,3046,1494,1552
36425,56440,5642,27186,3746,50798,3046,1494,1552
36430,56450,5642,27193,3746,50808,3046,1494,1552
36435,56456,5642,27195,3746,50814,3047,1494,1553
36440,56467,5642,27204,3746,50825,3047,1494,1553
36445,56471,5642,27205,3746,50829,3047,1494,1553
36450,56481,5642,27210,3746,50839,3047,1494,1553
36455,56487,5642,27211,3746,50845,3048,1494,1554
36460,56498,5642,27215,3746,50856,3048,1494,1554
36465,56502,5642,27218,3746,50860,3048,1494,1554
36470,56512,5642,27224,3746,50870,3048,1494,1554
36475,56518,5642,27227,3746,50876,3049,1494,1555
36480,56529,5642,27235,3746,50887,3049,1494,1555
36485,56533,5642,27236,3746,50891,3049,1494,1555
36490,56543,5642,27241,3746,50901,3049,1494,1555
36495,56549,5642,27244,3746,50907,3050,1495,1555
36500,56560,5642,27248,3746,50918,3050,1495,1555
36505,56564,5642,27250,3746,50922,3050,1495,1555
36510,56574,5642,27255,3746,50932,3050,1495,1555
36515,56580,5642,27258,3746,50938,3051,1496,1555
36520,56591,5642,27265,3746,50949,3051,1496,1555
36525,56595,5642,27267,3746,50953,3051,1496,1555
36530,56605,5644,27273,3748,50961,3051,1496,1555
36535,56611,5644,27277,3748,50967,3052,1497,1555
36540,56622,5646,27282,3749,50976,3053,1497,1556
36545,56626,5646,27283,3749,50980,3053,1497,1556
36550,56636,5648,27289,3750,50988,3053,1497,1556
36555,56642,5648,27293,3750,50994,3054,1498,1556
36560,56653,5649,27295,3750,51004,3055,1498,1557
36565,56657,5649,27297,3750,51008,3055,1498,1557
36570,56667,5651,27303,3751,51016,3055,1498,1557
36575,56673,5651,27309,3751,51022,3056,1499,1557
36580,56684,5654,27317,3754,51030,3057,1500,1557
36585,56688,5655,27318,3755,51033,3057,1500,1557
36590,56698,5657,27325,3757,51041,3057,1500,1557
36595,56704,5657,27326,3757,51047,3058,1500,1558
36600,56715,5659,27331,3759,51056,3059,1500,1559
36605,56719,5659,27332,3759,51060,3059,1500,1559
36610,56729,5661,27336,3760,51068,3059,1500,1559
36615,56735,5661,27337,3760,51074,3060,1501,1559
36620,56746,5662,27344,3760,51084,3061,1501,1560
36625,56750,5664,27346,3762,51086,3061,1501,1560
36630,56760,5666,27350,3763,51094,3061,1501,1560
36635,56766,5666,27353,3763,51100,3062,1502,1560
36640,56777,5668,27359,3764,51109,3063,1503,1560
36645,56781,5669,27361,3765,51112,3063,1503,1560
36650,56791,5671,27368,3767,51120,3063,1503,1560
36655,56797,5671,27369,3767,51126,3064,1504,1560
36660,56808,5673,27375,3769,51135,3065,1505,1560
36665,56812,5674,27376,3770,51138,3065,1505,1560
36670,56822,5676,27382,3770,51146,3065,1505,1560
36675,56828,5676,27382,3770,51152,3066,1505,1561
36680,56839,5678,27389,3772,51161,3067,1506,1561
36685,56843,5679,27391,3773,51164,3067,1506,1561
36690,56853,5681,27395,3774,51172,3067,1506,1561
36695,56859,5681,27398,3774,51178,3068,1507,1561
36700,56870,5684,27405,3777,51186,3069,1507,1562
36705,56874,5685,27407,3778,51189,3069,1507,1562
36710,56884,5687,27411,3778,51197,3069,1507,1562
36715,56890,5687,27413,3778,51203,3070,1507,1563
36720,56901,5688,27417,3778,51213,3071,1508,1563
36725,56905,5688,27418,3778,51217,3071,1508,1563
36730,56915,5689,27425,3779,51226,3071,1508,1563
36735,56921,5689,27426,3779,51232,3073,1508,1565
36740,56932,5689,27431,3779,51243,3073,1508,1565
36745,56936,5689,27431,3779,51247,3073,1508,1565
36750,56946,5690,27434,3779,51256,3073,1508,1565
36755,56952,5690,27437,3779,51262,3075,1510,1565
36760,56963,5690,27442,3779,51273,3075,1510,1565
36765,56967,5690,27444,3779,51277,3075,1510,1565
36770,56977,5691,27450,3779,51286,3075,1510,1565
36775,56983,5691,27451,3779,51292,3076,1510,1566
36780,56994,5691,27453,3779,51303,3076,1510,1566
36785,56998,5691,27455,3779,51307,3076,1510,1566
36790,57008,5693,27458,3779,51315,3076,1510,1566
36795,57014,5693,27461,3779,51321,3077,1510,1567
36800,57025,5694,27465,3780,51331,3077,1510,1567
36805,57029,5694,27466,3780,51335,3077,1510,1567
36810,57039,5696,27470,3781,51343,3077,1510,1567
36815,57045,5696,27472,3781,51349,3078,1511,1567
36820,57056,5699,27480,3784,51357,3078,1511,1567
36825,57060,5699,27482,3784,51361,3078,1511,1567
36830,57070,5701,27486,3784,51369,3078,1511,1567
36835,57076,5701,27488,3784,51375,3079,1512,1567
36840,57087,5703,27492,3786,51384,3080,1512,1568
36845,57091,5703,27494,3786,51388,3080,1512,1568
36850,57101,5703,27500,3786,51398,3080,1512,1568
36855,57107,5703,27503,3786,51404,3081,1513,1568
36860,57118,5704,27508,3786,51414,3081,1513,1568
36865,57122,5704,27510,3786,51418,3081,1513,1568
36870,57132,5704,27517,3786,51428,3081,1513,1568
36875,57138,5704,27518,3786,51434,3082,1513,1569
36880,57149,5705,27523,3786,51444,3082,1513,1569
36885,57153,5705,27523,3786,51448,3082,1513,1569
36890,57163,5705,27530,3786,51458,3082,1513,1569
36895,57169,5705,27531,3786,51464,3084,1513,1571
36900,57180,5706,27533,3786,51474,3084,1513,1571
36905,57184,5706,27534,3786,51478,3084,1513,1571
36910,57194,5706,27539,3786,51488,3084,1513,1571
36915,57200,5706,27541,3786,51494,3085,1514,1571
36920,57211,5707,27546,3786,51504,3085,1514,1571
36925,57215,5708,27548,3787,51507,3085,1514,1571
36930,57225,5708,27552,3787,51517,3085,1514,1571
36935,57231,5708,27555,3787,51523,3086,1515,1571
36940,57242,5709,27564,3788,51533,3086,1515,1571
36945,57246,5709,27566,3788,51537,3086,1515,1571
36950,57256,5711,27571,3790,51545,3086,1515,1571
36955,57262,5711,27573,3790,51551,3087,1515,1572
36960,57273,5712,27577,3791,51561,3088,1515,1573
36965,57277,5713,27580,3792,51564,3088,1515,1573
36970,57287,5714,27585,3793,51573,3088,1515,1573
36975,57293,5714,27589,3793,51579,3089,1515,1574
36980,57304,5715,27596,3794,51589,3089,1515,1574
36985,57308,5715,27597,3794,51593,3089,1515,1574
36990,57318,5716,27601,3794,51602,3089,1515,1574
36995,57324,5716,27603,3794,51608,3090,1515,1575
37000,57335,5718,27606,3795,51617,3090,1515,1575
37005,57339,5718,27609,3795,51621,3090,1515,1575
37010,57349,5719,27613,3795,51630,3090,1515,1575
37015,57355,5719,27616,3795,51636,3092,1516,1576
37020,57366,5720,27621,3796,51646,3092,1516,1576
37025,57370,5721,27624,3797,51649,3092,1516,1576
37030,57380,5722,27628,3797,51658,3092,1516,1576
37035,57386,5722,27632,3797,51664,3093,1517,1576
37040,57397,5723,27637,3797,51674,3093,1517,1576
37045,57401,5723,27639,3797,51678,3093,1517,1576
37050,57411,5724,27644,3797,51687,3093,1517,1576
37055,57417,5724,27648,3797,51693,3094,1517,1577
37060,57428,5725,27652,3798,51703,3094,1517,1577
37065,57432,5725,27653,3798,51707,3094,1517,1577
37070,57442,5727,27657,3798,51715,3094,1517,1577
37075,57448,5727,27658,3798,51721,3095,1517,1578
37080,57459,5729,27666,3800,51730,3096,1518,1578
37085,57463,5729,27669,3800,51734,3096,1518,1578
37090,57473,5730,27676,3801,51743,3096,1518,1578
37095,57479,5730,27680,3801,51749,3097,1519,1578
37100,57490,5730,27685,3801,51760,3098,1519,1579
37105,57494,5730,27685,3801,51764,3098,1519,1579
37110,57504,5731,27690,3802,51773,3098,1519,1579
37115,57510,5731,27693,3802,51779,3099,1520,1579
37120,57521,5731,27694,3802,51790,3100,1520,1580
37125,57525,5731,27695,3802,51794,3100,1520,1580
37130,57535,5732,27699,3802,51803,3100,1520,1580
37135,57541,5732,27701,3802,51809,3102,1521,1581
37140,57552,5732,27705,3802,51820,3103,1521,1582
37145,57556,5732,27707,3802,51824,3103,1521,1582
37150,57566,5733,27712,3803,51833,3103,1521,1582
37155,57572,5733,27715,3803,51839,3104,1521,1583
37160,57583,5733,27721,3803,51850,3105,1521,1584
37165,57587,5733,27724,3803,51854,3105,1521,1584
37170,57597,5734,27728,3803,51863,3105,1521,1584
37175,57603,5734,27730,3803,51869,3106,1522,1584
37180,57614,5735,27737,3804,51879,3107,1523,1584
37185,57618,5735,27737,3804,51883,3107,1523,1584
37190,57628,5737,27740,3804,51891,3107,1523,1584
37195,57634,5737,27743,3804,51896,3108,1523,1585
37200,57645,5739,27744,3805,51906,3109,1523,1586
37205,57649,5739,27744,3805,51910,3109,1523,1586
37210,57659,5740,27748,3806,51919,3109,1523,1586
37215,57665,5740,27752,3806,51925,3110,1524,1586
37220,57676,5741,27758,3807,51935,3110,1524,1586
37225,57680,5742,27759,3808,51938,3110,1524,1586
37230,57690,5743,27766,3809,51947,3110,1524,1586
37235,57696,5743,27771,3809,51953,3111,1524,1587
37240,57707,5745,27775,3810,51962,3111,1524,1587
37245,57711,5745,27777,3810,51966,3111,1524,1587
37250,57721,5746,27782,3810,51975,3111,1524,1587
37255,57727,5746,27785,3810,51981,3113,1525,1588
37260,57738,5747,27791,3811,51991,3113,1525,1588
37265,57742,5748,27793,3812,51994,3113,1525,1588
37270,57752,5748,27795,3812,52004,3113,1525,1588
37275,57758,5748,27800,3812,52010,3114,1526,1588
37280,57769,5749,27803,3812,52020,3114,1526,1588
37285,57773,5750,27804,3813,52023,3114,1526,1588
37290,57783,5750,27809,3813,52033,3114,1526,1588
37295,57789,5750,27812,3813,52039,3115,1527,1588
37300,57800,5751,27818,3814,52049,3115,1527,1588
37305,57804,5751,27819,3814,52053,3115,1527,1588
37310,57814,5752,27826,3815,52062,3115,1527,1588
37315,57820,5752,27829,3815,52068,3116,1527,1589
37320,57831,5754,27834,3816,52077,3117,1527,1590
37325,57835,5754,27835,3816,52081,3117,1527,1590
37330,57845,5755,27839,3816,52090,3117,1527,1590
37335,57851,5755,27842,3816,52095,3118,1528,1590
37340,57862,5758,27846,3818,52104,3118,1528,1590
37345,57866,5758,27848,3818,52108,3118,1528,1590
37350,57876,5759,27855,3818,52117,3118,1528,1590
37355,57882,5759,27858,3818,52122,3119,1528,1591
37360,57893,5762,27864,3821,52131,3119,1528,1591
37365,57897,5762,27866,3821,52135,3119,1528,1591
37370,57907,5763,27869,3821,52144,3119,1528,1591
37375,57913,5763,27873,3821,52149,3121,1529,1592
37380,57924,5766,27877,3823,52158,3121,1529,1592
37385,57928,5766,27878,3823,52162,3121,1529,1592
37390,57938,5767,27884,3824,52171,3121,1529,1592
37395,57944,5767,27887,3824,52177,3122,1530,1592
37400,57955,5768,27891,3824,52187,3123,1530,1593
37405,57959,5768,27891,3824,52191,3123,1530,1593
37410,57969,5769,27897,3824,52200,3123,1530,1593
37415,57975,5769,27899,3824,52206,3124,1531,1593
37420,57986,5770,27904,3824,52216,3125,1532,1593
37425,57990,5771,27907,3825,52219,3125,1532,1593
37430,58000,5772,27912,3826,52228,3125,1532,1593
37435,58006,5772,27915,3826,52234,3126,1533,1593
37440,58017,5773,27923,3827,52244,3127,1534,1593
37445,58021,5774,27927,3828,52247,3127,1534,1593
37450,58031,5775,27933,3829,52256,3127,1534,1593
37455,58037,5775,27937,3829,52262,3128,1535,1593
37460,58048,5775,27941,3829,52273,3128,1535,1593
37465,58052,5775,27945,3829,52277,3128,1535,1593
37470,58062,5776,27949,3830,52286,3128,1535,1593
37475,58068,5776,27954,3830,52292,3129,1536,1593
37480,58079,5776,27960,3830,52303,3129,1536,1593
37485,58083,5776,27961,3830,52307,3129,1536,1593
37490,58093,5777,27966,3830,52316,3129,1536,1593
37495,58099,5777,27968,3830,52322,3131,1536,1595
37500,58110,5777,27971,3830,52333,3131,1536,1595
37505,58114,5777,27974,3830,52337,3131,1536,1595
37510,58124,5778,27978,3830,52346,3131,1536,1595
37515,58130,5778,27981,3830,52352,3132,1537,1595
37520,58141,5778,27985,3830,52363,3132,1537,1595
37525,58145,5778,27985,3830,52367,3132,1537,1595
37530,58155,5779,27990,3830,52376,3132,1537,1595
37535,58161,5779,27992,3830,52382,3133,1537,1596
37540,58172,5779,27997,3830,52393,3133,1537,1596
37545,58176,5779,27999,3830,52397,3133,1537,1596
37550,58186,5781,28004,3830,52405,3133,1537,1596
37555,58192,5781,28008,3830,52410,3134,1538,1596
37560,58203,5785,28015,3834,52418,3135,1539,1596
37565,58207,5787,28017,3836,52420,3135,1539,1596
37570,58217,5788,28023,3836,52429,3135,1539,1596
37575,58223,5788,28027,3836,52434,3136,1540,1596
37580,58234,5790,28032,3837,52444,3137,1541,1596
37585,58238,5790,28033,3837,52448,3137,1541,1596
37590,58248,5791,28037,3837,52457,3137,1541,1596
37595,58254,5791,28043,3837,52462,3138,1542,1596
37600,58265,5793,28049,3839,52472,3139,1543,1596
37605,58269,5793,28050,3839,52476,3139,1543,1596
37610,58279,5794,28057,3840,52485,3139,1543,1596
37615,58285,5794,28061,3840,52490,3141,1544,1597
37620,58296,5796,28069,3842,52500,3142,1544,1598
37625,58300,5796,28070,3842,52504,3142,1544,1598
37630,58310,5797,28075,3843,52513,3142,1544,1598
37635,58316,5797,28079,3843,52518,3144,1545,1599
37640,58327,5799,28082,3844,52528,3144,1545,1599
37645,58331,5799,28086,3844,52532,3144,1545,1599
37650,58341,5800,28090,3844,52541,3144,1545,1599
37655,58347,5800,28095,3844,52546,3145,1546,1599
37660,58358,5802,28104,3846,52556,3145,1546,1599
37665,58362,5802,28106,3846,52560,3145,1546,1599
37670,58372,5804,28111,3846,52568,3145,1546,1599
37675,58378,5804,28114,3846,52574,3146,1546,1600
37680,58389,5806,28119,3848,52583,3147,1546,1601
37685,58393,5806,28120,3848,52587,3147,1546,1601
37690,58403,5808,28124,3849,52595,3147,1546,1601
37695,58409,5808,28126,3849,52601,3148,1546,1602
37700,58420,5809,28132,3850,52611,3149,1547,1602
37705,58424,5809,28133,3850,52615,3149,1547,1602
37710,58434,5811,28141,3852,52623,3149,1547,1602
37715,58440,5811,28143,3852,52629,3150,1547,1603
37720,58451,5812,28149,3853,52639,3151,1547,1604
37725,58455,5813,28151,3854,52642,3151,1547,1604
37730,58465,5815,28155,3855,52650,3151,1547,1604
37735,58471,5815,28157,3855,52656,3152,1547,1605
37740,58482,5816,28161,3856,52666,3153,1548,1605
37745,58486,5816,28164,3856,52670,3153,1548,1605
37750,58496,5817,28173,3857,52679,3153,1548,1605
37755,58502,5817,28176,3857,52685,3155,1548,1607
37760,58513,5817,28181,3857,52696,3155,1548,1607
37765,58517,5817,28184,3857,52700,3155,1548,1607
37770,58527,5818,28188,3857,52709,3155,1548,1607
37775,58533,5818,28190,3857,52715,3157,1549,1608
37780,58544,5818,28196,3857,52726,3157,1549,1608
37785,58548,5818,28198,3857,52730,3157,1549,1608
37790,58558,5819,28205,3858,52739,3157,1549,1608
37795,58564,5819,28209,3858,52745,3158,1550,1608
37800,58575,5822,28214,3860,52753,3158,1550,1608
37805,58579,5823,28215,3861,52756,3158,1550,1608
37810,58589,5825,28218,3862,52764,3158,1550,1608
37815,58595,5825,28220,3862,52770,3159,1551,1608
37820,58606,5828,28225,3864,52778,3159,1551,1608
37825,58610,5829,28226,3865,52781,3159,1551,1608
37830,58620,5831,28232,3866,52789,3159,1551,1608
37835,58626,5831,28234,3866,52795,3160,1551,1609
37840,58637,5833,28239,3867,52804,3160,1551,1609
37845,58641,5833,28239,3867,52808,3160,1551,1609
37850,58651,5835,28246,3869,52816,3160,1551,1609
37855,58657,5835,28249,3869,52822,3161,1551,1610
37860,58668,5838,28252,3871,52830,3162,1551,1611
37865,58672,5838,28253,3871,52834,3162,1551,1611
37870,58682,5839,28256,3872,52843,3162,1551,1611
37875,58688,5839,28258,3872,52849,3164,1552,1612
37880,58699,5840,28265,3873,52859,3164,1552,1612
37885,58703,5840,28266,3873,52863,3164,1552,1612
37890,58713,5841,28272,3874,52872,3164,1552,1612
37895,58719,5841,28276,3874,52877,3166,1553,1613
37900,58730,5843,28281,3875,52887,3166,1553,1613
37905,58734,5843,28284,3875,52891,3166,1553,1613
37910,58744,5844,28287,3875,52900,3166,1553,1613
37915,58750,5844,28288,3875,52906,3167,1553,1614
37920,58761,5845,28291,3876,52916,3167,1553,1614
37925,58765,5845,28293,3876,52920,3167,1553,1614
37930,58775,5847,28295,3876,52928,3167,1553,1614
37935,58781,5847,28299,3876,52933,3168,1554,1614
37940,58792,5850,28305,3878,52942,3169,1554,1615
37945,58796,5850,28308,3878,52946,3169,1554,1615
37950,58806,5852,28313,3879,52954,3169,1554,1615
37955,58812,5852,28316,3879,52960,3170,1555,1615
37960,58823,5854,28320,3881,52969,3171,1555,1616
37965,58827,5854,28321,3881,52973,3171,1555,1616
37970,58837,5856,28325,3882,52981,3171,1555,1616
37975,58843,5856,28329,3882,52987,3172,1556,1616
37980,58854,5859,28334,3885,52995,3173,1557,1616
37985,58858,5859,28335,3885,52999,3173,1557,1616
37990,58868,5860,28341,3885,53008,3173,1557,1616
37995,58874,5860,28344,3885,53014,3174,1558,1616
38000,58885,5861,28350,3886,53024,3174,1558,1616
38005,58889,5862,28354,3887,53027,3174,1558,1616
38010,58899,5863,28359,3888,53036,3174,1558,1616
38015,58905,5863,28362,3888,53042,3176,1559,1617
38020,58916,5864,28369,3889,53052,3176,1559,1617
38025,58920,5864,28370,3889,53056,3176,1559,1617
38030,58930,5865,28374,3889,53065,3176,1559,1617
38035,58936,5865,28377,3889,53071,3178,1561,1617
38040,58947,5866,28384,3890,53081,3178,1561,1617
38045,58951,5866,28385,3890,53085,3178,1561,1617
38050,58961,5867,28387,3890,53094,3178,1561,1617
38055,58967,5867,28390,3890,53100,3179,1561,1618
38060,58978,5868,28396,3890,53110,3179,1561,1618
38065,58982,5869,28398,3891,53113,3179,1561,1618
38070,58992,5870,28402,3891,53122,3179,1561,1618
38075,58998,5870,28407,3891,53127,3180,1562,1618
38080,59009,5872,28411,3893,53137,3180,1562,1618
38085,59013,5872,28413,3893,53141,3180,1562,1618
38090,59023,5873,28420,3894,53150,3180,1562,1618
38095,59029,5873,28421,3894,53156,3181,1562,1619
38100,59040,5874,28426,3895,53166,3182,1562,1620
38105,59044,5875,28429,3896,53169,3182,1562,1620
38110,59054,5876,28431,3897,53178,3182,1562,1620
38115,59060,5876,28433,3897,53183,3183,1562,1621
38120,59071,5879,28438,3899,53192,3184,1562,1622
38125,59075,5879,28440,3899,53196,3184,1562,1622
38130,59085,5880,28444,3899,53205,3184,1562,1622
38135,59091,5880,28450,3899,53210,3185,1563,1622
38140,59102,5884,28457,3903,53218,3186,1564,1622
38145,59106,5884,28458,3903,53222,3186,1564,1622
38150,59116,5885,28462,3903,53231,3186,1564,1622
38155,59122,5885,28464,3903,53236,3188,1565,1623
38160,59133,5889,28473,3907,53244,3189,1566,1623
38165,59137,5889,28474,3907,53248,3189,1566,1623
38170,59147,5889,28477,3907,53258,3189,1566,1623
38175,59153,5889,28481,3907,53264,3190,1567,1623
38180,59164,5891,28484,3909,53273,3191,1567,1624
38185,59168,5891,28485,3909,53277,3191,1567,1624
38190,59178,5891,28490,3909,53287,3191,1567,1624
38195,59184,5891,28491,3909,53293,3192,1567,1625
38200,59195,5894,28497,3911,53301,3193,1567,1626
38205,59199,5894,28501,3911,53305,3193,1567,1626
38210,59209,5895,28503,3911,53314,3193,1567,1626
38215,59215,5895,28505,3911,53320,3194,1567,1627
38220,59226,5896,28509,3912,53330,3195,1568,1627
38225,59230,5896,28512,3912,53334,3195,1568,1627
38230,59240,5897,28516,3912,53343,3195,1568,1627
38235,59246,5897,28516,3912,53349,3196,1568,1628
38240,59257,5897,28524,3912,53360,3197,1569,1628
38245,59261,5897,28525,3912,53364,3197,1569,1628
38250,59271,5898,28530,3912,53373,3197,1569,1628
38255,59277,5898,28531,3912,53379,3198,1569,1629
38260,59288,5898,28534,3912,53390,3199,1570,1629
38265,59292,5899,28537,3913,53393,3199,1570,1629
38270,59302,5900,28542,3913,53402,3199,1570,1629
38275,59308,5900,28547,3913,53407,3201,1572,1629
38280,59319,5901,28551,3914,53418,3201,1572,1629
38285,59323,5901,28553,3914,53422,3201,1572,1629
38290,59333,5903,28560,3916,53430,3201,1572,1629
38295,59339,5903,28563,3916,53436,3203,1573,1630
38300,59350,5903,28568,3916,53447,3203,1573,1630
38305,59354,5903,28570,3916,53451,3203,1573,1630
38310,59364,5905,28573,3917,53459,3203,1573,1630
38315,59370,5905,28576,3917,53465,3204,1573,1631
38320,59381,5905,28580,3917,53476,3204,1573,1631
38325,59385,5905,28580,3917,53480,3204,1573,1631
38330,59395,5907,28585,3918,53488,3204,1573,1631
38335,59401,5907,28587,3918,53494,3205,1573,1632
38340,59412,5909,28593,3920,53503,3205,1573,1632
38345,59416,5910,28594,3921,53506,3205,1573,1632
38350,59426,5912,28599,3922,53514,3205,1573,1632
38355,59432,5912,28603,3922,53520,3206,1573,1633
38360,59443,5914,28608,3923,53529,3206,1573,1633
38365,59447,5915,28612,3924,53532,3206,1573,1633
38370,59457,5917,28614,3924,53540,3206,1573,1633
38375,59463,5917,28616,3924,53546,3207,1573,1634
38380,59474,5918,28622,3925,53556,3208,1574,1634
38385,59478,5919,28626,3926,53559,3208,1574,1634
38390,59488,5921,28631,3927,53567,3208,1574,1634
38395,59494,5921,28634,3927,53572,3209,1574,1635
38400,59505,5924,28638,3929,53581,3210,1574,1636
38405,59509,5924,28641,3929,53585,3210,1574,1636
38410,59519,5925,28648,3929,53594,3210,1574,1636
38415,59525,5925,28649,3929,53600,3212,1575,1637
38420,59536,5927,28656,3930,53609,3213,1576,1637
38425,59540,5927,28658,3930,53613,3213,1576,1637
38430,59550,5928,28662,3931,53622,3213,1576,1637
38435,59556,5928,28666,3931,53627,3214,1576,1638
38440,59567,5931,28674,3934,53636,3215,1577,1638
38445,59571,5931,28678,3934,53640,3215,1577,1638
38450,59581,5932,28682,3935,53649,3215,1577,1638
38455,59587,5932,28686,3935,53655,3216,1577,1639
38460,59598,5935,28691,3938,53663,3217,1577,1640
38465,59602,5936,28694,3939,53666,3217,1577,1640
38470,59612,5936,28699,3939,53676,3217,1577,1640
38475,59618,5936,28703,3939,53682,3218,1577,1641
38480,59629,5938,28710,3941,53691,3219,1578,1641
38485,59633,5939,28714,3942,53694,3219,1578,1641
38490,59643,5939,28718,3942,53704,3219,1578,1641
38495,59649,5939,28721,3942,53710,3220,1578,1642
38500,59660,5940,28726,3942,53720,3221,1579,1642
38505,59664,5941,28729,3943,53723,3221,1579,1642
38510,59674,5942,28735,3944,53732,3221,1579,1642
38515,59680,5942,28737,3944,53738,3222,1580,1642
38520,59691,5944,28743,3946,53747,3223,1580,1643
38525,59695,5944,28743,3946,53751,3223,1580,1643
38530,59705,5945,28749,3947,53760,3223,1580,1643
38535,59711,5945,28751,3947,53766,3225,1581,1644
38540,59722,5946,28760,3948,53776,3225,1581,1644
38545,59726,5946,28763,3948,53780,3225,1581,1644
38550,59736,5947,28767,3948,53789,3225,1581,1644
38555,59742,5947,28771,3948,53794,3227,1583,1644
38560,59753,5948,28773,3949,53805,3227,1583,1644
38565,59757,5948,28776,3949,53809,3227,1583,1644
38570,59767,5950,28780,3950,53817,3227,1583,1644
38575,59773,5950,28785,3950,53822,3229,1584,1645
38580,59784,5951,28788,3951,53833,3229,1584,1645
38585,59788,5952,28790,3952,53836,3229,1584,1645
38590,59798,5954,28797,3954,53844,3229,1584,1645
38595,59804,5954,28800,3954,53850,3230,1584,1646
38600,59815,5955,28803,3955,53860,3230,1584,1646
38605,59819,5956,28806,3956,53863,3230,1584,1646
38610,59829,5958,28810,3956,53871,3230,1584,1646
38615,59835,5958,28812,3956,53876,3231,1584,1647
38620,59846,5963,28820,3961,53883,3231,1584,1647
38625,59850,5963,28821,3961,53887,3231,1584,1647
38630,59860,5965,28825,3961,53895,3231,1584,1647
38635,59866,5965,28827,3961,53900,3232,1585,1647
38640,59877,5968,28832,3964,53909,3233,1586,1647
38645,59881,5968,28834,3964,53913,3233,1586,1647
38650,59891,5969,28834,3964,53922,3233,1586,1647
38655,59897,5969,28836,3964,53928,3234,1587,1647
38660,59908,5969,28841,3964,53939,3235,1588,1647
38665,59912,5969,28842,3964,53943,3235,1588,1647
38670,59922,5970,28846,3964,53952,3235,1588,1647
38675,59928,5970,28852,3964,53958,3236,1589,1647
38680,59939,5970,28855,3964,53969,3237,1589,1648
38685,59943,5970,28857,3964,53973,3237,1589,1648
38690,59953,5971,28859,3964,53982,3237,1589,1648
38695,59959,5971,28861,3964,53988,3239,1589,1650
38700,59970,5972,28866,3965,53998,3240,1590,1650
38705,59974,5972,28868,3965,54002,3240,1590,1650
38710,59984,5973,28876,3965,54011,3240,1590,1650
38715,59990,5973,28879,3965,54017,3242,1591,1651
38720,60001,5973,28882,3965,54028,3243,1592,1651
38725,60005,5973,28884,3965,54032,3243,1592,1651
38730,60015,5974,28889,3966,54041,3243,1592,1651
38735,60021,5974,28893,3966,54047,3244,1593,1651
38740,60032,5974,28897,3966,54058,3244,1593,1651
38745,60036,5974,28901,3966,54062,3244,1593,1651
38750,60046,5976,28907,3968,54070,3244,1593,1651
38755,60052,5976,28910,3968,54075,3245,1594,1651
38760,60063,5978,28917,3970,54085,3245,1594,1651
38765,60067,5979,28919,3971,54088,3245,1594,1651
38770,60077,5981,28923,3973,54096,3245,1594,1651
38775,60083,5981,28924,3973,54102,3246,1594,1652
38780,60094,5982,28930,3974,54112,3246,1594,1652
38785,60098,5982,28932,3974,54116,3246,1594,1652
38790,60108,5984,28942,3976,54124,3246,1594,1652
38795,60114,5984,28942,3976,54130,3247,1594,1653
38800,60125,5985,28946,3976,54140,3247,1594,1653
38805,60129,5985,28946,3976,54144,3247,1594,1653
38810,60139,5987,28953,3977,54152,3247,1594,1653
38815,60145,5987,28955,3977,54158,3248,1594,1654
38820,60156,5990,28962,3979,54166,3248,1594,1654
38825,60160,5992,28965,3981,54168,3248,1594,1654
38830,60170,5994,28969,3982,54176,3248,1594,1654
38835,60176,5994,28969,3982,54182,3249,1594,1655
38840,60187,5996,28973,3983,54191,3249,1594,1655
38845,60191,5997,28976,3984,54194,3249,1594,1655
38850,60201,5999,28982,3986,54202,3249,1594,1655
38855,60207,5999,28984,3986,54208,3250,1594,1656
38860,60218,6001,28990,3988,54217,3250,1594,1656
38865,60222,6002,28992,3989,54220,3250,1594,1656
38870,60232,6004,28998,3990,54228,3250,1594,1656
38875,60238,6004,29002,3990,54234,3251,1595,1656
38880,60249,6005,29008,3991,54244,3252,1596,1656
38885,60253,6006,29009,3992,54247,3252,1596,1656
38890,60263,6006,29011,3992,54257,3252,1596,1656
38895,60269,6006,29012,3992,54263,3253,1596,1657
38900,60280,6006,29017,3992,54274,3254,1597,1657
38905,60284,6006,29019,3992,54278,3254,1597,1657
38910,60294,6006,29024,3992,54288,3254,1597,1657
38915,60300,6006,29028,3992,54294,3255,1598,1657
38920,60311,6006,29033,3992,54305,3256,1598,1658
38925,60315,6006,29036,3992,54309,3256,1598,1658
38930,60325,6006,29042,3992,54319,3256,1598,1658
38935,60331,6006,29044,3992,54325,3257,1598,1659
38940,60342,6006,29051,3992,54336,3258,1599,1659
38945,60346,6006,29053,3992,54340,3258,1599,1659
38950,60356,6006,29059,3992,54350,3258,1599,1659
38955,60362,6006,29062,3992,54356,3259,1600,1659
38960,60373,6006,29069,3992,54367,3260,1601,1659
38965,60377,6006,29069,3992,54371,3260,1601,1659
38970,60387,6006,29073,3992,54381,3260,1601,1659
38975,60393,6006,29076,3992,54387,3261,1601,1660
38980,60404,6006,29082,3992,54398,3261,1601,1660
38985,60408,6006,29085,3992,54402,3261,1601,1660
38990,60418,6007,29088,3992,54411,3261,1601,1660
38995,60424,6007,29092,3992,54416,3262,1602,1660
39000,60435,6011,29097,3995,54424,3262,1602,1660
39005,60439,6012,29101,3996,54427,3262,1602,1660
39010,60449,6014,29105,3996,54435,3262,1602,1660
39015,60455,6014,29110,3996,54441,3263,1603,1660
39020,60466,6015,29113,3996,54451,3263,1603,1660
39025,60470,6017,29115,3998,54453,3263,1603,1660
39030,60480,6019,29120,3998,54461,3263,1603,1660
39035,60486,6019,29122,3998,54467,3264,1603,1661
39040,60497,6021,29127,3999,54476,3264,1603,1661
39045,60501,6021,29129,3999,54480,3264,1603,1661
39050,60511,6023,29135,4000,54488,3264,1603,1661
39055,60517,6023,29140,4000,54494,3265,1603,1662
39060,60528,6024,29147,4000,54504,3265,1603,1662
39065,60532,6025,29149,4001,54507,3265,1603,1662
39070,60542,6027,29153,4003,54515,3265,1603,1662
39075,60548,6027,29156,4003,54521,3266,1603,1663
39080,60559,6028,29162,4004,54531,3266,1603,1663
39085,60563,6029,29164,4005,54534,3266,1603,1663
39090,60573,6031,29169,4006,54542,3266,1603,1663
39095,60579,6031,29171,4006,54548,3267,1604,1663
39100,60590,6032,29174,4007,54558,3267,1604,1663
39105,60594,6033,29175,4008,54561,3267,1604,1663
39110,60604,6035,29179,4009,54569,3267,1604,1663
39115,60610,6035,29182,4009,54575,3269,1605,1664
39120,60621,6037,29186,4010,54584,3270,1605,1665
39125,60625,6037,29189,4010,54588,3270,1605,1665
39130,60635,6037,29193,4010,54598,3270,1605,1665
39135,60641,6037,29197,4010,54604,3271,1606,1665
39140,60652,6037,29202,4010,54615,3271,1606,1665
39145,60656,6037,29206,4010,54619,3271,1606,1665
39150,60666,6037,29212,4010,54629,3271,1606,1665
39155,60672,6037,29215,4010,54635,3272,1607,1665
39160,60683,6037,29221,4010,54646,3272,1607,1665
39165,60687,6037,29223,4010,54650,3272,1607,1665
39170,60697,6037,29230,4010,54660,3272,1607,1665
39175,60703,6037,29233,4010,54666,3273,1607,1666
39180,60714,6037,29237,4010,54677,3273,1607,1666
39185,60718,6037,29239,4010,54681,3273,1607,1666
39190,60728,6037,29247,4010,54691,3273,1607,1666
39195,60734,6037,29251,4010,54697,3274,1608,1666
39200,60745,6037,29255,4010,54708,3274,1608,1666
39205,60749,6037,29257,4010,54712,3274,1608,1666
39210,60759,6037,29262,4010,54722,3274,1608,1666
39215,60765,6037,29267,4010,54728,3275,1609,1666
39220,60776,6037,29274,4010,54739,3275,1609,1666
39225,60780,6037,29277,4010,54743,3275,1609,1666
39230,60790,6039,29282,4010,54751,3275,1609,1666
39235,60796,6039,29283,4010,54757,3277,1609,1668
39240,60807,6042,29290,4013,54765,3277,1609,1668
39245,60811,6042,29293,4013,54769,3277,1609,1668
39250,60821,6043,29300,4014,54778,3277,1609,1668
39255,60827,6043,29303,4014,54784,3278,1610,1668
39260,60838,6045,29306,4015,54793,3278,1610,1668
39265,60842,6045,29307,4015,54797,3278,1610,1668
39270,60852,6046,29313,4015,54806,3278,1610,1668
39275,60858,6046,29317,4015,54812,3279,1610,1669
39280,60869,6047,29320,4016,54822,3279,1610,1669
39285,60873,6048,29323,4017,54825,3279,1610,1669
39290,60883,6049,29326,4018,54834,3279,1610,1669
39295,60889,6049,29328,4018,54840,3280,1611,1669
39300,60900,6051,29336,4020,54849,3281,1612,1669
39305,60904,6052,29337,4021,54852,3281,1612,1669
39310,60914,6053,29341,4021,54861,3281,1612,1669
39315,60920,6053,29343,4021,54867,3282,1612,1670
39320,60931,6054,29348,4022,54877,3283,1613,1670
39325,60935,6054,29348,4022,54881,3283,1613,1670
39330,60945,6055,29351,4022,54890,3283,1613,1670
39335,60951,6055,29354,4022,54896,3284,1613,1671
39340,60962,6055,29360,4022,54907,3285,1614,1671
39345,60966,6055,29364,4022,54911,3285,1614,1671
39350,60976,6057,29369,4023,54919,3285,1614,1671
39355,60982,6057,29371,4023,54925,3286,1615,1671
39360,60993,6059,29377,4025,54934,3287,1615,1672
39365,60997,6059,29380,4025,54938,3287,1615,1672
39370,61007,6061,29383,4027,54946,3287,1615,1672
39375,61013,6061,29386,4027,54952,3288,1615,1673
39380,61024,6063,29391,4028,54961,3288,1615,1673
39385,61028,6063,29392,4028,54965,3288,1615,1673
39390,61038,6065,29396,4030,54973,3288,1615,1673
39395,61044,6065,29399,4030,54979,3289,1615,1674
39400,61055,6066,29403,4030,54989,3289,1615,1674
39405,61059,6066,29403,4030,54993,3289,1615,1674
39410,61069,6068,29408,4031,55001,3289,1615,1674
39415,61075,6068,29412,4031,55007,3290,1616,1674
39420,61086,6069,29415,4031,55017,3290,1616,1674
39425,61090,6069,29418,4031,55021,3290,1616,1674
39430,61100,6071,29424,4031,55029,3290,1616,1674
39435,61106,6071,29424,4031,55035,3291,1616,1675
39440,61117,6072,29431,4032,55045,3291,1616,1675
39445,61121,6072,29432,4032,55049,3291,1616,1675
39450,61131,6074,29436,4032,55057,3291,1616,1675
39455,61137,6074,29437,4032,55063,3292,1616,1676
39460,61148,6075,29441,4032,55073,3292,1616,1676
39465,61152,6076,29445,4033,55076,3292,1616,1676
39470,61162,6078,29449,4033,55084,3292,1616,1676
39475,61168,6078,29451,4033,55089,3293,1617,1676
39480,61179,6081,29457,4035,55098,3294,1617,1677
39485,61183,6081,29459,4035,55102,3294,1617,1677
39490,61193,6082,29463,4035,55111,3294,1617,1677
39495,61199,6082,29464,4035,55117,3295,1617,1678
39500,61210,6084,29470,4037,55126,3296,1617,1679
39505,61214,6084,29470,4037,55130,3296,1617,1679
39510,61224,6085,29476,4038,55139,3296,1617,1679
39515,61230,6085,29478,4038,55145,3297,1617,1680
39520,61241,6087,29482,4039,55154,3298,1618,1680
39525,61245,6087,29484,4039,55158,3298,1618,1680
39530,61255,6088,29487,4040,55167,3298,1618,1680
39535,61261,6088,29492,4040,55172,3299,1619,1680
39540,61272,6091,29496,4042,55181,3300,1620,1680
39545,61276,6091,29496,4042,55185,3300,1620,1680
39550,61286,6092,29503,4043,55194,3300,1620,1680
39555,61292,6092,29507,4043,55200,3301,1620,1681
39560,61303,6093,29513,4044,55210,3301,1620,1681
39565,61307,6093,29515,4044,55214,3301,1620,1681
39570,61317,6094,29521,4044,55223,3301,1620,1681
39575,61323,6094,29525,4044,55229,3302,1621,1681
39580,61334,6096,29531,4045,55238,3302,1621,1681
39585,61338,6096,29533,4045,55242,3302,1621,1681
39590,61348,6098,29541,4047,55250,3302,1621,1681
39595,61354,6098,29542,4047,55256,3304,1622,1682
39600,61365,6099,29546,4048,55266,3305,1623,1682
39605,61369,6099,29547,4048,55270,3305,1623,1682
39610,61379,6101,29550,4049,55278,3305,1623,1682
39615,61385,6101,29553,4049,55284,3306,1624,1682
39620,61396,6101,29561,4049,55295,3307,1625,1682
39625,61400,6102,29564,4050,55298,3307,1625,1682
39630,61410,6104,29569,4051,55306,3307,1625,1682
39635,61416,6104,29570,4051,55312,3308,1625,1683
39640,61427,6104,29577,4051,55323,3309,1626,1683
39645,61431,6104,29577,4051,55327,3309,1626,1683
39650,61441,6106,29581,4052,55335,3309,1626,1683
39655,61447,6106,29584,4052,55340,3310,1627,1683
39660,61458,6108,29590,4054,55350,3311,1627,1684
39665,61462,6108,29592,4054,55354,3311,1627,1684
39670,61472,6110,29598,4056,55362,3311,1627,1684
39675,61478,6110,29601,4056,55367,3312,1627,1685
39680,61489,6111,29603,4057,55378,3312,1627,1685
39685,61493,6111,29604,4057,55382,3312,1627,1685
39690,61503,6112,29610,4057,55391,3312,1627,1685
39695,61509,6112,29616,4057,55397,3313,1628,1685
39700,61520,6112,29621,4057,55408,3313,1628,1685
39705,61524,6112,29623,4057,55412,3313,1628,1685
39710,61534,6113,29628,4058,55421,3313,1628,1685
39715,61540,6113,29632,4058,55427,3315,1630,1685
39720,61551,6113,29636,4058,55438,3315,1630,1685
39725,61555,6113,29639,4058,55442,3315,1630,1685
39730,61565,6114,29645,4059,55451,3315,1630,1685
39735,61571,6114,29648,4059,55457,3316,1631,1685
39740,61582,6115,29654,4060,55467,3316,1631,1685
39745,61586,6115,29655,4060,55471,3316,1631,1685
39750,61596,6116,29662,4061,55480,3316,1631,1685
39755,61602,6116,29663,4061,55486,3317,1632,1685
39760,61613,6117,29669,4062,55496,3317,1632,1685
39765,61617,6117,29670,4062,55500,3317,1632,1685
39770,61627,6118,29674,4063,55509,3317,1632,1685
39775,61633,6118,29678,4063,55515,3318,1632,1686
39780,61644,6121,29684,4066,55523,3319,1632,1687
39785,61648,6121,29685,4066,55527,3319,1632,1687
39790,61658,6121,29692,4066,55537,3319,1632,1687
39795,61664,6121,29694,4066,55543,3320,1633,1687
39800,61675,6122,29697,4066,55553,3320,1633,1687
39805,61679,6122,29699,4066,55557,3320,1633,1687
39810,61689,6122,29705,4066,55567,3320,1633,1687
39815,61695,6122,29707,4066,55573,3321,1633,1688
39820,61706,6123,29713,4067,55583,3321,1633,1688
39825,61710,6123,29713,4067,55587,3321,1633,1688
39830,61720,6123,29717,4067,55597,3321,1633,1688
39835,61726,6123,29722,4067,55603,3322,1634,1688
39840,61737,6124,29726,4068,55613,3322,1634,1688
39845,61741,6125,29729,4069,55616,3322,1634,1688
39850,61751,6125,29732,4069,55626,3322,1634,1688
39855,61757,6125,29736,4069,55632,3323,1634,1689
39860,61768,6126,29742,4069,55642,3323,1634,1689
39865,61772,6126,29743,4069,55646,3323,1634,1689
39870,61782,6126,29747,4069,55656,3323,1634,1689
39875,61788,6126,29751,4069,55662,3324,1634,1690
39880,61799,6127,29758,4070,55672,3324,1634,1690
39885,61803,6127,29759,4070,55676,3324,1634,1690
39890,61813,6128,29763,4070,55685,3324,1634,1690
39895,61819,6128,29767,4070,55690,3325,1635,1690
39900,61830,6130,29769,4071,55700,3326,1635,1691
39905,61834,6130,29769,4071,55704,3326,1635,1691
39910,61844,6131,29775,4072,55713,3326,1635,1691
39915,61850,6131,29777,4072,55719,3327,1636,1691
39920,61861,6132,29783,4073,55729,3327,1636,1691
39925,61865,6132,29783,4073,55733,3327,1636,1691
39930,61875,6133,29789,4074,55742,3327,1636,1691
39935,61881,6133,29791,4074,55748,3328,1636,1692
39940,61892,6134,29795,4074,55758,3328,1636,1692
39945,61896,6134,29797,4074,55762,3328,1636,1692
39950,61906,6135,29803,4075,55771,3328,1636,1692
39955,61912,6135,29803,4075,55777,3330,1636,1694
39960,61923,6137,29809,4077,55786,3330,1636,1694
39965,61927,6137,29810,4077,55790,3330,1636,1694
39970,61937,6138,29816,4078,55799,3330,1636,1694
39975,61943,6138,29820,4078,55805,3331,1637,1694
39980,61954,6139,29826,4078,55815,3331,1637,1694
39985,61958,6140,29828,4079,55818,3331,1637,1694
39990,61968,6141,29836,4079,55827,3331,1637,1694
39995,61974,6141,29840,4079,55833,3332,1638,1694
40000,61985,6142,29844,4080,55843,3332,1638,1694
40005,61989,6143,29846,4081,55846,3332,1638,1694
40010,61999,6145,29848,4082,55854,3332,1638,1694
40015,62005,6145,29852,4082,55859,3333,1639,1694
40020,62016,6148,29859,4085,55868,3333,1639,1694
40025,62020,6148,29861,4085,55872,3333,1639,1694
40030,62030,6149,29863,4085,55881,3333,1639,1694
40035,62036,6149,29866,4085,55887,3334,1640,1694
40040,62047,6149,29872,4085,55898,3334,1640,1694
40045,62051,6149,29873,4085,55902,3334,1640,1694
40050,62061,6150,29880,4085,55911,3334,1640,1694
40055,62067,6150,29884,4085,55917,3335,1640,1695
40060,62078,6150,29890,4085,55928,3335,1640,1695
40065,62082,6150,29892,4085,55932,3335,1640,1695
40070,62092,6151,29898,4086,55941,3335,1640,1695
40075,62098,6151,29902,4086,55947,3336,1641,1695
40080,62109,6151,29908,4086,55958,3336,1641,1695
40085,62113,6151,29910,4086,55962,3336,1641,1695
40090,62123,6152,29915,4086,55971,3336,1641,1695
40095,62129,6152,29918,4086,55977,3337,1641,1696
40100,62140,6152,29926,4086,55988,3337,1641,1696
40105,62144,6152,29928,4086,55992,3337,1641,1696
40110,62154,6153,29932,4087,56001,3337,1641,1696
40115,62160,6153,29933,4087,56007,3338,1642,1696
40120,62171,6153,29938,4087,56018,3338,1642,1696
40125,62175,6153,29939,4087,56022,3338,1642,1696
40130,62185,6155,29943,4088,56030,3338,1642,1696
40135,62191,6155,29946,4088,56036,3339,1642,1697
40140,62202,6158,29951,4091,56044,3339,1642,1697
40145,62206,6159,29953,4092,56047,3339,1642,1697
40150,62216,6160,29959,4092,56056,3339,1642,1697
40155,62222,6160,29963,4092,56061,3340,1643,1697
40160,62233,6162,29965,4093,56071,3340,1643,1697
40165,62237,6164,29968,4095,56073,3340,1643,1697
40170,62247,6165,29971,4096,56082,3340,1643,1697
40175,62253,6165,29973,4096,56088,3341,1643,1698
40180,62264,6166,29979,4096,56098,3341,1643,1698
40185,62268,6166,29979,4096,56102,3341,1643,1698
40190,62278,6167,29982,4097,56111,3341,1643,1698
40195,62284,6167,29987,4097,56116,3343,1645,1698
40200,62295,6170,29990,4099,56125,3343,1645,1698
40205,62299,6171,29991,4100,56128,3343,1645,1698
40210,62309,6172,29998,4100,56137,3343,1645,1698
40215,62315,6172,30001,4100,56143,3344,1646,1698
40220,62326,6173,30005,4101,56153,3344,1646,1698
40225,62330,6173,30006,4101,56157,3344,1646,1698
40230,62340,6174,30012,4101,56166,3344,1646,1698
40235,62346,6174,30013,4101,56171,3345,1646,1699
40240,62357,6177,30019,4103,56180,3345,1646,1699
40245,62361,6177,30021,4103,56184,3345,1646,1699
40250,62371,6179,30026,4104,56192,3345,1646,1699
40255,62377,6179,30028,4104,56197,3346,1646,1700
40260,62388,6181,30033,4105,56207,3347,1647,1700
40265,62392,6181,30033,4105,56211,3347,1647,1700
40270,62402,6182,30040,4106,56220,3347,1647,1700
40275,62408,6182,30042,4106,56226,3348,1648,1700
40280,62419,6183,30047,4106,56236,3349,1648,1701
40285,62423,6183,30047,4106,56240,3349,1648,1701
40290,62433,6184,30052,4107,56249,3349,1648,1701
40295,62439,6184,30055,4107,56255,3350,1648,1702
40300,62450,6186,30061,4108,56264,3351,1648,1703
40305,62454,6187,30062,4109,56267,3351,1648,1703
40310,62464,6188,30066,4110,56276,3351,1648,1703
40315,62470,6188,30067,4110,56282,3353,1648,1705
40320,62481,6190,30073,4112,56291,3354,1648,1706
40325,62485,6190,30074,4112,56295,3354,1648,1706
40330,62495,6191,30083,4113,56304,3354,1648,1706
40335,62501,6191,30085,4113,56310,3355,1648,1707
40340,62512,6193,30090,4114,56319,3356,1648,1708
40345,62516,6193,30091,4114,56323,3356,1648,1708
40350,62526,6194,30095,4114,56332,3356,1648,1708
40355,62532,6194,30100,4114,56338,3357,1649,1708
40360,62543,6196,30106,4115,56347,3358,1650,1708
40365,62547,6196,30108,4115,56351,3358,1650,1708
40370,62557,6197,30115,4116,56360,3358,1650,1708
40375,62563,6197,30119,4116,56366,3359,1651,1708
40380,62574,6199,30123,4118,56375,3360,1651,1709
40385,62578,6200,30125,4119,56378,3360,1651,1709
40390,62588,6202,30130,4120,56386,3360,1651,1709
40395,62594,6202,30131,4120,56392,3361,1651,1710
40400,62605,6202,30136,4120,56403,3361,1651,1710
40405,62609,6203,30138,4121,56406,3361,1651,1710
40410,62619,6205,30141,4122,56414,3361,1651,1710
40415,62625,6205,30143,4122,56420,3362,1652,1710
40420,62636,6205,30147,4122,56431,3362,1652,1710
40425,62640,6206,30150,4123,56434,3362,1652,1710
40430,62650,6208,30154,4124,56442,3362,1652,1710
40435,62656,6208,30156,4124,56448,3364,1653,1711
40440,62667,6208,30161,4124,56459,3364,1653,1711
40445,62671,6208,30163,4124,56463,3364,1653,1711
40450,62681,6210,30166,4124,56471,3364,1653,1711
40455,62687,6210,30170,4124,56477,3365,1653,1712
40460,62698,6210,30177,4124,56488,3365,1653,1712
40465,62702,6210,30179,4124,56492,3365,1653,1712
40470,62712,6212,30187,4126,56500,3365,1653,1712
40475,62718,6212,30190,4126,56506,3366,1653,1713
40480,62729,6212,30195,4126,56517,3366,1653,1713
40485,62733,6212,30197,4126,56521,3366,1653,1713
40490,62743,6214,30201,4126,56529,3366,1653,1713
40495,62749,6214,30205,4126,56535,3367,1654,1713
40500,62760,6217,30211,4129,56543,3368,1655,1713
40505,62764,6218,30212,4130,56546,3368,1655,1713
40510,62774,6220,30216,4131,56554,3368,1655,1713
40515,62780,6220,30217,4131,56560,3369,1656,1713
40520,62791,6221,30222,4132,56570,3370,1656,1714
40525,62795,6222,30225,4133,56573,3370,1656,1714
40530,62805,6224,30229,4133,56581,3370,1656,1714
40535,62811,6224,30231,4133,56587,3371,1656,1715
40540,62822,6226,30236,4134,56596,3372,1657,1715
40545,62826,6226,30237,4134,56600,3372,1657,1715
40550,62836,6228,30242,4136,56608,3372,1657,1715
40555,62842,6228,30243,4136,56613,3373,1657,1716
40560,62853,6231,30249,4139,56622,3374,1658,1716
40565,62857,6231,30253,4139,56626,3374,1658,1716
40570,62867,6232,30257,4139,56635,3374,1658,1716
40575,62873,6232,30260,4139,56640,3376,1659,1717
40580,62884,6234,30264,4140,56650,3377,1660,1717
40585,62888,6234,30264,4140,56654,3377,1660,1717
40590,62898,6235,30267,4141,56663,3377,1660,1717
40595,62904,6235,30270,4141,56668,3379,1661,1718
40600,62915,6238,30274,4143,56677,3380,1661,1719
40605,62919,6238,30276,4143,56681,3380,1661,1719
40610,62929,6239,30279,4143,56690,3380,1661,1719
40615,62935,6239,30283,4143,56695,3381,1662,1719
40620,62946,6241,30285,4145,56705,3382,1662,1720
40625,62950,6241,30287,4145,56709,3382,1662,1720
40630,62960,6242,30292,4145,56718,3382,1662,1720
40635,62966,6242,30294,4145,56724,3383,1662,1721
40640,62977,6242,30300,4145,56735,3383,1662,1721
40645,62981,6242,30303,4145,56739,3383,1662,1721
40650,62991,6243,30309,4146,56748,3383,1662,1721
40655,62997,6243,30313,4146,56754,3384,1662,1722
40660,63008,6243,30317,4146,56765,3384,1662,1722
40665,63012,6243,30319,4146,56769,3384,1662,1722
40670,63022,6245,30322,4147,56777,3384,1662,1722
40675,63028,6245,30325,4147,56783,3385,1662,1723
40680,63039,6245,30331,4147,56794,3385,1662,1723
40685,63043,6246,30333,4148,56797,3385,1662,1723
40690,63053,6248,30336,4149,56805,3385,1662,1723
40695,63059,6248,30340,4149,56811,3386,1663,1723
40700,63070,6249,30347,4150,56821,3386,1663,1723
40705,63074,6250,30349,4151,56824,3386,1663,1723
40710,63084,6252,30353,4152,56832,3386,1663,1723
40715,63090,6252,30354,4152,56838,3388,1664,1724
40720,63101,6254,30362,4154,56847,3388,1664,1724
40725,63105,6255,30364,4155,56850,3388,1664,1724
40730,63115,6257,30370,4156,56858,3388,1664,1724
40735,63121,6257,30372,4156,56863,3390,1665,1725
40740,63132,6260,30378,4159,56872,3390,1665,1725
40745,63136,6260,30379,4159,56876,3390,1665,1725
40750,63146,6261,30383,4160,56885,3390,1665,1725
40755,63152,6261,30387,4160,56891,3391,1665,1726
40760,63163,6262,30397,4161,56901,3392,1666,1726
40765,63167,6262,30400,4161,56905,3392,1666,1726
40770,63177,6263,30405,4162,56914,3392,1666,1726
40775,63183,6263,30407,4162,56920,3393,1666,1727
40780,63194,6263,30413,4162,56931,3394,1667,1727
40785,63198,6263,30415,4162,56935,3394,1667,1727
40790,63208,6264,30418,4163,56944,3394,1667,1727
40795,63214,6264,30418,4163,56950,3395,1667,1728
40800,63225,6265,30421,4164,56960,3396,1667,1729
40805,63229,6266,30423,4165,56963,3396,1667,1729
40810,63239,6267,30428,4166,56972,3396,1667,1729
40815,63245,6267,30429,4166,56978,3397,1667,1730
40820,63256,6268,30437,4167,56988,3398,1668,1730
40825,63260,6268,30438,4167,56992,3398,1668,1730
40830,63270,6269,30442,4168,57001,3398,1668,1730
40835,63276,6269,30444,4168,57007,3399,1668,1731
40840,63287,6269,30447,4168,57018,3400,1669,1731
40845,63291,6269,30449,4168,57022,3400,1669,1731
40850,63301,6270,30454,4169,57031,3400,1669,1731
40855,63307,6270,30456,4169,57037,3402,1670,1732
40860,63318,6271,30461,4169,57047,3403,1671,1732
40865,63322,6271,30464,4169,57051,3403,1671,1732
40870,63332,6272,30469,4170,57060,3403,1671,1732
40875,63338,6272,30472,4170,57065,3404,1672,1732
40880,63349,6274,30477,4171,57075,3404,1672,1732
40885,63353,6274,30479,4171,57079,3404,1672,1732
40890,63363,6275,30482,4171,57088,3404,1672,1732
40895,63369,6275,30484,4171,57094,3405,1672,1733
40900,63380,6276,30490,4171,57104,3405,1672,1733
40905,63384,6276,30492,4171,57108,3405,1672,1733
40910,63394,6277,30497,4172,57117,3405,1672,1733
40915,63400,6277,30501,4172,57122,3406,1672,1734
40920,63411,6280,30507,4174,57131,3406,1672,1734
40925,63415,6281,30509,4175,57134,3406,1672,1734
40930,63425,6283,30514,4176,57142,3406,1672,1734
40935,63431,6283,30517,4176,57148,3407,1673,1734
40940,63442,6284,30521,4176,57158,3408,1673,1735
40945,63446,6285,30524,4177,57161,3408,1673,1735
40950,63456,6287,30530,4178,57169,3408,1673,1735
40955,63462,6287,30534,4178,57175,3409,1674,1735
40960,63473,6289,30537,4179,57184,3410,1674,1736
40965,63477,6290,30538,4180,57187,3410,1674,1736
40970,63487,6292,30543,4181,57195,3410,1674,1736
40975,63493,6292,30547,4181,57201,3412,1675,1737
40980,63504,6294,30554,4183,57210,3413,1675,1738
40985,63508,6295,30556,4184,57213,3413,1675,1738
40990,63518,6295,30564,4184,57223,3413,1675,1738
40995,63524,6295,30566,4184,57229,3414,1676,1738
41000,63535,6296,30567,4184,57239,3414,1676,1738
41005,63539,6296,30570,4184,57243,3414,1676,1738
41010,63549,6296,30573,4184,57253,3414,1676,1738
41015,63555,6296,30577,4184,57259,3415,1677,1738
41020,63566,6298,30583,4186,57268,3415,1677,1738
41025,63570,6298,30585,4186,57272,3415,1677,1738
41030,63580,6298,30590,4186,57282,3415,1677,1738
41035,63586,6298,30593,4186,57288,3416,1677,1739
41040,63597,6299,30597,4186,57298,3416,1677,1739
41045,63601,6300,30599,4187,57301,3416,1677,1739
41050,63611,6300,30607,4187,57311,3416,1677,1739
41055,63617,6300,30610,4187,57317,3417,1677,1740
41060,63628,6301,30613,4187,57327,3417,1677,1740
41065,63632,6301,30615,4187,57331,3417,1677,1740
41070,63642,6301,30619,4187,57341,3417,1677,1740
41075,63648,6301,30620,4187,57347,3418,1678,1740
41080,63659,6302,30623,4187,57357,3418,1678,1740
41085,63663,6302,30624,4187,57361,3418,1678,1740
41090,63673,6304,30630,4188,57369,3418,1678,1740
41095,63679,6304,30634,4188,57374,3420,1679,1741
41100,63690,6306,30639,4190,57384,3421,1680,1741
41105,63694,6306,30640,4190,57388,3421,1680,1741
41110,63704,6308,30645,4191,57396,3421,1680,1741
41115,63710,6308,30647,4191,57402,3422,1680,1742
41120,63721,6308,30651,4191,57413,3422,1680,1742
41125,63725,6308,30652,4191,57417,3422,1680,1742
41130,63735,6310,30661,4193,57425,3422,1680,1742
41135,63741,6310,30662,4193,57431,3423,1681,1742
41140,63752,6310,30667,4193,57442,3423,1681,1742
41145,63756,6310,30670,4193,57446,3423,1681,1742
41150,63766,6312,30677,4195,57454,3423,1681,1742
41155,63772,6312,30680,4195,57460,3424,1681,1743
41160,63783,6312,30686,4195,57471,3424,1681,1743
41165,63787,6312,30688,4195,57475,3424,1681,1743
41170,63797,6314,30693,4196,57483,3424,1681,1743
41175,63803,6314,30694,4196,57489,3425,1681,1744
41180,63814,6314,30699,4196,57500,3425,1681,1744
41185,63818,6314,30702,4196,57504,3425,1681,1744
41190,63828,6316,30707,4197,57512,3425,1681,1744
41195,63834,6316,30712,4197,57518,3426,1682,1744
41200,63845,6316,30718,4197,57529,3426,1682,1744
41205,63849,6316,30721,4197,57533,3426,1682,1744
41210,63859,6318,30724,4197,57541,3426,1682,1744
41215,63865,6318,30725,4197,57546,3427,1682,1745
41220,63876,6322,30732,4200,57554,3428,1682,1746
41225,63880,6322,30735,4200,57558,3428,1682,1746
41230,63890,6323,30738,4200,57567,3428,1682,1746
41235,63896,6323,30741,4200,57573,3430,1684,1746
41240,63907,6324,30747,4200,57583,3430,1684,1746
41245,63911,6324,30749,4200,57587,3430,1684,1746
41250,63921,6325,30754,4200,57596,3430,1684,1746
41255,63927,6325,30756,4200,57602,3432,1685,1747
41260,63938,6326,30763,4200,57612,3432,1685,1747
41265,63942,6326,30765,4200,57616,3432,1685,1747
41270,63952,6327,30771,4201,57625,3432,1685,1747
41275,63958,6327,30773,4201,57631,3433,1685,1748
41280,63969,6328,30780,4202,57641,3433,1685,1748
41285,63973,6329,30782,4203,57644,3433,1685,1748
41290,63983,6330,30787,4203,57653,3433,1685,1748
41295,63989,6330,30789,4203,57659,3434,1685,1749
41300,64000,6331,30792,4203,57669,3434,1685,1749
41305,64004,6332,30796,4204,57672,3434,1685,1749
41310,64014,6333,30802,4205,57681,3434,1685,1749
41315,64020,6333,30804,4205,57687,3435,1686,1749
41320,64031,6334,30812,4206,57697,3435,1686,1749
41325,64035,6335,30815,4207,57700,3435,1686,1749
41330,64045,6337,30820,4208,57708,3435,1686,1749
41335,64051,6337,30821,4208,57714,3436,1686,1750
41340,64062,6340,30825,4210,57722,3436,1686,1750
41345,64066,6340,30827,4210,57726,3436,1686,1750
41350,64076,6341,30834,4211,57735,3436,1686,1750
41355,64082,6341,30837,4211,57741,3437,1687,1750
41360,64093,6341,30844,4211,57752,3437,1687,1750
41365,64097,6341,30846,4211,57756,3437,1687,1750
41370,64107,6342,30851,4212,57765,3437,1687,1750
41375,64113,6342,30853,4212,57771,3438,1687,1751
41380,64124,6342,30859,4212,57782,3438,1687,1751
41385,64128,6342,30862,4212,57786,3438,1687,1751
41390,64138,6343,30869,4212,57795,3438,1687,1751
41395,64144,6343,30871,4212,57801,3439,1687,1752
41400,64155,6343,30879,4212,57812,3439,1687,1752
41405,64159,6343,30880,4212,57816,3439,1687,1752
41410,64169,6344,30884,4213,57825,3439,1687,1752
41415,64175,6344,30887,4213,57831,3440,1688,1752
41420,64186,6344,30894,4213,57842,3440,1688,1752
41425,64190,6344,30897,4213,57846,3440,1688,1752
41430,64200,6345,30901,4213,57855,3440,1688,1752
41435,64206,6345,30904,4213,57861,3441,1689,1752
41440,64217,6345,30909,4213,57872,3442,1690,1752
41445,64221,6345,30911,4213,57876,3442,1690,1752
41450,64231,6347,30915,4214,57884,3442,1690,1752
41455,64237,6347,30916,4214,57890,3443,1690,1753
41460,64248,6350,30922,4217,57898,3444,1691,1753
41465,64252,6350,30924,4217,57902,3444,1691,1753
41470,64262,6350,30928,4217,57912,3444,1691,1753
41475,64268,6350,30929,4217,57918,3445,1691,1754
41480,64279,6351,30934,4217,57928,3445,1691,1754
41485,64283,6351,30935,4217,57932,3445,1691,1754
41490,64293,6351,30940,4217,57942,3445,1691,1754
41495,64299,6351,30944,4217,57948,3446,1691,1755
41500,64310,6352,30951,4218,57958,3446,1691,1755
41505,64314,6352,30953,4218,57962,3446,1691,1755
41510,64324,6352,30958,4218,57972,3446,1691,1755
41515,64330,6352,30961,4218,57978,3447,1691,1756
41520,64341,6353,30964,4218,57988,3447,1691,1756
41525,64345,6353,30967,4218,57992,3447,1691,1756
41530,64355,6353,30973,4218,58002,3447,1691,1756
41535,64361,6353,30975,4218,58008,3448,1692,1756
41540,64372,6354,30981,4218,58018,3448,1692,1756
41545,64376,6354,30983,4218,58022,3448,1692,1756
41550,64386,6354,30988,4218,58032,3448,1692,1756
41555,64392,6354,30990,4218,58038,3449,1693,1756
41560,64403,6355,30995,4219,58048,3449,1693,1756
41565,64407,6356,30998,4220,58051,3449,1693,1756
41570,64417,6358,31003,4221,58059,3449,1693,1756
41575,64423,6358,31006,4221,58065,3450,1693,1757
41580,64434,6360,31013,4223,58074,3450,1693,1757
41585,64438,6361,31014,4224,58077,3450,1693,1757
41590,64448,6363,31019,4226,58085,3450,1693,1757
41595,64454,6363,31023,4226,58091,3451,1694,1757
41600,64465,6365,31029,4228,58100,3452,1695,1757
41605,64469,6367,31032,4230,58102,3452,1695,1757
41610,64479,6369,31037,4230,58110,3452,1695,1757
41615,64485,6369,31040,4230,58116,3453,1695,1758
41620,64496,6371,31045,4231,58125,3454,1696,1758
41625,64500,6372,31047,4232,58128,3454,1696,1758
41630,64510,6374,31053,4233,58136,3454,1696,1758
41635,64516,6374,31056,4233,58142,3455,1696,1759
41640,64527,6375,31060,4233,58152,3456,1696,1760
41645,64531,6377,31064,4235,58154,3456,1696,1760
41650,64541,6379,31071,4236,58162,3456,1696,1760
41655,64547,6379,31074,4236,58168,3457,1697,1760
41660,64558,6380,31078,4236,58178,3457,1697,1760
41665,64562,6380,31081,4236,58182,3457,1697,1760
41670,64572,6382,31086,4237,58190,3457,1697,1760
41675,64578,6382,31090,4237,58196,3458,1697,1761
41680,64589,6383,31097,4238,58206,3458,1697,1761
41685,64593,6383,31098,4238,58210,3458,1697,1761
41690,64603,6385,31100,4238,58218,3458,1697,1761
41695,64609,6385,31102,4238,58224,3459,1698,1761
41700,64620,6387,31106,4239,58233,3460,1698,1762
41705,64624,6387,31108,4239,58237,3460,1698,1762
41710,64634,6388,31114,4240,58246,3460,1698,1762
41715,64640,6388,31116,4240,58251,3461,1698,1763
41720,64651,6391,31123,4242,58260,3461,1698,1763
41725,64655,6391,31125,4242,58264,3461,1698,1763
41730,64665,6392,31130,4243,58273,3461,1698,1763
41735,64671,6392,31132,4243,58279,3462,1698,1764
41740,64682,6394,31138,4245,58288,3462,1698,1764
41745,64686,6395,31141,4246,58291,3462,1698,1764
41750,64696,6396,31149,4246,58300,3462,1698,1764
41755,64702,6396,31150,4246,58306,3463,1698,1765
41760,64713,6398,31159,4248,58315,3463,1698,1765
41765,64717,6398,31160,4248,58319,3463,1698,1765
41770,64727,6400,31166,4250,58327,3463,1698,1765
41775,64733,6400,31171,4250,58333,3464,1699,1765
41780,64744,6402,31179,4252,58342,3464,1699,1765
41785,64748,6402,31181,4252,58346,3464,1699,1765
41790,64758,6404,31185,4253,58354,3464,1699,1765
41795,64764,6404,31188,4253,58360,3465,1700,1765
41800,64775,6405,31194,4254,58370,3465,1700,1765
41805,64779,6405,31195,4254,58374,3465,1700,1765
41810,64789,6407,31198,4255,58382,3465,1700,1765
41815,64795,6407,31200,4255,58388,3466,1701,1765
41820,64806,6408,31204,4255,58398,3467,1701,1766
41825,64810,6408,31207,4255,58402,3467,1701,1766
41830,64820,6409,31213,4256,58411,3467,1701,1766
41835,64826,6409,31218,4256,58417,3468,1702,1766
41840,64837,6411,31222,4258,58426,3468,1702,1766
41845,64841,6411,31224,4258,58430,3468,1702,1766
41850,64851,6411,31231,4258,58440,3468,1702,1766
41855,64857,6411,31233,4258,58446,3469,1703,1766
41860,64868,6411,31239,4258,58457,3469,1703,1766
41865,64872,6411,31240,4258,58461,3469,1703,1766
41870,64882,6411,31245,4258,58471,3469,1703,1766
41875,64888,6411,31247,4258,58477,3470,1703,1767
41880,64899,6411,31254,4258,58488,3470,1703,1767
41885,64903,6411,31257,4258,58492,3470,1703,1767
41890,64913,6411,31264,4258,58502,3470,1703,1767
41895,64919,6411,31268,4258,58508,3472,1704,1768
41900,64930,6411,31274,4258,58519,3472,1704,1768
41905,64934,6411,31275,4258,58523,3472,1704,1768
41910,64944,6411,31279,4258,58533,3472,1704,1768
41915,64950,6411,31282,4258,58539,3473,1705,1768
41920,64961,6411,31286,4258,58550,3473,1705,1768
41925,64965,6411,31287,4258,58554,3473,1705,1768
41930,64975,6412,31291,4259,58563,3473,1705,1768
41935,64981,6412,31295,4259,58569,3474,1705,1769
41940,64992,6414,31300,4261,58578,3474,1705,1769
41945,64996,6414,31302,4261,58582,3474,1705,1769
41950,65006,6415,31308,4262,58591,3474,1705,1769
41955,65012,6415,31311,4262,58597,3475,1706,1769
41960,65023,6417,31316,4264,58606,3475,1706,1769
41965,65027,6417,31318,4264,58610,3475,1706,1769
41970,65037,6418,31322,4265,58619,3475,1706,1769
41975,65043,6418,31325,4265,58625,3476,1707,1769
41980,65054,6419,31330,4266,58635,3476,1707,1769
41985,65058,6420,31331,4267,58638,3476,1707,1769
41990,65068,6421,31335,4267,58647,3476,1707,1769
41995,65074,6421,31337,4267,58653,3477,1707,1770
42000,65085,6422,31339,4268,58663,3478,1707,1771
42005,65089,6422,31340,4268,58667,3478,1707,1771
42010,65099,6423,31345,4269,58676,3478,1707,1771
42015,65105,6423,31348,4269,58682,3479,1708,1771
42020,65116,6424,31350,4270,58692,3480,1708,1772
42025,65120,6425,31354,4271,58695,3480,1708,1772
42030,65130,6426,31360,4272,58704,3480,1708,1772
42035,65136,6426,31362,4272,58710,3482,1709,1773
42040,65147,6429,31368,4274,58718,3483,1709,1774
42045,65151,6429,31369,4274,58722,3483,1709,1774
42050,65161,6431,31375,4275,58730,3483,1709,1774
42055,65167,6431,31378,4275,58735,3484,1709,1775
42060,65178,6433,31382,4276,58745,3485,1710,1775
42065,65182,6433,31383,4276,58749,3485,1710,1775
42070,65192,6434,31388,4276,58758,3485,1710,1775
42075,65198,6434,31391,4276,58764,3486,1710,1776
42080,65209,6435,31396,4276,58774,3487,1710,1777
42085,65213,6435,31399,4276,58778,3487,1710,1777
42090,65223,6436,31403,4276,58787,3487,1710,1777
42095,65229,6436,31407,4276,58793,3488,1711,1777
42100,65240,6437,31412,4277,58803,3489,1711,1778
42105,65244,6437,31415,4277,58807,3489,1711,1778
42110,65254,6438,31422,4277,58816,3489,1711,1778
42115,65260,6438,31422,4277,58822,3490,1711,1779
42120,65271,6439,31426,4277,58832,3491,1712,1779
42125,65275,6439,31427,4277,58836,3491,1712,1779
42130,65285,6440,31434,4278,58845,3491,1712,1779
42135,65291,6440,31440,4278,58851,3492,1713,1779
42140,65302,6441,31445,4278,58861,3492,1713,1779
42145,65306,6441,31448,4278,58865,3492,1713,1779
42150,65316,6442,31453,4278,58874,3492,1713,1779
42155,65322,6442,31457,4278,58880,3494,1715,1779
42160,65333,6443,31462,4278,58890,3494,1715,1779
42165,65337,6443,31462,4278,58894,3494,1715,1779
42170,65347,6445,31466,4278,58902,3494,1715,1779
42175,65353,6445,31468,4278,58908,3496,1717,1779
42180,65364,6447,31472,4280,58917,3496,1717,1779
42185,65368,6447,31474,4280,58921,3496,1717,1779
42190,65378,6449,31479,4281,58929,3496,1717,1779
42195,65384,6449,31483,4281,58935,3497,1718,1779
42200,65395,6450,31490,4282,58945,3497,1718,1779
42205,65399,6450,31491,4282,58949,3497,1718,1779
42210,65409,6452,31498,4283,58957,3497,1718,1779
42215,65415,6452,31503,4283,58963,3498,1718,1780
42220,65426,6452,31509,4283,58974,3498,1718,1780
42225,65430,6453,31511,4284,58977,3498,1718,1780
42230,65440,6455,31518,4285,58985,3498,1718,1780
42235,65446,6455,31522,4285,58991,3499,1719,1780
42240,65457,6456,31526,4286,59001,3500,1720,1780
42245,65461,6456,31526,4286,59005,3500,1720,1780
42250,65471,6457,31533,4287,59014,3500,1720,1780
42255,65477,6457,31536,4287,59020,3501,1720,1781
42260,65488,6457,31540,4287,59031,3502,1721,1781
42265,65492,6457,31542,4287,59035,3502,1721,1781
42270,65502,6458,31545,4287,59044,3502,1721,1781
42275,65508,6458,31548,4287,59050,3503,1721,1782
42280,65519,6458,31552,4287,59061,3504,1722,1782
42285,65523,6458,31555,4287,59065,3504,1722,1782
42290,65533,6459,31560,4287,59074,3504,1722,1782
42295,65539,6459,31562,4287,59080,3506,1723,1783
42300,65550,6461,31567,4288,59089,3507,1724,1783
42305,65554,6463,31570,4290,59091,3507,1724,1783
42310,65564,6465,31575,4290,59099,3507,1724,1783
42315,65570,6465,31579,4290,59104,3508,1724,1784
42320,65581,6467,31583,4292,59114,3509,1725,1784
42325,65585,6468,31585,4293,59117,3509,1725,1784
42330,65595,6470,31591,4294,59125,3509,1725,1784
42335,65601,6470,31595,4294,59130,3510,1726,1784
42340,65612,6472,31603,4296,59140,3511,1727,1784
42345,65616,6472,31604,4296,59144,3511,1727,1784
42350,65626,6474,31608,4296,59152,3511,1727,1784
42355,65632,6474,31611,4296,59157,3512,1728,1784
42360,65643,6476,31618,4297,59167,3513,1729,1784
42365,65647,6477,31620,4298,59170,3513,1729,1784
42370,65657,6479,31625,4300,59178,3513,1729,1784
42375,65663,6479,31627,4300,59183,3514,1729,1785
42380,65674,6481,31633,4302,59193,3515,1730,1785
42385,65678,6481,31635,4302,59197,3515,1730,1785
42390,65688,6483,31641,4303,59205,3515,1730,1785
42395,65694,6483,31645,4303,59210,3516,1731,1785
42400,65705,6485,31650,4305,59220,3517,1731,1786
42405,65709,6487,31653,4307,59222,3517,1731,1786
42410,65719,6489,31659,4309,59230,3517,1731,1786
42415,65725,6489,31661,4309,59236,3519,1733,1786
42420,65736,6491,31663,4310,59245,3520,1733,1787
42425,65740,6491,31665,4310,59249,3520,1733,1787
42430,65750,6492,31667,4311,59258,3520,1733,1787
42435,65756,6492,31671,4311,59264,3521,1734,1787
42440,65767,6493,31676,4312,59274,3522,1735,1787
42445,65771,6493,31679,4312,59278,3522,1735,1787
42450,65781,6494,31683,4313,59287,3522,1735,1787
42455,65787,6494,31687,4313,59293,3523,1736,1787
42460,65798,6494,31692,4313,59304,3524,1737,1787
42465,65802,6494,31695,4313,59308,3524,1737,1787
42470,65812,6495,31702,4314,59317,3524,1737,1787
42475,65818,6495,31705,4314,59323,3525,1737,1788
42480,65829,6497,31708,4316,59332,3525,1737,1788
42485,65833,6497,31710,4316,59336,3525,1737,1788
42490,65843,6498,31716,4316,59345,3525,1737,1788
42495,65849,6498,31717,4316,59351,3526,1737,1789
42500,65860,6498,31723,4316,59362,3526,1737,1789
42505,65864,6498,31727,4316,59366,3526,1737,1789
42510,65874,6499,31733,4317,59375,3526,1737,1789
42515,65880,6499,31738,4317,59381,3527,1738,1789
42520,65891,6499,31744,4317,59392,3527,1738,1789
42525,65895,6499,31746,4317,59396,3527,1738,1789
42530,65905,6501,31752,4318,59404,3527,1738,1789
42535,65911,6501,31752,4318,59410,3529,1738,1791
42540,65922,6503,31756,4319,59419,3529,1738,1791
42545,65926,6503,31757,4319,59423,3529,1738,1791
42550,65936,6503,31757,4319,59433,3529,1738,1791
42555,65942,6503,31758,4319,59439,3530,1738,1792
42560,65953,6505,31767,4320,59448,3531,1739,1792
42565,65957,6506,31770,4321,59451,3531,1739,1792
42570,65967,6506,31773,4321,59461,3531,1739,1792
42575,65973,6506,31779,4321,59467,3532,1740,1792
42580,65984,6507,31785,4322,59477,3533,1740,1793
42585,65988,6507,31787,4322,59481,3533,1740,1793
42590,65998,6507,31792,4322,59491,3533,1740,1793
42595,66004,6507,31793,4322,59497,3534,1740,1794
42600,66015,6509,31799,4323,59506,3535,1741,1794
42605,66019,6509,31800,4323,59510,3535,1741,1794
42610,66029,6509,31805,4323,59520,3535,1741,1794
42615,66035,6509,31808,4323,59526,3536,1741,1795
42620,66046,6510,31813,4324,59536,3536,1741,1795
42625,66050,6510,31816,4324,59540,3536,1741,1795
42630,66060,6510,31821,4324,59550,3536,1741,1795
42635,66066,6510,31824,4324,59556,3537,1742,1795
42640,66077,6511,31827,4324,59566,3537,1742,1795
42645,66081,6511,31828,4324,59570,3537,1742,1795
42650,66091,6513,31833,4325,59578,3537,1742,1795
42655,66097,6513,31837,4325,59583,3539,1743,1796
42660,66108,6515,31844,4327,59593,3539,1743,1796
42665,66112,6516,31847,4328,59596,3539,1743,1796
42670,66122,6518,31850,4328,59604,3539,1743,1796
42675,66128,6518,31852,4328,59610,3540,1743,1797
42680,66139,6519,31859,4329,59620,3540,1743,1797
42685,66143,6519,31860,4329,59624,3540,1743,1797
42690,66153,6521,31866,4330,59632,3540,1743,1797
42695,66159,6521,31869,4330,59638,3541,1743,1798
42700,66170,6521,31871,4330,59649,3541,1743,1798
42705,66174,6522,31873,4331,59652,3541,1743,1798
42710,66184,6524,31876,4332,59660,3541,1743,1798
42715,66190,6524,31878,4332,59665,3542,1743,1799
42720,66201,6525,31882,4333,59676,3543,1744,1799
42725,66205,6525,31883,4333,59680,3543,1744,1799
42730,66215,6527,31887,4334,59688,3543,1744,1799
42735,66221,6527,31890,4334,59694,3544,1745,1799
42740,66232,6527,31895,4334,59705,3545,1746,1799
42745,66236,6527,31897,4334,59709,3545,1746,1799
42750,66246,6529,31903,4336,59717,3545,1746,1799
42755,66252,6529,31905,4336,59723,3546,1746,1800
42760,66263,6529,31912,4336,59734,3547,1747,1800
42765,66267,6529,31913,4336,59738,3547,1747,1800
42770,66277,6531,31920,4337,59746,3547,1747,1800
42775,66283,6531,31924,4337,59752,3549,1747,1802
42780,66294,6534,31929,4339,59760,3550,1748,1802
42785,66298,6534,31932,4339,59764,3550,1748,1802
42790,66308,6536,31937,4340,59772,3550,1748,1802
42795,66314,6536,31941,4340,59778,3551,1749,1802
42800,66325,6538,31946,4341,59787,3551,1749,1802
42805,66329,6538,31948,4341,59791,3551,1749,1802
42810,66339,6540,31951,4342,59799,3551,1749,1802
42815,66345,6540,31953,4342,59805,3552,1749,1803
42820,66356,6542,31956,4343,59814,3552,1749,1803
42825,66360,6542,31957,4343,59818,3552,1749,1803
42830,66370,6544,31963,4343,59826,3552,1749,1803
42835,66376,6544,31966,4343,59831,3553,1749,1804
42840,66387,6547,31970,4346,59840,3554,1749,1805
42845,66391,6548,31972,4347,59843,3554,1749,1805
42850,66401,6549,31977,4348,59852,3554,1749,1805
42855,66407,6549,31978,4348,59858,3555,1749,1806
42860,66418,6550,31983,4348,59868,3556,1749,1807
42865,66422,6551,31985,4349,59871,3556,1749,1807
42870,66432,6552,31989,4349,59880,3556,1749,1807
42875,66438,6552,31992,4349,59886,3557,1750,1807
42880,66449,6553,31999,4349,59896,3558,1750,1808
42885,66453,6553,32000,4349,59900,3558,1750,1808
42890,66463,6554,32004,4349,59909,3558,1750,1808
42895,66469,6554,32007,4349,59915,3560,1751,1809
42900,66480,6556,32014,4351,59924,3561,1751,1810
42905,66484,6557,32017,4352,59927,3561,1751,1810
42910,66494,6557,32021,4352,59937,3561,1751,1810
42915,66500,6557,32021,4352,59943,3562,1751,1811
42920,66511,6559,32029,4354,59952,3562,1751,1811
42925,66515,6560,32032,4355,59955,3562,1751,1811
42930,66525,6560,32036,4355,59965,3562,1751,1811
42935,66531,6560,32038,4355,59971,3563,1751,1812
42940,66542,6561,32042,4355,59981,3563,1751,1812
42945,66546,6561,32042,4355,59985,3563,1751,1812
42950,66556,6562,32046,4355,59994,3563,1751,1812
42955,66562,6562,32048,4355,60000,3564,1751,1813
42960,66573,6565,32053,4357,60008,3564,1751,1813
42965,66577,6565,32056,4357,60012,3564,1751,1813
42970,66587,6566,32061,4358,60021,3564,1751,1813
42975,66593,6566,32064,4358,60027,3565,1752,1813
42980,66604,6568,32069,4359,60036,3565,1752,1813
42985,66608,6568,32071,4359,60040,3565,1752,1813
42990,66618,6569,32076,4360,60049,3565,1752,1813
42995,66624,6569,32079,4360,60055,3566,1752,1814
43000,66635,6571,32084,4362,60064,3566,1752,1814
43005,66639,6571,32087,4362,60068,3566,1752,1814
43010,66649,6573,32091,4364,60076,3566,1752,1814
43015,66655,6573,32095,4364,60082,3568,1753,1815
43020,66666,6574,32100,4364,60092,3568,1753,1815
43025,66670,6574,32101,4364,60096,3568,1753,1815
43030,66680,6576,32106,4364,60104,3568,1753,1815
43035,66686,6576,32111,4364,60110,3569,1754,1815
43040,66697,6578,32119,4366,60119,3569,1754,1815
43045,66701,6578,32120,4366,60123,3569,1754,1815
43050,66711,6580,32127,4367,60131,3569,1754,1815
43055,66717,6580,32129,4367,60137,3570,1755,1815
43060,66728,6582,32135,4368,60146,3570,1755,1815
43065,66732,6582,32135,4368,60150,3570,1755,1815
43070,66742,6584,32140,4369,60158,3570,1755,1815
43075,66748,6584,32144,4369,60163,3571,1756,1815
43080,66759,6586,32146,4371,60173,3572,1756,1816
43085,66763,6587,32148,4372,60176,3572,1756,1816
43090,66773,6588,32153,4372,60185,3572,1756,1816
43095,66779,6588,32157,4372,60191,3573,1757,1816
43100,66790,6588,32161,4372,60202,3574,1757,1817
43105,66794,6588,32163,4372,60206,3574,1757,1817
43110,66804,6589,32170,4373,60215,3574,1757,1817
43115,66810,6589,32173,4373,60221,3575,1757,1818
43120,66821,6589,32178,4373,60232,3575,1757,1818
43125,66825,6589,32179,4373,60236,3575,1757,1818
43130,66835,6590,32184,4374,60245,3575,1757,1818
43135,66841,6590,32189,4374,60251,3577,1759,1818
43140,66852,6590,32195,4374,60262,3577,1759,1818
43145,66856,6590,32197,4374,60266,3577,1759,1818
43150,66866,6591,32203,4375,60275,3577,1759,1818
43155,66872,6591,32206,4375,60281,3579,1760,1819
43160,66883,6591,32210,4375,60292,3579,1760,1819
43165,66887,6591,32212,4375,60296,3579,1760,1819
43170,66897,6592,32217,4376,60305,3579,1760,1819
43175,66903,6592,32221,4376,60311,3580,1760,1820
43180,66914,6592,32222,4376,60322,3580,1760,1820
43185,66918,6592,32224,4376,60326,3580,1760,1820
43190,66928,6594,32230,4378,60334,3580,1760,1820
43195,66934,6594,32232,4378,60340,3581,1760,1821
43200,66945,6597,32240,4381,60348,3582,1760,1822
43205,66949,6597,32241,4381,60352,3582,1760,1822
43210,66959,6599,32243,4382,60360,3582,1760,1822
43215,66965,6599,32246,4382,60366,3583,1761,1822
43220,66976,6601,32255,4383,60375,3584,1762,1822
43225,66980,6601,32257,4383,60379,3584,1762,1822
43230,66990,6603,32261,4384,60387,3584,1762,1822
43235,66996,6603,32263,4384,60393,3585,1762,1823
43240,67007,6606,32272,4387,60401,3586,1763,1823
43245,67011,6606,32273,4387,60405,3586,1763,1823
43250,67021,6608,32277,4387,60413,3586,1763,1823
43255,67027,6608,32280,4387,60419,3587,1763,1824
43260,67038,6611,32288,4389,60427,3588,1763,1825
43265,67042,6611,32290,4389,60431,3588,1763,1825
43270,67052,6613,32296,4390,60439,3588,1763,1825
43275,67058,6613,32300,4390,60445,3590,1765,1825
43280,67069,6615,32305,4392,60454,3591,1766,1825
43285,67073,6616,32308,4393,60457,3591,1766,1825
43290,67083,6618,32312,4394,60465,3591,1766,1825
43295,67089,6618,32315,4394,60471,3593,1766,1827
43300,67100,6619,32322,4395,60481,3594,1767,1827
43305,67104,6619,32323,4395,60485,3594,1767,1827
43310,67114,6621,32328,4396,60493,3594,1767,1827
43315,67120,6621,32329,4396,60499,3595,1768,1827
43320,67131,6623,32332,4397,60508,3596,1768,1828
43325,67135,6623,32333,4397,60512,3596,1768,1828
43330,67145,6623,32342,4397,60522,3596,1768,1828
43335,67151,6623,32345,4397,60528,3597,1769,1828
43340,67162,6623,32351,4397,60539,3597,1769,1828
43345,67166,6623,32354,4397,60543,3597,1769,1828
43350,67176,6623,32361,4397,60553,3597,1769,1828
43355,67182,6623,32364,4397,60559,3598,1770,1828
43360,67193,6623,32370,4397,60570,3598,1770,1828
43365,67197,6623,32372,4397,60574,3598,1770,1828
43370,67207,6623,32377,4397,60584,3598,1770,1828
43375,67213,6623,32378,4397,60590,3599,1770,1829
43380,67224,6623,32383,4397,60601,3599,1770,1829
43385,67228,6623,32384,4397,60605,3599,1770,1829
43390,67238,6623,32389,4397,60615,3599,1770,1829
43395,67244,6623,32391,4397,60621,3600,1770,1830
43400,67255,6623,32394,4397,60632,3600,1770,1830
43405,67259,6623,32398,4397,60636,3600,1770,1830
43410,67269,6623,32405,4397,60646,3600,1770,1830
43415,67275,6623,32406,4397,60652,3602,1770,1832
43420,67286,6623,32408,4397,60663,3602,1770,1832
43425,67290,6623,32410,4397,60667,3602,1770,1832
43430,67300,6624,32418,4398,60676,3602,1770,1832
43435,67306,6624,32422,4398,60682,3604,1772,1832
43440,67317,6626,32427,4400,60691,3605,1772,1833
43445,67321,6626,32429,4400,60695,3605,1772,1833
43450,67331,6627,32434,4401,60704,3605,1772,1833
43455,67337,6627,32437,4401,60710,3606,1772,1834
43460,67348,6629,32444,4403,60719,3607,1773,1834
43465,67352,6629,32447,4403,60723,3607,1773,1834
43470,67362,6630,32449,4403,60732,3607,1773,1834
43475,67368,6630,32453,4403,60738,3608,1774,1834
43480,67379,6631,32457,4403,60748,3609,1775,1834
43485,67383,6631,32457,4403,60752,3609,1775,1834
43490,67393,6632,32463,4403,60761,3609,1775,1834
43495,67399,6632,32466,4403,60767,3610,1776,1834
43500,67410,6633,32471,4403,60777,3611,1777,1834
43505,67414,6633,32472,4403,60781,3611,1777,1834
43510,67424,6634,32477,4404,60790,3611,1777,1834
43515,67430,6634,32479,4404,60796,3612,1777,1835
43520,67441,6636,32486,4405,60805,3613,1778,1835
43525,67445,6636,32487,4405,60809,3613,1778,1835
43530,67455,6637,32492,4406,60818,3613,1778,1835
43535,67461,6637,32495,4406,60824,3614,1779,1835
43540,67472,6638,32500,4406,60834,3615,1779,1836
43545,67476,6638,32502,4406,60838,3615,1779,1836
43550,67486,6640,32507,4407,60846,3615,1779,1836
43555,67492,6640,32511,4407,60851,3617,1781,1836
43560,67503,6642,32514,4408,60861,3618,1782,1836
43565,67507,6643,32515,4409,60864,3618,1782,1836
43570,67517,6645,32520,4410,60872,3618,1782,1836
43575,67523,6645,32523,4410,60878,3619,1783,1836
43580,67534,6646,32528,4411,60888,3619,1783,1836
43585,67538,6647,32530,4412,60891,3619,1783,1836
43590,67548,6649,32534,4412,60899,3619,1783,1836
43595,67554,6649,32537,4412,60904,3620,1783,1837
43600,67565,6652,32544,4414,60913,3620,1783,1837
43605,67569,6654,32546,4416,60915,3620,1783,1837
43610,67579,6656,32552,4417,60923,3620,1783,1837
43615,67585,6656,32556,4417,60928,3621,1784,1837
43620,67596,6660,32564,4421,60936,3621,1784,1837
43625,67600,6661,32565,4422,60939,3621,1784,1837
43630,67610,6662,32572,4423,60948,3621,1784,1837
43635,67616,6662,32576,4423,60954,3622,1784,1838
43640,67627,6665,32582,4426,60962,3622,1784,1838
43645,67631,6666,32586,4427,60965,3622,1784,1838
43650,67641,6667,32589,4427,60974,3622,1784,1838
43655,67647,6667,32593,4427,60980,3623,1785,1838
43660,67658,6668,32596,4427,60990,3623,1785,1838
43665,67662,6668,32597,4427,60994,3623,1785,1838
43670,67672,6669,32601,4427,61003,3623,1785,1838
43675,67678,6669,32605,4427,61009,3625,1786,1839
43680,67689,6672,32610,4430,61017,3626,1786,1840
43685,67693,6672,32612,4430,61021,3626,1786,1840
43690,67703,6673,32612,4430,61030,3626,1786,1840
43695,67709,6673,32615,4430,61035,3627,1786,1841
43700,67720,6675,32618,4432,61045,3628,1786,1842
43705,67724,6675,32620,4432,61049,3628,1786,1842
43710,67734,6676,32627,4433,61058,3628,1786,1842
43715,67740,6676,32632,4433,61063,3629,1786,1843
43720,67751,6678,32636,4435,61073,3630,1786,1844
43725,67755,6678,32638,4435,61077,3630,1786,1844
43730,67765,6679,32642,4435,61086,3630,1786,1844
43735,67771,6679,32645,4435,61092,3631,1786,1845
43740,67782,6679,32649,4435,61103,3632,1786,1846
43745,67786,6679,32651,4435,61107,3632,1786,1846
43750,67796,6679,32656,4435,61117,3632,1786,1846
43755,67802,6679,32659,4435,61123,3633,1787,1846
43760,67813,6679,32664,4435,61134,3634,1787,1847
43765,67817,6679,32665,4435,61138,3634,1787,1847
43770,67827,6679,32668,4435,61148,3634,1787,1847
43775,67833,6679,32672,4435,61154,3635,1788,1847
43780,67844,6679,32675,4435,61165,3635,1788,1847
43785,67848,6679,32678,4435,61169,3635,1788,1847
43790,67858,6679,32681,4435,61179,3635,1788,1847
43795,67864,6679,32684,4435,61184,3637,1788,1849
43800,67875,6681,32687,4437,61194,3637,1788,1849
43805,67879,6681,32690,4437,61198,3637,1788,1849
43810,67889,6682,32696,4437,61207,3637,1788,1849
43815,67895,6682,32698,4437,61213,3638,1789,1849
43820,67906,6685,32707,4440,61221,3638,1789,1849
43825,67910,6686,32709,4441,61224,3638,1789,1849
43830,67920,6687,32715,4442,61233,3638,1789,1849
43835,67926,6687,32718,4442,61239,3639,1789,1850
43840,67937,6689,32725,4444,61248,3639,1789,1850
43845,67941,6689,32726,4444,61252,3639,1789,1850
43850,67951,6691,32727,4444,61260,3639,1789,1850
43855,67957,6691,32730,4444,61266,3640,1789,1851
43860,67968,6692,32735,4444,61276,3640,1789,1851
43865,67972,6693,32736,4445,61279,3640,1789,1851
43870,67982,6695,32742,4446,61287,3640,1789,1851
43875,67988,6695,32745,4446,61293,3641,1790,1851
43880,67999,6696,32752,4446,61303,3642,1790,1852
43885,68003,6697,32754,4447,61306,3642,1790,1852
43890,68013,6699,32759,4448,61314,3642,1790,1852
43895,68019,6699,32764,4448,61320,3643,1791,1852
43900,68030,6700,32768,4449,61330,3644,1791,1853
43905,68034,6702,32770,4451,61332,3644,1791,1853
43910,68044,6704,32775,4452,61340,3644,1791,1853
43915,68050,6704,32777,4452,61346,3646,1792,1854
43920,68061,6706,32782,4453,61355,3647,1793,1854
43925,68065,6708,32784,4455,61357,3647,1793,1854
43930,68075,6710,32790,4456,61365,3647,1793,1854
43935,68081,6710,32792,4456,61370,3648,1793,1855
43940,68092,6712,32795,4458,61380,3648,1793,1855
43945,68096,6713,32797,4459,61383,3648,1793,1855
43950,68106,6715,32799,4459,61391,3648,1793,1855
43955,68112,6715,32802,4459,61396,3649,1793,1856
43960,68123,6718,32808,4462,61405,3649,1793,1856
43965,68127,6719,32811,4463,61408,3649,1793,1856
43970,68137,6721,32815,4464,61416,3649,1793,1856
43975,68143,6721,32817,4464,61422,3650,1793,1857
43980,68154,6722,32820,4464,61432,3650,1793,1857
43985,68158,6723,32822,4465,61435,3650,1793,1857
43990,68168,6725,32827,4465,61443,3650,1793,1857
43995,68174,6725,32832,4465,61449,3651,1794,1857
44000,68185,6726,32841,4466,61459,3651,1794,1857
44005,68189,6726,32842,4466,61463,3651,1794,1857
44010,68199,6728,32845,4467,61471,3651,1794,1857
44015,68205,6728,32846,4467,61477,3652,1794,1858
44020,68216,6728,32850,4467,61488,3652,1794,1858
44025,68220,6728,32852,4467,61492,3652,1794,1858
44030,68230,6730,32859,4469,61500,3652,1794,1858
44035,68236,6730,32860,4469,61506,3654,1794,1860
44040,68247,6731,32865,4470,61516,3655,1794,1861
44045,68251,6731,32868,4470,61520,3655,1794,1861
44050,68261,6732,32875,4471,61529,3655,1794,1861
44055,68267,6732,32877,4471,61535,3656,1794,1862
44060,68278,6732,32883,4471,61546,3657,1795,1862
44065,68282,6732,32884,4471,61550,3657,1795,1862
44070,68292,6733,32887,4471,61559,3657,1795,1862
44075,68298,6733,32888,4471,61565,3658,1795,1863
44080,68309,6733,32894,4471,61576,3659,1796,1863
44085,68313,6733,32896,4471,61580,3659,1796,1863
44090,68323,6734,32901,4472,61589,3659,1796,1863
44095,68329,6734,32903,4472,61594,3660,1796,1864
44100,68340,6738,32907,4475,61602,3661,1796,1865
44105,68344,6738,32909,4475,61606,3661,1796,1865
44110,68354,6740,32914,4477,61614,3661,1796,1865
44115,68360,6740,32916,4477,61619,3662,1796,1866
44120,68371,6743,32918,4479,61628,3663,1796,1867
44125,68375,6744,32920,4480,61631,3663,1796,1867
44130,68385,6746,32925,4481,61639,3663,1796,1867
44135,68391,6746,32927,4481,61644,3664,1797,1867
44140,68402,6750,32933,4485,61652,3665,1797,1868
44145,68406,6750,32936,4485,61656,3665,1797,1868
44150,68416,6752,32940,4485,61664,3665,1797,1868
44155,68422,6752,32941,4485,61670,3667,1798,1869
44160,68433,6754,32947,4487,61679,3668,1799,1869
44165,68437,6754,32951,4487,61683,3668,1799,1869
44170,68447,6754,32957,4487,61693,3668,1799,1869
44175,68453,6754,32961,4487,61699,3669,1800,1869
44180,68464,6754,32966,4487,61710,3669,1800,1869
44185,68468,6754,32968,4487,61714,3669,1800,1869
44190,68478,6754,32975,4487,61724,3669,1800,1869
44195,68484,6754,32978,4487,61730,3670,1801,1869
44200,68495,6754,32983,4487,61741,3670,1801,1869
44205,68499,6754,32984,4487,61745,3670,1801,1869
44210,68509,6754,32990,4487,61755,3670,1801,1869
44215,68515,6754,32994,4487,61761,3671,1802,1869
44220,68526,6754,32999,4487,61772,3671,1802,1869
44225,68530,6754,33001,4487,61776,3671,1802,1869
44230,68540,6754,33003,4487,61786,3671,1802,1869
44235,68546,6754,33006,4487,61792,3672,1802,1870
44240,68557,6754,33011,4487,61803,3672,1802,1870
44245,68561,6754,33012,4487,61807,3672,1802,1870
44250,68571,6754,33018,4487,61817,3672,1802,1870
44255,68577,6754,33019,4487,61823,3673,1802,1871
44260,68588,6754,33024,4487,61834,3673,1802,1871
44265,68592,6754,33024,4487,61838,3673,1802,1871
44270,68602,6756,33027,4487,61846,3673,1802,1871
44275,68608,6756,33031,4487,61851,3675,1802,1873
44280,68619,6759,33037,4490,61860,3676,1803,1873
44285,68623,6759,33039,4490,61864,3676,1803,1873
44290,68633,6761,33043,4491,61872,3676,1803,1873
44295,68639,6761,33047,4491,61878,3677,1804,1873
44300,68650,6763,33052,4492,61887,3678,1805,1873
44305,68654,6763,33055,4492,61891,3678,1805,1873
44310,68664,6765,33058,4492,61899,3678,1805,1873
44315,68670,6765,33063,4492,61905,3679,1806,1873
44320,68681,6767,33066,4493,61914,3680,1806,1874
44325,68685,6767,33068,4493,61918,3680,1806,1874
44330,68695,6769,33073,4495,61926,3680,1806,1874
44335,68701,6769,33077,4495,61932,3681,1807,1874
44340,68712,6771,33084,4496,61941,3682,1808,1874
44345,68716,6771,33088,4496,61945,3682,1808,1874
44350,68726,6773,33092,4497,61953,3682,1808,1874
44355,68732,6773,33097,4497,61959,3683,1809,1874
44360,68743,6775,33100,4499,61968,3684,1809,1875
44365,68747,6775,33103,4499,61972,3684,1809,1875
44370,68757,6777,33109,4501,61980,3684,1809,1875
44375,68763,6777,33112,4501,61986,3685,1809,1876
44380,68774,6779,33117,4502,61995,3686,1809,1877
44385,68778,6779,33119,4502,61999,3686,1809,1877
44390,68788,6781,33121,4502,62007,3686,1809,1877
44395,68794,6781,33123,4502,62013,3688,1809,1879
44400,68805,6783,33129,4503,62022,3689,1810,1879
44405,68809,6783,33131,4503,62026,3689,1810,1879
44410,68819,6784,33136,4503,62035,3689,1810,1879
44415,68825,6784,33138,4503,62041,3690,1811,1879
44420,68836,6784,33144,4503,62052,3690,1811,1879
44425,68840,6784,33146,4503,62056,3690,1811,1879
44430,68850,6785,33150,4503,62065,3690,1811,1879
44435,68856,6785,33152,4503,62071,3691,1811,1880
44440,68867,6785,33157,4503,62082,3691,1811,1880
44445,68871,6785,33159,4503,62086,3691,1811,1880
44450,68881,6786,33162,4504,62095,3691,1811,1880
44455,68887,6786,33165,4504,62101,3692,1812,1880
44460,68898,6786,33170,4504,62112,3692,1812,1880
44465,68902,6786,33172,4504,62116,3692,1812,1880
44470,68912,6787,33178,4505,62125,3692,1812,1880
44475,68918,6787,33180,4505,62131,3693,1813,1880
44480,68929,6787,33185,4505,62142,3693,1813,1880
44485,68933,6787,33187,4505,62146,3693,1813,1880
44490,68943,6788,33191,4505,62155,3693,1813,1880
44495,68949,6788,33193,4505,62161,3694,1813,1881
44500,68960,6789,33198,4506,62171,3694,1813,1881
44505,68964,6789,33199,4506,62175,3694,1813,1881
44510,68974,6791,33201,4507,62183,3694,1813,1881
44515,68980,6791,33202,4507,62189,3696,1813,1883
44520,68991,6793,33210,4508,62198,3696,1813,1883
44525,68995,6793,33212,4508,62202,3696,1813,1883
44530,69005,6795,33216,4508,62210,3696,1813,1883
44535,69011,6795,33217,4508,62216,3697,1814,1883
44540,69022,6797,33221,4509,62225,3697,1814,1883
44545,69026,6797,33223,4509,62229,3697,1814,1883
44550,69036,6799,33224,4509,62237,3697,1814,1883
44555,69042,6799,33227,4509,62243,3698,1814,1884
44560,69053,6801,33232,4510,62252,3698,1814,1884
44565,69057,6801,33235,4510,62256,3698,1814,1884
44570,69067,6803,33238,4511,62264,3698,1814,1884
44575,69073,6803,33240,4511,62270,3699,1814,1885
44580,69084,6804,33243,4512,62280,3700,1815,1885
44585,69088,6804,33245,4512,62284,3700,1815,1885
44590,69098,6806,33249,4514,62292,3700,1815,1885
44595,69104,6806,33251,4514,62298,3701,1815,1886
44600,69115,6807,33256,4515,62308,3702,1816,1886
44605,69119,6808,33258,4516,62311,3702,1816,1886
44610,69129,6810,33261,4517,62319,3702,1816,1886
44615,69135,6810,33264,4517,62325,3703,1816,1887
44620,69146,6813,33273,4520,62333,3704,1817,1887
44625,69150,6815,33276,4522,62335,3704,1817,1887
44630,69160,6817,33282,4523,62343,3704,1817,1887
44635,69166,6817,33286,4523,62348,3705,1817,1888
44640,69177,6820,33290,4525,62357,3706,1817,1889
44645,69181,6820,33290,4525,62361,3706,1817,1889
44650,69191,6821,33294,4525,62370,3706,1817,1889
44655,69197,6821,33297,4525,62375,3707,1817,1890
44660,69208,6823,33302,4526,62385,3707,1817,1890
44665,69212,6823,33304,4526,62389,3707,1817,1890
44670,69222,6824,33309,4527,62398,3707,1817,1890
44675,69228,6824,33314,4527,62404,3708,1818,1890
44680,69239,6825,33321,4528,62414,3708,1818,1890
44685,69243,6826,33324,4529,62417,3708,1818,1890
44690,69253,6827,33327,4529,62426,3708,1818,1890
44695,69259,6827,33329,4529,62432,3709,1818,1891
44700,69270,6828,33335,4529,62442,3709,1818,1891
44705,69274,6828,33336,4529,62446,3709,1818,1891
44710,69284,6829,33339,4529,62455,3709,1818,1891
44715,69290,6829,33340,4529,62461,3710,1818,1892
44720,69301,6831,33346,4530,62470,3710,1818,1892
44725,69305,6831,33346,4530,62474,3710,1818,1892
44730,69315,6832,33351,4530,62483,3710,1818,1892
44735,69321,6832,33353,4530,62489,3711,1818,1893
44740,69332,6834,33359,4532,62498,3711,1818,1893
44745,69336,6835,33362,4533,62501,3711,1818,1893
44750,69346,6837,33368,4534,62509,3711,1818,1893
44755,69352,6837,33371,4534,62515,3712,1819,1893
44760,69363,6839,33376,4535,62524,3712,1819,1893
44765,69367,6840,33379,4536,62527,3712,1819,1893
44770,69377,6841,33383,4537,62536,3712,1819,1893
44775,69383,6841,33384,4537,62541,3713,1819,1894
44780,69394,6843,33388,4538,62551,3713,1819,1894
44785,69398,6843,33391,4538,62555,3713,1819,1894
44790,69408,6844,33396,4539,62564,3713,1819,1894
44795,69414,6844,33399,4539,62570,3714,1820,1894
44800,69425,6845,33401,4540,62580,3714,1820,1894
44805,69429,6845,33402,4540,62584,3714,1820,1894
44810,69439,6846,33407,4541,62593,3714,1820,1894
44815,69445,6846,33411,4541,62599,3716,1821,1895
44820,69456,6848,33417,4542,62608,3716,1821,1895
44825,69460,6848,33417,4542,62612,3716,1821,1895
44830,69470,6848,33421,4542,62622,3716,1821,1895
44835,69476,6848,33423,4542,62628,3718,1822,1896
44840,69487,6849,33428,4542,62638,3719,1822,1897
44845,69491,6849,33430,4542,62642,3719,1822,1897
44850,69501,6849,33436,4542,62652,3719,1822,1897
44855,69507,6849,33441,4542,62658,3720,1823,1897
44860,69518,6850,33448,4543,62668,3721,1824,1897
44865,69522,6850,33450,4543,62672,3721,1824,1897
44870,69532,6851,33454,4544,62681,3721,1824,1897
44875,69538,6851,33456,4544,62687,3722,1825,1897
44880,69549,6852,33458,4544,62697,3723,1825,1898
44885,69553,6852,33459,4544,62701,3723,1825,1898
44890,69563,6854,33467,4546,62709,3723,1825,1898
44895,69569,6854,33470,4546,62714,3724,1825,1899
44900,69580,6855,33475,4547,62725,3724,1825,1899
44905,69584,6855,33476,4547,62729,3724,1825,1899
44910,69594,6857,33481,4548,62737,3724,1825,1899
44915,69600,6857,33483,4548,62742,3725,1825,1900
44920,69611,6858,33484,4549,62753,3725,1825,1900
44925,69615,6858,33486,4549,62757,3725,1825,1900
44930,69625,6860,33490,4549,62765,3725,1825,1900
44935,69631,6860,33493,4549,62771,3726,1825,1901
44940,69642,6860,33498,4549,62782,3726,1825,1901
44945,69646,6860,33502,4549,62786,3726,1825,1901
44950,69656,6862,33505,4549,62794,3726,1825,1901
44955,69662,6862,33508,4549,62800,3727,1826,1901
44960,69673,6862,33513,4549,62811,3727,1826,1901
44965,69677,6862,33516,4549,62815,3727,1826,1901
44970,69687,6864,33521,4550,62823,3727,1826,1901
44975,69693,6864,33524,4550,62829,3729,1827,1902
44980,69704,6864,33528,4550,62840,3729,1827,1902
44985,69708,6865,33531,4551,62843,3729,1827,1902
44990,69718,6867,33536,4552,62851,3729,1827,1902
44995,69724,6867,33538,4552,62857,3731,1829,1902
45000,69735,6869,33545,4553,62866,3732,1829,1903
45005,69739,6869,33546,4553,62870,3732,1829,1903
45010,69749,6870,33550,4554,62879,3732,1829,1903
45015,69755,6870,33553,4554,62885,3733,1830,1903
45020,69766,6873,33559,4557,62893,3734,1830,1904
45025,69770,6873,33559,4557,62897,3734,1830,1904
45030,69780,6874,33566,4558,62906,3734,1830,1904
45035,69786,6874,33570,4558,62912,3735,1831,1904
45040,69797,6875,33574,4559,62922,3736,1831,1905
45045,69801,6875,33576,4559,62926,3736,1831,1905
45050,69811,6876,33581,4559,62935,3736,1831,1905
45055,69817,6876,33584,4559,62941,3737,1831,1906
45060,69828,6878,33589,4561,62950,3738,1831,1907
45065,69832,6878,33590,4561,62954,3738,1831,1907
45070,69842,6879,33592,4562,62963,3738,1831,1907
45075,69848,6879,33596,4562,62969,3739,1832,1907
45080,69859,6880,33603,4563,62979,3739,1832,1907
45085,69863,6880,33604,4563,62983,3739,1832,1907
45090,69873,6881,33607,4564,62992,3739,1832,1907
45095,69879,6881,33612,4564,62998,3740,1833,1907
45100,69890,6882,33614,4565,63008,3740,1833,1907
45105,69894,6882,33617,4565,63012,3740,1833,1907
45110,69904,6884,33625,4567,63020,3740,1833,1907
45115,69910,6884,33629,4567,63026,3742,1834,1908
45120,69921,6885,33634,4568,63036,3742,1834,1908
45125,69925,6886,33636,4569,63039,3742,1834,1908
45130,69935,6888,33640,4570,63047,3742,1834,1908
45135,69941,6888,33644,4570,63053,3743,1835,1908
45140,69952,6888,33651,4570,63064,3743,1835,1908
45145,69956,6888,33653,4570,63068,3743,1835,1908
45150,69966,6890,33656,4571,63076,3743,1835,1908
45155,69972,6890,33661,4571,63082,3744,1836,1908
45160,69983,6891,33667,4572,63092,3744,1836,1908
45165,69987,6892,33671,4573,63095,3744,1836,1908
45170,69997,6894,33677,4573,63103,3744,1836,1908
45175,70003,6894,33681,4573,63109,3745,1836,1909
45180,70014,6895,33686,4574,63119,3746,1837,1909
45185,70018,6895,33687,4574,63123,3746,1837,1909
45190,70028,6896,33690,4575,63132,3746,1837,1909
45195,70034,6896,33693,4575,63138,3747,1837,1910
45200,70045,6896,33698,4575,63149,3748,1837,1911
45205,70049,6896,33702,4575,63153,3748,1837,1911
45210,70059,6897,33707,4575,63162,3748,1837,1911
45215,70065,6897,33711,4575,63168,3749,1838,1911
45220,70076,6897,33717,4575,63179,3750,1838,1912
45225,70080,6897,33718,4575,63183,3750,1838,1912
45230,70090,6898,33722,4576,63192,3750,1838,1912
45235,70096,6898,33725,4576,63197,3752,1839,1913
45240,70107,6903,33733,4580,63204,3753,1839,1914
45245,70111,6903,33735,4580,63208,3753,1839,1914
45250,70121,6904,33738,4580,63217,3753,1839,1914
45255,70127,6904,33739,4580,63223,3754,1839,1915
45260,70138,6906,33746,4581,63232,3754,1839,1915
45265,70142,6906,33748,4581,63236,3754,1839,1915
45270,70152,6907,33753,4582,63245,3754,1839,1915
45275,70158,6907,33756,4582,63250,3755,1839,1916
45280,70169,6909,33763,4583,63260,3755,1839,1916
45285,70173,6909,33765,4583,63264,3755,1839,1916
45290,70183,6910,33770,4584,63273,3755,1839,1916
45295,70189,6910,33771,4584,63279,3756,1839,1917
45300,70200,6911,33775,4585,63289,3756,1839,1917
45305,70204,6911,33777,4585,63293,3756,1839,1917
45310,70214,6912,33781,4586,63302,3756,1839,1917
45315,70220,6912,33783,4586,63307,3757,1839,1918
45320,70231,6915,33790,4588,63316,3757,1839,1918
45325,70235,6915,33791,4588,63320,3757,1839,1918
45330,70245,6916,33797,4589,63329,3757,1839,1918
45335,70251,6916,33799,4589,63335,3758,1840,1918
45340,70262,6918,33805,4591,63344,3758,1840,1918
45345,70266,6918,33805,4591,63348,3758,1840,1918
45350,70276,6920,33807,4591,63356,3758,1840,1918
45355,70282,6920,33810,4591,63362,3760,1841,1919
45360,70293,6922,33814,4592,63371,3761,1842,1919
45365,70297,6922,33815,4592,63375,3761,1842,1919
45370,70307,6924,33819,4593,63383,3761,1842,1919
45375,70313,6924,33821,4593,63389,3762,1843,1919
45380,70324,6926,33827,4594,63398,3763,1844,1919
45385,70328,6927,33829,4595,63401,3763,1844,1919
45390,70338,6929,33834,4596,63409,3763,1844,1919
45395,70344,6929,33835,4596,63415,3764,1844,1920
45400,70355,6930,33839,4596,63425,3765,1844,1921
45405,70359,6931,33841,4597,63428,3765,1844,1921
45410,70369,6933,33846,4599,63436,3765,1844,1921
45415,70375,6933,33851,4599,63442,3766,1845,1921
45420,70386,6935,33856,4601,63451,3767,1845,1922
45425,70390,6935,33858,4601,63455,3767,1845,1922
45430,70400,6937,33862,4602,63463,3767,1845,1922
45435,70406,6937,33865,4602,63469,3768,1846,1922
45440,70417,6937,33869,4602,63480,3768,1846,1922
45445,70421,6937,33872,4602,63484,3768,1846,1922
45450,70431,6939,33875,4602,63492,3768,1846,1922
45455,70437,6939,33877,4602,63498,3769,1846,1923
45460,70448,6940,33884,4603,63508,3769,1846,1923
45465,70452,6940,33887,4603,63512,3769,1846,1923
45470,70462,6942,33891,4604,63520,3769,1846,1923
45475,70468,6942,33892,4604,63525,3771,1846,1925
45480,70479,6944,33899,4606,63535,3772,1847,1925
45485,70483,6944,33899,4606,63539,3772,1847,1925
45490,70493,6945,33906,4607,63548,3772,1847,1925
45495,70499,6945,33909,4607,63554,3773,1847,1926
45500,70510,6946,33912,4607,63564,3774,1847,1927
45505,70514,6947,33914,4608,63567,3774,1847,1927
45510,70524,6948,33918,4608,63576,3774,1847,1927
45515,70530,6948,33921,4608,63581,3775,1847,1928
45520,70541,6951,33929,4610,63590,3776,1848,1928
45525,70545,6952,33931,4611,63593,3776,1848,1928
45530,70555,6953,33936,4612,63602,3776,1848,1928
45535,70561,6953,33940,4612,63607,3777,1848,1929
45540,70572,6957,33945,4616,63615,3778,1848,1930
45545,70576,6957,33946,4616,63619,3778,1848,1930
45550,70586,6958,33951,4616,63628,3778,1848,1930
45555,70592,6958,33954,4616,63634,3779,1848,1931
45560,70603,6958,33961,4616,63645,3780,1849,1931
45565,70607,6958,33962,4616,63649,3780,1849,1931
45570,70617,6959,33968,4617,63658,3780,1849,1931
45575,70623,6959,33971,4617,63664,3781,1849,1932
45580,70634,6959,33975,4617,63675,3782,1850,1932
45585,70638,6959,33975,4617,63679,3782,1850,1932
45590,70648,6961,33980,4618,63687,3782,1850,1932
45595,70654,6961,33981,4618,63693,3784,1851,1933
45600,70665,6962,33986,4619,63703,3785,1851,1934
45605,70669,6962,33987,4619,63707,3785,1851,1934
45610,70679,6964,33991,4620,63715,3785,1851,1934
45615,70685,6964,33993,4620,63721,3786,1852,1934
45620,70696,6964,33998,4620,63732,3786,1852,1934
45625,70700,6964,34000,4620,63736,3786,1852,1934
45630,70710,6966,34006,4620,63744,3786,1852,1934
45635,70716,6966,34008,4620,63750,3787,1852,1935
45640,70727,6966,34011,4620,63761,3787,1852,1935
45645,70731,6966,34014,4620,63765,3787,1852,1935
45650,70741,6968,34017,4621,63773,3787,1852,1935
45655,70747,6968,34019,4621,63778,3788,1852,1936
45660,70758,6971,34023,4623,63787,3788,1852,1936
45665,70762,6971,34026,4623,63791,3788,1852,1936
45670,70772,6973,34031,4624,63799,3788,1852,1936
45675,70778,6973,34035,4624,63805,3789,1852,1937
45680,70789,6974,34041,4624,63815,3789,1852,1937
45685,70793,6974,34043,4624,63819,3789,1852,1937
45690,70803,6976,34044,4624,63827,3789,1852,1937
45695,70809,6976,34048,4624,63833,3790,1853,1937
45700,70820,6977,34054,4625,63843,3790,1853,1937
45705,70824,6978,34057,4626,63846,3790,1853,1937
45710,70834,6980,34063,4627,63854,3790,1853,1937
45715,70840,6980,34066,4627,63860,3792,1854,1938
45720,70851,6983,34073,4630,63868,3793,1854,1939
45725,70855,6985,34076,4632,63870,3793,1854,1939
45730,70865,6987,34082,4633,63878,3793,1854,1939
45735,70871,6987,34085,4633,63884,3794,1854,1940
45740,70882,6990,34090,4636,63892,3795,1855,1940
45745,70886,6992,34094,4638,63894,3795,1855,1940
45750,70896,6994,34098,4638,63902,3795,1855,1940
45755,70902,6994,34101,4638,63908,3796,1856,1940
45760,70913,6995,34104,4639,63918,3797,1856,1941
45765,70917,6997,34106,4641,63920,3797,1856,1941
45770,70927,6999,34110,4643,63928,3797,1856,1941
45775,70933,6999,34114,4643,63933,3798,1857,1941
45780,70944,7004,34122,4647,63940,3799,1858,1941
45785,70948,7004,34123,4647,63944,3799,1858,1941
45790,70958,7004,34128,4647,63954,3799,1858,1941
45795,70964,7004,34129,4647,63960,3800,1858,1942
45800,70975,7004,34136,4647,63971,3800,1858,1942
45805,70979,7004,34139,4647,63975,3800,1858,1942
45810,70989,7004,34144,4647,63985,3800,1858,1942
45815,70995,7004,34147,4647,63991,3801,1859,1942
45820,71006,7004,34153,4647,64002,3801,1859,1942
45825,71010,7004,34154,4647,64006,3801,1859,1942
45830,71020,7004,34157,4647,64016,3801,1859,1942
45835,71026,7004,34160,4647,64022,3802,1859,1943
45840,71037,7004,34164,4647,64033,3802,1859,1943
45845,71041,7004,34167,4647,64037,3802,1859,1943
45850,71051,7004,34173,4647,64047,3802,1859,1943
45855,71057,7004,34176,4647,64053,3803,1859,1944
45860,71068,7004,34180,4647,64064,3803,1859,1944
45865,71072,7004,34182,4647,64068,3803,1859,1944
45870,71082,7004,34187,4647,64078,3803,1859,1944
45875,71088,7004,34188,4647,64084,3804,1859,1945
45880,71099,7004,34192,4647,64095,3804,1859,1945
45885,71103,7004,34194,4647,64099,3804,1859,1945
45890,71113,7006,34198,4647,64107,3804,1859,1945
45895,71119,7006,34201,4647,64113,3805,1860,1945
45900,71130,7007,34206,4648,64123,3806,1861,1945
45905,71134,7007,34209,4648,64127,3806,1861,1945
45910,71144,7009,34217,4650,64135,3806,1861,1945
45915,71150,7009,34221,4650,64140,3807,1861,1946
45920,71161,7012,34228,4652,64149,3807,1861,1946
45925,71165,7012,34231,4652,64153,3807,1861,1946
45930,71175,7014,34236,4653,64161,3807,1861,1946
45935,71181,7014,34238,4653,64167,3808,1862,1946
45940,71192,7016,34242,4654,64176,3808,1862,1946
45945,71196,7016,34244,4654,64180,3808,1862,1946
45950,71206,7018,34250,4654,64188,3808,1862,1946
45955,71212,7018,34255,4654,64193,3809,1863,1946
45960,71223,7020,34261,4656,64203,3809,1863,1946
45965,71227,7020,34262,4656,64207,3809,1863,1946
45970,71237,7021,34265,4656,64216,3809,1863,1946
45975,71243,7021,34266,4656,64222,3810,1863,1947
45980,71254,7022,34273,4656,64232,3810,1863,1947
45985,71258,7022,34277,4656,64236,3810,1863,1947
45990,71268,7023,34283,4657,64245,3810,1863,1947
45995,71274,7023,34286,4657,64250,3811,1864,1947
46000,71285,7026,34293,4659,64259,3811,1864,1947
46005,71289,7026,34296,4659,64263,3811,1864,1947
46010,71299,7027,34300,4659,64272,3811,1864,1947
46015,71305,7027,34302,4659,64278,3812,1865,1947
46020,71316,7028,34308,4659,64288,3813,1866,1947
46025,71320,7028,34308,4659,64292,3813,1866,1947
46030,71330,7029,34313,4660,64301,3813,1866,1947
46035,71336,7029,34317,4660,64307,3814,1867,1947
46040,71347,7030,34321,4661,64317,3814,1867,1947
46045,71351,7031,34324,4662,64320,3814,1867,1947
46050,71361,7032,34331,4663,64329,3814,1867,1947
46055,71367,7032,34334,4663,64335,3815,1868,1947
46060,71378,7033,34339,4664,64345,3815,1868,1947
46065,71382,7034,34341,4665,64348,3815,1868,1947
46070,71392,7036,34344,4665,64356,3815,1868,1947
46075,71398,7036,34348,4665,64362,3817,1868,1949
46080,71409,7038,34351,4666,64371,3817,1868,1949
46085,71413,7039,34352,4667,64374,3817,1868,1949
46090,71423,7041,34354,4668,64382,3817,1868,1949
46095,71429,7041,34355,4668,64388,3818,1868,1950
46100,71440,7042,34361,4669,64398,3818,1868,1950
46105,71444,7043,34363,4670,64401,3818,1868,1950
46110,71454,7045,34367,4672,64409,3818,1868,1950
46115,71460,7045,34371,4672,64415,3819,1869,1950
46120,71471,7046,34376,4672,64425,3819,1869,1950
46125,71475,7046,34377,4672,64429,3819,1869,1950
46130,71485,7048,34382,4673,64437,3819,1869,1950
46135,71491,7048,34385,4673,64442,3820,1869,1951
46140,71502,7050,34391,4675,64452,3821,1869,1952
46145,71506,7050,34393,4675,64456,3821,1869,1952
46150,71516,7051,34398,4676,64465,3821,1869,1952
46155,71522,7051,34402,4676,64471,3822,1870,1952
46160,71533,7051,34409,4676,64482,3823,1871,1952
46165,71537,7051,34411,4676,64486,3823,1871,1952
46170,71547,7052,34413,4676,64495,3823,1871,1952
46175,71553,7052,34414,4676,64501,3824,1871,1953
46180,71564,7052,34424,4676,64512,3825,1872,1953
46185,71568,7052,34426,4676,64516,3825,1872,1953
46190,71578,7053,34430,4677,64525,3825,1872,1953
46195,71584,7053,34431,4677,64531,3827,1873,1954
46200,71595,7053,34435,4677,64542,3828,1873,1955
46205,71599,7053,34437,4677,64546,3828,1873,1955
46210,71609,7054,34445,4678,64555,3828,1873,1955
46215,71615,7054,34450,4678,64561,3829,1874,1955
46220,71626,7055,34456,4679,64571,3830,1874,1956
46225,71630,7055,34457,4679,64575,3830,1874,1956
46230,71640,7056,34460,4680,64584,3830,1874,1956
46235,71646,7056,34461,4680,64590,3831,1874,1957
46240,71657,7058,34467,4682,64599,3831,1874,1957
46245,71661,7058,34470,4682,64603,3831,1874,1957
46250,71671,7060,34473,4682,64611,3831,1874,1957
46255,71677,7060,34475,4682,64617,3832,1874,1958
46260,71688,7063,34481,4685,64625,3833,1874,1959
46265,71692,7063,34483,4685,64629,3833,1874,1959
46270,71702,7065,34486,4686,64637,3833,1874,1959
46275,71708,7065,34489,4686,64643,3834,1875,1959
46280,71719,7066,34494,4686,64653,3834,1875,1959
46285,71723,7068,34497,4688,64655,3834,1875,1959
46290,71733,7070,34500,4688,64663,3834,1875,1959
46295,71739,7070,34501,4688,64669,3835,1875,1960
46300,71750,7072,34506,4690,64678,3835,1875,1960
46305,71754,7073,34507,4691,64681,3835,1875,1960
46310,71764,7075,34510,4691,64689,3835,1875,1960
46315,71770,7075,34513,4691,64695,3836,1876,1960
46320,71781,7077,34519,4693,64704,3836,1876,1960
46325,71785,7079,34522,4695,64706,3836,1876,1960
46330,71795,7081,34527,4695,64714,3836,1876,1960
46335,71801,7081,34529,4695,64720,3837,1876,1961
46340,71812,7082,34532,4695,64730,3837,1876,1961
46345,71816,7082,34534,4695,64734,3837,1876,1961
46350,71826,7084,34540,4697,64742,3837,1876,1961
46355,71832,7084,34542,4697,64748,3838,1876,1962
46360,71843,7085,34549,4697,64758,3838,1876,1962
46365,71847,7086,34550,4698,64761,3838,1876,1962
46370,71857,7088,34554,4699,64769,3838,1876,1962
46375,71863,7088,34556,4699,64774,3839,1876,1963
46380,71874,7092,34562,4703,64782,3840,1877,1963
46385,71878,7092,34565,4703,64786,3840,1877,1963
46390,71888,7092,34569,4703,64796,3840,1877,1963
46395,71894,7092,34573,4703,64802,3841,1878,1963
46400,71905,7092,34579,4703,64813,3841,1878,1963
46405,71909,7092,34580,4703,64817,3841,1878,1963
46410,71919,7092,34585,4703,64827,3841,1878,1963
46415,71925,7092,34587,4703,64833,3842,1878,1964
46420,71936,7092,34594,4703,64844,3842,1878,1964
46425,71940,7092,34595,4703,64848,3842,1878,1964
46430,71950,7092,34599,4703,64858,3842,1878,1964
46435,71956,7092,34602,4703,64864,3843,1879,1964
46440,71967,7092,34608,4703,64875,3843,1879,1964
46445,71971,7092,34611,4703,64879,3843,1879,1964
46450,71981,7092,34618,4703,64889,3843,1879,1964
46455,71987,7092,34621,4703,64895,3844,1880,1964
46460,71998,7092,34623,4703,64906,3844,1880,1964
46465,72002,7092,34624,4703,64910,3844,1880,1964
46470,72012,7092,34628,4703,64920,3844,1880,1964
46475,72018,7092,34630,4703,64926,3845,1881,1964
46480,72029,7092,34634,4703,64937,3845,1881,1964
46485,72033,7092,34635,4703,64941,3845,1881,1964
46490,72043,7094,34641,4704,64949,3845,1881,1964
46495,72049,7094,34643,4704,64955,3846,1882,1964
46500,72060,7096,34647,4705,64964,3846,1882,1964
46505,72064,7097,34649,4706,64967,3846,1882,1964
46510,72074,7099,34652,4707,64975,3846,1882,1964
46515,72080,7099,34655,4707,64981,3847,1882,1965
46520,72091,7102,34663,4710,64989,3848,1882,1966
46525,72095,7102,34664,4710,64993,3848,1882,1966
46530,72105,7104,34670,4711,65001,3848,1882,1966
46535,72111,7104,34671,4711,65007,3849,1883,1966
46540,72122,7106,34677,4712,65016,3850,1883,1967
46545,72126,7107,34680,4713,65019,3850,1883,1967
46550,72136,7109,34684,4713,65027,3850,1883,1967
46555,72142,7109,34685,4713,65033,3851,1883,1968
46560,72153,7111,34689,4715,65042,3852,1883,1969
46565,72157,7112,34693,4716,65045,3852,1883,1969
46570,72167,7113,34698,4716,65054,3852,1883,1969
46575,72173,7113,34700,4716,65060,3854,1883,1971
46580,72184,7114,34707,4717,65070,3854,1883,1971
46585,72188,7114,34708,4717,65074,3854,1883,1971
46590,72198,7115,34714,4718,65083,3854,1883,1971
46595,72204,7115,34717,4718,65089,3856,1884,1972
46600,72215,7116,34722,4718,65099,3856,1884,1972
46605,72219,7117,34723,4719,65102,3856,1884,1972
46610,72229,7118,34728,4720,65111,3856,1884,1972
46615,72235,7118,34730,4720,65116,3857,1884,1973
46620,72246,7121,34736,4723,65125,3857,1884,1973
46625,72250,7121,34738,4723,65129,3857,1884,1973
46630,72260,7123,34744,4723,65137,3857,1884,1973
46635,72266,7123,34747,4723,65143,3858,1885,1973
46640,72277,7124,34752,4724,65153,3858,1885,1973
46645,72281,7125,34755,4725,65156,3858,1885,1973
46650,72291,7127,34758,4726,65164,3858,1885,1973
46655,72297,7127,34763,4726,65169,3859,1886,1973
46660,72308,7129,34770,4728,65179,3859,1886,1973
46665,72312,7130,34774,4729,65182,3859,1886,1973
46670,72322,7132,34782,4731,65190,3859,1886,1973
46675,72328,7132,34783,4731,65196,3860,1886,1974
46680,72339,7132,34788,4731,65207,3860,1886,1974
46685,72343,7132,34788,4731,65211,3860,1886,1974
46690,72353,7133,34793,4732,65220,3860,1886,1974
46695,72359,7133,34794,4732,65226,3861,1886,1975
46700,72370,7133,34799,4732,65237,3862,1886,1976
46705,72374,7133,34803,4732,65241,3862,1886,1976
46710,72384,7134,34810,4732,65250,3862,1886,1976
46715,72390,7134,34813,4732,65256,3863,1887,1976
46720,72401,7134,34818,4732,65267,3864,1888,1976
46725,72405,7134,34820,4732,65271,3864,1888,1976
46730,72415,7135,34825,4732,65280,3864,1888,1976
46735,72421,7135,34828,4732,65286,3866,1889,1977
46740,72432,7138,34834,4735,65294,3867,1889,1978
46745,72436,7138,34835,4735,65298,3867,1889,1978
46750,72446,7138,34840,4735,65308,3867,1889,1978
46755,72452,7138,34842,4735,65314,3868,1889,1979
46760,72463,7140,34849,4736,65323,3868,1889,1979
46765,72467,7140,34851,4736,65327,3868,1889,1979
46770,72477,7140,34858,4736,65337,3868,1889,1979
46775,72483,7140,34862,4736,65343,3869,1890,1979
46780,72494,7141,34867,4737,65353,3869,1890,1979
46785,72498,7141,34869,4737,65357,3869,1890,1979
46790,72508,7142,34874,4737,65366,3869,1890,1979
46795,72514,7142,34878,4737,65371,3870,1890,1980
46800,72525,7145,34886,4739,65380,3870,1890,1980
46805,72529,7145,34888,4739,65384,3870,1890,1980
46810,72539,7146,34894,4739,65393,3870,1890,1980
46815,72545,7146,34896,4739,65398,3871,1890,1981
46820,72556,7150,34902,4742,65406,3871,1890,1981
46825,72560,7150,34904,4742,65410,3871,1890,1981
46830,72570,7151,34907,4743,65419,3871,1890,1981
46835,72576,7151,34911,4743,65424,3872,1891,1981
46840,72587,7153,34914,4744,65434,3872,1891,1981
46845,72591,7153,34915,4744,65438,3872,1891,1981
46850,72601,7155,34919,4745,65446,3872,1891,1981
46855,72607,7155,34923,4745,65452,3874,1892,1982
46860,72618,7157,34927,4747,65461,3874,1892,1982
46865,72622,7158,34928,4748,65464,3874,1892,1982
46870,72632,7160,34931,4748,65472,3874,1892,1982
46875,72638,7160,34935,4748,65478,3875,1892,1983
46880,72649,7162,34942,4750,65487,3876,1893,1983
46885,72653,7164,34944,4752,65489,3876,1893,1983
46890,72663,7166,34949,4752,65497,3876,1893,1983
46895,72669,7166,34953,4752,65503,3877,1893,1984
46900,72680,7167,34955,4752,65513,3878,1893,1985
46905,72684,7169,34958,4754,65515,3878,1893,1985
46910,72694,7171,34965,4756,65523,3878,1893,1985
46915,72700,7171,34969,4756,65529,3879,1894,1985
46920,72711,7173,34976,4757,65538,3880,1895,1985
46925,72715,7173,34978,4757,65542,3880,1895,1985
46930,72725,7174,34985,4757,65551,3880,1895,1985
46935,72731,7174,34988,4757,65557,3881,1895,1986
46940,72742,7174,34996,4757,65568,3881,1895,1986
46945,72746,7174,34999,4757,65572,3881,1895,1986
46950,72756,7175,35004,4757,65581,3881,1895,1986
46955,72762,7175,35006,4757,65587,3882,1895,1987
46960,72773,7175,35012,4757,65598,3882,1895,1987
46965,72777,7175,35015,4757,65602,3882,1895,1987
46970,72787,7176,35024,4758,65611,3882,1895,1987
46975,72793,7176,35027,4758,65617,3884,1897,1987
46980,72804,7177,35034,4759,65627,3884,1897,1987
46985,72808,7177,35037,4759,65631,3884,1897,1987
46990,72818,7178,35040,4759,65640,3884,1897,1987
46995,72824,7178,35042,4759,65646,3885,1897,1988
47000,72835,7178,35048,4759,65657,3885,1897,1988
47005,72839,7178,35051,4759,65661,3885,1897,1988
47010,72849,7179,35056,4759,65670,3885,1897,1988
47015,72855,7179,35058,4759,65676,3886,1898,1988
47020,72866,7180,35063,4760,65686,3886,1898,1988
47025,72870,7180,35065,4760,65690,3886,1898,1988
47030,72880,7182,35070,4761,65698,3886,1898,1988
47035,72886,7182,35071,4761,65703,3887,1898,1989
47040,72897,7186,35077,4764,65711,3888,1898,1990
47045,72901,7187,35079,4765,65714,3888,1898,1990
47050,72911,7188,35084,4765,65723,3888,1898,1990
47055,72917,7188,35088,4765,65729,3889,1898,1991
47060,72928,7189,35096,4766,65739,3890,1899,1991
47065,72932,7189,35098,4766,65743,3890,1899,1991
47070,72942,7190,35101,4767,65752,3890,1899,1991
47075,72948,7190,35103,4767,65758,3891,1900,1991
47080,72959,7191,35107,4768,65768,3892,1900,1992
47085,72963,7191,35109,4768,65772,3892,1900,1992
47090,72973,7192,35111,4769,65781,3892,1900,1992
47095,72979,7192,35116,4769,65787,3894,1902,1992
47100,72990,7193,35122,4770,65797,3895,1902,1993
47105,72994,7193,35123,4770,65801,3895,1902,1993
47110,73004,7194,35129,4771,65810,3895,1902,1993
47115,73010,7194,35129,4771,65816,3896,1902,1994
47120,73021,7194,35135,4771,65827,3897,1903,1994
47125,73025,7194,35136,4771,65831,3897,1903,1994
47130,73035,7195,35140,4771,65840,3897,1903,1994
47135,73041,7195,35144,4771,65846,3898,1904,1994
47140,73052,7195,35152,4771,65857,3899,1905,1994
47145,73056,7195,35155,4771,65861,3899,1905,1994
47150,73066,7197,35159,4772,65869,3899,1905,1994
47155,73072,7197,35162,4772,65875,3900,1905,1995
47160,73083,7198,35165,4773,65885,3901,1905,1996
47165,73087,7198,35165,4773,65889,3901,1905,1996
47170,73097,7199,35172,4773,65898,3901,1905,1996
47175,73103,7199,35174,4773,65904,3902,1905,1997
47180,73114,7200,35179,4773,65914,3902,1905,1997
47185,73118,7200,35180,4773,65918,3902,1905,1997
47190,73128,7201,35186,4774,65927,3902,1905,1997
47195,73134,7201,35189,4774,65933,3903,1905,1998
47200,73145,7202,35194,4775,65943,3903,1905,1998
47205,73149,7202,35196,4775,65947,3903,1905,1998
47210,73159,7203,35200,4776,65956,3903,1905,1998
47215,73165,7203,35204,4776,65962,3905,1906,1999
47220,73176,7204,35211,4777,65972,3905,1906,1999
47225,73180,7204,35213,4777,65976,3905,1906,1999
47230,73190,7205,35216,4777,65985,3905,1906,1999
47235,73196,7205,35219,4777,65991,3906,1907,1999
47240,73207,7206,35226,4778,66001,3906,1907,1999
47245,73211,7206,35227,4778,66005,3906,1907,1999
47250,73221,7207,35231,4778,66014,3906,1907,1999
47255,73227,7207,35234,4778,66020,3907,1908,1999
47260,73238,7208,35239,4779,66030,3907,1908,1999
47265,73242,7209,35241,4780,66033,3907,1908,1999
47270,73252,7211,35247,4782,66041,3907,1908,1999
47275,73258,7211,35248,4782,66047,3908,1908,2000
47280,73269,7214,35254,4784,66055,3909,1909,2000
47285,73273,7215,35256,4785,66058,3909,1909,2000
47290,73283,7216,35262,4785,66067,3909,1909,2000
47295,73289,7216,35265,4785,66073,3910,1909,2001
47300,73300,7217,35268,4785,66083,3911,1909,2002
47305,73304,7217,35270,4785,66087,3911,1909,2002
47310,73314,7218,35276,4786,66096,3911,1909,2002
47315,73320,7218,35279,4786,66102,3912,1909,2003
47320,73331,7219,35283,4786,66112,3913,1909,2004
47325,73335,7219,35286,4786,66116,3913,1909,2004
47330,73345,7220,35292,4787,66125,3913,1909,2004
47335,73351,7220,35294,4787,66131,3915,1910,2005
47340,73362,7221,35301,4788,66141,3916,1911,2005
47345,73366,7222,35303,4789,66144,3916,1911,2005
47350,73376,7223,35307,4789,66153,3916,1911,2005
47355,73382,7223,35308,4789,66159,3917,1912,2005
47360,73393,7224,35316,4790,66169,3917,1912,2005
47365,73397,7224,35318,4790,66173,3917,1912,2005
47370,73407,7225,35321,4790,66182,3917,1912,2005
47375,73413,7225,35324,4790,66188,3918,1913,2005
47380,73424,7226,35328,4790,66198,3918,1913,2005
47385,73428,7226,35329,4790,66202,3918,1913,2005
47390,73438,7228,35333,4790,66210,3918,1913,2005
47395,73444,7228,35338,4790,66216,3919,1914,2005
47400,73455,7229,35343,4791,66226,3919,1914,2005
47405,73459,7229,35345,4791,66230,3919,1914,2005
47410,73469,7231,35350,4792,66238,3919,1914,2005
47415,73475,7231,35354,4792,66244,3920,1915,2005
47420,73486,7232,35359,4792,66254,3920,1915,2005
47425,73490,7233,35362,4793,66257,3920,1915,2005
47430,73500,7235,35367,4795,66265,3920,1915,2005
47435,73506,7235,35371,4795,66271,3921,1916,2005
47440,73517,7237,35376,4797,66280,3921,1916,2005
47445,73521,7238,35378,4798,66283,3921,1916,2005
47450,73531,7240,35382,4799,66291,3921,1916,2005
47455,73537,7240,35386,4799,66297,3923,1917,2006
47460,73548,7243,35396,4802,66305,3924,1918,2006
47465,73552,7243,35399,4802,66309,3924,1918,2006
47470,73562,7244,35404,4802,66318,3924,1918,2006
47475,73568,7244,35405,4802,66324,3926,1918,2008
47480,73579,7246,35412,4804,66333,3927,1919,2008
47485,73583,7246,35414,4804,66337,3927,1919,2008
47490,73593,7247,35419,4805,66346,3927,1919,2008
47495,73599,7247,35422,4805,66352,3928,1919,2009
47500,73610,7249,35428,4807,66361,3929,1920,2009
47505,73614,7249,35430,4807,66365,3929,1920,2009
47510,73624,7250,35436,4807,66374,3929,1920,2009
47515,73630,7250,35438,4807,66380,3930,1921,2009
47520,73641,7254,35446,4811,66387,3931,1922,2009
47525,73645,7254,35449,4811,66391,3931,1922,2009
47530,73655,7254,35452,4811,66401,3931,1922,2009
47535,73661,7254,35457,4811,66407,3932,1923,2009
47540,73672,7254,35463,4811,66418,3932,1923,2009
47545,73676,7254,35465,4811,66422,3932,1923,2009
47550,73686,7254,35471,4811,66432,3932,1923,2009
47555,73692,7254,35471,4811,66438,3933,1923,2010
47560,73703,7254,35475,4811,66449,3933,1923,2010
47565,73707,7254,35476,4811,66453,3933,1923,2010
47570,73717,7254,35480,4811,66463,3933,1923,2010
47575,73723,7254,35482,4811,66469,3934,1923,2011
47580,73734,7254,35487,4811,66480,3934,1923,2011
47585,73738,7254,35490,4811,66484,3934,1923,2011
47590,73748,7254,35493,4811,66494,3934,1923,2011
47595,73754,7254,35498,4811,66500,3936,1924,2012
47600,73765,7254,35501,4811,66511,3936,1924,2012
47605,73769,7254,35502,4811,66515,3936,1924,2012
47610,73779,7254,35505,4811,66525,3936,1924,2012
47615,73785,7254,35508,4811,66531,3938,1924,2014
47620,73796,7254,35514,4811,66542,3938,1924,2014
47625,73800,7254,35517,4811,66546,3938,1924,2014
47630,73810,7256,35523,4813,66554,3938,1924,2014
47635,73816,7256,35526,4813,66560,3939,1925,2014
47640,73827,7257,35531,4814,66570,3940,1926,2014
47645,73831,7258,35535,4815,66573,3940,1926,2014
47650,73841,7259,35539,4815,66582,3940,1926,2014
47655,73847,7259,35542,4815,66588,3941,1926,2015
47660,73858,7260,35546,4816,66598,3942,1926,2016
47665,73862,7260,35546,4816,66602,3942,1926,2016
47670,73872,7261,35548,4816,66611,3942,1926,2016
47675,73878,7261,35553,4816,66616,3943,1927,2016
47680,73889,7265,35561,4820,66624,3944,1928,2016
47685,73893,7265,35563,4820,66628,3944,1928,2016
47690,73903,7266,35566,4820,66637,3944,1928,2016
47695,73909,7266,35570,4820,66642,3945,1929,2016
47700,73920,7268,35575,4822,66652,3946,1930,2016
47705,73924,7268,35577,4822,66656,3946,1930,2016
47710,73934,7269,35583,4823,66665,3946,1930,2016
47715,73940,7269,35585,4823,66671,3948,1931,2017
47720,73951,7271,35589,4824,66680,3949,1932,2017
47725,73955,7271,35590,4824,66684,3949,1932,2017
47730,73965,7272,35594,4824,66693,3949,1932,2017
47735,73971,7272,35596,4824,66699,3950,1933,2017
47740,73982,7275,35601,4826,66707,3951,1933,2018
47745,73986,7275,35604,4826,66711,3951,1933,2018
47750,73996,7277,35610,4828,66719,3951,1933,2018
47755,74002,7277,35614,4828,66725,3952,1933,2019
47760,74013,7279,35617,4829,66734,3953,1933,2020
47765,74017,7279,35619,4829,66738,3953,1933,2020
47770,74027,7280,35625,4829,66747,3953,1933,2020
47775,74033,7280,35629,4829,66753,3954,1933,2021
47780,74044,7280,35636,4829,66764,3954,1933,2021
47785,74048,7280,35638,4829,66768,3954,1933,2021
47790,74058,7281,35641,4829,66777,3954,1933,2021
47795,74064,7281,35644,4829,66783,3955,1933,2022
47800,74075,7281,35651,4829,66794,3955,1933,2022
47805,74079,7281,35653,4829,66798,3955,1933,2022
47810,74089,7282,35660,4829,66807,3955,1933,2022
47815,74095,7282,35660,4829,66813,3956,1933,2023
47820,74106,7282,35665,4829,66824,3956,1933,2023
47825,74110,7282,35666,4829,66828,3956,1933,2023
47830,74120,7283,35671,4830,66837,3956,1933,2023
47835,74126,7283,35674,4830,66843,3958,1933,2025
47840,74137,7283,35677,4830,66854,3958,1933,2025
47845,74141,7283,35678,4830,66858,3958,1933,2025
47850,74151,7284,35683,4831,66867,3958,1933,2025
47855,74157,7284,35686,4831,66873,3960,1933,2027
47860,74168,7284,35693,4831,66884,3960,1933,2027
47865,74172,7285,35695,4832,66887,3960,1933,2027
47870,74182,7286,35700,4833,66896,3960,1933,2027
47875,74188,7286,35704,4833,66901,3961,1934,2027
47880,74199,7289,35709,4835,66910,3962,1934,2028
47885,74203,7290,35710,4836,66913,3962,1934,2028
47890,74213,7291,35712,4836,66922,3962,1934,2028
47895,74219,7291,35716,4836,66928,3963,1935,2028
47900,74230,7293,35719,4837,66937,3964,1936,2028
47905,74234,7293,35721,4837,66941,3964,1936,2028
47910,74244,7294,35726,4837,66950,3964,1936,2028
47915,74250,7294,35726,4837,66956,3965,1936,2029
47920,74261,7297,35732,4840,66964,3965,1936,2029
47925,74265,7297,35733,4840,66968,3965,1936,2029
47930,74275,7298,35738,4841,66977,3965,1936,2029
47935,74281,7298,35740,4841,66983,3966,1936,2030
47940,74292,7300,35746,4842,66992,3966,1936,2030
47945,74296,7300,35748,4842,66996,3966,1936,2030
47950,74306,7301,35749,4842,67005,3966,1936,2030
47955,74312,7301,35750,4842,67010,3967,1936,2031
47960,74323,7303,35756,4844,67020,3967,1936,2031
47965,74327,7303,35757,4844,67024,3967,1936,2031
47970,74337,7304,35761,4844,67033,3967,1936,2031
47975,74343,7304,35764,4844,67038,3968,1937,2031
47980,74354,7306,35771,4846,67048,3968,1937,2031
47985,74358,7306,35774,4846,67052,3968,1937,2031
47990,74368,7308,35780,4847,67060,3968,1937,2031
47995,74374,7308,35784,4847,67065,3969,1937,2032
48000,74385,7310,35791,4849,67075,3969,1937,2032
48005,74389,7311,35793,4850,67078,3969,1937,2032
48010,74399,7312,35796,4851,67087,3969,1937,2032
48015,74405,7312,35800,4851,67093,3970,1937,2033
48020,74416,7314,35805,4853,67102,3971,1937,2034
48025,74420,7316,35807,4855,67104,3971,1937,2034
48030,74430,7317,35812,4855,67113,3971,1937,2034
48035,74436,7317,35816,4855,67119,3972,1938,2034
48040,74447,7319,35822,4856,67128,3973,1939,2034
48045,74451,7320,35825,4857,67131,3973,1939,2034
48050,74461,7321,35833,4858,67140,3973,1939,2034
48055,74467,7321,35835,4858,67146,3974,1940,2034
48060,74478,7322,35840,4858,67156,3975,1940,2035
48065,74482,7322,35844,4858,67160,3975,1940,2035
48070,74492,7322,35851,4858,67170,3975,1940,2035
48075,74498,7322,35852,4858,67176,3976,1940,2036
48080,74509,7322,35857,4858,67187,3976,1940,2036
48085,74513,7322,35859,4858,67191,3976,1940,2036
48090,74523,7322,35867,4858,67201,3976,1940,2036
48095,74529,7322,35869,4858,67207,3978,1940,2038
48100,74540,7322,35874,4858,67218,3978,1940,2038
48105,74544,7322,35877,4858,67222,3978,1940,2038
48110,74554,7323,35880,4858,67231,3978,1940,2038
48115,74560,7323,35882,4858,67237,3980,1941,2039
48120,74571,7324,35886,4859,67247,3980,1941,2039
48125,74575,7325,35888,4860,67250,3980,1941,2039
48130,74585,7327,35893,4862,67258,3980,1941,2039
48135,74591,7327,35896,4862,67264,3981,1942,2039
48140,74602,7328,35900,4862,67274,3981,1942,2039
48145,74606,7328,35900,4862,67278,3981,1942,2039
48150,74616,7330,35906,4862,67286,3981,1942,2039
48155,74622,7330,35908,4862,67292,3982,1943,2039
48160,74633,7332,35913,4863,67301,3982,1943,2039
48165,74637,7333,35916,4864,67304,3982,1943,2039
48170,74647,7335,35919,4864,67312,3982,1943,2039
48175,74653,7335,35922,4864,67318,3983,1944,2039
48180,74664,7337,35929,4865,67327,3983,1944,2039
48185,74668,7337,35932,4865,67331,3983,1944,2039
48190,74678,7339,35937,4867,67339,3983,1944,2039
48195,74684,7339,35941,4867,67345,3984,1944,2040
48200,74695,7339,35945,4867,67356,3984,1944,2040
48205,74699,7340,35949,4868,67359,3984,1944,2040
48210,74709,7342,35954,4868,67367,3984,1944,2040
48215,74715,7342,35958,4868,67373,3985,1944,2041
48220,74726,7342,35964,4868,67384,3985,1944,2041
48225,74730,7342,35965,4868,67388,3985,1944,2041
48230,74740,7344,35971,4868,67396,3985,1944,2041
48235,74746,7344,35973,4868,67402,3987,1944,2043
48240,74757,7345,35977,4869,67412,3988,1944,2044
48245,74761,7345,35979,4869,67416,3988,1944,2044
48250,74771,7346,35984,4869,67425,3988,1944,2044
48255,74777,7346,35987,4869,67431,3990,1946,2044
48260,74788,7347,35991,4870,67441,3991,1946,2045
48265,74792,7347,35993,4870,67445,3991,1946,2045
48270,74802,7348,35999,4871,67454,3991,1946,2045
48275,74808,7348,36002,4871,67460,3992,1946,2046
48280,74819,7349,36008,4872,67470,3993,1946,2047
48285,74823,7349,36010,4872,67474,3993,1946,2047
48290,74833,7350,36015,4873,67483,3993,1946,2047
48295,74839,7350,36018,4873,67489,3994,1946,2048
48300,74850,7351,36021,4874,67499,3995,1946,2049
48305,74854,7351,36022,4874,67503,3995,1946,2049
48310,74864,7352,36028,4874,67512,3995,1946,2049
48315,74870,7352,36031,4874,67518,3996,1947,2049
48320,74881,7353,36037,4875,67528,3997,1947,2050
48325,74885,7353,36040,4875,67532,3997,1947,2050
48330,74895,7354,36042,4876,67541,3997,1947,2050
48335,74901,7354,36043,4876,67547,3998,1947,2051
48340,74912,7355,36047,4876,67557,3999,1948,2051
48345,74916,7355,36050,4876,67561,3999,1948,2051
48350,74926,7357,36057,4877,67569,3999,1948,2051
48355,74932,7357,36061,4877,67574,4000,1949,2051
48360,74943,7359,36065,4878,67584,4000,1949,2051
48365,74947,7360,36068,4879,67587,4000,1949,2051
48370,74957,7362,36074,4879,67595,4000,1949,2051
48375,74963,7362,36077,4879,67600,4002,1949,2053
48380,74974,7365,36083,4881,67609,4002,1949,2053
48385,74978,7365,36085,4881,67613,4002,1949,2053
48390,74988,7367,36090,4881,67621,4002,1949,2053
48395,74994,7367,36091,4881,67627,4003,1949,2054
48400,75005,7368,36096,4881,67637,4003,1949,2054
48405,75009,7369,36098,4882,67640,4003,1949,2054
48410,75019,7371,36104,4884,67648,4003,1949,2054
48415,75025,7371,36107,4884,67654,4004,1950,2054
48420,75036,7374,36112,4886,67662,4004,1950,2054
48425,75040,7375,36114,4887,67665,4004,1950,2054
48430,75050,7376,36119,4888,67674,4004,1950,2054
48435,75056,7376,36123,4888,67680,4005,1951,2054
48440,75067,7379,36130,4891,67688,4005,1951,2054
48445,75071,7379,36130,4891,67692,4005,1951,2054
48450,75081,7380,36134,4891,67701,4005,1951,2054
48455,75087,7380,36137,4891,67707,4006,1951,2055
48460,75098,7382,36144,4892,67716,4007,1952,2055
48465,75102,7382,36146,4892,67720,4007,1952,2055
48470,75112,7383,36151,4892,67729,4007,1952,2055
48475,75118,7383,36153,4892,67735,4008,1952,2056
48480,75129,7384,36157,4892,67745,4009,1953,2056
48485,75133,7384,36158,4892,67749,4009,1953,2056
48490,75143,7385,36163,4892,67758,4009,1953,2056
48495,75149,7385,36167,4892,67764,4011,1955,2056
48500,75160,7387,36173,4894,67773,4012,1956,2056
48505,75164,7387,36175,4894,67777,4012,1956,2056
48510,75174,7388,36177,4894,67786,4012,1956,2056
48515,75180,7388,36180,4894,67792,4014,1957,2057
48520,75191,7391,36187,4897,67800,4015,1958,2057
48525,75195,7391,36189,4897,67804,4015,1958,2057
48530,75205,7393,36194,4898,67812,4015,1958,2057
48535,75211,7393,36197,4898,67818,4017,1959,2058
48540,75222,7396,36203,4901,67826,4018,1960,2058
48545,75226,7396,36205,4901,67830,4018,1960,2058
48550,75236,7396,36208,4901,67840,4018,1960,2058
48555,75242,7396,36212,4901,67846,4019,1961,2058
48560,75253,7396,36217,4901,67857,4019,1961,2058
48565,75257,7396,36218,4901,67861,4019,1961,2058
48570,75267,7396,36222,4901,67871,4019,1961,2058
48575,75273,7396,36227,4901,67877,4020,1962,2058
48580,75284,7396,36236,4901,67888,4020,1962,2058
48585,75288,7396,36240,4901,67892,4020,1962,2058
48590,75298,7396,36246,4901,67902,4020,1962,2058
48595,75304,7396,36249,4901,67908,4021,1963,2058
48600,75315,7396,36252,4901,67919,4021,1963,2058
48605,75319,7396,36255,4901,67923,4021,1963,2058
48610,75329,7396,36261,4901,67933,4021,1963,2058
48615,75335,7396,36266,4901,67939,4022,1964,2058
48620,75346,7396,36271,4901,67950,4022,1964,2058
48625,75350,7396,36274,4901,67954,4022,1964,2058
48630,75360,7396,36279,4901,67964,4022,1964,2058
48635,75366,7396,36283,4901,67970,4023,1965,2058
48640,75377,7396,36290,4901,67981,4023,1965,2058
48645,75381,7396,36291,4901,67985,4023,1965,2058
48650,75391,7397,36297,4902,67994,4023,1965,2058
48655,75397,7397,36299,4902,68000,4025,1966,2059
48660,75408,7400,36304,4904,68008,4026,1967,2059
48665,75412,7400,36306,4904,68012,4026,1967,2059
48670,75422,7402,36310,4905,68020,4026,1967,2059
48675,75428,7402,36312,4905,68026,4027,1967,2060
48680,75439,7403,36318,4905,68036,4028,1967,2061
48685,75443,7403,36321,4905,68040,4028,1967,2061
48690,75453,7405,36325,4905,68048,4028,1967,2061
48695,75459,7405,36327,4905,68054,4029,1967,2062
48700,75470,7407,36332,4906,68063,4030,1968,2062
48705,75474,7408,36334,4907,68066,4030,1968,2062
48710,75484,7410,36337,4908,68074,4030,1968,2062
48715,75490,7410,36338,4908,68080,4031,1968,2063
48720,75501,7412,36347,4910,68089,4032,1969,2063
48725,75505,7412,36347,4910,68093,4032,1969,2063
48730,75515,7414,36351,4910,68101,4032,1969,2063
48735,75521,7414,36353,4910,68107,4033,1969,2064
48740,75532,7415,36357,4910,68117,4034,1969,2065
48745,75536,7416,36358,4911,68120,4034,1969,2065
48750,75546,7418,36365,4913,68128,4034,1969,2065
48755,75552,7418,36368,4913,68134,4035,1969,2066
48760,75563,7419,36373,4913,68144,4036,1969,2067
48765,75567,7420,36377,4914,68147,4036,1969,2067
48770,75577,7422,36383,4915,68155,4036,1969,2067
48775,75583,7422,36386,4915,68160,4038,1969,2069
48780,75594,7425,36390,4918,68169,4039,1969,2070
48785,75598,7425,36393,4918,68173,4039,1969,2070
48790,75608,7426,36398,4918,68182,4039,1969,2070
48795,75614,7426,36399,4918,68188,4040,1969,2071
48800,75625,7426,36406,4918,68199,4040,1969,2071
48805,75629,7426,36407,4918,68203,4040,1969,2071
48810,75639,7427,36412,4918,68212,4040,1969,2071
48815,75645,7427,36415,4918,68218,4041,1970,2071
48820,75656,7427,36420,4918,68229,4041,1970,2071
48825,75660,7427,36421,4918,68233,4041,1970,2071
48830,75670,7428,36424,4919,68242,4041,1970,2071
48835,75676,7428,36428,4919,68247,4042,1971,2071
48840,75687,7430,36434,4921,68257,4042,1971,2071
48845,75691,7430,36436,4921,68261,4042,1971,2071
48850,75701,7431,36440,4921,68270,4042,1971,2071
48855,75707,7431,36440,4921,68276,4043,1971,2072
48860,75718,7432,36443,4922,68286,4043,1971,2072
48865,75722,7432,36447,4922,68290,4043,1971,2072
48870,75732,7433,36452,4922,68299,4043,1971,2072
48875,75738,7433,36456,4922,68304,4044,1971,2073
48880,75749,7435,36461,4924,68314,4044,1971,2073
48885,75753,7435,36464,4924,68318,4044,1971,2073
48890,75763,7437,36468,4924,68326,4044,1971,2073
48895,75769,7437,36470,4924,68332,4046,1971,2075
48900,75780,7440,36477,4927,68340,4047,1972,2075
48905,75784,7441,36480,4928,68343,4047,1972,2075
48910,75794,7442,36486,4928,68352,4047,1972,2075
48915,75800,7442,36489,4928,68358,4048,1973,2075
48920,75811,7445,36496,4930,68366,4049,1974,2075
48925,75815,7445,36498,4930,68370,4049,1974,2075
48930,75825,7446,36503,4930,68379,4049,1974,2075
48935,75831,7446,36506,4930,68385,4050,1975,2075
48940,75842,7447,36508,4931,68395,4051,1975,2076
48945,75846,7447,36509,4931,68399,4051,1975,2076
48950,75856,7448,36514,4932,68408,4051,1975,2076
48955,75862,7448,36516,4932,68414,4052,1976,2076
48960,75873,7451,36523,4935,68422,4053,1977,2076
48965,75877,7451,36524,4935,68426,4053,1977,2076
48970,75887,7451,36527,4935,68436,4053,1977,2076
48975,75893,7451,36529,4935,68442,4054,1978,2076
48980,75904,7452,36533,4935,68452,4054,1978,2076
48985,75908,7452,36535,4935,68456,4054,1978,2076
48990,75918,7452,36539,4935,68466,4054,1978,2076
48995,75924,7452,36541,4935,68472,4055,1978,2077
49000,75935,7453,36544,4936,68482,4055,1978,2077
49005,75939,7453,36547,4936,68486,4055,1978,2077
49010,75949,7453,36552,4936,68496,4055,1978,2077
49015,75955,7453,36555,4936,68502,4057,1979,2078
49020,75966,7454,36558,4936,68512,4057,1979,2078
49025,75970,7454,36560,4936,68516,4057,1979,2078
49030,75980,7456,36565,4937,68524,4057,1979,2078
49035,75986,7456,36568,4937,68530,4058,1979,2079
49040,75997,7460,36575,4941,68537,4058,1979,2079
49045,76001,7462,36578,4943,68539,4058,1979,2079
49050,76011,7464,36583,4944,68547,4058,1979,2079
49055,76017,7464,36584,4944,68553,4059,1979,2080
49060,76028,7466,36588,4945,68562,4059,1979,2080
49065,76032,7467,36589,4946,68565,4059,1979,2080
49070,76042,7469,36591,4946,68573,4059,1979,2080
49075,76048,7469,36592,4946,68579,4060,1979,2081
49080,76059,7471,36596,4947,68588,4060,1979,2081
49085,76063,7472,36597,4948,68591,4060,1979,2081
49090,76073,7474,36601,4948,68599,4060,1979,2081
49095,76079,7474,36604,4948,68605,4061,1979,2082
49100,76090,7474,36608,4948,68616,4061,1979,2082
49105,76094,7474,36610,4948,68620,4061,1979,2082
49110,76104,7476,36615,4949,68628,4061,1979,2082
49115,76110,7476,36619,4949,68634,4062,1980,2082
49120,76121,7476,36625,4949,68645,4062,1980,2082
49125,76125,7476,36628,4949,68649,4062,1980,2082
49130,76135,7478,36630,4949,68657,4062,1980,2082
49135,76141,7478,36633,4949,68663,4064,1981,2083
49140,76152,7479,36640,4950,68673,4065,1982,2083
49145,76156,7479,36642,4950,68677,4065,1982,2083
49150,76166,7479,36647,4950,68687,4065,1982,2083
49155,76172,7479,36649,4950,68693,4066,1982,2084
49160,76183,7479,36656,4950,68704,4066,1982,2084
49165,76187,7479,36658,4950,68708,4066,1982,2084
49170,76197,7479,36663,4950,68718,4066,1982,2084
49175,76203,7479,36665,4950,68724,4067,1982,2085
49180,76214,7479,36670,4950,68735,4067,1982,2085
49185,76218,7479,36670,4950,68739,4067,1982,2085
49190,76228,7479,36675,4950,68749,4067,1982,2085
49195,76234,7479,36680,4950,68755,4068,1983,2085
49200,76245,7480,36687,4950,68765,4069,1984,2085
49205,76249,7480,36689,4950,68769,4069,1984,2085
49210,76259,7480,36694,4950,68779,4069,1984,2085
49215,76265,7480,36698,4950,68785,4070,1985,2085
49220,76276,7481,36703,4951,68795,4070,1985,2085
49225,76280,7481,36705,4951,68799,4070,1985,2085
49230,76290,7481,36709,4951,68809,4070,1985,2085
49235,76296,7481,36710,4951,68815,4071,1985,2086
49240,76307,7483,36714,4953,68824,4071,1985,2086
49245,76311,7483,36715,4953,68828,4071,1985,2086
49250,76321,7485,36717,4953,68836,4071,1985,2086
49255,76327,7485,36721,4953,68841,4073,1987,2086
49260,76338,7487,36726,4954,68851,4074,1987,2087
49265,76342,7487,36728,4954,68855,4074,1987,2087
49270,76352,7489,36735,4955,68863,4074,1987,2087
49275,76358,7489,36737,4955,68869,4075,1987,2088
49280,76369,7492,36744,4957,68877,4076,1988,2088
49285,76373,7493,36747,4958,68880,4076,1988,2088
49290,76383,7495,36752,4960,68888,4076,1988,2088
49295,76389,7495,36755,4960,68893,4077,1988,2089
49300,76400,7498,36759,4963,68902,4078,1988,2090
49305,76404,7499,36761,4964,68905,4078,1988,2090
49310,76414,7501,36764,4966,68913,4078,1988,2090
49315,76420,7501,36764,4966,68919,4079,1988,2091
49320,76431,7502,36768,4966,68929,4080,1989,2091
49325,76435,7502,36769,4966,68933,4080,1989,2091
49330,76445,7504,36776,4967,68941,4080,1989,2091
49335,76451,7504,36778,4967,68947,4081,1989,2092
49340,76462,7506,36781,4968,68956,4081,1989,2092
49345,76466,7507,36783,4969,68959,4081,1989,2092
49350,76476,7509,36788,4969,68967,4081,1989,2092
49355,76482,7509,36792,4969,68973,4082,1990,2092
49360,76493,7511,36799,4970,68982,4082,1990,2092
49365,76497,7512,36800,4971,68985,4082,1990,2092
49370,76507,7514,36806,4971,68993,4082,1990,2092
49375,76513,7514,36809,4971,68999,4084,1991,2093
49380,76524,7516,36816,4973,69008,4084,1991,2093
49385,76528,7517,36819,4974,69011,4084,1991,2093
49390,76538,7517,36824,4974,69021,4084,1991,2093
49395,76544,7517,36827,4974,69027,4085,1991,2094
49400,76555,7519,36833,4975,69036,4085,1991,2094
49405,76559,7520,36834,4976,69039,4085,1991,2094
49410,76569,7520,36838,4976,69049,4085,1991,2094
49415,76575,7520,36842,4976,69055,4086,1991,2095
49420,76586,7521,36848,4976,69065,4086,1991,2095
49425,76590,7522,36851,4977,69068,4086,1991,2095
49430,76600,7522,36854,4977,69078,4086,1991,2095
49435,76606,7522,36856,4977,69084,4087,1991,2096
49440,76617,7523,36857,4977,69094,4088,1991,2097
49445,76621,7523,36859,4977,69098,4088,1991,2097
49450,76631,7523,36861,4977,69108,4088,1991,2097
49455,76637,7523,36863,4977,69114,4089,1991,2098
49460,76648,7523,36870,4977,69125,4089,1991,2098
49465,76652,7523,36871,4977,69129,4089,1991,2098
49470,76662,7523,36878,4977,69139,4089,1991,2098
49475,76668,7523,36881,4977,69145,4090,1992,2098
49480,76679,7523,36884,4977,69156,4090,1992,2098
49485,76683,7523,36888,4977,69160,4090,1992,2098
49490,76693,7524,36894,4977,69169,4090,1992,2098
49495,76699,7524,36896,4977,69175,4092,1992,2100
49500,76710,7524,36900,4977,69186,4093,1992,2101
49505,76714,7526,36902,4979,69188,4093,1992,2101
49510,76724,7528,36906,4979,69196,4093,1992,2101
49515,76730,7528,36910,4979,69201,4095,1993,2102
49520,76741,7531,36916,4981,69210,4096,1993,2103
49525,76745,7532,36919,4982,69213,4096,1993,2103
49530,76755,7534,36924,4983,69221,4096,1993,2103
49535,76761,7534,36927,4983,69227,4098,1994,2104
49540,76772,7535,36931,4984,69237,4099,1994,2105
49545,76776,7536,36934,4985,69240,4099,1994,2105
49550,76786,7538,36938,4986,69248,4099,1994,2105
49555,76792,7538,36943,4986,69253,4101,1996,2105
49560,76803,7541,36951,4989,69262,4102,1997,2105
49565,76807,7542,36953,4990,69265,4102,1997,2105
49570,76817,7543,36959,4990,69274,4102,1997,2105
49575,76823,7543,36963,4990,69279,4103,1998,2105
49580,76834,7545,36967,4991,69289,4103,1998,2105
49585,76838,7546,36970,4992,69292,4103,1998,2105
49590,76848,7547,36975,4992,69301,4103,1998,2105
49595,76854,7547,36980,4992,69306,4104,1999,2105
49600,76865,7550,36986,4994,69315,4104,1999,2105
49605,76869,7550,36986,4994,69319,4104,1999,2105
49610,76879,7551,36993,4995,69328,4104,1999,2105
49615,76885,7551,36996,4995,69334,4105,2000,2105
49620,76896,7552,37001,4996,69344,4105,2000,2105
49625,76900,7552,37003,4996,69348,4105,2000,2105
49630,76910,7553,37009,4997,69357,4105,2000,2105
49635,76916,7553,37011,4997,69363,4106,2000,2106
49640,76927,7553,37012,4997,69374,4106,2000,2106
49645,76931,7553,37015,4997,69378,4106,2000,2106
49650,76941,7554,37020,4997,69387,4106,2000,2106
49655,76947,7554,37024,4997,69393,4107,2001,2106
49660,76958,7554,37029,4997,69404,4107,2001,2106
49665,76962,7554,37031,4997,69408,4107,2001,2106
49670,76972,7556,37035,4998,69416,4107,2001,2106
49675,76978,7556,37037,4998,69422,4108,2002,2106
49680,76989,7556,37043,4998,69433,4109,2003,2106
49685,76993,7557,37047,4999,69436,4109,2003,2106
49690,77003,7559,37050,5000,69444,4109,2003,2106
49695,77009,7559,37052,5000,69450,4110,2004,2106
49700,77020,7560,37058,5001,69460,4111,2004,2107
49705,77024,7560,37060,5001,69464,4111,2004,2107
49710,77034,7562,37066,5002,69472,4111,2004,2107
49715,77040,7562,37068,5002,69478,4112,2004,2108
49720,77051,7563,37073,5003,69488,4113,2004,2109
49725,77055,7563,37073,5003,69492,4113,2004,2109
49730,77065,7565,37076,5004,69500,4113,2004,2109
49735,77071,7565,37077,5004,69506,4115,2004,2111
49740,77082,7566,37083,5005,69516,4116,2005,2111
49745,77086,7567,37084,5006,69519,4116,2005,2111
49750,77096,7569,37090,5008,69527,4116,2005,2111
49755,77102,7569,37094,5008,69533,4117,2005,2112
49760,77113,7570,37099,5008,69543,4117,2005,2112
49765,77117,7571,37101,5009,69546,4117,2005,2112
49770,77127,7573,37106,5009,69554,4117,2005,2112
49775,77133,7573,37108,5009,69560,4118,2005,2113
49780,77144,7575,37113,5010,69569,4118,2005,2113
49785,77148,7575,37115,5010,69573,4118,2005,2113
49790,77158,7577,37120,5010,69581,4118,2005,2113
49795,77164,7577,37122,5010,69587,4119,2005,2114
49800,77175,7579,37128,5012,69596,4120,2005,2115
49805,77179,7580,37132,5013,69599,4120,2005,2115
49810,77189,7582,37135,5014,69607,4120,2005,2115
49815,77195,7582,37137,5014,69613,4121,2006,2115
49820,77206,7584,37141,5016,69622,4122,2006,2116
49825,77210,7584,37143,5016,69626,4122,2006,2116
49830,77220,7586,37145,5016,69634,4122,2006,2116
49835,77226,7586,37146,5016,69640,4123,2007,2116
49840,77237,7588,37151,5018,69649,4124,2008,2116
49845,77241,7588,37152,5018,69653,4124,2008,2116
49850,77251,7590,37157,5019,69661,4124,2008,2116
49855,77257,7590,37158,5019,69667,4126,2009,2117
49860,77268,7592,37161,5021,69676,4127,2009,2118
49865,77272,7592,37162,5021,69680,4127,2009,2118
49870,77282,7594,37166,5021,69688,4127,2009,2118
49875,77288,7594,37169,5021,69694,4128,2010,2118
49880,77299,7595,37173,5022,69704,4129,2010,2119
49885,77303,7595,37173,5022,69708,4129,2010,2119
49890,77313,7597,37179,5022,69716,4129,2010,2119
49895,77319,7597,37182,5022,69722,4130,2010,2120
49900,77330,7599,37190,5024,69731,4131,2010,2121
49905,77334,7599,37191,5024,69735,4131,2010,2121
49910,77344,7601,37196,5025,69743,4131,2010,2121
49915,77350,7601,37198,5025,69749,4132,2011,2121
49920,77361,7602,37203,5026,69759,4133,2012,2121
49925,77365,7602,37206,5026,69763,4133,2012,2121
49930,77375,7602,37209,5026,69773,4133,2012,2121
49935,77381,7602,37213,5026,69779,4134,2013,2121
49940,77392,7602,37215,5026,69790,4134,2013,2121
49945,77396,7602,37218,5026,69794,4134,2013,2121
49950,77406,7602,37223,5026,69804,4134,2013,2121
49955,77412,7602,37228,5026,69810,4135,2014,2121
49960,77423,7602,37234,5026,69821,4135,2014,2121
49965,77427,7602,37236,5026,69825,4135,2014,2121
49970,77437,7602,37241,5026,69835,4135,2014,2121
49975,77443,7602,37243,5026,69841,4137,2015,2122
49980,77454,7604,37248,5027,69850,4138,2015,2123
49985,77458,7604,37250,5027,69854,4138,2015,2123
49990,77468,7604,37257,5027,69864,4138,2015,2123
49995,77474,7604,37258,5027,69870,4139,2015,2124
50000,77485,7606,37263,5028,69879,4139,2015,2124
50005,77489,7606,37264,5028,69883,4139,2015,2124
50010,77499,7606,37265,5028,69893,4139,2015,2124
50015,77505,7606,37269,5028,69899,4140,2016,2124
50020,77516,7607,37271,5029,69909,4140,2016,2124
50025,77520,7607,37273,5029,69913,4140,2016,2124
50030,77530,7609,37279,5031,69921,4140,2016,2124
50035,77536,7609,37285,5031,69926,4141,2017,2124
50040,77547,7613,37294,5035,69934,4141,2017,2124
50045,77551,7613,37296,5035,69938,4141,2017,2124
50050,77561,7614,37300,5036,69947,4141,2017,2124
50055,77567,7614,37303,5036,69953,4142,2018,2124
50060,77578,7616,37309,5037,69962,4143,2018,2125
50065,77582,7616,37311,5037,69966,4143,2018,2125
50070,77592,7617,37316,5038,69975,4143,2018,2125
50075,77598,7617,37318,5038,69981,4144,2018,2126
50080,77609,7619,37327,5040,69990,4144,2018,2126
50085,77613,7619,37331,5040,69994,4144,2018,2126
50090,77623,7620,37339,5041,70003,4144,2018,2126
50095,77629,7620,37341,5041,70009,4145,2018,2127
50100,77640,7622,37350,5043,70018,4145,2018,2127
50105,77644,7623,37354,5044,70021,4145,2018,2127
50110,77654,7624,37359,5045,70030,4145,2018,2127
50115,77660,7624,37362,5045,70036,4146,2019,2127
50120,77671,7625,37367,5045,70046,4146,2019,2127
50125,77675,7625,37367,5045,70050,4146,2019,2127
50130,77685,7626,37371,5045,70059,4146,2019,2127
50135,77691,7626,37375,5045,70065,4147,2020,2127
50140,77702,7627,37381,5046,70075,4147,2020,2127
50145,77706,7628,37382,5047,70078,4147,2020,2127
50150,77716,7630,37388,5048,70086,4147,2020,2127
50155,77722,7630,37392,5048,70091,4148,2021,2127
50160,77733,7633,37395,5050,70100,4148,2021,2127
50165,77737,7634,37399,5051,70103,4148,2021,2127
50170,77747,7636,37404,5052,70111,4148,2021,2127
50175,77753,7636,37410,5052,70117,4149,2022,2127
50180,77764,7637,37414,5053,70127,4150,2022,2128
50185,77768,7638,37417,5054,70130,4150,2022,2128
50190,77778,7640,37423,5054,70138,4150,2022,2128
50195,77784,7640,37427,5054,70144,4151,2023,2128
50200,77795,7640,37436,5054,70155,4152,2024,2128
50205,77799,7640,37439,5054,70159,4152,2024,2128
50210,77809,7641,37443,5054,70168,4152,2024,2128
50215,77815,7641,37445,5054,70174,4153,2025,2128
50220,77826,7641,37449,5054,70185,4154,2026,2128
50225,77830,7641,37450,5054,70189,4154,2026,2128
50230,77840,7641,37457,5054,70199,4154,2026,2128
50235,77846,7641,37461,5054,70205,4155,2027,2128
50240,77857,7641,37463,5054,70216,4155,2027,2128
50245,77861,7641,37463,5054,70220,4155,2027,2128
50250,77871,7641,37468,5054,70230,4155,2027,2128
50255,77877,7641,37471,5054,70236,4156,2028,2128
50260,77888,7641,37475,5054,70247,4156,2028,2128
50265,77892,7641,37476,5054,70251,4156,2028,2128
50270,77902,7641,37477,5054,70261,4156,2028,2128
50275,77908,7641,37480,5054,70267,4157,2029,2128
50280,77919,7642,37485,5054,70277,4157,2029,2128
50285,77923,7643,37487,5055,70280,4157,2029,2128
50290,77933,7643,37488,5055,70290,4157,2029,2128
50295,77939,7643,37489,5055,70296,4158,2030,2128
50300,77950,7644,37492,5056,70306,4158,2030,2128
50305,77954,7645,37493,5057,70309,4158,2030,2128
50310,77964,7645,37500,5057,70319,4158,2030,2128
50315,77970,7645,37502,5057,70325,4159,2030,2129
50320,77981,7646,37506,5058,70335,4159,2030,2129
50325,77985,7646,37506,5058,70339,4159,2030,2129
50330,77995,7648,37511,5059,70347,4159,2030,2129
50335,78001,7648,37514,5059,70353,4161,2030,2131
50340,78012,7650,37519,5061,70362,4162,2030,2132
50345,78016,7652,37521,5063,70364,4162,2030,2132
50350,78026,7654,37526,5064,70372,4162,2030,2132
50355,78032,7654,37528,5064,70378,4163,2030,2133
50360,78043,7655,37533,5064,70388,4164,2031,2133
50365,78047,7656,37535,5065,70391,4164,2031,2133
50370,78057,7658,37539,5066,70399,4164,2031,2133
50375,78063,7658,37541,5066,70405,4165,2031,2134
50380,78074,7659,37546,5066,70415,4166,2032,2134
50385,78078,7659,37547,5066,70419,4166,2032,2134
50390,78088,7661,37549,5067,70427,4166,2032,2134
50395,78094,7661,37554,5067,70432,4167,2033,2134
50400,78105,7663,37559,5069,70442,4168,2034,2134
50405,78109,7663,37560,5069,70446,4168,2034,2134
50410,78119,7664,37567,5070,70455,4168,2034,2134
50415,78125,7664,37568,5070,70461,4169,2034,2135
50420,78136,7665,37571,5070,70471,4169,2034,2135
50425,78140,7665,37575,5070,70475,4169,2034,2135
50430,78150,7666,37579,5070,70484,4169,2034,2135
50435,78156,7666,37583,5070,70489,4170,2035,2135
50440,78167,7668,37587,5071,70499,4170,2035,2135
50445,78171,7668,37589,5071,70503,4170,2035,2135
50450,78181,7669,37596,5072,70512,4170,2035,2135
50455,78187,7669,37601,5072,70517,4172,2037,2135
50460,78198,7671,37606,5074,70527,4172,2037,2135
50465,78202,7671,37608,5074,70531,4172,2037,2135
50470,78212,7673,37611,5075,70539,4172,2037,2135
50475,78218,7673,37614,5075,70545,4173,2038,2135
50480,78229,7675,37620,5076,70554,4173,2038,2135
50485,78233,7677,37623,5078,70556,4173,2038,2135
50490,78243,7679,37629,5080,70564,4173,2038,2135
50495,78249,7679,37634,5080,70570,4174,2039,2135
50500,78260,7682,37640,5082,70578,4174,2039,2135
50505,78264,7683,37642,5083,70581,4174,2039,2135
50510,78274,7685,37646,5084,70589,4174,2039,2135
50515,78280,7685,37647,5084,70595,4175,2039,2136
50520,78291,7686,37649,5084,70605,4176,2039,2137
50525,78295,7686,37651,5084,70609,4176,2039,2137
50530,78305,7686,37656,5084,70619,4176,2039,2137
50535,78311,7686,37659,5084,70625,4177,2039,2138
50540,78322,7686,37668,5084,70636,4177,2039,2138
50545,78326,7686,37672,5084,70640,4177,2039,2138
50550,78336,7686,37679,5084,70650,4177,2039,2138
50555,78342,7686,37682,5084,70656,4178,2040,2138
50560,78353,7686,37689,5084,70667,4178,2040,2138
50565,78357,7686,37692,5084,70671,4178,2040,2138
50570,78367,7686,37698,5084,70681,4178,2040,2138
50575,78373,7686,37702,5084,70687,4180,2042,2138
50580,78384,7686,37707,5084,70698,4180,2042,2138
50585,78388,7686,37709,5084,70702,4180,2042,2138
50590,78398,7686,37715,5084,70712,4180,2042,2138
50595,78404,7686,37716,5084,70718,4181,2042,2139
50600,78415,7686,37719,5084,70729,4181,2042,2139
50605,78419,7686,37719,5084,70733,4181,2042,2139
50610,78429,7686,37724,5084,70743,4181,2042,2139
50615,78435,7686,37727,5084,70749,4182,2043,2139
50620,78446,7686,37731,5084,70760,4182,2043,2139
50625,78450,7686,37732,5084,70764,4182,2043,2139
50630,78460,7688,37737,5084,70772,4182,2043,2139
50635,78466,7688,37739,5084,70778,4183,2043,2140
50640,78477,7691,37743,5086,70786,4183,2043,2140
50645,78481,7693,37746,5088,70788,4183,2043,2140
50650,78491,7695,37749,5089,70796,4183,2043,2140
50655,78497,7695,37753,5089,70802,4184,2043,2141
50660,78508,7696,37759,5090,70812,4184,2043,2141
50665,78512,7696,37761,5090,70816,4184,2043,2141
50670,78522,7698,37765,5091,70824,4184,2043,2141
50675,78528,7698,37767,5091,70830,4185,2043,2142
50680,78539,7699,37770,5092,70840,4185,2043,2142
50685,78543,7699,37772,5092,70844,4185,2043,2142
50690,78553,7701,37776,5093,70852,4185,2043,2142
50695,78559,7701,37778,5093,70858,4187,2045,2142
50700,78570,7701,37783,5093,70869,4187,2045,2142
50705,78574,7701,37784,5093,70873,4187,2045,2142
50710,78584,7703,37789,5095,70881,4187,2045,2142
50715,78590,7703,37791,5095,70887,4188,2045,2143
50720,78601,7704,37795,5096,70897,4188,2045,2143
50725,78605,7704,37797,5096,70901,4188,2045,2143
50730,78615,7706,37803,5097,70909,4188,2045,2143
50735,78621,7706,37806,5097,70915,4189,2046,2143
50740,78632,7707,37811,5098,70925,4189,2046,2143
50745,78636,7707,37814,5098,70929,4189,2046,2143
50750,78646,7709,37819,5100,70937,4189,2046,2143
50755,78652,7709,37821,5100,70943,4190,2047,2143
50760,78663,7711,37826,5102,70952,4191,2047,2144
50765,78667,7711,37828,5102,70956,4191,2047,2144
50770,78677,7712,37834,5103,70965,4191,2047,2144
50775,78683,7712,37837,5103,70971,4192,2048,2144
50780,78694,7713,37840,5104,70981,4192,2048,2144
50785,78698,7714,37842,5105,70984,4192,2048,2144
50790,78708,7715,37845,5105,70993,4192,2048,2144
50795,78714,7715,37847,5105,70998,4193,2048,2145
50800,78725,7717,37851,5106,71008,4193,2048,2145
50805,78729,7717,37853,5106,71012,4193,2048,2145
50810,78739,7718,37857,5106,71021,4193,2048,2145
50815,78745,7718,37860,5106,71027,4195,2050,2145
50820,78756,7720,37867,5107,71036,4195,2050,2145
50825,78760,7720,37870,5107,71040,4195,2050,2145
50830,78770,7720,37876,5107,71050,4195,2050,2145
50835,78776,7720,37878,5107,71056,4196,2050,2146
50840,78787,7721,37885,5108,71066,4196,2050,2146
50845,78791,7721,37888,5108,71070,4196,2050,2146
50850,78801,7721,37893,5108,71080,4196,2050,2146
50855,78807,7721,37896,5108,71086,4197,2051,2146
50860,78818,7722,37902,5108,71096,4197,2051,2146
50865,78822,7722,37905,5108,71100,4197,2051,2146
50870,78832,7723,37908,5108,71109,4197,2051,2146
50875,78838,7723,37910,5108,71115,4198,2052,2146
50880,78849,7725,37915,5110,71124,4199,2052,2147
50885,78853,7725,37916,5110,71128,4199,2052,2147
50890,78863,7727,37920,5112,71136,4199,2052,2147
50895,78869,7727,37921,5112,71142,4200,2052,2148
50900,78880,7728,37926,5112,71152,4200,2052,2148
50905,78884,7728,37928,5112,71156,4200,2052,2148
50910,78894,7730,37934,5113,71164,4200,2052,2148
50915,78900,7730,37938,5113,71170,4201,2052,2149
50920,78911,7731,37943,5113,71180,4201,2052,2149
50925,78915,7731,37945,5113,71184,4201,2052,2149
50930,78925,7733,37948,5113,71192,4201,2052,2149
50935,78931,7733,37949,5113,71198,4203,2052,2151
50940,78942,7734,37953,5113,71208,4203,2052,2151
50945,78946,7734,37955,5113,71212,4203,2052,2151
50950,78956,7736,37960,5114,71220,4203,2052,2151
50955,78962,7736,37965,5114,71226,4204,2053,2151
50960,78973,7738,37971,5115,71235,4204,2053,2151
50965,78977,7738,37974,5115,71239,4204,2053,2151
50970,78987,7740,37979,5116,71247,4204,2053,2151
50975,78993,7740,37983,5116,71253,4205,2054,2151
50980,79004,7741,37990,5116,71263,4205,2054,2151
50985,79008,7743,37993,5118,71265,4205,2054,2151
50990,79018,7745,37999,5118,71273,4205,2054,2151
50995,79024,7745,38001,5118,71279,4206,2054,2152
51000,79035,7747,38006,5119,71288,4207,2055,2152
51005,79039,7747,38008,5119,71292,4207,2055,2152
51010,79049,7747,38011,5119,71302,4207,2055,2152
51015,79055,7747,38016,5119,71308,4208,2056,2152
51020,79066,7747,38020,5119,71319,4208,2056,2152
51025,79070,7747,38022,5119,71323,4208,2056,2152
51030,79080,7747,38027,5119,71333,4208,2056,2152
51035,79086,7747,38032,5119,71339,4209,2057,2152
51040,79097,7747,38036,5119,71350,4209,2057,2152
51045,79101,7747,38036,5119,71354,4209,2057,2152
51050,79111,7747,38044,5119,71364,4209,2057,2152
51055,79117,7747,38047,5119,71370,4211,2058,2153
51060,79128,7747,38051,5119,71381,4211,2058,2153
51065,79132,7747,38055,5119,71385,4211,2058,2153
51070,79142,7747,38059,5119,71395,4211,2058,2153
51075,79148,7747,38062,5119,71401,4212,2059,2153
51080,79159,7747,38065,5119,71412,4212,2059,2153
51085,79163,7747,38067,5119,71416,4212,2059,2153
51090,79173,7747,38073,5119,71426,4212,2059,2153
51095,79179,7747,38077,5119,71432,4213,2059,2154
51100,79190,7747,38082,5119,71443,4213,2059,2154
51105,79194,7747,38086,5119,71447,4213,2059,2154
51110,79204,7749,38091,5120,71455,4213,2059,2154
51115,79210,7749,38094,5120,71460,4214,2059,2155
51120,79221,7752,38097,5122,71469,4215,2059,2156
51125,79225,7752,38099,5122,71473,4215,2059,2156
51130,79235,7754,38105,5122,71481,4215,2059,2156
51135,79241,7754,38108,5122,71486,4216,2060,2156
51140,79252,7756,38110,5124,71496,4217,2060,2157
51145,79256,7756,38113,5124,71500,4217,2060,2157
51150,79266,7758,38119,5125,71508,4217,2060,2157
51155,79272,7758,38122,5125,71513,4218,2060,2158
51160,79283,7760,38126,5126,71523,4219,2061,2158
51165,79287,7760,38129,5126,71527,4219,2061,2158
51170,79297,7762,38134,5126,71535,4219,2061,2158
51175,79303,7762,38134,5126,71541,4221,2061,2160
51180,79314,7764,38141,5127,71550,4222,2062,2160
51185,79318,7764,38142,5127,71554,4222,2062,2160
51190,79328,7765,38145,5127,71563,4222,2062,2160
51195,79334,7765,38148,5127,71568,4223,2062,2161
51200,79345,7767,38152,5129,71578,4223,2062,2161
51205,79349,7767,38154,5129,71582,4223,2062,2161
51210,79359,7768,38161,5130,71591,4223,2062,2161
51215,79365,7768,38163,5130,71597,4224,2062,2162
51220,79376,7770,38169,5131,71606,4224,2062,2162
51225,79380,7770,38173,5131,71610,4224,2062,2162
51230,79390,7771,38179,5132,71619,4224,2062,2162
51235,79396,7771,38183,5132,71624,4225,2063,2162
51240,79407,7773,38186,5133,71634,4225,2063,2162
51245,79411,7774,38188,5134,71637,4225,2063,2162
51250,79421,7774,38192,5134,71647,4225,2063,2162
51255,79427,7774,38197,5134,71653,4226,2064,2162
51260,79438,7775,38202,5134,71663,4227,2065,2162
51265,79442,7776,38205,5135,71666,4227,2065,2162
51270,79452,7776,38210,5135,71676,4227,2065,2162
51275,79458,7776,38212,5135,71682,4228,2066,2162
51280,79469,7778,38216,5136,71691,4229,2066,2163
51285,79473,7778,38219,5136,71695,4229,2066,2163
51290,79483,7779,38223,5136,71704,4229,2066,2163
51295,79489,7779,38226,5136,71710,4230,2066,2164
51300,79500,7780,38231,5137,71720,4230,2066,2164
51305,79504,7780,38232,5137,71724,4230,2066,2164
51310,79514,7781,38237,5137,71733,4230,2066,2164
51315,79520,7781,38239,5137,71739,4231,2066,2165
51320,79531,7782,38242,5138,71749,4231,2066,2165
51325,79535,7782,38243,5138,71753,4231,2066,2165
51330,79545,7783,38248,5138,71762,4231,2066,2165
51335,79551,7783,38252,5138,71767,4232,2066,2166
51340,79562,7785,38259,5139,71777,4232,2066,2166
51345,79566,7785,38259,5139,71781,4232,2066,2166
51350,79576,7786,38262,5139,71790,4232,2066,2166
51355,79582,7786,38266,5139,71795,4233,2067,2166
51360,79593,7788,38270,5141,71805,4233,2067,2166
51365,79597,7788,38271,5141,71809,4233,2067,2166
51370,79607,7790,38276,5142,71817,4233,2067,2166
51375,79613,7790,38276,5142,71823,4234,2067,2167
51380,79624,7792,38283,5144,71832,4234,2067,2167
51385,79628,7792,38284,5144,71836,4234,2067,2167
51390,79638,7794,38288,5145,71844,4234,2067,2167
51395,79644,7794,38290,5145,71850,4235,2068,2167
51400,79655,7796,38298,5146,71859,4236,2069,2167
51405,79659,7796,38300,5146,71863,4236,2069,2167
51410,79669,7798,38305,5147,71871,4236,2069,2167
51415,79675,7798,38308,5147,71877,4238,2071,2167
51420,79686,7800,38312,5149,71886,4239,2071,2168
51425,79690,7800,38314,5149,71890,4239,2071,2168
51430,79700,7802,38318,5149,71898,4239,2071,2168
51435,79706,7802,38319,5149,71904,4240,2071,2169
51440,79717,7804,38326,5151,71913,4241,2072,2169
51445,79721,7804,38327,5151,71917,4241,2072,2169
51450,79731,7806,38333,5152,71925,4241,2072,2169
51455,79737,7806,38336,5152,71931,4242,2073,2169
51460,79748,7808,38341,5153,71940,4243,2073,2170
51465,79752,7809,38344,5154,71943,4243,2073,2170
51470,79762,7811,38352,5155,71951,4243,2073,2170
51475,79768,7811,38356,5155,71956,4244,2074,2170
51480,79779,7815,38362,5158,71964,4245,2074,2171
51485,79783,7815,38365,5158,71968,4245,2074,2171
51490,79793,7816,38372,5158,71977,4245,2074,2171
51495,79799,7816,38375,5158,71982,4246,2075,2171
51500,79810,7818,38382,5160,71992,4246,2075,2171
51505,79814,7818,38383,5160,71996,4246,2075,2171
51510,79824,7819,38387,5160,72005,4246,2075,2171
51515,79830,7819,38389,5160,72011,4247,2076,2171
51520,79841,7819,38392,5160,72022,4247,2076,2171
51525,79845,7819,38394,5160,72026,4247,2076,2171
51530,79855,7820,38398,5161,72035,4247,2076,2171
51535,79861,7820,38400,5161,72041,4249,2076,2173
51540,79872,7820,38405,5161,72052,4249,2076,2173
51545,79876,7820,38407,5161,72056,4249,2076,2173
51550,79886,7821,38412,5162,72065,4249,2076,2173
51555,79892,7821,38416,5162,72071,4250,2077,2173
51560,79903,7821,38419,5162,72082,4250,2077,2173
51565,79907,7821,38421,5162,72086,4250,2077,2173
51570,79917,7822,38425,5162,72095,4250,2077,2173
51575,79923,7822,38428,5162,72101,4251,2077,2174
51580,79934,7822,38434,5162,72112,4251,2077,2174
51585,79938,7822,38437,5162,72116,4251,2077,2174
51590,79948,7824,38441,5163,72124,4251,2077,2174
51595,79954,7824,38443,5163,72130,4252,2078,2174
51600,79965,7826,38447,5165,72139,4253,2078,2175
51605,79969,7827,38449,5166,72142,4253,2078,2175
51610,79979,7829,38452,5167,72150,4253,2078,2175
51615,79985,7829,38455,5167,72156,4254,2078,2176
51620,79996,7831,38460,5169,72165,4255,2078,2177
51625,80000,7832,38462,5170,72168,4255,2078,2177
51630,80010,7834,38467,5170,72176,4255,2078,2177
51635,80016,7834,38470,5170,72182,4256,2079,2177
51640,80027,7835,38476,5171,72192,4257,2079,2178
51645,80031,7835,38477,5171,72196,4257,2079,2178
51650,80041,7837,38481,5173,72204,4257,2079,2178
51655,80047,7837,38482,5173,72210,4259,2080,2179
51660,80058,7838,38487,5174,72220,4260,2081,2179
51665,80062,7839,38488,5175,72223,4260,2081,2179
51670,80072,7841,38492,5175,72231,4260,2081,2179
51675,80078,7841,38496,5175,72237,4261,2081,2180
51680,80089,7842,38502,5176,72247,4262,2081,2181
51685,80093,7842,38502,5176,72251,4262,2081,2181
51690,80103,7844,38510,5177,72259,4262,2081,2181
51695,80109,7844,38512,5177,72265,4263,2082,2181
51700,80120,7845,38516,5177,72275,4264,2082,2182
51705,80124,7845,38516,5177,72279,4264,2082,2182
51710,80134,7847,38521,5178,72287,4264,2082,2182
51715,80140,7847,38525,5178,72293,4265,2083,2182
51720,80151,7850,38529,5180,72301,4266,2083,2183
51725,80155,7850,38531,5180,72305,4266,2083,2183
51730,80165,7850,38536,5180,72315,4266,2083,2183
51735,80171,7850,38540,5180,72321,4267,2084,2183
51740,80182,7850,38545,5180,72332,4267,2084,2183
51745,80186,7850,38548,5180,72336,4267,2084,2183
51750,80196,7850,38552,5180,72346,4267,2084,2183
51755,80202,7850,38555,5180,72352,4268,2085,2183
51760,80213,7850,38561,5180,72363,4268,2085,2183
51765,80217,7850,38565,5180,72367,4268,2085,2183
51770,80227,7850,38568,5180,72377,4268,2085,2183
51775,80233,7850,38572,5180,72383,4270,2087,2183
51780,80244,7850,38579,5180,72394,4270,2087,2183
51785,80248,7850,38580,5180,72398,4270,2087,2183
51790,80258,7850,38584,5180,72408,4270,2087,2183
51795,80264,7850,38589,5180,72414,4271,2088,2183
51800,80275,7850,38596,5180,72425,4271,2088,2183
51805,80279,7850,38598,5180,72429,4271,2088,2183
51810,80289,7850,38602,5180,72439,4271,2088,2183
51815,80295,7850,38603,5180,72445,4272,2088,2184
51820,80306,7850,38610,5180,72456,4272,2088,2184
51825,80310,7850,38612,5180,72460,4272,2088,2184
51830,80320,7852,38619,5182,72468,4272,2088,2184
51835,80326,7852,38621,5182,72474,4273,2089,2184
51840,80337,7853,38627,5183,72484,4273,2089,2184
51845,80341,7853,38628,5183,72488,4273,2089,2184
51850,80351,7855,38631,5183,72496,4273,2089,2184
51855,80357,7855,38635,5183,72501,4274,2090,2184
51860,80368,7858,38641,5186,72510,4275,2091,2184
51865,80372,7860,38644,5188,72512,4275,2091,2184
51870,80382,7862,38648,5189,72520,4275,2091,2184
51875,80388,7862,38652,5189,72526,4276,2092,2184
51880,80399,7864,38658,5190,72535,4277,2092,2185
51885,80403,7865,38660,5191,72538,4277,2092,2185
51890,80413,7867,38667,5193,72546,4277,2092,2185
51895,80419,7867,38669,5193,72552,4279,2092,2187
51900,80430,7869,38671,5194,72561,4280,2092,2188
51905,80434,7869,38674,5194,72565,4280,2092,2188
51910,80444,7870,38679,5194,72574,4280,2092,2188
51915,80450,7870,38682,5194,72579,4282,2093,2189
51920,80461,7871,38688,5195,72590,4282,2093,2189
51925,80465,7871,38690,5195,72594,4282,2093,2189
51930,80475,7872,38695,5196,72603,4282,2093,2189
51935,80481,7872,38698,5196,72608,4284,2095,2189
51940,80492,7873,38701,5197,72619,4284,2095,2189
51945,80496,7873,38703,5197,72623,4284,2095,2189
51950,80506,7874,38712,5198,72632,4284,2095,2189
51955,80512,7874,38714,5198,72638,4285,2096,2189
51960,80523,7874,38717,5198,72649,4285,2096,2189
51965,80527,7874,38718,5198,72653,4285,2096,2189
51970,80537,7875,38724,5199,72662,4285,2096,2189
51975,80543,7875,38726,5199,72668,4286,2096,2190
51980,80554,7875,38730,5199,72679,4286,2096,2190
51985,80558,7875,38732,5199,72683,4286,2096,2190
51990,80568,7876,38737,5199,72692,4286,2096,2190
51995,80574,7876,38741,5199,72698,4287,2097,2190
52000,80585,7876,38743,5199,72709,4287,2097,2190
52005,80589,7876,38745,5199,72713,4287,2097,2190
52010,80599,7878,38750,5199,72721,4287,2097,2190
52015,80605,7878,38754,5199,72727,4288,2098,2190
52020,80616,7880,38758,5201,72736,4288,2098,2190
52025,80620,7881,38759,5202,72739,4288,2098,2190
52030,80630,7883,38761,5202,72747,4288,2098,2190
52035,80636,7883,38764,5202,72753,4289,2099,2190
52040,80647,7886,38770,5205,72761,4289,2099,2190
52045,80651,7886,38772,5205,72765,4289,2099,2190
52050,80661,7888,38778,5207,72773,4289,2099,2190
52055,80667,7888,38781,5207,72779,4290,2100,2190
52060,80678,7890,38787,5209,72788,4291,2101,2190
52065,80682,7890,38790,5209,72792,4291,2101,2190
52070,80692,7892,38795,5210,72800,4291,2101,2190
52075,80698,7892,38799,5210,72805,4293,2102,2191
52080,80709,7894,38805,5212,72815,4294,2103,2191
52085,80713,7894,38806,5212,72819,4294,2103,2191
52090,80723,7894,38810,5212,72829,4294,2103,2191
52095,80729,7894,38813,5212,72835,4295,2103,2192
52100,80740,7895,38819,5212,72845,4295,2103,2192
52105,80744,7895,38821,5212,72849,4295,2103,2192
52110,80754,7895,38828,5212,72859,4295,2103,2192
52115,80760,7895,38831,5212,72865,4296,2104,2192
52120,80771,7896,38835,5212,72875,4296,2104,2192
52125,80775,7896,38837,5212,72879,4296,2104,2192
52130,80785,7896,38842,5212,72889,4296,2104,2192
52135,80791,7896,38847,5212,72895,4297,2105,2192
52140,80802,7897,38854,5213,72905,4297,2105,2192
52145,80806,7897,38855,5213,72909,4297,2105,2192
52150,80816,7897,38858,5213,72919,4297,2105,2192
52155,80822,7897,38861,5213,72925,4298,2106,2192
52160,80833,7898,38867,5213,72935,4298,2106,2192
52165,80837,7898,38870,5213,72939,4298,2106,2192
52170,80847,7898,38877,5213,72949,4298,2106,2192
52175,80853,7898,38880,5213,72955,4299,2107,2192
52180,80864,7899,38885,5214,72965,4299,2107,2192
52185,80868,7899,38887,5214,72969,4299,2107,2192
52190,80878,7900,38890,5214,72978,4299,2107,2192
52195,80884,7900,38892,5214,72983,4300,2107,2193
52200,80895,7904,38899,5217,72991,4301,2108,2193
52205,80899,7904,38900,5217,72995,4301,2108,2193
52210,80909,7905,38906,5218,73004,4301,2108,2193
52215,80915,7905,38912,5218,73010,4303,2110,2193
52220,80926,7907,38917,5219,73019,4303,2110,2193
52225,80930,7907,38919,5219,73023,4303,2110,2193
52230,80940,7908,38925,5219,73032,4303,2110,2193
52235,80946,7908,38927,5219,73038,4304,2110,2194
52240,80957,7909,38934,5220,73048,4304,2110,2194
52245,80961,7909,38936,5220,73052,4304,2110,2194
52250,80971,7910,38943,5221,73061,4304,2110,2194
52255,80977,7910,38945,5221,73067,4305,2110,2195
52260,80988,7911,38949,5222,73077,4305,2110,2195
52265,80992,7911,38950,5222,73081,4305,2110,2195
52270,81002,7912,38954,5223,73090,4305,2110,2195
52275,81008,7912,38958,5223,73096,4306,2111,2195
52280,81019,7913,38963,5223,73106,4306,2111,2195
52285,81023,7914,38965,5224,73109,4306,2111,2195
52290,81033,7915,38970,5224,73118,4306,2111,2195
52295,81039,7915,38973,5224,73124,4307,2111,2196
52300,81050,7916,38978,5225,73134,4307,2111,2196
52305,81054,7917,38981,5226,73137,4307,2111,2196
52310,81064,7919,38986,5226,73145,4307,2111,2196
52315,81070,7919,38990,5226,73151,4308,2112,2196
52320,81081,7920,38993,5226,73161,4309,2113,2196
52325,81085,7920,38994,5226,73165,4309,2113,2196
52330,81095,7921,38997,5226,73174,4309,2113,2196
52335,81101,7921,39001,5226,73180,4311,2115,2196
52340,81112,7921,39001,5226,73191,4312,2115,2197
52345,81116,7921,39004,5226,73195,4312,2115,2197
52350,81126,7922,39011,5226,73204,4312,2115,2197
52355,81132,7922,39013,5226,73210,4313,2116,2197
52360,81143,7923,39020,5227,73220,4314,2117,2197
52365,81147,7923,39021,5227,73224,4314,2117,2197
52370,81157,7924,39027,5228,73233,4314,2117,2197
52375,81163,7924,39028,5228,73239,4315,2117,2198
52380,81174,7924,39033,5228,73250,4316,2118,2198
52385,81178,7924,39035,5228,73254,4316,2118,2198
52390,81188,7925,39039,5229,73263,4316,2118,2198
52395,81194,7925,39044,5229,73269,4317,2119,2198
52400,81205,7925,39049,5229,73280,4317,2119,2198
52405,81209,7925,39050,5229,73284,4317,2119,2198
52410,81219,7926,39056,5229,73293,4317,2119,2198
52415,81225,7926,39062,5229,73299,4318,2120,2198
52420,81236,7926,39067,5229,73310,4318,2120,2198
52425,81240,7926,39070,5229,73314,4318,2120,2198
52430,81250,7928,39072,5229,73322,4318,2120,2198
52435,81256,7928,39077,5229,73327,4319,2121,2198
52440,81267,7930,39080,5230,73337,4319,2121,2198
52445,81271,7930,39082,5230,73341,4319,2121,2198
52450,81281,7931,39088,5231,73350,4319,2121,2198
52455,81287,7931,39091,5231,73356,4320,2122,2198
52460,81298,7932,39094,5231,73366,4321,2122,2199
52465,81302,7932,39094,5231,73370,4321,2122,2199
52470,81312,7933,39097,5231,73379,4321,2122,2199
52475,81318,7933,39099,5231,73385,4322,2122,2200
52480,81329,7934,39104,5232,73395,4323,2123,2200
52485,81333,7934,39105,5232,73399,4323,2123,2200
52490,81343,7935,39111,5233,73408,4323,2123,2200
52495,81349,7935,39113,5233,73414,4324,2123,2201
52500,81360,7936,39121,5234,73424,4325,2124,2201
52505,81364,7937,39124,5235,73427,4325,2124,2201
52510,81374,7938,39127,5235,73436,4325,2124,2201
52515,81380,7938,39129,5235,73442,4326,2124,2202
52520,81391,7939,39137,5236,73452,4327,2125,2202
52525,81395,7940,39138,5237,73455,4327,2125,2202
52530,81405,7941,39144,5238,73464,4327,2125,2202
52535,81411,7941,39147,5238,73470,4328,2125,2203
52540,81422,7942,39154,5238,73480,4329,2126,2203
52545,81426,7942,39156,5238,73484,4329,2126,2203
52550,81436,7944,39161,5238,73492,4329,2126,2203
52555,81442,7944,39163,5238,73498,4330,2126,2204
52560,81453,7946,39167,5239,73507,4331,2127,2204
52565,81457,7946,39168,5239,73511,4331,2127,2204
52570,81467,7948,39175,5240,73519,4331,2127,2204
52575,81473,7948,39179,5240,73525,4332,2128,2204
52580,81484,7949,39182,5240,73535,4332,2128,2204
52585,81488,7949,39184,5240,73539,4332,2128,2204
52590,81498,7951,39187,5240,73547,4332,2128,2204
52595,81504,7951,39189,5240,73553,4333,2129,2204
52600,81515,7952,39194,5240,73563,4333,2129,2204
52605,81519,7952,39195,5240,73567,4333,2129,2204
52610,81529,7954,39200,5241,73575,4333,2129,2204
52615,81535,7954,39202,5241,73581,4334,2129,2205
52620,81546,7955,39210,5242,73591,4334,2129,2205
52625,81550,7957,39213,5244,73593,4334,2129,2205
52630,81560,7959,39218,5245,73601,4334,2129,2205
52635,81566,7959,39223,5245,73607,4335,2130,2205
52640,81577,7960,39229,5245,73617,4335,2130,2205
52645,81581,7961,39230,5246,73620,4335,2130,2205
52650,81591,7963,39238,5247,73628,4335,2130,2205
52655,81597,7963,39241,5247,73634,4336,2130,2206
52660,81608,7964,39247,5247,73644,4336,2130,2206
52665,81612,7964,39249,5247,73648,4336,2130,2206
52670,81622,7966,39254,5248,73656,4336,2130,2206
52675,81628,7966,39255,5248,73662,4337,2130,2207
52680,81639,7969,39261,5250,73670,4338,2130,2208
52685,81643,7969,39265,5250,73674,4338,2130,2208
52690,81653,7969,39268,5250,73684,4338,2130,2208
52695,81659,7969,39272,5250,73690,4339,2130,2209
52700,81670,7969,39275,5250,73701,4339,2130,2209
52705,81674,7969,39279,5250,73705,4339,2130,2209
52710,81684,7969,39285,5250,73715,4339,2130,2209
52715,81690,7969,39285,5250,73721,4340,2130,2210
52720,81701,7969,39292,5250,73732,4340,2130,2210
52725,81705,7969,39294,5250,73736,4340,2130,2210
52730,81715,7969,39300,5250,73746,4340,2130,2210
52735,81721,7969,39304,5250,73752,4341,2131,2210
52740,81732,7969,39312,5250,73763,4341,2131,2210
52745,81736,7969,39316,5250,73767,4341,2131,2210
52750,81746,7969,39322,5250,73777,4341,2131,2210
52755,81752,7969,39325,5250,73783,4342,2131,2211
52760,81763,7969,39332,5250,73794,4342,2131,2211
52765,81767,7969,39333,5250,73798,4342,2131,2211
52770,81777,7969,39336,5250,73808,4342,2131,2211
52775,81783,7969,39340,5250,73814,4343,2132,2211
52780,81794,7969,39342,5250,73825,4343,2132,2211
52785,81798,7969,39344,5250,73829,4343,2132,2211
52790,81808,7971,39350,5250,73837,4343,2132,2211
52795,81814,7971,39351,5250,73843,4344,2132,2212
52800,81825,7973,39358,5251,73852,4344,2132,2212
52805,81829,7973,39359,5251,73856,4344,2132,2212
52810,81839,7975,39364,5252,73864,4344,2132,2212
52815,81845,7975,39367,5252,73869,4346,2133,2213
52820,81856,7978,39374,5255,73878,4346,2133,2213
52825,81860,7978,39376,5255,73882,4346,2133,2213
52830,81870,7980,39382,5256,73890,4346,2133,2213
52835,81876,7980,39384,5256,73896,4347,2133,2214
52840,81887,7981,39387,5256,73906,4347,2133,2214
52845,81891,7981,39387,5256,73910,4347,2133,2214
52850,81901,7983,39394,5257,73918,4347,2133,2214
52855,81907,7983,39396,5257,73924,4348,2134,2214
52860,81918,7985,39402,5258,73933,4348,2134,2214
52865,81922,7986,39405,5259,73936,4348,2134,2214
52870,81932,7988,39411,5260,73944,4348,2134,2214
52875,81938,7988,39413,5260,73950,4349,2135,2214
52880,81949,7988,39420,5260,73961,4350,2136,2214
52885,81953,7989,39423,5261,73964,4350,2136,2214
52890,81963,7991,39430,5262,73972,4350,2136,2214
52895,81969,7991,39432,5262,73978,4351,2136,2215
52900,81980,7991,39435,5262,73989,4352,2137,2215
52905,81984,7991,39436,5262,73993,4352,2137,2215
52910,81994,7993,39443,5263,74001,4352,2137,2215
52915,82000,7993,39444,5263,74007,4353,2137,2216
52920,82011,7993,39449,5263,74018,4354,2137,2217
52925,82015,7994,39451,5264,74021,4354,2137,2217
52930,82025,7996,39456,5265,74029,4354,2137,2217
52935,82031,7996,39460,5265,74035,4355,2137,2218
52940,82042,7996,39465,5265,74046,4356,2138,2218
52945,82046,7997,39467,5266,74049,4356,2138,2218
52950,82056,7999,39473,5268,74057,4356,2138,2218
52955,82062,7999,39478,5268,74063,4357,2139,2218
52960,82073,7999,39483,5268,74074,4358,2139,2219
52965,82077,7999,39486,5268,74078,4358,2139,2219
52970,82087,8001,39492,5269,74086,4358,2139,2219
52975,82093,8001,39498,5269,74091,4360,2141,2219
52980,82104,8003,39499,5270,74101,4361,2141,2220
52985,82108,8004,39503,5271,74104,4361,2141,2220
52990,82118,8005,39508,5272,74113,4361,2141,2220
52995,82124,8005,39513,5272,74119,4362,2142,2220
53000,82135,8006,39518,5272,74129,4362,2142,2220
53005,82139,8006,39519,5272,74133,4362,2142,2220
53010,82149,8007,39522,5272,74142,4362,2142,2220
53015,82155,8007,39528,5272,74148,4363,2143,2220
53020,82166,8009,39535,5274,74157,4363,2143,2220
53025,82170,8009,39536,5274,74161,4363,2143,2220
53030,82180,8010,39541,5275,74170,4363,2143,2220
53035,82186,8010,39543,5275,74176,4364,2143,2221
53040,82197,8011,39547,5275,74186,4364,2143,2221
53045,82201,8011,39550,5275,74190,4364,2143,2221
53050,82211,8012,39554,5275,74199,4364,2143,2221
53055,82217,8012,39557,5275,74205,4365,2144,2221
53060,82228,8014,39561,5276,74214,4365,2144,2221
53065,82232,8014,39563,5276,74218,4365,2144,2221
53070,82242,8015,39569,5277,74227,4365,2144,2221
53075,82248,8015,39570,5277,74233,4366,2145,2221
53080,82259,8016,39578,5278,74243,4366,2145,2221
53085,82263,8016,39580,5278,74247,4366,2145,2221
53090,82273,8018,39584,5280,74255,4366,2145,2221
53095,82279,8018,39587,5280,74260,4368,2146,2222
53100,82290,8023,39595,5284,74267,4369,2147,2222
53105,82294,8023,39597,5284,74271,4369,2147,2222
53110,82304,8024,39604,5285,74280,4369,2147,2222
53115,82310,8024,39609,5285,74286,4370,2148,2222
53120,82321,8025,39615,5286,74296,4370,2148,2222
53125,82325,8025,39618,5286,74300,4370,2148,2222
53130,82335,8026,39621,5286,74309,4370,2148,2222
53135,82341,8026,39625,5286,74315,4371,2149,2222
53140,82352,8026,39629,5286,74326,4371,2149,2222
53145,82356,8026,39631,5286,74330,4371,2149,2222
53150,82366,8027,39636,5287,74339,4371,2149,2222
53155,82372,8027,39639,5287,74345,4372,2149,2223
53160,82383,8028,39645,5288,74355,4372,2149,2223
53165,82387,8029,39646,5289,74358,4372,2149,2223
53170,82397,8031,39652,5291,74366,4372,2149,2223
53175,82403,8031,39653,5291,74372,4373,2149,2224
53180,82414,8032,39660,5292,74382,4374,2150,2224
53185,82418,8032,39661,5292,74386,4374,2150,2224
53190,82428,8034,39664,5293,74394,4374,2150,2224
53195,82434,8034,39665,5293,74400,4375,2150,2225
53200,82445,8036,39672,5294,74409,4376,2151,2225
53205,82449,8038,39675,5296,74411,4376,2151,2225
53210,82459,8040,39681,5298,74419,4376,2151,2225
53215,82465,8040,39686,5298,74425,4378,2153,2225
53220,82476,8042,39691,5299,74434,4379,2153,2226
53225,82480,8042,39693,5299,74438,4379,2153,2226
53230,82490,8043,39699,5300,74447,4379,2153,2226
53235,82496,8043,39700,5300,74453,4380,2153,2227
53240,82507,8043,39705,5300,74464,4380,2153,2227
53245,82511,8043,39707,5300,74468,4380,2153,2227
53250,82521,8044,39713,5301,74477,4380,2153,2227
53255,82527,8044,39715,5301,74483,4381,2153,2228
53260,82538,8044,39719,5301,74494,4381,2153,2228
53265,82542,8044,39719,5301,74498,4381,2153,2228
53270,82552,8045,39726,5302,74507,4381,2153,2228
53275,82558,8045,39729,5302,74513,4382,2153,2229
53280,82569,8047,39736,5304,74522,4382,2153,2229
53285,82573,8047,39738,5304,74526,4382,2153,2229
53290,82583,8048,39743,5305,74535,4382,2153,2229
53295,82589,8048,39747,5305,74541,4383,2154,2229
53300,82600,8050,39750,5307,74550,4383,2154,2229
53305,82604,8050,39753,5307,74554,4383,2154,2229
53310,82614,8051,39755,5307,74563,4383,2154,2229
53315,82620,8051,39759,5307,74569,4384,2155,2229
53320,82631,8054,39763,5309,74577,4384,2155,2229
53325,82635,8054,39765,5309,74581,4384,2155,2229
53330,82645,8056,39770,5310,74589,4384,2155,2229
53335,82651,8056,39773,5310,74595,4386,2156,2230
53340,82662,8058,39778,5312,74604,4387,2156,2231
53345,82666,8058,39782,5312,74608,4387,2156,2231
53350,82676,8060,39788,5314,74616,4387,2156,2231
53355,82682,8060,39790,5314,74622,4388,2156,2232
53360,82693,8061,39797,5315,74632,4388,2156,2232
53365,82697,8061,39797,5315,74636,4388,2156,2232
53370,82707,8063,39802,5316,74644,4388,2156,2232
53375,82713,8063,39805,5316,74650,4389,2156,2233
53380,82724,8063,39810,5316,74661,4389,2156,2233
53385,82728,8063,39812,5316,74665,4389,2156,2233
53390,82738,8065,39818,5317,74673,4389,2156,2233
53395,82744,8065,39820,5317,74679,4390,2156,2234
53400,82755,8066,39822,5318,74689,4390,2156,2234
53405,82759,8067,39825,5319,74692,4390,2156,2234
53410,82769,8069,39830,5319,74700,4390,2156,2234
53415,82775,8069,39833,5319,74705,4391,2157,2234
53420,82786,8072,39840,5321,74714,4391,2157,2234
53425,82790,8073,39843,5322,74717,4391,2157,2234
53430,82800,8075,39845,5323,74725,4391,2157,2234
53435,82806,8075,39849,5323,74731,4392,2158,2234
53440,82817,8076,39854,5323,74741,4392,2158,2234
53445,82821,8078,39858,5325,74743,4392,2158,2234
53450,82831,8080,39864,5327,74751,4392,2158,2234
53455,82837,8080,39867,5327,74757,4394,2159,2235
53460,82848,8082,39871,5329,74766,4395,2160,2235
53465,82852,8082,39873,5329,74770,4395,2160,2235
53470,82862,8083,39878,5330,74779,4395,2160,2235
53475,82868,8083,39883,5330,74785,4396,2161,2235
53480,82879,8083,39888,5330,74796,4397,2162,2235
53485,82883,8083,39891,5330,74800,4397,2162,2235
53490,82893,8084,39897,5330,74809,4397,2162,2235
53495,82899,8084,39900,5330,74815,4398,2162,2236
53500,82910,8084,39905,5330,74826,4399,2162,2237
53505,82914,8084,39905,5330,74830,4399,2162,2237
53510,82924,8085,39912,5331,74839,4399,2162,2237
53515,82930,8085,39914,5331,74845,4400,2163,2237
53520,82941,8086,39918,5332,74855,4401,2163,2238
53525,82945,8086,39921,5332,74859,4401,2163,2238
53530,82955,8087,39927,5333,74868,4401,2163,2238
53535,82961,8087,39931,5333,74874,4402,2163,2239
53540,82972,8087,39936,5333,74885,4402,2163,2239
53545,82976,8087,39937,5333,74889,4402,2163,2239
53550,82986,8088,39944,5334,74898,4402,2163,2239
53555,82992,8088,39945,5334,74904,4403,2163,2240
53560,83003,8088,39949,5334,74915,4403,2163,2240
53565,83007,8088,39953,5334,74919,4403,2163,2240
53570,83017,8090,39956,5335,74927,4403,2163,2240
53575,83023,8090,39958,5335,74933,4405,2164,2241
53580,83034,8092,39965,5336,74942,4405,2164,2241
53585,83038,8093,39968,5337,74945,4405,2164,2241
53590,83048,8094,39970,5337,74954,4405,2164,2241
53595,83054,8094,39974,5337,74960,4406,2165,2241
53600,83065,8097,39982,5339,74968,4406,2165,2241
53605,83069,8097,39984,5339,74972,4406,2165,2241
53610,83079,8098,39988,5340,74981,4406,2165,2241
53615,83085,8098,39992,5340,74987,4407,2165,2242
53620,83096,8100,39998,5341,74996,4407,2165,2242
53625,83100,8100,40000,5341,75000,4407,2165,2242
53630,83110,8101,40007,5342,75009,4407,2165,2242
53635,83116,8101,40010,5342,75015,4408,2165,2243
53640,83127,8104,40015,5344,75023,4408,2165,2243
53645,83131,8104,40016,5344,75027,4408,2165,2243
53650,83141,8105,40018,5344,75036,4408,2165,2243
53655,83147,8105,40019,5344,75042,4409,2165,2244
53660,83158,8106,40022,5344,75052,4410,2166,2244
53665,83162,8107,40024,5345,75055,4410,2166,2244
53670,83172,8108,40028,5345,75064,4410,2166,2244
53675,83178,8108,40032,5345,75070,4411,2166,2245
53680,83189,8110,40038,5347,75079,4412,2167,2245
53685,83193,8112,40041,5349,75081,4412,2167,2245
53690,83203,8114,40047,5350,75089,4412,2167,2245
53695,83209,8114,40050,5350,75095,4414,2168,2246
53700,83220,8116,40055,5351,75104,4415,2168,2247
53705,83224,8117,40058,5352,75107,4415,2168,2247
53710,83234,8119,40063,5353,75115,4415,2168,2247
53715,83240,8119,40065,5353,75121,4416,2168,2248
53720,83251,8120,40072,5354,75131,4417,2168,2249
53725,83255,8120,40073,5354,75135,4417,2168,2249
53730,83265,8122,40079,5355,75143,4417,2168,2249
53735,83271,8122,40082,5355,75149,4418,2169,2249
53740,83282,8123,40087,5356,75159,4419,2169,2250
53745,83286,8123,40088,5356,75163,4419,2169,2250
53750,83296,8125,40092,5356,75171,4419,2169,2250
53755,83302,8125,40097,5356,75176,4420,2169,2251
53760,83313,8128,40104,5359,75185,4421,2169,2252
53765,83317,8128,40107,5359,75189,4421,2169,2252
53770,83327,8129,40109,5360,75198,4421,2169,2252
53775,83333,8129,40112,5360,75204,4422,2170,2252
53780,83344,8129,40117,5360,75215,4423,2170,2253
53785,83348,8129,40119,5360,75219,4423,2170,2253
53790,83358,8130,40125,5361,75228,4423,2170,2253
53795,83364,8130,40129,5361,75234,4424,2171,2253
53800,83375,8130,40131,5361,75245,4425,2171,2254
53805,83379,8130,40134,5361,75249,4425,2171,2254
53810,83389,8131,40139,5362,75258,4425,2171,2254
53815,83395,8131,40142,5362,75264,4427,2172,2255
53820,83406,8133,40148,5364,75273,4428,2172,2256
53825,83410,8134,40151,5365,75276,4428,2172,2256
53830,83420,8135,40154,5365,75285,4428,2172,2256
53835,83426,8135,40157,5365,75291,4429,2173,2256
53840,83437,8136,40162,5366,75301,4429,2173,2256
53845,83441,8136,40165,5366,75305,4429,2173,2256
53850,83451,8137,40168,5367,75314,4429,2173,2256
53855,83457,8137,40171,5367,75320,4430,2174,2256
53860,83468,8138,40174,5368,75330,4430,2174,2256
53865,83472,8138,40176,5368,75334,4430,2174,2256
53870,83482,8140,40181,5369,75342,4430,2174,2256
53875,83488,8140,40184,5369,75348,4431,2175,2256
53880,83499,8142,40187,5370,75357,4432,2176,2256
53885,83503,8142,40188,5370,75361,4432,2176,2256
53890,83513,8144,40193,5371,75369,4432,2176,2256
53895,83519,8144,40196,5371,75374,4433,2176,2257
53900,83530,8147,40203,5373,75383,4434,2177,2257
53905,83534,8147,40204,5373,75387,4434,2177,2257
53910,83544,8149,40211,5374,75395,4434,2177,2257
53915,83550,8149,40213,5374,75400,4435,2177,2258
53920,83561,8152,40220,5377,75409,4436,2177,2259
53925,83565,8152,40223,5377,75413,4436,2177,2259
53930,83575,8154,40227,5379,75421,4436,2177,2259
53935,83581,8154,40228,5379,75427,4438,2177,2261
53940,83592,8156,40232,5381,75436,4439,2178,2261
53945,83596,8156,40234,5381,75440,4439,2178,2261
53950,83606,8158,40240,5382,75448,4439,2178,2261
53955,83612,8158,40243,5382,75454,4440,2179,2261
53960,83623,8160,40249,5384,75463,4440,2179,2261
53965,83627,8160,40252,5384,75467,4440,2179,2261
53970,83637,8162,40258,5385,75475,4440,2179,2261
53975,83643,8162,40260,5385,75481,4441,2180,2261
53980,83654,8164,40264,5387,75490,4441,2180,2261
53985,83658,8164,40266,5387,75494,4441,2180,2261
53990,83668,8166,40271,5388,75502,4441,2180,2261
53995,83674,8166,40275,5388,75508,4442,2181,2261
54000,83685,8169,40282,5390,75516,4442,2181,2261
54005,83689,8169,40283,5390,75520,4442,2181,2261
54010,83699,8171,40288,5391,75528,4442,2181,2261
54015,83705,8171,40292,5391,75534,4443,2182,2261
54020,83716,8171,40298,5391,75545,4443,2182,2261
54025,83720,8171,40301,5391,75549,4443,2182,2261
54030,83730,8173,40305,5391,75557,4443,2182,2261
54035,83736,8173,40309,5391,75563,4444,2182,2262
54040,83747,8173,40311,5391,75574,4444,2182,2262
54045,83751,8174,40314,5392,75577,4444,2182,2262
54050,83761,8176,40317,5392,75585,4444,2182,2262
54055,83767,8176,40319,5392,75591,4446,2182,2264
54060,83778,8176,40321,5392,75602,4447,2182,2265
54065,83782,8177,40325,5393,75605,4447,2182,2265
54070,83792,8179,40327,5393,75613,4447,2182,2265
54075,83798,8179,40329,5393,75619,4448,2183,2265
54080,83809,8179,40333,5393,75630,4449,2184,2265
54085,83813,8180,40334,5394,75633,4449,2184,2265
54090,83823,8182,40341,5396,75641,4449,2184,2265
54095,83829,8182,40343,5396,75647,4450,2184,2266
54100,83840,8182,40347,5396,75658,4451,2185,2266
54105,83844,8183,40349,5397,75661,4451,2185,2266
54110,83854,8185,40353,5398,75669,4451,2185,2266
54115,83860,8185,40354,5398,75675,4452,2186,2266
54120,83871,8187,40359,5399,75684,4453,2186,2267
54125,83875,8187,40362,5399,75688,4453,2186,2267
54130,83885,8187,40368,5399,75698,4453,2186,2267
54135,83891,8187,40373,5399,75704,4454,2187,2267
54140,83902,8188,40376,5400,75714,4455,2187,2268
54145,83906,8189,40377,5401,75717,4455,2187,2268
54150,83916,8189,40383,5401,75727,4455,2187,2268
54155,83922,8189,40386,5401,75733,4456,2188,2268
54160,83933,8190,40389,5401,75743,4457,2188,2269
54165,83937,8190,40391,5401,75747,4457,2188,2269
54170,83947,8190,40395,5401,75757,4457,2188,2269
54175,83953,8190,40400,5401,75763,4459,2190,2269
54180,83964,8192,40408,5403,75772,4460,2191,2269
54185,83968,8192,40410,5403,75776,4460,2191,2269
54190,83978,8192,40413,5403,75786,4460,2191,2269
54195,83984,8192,40416,5403,75792,4461,2192,2269
54200,83995,8193,40424,5404,75802,4461,2192,2269
54205,83999,8193,40426,5404,75806,4461,2192,2269
54210,84009,8193,40430,5404,75816,4461,2192,2269
54215,84015,8193,40433,5404,75822,4462,2192,2270
54220,84026,8194,40440,5405,75832,4462,2192,2270
54225,84030,8194,40441,5405,75836,4462,2192,2270
54230,84040,8196,40448,5406,75844,4462,2192,2270
54235,84046,8196,40449,5406,75850,4463,2192,2271
54240,84057,8198,40453,5407,75859,4463,2192,2271
54245,84061,8198,40453,5407,75863,4463,2192,2271
54250,84071,8200,40460,5408,75871,4463,2192,2271
54255,84077,8200,40463,5408,75877,4464,2192,2272
54260,84088,8203,40470,5411,75885,4464,2192,2272
54265,84092,8204,40473,5412,75888,4464,2192,2272
54270,84102,8206,40477,5413,75896,4464,2192,2272
54275,84108,8206,40478,5413,75902,4465,2192,2273
54280,84119,8207,40482,5413,75912,4465,2192,2273
54285,84123,8208,40484,5414,75915,4465,2192,2273
54290,84133,8210,40490,5416,75923,4465,2192,2273
54295,84139,8210,40493,5416,75928,4467,2193,2274
54300,84150,8212,40495,5417,75938,4468,2193,2275
54305,84154,8213,40498,5418,75941,4468,2193,2275
54310,84164,8214,40504,5418,75950,4468,2193,2275
54315,84170,8214,40509,5418,75956,4469,2194,2275
54320,84181,8214,40516,5418,75967,4470,2195,2275
54325,84185,8214,40518,5418,75971,4470,2195,2275
54330,84195,8215,40525,5418,75980,4470,2195,2275
54335,84201,8215,40527,5418,75986,4471,2195,2276
54340,84212,8215,40533,5418,75997,4472,2196,2276
54345,84216,8215,40537,5418,76001,4472,2196,2276
54350,84226,8216,40540,5419,76010,4472,2196,2276
54355,84232,8216,40542,5419,76016,4473,2196,2277
54360,84243,8216,40545,5419,76027,4474,2197,2277
54365,84247,8216,40547,5419,76031,4474,2197,2277
54370,84257,8217,40554,5419,76040,4474,2197,2277
54375,84263,8217,40558,5419,76046,4475,2197,2278
54380,84274,8219,40563,5420,76055,4476,2197,2279
54385,84278,8219,40564,5420,76059,4476,2197,2279
54390,84288,8220,40571,5420,76068,4476,2197,2279
54395,84294,8220,40575,5420,76074,4477,2197,2280
54400,84305,8222,40581,5422,76083,4478,2197,2281
54405,84309,8222,40583,5422,76087,4478,2197,2281
54410,84319,8224,40587,5424,76095,4478,2197,2281
54415,84325,8224,40591,5424,76100,4480,2198,2282
54420,84336,8226,40594,5426,76110,4481,2199,2282
54425,84340,8226,40596,5426,76114,4481,2199,2282
54430,84350,8228,40601,5427,76122,4481,2199,2282
54435,84356,8228,40604,5427,76127,4482,2199,2283
54440,84367,8230,40608,5428,76137,4482,2199,2283
54445,84371,8230,40609,5428,76141,4482,2199,2283
54450,84381,8232,40614,5429,76149,4482,2199,2283
54455,84387,8232,40616,5429,76155,4483,2199,2284
54460,84398,8233,40621,5429,76165,4483,2199,2284
54465,84402,8233,40621,5429,76169,4483,2199,2284
54470,84412,8235,40627,5431,76177,4483,2199,2284
54475,84418,8235,40631,5431,76182,4484,2200,2284
54480,84429,8238,40638,5434,76191,4484,2200,2284
54485,84433,8238,40640,5434,76195,4484,2200,2284
54490,84443,8239,40643,5435,76204,4484,2200,2284
54495,84449,8239,40646,5435,76209,4485,2201,2284
54500,84460,8241,40653,5436,76219,4485,2201,2284
54505,84464,8241,40657,5436,76223,4485,2201,2284
54510,84474,8242,40664,5437,76232,4485,2201,2284
54515,84480,8242,40667,5437,76237,4486,2202,2284
54520,84491,8244,40671,5438,76247,4486,2202,2284
54525,84495,8244,40672,5438,76251,4486,2202,2284
54530,84505,8245,40677,5438,76260,4486,2202,2284
54535,84511,8245,40678,5438,76266,4487,2202,2285
54540,84522,8246,40684,5438,76276,4487,2202,2285
54545,84526,8246,40684,5438,76280,4487,2202,2285
54550,84536,8248,40686,5438,76288,4487,2202,2285
54555,84542,8248,40690,5438,76294,4488,2203,2285
54560,84553,8250,40696,5440,76303,4489,2203,2286
54565,84557,8251,40698,5441,76306,4489,2203,2286
54570,84567,8253,40701,5442,76314,4489,2203,2286
54575,84573,8253,40706,5442,76320,4490,2204,2286
54580,84584,8254,40712,5443,76330,4491,2205,2286
54585,84588,8255,40713,5444,76333,4491,2205,2286
54590,84598,8257,40720,5445,76341,4491,2205,2286
54595,84604,8257,40722,5445,76347,4492,2205,2287
54600,84615,8260,40728,5447,76355,4493,2205,2288
54605,84619,8260,40731,5447,76359,4493,2205,2288
54610,84629,8260,40737,5447,76369,4493,2205,2288
54615,84635,8260,40739,5447,76375,4494,2206,2288
54620,84646,8260,40742,5447,76386,4494,2206,2288
54625,84650,8260,40743,5447,76390,4494,2206,2288
54630,84660,8260,40746,5447,76400,4494,2206,2288
54635,84666,8260,40749,5447,76406,4495,2207,2288
54640,84677,8260,40754,5447,76417,4495,2207,2288
54645,84681,8260,40757,5447,76421,4495,2207,2288
54650,84691,8260,40762,5447,76431,4495,2207,2288
54655,84697,8260,40767,5447,76437,4496,2208,2288
54660,84708,8260,40777,5447,76448,4496,2208,2288
54665,84712,8260,40778,5447,76452,4496,2208,2288
54670,84722,8260,40785,5447,76462,4496,2208,2288
54675,84728,8260,40787,5447,76468,4497,2208,2289
54680,84739,8260,40791,5447,76479,4497,2208,2289
54685,84743,8260,40794,5447,76483,4497,2208,2289
54690,84753,8260,40800,5447,76493,4497,2208,2289
54695,84759,8260,40803,5447,76499,4498,2208,2290
54700,84770,8260,40808,5447,76510,4498,2208,2290
54705,84774,8260,40811,5447,76514,4498,2208,2290
54710,84784,8262,40818,5449,76522,4498,2208,2290
54715,84790,8262,40820,5449,76527,4499,2208,2291
54720,84801,8267,40828,5453,76534,4500,2209,2291
54725,84805,8267,40829,5453,76538,4500,2209,2291
54730,84815,8269,40834,5455,76546,4500,2209,2291
54735,84821,8269,40836,5455,76551,4501,2209,2292
54740,84832,8272,40842,5458,76560,4501,2209,2292
54745,84836,8273,40844,5459,76563,4501,2209,2292
54750,84846,8275,40848,5460,76571,4501,2209,2292
54755,84852,8275,40850,5460,76577,4502,2209,2293
54760,84863,8276,40854,5460,76587,4503,2209,2294
54765,84867,8276,40855,5460,76591,4503,2209,2294
54770,84877,8278,40857,5460,76599,4503,2209,2294
54775,84883,8278,40859,5460,76605,4505,2210,2295
54780,84894,8280,40864,5461,76614,4506,2210,2296
54785,84898,8281,40866,5462,76617,4506,2210,2296
54790,84908,8283,40869,5462,76625,4506,2210,2296
54795,84914,8283,40872,5462,76631,4507,2211,2296
54800,84925,8284,40877,5462,76641,4507,2211,2296
54805,84929,8284,40878,5462,76645,4507,2211,2296
54810,84939,8286,40882,5462,76653,4507,2211,2296
54815,84945,8286,40885,5462,76659,4508,2211,2297
54820,84956,8287,40889,5462,76669,4508,2211,2297
54825,84960,8287,40890,5462,76673,4508,2211,2297
54830,84970,8289,40894,5462,76681,4508,2211,2297
54835,84976,8289,40896,5462,76687,4509,2211,2298
54840,84987,8290,40902,5462,76697,4510,2212,2298
54845,84991,8290,40903,5462,76701,4510,2212,2298
54850,85001,8292,40906,5462,76709,4510,2212,2298
54855,85007,8292,40910,5462,76715,4511,2213,2298
54860,85018,8292,40915,5462,76726,4512,2213,2299
54865,85022,8292,40918,5462,76730,4512,2213,2299
54870,85032,8294,40923,5463,76738,4512,2213,2299
54875,85038,8294,40925,5463,76744,4513,2213,2300
54880,85049,8294,40931,5463,76755,4514,2214,2300
54885,85053,8295,40933,5464,76758,4514,2214,2300
54890,85063,8297,40937,5464,76766,4514,2214,2300
54895,85069,8297,40941,5464,76772,4516,2214,2302
54900,85080,8299,40950,5466,76781,4517,2215,2302
54905,85084,8300,40953,5467,76784,4517,2215,2302
54910,85094,8302,40958,5468,76792,4517,2215,2302
54915,85100,8302,40960,5468,76798,4518,2216,2302
54920,85111,8302,40964,5468,76809,4519,2217,2302
54925,85115,8302,40966,5468,76813,4519,2217,2302
54930,85125,8304,40968,5470,76821,4519,2217,2302
54935,85131,8304,40971,5470,76827,4520,2218,2302
54940,85142,8304,40977,5470,76838,4521,2219,2302
54945,85146,8304,40979,5470,76842,4521,2219,2302
54950,85156,8306,40982,5470,76850,4521,2219,2302
54955,85162,8306,40984,5470,76855,4522,2220,2302
54960,85173,8310,40991,5474,76863,4523,2221,2302
54965,85177,8310,40994,5474,76867,4523,2221,2302
54970,85187,8310,40999,5474,76877,4523,2221,2302
54975,85193,8310,41002,5474,76883,4524,2221,2303
54980,85204,8312,41008,5475,76892,4524,2221,2303
54985,85208,8312,41009,5475,76896,4524,2221,2303
54990,85218,8312,41015,5475,76906,4524,2221,2303
54995,85224,8312,41019,5475,76912,4525,2222,2303
55000,85235,8314,41027,5476,76921,4525,2222,2303
55005,85239,8314,41029,5476,76925,4525,2222,2303
55010,85249,8314,41035,5476,76935,4525,2222,2303
55015,85255,8314,41037,5476,76941,4527,2222,2305
55020,85266,8316,41043,5478,76950,4527,2222,2305
55025,85270,8317,41045,5479,76953,4527,2222,2305
55030,85280,8317,41047,5479,76963,4527,2222,2305
55035,85286,8317,41049,5479,76969,4528,2222,2306
55040,85297,8318,41056,5480,76979,4528,2222,2306
55045,85301,8318,41057,5480,76983,4528,2222,2306
55050,85311,8318,41063,5480,76993,4528,2222,2306
55055,85317,8318,41066,5480,76999,4529,2222,2307
55060,85328,8319,41075,5481,77009,4529,2222,2307
55065,85332,8320,41077,5482,77012,4529,2222,2307
55070,85342,8322,41083,5483,77020,4529,2222,2307
55075,85348,8322,41087,5483,77026,4530,2223,2307
55080,85359,8324,41094,5484,77035,4531,2224,2307
55085,85363,8324,41097,5484,77039,4531,2224,2307
55090,85373,8326,41101,5484,77047,4531,2224,2307
55095,85379,8326,41106,5484,77053,4532,2224,2308
55100,85390,8326,41111,5484,77064,4533,2225,2308
55105,85394,8326,41112,5484,77068,4533,2225,2308
55110,85404,8328,41119,5485,77076,4533,2225,2308
55115,85410,8328,41119,5485,77082,4534,2225,2309
55120,85421,8328,41124,5485,77093,4535,2226,2309
55125,85425,8329,41125,5486,77096,4535,2226,2309
55130,85435,8331,41128,5487,77104,4535,2226,2309
55135,85441,8331,41131,5487,77110,4536,2227,2309
55140,85452,8331,41135,5487,77121,4537,2228,2309
55145,85456,8331,41138,5487,77125,4537,2228,2309
55150,85466,8333,41142,5488,77133,4537,2228,2309
55155,85472,8333,41144,5488,77139,4538,2229,2309
55160,85483,8334,41149,5489,77149,4539,2229,2310
55165,85487,8334,41152,5489,77153,4539,2229,2310
55170,85497,8336,41155,5490,77161,4539,2229,2310
55175,85503,8336,41159,5490,77167,4540,2229,2311
55180,85514,8336,41162,5490,77178,4541,2229,2312
55185,85518,8336,41164,5490,77182,4541,2229,2312
55190,85528,8338,41167,5490,77190,4541,2229,2312
55195,85534,8338,41169,5490,77196,4542,2230,2312
55200,85545,8341,41173,5492,77204,4543,2230,2313
55205,85549,8342,41174,5493,77207,4543,2230,2313
55210,85559,8343,41178,5494,77216,4543,2230,2313
55215,85565,8343,41181,5494,77222,4544,2231,2313
55220,85576,8344,41182,5494,77232,4544,2231,2313
55225,85580,8345,41185,5495,77235,4544,2231,2313
55230,85590,8346,41189,5495,77244,4544,2231,2313
55235,85596,8346,41192,5495,77249,4545,2231,2314
55240,85607,8349,41195,5498,77258,4545,2231,2314
55245,85611,8349,41196,5498,77262,4545,2231,2314
55250,85621,8350,41199,5499,77271,4545,2231,2314
55255,85627,8350,41202,5499,77276,4546,2232,2314
55260,85638,8354,41207,5502,77284,4546,2232,2314
55265,85642,8354,41209,5502,77288,4546,2232,2314
55270,85652,8354,41213,5502,77298,4546,2232,2314
55275,85658,8354,41217,5502,77304,4547,2232,2315
55280,85669,8356,41223,5503,77313,4547,2232,2315
55285,85673,8357,41226,5504,77316,4547,2232,2315
55290,85683,8357,41231,5504,77326,4547,2232,2315
55295,85689,8357,41235,5504,77332,4548,2233,2315
55300,85700,8358,41240,5505,77342,4548,2233,2315
55305,85704,8358,41242,5505,77346,4548,2233,2315
55310,85714,8359,41247,5505,77355,4548,2233,2315
55315,85720,8359,41248,5505,77361,4549,2233,2316
55320,85731,8362,41253,5507,77369,4549,2233,2316
55325,85735,8363,41254,5508,77372,4549,2233,2316
55330,85745,8364,41262,5509,77381,4549,2233,2316
55335,85751,8364,41265,5509,77387,4550,2234,2316
55340,85762,8364,41268,5509,77398,4551,2235,2316
55345,85766,8364,41268,5509,77402,4551,2235,2316
55350,85776,8365,41275,5509,77411,4551,2235,2316
55355,85782,8365,41279,5509,77417,4552,2235,2317
55360,85793,8366,41284,5510,77427,4553,2235,2318
55365,85797,8367,41285,5511,77430,4553,2235,2318
55370,85807,8369,41289,5512,77438,4553,2235,2318
55375,85813,8369,41293,5512,77444,4554,2236,2318
55380,85824,8370,41297,5513,77454,4555,2236,2319
55385,85828,8370,41299,5513,77458,4555,2236,2319
55390,85838,8371,41302,5513,77467,4555,2236,2319
55395,85844,8371,41304,5513,77473,4556,2236,2320
55400,85855,8371,41309,5513,77484,4556,2236,2320
55405,85859,8371,41311,5513,77488,4556,2236,2320
55410,85869,8372,41314,5513,77497,4556,2236,2320
55415,85875,8372,41317,5513,77503,4557,2236,2321
55420,85886,8372,41321,5513,77514,4557,2236,2321
55425,85890,8372,41325,5513,77518,4557,2236,2321
55430,85900,8373,41327,5514,77527,4557,2236,2321
55435,85906,8373,41330,5514,77533,4558,2236,2322
55440,85917,8376,41333,5516,77541,4558,2236,2322
55445,85921,8376,41335,5516,77545,4558,2236,2322
55450,85931,8378,41339,5518,77553,4558,2236,2322
55455,85937,8378,41342,5518,77559,4559,2236,2323
55460,85948,8381,41350,5521,77567,4559,2236,2323
55465,85952,8381,41350,5521,77571,4559,2236,2323
55470,85962,8383,41354,5522,77579,4559,2236,2323
55475,85968,8383,41357,5522,77584,4560,2236,2324
55480,85979,8385,41360,5523,77594,4560,2236,2324
55485,85983,8386,41362,5524,77597,4560,2236,2324
55490,85993,8388,41366,5525,77605,4560,2236,2324
55495,85999,8388,41370,5525,77610,4561,2236,2325
55500,86010,8392,41377,5529,77618,4561,2236,2325
55505,86014,8392,41379,5529,77622,4561,2236,2325
55510,86024,8393,41383,5529,77631,4561,2236,2325
55515,86030,8393,41388,5529,77636,4562,2237,2325
55520,86041,8395,41392,5530,77646,4563,2237,2326
55525,86045,8395,41395,5530,77650,4563,2237,2326
55530,86055,8396,41400,5530,77659,4563,2237,2326
55535,86061,8396,41405,5530,77665,4564,2238,2326
55540,86072,8397,41412,5530,77675,4565,2239,2326
55545,86076,8397,41415,5530,77679,4565,2239,2326
55550,86086,8398,41419,5531,77688,4565,2239,2326
55555,86092,8398,41422,5531,77694,4566,2239,2327
55560,86103,8400,41429,5532,77703,4567,2240,2327
55565,86107,8400,41431,5532,77707,4567,2240,2327
55570,86117,8401,41435,5532,77716,4567,2240,2327
55575,86123,8401,41439,5532,77721,4568,2240,2328
55580,86134,8404,41443,5534,77730,4569,2240,2329
55585,86138,8404,41444,5534,77734,4569,2240,2329
55590,86148,8405,41448,5534,77743,4569,2240,2329
55595,86154,8405,41450,5534,77749,4570,2241,2329
55600,86165,8406,41452,5534,77759,4571,2242,2329
55605,86169,8406,41453,5534,77763,4571,2242,2329
55610,86179,8408,41457,5534,77771,4571,2242,2329
55615,86185,8408,41460,5534,77777,4572,2242,2330
55620,86196,8410,41466,5536,77786,4573,2242,2331
55625,86200,8410,41467,5536,77790,4573,2242,2331
55630,86210,8412,41470,5538,77798,4573,2242,2331
55635,86216,8412,41475,5538,77804,4574,2243,2331
55640,86227,8413,41484,5539,77814,4575,2243,2332
55645,86231,8414,41488,5540,77817,4575,2243,2332
55650,86241,8416,41493,5541,77825,4575,2243,2332
55655,86247,8416,41495,5541,77831,4576,2243,2333
55660,86258,8416,41501,5541,77842,4577,2243,2334
55665,86262,8416,41503,5541,77846,4577,2243,2334
55670,86272,8418,41507,5542,77854,4577,2243,2334
55675,86278,8418,41510,5542,77860,4578,2243,2335
55680,86289,8419,41514,5543,77870,4579,2244,2335
55685,86293,8419,41518,5543,77874,4579,2244,2335
55690,86303,8421,41523,5543,77882,4579,2244,2335
55695,86309,8421,41527,5543,77888,4580,2244,2336
55700,86320,8421,41532,5543,77899,4580,2244,2336
55705,86324,8421,41534,5543,77903,4580,2244,2336
55710,86334,8423,41537,5543,77911,4580,2244,2336
55715,86340,8423,41543,5543,77917,4581,2245,2336
55720,86351,8423,41548,5543,77928,4581,2245,2336
55725,86355,8423,41548,5543,77932,4581,2245,2336
55730,86365,8425,41555,5545,77940,4581,2245,2336
55735,86371,8425,41558,5545,77946,4582,2246,2336
55740,86382,8426,41562,5546,77956,4583,2246,2337
55745,86386,8426,41563,5546,77960,4583,2246,2337
55750,86396,8428,41569,5548,77968,4583,2246,2337
55755,86402,8428,41572,5548,77974,4584,2247,2337
55760,86413,8429,41577,5548,77984,4585,2248,2337
55765,86417,8429,41580,5548,77988,4585,2248,2337
55770,86427,8431,41585,5550,77996,4585,2248,2337
55775,86433,8431,41589,5550,78002,4586,2249,2337
55780,86444,8433,41595,5551,78011,4587,2250,2337
55785,86448,8433,41596,5551,78015,4587,2250,2337
55790,86458,8435,41599,5552,78023,4587,2250,2337
55795,86464,8435,41600,5552,78029,4588,2250,2338
55800,86475,8436,41604,5552,78039,4589,2251,2338
55805,86479,8436,41606,5552,78043,4589,2251,2338
55810,86489,8438,41607,5552,78051,4589,2251,2338
55815,86495,8438,41609,5552,78057,4590,2252,2338
55820,86506,8438,41613,5552,78068,4590,2252,2338
55825,86510,8438,41614,5552,78072,4590,2252,2338
55830,86520,8440,41621,5554,78080,4590,2252,2338
55835,86526,8440,41622,5554,78086,4591,2252,2339
55840,86537,8440,41627,5554,78097,4591,2252,2339
55845,86541,8440,41630,5554,78101,4591,2252,2339
55850,86551,8442,41633,5556,78109,4591,2252,2339
55855,86557,8442,41637,5556,78114,4592,2253,2339
55860,86568,8443,41643,5557,78125,4592,2253,2339
55865,86572,8444,41646,5558,78128,4592,2253,2339
55870,86582,8445,41649,5558,78137,4592,2253,2339
55875,86588,8445,41651,5558,78143,4593,2253,2340
55880,86599,8448,41655,5560,78151,4593,2253,2340
55885,86603,8448,41657,5560,78155,4593,2253,2340
55890,86613,8449,41663,5560,78164,4593,2253,2340
55895,86619,8449,41667,5560,78169,4594,2254,2340
55900,86630,8452,41675,5563,78178,4594,2254,2340
55905,86634,8453,41678,5564,78181,4594,2254,2340
55910,86644,8454,41683,5564,78190,4594,2254,2340
55915,86650,8454,41687,5564,78196,4596,2255,2341
55920,86661,8455,41689,5564,78206,4597,2255,2342
55925,86665,8455,41692,5564,78210,4597,2255,2342
55930,86675,8455,41695,5564,78220,4597,2255,2342
55935,86681,8455,41698,5564,78226,4598,2256,2342
55940,86692,8455,41702,5564,78237,4599,2257,2342
55945,86696,8455,41704,5564,78241,4599,2257,2342
55950,86706,8455,41709,5564,78251,4599,2257,2342
55955,86712,8455,41712,5564,78257,4600,2257,2343
55960,86723,8455,41720,5564,78268,4601,2257,2344
55965,86727,8455,41720,5564,78272,4601,2257,2344
55970,86737,8456,41723,5564,78281,4601,2257,2344
55975,86743,8456,41726,5564,78286,4602,2258,2344
55980,86754,8457,41733,5565,78297,4603,2259,2344
55985,86758,8457,41735,5565,78301,4603,2259,2344
55990,86768,8458,41740,5566,78310,4603,2259,2344
55995,86774,8458,41744,5566,78316,4604,2259,2345
56000,86785,8458,41751,5566,78327,4604,2259,2345
56005,86789,8458,41753,5566,78331,4604,2259,2345
56010,86799,8459,41758,5566,78340,4604,2259,2345
56015,86805,8459,41759,5566,78346,4605,2259,2346
56020,86816,8459,41762,5566,78357,4605,2259,2346
56025,86820,8459,41764,5566,78361,4605,2259,2346
56030,86830,8461,41770,5566,78369,4605,2259,2346
56035,86836,8461,41774,5566,78375,4606,2260,2346
56040,86847,8464,41780,5568,78383,4606,2260,2346
56045,86851,8464,41782,5568,78387,4606,2260,2346
56050,86861,8466,41785,5569,78395,4606,2260,2346
56055,86867,8466,41789,5569,78400,4607,2260,2347
56060,86878,8469,41793,5571,78409,4608,2260,2348
56065,86882,8470,41796,5572,78412,4608,2260,2348
56070,86892,8472,41799,5573,78420,4608,2260,2348
56075,86898,8472,41801,5573,78426,4609,2261,2348
56080,86909,8474,41807,5575,78435,4610,2262,2348
56085,86913,8475,41809,5576,78438,4610,2262,2348
56090,86923,8477,41813,5576,78446,4610,2262,2348
56095,86929,8477,41816,5576,78452,4611,2263,2348
56100,86940,8479,41825,5577,78461,4612,2264,2348
56105,86944,8479,41826,5577,78465,4612,2264,2348
56110,86954,8481,41832,5578,78473,4612,2264,2348
56115,86960,8481,41835,5578,78479,4613,2265,2348
56120,86971,8481,41837,5578,78490,4614,2265,2349
56125,86975,8482,41840,5579,78493,4614,2265,2349
56130,86985,8484,41844,5579,78501,4614,2265,2349
56135,86991,8484,41845,5579,78507,4615,2265,2350
56140,87002,8484,41852,5579,78518,4616,2266,2350
56145,87006,8485,41854,5580,78521,4616,2266,2350
56150,87016,8487,41859,5581,78529,4616,2266,2350
56155,87022,8487,41863,5581,78535,4617,2267,2350
56160,87033,8488,41870,5582,78545,4618,2268,2350
56165,87037,8488,41873,5582,78549,4618,2268,2350
56170,87047,8490,41876,5584,78557,4618,2268,2350
56175,87053,8490,41879,5584,78563,4619,2269,2350
56180,87064,8490,41884,5584,78574,4619,2269,2350
56185,87068,8490,41885,5584,78578,4619,2269,2350
56190,87078,8492,41890,5585,78586,4619,2269,2350
56195,87084,8492,41893,5585,78592,4620,2269,2351
56200,87095,8493,41896,5586,78602,4620,2269,2351
56205,87099,8493,41900,5586,78606,4620,2269,2351
56210,87109,8495,41905,5587,78614,4620,2269,2351
56215,87115,8495,41909,5587,78620,4621,2270,2351
56220,87126,8497,41914,5588,78629,4622,2271,2351
56225,87130,8498,41918,5589,78632,4622,2271,2351
56230,87140,8500,41923,5591,78640,4622,2271,2351
56235,87146,8500,41927,5591,78645,4624,2272,2352
56240,87157,8501,41930,5592,78656,4624,2272,2352
56245,87161,8501,41934,5592,78660,4624,2272,2352
56250,87171,8503,41938,5593,78668,4624,2272,2352
56255,87177,8503,41940,5593,78673,4625,2272,2353
56260,87188,8504,41947,5594,78684,4625,2272,2353
56265,87192,8504,41950,5594,78688,4625,2272,2353
56270,87202,8506,41954,5594,78696,4625,2272,2353
56275,87208,8506,41956,5594,78702,4626,2272,2354
56280,87219,8506,41960,5594,78713,4627,2273,2354
56285,87223,8507,41962,5595,78716,4627,2273,2354
56290,87233,8509,41967,5596,78724,4627,2273,2354
56295,87239,8509,41970,5596,78730,4628,2274,2354
56300,87250,8510,41977,5597,78740,4629,2275,2354
56305,87254,8511,41979,5598,78743,4629,2275,2354
56310,87264,8513,41985,5599,78751,4629,2275,2354
56315,87270,8513,41987,5599,78757,4630,2275,2355
56320,87281,8514,41993,5600,78767,4631,2276,2355
56325,87285,8515,41995,5601,78770,4631,2276,2355
56330,87295,8517,42004,5602,78778,4631,2276,2355
56335,87301,8517,42005,5602,78784,4632,2276,2356
56340,87312,8519,42010,5603,78793,4633,2276,2357
56345,87316,8519,42011,5603,78797,4633,2276,2357
56350,87326,8520,42017,5604,78806,4633,2276,2357
56355,87332,8520,42021,5604,78812,4634,2277,2357
56360,87343,8521,42028,5605,78822,4634,2277,2357
56365,87347,8522,42032,5606,78825,4634,2277,2357
56370,87357,8523,42034,5606,78834,4634,2277,2357
56375,87363,8523,42036,5606,78840,4635,2277,2358
56380,87374,8525,42045,5607,78849,4635,2277,2358
56385,87378,8525,42045,5607,78853,4635,2277,2358
56390,87388,8526,42051,5607,78862,4635,2277,2358
56395,87394,8526,42053,5607,78868,4637,2278,2359
56400,87405,8527,42057,5608,78878,4637,2278,2359
56405,87409,8527,42058,5608,78882,4637,2278,2359
56410,87419,8528,42065,5609,78891,4637,2278,2359
56415,87425,8528,42069,5609,78897,4639,2279,2360
56420,87436,8529,42076,5610,78907,4639,2279,2360
56425,87440,8529,42077,5610,78911,4639,2279,2360
56430,87450,8530,42081,5611,78920,4639,2279,2360
56435,87456,8530,42083,5611,78926,4640,2280,2360
56440,87467,8532,42089,5613,78935,4640,2280,2360
56445,87471,8532,42091,5613,78939,4640,2280,2360
56450,87481,8534,42095,5615,78947,4640,2280,2360
56455,87487,8534,42099,5615,78952,4641,2281,2360
56460,87498,8538,42105,5618,78960,4642,2281,2361
56465,87502,8539,42108,5619,78963,4642,2281,2361
56470,87512,8540,42112,5620,78972,4642,2281,2361
56475,87518,8540,42114,5620,78977,4643,2281,2362
56480,87529,8542,42119,5621,78987,4643,2281,2362
56485,87533,8542,42122,5621,78991,4643,2281,2362
56490,87543,8543,42130,5622,79000,4643,2281,2362
56495,87549,8543,42135,5622,79006,4644,2282,2362
56500,87560,8544,42140,5623,79016,4644,2282,2362
56505,87564,8545,42142,5624,79019,4644,2282,2362
56510,87574,8546,42147,5625,79028,4644,2282,2362
56515,87580,8546,42152,5625,79034,4645,2283,2362
56520,87591,8547,42157,5625,79044,4645,2283,2362
56525,87595,8547,42157,5625,79048,4645,2283,2362
56530,87605,8548,42162,5625,79057,4645,2283,2362
56535,87611,8548,42166,5625,79063,4646,2284,2362
56540,87622,8550,42170,5626,79072,4646,2284,2362
56545,87626,8550,42172,5626,79076,4646,2284,2362
56550,87636,8551,42179,5626,79085,4646,2284,2362
56555,87642,8551,42180,5626,79091,4647,2284,2363
56560,87653,8552,42183,5627,79101,4647,2284,2363
56565,87657,8552,42184,5627,79105,4647,2284,2363
56570,87667,8554,42191,5629,79113,4647,2284,2363
56575,87673,8554,42195,5629,79119,4648,2285,2363
56580,87684,8557,42201,5632,79127,4649,2286,2363
56585,87688,8558,42203,5633,79130,4649,2286,2363
56590,87698,8559,42208,5634,79139,4649,2286,2363
56595,87704,8559,42209,5634,79145,4650,2286,2364
56600,87715,8559,42214,5634,79156,4650,2286,2364
56605,87719,8559,42217,5634,79160,4650,2286,2364
56610,87729,8560,42221,5634,79169,4650,2286,2364
56615,87735,8560,42225,5634,79175,4651,2287,2364
56620,87746,8560,42229,5634,79186,4651,2287,2364
56625,87750,8560,42231,5634,79190,4651,2287,2364
56630,87760,8561,42238,5635,79199,4651,2287,2364
56635,87766,8561,42242,5635,79205,4652,2287,2365
56640,87777,8561,42250,5635,79216,4652,2287,2365
56645,87781,8561,42251,5635,79220,4652,2287,2365
56650,87791,8562,42257,5636,79229,4652,2287,2365
56655,87797,8562,42261,5636,79235,4653,2287,2366
56660,87808,8562,42267,5636,79246,4653,2287,2366
56665,87812,8563,42271,5637,79249,4653,2287,2366
56670,87822,8564,42277,5638,79258,4653,2287,2366
56675,87828,8564,42279,5638,79264,4654,2287,2367
56680,87839,8564,42287,5638,79275,4654,2287,2367
56685,87843,8564,42289,5638,79279,4654,2287,2367
56690,87853,8566,42294,5639,79287,4654,2287,2367
56695,87859,8566,42297,5639,79292,4655,2288,2367
56700,87870,8571,42301,5643,79299,4656,2288,2368
56705,87874,8571,42304,5643,79303,4656,2288,2368
56710,87884,8571,42309,5643,79313,4656,2288,2368
56715,87890,8571,42312,5643,79319,4657,2288,2369
56720,87901,8573,42317,5644,79328,4658,2289,2369
56725,87905,8573,42318,5644,79332,4658,2289,2369
56730,87915,8573,42322,5644,79342,4658,2289,2369
56735,87921,8573,42323,5644,79348,4659,2289,2370
56740,87932,8575,42328,5645,79357,4660,2290,2370
56745,87936,8575,42329,5645,79361,4660,2290,2370
56750,87946,8575,42335,5645,79371,4660,2290,2370
56755,87952,8575,42336,5645,79377,4661,2291,2370
56760,87963,8577,42341,5646,79386,4662,2291,2371
56765,87967,8577,42344,5646,79390,4662,2291,2371
56770,87977,8577,42350,5646,79400,4662,2291,2371
56775,87983,8577,42355,5646,79406,4663,2291,2372
56780,87994,8578,42361,5646,79416,4663,2291,2372
56785,87998,8578,42363,5646,79420,4663,2291,2372
56790,88008,8578,42369,5646,79430,4663,2291,2372
56795,88014,8578,42369,5646,79436,4664,2291,2373
56800,88025,8579,42373,5646,79446,4664,2291,2373
56805,88029,8579,42374,5646,79450,4664,2291,2373
56810,88039,8581,42380,5646,79458,4664,2291,2373
56815,88045,8581,42382,5646,79464,4665,2291,2374
56820,88056,8584,42388,5648,79472,4665,2291,2374
56825,88060,8584,42390,5648,79476,4665,2291,2374
56830,88070,8586,42395,5649,79484,4665,2291,2374
56835,88076,8586,42397,5649,79490,4666,2291,2375
56840,88087,8586,42401,5649,79501,4666,2291,2375
56845,88091,8586,42402,5649,79505,4666,2291,2375
56850,88101,8588,42407,5650,79513,4666,2291,2375
56855,88107,8588,42409,5650,79519,4667,2292,2375
56860,88118,8588,42416,5650,79530,4667,2292,2375
56865,88122,8589,42420,5651,79533,4667,2292,2375
56870,88132,8591,42425,5653,79541,4667,2292,2375
56875,88138,8591,42425,5653,79547,4668,2292,2376
56880,88149,8591,42426,5653,79558,4669,2292,2377
56885,88153,8591,42427,5653,79562,4669,2292,2377
56890,88163,8593,42431,5653,79570,4669,2292,2377
56895,88169,8593,42436,5653,79576,4670,2293,2377
56900,88180,8594,42442,5654,79586,4671,2294,2377
56905,88184,8594,42444,5654,79590,4671,2294,2377
56910,88194,8596,42448,5654,79598,4671,2294,2377
56915,88200,8596,42450,5654,79604,4672,2294,2378
56920,88211,8597,42456,5655,79614,4673,2294,2379
56925,88215,8597,42457,5655,79618,4673,2294,2379
56930,88225,8599,42461,5656,79626,4673,2294,2379
56935,88231,8599,42463,5656,79631,4674,2294,2380
56940,88242,8602,42467,5658,79640,4675,2294,2381
56945,88246,8602,42470,5658,79644,4675,2294,2381
56950,88256,8603,42476,5658,79653,4675,2294,2381
56955,88262,8603,42478,5658,79659,4676,2294,2382
56960,88273,8604,42483,5658,79669,4676,2294,2382
56965,88277,8604,42484,5658,79673,4676,2294,2382
56970,88287,8605,42485,5658,79682,4676,2294,2382
56975,88293,8605,42490,5658,79688,4677,2295,2382
56980,88304,8607,42496,5659,79697,4677,2295,2382
56985,88308,8607,42496,5659,79701,4677,2295,2382
56990,88318,8608,42505,5660,79710,4677,2295,2382
56995,88324,8608,42507,5660,79716,4678,2296,2382
57000,88335,8609,42513,5661,79726,4678,2296,2382
57005,88339,8609,42516,5661,79730,4678,2296,2382
57010,88349,8610,42521,5661,79739,4678,2296,2382
57015,88355,8610,42523,5661,79745,4679,2296,2383
57020,88366,8611,42531,5662,79755,4679,2296,2383
57025,88370,8612,42533,5663,79758,4679,2296,2383
57030,88380,8613,42540,5664,79767,4679,2296,2383
57035,88386,8613,42545,5664,79773,4680,2297,2383
57040,88397,8614,42548,5664,79783,4680,2297,2383
57045,88401,8614,42549,5664,79787,4680,2297,2383
57050,88411,8616,42553,5666,79795,4680,2297,2383
57055,88417,8616,42554,5666,79801,4681,2297,2384
57060,88428,8618,42560,5668,79810,4682,2297,2385
57065,88432,8618,42562,5668,79814,4682,2297,2385
57070,88442,8619,42565,5668,79823,4682,2297,2385
57075,88448,8619,42567,5668,79829,4683,2297,2386
57080,88459,8619,42571,5668,79840,4683,2297,2386
57085,88463,8619,42574,5668,79844,4683,2297,2386
57090,88473,8620,42578,5668,79853,4683,2297,2386
57095,88479,8620,42583,5668,79859,4684,2298,2386
57100,88490,8620,42588,5668,79870,4684,2298,2386
57105,88494,8620,42590,5668,79874,4684,2298,2386
57110,88504,8621,42595,5669,79883,4684,2298,2386
57115,88510,8621,42598,5669,79889,4685,2298,2387
57120,88521,8621,42603,5669,79900,4685,2298,2387
57125,88525,8621,42606,5669,79904,4685,2298,2387
57130,88535,8622,42612,5670,79913,4685,2298,2387
57135,88541,8622,42616,5670,79919,4686,2298,2388
57140,88552,8622,42620,5670,79930,4686,2298,2388
57145,88556,8622,42622,5670,79934,4686,2298,2388
57150,88566,8623,42626,5671,79943,4686,2298,2388
57155,88572,8623,42629,5671,79949,4687,2299,2388
57160,88583,8623,42635,5671,79960,4687,2299,2388
57165,88587,8623,42637,5671,79964,4687,2299,2388
57170,88597,8625,42641,5672,79972,4687,2299,2388
57175,88603,8625,42643,5672,79977,4689,2300,2389
57180,88614,8627,42649,5674,79987,4690,2300,2390
57185,88618,8627,42650,5674,79991,4690,2300,2390
57190,88628,8628,42656,5675,80000,4690,2300,2390
57195,88634,8628,42660,5675,80006,4691,2301,2390
57200,88645,8629,42665,5675,80016,4691,2301,2390
57205,88649,8629,42666,5675,80020,4691,2301,2390
57210,88659,8630,42670,5675,80029,4691,2301,2390
57215,88665,8630,42673,5675,80035,4692,2302,2390
57220,88676,8631,42677,5675,80045,4692,2302,2390
57225,88680,8631,42678,5675,80049,4692,2302,2390
57230,88690,8632,42682,5675,80058,4692,2302,2390
57235,88696,8632,42683,5675,80064,4693,2303,2390
57240,88707,8634,42690,5676,80073,4693,2303,2390
57245,88711,8634,42692,5676,80077,4693,2303,2390
57250,88721,8635,42697,5676,80086,4693,2303,2390
57255,88727,8635,42702,5676,80092,4694,2303,2391
57260,88738,8637,42708,5677,80101,4694,2303,2391
57265,88742,8637,42709,5677,80105,4694,2303,2391
57270,88752,8638,42716,5678,80114,4694,2303,2391
57275,88758,8638,42719,5678,80120,4695,2303,2392
57280,88769,8639,42725,5679,80130,4695,2303,2392
57285,88773,8639,42727,5679,80134,4695,2303,2392
57290,88783,8641,42730,5679,80142,4695,2303,2392
57295,88789,8641,42731,5679,80148,4697,2303,2394
57300,88800,8645,42735,5682,80155,4697,2303,2394
57305,88804,8645,42735,5682,80159,4697,2303,2394
57310,88814,8647,42741,5682,80167,4697,2303,2394
57315,88820,8647,42744,5682,80173,4698,2304,2394
57320,88831,8649,42752,5684,80182,4698,2304,2394
57325,88835,8650,42755,5685,80185,4698,2304,2394
57330,88845,8652,42759,5686,80193,4698,2304,2394
57335,88851,8652,42760,5686,80199,4699,2305,2394
57340,88862,8654,42762,5687,80208,4699,2305,2394
57345,88866,8655,42765,5688,80211,4699,2305,2394
57350,88876,8657,42771,5689,80219,4699,2305,2394
57355,88882,8657,42774,5689,80225,4700,2305,2395
57360,88893,8658,42780,5690,80235,4701,2305,2396
57365,88897,8658,42780,5690,80239,4701,2305,2396
57370,88907,8659,42786,5690,80248,4701,2305,2396
57375,88913,8659,42789,5690,80254,4702,2306,2396
57380,88924,8660,42794,5690,80264,4702,2306,2396
57385,88928,8660,42796,5690,80268,4702,2306,2396
57390,88938,8661,42800,5690,80277,4702,2306,2396
57395,88944,8661,42803,5690,80282,4703,2307,2396
57400,88955,8663,42808,5691,80292,4703,2307,2396
57405,88959,8663,42809,5691,80296,4703,2307,2396
57410,88969,8664,42814,5692,80305,4703,2307,2396
57415,88975,8664,42818,5692,80311,4705,2309,2396
57420,88986,8666,42820,5693,80320,4705,2309,2396
57425,88990,8666,42822,5693,80324,4705,2309,2396
57430,89000,8668,42827,5694,80332,4705,2309,2396
57435,89006,8668,42829,5694,80338,4706,2310,2396
57440,89017,8669,42834,5695,80348,4706,2310,2396
57445,89021,8669,42836,5695,80352,4706,2310,2396
57450,89031,8671,42840,5696,80360,4706,2310,2396
57455,89037,8671,42842,5696,80366,4707,2310,2397
57460,89048,8672,42851,5697,80376,4707,2310,2397
57465,89052,8672,42853,5697,80380,4707,2310,2397
57470,89062,8674,42859,5699,80388,4707,2310,2397
57475,89068,8674,42862,5699,80394,4708,2311,2397
57480,89079,8674,42866,5699,80405,4708,2311,2397
57485,89083,8674,42866,5699,80409,4708,2311,2397
57490,89093,8676,42870,5701,80417,4708,2311,2397
57495,89099,8676,42873,5701,80423,4709,2311,2398
57500,89110,8676,42878,5701,80434,4709,2311,2398
57505,89114,8676,42879,5701,80438,4709,2311,2398
57510,89124,8678,42885,5703,80446,4709,2311,2398
57515,89130,8678,42887,5703,80452,4710,2311,2399
57520,89141,8678,42892,5703,80463,4710,2311,2399
57525,89145,8678,42894,5703,80467,4710,2311,2399
57530,89155,8680,42900,5705,80475,4710,2311,2399
57535,89161,8680,42903,5705,80480,4712,2311,2401
57540,89172,8683,42906,5707,80489,4713,2312,2401
57545,89176,8685,42910,5709,80491,4713,2312,2401
57550,89186,8686,42915,5710,80500,4713,2312,2401
57555,89192,8686,42919,5710,80506,4714,2313,2401
57560,89203,8687,42925,5711,80516,4715,2314,2401
57565,89207,8688,42928,5712,80519,4715,2314,2401
57570,89217,8689,42931,5712,80528,4715,2314,2401
57575,89223,8689,42936,5712,80534,4716,2314,2402
57580,89234,8691,42942,5714,80543,4717,2314,2403
57585,89238,8692,42945,5715,80546,4717,2314,2403
57590,89248,8693,42949,5716,80555,4717,2314,2403
57595,89254,8693,42954,5716,80561,4718,2315,2403
57600,89265,8695,42959,5718,80570,4719,2316,2403
57605,89269,8695,42961,5718,80574,4719,2316,2403
57610,89279,8695,42964,5718,80584,4719,2316,2403
57615,89285,8695,42967,5718,80590,4720,2316,2404
57620,89296,8695,42972,5718,80601,4720,2316,2404
57625,89300,8695,42974,5718,80605,4720,2316,2404
57630,89310,8695,42977,5718,80615,4720,2316,2404
57635,89316,8695,42980,5718,80621,4721,2316,2405
57640,89327,8695,42984,5718,80632,4721,2316,2405
57645,89331,8695,42985,5718,80636,4721,2316,2405
57650,89341,8696,42989,5718,80645,4721,2316,2405
57655,89347,8696,42992,5718,80650,4723,2317,2406
57660,89358,8698,42995,5720,80660,4723,2317,2406
57665,89362,8699,42997,5721,80663,4723,2317,2406
57670,89372,8700,43000,5721,80672,4723,2317,2406
57675,89378,8700,43004,5721,80678,4724,2318,2406
57680,89389,8703,43009,5723,80686,4725,2318,2407
57685,89393,8703,43010,5723,80690,4725,2318,2407
57690,89403,8704,43016,5723,80699,4725,2318,2407
57695,89409,8704,43018,5723,80705,4726,2318,2408
57700,89420,8706,43023,5724,80714,4727,2319,2408
57705,89424,8706,43024,5724,80718,4727,2319,2408
57710,89434,8708,43029,5725,80726,4727,2319,2408
57715,89440,8708,43031,5725,80732,4728,2320,2408
57720,89451,8709,43035,5726,80742,4729,2320,2409
57725,89455,8709,43038,5726,80746,4729,2320,2409
57730,89465,8711,43041,5726,80754,4729,2320,2409
57735,89471,8711,43045,5726,80760,4730,2320,2410
57740,89482,8712,43050,5727,80770,4730,2320,2410
57745,89486,8712,43052,5727,80774,4730,2320,2410
57750,89496,8714,43057,5729,80782,4730,2320,2410
57755,89502,8714,43062,5729,80788,4731,2321,2410
57760,89513,8716,43071,5731,80797,4731,2321,2410
57765,89517,8716,43074,5731,80801,4731,2321,2410
57770,89527,8718,43079,5732,80809,4731,2321,2410
57775,89533,8718,43082,5732,80814,4733,2321,2412
57780,89544,8722,43090,5736,80822,4733,2321,2412
57785,89548,8722,43094,5736,80826,4733,2321,2412
57790,89558,8723,43100,5737,80835,4733,2321,2412
57795,89564,8723,43102,5737,80841,4734,2321,2413
57800,89575,8723,43108,5737,80852,4734,2321,2413
57805,89579,8723,43110,5737,80856,4734,2321,2413
57810,89589,8724,43115,5737,80865,4734,2321,2413
57815,89595,8724,43119,5737,80871,4735,2322,2413
57820,89606,8724,43126,5737,80882,4735,2322,2413
57825,89610,8724,43129,5737,80886,4735,2322,2413
57830,89620,8725,43135,5737,80895,4735,2322,2413
57835,89626,8725,43138,5737,80901,4736,2323,2413
57840,89637,8726,43142,5738,80911,4736,2323,2413
57845,89641,8726,43144,5738,80915,4736,2323,2413
57850,89651,8727,43148,5738,80924,4736,2323,2413
57855,89657,8727,43152,5738,80930,4737,2323,2414
57860,89668,8728,43158,5738,80940,4738,2324,2414
57865,89672,8728,43160,5738,80944,4738,2324,2414
57870,89682,8729,43165,5738,80953,4738,2324,2414
57875,89688,8729,43167,5738,80959,4739,2324,2415
57880,89699,8731,43172,5739,80968,4740,2324,2416
57885,89703,8732,43174,5740,80971,4740,2324,2416
57890,89713,8734,43176,5740,80979,4740,2324,2416
57895,89719,8734,43180,5740,80985,4742,2325,2417
57900,89730,8737,43186,5742,80993,4743,2326,2417
57905,89734,8737,43187,5742,80997,4743,2326,2417
57910,89744,8738,43193,5743,81006,4743,2326,2417
57915,89750,8738,43194,5743,81012,4744,2326,2418
57920,89761,8739,43201,5743,81022,4745,2327,2418
57925,89765,8739,43203,5743,81026,4745,2327,2418
57930,89775,8740,43209,5744,81035,4745,2327,2418
57935,89781,8740,43211,5744,81041,4746,2328,2418
57940,89792,8741,43221,5745,81051,4746,2328,2418
57945,89796,8741,43223,5745,81055,4746,2328,2418
57950,89806,8742,43228,5745,81064,4746,2328,2418
57955,89812,8742,43232,5745,81069,4747,2329,2418
57960,89823,8744,43237,5747,81079,4747,2329,2418
57965,89827,8744,43238,5747,81083,4747,2329,2418
57970,89837,8745,43243,5747,81092,4747,2329,2418
57975,89843,8745,43243,5747,81098,4748,2329,2419
57980,89854,8746,43247,5747,81108,4748,2329,2419
57985,89858,8746,43250,5747,81112,4748,2329,2419
57990,89868,8747,43257,5748,81121,4748,2329,2419
57995,89874,8747,43259,5748,81126,4749,2329,2420
58000,89885,8749,43266,5749,81136,4749,2329,2420
58005,89889,8749,43266,5749,81140,4749,2329,2420
58010,89899,8751,43268,5750,81148,4749,2329,2420
58015,89905,8751,43273,5750,81153,4751,2331,2420
58020,89916,8755,43279,5753,81161,4751,2331,2420
58025,89920,8756,43281,5754,81164,4751,2331,2420
58030,89930,8758,43286,5756,81172,4751,2331,2420
58035,89936,8758,43290,5756,81178,4752,2332,2420
58040,89947,8761,43298,5759,81186,4753,2333,2420
58045,89951,8761,43299,5759,81190,4753,2333,2420
58050,89961,8763,43303,5760,81198,4753,2333,2420
58055,89967,8763,43307,5760,81204,4754,2334,2420
58060,89978,8765,43310,5761,81213,4755,2335,2420
58065,89982,8766,43312,5762,81216,4755,2335,2420
58070,89992,8768,43314,5763,81224,4755,2335,2420
58075,89998,8768,43316,5763,81230,4756,2335,2421
58080,90009,8771,43325,5766,81238,4757,2336,2421
58085,90013,8771,43326,5766,81242,4757,2336,2421
58090,90023,8772,43333,5767,81251,4757,2336,2421
58095,90029,8772,43337,5767,81257,4758,2337,2421
58100,90040,8773,43340,5767,81267,4759,2337,2422
58105,90044,8773,43342,5767,81271,4759,2337,2422
58110,90054,8774,43346,5768,81280,4759,2337,2422
58115,90060,8774,43348,5768,81286,4760,2337,2423
58120,90071,8775,43353,5769,81296,4761,2338,2423
58125,90075,8776,43355,5770,81299,4761,2338,2423
58130,90085,8777,43360,5771,81308,4761,2338,2423
58135,90091,8777,43364,5771,81313,4763,2340,2423
58140,90102,8780,43370,5774,81322,4764,2340,2424
58145,90106,8780,43372,5774,81326,4764,2340,2424
58150,90116,8780,43379,5774,81336,4764,2340,2424
58155,90122,8780,43382,5774,81342,4765,2341,2424
58160,90133,8780,43387,5774,81353,4765,2341,2424
58165,90137,8780,43389,5774,81357,4765,2341,2424
58170,90147,8780,43396,5774,81367,4765,2341,2424
58175,90153,8780,43401,5774,81373,4766,2342,2424
58180,90164,8780,43406,5774,81384,4766,2342,2424
58185,90168,8780,43407,5774,81388,4766,2342,2424
58190,90178,8780,43409,5774,81398,4766,2342,2424
58195,90184,8780,43412,5774,81404,4767,2343,2424
58200,90195,8780,43417,5774,81415,4767,2343,2424
58205,90199,8780,43419,5774,81419,4767,2343,2424
58210,90209,8780,43422,5774,81429,4767,2343,2424
58215,90215,8780,43423,5774,81435,4768,2344,2424
58220,90226,8780,43427,5774,81446,4768,2344,2424
58225,90230,8780,43429,5774,81450,4768,2344,2424
58230,90240,8780,43432,5774,81460,4768,2344,2424
58235,90246,8780,43433,5774,81466,4769,2344,2425
58240,90257,8780,43435,5774,81477,4769,2344,2425
58245,90261,8780,43437,5774,81481,4769,2344,2425
58250,90271,8782,43440,5774,81489,4769,2344,2425
58255,90277,8782,43445,5774,81495,4771,2346,2425
58260,90288,8785,43450,5776,81503,4771,2346,2425
58265,90292,8785,43451,5776,81507,4771,2346,2425
58270,90302,8787,43457,5777,81515,4771,2346,2425
58275,90308,8787,43460,5777,81521,4772,2347,2425
58280,90319,8787,43464,5777,81532,4773,2347,2426
58285,90323,8787,43467,5777,81536,4773,2347,2426
58290,90333,8789,43473,5778,81544,4773,2347,2426
58295,90339,8789,43475,5778,81550,4774,2347,2427
58300,90350,8789,43482,5778,81561,4775,2347,2428
58305,90354,8789,43482,5778,81565,4775,2347,2428
58310,90364,8791,43485,5778,81573,4775,2347,2428
58315,90370,8791,43487,5778,81579,4776,2347,2429
58320,90381,8791,43490,5778,81590,4777,2347,2430
58325,90385,8791,43490,5778,81594,4777,2347,2430
58330,90395,8793,43496,5779,81602,4777,2347,2430
58335,90401,8793,43498,5779,81608,4778,2348,2430
58340,90412,8793,43502,5779,81619,4779,2348,2431
58345,90416,8794,43505,5780,81622,4779,2348,2431
58350,90426,8796,43512,5782,81630,4779,2348,2431
58355,90432,8796,43516,5782,81636,4780,2349,2431
58360,90443,8796,43521,5782,81647,4781,2350,2431
58365,90447,8796,43524,5782,81651,4781,2350,2431
58370,90457,8798,43530,5784,81659,4781,2350,2431
58375,90463,8798,43531,5784,81665,4783,2350,2433
58380,90474,8801,43538,5787,81673,4784,2350,2434
58385,90478,8801,43540,5787,81677,4784,2350,2434
58390,90488,8802,43545,5787,81686,4784,2350,2434
58395,90494,8802,43549,5787,81692,4785,2351,2434
58400,90505,8803,43555,5788,81702,4785,2351,2434
58405,90509,8803,43558,5788,81706,4785,2351,2434
58410,90519,8804,43563,5788,81715,4785,2351,2434
58415,90525,8804,43566,5788,81721,4786,2351,2435
58420,90536,8805,43571,5789,81731,4786,2351,2435
58425,90540,8805,43574,5789,81735,4786,2351,2435
58430,90550,8806,43581,5789,81744,4786,2351,2435
58435,90556,8806,43583,5789,81750,4787,2351,2436
58440,90567,8807,43587,5790,81760,4787,2351,2436
58445,90571,8807,43588,5790,81764,4787,2351,2436
58450,90581,8808,43594,5791,81773,4787,2351,2436
58455,90587,8808,43596,5791,81779,4788,2352,2436
58460,90598,8808,43600,5791,81790,4788,2352,2436
58465,90602,8808,43601,5791,81794,4788,2352,2436
58470,90612,8809,43604,5792,81803,4788,2352,2436
58475,90618,8809,43606,5792,81809,4789,2352,2437
58480,90629,8809,43612,5792,81820,4789,2352,2437
58485,90633,8809,43613,5792,81824,4789,2352,2437
58490,90643,8811,43617,5793,81832,4789,2352,2437
58495,90649,8811,43620,5793,81838,4791,2353,2438
58500,90660,8813,43627,5795,81847,4792,2353,2439
58505,90664,8813,43629,5795,81851,4792,2353,2439
58510,90674,8815,43637,5797,81859,4792,2353,2439
58515,90680,8815,43639,5797,81865,4793,2354,2439
58520,90691,8816,43643,5798,81875,4794,2354,2440
58525,90695,8817,43645,5799,81878,4794,2354,2440
58530,90705,8819,43649,5800,81886,4794,2354,2440
58535,90711,8819,43652,5800,81892,4795,2355,2440
58540,90722,8821,43659,5802,81901,4796,2355,2441
58545,90726,8822,43661,5803,81904,4796,2355,2441
58550,90736,8824,43666,5805,81912,4796,2355,2441
58555,90742,8824,43670,5805,81918,4797,2356,2441
58560,90753,8826,43673,5806,81927,4798,2356,2442
58565,90757,8826,43674,5806,81931,4798,2356,2442
58570,90767,8828,43678,5806,81939,4798,2356,2442
58575,90773,8828,43681,5806,81945,4799,2356,2443
58580,90784,8830,43686,5808,81954,4800,2357,2443
58585,90788,8831,43688,5809,81957,4800,2357,2443
58590,90798,8833,43692,5810,81965,4800,2357,2443
58595,90804,8833,43695,5810,81971,4801,2358,2443
58600,90815,8834,43700,5811,81981,4802,2358,2444
58605,90819,8835,43702,5812,81984,4802,2358,2444
58610,90829,8837,43707,5812,81992,4802,2358,2444
58615,90835,8837,43711,5812,81998,4804,2358,2446
58620,90846,8840,43716,5815,82006,4805,2358,2447
58625,90850,8840,43717,5815,82010,4805,2358,2447
58630,90860,8841,43718,5815,82019,4805,2358,2447
58635,90866,8841,43721,5815,82025,4806,2359,2447
58640,90877,8842,43725,5815,82035,4807,2360,2447
58645,90881,8842,43726,5815,82039,4807,2360,2447
58650,90891,8843,43731,5816,82048,4807,2360,2447
58655,90897,8843,43733,5816,82053,4808,2360,2448
58660,90908,8845,43740,5818,82063,4809,2361,2448
58665,90912,8846,43743,5819,82066,4809,2361,2448
58670,90922,8847,43744,5819,82075,4809,2361,2448
58675,90928,8847,43746,5819,82081,4810,2362,2448
58680,90939,8848,43755,5820,82091,4811,2363,2448
58685,90943,8848,43756,5820,82095,4811,2363,2448
58690,90953,8849,43761,5820,82104,4811,2363,2448
58695,90959,8849,43764,5820,82110,4812,2364,2448
58700,90970,8850,43770,5821,82120,4812,2364,2448
58705,90974,8851,43772,5822,82123,4812,2364,2448
58710,90984,8852,43775,5822,82132,4812,2364,2448
58715,90990,8852,43776,5822,82138,4813,2365,2448
58720,91001,8853,43783,5823,82148,4813,2365,2448
58725,91005,8853,43784,5823,82152,4813,2365,2448
58730,91015,8855,43788,5824,82160,4813,2365,2448
58735,91021,8855,43791,5824,82166,4815,2366,2449
58740,91032,8856,43795,5824,82176,4815,2366,2449
58745,91036,8857,43798,5825,82179,4815,2366,2449
58750,91046,8859,43804,5827,82187,4815,2366,2449
58755,91052,8859,43806,5827,82193,4816,2367,2449
58760,91063,8862,43813,5829,82201,4816,2367,2449
58765,91067,8862,43815,5829,82205,4816,2367,2449
58770,91077,8864,43820,5830,82213,4816,2367,2449
58775,91083,8864,43825,5830,82219,4817,2368,2449
58780,91094,8866,43831,5831,82228,4817,2368,2449
58785,91098,8866,43832,5831,82232,4817,2368,2449
58790,91108,8868,43837,5832,82240,4817,2368,2449
58795,91114,8868,43838,5832,82246,4818,2368,2450
58800,91125,8869,43844,5832,82256,4819,2369,2450
58805,91129,8869,43847,5832,82260,4819,2369,2450
58810,91139,8871,43851,5833,82268,4819,2369,2450
58815,91145,8871,43856,5833,82274,4820,2370,2450
58820,91156,8872,43862,5834,82284,4821,2371,2450
58825,91160,8872,43864,5834,82288,4821,2371,2450
58830,91170,8874,43866,5834,82296,4821,2371,2450
58835,91176,8874,43869,5834,82302,4822,2372,2450
58840,91187,8875,43873,5835,82312,4823,2373,2450
58845,91191,8876,43877,5836,82315,4823,2373,2450
58850,91201,8878,43880,5837,82323,4823,2373,2450
58855,91207,8878,43885,5837,82328,4825,2375,2450
58860,91218,8882,43892,5840,82336,4826,2376,2450
58865,91222,8882,43893,5840,82340,4826,2376,2450
58870,91232,8882,43896,5840,82350,4826,2376,2450
58875,91238,8882,43901,5840,82356,4827,2376,2451
58880,91249,8882,43907,5840,82367,4827,2376,2451
58885,91253,8882,43910,5840,82371,4827,2376,2451
58890,91263,8882,43917,5840,82381,4827,2376,2451
58895,91269,8882,43923,5840,82387,4828,2377,2451
58900,91280,8882,43931,5840,82398,4828,2377,2451
58905,91284,8882,43933,5840,82402,4828,2377,2451
58910,91294,8882,43939,5840,82412,4828,2377,2451
58915,91300,8882,43942,5840,82418,4829,2377,2452
58920,91311,8882,43946,5840,82429,4829,2377,2452
58925,91315,8882,43948,5840,82433,4829,2377,2452
58930,91325,8882,43955,5840,82443,4829,2377,2452
58935,91331,8882,43958,5840,82449,4830,2378,2452
58940,91342,8882,43965,5840,82460,4830,2378,2452
58945,91346,8882,43967,5840,82464,4830,2378,2452
58950,91356,8882,43970,5840,82474,4830,2378,2452
58955,91362,8882,43974,5840,82480,4831,2378,2453
58960,91373,8882,43979,5840,82491,4831,2378,2453
58965,91377,8882,43980,5840,82495,4831,2378,2453
58970,91387,8884,43986,5842,82503,4831,2378,2453
58975,91393,8884,43989,5842,82509,4833,2378,2455
58980,91404,8886,43995,5844,82518,4834,2378,2456
58985,91408,8886,43995,5844,82522,4834,2378,2456
58990,91418,8888,44001,5845,82530,4834,2378,2456
58995,91424,8888,44003,5845,82535,4835,2378,2457
59000,91435,8890,44007,5846,82545,4836,2378,2458
59005,91439,8890,44009,5846,82549,4836,2378,2458
59010,91449,8892,44012,5847,82557,4836,2378,2458
59015,91455,8892,44014,5847,82563,4837,2378,2459
59020,91466,8894,44019,5849,82572,4838,2379,2459
59025,91470,8895,44022,5850,82575,4838,2379,2459
59030,91480,8897,44030,5852,82583,4838,2379,2459
59035,91486,8897,44035,5852,82588,4839,2379,2460
59040,91497,8900,44041,5855,82597,4840,2380,2460
59045,91501,8901,44042,5856,82600,4840,2380,2460
59050,91511,8902,44047,5857,82609,4840,2380,2460
59055,91517,8902,44049,5857,82615,4841,2381,2460
59060,91528,8903,44054,5858,82625,4842,2381,2461
59065,91532,8904,44056,5859,82628,4842,2381,2461
59070,91542,8905,44061,5859,82637,4842,2381,2461
59075,91548,8905,44065,5859,82643,4843,2382,2461
59080,91559,8907,44072,5861,82652,4844,2383,2461
59085,91563,8907,44074,5861,82656,4844,2383,2461
59090,91573,8908,44078,5861,82665,4844,2383,2461
59095,91579,8908,44080,5861,82671,4846,2384,2462
59100,91590,8910,44084,5862,82680,4847,2384,2463
59105,91594,8910,44085,5862,82684,4847,2384,2463
59110,91604,8910,44091,5862,82694,4847,2384,2463
59115,91610,8910,44094,5862,82700,4849,2385,2464
59120,91621,8910,44100,5862,82711,4849,2385,2464
59125,91625,8910,44101,5862,82715,4849,2385,2464
59130,91635,8910,44105,5862,82725,4849,2385,2464
59135,91641,8910,44109,5862,82731,4850,2386,2464
59140,91652,8910,44114,5862,82742,4850,2386,2464
59145,91656,8910,44116,5862,82746,4850,2386,2464
59150,91666,8910,44120,5862,82756,4850,2386,2464
59155,91672,8910,44124,5862,82762,4851,2387,2464
59160,91683,8910,44128,5862,82773,4851,2387,2464
59165,91687,8910,44129,5862,82777,4851,2387,2464
59170,91697,8910,44136,5862,82787,4851,2387,2464
59175,91703,8910,44140,5862,82793,4852,2388,2464
59180,91714,8910,44141,5862,82804,4853,2388,2465
59185,91718,8910,44142,5862,82808,4853,2388,2465
59190,91728,8910,44144,5862,82818,4853,2388,2465
59195,91734,8910,44146,5862,82824,4854,2388,2466
59200,91745,8910,44154,5862,82835,4855,2389,2466
59205,91749,8910,44157,5862,82839,4855,2389,2466
59210,91759,8911,44162,5862,82848,4855,2389,2466
59215,91765,8911,44165,5862,82853,4856,2390,2466
59220,91776,8914,44172,5865,82862,4856,2390,2466
59225,91780,8914,44174,5865,82866,4856,2390,2466
59230,91790,8916,44178,5866,82874,4856,2390,2466
59235,91796,8916,44182,5866,82879,4857,2390,2467
59240,91807,8920,44188,5870,82887,4857,2390,2467
59245,91811,8922,44190,5872,82889,4857,2390,2467
59250,91821,8924,44197,5873,82897,4857,2390,2467
59255,91827,8924,44202,5873,82903,4858,2391,2467
59260,91838,8926,44205,5874,82912,4858,2391,2467
59265,91842,8928,44208,5876,82914,4858,2391,2467
59270,91852,8930,44211,5877,82922,4858,2391,2467
59275,91858,8930,44212,5877,82928,4859,2392,2467
59280,91869,8931,44215,5877,82938,4859,2392,2467
59285,91873,8932,44217,5878,82941,4859,2392,2467
59290,91883,8934,44222,5879,82949,4859,2392,2467
59295,91889,8934,44225,5879,82955,4860,2393,2467
59300,91900,8935,44229,5879,82965,4860,2393,2467
59305,91904,8937,44233,5881,82967,4860,2393,2467
59310,91914,8939,44239,5883,82975,4860,2393,2467
59315,91920,8939,44245,5883,82981,4861,2394,2467
59320,91931,8940,44247,5883,82991,4862,2394,2468
59325,91935,8942,44250,5885,82993,4862,2394,2468
59330,91945,8944,44255,5886,83001,4862,2394,2468
59335,91951,8944,44257,5886,83007,4863,2395,2468
59340,91962,8945,44262,5886,83017,4864,2396,2468
59345,91966,8945,44263,5886,83021,4864,2396,2468
59350,91976,8946,44268,5886,83030,4864,2396,2468
59355,91982,8946,44271,5886,83036,4866,2397,2469
59360,91993,8946,44275,5886,83047,4867,2397,2470
59365,91997,8946,44275,5886,83051,4867,2397,2470
59370,92007,8947,44280,5886,83060,4867,2397,2470
59375,92013,8947,44284,5886,83066,4868,2397,2471
59380,92024,8947,44288,5886,83077,4868,2397,2471
59385,92028,8947,44289,5886,83081,4868,2397,2471
59390,92038,8948,44295,5887,83090,4868,2397,2471
59395,92044,8948,44300,5887,83096,4869,2398,2471
59400,92055,8948,44304,5887,83107,4869,2398,2471
59405,92059,8949,44305,5888,83110,4869,2398,2471
59410,92069,8951,44309,5888,83118,4869,2398,2471
59415,92075,8951,44310,5888,83123,4870,2398,2472
59420,92086,8953,44315,5890,83133,4871,2399,2472
59425,92090,8954,44317,5891,83136,4871,2399,2472
59430,92100,8956,44321,5892,83144,4871,2399,2472
59435,92106,8956,44321,5892,83150,4872,2399,2473
59440,92117,8958,44327,5894,83159,4873,2399,2474
59445,92121,8959,44329,5895,83162,4873,2399,2474
59450,92131,8961,44333,5895,83170,4873,2399,2474
59455,92137,8961,44336,5895,83176,4874,2400,2474
59460,92148,8962,44340,5896,83186,4875,2400,2475
59465,92152,8962,44340,5896,83190,4875,2400,2475
59470,92162,8963,44343,5897,83199,4875,2400,2475
59475,92168,8963,44346,5897,83205,4877,2401,2476
59480,92179,8963,44352,5897,83216,4878,2402,2476
59485,92183,8963,44356,5897,83220,4878,2402,2476
59490,92193,8964,44361,5897,83229,4878,2402,2476
59495,92199,8964,44363,5897,83235,4879,2403,2476
59500,92210,8964,44369,5897,83246,4880,2404,2476
59505,92214,8964,44371,5897,83250,4880,2404,2476
59510,92224,8965,44374,5897,83259,4880,2404,2476
59515,92230,8965,44375,5897,83264,4881,2404,2477
59520,92241,8967,44380,5899,83274,4882,2404,2478
59525,92245,8967,44380,5899,83278,4882,2404,2478
59530,92255,8967,44384,5899,83288,4882,2404,2478
59535,92261,8967,44384,5899,83294,4883,2404,2479
59540,92272,8969,44390,5901,83303,4884,2405,2479
59545,92276,8969,44393,5901,83307,4884,2405,2479
59550,92286,8969,44396,5901,83317,4884,2405,2479
59555,92292,8969,44398,5901,83323,4885,2406,2479
59560,92303,8972,44405,5903,83331,4886,2407,2479
59565,92307,8972,44409,5903,83335,4886,2407,2479
59570,92317,8973,44416,5903,83344,4886,2407,2479
59575,92323,8973,44418,5903,83350,4887,2407,2480
59580,92334,8975,44423,5904,83359,4888,2407,2481
59585,92338,8976,44425,5905,83362,4888,2407,2481
59590,92348,8977,44429,5905,83371,4888,2407,2481
59595,92354,8977,44432,5905,83376,4890,2408,2482
59600,92365,8979,44436,5906,83386,4890,2408,2482
59605,92369,8980,44439,5907,83389,4890,2408,2482
59610,92379,8981,44444,5907,83398,4890,2408,2482
59615,92385,8981,44446,5907,83404,4892,2408,2484
59620,92396,8982,44452,5907,83414,4892,2408,2484
59625,92400,8983,44453,5908,83417,4892,2408,2484
59630,92410,8985,44459,5910,83425,4892,2408,2484
59635,92416,8985,44462,5910,83431,4893,2409,2484
59640,92427,8986,44465,5910,83441,4893,2409,2484
59645,92431,8987,44466,5911,83444,4893,2409,2484
59650,92441,8989,44470,5911,83452,4893,2409,2484
59655,92447,8989,44473,5911,83457,4894,2410,2484
59660,92458,8991,44477,5912,83467,4894,2410,2484
59665,92462,8991,44478,5912,83471,4894,2410,2484
59670,92472,8993,44481,5913,83479,4894,2410,2484
59675,92478,8993,44483,5913,83485,4895,2410,2485
59680,92489,8994,44488,5913,83495,4895,2410,2485
59685,92493,8996,44491,5915,83497,4895,2410,2485
59690,92503,8998,44496,5915,83505,4895,2410,2485
59695,92509,8998,44500,5915,83510,4896,2411,2485
59700,92520,9002,44507,5918,83518,4897,2412,2485
59705,92524,9003,44510,5919,83521,4897,2412,2485
59710,92534,9005,44514,5920,83529,4897,2412,2485
59715,92540,9005,44514,5920,83535,4898,2412,2486
59720,92551,9008,44520,5923,83543,4899,2412,2487
59725,92555,9008,44522,5923,83547,4899,2412,2487
59730,92565,9010,44528,5923,83555,4899,2412,2487
59735,92571,9010,44532,5923,83561,4900,2413,2487
59740,92582,9013,44538,5926,83569,4901,2414,2487
59745,92586,9013,44538,5926,83573,4901,2414,2487
59750,92596,9015,44543,5927,83581,4901,2414,2487
59755,92602,9015,44545,5927,83587,4902,2414,2488
59760,92613,9017,44550,5929,83596,4903,2415,2488
59765,92617,9017,44552,5929,83600,4903,2415,2488
59770,92627,9018,44558,5930,83609,4903,2415,2488
59775,92633,9018,44559,5930,83615,4904,2415,2489
59780,92644,9018,44561,5930,83626,4905,2416,2489
59785,92648,9018,44561,5930,83630,4905,2416,2489
59790,92658,9019,44564,5930,83639,4905,2416,2489
59795,92664,9019,44566,5930,83645,4906,2417,2489
59800,92675,9021,44574,5932,83654,4907,2418,2489
59805,92679,9021,44575,5932,83658,4907,2418,2489
59810,92689,9022,44580,5933,83667,4907,2418,2489
59815,92695,9022,44583,5933,83673,4908,2418,2490
59820,92706,9024,44587,5934,83682,4909,2419,2490
59825,92710,9024,44588,5934,83686,4909,2419,2490
59830,92720,9026,44592,5936,83694,4909,2419,2490
59835,92726,9026,44593,5936,83700,4910,2419,2491
59840,92737,9028,44597,5937,83709,4910,2419,2491
59845,92741,9028,44599,5937,83713,4910,2419,2491
59850,92751,9030,44604,5938,83721,4910,2419,2491
59855,92757,9030,44606,5938,83726,4911,2419,2492
59860,92768,9033,44611,5941,83735,4911,2419,2492
59865,92772,9033,44612,5941,83739,4911,2419,2492
59870,92782,9035,44617,5942,83747,4911,2419,2492
59875,92788,9035,44621,5942,83752,4912,2420,2492
59880,92799,9037,44625,5943,83762,4912,2420,2492
59885,92803,9038,44626,5944,83765,4912,2420,2492
59890,92813,9039,44629,5944,83774,4912,2420,2492
59895,92819,9039,44630,5944,83780,4913,2420,2493
59900,92830,9041,44637,5946,83789,4914,2420,2494
59905,92834,9041,44639,5946,83793,4914,2420,2494
59910,92844,9042,44645,5947,83802,4914,2420,2494
59915,92850,9042,44646,5947,83808,4915,2420,2495
59920,92861,9043,44650,5947,83818,4916,2420,2496
59925,92865,9043,44651,5947,83822,4916,2420,2496
59930,92875,9044,44655,5948,83831,4916,2420,2496
59935,92881,9044,44659,5948,83837,4917,2421,2496
59940,92892,9046,44663,5950,83846,4918,2421,2497
59945,92896,9046,44666,5950,83850,4918,2421,2497
59950,92906,9046,44670,5950,83860,4918,2421,2497
59955,92912,9046,44674,5950,83866,4919,2422,2497
59960,92923,9047,44678,5950,83876,4920,2423,2497
59965,92927,9048,44680,5951,83879,4920,2423,2497
59970,92937,9048,44681,5951,83889,4920,2423,2497
59975,92943,9048,44686,5951,83895,4921,2424,2497
59980,92954,9049,44691,5952,83905,4921,2424,2497
59985,92958,9049,44694,5952,83909,4921,2424,2497
59990,92968,9049,44701,5952,83919,4921,2424,2497
59995,92974,9049,44703,5952,83925,4922,2425,2497
60000,92985,9050,44705,5952,83935,4922,2425,2497
60005,92989,9050,44707,5952,83939,4922,2425,2497
60010,92999,9050,44710,5952,83949,4922,2425,2497
60015,93005,9050,44712,5952,83955,4923,2425,2498
60020,93016,9051,44716,5952,83965,4923,2425,2498
60025,93020,9051,44717,5952,83969,4923,2425,2498
60030,93030,9051,44722,5952,83979,4923,2425,2498
60035,93036,9051,44723,5952,83985,4924,2425,2499
60040,93047,9052,44728,5952,83995,4924,2425,2499
60045,93051,9052,44729,5952,83999,4924,2425,2499
60050,93061,9054,44735,5953,84007,4924,2425,2499
60055,93067,9054,44738,5953,84013,4925,2426,2499
60060,93078,9057,44744,5956,84021,4925,2426,2499
60065,93082,9057,44745,5956,84025,4925,2426,2499
60070,93092,9059,44751,5957,84033,4925,2426,2499
60075,93098,9059,44756,5957,84038,4926,2427,2499
60080,93109,9063,44762,5961,84046,4927,2428,2499
60085,93113,9063,44763,5961,84050,4927,2428,2499
60090,93123,9065,44769,5963,84058,4927,2428,2499
60095,93129,9065,44772,5963,84063,4928,2428,2500
60100,93140,9067,44777,5964,84073,4929,2428,2501
60105,93144,9067,44778,5964,84077,4929,2428,2501
60110,93154,9069,44780,5966,84085,4929,2428,2501
60115,93160,9069,44783,5966,84091,4930,2429,2501
60120,93171,9072,44791,5968,84099,4931,2430,2501
60125,93175,9072,44793,5968,84103,4931,2430,2501
60130,93185,9073,44798,5968,84112,4931,2430,2501
60135,93191,9073,44799,5968,84117,4932,2430,2502
60140,93202,9075,44805,5969,84127,4933,2431,2502
60145,93206,9076,44808,5970,84130,4933,2431,2502
60150,93216,9077,44812,5970,84139,4933,2431,2502
60155,93222,9077,44814,5970,84144,4934,2431,2503
60160,93233,9079,44819,5971,84154,4935,2432,2503
60165,93237,9080,44821,5972,84157,4935,2432,2503
60170,93247,9081,44824,5972,84166,4935,2432,2503
60175,93253,9081,44828,5972,84172,4937,2433,2504
60180,93264,9085,44835,5976,84179,4938,2433,2505
60185,93268,9085,44837,5976,84183,4938,2433,2505
60190,93278,9085,44842,5976,84193,4938,2433,2505
60195,93284,9085,44845,5976,84199,4939,2433,2506
60200,93295,9087,44851,5978,84208,4939,2433,2506
60205,93299,9087,44854,5978,84212,4939,2433,2506
60210,93309,9087,44859,5978,84222,4939,2433,2506
60215,93315,9087,44863,5978,84228,4940,2434,2506
60220,93326,9089,44868,5979,84237,4940,2434,2506
60225,93330,9089,44870,5979,84241,4940,2434,2506
60230,93340,9090,44874,5980,84250,4940,2434,2506
60235,93346,9090,44875,5980,84256,4941,2434,2507
60240,93357,9092,44883,5982,84265,4942,2435,2507
60245,93361,9092,44886,5982,84269,4942,2435,2507
60250,93371,9093,44889,5982,84278,4942,2435,2507
60255,93377,9093,44893,5982,84284,4943,2436,2507
60260,93388,9095,44899,5984,84293,4943,2436,2507
60265,93392,9095,44900,5984,84297,4943,2436,2507
60270,93402,9096,44907,5985,84306,4943,2436,2507
60275,93408,9096,44911,5985,84312,4944,2437,2507
60280,93419,9098,44918,5986,84321,4944,2437,2507
60285,93423,9098,44920,5986,84325,4944,2437,2507
60290,93433,9100,44923,5986,84333,4944,2437,2507
60295,93439,9100,44925,5986,84339,4945,2438,2507
60300,93450,9102,44929,5987,84348,4946,2439,2507
60305,93454,9102,44932,5987,84352,4946,2439,2507
60310,93464,9104,44938,5989,84360,4946,2439,2507
60315,93470,9104,44943,5989,84365,4948,2441,2507
60320,93481,9106,44950,5991,84375,4949,2442,2507
60325,93485,9106,44953,5991,84379,4949,2442,2507
60330,93495,9108,44957,5993,84387,4949,2442,2507
60335,93501,9108,44959,5993,84392,4950,2442,2508
60340,93512,9110,44967,5995,84402,4951,2442,2509
60345,93516,9110,44969,5995,84406,4951,2442,2509
60350,93526,9112,44973,5996,84414,4951,2442,2509
60355,93532,9112,44977,5996,84419,4952,2443,2509
60360,93543,9114,44985,5998,84429,4953,2444,2509
60365,93547,9114,44988,5998,84433,4953,2444,2509
60370,93557,9115,44994,5999,84442,4953,2444,2509
60375,93563,9115,44997,5999,84447,4954,2444,2510
60380,93574,9116,45002,6000,84458,4955,2445,2510
60385,93578,9116,45005,6000,84462,4955,2445,2510
60390,93588,9117,45009,6001,84471,4955,2445,2510
60395,93594,9117,45013,6001,84477,4956,2446,2510
60400,93605,9118,45019,6002,84487,4957,2446,2511
60405,93609,9118,45020,6002,84491,4957,2446,2511
60410,93619,9119,45025,6002,84500,4957,2446,2511
60415,93625,9119,45028,6002,84505,4958,2447,2511
60420,93636,9123,45033,6005,84513,4959,2448,2511
60425,93640,9123,45034,6005,84517,4959,2448,2511
60430,93650,9124,45037,6005,84526,4959,2448,2511
60435,93656,9124,45039,6005,84532,4961,2448,2513
60440,93667,9125,45045,6006,84542,4961,2448,2513
60445,93671,9125,45048,6006,84546,4961,2448,2513
60450,93681,9126,45053,6006,84555,4961,2448,2513
60455,93687,9126,45058,6006,84560,4962,2449,2513
60460,93698,9128,45063,6008,84570,4962,2449,2513
60465,93702,9128,45065,6008,84574,4962,2449,2513
60470,93712,9130,45070,6008,84582,4962,2449,2513
60475,93718,9130,45072,6008,84587,4963,2450,2513
60480,93729,9133,45078,6011,84596,4963,2450,2513
60485,93733,9133,45081,6011,84600,4963,2450,2513
60490,93743,9134,45085,6012,84609,4963,2450,2513
60495,93749,9134,45089,6012,84615,4964,2451,2513
60500,93760,9135,45095,6013,84625,4964,2451,2513
60505,93764,9135,45097,6013,84629,4964,2451,2513
60510,93774,9136,45101,6013,84638,4964,2451,2513
60515,93780,9136,45103,6013,84644,4965,2452,2513
60520,93791,9137,45107,6013,84654,4965,2452,2513
60525,93795,9137,45110,6013,84658,4965,2452,2513
60530,93805,9138,45117,6013,84667,4965,2452,2513
60535,93811,9138,45120,6013,84673,4966,2452,2514
60540,93822,9141,45126,6016,84681,4967,2452,2515
60545,93826,9142,45128,6017,84684,4967,2452,2515
60550,93836,9144,45132,6018,84692,4967,2452,2515
60555,93842,9144,45134,6018,84698,4969,2453,2516
60560,93853,9146,45136,6019,84707,4970,2453,2517
60565,93857,9147,45137,6020,84710,4970,2453,2517
60570,93867,9149,45142,6021,84718,4970,2453,2517
60575,93873,9149,45147,6021,84724,4971,2454,2517
60580,93884,9152,45155,6024,84732,4972,2454,2518
60585,93888,9152,45157,6024,84736,4972,2454,2518
60590,93898,9154,45165,6026,84744,4972,2454,2518
60595,93904,9154,45170,6026,84749,4973,2454,2519
60600,93915,9157,45173,6028,84758,4974,2454,2520
60605,93919,9157,45173,6028,84762,4974,2454,2520
60610,93929,9158,45180,6029,84771,4974,2454,2520
60615,93935,9158,45184,6029,84777,4975,2455,2520
60620,93946,9158,45189,6029,84788,4975,2455,2520
60625,93950,9158,45191,6029,84792,4975,2455,2520
60630,93960,9159,45195,6030,84801,4975,2455,2520
60635,93966,9159,45198,6030,84807,4976,2456,2520
60640,93977,9159,45204,6030,84818,4976,2456,2520
60645,93981,9159,45206,6030,84822,4976,2456,2520
60650,93991,9160,45211,6030,84831,4976,2456,2520
60655,93997,9160,45214,6030,84837,4977,2457,2520
60660,94008,9160,45221,6030,84848,4977,2457,2520
60665,94012,9160,45223,6030,84852,4977,2457,2520
60670,94022,9161,45227,6031,84861,4977,2457,2520
60675,94028,9161,45230,6031,84867,4978,2457,2521
60680,94039,9161,45237,6031,84878,4978,2457,2521
60685,94043,9161,45239,6031,84882,4978,2457,2521
60690,94053,9162,45242,6031,84891,4978,2457,2521
60695,94059,9162,45243,6031,84896,4979,2457,2522
60700,94070,9163,45250,6032,84907,4979,2457,2522
60705,94074,9163,45252,6032,84911,4979,2457,2522
60710,94084,9165,45258,6033,84919,4979,2457,2522
60715,94090,9165,45260,6033,84925,4980,2457,2523
60720,94101,9167,45267,6035,84934,4981,2458,2523
60725,94105,9167,45270,6035,84938,4981,2458,2523
60730,94115,9168,45275,6035,84947,4981,2458,2523
60735,94121,9168,45278,6035,84953,4982,2458,2524
60740,94132,9169,45283,6036,84963,4983,2458,2525
60745,94136,9169,45284,6036,84967,4983,2458,2525
60750,94146,9170,45289,6036,84976,4983,2458,2525
60755,94152,9170,45293,6036,84981,4984,2459,2525
60760,94163,9173,45297,6039,84990,4985,2459,2526
60765,94167,9173,45301,6039,84994,4985,2459,2526
60770,94177,9174,45304,6039,85003,4985,2459,2526
60775,94183,9174,45307,6039,85008,4986,2460,2526
60780,94194,9177,45314,6041,85017,4987,2461,2526
60785,94198,9177,45315,6041,85021,4987,2461,2526
60790,94208,9178,45319,6041,85030,4987,2461,2526
60795,94214,9178,45321,6041,85036,4988,2462,2526
60800,94225,9181,45327,6043,85044,4989,2463,2526
60805,94229,9182,45328,6044,85047,4989,2463,2526
60810,94239,9183,45333,6044,85056,4989,2463,2526
60815,94245,9183,45335,6044,85062,4990,2463,2527
60820,94256,9185,45341,6046,85071,4991,2464,2527
60825,94260,9186,45343,6047,85074,4991,2464,2527
60830,94270,9188,45351,6049,85082,4991,2464,2527
60835,94276,9188,45354,6049,85088,4992,2465,2527
60840,94287,9190,45357,6050,85097,4993,2466,2527
60845,94291,9191,45359,6051,85100,4993,2466,2527
60850,94301,9193,45365,6053,85108,4993,2466,2527
60855,94307,9193,45368,6053,85114,4994,2467,2527
60860,94318,9195,45376,6055,85123,4995,2468,2527
60865,94322,9196,45378,6056,85126,4995,2468,2527
60870,94332,9198,45383,6057,85134,4995,2468,2527
60875,94338,9198,45388,6057,85140,4996,2469,2527
60880,94349,9200,45393,6059,85149,4997,2469,2528
60885,94353,9201,45394,6060,85152,4997,2469,2528
60890,94363,9203,45400,6060,85160,4997,2469,2528
60895,94369,9203,45402,6060,85166,4998,2469,2529
60900,94380,9204,45406,6060,85176,4999,2469,2530
60905,94384,9204,45408,6060,85180,4999,2469,2530
60910,94394,9206,45413,6060,85188,4999,2469,2530
60915,94400,9206,45418,6060,85194,5000,2470,2530
60920,94411,9208,45422,6062,85203,5001,2470,2531
60925,94415,9208,45424,6062,85207,5001,2470,2531
60930,94425,9209,45429,6062,85216,5001,2470,2531
60935,94431,9209,45432,6062,85221,5002,2471,2531
60940,94442,9210,45436,6063,85232,5003,2472,2531
60945,94446,9211,45439,6064,85235,5003,2472,2531
60950,94456,9212,45448,6065,85244,5003,2472,2531
60955,94462,9212,45452,6065,85249,5004,2473,2531
60960,94473,9214,45457,6067,85259,5005,2473,2532
60965,94477,9214,45460,6067,85263,5005,2473,2532
60970,94487,9214,45463,6067,85273,5005,2473,2532
60975,94493,9214,45468,6067,85279,5006,2474,2532
60980,94504,9215,45469,6067,85289,5007,2474,2533
60985,94508,9215,45472,6067,85293,5007,2474,2533
60990,94518,9215,45473,6067,85303,5007,2474,2533
60995,94524,9215,45476,6067,85309,5008,2474,2534
61000,94535,9216,45484,6068,85319,5009,2475,2534
61005,94539,9216,45487,6068,85323,5009,2475,2534
61010,94549,9216,45491,6068,85333,5009,2475,2534
61015,94555,9216,45493,6068,85339,5011,2476,2535
61020,94566,9217,45500,6068,85349,5012,2476,2536
61025,94570,9217,45500,6068,85353,5012,2476,2536
61030,94580,9218,45505,6069,85362,5012,2476,2536
61035,94586,9218,45508,6069,85368,5013,2477,2536
61040,94597,9219,45516,6069,85378,5013,2477,2536
61045,94601,9219,45519,6069,85382,5013,2477,2536
61050,94611,9220,45523,6070,85391,5013,2477,2536
61055,94617,9220,45527,6070,85396,5014,2477,2537
61060,94628,9222,45528,6071,85406,5014,2477,2537
61065,94632,9222,45529,6071,85410,5014,2477,2537
61070,94642,9224,45534,6072,85418,5014,2477,2537
61075,94648,9224,45539,6072,85424,5015,2478,2537
61080,94659,9226,45544,6073,85433,5015,2478,2537
61085,94663,9227,45548,6074,85436,5015,2478,2537
61090,94673,9229,45551,6076,85444,5015,2478,2537
61095,94679,9229,45554,6076,85450,5016,2478,2538
61100,94690,9230,45560,6077,85460,5017,2478,2539
61105,94694,9230,45561,6077,85464,5017,2478,2539
61110,94704,9232,45566,6077,85472,5017,2478,2539
61115,94710,9232,45568,6077,85478,5018,2479,2539
61120,94721,9233,45572,6077,85488,5019,2479,2540
61125,94725,9234,45574,6078,85491,5019,2479,2540
61130,94735,9236,45579,6079,85499,5019,2479,2540
61135,94741,9236,45582,6079,85505,5020,2479,2541
61140,94752,9239,45589,6081,85513,5021,2480,2541
61145,94756,9240,45592,6082,85516,5021,2480,2541
61150,94766,9242,45597,6083,85524,5021,2480,2541
61155,94772,9242,45599,6083,85530,5022,2481,2541
61160,94783,9242,45604,6083,85541,5023,2482,2541
61165,94787,9242,45606,6083,85545,5023,2482,2541
61170,94797,9244,45613,6085,85553,5023,2482,2541
61175,94803,9244,45617,6085,85559,5024,2483,2541
61180,94814,9244,45621,6085,85570,5025,2484,2541
61185,94818,9244,45623,6085,85574,5025,2484,2541
61190,94828,9246,45630,6087,85582,5025,2484,2541
61195,94834,9246,45634,6087,85587,5026,2485,2541
61200,94845,9248,45641,6089,85597,5027,2486,2541
61205,94849,9249,45643,6090,85600,5027,2486,2541
61210,94859,9251,45645,6090,85608,5027,2486,2541
61215,94865,9251,45648,6090,85614,5028,2487,2541
61220,94876,9251,45653,6090,85625,5029,2488,2541
61225,94880,9252,45654,6091,85628,5029,2488,2541
61230,94890,9254,45658,6093,85636,5029,2488,2541
61235,94896,9254,45664,6093,85641,5030,2489,2541
61240,94907,9257,45669,6096,85650,5031,2489,2542
61245,94911,9257,45672,6096,85654,5031,2489,2542
61250,94921,9259,45679,6097,85662,5031,2489,2542
61255,94927,9259,45681,6097,85668,5033,2489,2544
61260,94938,9263,45687,6100,85675,5034,2489,2545
61265,94942,9264,45690,6101,85678,5034,2489,2545
61270,94952,9264,45696,6101,85688,5034,2489,2545
61275,94958,9264,45699,6101,85694,5035,2490,2545
61280,94969,9266,45706,6103,85703,5036,2490,2546
61285,94973,9266,45708,6103,85707,5036,2490,2546
61290,94983,9266,45714,6103,85717,5036,2490,2546
61295,94989,9266,45720,6103,85723,5037,2491,2546
61300,95000,9267,45726,6104,85733,5038,2492,2546
61305,95004,9267,45728,6104,85737,5038,2492,2546
61310,95014,9267,45732,6104,85747,5038,2492,2546
61315,95020,9267,45735,6104,85753,5039,2492,2547
61320,95031,9268,45737,6105,85763,5040,2492,2548
61325,95035,9268,45739,6105,85767,5040,2492,2548
61330,95045,9268,45746,6105,85777,5040,2492,2548
61335,95051,9268,45750,6105,85783,5041,2493,2548
61340,95062,9270,45757,6107,85792,5042,2493,2549
61345,95066,9270,45758,6107,85796,5042,2493,2549
61350,95076,9270,45766,6107,85806,5042,2493,2549
61355,95082,9270,45768,6107,85812,5043,2493,2550
61360,95093,9271,45774,6108,85822,5044,2493,2551
61365,95097,9271,45775,6108,85826,5044,2493,2551
61370,95107,9273,45780,6109,85834,5044,2493,2551
61375,95113,9273,45785,6109,85839,5046,2495,2551
61380,95124,9276,45789,6111,85848,5047,2495,2552
61385,95128,9276,45791,6111,85852,5047,2495,2552
61390,95138,9278,45794,6112,85860,5047,2495,2552
61395,95144,9278,45797,6112,85866,5048,2495,2553
61400,95155,9280,45802,6114,85875,5049,2496,2553
61405,95159,9280,45804,6114,85879,5049,2496,2553
61410,95169,9282,45809,6115,85887,5049,2496,2553
61415,95175,9282,45811,6115,85893,5050,2496,2554
61420,95186,9283,45815,6116,85903,5051,2496,2555
61425,95190,9283,45816,6116,85907,5051,2496,2555
61430,95200,9285,45818,6116,85915,5051,2496,2555
61435,95206,9285,45820,6116,85921,5052,2496,2556
61440,95217,9287,45826,6117,85930,5053,2497,2556
61445,95221,9288,45827,6118,85933,5053,2497,2556
61450,95231,9290,45830,6118,85941,5053,2497,2556
61455,95237,9290,45832,6118,85947,5054,2497,2557
61460,95248,9292,45837,6120,85956,5055,2498,2557
61465,95252,9293,45838,6121,85959,5055,2498,2557
61470,95262,9295,45847,6123,85967,5055,2498,2557
61475,95268,9295,45850,6123,85973,5056,2498,2558
61480,95279,9296,45854,6124,85983,5057,2498,2559
61485,95283,9297,45856,6125,85986,5057,2498,2559
61490,95293,9299,45863,6126,85994,5057,2498,2559
61495,95299,9299,45867,6126,86000,5059,2500,2559
61500,95310,9302,45875,6129,86008,5060,2501,2559
61505,95314,9302,45878,6129,86012,5060,2501,2559
61510,95324,9302,45881,6129,86022,5060,2501,2559
61515,95330,9302,45883,6129,86028,5062,2501,2561
61520,95341,9302,45888,6129,86039,5063,2502,2561
61525,95345,9302,45889,6129,86043,5063,2502,2561
61530,95355,9302,45892,6129,86053,5063,2502,2561
61535,95361,9302,45895,6129,86059,5064,2502,2562
61540,95372,9302,45898,6129,86070,5064,2502,2562
61545,95376,9302,45899,6129,86074,5064,2502,2562
61550,95386,9302,45905,6129,86084,5064,2502,2562
61555,95392,9302,45907,6129,86090,5065,2502,2563
61560,95403,9302,45914,6129,86101,5065,2502,2563
61565,95407,9302,45917,6129,86105,5065,2502,2563
61570,95417,9302,45921,6129,86115,5065,2502,2563
61575,95423,9302,45923,6129,86121,5066,2502,2564
61580,95434,9302,45930,6129,86132,5066,2502,2564
61585,95438,9302,45933,6129,86136,5066,2502,2564
61590,95448,9302,45937,6129,86146,5066,2502,2564
61595,95454,9302,45939,6129,86152,5067,2502,2565
61600,95465,9302,45948,6129,86163,5067,2502,2565
61605,95469,9302,45952,6129,86167,5067,2502,2565
61610,95479,9304,45959,6131,86175,5067,2502,2565
61615,95485,9304,45963,6131,86181,5068,2503,2565
61620,95496,9306,45967,6133,86190,5068,2503,2565
61625,95500,9306,45969,6133,86194,5068,2503,2565
61630,95510,9308,45973,6133,86202,5068,2503,2565
61635,95516,9308,45977,6133,86208,5069,2503,2566
61640,95527,9310,45981,6134,86217,5069,2503,2566
61645,95531,9310,45983,6134,86221,5069,2503,2566
61650,95541,9312,45987,6135,86229,5069,2503,2566
61655,95547,9312,45990,6135,86235,5070,2503,2567
61660,95558,9314,45995,6136,86244,5070,2503,2567
61665,95562,9315,45997,6137,86247,5070,2503,2567
61670,95572,9317,46003,6138,86255,5070,2503,2567
61675,95578,9317,46006,6138,86261,5071,2503,2568
61680,95589,9319,46011,6139,86270,5072,2503,2569
61685,95593,9319,46013,6139,86274,5072,2503,2569
61690,95603,9321,46019,6140,86282,5072,2503,2569
61695,95609,9321,46022,6140,86288,5073,2504,2569
61700,95620,9323,46028,6141,86297,5074,2505,2569
61705,95624,9324,46031,6142,86300,5074,2505,2569
61710,95634,9326,46036,6144,86308,5074,2505,2569
61715,95640,9326,46036,6144,86314,5075,2505,2570
61720,95651,9329,46043,6147,86322,5076,2505,2571
61725,95655,9330,46046,6148,86325,5076,2505,2571
61730,95665,9332,46050,6149,86333,5076,2505,2571
61735,95671,9332,46055,6149,86338,5077,2506,2571
61740,95682,9336,46063,6152,86346,5078,2506,2572
61745,95686,9336,46065,6152,86350,5078,2506,2572
61750,95696,9337,46069,6152,86359,5078,2506,2572
61755,95702,9337,46072,6152,86365,5080,2507,2573
61760,95713,9338,46078,6153,86375,5080,2507,2573
61765,95717,9338,46081,6153,86379,5080,2507,2573
61770,95727,9339,46085,6154,86388,5080,2507,2573
61775,95733,9339,46088,6154,86394,5081,2508,2573
61780,95744,9340,46093,6155,86404,5081,2508,2573
61785,95748,9340,46095,6155,86408,5081,2508,2573
61790,95758,9341,46100,6156,86417,5081,2508,2573
61795,95764,9341,46104,6156,86423,5082,2509,2573
61800,95775,9342,46112,6157,86433,5082,2509,2573
61805,95779,9342,46115,6157,86437,5082,2509,2573
61810,95789,9342,46118,6157,86447,5082,2509,2573
61815,95795,9342,46121,6157,86453,5083,2509,2574
61820,95806,9342,46128,6157,86464,5083,2509,2574
61825,95810,9342,46130,6157,86468,5083,2509,2574
61830,95820,9342,46136,6157,86478,5083,2509,2574
61835,95826,9342,46140,6157,86484,5084,2510,2574
61840,95837,9342,46146,6157,86495,5084,2510,2574
61845,95841,9342,46147,6157,86499,5084,2510,2574
61850,95851,9343,46153,6158,86508,5084,2510,2574
61855,95857,9343,46157,6158,86514,5085,2511,2574
61860,95868,9345,46160,6159,86523,5086,2511,2575
61865,95872,9345,46162,6159,86527,5086,2511,2575
61870,95882,9347,46167,6160,86535,5086,2511,2575
61875,95888,9347,46171,6160,86540,5088,2512,2576
61880,95899,9350,46176,6163,86549,5088,2512,2576
61885,95903,9350,46180,6163,86553,5088,2512,2576
61890,95913,9352,46186,6164,86561,5088,2512,2576
61895,95919,9352,46189,6164,86567,5090,2513,2577
61900,95930,9354,46193,6165,86576,5090,2513,2577
61905,95934,9354,46195,6165,86580,5090,2513,2577
61910,95944,9356,46200,6166,86588,5090,2513,2577
61915,95950,9356,46201,6166,86593,5091,2513,2578
61920,95961,9360,46206,6170,86601,5091,2513,2578
61925,95965,9360,46208,6170,86605,5091,2513,2578
61930,95975,9362,46214,6171,86613,5091,2513,2578
61935,95981,9362,46216,6171,86619,5092,2514,2578
61940,95992,9363,46219,6171,86629,5092,2514,2578
61945,95996,9363,46220,6171,86633,5092,2514,2578
61950,96006,9365,46224,6171,86641,5092,2514,2578
61955,96012,9365,46226,6171,86647,5093,2514,2579
61960,96023,9368,46232,6173,86655,5093,2514,2579
61965,96027,9368,46233,6173,86659,5093,2514,2579
61970,96037,9370,46235,6175,86667,5093,2514,2579
61975,96043,9370,46237,6175,86672,5094,2514,2580
61980,96054,9374,46245,6179,86680,5095,2514,2581
61985,96058,9375,46246,6180,86683,5095,2514,2581
61990,96068,9375,46253,6180,86693,5095,2514,2581
61995,96074,9375,46254,6180,86699,5096,2514,2582
62000,96085,9376,46259,6180,86709,5096,2514,2582
62005,96089,9377,46261,6181,86712,5096,2514,2582
62010,96099,9377,46269,6181,86722,5096,2514,2582
62015,96105,9377,46271,6181,86728,5098,2515,2583
62020,96116,9378,46278,6182,86738,5098,2515,2583
62025,96120,9378,46279,6182,86742,5098,2515,2583
62030,96130,9378,46284,6182,86752,5098,2515,2583
62035,96136,9378,46286,6182,86758,5100,2516,2584
62040,96147,9379,46291,6182,86768,5100,2516,2584
62045,96151,9379,46292,6182,86772,5100,2516,2584
62050,96161,9379,46295,6182,86782,5100,2516,2584
62055,96167,9379,46299,6182,86788,5101,2516,2585
62060,96178,9380,46305,6182,86798,5101,2516,2585
62065,96182,9380,46307,6182,86802,5101,2516,2585
62070,96192,9380,46312,6182,86812,5101,2516,2585
62075,96198,9380,46317,6182,86818,5102,2517,2585
62080,96209,9381,46320,6182,86828,5102,2517,2585
62085,96213,9381,46322,6182,86832,5102,2517,2585
62090,96223,9382,46328,6182,86841,5102,2517,2585
62095,96229,9382,46330,6182,86847,5103,2517,2586
62100,96240,9383,46332,6182,86857,5104,2517,2587
62105,96244,9383,46334,6182,86861,5104,2517,2587
62110,96254,9385,46339,6184,86869,5104,2517,2587
62115,96260,9385,46342,6184,86875,5105,2517,2588
62120,96271,9385,46347,6184,86886,5105,2517,2588
62125,96275,9385,46349,6184,86890,5105,2517,2588
62130,96285,9387,46351,6184,86898,5105,2517,2588
62135,96291,9387,46353,6184,86904,5106,2517,2589
62140,96302,9388,46358,6185,86914,5106,2517,2589
62145,96306,9388,46361,6185,86918,5106,2517,2589
62150,96316,9390,46365,6185,86926,5106,2517,2589
62155,96322,9390,46368,6185,86931,5108,2518,2590
62160,96333,9392,46374,6187,86941,5108,2518,2590
62165,96337,9392,46377,6187,86945,5108,2518,2590
62170,96347,9394,46380,6187,86953,5108,2518,2590
62175,96353,9394,46383,6187,86958,5109,2518,2591
62180,96364,9396,46388,6189,86968,5109,2518,2591
62185,96368,9396,46390,6189,86972,5109,2518,2591
62190,96378,9398,46394,6190,86980,5109,2518,2591
62195,96384,9398,46396,6190,86985,5110,2518,2592
62200,96395,9399,46401,6191,86996,5110,2518,2592
62205,96399,9399,46404,6191,87000,5110,2518,2592
62210,96409,9401,46407,6193,87008,5110,2518,2592
62215,96415,9401,46410,6193,87014,5111,2519,2592
62220,96426,9404,46417,6196,87022,5112,2519,2593
62225,96430,9404,46418,6196,87026,5112,2519,2593
62230,96440,9405,46424,6196,87035,5112,2519,2593
62235,96446,9405,46426,6196,87041,5113,2519,2594
62240,96457,9407,46435,6198,87050,5114,2520,2594
62245,96461,9407,46438,6198,87054,5114,2520,2594
62250,96471,9408,46443,6199,87063,5114,2520,2594
62255,96477,9408,46444,6199,87069,5115,2520,2595
62260,96488,9409,46449,6199,87079,5116,2520,2596
62265,96492,9410,46452,6200,87082,5116,2520,2596
62270,96502,9411,46457,6200,87091,5116,2520,2596
62275,96508,9411,46459,6200,87097,5118,2521,2597
62280,96519,9413,46465,6201,87106,5119,2522,2597
62285,96523,9413,46468,6201,87110,5119,2522,2597
62290,96533,9414,46471,6201,87119,5119,2522,2597
62295,96539,9414,46475,6201,87125,5121,2523,2598
62300,96550,9414,46481,6201,87136,5121,2523,2598
62305,96554,9414,46484,6201,87140,5121,2523,2598
62310,96564,9415,46488,6202,87149,5121,2523,2598
62315,96570,9415,46492,6202,87155,5122,2523,2599
62320,96581,9415,46498,6202,87166,5122,2523,2599
62325,96585,9415,46500,6202,87170,5122,2523,2599
62330,96595,9417,46505,6203,87178,5122,2523,2599
62335,96601,9417,46507,6203,87184,5123,2524,2599
62340,96612,9419,46516,6205,87193,5123,2524,2599
62345,96616,9419,46518,6205,87197,5123,2524,2599
62350,96626,9421,46522,6205,87205,5123,2524,2599
62355,96632,9421,46525,6205,87210,5124,2525,2599
62360,96643,9423,46532,6207,87220,5124,2525,2599
62365,96647,9423,46534,6207,87224,5124,2525,2599
62370,96657,9425,46540,6208,87232,5124,2525,2599
62375,96663,9425,46545,6208,87238,5125,2526,2599
62380,96674,9425,46550,6208,87249,5125,2526,2599
62385,96678,9425,46553,6208,87253,5125,2526,2599
62390,96688,9427,46560,6210,87261,5125,2526,2599
62395,96694,9427,46565,6210,87267,5126,2527,2599
62400,96705,9429,46571,6212,87276,5127,2527,2600
62405,96709,9429,46572,6212,87280,5127,2527,2600
62410,96719,9431,46577,6212,87288,5127,2527,2600
62415,96725,9431,46582,6212,87294,5129,2529,2600
62420,96736,9432,46586,6212,87304,5129,2529,2600
62425,96740,9432,46586,6212,87308,5129,2529,2600
62430,96750,9434,46590,6212,87316,5129,2529,2600
62435,96756,9434,46592,6212,87321,5130,2529,2601
62440,96767,9437,46595,6214,87330,5130,2529,2601
62445,96771,9437,46596,6214,87334,5130,2529,2601
62450,96781,9439,46599,6215,87342,5130,2529,2601
62455,96787,9439,46601,6215,87348,5131,2529,2602
62460,96798,9440,46605,6216,87358,5131,2529,2602
62465,96802,9441,46607,6217,87361,5131,2529,2602
62470,96812,9443,46613,6218,87369,5131,2529,2602
62475,96818,9443,46616,6218,87375,5132,2530,2602
62480,96829,9444,46620,6218,87385,5132,2530,2602
62485,96833,9445,46622,6219,87388,5132,2530,2602
62490,96843,9447,46627,6221,87396,5132,2530,2602
62495,96849,9447,46630,6221,87402,5133,2531,2602
62500,96860,9449,46633,6222,87411,5133,2531,2602
62505,96864,9449,46635,6222,87415,5133,2531,2602
62510,96874,9451,46641,6223,87423,5133,2531,2602
62515,96880,9451,46644,6223,87429,5134,2531,2603
62520,96891,9455,46651,6226,87436,5135,2532,2603
62525,96895,9455,46653,6226,87440,5135,2532,2603
62530,96905,9456,46658,6226,87449,5135,2532,2603
62535,96911,9456,46661,6226,87455,5137,2533,2604
62540,96922,9457,46670,6227,87465,5138,2534,2604
62545,96926,9457,46673,6227,87469,5138,2534,2604
62550,96936,9458,46679,6228,87478,5138,2534,2604
62555,96942,9458,46681,6228,87483,5139,2534,2605
62560,96953,9459,46687,6229,87494,5139,2534,2605
62565,96957,9459,46688,6229,87498,5139,2534,2605
62570,96967,9460,46696,6230,87507,5139,2534,2605
62575,96973,9460,46700,6230,87513,5140,2535,2605
62580,96984,9460,46705,6230,87524,5140,2535,2605
62585,96988,9460,46707,6230,87528,5140,2535,2605
62590,96998,9461,46711,6230,87537,5140,2535,2605
62595,97004,9461,46714,6230,87543,5141,2536,2605
62600,97015,9461,46718,6230,87554,5141,2536,2605
62605,97019,9461,46721,6230,87558,5141,2536,2605
62610,97029,9462,46725,6230,87567,5141,2536,2605
62615,97035,9462,46728,6230,87572,5142,2536,2606
62620,97046,9463,46732,6231,87583,5142,2536,2606
62625,97050,9463,46733,6231,87587,5142,2536,2606
62630,97060,9465,46741,6232,87595,5142,2536,2606
62635,97066,9465,46743,6232,87601,5143,2536,2607
62640,97077,9468,46750,6235,87609,5143,2536,2607
62645,97081,9468,46753,6235,87613,5143,2536,2607
62650,97091,9470,46755,6235,87621,5143,2536,2607
62655,97097,9470,46759,6235,87627,5145,2537,2608
62660,97108,9472,46765,6236,87636,5146,2538,2608
62665,97112,9472,46768,6236,87640,5146,2538,2608
62670,97122,9474,46771,6237,87648,5146,2538,2608
62675,97128,9474,46776,6237,87653,5147,2539,2608
62680,97139,9476,46780,6239,87663,5148,2539,2609
62685,97143,9476,46782,6239,87667,5148,2539,2609
62690,97153,9478,46787,6240,87675,5148,2539,2609
62695,97159,9478,46791,6240,87680,5149,2540,2609
62700,97170,9481,46795,6243,87689,5150,2540,2610
62705,97174,9481,46799,6243,87693,5150,2540,2610
62710,97184,9483,46803,6243,87701,5150,2540,2610
62715,97190,9483,46804,6243,87707,5151,2540,2611
62720,97201,9484,46809,6244,87717,5151,2540,2611
62725,97205,9484,46811,6244,87721,5151,2540,2611
62730,97215,9486,46818,6245,87729,5151,2540,2611
62735,97221,9486,46821,6245,87735,5152,2540,2612
62740,97232,9487,46826,6246,87745,5152,2540,2612
62745,97236,9487,46830,6246,87749,5152,2540,2612
62750,97246,9489,46835,6247,87757,5152,2540,2612
62755,97252,9489,46836,6247,87763,5153,2540,2613
62760,97263,9490,46842,6248,87773,5153,2540,2613
62765,97267,9491,46843,6249,87776,5153,2540,2613
62770,97277,9493,46847,6249,87784,5153,2540,2613
62775,97283,9493,46851,6249,87790,5155,2541,2614
62780,97294,9494,46856,6249,87800,5155,2541,2614
62785,97298,9494,46858,6249,87804,5155,2541,2614
62790,97308,9496,46861,6250,87812,5155,2541,2614
62795,97314,9496,46863,6250,87818,5156,2541,2615
62800,97325,9499,46869,6252,87826,5156,2541,2615
62805,97329,9500,46872,6253,87829,5156,2541,2615
62810,97339,9502,46877,6253,87837,5156,2541,2615
62815,97345,9502,46880,6253,87842,5157,2542,2615
62820,97356,9505,46886,6255,87851,5158,2542,2616
62825,97360,9506,46889,6256,87854,5158,2542,2616
62830,97370,9508,46895,6258,87862,5158,2542,2616
62835,97376,9508,46901,6258,87867,5159,2543,2616
62840,97387,9510,46907,6259,87877,5160,2543,2617
62845,97391,9511,46911,6260,87880,5160,2543,2617
62850,97401,9513,46918,6261,87888,5160,2543,2617
62855,97407,9513,46923,6261,87893,5161,2544,2617
62860,97418,9515,46928,6262,87903,5162,2545,2617
62865,97422,9515,46930,6262,87907,5162,2545,2617
62870,97432,9517,46934,6263,87915,5162,2545,2617
62875,97438,9517,46936,6263,87920,5163,2545,2618
62880,97449,9521,46942,6266,87928,5164,2545,2619
62885,97453,9521,46943,6266,87932,5164,2545,2619
62890,97463,9523,46949,6267,87940,5164,2545,2619
62895,97469,9523,46952,6267,87946,5166,2546,2620
62900,97480,9523,46958,6267,87957,5166,2546,2620
62905,97484,9523,46959,6267,87961,5166,2546,2620
62910,97494,9525,46965,6269,87969,5166,2546,2620
62915,97500,9525,46968,6269,87975,5168,2547,2621
62920,97511,9526,46976,6270,87985,5168,2547,2621
62925,97515,9526,46977,6270,87989,5168,2547,2621
62930,97525,9528,46980,6270,87997,5168,2547,2621
62935,97531,9528,46981,6270,88003,5169,2548,2621
62940,97542,9528,46985,6270,88014,5169,2548,2621
62945,97546,9529,46987,6271,88017,5169,2548,2621
62950,97556,9530,46990,6271,88026,5169,2548,2621
62955,97562,9530,46994,6271,88032,5170,2549,2621
62960,97573,9532,47000,6272,88041,5171,2549,2622
62965,97577,9533,47004,6273,88044,5171,2549,2622
62970,97587,9534,47008,6274,88053,5171,2549,2622
62975,97593,9534,47009,6274,88059,5172,2550,2622
62980,97604,9537,47014,6276,88067,5173,2550,2623
62985,97608,9537,47016,6276,88071,5173,2550,2623
62990,97618,9538,47019,6276,88080,5173,2550,2623
62995,97624,9538,47023,6276,88085,5174,2550,2624
63000,97635,9540,47027,6277,88095,5175,2551,2624
63005,97639,9540,47030,6277,88099,5175,2551,2624
63010,97649,9541,47036,6278,88108,5175,2551,2624
63015,97655,9541,47039,6278,88113,5176,2551,2625
63020,97666,9542,47044,6279,88124,5176,2551,2625
63025,97670,9542,47045,6279,88128,5176,2551,2625
63030,97680,9543,47051,6280,88137,5176,2551,2625
63035,97686,9543,47054,6280,88142,5178,2552,2626
63040,97697,9544,47060,6281,88153,5178,2552,2626
63045,97701,9544,47061,6281,88157,5178,2552,2626
63050,97711,9545,47067,6282,88166,5178,2552,2626
63055,97717,9545,47069,6282,88171,5179,2552,2627
63060,97728,9547,47072,6284,88181,5179,2552,2627
63065,97732,9547,47073,6284,88185,5179,2552,2627
63070,97742,9549,47077,6284,88193,5179,2552,2627
63075,97748,9549,47080,6284,88199,5180,2552,2628
63080,97759,9550,47083,6284,88209,5180,2552,2628
63085,97763,9550,47086,6284,88213,5180,2552,2628
63090,97773,9552,47090,6285,88221,5180,2552,2628
63095,97779,9552,47092,6285,88227,5181,2552,2629
63100,97790,9554,47096,6286,88236,5181,2552,2629
63105,97794,9554,47097,6286,88240,5181,2552,2629
63110,97804,9556,47101,6286,88248,5181,2552,2629
63115,97810,9556,47104,6286,88254,5182,2553,2629
63120,97821,9559,47109,6288,88262,5183,2553,2630
63125,97825,9559,47112,6288,88266,5183,2553,2630
63130,97835,9561,47118,6289,88274,5183,2553,2630
63135,97841,9561,47123,6289,88280,5184,2554,2630
63140,97852,9561,47127,6289,88291,5185,2555,2630
63145,97856,9561,47129,6289,88295,5185,2555,2630
63150,97866,9563,47134,6289,88303,5185,2555,2630
63155,97872,9563,47139,6289,88309,5187,2556,2631
63160,97883,9564,47144,6290,88319,5188,2556,2632
63165,97887,9564,47148,6290,88323,5188,2556,2632
63170,97897,9566,47157,6292,88331,5188,2556,2632
63175,97903,9566,47159,6292,88337,5190,2557,2633
63180,97914,9567,47164,6293,88347,5191,2557,2634
63185,97918,9567,47166,6293,88351,5191,2557,2634
63190,97928,9569,47170,6295,88359,5191,2557,2634
63195,97934,9569,47176,6295,88364,5192,2558,2634
63200,97945,9570,47179,6296,88375,5193,2558,2635
63205,97949,9570,47180,6296,88379,5193,2558,2635
63210,97959,9572,47186,6297,88387,5193,2558,2635
63215,97965,9572,47190,6297,88392,5194,2558,2636
63220,97976,9573,47197,6298,88403,5195,2559,2636
63225,97980,9573,47200,6298,88407,5195,2559,2636
63230,97990,9575,47206,6299,88415,5195,2559,2636
63235,97996,9575,47208,6299,88421,5196,2560,2636
63240,98007,9576,47212,6299,88431,5197,2561,2636
63245,98011,9576,47213,6299,88435,5197,2561,2636
63250,98021,9578,47218,6299,88443,5197,2561,2636
63255,98027,9578,47218,6299,88449,5198,2561,2637
63260,98038,9580,47224,6300,88458,5198,2561,2637
63265,98042,9581,47226,6301,88461,5198,2561,2637
63270,98052,9583,47228,6302,88469,5198,2561,2637
63275,98058,9583,47231,6302,88475,5199,2562,2637
63280,98069,9585,47238,6303,88484,5199,2562,2637
63285,98073,9586,47241,6304,88487,5199,2562,2637
63290,98083,9588,47246,6306,88495,5199,2562,2637
63295,98089,9588,47250,6306,88500,5201,2563,2638
63300,98100,9591,47257,6308,88509,5201,2563,2638
63305,98104,9592,47259,6309,88512,5201,2563,2638
63310,98114,9593,47262,6309,88521,5201,2563,2638
63315,98120,9593,47266,6309,88527,5202,2564,2638
63320,98131,9594,47272,6309,88537,5202,2564,2638
63325,98135,9594,47275,6309,88541,5202,2564,2638
63330,98145,9595,47280,6309,88550,5202,2564,2638
63335,98151,9595,47282,6309,88556,5203,2564,2639
63340,98162,9596,47290,6310,88566,5203,2564,2639
63345,98166,9596,47293,6310,88570,5203,2564,2639
63350,98176,9597,47300,6311,88579,5203,2564,2639
63355,98182,9597,47301,6311,88585,5204,2564,2640
63360,98193,9600,47309,6314,88593,5205,2564,2641
63365,98197,9600,47310,6314,88597,5205,2564,2641
63370,98207,9602,47315,6315,88605,5205,2564,2641
63375,98213,9602,47318,6315,88611,5206,2564,2642
63380,98224,9605,47325,6317,88619,5207,2565,2642
63385,98228,9605,47325,6317,88623,5207,2565,2642
63390,98238,9607,47329,6317,88631,5207,2565,2642
63395,98244,9607,47330,6317,88637,5208,2566,2642
63400,98255,9610,47335,6319,88645,5209,2566,2643
63405,98259,9610,47337,6319,88649,5209,2566,2643
63410,98269,9612,47341,6320,88657,5209,2566,2643
63415,98275,9612,47343,6320,88663,5211,2567,2644
63420,98286,9614,47348,6322,88672,5212,2568,2644
63425,98290,9614,47349,6322,88676,5212,2568,2644
63430,98300,9615,47357,6323,88685,5212,2568,2644
63435,98306,9615,47361,6323,88690,5213,2568,2645
63440,98317,9618,47365,6326,88699,5213,2568,2645
63445,98321,9618,47365,6326,88703,5213,2568,2645
63450,98331,9619,47369,6326,88712,5213,2568,2645
63455,98337,9619,47372,6326,88718,5214,2568,2646
63460,98348,9621,47378,6327,88727,5214,2568,2646
63465,98352,9621,47380,6327,88731,5214,2568,2646
63470,98362,9622,47386,6328,88740,5214,2568,2646
63475,98368,9622,47389,6328,88746,5215,2568,2647
63480,98379,9623,47394,6329,88756,5215,2568,2647
63485,98383,9623,47398,6329,88760,5215,2568,2647
63490,98393,9624,47403,6330,88769,5215,2568,2647
63495,98399,9624,47408,6330,88774,5216,2569,2647
63500,98410,9625,47415,6331,88785,5216,2569,2647
63505,98414,9625,47417,6331,88789,5216,2569,2647
63510,98424,9626,47422,6331,88798,5216,2569,2647
63515,98430,9626,47422,6331,88804,5217,2569,2648
63520,98441,9626,47427,6331,88815,5217,2569,2648
63525,98445,9626,47430,6331,88819,5217,2569,2648
63530,98455,9627,47435,6331,88828,5217,2569,2648
63535,98461,9627,47438,6331,88833,5219,2569,2650
63540,98472,9631,47445,6335,88841,5220,2569,2651
63545,98476,9631,47447,6335,88845,5220,2569,2651
63550,98486,9633,47451,6335,88853,5220,2569,2651
63555,98492,9633,47453,6335,88859,5221,2569,2652
63560,98503,9636,47458,6338,88867,5222,2569,2653
63565,98507,9636,47461,6338,88871,5222,2569,2653
63570,98517,9638,47468,6340,88879,5222,2569,2653
63575,98523,9638,47470,6340,88884,5222,2569,2653
63580,98534,9641,47476,6342,88893,5223,2570,2653
63585,98538,9641,47477,6342,88897,5223,2570,2653
63590,98548,9643,47481,6343,88905,5223,2570,2653
63595,98554,9643,47484,6343,88910,5223,2570,2653
63600,98565,9646,47491,6346,88919,5224,2570,2654
63605,98569,9646,47493,6346,88923,5224,2570,2654
63610,98579,9648,47499,6348,88931,5224,2570,2654
63615,98585,9648,47502,6348,88936,5224,2570,2654
63620,98596,9652,47505,6351,88944,5224,2570,2654
63625,98600,9652,47505,6351,88948,5224,2570,2654
63630,98610,9654,47510,6352,88956,5224,2570,2654
63635,98616,9654,47512,6352,88962,5224,2570,2654
63640,98627,9656,47518,6354,88971,5224,2570,2654
63645,98631,9656,47519,6354,88975,5224,2570,2654
63650,98641,9658,47522,6355,88983,5224,2570,2654
63655,98647,9658,47525,6355,88989,5225,2570,2655
63660,98658,9660,47529,6356,88998,5225,2570,2655
63665,98662,9660,47531,6356,89002,5225,2570,2655
63670,98672,9661,47538,6357,89011,5225,2570,2655
63675,98678,9661,47540,6357,89017,5225,2570,2655
63680,98689,9661,47545,6357,89028,5225,2570,2655
63685,98693,9661,47547,6357,89032,5225,2570,2655
63690,98703,9662,47553,6358,89041,5225,2570,2655
63695,98709,9662,47557,6358,89046,5225,2570,2655
63700,98720,9663,47564,6359,89057,5225,2570,2655
63705,98724,9663,47565,6359,89061,5225,2570,2655
63710,98734,9664,47571,6360,89070,5225,2570,2655
63715,98740,9664,47573,6360,89075,5225,2570,2655
63720,98751,9665,47580,6361,89086,5225,2570,2655
63725,98755,9665,47581,6361,89090,5225,2570,2655
63730,98765,9666,47586,6362,89099,5225,2570,2655
63735,98771,9666,47587,6362,89105,5225,2570,2655
63740,98782,9666,47593,6362,89116,5225,2570,2655
63745,98786,9666,47594,6362,89120,5225,2570,2655
63750,98796,9667,47595,6363,89129,5225,2570,2655
63755,98802,9667,47599,6363,89135,5225,2570,2655
63760,98813,9667,47603,6363,89146,5225,2570,2655
63765,98817,9667,47605,6363,89150,5225,2570,2655
63770,98827,9669,47608,6363,89158,5225,2570,2655
63775,98833,9669,47611,6363,89163,5226,2570,2656
63780,98844,9672,47613,6365,89172,5226,2570,2656
63785,98848,9672,47615,6365,89176,5226,2570,2656
63790,98858,9674,47620,6367,89184,5226,2570,2656
63795,98864,9674,47625,6367,89189,5227,2571,2656
63800,98875,9678,47630,6371,89197,5227,2571,2656
63805,98879,9678,47633,6371,89201,5227,2571,2656
63810,98889,9680,47636,6372,89209,5227,2571,2656
63815,98895,9680,47639,6372,89214,5227,2571,2656
63820,98906,9683,47645,6374,89223,5227,2571,2656
63825,98910,9683,47647,6374,89227,5227,2571,2656
63830,98920,9685,47653,6375,89235,5227,2571,2656
63835,98926,9685,47655,6375,89241,5227,2571,2656
63840,98937,9687,47659,6377,89250,5227,2571,2656
63845,98941,9687,47662,6377,89254,5227,2571,2656
63850,98951,9689,47667,6379,89262,5227,2571,2656
63855,98957,9689,47669,6379,89268,5227,2571,2656
63860,98968,9692,47674,6381,89276,5227,2571,2656
63865,98972,9692,47674,6381,89280,5227,2571,2656
63870,98982,9694,47679,6382,89288,5227,2571,2656
63875,98988,9694,47683,6382,89294,5227,2571,2656
63880,98999,9695,47686,6382,89304,5227,2571,2656
63885,99003,9695,47687,6382,89308,5227,2571,2656
63890,99013,9697,47692,6382,89316,5227,2571,2656
63895,99019,9697,47692,6382,89322,5227,2571,2656
63900,99030,9700,47700,6385,89330,5227,2571,2656
63905,99034,9701,47703,6386,89333,5227,2571,2656
63910,99044,9703,47709,6387,89341,5227,2571,2656
63915,99050,9703,47711,6387,89347,5228,2571,2657
63920,99061,9706,47717,6389,89355,5228,2571,2657
63925,99065,9706,47719,6389,89359,5228,2571,2657
63930,99075,9708,47722,6390,89367,5228,2571,2657
63935,99081,9708,47724,6390,89373,5228,2571,2657
63940,99092,9709,47729,6390,89383,5228,2571,2657
63945,99096,9710,47730,6391,89386,5228,2571,2657
63950,99106,9712,47732,6391,89394,5228,2571,2657
63955,99112,9712,47733,6391,89400,5228,2571,2657
63960,99123,9715,47740,6394,89408,5228,2571,2657
63965,99127,9715,47741,6394,89412,5228,2571,2657
63970,99137,9716,47746,6394,89421,5228,2571,2657
63975,99143,9716,47749,6394,89427,5228,2571,2657
63980,99154,9717,47755,6394,89437,5228,2571,2657
63985,99158,9718,47758,6395,89440,5228,2571,2657
63990,99168,9719,47767,6395,89449,5228,2571,2657
63995,99174,9719,47769,6395,89455,5228,2571,2657
64000,99185,9720,47773,6395,89465,5228,2571,2657
64005,99189,9720,47774,6395,89469,5228,2571,2657
64010,99199,9721,47781,6396,89478,5228,2571,2657
64015,99205,9721,47785,6396,89483,5228,2571,2657
64020,99216,9724,47788,6398,89492,5228,2571,2657
64025,99220,9725,47791,6399,89495,5228,2571,2657
64030,99230,9726,47797,6399,89504,5228,2571,2657
64035,99236,9726,47802,6399,89509,5229,2572,2657
64040,99247,9727,47809,6400,89520,5229,2572,2657
64045,99251,9727,47810,6400,89524,5229,2572,2657
64050,99261,9728,47816,6401,89533,5229,2572,2657
64055,99267,9728,47819,6401,89538,5230,2573,2657
64060,99278,9729,47822,6402,89549,5230,2573,2657
64065,99282,9729,47824,6402,89553,5230,2573,2657
64070,99292,9730,47829,6403,89562,5230,2573,2657
64075,99298,9730,47833,6403,89567,5230,2573,2657
64080,99309,9731,47840,6404,89578,5230,2573,2657
64085,99313,9731,47843,6404,89582,5230,2573,2657
64090,99323,9732,47849,6404,89591,5230,2573,2657
64095,99329,9732,47854,6404,89596,5230,2573,2657
64100,99340,9733,47862,6405,89607,5230,2573,2657
64105,99344,9733,47863,6405,89611,5230,2573,2657
64110,99354,9734,47867,6406,89620,5230,2573,2657
64115,99360,9734,47870,6406,89626,5230,2573,2657
64120,99371,9734,47875,6406,89637,5230,2573,2657
64125,99375,9734,47876,6406,89641,5230,2573,2657
64130,99385,9735,47879,6406,89650,5230,2573,2657
64135,99391,9735,47883,6406,89656,5230,2573,2657
64140,99402,9737,47888,6407,89665,5230,2573,2657
64145,99406,9737,47890,6407,89669,5230,2573,2657
64150,99416,9738,47894,6407,89678,5230,2573,2657
64155,99422,9738,47896,6407,89684,5230,2573,2657
64160,99433,9739,47902,6407,89694,5230,2573,2657
64165,99437,9739,47904,6407,89698,5230,2573,2657
64170,99447,9740,47910,6408,89707,5230,2573,2657
64175,99453,9740,47912,6408,89713,5230,2573,2657
64180,99464,9741,47918,6408,89723,5230,2573,2657
64185,99468,9741,47921,6408,89727,5230,2573,2657
64190,99478,9742,47925,6409,89736,5230,2573,2657
64195,99484,9742,47929,6409,89742,5230,2573,2657
64200,99495,9743,47933,6410,89752,5230,2573,2657
64205,99499,9743,47934,6410,89756,5230,2573,2657
64210,99509,9744,47939,6411,89765,5230,2573,2657
64215,99515,9744,47943,6411,89770,5230,2573,2657
64220,99526,9746,47947,6412,89780,5230,2573,2657
64225,99530,9746,47948,6412,89784,5230,2573,2657
64230,99540,9747,47953,6412,89793,5230,2573,2657
64235,99546,9747,47956,6412,89798,5230,2573,2657
64240,99557,9749,47960,6413,89808,5230,2573,2657
64245,99561,9749,47962,6413,89812,5230,2573,2657
64250,99571,9750,47965,6413,89821,5230,2573,2657
64255,99577,9750,47969,6413,89827,5230,2573,2657
64260,99588,9752,47973,6414,89836,5230,2573,2657
64265,99592,9752,47976,6414,89840,5230,2573,2657
64270,99602,9753,47979,6414,89849,5230,2573,2657
64275,99608,9753,47981,6414,89854,5230,2573,2657
64280,99619,9756,47985,6416,89863,5230,2573,2657
64285,99623,9756,47986,6416,89867,5230,2573,2657
64290,99633,9757,47993,6416,89876,5230,2573,2657
64295,99639,9757,47995,6416,89882,5230,2573,2657
64300,99650,9758,48001,6416,89892,5230,2573,2657
64305,99654,9758,48002,6416,89896,5230,2573,2657
64310,99664,9759,48006,6416,89905,5230,2573,2657
64315,99670,9759,48010,6416,89910,5230,2573,2657
64320,99681,9763,48017,6420,89918,5230,2573,2657
64325,99685,9763,48019,6420,89922,5230,2573,2657
64330,99695,9764,48025,6421,89931,5230,2573,2657
64335,99701,9764,48026,6421,89936,5230,2573,2657
64340,99712,9767,48034,6424,89945,5230,2573,2657
64345,99716,9767,48037,6424,89949,5230,2573,2657
64350,99726,9768,48041,6425,89958,5230,2573,2657
64355,99732,9768,48044,6425,89963,5230,2573,2657
64360,99743,9771,48049,6427,89972,5230,2573,2657
64365,99747,9771,48050,6427,89976,5230,2573,2657
64370,99757,9772,48053,6427,89985,5230,2573,2657
64375,99763,9772,48057,6427,89990,5230,2573,2657
64380,99774,9774,48065,6428,90000,5230,2573,2657
64385,99778,9774,48068,6428,90004,5230,2573,2657
64390,99788,9775,48073,6429,90013,5230,2573,2657
64395,99794,9775,48074,6429,90019,5230,2573,2657
64400,99805,9776,48078,6430,90029,5230,2573,2657
64405,99809,9776,48081,6430,90033,5230,2573,2657
64410,99819,9777,48086,6431,90042,5230,2573,2657
64415,99825,9777,48089,6431,90047,5230,2573,2657
64420,99836,9780,48095,6433,90056,5230,2573,2657
64425,99840,9780,48097,6433,90060,5230,2573,2657
64430,99850,9781,48103,6434,90069,5230,2573,2657
64435,99856,9781,48105,6434,90075,5230,2573,2657
64440,99867,9783,48112,6436,90084,5230,2573,2657
64445,99871,9783,48114,6436,90088,5230,2573,2657
64450,99881,9784,48120,6437,90097,5230,2573,2657
64455,99887,9784,48122,6437,90103,5230,2573,2657
64460,99898,9786,48125,6438,90112,5230,2573,2657
64465,99902,9786,48127,6438,90116,5230,2573,2657
64470,99912,9787,48129,6438,90125,5230,2573,2657
64475,99918,9787,48130,6438,90131,5230,2573,2657
64480,99929,9788,48133,6439,90141,5230,2573,2657
64485,99933,9788,48133,6439,90145,5230,2573,2657
64490,99943,9789,48136,6439,90154,5230,2573,2657
64495,99949,9789,48137,6439,90160,5231,2574,2657
64500,99960,9790,48143,6440,90170,5231,2574,2657
64505,99964,9790,48146,6440,90174,5231,2574,2657
64510,99974,9791,48150,6440,90183,5231,2574,2657
64515,99980,9791,48152,6440,90189,5232,2574,2658
64520,99991,9793,48157,6441,90198,5232,2574,2658
64525,99995,9793,48160,6441,90202,5232,2574,2658
64530,100005,9794,48165,6441,90211,5232,2574,2658
64535,100011,9794,48167,6441,90216,5232,2574,2658
64540,100022,9797,48171,6443,90225,5232,2574,2658
64545,100026,9797,48173,6443,90229,5232,2574,2658
64550,100036,9798,48180,6444,90238,5232,2574,2658
64555,100042,9798,48183,6444,90243,5232,2574,2658
64560,100053,9801,48186,6446,90252,5232,2574,2658
64565,100057,9801,48186,6446,90256,5232,2574,2658
64570,100067,9802,48192,6446,90265,5232,2574,2658
64575,100073,9802,48193,6446,90271,5232,2574,2658
64580,100084,9804,48198,6448,90280,5232,2574,2658
64585,100088,9804,48200,6448,90284,5232,2574,2658
64590,100098,9805,48204,6448,90293,5232,2574,2658
64595,100104,9805,48208,6448,90298,5232,2574,2658
64600,100115,9807,48216,6450,90308,5232,2574,2658
64605,100119,9807,48218,6450,90312,5232,2574,2658
64610,100129,9808,48224,6450,90321,5232,2574,2658
64615,100135,9808,48228,6450,90327,5232,2574,2658
64620,100146,9811,48235,6452,90335,5232,2574,2658
64625,100150,9811,48237,6452,90339,5232,2574,2658
64630,100160,9812,48241,6452,90348,5232,2574,2658
64635,100166,9812,48244,6452,90353,5233,2575,2658
64640,100177,9815,48249,6454,90362,5233,2575,2658
64645,100181,9815,48252,6454,90366,5233,2575,2658
64650,100191,9816,48259,6455,90375,5233,2575,2658
64655,100197,9816,48263,6455,90380,5233,2575,2658
64660,100208,9819,48267,6458,90389,5233,2575,2658
64665,100212,9819,48268,6458,90393,5233,2575,2658
64670,100222,9820,48272,6458,90402,5233,2575,2658
64675,100228,9820,48274,6458,90407,5233,2575,2658
64680,100239,9823,48278,6460,90416,5233,2575,2658
64685,100243,9823,48278,6460,90420,5233,2575,2658
64690,100253,9824,48283,6461,90429,5233,2575,2658
64695,100259,9824,48286,6461,90435,5233,2575,2658
64700,100270,9825,48290,6461,90445,5233,2575,2658
64705,100274,9825,48291,6461,90449,5233,2575,2658
64710,100284,9826,48296,6462,90458,5233,2575,2658
64715,100290,9826,48299,6462,90464,5233,2575,2658
64720,100301,9827,48305,6463,90474,5233,2575,2658
64725,100305,9827,48309,6463,90478,5233,2575,2658
64730,100315,9828,48312,6464,90487,5233,2575,2658
64735,100321,9828,48316,6464,90492,5233,2575,2658
64740,100332,9830,48321,6465,90502,5233,2575,2658
64745,100336,9830,48323,6465,90506,5233,2575,2658
64750,100346,9831,48328,6466,90515,5233,2575,2658
64755,100352,9831,48329,6466,90521,5233,2575,2658
64760,100363,9832,48332,6467,90531,5233,2575,2658
64765,100367,9832,48333,6467,90535,5233,2575,2658
64770,100377,9833,48338,6468,90544,5233,2575,2658
64775,100383,9833,48339,6468,90550,5233,2575,2658
64780,100394,9835,48344,6470,90559,5233,2575,2658
64785,100398,9835,48345,6470,90563,5233,2575,2658
64790,100408,9836,48351,6470,90572,5233,2575,2658
64795,100414,9836,48355,6470,90577,5234,2576,2658
64800,100425,9839,48362,6473,90586,5234,2576,2658
64805,100429,9839,48364,6473,90590,5234,2576,2658
64810,100439,9840,48370,6474,90599,5234,2576,2658
64815,100445,9840,48374,6474,90605,5234,2576,2658
64820,100456,9841,48380,6475,90615,5234,2576,2658
64825,100460,9841,48381,6475,90619,5234,2576,2658
64830,100470,9842,48388,6476,90628,5234,2576,2658
64835,100476,9842,48389,6476,90634,5234,2576,2658
64840,100487,9845,48396,6479,90642,5234,2576,2658
64845,100491,9845,48398,6479,90646,5234,2576,2658
64850,100501,9846,48399,6479,90655,5234,2576,2658
64855,100507,9846,48404,6479,90661,5234,2576,2658
64860,100518,9847,48407,6479,90671,5234,2576,2658
64865,100522,9847,48410,6479,90675,5234,2576,2658
64870,100532,9848,48415,6479,90684,5234,2576,2658
64875,100538,9848,48418,6479,90689,5234,2576,2658
64880,100549,9851,48425,6481,90698,5234,2576,2658
64885,100553,9851,48428,6481,90702,5234,2576,2658
64890,100563,9852,48435,6482,90711,5234,2576,2658
64895,100569,9852,48438,6482,90716,5234,2576,2658
64900,100580,9855,48444,6485,90725,5234,2576,2658
64905,100584,9855,48446,6485,90729,5234,2576,2658
64910,100594,9856,48451,6486,90738,5234,2576,2658
64915,100600,9856,48454,6486,90744,5235,2577,2658
64920,100611,9857,48458,6487,90754,5235,2577,2658
64925,100615,9857,48459,6487,90758,5235,2577,2658
64930,100625,9858,48462,6488,90767,5235,2577,2658
64935,100631,9858,48465,6488,90773,5236,2578,2658
64940,100642,9860,48468,6490,90782,5236,2578,2658
64945,100646,9860,48469,6490,90786,5236,2578,2658
64950,100656,9861,48475,6490,90795,5236,2578,2658
64955,100662,9861,48478,6490,90800,5236,2578,2658
64960,100673,9864,48485,6493,90809,5236,2578,2658
64965,100677,9864,48487,6493,90813,5236,2578,2658
64970,100687,9865,48493,6494,90822,5236,2578,2658
64975,100693,9865,48495,6494,90827,5236,2578,2658
64980,100704,9867,48499,6496,90837,5236,2578,2658
64985,100708,9867,48500,6496,90841,5236,2578,2658
64990,100718,9868,48504,6497,90850,5236,2578,2658
64995,100724,9868,48506,6497,90856,5236,2578,2658
65000,100735,9870,48509,6498,90865,5236,2578,2658
65005,100739,9870,48511,6498,90869,5236,2578,2658
65010,100749,9871,48518,6498,90878,5236,2578,2658
65015,100755,9871,48519,6498,90884,5236,2578,2658
65020,100766,9873,48523,6499,90893,5236,2578,2658
65025,100770,9873,48524,6499,90897,5236,2578,2658
65030,100780,9874,48530,6499,90906,5236,2578,2658
65035,100786,9874,48531,6499,90912,5236,2578,2658
65040,100797,9876,48535,6500,90921,5236,2578,2658
65045,100801,9876,48537,6500,90925,5236,2578,2658
65050,100811,9877,48542,6501,90934,5236,2578,2658
65055,100817,9877,48544,6501,90939,5237,2579,2658
65060,100828,9879,48547,6502,90949,5237,2579,2658
65065,100832,9879,48548,6502,90953,5237,2579,2658
65070,100842,9880,48552,6502,90962,5237,2579,2658
65075,100848,9880,48555,6502,90967,5237,2579,2658
65080,100859,9882,48559,6503,90977,5237,2579,2658
65085,100863,9882,48562,6503,90981,5237,2579,2658
65090,100873,9883,48566,6503,90990,5237,2579,2658
65095,100879,9883,48567,6503,90996,5237,2579,2658
65100,100890,9885,48571,6504,91005,5237,2579,2658
65105,100894,9885,48573,6504,91009,5237,2579,2658
65110,100904,9886,48575,6504,91018,5237,2579,2658
65115,100910,9886,48578,6504,91024,5237,2579,2658
65120,100921,9887,48586,6504,91034,5237,2579,2658
65125,100925,9887,48588,6504,91038,5237,2579,2658
65130,100935,9888,48593,6504,91047,5237,2579,2658
65135,100941,9888,48596,6504,91053,5237,2579,2658
65140,100952,9890,48603,6505,91062,5237,2579,2658
65145,100956,9890,48606,6505,91066,5237,2579,2658
65150,100966,9891,48610,6506,91075,5237,2579,2658
65155,100972,9891,48613,6506,91080,5237,2579,2658
65160,100983,9894,48617,6508,91089,5237,2579,2658
65165,100987,9894,48619,6508,91093,5237,2579,2658
65170,100997,9895,48624,6508,91102,5237,2579,2658
65175,101003,9895,48627,6508,91107,5238,2579,2659
65180,101014,9897,48633,6510,91117,5238,2579,2659
65185,101018,9897,48636,6510,91121,5238,2579,2659
65190,101028,9898,48640,6510,91130,5238,2579,2659
65195,101034,9898,48645,6510,91135,5239,2580,2659
65200,101045,9900,48649,6512,91145,5239,2580,2659
65205,101049,9900,48652,6512,91149,5239,2580,2659
65210,101059,9901,48656,6513,91158,5239,2580,2659
65215,101065,9901,48657,6513,91163,5239,2580,2659
65220,101076,9904,48665,6516,91172,5239,2580,2659
65225,101080,9904,48665,6516,91176,5239,2580,2659
65230,101090,9905,48670,6516,91185,5239,2580,2659
65235,101096,9905,48671,6516,91191,5239,2580,2659
65240,101107,9907,48675,6517,91200,5239,2580,2659
65245,101111,9907,48677,6517,91204,5239,2580,2659
65250,101121,9908,48682,6517,91213,5239,2580,2659
65255,101127,9908,48683,6517,91219,5239,2580,2659
65260,101138,9910,48687,6518,91228,5239,2580,2659
65265,101142,9910,48690,6518,91232,5239,2580,2659
65270,101152,9911,48694,6518,91241,5239,2580,2659
65275,101158,9911,48695,6518,91247,5239,2580,2659
65280,101169,9914,48699,6520,91255,5239,2580,2659
65285,101173,9914,48700,6520,91259,5239,2580,2659
65290,101183,9915,48704,6520,91268,5239,2580,2659
65295,101189,9915,48708,6520,91274,5239,2580,2659
65300,101200,9917,48714,6521,91283,5239,2580,2659
65305,101204,9917,48716,6521,91287,5239,2580,2659
65310,101214,9918,48722,6521,91296,5239,2580,2659
65315,101220,9918,48726,6521,91302,5240,2581,2659
65320,101231,9920,48733,6523,91311,5240,2581,2659
65325,101235,9920,48735,6523,91315,5240,2581,2659
65330,101245,9921,48742,6524,91324,5240,2581,2659
65335,101251,9921,48746,6524,91330,5241,2582,2659
65340,101262,9923,48750,6526,91339,5241,2582,2659
65345,101266,9923,48753,6526,91343,5241,2582,2659
65350,101276,9924,48756,6527,91352,5241,2582,2659
65355,101282,9924,48759,6527,91358,5242,2583,2659
65360,101293,9926,48764,6529,91367,5242,2583,2659
65365,101297,9926,48766,6529,91371,5242,2583,2659
65370,101307,9927,48773,6530,91380,5242,2583,2659
65375,101313,9927,48776,6530,91386,5243,2583,2660
65380,101324,9929,48782,6532,91395,5243,2583,2660
65385,101328,9929,48785,6532,91399,5243,2583,2660
65390,101338,9930,48789,6533,91408,5243,2583,2660
65395,101344,9930,48793,6533,91413,5243,2583,2660
65400,101355,9933,48797,6535,91422,5243,2583,2660
65405,101359,9933,48799,6535,91426,5243,2583,2660
65410,101369,9934,48805,6535,91435,5243,2583,2660
65415,101375,9934,48808,6535,91440,5243,2583,2660
65420,101386,9936,48810,6536,91450,5243,2583,2660
65425,101390,9936,48811,6536,91454,5243,2583,2660
65430,101400,9937,48817,6537,91463,5243,2583,2660
65435,101406,9937,48818,6537,91469,5243,2583,2660
65440,101417,9939,48825,6538,91478,5243,2583,2660
65445,101421,9939,48827,6538,91482,5243,2583,2660
65450,101431,9940,48831,6538,91491,5243,2583,2660
65455,101437,9940,48833,6538,91497,5243,2583,2660
65460,101448,9942,48840,6540,91506,5243,2583,2660
65465,101452,9942,48842,6540,91510,5243,2583,2660
65470,101462,9943,48846,6541,91519,5243,2583,2660
65475,101468,9943,48848,6541,91525,5243,2583,2660
65480,101479,9945,48853,6542,91534,5243,2583,2660
65485,101483,9945,48854,6542,91538,5243,2583,2660
65490,101493,9946,48860,6542,91547,5243,2583,2660
65495,101499,9946,48865,6542,91553,5243,2583,2660
65500,101510,9948,48870,6544,91562,5243,2583,2660
65505,101514,9948,48872,6544,91566,5243,2583,2660
65510,101524,9949,48876,6545,91575,5243,2583,2660
65515,101530,9949,48881,6545,91580,5244,2583,2661
65520,101541,9952,48888,6548,91589,5244,2583,2661
65525,101545,9952,48889,6548,91593,5244,2583,2661
65530,101555,9953,48893,6548,91602,5244,2583,2661
65535,101561,9953,48896,6548,91608,5245,2584,2661
65540,101572,9955,48906,6550,91617,5245,2584,2661
65545,101576,9955,48909,6550,91621,5245,2584,2661
65550,101586,9956,48914,6551,91630,5245,2584,2661
65555,101592,9956,48915,6551,91636,5245,2584,2661
65560,101603,9958,48919,6552,91645,5245,2584,2661
65565,101607,9958,48920,6552,91649,5245,2584,2661
65570,101617,9959,48922,6552,91658,5245,2584,2661
65575,101623,9959,48925,6552,91663,5245,2584,2661
65580,101634,9963,48931,6555,91671,5245,2584,2661
65585,101638,9963,48931,6555,91675,5245,2584,2661
65590,101648,9964,48935,6555,91684,5245,2584,2661
65595,101654,9964,48939,6555,91690,5245,2584,2661
65600,101665,9967,48946,6557,91698,5245,2584,2661
65605,101669,9967,48948,6557,91702,5245,2584,2661
65610,101679,9968,48952,6558,91711,5245,2584,2661
65615,101685,9968,48954,6558,91717,5245,2584,2661
65620,101696,9970,48958,6560,91726,5245,2584,2661
65625,101700,9970,48961,6560,91730,5245,2584,2661
65630,101710,9971,48965,6560,91739,5245,2584,2661
65635,101716,9971,48970,6560,91744,5245,2584,2661
65640,101727,9974,48976,6562,91753,5245,2584,2661
65645,101731,9974,48978,6562,91757,5245,2584,2661
65650,101741,9975,48984,6563,91766,5245,2584,2661
65655,101747,9975,48987,6563,91772,5245,2584,2661
65660,101758,9977,48994,6565,91781,5245,2584,2661
65665,101762,9977,48994,6565,91785,5245,2584,2661
65670,101772,9978,48996,6566,91794,5245,2584,2661
65675,101778,9978,49000,6566,91800,5245,2584,2661
65680,101789,9980,49007,6567,91809,5245,2584,2661
65685,101793,9980,49009,6567,91813,5245,2584,2661
65690,101803,9981,49016,6568,91822,5245,2584,2661
65695,101809,9981,49020,6568,91828,5245,2584,2661
65700,101820,9982,49026,6569,91838,5245,2584,2661
65705,101824,9982,49028,6569,91842,5245,2584,2661
65710,101834,9983,49033,6570,91851,5245,2584,2661
65715,101840,9983,49034,6570,91857,5245,2584,2661
65720,101851,9985,49040,6572,91866,5245,2584,2661
65725,101855,9985,49043,6572,91870,5245,2584,2661
65730,101865,9986,49051,6572,91879,5245,2584,2661
65735,101871,9986,49054,6572,91885,5245,2584,2661
65740,101882,9988,49061,6574,91894,5245,2584,2661
65745,101886,9988,49061,6574,91898,5245,2584,2661
65750,101896,9989,49066,6575,91907,5245,2584,2661
65755,101902,9989,49069,6575,91912,5246,2584,2662
65760,101913,9993,49074,6578,91920,5246,2584,2662
65765,101917,9993,49076,6578,91924,5246,2584,2662
65770,101927,9994,49082,6579,91933,5246,2584,2662
65775,101933,9994,49084,6579,91938,5247,2584,2663
65780,101944,9998,49091,6582,91946,5247,2584,2663
65785,101948,9998,49093,6582,91950,5247,2584,2663
65790,101958,9999,49096,6582,91959,5247,2584,2663
65795,101964,9999,49099,6582,91965,5247,2584,2663
65800,101975,10001,49105,6583,91974,5247,2584,2663
65805,101979,10001,49108,6583,91978,5247,2584,2663
65810,101989,10002,49114,6584,91987,5247,2584,2663
65815,101995,10002,49117,6584,91993,5247,2584,2663
65820,102006,10005,49126,6587,92001,5247,2584,2663
65825,102010,10005,49128,6587,92005,5247,2584,2663
65830,102020,10006,49136,6588,92014,5247,2584,2663
65835,102026,10006,49138,6588,92019,5247,2584,2663
65840,102037,10009,49145,6591,92028,5247,2584,2663
65845,102041,10009,49148,6591,92032,5247,2584,2663
65850,102051,10010,49149,6591,92041,5247,2584,2663
65855,102057,10010,49150,6591,92047,5247,2584,2663
65860,102068,10011,49153,6591,92057,5247,2584,2663
65865,102072,10011,49154,6591,92061,5247,2584,2663
65870,102082,10012,49161,6592,92070,5247,2584,2663
65875,102088,10012,49162,6592,92076,5247,2584,2663
65880,102099,10014,49165,6594,92085,5247,2584,2663
65885,102103,10014,49165,6594,92089,5247,2584,2663
65890,102113,10015,49167,6594,92098,5247,2584,2663
65895,102119,10015,49169,6594,92104,5248,2584,2664
65900,102130,10017,49173,6595,92113,5248,2584,2664
65905,102134,10017,49175,6595,92117,5248,2584,2664
65910,102144,10018,49183,6595,92126,5248,2584,2664
65915,102150,10018,49185,6595,92131,5249,2584,2665
65920,102161,10021,49189,6598,92140,5249,2584,2665
65925,102165,10021,49191,6598,92144,5249,2584,2665
65930,102175,10022,49195,6599,92153,5249,2584,2665
65935,102181,10022,49197,6599,92159,5249,2584,2665
65940,102192,10023,49203,6600,92169,5249,2584,2665
65945,102196,10023,49204,6600,92173,5249,2584,2665
65950,102206,10024,49212,6601,92182,5249,2584,2665
65955,102212,10024,49213,6601,92188,5249,2584,2665
65960,102223,10025,49219,6602,92198,5249,2584,2665
65965,102227,10025,49221,6602,92202,5249,2584,2665
65970,102237,10026,49224,6602,92211,5249,2584,2665
65975,102243,10026,49225,6602,92217,5249,2584,2665
65980,102254,10028,49231,6603,92226,5249,2584,2665
65985,102258,10028,49232,6603,92230,5249,2584,2665
65990,102268,10029,49236,6603,92239,5249,2584,2665
65995,102274,10029,49237,6603,92245,5249,2584,2665
66000,102285,10031,49239,6605,92254,5249,2584,2665
66005,102289,10031,49241,6605,92258,5249,2584,2665
66010,102299,10032,49245,6606,92267,5249,2584,2665
66015,102305,10032,49247,6606,92272,5249,2584,2665
66020,102316,10035,49251,6608,92281,5249,2584,2665
66025,102320,10035,49251,6608,92285,5249,2584,2665
66030,102330,10036,49258,6608,92294,5249,2584,2665
66035,102336,10036,49260,6608,92300,5250,2584,2666
66040,102347,10038,49267,6609,92309,5250,2584,2666
66045,102351,10038,49269,6609,92313,5250,2584,2666
66050,102361,10039,49274,6610,92322,5250,2584,2666
66055,102367,10039,49277,6610,92327,5250,2584,2666
66060,102378,10041,49282,6612,92337,5250,2584,2666
66065,102382,10041,49284,6612,92341,5250,2584,2666
66070,102392,10042,49288,6612,92350,5250,2584,2666
66075,102398,10042,49291,6612,92356,5250,2584,2666
66080,102409,10044,49294,6613,92365,5250,2584,2666
66085,102413,10044,49297,6613,92369,5250,2584,2666
66090,102423,10045,49304,6614,92378,5250,2584,2666
66095,102429,10045,49309,6614,92383,5250,2584,2666
66100,102440,10048,49314,6616,92392,5250,2584,2666
66105,102444,10048,49315,6616,92396,5250,2584,2666
66110,102454,10049,49322,6617,92405,5250,2584,2666
66115,102460,10049,49325,6617,92410,5250,2584,2666
66120,102471,10052,49331,6619,92419,5250,2584,2666
66125,102475,10052,49333,6619,92423,5250,2584,2666
66130,102485,10053,49336,6619,92432,5250,2584,2666
66135,102491,10053,49339,6619,92437,5250,2584,2666
66140,102502,10056,49347,6622,92446,5250,2584,2666
66145,102506,10056,49347,6622,92450,5250,2584,2666
66150,102516,10057,49350,6622,92459,5250,2584,2666
66155,102522,10057,49351,6622,92465,5251,2584,2667
66160,102533,10059,49359,6624,92474,5251,2584,2667
66165,102537,10059,49362,6624,92478,5251,2584,2667
66170,102547,10060,49368,6625,92487,5251,2584,2667
66175,102553,10060,49370,6625,92493,5252,2584,2668
66180,102564,10061,49374,6626,92503,5252,2584,2668
66185,102568,10061,49376,6626,92507,5252,2584,2668
66190,102578,10062,49383,6626,92516,5252,2584,2668
66195,102584,10062,49384,6626,92522,5252,2584,2668
66200,102595,10063,49390,6627,92532,5252,2584,2668
66205,102599,10063,49391,6627,92536,5252,2584,2668
66210,102609,10064,49398,6628,92545,5252,2584,2668
66215,102615,10064,49400,6628,92551,5252,2584,2668
66220,102626,10065,49402,6628,92561,5252,2584,2668
66225,102630,10065,49402,6628,92565,5252,2584,2668
66230,102640,10066,49408,6629,92574,5252,2584,2668
66235,102646,10066,49410,6629,92580,5252,2584,2668
66240,102657,10069,49417,6632,92588,5252,2584,2668
66245,102661,10069,49420,6632,92592,5252,2584,2668
66250,102671,10070,49423,6633,92601,5252,2584,2668
66255,102677,10070,49429,6633,92606,5252,2584,2668
66260,102688,10073,49436,6636,92615,5252,2584,2668
66265,102692,10073,49438,6636,92619,5252,2584,2668
66270,102702,10074,49442,6637,92628,5252,2584,2668
66275,102708,10074,49444,6637,92634,5252,2584,2668
66280,102719,10076,49448,6638,92643,5252,2584,2668
66285,102723,10076,49450,6638,92647,5252,2584,2668
66290,102733,10077,49456,6639,92656,5252,2584,2668
66295,102739,10077,49457,6639,92662,5253,2584,2669
66300,102750,10080,49463,6642,92670,5253,2584,2669
66305,102754,10080,49465,6642,92674,5253,2584,2669
66310,102764,10081,49470,6642,92683,5253,2584,2669
66315,102770,10081,49473,6642,92689,5253,2584,2669
66320,102781,10083,49481,6644,92698,5253,2584,2669
66325,102785,10083,49484,6644,92702,5253,2584,2669
66330,102795,10084,49491,6645,92711,5253,2584,2669
66335,102801,10084,49492,6645,92717,5253,2584,2669
66340,102812,10087,49498,6648,92725,5253,2584,2669
66345,102816,10087,49499,6648,92729,5253,2584,2669
66350,102826,10088,49507,6649,92738,5253,2584,2669
66355,102832,10088,49508,6649,92744,5253,2584,2669
66360,102843,10090,49514,6651,92753,5253,2584,2669
66365,102847,10090,49517,6651,92757,5253,2584,2669
66370,102857,10091,49522,6652,92766,5253,2584,2669
66375,102863,10091,49528,6652,92771,5253,2584,2669
66380,102874,10093,49535,6654,92781,5253,2584,2669
66385,102878,10093,49538,6654,92785,5253,2584,2669
66390,102888,10094,49543,6654,92794,5253,2584,2669
66395,102894,10094,49546,6654,92799,5253,2584,2669
66400,102905,10096,49550,6655,92809,5253,2584,2669
66405,102909,10096,49551,6655,92813,5253,2584,2669
66410,102919,10097,49557,6656,92822,5253,2584,2669
66415,102925,10097,49560,6656,92828,5254,2584,2670
66420,102936,10098,49565,6657,92838,5254,2584,2670
66425,102940,10098,49567,6657,92842,5254,2584,2670
66430,102950,10099,49573,6658,92851,5254,2584,2670
66435,102956,10099,49574,6658,92857,5254,2584,2670
66440,102967,10100,49580,6658,92867,5254,2584,2670
66445,102971,10100,49583,6658,92871,5254,2584,2670
66450,102981,10101,49585,6658,92880,5254,2584,2670
66455,102987,10101,49589,6658,92885,5254,2584,2670
66460,102998,10103,49593,6659,92895,5254,2584,2670
66465,103002,10103,49593,6659,92899,5254,2584,2670
66470,103012,10104,49596,6659,92908,5254,2584,2670
66475,103018,10104,49600,6659,92913,5254,2584,2670
66480,103029,10107,49604,6661,92922,5254,2584,2670
66485,103033,10107,49604,6661,92926,5254,2584,2670
66490,103043,10108,49608,6662,92935,5254,2584,2670
66495,103049,10108,49614,6662,92940,5254,2584,2670
66500,103060,10110,49619,6664,92950,5254,2584,2670
66505,103064,10110,49622,6664,92954,5254,2584,2670
66510,103074,10111,49626,6664,92963,5254,2584,2670
66515,103080,10111,49630,6664,92968,5254,2584,2670
66520,103091,10115,49635,6668,92976,5254,2584,2670
66525,103095,10115,49637,6668,92980,5254,2584,2670
66530,103105,10116,49641,6669,92989,5254,2584,2670
66535,103111,10116,49645,6669,92994,5255,2585,2670
66540,103122,10119,49649,6671,93003,5255,2585,2670
66545,103126,10119,49650,6671,93007,5255,2585,2670
66550,103136,10120,49656,6672,93016,5255,2585,2670
66555,103142,10120,49659,6672,93021,5256,2586,2670
66560,103153,10123,49665,6674,93030,5256,2586,2670
66565,103157,10123,49667,6674,93034,5256,2586,2670
66570,103167,10124,49670,6675,93043,5256,2586,2670
66575,103173,10124,49674,6675,93048,5256,2586,2670
66580,103184,10126,49680,6677,93058,5256,2586,2670
66585,103188,10126,49681,6677,93062,5256,2586,2670
66590,103198,10127,49686,6677,93071,5256,2586,2670
66595,103204,10127,49689,6677,93077,5256,2586,2670
66600,103215,10129,49693,6679,93086,5256,2586,2670
66605,103219,10129,49694,6679,93090,5256,2586,2670
66610,103229,10130,49697,6680,93099,5256,2586,2670
66615,103235,10130,49702,6680,93104,5256,2586,2670
66620,103246,10132,49708,6682,93114,5256,2586,2670
66625,103250,10132,49711,6682,93118,5256,2586,2670
66630,103260,10133,49716,6682,93127,5256,2586,2670
66635,103266,10133,49720,6682,93132,5256,2586,2670
66640,103277,10135,49725,6684,93142,5256,2586,2670
66645,103281,10135,49727,6684,93146,5256,2586,2670
66650,103291,10136,49731,6684,93155,5256,2586,2670
66655,103297,10136,49734,6684,93161,5256,2586,2670
66660,103308,10138,49742,6685,93170,5256,2586,2670
66665,103312,10138,49744,6685,93174,5256,2586,2670
66670,103322,10139,49749,6686,93183,5256,2586,2670
66675,103328,10139,49753,6686,93189,5257,2587,2670
66680,103339,10140,49757,6686,93199,5257,2587,2670
66685,103343,10140,49759,6686,93203,5257,2587,2670
66690,103353,10141,49765,6687,93212,5257,2587,2670
66695,103359,10141,49767,6687,93218,5257,2587,2670
66700,103370,10143,49775,6688,93227,5257,2587,2670
66705,103374,10143,49777,6688,93231,5257,2587,2670
66710,103384,10144,49783,6689,93240,5257,2587,2670
66715,103390,10144,49785,6689,93246,5257,2587,2670
66720,103401,10147,49790,6691,93254,5257,2587,2670
66725,103405,10147,49791,6691,93258,5257,2587,2670
66730,103415,10148,49794,6691,93267,5257,2587,2670
66735,103421,10148,49797,6691,93273,5257,2587,2670
66740,103432,10151,49803,6694,93281,5257,2587,2670
66745,103436,10151,49805,6694,93285,5257,2587,2670
66750,103446,10152,49806,6694,93294,5257,2587,2670
66755,103452,10152,49809,6694,93299,5257,2587,2670
66760,103463,10155,49818,6697,93308,5257,2587,2670
66765,103467,10155,49821,6697,93312,5257,2587,2670
66770,103477,10156,49825,6697,93321,5257,2587,2670
66775,103483,10156,49828,6697,93327,5257,2587,2670
66780,103494,10158,49831,6698,93336,5257,2587,2670
66785,103498,10158,49834,6698,93340,5257,2587,2670
66790,103508,10159,49839,6699,93349,5257,2587,2670
66795,103514,10159,49841,6699,93355,5258,2588,2670
66800,103525,10161,49847,6701,93364,5258,2588,2670
66805,103529,10161,49850,6701,93368,5258,2588,2670
66810,103539,10162,49854,6702,93377,5258,2588,2670
66815,103545,10162,49855,6702,93383,5259,2588,2671
66820,103556,10164,49861,6703,93392,5259,2588,2671
66825,103560,10164,49862,6703,93396,5259,2588,2671
66830,103570,10165,49868,6703,93405,5259,2588,2671
66835,103576,10165,49871,6703,93411,5259,2588,2671
66840,103587,10168,49876,6706,93419,5259,2588,2671
66845,103591,10168,49879,6706,93423,5259,2588,2671
66850,103601,10169,49886,6706,93432,5259,2588,2671
66855,103607,10169,49889,6706,93437,5259,2588,2671
66860,103618,10171,49894,6708,93447,5259,2588,2671
66865,103622,10171,49896,6708,93451,5259,2588,2671
66870,103632,10172,49900,6709,93460,5259,2588,2671
66875,103638,10172,49903,6709,93466,5259,2588,2671
66880,103649,10174,49906,6710,93475,5259,2588,2671
66885,103653,10174,49908,6710,93479,5259,2588,2671
66890,103663,10175,49916,6711,93488,5259,2588,2671
66895,103669,10175,49917,6711,93494,5259,2588,2671
66900,103680,10177,49922,6713,93503,5259,2588,2671
66905,103684,10177,49923,6713,93507,5259,2588,2671
66910,103694,10178,49927,6714,93516,5259,2588,2671
66915,103700,10178,49929,6714,93522,5259,2588,2671
66920,103711,10179,49934,6715,93532,5259,2588,2671
66925,103715,10179,49936,6715,93536,5259,2588,2671
66930,103725,10180,49939,6715,93545,5259,2588,2671
66935,103731,10180,49943,6715,93550,5260,2589,2671
66940,103742,10183,49948,6717,93559,5260,2589,2671
66945,103746,10183,49950,6717,93563,5260,2589,2671
66950,103756,10184,49955,6717,93572,5260,2589,2671
66955,103762,10184,49957,6717,93577,5261,2590,2671
66960,103773,10187,49964,6720,93586,5261,2590,2671
66965,103777,10187,49966,6720,93590,5261,2590,2671
66970,103787,10188,49969,6720,93599,5261,2590,2671
66975,103793,10188,49974,6720,93604,5261,2590,2671
66980,103804,10190,49978,6722,93614,5261,2590,2671
66985,103808,10190,49980,6722,93618,5261,2590,2671
66990,103818,10191,49983,6723,93627,5261,2590,2671
66995,103824,10191,49986,6723,93633,5261,2590,2671
67000,103835,10194,49993,6726,93641,5261,2590,2671
67005,103839,10194,49995,6726,93645,5261,2590,2671
67010,103849,10195,50000,6727,93654,5261,2590,2671
67015,103855,10195,50004,6727,93659,5261,2590,2671
67020,103866,10197,50009,6729,93669,5261,2590,2671
67025,103870,10197,50009,6729,93673,5261,2590,2671
67030,103880,10198,50015,6730,93682,5261,2590,2671
67035,103886,10198,50018,6730,93687,5261,2590,2671
67040,103897,10200,50022,6732,93697,5261,2590,2671
67045,103901,10200,50024,6732,93701,5261,2590,2671
67050,103911,10201,50026,6732,93710,5261,2590,2671
67055,103917,10201,50028,6732,93715,5261,2590,2671
67060,103928,10203,50031,6734,93725,5261,2590,2671
67065,103932,10203,50033,6734,93729,5261,2590,2671
67070,103942,10204,50038,6734,93738,5261,2590,2671
67075,103948,10204,50044,6734,93743,5262,2591,2671
67080,103959,10206,50053,6736,93753,5262,2591,2671
67085,103963,10206,50055,6736,93757,5262,2591,2671
67090,103973,10207,50060,6737,93766,5262,2591,2671
67095,103979,10207,50060,6737,93772,5263,2591,2672
67100,103990,10207,50066,6737,93783,5263,2591,2672
67105,103994,10207,50067,6737,93787,5263,2591,2672
67110,104004,10208,50074,6737,93796,5263,2591,2672
67115,104010,10208,50077,6737,93801,5264,2592,2672
67120,104021,10209,50085,6738,93812,5264,2592,2672
67125,104025,10209,50087,6738,93816,5264,2592,2672
67130,104035,10210,50093,6738,93825,5264,2592,2672
67135,104041,10210,50096,6738,93830,5264,2592,2672
67140,104052,10211,50102,6739,93841,5264,2592,2672
67145,104056,10211,50103,6739,93845,5264,2592,2672
67150,104066,10212,50106,6739,93854,5264,2592,2672
67155,104072,10212,50108,6739,93860,5264,2592,2672
67160,104083,10212,50114,6739,93871,5264,2592,2672
67165,104087,10212,50116,6739,93875,5264,2592,2672
67170,104097,10213,50120,6740,93884,5264,2592,2672
67175,104103,10213,50124,6740,93890,5264,2592,2672
67180,104114,10213,50129,6740,93901,5264,2592,2672
67185,104118,10213,50131,6740,93905,5264,2592,2672
67190,104128,10214,50136,6740,93914,5264,2592,2672
67195,104134,10214,50137,6740,93920,5264,2592,2672
67200,104145,10215,50140,6741,93930,5264,2592,2672
67205,104149,10215,50142,6741,93934,5264,2592,2672
67210,104159,10216,50147,6742,93943,5264,2592,2672
67215,104165,10216,50151,6742,93949,5264,2592,2672
67220,104176,10216,50158,6742,93960,5264,2592,2672
67225,104180,10216,50161,6742,93964,5264,2592,2672
67230,104190,10217,50166,6742,93973,5264,2592,2672
67235,104196,10217,50167,6742,93979,5264,2592,2672
67240,104207,10218,50173,6743,93989,5264,2592,2672
67245,104211,10218,50174,6743,93993,5264,2592,2672
67250,104221,10219,50178,6743,94002,5264,2592,2672
67255,104227,10219,50180,6743,94008,5265,2593,2672
67260,104238,10220,50183,6744,94018,5265,2593,2672
67265,104242,10220,50185,6744,94022,5265,2593,2672
67270,104252,10221,50188,6744,94031,5265,2593,2672
67275,104258,10221,50191,6744,94037,5266,2593,2673
67280,104269,10221,50194,6744,94048,5266,2593,2673
67285,104273,10221,50196,6744,94052,5266,2593,2673
67290,104283,10222,50200,6744,94061,5266,2593,2673
67295,104289,10222,50204,6744,94066,5266,2593,2673
67300,104300,10223,50210,6745,94077,5266,2593,2673
67305,104304,10223,50211,6745,94081,5266,2593,2673
67310,104314,10224,50217,6745,94090,5266,2593,2673
67315,104320,10224,50218,6745,94096,5266,2593,2673
67320,104331,10224,50224,6745,94107,5266,2593,2673
67325,104335,10224,50227,6745,94111,5266,2593,2673
67330,104345,10225,50232,6746,94120,5266,2593,2673
67335,104351,10225,50234,6746,94125,5266,2593,2673
67340,104362,10226,50240,6747,94136,5266,2593,2673
67345,104366,10226,50242,6747,94140,5266,2593,2673
67350,104376,10227,50248,6747,94149,5266,2593,2673
67355,104382,10227,50251,6747,94154,5266,2593,2673
67360,104393,10228,50256,6748,94165,5266,2593,2673
67365,104397,10228,50258,6748,94169,5266,2593,2673
67370,104407,10229,50263,6749,94178,5266,2593,2673
67375,104413,10229,50266,6749,94184,5266,2593,2673
67380,104424,10229,50268,6749,94195,5266,2593,2673
67385,104428,10229,50270,6749,94199,5266,2593,2673
67390,104438,10230,50272,6749,94208,5266,2593,2673
67395,104444,10230,50274,6749,94213,5266,2593,2673
67400,104455,10231,50277,6750,94224,5266,2593,2673
67405,104459,10231,50279,6750,94228,5266,2593,2673
67410,104469,10232,50281,6750,94237,5266,2593,2673
67415,104475,10232,50283,6750,94243,5266,2593,2673
67420,104486,10232,50291,6750,94254,5266,2593,2673
67425,104490,10232,50292,6750,94258,5266,2593,2673
67430,104500,10233,50297,6751,94267,5266,2593,2673
67435,104506,10233,50301,6751,94272,5267,2593,2674
67440,104517,10234,50305,6752,94283,5267,2593,2674
67445,104521,10234,50308,6752,94287,5267,2593,2674
67450,104531,10235,50315,6753,94296,5267,2593,2674
67455,104537,10235,50318,6753,94302,5267,2593,2674
67460,104548,10235,50325,6753,94313,5267,2593,2674
67465,104552,10235,50326,6753,94317,5267,2593,2674
67470,104562,10236,50332,6754,94326,5267,2593,2674
67475,104568,10236,50336,6754,94332,5267,2593,2674
67480,104579,10236,50338,6754,94343,5267,2593,2674
67485,104583,10236,50341,6754,94347,5267,2593,2674
67490,104593,10237,50346,6755,94356,5267,2593,2674
67495,104599,10237,50347,6755,94362,5267,2593,2674
67500,104610,10238,50352,6756,94372,5267,2593,2674
67505,104614,10238,50353,6756,94376,5267,2593,2674
67510,104624,10239,50357,6756,94385,5267,2593,2674
67515,104630,10239,50359,6756,94391,5267,2593,2674
67520,104641,10239,50362,6756,94402,5267,2593,2674
67525,104645,10239,50365,6756,94406,5267,2593,2674
67530,104655,10240,50370,6756,94415,5267,2593,2674
67535,104661,10240,50374,6756,94421,5267,2593,2674
67540,104672,10241,50379,6757,94431,5267,2593,2674
67545,104676,10241,50382,6757,94435,5267,2593,2674
67550,104686,10242,50386,6758,94444,5267,2593,2674
67555,104692,10242,50390,6758,94450,5267,2593,2674
67560,104703,10243,50395,6759,94460,5267,2593,2674
67565,104707,10243,50398,6759,94464,5267,2593,2674
67570,104717,10244,50404,6759,94473,5267,2593,2674
67575,104723,10244,50406,6759,94479,5267,2593,2674
67580,104734,10244,50412,6759,94490,5267,2593,2674
67585,104738,10244,50415,6759,94494,5267,2593,2674
67590,104748,10245,50420,6760,94503,5267,2593,2674
67595,104754,10245,50424,6760,94509,5267,2593,2674
67600,104765,10245,50426,6760,94520,5267,2593,2674
67605,104769,10245,50428,6760,94524,5267,2593,2674
67610,104779,10246,50434,6761,94533,5267,2593,2674
67615,104785,10246,50437,6761,94539,5267,2593,2674
67620,104796,10247,50444,6762,94549,5267,2593,2674
67625,104800,10247,50446,6762,94553,5267,2593,2674
67630,104810,10248,50449,6763,94562,5267,2593,2674
67635,104816,10248,50451,6763,94567,5267,2593,2674
67640,104827,10249,50454,6764,94578,5267,2593,2674
67645,104831,10249,50456,6764,94582,5267,2593,2674
67650,104841,10250,50463,6765,94591,5267,2593,2674
67655,104847,10250,50467,6765,94596,5267,2593,2674
67660,104858,10251,50471,6766,94607,5267,2593,2674
67665,104862,10251,50473,6766,94611,5267,2593,2674
67670,104872,10252,50477,6766,94620,5267,2593,2674
67675,104878,10252,50480,6766,94626,5268,2594,2674
67680,104889,10253,50485,6767,94636,5268,2594,2674
67685,104893,10253,50486,6767,94640,5268,2594,2674
67690,104903,10254,50491,6767,94649,5268,2594,2674
67695,104909,10254,50493,6767,94655,5269,2595,2674
67700,104920,10254,50497,6767,94666,5269,2595,2674
67705,104924,10254,50498,6767,94670,5269,2595,2674
67710,104934,10255,50500,6768,94679,5269,2595,2674
67715,104940,10255,50502,6768,94684,5269,2595,2674
67720,104951,10257,50506,6770,94694,5269,2595,2674
67725,104955,10257,50508,6770,94698,5269,2595,2674
67730,104965,10258,50511,6770,94707,5269,2595,2674
67735,104971,10258,50514,6770,94712,5269,2595,2674
67740,104982,10260,50517,6772,94722,5269,2595,2674
67745,104986,10260,50520,6772,94726,5269,2595,2674
67750,104996,10261,50525,6773,94735,5269,2595,2674
67755,105002,10261,50528,6773,94741,5269,2595,2674
67760,105013,10262,50534,6774,94751,5269,2595,2674
67765,105017,10262,50536,6774,94755,5269,2595,2674
67770,105027,10263,50541,6775,94764,5269,2595,2674
67775,105033,10263,50542,6775,94770,5269,2595,2674
67780,105044,10264,50547,6776,94780,5269,2595,2674
67785,105048,10264,50549,6776,94784,5269,2595,2674
67790,105058,10265,50554,6777,94793,5269,2595,2674
67795,105064,10265,50556,6777,94799,5269,2595,2674
67800,105075,10265,50558,6777,94810,5269,2595,2674
67805,105079,10265,50562,6777,94814,5269,2595,2674
67810,105089,10266,50566,6778,94823,5269,2595,2674
67815,105095,10266,50570,6778,94829,5270,2596,2674
67820,105106,10267,50574,6779,94839,5270,2596,2674
67825,105110,10267,50578,6779,94843,5270,2596,2674
67830,105120,10268,50582,6779,94852,5270,2596,2674
67835,105126,10268,50584,6779,94858,5270,2596,2674
67840,105137,10268,50588,6779,94869,5270,2596,2674
67845,105141,10268,50591,6779,94873,5270,2596,2674
67850,105151,10269,50598,6779,94882,5270,2596,2674
67855,105157,10269,50600,6779,94887,5270,2596,2674
67860,105168,10270,50602,6780,94898,5270,2596,2674
67865,105172,10270,50602,6780,94902,5270,2596,2674
67870,105182,10271,50607,6781,94911,5270,2596,2674
67875,105188,10271,50610,6781,94917,5270,2596,2674
67880,105199,10271,50613,6781,94928,5270,2596,2674
67885,105203,10271,50614,6781,94932,5270,2596,2674
67890,105213,10272,50620,6782,94941,5270,2596,2674
67895,105219,10272,50621,6782,94947,5270,2596,2674
67900,105230,10272,50625,6782,94958,5270,2596,2674
67905,105234,10272,50627,6782,94962,5270,2596,2674
67910,105244,10273,50632,6783,94971,5270,2596,2674
67915,105250,10273,50637,6783,94977,5270,2596,2674
67920,105261,10274,50644,6784,94987,5270,2596,2674
67925,105265,10274,50645,6784,94991,5270,2596,2674
67930,105275,10275,50652,6784,95000,5270,2596,2674
67935,105281,10275,50654,6784,95006,5271,2597,2674
67940,105292,10275,50658,6784,95017,5271,2597,2674
67945,105296,10275,50659,6784,95021,5271,2597,2674
67950,105306,10276,50662,6785,95030,5271,2597,2674
67955,105312,10276,50663,6785,95036,5271,2597,2674
67960,105323,10277,50668,6786,95046,5271,2597,2674
67965,105327,10277,50670,6786,95050,5271,2597,2674
67970,105337,10278,50673,6786,95059,5271,2597,2674
67975,105343,10278,50677,6786,95065,5271,2597,2674
67980,105354,10278,50681,6786,95076,5271,2597,2674
67985,105358,10278,50683,6786,95080,5271,2597,2674
67990,105368,10279,50690,6786,95089,5271,2597,2674
67995,105374,10279,50694,6786,95094,5271,2597,2674
68000,105385,10281,50699,6788,95104,5271,2597,2674
68005,105389,10281,50700,6788,95108,5271,2597,2674
68010,105399,10282,50709,6789,95117,5271,2597,2674
68015,105405,10282,50713,6789,95122,5271,2597,2674
68020,105416,10283,50718,6790,95133,5271,2597,2674
68025,105420,10283,50721,6790,95137,5271,2597,2674
68030,105430,10284,50726,6790,95146,5271,2597,2674
68035,105436,10284,50730,6790,95152,5271,2597,2674
68040,105447,10284,50737,6790,95163,5271,2597,2674
68045,105451,10284,50740,6790,95167,5271,2597,2674
68050,105461,10285,50746,6790,95176,5271,2597,2674
68055,105467,10285,50749,6790,95182,5272,2598,2674
68060,105478,10285,50755,6790,95193,5272,2598,2674
68065,105482,10285,50759,6790,95197,5272,2598,2674
68070,105492,10286,50763,6791,95206,5272,2598,2674
68075,105498,10286,50765,6791,95211,5272,2598,2674
68080,105509,10288,50772,6793,95221,5272,2598,2674
68085,105513,10288,50773,6793,95225,5272,2598,2674
68090,105523,10289,50779,6793,95234,5272,2598,2674
68095,105529,10289,50782,6793,95239,5272,2598,2674
68100,105540,10291,50790,6795,95249,5272,2598,2674
68105,105544,10291,50790,6795,95253,5272,2598,2674
68110,105554,10292,50792,6795,95262,5272,2598,2674
68115,105560,10292,50794,6795,95268,5272,2598,2674
68120,105571,10293,50800,6796,95278,5272,2598,2674
68125,105575,10293,50802,6796,95282,5272,2598,2674
68130,105585,10294,50805,6796,95291,5272,2598,2674
68135,105591,10294,50807,6796,95297,5272,2598,2674
68140,105602,10295,50813,6797,95307,5272,2598,2674
68145,105606,10295,50814,6797,95311,5272,2598,2674
68150,105616,10296,50819,6797,95320,5272,2598,2674
68155,105622,10296,50823,6797,95326,5272,2598,2674
68160,105633,10296,50826,6797,95337,5272,2598,2674
68165,105637,10296,50828,6797,95341,5272,2598,2674
68170,105647,10297,50832,6797,95350,5272,2598,2674
68175,105653,10297,50837,6797,95355,5273,2598,2675
68180,105664,10299,50844,6799,95365,5273,2598,2675
68185,105668,10299,50848,6799,95369,5273,2598,2675
68190,105678,10300,50855,6800,95378,5273,2598,2675
68195,105684,10300,50857,6800,95384,5273,2598,2675
68200,105695,10300,50862,6800,95395,5273,2598,2675
68205,105699,10300,50863,6800,95399,5273,2598,2675
68210,105709,10301,50866,6801,95408,5273,2598,2675
68215,105715,10301,50870,6801,95413,5273,2598,2675
68220,105726,10302,50878,6802,95424,5273,2598,2675
68225,105730,10302,50880,6802,95428,5273,2598,2675
68230,105740,10303,50884,6802,95437,5273,2598,2675
68235,105746,10303,50887,6802,95442,5273,2598,2675
68240,105757,10304,50891,6803,95453,5273,2598,2675
68245,105761,10304,50893,6803,95457,5273,2598,2675
68250,105771,10305,50897,6804,95466,5273,2598,2675
68255,105777,10305,50899,6804,95471,5273,2598,2675
68260,105788,10306,50904,6805,95482,5273,2598,2675
68265,105792,10306,50906,6805,95486,5273,2598,2675
68270,105802,10307,50912,6806,95495,5273,2598,2675
68275,105808,10307,50915,6806,95500,5273,2598,2675
68280,105819,10308,50923,6807,95511,5273,2598,2675
68285,105823,10308,50926,6807,95515,5273,2598,2675
68290,105833,10309,50930,6808,95524,5273,2598,2675
68295,105839,10309,50933,6808,95530,5274,2599,2675
68300,105850,10309,50938,6808,95541,5274,2599,2675
68305,105854,10309,50939,6808,95545,5274,2599,2675
68310,105864,10310,50944,6808,95554,5274,2599,2675
68315,105870,10310,50945,6808,95560,5274,2599,2675
68320,105881,10310,50950,6808,95571,5274,2599,2675
68325,105885,10310,50954,6808,95575,5274,2599,2675
68330,105895,10311,50957,6809,95584,5274,2599,2675
68335,105901,10311,50960,6809,95590,5274,2599,2675
68340,105912,10311,50966,6809,95601,5274,2599,2675
68345,105916,10311,50969,6809,95605,5274,2599,2675
68350,105926,10312,50972,6809,95614,5274,2599,2675
68355,105932,10312,50977,6809,95620,5274,2599,2675
68360,105943,10312,50983,6809,95631,5274,2599,2675
68365,105947,10312,50986,6809,95635,5274,2599,2675
68370,105957,10313,50991,6809,95644,5274,2599,2675
68375,105963,10313,50995,6809,95650,5274,2599,2675
68380,105974,10313,51001,6809,95661,5274,2599,2675
68385,105978,10313,51002,6809,95665,5274,2599,2675
68390,105988,10314,51006,6809,95674,5274,2599,2675
68395,105994,10314,51010,6809,95680,5274,2599,2675
68400,106005,10314,51015,6809,95691,5274,2599,2675
68405,106009,10314,51016,6809,95695,5274,2599,2675
68410,106019,10315,51020,6810,95704,5274,2599,2675
68415,106025,10315,51023,6810,95710,5275,2599,2676
68420,106036,10315,51026,6810,95721,5275,2599,2676
68425,106040,10315,51028,6810,95725,5275,2599,2676
68430,106050,10316,51035,6811,95734,5275,2599,2676
68435,106056,10316,51037,6811,95740,5276,2600,2676
68440,106067,10316,51042,6811,95751,5276,2600,2676
68445,106071,10316,51044,6811,95755,5276,2600,2676
68450,106081,10317,51047,6811,95764,5276,2600,2676
68455,106087,10317,51049,6811,95769,5276,2600,2676
68460,106098,10318,51057,6812,95780,5276,2600,2676
68465,106102,10318,51059,6812,95784,5276,2600,2676
68470,106112,10319,51068,6813,95793,5276,2600,2676
68475,106118,10319,51071,6813,95799,5276,2600,2676
68480,106129,10319,51076,6813,95810,5276,2600,2676
68485,106133,10319,51077,6813,95814,5276,2600,2676
68490,106143,10320,51082,6814,95823,5276,2600,2676
68495,106149,10320,51086,6814,95829,5276,2600,2676
68500,106160,10320,51090,6814,95840,5276,2600,2676
68505,106164,10320,51090,6814,95844,5276,2600,2676
68510,106174,10321,51095,6814,95853,5276,2600,2676
68515,106180,10321,51097,6814,95859,5276,2600,2676
68520,106191,10321,51104,6814,95870,5276,2600,2676
68525,106195,10321,51105,6814,95874,5276,2600,2676
68530,106205,10322,51110,6815,95883,5276,2600,2676
68535,106211,10322,51113,6815,95888,5276,2600,2676
68540,106222,10323,51116,6816,95899,5276,2600,2676
68545,106226,10323,51120,6816,95903,5276,2600,2676
68550,106236,10324,51125,6817,95912,5276,2600,2676
68555,106242,10324,51128,6817,95917,5277,2600,2677
68560,106253,10325,51134,6818,95928,5277,2600,2677
68565,106257,10325,51136,6818,95932,5277,2600,2677
68570,106267,10326,51141,6819,95941,5277,2600,2677
68575,106273,10326,51147,6819,95946,5277,2600,2677
68580,106284,10327,51152,6820,95957,5277,2600,2677
68585,106288,10327,51154,6820,95961,5277,2600,2677
68590,106298,10328,51159,6821,95970,5277,2600,2677
68595,106304,10328,51164,6821,95975,5277,2600,2677
68600,106315,10329,51169,6822,95986,5277,2600,2677
68605,106319,10329,51170,6822,95990,5277,2600,2677
68610,106329,10330,51175,6823,95999,5277,2600,2677
68615,106335,10330,51177,6823,96004,5277,2600,2677
68620,106346,10331,51178,6823,96015,5277,2600,2677
68625,106350,10331,51181,6823,96019,5277,2600,2677
68630,106360,10332,51186,6824,96028,5277,2600,2677
68635,106366,10332,51188,6824,96033,5277,2600,2677
68640,106377,10333,51193,6824,96044,5277,2600,2677
68645,106381,10333,51193,6824,96048,5277,2600,2677
68650,106391,10334,51198,6825,96057,5277,2600,2677
68655,106397,10334,51201,6825,96062,5277,2600,2677
68660,106408,10335,51207,6826,96073,5277,2600,2677
68665,106412,10335,51208,6826,96077,5277,2600,2677
68670,106422,10336,51211,6826,96086,5277,2600,2677
68675,106428,10336,51215,6826,96091,5277,2600,2677
68680,106439,10337,51220,6827,96102,5277,2600,2677
68685,106443,10337,51220,6827,96106,5277,2600,2677
68690,106453,10338,51223,6828,96115,5277,2600,2677
68695,106459,10338,51225,6828,96120,5277,2600,2677
68700,106470,10339,51229,6828,96131,5277,2600,2677
68705,106474,10339,51229,6828,96135,5277,2600,2677
68710,106484,10340,51236,6829,96144,5277,2600,2677
68715,106490,10340,51238,6829,96149,5277,2600,2677
68720,106501,10341,51240,6830,96160,5277,2600,2677
68725,106505,10341,51242,6830,96164,5277,2600,2677
68730,106515,10342,51245,6830,96173,5277,2600,2677
68735,106521,10342,51249,6830,96178,5277,2600,2677
68740,106532,10343,51256,6831,96189,5277,2600,2677
68745,106536,10343,51258,6831,96193,5277,2600,2677
68750,106546,10344,51263,6831,96202,5277,2600,2677
68755,106552,10344,51264,6831,96207,5277,2600,2677
68760,106563,10345,51269,6831,96218,5277,2600,2677
68765,106567,10345,51270,6831,96222,5277,2600,2677
68770,106577,10346,51274,6832,96231,5277,2600,2677
68775,106583,10346,51279,6832,96236,5277,2600,2677
68780,106594,10347,51284,6833,96247,5277,2600,2677
68785,106598,10347,51287,6833,96251,5277,2600,2677
68790,106608,10348,51292,6833,96260,5277,2600,2677
68795,106614,10348,51293,6833,96265,5277,2600,2677
68800,106625,10349,51297,6833,96276,5277,2600,2677
68805,106629,10349,51299,6833,96280,5277,2600,2677
68810,106639,10350,51305,6834,96289,5277,2600,2677
68815,106645,10350,51309,6834,96294,5277,2600,2677
68820,106656,10351,51314,6835,96305,5277,2600,2677
68825,106660,10351,51316,6835,96309,5277,2600,2677
68830,106670,10352,51318,6835,96318,5277,2600,2677
68835,106676,10352,51321,6835,96323,5277,2600,2677
68840,106687,10353,51328,6836,96334,5277,2600,2677
68845,106691,10353,51330,6836,96338,5277,2600,2677
68850,106701,10354,51335,6837,96347,5277,2600,2677
68855,106707,10354,51338,6837,96352,5277,2600,2677
68860,106718,10355,51342,6838,96363,5277,2600,2677
68865,106722,10355,51345,6838,96367,5277,2600,2677
68870,106732,10356,51350,6839,96376,5277,2600,2677
68875,106738,10356,51353,6839,96381,5277,2600,2677
68880,106749,10357,51356,6840,96392,5277,2600,2677
68885,106753,10357,51357,6840,96396,5277,2600,2677
68890,106763,10358,51360,6840,96405,5277,2600,2677
68895,106769,10358,51362,6840,96410,5278,2600,2678
68900,106780,10359,51364,6840,96421,5278,2600,2678
68905,106784,10359,51366,6840,96425,5278,2600,2678
68910,106794,10360,51372,6840,96434,5278,2600,2678
68915,106800,10360,51375,6840,96439,5278,2600,2678
68920,106811,10361,51381,6840,96450,5278,2600,2678
68925,106815,10361,51382,6840,96454,5278,2600,2678
68930,106825,10362,51386,6840,96463,5278,2600,2678
68935,106831,10362,51388,6840,96468,5278,2600,2678
68940,106842,10363,51396,6841,96479,5278,2600,2678
68945,106846,10363,51398,6841,96483,5278,2600,2678
68950,106856,10364,51402,6842,96492,5278,2600,2678
68955,106862,10364,51405,6842,96498,5278,2600,2678
68960,106873,10364,51412,6842,96509,5278,2600,2678
68965,106877,10364,51413,6842,96513,5278,2600,2678
68970,106887,10365,51417,6843,96522,5278,2600,2678
68975,106893,10365,51419,6843,96528,5278,2600,2678
68980,106904,10365,51423,6843,96539,5278,2600,2678
68985,106908,10365,51425,6843,96543,5278,2600,2678
68990,106918,10366,51433,6844,96552,5278,2600,2678
68995,106924,10366,51438,6844,96558,5278,2600,2678
69000,106935,10366,51444,6844,96569,5278,2600,2678
69005,106939,10366,51446,6844,96573,5278,2600,2678
69010,106949,10367,51450,6845,96582,5278,2600,2678
69015,106955,10367,51454,6845,96588,5279,2601,2678
69020,106966,10367,51459,6845,96599,5279,2601,2678
69025,106970,10367,51463,6845,96603,5279,2601,2678
69030,106980,10368,51468,6845,96612,5279,2601,2678
69035,106986,10368,51469,6845,96618,5280,2601,2679
69040,106997,10368,51473,6845,96629,5280,2601,2679
69045,107001,10368,51475,6845,96633,5280,2601,2679
69050,107011,10369,51482,6846,96642,5280,2601,2679
69055,107017,10369,51484,6846,96647,5280,2601,2679
69060,107028,10370,51490,6846,96658,5280,2601,2679
69065,107032,10370,51493,6846,96662,5280,2601,2679
69070,107042,10371,51498,6847,96671,5280,2601,2679
69075,107048,10371,51500,6847,96676,5280,2601,2679
69080,107059,10372,51506,6848,96687,5280,2601,2679
69085,107063,10372,51509,6848,96691,5280,2601,2679
69090,107073,10373,51515,6849,96700,5280,2601,2679
69095,107079,10373,51518,6849,96705,5280,2601,2679
69100,107090,10374,51525,6849,96716,5280,2601,2679
69105,107094,10374,51528,6849,96720,5280,2601,2679
69110,107104,10375,51531,6849,96729,5280,2601,2679
69115,107110,10375,51535,6849,96734,5280,2601,2679
69120,107121,10376,51540,6849,96745,5280,2601,2679
69125,107125,10376,51541,6849,96749,5280,2601,2679
69130,107135,10377,51548,6850,96758,5280,2601,2679
69135,107141,10377,51550,6850,96764,5280,2601,2679
69140,107152,10377,51555,6850,96775,5280,2601,2679
69145,107156,10377,51557,6850,96779,5280,2601,2679
69150,107166,10377,51561,6850,96789,5280,2601,2679
69155,107172,10377,51566,6850,96795,5281,2602,2679
69160,107183,10377,51574,6850,96806,5281,2602,2679
69165,107187,10377,51576,6850,96810,5281,2602,2679
69170,107197,10377,51580,6850,96820,5281,2602,2679
69175,107203,10377,51585,6850,96826,5282,2603,2679
69180,107214,10377,51589,6850,96837,5282,2603,2679
69185,107218,10377,51591,6850,96841,5282,2603,2679
69190,107228,10377,51596,6850,96851,5282,2603,2679
69195,107234,10377,51598,6850,96857,5282,2603,2679
69200,107245,10377,51604,6850,96868,5282,2603,2679
69205,107249,10377,51605,6850,96872,5282,2603,2679
69210,107259,10377,51612,6850,96882,5282,2603,2679
69215,107265,10377,51615,6850,96888,5282,2603,2679
69220,107276,10377,51620,6850,96899,5282,2603,2679
69225,107280,10377,51621,6850,96903,5282,2603,2679
69230,107290,10377,51626,6850,96913,5282,2603,2679
69235,107296,10377,51628,6850,96919,5282,2603,2679
69240,107307,10377,51633,6850,96930,5282,2603,2679
69245,107311,10377,51634,6850,96934,5282,2603,2679
69250,107321,10377,51636,6850,96944,5282,2603,2679
69255,107327,10377,51640,6850,96950,5282,2603,2679
69260,107338,10377,51646,6850,96961,5282,2603,2679
69265,107342,10377,51647,6850,96965,5282,2603,2679
69270,107352,10377,51652,6850,96975,5282,2603,2679
69275,107358,10377,51655,6850,96981,5282,2603,2679
69280,107369,10377,51662,6850,96992,5282,2603,2679
69285,107373,10377,51665,6850,96996,5282,2603,2679
69290,107383,10377,51669,6850,97006,5282,2603,2679
69295,107389,10377,51674,6850,97012,5283,2604,2679
69300,107400,10377,51682,6850,97023,5283,2604,2679
69305,107404,10377,51684,6850,97027,5283,2604,2679
69310,107414,10377,51691,6850,97037,5283,2604,2679
69315,107420,10377,51692,6850,97043,5283,2604,2679
69320,107431,10377,51697,6850,97054,5283,2604,2679
69325,107435,10377,51700,6850,97058,5283,2604,2679
69330,107445,10377,51704,6850,97068,5283,2604,2679
69335,107451,10377,51707,6850,97074,5283,2604,2679
69340,107462,10377,51711,6850,97085,5283,2604,2679
69345,107466,10377,51711,6850,97089,5283,2604,2679
69350,107476,10377,51716,6850,97099,5283,2604,2679
69355,107482,10377,51719,6850,97105,5283,2604,2679
69360,107493,10377,51721,6850,97116,5283,2604,2679
69365,107497,10377,51723,6850,97120,5283,2604,2679
69370,107507,10377,51726,6850,97130,5283,2604,2679
69375,107513,10377,51727,6850,97136,5283,2604,2679
69380,107524,10377,51732,6850,97147,5283,2604,2679
69385,107528,10377,51734,6850,97151,5283,2604,2679
69390,107538,10377,51738,6850,97161,5283,2604,2679
69395,107544,10377,51742,6850,97167,5283,2604,2679
69400,107555,10377,51748,6850,97178,5283,2604,2679
69405,107559,10377,51749,6850,97182,5283,2604,2679
69410,107569,10377,51754,6850,97192,5283,2604,2679
69415,107575,10377,51758,6850,97198,5284,2605,2679
69420,107586,10377,51767,6850,97209,5284,2605,2679
69425,107590,10377,51769,6850,97213,5284,2605,2679
69430,107600,10377,51774,6850,97223,5284,2605,2679
69435,107606,10377,51777,6850,97229,5284,2605,2679
69440,107617,10377,51782,6850,97240,5284,2605,2679
69445,107621,10377,51783,6850,97244,5284,2605,2679
69450,107631,10377,51786,6850,97254,5284,2605,2679
69455,107637,10377,51791,6850,97260,5284,2605,2679
69460,107648,10377,51797,6850,97271,5284,2605,2679
69465,107652,10377,51799,6850,97275,5284,2605,2679
69470,107662,10377,51802,6850,97285,5284,2605,2679
69475,107668,10377,51805,6850,97291,5284,2605,2679
69480,107679,10377,51812,6850,97302,5284,2605,2679
69485,107683,10377,51814,6850,97306,5284,2605,2679
69490,107693,10377,51817,6850,97316,5284,2605,2679
69495,107699,10377,51819,6850,97322,5284,2605,2679
69500,107710,10377,51824,6850,97333,5284,2605,2679
69505,107714,10377,51824,6850,97337,5284,2605,2679
69510,107724,10377,51831,6850,97347,5284,2605,2679
69515,107730,10377,51834,6850,97353,5284,2605,2679
69520,107741,10377,51840,6850,97364,5284,2605,2679
69525,107745,10377,51843,6850,97368,5284,2605,2679
69530,107755,10377,51847,6850,97378,5284,2605,2679
69535,107761,10377,51848,6850,97384,5285,2605,2680
69540,107772,10377,51852,6850,97395,5285,2605,2680
69545,107776,10377,51853,6850,97399,5285,2605,2680
69550,107786,10377,51859,6850,97409,5285,2605,2680
69555,107792,10377,51862,6850,97415,5285,2605,2680
69560,107803,10377,51866,6850,97426,5285,2605,2680
69565,107807,10377,51868,6850,97430,5285,2605,2680
69570,107817,10377,51873,6850,97440,5285,2605,2680
69575,107823,10377,51877,6850,97446,5285,2605,2680
69580,107834,10377,51883,6850,97457,5285,2605,2680
69585,107838,10377,51884,6850,97461,5285,2605,2680
69590,107848,10377,51888,6850,97471,5285,2605,2680
69595,107854,10377,51889,6850,97477,5285,2605,2680
69600,107865,10377,51895,6850,97488,5285,2605,2680
69605,107869,10377,51895,6850,97492,5285,2605,2680
69610,107879,10377,51900,6850,97502,5285,2605,2680
69615,107885,10377,51902,6850,97508,5285,2605,2680
69620,107896,10377,51908,6850,97519,5285,2605,2680
69625,107900,10377,51910,6850,97523,5285,2605,2680
69630,107910,10377,51915,6850,97533,5285,2605,2680
69635,107916,10377,51919,6850,97539,5285,2605,2680
69640,107927,10377,51923,6850,97550,5285,2605,2680
69645,107931,10377,51924,6850,97554,5285,2605,2680
69650,107941,10377,51930,6850,97564,5285,2605,2680
69655,107947,10377,51933,6850,97570,5286,2606,2680
69660,107958,10377,51939,6850,97581,5286,2606,2680
69665,107962,10377,51941,6850,97585,5286,2606,2680
69670,107972,10377,51944,6850,97595,5286,2606,2680
69675,107978,10377,51948,6850,97601,5286,2606,2680
69680,107989,10377,51955,6850,97612,5286,2606,2680
69685,107993,10377,51956,6850,97616,5286,2606,2680
69690,108003,10377,51960,6850,97626,5286,2606,2680
69695,108009,10377,51964,6850,97632,5286,2606,2680
69700,108020,10377,51968,6850,97643,5286,2606,2680
69705,108024,10377,51969,6850,97647,5286,2606,2680
69710,108034,10377,51972,6850,97657,5286,2606,2680
69715,108040,10377,51976,6850,97663,5286,2606,2680
69720,108051,10377,51979,6850,97674,5286,2606,2680
69725,108055,10377,51980,6850,97678,5286,2606,2680
69730,108065,10377,51984,6850,97688,5286,2606,2680
69735,108071,10377,51987,6850,97694,5286,2606,2680
69740,108082,10377,51992,6850,97705,5286,2606,2680
69745,108086,10377,51993,6850,97709,5286,2606,2680
69750,108096,10377,51995,6850,97719,5286,2606,2680
69755,108102,10377,51997,6850,97725,5286,2606,2680
69760,108113,10377,52003,6850,97736,5286,2606,2680
69765,108117,10377,52004,6850,97740,5286,2606,2680
69770,108127,10377,52010,6850,97750,5286,2606,2680
69775,108133,10377,52012,6850,97756,5287,2606,2681
69780,108144,10377,52020,6850,97767,5287,2606,2681
69785,108148,10377,52021,6850,97771,5287,2606,2681
69790,108158,10377,52023,6850,97781,5287,2606,2681
69795,108164,10377,52026,6850,97787,5287,2606,2681
69800,108175,10377,52034,6850,97798,5287,2606,2681
69805,108179,10377,52035,6850,97802,5287,2606,2681
69810,108189,10377,52039,6850,97812,5287,2606,2681
69815,108195,10377,52042,6850,97818,5287,2606,2681
69820,108206,10377,52049,6850,97829,5287,2606,2681
69825,108210,10377,52052,6850,97833,5287,2606,2681
69830,108220,10377,52059,6850,97843,5287,2606,2681
69835,108226,10377,52064,6850,97849,5287,2606,2681
69840,108237,10377,52071,6850,97860,5287,2606,2681
69845,108241,10377,52073,6850,97864,5287,2606,2681
69850,108251,10377,52077,6850,97874,5287,2606,2681
69855,108257,10377,52081,6850,97880,5287,2606,2681
69860,108268,10377,52088,6850,97891,5287,2606,2681
69865,108272,10377,52090,6850,97895,5287,2606,2681
69870,108282,10377,52095,6850,97905,5287,2606,2681
69875,108288,10377,52098,6850,97911,5287,2606,2681
69880,108299,10377,52101,6850,97922,5287,2606,2681
69885,108303,10377,52103,6850,97926,5287,2606,2681
69890,108313,10377,52108,6850,97936,5287,2606,2681
69895,108319,10377,52112,6850,97942,5288,2607,2681
69900,108330,10377,52115,6850,97953,5288,2607,2681
69905,108334,10377,52117,6850,97957,5288,2607,2681
69910,108344,10377,52123,6850,97967,5288,2607,2681
69915,108350,10377,52125,6850,97973,5288,2607,2681
69920,108361,10377,52128,6850,97984,5288,2607,2681
69925,108365,10377,52128,6850,97988,5288,2607,2681
69930,108375,10377,52134,6850,97998,5288,2607,2681
69935,108381,10377,52135,6850,98004,5288,2607,2681
69940,108392,10377,52141,6850,98015,5288,2607,2681
69945,108396,10377,52143,6850,98019,5288,2607,2681
69950,108406,10377,52147,6850,98029,5288,2607,2681
69955,108412,10377,52151,6850,98035,5288,2607,2681
69960,108423,10377,52155,6850,98046,5288,2607,2681
69965,108427,10377,52156,6850,98050,5288,2607,2681
69970,108437,10377,52159,6850,98060,5288,2607,2681
69975,108443,10377,52162,6850,98066,5288,2607,2681
69980,108454,10377,52168,6850,98077,5288,2607,2681
69985,108458,10377,52169,6850,98081,5288,2607,2681
69990,108468,10377,52175,6850,98091,5288,2607,2681
69995,108474,10377,52180,6850,98097,5288,2607,2681
70000,108485,10377,52188,6850,98108,5288,2607,2681
70005,108489,10377,52191,6850,98112,5288,2607,2681
70010,108499,10377,52194,6850,98122,5288,2607,2681
70015,108505,10377,52198,6850,98128,5288,2607,2681
70020,108516,10377,52204,6850,98139,5288,2607,2681
70025,108520,10377,52206,6850,98143,5288,2607,2681
70030,108530,10377,52208,6850,98153,5288,2607,2681
70035,108536,10377,52209,6850,98159,5289,2607,2682
70040,108547,10377,52211,6850,98170,5289,2607,2682
70045,108551,10377,52213,6850,98174,5289,2607,2682
70050,108561,10377,52217,6850,98184,5289,2607,2682
70055,108567,10377,52221,6850,98190,5289,2607,2682
70060,108578,10377,52227,6850,98201,5289,2607,2682
70065,108582,10377,52230,6850,98205,5289,2607,2682
70070,108592,10377,52235,6850,98215,5289,2607,2682
70075,108598,10377,52238,6850,98221,5289,2607,2682
70080,108609,10377,52242,6850,98232,5289,2607,2682
70085,108613,10377,52245,6850,98236,5289,2607,2682
70090,108623,10377,52251,6850,98246,5289,2607,2682
70095,108629,10377,52252,6850,98252,5289,2607,2682
70100,108640,10377,52259,6850,98263,5289,2607,2682
70105,108644,10377,52261,6850,98267,5289,2607,2682
70110,108654,10377,52268,6850,98277,5289,2607,2682
70115,108660,10377,52270,6850,98283,5289,2607,2682
70120,108671,10377,52275,6850,98294,5289,2607,2682
70125,108675,10377,52277,6850,98298,5289,2607,2682
70130,108685,10377,52282,6850,98308,5289,2607,2682
70135,108691,10377,52285,6850,98314,5289,2607,2682
70140,108702,10377,52292,6850,98325,5289,2607,2682
70145,108706,10377,52293,6850,98329,5289,2607,2682
70150,108716,10377,52300,6850,98339,5289,2607,2682
70155,108722,10377,52301,6850,98345,5290,2607,2683
70160,108733,10377,52307,6850,98356,5290,2607,2683
70165,108737,10377,52310,6850,98360,5290,2607,2683
70170,108747,10377,52316,6850,98370,5290,2607,2683
70175,108753,10377,52318,6850,98376,5290,2607,2683
70180,108764,10377,52324,6850,98387,5290,2607,2683
70185,108768,10377,52328,6850,98391,5290,2607,2683
70190,108778,10377,52333,6850,98401,5290,2607,2683
70195,108784,10377,52338,6850,98407,5290,2607,2683
70200,108795,10377,52343,6850,98418,5290,2607,2683
70205,108799,10377,52344,6850,98422,5290,2607,2683
70210,108809,10377,52349,6850,98432,5290,2607,2683
70215,108815,10377,52352,6850,98438,5290,2607,2683
70220,108826,10377,52361,6850,98449,5290,2607,2683
70225,108830,10377,52363,6850,98453,5290,2607,2683
70230,108840,10377,52369,6850,98463,5290,2607,2683
70235,108846,10377,52373,6850,98469,5290,2607,2683
70240,108857,10377,52377,6850,98480,5290,2607,2683
70245,108861,10377,52380,6850,98484,5290,2607,2683
70250,108871,10377,52385,6850,98494,5290,2607,2683
70255,108877,10377,52389,6850,98500,5290,2607,2683
70260,108888,10377,52393,6850,98511,5290,2607,2683
70265,108892,10377,52396,6850,98515,5290,2607,2683
70270,108902,10377,52397,6850,98525,5290,2607,2683
70275,108908,10377,52402,6850,98531,5291,2607,2684
70280,108919,10377,52408,6850,98542,5291,2607,2684
70285,108923,10377,52408,6850,98546,5291,2607,2684
70290,108933,10377,52412,6850,98556,5291,2607,2684
70295,108939,10377,52415,6850,98562,5292,2608,2684
70300,108950,10377,52421,6850,98573,5292,2608,2684
70305,108954,10377,52422,6850,98577,5292,2608,2684
70310,108964,10377,52428,6850,98587,5292,2608,2684
70315,108970,10377,52429,6850,98593,5293,2608,2685
70320,108981,10377,52435,6850,98604,5293,2608,2685
70325,108985,10377,52437,6850,98608,5293,2608,2685
70330,108995,10377,52440,6850,98618,5293,2608,2685
70335,109001,10377,52442,6850,98624,5293,2608,2685
70340,109012,10377,52448,6850,98635,5293,2608,2685
70345,109016,10377,52448,6850,98639,5293,2608,2685
70350,109026,10377,52451,6850,98649,5293,2608,2685
70355,109032,10377,52454,6850,98655,5293,2608,2685
70360,109043,10377,52462,6850,98666,5293,2608,2685
70365,109047,10377,52463,6850,98670,5293,2608,2685
70370,109057,10377,52465,6850,98680,5293,2608,2685
70375,109063,10377,52466,6850,98686,5293,2608,2685
70380,109074,10377,52472,6850,98697,5293,2608,2685
70385,109078,10377,52472,6850,98701,5293,2608,2685
70390,109088,10377,52480,6850,98711,5293,2608,2685
70395,109094,10377,52481,6850,98717,5293,2608,2685
70400,109105,10377,52487,6850,98728,5293,2608,2685
70405,109109,10377,52489,6850,98732,5293,2608,2685
70410,109119,10377,52496,6850,98742,5293,2608,2685
70415,109125,10377,52499,6850,98748,5293,2608,2685
70420,109136,10377,52503,6850,98759,5293,2608,2685
70425,109140,10377,52505,6850,98763,5293,2608,2685
70430,109150,10377,52510,6850,98773,5293,2608,2685
70435,109156,10377,52515,6850,98779,5294,2609,2685
70440,109167,10377,52521,6850,98790,5294,2609,2685
70445,109171,10377,52525,6850,98794,5294,2609,2685
70450,109181,10377,52528,6850,98804,5294,2609,2685
70455,109187,10377,52531,6850,98810,5294,2609,2685
70460,109198,10377,52538,6850,98821,5294,2609,2685
70465,109202,10377,52541,6850,98825,5294,2609,2685
70470,109212,10377,52544,6850,98835,5294,2609,2685
70475,109218,10377,52546,6850,98841,5294,2609,2685
70480,109229,10377,52554,6850,98852,5294,2609,2685
70485,109233,10377,52557,6850,98856,5294,2609,2685
70490,109243,10377,52561,6850,98866,5294,2609,2685
70495,109249,10377,52564,6850,98872,5294,2609,2685
70500,109260,10377,52568,6850,98883,5294,2609,2685
70505,109264,10377,52570,6850,98887,5294,2609,2685
70510,109274,10377,52574,6850,98897,5294,2609,2685
70515,109280,10377,52578,6850,98903,5294,2609,2685
70520,109291,10377,52580,6850,98914,5294,2609,2685
70525,109295,10377,52583,6850,98918,5294,2609,2685
70530,109305,10377,52587,6850,98928,5294,2609,2685
70535,109311,10377,52588,6850,98934,5294,2609,2685
70540,109322,10377,52594,6850,98945,5294,2609,2685
70545,109326,10377,52594,6850,98949,5294,2609,2685
70550,109336,10377,52597,6850,98959,5294,2609,2685
70555,109342,10377,52597,6850,98965,5295,2609,2686
70560,109353,10377,52601,6850,98976,5295,2609,2686
70565,109357,10377,52603,6850,98980,5295,2609,2686
70570,109367,10377,52606,6850,98990,5295,2609,2686
70575,109373,10377,52610,6850,98996,5296,2609,2687
70580,109384,10377,52617,6850,99007,5296,2609,2687
70585,109388,10377,52620,6850,99011,5296,2609,2687
70590,109398,10377,52624,6850,99021,5296,2609,2687
70595,109404,10377,52626,6850,99027,5296,2609,2687
70600,109415,10377,52630,6850,99038,5296,2609,2687
70605,109419,10377,52634,6850,99042,5296,2609,2687
70610,109429,10377,52638,6850,99052,5296,2609,2687
70615,109435,10377,52641,6850,99058,5296,2609,2687
70620,109446,10377,52646,6850,99069,5296,2609,2687
70625,109450,10377,52647,6850,99073,5296,2609,2687
70630,109460,10377,52651,6850,99083,5296,2609,2687
70635,109466,10377,52654,6850,99089,5296,2609,2687
70640,109477,10377,52658,6850,99100,5296,2609,2687
70645,109481,10377,52659,6850,99104,5296,2609,2687
70650,109491,10377,52661,6850,99114,5296,2609,2687
70655,109497,10377,52664,6850,99120,5296,2609,2687
70660,109508,10377,52671,6850,99131,5296,2609,2687
70665,109512,10377,52673,6850,99135,5296,2609,2687
70670,109522,10377,52678,6850,99145,5296,2609,2687
70675,109528,10377,52684,6850,99151,5296,2609,2687
70680,109539,10377,52689,6850,99162,5296,2609,2687
70685,109543,10377,52690,6850,99166,5296,2609,2687
70690,109553,10377,52693,6850,99176,5296,2609,2687
70695,109559,10377,52697,6850,99182,5297,2610,2687
70700,109570,10377,52704,6850,99193,5297,2610,2687
70705,109574,10377,52706,6850,99197,5297,2610,2687
70710,109584,10377,52712,6850,99207,5297,2610,2687
70715,109590,10377,52718,6850,99213,5297,2610,2687
70720,109601,10377,52725,6850,99224,5297,2610,2687
70725,109605,10377,52726,6850,99228,5297,2610,2687
70730,109615,10377,52730,6850,99238,5297,2610,2687
70735,109621,10377,52733,6850,99244,5297,2610,2687
70740,109632,10377,52737,6850,99255,5297,2610,2687
70745,109636,10377,52738,6850,99259,5297,2610,2687
70750,109646,10377,52744,6850,99269,5297,2610,2687
70755,109652,10377,52749,6850,99275,5297,2610,2687
70760,109663,10377,52756,6850,99286,5297,2610,2687
70765,109667,10377,52758,6850,99290,5297,2610,2687
70770,109677,10377,52761,6850,99300,5297,2610,2687
70775,109683,10377,52764,6850,99306,5297,2610,2687
70780,109694,10377,52769,6850,99317,5297,2610,2687
70785,109698,10377,52772,6850,99321,5297,2610,2687
70790,109708,10377,52776,6850,99331,5297,2610,2687
70795,109714,10377,52778,6850,99337,5297,2610,2687
70800,109725,10377,52783,6850,99348,5297,2610,2687
70805,109729,10377,52784,6850,99352,5297,2610,2687
70810,109739,10377,52790,6850,99362,5297,2610,2687
70815,109745,10377,52792,6850,99368,5298,2611,2687
70820,109756,10377,52798,6850,99379,5298,2611,2687
70825,109760,10377,52800,6850,99383,5298,2611,2687
70830,109770,10377,52808,6850,99393,5298,2611,2687
70835,109776,10377,52813,6850,99399,5298,2611,2687
70840,109787,10377,52821,6850,99410,5298,2611,2687
70845,109791,10377,52823,6850,99414,5298,2611,2687
70850,109801,10377,52830,6850,99424,5298,2611,2687
70855,109807,10377,52834,6850,99430,5298,2611,2687
70860,109818,10377,52841,6850,99441,5298,2611,2687
70865,109822,10377,52844,6850,99445,5298,2611,2687
70870,109832,10377,52849,6850,99455,5298,2611,2687
70875,109838,10377,52853,6850,99461,5298,2611,2687
70880,109849,10377,52859,6850,99472,5298,2611,2687
70885,109853,10377,52860,6850,99476,5298,2611,2687
70890,109863,10377,52868,6850,99486,5298,2611,2687
70895,109869,10377,52872,6850,99492,5298,2611,2687
70900,109880,10377,52877,6850,99503,5298,2611,2687
70905,109884,10377,52879,6850,99507,5298,2611,2687
70910,109894,10377,52883,6850,99517,5298,2611,2687
70915,109900,10377,52884,6850,99523,5298,2611,2687
70920,109911,10377,52885,6850,99534,5298,2611,2687
70925,109915,10377,52886,6850,99538,5298,2611,2687
70930,109925,10377,52895,6850,99548,5298,2611,2687
70935,109931,10377,52896,6850,99554,5298,2611,2687
70940,109942,10377,52901,6850,99565,5298,2611,2687
70945,109946,10377,52904,6850,99569,5298,2611,2687
70950,109956,10377,52906,6850,99579,5298,2611,2687
70955,109962,10377,52909,6850,99585,5299,2611,2688
70960,109973,10377,52916,6850,99596,5299,2611,2688
70965,109977,10377,52919,6850,99600,5299,2611,2688
70970,109987,10377,52925,6850,99610,5299,2611,2688
70975,109993,10377,52930,6850,99616,5299,2611,2688
70980,110004,10377,52936,6850,99627,5299,2611,2688
70985,110008,10377,52938,6850,99631,5299,2611,2688
70990,110018,10377,52947,6850,99641,5299,2611,2688
70995,110024,10377,52950,6850,99647,5299,2611,2688
71000,110035,10377,52955,6850,99658,5299,2611,2688
71005,110039,10377,52956,6850,99662,5299,2611,2688
71010,110049,10377,52961,6850,99672,5299,2611,2688
71015,110055,10377,52962,6850,99678,5299,2611,2688
71020,110066,10377,52967,6850,99689,5299,2611,2688
71025,110070,10377,52968,6850,99693,5299,2611,2688
71030,110080,10377,52971,6850,99703,5299,2611,2688
71035,110086,10377,52974,6850,99709,5299,2611,2688
71040,110097,10377,52981,6850,99720,5299,2611,2688
71045,110101,10377,52982,6850,99724,5299,2611,2688
71050,110111,10377,52989,6850,99734,5299,2611,2688
71055,110117,10377,52995,6850,99740,5299,2611,2688
71060,110128,10377,53003,6850,99751,5299,2611,2688
71065,110132,10377,53006,6850,99755,5299,2611,2688
71070,110142,10377,53009,6850,99765,5299,2611,2688
71075,110148,10377,53012,6850,99771,5299,2611,2688
71080,110159,10377,53016,6850,99782,5299,2611,2688
71085,110163,10377,53018,6850,99786,5299,2611,2688
71090,110173,10377,53024,6850,99796,5299,2611,2688
71095,110179,10377,53029,6850,99802,5299,2611,2688
71100,110190,10377,53035,6850,99813,5299,2611,2688
71105,110194,10377,53035,6850,99817,5299,2611,2688
71110,110204,10377,53039,6850,99827,5299,2611,2688
71115,110210,10377,53041,6850,99833,5299,2611,2688
71120,110221,10377,53048,6850,99844,5299,2611,2688
71125,110225,10377,53051,6850,99848,5299,2611,2688
71130,110235,10377,53057,6850,99858,5299,2611,2688
71135,110241,10377,53061,6850,99864,5299,2611,2688
71140,110252,10377,53070,6850,99875,5299,2611,2688
71145,110256,10377,53071,6850,99879,5299,2611,2688
71150,110266,10377,53076,6850,99889,5299,2611,2688
71155,110272,10377,53077,6850,99895,5299,2611,2688
71160,110283,10377,53082,6850,99906,5299,2611,2688
71165,110287,10377,53085,6850,99910,5299,2611,2688
71170,110297,10377,53090,6850,99920,5299,2611,2688
71175,110303,10377,53094,6850,99926,5299,2611,2688
71180,110314,10377,53101,6850,99937,5299,2611,2688
71185,110318,10377,53102,6850,99941,5299,2611,2688
71190,110328,10377,53108,6850,99951,5299,2611,2688
71195,110334,10377,53113,6850,99957,5299,2611,2688
71200,110345,10377,53121,6850,99968,5299,2611,2688
71205,110349,10377,53124,6850,99972,5299,2611,2688
71210,110359,10377,53128,6850,99982,5299,2611,2688
71215,110365,10377,53131,6850,99988,5299,2611,2688
71220,110376,10377,53137,6850,99999,5299,2611,2688
71225,110380,10377,53140,6850,100003,5299,2611,2688
71230,110390,10377,53146,6850,100013,5299,2611,2688
71235,110396,10377,53151,6850,100019,5299,2611,2688
71240,110407,10377,53154,6850,100030,5299,2611,2688
71245,110411,10377,53157,6850,100034,5299,2611,2688
71250,110421,10377,53163,6850,100044,5299,2611,2688
71255,110427,10377,53167,6850,100050,5299,2611,2688
71260,110438,10377,53175,6850,100061,5299,2611,2688
71265,110442,10377,53176,6850,100065,5299,2611,2688
71270,110452,10377,53180,6850,100075,5299,2611,2688
71275,110458,10377,53183,6850,100081,5300,2612,2688
71280,110469,10377,53191,6850,100092,5300,2612,2688
71285,110473,10377,53193,6850,100096,5300,2612,2688
71290,110483,10377,53198,6850,100106,5300,2612,2688
71295,110489,10377,53201,6850,100112,5300,2612,2688
71300,110500,10377,53204,6850,100123,5300,2612,2688
71305,110504,10377,53205,6850,100127,5300,2612,2688
71310,110514,10377,53212,6850,100137,5300,2612,2688
71315,110520,10377,53215,6850,100143,5300,2612,2688
71320,110531,10377,53219,6850,100154,5300,2612,2688
71325,110535,10377,53221,6850,100158,5300,2612,2688
71330,110545,10377,53222,6850,100168,5300,2612,2688
71335,110551,10377,53223,6850,100174,5300,2612,2688
71340,110562,10377,53227,6850,100185,5300,2612,2688
71345,110566,10377,53229,6850,100189,5300,2612,2688
71350,110576,10377,53234,6850,100199,5300,2612,2688
71355,110582,10377,53236,6850,100205,5300,2612,2688
71360,110593,10377,53243,6850,100216,5300,2612,2688
71365,110597,10377,53243,6850,100220,5300,2612,2688
71370,110607,10377,53246,6850,100230,5300,2612,2688
71375,110613,10377,53249,6850,100236,5300,2612,2688
71380,110624,10377,53253,6850,100247,5300,2612,2688
71385,110628,10377,53254,6850,100251,5300,2612,2688
71390,110638,10377,53258,6850,100261,5300,2612,2688
71395,110644,10377,53260,6850,100267,5300,2612,2688
71400,110655,10377,53267,6850,100278,5300,2612,2688
71405,110659,10377,53268,6850,100282,5300,2612,2688
71410,110669,10377,53272,6850,100292,5300,2612,2688
71415,110675,10377,53275,6850,100298,5300,2612,2688
71420,110686,10377,53281,6850,100309,5300,2612,2688
71425,110690,10377,53282,6850,100313,5300,2612,2688
71430,110700,10377,53289,6850,100323,5300,2612,2688
71435,110706,10377,53292,6850,100329,5300,2612,2688
71440,110717,10377,53299,6850,100340,5300,2612,2688
71445,110721,10377,53302,6850,100344,5300,2612,2688
71450,110731,10377,53306,6850,100354,5300,2612,2688
71455,110737,10377,53307,6850,100360,5300,2612,2688
71460,110748,10377,53312,6850,100371,5300,2612,2688
71465,110752,10377,53313,6850,100375,5300,2612,2688
71470,110762,10377,53316,6850,100385,5300,2612,2688
71475,110768,10377,53319,6850,100391,5300,2612,2688
71480,110779,10377,53327,6850,100402,5300,2612,2688
71485,110783,10377,53328,6850,100406,5300,2612,2688
71490,110793,10377,53333,6850,100416,5300,2612,2688
71495,110799,10377,53337,6850,100422,5300,2612,2688
71500,110810,10377,53343,6850,100433,5300,2612,2688
71505,110814,10377,53346,6850,100437,5300,2612,2688
71510,110824,10377,53352,6850,100447,5300,2612,2688
71515,110830,10377,53355,6850,100453,5300,2612,2688
71520,110841,10377,53359,6850,100464,5300,2612,2688
71525,110845,10377,53360,6850,100468,5300,2612,2688
71530,110855,10377,53366,6850,100478,5300,2612,2688
71535,110861,10377,53371,6850,100484,5300,2612,2688
71540,110872,10377,53374,6850,100495,5300,2612,2688
71545,110876,10377,53375,6850,100499,5300,2612,2688
71550,110886,10377,53381,6850,100509,5300,2612,2688
71555,110892,10377,53385,6850,100515,5300,2612,2688
71560,110903,10377,53391,6850,100526,5300,2612,2688
71565,110907,10377,53395,6850,100530,5300,2612,2688
71570,110917,10377,53401,6850,100540,5300,2612,2688
71575,110923,10377,53402,6850,100546,5300,2612,2688
71580,110934,10377,53406,6850,100557,5300,2612,2688
71585,110938,10377,53407,6850,100561,5300,2612,2688
71590,110948,10377,53411,6850,100571,5300,2612,2688
71595,110954,10377,53414,6850,100577,5300,2612,2688
71600,110965,10377,53423,6850,100588,5300,2612,2688
71605,110969,10377,53426,6850,100592,5300,2612,2688
71610,110979,10377,53432,6850,100602,5300,2612,2688
71615,110985,10377,53436,6850,100608,5300,2612,2688
71620,110996,10377,53441,6850,100619,5300,2612,2688
71625,111000,10377,53442,6850,100623,5300,2612,2688
71630,111010,10377,53447,6850,100633,5300,2612,2688
71635,111016,10377,53450,6850,100639,5300,2612,2688
71640,111027,10377,53457,6850,100650,5300,2612,2688
71645,111031,10377,53458,6850,100654,5300,2612,2688
71650,111041,10377,53460,6850,100664,5300,2612,2688
71655,111047,10377,53464,6850,100670,5300,2612,2688
71660,111058,10377,53469,6850,100681,5300,2612,2688
71665,111062,10377,53473,6850,100685,5300,2612,2688
71670,111072,10377,53473,6850,100695,5300,2612,2688
71675,111078,10377,53474,6850,100701,5300,2612,2688
71680,111089,10377,53480,6850,100712,5300,2612,2688
71685,111093,10377,53481,6850,100716,5300,2612,2688
71690,111103,10377,53486,6850,100726,5300,2612,2688
71695,111109,10377,53489,6850,100732,5301,2612,2689
71700,111120,10377,53492,6850,100743,5301,2612,2689
71705,111124,10377,53493,6850,100747,5301,2612,2689
71710,111134,10377,53495,6850,100757,5301,2612,2689
71715,111140,10377,53498,6850,100763,5302,2612,2690
71720,111151,10377,53503,6850,100774,5302,2612,2690
71725,111155,10377,53506,6850,100778,5302,2612,2690
71730,111165,10377,53514,6850,100788,5302,2612,2690
71735,111171,10377,53516,6850,100794,5302,2612,2690
71740,111182,10377,53524,6850,100805,5302,2612,2690
71745,111186,10377,53527,6850,100809,5302,2612,2690
71750,111196,10377,53533,6850,100819,5302,2612,2690
71755,111202,10377,53536,6850,100825,5302,2612,2690
71760,111213,10377,53542,6850,100836,5302,2612,2690
71765,111217,10377,53543,6850,100840,5302,2612,2690
71770,111227,10377,53549,6850,100850,5302,2612,2690
71775,111233,10377,53554,6850,100856,5302,2612,2690
71780,111244,10377,53557,6850,100867,5302,2612,2690
71785,111248,10377,53558,6850,100871,5302,2612,2690
71790,111258,10377,53563,6850,100881,5302,2612,2690
71795,111264,10377,53566,6850,100887,5302,2612,2690
71800,111275,10377,53571,6850,100898,5302,2612,2690
71805,111279,10377,53572,6850,100902,5302,2612,2690
71810,111289,10377,53576,6850,100912,5302,2612,2690
71815,111295,10377,53581,6850,100918,5302,2612,2690
71820,111306,10377,53585,6850,100929,5302,2612,2690
71825,111310,10377,53588,6850,100933,5302,2612,2690
71830,111320,10377,53592,6850,100943,5302,2612,2690
71835,111326,10377,53594,6850,100949,5303,2612,2691
71840,111337,10377,53599,6850,100960,5303,2612,2691
71845,111341,10377,53601,6850,100964,5303,2612,2691
71850,111351,10377,53604,6850,100974,5303,2612,2691
71855,111357,10377,53608,6850,100980,5303,2612,2691
71860,111368,10377,53614,6850,100991,5303,2612,2691
71865,111372,10377,53616,6850,100995,5303,2612,2691
71870,111382,10377,53622,6850,101005,5303,2612,2691
71875,111388,10377,53625,6850,101011,5303,2612,2691
71880,111399,10377,53630,6850,101022,5303,2612,2691
71885,111403,10377,53631,6850,101026,5303,2612,2691
71890,111413,10377,53636,6850,101036,5303,2612,2691
71895,111419,10377,53638,6850,101042,5303,2612,2691
71900,111430,10377,53642,6850,101053,5303,2612,2691
71905,111434,10377,53642,6850,101057,5303,2612,2691
71910,111444,10377,53647,6850,101067,5303,2612,2691
71915,111450,10377,53650,6850,101073,5303,2612,2691
71920,111461,10377,53656,6850,101084,5303,2612,2691
71925,111465,10377,53657,6850,101088,5303,2612,2691
71930,111475,10377,53661,6850,101098,5303,2612,2691
71935,111481,10377,53662,6850,101104,5303,2612,2691
71940,111492,10377,53670,6850,101115,5303,2612,2691
71945,111496,10377,53671,6850,101119,5303,2612,2691
71950,111506,10377,53677,6850,101129,5303,2612,2691
71955,111512,10377,53678,6850,101135,5304,2613,2691
71960,111523,10377,53682,6850,101146,5304,2613,2691
71965,111527,10377,53682,6850,101150,5304,2613,2691
71970,111537,10377,53686,6850,101160,5304,2613,2691
71975,111543,10377,53690,6850,101166,5305,2614,2691
71980,111554,10377,53693,6850,101177,5305,2614,2691
71985,111558,10377,53695,6850,101181,5305,2614,2691
71990,111568,10377,53700,6850,101191,5305,2614,2691
71995,111574,10377,53703,6850,101197,5305,2614,2691
72000,111585,10377,53711,6850,101208,5305,2614,2691
72005,111589,10377,53711,6850,101212,5305,2614,2691
72010,111599,10377,53718,6850,101222,5305,2614,2691
72015,111605,10377,53723,6850,101228,5305,2614,2691
72020,111616,10377,53726,6850,101239,5305,2614,2691
72025,111620,10377,53728,6850,101243,5305,2614,2691
72030,111630,10377,53733,6850,101253,5305,2614,2691
72035,111636,10377,53736,6850,101259,5305,2614,2691
72040,111647,10377,53741,6850,101270,5305,2614,2691
72045,111651,10377,53742,6850,101274,5305,2614,2691
72050,111661,10377,53747,6850,101284,5305,2614,2691
72055,111667,10377,53752,6850,101290,5305,2614,2691
72060,111678,10377,53760,6850,101301,5305,2614,2691
72065,111682,10377,53764,6850,101305,5305,2614,2691
72070,111692,10377,53769,6850,101315,5305,2614,2691
72075,111698,10377,53773,6850,101321,5305,2614,2691
72080,111709,10377,53777,6850,101332,5305,2614,2691
72085,111713,10377,53780,6850,101336,5305,2614,2691
72090,111723,10377,53786,6850,101346,5305,2614,2691
72095,111729,10377,53788,6850,101352,5306,2614,2692
72100,111740,10377,53793,6850,101363,5306,2614,2692
72105,111744,10377,53794,6850,101367,5306,2614,2692
72110,111754,10377,53799,6850,101377,5306,2614,2692
72115,111760,10377,53803,6850,101383,5306,2614,2692
72120,111771,10377,53809,6850,101394,5306,2614,2692
72125,111775,10377,53810,6850,101398,5306,2614,2692
72130,111785,10377,53815,6850,101408,5306,2614,2692
72135,111791,10377,53820,6850,101414,5306,2614,2692
72140,111802,10377,53825,6850,101425,5306,2614,2692
72145,111806,10377,53826,6850,101429,5306,2614,2692
72150,111816,10377,53832,6850,101439,5306,2614,2692
72155,111822,10377,53835,6850,101445,5306,2614,2692
72160,111833,10377,53841,6850,101456,5306,2614,2692
72165,111837,10377,53844,6850,101460,5306,2614,2692
72170,111847,10377,53848,6850,101470,5306,2614,2692
72175,111853,10377,53850,6850,101476,5306,2614,2692
72180,111864,10377,53857,6850,101487,5306,2614,2692
72185,111868,10377,53858,6850,101491,5306,2614,2692
72190,111878,10377,53865,6850,101501,5306,2614,2692
72195,111884,10377,53868,6850,101507,5306,2614,2692
72200,111895,10377,53873,6850,101518,5306,2614,2692
72205,111899,10377,53874,6850,101522,5306,2614,2692
72210,111909,10377,53877,6850,101532,5306,2614,2692
72215,111915,10377,53879,6850,101538,5307,2614,2693
72220,111926,10377,53881,6850,101549,5307,2614,2693
72225,111930,10377,53883,6850,101553,5307,2614,2693
72230,111940,10377,53889,6850,101563,5307,2614,2693
72235,111946,10377,53894,6850,101569,5308,2615,2693
72240,111957,10377,53897,6850,101580,5308,2615,2693
72245,111961,10377,53897,6850,101584,5308,2615,2693
72250,111971,10377,53902,6850,101594,5308,2615,2693
72255,111977,10377,53905,6850,101600,5308,2615,2693
72260,111988,10377,53909,6850,101611,5308,2615,2693
72265,111992,10377,53912,6850,101615,5308,2615,2693
72270,112002,10377,53920,6850,101625,5308,2615,2693
72275,112008,10377,53923,6850,101631,5308,2615,2693
72280,112019,10377,53931,6850,101642,5308,2615,2693
72285,112023,10377,53933,6850,101646,5308,2615,2693
72290,112033,10377,53936,6850,101656,5308,2615,2693
72295,112039,10377,53936,6850,101662,5308,2615,2693
72300,112050,10377,53943,6850,101673,5308,2615,2693
72305,112054,10377,53945,6850,101677,5308,2615,2693
72310,112064,10377,53950,6850,101687,5308,2615,2693
72315,112070,10377,53952,6850,101693,5308,2615,2693
72320,112081,10377,53957,6850,101704,5308,2615,2693
72325,112085,10377,53959,6850,101708,5308,2615,2693
72330,112095,10377,53962,6850,101718,5308,2615,2693
72335,112101,10377,53966,6850,101724,5308,2615,2693
72340,112112,10377,53972,6850,101735,5308,2615,2693
72345,112116,10377,53975,6850,101739,5308,2615,2693
72350,112126,10377,53981,6850,101749,5308,2615,2693
72355,112132,10377,53982,6850,101755,5308,2615,2693
72360,112143,10377,53985,6850,101766,5308,2615,2693
72365,112147,10377,53985,6850,101770,5308,2615,2693
72370,112157,10377,53990,6850,101780,5308,2615,2693
72375,112163,10377,53992,6850,101786,5308,2615,2693
72380,112174,10377,53997,6850,101797,5308,2615,2693
72385,112178,10377,53999,6850,101801,5308,2615,2693
72390,112188,10377,54005,6850,101811,5308,2615,2693
72395,112194,10377,54009,6850,101817,5308,2615,2693
72400,112205,10377,54012,6850,101828,5308,2615,2693
72405,112209,10377,54016,6850,101832,5308,2615,2693
72410,112219,10377,54022,6850,101842,5308,2615,2693
72415,112225,10377,54024,6850,101848,5308,2615,2693
72420,112236,10377,54031,6850,101859,5308,2615,2693
72425,112240,10377,54034,6850,101863,5308,2615,2693
72430,112250,10377,54039,6850,101873,5308,2615,2693
72435,112256,10377,54041,6850,101879,5308,2615,2693
72440,112267,10377,54045,6850,101890,5308,2615,2693
72445,112271,10377,54047,6850,101894,5308,2615,2693
72450,112281,10377,54051,6850,101904,5308,2615,2693
72455,112287,10377,54054,6850,101910,5308,2615,2693
72460,112298,10377,54060,6850,101921,5308,2615,2693
72465,112302,10377,54061,6850,101925,5308,2615,2693
72470,112312,10377,54067,6850,101935,5308,2615,2693
72475,112318,10377,54071,6850,101941,5308,2615,2693
72480,112329,10377,54076,6850,101952,5308,2615,2693
72485,112333,10377,54079,6850,101956,5308,2615,2693
72490,112343,10377,54082,6850,101966,5308,2615,2693
72495,112349,10377,54084,6850,101972,5308,2615,2693
72500,112360,10377,54091,6850,101983,5308,2615,2693
72505,112364,10377,54093,6850,101987,5308,2615,2693
72510,112374,10377,54095,6850,101997,5308,2615,2693
72515,112380,10377,54097,6850,102003,5308,2615,2693
72520,112391,10377,54100,6850,102014,5308,2615,2693
72525,112395,10377,54102,6850,102018,5308,2615,2693
72530,112405,10377,54107,6850,102028,5308,2615,2693
72535,112411,10377,54112,6850,102034,5308,2615,2693
72540,112422,10377,54116,6850,102045,5308,2615,2693
72545,112426,10377,54119,6850,102049,5308,2615,2693
72550,112436,10377,54125,6850,102059,5308,2615,2693
72555,112442,10377,54128,6850,102065,5309,2616,2693
72560,112453,10377,54134,6850,102076,5309,2616,2693
72565,112457,10377,54136,6850,102080,5309,2616,2693
72570,112467,10377,54141,6850,102090,5309,2616,2693
72575,112473,10377,54144,6850,102096,5309,2616,2693
72580,112484,10377,54150,6850,102107,5309,2616,2693
72585,112488,10377,54152,6850,102111,5309,2616,2693
72590,112498,10377,54156,6850,102121,5309,2616,2693
72595,112504,10377,54158,6850,102127,5309,2616,2693
72600,112515,10377,54163,6850,102138,5309,2616,2693
72605,112519,10377,54163,6850,102142,5309,2616,2693
72610,112529,10377,54167,6850,102152,5309,2616,2693
72615,112535,10377,54169,6850,102158,5309,2616,2693
72620,112546,10377,54173,6850,102169,5309,2616,2693
72625,112550,10377,54176,6850,102173,5309,2616,2693
72630,112560,10377,54182,6850,102183,5309,2616,2693
72635,112566,10377,54184,6850,102189,5309,2616,2693
72640,112577,10377,54190,6850,102200,5309,2616,2693
72645,112581,10377,54191,6850,102204,5309,2616,2693
72650,112591,10377,54195,6850,102214,5309,2616,2693
72655,112597,10377,54199,6850,102220,5309,2616,2693
72660,112608,10377,54206,6850,102231,5309,2616,2693
72665,112612,10377,54207,6850,102235,5309,2616,2693
72670,112622,10377,54213,6850,102245,5309,2616,2693
72675,112628,10377,54216,6850,102251,5310,2616,2694
72680,112639,10377,54221,6850,102262,5310,2616,2694
72685,112643,10377,54223,6850,102266,5310,2616,2694
72690,112653,10377,54228,6850,102276,5310,2616,2694
72695,112659,10377,54228,6850,102282,5311,2616,2695
72700,112670,10377,54234,6850,102293,5311,2616,2695
72705,112674,10377,54236,6850,102297,5311,2616,2695
72710,112684,10377,54242,6850,102307,5311,2616,2695
72715,112690,10377,54245,6850,102313,5311,2616,2695
72720,112701,10377,54250,6850,102324,5311,2616,2695
72725,112705,10377,54252,6850,102328,5311,2616,2695
72730,112715,10377,54258,6850,102338,5311,2616,2695
72735,112721,10377,54262,6850,102344,5311,2616,2695
72740,112732,10377,54267,6850,102355,5311,2616,2695
72745,112736,10377,54270,6850,102359,5311,2616,2695
72750,112746,10377,54275,6850,102369,5311,2616,2695
72755,112752,10377,54277,6850,102375,5311,2616,2695
72760,112763,10377,54282,6850,102386,5311,2616,2695
72765,112767,10377,54284,6850,102390,5311,2616,2695
72770,112777,10377,54288,6850,102400,5311,2616,2695
72775,112783,10377,54291,6850,102406,5311,2616,2695
72780,112794,10377,54297,6850,102417,5311,2616,2695
72785,112798,10377,54299,6850,102421,5311,2616,2695
72790,112808,10377,54303,6850,102431,5311,2616,2695
72795,112814,10377,54304,6850,102437,5311,2616,2695
72800,112825,10377,54307,6850,102448,5311,2616,2695
72805,112829,10377,54310,6850,102452,5311,2616,2695
72810,112839,10377,54315,6850,102462,5311,2616,2695
72815,112845,10377,54317,6850,102468,5312,2616,2696
72820,112856,10377,54322,6850,102479,5312,2616,2696
72825,112860,10377,54324,6850,102483,5312,2616,2696
72830,112870,10377,54328,6850,102493,5312,2616,2696
72835,112876,10377,54333,6850,102499,5313,2616,2697
72840,112887,10377,54338,6850,102510,5313,2616,2697
72845,112891,10377,54339,6850,102514,5313,2616,2697
72850,112901,10377,54342,6850,102524,5313,2616,2697
72855,112907,10377,54344,6850,102530,5313,2616,2697
72860,112918,10377,54348,6850,102541,5313,2616,2697
72865,112922,10377,54349,6850,102545,5313,2616,2697
72870,112932,10377,54353,6850,102555,5313,2616,2697
72875,112938,10377,54355,6850,102561,5313,2616,2697
72880,112949,10377,54359,6850,102572,5313,2616,2697
72885,112953,10377,54359,6850,102576,5313,2616,2697
72890,112963,10377,54365,6850,102586,5313,2616,2697
72895,112969,10377,54369,6850,102592,5313,2616,2697
72900,112980,10377,54375,6850,102603,5313,2616,2697
72905,112984,10377,54377,6850,102607,5313,2616,2697
72910,112994,10377,54385,6850,102617,5313,2616,2697
72915,113000,10377,54389,6850,102623,5314,2617,2697
72920,113011,10377,54395,6850,102634,5314,2617,2697
72925,113015,10377,54396,6850,102638,5314,2617,2697
72930,113025,10377,54401,6850,102648,5314,2617,2697
72935,113031,10377,54404,6850,102654,5314,2617,2697
72940,113042,10377,54408,6850,102665,5314,2617,2697
72945,113046,10377,54410,6850,102669,5314,2617,2697
72950,113056,10377,54414,6850,102679,5314,2617,2697
72955,113062,10377,54414,6850,102685,5314,2617,2697
72960,113073,10377,54421,6850,102696,5314,2617,2697
72965,113077,10377,54423,6850,102700,5314,2617,2697
72970,113087,10377,54429,6850,102710,5314,2617,2697
72975,113093,10377,54429,6850,102716,5314,2617,2697
72980,113104,10377,54437,6850,102727,5314,2617,2697
72985,113108,10377,54438,6850,102731,5314,2617,2697
72990,113118,10377,54444,6850,102741,5314,2617,2697
72995,113124,10377,54445,6850,102747,5314,2617,2697
73000,113135,10377,54447,6850,102758,5314,2617,2697
73005,113139,10377,54448,6850,102762,5314,2617,2697
73010,113149,10377,54454,6850,102772,5314,2617,2697
73015,113155,10377,54457,6850,102778,5314,2617,2697
73020,113166,10377,54465,6850,102789,5314,2617,2697
73025,113170,10377,54467,6850,102793,5314,2617,2697
73030,113180,10377,54470,6850,102803,5314,2617,2697
73035,113186,10377,54472,6850,102809,5314,2617,2697
73040,113197,10377,54476,6850,102820,5314,2617,2697
73045,113201,10377,54476,6850,102824,5314,2617,2697
73050,113211,10377,54481,6850,102834,5314,2617,2697
73055,113217,10377,54485,6850,102840,5314,2617,2697
73060,113228,10377,54489,6850,102851,5314,2617,2697
73065,113232,10377,54490,6850,102855,5314,2617,2697
73070,113242,10377,54497,6850,102865,5314,2617,2697
73075,113248,10377,54499,6850,102871,5315,2618,2697
73080,113259,10377,54505,6850,102882,5315,2618,2697
73085,113263,10377,54507,6850,102886,5315,2618,2697
73090,113273,10377,54513,6850,102896,5315,2618,2697
73095,113279,10377,54518,6850,102902,5316,2619,2697
73100,113290,10377,54525,6850,102913,5316,2619,2697
73105,113294,10377,54528,6850,102917,5316,2619,2697
73110,113304,10377,54535,6850,102927,5316,2619,2697
73115,113310,10377,54536,6850,102933,5316,2619,2697
73120,113321,10377,54541,6850,102944,5316,2619,2697
73125,113325,10377,54545,6850,102948,5316,2619,2697
73130,113335,10377,54549,6850,102958,5316,2619,2697
73135,113341,10377,54554,6850,102964,5316,2619,2697
73140,113352,10377,54559,6850,102975,5316,2619,2697
73145,113356,10377,54560,6850,102979,5316,2619,2697
73150,113366,10377,54564,6850,102989,5316,2619,2697
73155,113372,10377,54566,6850,102995,5316,2619,2697
73160,113383,10377,54570,6850,103006,5316,2619,2697
73165,113387,10377,54573,6850,103010,5316,2619,2697
73170,113397,10377,54580,6850,103020,5316,2619,2697
73175,113403,10377,54583,6850,103026,5316,2619,2697
73180,113414,10377,54590,6850,103037,5316,2619,2697
73185,113418,10377,54593,6850,103041,5316,2619,2697
73190,113428,10377,54597,6850,103051,5316,2619,2697
73195,113434,10377,54601,6850,103057,5316,2619,2697
73200,113445,10377,54606,6850,103068,5316,2619,2697
73205,113449,10377,54607,6850,103072,5316,2619,2697
73210,113459,10377,54613,6850,103082,5316,2619,2697
73215,113465,10377,54614,6850,103088,5317,2619,2698
73220,113476,10377,54619,6850,103099,5317,2619,2698
73225,113480,10377,54621,6850,103103,5317,2619,2698
73230,113490,10377,54627,6850,103113,5317,2619,2698
73235,113496,10377,54627,6850,103119,5317,2619,2698
73240,113507,10377,54632,6850,103130,5317,2619,2698
73245,113511,10377,54632,6850,103134,5317,2619,2698
73250,113521,10377,54637,6850,103144,5317,2619,2698
73255,113527,10377,54639,6850,103150,5317,2619,2698
73260,113538,10377,54648,6850,103161,5317,2619,2698
73265,113542,10377,54651,6850,103165,5317,2619,2698
73270,113552,10377,54657,6850,103175,5317,2619,2698
73275,113558,10377,54657,6850,103181,5317,2619,2698
73280,113569,10377,54659,6850,103192,5317,2619,2698
73285,113573,10377,54662,6850,103196,5317,2619,2698
73290,113583,10377,54667,6850,103206,5317,2619,2698
73295,113589,10377,54669,6850,103212,5317,2619,2698
73300,113600,10377,54674,6850,103223,5317,2619,2698
73305,113604,10377,54678,6850,103227,5317,2619,2698
73310,113614,10377,54683,6850,103237,5317,2619,2698
73315,113620,10377,54687,6850,103243,5317,2619,2698
73320,113631,10377,54692,6850,103254,5317,2619,2698
73325,113635,10377,54693,6850,103258,5317,2619,2698
73330,113645,10377,54698,6850,103268,5317,2619,2698
73335,113651,10377,54699,6850,103274,5318,2620,2698
73340,113662,10377,54704,6850,103285,5318,2620,2698
73345,113666,10377,54705,6850,103289,5318,2620,2698
73350,113676,10377,54710,6850,103299,5318,2620,2698
73355,113682,10377,54713,6850,103305,5318,2620,2698
73360,113693,10377,54719,6850,103316,5318,2620,2698
73365,113697,10377,54721,6850,103320,5318,2620,2698
73370,113707,10377,54730,6850,103330,5318,2620,2698
73375,113713,10377,54732,6850,103336,5318,2620,2698
73380,113724,10377,54738,6850,103347,5318,2620,2698
73385,113728,10377,54741,6850,103351,5318,2620,2698
73390,113738,10377,54745,6850,103361,5318,2620,2698
73395,113744,10377,54747,6850,103367,5318,2620,2698
73400,113755,10377,54751,6850,103378,5318,2620,2698
73405,113759,10377,54751,6850,103382,5318,2620,2698
73410,113769,10377,54757,6850,103392,5318,2620,2698
73415,113775,10377,54761,6850,103398,5318,2620,2698
73420,113786,10377,54765,6850,103409,5318,2620,2698
73425,113790,10377,54768,6850,103413,5318,2620,2698
73430,113800,10377,54773,6850,103423,5318,2620,2698
73435,113806,10377,54776,6850,103429,5318,2620,2698
73440,113817,10377,54778,6850,103440,5318,2620,2698
73445,113821,10377,54779,6850,103444,5318,2620,2698
73450,113831,10377,54786,6850,103454,5318,2620,2698
73455,113837,10377,54790,6850,103460,5319,2620,2699
73460,113848,10377,54792,6850,103471,5319,2620,2699
73465,113852,10377,54796,6850,103475,5319,2620,2699
73470,113862,10377,54800,6850,103485,5319,2620,2699
73475,113868,10377,54802,6850,103491,5320,2620,2700
73480,113879,10377,54806,6850,103502,5320,2620,2700
73485,113883,10377,54808,6850,103506,5320,2620,2700
73490,113893,10377,54815,6850,103516,5320,2620,2700
73495,113899,10377,54818,6850,103522,5320,2620,2700
73500,113910,10377,54824,6850,103533,5320,2620,2700
73505,113914,10377,54825,6850,103537,5320,2620,2700
73510,113924,10377,54830,6850,103547,5320,2620,2700
73515,113930,10377,54835,6850,103553,5320,2620,2700
73520,113941,10377,54839,6850,103564,5320,2620,2700
73525,113945,10377,54840,6850,103568,5320,2620,2700
73530,113955,10377,54848,6850,103578,5320,2620,2700
73535,113961,10377,54852,6850,103584,5320,2620,2700
73540,113972,10377,54855,6850,103595,5320,2620,2700
73545,113976,10377,54855,6850,103599,5320,2620,2700
73550,113986,10377,54861,6850,103609,5320,2620,2700
73555,113992,10377,54862,6850,103615,5320,2620,2700
73560,114003,10377,54869,6850,103626,5320,2620,2700
73565,114007,10377,54870,6850,103630,5320,2620,2700
73570,114017,10377,54873,6850,103640,5320,2620,2700
73575,114023,10377,54875,6850,103646,5320,2620,2700
73580,114034,10377,54878,6850,103657,5320,2620,2700
73585,114038,10377,54881,6850,103661,5320,2620,2700
73590,114048,10377,54888,6850,103671,5320,2620,2700
73595,114054,10377,54892,6850,103677,5321,2621,2700
73600,114065,10377,54898,6850,103688,5321,2621,2700
73605,114069,10377,54900,6850,103692,5321,2621,2700
73610,114079,10377,54904,6850,103702,5321,2621,2700
73615,114085,10377,54905,6850,103708,5322,2621,2701
73620,114096,10377,54907,6850,103719,5322,2621,2701
73625,114100,10377,54908,6850,103723,5322,2621,2701
73630,114110,10377,54914,6850,103733,5322,2621,2701
73635,114116,10377,54916,6850,103739,5322,2621,2701
73640,114127,10377,54919,6850,103750,5322,2621,2701
73645,114131,10377,54920,6850,103754,5322,2621,2701
73650,114141,10377,54927,6850,103764,5322,2621,2701
73655,114147,10377,54930,6850,103770,5322,2621,2701
73660,114158,10377,54934,6850,103781,5322,2621,2701
73665,114162,10377,54934,6850,103785,5322,2621,2701
73670,114172,10377,54939,6850,103795,5322,2621,2701
73675,114178,10377,54942,6850,103801,5322,2621,2701
73680,114189,10377,54946,6850,103812,5322,2621,2701
73685,114193,10377,54949,6850,103816,5322,2621,2701
73690,114203,10377,54953,6850,103826,5322,2621,2701
73695,114209,10377,54955,6850,103832,5322,2621,2701
73700,114220,10377,54957,6850,103843,5322,2621,2701
73705,114224,10377,54961,6850,103847,5322,2621,2701
73710,114234,10377,54968,6850,103857,5322,2621,2701
73715,114240,10377,54970,6850,103863,5322,2621,2701
73720,114251,10377,54976,6850,103874,5322,2621,2701
73725,114255,10377,54978,6850,103878,5322,2621,2701
73730,114265,10377,54983,6850,103888,5322,2621,2701
73735,114271,10377,54987,6850,103894,5323,2622,2701
73740,114282,10377,54993,6850,103905,5323,2622,2701
73745,114286,10377,54993,6850,103909,5323,2622,2701
73750,114296,10377,54997,6850,103919,5323,2622,2701
73755,114302,10377,54998,6850,103925,5323,2622,2701
73760,114313,10377,55003,6850,103936,5323,2622,2701
73765,114317,10377,55004,6850,103940,5323,2622,2701
73770,114327,10377,55011,6850,103950,5323,2622,2701
73775,114333,10377,55014,6850,103956,5323,2622,2701
73780,114344,10377,55017,6850,103967,5323,2622,2701
73785,114348,10377,55018,6850,103971,5323,2622,2701
73790,114358,10377,55021,6850,103981,5323,2622,2701
73795,114364,10377,55024,6850,103987,5323,2622,2701
73800,114375,10377,55030,6850,103998,5323,2622,2701
73805,114379,10377,55034,6850,104002,5323,2622,2701
73810,114389,10377,55037,6850,104012,5323,2622,2701
73815,114395,10377,55040,6850,104018,5323,2622,2701
73820,114406,10377,55045,6850,104029,5323,2622,2701
73825,114410,10377,55048,6850,104033,5323,2622,2701
73830,114420,10377,55055,6850,104043,5323,2622,2701
73835,114426,10377,55059,6850,104049,5323,2622,2701
73840,114437,10377,55064,6850,104060,5323,2622,2701
73845,114441,10377,55067,6850,104064,5323,2622,2701
73850,114451,10377,55071,6850,104074,5323,2622,2701
73855,114457,10377,55076,6850,104080,5324,2623,2701
73860,114468,10377,55082,6850,104091,5324,2623,2701
73865,114472,10377,55083,6850,104095,5324,2623,2701
73870,114482,10377,55087,6850,104105,5324,2623,2701
73875,114488,10377,55090,6850,104111,5324,2623,2701
73880,114499,10377,55095,6850,104122,5324,2623,2701
73885,114503,10377,55097,6850,104126,5324,2623,2701
73890,114513,10377,55102,6850,104136,5324,2623,2701
73895,114519,10377,55105,6850,104142,5324,2623,2701
73900,114530,10377,55111,6850,104153,5324,2623,2701
73905,114534,10377,55114,6850,104157,5324,2623,2701
73910,114544,10377,55117,6850,104167,5324,2623,2701
73915,114550,10377,55118,6850,104173,5324,2623,2701
73920,114561,10377,55121,6850,104184,5324,2623,2701
73925,114565,10377,55123,6850,104188,5324,2623,2701
73930,114575,10377,55129,6850,104198,5324,2623,2701
73935,114581,10377,55134,6850,104204,5324,2623,2701
73940,114592,10377,55139,6850,104215,5324,2623,2701
73945,114596,10377,55141,6850,104219,5324,2623,2701
73950,114606,10377,55148,6850,104229,5324,2623,2701
73955,114612,10377,55150,6850,104235,5324,2623,2701
73960,114623,10377,55155,6850,104246,5324,2623,2701
73965,114627,10377,55157,6850,104250,5324,2623,2701
73970,114637,10377,55164,6850,104260,5324,2623,2701
73975,114643,10377,55165,6850,104266,5325,2623,2702
73980,114654,10377,55170,6850,104277,5325,2623,2702
73985,114658,10377,55172,6850,104281,5325,2623,2702
73990,114668,10377,55179,6850,104291,5325,2623,2702
73995,114674,10377,55181,6850,104297,5326,2623,2703
74000,114685,10377,55188,6850,104308,5326,2623,2703
74005,114689,10377,55188,6850,104312,5326,2623,2703
74010,114699,10377,55194,6850,104322,5326,2623,2703
74015,114705,10377,55197,6850,104328,5326,2623,2703
74020,114716,10377,55202,6850,104339,5326,2623,2703
74025,114720,10377,55204,6850,104343,5326,2623,2703
74030,114730,10377,55207,6850,104353,5326,2623,2703
74035,114736,10377,55210,6850,104359,5326,2623,2703
74040,114747,10377,55216,6850,104370,5326,2623,2703
74045,114751,10377,55219,6850,104374,5326,2623,2703
74050,114761,10377,55225,6850,104384,5326,2623,2703
74055,114767,10377,55226,6850,104390,5326,2623,2703
74060,114778,10377,55232,6850,104401,5326,2623,2703
74065,114782,10377,55235,6850,104405,5326,2623,2703
74070,114792,10377,55240,6850,104415,5326,2623,2703
74075,114798,10377,55244,6850,104421,5326,2623,2703
74080,114809,10377,55250,6850,104432,5326,2623,2703
74085,114813,10377,55253,6850,104436,5326,2623,2703
74090,114823,10377,55255,6850,104446,5326,2623,2703
74095,114829,10377,55258,6850,104452,5326,2623,2703
74100,114840,10377,55263,6850,104463,5326,2623,2703
74105,114844,10377,55267,6850,104467,5326,2623,2703
74110,114854,10377,55270,6850,104477,5326,2623,2703
74115,114860,10377,55273,6850,104483,5327,2623,2704
74120,114871,10377,55277,6850,104494,5327,2623,2704
74125,114875,10377,55279,6850,104498,5327,2623,2704
74130,114885,10377,55285,6850,104508,5327,2623,2704
74135,114891,10377,55288,6850,104514,5328,2623,2705
74140,114902,10377,55293,6850,104525,5328,2623,2705
74145,114906,10377,55296,6850,104529,5328,2623,2705
74150,114916,10377,55297,6850,104539,5328,2623,2705
74155,114922,10377,55301,6850,104545,5328,2623,2705
74160,114933,10377,55311,6850,104556,5328,2623,2705
74165,114937,10377,55313,6850,104560,5328,2623,2705
74170,114947,10377,55318,6850,104570,5328,2623,2705
74175,114953,10377,55321,6850,104576,5328,2623,2705
74180,114964,10377,55326,6850,104587,5328,2623,2705
74185,114968,10377,55328,6850,104591,5328,2623,2705
74190,114978,10377,55330,6850,104601,5328,2623,2705
74195,114984,10377,55332,6850,104607,5328,2623,2705
74200,114995,10377,55338,6850,104618,5328,2623,2705
74205,114999,10377,55340,6850,104622,5328,2623,2705
74210,115009,10377,55343,6850,104632,5328,2623,2705
74215,115015,10377,55345,6850,104638,5328,2623,2705
74220,115026,10377,55352,6850,104649,5328,2623,2705
74225,115030,10377,55355,6850,104653,5328,2623,2705
74230,115040,10377,55362,6850,104663,5328,2623,2705
74235,115046,10377,55362,6850,104669,5328,2623,2705
74240,115057,10377,55369,6850,104680,5328,2623,2705
74245,115061,10377,55370,6850,104684,5328,2623,2705
74250,115071,10377,55374,6850,104694,5328,2623,2705
74255,115077,10377,55378,6850,104700,5329,2623,2706
74260,115088,10377,55380,6850,104711,5329,2623,2706
74265,115092,10377,55383,6850,104715,5329,2623,2706
74270,115102,10377,55389,6850,104725,5329,2623,2706
74275,115108,10377,55392,6850,104731,5330,2623,2707
74280,115119,10377,55396,6850,104742,5330,2623,2707
74285,115123,10377,55398,6850,104746,5330,2623,2707
74290,115133,10377,55403,6850,104756,5330,2623,2707
74295,115139,10377,55406,6850,104762,5330,2623,2707
74300,115150,10377,55411,6850,104773,5330,2623,2707
74305,115154,10377,55412,6850,104777,5330,2623,2707
74310,115164,10377,55415,6850,104787,5330,2623,2707
74315,115170,10377,55420,6850,104793,5330,2623,2707
74320,115181,10377,55428,6850,104804,5330,2623,2707
74325,115185,10377,55429,6850,104808,5330,2623,2707
74330,115195,10377,55433,6850,104818,5330,2623,2707
74335,115201,10377,55437,6850,104824,5330,2623,2707
74340,115212,10377,55446,6850,104835,5330,2623,2707
74345,115216,10377,55446,6850,104839,5330,2623,2707
74350,115226,10377,55451,6850,104849,5330,2623,2707
74355,115232,10377,55454,6850,104855,5330,2623,2707
74360,115243,10377,55461,6850,104866,5330,2623,2707
74365,115247,10377,55462,6850,104870,5330,2623,2707
74370,115257,10377,55465,6850,104880,5330,2623,2707
74375,115263,10377,55468,6850,104886,5330,2623,2707
74380,115274,10377,55474,6850,104897,5330,2623,2707
74385,115278,10377,55474,6850,104901,5330,2623,2707
74390,115288,10377,55476,6850,104911,5330,2623,2707
74395,115294,10377,55481,6850,104917,5331,2624,2707
74400,115305,10377,55486,6850,104928,5331,2624,2707
74405,115309,10377,55488,6850,104932,5331,2624,2707
74410,115319,10377,55490,6850,104942,5331,2624,2707
74415,115325,10377,55493,6850,104948,5331,2624,2707
74420,115336,10377,55498,6850,104959,5331,2624,2707
74425,115340,10377,55500,6850,104963,5331,2624,2707
74430,115350,10377,55504,6850,104973,5331,2624,2707
74435,115356,10377,55509,6850,104979,5331,2624,2707
74440,115367,10377,55513,6850,104990,5331,2624,2707
74445,115371,10377,55514,6850,104994,5331,2624,2707
74450,115381,10377,55515,6850,105004,5331,2624,2707
74455,115387,10377,55520,6850,105010,5331,2624,2707
74460,115398,10377,55525,6850,105021,5331,2624,2707
74465,115402,10377,55528,6850,105025,5331,2624,2707
74470,115412,10377,55531,6850,105035,5331,2624,2707
74475,115418,10377,55534,6850,105041,5331,2624,2707
74480,115429,10377,55539,6850,105052,5331,2624,2707
74485,115433,10377,55542,6850,105056,5331,2624,2707
74490,115443,10377,55548,6850,105066,5331,2624,2707
74495,115449,10377,55550,6850,105072,5331,2624,2707
74500,115460,10377,55556,6850,105083,5331,2624,2707
74505,115464,10377,55558,6850,105087,5331,2624,2707
74510,115474,10377,55562,6850,105097,5331,2624,2707
74515,115480,10377,55565,6850,105103,5332,2625,2707
74520,115491,10377,55571,6850,105114,5332,2625,2707
74525,115495,10377,55571,6850,105118,5332,2625,2707
74530,115505,10377,55577,6850,105128,5332,2625,2707
74535,115511,10377,55581,6850,105134,5333,2626,2707
74540,115522,10377,55588,6850,105145,5333,2626,2707
74545,115526,10377,55591,6850,105149,5333,2626,2707
74550,115536,10377,55596,6850,105159,5333,2626,2707
74555,115542,10377,55598,6850,105165,5333,2626,2707
74560,115553,10377,55601,6850,105176,5333,2626,2707
74565,115557,10377,55601,6850,105180,5333,2626,2707
74570,115567,10377,55606,6850,105190,5333,2626,2707
74575,115573,10377,55608,6850,105196,5333,2626,2707
74580,115584,10377,55614,6850,105207,5333,2626,2707
74585,115588,10377,55617,6850,105211,5333,2626,2707
74590,115598,10377,55623,6850,105221,5333,2626,2707
74595,115604,10377,55625,6850,105227,5333,2626,2707
74600,115615,10377,55631,6850,105238,5333,2626,2707
74605,115619,10377,55632,6850,105242,5333,2626,2707
74610,115629,10377,55637,6850,105252,5333,2626,2707
74615,115635,10377,55641,6850,105258,5333,2626,2707
74620,115646,10377,55647,6850,105269,5333,2626,2707
74625,115650,10377,55649,6850,105273,5333,2626,2707
74630,115660,10377,55655,6850,105283,5333,2626,2707
74635,115666,10377,55658,6850,105289,5333,2626,2707
74640,115677,10377,55664,6850,105300,5333,2626,2707
74645,115681,10377,55667,6850,105304,5333,2626,2707
74650,115691,10377,55671,6850,105314,5333,2626,2707
74655,115697,10377,55676,6850,105320,5334,2626,2708
74660,115708,10377,55679,6850,105331,5334,2626,2708
74665,115712,10377,55679,6850,105335,5334,2626,2708
74670,115722,10377,55685,6850,105345,5334,2626,2708
74675,115728,10377,55687,6850,105351,5334,2626,2708
74680,115739,10377,55692,6850,105362,5334,2626,2708
74685,115743,10377,55693,6850,105366,5334,2626,2708
74690,115753,10377,55698,6850,105376,5334,2626,2708
74695,115759,10377,55701,6850,105382,5334,2626,2708
74700,115770,10377,55707,6850,105393,5334,2626,2708
74705,115774,10377,55707,6850,105397,5334,2626,2708
74710,115784,10377,55712,6850,105407,5334,2626,2708
74715,115790,10377,55715,6850,105413,5334,2626,2708
74720,115801,10377,55720,6850,105424,5334,2626,2708
74725,115805,10377,55721,6850,105428,5334,2626,2708
74730,115815,10377,55725,6850,105438,5334,2626,2708
74735,115821,10377,55728,6850,105444,5334,2626,2708
74740,115832,10377,55735,6850,105455,5334,2626,2708
74745,115836,10377,55738,6850,105459,5334,2626,2708
74750,115846,10377,55744,6850,105469,5334,2626,2708
74755,115852,10377,55745,6850,105475,5334,2626,2708
74760,115863,10377,55752,6850,105486,5334,2626,2708
74765,115867,10377,55754,6850,105490,5334,2626,2708
74770,115877,10377,55757,6850,105500,5334,2626,2708
74775,115883,10377,55760,6850,105506,5335,2626,2709
74780,115894,10377,55765,6850,105517,5335,2626,2709
74785,115898,10377,55768,6850,105521,5335,2626,2709
74790,115908,10377,55775,6850,105531,5335,2626,2709
74795,115914,10377,55778,6850,105537,5336,2626,2710
74800,115925,10377,55782,6850,105548,5336,2626,2710
74805,115929,10377,55783,6850,105552,5336,2626,2710
74810,115939,10377,55789,6850,105562,5336,2626,2710
74815,115945,10377,55790,6850,105568,5336,2626,2710
74820,115956,10377,55797,6850,105579,5336,2626,2710
74823,115960,10377,55800,6850,105583,5336,2626,2710
